app,usage,start_time,end_time,created_at,tz,device_id,device_model
com.apple.finder,1,1710991823,1710991824,1710991824.99898,-18000,,
com.google.Chrome,19,1710991804,1710991823,1710991823.793408,-18000,,
com.apple.finder,2,1710991802,1710991804,1710991804.699504,-18000,,
com.apple.Terminal,30,1710991772,1710991802,1710991802.820313,-18000,,
com.google.Chrome,10,1710991762,1710991772,1710991772.78763,-18000,,
com.apple.Terminal,17,1710991745,1710991762,1710991762.735448,-18000,,
com.apple.finder,5,1710991740,1710991745,1710991745.854815,-18000,,
org.python.IDLE,21,1710991719,1710991740,1710991740.719225,-18000,,
com.apple.finder,10,1710991709,1710991719,1710991719.66012,-18000,,
org.python.IDLE,20,1710991689,1710991709,1710991709.79091,-18000,,
com.apple.finder,34,1710991655,1710991689,1710991689.568953,-18000,,
com.google.Chrome,6,1710991649,1710991655,1710991655.180063,-18000,,
com.google.Chrome,3,1710985536,1710985539,1710985539.6696959,-18000,,
com.apple.finder,1,1710985535,1710985536,1710985536.561325,-18000,,
com.apple.Notes,14,1710985521,1710985535,1710985535.601831,-18000,,
com.google.Chrome,5,1710985516,1710985521,1710985521.281804,-18000,,
com.leomehlig.today,14,1710985502,1710985516,1710985516.964884,-18000,,
com.google.Chrome,86,1710985416,1710985502,1710985502.589021,-18000,,
com.leomehlig.today,63,1710985353,1710985416,1710985416.7241359,-18000,,
com.apple.finder,13,1710985340,1710985353,1710985353.29741,-18000,,
com.leomehlig.today,46,1710985294,1710985340,1710985340.250803,-18000,,
com.apple.Notes,7,1710985287,1710985294,1710985295.039298,-18000,,
com.leomehlig.today,29,1710985258,1710985287,1710985288.002403,-18000,,
com.apple.Notes,91,1710985167,1710985258,1710985258.830772,-18000,,
com.google.Chrome,3,1710985164,1710985167,1710985167.66695,-18000,,
com.google.Chrome,300,1710984772,1710985072,1710985072.1882648,-18000,,
com.leomehlig.today,40,1710984732,1710984772,1710984772.252734,-18000,,
com.google.Chrome,547,1710984185,1710984732,1710984732.6860042,-18000,,
com.leomehlig.today,3,1710984182,1710984185,1710984185.386399,-18000,,
com.google.Chrome,1134,1710983048,1710984182,1710984182.178796,-18000,,
com.leomehlig.today,6,1710983042,1710983048,1710983048.769397,-18000,,
com.google.Chrome,1592,1710981450,1710983042,1710983042.990031,-18000,,
com.google.Chrome,301,1710981114,1710981415,1710981415.4962091,-18000,,
com.google.Chrome,1729,1710979372,1710981101,1710981101.216414,-18000,,
com.leomehlig.today,2,1710979232,1710979234,1710979234.2335482,-18000,,
com.google.Chrome,218,1710979014,1710979232,1710979232.467451,-18000,,
com.leomehlig.today,14,1710979000,1710979014,1710979014.87307,-18000,,
com.leomehlig.today,58,1710976536,1710976594,1710976594.325235,-18000,,
com.google.Chrome,249,1710976287,1710976536,1710976536.873289,-18000,,
com.leomehlig.today,19,1710976258,1710976277,1710976277.6955929,-18000,,
com.google.Chrome,3,1710976255,1710976258,1710976258.270469,-18000,,
com.apple.finder,20,1710976235,1710976255,1710976255.914864,-18000,,
com.apple.Photos,15,1710976220,1710976235,1710976235.698463,-18000,,
com.apple.finder,24,1710976196,1710976220,1710976220.338993,-18000,,
com.apple.Photos,52,1710976144,1710976196,1710976196.6471748,-18000,,
com.google.Chrome,87,1710976057,1710976144,1710976144.8992538,-18000,,
com.apple.Photos,9,1710976048,1710976057,1710976057.1456919,-18000,,
com.google.Chrome,38,1710976010,1710976048,1710976048.831634,-18000,,
com.apple.Photos,62,1710975948,1710976010,1710976010.909593,-18000,,
com.apple.finder,48,1710975900,1710975948,1710975948.4499931,-18000,,
com.apple.Photos,55,1710975845,1710975900,1710975900.151318,-18000,,
com.apple.finder,82,1710975763,1710975845,1710975845.4999108,-18000,,
com.apple.Photos,74,1710975689,1710975763,1710975764.165133,-18000,,
com.google.Chrome,44,1710975645,1710975689,1710975689.198586,-18000,,
com.apple.Photos,1,1710975644,1710975645,1710975645.784883,-18000,,
com.google.Chrome,19,1710975625,1710975644,1710975645.0201,-18000,,
com.apple.Photos,7,1710975618,1710975625,1710975625.697964,-18000,,
com.leomehlig.today,51,1710975567,1710975618,1710975618.2113562,-18000,,
com.google.Chrome,26,1710975541,1710975567,1710975567.323215,-18000,,
com.google.Chrome,2,1710967447,1710967449,1710967449.0576801,-18000,,
com.apple.finder,1,1710967446,1710967447,1710967447.411924,-18000,,
com.google.Chrome,9,1710967437,1710967446,1710967446.187005,-18000,,
com.microsoft.Outlook,4,1710967433,1710967437,1710967437.9537668,-18000,,
com.apple.iCal,20,1710967413,1710967433,1710967433.067473,-18000,,
com.google.Chrome,17,1710967396,1710967413,1710967413.802702,-18000,,
com.microsoft.Outlook,5,1710967391,1710967396,1710967396.2916079,-18000,,
com.google.Chrome,68,1710967323,1710967391,1710967391.321176,-18000,,
com.microsoft.Outlook,5,1710967318,1710967323,1710967323.423557,-18000,,
com.microsoft.Outlook,303,1710966846,1710967149,1710967149.923347,-18000,,
com.google.Chrome,8,1710966838,1710966846,1710966846.232341,-18000,,
com.apple.finder,2,1710966832,1710966834,1710966835.772503,-18000,,
com.apple.finder,3,1710966035,1710966038,1710966038.925111,-18000,,
com.google.Chrome,3,1710966032,1710966035,1710966035.351965,-18000,,
com.leomehlig.today,70,1710965962,1710966032,1710966032.8947911,-18000,,
com.google.Chrome,456,1710965506,1710965962,1710965962.54321,-18000,,
com.google.Chrome,909,1710964530,1710965439,1710965439.77909,-18000,,
com.google.Chrome,525,1710963931,1710964456,1710964456.791647,-18000,,
com.google.Chrome,975,1710962895,1710963870,1710963870.1384811,-18000,,
com.google.Chrome,332,1710962553,1710962885,1710962885.714837,-18000,,
com.leomehlig.today,8,1710962522,1710962530,1710962530.26409,-18000,,
com.leomehlig.today,23,1710957452,1710957475,1710957475.791235,-18000,,
com.apple.Preview,194,1710957258,1710957452,1710957452.5613708,-18000,,
com.apple.iCal,4,1710957254,1710957258,1710957258.242972,-18000,,
com.apple.Preview,1231,1710956023,1710957254,1710957254.772274,-18000,,
com.apple.MobileSMS,5,1710956018,1710956023,1710956023.079114,-18000,,
com.apple.Preview,12,1710956006,1710956018,1710956018.861826,-18000,,
com.apple.MobileSMS,23,1710955983,1710956006,1710956006.595749,-18000,,
com.apple.iCal,17,1710955966,1710955983,1710955983.370527,-18000,,
com.apple.MobileSMS,206,1710955760,1710955966,1710955966.6942558,-18000,,
com.apple.iCal,45,1710955715,1710955760,1710955761.0606298,-18000,,
com.apple.MobileSMS,93,1710955622,1710955715,1710955715.242672,-18000,,
com.apple.Preview,34,1710955588,1710955622,1710955622.1703649,-18000,,
com.apple.finder,4,1710955584,1710955588,1710955588.701762,-18000,,
com.apple.Preview,1,1710955583,1710955584,1710955584.8084512,-18000,,
com.apple.Notes,49,1710955534,1710955583,1710955583.7649589,-18000,,
com.leomehlig.today,2,1710955530,1710955532,1710955532.504198,-18000,,
com.apple.systempreferences,1,1710955529,1710955530,1710955530.355685,-18000,,
com.leomehlig.today,10,1710955518,1710955528,1710955528.24195,-18000,,
com.leomehlig.today,4,1710950794,1710950798,1710950798.420092,-18000,,
com.microsoft.VSCode,7,1710950787,1710950794,1710950795.050487,-18000,,
com.google.Chrome,289,1710950498,1710950787,1710950787.185128,-18000,,
com.microsoft.VSCode,4,1710950475,1710950479,1710950479.2025561,-18000,,
com.microsoft.VSCode,3059,1710946264,1710949323,1710949323.987154,-18000,,
com.apple.iCal,49,1710946215,1710946264,1710946265.009983,-18000,,
com.google.Chrome,35,1710946180,1710946215,1710946215.483735,-18000,,
com.microsoft.VSCode,279,1710945901,1710946180,1710946180.258735,-18000,,
com.leomehlig.today,100,1710945801,1710945901,1710945901.275731,-18000,,
com.google.Chrome,6,1710945795,1710945801,1710945801.549041,-18000,,
com.microsoft.VSCode,436,1710945359,1710945795,1710945795.7298021,-18000,,
com.apple.MobileSMS,6,1710945353,1710945359,1710945359.5428429,-18000,,
com.microsoft.VSCode,133,1710945220,1710945353,1710945353.120214,-18000,,
com.google.Chrome,10,1710945210,1710945220,1710945220.484416,-18000,,
com.microsoft.VSCode,2,1710945208,1710945210,1710945211.30652,-18000,,
com.google.Chrome,12,1710945196,1710945208,1710945208.854982,-18000,,
com.apple.finder,2,1710945194,1710945196,1710945198.573189,-18000,,
com.apple.finder,10,1710907177,1710907187,1710907187.717303,-18000,,
com.apple.Photos,2,1710907175,1710907177,1710907178.436393,-18000,,
com.google.Chrome,404,1710906771,1710907175,1710907175.817974,-18000,,
com.google.Chrome,736,1710905691,1710906427,1710906427.0334392,-18000,,
com.google.Chrome,762,1710904567,1710905329,1710905329.010257,-18000,,
com.google.Chrome,907,1710903507,1710904414,1710904414.445723,-18000,,
com.google.Chrome,374,1710902853,1710903227,1710903227.5756001,-18000,,
com.google.Chrome,301,1710902447,1710902748,1710902748.3843179,-18000,,
com.google.Chrome,490,1710901708,1710902198,1710902198.432375,-18000,,
com.google.Chrome,396,1710901194,1710901590,1710901590.2509708,-18000,,
com.google.Chrome,598,1710900107,1710900705,1710900705.380515,-18000,,
com.apple.finder,2,1710900105,1710900107,1710900108.002603,-18000,,
com.microsoft.VSCode,505,1710899600,1710900105,1710900105.830375,-18000,,
com.apple.finder,0,1710899600,1710899600,1710899601.022931,-18000,,
com.google.Chrome,1,1710899599,1710899600,1710899600.414837,-18000,,
com.apple.finder,1,1710899598,1710899599,1710899599.485167,-18000,,
com.microsoft.VSCode,6,1710899592,1710899598,1710899598.749541,-18000,,
com.apple.finder,6,1710899586,1710899592,1710899592.9359698,-18000,,
com.google.Chrome,2,1710899584,1710899586,1710899586.307375,-18000,,
com.microsoft.VSCode,34,1710899550,1710899584,1710899584.487763,-18000,,
com.google.Chrome,27,1710899523,1710899550,1710899550.213976,-18000,,
com.microsoft.VSCode,1,1710899522,1710899523,1710899523.9172,-18000,,
com.microsoft.VSCode,712,1710895396,1710896108,1710896108.129942,-18000,,
com.microsoft.VSCode,311,1710895083,1710895394,1710895394.6544461,-18000,,
com.apple.finder,2,1710895081,1710895083,1710895083.985653,-18000,,
com.microsoft.VSCode,53,1710895028,1710895081,1710895081.51292,-18000,,
com.apple.finder,1,1710895027,1710895028,1710895028.4274812,-18000,,
com.apple.systempreferences,4,1710895022,1710895026,1710895026.823236,-18000,,
com.apple.finder,2,1710895019,1710895021,1710895021.1204782,-18000,,
com.apple.iWork.Numbers,17,1710895002,1710895019,1710895019.391035,-18000,,
com.apple.finder,203,1710894799,1710895002,1710895003.00895,-18000,,
com.microsoft.VSCode,33,1710894766,1710894799,1710894800.06608,-18000,,
com.apple.finder,30,1710894736,1710894766,1710894766.971754,-18000,,
com.microsoft.VSCode,13,1710894723,1710894736,1710894736.25695,-18000,,
com.apple.finder,3,1710894720,1710894723,1710894723.953755,-18000,,
com.microsoft.VSCode,13,1710894707,1710894720,1710894720.3868089,-18000,,
com.apple.finder,4,1710894703,1710894707,1710894707.5595598,-18000,,
com.microsoft.VSCode,3,1710894700,1710894703,1710894704.142313,-18000,,
com.apple.finder,4,1710894696,1710894700,1710894700.1912231,-18000,,
com.microsoft.VSCode,23,1710894673,1710894696,1710894696.763444,-18000,,
com.apple.finder,5,1710894668,1710894673,1710894673.252506,-18000,,
com.google.Chrome,1,1710894667,1710894668,1710894668.954589,-18000,,
com.microsoft.VSCode,14,1710894653,1710894667,1710894667.098331,-18000,,
com.google.Chrome,30,1710894623,1710894653,1710894653.640122,-18000,,
com.microsoft.Outlook,21,1710894602,1710894623,1710894623.3422809,-18000,,
com.google.Chrome,23,1710894579,1710894602,1710894602.210401,-18000,,
com.apple.finder,7,1710894572,1710894579,1710894579.076369,-18000,,
com.google.Chrome,2,1710894570,1710894572,1710894572.521976,-18000,,
com.microsoft.VSCode,594,1710893976,1710894570,1710894570.923655,-18000,,
com.apple.finder,6,1710893970,1710893976,1710893976.48107,-18000,,
com.microsoft.VSCode,40,1710893930,1710893970,1710893971.031228,-18000,,
com.google.Chrome,43,1710893887,1710893930,1710893931.0352058,-18000,,
com.microsoft.VSCode,866,1710893021,1710893887,1710893887.705071,-18000,,
com.apple.finder,27,1710892994,1710893021,1710893022.0538359,-18000,,
com.microsoft.Outlook,38,1710892956,1710892994,1710892994.447896,-18000,,
com.google.Chrome,4,1710892952,1710892956,1710892956.521265,-18000,,
com.apple.finder,11,1710892941,1710892952,1710892952.1317,-18000,,
com.apple.finder,24,1710891862,1710891886,1710891886.9648871,-18000,,
com.apple.Photos,1,1710891861,1710891862,1710891862.568015,-18000,,
com.apple.finder,1,1710891860,1710891861,1710891862.026236,-18000,,
com.apple.Photos,1,1710891859,1710891860,1710891860.2246308,-18000,,
com.apple.finder,2,1710891857,1710891859,1710891859.778311,-18000,,
com.apple.Photos,0,1710891857,1710891857,1710891857.8911772,-18000,,
com.apple.finder,1,1710891856,1710891857,1710891857.18061,-18000,,
com.apple.Photos,8,1710891848,1710891856,1710891856.32655,-18000,,
com.apple.finder,88,1710891760,1710891848,1710891848.105269,-18000,,
com.google.Chrome,51,1710891709,1710891760,1710891760.931635,-18000,,
com.apple.Photos,65,1710891644,1710891709,1710891709.511125,-18000,,
com.google.Chrome,91,1710891553,1710891644,1710891644.648309,-18000,,
com.google.Chrome,8,1710891426,1710891434,1710891434.178463,-18000,,
com.leomehlig.today,94,1710891332,1710891426,1710891426.54747,-18000,,
com.apple.Preview,209,1710891123,1710891332,1710891332.643311,-18000,,
com.google.Chrome,8,1710891115,1710891123,1710891124.000351,-18000,,
com.apple.Preview,1004,1710890111,1710891115,1710891115.661654,-18000,,
com.google.Chrome,56,1710890055,1710890111,1710890111.914257,-18000,,
com.apple.Preview,69,1710889986,1710890055,1710890055.7045,-18000,,
com.google.Chrome,2,1710889984,1710889986,1710889986.6976671,-18000,,
com.apple.Preview,1602,1710888382,1710889984,1710889984.2428532,-18000,,
com.apple.finder,2,1710888380,1710888382,1710888382.8989248,-18000,,
com.leomehlig.today,108,1710888272,1710888380,1710888381.0391731,-18000,,
com.leomehlig.today,29,1710885384,1710885413,1710885413.292543,-18000,,
com.apple.Preview,803,1710884581,1710885384,1710885384.2077909,-18000,,
com.google.Chrome,3,1710884578,1710884581,1710884581.5189462,-18000,,
com.apple.Preview,1761,1710882817,1710884578,1710884578.703718,-18000,,
com.google.Chrome,3,1710882814,1710882817,1710882817.067502,-18000,,
com.apple.Preview,9,1710882805,1710882814,1710882814.859293,-18000,,
com.apple.finder,7,1710882798,1710882805,1710882805.3068218,-18000,,
com.google.Chrome,29,1710882769,1710882798,1710882798.243252,-18000,,
com.leomehlig.today,10,1710882759,1710882769,1710882769.04056,-18000,,
com.google.Chrome,44,1710882715,1710882759,1710882759.761852,-18000,,
com.leomehlig.today,35,1710882661,1710882696,1710882696.367774,-18000,,
com.leomehlig.today,3,1710879648,1710879651,1710879651.360828,-18000,,
com.google.Chrome,98,1710879550,1710879648,1710879648.845811,-18000,,
com.leomehlig.today,9,1710879541,1710879550,1710879550.627277,-18000,,
us.zoom.xos,395,1710879146,1710879541,1710879541.911886,-18000,,
com.leomehlig.today,1,1710879145,1710879146,1710879146.890294,-18000,,
com.google.Chrome,1,1710879144,1710879145,1710879145.7442222,-18000,,
com.leomehlig.today,13,1710879131,1710879144,1710879145.015918,-18000,,
com.google.Chrome,16,1710879115,1710879131,1710879131.667687,-18000,,
us.zoom.xos,358,1710878757,1710879115,1710879115.994872,-18000,,
com.leomehlig.today,82,1710878675,1710878757,1710878757.131172,-18000,,
com.google.Chrome,23,1710878652,1710878675,1710878675.4214668,-18000,,
us.zoom.xos,65,1710878587,1710878652,1710878652.9967,-18000,,
com.google.Chrome,1,1710878586,1710878587,1710878587.141934,-18000,,
com.apple.iCal,106,1710878480,1710878586,1710878586.285311,-18000,,
com.google.Chrome,21,1710878459,1710878480,1710878480.660078,-18000,,
us.zoom.xos,570,1710877889,1710878459,1710878459.6991029,-18000,,
us.zoom.xos,311,1710877122,1710877433,1710877433.1994328,-18000,,
us.zoom.xos,304,1710876587,1710876891,1710876891.3174682,-18000,,
us.zoom.xos,312,1710876208,1710876520,1710876520.4976969,-18000,,
com.apple.calculator,30,1710876178,1710876208,1710876208.456294,-18000,,
us.zoom.xos,1,1710876177,1710876178,1710876178.91089,-18000,,
com.apple.finder,74,1710876103,1710876177,1710876177.298545,-18000,,
com.google.Chrome,40,1710876063,1710876103,1710876103.98719,-18000,,
com.apple.iCal,30,1710876033,1710876063,1710876063.42982,-18000,,
com.leomehlig.today,145,1710875888,1710876033,1710876033.43764,-18000,,
com.leomehlig.today,303,1710875400,1710875703,1710875703.587378,-18000,,
com.leomehlig.today,326,1710875058,1710875384,1710875384.048686,-18000,,
us.zoom.xos,35,1710875023,1710875058,1710875058.589494,-18000,,
com.apple.finder,59,1710874964,1710875023,1710875023.210565,-18000,,
com.apple.archiveutility,0,1710874964,1710874964,1710874964.652169,-18000,,
com.apple.finder,12,1710874952,1710874964,1710874964.342657,-18000,,
com.google.Chrome,53,1710874899,1710874952,1710874952.5632858,-18000,,
us.zoom.xos,10,1710874889,1710874899,1710874899.767815,-18000,,
com.microsoft.Outlook,20,1710874869,1710874889,1710874889.58819,-18000,,
us.zoom.xos,111,1710874758,1710874869,1710874870.0052361,-18000,,
com.google.Chrome,1,1710874757,1710874758,1710874758.1976728,-18000,,
us.zoom.xos,3,1710874754,1710874757,1710874757.893609,-18000,,
com.google.Chrome,688,1710874066,1710874754,1710874754.27297,-18000,,
com.leomehlig.today,21,1710874045,1710874066,1710874066.241428,-18000,,
com.google.Chrome,288,1710873757,1710874045,1710874045.818836,-18000,,
com.apple.finder,32,1710873725,1710873757,1710873758.0261521,-18000,,
com.apple.archiveutility,1,1710873724,1710873725,1710873725.117159,-18000,,
com.apple.finder,16,1710873708,1710873724,1710873724.870613,-18000,,
com.google.Chrome,5,1710873703,1710873708,1710873708.9076939,-18000,,
com.apple.finder,7,1710873696,1710873703,1710873703.5611758,-18000,,
com.google.Chrome,83,1710873613,1710873696,1710873696.2637339,-18000,,
com.apple.finder,17,1710873596,1710873613,1710873613.1142778,-18000,,
com.apple.archiveutility,0,1710873596,1710873596,1710873596.3932009,-18000,,
com.apple.finder,4,1710873592,1710873596,1710873596.0974622,-18000,,
com.google.Chrome,29,1710873563,1710873592,1710873592.2910419,-18000,,
com.leomehlig.today,17,1710873546,1710873563,1710873563.851687,-18000,,
com.google.Chrome,10,1710873536,1710873546,1710873546.825484,-18000,,
com.microsoft.Powerpoint,9,1710873527,1710873536,1710873536.848696,-18000,,
com.apple.finder,11,1710873516,1710873527,1710873527.953065,-18000,,
com.microsoft.Powerpoint,8,1710873508,1710873516,1710873516.6657162,-18000,,
com.apple.finder,0,1710873508,1710873508,1710873508.87902,-18000,,
com.microsoft.Powerpoint,3,1710873505,1710873508,1710873508.182948,-18000,,
com.apple.finder,10,1710873495,1710873505,1710873505.245898,-18000,,
com.google.Chrome,1388,1710872107,1710873495,1710873495.838891,-18000,,
com.leomehlig.today,19,1710872088,1710872107,1710872107.394584,-18000,,
com.google.Chrome,636,1710871452,1710872088,1710872088.346369,-18000,,
com.leomehlig.today,41,1710871411,1710871452,1710871452.263274,-18000,,
com.microsoft.Word,3,1710871408,1710871411,1710871411.41788,-18000,,
com.google.Chrome,33,1710871375,1710871408,1710871408.721267,-18000,,
com.microsoft.Word,9,1710871366,1710871375,1710871375.597107,-18000,,
com.google.Chrome,1,1710871365,1710871366,1710871366.9941602,-18000,,
com.microsoft.Word,67,1710871298,1710871365,1710871365.2230039,-18000,,
com.apple.finder,13,1710871285,1710871298,1710871298.270006,-18000,,
com.google.Chrome,139,1710871146,1710871285,1710871285.610032,-18000,,
com.leomehlig.today,29,1710871117,1710871146,1710871146.842227,-18000,,
com.google.Chrome,210,1710870907,1710871117,1710871118.09393,-18000,,
com.apple.Preview,168,1710870739,1710870907,1710870907.466887,-18000,,
com.google.Chrome,2,1710870737,1710870739,1710870739.283102,-18000,,
com.apple.Preview,83,1710870654,1710870737,1710870738.050669,-18000,,
com.google.Chrome,4,1710870650,1710870654,1710870654.420298,-18000,,
com.apple.Preview,143,1710870507,1710870650,1710870650.749661,-18000,,
com.google.Chrome,2,1710870505,1710870507,1710870507.802874,-18000,,
com.apple.Preview,182,1710870323,1710870505,1710870505.383356,-18000,,
com.google.Chrome,1,1710870322,1710870323,1710870323.7780719,-18000,,
com.apple.Preview,15,1710870307,1710870322,1710870322.399067,-18000,,
com.google.Chrome,3,1710870304,1710870307,1710870307.968566,-18000,,
com.apple.Preview,6,1710870298,1710870304,1710870304.704252,-18000,,
com.google.Chrome,5,1710870293,1710870298,1710870298.582999,-18000,,
com.apple.Preview,115,1710870178,1710870293,1710870293.958307,-18000,,
com.google.Chrome,2,1710870176,1710870178,1710870178.68137,-18000,,
com.apple.Preview,29,1710870147,1710870176,1710870176.832401,-18000,,
com.google.Chrome,89,1710870058,1710870147,1710870147.984237,-18000,,
com.apple.Preview,62,1710869996,1710870058,1710870058.987509,-18000,,
com.google.Chrome,33,1710869963,1710869996,1710869996.409595,-18000,,
com.apple.Preview,252,1710869711,1710869963,1710869963.643138,-18000,,
com.apple.Preview,512,1710868796,1710869308,1710869308.646541,-18000,,
com.google.Chrome,5,1710868791,1710868796,1710868796.146826,-18000,,
com.apple.Preview,122,1710868669,1710868791,1710868791.276926,-18000,,
com.google.Chrome,60,1710868609,1710868669,1710868669.887615,-18000,,
com.apple.Preview,151,1710868458,1710868609,1710868609.212498,-18000,,
com.google.Chrome,86,1710868372,1710868458,1710868458.529655,-18000,,
com.leomehlig.today,279,1710868093,1710868372,1710868372.171804,-18000,,
com.apple.iCal,8,1710868085,1710868093,1710868093.427277,-18000,,
com.leomehlig.today,7,1710868078,1710868085,1710868085.852446,-18000,,
com.leomehlig.today,23,1710865954,1710865977,1710865977.849529,-18000,,
com.google.Chrome,97,1710865857,1710865954,1710865954.455087,-18000,,
com.apple.Preview,260,1710865597,1710865857,1710865857.220848,-18000,,
com.google.Chrome,54,1710865543,1710865597,1710865597.725836,-18000,,
com.apple.Preview,713,1710864830,1710865543,1710865543.39625,-18000,,
com.apple.MobileSMS,7,1710864823,1710864830,1710864830.75681,-18000,,
com.apple.Preview,368,1710864455,1710864823,1710864823.842956,-18000,,
com.google.Chrome,828,1710863627,1710864455,1710864455.430708,-18000,,
com.hnc.Discord,24,1710863603,1710863627,1710863627.53387,-18000,,
com.google.Chrome,8,1710863595,1710863603,1710863603.877847,-18000,,
com.hnc.Discord,9,1710863586,1710863595,1710863595.866931,-18000,,
com.google.Chrome,222,1710863364,1710863586,1710863586.6325011,-18000,,
com.apple.Preview,30,1710863334,1710863364,1710863364.350519,-18000,,
com.google.Chrome,43,1710863291,1710863334,1710863334.7945518,-18000,,
com.apple.Preview,178,1710863113,1710863291,1710863291.1573749,-18000,,
com.apple.finder,1,1710863112,1710863113,1710863113.76173,-18000,,
com.google.Chrome,88,1710863024,1710863112,1710863112.2243428,-18000,,
com.leomehlig.today,23,1710862988,1710863011,1710863012.7552981,-18000,,
com.leomehlig.today,44,1710858251,1710858295,1710858295.471448,-18000,,
com.google.Chrome,2,1710858249,1710858251,1710858251.810766,-18000,,
com.google.Chrome,214,1710820706,1710820920,1710820920.3886929,-18000,,
com.google.Chrome,300,1710820377,1710820677,1710820677.8372478,-18000,,
com.google.Chrome,700,1710817731,1710818431,1710818431.349424,-18000,,
com.google.Chrome,301,1710817171,1710817472,1710817472.15745,-18000,,
com.google.Chrome,311,1710816677,1710816988,1710816988.512641,-18000,,
com.google.Chrome,1067,1710815535,1710816602,1710816602.234227,-18000,,
com.google.Chrome,429,1710814622,1710815051,1710815051.9859982,-18000,,
com.google.Chrome,450,1710813937,1710814387,1710814387.283294,-18000,,
com.microsoft.Outlook,1,1710813936,1710813937,1710813938.0041819,-18000,,
com.google.Chrome,1,1710813935,1710813936,1710813937.012111,-18000,,
com.microsoft.Outlook,11,1710813924,1710813935,1710813935.087809,-18000,,
com.google.Chrome,404,1710813520,1710813924,1710813924.700916,-18000,,
com.microsoft.Outlook,1,1710813519,1710813520,1710813520.885596,-18000,,
com.google.Chrome,12,1710813507,1710813519,1710813519.781509,-18000,,
com.microsoft.Outlook,2,1710813505,1710813507,1710813507.299316,-18000,,
com.google.Chrome,5,1710813500,1710813505,1710813505.685978,-18000,,
com.microsoft.Outlook,8,1710813474,1710813482,1710813482.386652,-18000,,
com.google.Chrome,281,1710813193,1710813474,1710813474.054421,-18000,,
com.apple.finder,15,1710813178,1710813193,1710813193.380878,-18000,,
com.apple.finder,2,1710812153,1710812155,1710812155.970662,-18000,,
com.google.Chrome,8,1710812145,1710812153,1710812153.510637,-18000,,
com.leomehlig.today,85,1710812060,1710812145,1710812145.669699,-18000,,
com.apple.MobileSMS,42,1710812018,1710812060,1710812060.674829,-18000,,
com.leomehlig.today,1,1710812017,1710812018,1710812018.8291779,-18000,,
com.google.Chrome,13,1710812004,1710812017,1710812017.665189,-18000,,
com.leomehlig.today,30,1710811974,1710812004,1710812004.278929,-18000,,
com.google.Chrome,358,1710811616,1710811974,1710811974.83272,-18000,,
com.apple.news,2,1710811614,1710811616,1710811616.383675,-18000,,
com.apple.MobileSMS,35,1710811579,1710811614,1710811614.7080321,-18000,,
com.apple.news,66,1710811513,1710811579,1710811579.893073,-18000,,
com.apple.MobileSMS,3,1710811510,1710811513,1710811513.897836,-18000,,
com.google.Chrome,23,1710811487,1710811510,1710811510.507481,-18000,,
com.leomehlig.today,34,1710811453,1710811487,1710811487.759871,-18000,,
com.google.Chrome,486,1710810967,1710811453,1710811453.824882,-18000,,
com.google.Chrome,95,1710809707,1710809802,1710809802.485804,-18000,,
com.google.Chrome,75,1710809034,1710809109,1710809109.077373,-18000,,
com.google.Chrome,70,1710808900,1710808970,1710808970.3960881,-18000,,
com.leomehlig.today,36,1710808864,1710808900,1710808900.434658,-18000,,
com.google.Chrome,633,1710808231,1710808864,1710808864.480142,-18000,,
com.apple.finder,2,1710808229,1710808231,1710808231.7343721,-18000,,
com.google.Chrome,46,1710808183,1710808229,1710808229.19795,-18000,,
com.apple.finder,1,1710808182,1710808183,1710808183.874933,-18000,,
com.google.Chrome,0,1710808182,1710808182,1710808182.798455,-18000,,
com.apple.Notes,2,1710808180,1710808182,1710808182.1553411,-18000,,
com.google.Chrome,12,1710808168,1710808180,1710808180.816938,-18000,,
com.apple.Notes,2,1710808166,1710808168,1710808168.68542,-18000,,
com.google.Chrome,16,1710808150,1710808166,1710808166.085232,-18000,,
com.apple.Notes,3,1710808147,1710808150,1710808150.7651129,-18000,,
com.google.Chrome,19,1710808128,1710808147,1710808147.66542,-18000,,
com.apple.Notes,2,1710808126,1710808128,1710808128.4982228,-18000,,
com.google.Chrome,10,1710808116,1710808126,1710808127.009064,-18000,,
com.apple.Notes,1,1710808115,1710808116,1710808117.011339,-18000,,
com.google.Chrome,8,1710808107,1710808115,1710808115.54362,-18000,,
com.apple.Notes,1,1710808106,1710808107,1710808107.593344,-18000,,
com.google.Chrome,7,1710808099,1710808106,1710808106.558619,-18000,,
com.apple.Notes,1,1710808098,1710808099,1710808099.6163511,-18000,,
com.google.Chrome,48,1710808050,1710808098,1710808098.127454,-18000,,
com.apple.Notes,159,1710807891,1710808050,1710808050.351469,-18000,,
com.google.Chrome,3,1710807888,1710807891,1710807891.097364,-18000,,
com.apple.Notes,6,1710807882,1710807888,1710807888.690565,-18000,,
com.google.Chrome,210,1710807672,1710807882,1710807882.092475,-18000,,
com.apple.finder,15,1710807657,1710807672,1710807672.186387,-18000,,
com.apple.Photos,7,1710807650,1710807657,1710807658.055348,-18000,,
com.apple.finder,43,1710807607,1710807650,1710807650.869351,-18000,,
com.google.Chrome,440,1710807167,1710807607,1710807608.0641189,-18000,,
com.leomehlig.today,5,1710807162,1710807167,1710807167.207779,-18000,,
com.google.Chrome,230,1710806932,1710807162,1710807162.468021,-18000,,
com.leomehlig.today,56,1710806876,1710806932,1710806932.2586799,-18000,,
com.microsoft.Word,257,1710806619,1710806876,1710806876.1269531,-18000,,
com.google.Chrome,6,1710806613,1710806619,1710806619.67523,-18000,,
com.microsoft.Word,256,1710806357,1710806613,1710806613.814271,-18000,,
com.google.Chrome,2,1710806355,1710806357,1710806357.059515,-18000,,
com.microsoft.Word,97,1710806258,1710806355,1710806355.794616,-18000,,
com.google.Chrome,3,1710806255,1710806258,1710806259.049073,-18000,,
com.apple.MobileSMS,3,1710806252,1710806255,1710806255.2484488,-18000,,
com.google.Chrome,143,1710806109,1710806252,1710806252.437303,-18000,,
com.apple.MobileSMS,46,1710806063,1710806109,1710806109.169763,-18000,,
com.microsoft.VSCode,5,1710806058,1710806063,1710806063.083982,-18000,,
com.apple.MobileSMS,10,1710806048,1710806058,1710806058.12191,-18000,,
com.microsoft.VSCode,15,1710806033,1710806048,1710806049.0430999,-18000,,
com.apple.MobileSMS,2,1710806031,1710806033,1710806033.196652,-18000,,
com.microsoft.VSCode,14,1710806017,1710806031,1710806031.486418,-18000,,
com.google.Chrome,92,1710805925,1710806017,1710806017.20227,-18000,,
com.leomehlig.today,15,1710805910,1710805925,1710805925.377942,-18000,,
com.google.Chrome,126,1710805784,1710805910,1710805910.369426,-18000,,
com.microsoft.VSCode,2,1710805782,1710805784,1710805784.495164,-18000,,
com.leomehlig.today,38,1710805744,1710805782,1710805782.638777,-18000,,
com.microsoft.VSCode,348,1710805396,1710805744,1710805744.971438,-18000,,
com.google.Chrome,1,1710805395,1710805396,1710805396.136097,-18000,,
com.microsoft.VSCode,7,1710805388,1710805395,1710805395.199456,-18000,,
com.google.Chrome,3,1710805385,1710805388,1710805388.132015,-18000,,
com.microsoft.VSCode,14,1710805371,1710805385,1710805385.302846,-18000,,
com.google.Chrome,16,1710805355,1710805371,1710805371.224436,-18000,,
com.microsoft.VSCode,10,1710805345,1710805355,1710805355.9353352,-18000,,
com.google.Chrome,7,1710805338,1710805345,1710805345.0827498,-18000,,
com.microsoft.VSCode,2,1710805336,1710805338,1710805338.487273,-18000,,
com.google.Chrome,29,1710805307,1710805336,1710805336.077239,-18000,,
com.microsoft.VSCode,433,1710804874,1710805307,1710805307.850946,-18000,,
com.google.Chrome,32,1710804842,1710804874,1710804874.626385,-18000,,
com.microsoft.VSCode,17,1710804825,1710804842,1710804842.180665,-18000,,
com.google.Chrome,70,1710804755,1710804825,1710804825.108508,-18000,,
com.microsoft.VSCode,574,1710804181,1710804755,1710804755.099561,-18000,,
com.apple.finder,83,1710804098,1710804181,1710804181.276861,-18000,,
com.microsoft.VSCode,416,1710803682,1710804098,1710804098.293213,-18000,,
com.apple.MobileSMS,36,1710803646,1710803682,1710803682.3960361,-18000,,
com.microsoft.VSCode,20,1710803626,1710803646,1710803646.611926,-18000,,
com.apple.MobileSMS,5,1710803621,1710803626,1710803626.562368,-18000,,
com.microsoft.VSCode,126,1710803495,1710803621,1710803621.37691,-18000,,
com.apple.MobileSMS,0,1710803495,1710803495,1710803495.955665,-18000,,
com.microsoft.VSCode,2,1710803493,1710803495,1710803495.360475,-18000,,
com.apple.MobileSMS,5,1710803488,1710803493,1710803493.387438,-18000,,
com.microsoft.VSCode,11,1710803477,1710803488,1710803488.8864012,-18000,,
com.apple.MobileSMS,7,1710803470,1710803477,1710803477.993109,-18000,,
com.microsoft.VSCode,6,1710803464,1710803470,1710803470.402872,-18000,,
com.apple.MobileSMS,5,1710803459,1710803464,1710803464.892737,-18000,,
com.microsoft.VSCode,5,1710803454,1710803459,1710803459.890864,-18000,,
com.apple.MobileSMS,2,1710803452,1710803454,1710803454.199697,-18000,,
com.microsoft.VSCode,5,1710803447,1710803452,1710803452.464026,-18000,,
com.apple.MobileSMS,10,1710803437,1710803447,1710803447.710098,-18000,,
com.microsoft.VSCode,568,1710802869,1710803437,1710803437.614362,-18000,,
com.apple.finder,1,1710802868,1710802869,1710802870.0399299,-18000,,
com.microsoft.VSCode,205,1710802663,1710802868,1710802868.4234009,-18000,,
com.apple.finder,77,1710802586,1710802663,1710802663.572703,-18000,,
com.google.Chrome,17,1710802569,1710802586,1710802586.872529,-18000,,
com.apple.systempreferences,46,1710802523,1710802569,1710802569.716836,-18000,,
com.google.Chrome,112,1710802405,1710802517,1710802517.7667499,-18000,,
com.leomehlig.today,23,1710802382,1710802405,1710802405.711024,-18000,,
com.leomehlig.today,173,1710795554,1710795727,1710795727.210639,-18000,,
com.microsoft.Word,22,1710795532,1710795554,1710795554.529592,-18000,,
com.microsoft.Word,343,1710795188,1710795531,1710795531.253006,-18000,,
com.google.Chrome,409,1710794779,1710795188,1710795188.9407449,-18000,,
com.microsoft.Word,4,1710794775,1710794779,1710794779.383961,-18000,,
com.google.Chrome,149,1710794626,1710794775,1710794775.226942,-18000,,
com.microsoft.Word,1,1710794625,1710794626,1710794626.583096,-18000,,
com.google.Chrome,1,1710794624,1710794625,1710794625.527882,-18000,,
com.microsoft.Word,12,1710794612,1710794624,1710794624.194646,-18000,,
com.google.Chrome,228,1710794384,1710794612,1710794612.862458,-18000,,
com.microsoft.Word,12,1710794372,1710794384,1710794384.885573,-18000,,
com.google.Chrome,37,1710794335,1710794372,1710794372.519631,-18000,,
com.microsoft.Word,6,1710794329,1710794335,1710794335.66103,-18000,,
com.google.Chrome,13,1710794316,1710794329,1710794329.807053,-18000,,
com.microsoft.Word,3,1710794313,1710794316,1710794316.9853868,-18000,,
com.google.Chrome,10,1710794303,1710794313,1710794313.466397,-18000,,
com.microsoft.Word,3,1710794300,1710794303,1710794303.255045,-18000,,
com.google.Chrome,10,1710794290,1710794300,1710794300.838953,-18000,,
com.microsoft.Word,4,1710794286,1710794290,1710794290.089591,-18000,,
com.google.Chrome,13,1710794273,1710794286,1710794286.102715,-18000,,
com.microsoft.Word,4,1710794269,1710794273,1710794273.668457,-18000,,
com.google.Chrome,19,1710794250,1710794269,1710794269.7694979,-18000,,
com.microsoft.Word,1,1710794249,1710794250,1710794250.984967,-18000,,
com.google.Chrome,9,1710794240,1710794249,1710794249.428245,-18000,,
com.microsoft.Word,4,1710794236,1710794240,1710794240.6868649,-18000,,
com.google.Chrome,5,1710794231,1710794236,1710794236.912416,-18000,,
com.microsoft.Word,2,1710794229,1710794231,1710794231.775209,-18000,,
com.google.Chrome,4,1710794225,1710794229,1710794229.263047,-18000,,
com.microsoft.Word,5,1710794220,1710794225,1710794225.8080149,-18000,,
com.google.Chrome,15,1710794205,1710794220,1710794220.22312,-18000,,
com.microsoft.Word,3,1710794202,1710794205,1710794206.0242538,-18000,,
com.google.Chrome,6,1710794196,1710794202,1710794203.029777,-18000,,
com.microsoft.Word,3,1710794193,1710794196,1710794196.2474,-18000,,
com.google.Chrome,59,1710794134,1710794193,1710794193.383898,-18000,,
com.microsoft.Word,3,1710794131,1710794134,1710794134.1464682,-18000,,
com.google.Chrome,61,1710794070,1710794131,1710794131.248157,-18000,,
com.microsoft.Word,2,1710794068,1710794070,1710794070.912704,-18000,,
com.google.Chrome,56,1710794012,1710794068,1710794068.1424541,-18000,,
com.microsoft.Word,5,1710794007,1710794012,1710794012.6160011,-18000,,
com.google.Chrome,81,1710793926,1710794007,1710794007.491075,-18000,,
com.microsoft.Word,4,1710793922,1710793926,1710793926.421943,-18000,,
com.google.Chrome,70,1710793852,1710793922,1710793923.076692,-18000,,
com.microsoft.Word,3,1710793849,1710793852,1710793852.985289,-18000,,
com.google.Chrome,0,1710793849,1710793849,1710793849.761821,-18000,,
com.microsoft.Word,7,1710793842,1710793849,1710793849.187509,-18000,,
com.google.Chrome,1,1710793841,1710793842,1710793842.4243069,-18000,,
com.microsoft.Word,1,1710793840,1710793841,1710793841.466836,-18000,,
com.apple.finder,4,1710793836,1710793840,1710793840.300945,-18000,,
com.apple.Preview,2,1710793834,1710793836,1710793836.385397,-18000,,
com.apple.finder,7,1710793827,1710793834,1710793834.198637,-18000,,
com.leomehlig.today,1,1710793826,1710793827,1710793828.094219,-18000,,
com.google.Chrome,2,1710793824,1710793826,1710793826.901465,-18000,,
com.leomehlig.today,9,1710793815,1710793824,1710793824.514334,-18000,,
com.google.Chrome,2,1710793813,1710793815,1710793815.14144,-18000,,
com.microsoft.Word,2,1710793811,1710793813,1710793813.401,-18000,,
com.google.Chrome,19,1710793792,1710793811,1710793811.815222,-18000,,
com.microsoft.Word,2,1710793790,1710793792,1710793792.2849731,-18000,,
com.google.Chrome,0,1710793790,1710793790,1710793790.713146,-18000,,
com.microsoft.Word,5,1710793785,1710793790,1710793790.300719,-18000,,
com.google.Chrome,17,1710793768,1710793785,1710793785.298847,-18000,,
com.microsoft.Word,18,1710793750,1710793768,1710793769.00226,-18000,,
com.google.Chrome,2,1710793748,1710793750,1710793750.838832,-18000,,
com.microsoft.Word,2,1710793746,1710793748,1710793748.7771978,-18000,,
com.google.Chrome,43,1710793703,1710793746,1710793746.152659,-18000,,
com.microsoft.Word,70,1710793633,1710793703,1710793703.514183,-18000,,
com.google.Chrome,8,1710793625,1710793633,1710793633.386263,-18000,,
com.microsoft.Word,1,1710793624,1710793625,1710793625.887387,-18000,,
com.google.Chrome,8,1710793616,1710793624,1710793624.4282851,-18000,,
com.microsoft.Word,16,1710793600,1710793616,1710793616.4404778,-18000,,
com.apple.finder,18,1710793582,1710793600,1710793600.194954,-18000,,
com.google.Chrome,103,1710793479,1710793582,1710793583.097828,-18000,,
com.leomehlig.today,168,1710793311,1710793479,1710793479.696698,-18000,,
com.microsoft.Outlook,11,1710793300,1710793311,1710793311.084564,-18000,,
com.google.Chrome,41,1710793259,1710793300,1710793300.5956712,-18000,,
com.microsoft.Outlook,11,1710793248,1710793259,1710793259.07301,-18000,,
com.google.Chrome,32,1710793216,1710793248,1710793249.002856,-18000,,
com.microsoft.Outlook,119,1710793097,1710793216,1710793216.761945,-18000,,
com.google.Chrome,83,1710793014,1710793097,1710793097.2099009,-18000,,
com.leomehlig.today,55,1710792959,1710793014,1710793014.403016,-18000,,
com.google.Chrome,5,1710792954,1710792959,1710792959.617903,-18000,,
com.leomehlig.today,5,1710792949,1710792954,1710792954.175932,-18000,,
com.google.Chrome,1399,1710791550,1710792949,1710792949.170055,-18000,,
com.google.Chrome,305,1710791109,1710791414,1710791414.485618,-18000,,
com.apple.MobileSMS,4,1710791105,1710791109,1710791109.858773,-18000,,
com.google.Chrome,31,1710791074,1710791105,1710791106.020129,-18000,,
com.apple.MobileSMS,5,1710791069,1710791074,1710791074.118159,-18000,,
com.google.Chrome,4,1710791065,1710791069,1710791069.183217,-18000,,
com.apple.MobileSMS,11,1710791054,1710791065,1710791065.5163178,-18000,,
com.google.Chrome,2,1710791052,1710791054,1710791054.063827,-18000,,
com.apple.MobileSMS,8,1710791044,1710791052,1710791052.7085428,-18000,,
com.google.Chrome,3,1710791041,1710791044,1710791044.977308,-18000,,
com.apple.MobileSMS,6,1710791035,1710791041,1710791041.9911041,-18000,,
com.google.Chrome,6,1710791029,1710791035,1710791035.919781,-18000,,
com.apple.MobileSMS,28,1710791001,1710791029,1710791029.9298959,-18000,,
com.google.Chrome,5,1710790996,1710791001,1710791001.5882468,-18000,,
com.apple.MobileSMS,19,1710790977,1710790996,1710790996.0633888,-18000,,
com.google.Chrome,55,1710790922,1710790977,1710790977.9300199,-18000,,
com.google.Chrome,914,1710789412,1710790326,1710790326.9893498,-18000,,
com.google.Chrome,496,1710788507,1710789003,1710789003.934404,-18000,,
com.leomehlig.today,5,1710788502,1710788507,1710788507.984086,-18000,,
com.google.Chrome,22,1710788480,1710788502,1710788502.163896,-18000,,
com.apple.Preview,10,1710788470,1710788480,1710788480.405264,-18000,,
com.apple.Preview,775,1710783991,1710784766,1710784766.34408,-18000,,
com.google.Chrome,49,1710783942,1710783991,1710783991.1009278,-18000,,
com.apple.Preview,2,1710783940,1710783942,1710783942.217377,-18000,,
com.apple.finder,6,1710783934,1710783940,1710783940.9164271,-18000,,
com.leomehlig.today,4,1710783930,1710783934,1710783935.206377,-18000,,
com.leomehlig.today,47,1710781052,1710781099,1710781099.595471,-18000,,
com.apple.iCal,27,1710781025,1710781052,1710781052.902436,-18000,,
com.leomehlig.today,17,1710781008,1710781025,1710781025.411514,-18000,,
com.google.Chrome,1,1710781007,1710781008,1710781008.600296,-18000,,
com.microsoft.Word,3,1710781004,1710781007,1710781007.3946152,-18000,,
com.google.Chrome,59,1710780945,1710781004,1710781004.867522,-18000,,
com.leomehlig.today,26,1710780919,1710780945,1710780945.951191,-18000,,
com.google.Chrome,349,1710780570,1710780919,1710780919.9126859,-18000,,
com.google.Chrome,359,1710780015,1710780374,1710780374.183819,-18000,,
com.google.Chrome,540,1710779454,1710779994,1710779994.049176,-18000,,
com.apple.finder,36,1710779418,1710779454,1710779454.230829,-18000,,
com.microsoft.Word,1,1710779417,1710779418,1710779418.510919,-18000,,
com.google.Chrome,38,1710779379,1710779417,1710779417.201456,-18000,,
com.microsoft.Word,24,1710779355,1710779379,1710779379.276847,-18000,,
com.google.Chrome,602,1710778753,1710779355,1710779355.967751,-18000,,
com.leomehlig.today,77,1710778676,1710778753,1710778753.463732,-18000,,
com.google.Chrome,432,1710778244,1710778676,1710778676.3273559,-18000,,
com.apple.iCal,37,1710778182,1710778219,1710778219.86764,-18000,,
com.google.Chrome,61,1710778121,1710778182,1710778183.029881,-18000,,
com.apple.finder,3,1710778103,1710778106,1710778107.068577,-18000,,
com.apple.systempreferences,10,1710778093,1710778103,1710778104.184794,-18000,,
com.google.Chrome,23,1710778066,1710778089,1710778089.452642,-18000,,
com.google.Chrome,709,1710703201,1710703910,1710703910.4258518,-18000,,
com.apple.finder,4,1710703181,1710703185,1710703185.527499,-18000,,
com.google.Chrome,3,1710703178,1710703181,1710703181.4317222,-18000,,
com.apple.finder,0,1710703178,1710703178,1710703178.896687,-18000,,
com.google.Chrome,59,1710703119,1710703178,1710703178.249121,-18000,,
com.google.Chrome,514,1710698294,1710698808,1710698808.669654,-18000,,
com.apple.iCal,3,1710698291,1710698294,1710698294.640918,-18000,,
com.apple.iCal,23,1710697701,1710697724,1710697724.465765,-18000,,
com.google.Chrome,2,1710697699,1710697701,1710697702.008564,-18000,,
com.google.Chrome,867,1710696791,1710697658,1710697658.483724,-18000,,
com.leomehlig.today,184,1710696607,1710696791,1710696791.911444,-18000,,
com.apple.iCal,8,1710696599,1710696607,1710696607.790084,-18000,,
com.leomehlig.today,21,1710696578,1710696599,1710696599.9490008,-18000,,
com.apple.iCal,3,1710696575,1710696578,1710696578.918674,-18000,,
com.apple.iCal,340,1710695819,1710696159,1710696159.701195,-18000,,
com.leomehlig.today,45,1710695774,1710695819,1710695819.5021172,-18000,,
com.google.Chrome,58,1710695716,1710695774,1710695774.4404159,-18000,,
com.google.Chrome,647,1710694840,1710695487,1710695487.0389829,-18000,,
com.google.Chrome,355,1710693179,1710693534,1710693534.43952,-18000,,
com.google.Chrome,1123,1710637013,1710638136,1710638136.339036,-18000,,
com.apple.iCal,35,1710636978,1710637013,1710637013.099051,-18000,,
com.google.Chrome,3,1710636975,1710636978,1710636978.762768,-18000,,
com.apple.iCal,6,1710636969,1710636975,1710636975.722423,-18000,,
com.google.Chrome,56,1710636913,1710636969,1710636970.0196729,-18000,,
com.apple.iCal,20,1710636893,1710636913,1710636913.980342,-18000,,
com.google.Chrome,131,1710636762,1710636893,1710636893.418799,-18000,,
com.apple.Preview,11,1710636751,1710636762,1710636762.39539,-18000,,
com.google.Chrome,55,1710636696,1710636751,1710636751.6545591,-18000,,
com.apple.Preview,111,1710636585,1710636696,1710636696.60832,-18000,,
com.google.Chrome,9,1710636576,1710636585,1710636586.005844,-18000,,
com.apple.Preview,137,1710636439,1710636576,1710636576.489461,-18000,,
com.google.Chrome,3,1710636436,1710636439,1710636439.426923,-18000,,
com.apple.Preview,1,1710636435,1710636436,1710636436.342105,-18000,,
com.google.Chrome,1,1710636434,1710636435,1710636435.7243419,-18000,,
com.apple.Preview,1,1710636433,1710636434,1710636434.408022,-18000,,
com.google.Chrome,28,1710636405,1710636433,1710636433.3121629,-18000,,
com.apple.Preview,85,1710636320,1710636405,1710636405.422359,-18000,,
com.apple.finder,43,1710636277,1710636320,1710636320.697356,-18000,,
com.google.Chrome,1,1710636276,1710636277,1710636277.957958,-18000,,
com.google.Chrome,532,1710635736,1710636268,1710636268.979547,-18000,,
com.leomehlig.today,25,1710635547,1710635572,1710635572.5755591,-18000,,
com.google.Chrome,54,1710635493,1710635547,1710635548.048275,-18000,,
com.leomehlig.today,84,1710635409,1710635493,1710635494.049264,-18000,,
com.google.Chrome,2,1710635407,1710635409,1710635410.032753,-18000,,
com.leomehlig.today,81,1710635326,1710635407,1710635407.567758,-18000,,
com.google.Chrome,3,1710635323,1710635326,1710635326.123327,-18000,,
com.leomehlig.today,49,1710635266,1710635315,1710635315.743185,-18000,,
com.google.Chrome,87,1710635179,1710635266,1710635266.991891,-18000,,
com.apple.finder,2,1710635177,1710635179,1710635179.7914948,-18000,,
com.leomehlig.today,13,1710635164,1710635177,1710635177.469507,-18000,,
com.apple.iCal,57,1710635107,1710635164,1710635164.173316,-18000,,
com.leomehlig.today,30,1710635077,1710635107,1710635107.809115,-18000,,
com.google.Chrome,3,1710635074,1710635077,1710635077.352211,-18000,,
com.google.Chrome,1071,1710632624,1710633695,1710633695.437041,-18000,,
com.google.Chrome,495,1710628593,1710629088,1710629088.138694,-18000,,
com.google.Chrome,1293,1710566589,1710567882,1710567882.7078152,-18000,,
com.google.Chrome,425,1710566001,1710566426,1710566426.6126351,-18000,,
com.google.Chrome,331,1710565364,1710565695,1710565695.77122,-18000,,
com.google.Chrome,438,1710538277,1710538715,1710538715.616539,-18000,,
com.leomehlig.today,234,1710538043,1710538277,1710538277.585007,-18000,,
com.google.Chrome,245,1710537798,1710538043,1710538043.626764,-18000,,
com.apple.Preview,103,1710537695,1710537798,1710537799.0215259,-18000,,
com.google.Chrome,84,1710537611,1710537695,1710537695.965173,-18000,,
com.apple.Preview,21,1710537590,1710537611,1710537611.771645,-18000,,
com.google.Chrome,43,1710537547,1710537590,1710537590.332948,-18000,,
com.google.Chrome,1514,1710535599,1710537113,1710537113.9840841,-18000,,
com.google.Chrome,304,1710535226,1710535530,1710535530.525758,-18000,,
com.google.Chrome,2109,1710532940,1710535049,1710535049.598335,-18000,,
com.google.Chrome,803,1710532027,1710532830,1710532830.098732,-18000,,
com.google.Chrome,832,1710531172,1710532004,1710532004.916469,-18000,,
com.google.Chrome,947,1710530133,1710531080,1710531080.4393458,-18000,,
com.leomehlig.today,5,1710530128,1710530133,1710530133.890141,-18000,,
com.google.Chrome,10,1710530118,1710530128,1710530128.4182801,-18000,,
com.leomehlig.today,72,1710530046,1710530118,1710530118.5874991,-18000,,
com.google.Chrome,3,1710530043,1710530046,1710530046.5112119,-18000,,
com.google.Chrome,821,1710527934,1710528755,1710528755.523884,-18000,,
com.apple.Preview,3,1710527931,1710527934,1710527934.210906,-18000,,
com.google.Chrome,132,1710527799,1710527931,1710527931.289382,-18000,,
com.apple.Preview,5,1710527794,1710527799,1710527799.259993,-18000,,
com.google.Chrome,149,1710527645,1710527794,1710527794.915133,-18000,,
com.apple.Preview,103,1710527542,1710527645,1710527645.254179,-18000,,
com.google.Chrome,10,1710527532,1710527542,1710527542.8595052,-18000,,
com.apple.Preview,120,1710527412,1710527532,1710527533.057389,-18000,,
com.google.Chrome,147,1710527265,1710527412,1710527412.7126698,-18000,,
com.apple.Preview,3,1710527262,1710527265,1710527266.066428,-18000,,
com.google.Chrome,1166,1710526096,1710527262,1710527262.245055,-18000,,
com.apple.Preview,2,1710526094,1710526096,1710526096.561003,-18000,,
com.google.Chrome,10,1710526084,1710526094,1710526094.289732,-18000,,
com.google.Chrome,300,1710518528,1710518828,1710518828.822495,-18000,,
com.apple.Preview,1,1710518527,1710518528,1710518528.827983,-18000,,
com.google.Chrome,2,1710518525,1710518527,1710518527.856211,-18000,,
com.apple.Preview,120,1710518405,1710518525,1710518525.323034,-18000,,
com.google.Chrome,2,1710518403,1710518405,1710518405.132606,-18000,,
com.apple.Preview,33,1710518370,1710518403,1710518403.639271,-18000,,
com.google.Chrome,19,1710518351,1710518370,1710518370.754679,-18000,,
com.apple.Preview,79,1710518272,1710518351,1710518351.054424,-18000,,
com.google.Chrome,13,1710518259,1710518272,1710518272.947084,-18000,,
com.apple.Preview,149,1710518110,1710518259,1710518259.749865,-18000,,
com.apple.finder,2,1710518108,1710518110,1710518110.944879,-18000,,
com.google.Chrome,147,1710517961,1710518108,1710518108.987927,-18000,,
com.google.Chrome,211,1710473664,1710473875,1710473875.512816,-18000,,
com.apple.Photos,1,1710473651,1710473652,1710473655.440117,-18000,,
com.google.Chrome,2,1710473649,1710473651,1710473651.7401152,-18000,,
com.google.Chrome,109,1710462675,1710462784,1710462784.148522,-18000,,
com.google.Chrome,499,1710462175,1710462674,1710462674.834309,-18000,,
com.burbn.instagram,4,1710459862,1710459866,1710459866.810017,-18000,EB445137-D7F5-57EC-87DA-1DB460D64046,"iPhone13,2"
com.burbn.instagram,7,1710458183,1710458190,1710458190.816817,-18000,EB445137-D7F5-57EC-87DA-1DB460D64046,"iPhone13,2"
com.google.Chrome,300,1710457756,1710458056,1710458056.929225,-18000,,
com.burbn.instagram,548,1710457632,1710458180,1710458180.128011,-18000,EB445137-D7F5-57EC-87DA-1DB460D64046,"iPhone13,2"
com.letterboxd.LetterboxdApp,156,1710457474,1710457630,1710457631.022972,-18000,EB445137-D7F5-57EC-87DA-1DB460D64046,"iPhone13,2"
com.hammerandchisel.discord,5,1710457468,1710457473,1710457473.972951,-18000,EB445137-D7F5-57EC-87DA-1DB460D64046,"iPhone13,2"
com.apple.findmy,2,1710457466,1710457468,1710457469.107573,-18000,EB445137-D7F5-57EC-87DA-1DB460D64046,"iPhone13,2"
com.google.Chrome,300,1710457455,1710457755,1710457755.137625,-18000,,
com.apple.findmy,7,1710457360,1710457367,1710457367.457896,-18000,EB445137-D7F5-57EC-87DA-1DB460D64046,"iPhone13,2"
com.apple.MobileSMS,2,1710457358,1710457360,1710457360.515378,-18000,EB445137-D7F5-57EC-87DA-1DB460D64046,"iPhone13,2"
com.google.ios.youtube,1,1710457357,1710457358,1710457358.87198,-18000,EB445137-D7F5-57EC-87DA-1DB460D64046,"iPhone13,2"
com.apple.MobileSMS,3,1710457354,1710457357,1710457357.61917,-18000,EB445137-D7F5-57EC-87DA-1DB460D64046,"iPhone13,2"
com.google.Chrome,197,1710457081,1710457278,1710457278.8635159,-18000,,
com.leomehlig.today,59,1710457004,1710457063,1710457063.822478,-18000,,
com.google.Chrome,20,1710456984,1710457004,1710457004.784229,-18000,,
com.leomehlig.today,49,1710456935,1710456984,1710456984.484785,-18000,,
com.google.Chrome,895,1710456040,1710456935,1710456935.683187,-18000,,
com.apple.MobileSMS,4,1710456013,1710456017,1710456017.65864,-18000,EB445137-D7F5-57EC-87DA-1DB460D64046,"iPhone13,2"
com.google.ios.youtube,2,1710456011,1710456013,1710456013.778363,-18000,EB445137-D7F5-57EC-87DA-1DB460D64046,"iPhone13,2"
com.google.ios.youtube,3,1710455086,1710455089,1710455089.724543,-18000,EB445137-D7F5-57EC-87DA-1DB460D64046,"iPhone13,2"
com.google.Chrome,1110,1710454172,1710455282,1710455282.510155,-18000,,
com.google.ios.youtube,618,1710453555,1710454173,1710454173.5710878,-18000,EB445137-D7F5-57EC-87DA-1DB460D64046,"iPhone13,2"
com.google.Chrome,632,1710453196,1710453828,1710453828.188215,-18000,,
com.google.ios.youtube,370,1710452850,1710453220,1710453220.843688,-18000,EB445137-D7F5-57EC-87DA-1DB460D64046,"iPhone13,2"
com.google.Chrome,327,1710452791,1710453118,1710453118.743053,-18000,,
com.google.Chrome,987,1710451734,1710452721,1710452721.271565,-18000,,
com.leomehlig.today,30,1710451704,1710451734,1710451734.919589,-18000,,
com.apple.iCal,19,1710451685,1710451704,1710451705.051898,-18000,,
com.leomehlig.today,26,1710451659,1710451685,1710451685.676769,-18000,,
com.google.Chrome,151,1710451508,1710451659,1710451659.920909,-18000,,
com.apple.MobileSMS,6,1710451502,1710451508,1710451508.5842052,-18000,,
com.google.ios.youtube,2,1710451497,1710451499,1710451499.325372,-18000,EB445137-D7F5-57EC-87DA-1DB460D64046,"iPhone13,2"
com.google.ios.youtube,2132,1710449364,1710451496,1710451496.327651,-18000,EB445137-D7F5-57EC-87DA-1DB460D64046,"iPhone13,2"
com.microsoft.Office.Outlook,79,1710449285,1710449364,1710449364.040935,-18000,EB445137-D7F5-57EC-87DA-1DB460D64046,"iPhone13,2"
com.google.ios.youtube,79,1710449206,1710449285,1710449286.252074,-18000,EB445137-D7F5-57EC-87DA-1DB460D64046,"iPhone13,2"
com.apple.news,8,1710449196,1710449204,1710449204.983248,-18000,EB445137-D7F5-57EC-87DA-1DB460D64046,"iPhone13,2"
com.apple.MobileSMS,309,1710449170,1710449479,1710449479.0814729,-18000,,
com.apple.finder,3,1710449167,1710449170,1710449170.402131,-18000,,
com.apple.MobileSMS,3,1710449164,1710449167,1710449167.72295,-18000,,
com.apple.finder,25,1710449139,1710449164,1710449164.998269,-18000,,
com.microsoft.VSCode,2,1710449137,1710449139,1710449140.0036612,-18000,,
com.apple.finder,2,1710449135,1710449137,1710449137.6492481,-18000,,
com.microsoft.VSCode,22,1710449113,1710449135,1710449135.3319979,-18000,,
com.apple.finder,11,1710449102,1710449113,1710449113.305749,-18000,,
com.microsoft.VSCode,7,1710449095,1710449102,1710449102.897547,-18000,,
com.apple.finder,9,1710449086,1710449095,1710449095.730044,-18000,,
com.apple.MobileSMS,23,1710449063,1710449086,1710449086.206163,-18000,,
com.apple.finder,3,1710449060,1710449063,1710449063.3828611,-18000,,
com.apple.iWork.Numbers,21,1710449039,1710449060,1710449060.572496,-18000,,
com.apple.finder,63,1710448976,1710449039,1710449039.340238,-18000,,
com.apple.iWork.Numbers,5,1710448971,1710448976,1710448976.289427,-18000,,
com.apple.MobileSMS,15,1710448956,1710448971,1710448971.775368,-18000,,
com.apple.iWork.Numbers,2,1710448954,1710448956,1710448956.852709,-18000,,
com.apple.finder,41,1710448913,1710448954,1710448954.160764,-18000,,
com.apple.iWork.Numbers,41,1710448872,1710448913,1710448913.2730742,-18000,,
com.apple.finder,23,1710448849,1710448872,1710448872.968977,-18000,,
com.apple.MobileSMS,13,1710448836,1710448849,1710448849.3373818,-18000,,
com.google.Chrome,356,1710448480,1710448836,1710448836.6024551,-18000,,
com.apple.finder,121,1710448359,1710448480,1710448480.524863,-18000,,
com.microsoft.VSCode,3,1710448356,1710448359,1710448360.1112862,-18000,,
com.apple.MobileSMS,10,1710448346,1710448356,1710448356.9188309,-18000,,
com.apple.finder,3,1710448343,1710448346,1710448347.078171,-18000,,
com.apple.MobileSMS,3,1710448340,1710448343,1710448343.384562,-18000,,
com.apple.finder,28,1710448312,1710448340,1710448340.317661,-18000,,
com.microsoft.VSCode,202,1710448110,1710448312,1710448313.0460138,-18000,,
us.zoom.xos,66,1710448044,1710448110,1710448110.533896,-18000,,
com.microsoft.VSCode,19,1710448025,1710448044,1710448045.022865,-18000,,
us.zoom.xos,7,1710448018,1710448025,1710448025.697489,-18000,,
com.microsoft.VSCode,33,1710447985,1710448018,1710448018.226902,-18000,,
us.zoom.xos,17,1710447968,1710447985,1710447985.9196448,-18000,,
com.microsoft.VSCode,6,1710447962,1710447968,1710447968.464577,-18000,,
us.zoom.xos,2,1710447960,1710447962,1710447962.4398332,-18000,,
com.microsoft.VSCode,45,1710447915,1710447960,1710447960.487278,-18000,,
com.apple.news,66,1710447757,1710447823,1710447823.309146,-18000,EB445137-D7F5-57EC-87DA-1DB460D64046,"iPhone13,2"
com.apple.findmy,14,1710447737,1710447751,1710447751.998417,-18000,EB445137-D7F5-57EC-87DA-1DB460D64046,"iPhone13,2"
us.zoom.xos,188,1710447727,1710447915,1710447915.876759,-18000,,
com.microsoft.VSCode,81,1710447646,1710447727,1710447727.322307,-18000,,
com.apple.finder,143,1710447503,1710447646,1710447646.567964,-18000,,
us.zoom.xos,9,1710447494,1710447503,1710447504.036607,-18000,,
com.apple.finder,13,1710447481,1710447494,1710447494.947674,-18000,,
com.microsoft.VSCode,113,1710447368,1710447481,1710447481.50356,-18000,,
us.zoom.xos,28,1710447340,1710447368,1710447368.300518,-18000,,
com.microsoft.VSCode,1,1710447339,1710447340,1710447340.9356751,-18000,,
com.apple.finder,4,1710447335,1710447339,1710447339.695281,-18000,,
com.microsoft.VSCode,9,1710447326,1710447335,1710447335.910187,-18000,,
com.apple.finder,13,1710447313,1710447326,1710447326.9528952,-18000,,
com.microsoft.VSCode,10,1710447303,1710447313,1710447313.6333442,-18000,,
com.apple.finder,3,1710447300,1710447303,1710447303.547978,-18000,,
com.microsoft.VSCode,8,1710447292,1710447300,1710447300.416057,-18000,,
com.apple.finder,25,1710447267,1710447292,1710447292.65275,-18000,,
us.zoom.xos,66,1710447201,1710447267,1710447267.232098,-18000,,
com.microsoft.VSCode,6,1710447195,1710447201,1710447201.9055228,-18000,,
us.zoom.xos,2,1710447193,1710447195,1710447195.1333342,-18000,,
com.microsoft.VSCode,21,1710447172,1710447193,1710447193.75494,-18000,,
us.zoom.xos,48,1710447124,1710447172,1710447172.141195,-18000,,
com.microsoft.VSCode,8,1710447116,1710447124,1710447124.318856,-18000,,
us.zoom.xos,8,1710447108,1710447116,1710447116.443219,-18000,,
com.microsoft.VSCode,15,1710447093,1710447108,1710447108.9497252,-18000,,
us.zoom.xos,5,1710447088,1710447093,1710447093.8503032,-18000,,
com.microsoft.VSCode,43,1710447045,1710447088,1710447088.582936,-18000,,
us.zoom.xos,1,1710447044,1710447045,1710447045.816685,-18000,,
com.microsoft.VSCode,1,1710447043,1710447044,1710447044.910914,-18000,,
us.zoom.xos,83,1710446960,1710447043,1710447043.925293,-18000,,
com.microsoft.VSCode,2,1710446958,1710446960,1710446960.567344,-18000,,
com.google.Chrome,56,1710446902,1710446958,1710446958.521402,-18000,,
com.microsoft.VSCode,4,1710446898,1710446902,1710446902.0871449,-18000,,
us.zoom.xos,49,1710446849,1710446898,1710446898.4343781,-18000,,
com.microsoft.VSCode,8,1710446841,1710446849,1710446849.963294,-18000,,
us.zoom.xos,10,1710446831,1710446841,1710446841.095722,-18000,,
com.microsoft.VSCode,8,1710446823,1710446831,1710446831.15277,-18000,,
us.zoom.xos,140,1710446683,1710446823,1710446823.279804,-18000,,
com.google.Chrome,4,1710446679,1710446683,1710446683.631155,-18000,,
us.zoom.xos,11,1710446668,1710446679,1710446679.27653,-18000,,
com.microsoft.VSCode,36,1710446632,1710446668,1710446668.199041,-18000,,
us.zoom.xos,7,1710446625,1710446632,1710446632.234861,-18000,,
com.apple.MobileSMS,7,1710446618,1710446625,1710446625.918929,-18000,,
us.zoom.xos,18,1710446600,1710446618,1710446618.6900868,-18000,,
com.google.Chrome,2,1710446598,1710446600,1710446600.9340072,-18000,,
us.zoom.xos,1,1710446597,1710446598,1710446598.8981729,-18000,,
com.google.Chrome,3,1710446594,1710446597,1710446597.383672,-18000,,
com.microsoft.Outlook,31,1710446563,1710446594,1710446594.242491,-18000,,
com.apple.systempreferences,4,1710446559,1710446563,1710446563.408194,-18000,,
com.microsoft.Outlook,2,1710446554,1710446556,1710446556.3120499,-18000,,
com.google.Chrome,52,1710446490,1710446542,1710446542.110873,-18000,,
com.apple.MobileSMS,9,1710446481,1710446490,1710446490.598311,-18000,,
com.google.Chrome,409,1710446072,1710446481,1710446481.705566,-18000,,
com.apple.MobileSMS,4,1710445934,1710445938,1710445939.413023,-18000,,
com.google.Chrome,2,1710445932,1710445934,1710445934.359894,-18000,,
com.apple.findmy,6,1710445783,1710445789,1710445789.525303,-18000,EB445137-D7F5-57EC-87DA-1DB460D64046,"iPhone13,2"
com.apple.camera,1,1710445783,1710445784,1710445784.205199,-18000,EB445137-D7F5-57EC-87DA-1DB460D64046,"iPhone13,2"
com.apple.findmy,4,1710445775,1710445779,1710445779.358325,-18000,EB445137-D7F5-57EC-87DA-1DB460D64046,"iPhone13,2"
com.apple.findmy,5,1710445758,1710445763,1710445763.665416,-18000,EB445137-D7F5-57EC-87DA-1DB460D64046,"iPhone13,2"
com.apple.findmy,6,1710445417,1710445423,1710445424.151212,-18000,EB445137-D7F5-57EC-87DA-1DB460D64046,"iPhone13,2"
com.apple.news,135,1710445274,1710445409,1710445409.808871,-18000,EB445137-D7F5-57EC-87DA-1DB460D64046,"iPhone13,2"
com.microsoft.Office.Outlook,5,1710445257,1710445262,1710445262.912436,-18000,EB445137-D7F5-57EC-87DA-1DB460D64046,"iPhone13,2"
com.microsoft.Office.Outlook,4,1710444996,1710445000,1710445000.287358,-18000,EB445137-D7F5-57EC-87DA-1DB460D64046,"iPhone13,2"
com.letterboxd.LetterboxdApp,9,1710444987,1710444996,1710444996.4354892,-18000,EB445137-D7F5-57EC-87DA-1DB460D64046,"iPhone13,2"
com.google.Chrome,264,1710444986,1710445250,1710445250.52396,-18000,,
com.google.Chrome,472,1710444438,1710444910,1710444910.4347959,-18000,,
com.letterboxd.LetterboxdApp,8,1710444337,1710444345,1710444345.275353,-18000,EB445137-D7F5-57EC-87DA-1DB460D64046,"iPhone13,2"
com.letterboxd.LetterboxdApp,70,1710444015,1710444085,1710444085.7907472,-18000,EB445137-D7F5-57EC-87DA-1DB460D64046,"iPhone13,2"
com.google.Chrome,499,1710443919,1710444418,1710444418.287322,-18000,,
com.apple.MobileSMS,5,1710443914,1710443919,1710443920.023664,-18000,,
com.google.Chrome,804,1710443110,1710443914,1710443914.585381,-18000,,
com.burbn.instagram,3,1710442006,1710442009,1710442009.630258,-18000,EB445137-D7F5-57EC-87DA-1DB460D64046,"iPhone13,2"
com.burbn.instagram,168,1710441838,1710442006,1710442006.6252909,-18000,EB445137-D7F5-57EC-87DA-1DB460D64046,"iPhone13,2"
com.apple.news,36,1710441739,1710441775,1710441775.59798,-18000,EB445137-D7F5-57EC-87DA-1DB460D64046,"iPhone13,2"
com.google.Chrome,1027,1710441667,1710442694,1710442694.157089,-18000,,
com.google.Chrome,416,1710441167,1710441583,1710441583.3892121,-18000,,
com.google.Chrome,701,1710439662,1710440363,1710440364.002139,-18000,,
com.google.Chrome,301,1710439106,1710439407,1710439407.5781999,-18000,,
com.google.Chrome,413,1710438521,1710438934,1710438934.6802912,-18000,,
com.toyopagroup.picaboo,9,1710437717,1710437726,1710437726.810162,-18000,EB445137-D7F5-57EC-87DA-1DB460D64046,"iPhone13,2"
com.google.Chrome,839,1710437399,1710438238,1710438238.948893,-18000,,
com.apple.Health,104,1710437078,1710437182,1710437182.118026,-18000,EB445137-D7F5-57EC-87DA-1DB460D64046,"iPhone13,2"
com.apple.Health,42,1710437035,1710437077,1710437078.072995,-18000,EB445137-D7F5-57EC-87DA-1DB460D64046,"iPhone13,2"
com.toyopagroup.picaboo,6,1710437027,1710437033,1710437033.882656,-18000,EB445137-D7F5-57EC-87DA-1DB460D64046,"iPhone13,2"
com.google.Chrome,1013,1710436373,1710437386,1710437386.583051,-18000,,
com.apple.MobileSMS,9,1710436364,1710436373,1710436373.828119,-18000,,
com.google.Chrome,28,1710436336,1710436364,1710436364.546951,-18000,,
com.apple.MobileSMS,19,1710436317,1710436336,1710436336.1538439,-18000,,
com.toyopagroup.picaboo,3,1710436129,1710436132,1710436132.7847,-18000,EB445137-D7F5-57EC-87DA-1DB460D64046,"iPhone13,2"
com.letterboxd.LetterboxdApp,4,1710436125,1710436129,1710436129.40502,-18000,EB445137-D7F5-57EC-87DA-1DB460D64046,"iPhone13,2"
com.letterboxd.LetterboxdApp,41,1710436077,1710436118,1710436118.54501,-18000,EB445137-D7F5-57EC-87DA-1DB460D64046,"iPhone13,2"
com.google.Chrome,264,1710436053,1710436317,1710436317.6241798,-18000,,
com.apple.MobileSMS,7,1710436046,1710436053,1710436053.280786,-18000,,
com.letterboxd.LetterboxdApp,24,1710435521,1710435545,1710435546.1089191,-18000,EB445137-D7F5-57EC-87DA-1DB460D64046,"iPhone13,2"
com.google.Chrome,1163,1710434883,1710436046,1710436046.4709969,-18000,,
com.google.Chrome,326,1710434521,1710434847,1710434847.835135,-18000,,
com.google.Chrome,363,1710434076,1710434439,1710434439.7265282,-18000,,
com.google.Chrome,305,1710432654,1710432959,1710432959.4337091,-18000,,
com.microsoft.Office.Outlook,13,1710432600,1710432613,1710432613.371364,-18000,EB445137-D7F5-57EC-87DA-1DB460D64046,"iPhone13,2"
com.microsoft.VSCode,157,1710432497,1710432654,1710432655.01548,-18000,,
com.apple.finder,13,1710432484,1710432497,1710432497.305914,-18000,,
com.microsoft.VSCode,113,1710432371,1710432484,1710432484.381552,-18000,,
com.apple.finder,207,1710432164,1710432371,1710432371.821711,-18000,,
com.microsoft.VSCode,5,1710432159,1710432164,1710432164.6848412,-18000,,
com.apple.finder,93,1710432066,1710432159,1710432159.5257201,-18000,,
com.microsoft.VSCode,4,1710432062,1710432066,1710432066.4743319,-18000,,
com.apple.finder,4,1710432058,1710432062,1710432062.826041,-18000,,
com.microsoft.VSCode,5,1710432053,1710432058,1710432058.405285,-18000,,
com.apple.finder,13,1710432040,1710432053,1710432054.056841,-18000,,
com.microsoft.VSCode,5,1710432035,1710432040,1710432040.0783238,-18000,,
com.apple.finder,3,1710432032,1710432035,1710432035.629374,-18000,,
com.microsoft.VSCode,0,1710432032,1710432032,1710432032.971654,-18000,,
com.apple.finder,1,1710432031,1710432032,1710432032.119519,-18000,,
com.microsoft.VSCode,5,1710432026,1710432031,1710432031.467802,-18000,,
com.apple.finder,4,1710432022,1710432026,1710432026.877857,-18000,,
com.microsoft.VSCode,4,1710432018,1710432022,1710432023.0450978,-18000,,
com.apple.finder,147,1710431871,1710432018,1710432018.978598,-18000,,
com.microsoft.VSCode,4,1710431867,1710431871,1710431871.326611,-18000,,
com.apple.finder,2,1710431865,1710431867,1710431867.531699,-18000,,
com.microsoft.VSCode,3,1710431862,1710431865,1710431865.205086,-18000,,
com.apple.finder,21,1710431841,1710431862,1710431862.4368138,-18000,,
com.microsoft.VSCode,38,1710431803,1710431841,1710431841.916796,-18000,,
com.apple.finder,23,1710431780,1710431803,1710431803.5123348,-18000,,
com.microsoft.VSCode,13,1710431767,1710431780,1710431781.074929,-18000,,
com.google.Chrome,336,1710431431,1710431767,1710431767.832727,-18000,,
com.google.Chrome,316,1710430579,1710430895,1710430895.4931421,-18000,,
com.google.Chrome,2177,1710428149,1710430326,1710430326.0411968,-18000,,
com.toyopagroup.picaboo,27,1710428064,1710428091,1710428091.643754,-18000,EB445137-D7F5-57EC-87DA-1DB460D64046,"iPhone13,2"
com.apple.weather,14,1710426494,1710426508,1710426508.21052,-18000,EB445137-D7F5-57EC-87DA-1DB460D64046,"iPhone13,2"
com.apple.MobileSMS,10,1710426469,1710426479,1710426479.692171,-18000,EB445137-D7F5-57EC-87DA-1DB460D64046,"iPhone13,2"
com.microsoft.Office.Outlook,11,1710426457,1710426468,1710426468.639344,-18000,EB445137-D7F5-57EC-87DA-1DB460D64046,"iPhone13,2"
com.apple.MobileSMS,62,1710426390,1710426452,1710426452.6052961,-18000,EB445137-D7F5-57EC-87DA-1DB460D64046,"iPhone13,2"
com.apple.MobileSMS,28,1710426361,1710426389,1710426389.211884,-18000,EB445137-D7F5-57EC-87DA-1DB460D64046,"iPhone13,2"
com.apple.findmy,3,1710426358,1710426361,1710426363.3067842,-18000,EB445137-D7F5-57EC-87DA-1DB460D64046,"iPhone13,2"
com.apple.findmy,6,1710425205,1710425211,1710425212.047552,-18000,EB445137-D7F5-57EC-87DA-1DB460D64046,"iPhone13,2"
com.apple.findmy,8,1710424788,1710424796,1710424796.873837,-18000,EB445137-D7F5-57EC-87DA-1DB460D64046,"iPhone13,2"
com.apple.MobileSMS,11,1710424654,1710424665,1710424666.071528,-18000,EB445137-D7F5-57EC-87DA-1DB460D64046,"iPhone13,2"
com.toyopagroup.picaboo,11,1710424629,1710424640,1710424640.861793,-18000,EB445137-D7F5-57EC-87DA-1DB460D64046,"iPhone13,2"
com.apple.MobileSMS,6,1710395240,1710395246,1710395246.025563,-18000,EB445137-D7F5-57EC-87DA-1DB460D64046,"iPhone13,2"
com.apple.MobileSMS,13,1710395216,1710395229,1710395229.664442,-18000,EB445137-D7F5-57EC-87DA-1DB460D64046,"iPhone13,2"
com.apple.MobileSMS,4,1710395143,1710395147,1710395147.0399141,-18000,EB445137-D7F5-57EC-87DA-1DB460D64046,"iPhone13,2"
com.apple.MobileSMS,8,1710395104,1710395112,1710395112.59776,-18000,EB445137-D7F5-57EC-87DA-1DB460D64046,"iPhone13,2"
com.apple.MobileSMS,77,1710394938,1710395015,1710395015.291743,-18000,EB445137-D7F5-57EC-87DA-1DB460D64046,"iPhone13,2"
com.apple.MobileSMS,11,1710391253,1710391264,1710391264.761952,-18000,EB445137-D7F5-57EC-87DA-1DB460D64046,"iPhone13,2"
com.apple.MobileSMS,3,1710391245,1710391248,1710391248.254963,-18000,EB445137-D7F5-57EC-87DA-1DB460D64046,"iPhone13,2"
com.apple.MobileSMS,12,1710391226,1710391238,1710391238.943464,-18000,EB445137-D7F5-57EC-87DA-1DB460D64046,"iPhone13,2"
com.apple.MobileSMS,3,1710391195,1710391198,1710391198.0494452,-18000,EB445137-D7F5-57EC-87DA-1DB460D64046,"iPhone13,2"
com.apple.MobileSMS,18,1710388414,1710388432,1710388432.591013,-18000,EB445137-D7F5-57EC-87DA-1DB460D64046,"iPhone13,2"
com.apple.MobileSMS,21,1710388356,1710388377,1710388377.2718039,-18000,EB445137-D7F5-57EC-87DA-1DB460D64046,"iPhone13,2"
com.apple.PosterBoard,2,1710388355,1710388357,1710388357.381799,-18000,EB445137-D7F5-57EC-87DA-1DB460D64046,"iPhone13,2"
com.burbn.instagram,7,1710385646,1710385653,1710385653.4225168,-18000,EB445137-D7F5-57EC-87DA-1DB460D64046,"iPhone13,2"
com.google.Chrome,1168,1710359279,1710360447,1710360447.9043012,-18000,,
com.google.Chrome,441,1710358810,1710359251,1710359251.6191468,-18000,,
com.leomehlig.today,51,1710358759,1710358810,1710358810.820057,-18000,,
com.google.Chrome,8,1710358751,1710358759,1710358759.038902,-18000,,
com.leomehlig.today,1,1710358750,1710358751,1710358751.38512,-18000,,
com.google.Chrome,1,1710358749,1710358750,1710358750.370496,-18000,,
com.leomehlig.today,1,1710358748,1710358749,1710358749.198569,-18000,,
com.google.Chrome,196,1710358552,1710358748,1710358748.736381,-18000,,
com.google.Chrome,300,1710358072,1710358372,1710358372.928039,-18000,,
com.leomehlig.today,1,1710358071,1710358072,1710358072.921865,-18000,,
com.google.Chrome,0,1710358071,1710358071,1710358071.782916,-18000,,
com.toyopagroup.picaboo,40,1710357723,1710357763,1710357763.1189399,-18000,EB445137-D7F5-57EC-87DA-1DB460D64046,"iPhone13,2"
com.toyopagroup.picaboo,10,1710357641,1710357651,1710357651.457079,-18000,EB445137-D7F5-57EC-87DA-1DB460D64046,"iPhone13,2"
com.toyopagroup.picaboo,18,1710357588,1710357606,1710357606.422141,-18000,EB445137-D7F5-57EC-87DA-1DB460D64046,"iPhone13,2"
com.toyopagroup.picaboo,200,1710357221,1710357421,1710357421.268764,-18000,EB445137-D7F5-57EC-87DA-1DB460D64046,"iPhone13,2"
com.toyopagroup.picaboo,27,1710357156,1710357183,1710357183.6907349,-18000,EB445137-D7F5-57EC-87DA-1DB460D64046,"iPhone13,2"
com.burbn.instagram,3,1710357153,1710357156,1710357156.8853211,-18000,EB445137-D7F5-57EC-87DA-1DB460D64046,"iPhone13,2"
com.google.Chrome,1107,1710356908,1710358015,1710358015.8918839,-18000,,
com.leomehlig.today,27,1710356881,1710356908,1710356908.2418609,-18000,,
com.burbn.instagram,2,1710356712,1710356714,1710356714.363817,-18000,EB445137-D7F5-57EC-87DA-1DB460D64046,"iPhone13,2"
com.google.Chrome,553,1710356328,1710356881,1710356881.3020868,-18000,,
com.burbn.instagram,6,1710356116,1710356122,1710356122.7601008,-18000,EB445137-D7F5-57EC-87DA-1DB460D64046,"iPhone13,2"
com.burbn.instagram,3,1710356091,1710356094,1710356094.425074,-18000,EB445137-D7F5-57EC-87DA-1DB460D64046,"iPhone13,2"
com.burbn.instagram,9,1710356040,1710356049,1710356049.288093,-18000,EB445137-D7F5-57EC-87DA-1DB460D64046,"iPhone13,2"
com.apple.findmy,10,1710356029,1710356039,1710356039.505719,-18000,EB445137-D7F5-57EC-87DA-1DB460D64046,"iPhone13,2"
com.strava.stravaride,3,1710356026,1710356029,1710356029.212199,-18000,EB445137-D7F5-57EC-87DA-1DB460D64046,"iPhone13,2"
com.google.Chrome,365,1710355422,1710355787,1710355787.237489,-18000,,
com.strava.stravaride,59,1710355323,1710355382,1710355382.463431,-18000,EB445137-D7F5-57EC-87DA-1DB460D64046,"iPhone13,2"
com.google.Gmail,3,1710355320,1710355323,1710355323.436582,-18000,EB445137-D7F5-57EC-87DA-1DB460D64046,"iPhone13,2"
com.apple.MobileSMS,70,1710355316,1710355386,1710355387.6292338,-18000,,
com.google.Gmail,11,1710354098,1710354109,1710354109.436157,-18000,EB445137-D7F5-57EC-87DA-1DB460D64046,"iPhone13,2"
com.google.Gmail,15,1710353877,1710353892,1710353892.9092011,-18000,EB445137-D7F5-57EC-87DA-1DB460D64046,"iPhone13,2"
com.google.Gmail,15,1710353676,1710353691,1710353691.445046,-18000,EB445137-D7F5-57EC-87DA-1DB460D64046,"iPhone13,2"
com.google.Gmail,68,1710353374,1710353442,1710353442.447259,-18000,EB445137-D7F5-57EC-87DA-1DB460D64046,"iPhone13,2"
com.apple.Music,7,1710353366,1710353373,1710353373.6425982,-18000,EB445137-D7F5-57EC-87DA-1DB460D64046,"iPhone13,2"
com.apple.Music,8,1710352921,1710352929,1710352929.894967,-18000,EB445137-D7F5-57EC-87DA-1DB460D64046,"iPhone13,2"
com.apple.Music,6,1710352736,1710352742,1710352742.596362,-18000,EB445137-D7F5-57EC-87DA-1DB460D64046,"iPhone13,2"
com.apple.Music,79,1710352068,1710352147,1710352147.692404,-18000,EB445137-D7F5-57EC-87DA-1DB460D64046,"iPhone13,2"
com.apple.PeopleViewService,2,1710352063,1710352065,1710352065.471415,-18000,EB445137-D7F5-57EC-87DA-1DB460D64046,"iPhone13,2"
com.toyopagroup.picaboo,3,1710352059,1710352062,1710352063.417742,-18000,EB445137-D7F5-57EC-87DA-1DB460D64046,"iPhone13,2"
com.toyopagroup.picaboo,3,1710351986,1710351989,1710351989.272758,-18000,EB445137-D7F5-57EC-87DA-1DB460D64046,"iPhone13,2"
com.toyopagroup.picaboo,44,1710351921,1710351965,1710351966.013335,-18000,EB445137-D7F5-57EC-87DA-1DB460D64046,"iPhone13,2"
com.apple.mobileslideshow,2,1710351919,1710351921,1710351923.1946,-18000,EB445137-D7F5-57EC-87DA-1DB460D64046,"iPhone13,2"
com.apple.mobileslideshow,30,1710350456,1710350486,1710350486.676244,-18000,EB445137-D7F5-57EC-87DA-1DB460D64046,"iPhone13,2"
com.apple.mobileslideshow,7,1710350432,1710350439,1710350439.3532128,-18000,EB445137-D7F5-57EC-87DA-1DB460D64046,"iPhone13,2"
com.apple.mobileslideshow,16,1710350415,1710350431,1710350431.329253,-18000,EB445137-D7F5-57EC-87DA-1DB460D64046,"iPhone13,2"
com.apple.mobileslideshow,11,1710350026,1710350037,1710350038.019009,-18000,EB445137-D7F5-57EC-87DA-1DB460D64046,"iPhone13,2"
com.burbn.instagram,4,1710349976,1710349980,1710349980.650216,-18000,EB445137-D7F5-57EC-87DA-1DB460D64046,"iPhone13,2"
com.burbn.instagram,373,1710349598,1710349971,1710349971.5859442,-18000,EB445137-D7F5-57EC-87DA-1DB460D64046,"iPhone13,2"
com.toyopagroup.picaboo,10,1710349569,1710349579,1710349579.488616,-18000,EB445137-D7F5-57EC-87DA-1DB460D64046,"iPhone13,2"
com.toyopagroup.picaboo,26,1710348943,1710348969,1710348969.492652,-18000,EB445137-D7F5-57EC-87DA-1DB460D64046,"iPhone13,2"
com.burbn.instagram,1,1710348942,1710348943,1710348943.726027,-18000,EB445137-D7F5-57EC-87DA-1DB460D64046,"iPhone13,2"
com.burbn.instagram,12,1710348748,1710348760,1710348760.4293709,-18000,EB445137-D7F5-57EC-87DA-1DB460D64046,"iPhone13,2"
com.burbn.instagram,129,1710346587,1710346716,1710346716.913975,-18000,EB445137-D7F5-57EC-87DA-1DB460D64046,"iPhone13,2"
com.toyopagroup.picaboo,4,1710346583,1710346587,1710346587.549834,-18000,EB445137-D7F5-57EC-87DA-1DB460D64046,"iPhone13,2"
com.burbn.instagram,424,1710346159,1710346583,1710346584.389554,-18000,EB445137-D7F5-57EC-87DA-1DB460D64046,"iPhone13,2"
com.toyopagroup.picaboo,10,1710346148,1710346158,1710346158.853366,-18000,EB445137-D7F5-57EC-87DA-1DB460D64046,"iPhone13,2"
com.burbn.instagram,9,1710346139,1710346148,1710346148.3213801,-18000,EB445137-D7F5-57EC-87DA-1DB460D64046,"iPhone13,2"
com.toyopagroup.picaboo,3,1710346133,1710346136,1710346136.424162,-18000,EB445137-D7F5-57EC-87DA-1DB460D64046,"iPhone13,2"
com.burbn.instagram,9,1710346124,1710346133,1710346133.912156,-18000,EB445137-D7F5-57EC-87DA-1DB460D64046,"iPhone13,2"
com.toyopagroup.picaboo,4,1710346120,1710346124,1710346124.494307,-18000,EB445137-D7F5-57EC-87DA-1DB460D64046,"iPhone13,2"
com.burbn.instagram,25,1710346095,1710346120,1710346120.234762,-18000,EB445137-D7F5-57EC-87DA-1DB460D64046,"iPhone13,2"
com.toyopagroup.picaboo,8,1710346086,1710346094,1710346094.818701,-18000,EB445137-D7F5-57EC-87DA-1DB460D64046,"iPhone13,2"
com.burbn.instagram,144,1710345942,1710346086,1710346086.348833,-18000,EB445137-D7F5-57EC-87DA-1DB460D64046,"iPhone13,2"
com.apple.news,167,1710345771,1710345938,1710345938.829073,-18000,EB445137-D7F5-57EC-87DA-1DB460D64046,"iPhone13,2"
com.burbn.instagram,194,1710345550,1710345744,1710345744.6521769,-18000,EB445137-D7F5-57EC-87DA-1DB460D64046,"iPhone13,2"
com.thestorygraph.thestorygraph,90,1710345457,1710345547,1710345547.936287,-18000,EB445137-D7F5-57EC-87DA-1DB460D64046,"iPhone13,2"
com.apple.mobileslideshow,53,1710345391,1710345444,1710345444.387858,-18000,EB445137-D7F5-57EC-87DA-1DB460D64046,"iPhone13,2"
com.toyopagroup.picaboo,42,1710345345,1710345387,1710345387.827783,-18000,EB445137-D7F5-57EC-87DA-1DB460D64046,"iPhone13,2"
com.hammerandchisel.discord,15,1710345328,1710345343,1710345344.255321,-18000,EB445137-D7F5-57EC-87DA-1DB460D64046,"iPhone13,2"
com.microsoft.Office.Outlook,18,1710345304,1710345322,1710345322.6526508,-18000,EB445137-D7F5-57EC-87DA-1DB460D64046,"iPhone13,2"
com.apple.weather,4,1710345300,1710345304,1710345304.980136,-18000,EB445137-D7F5-57EC-87DA-1DB460D64046,"iPhone13,2"
com.apple.weather,3,1710344722,1710344725,1710344726.26116,-18000,EB445137-D7F5-57EC-87DA-1DB460D64046,"iPhone13,2"
com.apple.news,876,1710343843,1710344719,1710344719.046763,-18000,EB445137-D7F5-57EC-87DA-1DB460D64046,"iPhone13,2"
com.apple.MobileSMS,16,1710343827,1710343843,1710343843.2288,-18000,EB445137-D7F5-57EC-87DA-1DB460D64046,"iPhone13,2"
com.apple.Health,57,1710343255,1710343312,1710343312.9953609,-18000,EB445137-D7F5-57EC-87DA-1DB460D64046,"iPhone13,2"
com.letterboxd.LetterboxdApp,2,1710343250,1710343252,1710343252.917984,-18000,EB445137-D7F5-57EC-87DA-1DB460D64046,"iPhone13,2"
com.apple.camera,0,1710343235,1710343235,1710343235.451612,-18000,EB445137-D7F5-57EC-87DA-1DB460D64046,"iPhone13,2"
com.letterboxd.LetterboxdApp,12,1710343233,1710343245,1710343245.386425,-18000,EB445137-D7F5-57EC-87DA-1DB460D64046,"iPhone13,2"
com.letterboxd.LetterboxdApp,1,1710343228,1710343229,1710343229.851948,-18000,EB445137-D7F5-57EC-87DA-1DB460D64046,"iPhone13,2"
com.letterboxd.LetterboxdApp,5,1710343222,1710343227,1710343227.2916188,-18000,EB445137-D7F5-57EC-87DA-1DB460D64046,"iPhone13,2"
com.letterboxd.LetterboxdApp,10,1710343055,1710343065,1710343065.893681,-18000,EB445137-D7F5-57EC-87DA-1DB460D64046,"iPhone13,2"
com.letterboxd.LetterboxdApp,13,1710342260,1710342273,1710342273.815062,-18000,EB445137-D7F5-57EC-87DA-1DB460D64046,"iPhone13,2"
com.letterboxd.LetterboxdApp,3,1710342255,1710342258,1710342258.52462,-18000,EB445137-D7F5-57EC-87DA-1DB460D64046,"iPhone13,2"
com.letterboxd.LetterboxdApp,11,1710342239,1710342250,1710342251.0231981,-18000,EB445137-D7F5-57EC-87DA-1DB460D64046,"iPhone13,2"
com.apple.MobileSMS,11,1710342148,1710342159,1710342159.5543299,-18000,EB445137-D7F5-57EC-87DA-1DB460D64046,"iPhone13,2"
com.google.chrome.ios,95,1710342052,1710342147,1710342147.961506,-18000,EB445137-D7F5-57EC-87DA-1DB460D64046,"iPhone13,2"
com.apple.MobileSMS,5,1710342047,1710342052,1710342052.933126,-18000,EB445137-D7F5-57EC-87DA-1DB460D64046,"iPhone13,2"
com.burbn.instagram,1735,1710340312,1710342047,1710342047.215589,-18000,EB445137-D7F5-57EC-87DA-1DB460D64046,"iPhone13,2"
com.apple.Health,20,1710340255,1710340275,1710340275.925992,-18000,EB445137-D7F5-57EC-87DA-1DB460D64046,"iPhone13,2"
com.apple.Health,180,1710340072,1710340252,1710340252.679861,-18000,EB445137-D7F5-57EC-87DA-1DB460D64046,"iPhone13,2"
com.apple.weather,5,1710340007,1710340012,1710340012.50921,-18000,EB445137-D7F5-57EC-87DA-1DB460D64046,"iPhone13,2"
com.apple.findmy,6,1710340000,1710340006,1710340006.84308,-18000,EB445137-D7F5-57EC-87DA-1DB460D64046,"iPhone13,2"
com.apple.mobiletimer,1,1710339997,1710339998,1710339999.4196172,-18000,EB445137-D7F5-57EC-87DA-1DB460D64046,"iPhone13,2"
com.apple.mobiletimer,8,1710339989,1710339997,1710339997.638904,-18000,EB445137-D7F5-57EC-87DA-1DB460D64046,"iPhone13,2"
com.letterboxd.LetterboxdApp,13,1710308256,1710308269,1710308269.635716,-18000,EB445137-D7F5-57EC-87DA-1DB460D64046,"iPhone13,2"
com.apple.camera,0,1710308138,1710308138,1710308138.3796248,-18000,EB445137-D7F5-57EC-87DA-1DB460D64046,"iPhone13,2"
com.letterboxd.LetterboxdApp,15,1710308133,1710308148,1710308148.170836,-18000,EB445137-D7F5-57EC-87DA-1DB460D64046,"iPhone13,2"
com.letterboxd.LetterboxdApp,72,1710308025,1710308097,1710308098.1376982,-18000,EB445137-D7F5-57EC-87DA-1DB460D64046,"iPhone13,2"
com.letterboxd.LetterboxdApp,125,1710307898,1710308023,1710308023.82317,-18000,EB445137-D7F5-57EC-87DA-1DB460D64046,"iPhone13,2"
com.google.chrome.ios,24,1710305771,1710305795,1710305795.543278,-18000,EB445137-D7F5-57EC-87DA-1DB460D64046,"iPhone13,2"
com.toyopagroup.picaboo,6,1710305764,1710305770,1710305771.235915,-18000,EB445137-D7F5-57EC-87DA-1DB460D64046,"iPhone13,2"
com.apple.MobileSMS,4,1710298661,1710298665,1710298665.933529,-18000,,
com.google.Chrome,1100,1710297561,1710298661,1710298661.338584,-18000,,
com.apple.systempreferences,16,1710297545,1710297561,1710297561.944721,-18000,,
com.google.Chrome,1380,1710296159,1710297539,1710297539.2311192,-18000,,
com.apple.MobileSMS,6,1710296153,1710296159,1710296159.271924,-18000,,
com.google.Chrome,780,1710295373,1710296153,1710296154.015029,-18000,,
com.google.Chrome,13,1710294981,1710294994,1710294994.860354,-18000,,
com.google.Chrome,382,1710291241,1710291623,1710291623.1500978,-18000,,
com.google.Chrome,1631,1710289048,1710290679,1710290679.393825,-18000,,
com.google.Chrome,301,1710286995,1710287296,1710287296.650605,-18000,,
com.google.Chrome,790,1710286166,1710286956,1710286956.517243,-18000,,
com.apple.systempreferences,3,1710286161,1710286164,1710286164.3717399,-18000,,
com.google.Chrome,385,1710285775,1710286160,1710286160.3686318,-18000,,
com.google.Chrome,915,1710283805,1710284720,1710284720.5789142,-18000,,
com.google.Chrome,795,1710282850,1710283645,1710283645.588342,-18000,,
com.google.Chrome,3,1710275633,1710275636,1710275636.363453,-18000,,
com.apple.MobileSMS,3,1710275630,1710275633,1710275633.841845,-18000,,
com.google.Chrome,251,1710275379,1710275630,1710275630.891428,-18000,,
com.apple.MobileSMS,3,1710275376,1710275379,1710275379.610509,-18000,,
com.apple.systempreferences,158,1710275218,1710275376,1710275376.5675569,-18000,,
com.google.Chrome,120,1710275092,1710275212,1710275212.1560469,-18000,,
com.apple.MobileSMS,8,1710275084,1710275092,1710275092.151422,-18000,,
com.google.Chrome,15,1710275069,1710275084,1710275084.85659,-18000,,
com.apple.MobileSMS,10,1710275059,1710275069,1710275069.8412461,-18000,,
com.google.Chrome,510,1710274549,1710275059,1710275060.0821218,-18000,,
com.apple.MobileSMS,16,1710253382,1710253398,1710253398.9086719,-18000,EB445137-D7F5-57EC-87DA-1DB460D64046,"iPhone13,2"
com.apple.news,3,1710252242,1710252245,1710252245.486948,-18000,EB445137-D7F5-57EC-87DA-1DB460D64046,"iPhone13,2"
com.apple.findmy,24,1710252183,1710252207,1710252207.389863,-18000,EB445137-D7F5-57EC-87DA-1DB460D64046,"iPhone13,2"
com.apple.mobiletimer,0,1710252164,1710252164,1710252164.973967,-18000,EB445137-D7F5-57EC-87DA-1DB460D64046,"iPhone13,2"
com.apple.mobiletimer,16,1710252000,1710252016,1710252016.262858,-18000,EB445137-D7F5-57EC-87DA-1DB460D64046,"iPhone13,2"
com.apple.mobiletimer,13,1710223938,1710223951,1710223951.6124082,-18000,EB445137-D7F5-57EC-87DA-1DB460D64046,"iPhone13,2"
com.apple.mobiletimer,1,1710223935,1710223936,1710223936.4197469,-18000,EB445137-D7F5-57EC-87DA-1DB460D64046,"iPhone13,2"
com.apple.mobiletimer,4,1710223930,1710223934,1710223934.8818731,-18000,EB445137-D7F5-57EC-87DA-1DB460D64046,"iPhone13,2"
com.thestorygraph.thestorygraph,3,1710223927,1710223930,1710223930.792434,-18000,EB445137-D7F5-57EC-87DA-1DB460D64046,"iPhone13,2"
com.thestorygraph.thestorygraph,13,1710223884,1710223897,1710223897.747882,-18000,EB445137-D7F5-57EC-87DA-1DB460D64046,"iPhone13,2"
com.thestorygraph.thestorygraph,113,1710223766,1710223879,1710223879.765431,-18000,EB445137-D7F5-57EC-87DA-1DB460D64046,"iPhone13,2"
com.apple.camera,0,1710221039,1710221039,1710221039.684438,-18000,EB445137-D7F5-57EC-87DA-1DB460D64046,"iPhone13,2"
com.letterboxd.LetterboxdApp,60,1710220961,1710221021,1710221021.882608,-18000,EB445137-D7F5-57EC-87DA-1DB460D64046,"iPhone13,2"
com.letterboxd.LetterboxdApp,199,1710220760,1710220959,1710220959.658976,-18000,EB445137-D7F5-57EC-87DA-1DB460D64046,"iPhone13,2"
com.google.chrome.ios,10,1710220750,1710220760,1710220760.438396,-18000,EB445137-D7F5-57EC-87DA-1DB460D64046,"iPhone13,2"
com.letterboxd.LetterboxdApp,210,1710220540,1710220750,1710220750.187375,-18000,EB445137-D7F5-57EC-87DA-1DB460D64046,"iPhone13,2"
com.letterboxd.LetterboxdApp,12,1710219653,1710219665,1710219665.759018,-18000,EB445137-D7F5-57EC-87DA-1DB460D64046,"iPhone13,2"
com.google.Gmail,32,1710219406,1710219438,1710219438.48873,-18000,EB445137-D7F5-57EC-87DA-1DB460D64046,"iPhone13,2"
com.letterboxd.LetterboxdApp,323,1710217792,1710218115,1710218115.1355739,-18000,EB445137-D7F5-57EC-87DA-1DB460D64046,"iPhone13,2"
com.apple.Health,6,1710217780,1710217786,1710217787.010783,-18000,EB445137-D7F5-57EC-87DA-1DB460D64046,"iPhone13,2"
com.apple.Health,51,1710216772,1710216823,1710216823.952139,-18000,EB445137-D7F5-57EC-87DA-1DB460D64046,"iPhone13,2"
com.hammerandchisel.discord,32,1710216735,1710216767,1710216767.700265,-18000,EB445137-D7F5-57EC-87DA-1DB460D64046,"iPhone13,2"
com.google.chrome.ios,16,1710216719,1710216735,1710216735.3014011,-18000,EB445137-D7F5-57EC-87DA-1DB460D64046,"iPhone13,2"
com.google.Chrome,552,1710210890,1710211442,1710211442.1029649,-18000,,
com.google.Chrome,247,1710208475,1710208722,1710208722.681998,-18000,,
com.apple.systempreferences,151,1710208324,1710208475,1710208475.920212,-18000,,
com.google.Chrome,66,1710208252,1710208318,1710208318.082727,-18000,,
com.google.Chrome,294,1710205764,1710206058,1710206058.064853,-18000,,
com.google.Chrome,5,1710204839,1710204844,1710204844.587996,-18000,,
com.google.Chrome,359,1710204343,1710204702,1710204702.113858,-18000,,
com.microsoft.Outlook,7,1710204336,1710204343,1710204343.8884702,-18000,,
com.google.Chrome,4,1710204332,1710204336,1710204336.450019,-18000,,
com.google.Chrome,318,1710202068,1710202386,1710202386.4160619,-18000,,
com.google.Chrome,1440,1710200045,1710201485,1710201485.106267,-18000,,
com.leomehlig.today,33,1710200012,1710200045,1710200045.112537,-18000,,
com.google.Chrome,6,1710200006,1710200012,1710200013.18257,-18000,,
com.google.Chrome,334,1710195665,1710195999,1710195999.889429,-18000,,
com.leomehlig.today,10,1710195655,1710195665,1710195665.664542,-18000,,
com.google.Chrome,3,1710195652,1710195655,1710195655.279419,-18000,,
com.leomehlig.today,23,1710195629,1710195652,1710195653.029881,-18000,,
com.google.Chrome,16,1710195613,1710195629,1710195629.3570728,-18000,,
com.leomehlig.today,10,1710195603,1710195613,1710195613.14506,-18000,,
com.google.Chrome,334,1710195269,1710195603,1710195603.259162,-18000,,
com.leomehlig.today,1,1710195268,1710195269,1710195270.131041,-18000,,
com.google.Chrome,114,1710195154,1710195268,1710195268.329761,-18000,,
com.google.Chrome,859,1710194294,1710195153,1710195153.5105171,-18000,,
com.leomehlig.today,2,1710194292,1710194294,1710194294.769767,-18000,,
com.google.Chrome,466,1710193826,1710194292,1710194292.948909,-18000,,
com.google.Chrome,313,1710192866,1710193179,1710193180.0126119,-18000,,
com.leomehlig.today,28,1710192838,1710192866,1710192866.144884,-18000,,
com.leomehlig.today,39,1710182130,1710182169,1710182169.955064,-18000,,
com.google.Chrome,929,1710181201,1710182130,1710182130.855638,-18000,,
com.leomehlig.today,9,1710181192,1710181201,1710181201.509598,-18000,,
com.google.Chrome,6,1710181186,1710181192,1710181192.40301,-18000,,
com.google.Chrome,459,1710180271,1710180730,1710180730.969312,-18000,,
com.google.Chrome,519,1710179738,1710180257,1710180257.1431441,-18000,,
com.leomehlig.today,13,1710179707,1710179720,1710179720.4798489,-18000,,
com.apple.iCal,41,1710179666,1710179707,1710179707.9110441,-18000,,
com.google.Chrome,2,1710179664,1710179666,1710179666.129852,-18000,,
com.leomehlig.today,49,1710179615,1710179664,1710179664.063923,-18000,,
com.google.Chrome,23,1710179592,1710179615,1710179615.668534,-18000,,
com.google.Chrome,375,1710124385,1710124760,1710124760.550088,-18000,,
com.google.Chrome,757,1710113965,1710114722,1710114722.8725328,-18000,,
com.google.Chrome,546,1710113382,1710113928,1710113928.359675,-18000,,
com.google.Chrome,1003,1710111349,1710112352,1710112352.601006,-18000,,
com.apple.systempreferences,3,1710111346,1710111349,1710111349.70362,-18000,,
com.google.Chrome,2,1710111341,1710111343,1710111343.380893,-18000,,
com.google.Chrome,17,1710104163,1710104180,1710104180.2132359,-18000,,
com.google.Chrome,1230,1710102722,1710103952,1710103952.316993,-18000,,
com.google.Chrome,1152,1710101508,1710102660,1710102660.586082,-18000,,
com.apple.MobileSMS,33,1710101475,1710101508,1710101508.945694,-18000,,
com.google.Chrome,1014,1710100461,1710101475,1710101475.536876,-18000,,
com.apple.MobileSMS,4,1710100457,1710100461,1710100461.2530031,-18000,,
com.google.Chrome,117,1710100340,1710100457,1710100457.055182,-18000,,
com.google.Chrome,1247,1710098716,1710099963,1710099963.400361,-18000,,
com.apple.finder,28,1710098688,1710098716,1710098716.655161,-18000,,
com.google.Chrome,420,1710098268,1710098688,1710098688.384649,-18000,,
com.google.Chrome,75,1710087088,1710087163,1710087163.507796,-18000,,
com.apple.finder,54,1710087034,1710087088,1710087088.893382,-18000,,
com.google.Chrome,1,1710087033,1710087034,1710087034.810337,-18000,,
com.apple.finder,1,1710087032,1710087033,1710087033.3655891,-18000,,
com.google.Chrome,3,1710087029,1710087032,1710087032.5909681,-18000,,
com.google.Chrome,1,1710048272,1710048273,1710048274.007205,-21600,,
com.google.Chrome,498,1710047715,1710048213,1710048213.3933911,-21600,,
com.google.Chrome,317,1710045779,1710046096,1710046096.470193,-21600,,
com.google.Chrome,306,1710045383,1710045689,1710045689.3304172,-21600,,
com.google.Chrome,301,1710045053,1710045354,1710045354.831238,-21600,,
com.google.Chrome,1605,1710043390,1710044995,1710044995.467104,-21600,,
com.google.Chrome,301,1710041740,1710042041,1710042041.044477,-21600,,
com.google.Chrome,300,1710041366,1710041666,1710041666.9115782,-21600,,
com.google.Chrome,394,1710040884,1710041278,1710041278.215301,-21600,,
com.google.Chrome,3852,1710036319,1710040171,1710040171.972539,-21600,,
com.google.Chrome,534,1710003138,1710003672,1710003673.010329,-21600,,
com.apple.iCal,9,1710003129,1710003138,1710003139.099872,-21600,,
com.apple.MobileSMS,19,1710003110,1710003129,1710003129.103675,-21600,,
com.apple.iCal,28,1710003082,1710003110,1710003110.9170508,-21600,,
com.google.Chrome,339,1710002743,1710003082,1710003082.346328,-21600,,
com.apple.iCal,151,1710002592,1710002743,1710002744.053334,-21600,,
com.google.Chrome,9,1710002583,1710002592,1710002592.381721,-21600,,
com.apple.iCal,8,1710002575,1710002583,1710002583.5059052,-21600,,
com.google.Chrome,2,1710002573,1710002575,1710002575.1477098,-21600,,
com.apple.iCal,14,1710002559,1710002573,1710002573.181766,-21600,,
com.google.Chrome,11,1710002548,1710002559,1710002559.292521,-21600,,
com.apple.iCal,2,1710002546,1710002548,1710002548.1324449,-21600,,
com.google.Chrome,15,1710002531,1710002546,1710002546.864481,-21600,,
com.apple.iCal,1,1710002530,1710002531,1710002531.654244,-21600,,
com.google.Chrome,2,1710002528,1710002530,1710002530.671698,-21600,,
com.apple.iCal,23,1710002505,1710002528,1710002528.181706,-21600,,
com.google.Chrome,3,1710002502,1710002505,1710002505.4991689,-21600,,
com.apple.iCal,11,1710002491,1710002502,1710002502.945261,-21600,,
com.google.Chrome,8,1710002483,1710002491,1710002491.526956,-21600,,
com.apple.iCal,6,1710002477,1710002483,1710002483.672978,-21600,,
com.google.Chrome,23,1710002454,1710002477,1710002477.67909,-21600,,
com.apple.iCal,1,1710002453,1710002454,1710002454.301578,-21600,,
com.google.Chrome,1,1710002452,1710002453,1710002453.7481961,-21600,,
com.apple.iCal,15,1710002437,1710002452,1710002452.50559,-21600,,
com.google.Chrome,3,1710002434,1710002437,1710002437.156798,-21600,,
com.apple.iCal,1,1710002433,1710002434,1710002434.6113548,-21600,,
com.google.Chrome,1,1710002432,1710002433,1710002433.3629231,-21600,,
com.apple.iCal,23,1710002409,1710002432,1710002432.27529,-21600,,
com.google.Chrome,17,1710002392,1710002409,1710002409.090457,-21600,,
com.apple.iCal,20,1710002372,1710002392,1710002392.737253,-21600,,
com.google.Chrome,10,1710002362,1710002372,1710002372.547082,-21600,,
com.apple.iCal,7,1710002355,1710002362,1710002362.3896608,-21600,,
com.google.Chrome,4,1710002351,1710002355,1710002355.091752,-21600,,
com.apple.iCal,6,1710002345,1710002351,1710002351.840229,-21600,,
com.google.Chrome,5,1710002340,1710002345,1710002346.0108461,-21600,,
com.apple.iCal,43,1710002297,1710002340,1710002340.252229,-21600,,
com.google.Chrome,2,1710002295,1710002297,1710002297.979933,-21600,,
com.apple.iCal,13,1710002282,1710002295,1710002295.733881,-21600,,
com.google.Chrome,1,1710002281,1710002282,1710002282.938077,-21600,,
com.apple.iCal,2,1710002279,1710002281,1710002281.065851,-21600,,
com.google.Chrome,7,1710002272,1710002279,1710002279.52179,-21600,,
com.apple.iCal,9,1710002263,1710002272,1710002272.705741,-21600,,
com.google.Chrome,7,1710002256,1710002263,1710002263.873143,-21600,,
com.apple.iCal,1,1710002255,1710002256,1710002256.734863,-21600,,
com.google.Chrome,11,1710002244,1710002255,1710002255.530535,-21600,,
com.apple.iCal,17,1710002227,1710002244,1710002244.740725,-21600,,
com.google.Chrome,1,1710002226,1710002227,1710002227.096939,-21600,,
com.apple.iCal,1,1710002225,1710002226,1710002226.273798,-21600,,
com.google.Chrome,3,1710002222,1710002225,1710002225.7044811,-21600,,
com.apple.iCal,8,1710002214,1710002222,1710002222.0967178,-21600,,
com.google.Chrome,1,1710002213,1710002214,1710002214.927396,-21600,,
com.apple.iCal,13,1710002200,1710002213,1710002213.6231952,-21600,,
com.google.Chrome,1,1710002199,1710002200,1710002200.994029,-21600,,
com.apple.iCal,2,1710002197,1710002199,1710002199.849865,-21600,,
com.google.Chrome,20,1710002177,1710002197,1710002197.417104,-21600,,
com.apple.systempreferences,13,1710002153,1710002166,1710002166.183837,-21600,,
com.google.Chrome,2,1710002148,1710002150,1710002150.422114,-21600,,
com.apple.MobileSMS,32,1710001473,1710001505,1710001505.570472,-21600,,
com.google.Chrome,0,1710001473,1710001473,1710001473.869879,-21600,,
com.apple.MobileSMS,13,1710001460,1710001473,1710001473.394247,-21600,,
com.google.Chrome,450,1710001010,1710001460,1710001460.6229959,-21600,,
com.google.Chrome,74,1709959372,1709959446,1709959446.946704,-21600,,
com.google.Chrome,372,1709957972,1709958344,1709958344.702954,-21600,,
com.google.Chrome,325,1709956757,1709957082,1709957082.575726,-21600,,
com.leomehlig.today,8,1709956749,1709956757,1709956757.935687,-21600,,
com.google.Chrome,2,1709956747,1709956749,1709956749.940209,-21600,,
com.leomehlig.today,1,1709956746,1709956747,1709956747.4315991,-21600,,
com.apple.finder,0,1709956746,1709956746,1709956746.728581,-21600,,
com.microsoft.Outlook,3,1709956743,1709956746,1709956746.350896,-21600,,
com.google.Chrome,7,1709956736,1709956743,1709956743.625695,-21600,,
com.apple.MobileSMS,15,1709956721,1709956736,1709956736.214972,-21600,,
com.google.Chrome,28,1709956693,1709956721,1709956721.1653829,-21600,,
com.google.Chrome,301,1709928790,1709929091,1709929091.8374681,-21600,,
com.google.Chrome,493,1709928265,1709928758,1709928758.581958,-21600,,
com.google.Chrome,1003,1709925437,1709926440,1709926440.429302,-21600,,
com.apple.systempreferences,2,1709925426,1709925428,1709925428.210732,-21600,,
com.google.Chrome,11,1709925408,1709925419,1709925419.900362,-21600,,
com.microsoft.Outlook,9,1709925379,1709925388,1709925388.974959,-21600,,
com.google.Chrome,6,1709925373,1709925379,1709925380.041122,-21600,,
com.microsoft.Outlook,0,1709925373,1709925373,1709925376.021487,-21600,,
com.google.Chrome,286,1709925087,1709925373,1709925373.920289,-21600,,
com.leomehlig.today,17,1709925070,1709925087,1709925087.9830341,-21600,,
us.zoom.xos,1,1709925069,1709925070,1709925071.0412822,-21600,,
com.apple.systempreferences,13,1709925056,1709925069,1709925069.790152,-21600,,
us.zoom.xos,4,1709925051,1709925055,1709925055.52684,-21600,,
com.apple.systempreferences,4,1709925042,1709925046,1709925046.818114,-21600,,
us.zoom.xos,4,1709925032,1709925036,1709925036.761107,-21600,,
us.zoom.xos,11,1709912933,1709912944,1709912944.881361,-21600,,
com.google.Chrome,51,1709912882,1709912933,1709912933.6190581,-21600,,
us.zoom.xos,9,1709912873,1709912882,1709912882.911344,-21600,,
com.google.Chrome,2078,1709910795,1709912873,1709912873.943227,-21600,,
us.zoom.xos,9,1709910786,1709910795,1709910795.180623,-21600,,
com.google.Chrome,551,1709910235,1709910786,1709910786.8645859,-21600,,
us.zoom.xos,5,1709910230,1709910235,1709910235.59266,-21600,,
com.google.Chrome,10,1709910220,1709910230,1709910231.0357652,-21600,,
us.zoom.xos,1,1709910219,1709910220,1709910220.73477,-21600,,
com.google.Chrome,1,1709910218,1709910219,1709910219.4441829,-21600,,
us.zoom.xos,1,1709910217,1709910218,1709910218.4835181,-21600,,
com.google.Chrome,2,1709910215,1709910217,1709910217.679205,-21600,,
us.zoom.xos,1,1709910214,1709910215,1709910215.9066901,-21600,,
com.google.Chrome,3,1709910211,1709910214,1709910214.96665,-21600,,
us.zoom.xos,3,1709910208,1709910211,1709910211.617362,-21600,,
com.microsoft.Outlook,1,1709910207,1709910208,1709910208.159245,-21600,,
com.google.Chrome,1,1709910206,1709910207,1709910207.169538,-21600,,
com.microsoft.Outlook,1,1709910205,1709910206,1709910206.672367,-21600,,
us.zoom.xos,19,1709910186,1709910205,1709910205.381396,-21600,,
com.microsoft.Outlook,80,1709910106,1709910186,1709910186.721168,-21600,,
us.zoom.xos,52,1709910054,1709910106,1709910106.309039,-21600,,
com.google.Chrome,29,1709910025,1709910054,1709910054.8776522,-21600,,
us.zoom.xos,2,1709910023,1709910025,1709910025.950784,-21600,,
com.google.Chrome,5,1709910018,1709910023,1709910023.8505468,-21600,,
us.zoom.xos,27,1709909991,1709910018,1709910018.559949,-21600,,
com.google.Chrome,5,1709909986,1709909991,1709909991.118803,-21600,,
us.zoom.xos,5,1709909981,1709909986,1709909986.561969,-21600,,
com.google.Chrome,12,1709909969,1709909981,1709909981.168231,-21600,,
us.zoom.xos,68,1709909901,1709909969,1709909969.248259,-21600,,
com.google.Chrome,248,1709909653,1709909901,1709909901.7132568,-21600,,
com.apple.systempreferences,9,1709909644,1709909653,1709909653.141187,-21600,,
com.google.Chrome,28,1709909616,1709909644,1709909644.236826,-21600,,
com.apple.systempreferences,31,1709909585,1709909616,1709909616.228252,-21600,,
com.google.Chrome,66,1709909513,1709909579,1709909579.07762,-21600,,
com.microsoft.Outlook,1,1709909512,1709909513,1709909513.4342809,-21600,,
com.google.Chrome,5,1709909507,1709909512,1709909512.234021,-21600,,
com.microsoft.Outlook,15,1709909492,1709909507,1709909507.886651,-21600,,
com.google.Chrome,42,1709909450,1709909492,1709909492.205622,-21600,,
com.leomehlig.today,9,1709909441,1709909450,1709909451.6386828,-21600,,
com.leomehlig.today,25,1709874177,1709874202,1709874202.201195,-21600,,
com.google.Chrome,2115,1709872062,1709874177,1709874178.106049,-21600,,
com.google.Chrome,832,1709870822,1709871654,1709871654.3527699,-21600,,
com.microsoft.Outlook,10,1709870812,1709870822,1709870823.043836,-21600,,
com.google.Chrome,55,1709870757,1709870812,1709870812.4564462,-21600,,
com.microsoft.Outlook,26,1709870731,1709870757,1709870757.7253199,-21600,,
com.google.Chrome,12,1709870719,1709870731,1709870731.081931,-21600,,
com.microsoft.Outlook,2,1709870717,1709870719,1709870719.480931,-21600,,
com.google.Chrome,443,1709870274,1709870717,1709870717.5230122,-21600,,
com.google.chrome.ios,4,1709868362,1709868366,1709868366.662873,-21600,EB445137-D7F5-57EC-87DA-1DB460D64046,"iPhone13,2"
com.google.chrome.ios,10,1709868105,1709868115,1709868115.739562,-21600,EB445137-D7F5-57EC-87DA-1DB460D64046,"iPhone13,2"
com.google.chrome.ios,42,1709868020,1709868062,1709868062.990591,-21600,EB445137-D7F5-57EC-87DA-1DB460D64046,"iPhone13,2"
com.microsoft.Office.Outlook,6,1709868014,1709868020,1709868020.4089332,-21600,EB445137-D7F5-57EC-87DA-1DB460D64046,"iPhone13,2"
com.microsoft.Office.Outlook,41,1709867926,1709867967,1709867967.855983,-21600,EB445137-D7F5-57EC-87DA-1DB460D64046,"iPhone13,2"
com.google.Chrome,84,1709867882,1709867966,1709867966.920177,-21600,,
com.microsoft.VSCode,2,1709867880,1709867882,1709867884.637222,-21600,,
com.microsoft.Office.Outlook,7,1709867861,1709867868,1709867868.788178,-21600,EB445137-D7F5-57EC-87DA-1DB460D64046,"iPhone13,2"
com.toyopagroup.picaboo,76,1709867785,1709867861,1709867861.183519,-21600,EB445137-D7F5-57EC-87DA-1DB460D64046,"iPhone13,2"
com.google.chrome.ios,32,1709867753,1709867785,1709867785.152678,-21600,EB445137-D7F5-57EC-87DA-1DB460D64046,"iPhone13,2"
com.apple.news,12,1709867741,1709867753,1709867753.440085,-21600,EB445137-D7F5-57EC-87DA-1DB460D64046,"iPhone13,2"
com.apple.news,2,1709867738,1709867740,1709867741.040079,-21600,EB445137-D7F5-57EC-87DA-1DB460D64046,"iPhone13,2"
com.apple.news,9,1709867041,1709867050,1709867050.8542109,-21600,EB445137-D7F5-57EC-87DA-1DB460D64046,"iPhone13,2"
com.toyopagroup.picaboo,34,1709866972,1709867006,1709867006.6893091,-21600,EB445137-D7F5-57EC-87DA-1DB460D64046,"iPhone13,2"
com.toyopagroup.picaboo,29,1709866932,1709866961,1709866961.2197862,-21600,EB445137-D7F5-57EC-87DA-1DB460D64046,"iPhone13,2"
com.google.chrome.ios,33,1709866899,1709866932,1709866933.215942,-21600,EB445137-D7F5-57EC-87DA-1DB460D64046,"iPhone13,2"
com.toyopagroup.picaboo,4,1709866890,1709866894,1709866894.580117,-21600,EB445137-D7F5-57EC-87DA-1DB460D64046,"iPhone13,2"
com.apple.news,5,1709866885,1709866890,1709866890.922245,-21600,EB445137-D7F5-57EC-87DA-1DB460D64046,"iPhone13,2"
com.toyopagroup.picaboo,6,1709866874,1709866880,1709866880.358439,-21600,EB445137-D7F5-57EC-87DA-1DB460D64046,"iPhone13,2"
com.apple.news,3,1709866871,1709866874,1709866874.154856,-21600,EB445137-D7F5-57EC-87DA-1DB460D64046,"iPhone13,2"
com.toyopagroup.picaboo,28,1709866838,1709866866,1709866866.2597141,-21600,EB445137-D7F5-57EC-87DA-1DB460D64046,"iPhone13,2"
com.toyopagroup.picaboo,16,1709866552,1709866568,1709866568.3941932,-21600,EB445137-D7F5-57EC-87DA-1DB460D64046,"iPhone13,2"
com.toyopagroup.picaboo,10,1709866498,1709866508,1709866508.178691,-21600,EB445137-D7F5-57EC-87DA-1DB460D64046,"iPhone13,2"
com.toyopagroup.picaboo,36,1709866457,1709866493,1709866493.564272,-21600,EB445137-D7F5-57EC-87DA-1DB460D64046,"iPhone13,2"
com.apple.news,50,1709866407,1709866457,1709866457.422131,-21600,EB445137-D7F5-57EC-87DA-1DB460D64046,"iPhone13,2"
com.toyopagroup.picaboo,3,1709866400,1709866403,1709866403.403668,-21600,EB445137-D7F5-57EC-87DA-1DB460D64046,"iPhone13,2"
com.toyopagroup.picaboo,10,1709866385,1709866395,1709866395.523906,-21600,EB445137-D7F5-57EC-87DA-1DB460D64046,"iPhone13,2"
com.toyopagroup.picaboo,8,1709866370,1709866378,1709866378.4725509,-21600,EB445137-D7F5-57EC-87DA-1DB460D64046,"iPhone13,2"
com.toyopagroup.picaboo,5,1709866360,1709866365,1709866365.908893,-21600,EB445137-D7F5-57EC-87DA-1DB460D64046,"iPhone13,2"
com.toyopagroup.picaboo,11,1709866338,1709866349,1709866349.825739,-21600,EB445137-D7F5-57EC-87DA-1DB460D64046,"iPhone13,2"
com.toyopagroup.picaboo,19,1709866318,1709866337,1709866337.4717221,-21600,EB445137-D7F5-57EC-87DA-1DB460D64046,"iPhone13,2"
com.toyopagroup.picaboo,2,1709865770,1709865772,1709865772.7329922,-21600,EB445137-D7F5-57EC-87DA-1DB460D64046,"iPhone13,2"
com.toyopagroup.picaboo,9,1709865613,1709865622,1709865622.613493,-21600,EB445137-D7F5-57EC-87DA-1DB460D64046,"iPhone13,2"
com.apple.MobileSMS,5,1709865604,1709865609,1709865609.4683719,-21600,EB445137-D7F5-57EC-87DA-1DB460D64046,"iPhone13,2"
com.google.chrome.ios,3,1709865601,1709865604,1709865605.131826,-21600,EB445137-D7F5-57EC-87DA-1DB460D64046,"iPhone13,2"
com.google.chrome.ios,782,1709864805,1709865587,1709865587.342072,-21600,EB445137-D7F5-57EC-87DA-1DB460D64046,"iPhone13,2"
com.google.chrome.ios,6,1709864180,1709864186,1709864186.904805,-21600,EB445137-D7F5-57EC-87DA-1DB460D64046,"iPhone13,2"
com.google.chrome.ios,23,1709864155,1709864178,1709864178.4032888,-21600,EB445137-D7F5-57EC-87DA-1DB460D64046,"iPhone13,2"
com.google.Gmail,5,1709864150,1709864155,1709864155.8848572,-21600,EB445137-D7F5-57EC-87DA-1DB460D64046,"iPhone13,2"
com.microsoft.VSCode,19,1709864061,1709864080,1709864081.0423322,-21600,,
com.apple.finder,29,1709864032,1709864061,1709864061.349968,-21600,,
com.microsoft.VSCode,371,1709863661,1709864032,1709864032.874596,-21600,,
com.google.Gmail,1,1709863657,1709863658,1709863658.74487,-21600,EB445137-D7F5-57EC-87DA-1DB460D64046,"iPhone13,2"
com.microsoft.Office.Outlook,67,1709863590,1709863657,1709863657.537118,-21600,EB445137-D7F5-57EC-87DA-1DB460D64046,"iPhone13,2"
com.google.Chrome,73,1709863588,1709863661,1709863661.518063,-21600,,
com.google.chrome.ios,6,1709863584,1709863590,1709863590.290669,-21600,EB445137-D7F5-57EC-87DA-1DB460D64046,"iPhone13,2"
com.apple.camera,8,1709863576,1709863584,1709863584.841014,-21600,EB445137-D7F5-57EC-87DA-1DB460D64046,"iPhone13,2"
com.microsoft.VSCode,121,1709863467,1709863588,1709863588.834571,-21600,,
com.apple.finder,2,1709863465,1709863467,1709863467.117776,-21600,,
com.microsoft.VSCode,13,1709863452,1709863465,1709863466.032648,-21600,,
com.apple.finder,1,1709863451,1709863452,1709863453.0308352,-21600,,
com.microsoft.VSCode,2,1709863449,1709863451,1709863451.9758859,-21600,,
com.apple.finder,1,1709863448,1709863449,1709863449.565409,-21600,,
com.microsoft.VSCode,13,1709863435,1709863448,1709863448.415467,-21600,,
com.apple.finder,33,1709863402,1709863435,1709863435.4857721,-21600,,
com.microsoft.VSCode,20,1709863382,1709863402,1709863402.6810799,-21600,,
com.apple.finder,10,1709863372,1709863382,1709863382.282068,-21600,,
com.microsoft.VSCode,19,1709863353,1709863372,1709863372.448667,-21600,,
com.apple.finder,188,1709863165,1709863353,1709863353.686059,-21600,,
com.google.Chrome,71,1709863094,1709863165,1709863165.1585488,-21600,,
com.apple.finder,66,1709863028,1709863094,1709863094.893177,-21600,,
com.microsoft.VSCode,5,1709863023,1709863028,1709863028.651577,-21600,,
com.apple.finder,186,1709862837,1709863023,1709863023.337496,-21600,,
com.apple.iWork.Numbers,420,1709862417,1709862837,1709862837.3183289,-21600,,
com.apple.finder,7,1709862410,1709862417,1709862417.403325,-21600,,
com.microsoft.VSCode,7,1709862403,1709862410,1709862410.733296,-21600,,
com.google.Chrome,3,1709862400,1709862403,1709862403.402666,-21600,,
com.microsoft.VSCode,35,1709862365,1709862400,1709862400.71341,-21600,,
com.apple.finder,72,1709862293,1709862365,1709862365.2668672,-21600,,
com.apple.archiveutility,1,1709862292,1709862293,1709862293.272233,-21600,,
com.apple.finder,5,1709862287,1709862292,1709862292.506418,-21600,,
com.google.Chrome,452,1709861835,1709862287,1709862287.840601,-21600,,
com.apple.iCal,18,1709861817,1709861835,1709861835.702176,-21600,,
com.google.Chrome,153,1709861664,1709861817,1709861817.6575,-21600,,
com.microsoft.VSCode,11,1709861653,1709861664,1709861664.958617,-21600,,
com.apple.iCal,36,1709861617,1709861653,1709861653.437827,-21600,,
com.google.Chrome,200,1709861417,1709861617,1709861618.026554,-21600,,
com.microsoft.VSCode,248,1709861169,1709861417,1709861417.587564,-21600,,
com.google.Chrome,21,1709861148,1709861169,1709861169.146939,-21600,,
com.microsoft.VSCode,75,1709861073,1709861148,1709861148.861213,-21600,,
com.apple.finder,15,1709861058,1709861073,1709861073.61778,-21600,,
com.microsoft.VSCode,7,1709861051,1709861058,1709861058.110559,-21600,,
com.google.Chrome,160,1709860891,1709861051,1709861052.0365481,-21600,,
com.apple.finder,7,1709860884,1709860891,1709860891.922017,-21600,,
com.google.Chrome,10,1709860874,1709860884,1709860884.6987991,-21600,,
com.apple.finder,36,1709860838,1709860874,1709860874.7942219,-21600,,
com.google.Chrome,1,1709860837,1709860838,1709860838.388907,-21600,,
com.microsoft.VSCode,23,1709860814,1709860837,1709860837.9221458,-21600,,
com.google.Chrome,31,1709860783,1709860814,1709860814.276202,-21600,,
com.apple.finder,1,1709860782,1709860783,1709860784.075372,-21600,,
com.microsoft.VSCode,82,1709860700,1709860782,1709860782.20491,-21600,,
com.apple.MobileSMS,3,1709860697,1709860700,1709860700.42611,-21600,,
com.microsoft.VSCode,85,1709860612,1709860697,1709860697.356293,-21600,,
com.apple.finder,64,1709860548,1709860612,1709860613.02895,-21600,,
com.microsoft.VSCode,2,1709860546,1709860548,1709860548.803715,-21600,,
com.google.Chrome,293,1709860253,1709860546,1709860546.680135,-21600,,
com.microsoft.VSCode,240,1709860013,1709860253,1709860253.829622,-21600,,
com.google.Chrome,3,1709860010,1709860013,1709860013.423902,-21600,,
com.tinyspeck.chatlyio,20,1709858347,1709858367,1709858367.890523,-21600,EB445137-D7F5-57EC-87DA-1DB460D64046,"iPhone13,2"
com.apple.Health,3,1709858343,1709858346,1709858346.5216541,-21600,EB445137-D7F5-57EC-87DA-1DB460D64046,"iPhone13,2"
com.apple.Health,3,1709858332,1709858335,1709858335.179206,-21600,EB445137-D7F5-57EC-87DA-1DB460D64046,"iPhone13,2"
com.google.Chrome,4,1709858228,1709858232,1709858232.512665,-21600,,
com.google.Chrome,135,1709858092,1709858227,1709858227.094403,-21600,,
com.apple.Health,2,1709858038,1709858040,1709858040.3437982,-21600,EB445137-D7F5-57EC-87DA-1DB460D64046,"iPhone13,2"
com.apple.Health,25,1709857855,1709857880,1709857880.076836,-21600,EB445137-D7F5-57EC-87DA-1DB460D64046,"iPhone13,2"
com.google.Maps,3,1709857848,1709857851,1709857851.6180968,-21600,EB445137-D7F5-57EC-87DA-1DB460D64046,"iPhone13,2"
com.google.Maps,35,1709857807,1709857842,1709857842.446523,-21600,EB445137-D7F5-57EC-87DA-1DB460D64046,"iPhone13,2"
com.apple.MobileSMS,3,1709857801,1709857804,1709857804.730217,-21600,EB445137-D7F5-57EC-87DA-1DB460D64046,"iPhone13,2"
edu.illinois.rokwire.ios,3,1709857796,1709857799,1709857799.480492,-21600,EB445137-D7F5-57EC-87DA-1DB460D64046,"iPhone13,2"
com.google.Chrome,870,1709857158,1709858028,1709858028.748271,-21600,,
edu.illinois.rokwire.ios,4,1709857088,1709857092,1709857092.86052,-21600,EB445137-D7F5-57EC-87DA-1DB460D64046,"iPhone13,2"
edu.illinois.rokwire.ios,15,1709856751,1709856766,1709856766.75703,-21600,EB445137-D7F5-57EC-87DA-1DB460D64046,"iPhone13,2"
edu.illinois.rokwire.ios,4,1709856747,1709856751,1709856751.047374,-21600,EB445137-D7F5-57EC-87DA-1DB460D64046,"iPhone13,2"
edu.illinois.rokwire.ios,7,1709856677,1709856684,1709856684.164918,-21600,EB445137-D7F5-57EC-87DA-1DB460D64046,"iPhone13,2"
edu.illinois.rokwire.ios,30,1709856486,1709856516,1709856516.9174418,-21600,EB445137-D7F5-57EC-87DA-1DB460D64046,"iPhone13,2"
com.toyopagroup.picaboo,8,1709856478,1709856486,1709856486.7107391,-21600,EB445137-D7F5-57EC-87DA-1DB460D64046,"iPhone13,2"
com.google.Chrome,470,1709856424,1709856894,1709856894.4358258,-21600,,
com.leomehlig.today,9,1709856415,1709856424,1709856425.793092,-21600,,
com.apple.iCal,6,1709856409,1709856415,1709856416.105599,-21600,,
com.google.Chrome,29,1709856380,1709856409,1709856409.390678,-21600,,
us.zoom.xos,6,1709856374,1709856380,1709856380.617399,-21600,,
com.toyopagroup.picaboo,7,1709856101,1709856108,1709856108.58775,-21600,EB445137-D7F5-57EC-87DA-1DB460D64046,"iPhone13,2"
com.toyopagroup.picaboo,2,1709854894,1709854896,1709854896.834993,-21600,EB445137-D7F5-57EC-87DA-1DB460D64046,"iPhone13,2"
com.toyopagroup.picaboo,2,1709852802,1709852804,1709852804.933639,-21600,EB445137-D7F5-57EC-87DA-1DB460D64046,"iPhone13,2"
com.toyopagroup.picaboo,7,1709852794,1709852801,1709852801.564878,-21600,EB445137-D7F5-57EC-87DA-1DB460D64046,"iPhone13,2"
com.toyopagroup.picaboo,9,1709852719,1709852728,1709852728.304003,-21600,EB445137-D7F5-57EC-87DA-1DB460D64046,"iPhone13,2"
com.toyopagroup.picaboo,2,1709852702,1709852704,1709852704.23437,-21600,EB445137-D7F5-57EC-87DA-1DB460D64046,"iPhone13,2"
com.toyopagroup.picaboo,1,1709852663,1709852664,1709852664.264533,-21600,EB445137-D7F5-57EC-87DA-1DB460D64046,"iPhone13,2"
com.toyopagroup.picaboo,2,1709852608,1709852610,1709852610.39962,-21600,EB445137-D7F5-57EC-87DA-1DB460D64046,"iPhone13,2"
com.toyopagroup.picaboo,6,1709852568,1709852574,1709852574.664381,-21600,EB445137-D7F5-57EC-87DA-1DB460D64046,"iPhone13,2"
com.toyopagroup.picaboo,23,1709852535,1709852558,1709852558.3521109,-21600,EB445137-D7F5-57EC-87DA-1DB460D64046,"iPhone13,2"
com.toyopagroup.picaboo,20,1709852458,1709852478,1709852478.3057961,-21600,EB445137-D7F5-57EC-87DA-1DB460D64046,"iPhone13,2"
us.parkmobile.ParkMobile,5,1709852190,1709852195,1709852195.2061992,-21600,EB445137-D7F5-57EC-87DA-1DB460D64046,"iPhone13,2"
us.parkmobile.ParkMobile,20,1709852159,1709852179,1709852179.1469312,-21600,EB445137-D7F5-57EC-87DA-1DB460D64046,"iPhone13,2"
us.parkmobile.ParkMobile,16,1709851936,1709851952,1709851953.0697489,-21600,EB445137-D7F5-57EC-87DA-1DB460D64046,"iPhone13,2"
com.google.Maps,19,1709851915,1709851934,1709851934.241654,-21600,EB445137-D7F5-57EC-87DA-1DB460D64046,"iPhone13,2"
com.toyopagroup.picaboo,5,1709851905,1709851910,1709851910.8003101,-21600,EB445137-D7F5-57EC-87DA-1DB460D64046,"iPhone13,2"
com.toyopagroup.picaboo,26,1709851646,1709851672,1709851672.6589332,-21600,EB445137-D7F5-57EC-87DA-1DB460D64046,"iPhone13,2"
com.toyopagroup.picaboo,4,1709850958,1709850962,1709850963.015255,-21600,EB445137-D7F5-57EC-87DA-1DB460D64046,"iPhone13,2"
com.toyopagroup.picaboo,3,1709850942,1709850945,1709850945.21719,-21600,EB445137-D7F5-57EC-87DA-1DB460D64046,"iPhone13,2"
edu.illinois.rokwire.ios,19,1709850921,1709850940,1709850940.551503,-21600,EB445137-D7F5-57EC-87DA-1DB460D64046,"iPhone13,2"
com.toyopagroup.picaboo,3,1709850908,1709850911,1709850911.040385,-21600,EB445137-D7F5-57EC-87DA-1DB460D64046,"iPhone13,2"
us.zoom.xos,198,1709850831,1709851029,1709851029.14274,-21600,,
com.google.chrome.ios,47,1709850570,1709850617,1709850617.557321,-21600,EB445137-D7F5-57EC-87DA-1DB460D64046,"iPhone13,2"
com.burbn.instagram,5,1709850552,1709850557,1709850557.522965,-21600,EB445137-D7F5-57EC-87DA-1DB460D64046,"iPhone13,2"
com.intsig.CamScannerLite,9,1709850541,1709850550,1709850550.042803,-21600,EB445137-D7F5-57EC-87DA-1DB460D64046,"iPhone13,2"
us.zoom.xos,300,1709850334,1709850634,1709850634.1601071,-21600,,
com.google.Chrome,483,1709849851,1709850334,1709850334.24524,-21600,,
us.zoom.xos,4,1709849847,1709849851,1709849851.740983,-21600,,
com.google.Chrome,5,1709849842,1709849847,1709849847.6606832,-21600,,
com.apple.systempreferences,7,1709849835,1709849842,1709849842.921624,-21600,,
com.google.Chrome,0,1709849835,1709849835,1709849835.339742,-21600,,
us.zoom.xos,2,1709849758,1709849760,1709849760.702812,-21600,,
com.google.Chrome,559,1709849199,1709849758,1709849758.603078,-21600,,
us.zoom.xos,3,1709849196,1709849199,1709849199.220478,-21600,,
com.google.Chrome,12,1709849184,1709849196,1709849196.794026,-21600,,
com.apple.finder,15,1709849169,1709849184,1709849184.306704,-21600,,
com.intsig.CamScannerLite,103,1709849105,1709849208,1709849208.245209,-21600,EB445137-D7F5-57EC-87DA-1DB460D64046,"iPhone13,2"
com.apple.MobileSMS,5,1709849099,1709849104,1709849104.327523,-21600,EB445137-D7F5-57EC-87DA-1DB460D64046,"iPhone13,2"
us.zoom.xos,79,1709849090,1709849169,1709849169.188178,-21600,,
com.google.Chrome,44,1709849046,1709849090,1709849090.257175,-21600,,
us.zoom.xos,8,1709849038,1709849046,1709849046.5726929,-21600,,
com.google.Chrome,125,1709848913,1709849038,1709849039.013986,-21600,,
com.apple.MobileSMS,94,1709848912,1709849006,1709849006.416501,-21600,EB445137-D7F5-57EC-87DA-1DB460D64046,"iPhone13,2"
com.apple.weather,2,1709848910,1709848912,1709848912.335253,-21600,EB445137-D7F5-57EC-87DA-1DB460D64046,"iPhone13,2"
us.zoom.xos,20,1709848893,1709848913,1709848913.146051,-21600,,
com.google.Chrome,8,1709848885,1709848893,1709848893.952129,-21600,,
us.zoom.xos,7,1709848878,1709848885,1709848885.864676,-21600,,
com.google.Chrome,95,1709848783,1709848878,1709848878.178275,-21600,,
com.apple.weather,2,1709848734,1709848736,1709848736.109892,-21600,EB445137-D7F5-57EC-87DA-1DB460D64046,"iPhone13,2"
com.apple.weather,4,1709848200,1709848204,1709848204.913371,-21600,EB445137-D7F5-57EC-87DA-1DB460D64046,"iPhone13,2"
us.zoom.xos,830,1709847953,1709848783,1709848783.192665,-21600,,
com.google.Chrome,1,1709847952,1709847953,1709847954.1077518,-21600,,
com.apple.iCal,4,1709847948,1709847952,1709847952.4035969,-21600,,
us.zoom.xos,2,1709847946,1709847948,1709847948.360569,-21600,,
com.burbn.instagram,4,1709847724,1709847728,1709847728.4921088,-21600,EB445137-D7F5-57EC-87DA-1DB460D64046,"iPhone13,2"
com.apple.weather,3,1709847719,1709847722,1709847722.654757,-21600,EB445137-D7F5-57EC-87DA-1DB460D64046,"iPhone13,2"
com.apple.weather,16,1709846713,1709846729,1709846729.228757,-21600,EB445137-D7F5-57EC-87DA-1DB460D64046,"iPhone13,2"
com.apple.news,4,1709846709,1709846713,1709846713.724059,-21600,EB445137-D7F5-57EC-87DA-1DB460D64046,"iPhone13,2"
us.zoom.xos,307,1709846404,1709846711,1709846711.5338511,-21600,,
com.apple.news,398,1709846005,1709846403,1709846404.0618181,-21600,EB445137-D7F5-57EC-87DA-1DB460D64046,"iPhone13,2"
com.apple.news,4,1709845994,1709845998,1709845998.279047,-21600,EB445137-D7F5-57EC-87DA-1DB460D64046,"iPhone13,2"
us.zoom.xos,342,1709845948,1709846290,1709846290.764528,-21600,,
com.leomehlig.today,41,1709845907,1709845948,1709845948.377974,-21600,,
us.zoom.xos,1,1709845906,1709845907,1709845907.7638779,-21600,,
com.apple.Preview,3,1709845903,1709845906,1709845906.9498,-21600,,
us.zoom.xos,230,1709845673,1709845903,1709845903.942009,-21600,,
com.google.Chrome,109,1709845564,1709845673,1709845673.495727,-21600,,
com.apple.news,45,1709845517,1709845562,1709845563.008863,-21600,EB445137-D7F5-57EC-87DA-1DB460D64046,"iPhone13,2"
com.hammerandchisel.discord,68,1709845422,1709845490,1709845490.785307,-21600,EB445137-D7F5-57EC-87DA-1DB460D64046,"iPhone13,2"
com.burbn.instagram,3,1709845419,1709845422,1709845422.250008,-21600,EB445137-D7F5-57EC-87DA-1DB460D64046,"iPhone13,2"
us.zoom.xos,259,1709845305,1709845564,1709845564.450945,-21600,,
com.google.Chrome,12,1709845293,1709845305,1709845305.2493029,-21600,,
us.zoom.xos,3,1709845290,1709845293,1709845293.760501,-21600,,
com.google.Chrome,19,1709845271,1709845290,1709845290.614557,-21600,,
com.burbn.instagram,87,1709845184,1709845271,1709845271.189344,-21600,EB445137-D7F5-57EC-87DA-1DB460D64046,"iPhone13,2"
us.zoom.xos,91,1709845180,1709845271,1709845271.153257,-21600,,
com.google.Chrome,11,1709845169,1709845180,1709845180.086731,-21600,,
us.zoom.xos,0,1709845169,1709845169,1709845169.818053,-21600,,
com.google.Chrome,1,1709845168,1709845169,1709845169.301893,-21600,,
com.burbn.instagram,562,1709844602,1709845164,1709845165.12959,-21600,EB445137-D7F5-57EC-87DA-1DB460D64046,"iPhone13,2"
com.google.Chrome,608,1709844287,1709844895,1709844895.625514,-21600,,
us.zoom.xos,20,1709844267,1709844287,1709844287.2733788,-21600,,
com.google.Chrome,76,1709844191,1709844267,1709844267.624032,-21600,,
com.apple.finder,1,1709844190,1709844191,1709844191.503943,-21600,,
us.zoom.xos,4,1709844186,1709844190,1709844190.5669188,-21600,,
com.google.Chrome,38,1709844148,1709844186,1709844186.153592,-21600,,
us.zoom.xos,14,1709844134,1709844148,1709844148.9400249,-21600,,
com.google.Chrome,0,1709844134,1709844134,1709844134.871564,-21600,,
us.zoom.xos,11,1709844123,1709844134,1709844134.835341,-21600,,
com.google.Chrome,229,1709843894,1709844123,1709844123.265373,-21600,,
com.apple.finder,0,1709843894,1709843894,1709843894.75683,-21600,,
com.microsoft.Word,3,1709843891,1709843894,1709843894.2090402,-21600,,
com.apple.finder,6,1709843885,1709843891,1709843891.124331,-21600,,
com.google.Chrome,16,1709843869,1709843885,1709843885.574448,-21600,,
com.apple.finder,14,1709843855,1709843869,1709843869.617961,-21600,,
us.zoom.xos,3,1709843852,1709843855,1709843855.075789,-21600,,
com.apple.finder,0,1709843852,1709843852,1709843852.93743,-21600,,
com.google.Chrome,28,1709843824,1709843852,1709843852.327753,-21600,,
com.apple.finder,2,1709843799,1709843801,1709843801.822299,-21600,,
com.google.Chrome,34,1709843765,1709843799,1709843799.856425,-21600,,
us.zoom.xos,4,1709843761,1709843765,1709843765.572321,-21600,,
com.google.Chrome,33,1709843728,1709843761,1709843761.283052,-21600,,
us.zoom.xos,23,1709843705,1709843728,1709843728.155679,-21600,,
com.google.Chrome,366,1709843339,1709843705,1709843705.323923,-21600,,
us.zoom.xos,23,1709843316,1709843339,1709843339.093488,-21600,,
com.google.Chrome,153,1709843163,1709843316,1709843316.8946939,-21600,,
us.zoom.xos,9,1709843154,1709843163,1709843163.169101,-21600,,
com.google.Chrome,108,1709843046,1709843154,1709843154.9132671,-21600,,
us.zoom.xos,7,1709843039,1709843046,1709843046.481512,-21600,,
com.google.Chrome,12,1709843027,1709843039,1709843039.807136,-21600,,
us.zoom.xos,5,1709843022,1709843027,1709843027.493216,-21600,,
com.google.Chrome,232,1709842790,1709843022,1709843022.244992,-21600,,
us.zoom.xos,54,1709842736,1709842790,1709842790.636446,-21600,,
com.google.Chrome,291,1709842445,1709842736,1709842736.3176498,-21600,,
us.zoom.xos,1,1709842444,1709842445,1709842445.731165,-21600,,
com.google.Chrome,344,1709842100,1709842444,1709842444.499599,-21600,,
us.zoom.xos,61,1709842039,1709842100,1709842100.663594,-21600,,
com.google.Chrome,7,1709842032,1709842039,1709842039.8360329,-21600,,
com.hnc.Discord,135,1709841897,1709842032,1709842032.869492,-21600,,
com.google.Chrome,2,1709841895,1709841897,1709841897.7961202,-21600,,
com.hnc.Discord,9,1709841886,1709841895,1709841895.401716,-21600,,
com.apple.finder,15,1709841871,1709841886,1709841886.285439,-21600,,
com.hnc.Discord,1,1709841870,1709841871,1709841871.473352,-21600,,
us.zoom.xos,1,1709841869,1709841870,1709841870.4968219,-21600,,
com.hnc.Discord,39,1709841830,1709841869,1709841869.8708138,-21600,,
us.zoom.xos,10,1709841820,1709841830,1709841830.555692,-21600,,
com.hnc.Discord,4,1709841816,1709841820,1709841820.832121,-21600,,
com.google.Chrome,20,1709841796,1709841816,1709841816.512878,-21600,,
com.apple.finder,39,1709841757,1709841796,1709841796.638873,-21600,,
com.apple.Preview,5,1709841752,1709841757,1709841757.907073,-21600,,
com.apple.finder,5,1709841747,1709841752,1709841752.154835,-21600,,
com.google.Chrome,1,1709841746,1709841747,1709841747.140317,-21600,,
us.zoom.xos,1,1709841745,1709841746,1709841746.3936129,-21600,,
com.google.Chrome,2,1709841743,1709841745,1709841745.625125,-21600,,
com.apple.Notes,1,1709841742,1709841743,1709841744.062093,-21600,,
com.google.Chrome,6,1709841736,1709841742,1709841742.5843081,-21600,,
com.apple.finder,4,1709841732,1709841736,1709841736.6052651,-21600,,
us.zoom.xos,57,1709841675,1709841732,1709841732.9739208,-21600,,
com.apple.finder,70,1709841605,1709841675,1709841675.988128,-21600,,
com.google.Chrome,4,1709841601,1709841605,1709841605.348803,-21600,,
us.zoom.xos,39,1709841562,1709841601,1709841601.448265,-21600,,
com.google.Chrome,2,1709841560,1709841562,1709841563.0094671,-21600,,
us.zoom.xos,1,1709841559,1709841560,1709841560.2883902,-21600,,
com.google.Chrome,4,1709841555,1709841559,1709841559.266226,-21600,,
com.apple.finder,14,1709841541,1709841555,1709841555.588119,-21600,,
com.google.Chrome,7,1709841534,1709841541,1709841541.261734,-21600,,
com.apple.finder,7,1709841527,1709841534,1709841534.313371,-21600,,
com.google.Chrome,12,1709841515,1709841527,1709841527.213262,-21600,,
com.google.Chrome,357,1709840043,1709840400,1709840400.458072,-21600,,
com.google.Chrome,490,1709839544,1709840034,1709840034.559371,-21600,,
com.google.Chrome,654,1709838769,1709839423,1709839423.7012239,-21600,,
com.apple.MobileSMS,57,1709838662,1709838719,1709838719.2351,-21600,,
com.google.Chrome,2,1709838660,1709838662,1709838662.175638,-21600,,
com.google.Chrome,208,1709838063,1709838271,1709838271.597896,-21600,,
com.google.Chrome,488,1709835365,1709835853,1709835853.176941,-21600,,
com.google.Chrome,306,1709834382,1709834688,1709834688.192844,-21600,,
com.google.Chrome,85,1709831987,1709832072,1709832072.81864,-21600,,
com.apple.finder,13,1709831974,1709831987,1709831987.224884,-21600,,
com.google.Chrome,19,1709831955,1709831974,1709831974.144733,-21600,,
com.apple.finder,13,1709831942,1709831955,1709831956.019555,-21600,,
com.apple.Preview,57,1709831885,1709831942,1709831942.7151551,-21600,,
com.google.Chrome,4,1709831881,1709831885,1709831885.749331,-21600,,
com.apple.Preview,17,1709831864,1709831881,1709831881.604892,-21600,,
com.google.Chrome,2,1709831862,1709831864,1709831864.477823,-21600,,
com.apple.Preview,18,1709831844,1709831862,1709831862.400186,-21600,,
com.google.Chrome,1,1709831843,1709831844,1709831844.685485,-21600,,
com.apple.Preview,2,1709831841,1709831843,1709831843.359312,-21600,,
com.google.Chrome,1,1709831840,1709831841,1709831841.900581,-21600,,
com.apple.Preview,3,1709831837,1709831840,1709831841.025185,-21600,,
com.google.Chrome,11,1709831826,1709831837,1709831837.394517,-21600,,
com.apple.Preview,2,1709831824,1709831826,1709831826.631001,-21600,,
com.google.Chrome,6,1709831818,1709831824,1709831824.457509,-21600,,
com.apple.Preview,14,1709831804,1709831818,1709831818.3760371,-21600,,
com.google.Chrome,34,1709831770,1709831804,1709831804.256963,-21600,,
com.apple.Preview,4,1709831766,1709831770,1709831771.046173,-21600,,
com.google.Chrome,5,1709831761,1709831766,1709831766.080481,-21600,,
com.apple.Preview,16,1709831745,1709831761,1709831761.6307058,-21600,,
com.google.Chrome,7,1709831738,1709831745,1709831746.011952,-21600,,
com.apple.Preview,9,1709831729,1709831738,1709831738.270607,-21600,,
com.google.Chrome,19,1709831710,1709831729,1709831729.138355,-21600,,
com.apple.Preview,2,1709831708,1709831710,1709831710.608156,-21600,,
com.google.Chrome,7,1709831701,1709831708,1709831708.272641,-21600,,
com.apple.Preview,6,1709831695,1709831701,1709831702.0305119,-21600,,
com.google.Chrome,3,1709831692,1709831695,1709831695.683281,-21600,,
com.apple.Preview,35,1709831657,1709831692,1709831692.132612,-21600,,
com.google.Chrome,4,1709831653,1709831657,1709831657.0861201,-21600,,
com.apple.Preview,7,1709831646,1709831653,1709831653.178937,-21600,,
com.google.Chrome,2,1709831644,1709831646,1709831646.7288508,-21600,,
com.apple.Preview,3,1709831641,1709831644,1709831644.882595,-21600,,
com.google.Chrome,12,1709831629,1709831641,1709831641.825949,-21600,,
com.apple.Preview,16,1709831613,1709831629,1709831629.104185,-21600,,
com.google.Chrome,10,1709831603,1709831613,1709831613.591388,-21600,,
com.apple.Preview,8,1709831595,1709831603,1709831603.249089,-21600,,
com.google.Chrome,1,1709831594,1709831595,1709831595.607847,-21600,,
com.apple.Preview,1,1709831593,1709831594,1709831594.949839,-21600,,
com.google.Chrome,7,1709831586,1709831593,1709831593.132309,-21600,,
com.apple.Preview,1,1709831585,1709831586,1709831586.191733,-21600,,
com.google.Chrome,2,1709831583,1709831585,1709831585.4721851,-21600,,
com.apple.Preview,7,1709831576,1709831583,1709831583.184458,-21600,,
com.google.Chrome,12,1709831564,1709831576,1709831576.6251569,-21600,,
com.apple.Preview,23,1709831541,1709831564,1709831564.153542,-21600,,
com.google.Chrome,25,1709831516,1709831541,1709831541.3863459,-21600,,
com.apple.Preview,2,1709831514,1709831516,1709831516.148288,-21600,,
com.google.Chrome,6,1709831508,1709831514,1709831514.536572,-21600,,
com.apple.Preview,17,1709831491,1709831508,1709831508.22047,-21600,,
com.google.Chrome,3,1709831488,1709831491,1709831491.3983889,-21600,,
com.apple.Preview,2,1709831486,1709831488,1709831488.470566,-21600,,
com.google.Chrome,2,1709831484,1709831486,1709831486.114604,-21600,,
com.apple.Preview,5,1709831479,1709831484,1709831484.532254,-21600,,
com.google.Chrome,2,1709831477,1709831479,1709831479.1048589,-21600,,
com.apple.Preview,1,1709831476,1709831477,1709831477.78718,-21600,,
com.google.Chrome,5,1709831471,1709831476,1709831476.420563,-21600,,
com.apple.Preview,4,1709831467,1709831471,1709831472.0542378,-21600,,
com.google.Chrome,1,1709831466,1709831467,1709831467.654845,-21600,,
com.apple.Preview,6,1709831460,1709831466,1709831466.8647308,-21600,,
com.google.Chrome,4,1709831456,1709831460,1709831460.7292042,-21600,,
com.apple.Preview,11,1709831445,1709831456,1709831456.2737532,-21600,,
com.google.Chrome,7,1709831438,1709831445,1709831445.948625,-21600,,
com.apple.Preview,5,1709831433,1709831438,1709831438.3629751,-21600,,
com.google.Chrome,5,1709831428,1709831433,1709831433.659639,-21600,,
com.apple.Preview,2,1709831426,1709831428,1709831428.988453,-21600,,
com.google.Chrome,8,1709831418,1709831426,1709831426.3668299,-21600,,
com.apple.Preview,3,1709831415,1709831418,1709831418.468831,-21600,,
com.google.Chrome,0,1709831415,1709831415,1709831415.932576,-21600,,
com.apple.Preview,8,1709831407,1709831415,1709831415.474018,-21600,,
com.google.Chrome,1,1709831406,1709831407,1709831407.62961,-21600,,
com.apple.Preview,6,1709831400,1709831406,1709831406.709083,-21600,,
com.google.Chrome,6,1709831394,1709831400,1709831400.935313,-21600,,
com.apple.Preview,2,1709831392,1709831394,1709831395.0297751,-21600,,
com.google.Chrome,1,1709831391,1709831392,1709831392.813696,-21600,,
com.apple.Preview,3,1709831388,1709831391,1709831391.706965,-21600,,
com.google.Chrome,1,1709831387,1709831388,1709831388.792063,-21600,,
com.apple.Preview,38,1709831349,1709831387,1709831387.384153,-21600,,
com.google.Chrome,10,1709831339,1709831349,1709831349.302269,-21600,,
com.apple.Preview,10,1709831329,1709831339,1709831339.499793,-21600,,
com.google.Chrome,1,1709831328,1709831329,1709831329.21734,-21600,,
com.apple.Preview,10,1709831318,1709831328,1709831328.3812962,-21600,,
com.google.Chrome,2,1709831316,1709831318,1709831318.428875,-21600,,
com.apple.Preview,4,1709831312,1709831316,1709831316.284562,-21600,,
com.google.Chrome,3,1709831309,1709831312,1709831312.688518,-21600,,
com.apple.Preview,3,1709831306,1709831309,1709831309.923846,-21600,,
com.google.Chrome,2,1709831304,1709831306,1709831306.195239,-21600,,
com.apple.Preview,3,1709831301,1709831304,1709831304.916368,-21600,,
com.google.Chrome,0,1709831301,1709831301,1709831301.9565969,-21600,,
com.apple.Preview,2,1709831299,1709831301,1709831301.103994,-21600,,
com.google.Chrome,5,1709831294,1709831299,1709831299.723884,-21600,,
com.apple.Preview,1,1709831293,1709831294,1709831294.3512712,-21600,,
com.google.Chrome,3,1709831290,1709831293,1709831293.642438,-21600,,
com.apple.Preview,5,1709831285,1709831290,1709831290.103663,-21600,,
com.google.Chrome,7,1709831278,1709831285,1709831285.257856,-21600,,
com.apple.Preview,1,1709831277,1709831278,1709831278.314715,-21600,,
com.google.Chrome,2,1709831275,1709831277,1709831277.394443,-21600,,
com.apple.Preview,4,1709831271,1709831275,1709831275.6173701,-21600,,
com.google.Chrome,20,1709831251,1709831271,1709831271.580955,-21600,,
com.apple.Preview,2,1709831249,1709831251,1709831251.5826468,-21600,,
com.google.Chrome,3,1709831246,1709831249,1709831249.5986118,-21600,,
com.apple.Preview,0,1709831246,1709831246,1709831246.82881,-21600,,
com.google.Chrome,17,1709831229,1709831246,1709831246.242859,-21600,,
com.apple.Preview,2,1709831227,1709831229,1709831229.375782,-21600,,
com.google.Chrome,0,1709831227,1709831227,1709831227.53797,-21600,,
com.apple.Preview,2,1709831225,1709831227,1709831227.107192,-21600,,
com.google.Chrome,3,1709831222,1709831225,1709831225.709105,-21600,,
com.apple.Preview,16,1709831206,1709831222,1709831222.505573,-21600,,
com.google.Chrome,20,1709831186,1709831206,1709831206.572106,-21600,,
com.apple.Preview,6,1709831180,1709831186,1709831186.3874888,-21600,,
com.google.Chrome,2,1709831178,1709831180,1709831180.906775,-21600,,
com.apple.Preview,7,1709831171,1709831178,1709831178.504047,-21600,,
com.google.Chrome,3,1709831168,1709831171,1709831172.000056,-21600,,
com.apple.Preview,2,1709831166,1709831168,1709831168.725745,-21600,,
com.google.Chrome,5,1709831161,1709831166,1709831166.3852758,-21600,,
com.apple.Preview,1,1709831160,1709831161,1709831161.484816,-21600,,
com.google.Chrome,1,1709831159,1709831160,1709831160.8443542,-21600,,
com.apple.finder,1,1709831158,1709831159,1709831159.840948,-21600,,
com.apple.Preview,6,1709831152,1709831158,1709831158.653671,-21600,,
com.apple.finder,9,1709831143,1709831152,1709831152.4171,-21600,,
com.google.Chrome,21,1709831122,1709831143,1709831143.9057941,-21600,,
com.apple.finder,2,1709831120,1709831122,1709831123.039448,-21600,,
com.apple.Preview,36,1709831084,1709831120,1709831120.302956,-21600,,
com.apple.finder,3,1709831081,1709831084,1709831084.192714,-21600,,
com.google.Chrome,1765,1709829316,1709831081,1709831081.6981292,-21600,,
com.microsoft.Word,1,1709829315,1709829316,1709829316.549055,-21600,,
com.google.Chrome,5,1709829310,1709829315,1709829315.4220881,-21600,,
com.microsoft.Word,1,1709829309,1709829310,1709829310.9920511,-21600,,
com.google.Chrome,4,1709829305,1709829309,1709829309.881713,-21600,,
com.microsoft.Word,2,1709829303,1709829305,1709829305.63969,-21600,,
com.google.Chrome,3,1709829300,1709829303,1709829303.46036,-21600,,
com.microsoft.Word,1,1709829299,1709829300,1709829300.997864,-21600,,
com.google.Chrome,3,1709829296,1709829299,1709829299.445142,-21600,,
com.microsoft.Word,3,1709829293,1709829296,1709829296.866588,-21600,,
com.google.Chrome,17,1709829276,1709829293,1709829293.826185,-21600,,
com.microsoft.Word,246,1709829030,1709829276,1709829276.596366,-21600,,
com.apple.Notes,15,1709829015,1709829030,1709829030.421637,-21600,,
com.apple.Notes,355,1709828300,1709828655,1709828655.9575229,-21600,,
com.microsoft.Word,413,1709827887,1709828300,1709828300.8067389,-21600,,
com.google.Chrome,25,1709827862,1709827887,1709827887.3941488,-21600,,
com.microsoft.Word,2,1709827860,1709827862,1709827862.53292,-21600,,
com.apple.finder,1,1709827859,1709827860,1709827860.8755589,-21600,,
com.apple.Preview,119,1709827740,1709827859,1709827859.330359,-21600,,
com.apple.finder,2,1709827738,1709827740,1709827740.5558429,-21600,,
com.google.Chrome,5,1709827733,1709827738,1709827739.073945,-21600,,
com.microsoft.Word,18,1709827715,1709827733,1709827733.534678,-21600,,
com.apple.finder,0,1709827715,1709827715,1709827715.4305801,-21600,,
com.microsoft.Word,7,1709827708,1709827715,1709827715.109719,-21600,,
com.apple.finder,1,1709827707,1709827708,1709827708.88723,-21600,,
com.google.Chrome,1,1709827706,1709827707,1709827707.1677651,-21600,,
com.apple.finder,25,1709827681,1709827706,1709827706.306638,-21600,,
com.google.Chrome,614,1709827067,1709827681,1709827681.8167892,-21600,,
com.google.Chrome,9,1709825833,1709825842,1709825842.368991,-21600,,
com.google.Chrome,332,1709825500,1709825832,1709825832.150865,-21600,,
com.leomehlig.today,4,1709825496,1709825500,1709825500.8429232,-21600,,
com.leomehlig.today,44,1709825077,1709825121,1709825121.772032,-21600,,
com.microsoft.VSCode,11,1709825066,1709825077,1709825077.777742,-21600,,
com.leomehlig.today,8,1709825058,1709825066,1709825066.094661,-21600,,
com.microsoft.rdc.macos,346,1709824712,1709825058,1709825058.753248,-21600,,
com.google.Chrome,151,1709824561,1709824712,1709824712.6075711,-21600,,
com.leomehlig.today,9,1709824552,1709824561,1709824561.367408,-21600,,
com.microsoft.VSCode,1,1709824551,1709824552,1709824553.034008,-21600,,
com.google.Chrome,396,1709824155,1709824551,1709824551.297507,-21600,,
com.microsoft.rdc.macos,3,1709824152,1709824155,1709824157.468262,-21600,,
com.microsoft.rdc.macos,276,1709787629,1709787905,1709787905.606221,-21600,,
com.google.Chrome,3,1709787626,1709787629,1709787629.139879,-21600,,
com.google.Chrome,36,1709787525,1709787561,1709787561.9743009,-21600,,
com.google.Chrome,305,1709786659,1709786964,1709786964.674063,-21600,,
com.google.Chrome,441,1709786180,1709786621,1709786621.201376,-21600,,
com.google.Chrome,340,1709784848,1709785188,1709785188.1965141,-21600,,
com.microsoft.rdc.macos,61,1709784787,1709784848,1709784848.6304278,-21600,,
com.microsoft.rdc.macos,355,1709780400,1709780755,1709780755.837407,-21600,,
com.google.Chrome,4,1709780396,1709780400,1709780400.887344,-21600,,
com.google.Chrome,345,1709776635,1709776980,1709776980.282548,-21600,,
com.google.Chrome,455,1709774011,1709774466,1709774466.479455,-21600,,
com.google.Chrome,424,1709773461,1709773885,1709773885.330852,-21600,,
com.google.Chrome,302,1709773064,1709773366,1709773366.5800881,-21600,,
com.google.Chrome,356,1709772043,1709772399,1709772399.129589,-21600,,
com.google.Chrome,403,1709770672,1709771075,1709771075.884289,-21600,,
com.microsoft.rdc.macos,53,1709770619,1709770672,1709770672.115532,-21600,,
com.google.Chrome,6,1709770613,1709770619,1709770619.8373032,-21600,,
com.google.Chrome,10,1709767518,1709767528,1709767528.332312,-21600,,
com.google.Chrome,309,1709766873,1709767182,1709767182.6142812,-21600,,
com.google.Chrome,314,1709766174,1709766488,1709766488.749155,-21600,,
com.google.Chrome,531,1709765586,1709766117,1709766117.4921741,-21600,,
com.google.Chrome,668,1709764744,1709765412,1709765412.534152,-21600,,
com.google.Chrome,854,1709763337,1709764191,1709764191.071626,-21600,,
com.google.Chrome,740,1709762320,1709763060,1709763060.463803,-21600,,
com.google.Chrome,1003,1709761300,1709762303,1709762303.501594,-21600,,
com.google.Chrome,15,1709761167,1709761182,1709761182.8901901,-21600,,
com.google.Chrome,653,1709760388,1709761041,1709761041.113714,-21600,,
com.google.Chrome,454,1709759758,1709760212,1709760212.4662619,-21600,,
com.google.Chrome,1751,1709757499,1709759250,1709759250.815785,-21600,,
com.microsoft.rdc.macos,410,1709757089,1709757499,1709757500.429998,-21600,,
com.google.Chrome,300,1709756732,1709757032,1709757032.930573,-21600,,
com.google.Chrome,504,1709750444,1709750948,1709750948.7947068,-21600,,
com.google.Chrome,384,1709749702,1709750086,1709750086.2111459,-21600,,
com.microsoft.VSCode,8,1709749694,1709749702,1709749702.6229649,-21600,,
com.microsoft.VSCode,403,1709742233,1709742636,1709742636.055537,-21600,,
com.google.Chrome,1,1709742232,1709742233,1709742234.0123801,-21600,,
com.microsoft.VSCode,55,1709742177,1709742232,1709742232.405123,-21600,,
com.google.Chrome,1,1709742176,1709742177,1709742177.4828181,-21600,,
com.microsoft.VSCode,449,1709741727,1709742176,1709742176.555083,-21600,,
com.google.Chrome,173,1709741554,1709741727,1709741727.5993528,-21600,,
com.microsoft.VSCode,241,1709741313,1709741554,1709741555.006034,-21600,,
com.google.Chrome,179,1709741134,1709741313,1709741313.991239,-21600,,
com.microsoft.VSCode,670,1709740464,1709741134,1709741134.8813128,-21600,,
com.google.Chrome,218,1709740246,1709740464,1709740464.570819,-21600,,
com.microsoft.VSCode,142,1709740104,1709740246,1709740246.386224,-21600,,
com.leomehlig.today,12,1709740092,1709740104,1709740104.374969,-21600,,
com.microsoft.VSCode,53,1709740039,1709740092,1709740092.523549,-21600,,
com.google.Chrome,55,1709739984,1709740039,1709740039.7046509,-21600,,
com.microsoft.VSCode,242,1709739742,1709739984,1709739984.267842,-21600,,
com.google.Chrome,139,1709739603,1709739742,1709739742.3764071,-21600,,
com.microsoft.VSCode,564,1709739039,1709739603,1709739603.947562,-21600,,
com.google.Chrome,88,1709738951,1709739039,1709739039.350625,-21600,,
com.microsoft.VSCode,18,1709738933,1709738951,1709738951.731982,-21600,,
com.google.Chrome,2,1709738931,1709738933,1709738933.200135,-21600,,
com.microsoft.VSCode,12,1709738919,1709738931,1709738931.290997,-21600,,
com.google.Chrome,1,1709738918,1709738919,1709738919.483004,-21600,,
com.microsoft.VSCode,4,1709738914,1709738918,1709738918.796793,-21600,,
com.google.Chrome,209,1709738705,1709738914,1709738914.453609,-21600,,
com.google.Chrome,801,1709698506,1709699307,1709699307.662833,-21600,,
com.google.Chrome,306,1709697682,1709697988,1709697988.1563358,-21600,,
com.google.Chrome,441,1709697100,1709697541,1709697541.5500832,-21600,,
com.apple.MobileSMS,6,1709697094,1709697100,1709697100.2852101,-21600,,
com.google.Chrome,1,1709697093,1709697094,1709697094.609253,-21600,,
com.leomehlig.today,17,1709697076,1709697093,1709697093.941337,-21600,,
com.leomehlig.today,23,1709696527,1709696550,1709696550.431316,-21600,,
com.google.Chrome,2,1709696525,1709696527,1709696527.640779,-21600,,
com.microsoft.VSCode,81,1709696444,1709696525,1709696525.1448011,-21600,,
com.google.Chrome,1,1709696443,1709696444,1709696444.146426,-21600,,
com.microsoft.VSCode,2,1709696441,1709696443,1709696443.4085898,-21600,,
com.google.Chrome,1,1709696440,1709696441,1709696441.641876,-21600,,
com.microsoft.VSCode,22,1709696418,1709696440,1709696440.720645,-21600,,
com.google.Chrome,2,1709696416,1709696418,1709696418.264338,-21600,,
com.microsoft.VSCode,13,1709696403,1709696416,1709696416.6681728,-21600,,
com.google.Chrome,7,1709696396,1709696403,1709696403.939447,-21600,,
com.microsoft.VSCode,364,1709696032,1709696396,1709696396.252089,-21600,,
com.google.Chrome,1,1709696031,1709696032,1709696032.6174831,-21600,,
com.microsoft.VSCode,7,1709696024,1709696031,1709696031.719327,-21600,,
com.google.Chrome,0,1709696024,1709696024,1709696024.868876,-21600,,
com.microsoft.VSCode,3,1709696021,1709696024,1709696024.112043,-21600,,
com.google.Chrome,14,1709696007,1709696021,1709696022.064733,-21600,,
com.microsoft.VSCode,622,1709695385,1709696007,1709696007.274518,-21600,,
com.google.Chrome,2,1709695383,1709695385,1709695385.489053,-21600,,
com.google.Chrome,263,1709691642,1709691905,1709691905.886821,-21600,,
com.leomehlig.today,4,1709691638,1709691642,1709691643.566733,-21600,,
com.microsoft.VSCode,39,1709691599,1709691638,1709691638.550994,-21600,,
com.google.Chrome,30,1709691569,1709691599,1709691600.065072,-21600,,
com.leomehlig.today,34,1709691535,1709691569,1709691569.9170861,-21600,,
com.google.Chrome,1032,1709690503,1709691535,1709691535.298239,-21600,,
com.google.Chrome,1450,1709688593,1709690043,1709690043.6405668,-21600,,
com.leomehlig.today,29,1709688564,1709688593,1709688593.079382,-21600,,
com.google.Chrome,6,1709688558,1709688564,1709688564.9160872,-21600,,
com.leomehlig.today,84,1709688474,1709688558,1709688558.860784,-21600,,
com.google.Chrome,167,1709688307,1709688474,1709688474.818047,-21600,,
com.google.Chrome,304,1709686380,1709686684,1709686684.144995,-21600,,
com.google.Chrome,307,1709685859,1709686166,1709686166.441473,-21600,,
com.google.Chrome,307,1709685547,1709685854,1709685854.6206899,-21600,,
com.google.Chrome,699,1709684603,1709685302,1709685302.459735,-21600,,
com.apple.MobileSMS,15,1709684588,1709684603,1709684603.7340112,-21600,,
com.google.Chrome,20,1709684568,1709684588,1709684588.715627,-21600,,
com.apple.MobileSMS,14,1709684554,1709684568,1709684568.2537398,-21600,,
com.google.Chrome,49,1709684505,1709684554,1709684554.9626908,-21600,,
com.leomehlig.today,5,1709684500,1709684505,1709684505.74071,-21600,,
com.google.Chrome,3,1709684497,1709684500,1709684501.026425,-21600,,
com.leomehlig.today,3,1709684494,1709684497,1709684497.927532,-21600,,
com.apple.MobileSMS,81,1709684413,1709684494,1709684494.348658,-21600,,
com.leomehlig.today,18,1709684395,1709684413,1709684413.836636,-21600,,
com.google.Chrome,2,1709684393,1709684395,1709684395.478363,-21600,,
com.google.Chrome,10,1709673974,1709673984,1709673984.4052749,-21600,,
us.zoom.xos,294,1709673680,1709673974,1709673974.9647489,-21600,,
us.zoom.xos,300,1709672721,1709673021,1709673021.1278238,-21600,,
com.google.Chrome,42,1709672679,1709672721,1709672721.194001,-21600,,
us.zoom.xos,24,1709672655,1709672679,1709672680.0276399,-21600,,
com.google.Chrome,223,1709672432,1709672655,1709672655.063154,-21600,,
us.zoom.xos,3,1709672429,1709672432,1709672432.13653,-21600,,
com.google.Chrome,203,1709672226,1709672429,1709672429.6392798,-21600,,
us.zoom.xos,0,1709672226,1709672226,1709672226.91648,-21600,,
com.google.Chrome,268,1709671958,1709672226,1709672226.07569,-21600,,
us.zoom.xos,3,1709671955,1709671958,1709671958.680655,-21600,,
com.google.Chrome,91,1709671864,1709671955,1709671955.865593,-21600,,
us.zoom.xos,30,1709671834,1709671864,1709671864.30037,-21600,,
com.google.Chrome,185,1709671649,1709671834,1709671834.75244,-21600,,
us.zoom.xos,14,1709671635,1709671649,1709671649.5120668,-21600,,
com.google.Chrome,59,1709671576,1709671635,1709671635.4672341,-21600,,
us.zoom.xos,6,1709671570,1709671576,1709671576.800843,-21600,,
us.zoom.xos,917,1709670519,1709671436,1709671436.398346,-21600,,
com.google.Chrome,18,1709670501,1709670519,1709670519.847614,-21600,,
us.zoom.xos,7,1709670494,1709670501,1709670501.506946,-21600,,
com.google.Chrome,13,1709670481,1709670494,1709670494.1197371,-21600,,
us.zoom.xos,310,1709670171,1709670481,1709670481.1180382,-21600,,
com.google.Chrome,446,1709669725,1709670171,1709670171.483412,-21600,,
us.zoom.xos,10,1709669715,1709669725,1709669725.477169,-21600,,
com.google.Chrome,215,1709669500,1709669715,1709669715.177412,-21600,,
us.zoom.xos,7,1709669493,1709669500,1709669501.0173712,-21600,,
com.google.Chrome,532,1709668961,1709669493,1709669493.647285,-21600,,
com.microsoft.Outlook,17,1709668944,1709668961,1709668961.873248,-21600,,
com.google.Chrome,9,1709668935,1709668944,1709668944.240325,-21600,,
com.microsoft.Outlook,1,1709668934,1709668935,1709668935.990487,-21600,,
com.google.Chrome,7,1709668927,1709668934,1709668935.10359,-21600,,
us.zoom.xos,35,1709668892,1709668927,1709668927.373845,-21600,,
com.google.Chrome,0,1709668892,1709668892,1709668892.866291,-21600,,
us.zoom.xos,1,1709668891,1709668892,1709668892.126418,-21600,,
com.google.Chrome,1,1709668890,1709668891,1709668891.625824,-21600,,
us.zoom.xos,3,1709668887,1709668890,1709668890.335483,-21600,,
com.google.Chrome,22,1709668865,1709668887,1709668887.630169,-21600,,
com.leomehlig.today,6,1709668859,1709668865,1709668867.037112,-21600,,
com.leomehlig.today,83,1709666201,1709666284,1709666284.5761518,-21600,,
com.apple.iCal,5,1709666196,1709666201,1709666201.4261699,-21600,,
com.leomehlig.today,34,1709666162,1709666196,1709666196.890296,-21600,,
com.microsoft.VSCode,641,1709665521,1709666162,1709666162.180958,-21600,,
com.apple.finder,6,1709665515,1709665521,1709665521.86094,-21600,,
com.leomehlig.today,1,1709665514,1709665515,1709665515.812364,-21600,,
com.google.Chrome,3,1709665511,1709665514,1709665514.768297,-21600,,
com.leomehlig.today,17,1709665494,1709665511,1709665511.8450441,-21600,,
com.google.Chrome,21,1709665473,1709665494,1709665494.3503408,-21600,,
com.apple.finder,9,1709665464,1709665473,1709665473.494011,-21600,,
com.apple.Preview,6,1709665458,1709665464,1709665464.841354,-21600,,
com.apple.finder,2,1709665456,1709665458,1709665458.770066,-21600,,
com.google.Chrome,32,1709665424,1709665456,1709665456.940669,-21600,,
com.apple.Preview,11,1709665413,1709665424,1709665424.237284,-21600,,
com.google.Chrome,4,1709665409,1709665413,1709665413.026781,-21600,,
com.apple.Preview,7,1709665402,1709665409,1709665409.1249151,-21600,,
com.google.Chrome,21,1709665381,1709665402,1709665402.5684729,-21600,,
com.apple.Preview,9,1709665372,1709665381,1709665381.793608,-21600,,
com.google.Chrome,1,1709665371,1709665372,1709665372.122158,-21600,,
com.apple.Preview,1,1709665370,1709665371,1709665371.519866,-21600,,
com.google.Chrome,1,1709665369,1709665370,1709665370.623867,-21600,,
com.apple.Preview,5,1709665364,1709665369,1709665369.08709,-21600,,
com.google.Chrome,52,1709665312,1709665364,1709665364.842139,-21600,,
com.apple.Preview,14,1709665298,1709665312,1709665312.329133,-21600,,
com.google.Chrome,6,1709665292,1709665298,1709665298.0518131,-21600,,
com.apple.Preview,14,1709665278,1709665292,1709665292.1780648,-21600,,
com.google.Chrome,1,1709665277,1709665278,1709665278.957943,-21600,,
com.apple.Preview,1,1709665276,1709665277,1709665278.003168,-21600,,
com.google.Chrome,19,1709665257,1709665276,1709665276.919838,-21600,,
com.apple.Preview,13,1709665244,1709665257,1709665258.117388,-21600,,
com.google.Chrome,19,1709665225,1709665244,1709665245.0470319,-21600,,
com.apple.Preview,13,1709665212,1709665225,1709665225.8695378,-21600,,
com.google.Chrome,1,1709665211,1709665212,1709665212.536244,-21600,,
com.apple.Preview,4,1709665207,1709665211,1709665211.426486,-21600,,
com.google.Chrome,10,1709665197,1709665207,1709665207.081723,-21600,,
com.apple.Preview,10,1709665187,1709665197,1709665197.911093,-21600,,
com.apple.finder,10,1709665177,1709665187,1709665187.872196,-21600,,
com.apple.Preview,9,1709665168,1709665177,1709665177.3186831,-21600,,
com.apple.finder,0,1709665168,1709665168,1709665169.082254,-21600,,
com.apple.Preview,4,1709665164,1709665168,1709665168.5398479,-21600,,
com.apple.finder,2,1709665162,1709665164,1709665164.899179,-21600,,
com.google.Chrome,23,1709665139,1709665162,1709665162.340222,-21600,,
com.leomehlig.today,6,1709665133,1709665139,1709665139.9900432,-21600,,
com.leomehlig.today,70,1709657914,1709657984,1709657984.5663319,-21600,,
com.google.Chrome,754,1709657160,1709657914,1709657914.285603,-21600,,
com.leomehlig.today,3,1709657157,1709657160,1709657160.2628489,-21600,,
com.google.Chrome,845,1709656312,1709657157,1709657157.568675,-21600,,
com.leomehlig.today,2,1709656310,1709656312,1709656312.371043,-21600,,
com.google.Chrome,2873,1709653437,1709656310,1709656310.835269,-21600,,
com.leomehlig.today,23,1709653414,1709653437,1709653438.8952498,-21600,,
com.google.Chrome,10,1709653404,1709653414,1709653414.48379,-21600,,
com.google.Chrome,1981,1709613528,1709615509,1709615509.330358,-21600,,
com.apple.finder,3,1709613525,1709613528,1709613528.198529,-21600,,
com.apple.finder,27,1709610268,1709610295,1709610295.945822,-21600,,
com.leomehlig.today,9,1709610259,1709610268,1709610268.722145,-21600,,
com.apple.finder,5,1709610254,1709610259,1709610259.722153,-21600,,
com.microsoft.Excel,2,1709610252,1709610254,1709610254.506802,-21600,,
com.apple.finder,83,1709610169,1709610252,1709610252.831801,-21600,,
com.microsoft.Excel,14,1709610155,1709610169,1709610169.761787,-21600,,
com.leomehlig.today,3,1709610152,1709610155,1709610155.95368,-21600,,
com.microsoft.Excel,3,1709610149,1709610152,1709610152.769192,-21600,,
com.leomehlig.today,14,1709610135,1709610149,1709610149.218298,-21600,,
com.microsoft.Excel,3,1709610132,1709610135,1709610135.517252,-21600,,
com.leomehlig.today,7,1709610125,1709610132,1709610132.662987,-21600,,
com.microsoft.Excel,2,1709610123,1709610125,1709610125.650041,-21600,,
com.leomehlig.today,1,1709610122,1709610123,1709610123.4552221,-21600,,
com.microsoft.Excel,3,1709610119,1709610122,1709610122.228622,-21600,,
com.leomehlig.today,11,1709610108,1709610119,1709610119.473322,-21600,,
com.microsoft.Excel,6,1709610102,1709610108,1709610108.590884,-21600,,
com.leomehlig.today,8,1709610094,1709610102,1709610102.096561,-21600,,
com.microsoft.Excel,3,1709610091,1709610094,1709610094.3010612,-21600,,
com.leomehlig.today,3,1709610088,1709610091,1709610091.911407,-21600,,
com.microsoft.Excel,5,1709610083,1709610088,1709610088.64697,-21600,,
com.leomehlig.today,27,1709610056,1709610083,1709610083.945774,-21600,,
com.microsoft.Excel,6,1709610050,1709610056,1709610056.112321,-21600,,
com.leomehlig.today,8,1709610042,1709610050,1709610050.940867,-21600,,
com.microsoft.Excel,44,1709609998,1709610042,1709610042.211753,-21600,,
com.leomehlig.today,3,1709609995,1709609998,1709609998.767027,-21600,,
com.microsoft.Excel,2,1709609993,1709609995,1709609995.783794,-21600,,
com.leomehlig.today,7,1709609986,1709609993,1709609993.153158,-21600,,
com.microsoft.Excel,4,1709609982,1709609986,1709609986.383491,-21600,,
com.leomehlig.today,7,1709609975,1709609982,1709609982.311275,-21600,,
com.microsoft.Excel,4,1709609971,1709609975,1709609975.599028,-21600,,
com.leomehlig.today,9,1709609962,1709609971,1709609971.94505,-21600,,
com.microsoft.Excel,58,1709609904,1709609962,1709609962.46706,-21600,,
com.apple.finder,19,1709609885,1709609904,1709609904.9124231,-21600,,
com.google.Chrome,31,1709609854,1709609885,1709609885.092427,-21600,,
com.leomehlig.today,82,1709609772,1709609854,1709609854.5203009,-21600,,
com.google.Chrome,51,1709609721,1709609772,1709609772.5232592,-21600,,
com.apple.iCal,81,1709609640,1709609721,1709609721.359435,-21600,,
com.leomehlig.today,31,1709609609,1709609640,1709609640.437746,-21600,,
com.google.Chrome,2,1709609607,1709609609,1709609609.531388,-21600,,
com.leomehlig.today,2,1709609605,1709609607,1709609607.7744389,-21600,,
com.google.Chrome,29,1709609576,1709609605,1709609605.585134,-21600,,
com.leomehlig.today,26,1709609550,1709609576,1709609576.424252,-21600,,
com.google.Chrome,7,1709609543,1709609550,1709609550.133521,-21600,,
com.leomehlig.today,229,1709609314,1709609543,1709609543.903331,-21600,,
com.apple.Notes,1,1709609313,1709609314,1709609314.2941818,-21600,,
com.google.Chrome,4,1709609309,1709609313,1709609313.134574,-21600,,
com.apple.Notes,11,1709609298,1709609309,1709609309.999446,-21600,,
com.google.Chrome,16,1709609282,1709609298,1709609298.268723,-21600,,
com.apple.Notes,9,1709609273,1709609282,1709609282.674983,-21600,,
com.google.Chrome,610,1709608663,1709609273,1709609273.90449,-21600,,
com.apple.Notes,2,1709608661,1709608663,1709608663.591121,-21600,,
com.google.Chrome,250,1709608411,1709608661,1709608661.152522,-21600,,
com.apple.Notes,11,1709608400,1709608411,1709608411.291559,-21600,,
com.google.Chrome,3,1709608397,1709608400,1709608400.6198192,-21600,,
com.apple.Preview,4,1709608393,1709608397,1709608397.072978,-21600,,
com.google.Chrome,14,1709608379,1709608393,1709608393.313133,-21600,,
com.leomehlig.today,2,1709608377,1709608379,1709608379.7505221,-21600,,
com.google.Chrome,613,1709607764,1709608377,1709608377.148391,-21600,,
com.leomehlig.today,1,1709607763,1709607764,1709607764.041936,-21600,,
com.google.Chrome,4,1709607759,1709607763,1709607763.277869,-21600,,
com.leomehlig.today,14,1709607745,1709607759,1709607759.8984299,-21600,,
com.google.Chrome,138,1709607607,1709607745,1709607745.4350471,-21600,,
com.apple.Notes,10,1709607597,1709607607,1709607607.423541,-21600,,
com.apple.Preview,1198,1709606399,1709607597,1709607597.463793,-21600,,
com.apple.finder,2,1709606397,1709606399,1709606399.892132,-21600,,
com.apple.Preview,2,1709606395,1709606397,1709606397.672824,-21600,,
com.apple.finder,2,1709606393,1709606395,1709606395.6232219,-21600,,
com.apple.Preview,1,1709606392,1709606393,1709606393.962994,-21600,,
com.google.Chrome,5,1709606387,1709606392,1709606392.7866411,-21600,,
com.google.Chrome,1098,1709605278,1709606376,1709606376.516221,-21600,,
com.apple.Notes,13,1709605265,1709605278,1709605278.608231,-21600,,
com.google.Chrome,68,1709605197,1709605265,1709605265.277955,-21600,,
com.leomehlig.today,16,1709605181,1709605197,1709605197.843776,-21600,,
com.google.Chrome,42,1709605139,1709605181,1709605181.668909,-21600,,
com.leomehlig.today,23,1709605116,1709605139,1709605139.706156,-21600,,
com.google.Chrome,2,1709605114,1709605116,1709605116.2812219,-21600,,
com.google.Chrome,649,1709596740,1709597389,1709597389.987596,-21600,,
com.google.Chrome,1906,1709594822,1709596728,1709596728.099262,-21600,,
com.google.Chrome,162,1709589970,1709590132,1709590132.6870399,-21600,,
com.leomehlig.today,2,1709589968,1709589970,1709589971.794783,-21600,,
com.leomehlig.today,148,1709589630,1709589778,1709589778.451751,-21600,,
com.google.Chrome,356,1709589274,1709589630,1709589631.003413,-21600,,
com.apple.Notes,34,1709589240,1709589274,1709589274.970738,-21600,,
com.google.Chrome,284,1709588956,1709589240,1709589240.7831821,-21600,,
com.leomehlig.today,18,1709588938,1709588956,1709588956.511142,-21600,,
com.apple.MobileSMS,5,1709588933,1709588938,1709588938.129784,-21600,,
com.leomehlig.today,1,1709588932,1709588933,1709588933.962245,-21600,,
com.google.Chrome,816,1709588116,1709588932,1709588932.5708861,-21600,,
com.apple.Preview,6,1709588110,1709588116,1709588116.543098,-21600,,
com.apple.Preview,761,1709586967,1709587728,1709587728.8950682,-21600,,
com.apple.Notes,8,1709586959,1709586967,1709586967.626396,-21600,,
com.apple.Preview,1027,1709585932,1709586959,1709586959.110851,-21600,,
com.google.Chrome,159,1709585773,1709585932,1709585932.467818,-21600,,
com.apple.Preview,95,1709585678,1709585773,1709585773.88536,-21600,,
com.leomehlig.today,2,1709585676,1709585678,1709585679.054172,-21600,,
com.google.Chrome,59,1709585617,1709585676,1709585676.682833,-21600,,
com.leomehlig.today,133,1709585484,1709585617,1709585617.8161159,-21600,,
com.apple.iCal,8,1709585476,1709585484,1709585484.683299,-21600,,
com.leomehlig.today,6,1709585470,1709585476,1709585476.186096,-21600,,
com.apple.Preview,29,1709585441,1709585470,1709585470.897917,-21600,,
com.google.Chrome,5,1709585436,1709585441,1709585441.6416411,-21600,,
com.apple.Notes,7,1709585429,1709585436,1709585436.9672852,-21600,,
com.google.Chrome,160,1709585269,1709585429,1709585429.708425,-21600,,
com.apple.Notes,5,1709584387,1709584392,1709584392.1151261,-21600,,
com.google.Chrome,1251,1709583136,1709584387,1709584387.3784351,-21600,,
com.apple.Notes,2,1709583134,1709583136,1709583136.406419,-21600,,
com.google.Chrome,113,1709583021,1709583134,1709583134.9638572,-21600,,
com.apple.Notes,7,1709583014,1709583021,1709583021.233593,-21600,,
com.google.Chrome,2,1709583012,1709583014,1709583014.382021,-21600,,
com.apple.Notes,2,1709583010,1709583012,1709583012.946111,-21600,,
com.apple.Preview,1,1709583009,1709583010,1709583010.704133,-21600,,
com.google.Chrome,4,1709583005,1709583009,1709583009.861934,-21600,,
com.apple.Preview,6,1709582999,1709583005,1709583005.622828,-21600,,
com.apple.MobileSMS,2,1709582997,1709582999,1709583000.050422,-21600,,
com.apple.Preview,4,1709582993,1709582997,1709582997.1172662,-21600,,
com.instructure.icanvas,2,1709579744,1709579746,1709579746.481543,-21600,EB445137-D7F5-57EC-87DA-1DB460D64046,"iPhone13,2"
com.instructure.icanvas,6,1709579186,1709579192,1709579192.792074,-21600,EB445137-D7F5-57EC-87DA-1DB460D64046,"iPhone13,2"
com.instructure.icanvas,13,1709579053,1709579066,1709579066.554243,-21600,EB445137-D7F5-57EC-87DA-1DB460D64046,"iPhone13,2"
com.apple.news,2,1709579049,1709579051,1709579051.485402,-21600,EB445137-D7F5-57EC-87DA-1DB460D64046,"iPhone13,2"
com.apple.news,172,1709578681,1709578853,1709578854.371886,-21600,EB445137-D7F5-57EC-87DA-1DB460D64046,"iPhone13,2"
com.apple.Health,9,1709578664,1709578673,1709578673.159083,-21600,EB445137-D7F5-57EC-87DA-1DB460D64046,"iPhone13,2"
com.apple.Preview,1120,1709577493,1709578613,1709578613.960921,-21600,,
com.apple.finder,2,1709577491,1709577493,1709577493.2854629,-21600,,
com.microsoft.VSCode,32,1709577459,1709577491,1709577491.5301871,-21600,,
com.google.Chrome,28,1709577431,1709577459,1709577459.202855,-21600,,
com.microsoft.VSCode,100,1709577331,1709577431,1709577431.762922,-21600,,
com.google.Chrome,47,1709577284,1709577331,1709577331.8753119,-21600,,
com.microsoft.VSCode,97,1709577187,1709577284,1709577284.78474,-21600,,
com.leomehlig.today,14,1709577173,1709577187,1709577187.7483048,-21600,,
com.google.Chrome,98,1709577075,1709577173,1709577173.785737,-21600,,
com.apple.Health,10,1709576720,1709576730,1709576731.115237,-21600,EB445137-D7F5-57EC-87DA-1DB460D64046,"iPhone13,2"
com.burbn.instagram,2,1709576718,1709576720,1709576720.896986,-21600,EB445137-D7F5-57EC-87DA-1DB460D64046,"iPhone13,2"
com.burbn.instagram,16,1709576519,1709576535,1709576535.979944,-21600,EB445137-D7F5-57EC-87DA-1DB460D64046,"iPhone13,2"
com.burbn.instagram,2,1709576142,1709576144,1709576144.2765489,-21600,EB445137-D7F5-57EC-87DA-1DB460D64046,"iPhone13,2"
com.burbn.instagram,227,1709575808,1709576035,1709576035.8521628,-21600,EB445137-D7F5-57EC-87DA-1DB460D64046,"iPhone13,2"
com.apple.AppStore,3,1709575803,1709575806,1709575806.217142,-21600,EB445137-D7F5-57EC-87DA-1DB460D64046,"iPhone13,2"
com.burbn.instagram,21,1709575782,1709575803,1709575803.945102,-21600,EB445137-D7F5-57EC-87DA-1DB460D64046,"iPhone13,2"
com.hammerandchisel.discord,17,1709575231,1709575248,1709575248.779897,-21600,EB445137-D7F5-57EC-87DA-1DB460D64046,"iPhone13,2"
com.apple.MobileSMS,8,1709575221,1709575229,1709575229.196258,-21600,EB445137-D7F5-57EC-87DA-1DB460D64046,"iPhone13,2"
com.apple.MobileSMS,1,1709574658,1709574659,1709574659.471323,-21600,EB445137-D7F5-57EC-87DA-1DB460D64046,"iPhone13,2"
com.apple.MobileSMS,3,1709574601,1709574604,1709574604.238842,-21600,EB445137-D7F5-57EC-87DA-1DB460D64046,"iPhone13,2"
com.apple.MobileSMS,1,1709574481,1709574482,1709574482.3686628,-21600,EB445137-D7F5-57EC-87DA-1DB460D64046,"iPhone13,2"
com.apple.MobileSMS,6,1709574460,1709574466,1709574466.8042521,-21600,EB445137-D7F5-57EC-87DA-1DB460D64046,"iPhone13,2"
com.apple.MobileSMS,5,1709574128,1709574133,1709574133.897387,-21600,EB445137-D7F5-57EC-87DA-1DB460D64046,"iPhone13,2"
com.apple.MobileSMS,28,1709574086,1709574114,1709574114.6795201,-21600,EB445137-D7F5-57EC-87DA-1DB460D64046,"iPhone13,2"
com.apple.MobileSMS,20,1709573936,1709573956,1709573956.86343,-21600,EB445137-D7F5-57EC-87DA-1DB460D64046,"iPhone13,2"
com.apple.MobileSMS,2,1709573930,1709573932,1709573932.9360971,-21600,EB445137-D7F5-57EC-87DA-1DB460D64046,"iPhone13,2"
com.apple.MobileSMS,45,1709573858,1709573903,1709573904.022327,-21600,EB445137-D7F5-57EC-87DA-1DB460D64046,"iPhone13,2"
com.microsoft.Office.Outlook,106,1709573718,1709573824,1709573824.034179,-21600,EB445137-D7F5-57EC-87DA-1DB460D64046,"iPhone13,2"
edu.illinois.rokwire.ios,2,1709573714,1709573716,1709573716.9192839,-21600,EB445137-D7F5-57EC-87DA-1DB460D64046,"iPhone13,2"
com.google.Chrome,2126,1709571556,1709573682,1709573682.573556,-21600,,
com.leomehlig.today,2,1709571554,1709571556,1709571556.454283,-21600,,
edu.illinois.rokwire.ios,8,1709570732,1709570740,1709570740.158836,-21600,EB445137-D7F5-57EC-87DA-1DB460D64046,"iPhone13,2"
edu.illinois.rokwire.ios,48,1709570681,1709570729,1709570729.3395128,-21600,EB445137-D7F5-57EC-87DA-1DB460D64046,"iPhone13,2"
edu.illinois.rokwire.ios,18,1709570592,1709570610,1709570610.704338,-21600,EB445137-D7F5-57EC-87DA-1DB460D64046,"iPhone13,2"
com.microsoft.Office.Outlook,3,1709570588,1709570591,1709570591.287529,-21600,EB445137-D7F5-57EC-87DA-1DB460D64046,"iPhone13,2"
com.microsoft.Office.Outlook,8,1709570493,1709570501,1709570501.319035,-21600,EB445137-D7F5-57EC-87DA-1DB460D64046,"iPhone13,2"
com.apple.Health,42,1709570450,1709570492,1709570492.616544,-21600,EB445137-D7F5-57EC-87DA-1DB460D64046,"iPhone13,2"
com.strava.stravaride,106,1709570341,1709570447,1709570447.2813,-21600,EB445137-D7F5-57EC-87DA-1DB460D64046,"iPhone13,2"
com.apple.MobileSMS,4,1709570336,1709570340,1709570340.462331,-21600,EB445137-D7F5-57EC-87DA-1DB460D64046,"iPhone13,2"
com.apple.weather,3,1709570332,1709570335,1709570336.1293092,-21600,EB445137-D7F5-57EC-87DA-1DB460D64046,"iPhone13,2"
com.apple.weather,13,1709570053,1709570066,1709570066.6312099,-21600,EB445137-D7F5-57EC-87DA-1DB460D64046,"iPhone13,2"
com.apple.weather,3,1709569785,1709569788,1709569788.418642,-21600,EB445137-D7F5-57EC-87DA-1DB460D64046,"iPhone13,2"
com.apple.weather,10,1709569758,1709569768,1709569768.9698691,-21600,EB445137-D7F5-57EC-87DA-1DB460D64046,"iPhone13,2"
com.leomehlig.today,51,1709569695,1709569746,1709569746.919322,-21600,,
com.microsoft.VSCode,43,1709569652,1709569695,1709569695.473411,-21600,,
com.google.Chrome,27,1709569625,1709569652,1709569652.486269,-21600,,
com.apple.weather,4,1709569445,1709569449,1709569449.721842,-21600,EB445137-D7F5-57EC-87DA-1DB460D64046,"iPhone13,2"
com.apple.weather,10,1709569422,1709569432,1709569432.099539,-21600,EB445137-D7F5-57EC-87DA-1DB460D64046,"iPhone13,2"
com.microsoft.VSCode,239,1709569386,1709569625,1709569625.534404,-21600,,
com.google.Chrome,62,1709569324,1709569386,1709569386.813064,-21600,,
com.apple.weather,10,1709569295,1709569305,1709569305.2613358,-21600,EB445137-D7F5-57EC-87DA-1DB460D64046,"iPhone13,2"
com.apple.weather,9,1709568635,1709568644,1709568644.098036,-21600,EB445137-D7F5-57EC-87DA-1DB460D64046,"iPhone13,2"
com.microsoft.VSCode,807,1709568517,1709569324,1709569325.058621,-21600,,
com.google.Chrome,5,1709568512,1709568517,1709568517.9740849,-21600,,
com.apple.weather,6,1709568310,1709568316,1709568316.634664,-21600,EB445137-D7F5-57EC-87DA-1DB460D64046,"iPhone13,2"
com.instructure.icanvas,5,1709568304,1709568309,1709568309.989155,-21600,EB445137-D7F5-57EC-87DA-1DB460D64046,"iPhone13,2"
com.google.Chrome,193,1709566916,1709567109,1709567109.3190331,-21600,,
com.burbn.instagram,660,1709563704,1709564364,1709564364.2003422,-21600,EB445137-D7F5-57EC-87DA-1DB460D64046,"iPhone13,2"
com.instructure.icanvas,23,1709563681,1709563704,1709563704.279737,-21600,EB445137-D7F5-57EC-87DA-1DB460D64046,"iPhone13,2"
com.burbn.instagram,121,1709563560,1709563681,1709563681.8417659,-21600,EB445137-D7F5-57EC-87DA-1DB460D64046,"iPhone13,2"
com.markhambly.APOD,50,1709563498,1709563548,1709563548.02687,-21600,EB445137-D7F5-57EC-87DA-1DB460D64046,"iPhone13,2"
com.apple.Health,93,1709563390,1709563483,1709563483.733891,-21600,EB445137-D7F5-57EC-87DA-1DB460D64046,"iPhone13,2"
com.microsoft.Office.Outlook,147,1709563237,1709563384,1709563384.508955,-21600,EB445137-D7F5-57EC-87DA-1DB460D64046,"iPhone13,2"
com.microsoft.Office.Outlook,28,1709563174,1709563202,1709563202.077814,-21600,EB445137-D7F5-57EC-87DA-1DB460D64046,"iPhone13,2"
com.apple.mobiletimer,9,1709563159,1709563168,1709563168.970649,-21600,EB445137-D7F5-57EC-87DA-1DB460D64046,"iPhone13,2"
com.apple.Health,42,1709532787,1709532829,1709532829.272718,-21600,EB445137-D7F5-57EC-87DA-1DB460D64046,"iPhone13,2"
com.google.chrome.ios,3,1709532784,1709532787,1709532787.798932,-21600,EB445137-D7F5-57EC-87DA-1DB460D64046,"iPhone13,2"
com.google.Chrome,100,1709532672,1709532772,1709532772.4671168,-21600,,
com.google.chrome.ios,2,1709532398,1709532400,1709532400.645556,-21600,EB445137-D7F5-57EC-87DA-1DB460D64046,"iPhone13,2"
com.google.chrome.ios,6,1709530931,1709530937,1709530937.35501,-21600,EB445137-D7F5-57EC-87DA-1DB460D64046,"iPhone13,2"
com.google.chrome.ios,36,1709529743,1709529779,1709529780.284151,-21600,EB445137-D7F5-57EC-87DA-1DB460D64046,"iPhone13,2"
com.google.chrome.ios,104,1709528959,1709529063,1709529063.8892422,-21600,EB445137-D7F5-57EC-87DA-1DB460D64046,"iPhone13,2"
com.google.Chrome,1990,1709522568,1709524558,1709524558.286377,-21600,,
com.apple.iCal,62,1709522506,1709522568,1709522568.603057,-21600,,
com.leomehlig.today,331,1709522175,1709522506,1709522506.322335,-21600,,
com.apple.Notes,2,1709522173,1709522175,1709522175.561276,-21600,,
com.leomehlig.today,13,1709522160,1709522173,1709522173.438774,-21600,,
com.apple.Notes,7,1709522153,1709522160,1709522160.60639,-21600,,
com.leomehlig.today,34,1709522119,1709522153,1709522153.985774,-21600,,
com.apple.iCal,8,1709522111,1709522119,1709522119.611692,-21600,,
com.leomehlig.today,91,1709522020,1709522111,1709522111.7837992,-21600,,
com.apple.Preview,11,1709522009,1709522020,1709522020.100267,-21600,,
com.toyopagroup.picaboo,21,1709521579,1709521600,1709521600.9271889,-21600,EB445137-D7F5-57EC-87DA-1DB460D64046,"iPhone13,2"
com.apple.Music,7,1709521571,1709521578,1709521578.0555692,-21600,EB445137-D7F5-57EC-87DA-1DB460D64046,"iPhone13,2"
com.apple.Music,10,1709521211,1709521221,1709521221.305892,-21600,EB445137-D7F5-57EC-87DA-1DB460D64046,"iPhone13,2"
com.apple.Music,2,1709521052,1709521054,1709521055.108604,-21600,EB445137-D7F5-57EC-87DA-1DB460D64046,"iPhone13,2"
com.apple.Music,7,1709520216,1709520223,1709520223.039771,-21600,EB445137-D7F5-57EC-87DA-1DB460D64046,"iPhone13,2"
com.apple.Music,6,1709519746,1709519752,1709519752.727871,-21600,EB445137-D7F5-57EC-87DA-1DB460D64046,"iPhone13,2"
com.apple.Music,7,1709519635,1709519642,1709519642.096775,-21600,EB445137-D7F5-57EC-87DA-1DB460D64046,"iPhone13,2"
com.apple.Music,6,1709519587,1709519593,1709519593.491534,-21600,EB445137-D7F5-57EC-87DA-1DB460D64046,"iPhone13,2"
com.apple.Music,7,1709518698,1709518705,1709518705.229157,-21600,EB445137-D7F5-57EC-87DA-1DB460D64046,"iPhone13,2"
com.apple.Music,134,1709518293,1709518427,1709518427.321435,-21600,EB445137-D7F5-57EC-87DA-1DB460D64046,"iPhone13,2"
com.apple.Music,35,1709518257,1709518292,1709518292.327571,-21600,EB445137-D7F5-57EC-87DA-1DB460D64046,"iPhone13,2"
com.t11.celeste,7,1709518245,1709518252,1709518252.865262,-21600,EB445137-D7F5-57EC-87DA-1DB460D64046,"iPhone13,2"
com.t11.celeste,15,1709517792,1709517807,1709517807.869492,-21600,EB445137-D7F5-57EC-87DA-1DB460D64046,"iPhone13,2"
com.google.chrome.ios,16,1709517776,1709517792,1709517793.356645,-21600,EB445137-D7F5-57EC-87DA-1DB460D64046,"iPhone13,2"
com.t11.celeste,16,1709517759,1709517775,1709517775.976877,-21600,EB445137-D7F5-57EC-87DA-1DB460D64046,"iPhone13,2"
com.t11.celeste,6,1709517750,1709517756,1709517756.68804,-21600,EB445137-D7F5-57EC-87DA-1DB460D64046,"iPhone13,2"
com.t11.celeste,11,1709517737,1709517748,1709517748.294149,-21600,EB445137-D7F5-57EC-87DA-1DB460D64046,"iPhone13,2"
com.t11.celeste,5,1709516881,1709516886,1709516886.4914842,-21600,EB445137-D7F5-57EC-87DA-1DB460D64046,"iPhone13,2"
com.t11.celeste,12,1709516612,1709516624,1709516625.060697,-21600,EB445137-D7F5-57EC-87DA-1DB460D64046,"iPhone13,2"
com.apple.Music,6,1709516602,1709516608,1709516608.237864,-21600,EB445137-D7F5-57EC-87DA-1DB460D64046,"iPhone13,2"
com.apple.Music,16,1709516575,1709516591,1709516591.167481,-21600,EB445137-D7F5-57EC-87DA-1DB460D64046,"iPhone13,2"
com.apple.Music,18,1709516332,1709516350,1709516350.723211,-21600,EB445137-D7F5-57EC-87DA-1DB460D64046,"iPhone13,2"
com.apple.Music,10,1709515228,1709515238,1709515238.7128968,-21600,EB445137-D7F5-57EC-87DA-1DB460D64046,"iPhone13,2"
com.apple.Music,70,1709513863,1709513933,1709513933.52163,-21600,EB445137-D7F5-57EC-87DA-1DB460D64046,"iPhone13,2"
com.toyopagroup.picaboo,4,1709513856,1709513860,1709513860.479775,-21600,EB445137-D7F5-57EC-87DA-1DB460D64046,"iPhone13,2"
com.toyopagroup.picaboo,14,1709511613,1709511627,1709511627.8784208,-21600,EB445137-D7F5-57EC-87DA-1DB460D64046,"iPhone13,2"
com.toyopagroup.picaboo,9,1709511332,1709511341,1709511341.5580611,-21600,EB445137-D7F5-57EC-87DA-1DB460D64046,"iPhone13,2"
com.toyopagroup.picaboo,6,1709511325,1709511331,1709511331.245222,-21600,EB445137-D7F5-57EC-87DA-1DB460D64046,"iPhone13,2"
com.toyopagroup.picaboo,1,1709511238,1709511239,1709511239.483594,-21600,EB445137-D7F5-57EC-87DA-1DB460D64046,"iPhone13,2"
com.toyopagroup.picaboo,3,1709511156,1709511159,1709511159.313723,-21600,EB445137-D7F5-57EC-87DA-1DB460D64046,"iPhone13,2"
com.toyopagroup.picaboo,7,1709511072,1709511079,1709511079.476475,-21600,EB445137-D7F5-57EC-87DA-1DB460D64046,"iPhone13,2"
com.toyopagroup.picaboo,6,1709511040,1709511046,1709511046.5570312,-21600,EB445137-D7F5-57EC-87DA-1DB460D64046,"iPhone13,2"
com.toyopagroup.picaboo,3,1709511019,1709511022,1709511022.6226912,-21600,EB445137-D7F5-57EC-87DA-1DB460D64046,"iPhone13,2"
Astrospheric.Astrospheric,1,1709511018,1709511019,1709511019.608896,-21600,EB445137-D7F5-57EC-87DA-1DB460D64046,"iPhone13,2"
Astrospheric.Astrospheric,46,1709510769,1709510815,1709510815.288803,-21600,EB445137-D7F5-57EC-87DA-1DB460D64046,"iPhone13,2"
com.toyopagroup.picaboo,3,1709510765,1709510768,1709510769.44249,-21600,EB445137-D7F5-57EC-87DA-1DB460D64046,"iPhone13,2"
com.toyopagroup.picaboo,4,1709510167,1709510171,1709510171.824724,-21600,EB445137-D7F5-57EC-87DA-1DB460D64046,"iPhone13,2"
com.apple.mobileslideshow,2,1709510165,1709510167,1709510167.738706,-21600,EB445137-D7F5-57EC-87DA-1DB460D64046,"iPhone13,2"
com.apple.Preview,901,1709510122,1709511023,1709511023.510491,-21600,,
com.leomehlig.today,13,1709510109,1709510122,1709510122.312748,-21600,,
com.google.Chrome,16,1709510093,1709510109,1709510109.912322,-21600,,
com.apple.mobileslideshow,24,1709510057,1709510081,1709510082.826569,-21600,EB445137-D7F5-57EC-87DA-1DB460D64046,"iPhone13,2"
com.burbn.instagram,57,1709510000,1709510057,1709510058.280756,-21600,EB445137-D7F5-57EC-87DA-1DB460D64046,"iPhone13,2"
com.burbn.instagram,6,1709509991,1709509997,1709509997.702616,-21600,EB445137-D7F5-57EC-87DA-1DB460D64046,"iPhone13,2"
com.apple.finder,110,1709509983,1709510093,1709510093.8300009,-21600,,
com.google.Chrome,1,1709509982,1709509983,1709509983.785225,-21600,,
com.google.Chrome,316,1709505498,1709505814,1709505814.546082,-21600,,
com.google.Chrome,696,1709504053,1709504749,1709504749.094651,-21600,,
com.google.Chrome,312,1709503467,1709503779,1709503779.753401,-21600,,
com.google.Chrome,431,1709502990,1709503421,1709503421.183459,-21600,,
com.apple.Preview,3,1709502987,1709502990,1709502990.649214,-21600,,
com.apple.Preview,165,1709502678,1709502843,1709502843.2599158,-21600,,
com.apple.Preview,164,1709501552,1709501716,1709501716.901907,-21600,,
com.apple.Notes,3,1709501549,1709501552,1709501552.12289,-21600,,
com.apple.Notes,18,1709497077,1709497095,1709497095.134047,-21600,,
com.leomehlig.today,28,1709497049,1709497077,1709497077.783248,-21600,,
com.google.Chrome,213,1709496836,1709497049,1709497049.628967,-21600,,
com.apple.Notes,2,1709496834,1709496836,1709496836.801166,-21600,,
com.google.Chrome,7,1709496827,1709496834,1709496834.1889548,-21600,,
com.apple.Notes,1,1709496826,1709496827,1709496827.7767382,-21600,,
com.google.Chrome,4,1709496822,1709496826,1709496826.066163,-21600,,
com.apple.Notes,2,1709496820,1709496822,1709496822.196425,-21600,,
com.google.Chrome,291,1709496529,1709496820,1709496820.094411,-21600,,
com.apple.Notes,2,1709496527,1709496529,1709496529.708445,-21600,,
com.google.Chrome,2,1709496525,1709496527,1709496527.9785318,-21600,,
com.apple.Preview,53,1709496472,1709496525,1709496525.8196259,-21600,,
com.leomehlig.today,42,1709496430,1709496472,1709496472.827735,-21600,,
com.apple.Preview,4,1709496426,1709496430,1709496430.1280441,-21600,,
com.google.Chrome,3,1709496423,1709496426,1709496426.325202,-21600,,
com.apple.Notes,8,1709496415,1709496423,1709496423.656313,-21600,,
com.google.Chrome,54,1709496361,1709496415,1709496415.580204,-21600,,
com.apple.Notes,2,1709496359,1709496361,1709496361.147974,-21600,,
com.apple.Preview,38,1709496321,1709496359,1709496359.788352,-21600,,
com.apple.Notes,1,1709496320,1709496321,1709496321.8053498,-21600,,
com.google.Chrome,96,1709496224,1709496320,1709496320.86301,-21600,,
com.apple.Notes,1,1709496223,1709496224,1709496224.850111,-21600,,
com.apple.Preview,132,1709496091,1709496223,1709496223.804172,-21600,,
com.apple.Notes,1,1709496090,1709496091,1709496091.6210132,-21600,,
com.google.Chrome,82,1709496008,1709496090,1709496090.254702,-21600,,
com.apple.Notes,1,1709496007,1709496008,1709496008.654982,-21600,,
com.google.Chrome,1,1709496006,1709496007,1709496007.2794871,-21600,,
com.apple.Notes,3,1709496003,1709496006,1709496006.7034988,-21600,,
com.google.Chrome,12,1709495991,1709496003,1709496003.2135448,-21600,,
com.apple.Preview,31,1709495960,1709495991,1709495991.194344,-21600,,
com.google.Chrome,442,1709495518,1709495960,1709495960.2208428,-21600,,
com.apple.Preview,54,1709495464,1709495518,1709495518.7687469,-21600,,
com.google.Chrome,1186,1709494278,1709495464,1709495464.651403,-21600,,
com.apple.Preview,0,1709494278,1709494278,1709494278.7088928,-21600,,
com.google.Chrome,2,1709494276,1709494278,1709494278.132077,-21600,,
com.apple.Notes,1,1709494275,1709494276,1709494276.703532,-21600,,
com.apple.Preview,1,1709494274,1709494275,1709494275.214088,-21600,,
com.apple.Notes,1,1709494273,1709494274,1709494274.812932,-21600,,
com.apple.finder,1,1709494272,1709494273,1709494273.448823,-21600,,
com.apple.Preview,16,1709494256,1709494272,1709494272.608938,-21600,,
com.apple.finder,2,1709494254,1709494256,1709494256.524478,-21600,,
com.apple.Notes,1,1709494253,1709494254,1709494254.866255,-21600,,
com.google.Chrome,83,1709494170,1709494253,1709494253.380616,-21600,,
com.apple.Notes,3,1709494167,1709494170,1709494170.244549,-21600,,
com.google.Chrome,3,1709494164,1709494167,1709494167.816008,-21600,,
com.apple.Notes,1,1709494163,1709494164,1709494164.867419,-21600,,
com.google.Chrome,2,1709494161,1709494163,1709494163.455796,-21600,,
com.apple.Notes,39,1709494122,1709494161,1709494161.6234431,-21600,,
com.google.Chrome,7,1709494115,1709494122,1709494122.2470589,-21600,,
com.leomehlig.today,6,1709494109,1709494115,1709494115.3345509,-21600,,
com.google.Chrome,592,1709493517,1709494109,1709494109.513993,-21600,,
com.microsoft.onenote.mac,146,1709493371,1709493517,1709493517.284659,-21600,,
com.google.Chrome,6,1709493365,1709493371,1709493371.683175,-21600,,
com.apple.AppStore,3,1709493362,1709493365,1709493365.782192,-21600,,
com.google.Chrome,5,1709493357,1709493362,1709493362.671897,-21600,,
com.leomehlig.today,114,1709493243,1709493357,1709493357.679939,-21600,,
com.google.Chrome,2,1709493241,1709493243,1709493244.105833,-21600,,
com.google.Chrome,5,1709486050,1709486055,1709486056.0931501,-21600,,
com.google.Chrome,535,1709485366,1709485901,1709485901.7755709,-21600,,
com.google.Chrome,14,1709485232,1709485246,1709485246.26683,-21600,,
com.google.Chrome,888,1709484320,1709485208,1709485208.367202,-21600,,
com.apple.finder,3,1709484317,1709484320,1709484320.546253,-21600,,
com.microsoft.rdc.macos,48,1709484269,1709484317,1709484317.667883,-21600,,
com.microsoft.rdc.macos,14,1709484000,1709484014,1709484014.725774,-21600,,
com.apple.finder,172,1709483828,1709484000,1709484000.5576649,-21600,,
com.microsoft.rdc.macos,3,1709483635,1709483638,1709483638.236166,-21600,,
com.apple.finder,4,1709483631,1709483635,1709483636.006212,-21600,,
com.microsoft.rdc.macos,23,1709483598,1709483621,1709483621.201715,-21600,,
com.apple.finder,16,1709483582,1709483598,1709483598.4930449,-21600,,
com.microsoft.rdc.macos,87,1709483495,1709483582,1709483582.3854852,-21600,,
com.apple.finder,31,1709483464,1709483495,1709483495.900948,-21600,,
com.microsoft.rdc.macos,4,1709448483,1709448487,1709448487.292774,-21600,,
com.microsoft.rdc.macos,215,1709444353,1709444568,1709444568.7164369,-21600,,
com.microsoft.rdc.macos,330,1709443985,1709444315,1709444315.434252,-21600,,
com.microsoft.rdc.macos,341,1709442653,1709442994,1709442994.2570438,-21600,,
com.microsoft.rdc.macos,318,1709441761,1709442079,1709442079.9022279,-21600,,
com.microsoft.rdc.macos,300,1709440777,1709441077,1709441077.6611161,-21600,,
com.microsoft.rdc.macos,354,1709440410,1709440764,1709440764.977982,-21600,,
com.microsoft.rdc.macos,75,1709439174,1709439249,1709439249.40066,-21600,,
com.microsoft.rdc.macos,2,1709438550,1709438552,1709438552.713675,-21600,,
com.microsoft.rdc.macos,415,1709438130,1709438545,1709438545.328551,-21600,,
com.microsoft.rdc.macos,2285,1709435806,1709438091,1709438091.3860168,-21600,,
com.google.Chrome,1,1709435805,1709435806,1709435806.583395,-21600,,
com.microsoft.rdc.macos,1,1709435804,1709435805,1709435805.184826,-21600,,
com.google.Chrome,1,1709435803,1709435804,1709435804.449084,-21600,,
com.microsoft.rdc.macos,60,1709435743,1709435803,1709435803.885186,-21600,,
com.google.Chrome,1,1709435742,1709435743,1709435743.574338,-21600,,
com.microsoft.rdc.macos,20,1709435722,1709435742,1709435742.178628,-21600,,
com.google.Chrome,20,1709435702,1709435722,1709435722.209456,-21600,,
com.google.Chrome,3,1709428384,1709428387,1709428387.971947,-21600,,
com.leomehlig.today,30,1709428354,1709428384,1709428384.629662,-21600,,
com.apple.Music,1,1709428353,1709428354,1709428354.807207,-21600,,
com.google.Chrome,5,1709428348,1709428353,1709428353.936265,-21600,,
com.apple.Preview,71,1709428072,1709428143,1709428143.335783,-21600,,
com.google.Chrome,9,1709428063,1709428072,1709428072.602779,-21600,,
com.apple.Preview,96,1709427967,1709428063,1709428063.318369,-21600,,
com.google.Chrome,83,1709427884,1709427967,1709427967.74166,-21600,,
com.apple.Preview,153,1709427731,1709427884,1709427884.800899,-21600,,
com.google.Chrome,562,1709427169,1709427731,1709427731.178413,-21600,,
com.apple.Preview,27,1709427142,1709427169,1709427169.9770842,-21600,,
com.google.Chrome,457,1709426685,1709427142,1709427142.778681,-21600,,
com.apple.iCal,13,1709426672,1709426685,1709426685.39908,-21600,,
com.leomehlig.today,25,1709426647,1709426672,1709426672.803041,-21600,,
com.google.Chrome,1040,1709425607,1709426647,1709426647.115138,-21600,,
com.apple.Notes,2,1709425605,1709425607,1709425607.9504008,-21600,,
com.apple.Music,28,1709425577,1709425605,1709425606.090178,-21600,,
com.google.Chrome,173,1709425404,1709425577,1709425577.1411881,-21600,,
com.apple.Notes,9,1709425395,1709425404,1709425404.469389,-21600,,
com.apple.Preview,556,1709424839,1709425395,1709425395.776051,-21600,,
com.apple.Preview,1375,1709422868,1709424243,1709424243.372236,-21600,,
com.google.Chrome,3,1709422865,1709422868,1709422868.1447458,-21600,,
com.apple.Preview,5,1709422860,1709422865,1709422865.403708,-21600,,
com.google.Chrome,12,1709422848,1709422860,1709422860.846438,-21600,,
com.apple.Preview,1176,1709421672,1709422848,1709422848.739049,-21600,,
com.leomehlig.today,16,1709421656,1709421672,1709421672.788579,-21600,,
com.apple.Preview,3,1709421653,1709421656,1709421656.1791859,-21600,,
com.apple.finder,1,1709421652,1709421653,1709421653.688592,-21600,,
com.apple.Preview,1,1709421651,1709421652,1709421652.321023,-21600,,
com.google.Chrome,124,1709421527,1709421651,1709421651.489445,-21600,,
com.apple.Notes,1,1709421526,1709421527,1709421529.475945,-21600,,
com.google.Chrome,0,1709421526,1709421526,1709421529.103766,-21600,,
com.apple.Notes,8,1709421518,1709421526,1709421526.672503,-21600,,
com.apple.FaceTime,142,1709421376,1709421518,1709421518.352209,-21600,,
com.apple.MobileSMS,2,1709421374,1709421376,1709421376.345648,-21600,,
com.apple.FaceTime,1,1709421373,1709421374,1709421374.202297,-21600,,
com.apple.FaceTime,303,1709420403,1709420706,1709420706.072651,-21600,,
com.apple.MobileSMS,3,1709420400,1709420403,1709420403.314347,-21600,,
com.apple.FaceTime,1,1709420399,1709420400,1709420400.8307261,-21600,,
com.apple.FaceTime,316,1709419971,1709420287,1709420287.527485,-21600,,
com.apple.DeskCam,2,1709419969,1709419971,1709419971.746438,-21600,,
com.apple.FaceTime,165,1709419804,1709419969,1709419969.806818,-21600,,
com.apple.MobileSMS,14,1709419790,1709419804,1709419805.073775,-21600,,
com.apple.Notes,101,1709419689,1709419790,1709419790.5692968,-21600,,
com.google.Chrome,296,1709419393,1709419689,1709419689.662976,-21600,,
com.apple.Notes,79,1709419314,1709419393,1709419393.59058,-21600,,
com.leomehlig.today,51,1709419263,1709419314,1709419314.3016481,-21600,,
com.google.Chrome,8,1709419255,1709419263,1709419263.782691,-21600,,
com.google.Chrome,317,1709402890,1709403207,1709403207.413842,-21600,,
com.google.Chrome,301,1709400612,1709400913,1709400913.0744839,-21600,,
com.google.Chrome,665,1709399894,1709400559,1709400559.82094,-21600,,
com.leomehlig.today,36,1709399858,1709399894,1709399894.309657,-21600,,
com.google.Chrome,235,1709399623,1709399858,1709399858.681594,-21600,,
com.toyopagroup.picaboo,11,1709355527,1709355538,1709355539.073468,-21600,EB445137-D7F5-57EC-87DA-1DB460D64046,"iPhone13,2"
com.toyopagroup.picaboo,48,1709353292,1709353340,1709353340.8888888,-21600,EB445137-D7F5-57EC-87DA-1DB460D64046,"iPhone13,2"
com.apple.MobileSMS,3,1709344771,1709344774,1709344774.823266,-21600,EB445137-D7F5-57EC-87DA-1DB460D64046,"iPhone13,2"
com.supercell.magic,49,1709343798,1709343847,1709343847.067363,-21600,EB445137-D7F5-57EC-87DA-1DB460D64046,"iPhone13,2"
com.burbn.instagram,37,1709343236,1709343273,1709343273.3284311,-21600,EB445137-D7F5-57EC-87DA-1DB460D64046,"iPhone13,2"
com.toyopagroup.picaboo,3,1709343232,1709343235,1709343236.096873,-21600,EB445137-D7F5-57EC-87DA-1DB460D64046,"iPhone13,2"
co.hinge.mobile.ios,48,1709341877,1709341925,1709341925.927768,-21600,EB445137-D7F5-57EC-87DA-1DB460D64046,"iPhone13,2"
com.apple.MobileSMS,5,1709341867,1709341872,1709341872.454818,-21600,EB445137-D7F5-57EC-87DA-1DB460D64046,"iPhone13,2"
com.apple.MobileSMS,32,1709341534,1709341566,1709341566.4601002,-21600,EB445137-D7F5-57EC-87DA-1DB460D64046,"iPhone13,2"
com.apple.MobileSMS,10,1709340719,1709340729,1709340729.923431,-21600,EB445137-D7F5-57EC-87DA-1DB460D64046,"iPhone13,2"
com.apple.MobileSMS,2,1709340715,1709340717,1709340717.894466,-21600,EB445137-D7F5-57EC-87DA-1DB460D64046,"iPhone13,2"
com.apple.MobileSMS,5,1709339988,1709339993,1709339993.17045,-21600,EB445137-D7F5-57EC-87DA-1DB460D64046,"iPhone13,2"
com.apple.MobileSMS,10,1709339161,1709339171,1709339171.794271,-21600,EB445137-D7F5-57EC-87DA-1DB460D64046,"iPhone13,2"
edu.illinois.rokwire.ios,2,1709339159,1709339161,1709339161.81143,-21600,EB445137-D7F5-57EC-87DA-1DB460D64046,"iPhone13,2"
edu.illinois.rokwire.ios,2,1709339139,1709339141,1709339141.0889602,-21600,EB445137-D7F5-57EC-87DA-1DB460D64046,"iPhone13,2"
edu.illinois.rokwire.ios,20,1709338916,1709338936,1709338936.925731,-21600,EB445137-D7F5-57EC-87DA-1DB460D64046,"iPhone13,2"
edu.illinois.rokwire.ios,34,1709338782,1709338816,1709338816.885271,-21600,EB445137-D7F5-57EC-87DA-1DB460D64046,"iPhone13,2"
edu.illinois.rokwire.ios,39,1709336559,1709336598,1709336598.797862,-21600,EB445137-D7F5-57EC-87DA-1DB460D64046,"iPhone13,2"
com.clairmail.fth.client,7,1709336545,1709336552,1709336552.283338,-21600,EB445137-D7F5-57EC-87DA-1DB460D64046,"iPhone13,2"
com.clairmail.fth.client,6,1709334709,1709334715,1709334715.601921,-21600,EB445137-D7F5-57EC-87DA-1DB460D64046,"iPhone13,2"
com.clairmail.fth.client,50,1709334658,1709334708,1709334708.74983,-21600,EB445137-D7F5-57EC-87DA-1DB460D64046,"iPhone13,2"
com.toyopagroup.picaboo,4,1709333852,1709333856,1709333856.918647,-21600,EB445137-D7F5-57EC-87DA-1DB460D64046,"iPhone13,2"
com.toyopagroup.picaboo,3,1709333227,1709333230,1709333230.305307,-21600,EB445137-D7F5-57EC-87DA-1DB460D64046,"iPhone13,2"
com.toyopagroup.picaboo,6,1709331883,1709331889,1709331889.762267,-21600,EB445137-D7F5-57EC-87DA-1DB460D64046,"iPhone13,2"
com.toyopagroup.picaboo,7,1709331702,1709331709,1709331709.6200871,-21600,EB445137-D7F5-57EC-87DA-1DB460D64046,"iPhone13,2"
com.toyopagroup.picaboo,4,1709331361,1709331365,1709331365.225189,-21600,EB445137-D7F5-57EC-87DA-1DB460D64046,"iPhone13,2"
com.toyopagroup.picaboo,6,1709330961,1709330967,1709330968.01118,-21600,EB445137-D7F5-57EC-87DA-1DB460D64046,"iPhone13,2"
com.toyopagroup.picaboo,14,1709330647,1709330661,1709330661.2788482,-21600,EB445137-D7F5-57EC-87DA-1DB460D64046,"iPhone13,2"
com.microsoft.Office.Outlook,9,1709330638,1709330647,1709330647.188932,-21600,EB445137-D7F5-57EC-87DA-1DB460D64046,"iPhone13,2"
com.toyopagroup.picaboo,106,1709330530,1709330636,1709330636.642972,-21600,EB445137-D7F5-57EC-87DA-1DB460D64046,"iPhone13,2"
com.google.Chrome,2122,1709329572,1709331694,1709331694.148315,-21600,,
com.leomehlig.today,6,1709329566,1709329572,1709329572.95453,-21600,,
com.burbn.instagram,232,1709327544,1709327776,1709327776.084055,-21600,EB445137-D7F5-57EC-87DA-1DB460D64046,"iPhone13,2"
com.google.Chrome,2225,1709327341,1709329566,1709329566.98137,-21600,,
com.microsoft.Outlook,30,1709327311,1709327341,1709327341.3976831,-21600,,
com.google.Chrome,37,1709327274,1709327311,1709327311.375258,-21600,,
com.leomehlig.today,27,1709327247,1709327274,1709327274.5576692,-21600,,
com.google.Chrome,1,1709327246,1709327247,1709327248.018015,-21600,,
com.leomehlig.today,7,1709327239,1709327246,1709327247.0105782,-21600,,
com.google.Chrome,672,1709326567,1709327239,1709327239.122927,-21600,,
com.leomehlig.today,1,1709326566,1709326567,1709326567.7494988,-21600,,
com.google.Chrome,1106,1709325460,1709326566,1709326566.754335,-21600,,
com.toyopagroup.picaboo,6,1709325401,1709325407,1709325407.610736,-21600,EB445137-D7F5-57EC-87DA-1DB460D64046,"iPhone13,2"
com.google.Chrome,516,1709324831,1709325347,1709325348.0144339,-21600,,
com.burbn.instagram,520,1709324230,1709324750,1709324751.345879,-21600,EB445137-D7F5-57EC-87DA-1DB460D64046,"iPhone13,2"
com.google.Chrome,890,1709323551,1709324441,1709324441.348901,-21600,,
com.leomehlig.today,16,1709323535,1709323551,1709323552.339663,-21600,,
com.apple.finder,2,1709323533,1709323535,1709323536.047412,-21600,,
com.leomehlig.today,2,1709323531,1709323533,1709323533.800354,-21600,,
com.apple.finder,3,1709323528,1709323531,1709323531.190171,-21600,,
com.leomehlig.today,21,1709323507,1709323528,1709323528.452632,-21600,,
com.apple.finder,1,1709323506,1709323507,1709323507.524755,-21600,,
com.apple.Photos,2,1709323504,1709323506,1709323506.912387,-21600,,
com.apple.finder,2,1709323502,1709323504,1709323504.125963,-21600,,
com.apple.Notes,4,1709323498,1709323502,1709323503.085428,-21600,,
com.hammerandchisel.discord,110,1709323377,1709323487,1709323487.9261022,-21600,EB445137-D7F5-57EC-87DA-1DB460D64046,"iPhone13,2"
com.microsoft.Office.Outlook,18,1709323354,1709323372,1709323372.81972,-21600,EB445137-D7F5-57EC-87DA-1DB460D64046,"iPhone13,2"
com.apple.mobilecal,87,1709319656,1709319743,1709319743.496192,-21600,EB445137-D7F5-57EC-87DA-1DB460D64046,"iPhone13,2"
com.microsoft.Office.Outlook,40,1709319566,1709319606,1709319606.370784,-21600,EB445137-D7F5-57EC-87DA-1DB460D64046,"iPhone13,2"
com.burbn.instagram,4,1709319562,1709319566,1709319567.459686,-21600,EB445137-D7F5-57EC-87DA-1DB460D64046,"iPhone13,2"
com.apple.Notes,8,1709319518,1709319526,1709319527.089752,-21600,,
com.leomehlig.today,5,1709319513,1709319518,1709319518.694862,-21600,,
com.apple.Notes,2,1709319511,1709319513,1709319513.358675,-21600,,
com.google.Chrome,173,1709319338,1709319511,1709319511.281344,-21600,,
com.apple.Preview,73,1709319265,1709319338,1709319338.23987,-21600,,
com.google.Chrome,16,1709319249,1709319265,1709319265.559289,-21600,,
com.apple.Preview,164,1709319085,1709319249,1709319250.0105891,-21600,,
com.apple.finder,2,1709319083,1709319085,1709319085.248396,-21600,,
com.apple.Preview,1,1709319082,1709319083,1709319084.05765,-21600,,
com.google.Chrome,1449,1709317633,1709319082,1709319082.486975,-21600,,
com.apple.Notes,1,1709317632,1709317633,1709317633.471593,-21600,,
com.google.Chrome,2,1709317630,1709317632,1709317632.163189,-21600,,
com.apple.Notes,2,1709317628,1709317630,1709317630.705851,-21600,,
com.google.Chrome,8,1709317620,1709317628,1709317628.476059,-21600,,
com.apple.Notes,2,1709317618,1709317620,1709317620.467678,-21600,,
com.google.Chrome,9,1709317609,1709317618,1709317618.457203,-21600,,
com.apple.Notes,2,1709317607,1709317609,1709317609.7686028,-21600,,
com.google.Chrome,1,1709317606,1709317607,1709317608.316636,-21600,,
com.apple.Notes,6,1709317600,1709317606,1709317606.9623132,-21600,,
com.leomehlig.today,22,1709317578,1709317600,1709317600.187983,-21600,,
com.burbn.instagram,90,1709315095,1709315185,1709315185.5858278,-21600,EB445137-D7F5-57EC-87DA-1DB460D64046,"iPhone13,2"
com.burbn.instagram,6,1709315071,1709315077,1709315077.799584,-21600,EB445137-D7F5-57EC-87DA-1DB460D64046,"iPhone13,2"
com.burbn.instagram,2,1709315049,1709315051,1709315051.072021,-21600,EB445137-D7F5-57EC-87DA-1DB460D64046,"iPhone13,2"
com.burbn.instagram,555,1709314448,1709315003,1709315003.753763,-21600,EB445137-D7F5-57EC-87DA-1DB460D64046,"iPhone13,2"
com.apple.news,50,1709314398,1709314448,1709314448.2627401,-21600,EB445137-D7F5-57EC-87DA-1DB460D64046,"iPhone13,2"
com.microsoft.Office.Outlook,66,1709314327,1709314393,1709314393.329824,-21600,EB445137-D7F5-57EC-87DA-1DB460D64046,"iPhone13,2"
edu.illinois.rokwire.ios,56,1709312431,1709312487,1709312487.178,-21600,EB445137-D7F5-57EC-87DA-1DB460D64046,"iPhone13,2"
com.burbn.instagram,266,1709312164,1709312430,1709312430.645133,-21600,EB445137-D7F5-57EC-87DA-1DB460D64046,"iPhone13,2"
Astrospheric.Astrospheric,22,1709312135,1709312157,1709312157.540269,-21600,EB445137-D7F5-57EC-87DA-1DB460D64046,"iPhone13,2"
com.toyopagroup.picaboo,34,1709312096,1709312130,1709312130.7143312,-21600,EB445137-D7F5-57EC-87DA-1DB460D64046,"iPhone13,2"
com.apple.camera,1,1709312070,1709312071,1709312071.341006,-21600,EB445137-D7F5-57EC-87DA-1DB460D64046,"iPhone13,2"
com.apple.camera,1,1709311998,1709311999,1709311999.0268002,-21600,EB445137-D7F5-57EC-87DA-1DB460D64046,"iPhone13,2"
com.leomehlig.today,202,1709309989,1709310191,1709310191.7077188,-21600,,
com.apple.Preview,1641,1709308348,1709309989,1709309989.496747,-21600,,
com.apple.finder,1,1709308347,1709308348,1709308348.7304912,-21600,,
com.leomehlig.today,11,1709308336,1709308347,1709308347.3779159,-21600,,
com.facebook.Facebook,281,1709308019,1709308300,1709308300.977392,-21600,EB445137-D7F5-57EC-87DA-1DB460D64046,"iPhone13,2"
com.thestorygraph.thestorygraph,12,1709308003,1709308015,1709308015.73461,-21600,EB445137-D7F5-57EC-87DA-1DB460D64046,"iPhone13,2"
com.apple.Health,4,1709307997,1709308001,1709308001.454251,-21600,EB445137-D7F5-57EC-87DA-1DB460D64046,"iPhone13,2"
com.apple.Health,4,1709307171,1709307175,1709307175.563544,-21600,EB445137-D7F5-57EC-87DA-1DB460D64046,"iPhone13,2"
com.apple.Health,10,1709306308,1709306318,1709306318.825458,-21600,EB445137-D7F5-57EC-87DA-1DB460D64046,"iPhone13,2"
com.leomehlig.today,55,1709305976,1709306031,1709306031.436201,-21600,,
com.apple.Notes,91,1709305885,1709305976,1709305976.62563,-21600,,
com.leomehlig.today,11,1709305874,1709305885,1709305885.560869,-21600,,
com.apple.Notes,20,1709305854,1709305874,1709305874.513976,-21600,,
com.leomehlig.today,5,1709305849,1709305854,1709305854.776525,-21600,,
com.apple.Health,67,1709305779,1709305846,1709305846.2878761,-21600,EB445137-D7F5-57EC-87DA-1DB460D64046,"iPhone13,2"
com.apple.Preferences,21,1709305754,1709305775,1709305775.295189,-21600,EB445137-D7F5-57EC-87DA-1DB460D64046,"iPhone13,2"
com.apple.weather,5,1709305745,1709305750,1709305750.7874851,-21600,EB445137-D7F5-57EC-87DA-1DB460D64046,"iPhone13,2"
com.apple.weather,28,1709304025,1709304053,1709304053.326343,-21600,EB445137-D7F5-57EC-87DA-1DB460D64046,"iPhone13,2"
com.apple.PosterBoard,10,1709303997,1709304007,1709304007.2109199,-21600,EB445137-D7F5-57EC-87DA-1DB460D64046,"iPhone13,2"
com.thestorygraph.thestorygraph,14,1709271449,1709271463,1709271463.233671,-21600,EB445137-D7F5-57EC-87DA-1DB460D64046,"iPhone13,2"
com.leomehlig.today,2,1709264699,1709264701,1709264701.653101,-21600,,
com.apple.finder,0,1709264699,1709264699,1709264700.105565,-21600,,
com.apple.Notes,79,1709264620,1709264699,1709264699.3093162,-21600,,
com.leomehlig.today,66,1709264554,1709264620,1709264620.1266022,-21600,,
com.google.Chrome,572,1709263982,1709264554,1709264554.323021,-21600,,
com.apple.Notes,42,1709263567,1709263609,1709263609.634815,-21600,,
com.google.Chrome,75,1709263492,1709263567,1709263568.040288,-21600,,
com.apple.Notes,4,1709263488,1709263492,1709263492.446465,-21600,,
com.apple.Preview,1,1709263487,1709263488,1709263488.7617002,-21600,,
com.google.Chrome,430,1709263057,1709263487,1709263487.796111,-21600,,
com.apple.Preview,82,1709262975,1709263057,1709263057.9940748,-21600,,
com.google.Chrome,27,1709262948,1709262975,1709262975.58892,-21600,,
com.apple.Notes,8,1709262940,1709262948,1709262948.533231,-21600,,
com.apple.Preview,404,1709262536,1709262940,1709262940.3907561,-21600,,
com.apple.Notes,693,1709261843,1709262536,1709262536.3596702,-21600,,
com.apple.Preview,6,1709261837,1709261843,1709261843.913399,-21600,,
com.apple.Notes,11,1709261826,1709261837,1709261838.0525122,-21600,,
com.apple.Preview,1,1709261825,1709261826,1709261826.397109,-21600,,
com.apple.Notes,1,1709261824,1709261825,1709261825.831585,-21600,,
com.google.Chrome,245,1709261579,1709261824,1709261825.0068688,-21600,,
com.apple.Notes,3,1709261576,1709261579,1709261579.188003,-21600,,
com.google.Chrome,237,1709261339,1709261576,1709261576.984457,-21600,,
com.apple.Notes,4,1709261335,1709261339,1709261339.9050379,-21600,,
com.google.Chrome,4,1709261331,1709261335,1709261335.057874,-21600,,
com.apple.Preview,768,1709260563,1709261331,1709261331.338029,-21600,,
com.google.Chrome,4,1709260559,1709260563,1709260563.593495,-21600,,
com.leomehlig.today,8,1709260551,1709260559,1709260559.349297,-21600,,
com.apple.iCal,13,1709260538,1709260551,1709260551.271649,-21600,,
com.leomehlig.today,31,1709260507,1709260538,1709260538.7551088,-21600,,
com.google.Chrome,7,1709260500,1709260507,1709260507.89697,-21600,,
com.microsoft.VSCode,25,1709260475,1709260500,1709260500.3897471,-21600,,
com.microsoft.VSCode,402,1709258307,1709258709,1709258709.503519,-21600,,
com.google.Chrome,20,1709258287,1709258307,1709258307.951292,-21600,,
com.microsoft.VSCode,338,1709257949,1709258287,1709258287.2038388,-21600,,
com.google.Chrome,76,1709257873,1709257949,1709257949.9594169,-21600,,
com.microsoft.VSCode,7,1709257866,1709257873,1709257873.761203,-21600,,
com.google.Chrome,4,1709257862,1709257866,1709257867.0298061,-21600,,
com.microsoft.VSCode,32,1709257830,1709257862,1709257862.598649,-21600,,
com.google.Chrome,114,1709257716,1709257830,1709257830.4394841,-21600,,
com.apple.systempreferences,1,1709257711,1709257712,1709257713.0779681,-21600,,
com.google.Chrome,27,1709257682,1709257709,1709257709.49868,-21600,,
com.microsoft.VSCode,36,1709257646,1709257682,1709257682.9480782,-21600,,
com.google.Chrome,32,1709257614,1709257646,1709257646.877224,-21600,,
com.microsoft.VSCode,213,1709257401,1709257614,1709257614.5177422,-21600,,
com.google.Chrome,20,1709257381,1709257401,1709257401.9176002,-21600,,
com.microsoft.VSCode,16,1709257365,1709257381,1709257381.667058,-21600,,
com.google.Chrome,15,1709257350,1709257365,1709257365.780779,-21600,,
com.microsoft.VSCode,170,1709257180,1709257350,1709257350.1994162,-21600,,
com.apple.finder,21,1709257159,1709257180,1709257180.640393,-21600,,
com.google.Chrome,5,1709257154,1709257159,1709257159.676457,-21600,,
com.microsoft.VSCode,30,1709257124,1709257154,1709257155.0897322,-21600,,
com.apple.finder,69,1709257055,1709257124,1709257124.608972,-21600,,
com.google.Chrome,0,1709257055,1709257055,1709257056.0751529,-21600,,
com.microsoft.VSCode,5,1709257050,1709257055,1709257055.434663,-21600,,
com.google.Chrome,150,1709256900,1709257050,1709257051.0824351,-21600,,
com.microsoft.VSCode,90,1709256810,1709256900,1709256900.345059,-21600,,
com.google.Chrome,26,1709256784,1709256810,1709256810.04817,-21600,,
com.microsoft.VSCode,460,1709256324,1709256784,1709256784.8636699,-21600,,
com.google.Chrome,431,1709255893,1709256324,1709256324.476434,-21600,,
com.microsoft.VSCode,190,1709255703,1709255893,1709255893.867904,-21600,,
com.google.Chrome,166,1709255537,1709255703,1709255703.108677,-21600,,
com.microsoft.VSCode,268,1709255269,1709255537,1709255537.894628,-21600,,
com.apple.MobileSMS,28,1709255241,1709255269,1709255269.753162,-21600,,
com.microsoft.VSCode,8,1709255233,1709255241,1709255241.605547,-21600,,
com.apple.MobileSMS,8,1709255225,1709255233,1709255233.9062371,-21600,,
com.microsoft.VSCode,31,1709255194,1709255225,1709255225.8350549,-21600,,
com.apple.finder,11,1709255183,1709255194,1709255194.6323152,-21600,,
com.google.Chrome,10,1709255173,1709255183,1709255183.854381,-21600,,
com.apple.Preview,186,1709254987,1709255173,1709255173.9663448,-21600,,
com.apple.Preview,862,1709252894,1709253756,1709253756.92944,-21600,,
com.leomehlig.today,77,1709252817,1709252894,1709252894.479305,-21600,,
com.apple.iCal,21,1709252796,1709252817,1709252817.293051,-21600,,
com.leomehlig.today,4,1709252792,1709252796,1709252796.0479422,-21600,,
com.google.Chrome,83,1709252709,1709252792,1709252792.200255,-21600,,
com.apple.MobileSMS,10,1709252699,1709252709,1709252709.884764,-21600,,
com.google.Chrome,5,1709252694,1709252699,1709252699.7224631,-21600,,
com.google.Chrome,109,1709247530,1709247639,1709247639.1850882,-21600,,
com.microsoft.rdc.macos,3,1709247512,1709247515,1709247515.53035,-21600,,
com.microsoft.rdc.macos,907,1709246581,1709247488,1709247488.317409,-21600,,
com.apple.MobileSMS,21,1709246560,1709246581,1709246581.704577,-21600,,
com.apple.MobileSMS,5,1709242916,1709242921,1709242922.026462,-21600,,
com.google.Chrome,18,1709242898,1709242916,1709242916.277762,-21600,,
us.zoom.xos,40,1709242858,1709242898,1709242898.9221,-21600,,
us.zoom.xos,30,1709241677,1709241707,1709241707.29037,-21600,,
us.zoom.xos,300,1709241340,1709241640,1709241640.676682,-21600,,
com.google.Chrome,26,1709241314,1709241340,1709241340.69543,-21600,,
us.zoom.xos,286,1709241028,1709241314,1709241314.097213,-21600,,
com.toyopagroup.picaboo,3,1709240757,1709240760,1709240760.350641,-21600,EB445137-D7F5-57EC-87DA-1DB460D64046,"iPhone13,2"
com.apple.Preferences,270,1709240393,1709240663,1709240664.245339,-21600,EB445137-D7F5-57EC-87DA-1DB460D64046,"iPhone13,2"
us.zoom.xos,697,1709240116,1709240813,1709240813.36609,-21600,,
com.leomehlig.today,79,1709240037,1709240116,1709240116.95333,-21600,,
us.zoom.xos,295,1709239742,1709240037,1709240037.365923,-21600,,
org.stellarium.Stellarium,304,1709239438,1709239742,1709239742.6601958,-21600,,
com.ryansponzilli.DeepSkyCatalog,353,1709239437,1709239790,1709239790.835558,-21600,EB445137-D7F5-57EC-87DA-1DB460D64046,"iPhone13,2"
us.zoom.xos,3,1709239435,1709239438,1709239438.360941,-21600,,
com.ryansponzilli.DeepSkyCatalog,45,1709239389,1709239434,1709239434.9632568,-21600,EB445137-D7F5-57EC-87DA-1DB460D64046,"iPhone13,2"
Astrospheric.Astrospheric,21,1709239352,1709239373,1709239373.193204,-21600,EB445137-D7F5-57EC-87DA-1DB460D64046,"iPhone13,2"
us.zoom.xos,314,1709239098,1709239412,1709239412.309139,-21600,,
com.burbn.instagram,344,1709238730,1709239074,1709239075.035748,-21600,EB445137-D7F5-57EC-87DA-1DB460D64046,"iPhone13,2"
com.google.Gmail,28,1709238694,1709238722,1709238722.315656,-21600,EB445137-D7F5-57EC-87DA-1DB460D64046,"iPhone13,2"
com.truebill.truebillnative,69,1709238625,1709238694,1709238694.3261352,-21600,EB445137-D7F5-57EC-87DA-1DB460D64046,"iPhone13,2"
com.robinhood.release.Robinhood,18,1709238606,1709238624,1709238624.728971,-21600,EB445137-D7F5-57EC-87DA-1DB460D64046,"iPhone13,2"
us.zoom.xos,545,1709238552,1709239097,1709239097.91732,-21600,,
com.hammerandchisel.discord,148,1709238294,1709238442,1709238442.891876,-21600,EB445137-D7F5-57EC-87DA-1DB460D64046,"iPhone13,2"
com.toyopagroup.picaboo,24,1709238268,1709238292,1709238292.1517382,-21600,EB445137-D7F5-57EC-87DA-1DB460D64046,"iPhone13,2"
us.zoom.xos,301,1709238231,1709238532,1709238532.667798,-21600,,
com.google.Chrome,54,1709238177,1709238231,1709238231.7055101,-21600,,
us.zoom.xos,3,1709238174,1709238177,1709238178.038733,-21600,,
com.google.Chrome,2,1709238172,1709238174,1709238174.7795792,-21600,,
us.zoom.xos,17,1709238001,1709238018,1709238018.490481,-21600,,
com.toyopagroup.picaboo,10,1709237955,1709237965,1709237965.461247,-21600,EB445137-D7F5-57EC-87DA-1DB460D64046,"iPhone13,2"
com.google.Chrome,254,1709237747,1709238001,1709238001.1053371,-21600,,
us.zoom.xos,26,1709237721,1709237747,1709237747.78491,-21600,,
com.google.Chrome,73,1709237648,1709237721,1709237721.10197,-21600,,
us.zoom.xos,1,1709237647,1709237648,1709237648.745946,-21600,,
com.google.Chrome,32,1709237615,1709237647,1709237647.912218,-21600,,
us.zoom.xos,5,1709237610,1709237615,1709237615.464385,-21600,,
com.google.Chrome,95,1709237515,1709237610,1709237610.377744,-21600,,
us.zoom.xos,98,1709237417,1709237515,1709237515.540691,-21600,,
com.burbn.instagram,504,1709236912,1709237416,1709237416.4105449,-21600,EB445137-D7F5-57EC-87DA-1DB460D64046,"iPhone13,2"
us.zoom.xos,301,1709236904,1709237205,1709237205.528318,-21600,,
com.google.Chrome,51,1709236853,1709236904,1709236904.336312,-21600,,
us.zoom.xos,46,1709236807,1709236853,1709236853.87922,-21600,,
com.google.Chrome,3,1709236804,1709236807,1709236807.884589,-21600,,
us.zoom.xos,0,1709236804,1709236804,1709236805.0225859,-21600,,
com.burbn.instagram,185,1709236609,1709236794,1709236794.314025,-21600,EB445137-D7F5-57EC-87DA-1DB460D64046,"iPhone13,2"
com.tinyspeck.chatlyio,15,1709236594,1709236609,1709236609.582302,-21600,EB445137-D7F5-57EC-87DA-1DB460D64046,"iPhone13,2"
com.apple.Music,4,1709236588,1709236592,1709236592.2915468,-21600,EB445137-D7F5-57EC-87DA-1DB460D64046,"iPhone13,2"
com.google.Chrome,235,1709236569,1709236804,1709236804.312152,-21600,,
com.apple.Notes,3,1709236566,1709236569,1709236569.846998,-21600,,
com.google.Chrome,3,1709236563,1709236566,1709236566.9656081,-21600,,
com.apple.Preview,1,1709236562,1709236563,1709236563.536941,-21600,,
com.google.Chrome,2,1709236560,1709236562,1709236562.799694,-21600,,
com.apple.Preview,6,1709236554,1709236560,1709236560.420065,-21600,,
com.google.Chrome,8,1709236546,1709236554,1709236554.3384519,-21600,,
com.leomehlig.today,46,1709236500,1709236546,1709236546.372737,-21600,,
com.google.Chrome,22,1709236478,1709236500,1709236500.95219,-21600,,
com.apple.finder,4,1709236474,1709236478,1709236478.681397,-21600,,
com.apple.Preview,1,1709236473,1709236474,1709236474.569334,-21600,,
com.google.Chrome,649,1709235824,1709236473,1709236473.613755,-21600,,
com.apple.finder,20,1709235804,1709235824,1709235825.0007238,-21600,,
com.apple.archiveutility,0,1709235804,1709235804,1709235804.916661,-21600,,
com.apple.finder,7,1709235797,1709235804,1709235804.6233191,-21600,,
com.google.Chrome,39,1709235758,1709235797,1709235797.773341,-21600,,
com.apple.Notes,6,1709235752,1709235758,1709235758.969823,-21600,,
com.apple.Music,2,1709235438,1709235440,1709235440.268786,-21600,EB445137-D7F5-57EC-87DA-1DB460D64046,"iPhone13,2"
com.apple.Music,20,1709234162,1709234182,1709234182.784587,-21600,EB445137-D7F5-57EC-87DA-1DB460D64046,"iPhone13,2"
com.apple.mobiletimer,4,1709234158,1709234162,1709234162.3445601,-21600,EB445137-D7F5-57EC-87DA-1DB460D64046,"iPhone13,2"
com.apple.mobiletimer,6,1709233772,1709233778,1709233778.840761,-21600,EB445137-D7F5-57EC-87DA-1DB460D64046,"iPhone13,2"
com.apple.mobiletimer,6,1709233717,1709233723,1709233723.5224872,-21600,EB445137-D7F5-57EC-87DA-1DB460D64046,"iPhone13,2"
com.apple.mobiletimer,2,1709233710,1709233712,1709233712.5705152,-21600,EB445137-D7F5-57EC-87DA-1DB460D64046,"iPhone13,2"
com.facebook.Facebook,77,1709233633,1709233710,1709233710.380815,-21600,EB445137-D7F5-57EC-87DA-1DB460D64046,"iPhone13,2"
com.tinyspeck.chatlyio,3,1709233623,1709233626,1709233626.923235,-21600,EB445137-D7F5-57EC-87DA-1DB460D64046,"iPhone13,2"
com.apple.Notes,302,1709233601,1709233903,1709233903.7991009,-21600,,
com.google.Chrome,3,1709233598,1709233601,1709233601.4901628,-21600,,
com.tinyspeck.chatlyio,33,1709233545,1709233578,1709233579.006573,-21600,EB445137-D7F5-57EC-87DA-1DB460D64046,"iPhone13,2"
com.microsoft.Office.Outlook,2,1709233540,1709233542,1709233542.4851708,-21600,EB445137-D7F5-57EC-87DA-1DB460D64046,"iPhone13,2"
com.leomehlig.today,83,1709233515,1709233598,1709233598.530682,-21600,,
com.apple.iCal,2,1709233513,1709233515,1709233515.795117,-21600,,
com.leomehlig.today,1,1709233512,1709233513,1709233513.851968,-21600,,
com.microsoft.Office.Outlook,35,1709233474,1709233509,1709233509.501968,-21600,EB445137-D7F5-57EC-87DA-1DB460D64046,"iPhone13,2"
com.apple.mobiletimer,4,1709233468,1709233472,1709233472.546781,-21600,EB445137-D7F5-57EC-87DA-1DB460D64046,"iPhone13,2"
com.google.Chrome,50,1709233462,1709233512,1709233512.24264,-21600,,
com.leomehlig.today,62,1709233400,1709233462,1709233462.810226,-21600,,
com.apple.mobiletimer,8,1709233388,1709233396,1709233396.778764,-21600,EB445137-D7F5-57EC-87DA-1DB460D64046,"iPhone13,2"
com.google.Chrome,407,1709232993,1709233400,1709233401.132574,-21600,,
com.apple.Notes,3,1709232990,1709232993,1709232993.602354,-21600,,
com.google.Chrome,73,1709232917,1709232990,1709232990.724907,-21600,,
com.apple.Notes,1,1709232916,1709232917,1709232917.6045089,-21600,,
com.apple.mobiletimer,7,1709232877,1709232884,1709232884.177517,-21600,EB445137-D7F5-57EC-87DA-1DB460D64046,"iPhone13,2"
com.apple.mobiletimer,6,1709232869,1709232875,1709232875.747988,-21600,EB445137-D7F5-57EC-87DA-1DB460D64046,"iPhone13,2"
com.google.Chrome,81,1709232835,1709232916,1709232916.367498,-21600,,
com.apple.Notes,17,1709232818,1709232835,1709232835.6902199,-21600,,
com.apple.Preview,729,1709232089,1709232818,1709232818.58969,-21600,,
com.apple.mobiletimer,3,1709231965,1709231968,1709231969.0156531,-21600,EB445137-D7F5-57EC-87DA-1DB460D64046,"iPhone13,2"
com.burbn.instagram,2,1709231963,1709231965,1709231965.583593,-21600,EB445137-D7F5-57EC-87DA-1DB460D64046,"iPhone13,2"
com.burbn.instagram,79,1709231867,1709231946,1709231946.745353,-21600,EB445137-D7F5-57EC-87DA-1DB460D64046,"iPhone13,2"
com.burbn.instagram,142,1709231717,1709231859,1709231859.58658,-21600,EB445137-D7F5-57EC-87DA-1DB460D64046,"iPhone13,2"
com.apple.news,6,1709231710,1709231716,1709231716.352052,-21600,EB445137-D7F5-57EC-87DA-1DB460D64046,"iPhone13,2"
com.apple.news,6,1709231551,1709231557,1709231557.2807279,-21600,EB445137-D7F5-57EC-87DA-1DB460D64046,"iPhone13,2"
com.apple.news,8,1709231537,1709231545,1709231545.907483,-21600,EB445137-D7F5-57EC-87DA-1DB460D64046,"iPhone13,2"
com.apple.news,6,1709231521,1709231527,1709231527.6878738,-21600,EB445137-D7F5-57EC-87DA-1DB460D64046,"iPhone13,2"
com.apple.news,6,1709231450,1709231456,1709231456.8790622,-21600,EB445137-D7F5-57EC-87DA-1DB460D64046,"iPhone13,2"
com.apple.news,6,1709231245,1709231251,1709231251.2616758,-21600,EB445137-D7F5-57EC-87DA-1DB460D64046,"iPhone13,2"
com.apple.news,6,1709231092,1709231098,1709231098.648178,-21600,EB445137-D7F5-57EC-87DA-1DB460D64046,"iPhone13,2"
com.apple.Preview,1549,1709230289,1709231838,1709231838.3556662,-21600,,
com.apple.finder,1,1709230288,1709230289,1709230291.3991241,-21600,,
com.apple.Preview,1,1709230287,1709230288,1709230291.298696,-21600,,
com.google.Chrome,2,1709230285,1709230287,1709230287.135005,-21600,,
com.apple.news,1,1709230257,1709230258,1709230259.08608,-21600,EB445137-D7F5-57EC-87DA-1DB460D64046,"iPhone13,2"
com.apple.news,17,1709230183,1709230200,1709230200.907865,-21600,EB445137-D7F5-57EC-87DA-1DB460D64046,"iPhone13,2"
com.apple.mobiletimer,3,1709230180,1709230183,1709230183.2040439,-21600,EB445137-D7F5-57EC-87DA-1DB460D64046,"iPhone13,2"
com.apple.mobiletimer,3,1709230155,1709230158,1709230158.7359838,-21600,EB445137-D7F5-57EC-87DA-1DB460D64046,"iPhone13,2"
com.apple.news,2,1709230153,1709230155,1709230155.577188,-21600,EB445137-D7F5-57EC-87DA-1DB460D64046,"iPhone13,2"
com.apple.news,71,1709230002,1709230073,1709230073.627685,-21600,EB445137-D7F5-57EC-87DA-1DB460D64046,"iPhone13,2"
com.apple.news,8,1709229869,1709229877,1709229877.403245,-21600,EB445137-D7F5-57EC-87DA-1DB460D64046,"iPhone13,2"
com.apple.news,3,1709229764,1709229767,1709229768.9918032,-21600,EB445137-D7F5-57EC-87DA-1DB460D64046,"iPhone13,2"
com.apple.news,134,1709229472,1709229606,1709229606.790446,-21600,EB445137-D7F5-57EC-87DA-1DB460D64046,"iPhone13,2"
com.apple.news,1,1709229419,1709229420,1709229420.725091,-21600,EB445137-D7F5-57EC-87DA-1DB460D64046,"iPhone13,2"
com.apple.news,3,1709229239,1709229242,1709229242.9545069,-21600,EB445137-D7F5-57EC-87DA-1DB460D64046,"iPhone13,2"
com.apple.news,165,1709229045,1709229210,1709229210.4066281,-21600,EB445137-D7F5-57EC-87DA-1DB460D64046,"iPhone13,2"
com.apple.mobiletimer,5,1709229035,1709229040,1709229040.117165,-21600,EB445137-D7F5-57EC-87DA-1DB460D64046,"iPhone13,2"
com.apple.mobiletimer,4,1709228545,1709228549,1709228549.767575,-21600,EB445137-D7F5-57EC-87DA-1DB460D64046,"iPhone13,2"
edu.illinois.rokwire.ios,5,1709228538,1709228543,1709228543.513112,-21600,EB445137-D7F5-57EC-87DA-1DB460D64046,"iPhone13,2"
edu.illinois.rokwire.ios,9,1709228522,1709228531,1709228531.589507,-21600,EB445137-D7F5-57EC-87DA-1DB460D64046,"iPhone13,2"
edu.illinois.rokwire.ios,1,1709228521,1709228522,1709228522.212672,-21600,EB445137-D7F5-57EC-87DA-1DB460D64046,"iPhone13,2"
com.apple.camera,1,1709228278,1709228279,1709228281.371357,-21600,EB445137-D7F5-57EC-87DA-1DB460D64046,"iPhone13,2"
edu.illinois.rokwire.ios,5,1709228274,1709228279,1709228281.4218469,-21600,EB445137-D7F5-57EC-87DA-1DB460D64046,"iPhone13,2"
edu.illinois.rokwire.ios,24,1709227902,1709227926,1709227926.276017,-21600,EB445137-D7F5-57EC-87DA-1DB460D64046,"iPhone13,2"
com.toyopagroup.picaboo,6,1709227893,1709227899,1709227899.304109,-21600,EB445137-D7F5-57EC-87DA-1DB460D64046,"iPhone13,2"
com.toyopagroup.picaboo,7,1709227106,1709227113,1709227113.277975,-21600,EB445137-D7F5-57EC-87DA-1DB460D64046,"iPhone13,2"
com.google.Chrome,66,1709226980,1709227046,1709227046.720776,-21600,,
com.apple.finder,18,1709226962,1709226980,1709226980.132735,-21600,,
com.google.Chrome,22,1709226940,1709226962,1709226962.304158,-21600,,
com.apple.finder,9,1709226931,1709226940,1709226940.860276,-21600,,
com.google.Chrome,5,1709226926,1709226931,1709226931.3401132,-21600,,
com.apple.finder,17,1709226909,1709226926,1709226926.613575,-21600,,
com.google.Chrome,13,1709226896,1709226909,1709226909.157172,-21600,,
com.apple.Preview,35,1709226861,1709226896,1709226896.85676,-21600,,
com.google.Chrome,1,1709226860,1709226861,1709226861.6019,-21600,,
com.apple.Preview,2,1709226858,1709226860,1709226861.014235,-21600,,
com.google.Chrome,3,1709226855,1709226858,1709226859.0043402,-21600,,
com.apple.Preview,3,1709226852,1709226855,1709226855.0700278,-21600,,
com.google.Chrome,1,1709226851,1709226852,1709226852.606501,-21600,,
com.apple.Preview,3,1709226848,1709226851,1709226851.588423,-21600,,
com.google.Chrome,3,1709226845,1709226848,1709226848.095535,-21600,,
com.apple.Preview,4,1709226841,1709226845,1709226845.6272922,-21600,,
com.google.Chrome,2,1709226839,1709226841,1709226841.6498852,-21600,,
com.apple.Preview,14,1709226825,1709226839,1709226839.168793,-21600,,
com.google.Chrome,21,1709226804,1709226825,1709226825.673888,-21600,,
com.apple.Preview,30,1709226774,1709226804,1709226804.7031388,-21600,,
com.google.Chrome,14,1709226760,1709226774,1709226774.787797,-21600,,
com.apple.Preview,20,1709226740,1709226760,1709226760.371821,-21600,,
com.google.Chrome,4,1709226736,1709226740,1709226740.56146,-21600,,
com.apple.Preview,50,1709226686,1709226736,1709226736.171695,-21600,,
com.google.Chrome,9,1709226677,1709226686,1709226686.289532,-21600,,
com.apple.Preview,61,1709226616,1709226677,1709226677.739821,-21600,,
com.google.Chrome,11,1709226605,1709226616,1709226616.5339751,-21600,,
com.apple.Preview,3,1709226602,1709226605,1709226605.459694,-21600,,
com.google.Chrome,10,1709226592,1709226602,1709226602.842564,-21600,,
com.apple.Preview,44,1709226548,1709226592,1709226592.317174,-21600,,
com.google.Chrome,2,1709226546,1709226548,1709226548.253124,-21600,,
com.apple.Preview,4,1709226542,1709226546,1709226546.783963,-21600,,
com.google.Chrome,0,1709226542,1709226542,1709226542.8604279,-21600,,
com.apple.Preview,4,1709226538,1709226542,1709226542.175772,-21600,,
com.google.Chrome,3,1709226535,1709226538,1709226538.0567532,-21600,,
com.apple.Preview,7,1709226528,1709226535,1709226535.051502,-21600,,
com.google.Chrome,26,1709226502,1709226528,1709226528.6044269,-21600,,
com.apple.Preview,4,1709226498,1709226502,1709226502.310164,-21600,,
com.google.Chrome,3,1709226495,1709226498,1709226498.44187,-21600,,
com.apple.Preview,4,1709226491,1709226495,1709226495.932674,-21600,,
com.google.Chrome,10,1709226481,1709226491,1709226491.947254,-21600,,
com.apple.Preview,188,1709226293,1709226481,1709226481.183928,-21600,,
com.google.Chrome,2,1709226291,1709226293,1709226293.424612,-21600,,
com.apple.Preview,2,1709226289,1709226291,1709226291.820798,-21600,,
com.google.Chrome,2,1709226287,1709226289,1709226289.103191,-21600,,
com.apple.Preview,6,1709226281,1709226287,1709226287.825797,-21600,,
com.google.Chrome,3,1709226278,1709226281,1709226281.930956,-21600,,
com.apple.Preview,30,1709226248,1709226278,1709226278.610318,-21600,,
com.google.Chrome,73,1709226175,1709226248,1709226248.164287,-21600,,
com.apple.Preview,71,1709226104,1709226175,1709226175.5926251,-21600,,
com.google.Chrome,11,1709226093,1709226104,1709226104.932407,-21600,,
com.apple.Preview,2,1709226091,1709226093,1709226093.181666,-21600,,
com.google.Chrome,1,1709226090,1709226091,1709226091.475178,-21600,,
com.apple.Preview,3,1709226087,1709226090,1709226090.818152,-21600,,
com.google.Chrome,15,1709226072,1709226087,1709226087.545486,-21600,,
com.apple.Preview,64,1709226008,1709226072,1709226072.925106,-21600,,
com.google.Chrome,1,1709226007,1709226008,1709226008.1066952,-21600,,
com.apple.Preview,4,1709226003,1709226007,1709226007.307734,-21600,,
com.google.Chrome,1,1709226002,1709226003,1709226003.157572,-21600,,
com.apple.Preview,3,1709225999,1709226002,1709226002.411405,-21600,,
com.google.Chrome,1,1709225998,1709225999,1709225999.923956,-21600,,
com.apple.Preview,5,1709225993,1709225998,1709225999.032473,-21600,,
com.google.Chrome,1,1709225992,1709225993,1709225993.948225,-21600,,
com.apple.Preview,4,1709225988,1709225992,1709225992.3783169,-21600,,
com.google.Chrome,2,1709225986,1709225988,1709225988.9521952,-21600,,
com.apple.Preview,11,1709225975,1709225986,1709225986.31994,-21600,,
com.google.Chrome,24,1709225951,1709225975,1709225975.096599,-21600,,
com.apple.Preview,59,1709225892,1709225951,1709225951.6943278,-21600,,
com.google.Chrome,61,1709225831,1709225892,1709225892.349306,-21600,,
com.apple.Preview,49,1709225782,1709225831,1709225831.574909,-21600,,
com.google.Chrome,44,1709225738,1709225782,1709225782.735468,-21600,,
com.apple.Preview,18,1709225720,1709225738,1709225738.805503,-21600,,
com.google.Chrome,4,1709225716,1709225720,1709225720.558094,-21600,,
com.apple.Preview,20,1709225696,1709225716,1709225716.078158,-21600,,
com.google.Chrome,117,1709225579,1709225696,1709225696.162022,-21600,,
com.apple.Preview,40,1709225539,1709225579,1709225579.651719,-21600,,
com.google.Chrome,2,1709225537,1709225539,1709225540.053091,-21600,,
com.apple.Preview,7,1709225530,1709225537,1709225537.881958,-21600,,
com.google.Chrome,11,1709225519,1709225530,1709225530.3377,-21600,,
com.apple.Preview,51,1709225468,1709225519,1709225519.205533,-21600,,
com.google.Chrome,5,1709225463,1709225468,1709225468.172511,-21600,,
com.apple.Preview,35,1709225428,1709225463,1709225463.10798,-21600,,
com.google.Chrome,2,1709225426,1709225428,1709225428.303554,-21600,,
com.apple.Preview,5,1709225421,1709225426,1709225426.8527179,-21600,,
com.google.Chrome,14,1709225407,1709225421,1709225421.5512772,-21600,,
com.apple.Preview,68,1709225339,1709225407,1709225407.899118,-21600,,
com.google.Chrome,1,1709225338,1709225339,1709225339.5625901,-21600,,
com.apple.Preview,2,1709225336,1709225338,1709225338.628303,-21600,,
com.google.Chrome,5,1709225331,1709225336,1709225336.351418,-21600,,
com.toyopagroup.picaboo,36,1709225067,1709225103,1709225103.7054682,-21600,EB445137-D7F5-57EC-87DA-1DB460D64046,"iPhone13,2"
com.apple.news,1,1709225066,1709225067,1709225068.770128,-21600,EB445137-D7F5-57EC-87DA-1DB460D64046,"iPhone13,2"
com.apple.Preview,286,1709225045,1709225331,1709225331.273241,-21600,,
com.google.Chrome,123,1709224922,1709225045,1709225045.814681,-21600,,
com.apple.Preview,37,1709224885,1709224922,1709224922.839855,-21600,,
com.google.Chrome,3,1709224882,1709224885,1709224885.939784,-21600,,
com.apple.Preview,4,1709224878,1709224882,1709224882.079976,-21600,,
com.google.Chrome,1,1709224877,1709224878,1709224878.86955,-21600,,
com.apple.Preview,5,1709224872,1709224877,1709224877.430177,-21600,,
com.google.Chrome,47,1709224825,1709224872,1709224872.584403,-21600,,
com.apple.Preview,128,1709224697,1709224825,1709224825.413044,-21600,,
com.apple.finder,1,1709224696,1709224697,1709224698.234057,-21600,,
com.google.Chrome,22,1709224674,1709224696,1709224696.48557,-21600,,
com.apple.news,55,1709222755,1709222810,1709222810.5769,-21600,EB445137-D7F5-57EC-87DA-1DB460D64046,"iPhone13,2"
com.apple.Health,43,1709222704,1709222747,1709222747.545757,-21600,EB445137-D7F5-57EC-87DA-1DB460D64046,"iPhone13,2"
com.google.Chrome,509,1709222483,1709222992,1709222992.186112,-21600,,
com.apple.finder,30,1709222453,1709222483,1709222483.695006,-21600,,
com.google.Chrome,130,1709222323,1709222453,1709222453.879051,-21600,,
com.leomehlig.today,10,1709222313,1709222323,1709222323.276403,-21600,,
com.apple.Health,4,1709222298,1709222302,1709222302.329762,-21600,EB445137-D7F5-57EC-87DA-1DB460D64046,"iPhone13,2"
com.apple.Health,2,1709222139,1709222141,1709222141.317954,-21600,EB445137-D7F5-57EC-87DA-1DB460D64046,"iPhone13,2"
com.apple.Health,6,1709221979,1709221985,1709221985.244884,-21600,EB445137-D7F5-57EC-87DA-1DB460D64046,"iPhone13,2"
com.apple.Health,2,1709221975,1709221977,1709221977.644279,-21600,EB445137-D7F5-57EC-87DA-1DB460D64046,"iPhone13,2"
com.apple.Health,2,1709221973,1709221975,1709221975.2338681,-21600,EB445137-D7F5-57EC-87DA-1DB460D64046,"iPhone13,2"
com.apple.Health,2,1709221782,1709221784,1709221784.89995,-21600,EB445137-D7F5-57EC-87DA-1DB460D64046,"iPhone13,2"
com.apple.Health,10,1709221352,1709221362,1709221362.696185,-21600,EB445137-D7F5-57EC-87DA-1DB460D64046,"iPhone13,2"
com.apple.weather,3,1709221348,1709221351,1709221351.428164,-21600,EB445137-D7F5-57EC-87DA-1DB460D64046,"iPhone13,2"
com.apple.weather,2,1709221176,1709221178,1709221178.836361,-21600,EB445137-D7F5-57EC-87DA-1DB460D64046,"iPhone13,2"
com.leomehlig.today,91,1709221042,1709221133,1709221133.300758,-21600,,
com.apple.Preview,3,1709221039,1709221042,1709221042.879488,-21600,,
com.apple.finder,1292,1709219726,1709221018,1709221018.2744899,-21600,,
com.apple.Preview,2,1709219724,1709219726,1709219726.48,-21600,,
com.apple.finder,2,1709219722,1709219724,1709219724.6578112,-21600,,
com.google.Chrome,33,1709219689,1709219722,1709219722.9534168,-21600,,
com.leomehlig.today,3,1709219686,1709219689,1709219690.3280869,-21600,,
com.markhambly.APOD,83,1709219576,1709219659,1709219659.968151,-21600,EB445137-D7F5-57EC-87DA-1DB460D64046,"iPhone13,2"
com.apple.MobileSMS,3,1709219569,1709219572,1709219572.851636,-21600,EB445137-D7F5-57EC-87DA-1DB460D64046,"iPhone13,2"
com.toyopagroup.picaboo,52,1709219516,1709219568,1709219568.2984161,-21600,EB445137-D7F5-57EC-87DA-1DB460D64046,"iPhone13,2"
com.apple.Health,3,1709219513,1709219516,1709219516.143707,-21600,EB445137-D7F5-57EC-87DA-1DB460D64046,"iPhone13,2"
com.apple.Health,6,1709219466,1709219472,1709219472.463431,-21600,EB445137-D7F5-57EC-87DA-1DB460D64046,"iPhone13,2"
com.apple.Health,13,1709219451,1709219464,1709219464.293373,-21600,EB445137-D7F5-57EC-87DA-1DB460D64046,"iPhone13,2"
com.apple.weather,14,1709219437,1709219451,1709219451.473048,-21600,EB445137-D7F5-57EC-87DA-1DB460D64046,"iPhone13,2"
com.leomehlig.today,205,1709177315,1709177520,1709177520.609175,-21600,,
com.apple.Notes,21,1709177294,1709177315,1709177315.664001,-21600,,
com.leomehlig.today,16,1709177278,1709177294,1709177294.44725,-21600,,
com.apple.Notes,12,1709177266,1709177278,1709177278.839388,-21600,,
com.apple.Preview,476,1709176790,1709177266,1709177266.185732,-21600,,
com.apple.Notes,25,1709176765,1709176790,1709176790.393822,-21600,,
com.apple.Preview,30,1709176735,1709176765,1709176765.575315,-21600,,
com.apple.Notes,3,1709176732,1709176735,1709176735.8252292,-21600,,
com.apple.Preview,145,1709176587,1709176732,1709176732.251789,-21600,,
com.apple.Notes,21,1709176566,1709176587,1709176587.61756,-21600,,
com.apple.Preview,245,1709176321,1709176566,1709176566.585431,-21600,,
com.google.Chrome,298,1709176023,1709176321,1709176321.371675,-21600,,
com.apple.Notes,71,1709175952,1709176023,1709176023.760598,-21600,,
com.apple.Preview,534,1709175418,1709175952,1709175952.286106,-21600,,
com.apple.Notes,194,1709175224,1709175418,1709175418.633364,-21600,,
com.apple.Preview,185,1709175039,1709175224,1709175224.778754,-21600,,
com.google.Chrome,113,1709174926,1709175039,1709175039.120768,-21600,,
com.apple.Notes,1,1709174925,1709174926,1709174926.817723,-21600,,
com.apple.Preview,40,1709174885,1709174925,1709174925.338877,-21600,,
com.google.Chrome,2,1709174883,1709174885,1709174885.9162312,-21600,,
com.apple.Notes,12,1709174871,1709174883,1709174883.8085961,-21600,,
com.apple.Preview,88,1709174783,1709174871,1709174871.479748,-21600,,
com.apple.iCal,39,1709174744,1709174783,1709174783.194277,-21600,,
com.leomehlig.today,20,1709174724,1709174744,1709174744.200371,-21600,,
com.apple.Preview,2,1709174722,1709174724,1709174724.26601,-21600,,
com.apple.finder,2,1709174720,1709174722,1709174722.4643111,-21600,,
com.apple.Preview,7,1709174713,1709174720,1709174720.978948,-21600,,
com.google.Chrome,315,1709174398,1709174713,1709174713.214065,-21600,,
com.apple.Notes,25,1709174373,1709174398,1709174398.151536,-21600,,
com.google.Chrome,449,1709173924,1709174373,1709174373.3609061,-21600,,
com.apple.MobileSMS,25,1709173899,1709173924,1709173924.408849,-21600,,
com.apple.Photos,1,1709173898,1709173899,1709173899.688761,-21600,,
com.google.Chrome,21,1709173877,1709173898,1709173898.927701,-21600,,
com.microsoft.VSCode,178,1709173699,1709173877,1709173878.020996,-21600,,
com.microsoft.VSCode,39,1709172032,1709172071,1709172071.605478,-21600,,
com.apple.finder,4,1709172028,1709172032,1709172032.888517,-21600,,
com.microsoft.VSCode,9,1709172019,1709172028,1709172029.0279741,-21600,,
com.apple.finder,13,1709172006,1709172019,1709172019.78505,-21600,,
com.microsoft.VSCode,36,1709171970,1709172006,1709172006.276072,-21600,,
com.google.Chrome,16,1709171954,1709171970,1709171970.52319,-21600,,
com.microsoft.Outlook,8,1709171946,1709171954,1709171954.842462,-21600,,
com.microsoft.VSCode,19,1709171927,1709171946,1709171946.650782,-21600,,
com.google.Chrome,2,1709171925,1709171927,1709171927.5808868,-21600,,
com.microsoft.VSCode,5,1709171893,1709171898,1709171898.9652128,-21600,,
com.google.Chrome,49,1709171844,1709171893,1709171893.045172,-21600,,
com.microsoft.VSCode,6,1709171838,1709171844,1709171844.79182,-21600,,
com.google.Chrome,12,1709171826,1709171838,1709171838.700459,-21600,,
com.apple.iCal,1,1709171825,1709171826,1709171826.829444,-21600,,
com.apple.iCal,6,1709169094,1709169100,1709169100.513916,-21600,,
com.microsoft.Outlook,17,1709169077,1709169094,1709169094.525041,-21600,,
com.apple.iCal,7,1709169070,1709169077,1709169077.604244,-21600,,
com.microsoft.Outlook,89,1709168981,1709169070,1709169070.593883,-21600,,
com.apple.iCal,8,1709168973,1709168981,1709168981.1511068,-21600,,
com.apple.MobileSMS,8,1709157058,1709157066,1709157066.2613878,-21600,EB445137-D7F5-57EC-87DA-1DB460D64046,"iPhone13,2"
com.apple.MobileSMS,6,1709156604,1709156610,1709156610.503576,-21600,EB445137-D7F5-57EC-87DA-1DB460D64046,"iPhone13,2"
com.apple.MobileSMS,2,1709156334,1709156336,1709156336.307766,-21600,EB445137-D7F5-57EC-87DA-1DB460D64046,"iPhone13,2"
com.apple.MobileSMS,2,1709156332,1709156334,1709156334.052665,-21600,EB445137-D7F5-57EC-87DA-1DB460D64046,"iPhone13,2"
com.apple.MobileSMS,3,1709156202,1709156205,1709156205.5130792,-21600,EB445137-D7F5-57EC-87DA-1DB460D64046,"iPhone13,2"
com.apple.iCal,73,1709156125,1709156198,1709156198.798431,-21600,,
com.leomehlig.today,27,1709156098,1709156125,1709156125.559692,-21600,,
com.google.Chrome,3,1709156095,1709156098,1709156098.158519,-21600,,
com.apple.MobileSMS,62,1709156027,1709156089,1709156089.544064,-21600,EB445137-D7F5-57EC-87DA-1DB460D64046,"iPhone13,2"
com.microsoft.VSCode,214,1709155881,1709156095,1709156095.239784,-21600,,
com.google.Chrome,20,1709155861,1709155881,1709155881.5637488,-21600,,
com.microsoft.VSCode,32,1709155829,1709155861,1709155862.4944282,-21600,,
com.apple.MobileSMS,13,1709155822,1709155835,1709155835.3981771,-21600,EB445137-D7F5-57EC-87DA-1DB460D64046,"iPhone13,2"
com.google.Chrome,10,1709155819,1709155829,1709155829.574286,-21600,,
com.apple.MobileSMS,129,1709155672,1709155801,1709155801.63129,-21600,EB445137-D7F5-57EC-87DA-1DB460D64046,"iPhone13,2"
com.apple.MobileSMS,91,1709155570,1709155661,1709155661.4751391,-21600,EB445137-D7F5-57EC-87DA-1DB460D64046,"iPhone13,2"
com.apple.MobileSMS,27,1709155540,1709155567,1709155567.132822,-21600,EB445137-D7F5-57EC-87DA-1DB460D64046,"iPhone13,2"
com.toyopagroup.picaboo,6,1709155525,1709155531,1709155531.872999,-21600,EB445137-D7F5-57EC-87DA-1DB460D64046,"iPhone13,2"
com.toyopagroup.picaboo,16,1709155402,1709155418,1709155418.82064,-21600,EB445137-D7F5-57EC-87DA-1DB460D64046,"iPhone13,2"
com.toyopagroup.picaboo,8,1709155389,1709155397,1709155397.350799,-21600,EB445137-D7F5-57EC-87DA-1DB460D64046,"iPhone13,2"
com.toyopagroup.picaboo,12,1709155374,1709155386,1709155386.081327,-21600,EB445137-D7F5-57EC-87DA-1DB460D64046,"iPhone13,2"
com.toyopagroup.picaboo,45,1709155310,1709155355,1709155355.5328898,-21600,EB445137-D7F5-57EC-87DA-1DB460D64046,"iPhone13,2"
com.toyopagroup.picaboo,8,1709155297,1709155305,1709155305.66157,-21600,EB445137-D7F5-57EC-87DA-1DB460D64046,"iPhone13,2"
com.toyopagroup.picaboo,10,1709155284,1709155294,1709155294.5233312,-21600,EB445137-D7F5-57EC-87DA-1DB460D64046,"iPhone13,2"
com.apple.MobileSMS,3,1709155281,1709155284,1709155285.20116,-21600,EB445137-D7F5-57EC-87DA-1DB460D64046,"iPhone13,2"
com.apple.MobileSMS,12,1709155223,1709155235,1709155235.740147,-21600,EB445137-D7F5-57EC-87DA-1DB460D64046,"iPhone13,2"
com.apple.MobileSMS,65,1709155158,1709155223,1709155223.299574,-21600,EB445137-D7F5-57EC-87DA-1DB460D64046,"iPhone13,2"
com.apple.MobileSMS,2,1709155151,1709155153,1709155153.45522,-21600,EB445137-D7F5-57EC-87DA-1DB460D64046,"iPhone13,2"
com.apple.MobileSMS,4,1709155146,1709155150,1709155150.576531,-21600,EB445137-D7F5-57EC-87DA-1DB460D64046,"iPhone13,2"
com.apple.InCallService,1,1709155145,1709155146,1709155146.274281,-21600,EB445137-D7F5-57EC-87DA-1DB460D64046,"iPhone13,2"
com.apple.InCallService,3,1709154843,1709154846,1709154846.878684,-21600,EB445137-D7F5-57EC-87DA-1DB460D64046,"iPhone13,2"
com.apple.MobileSMS,17,1709154826,1709154843,1709154843.387488,-21600,EB445137-D7F5-57EC-87DA-1DB460D64046,"iPhone13,2"
com.apple.MobileSMS,29,1709154795,1709154824,1709154824.1575289,-21600,EB445137-D7F5-57EC-87DA-1DB460D64046,"iPhone13,2"
com.apple.InCallService,2,1709154792,1709154794,1709154794.685336,-21600,EB445137-D7F5-57EC-87DA-1DB460D64046,"iPhone13,2"
com.apple.InCallService,2,1709153830,1709153832,1709153832.113491,-21600,EB445137-D7F5-57EC-87DA-1DB460D64046,"iPhone13,2"
com.apple.InCallService,4,1709153824,1709153828,1709153828.467252,-21600,EB445137-D7F5-57EC-87DA-1DB460D64046,"iPhone13,2"
com.apple.MobileSMS,10,1709153814,1709153824,1709153824.1709518,-21600,EB445137-D7F5-57EC-87DA-1DB460D64046,"iPhone13,2"
com.apple.findmy,13,1709153801,1709153814,1709153814.827512,-21600,EB445137-D7F5-57EC-87DA-1DB460D64046,"iPhone13,2"
com.apple.findmy,8,1709153490,1709153498,1709153498.640571,-21600,EB445137-D7F5-57EC-87DA-1DB460D64046,"iPhone13,2"
com.google.chrome.ios,6,1709153483,1709153489,1709153489.315322,-21600,EB445137-D7F5-57EC-87DA-1DB460D64046,"iPhone13,2"
com.google.chrome.ios,6,1709153366,1709153372,1709153372.0375829,-21600,EB445137-D7F5-57EC-87DA-1DB460D64046,"iPhone13,2"
com.google.chrome.ios,6,1709153001,1709153007,1709153007.88588,-21600,EB445137-D7F5-57EC-87DA-1DB460D64046,"iPhone13,2"
com.google.chrome.ios,116,1709152860,1709152976,1709152976.985996,-21600,EB445137-D7F5-57EC-87DA-1DB460D64046,"iPhone13,2"
com.apple.Health,2,1709152858,1709152860,1709152862.9783468,-21600,EB445137-D7F5-57EC-87DA-1DB460D64046,"iPhone13,2"
com.apple.Health,2,1709152795,1709152797,1709152797.4676309,-21600,EB445137-D7F5-57EC-87DA-1DB460D64046,"iPhone13,2"
com.apple.Health,14,1709152653,1709152667,1709152667.345756,-21600,EB445137-D7F5-57EC-87DA-1DB460D64046,"iPhone13,2"
com.apple.Health,45,1709152468,1709152513,1709152513.271431,-21600,EB445137-D7F5-57EC-87DA-1DB460D64046,"iPhone13,2"
com.google.Gmail,33,1709152310,1709152343,1709152343.354848,-21600,EB445137-D7F5-57EC-87DA-1DB460D64046,"iPhone13,2"
com.burbn.instagram,7,1709152303,1709152310,1709152310.0582051,-21600,EB445137-D7F5-57EC-87DA-1DB460D64046,"iPhone13,2"
com.burbn.instagram,421,1709151133,1709151554,1709151554.234743,-21600,EB445137-D7F5-57EC-87DA-1DB460D64046,"iPhone13,2"
com.apple.MobileSMS,3,1709150590,1709150593,1709150593.10891,-21600,EB445137-D7F5-57EC-87DA-1DB460D64046,"iPhone13,2"
com.apple.mobilecal,58,1709150531,1709150589,1709150589.628339,-21600,EB445137-D7F5-57EC-87DA-1DB460D64046,"iPhone13,2"
com.microsoft.Office.Outlook,28,1709150501,1709150529,1709150529.272773,-21600,EB445137-D7F5-57EC-87DA-1DB460D64046,"iPhone13,2"
com.burbn.instagram,50,1709150419,1709150469,1709150469.490377,-21600,EB445137-D7F5-57EC-87DA-1DB460D64046,"iPhone13,2"
com.microsoft.Office.Outlook,5,1709150375,1709150380,1709150380.094311,-21600,EB445137-D7F5-57EC-87DA-1DB460D64046,"iPhone13,2"
com.apple.MobileSMS,35,1709150340,1709150375,1709150375.363908,-21600,EB445137-D7F5-57EC-87DA-1DB460D64046,"iPhone13,2"
com.google.Chrome,112,1709150210,1709150322,1709150322.2148151,-21600,,
com.leomehlig.today,2,1709150208,1709150210,1709150211.7300491,-21600,,
com.apple.MobileSMS,3,1709150194,1709150197,1709150197.8792238,-21600,EB445137-D7F5-57EC-87DA-1DB460D64046,"iPhone13,2"
com.apple.news,19,1709150175,1709150194,1709150194.266271,-21600,EB445137-D7F5-57EC-87DA-1DB460D64046,"iPhone13,2"
com.apple.MobileSMS,2,1709150173,1709150175,1709150175.823443,-21600,EB445137-D7F5-57EC-87DA-1DB460D64046,"iPhone13,2"
com.apple.news,14,1709150159,1709150173,1709150173.546046,-21600,EB445137-D7F5-57EC-87DA-1DB460D64046,"iPhone13,2"
com.apple.MobileSMS,75,1709150084,1709150159,1709150159.660923,-21600,EB445137-D7F5-57EC-87DA-1DB460D64046,"iPhone13,2"
com.apple.news,14,1709150070,1709150084,1709150084.089514,-21600,EB445137-D7F5-57EC-87DA-1DB460D64046,"iPhone13,2"
com.apple.MobileSMS,33,1709150035,1709150068,1709150069.117169,-21600,EB445137-D7F5-57EC-87DA-1DB460D64046,"iPhone13,2"
com.apple.news,27,1709150008,1709150035,1709150035.5089788,-21600,EB445137-D7F5-57EC-87DA-1DB460D64046,"iPhone13,2"
com.apple.MobileSMS,6,1709150002,1709150008,1709150008.758991,-21600,EB445137-D7F5-57EC-87DA-1DB460D64046,"iPhone13,2"
com.apple.news,28,1709149974,1709150002,1709150002.969252,-21600,EB445137-D7F5-57EC-87DA-1DB460D64046,"iPhone13,2"
com.apple.news,3,1709149962,1709149965,1709149965.796053,-21600,EB445137-D7F5-57EC-87DA-1DB460D64046,"iPhone13,2"
com.apple.news,26,1709149885,1709149911,1709149912.057553,-21600,EB445137-D7F5-57EC-87DA-1DB460D64046,"iPhone13,2"
com.apple.MobileSMS,18,1709149832,1709149850,1709149850.89204,-21600,EB445137-D7F5-57EC-87DA-1DB460D64046,"iPhone13,2"
com.whentowork.iOS.WhenToWork-Employee-Scheduling,28,1709149773,1709149801,1709149802.094526,-21600,EB445137-D7F5-57EC-87DA-1DB460D64046,"iPhone13,2"
com.apple.mobilecal,6,1709149767,1709149773,1709149773.401411,-21600,EB445137-D7F5-57EC-87DA-1DB460D64046,"iPhone13,2"
com.apple.mobilecal,32,1709146847,1709146879,1709146879.723592,-21600,EB445137-D7F5-57EC-87DA-1DB460D64046,"iPhone13,2"
com.apple.news,2,1709146844,1709146846,1709146846.5005732,-21600,EB445137-D7F5-57EC-87DA-1DB460D64046,"iPhone13,2"
com.apple.news,6,1709146772,1709146778,1709146779.00405,-21600,EB445137-D7F5-57EC-87DA-1DB460D64046,"iPhone13,2"
com.apple.news,326,1709146445,1709146771,1709146772.2334151,-21600,EB445137-D7F5-57EC-87DA-1DB460D64046,"iPhone13,2"
com.microsoft.Office.Outlook,9,1709146425,1709146434,1709146434.361064,-21600,EB445137-D7F5-57EC-87DA-1DB460D64046,"iPhone13,2"
com.hammerandchisel.discord,72,1709146350,1709146422,1709146422.467063,-21600,EB445137-D7F5-57EC-87DA-1DB460D64046,"iPhone13,2"
com.apple.journal,5,1709146342,1709146347,1709146347.517158,-21600,EB445137-D7F5-57EC-87DA-1DB460D64046,"iPhone13,2"
com.leomehlig.today,6,1709146325,1709146331,1709146331.573669,-21600,,
com.apple.finder,4,1709146321,1709146325,1709146325.327029,-21600,,
com.apple.Preview,6,1709146315,1709146321,1709146321.979914,-21600,,
com.google.Chrome,155,1709146160,1709146315,1709146315.950474,-21600,,
com.apple.Preview,32,1709146128,1709146160,1709146161.0452142,-21600,,
com.apple.finder,2,1709146126,1709146128,1709146129.8183541,-21600,,
com.leomehlig.today,3,1709146123,1709146126,1709146126.299669,-21600,,
com.apple.journal,44,1709145628,1709145672,1709145672.3448381,-21600,EB445137-D7F5-57EC-87DA-1DB460D64046,"iPhone13,2"
com.burbn.instagram,2,1709145621,1709145623,1709145623.838879,-21600,EB445137-D7F5-57EC-87DA-1DB460D64046,"iPhone13,2"
com.burbn.instagram,3,1709145574,1709145577,1709145577.20999,-21600,EB445137-D7F5-57EC-87DA-1DB460D64046,"iPhone13,2"
com.burbn.instagram,103,1709144865,1709144968,1709144968.490982,-21600,EB445137-D7F5-57EC-87DA-1DB460D64046,"iPhone13,2"
com.burbn.instagram,6,1709144807,1709144813,1709144813.56478,-21600,EB445137-D7F5-57EC-87DA-1DB460D64046,"iPhone13,2"
com.burbn.instagram,2,1709144792,1709144794,1709144794.4604669,-21600,EB445137-D7F5-57EC-87DA-1DB460D64046,"iPhone13,2"
com.burbn.instagram,66,1709144670,1709144736,1709144736.1610122,-21600,EB445137-D7F5-57EC-87DA-1DB460D64046,"iPhone13,2"
com.burbn.instagram,61,1709143668,1709143729,1709143729.503804,-21600,EB445137-D7F5-57EC-87DA-1DB460D64046,"iPhone13,2"
com.google.Maps,5,1709143663,1709143668,1709143668.943371,-21600,EB445137-D7F5-57EC-87DA-1DB460D64046,"iPhone13,2"
com.google.Maps,14,1709143432,1709143446,1709143446.6486878,-21600,EB445137-D7F5-57EC-87DA-1DB460D64046,"iPhone13,2"
com.burbn.instagram,79,1709143353,1709143432,1709143432.106678,-21600,EB445137-D7F5-57EC-87DA-1DB460D64046,"iPhone13,2"
com.google.chrome.ios,8,1709143345,1709143353,1709143354.021594,-21600,EB445137-D7F5-57EC-87DA-1DB460D64046,"iPhone13,2"
com.burbn.instagram,38,1709143307,1709143345,1709143345.756875,-21600,EB445137-D7F5-57EC-87DA-1DB460D64046,"iPhone13,2"
com.google.Maps,7,1709143300,1709143307,1709143307.465173,-21600,EB445137-D7F5-57EC-87DA-1DB460D64046,"iPhone13,2"
com.burbn.instagram,224,1709143076,1709143300,1709143301.037068,-21600,EB445137-D7F5-57EC-87DA-1DB460D64046,"iPhone13,2"
com.google.Maps,10,1709143066,1709143076,1709143076.790265,-21600,EB445137-D7F5-57EC-87DA-1DB460D64046,"iPhone13,2"
com.google.Maps,46,1709142985,1709143031,1709143031.013725,-21600,EB445137-D7F5-57EC-87DA-1DB460D64046,"iPhone13,2"
com.google.chrome.ios,17,1709142968,1709142985,1709142985.690206,-21600,EB445137-D7F5-57EC-87DA-1DB460D64046,"iPhone13,2"
com.burbn.instagram,197,1709142771,1709142968,1709142968.367673,-21600,EB445137-D7F5-57EC-87DA-1DB460D64046,"iPhone13,2"
edu.illinois.rokwire.ios,13,1709142757,1709142770,1709142770.306474,-21600,EB445137-D7F5-57EC-87DA-1DB460D64046,"iPhone13,2"
edu.illinois.rokwire.ios,4,1709142748,1709142752,1709142752.334171,-21600,EB445137-D7F5-57EC-87DA-1DB460D64046,"iPhone13,2"
edu.illinois.rokwire.ios,14,1709142565,1709142579,1709142579.836114,-21600,EB445137-D7F5-57EC-87DA-1DB460D64046,"iPhone13,2"
com.google.Maps,15,1709142550,1709142565,1709142565.398195,-21600,EB445137-D7F5-57EC-87DA-1DB460D64046,"iPhone13,2"
com.google.chrome.ios,3,1709142546,1709142549,1709142549.551537,-21600,EB445137-D7F5-57EC-87DA-1DB460D64046,"iPhone13,2"
com.google.chrome.ios,6,1709141883,1709141889,1709141889.959521,-21600,EB445137-D7F5-57EC-87DA-1DB460D64046,"iPhone13,2"
com.google.chrome.ios,34,1709141848,1709141882,1709141882.220646,-21600,EB445137-D7F5-57EC-87DA-1DB460D64046,"iPhone13,2"
com.google.chrome.ios,59,1709140730,1709140789,1709140789.2816901,-21600,EB445137-D7F5-57EC-87DA-1DB460D64046,"iPhone13,2"
com.burbn.instagram,183,1709139550,1709139733,1709139733.714802,-21600,EB445137-D7F5-57EC-87DA-1DB460D64046,"iPhone13,2"
Astrospheric.Astrospheric,25,1709139518,1709139543,1709139543.755846,-21600,EB445137-D7F5-57EC-87DA-1DB460D64046,"iPhone13,2"
com.apple.news,135,1709139378,1709139513,1709139513.57475,-21600,EB445137-D7F5-57EC-87DA-1DB460D64046,"iPhone13,2"
com.toyopagroup.picaboo,25,1709139338,1709139363,1709139363.977069,-21600,EB445137-D7F5-57EC-87DA-1DB460D64046,"iPhone13,2"
edu.illinois.rokwire.ios,5,1709139332,1709139337,1709139337.215592,-21600,EB445137-D7F5-57EC-87DA-1DB460D64046,"iPhone13,2"
com.leomehlig.today,16,1709139273,1709139289,1709139289.1130362,-21600,,
com.google.Chrome,71,1709139202,1709139273,1709139273.473103,-21600,,
com.apple.Notes,29,1709139173,1709139202,1709139203.436383,-21600,,
com.leomehlig.today,49,1709139124,1709139173,1709139173.054882,-21600,,
com.google.Chrome,18,1709139106,1709139124,1709139124.5686932,-21600,,
edu.illinois.rokwire.ios,1,1709139028,1709139029,1709139029.996961,-21600,EB445137-D7F5-57EC-87DA-1DB460D64046,"iPhone13,2"
edu.illinois.rokwire.ios,68,1709138959,1709139027,1709139027.627092,-21600,EB445137-D7F5-57EC-87DA-1DB460D64046,"iPhone13,2"
com.hammerandchisel.discord,30,1709138916,1709138946,1709138946.9535499,-21600,EB445137-D7F5-57EC-87DA-1DB460D64046,"iPhone13,2"
com.microsoft.Office.Outlook,17,1709138898,1709138915,1709138915.827065,-21600,EB445137-D7F5-57EC-87DA-1DB460D64046,"iPhone13,2"
com.instructure.icanvas,3,1709138890,1709138893,1709138894.019413,-21600,EB445137-D7F5-57EC-87DA-1DB460D64046,"iPhone13,2"
com.instructure.icanvas,44,1709138846,1709138890,1709138890.679373,-21600,EB445137-D7F5-57EC-87DA-1DB460D64046,"iPhone13,2"
com.google.chrome.ios,41,1709137991,1709138032,1709138032.106223,-21600,EB445137-D7F5-57EC-87DA-1DB460D64046,"iPhone13,2"
com.microsoft.Office.Outlook,5,1709137986,1709137991,1709137991.069796,-21600,EB445137-D7F5-57EC-87DA-1DB460D64046,"iPhone13,2"
edu.illinois.rokwire.ios,3,1709137983,1709137986,1709137986.589917,-21600,EB445137-D7F5-57EC-87DA-1DB460D64046,"iPhone13,2"
com.google.Chrome,44,1709137776,1709137820,1709137820.44415,-21600,,
com.microsoft.Outlook,19,1709137757,1709137776,1709137776.0439382,-21600,,
com.google.Chrome,16,1709137741,1709137757,1709137757.1682482,-21600,,
com.microsoft.Outlook,5,1709137736,1709137741,1709137741.939877,-21600,,
com.google.Chrome,1,1709137735,1709137736,1709137736.409446,-21600,,
us.zoom.xos,0,1709137735,1709137735,1709137735.832195,-21600,,
com.google.Chrome,21,1709137714,1709137735,1709137735.583308,-21600,,
us.zoom.xos,5,1709137709,1709137714,1709137714.163084,-21600,,
com.google.Chrome,67,1709137642,1709137709,1709137709.536769,-21600,,
com.microsoft.Outlook,7,1709137635,1709137642,1709137643.04803,-21600,,
com.google.Chrome,278,1709137357,1709137635,1709137636.0717878,-21600,,
us.zoom.xos,3,1709137354,1709137357,1709137357.816473,-21600,,
com.microsoft.Outlook,23,1709137331,1709137354,1709137354.268111,-21600,,
us.zoom.xos,48,1709137283,1709137331,1709137331.450598,-21600,,
com.google.Chrome,7,1709137276,1709137283,1709137283.068726,-21600,,
com.microsoft.Outlook,33,1709137243,1709137276,1709137276.6006532,-21600,,
com.microsoft.VSCode,3,1709137240,1709137243,1709137243.488298,-21600,,
com.microsoft.VSCode,2,1709137194,1709137196,1709137196.991881,-21600,,
com.microsoft.VSCode,1916,1709135277,1709137193,1709137193.7788692,-21600,,
com.microsoft.Outlook,70,1709135207,1709135277,1709135277.610313,-21600,,
com.microsoft.VSCode,5,1709135202,1709135207,1709135207.1321058,-21600,,
com.microsoft.Outlook,25,1709135177,1709135202,1709135202.5777822,-21600,,
com.microsoft.VSCode,558,1709134619,1709135177,1709135177.3332338,-21600,,
com.google.Chrome,357,1709134262,1709134619,1709134619.31489,-21600,,
com.microsoft.VSCode,11,1709134251,1709134262,1709134262.0597038,-21600,,
com.google.Chrome,7,1709134244,1709134251,1709134251.2308269,-21600,,
com.microsoft.VSCode,6,1709134238,1709134244,1709134244.3987122,-21600,,
com.google.Chrome,3,1709134235,1709134238,1709134238.097631,-21600,,
com.microsoft.VSCode,36,1709134199,1709134235,1709134235.160464,-21600,,
com.google.Chrome,67,1709134132,1709134199,1709134199.973246,-21600,,
com.apple.finder,20,1709134112,1709134132,1709134132.9968,-21600,,
com.apple.camera,3,1709133999,1709134002,1709134003.1830459,-21600,EB445137-D7F5-57EC-87DA-1DB460D64046,"iPhone13,2"
edu.illinois.rokwire.ios,6,1709133996,1709134002,1709134003.255396,-21600,EB445137-D7F5-57EC-87DA-1DB460D64046,"iPhone13,2"
edu.illinois.rokwire.ios,6,1709133036,1709133042,1709133042.14835,-21600,EB445137-D7F5-57EC-87DA-1DB460D64046,"iPhone13,2"
edu.illinois.rokwire.ios,39,1709132978,1709133017,1709133017.317957,-21600,EB445137-D7F5-57EC-87DA-1DB460D64046,"iPhone13,2"
com.apple.weather,12,1709132965,1709132977,1709132977.277802,-21600,EB445137-D7F5-57EC-87DA-1DB460D64046,"iPhone13,2"
com.instructure.icanvas,54,1709132676,1709132730,1709132730.515211,-21600,EB445137-D7F5-57EC-87DA-1DB460D64046,"iPhone13,2"
com.apple.finder,3,1709092815,1709092818,1709092818.36168,-21600,,
com.apple.Music,79,1709092736,1709092815,1709092815.7365909,-21600,,
com.apple.finder,2,1709092734,1709092736,1709092736.741756,-21600,,
com.google.Chrome,11,1709092723,1709092734,1709092734.5692039,-21600,,
com.apple.finder,4,1709092719,1709092723,1709092723.838018,-21600,,
com.microsoft.VSCode,199,1709092520,1709092719,1709092719.990771,-21600,,
com.apple.finder,25,1709092495,1709092520,1709092520.2773,-21600,,
com.google.Chrome,0,1709092495,1709092495,1709092495.9505138,-21600,,
com.apple.finder,2,1709092493,1709092495,1709092495.391926,-21600,,
com.google.Chrome,68,1709092425,1709092493,1709092493.420742,-21600,,
com.microsoft.VSCode,329,1709092096,1709092425,1709092426.254348,-21600,,
com.apple.finder,9,1709092087,1709092096,1709092096.908148,-21600,,
com.microsoft.VSCode,37,1709092050,1709092087,1709092088.0056648,-21600,,
com.apple.finder,39,1709092011,1709092050,1709092050.939423,-21600,,
com.google.Chrome,34,1709091977,1709092011,1709092011.1263719,-21600,,
com.leomehlig.today,1,1709091976,1709091977,1709091977.0848122,-21600,,
com.google.Chrome,23,1709091953,1709091976,1709091976.401974,-21600,,
com.leomehlig.today,1,1709091952,1709091953,1709091953.6865249,-21600,,
com.apple.iCal,8,1709091944,1709091952,1709091952.403398,-21600,,
com.leomehlig.today,8,1709091936,1709091944,1709091944.425955,-21600,,
com.google.Chrome,8,1709091928,1709091936,1709091936.094892,-21600,,
com.leomehlig.today,1,1709091927,1709091928,1709091928.463503,-21600,,
com.apple.iCal,5,1709091922,1709091927,1709091927.114923,-21600,,
com.leomehlig.today,4,1709091918,1709091922,1709091922.4919071,-21600,,
com.google.Chrome,11,1709091907,1709091918,1709091918.145628,-21600,,
com.leomehlig.today,2,1709091905,1709091907,1709091907.653325,-21600,,
com.apple.iCal,16,1709091889,1709091905,1709091905.2291899,-21600,,
com.leomehlig.today,3,1709091886,1709091889,1709091889.467035,-21600,,
com.google.Chrome,8,1709091878,1709091886,1709091886.420064,-21600,,
com.leomehlig.today,1,1709091877,1709091878,1709091878.8657122,-21600,,
com.google.Chrome,4,1709091873,1709091877,1709091877.6266398,-21600,,
com.leomehlig.today,2,1709091871,1709091873,1709091873.584598,-21600,,
com.google.Chrome,1,1709091870,1709091871,1709091871.2658448,-21600,,
com.leomehlig.today,2,1709091868,1709091870,1709091870.2149901,-21600,,
com.google.Chrome,2,1709091866,1709091868,1709091868.795774,-21600,,
com.leomehlig.today,4,1709091862,1709091866,1709091866.997293,-21600,,
com.google.Chrome,3,1709091859,1709091862,1709091862.2048779,-21600,,
com.leomehlig.today,6,1709091853,1709091859,1709091859.411665,-21600,,
com.google.Chrome,4,1709091849,1709091853,1709091853.853238,-21600,,
com.leomehlig.today,1,1709091848,1709091849,1709091849.6179252,-21600,,
com.google.Chrome,1,1709091847,1709091848,1709091848.7148662,-21600,,
com.leomehlig.today,7,1709091840,1709091847,1709091847.517847,-21600,,
com.google.Chrome,2,1709091838,1709091840,1709091840.316777,-21600,,
com.leomehlig.today,8,1709091830,1709091838,1709091838.678543,-21600,,
com.google.Chrome,3,1709091827,1709091830,1709091830.521549,-21600,,
com.leomehlig.today,27,1709091800,1709091827,1709091827.105854,-21600,,
com.google.Chrome,5,1709091795,1709091800,1709091800.1632571,-21600,,
com.leomehlig.today,7,1709091788,1709091795,1709091795.446214,-21600,,
com.google.Chrome,4,1709091784,1709091788,1709091788.910749,-21600,,
com.leomehlig.today,3,1709091781,1709091784,1709091784.918542,-21600,,
com.google.Chrome,3,1709091778,1709091781,1709091781.349951,-21600,,
com.leomehlig.today,18,1709091760,1709091778,1709091778.854296,-21600,,
com.google.Chrome,2,1709091758,1709091760,1709091760.2621179,-21600,,
com.leomehlig.today,2,1709091756,1709091758,1709091758.678045,-21600,,
com.google.Chrome,1,1709091755,1709091756,1709091756.8256512,-21600,,
com.leomehlig.today,4,1709091751,1709091755,1709091755.1948671,-21600,,
com.google.Chrome,2,1709091749,1709091751,1709091751.793503,-21600,,
com.leomehlig.today,3,1709091746,1709091749,1709091749.812581,-21600,,
com.google.Chrome,2,1709091744,1709091746,1709091746.440649,-21600,,
com.leomehlig.today,6,1709091738,1709091744,1709091744.505266,-21600,,
com.google.Chrome,3,1709091735,1709091738,1709091738.4792252,-21600,,
com.leomehlig.today,5,1709091730,1709091735,1709091735.838097,-21600,,
com.google.Chrome,1,1709091729,1709091730,1709091730.926594,-21600,,
com.leomehlig.today,11,1709091718,1709091729,1709091729.706404,-21600,,
com.google.Chrome,2,1709091716,1709091718,1709091718.137826,-21600,,
com.leomehlig.today,4,1709091712,1709091716,1709091716.366952,-21600,,
com.google.Chrome,4,1709091708,1709091712,1709091712.313004,-21600,,
com.leomehlig.today,3,1709091705,1709091708,1709091708.79877,-21600,,
com.google.Chrome,3,1709091702,1709091705,1709091705.211025,-21600,,
com.leomehlig.today,20,1709091682,1709091702,1709091702.774413,-21600,,
com.google.Chrome,2,1709091680,1709091682,1709091682.392467,-21600,,
com.leomehlig.today,1,1709091679,1709091680,1709091680.803595,-21600,,
com.google.Chrome,2,1709091677,1709091679,1709091679.325752,-21600,,
com.leomehlig.today,2,1709091675,1709091677,1709091677.258267,-21600,,
com.google.Chrome,2,1709091673,1709091675,1709091675.583002,-21600,,
com.leomehlig.today,5,1709091668,1709091673,1709091673.784828,-21600,,
com.google.Chrome,3,1709091665,1709091668,1709091668.1290832,-21600,,
com.leomehlig.today,0,1709091665,1709091665,1709091666.006491,-21600,,
com.google.Chrome,1,1709091664,1709091665,1709091665.127448,-21600,,
com.leomehlig.today,5,1709091659,1709091664,1709091664.74888,-21600,,
com.google.Chrome,4,1709091655,1709091659,1709091659.1227078,-21600,,
com.leomehlig.today,4,1709091651,1709091655,1709091655.68672,-21600,,
com.google.Chrome,3,1709091648,1709091651,1709091652.019227,-21600,,
com.leomehlig.today,8,1709091640,1709091648,1709091648.5138521,-21600,,
com.google.Chrome,3,1709091637,1709091640,1709091641.022999,-21600,,
com.leomehlig.today,3,1709091634,1709091637,1709091637.7456908,-21600,,
com.google.Chrome,2,1709091632,1709091634,1709091634.0473828,-21600,,
com.leomehlig.today,1,1709091631,1709091632,1709091632.9446878,-21600,,
com.google.Chrome,2,1709091629,1709091631,1709091631.862509,-21600,,
com.leomehlig.today,5,1709091624,1709091629,1709091629.350307,-21600,,
com.google.Chrome,1,1709091623,1709091624,1709091624.653514,-21600,,
com.leomehlig.today,8,1709091615,1709091623,1709091623.111089,-21600,,
com.google.Chrome,4,1709091611,1709091615,1709091615.249514,-21600,,
com.leomehlig.today,4,1709091607,1709091611,1709091611.681933,-21600,,
com.google.Chrome,2,1709091605,1709091607,1709091607.174357,-21600,,
com.leomehlig.today,5,1709091600,1709091605,1709091605.724018,-21600,,
com.google.Chrome,1,1709091599,1709091600,1709091600.90485,-21600,,
com.leomehlig.today,3,1709091596,1709091599,1709091599.161,-21600,,
com.google.Chrome,2,1709091594,1709091596,1709091596.1783361,-21600,,
com.leomehlig.today,8,1709091586,1709091594,1709091594.643032,-21600,,
com.google.Chrome,4,1709091582,1709091586,1709091586.3192968,-21600,,
com.leomehlig.today,6,1709091576,1709091582,1709091582.128315,-21600,,
com.google.Chrome,3,1709091573,1709091576,1709091576.550259,-21600,,
com.leomehlig.today,6,1709091567,1709091573,1709091574.0230842,-21600,,
com.google.Chrome,1,1709091566,1709091567,1709091567.711874,-21600,,
com.leomehlig.today,1,1709091565,1709091566,1709091566.656166,-21600,,
com.google.Chrome,1,1709091564,1709091565,1709091565.5493078,-21600,,
com.leomehlig.today,0,1709091564,1709091564,1709091564.824754,-21600,,
com.google.Chrome,2,1709091562,1709091564,1709091564.333812,-21600,,
com.leomehlig.today,4,1709091558,1709091562,1709091562.455745,-21600,,
com.google.Chrome,4,1709091554,1709091558,1709091558.171334,-21600,,
com.leomehlig.today,6,1709091548,1709091554,1709091554.5456262,-21600,,
com.google.Chrome,3,1709091545,1709091548,1709091548.572547,-21600,,
com.leomehlig.today,15,1709091530,1709091545,1709091545.365855,-21600,,
com.google.Chrome,15,1709091515,1709091530,1709091530.245695,-21600,,
com.leomehlig.today,2,1709091513,1709091515,1709091515.561379,-21600,,
com.google.Chrome,4,1709091509,1709091513,1709091513.972001,-21600,,
com.leomehlig.today,17,1709091492,1709091509,1709091509.359937,-21600,,
com.google.Chrome,14,1709091478,1709091492,1709091492.445788,-21600,,
com.leomehlig.today,14,1709091464,1709091478,1709091479.0180101,-21600,,
com.google.Chrome,4,1709091460,1709091464,1709091464.718854,-21600,,
com.leomehlig.today,18,1709091442,1709091460,1709091461.003745,-21600,,
com.google.Chrome,4,1709091438,1709091442,1709091442.792142,-21600,,
com.leomehlig.today,1,1709091437,1709091438,1709091438.789748,-21600,,
com.google.Chrome,1,1709091436,1709091437,1709091437.071466,-21600,,
com.leomehlig.today,2,1709091434,1709091436,1709091436.6693702,-21600,,
com.google.Chrome,3,1709091431,1709091434,1709091434.128965,-21600,,
com.leomehlig.today,8,1709091423,1709091431,1709091431.194241,-21600,,
com.google.Chrome,1,1709091422,1709091423,1709091423.837267,-21600,,
com.leomehlig.today,3,1709091419,1709091422,1709091422.444562,-21600,,
com.google.Chrome,2,1709091417,1709091419,1709091420.009848,-21600,,
com.leomehlig.today,5,1709091412,1709091417,1709091417.156654,-21600,,
com.google.Chrome,2,1709091410,1709091412,1709091412.300834,-21600,,
com.leomehlig.today,2,1709091408,1709091410,1709091410.600903,-21600,,
com.google.Chrome,3,1709091405,1709091408,1709091408.4625912,-21600,,
com.leomehlig.today,7,1709091398,1709091405,1709091405.838132,-21600,,
com.google.Chrome,3,1709091395,1709091398,1709091398.708894,-21600,,
com.leomehlig.today,13,1709091382,1709091395,1709091395.78468,-21600,,
com.google.Chrome,1,1709091381,1709091382,1709091382.4517841,-21600,,
com.leomehlig.today,3,1709091378,1709091381,1709091381.219376,-21600,,
com.google.Chrome,1,1709091377,1709091378,1709091378.516659,-21600,,
com.leomehlig.today,3,1709091374,1709091377,1709091377.5381598,-21600,,
com.google.Chrome,3,1709091371,1709091374,1709091374.466938,-21600,,
com.leomehlig.today,5,1709091366,1709091371,1709091371.917418,-21600,,
com.google.Chrome,2,1709091364,1709091366,1709091366.9336128,-21600,,
com.leomehlig.today,10,1709091354,1709091364,1709091364.4239302,-21600,,
com.google.Chrome,1,1709091353,1709091354,1709091354.20136,-21600,,
com.leomehlig.today,1,1709091352,1709091353,1709091353.3660789,-21600,,
com.google.Chrome,4,1709091348,1709091352,1709091352.205502,-21600,,
com.leomehlig.today,2,1709091346,1709091348,1709091348.609106,-21600,,
com.google.Chrome,1,1709091345,1709091346,1709091346.8513432,-21600,,
com.leomehlig.today,4,1709091341,1709091345,1709091345.3810248,-21600,,
com.google.Chrome,2,1709091339,1709091341,1709091341.239491,-21600,,
com.leomehlig.today,2,1709091337,1709091339,1709091339.173602,-21600,,
com.google.Chrome,3,1709091334,1709091337,1709091337.5792398,-21600,,
com.leomehlig.today,4,1709091330,1709091334,1709091334.971906,-21600,,
com.google.Chrome,1,1709091329,1709091330,1709091330.8574739,-21600,,
com.leomehlig.today,4,1709091325,1709091329,1709091329.4495769,-21600,,
com.google.Chrome,2,1709091323,1709091325,1709091325.499352,-21600,,
com.leomehlig.today,4,1709091319,1709091323,1709091323.706301,-21600,,
com.google.Chrome,1,1709091318,1709091319,1709091319.9529948,-21600,,
com.leomehlig.today,0,1709091318,1709091318,1709091318.771707,-21600,,
com.google.Chrome,1,1709091317,1709091318,1709091318.181119,-21600,,
com.leomehlig.today,1,1709091316,1709091317,1709091317.2679849,-21600,,
com.google.Chrome,1,1709091315,1709091316,1709091316.778115,-21600,,
com.leomehlig.today,2,1709091313,1709091315,1709091315.540051,-21600,,
com.google.Chrome,1,1709091312,1709091313,1709091313.837167,-21600,,
com.leomehlig.today,12,1709091300,1709091312,1709091312.7418442,-21600,,
com.google.Chrome,3,1709091297,1709091300,1709091300.680026,-21600,,
com.leomehlig.today,4,1709091293,1709091297,1709091297.4308748,-21600,,
com.google.Chrome,3,1709091290,1709091293,1709091293.264821,-21600,,
com.leomehlig.today,1,1709091289,1709091290,1709091290.9682631,-21600,,
com.google.Chrome,1,1709091288,1709091289,1709091289.7299109,-21600,,
com.leomehlig.today,2,1709091286,1709091288,1709091288.084992,-21600,,
com.google.Chrome,1,1709091285,1709091286,1709091286.362819,-21600,,
com.leomehlig.today,14,1709091271,1709091285,1709091285.036566,-21600,,
com.google.Chrome,3,1709091268,1709091271,1709091271.99698,-21600,,
com.leomehlig.today,2,1709091266,1709091268,1709091268.256908,-21600,,
com.google.Chrome,5,1709091261,1709091266,1709091266.478662,-21600,,
com.leomehlig.today,19,1709091242,1709091261,1709091262.025491,-21600,,
com.google.Chrome,2,1709091240,1709091242,1709091242.645859,-21600,,
com.leomehlig.today,5,1709091235,1709091240,1709091240.3172169,-21600,,
com.google.Chrome,4,1709091231,1709091235,1709091235.031827,-21600,,
com.leomehlig.today,18,1709091213,1709091231,1709091231.032837,-21600,,
com.google.Chrome,4,1709091209,1709091213,1709091213.3854852,-21600,,
com.leomehlig.today,5,1709091204,1709091209,1709091209.793469,-21600,,
com.google.Chrome,1,1709091203,1709091204,1709091205.016731,-21600,,
com.leomehlig.today,3,1709091200,1709091203,1709091203.574506,-21600,,
com.google.Chrome,4,1709091196,1709091200,1709091200.7951179,-21600,,
com.leomehlig.today,1,1709091195,1709091196,1709091196.752176,-21600,,
com.google.Chrome,0,1709091195,1709091195,1709091195.922206,-21600,,
com.leomehlig.today,4,1709091191,1709091195,1709091195.5553951,-21600,,
com.google.Chrome,3,1709091188,1709091191,1709091191.903325,-21600,,
com.leomehlig.today,3,1709091185,1709091188,1709091188.6590738,-21600,,
com.google.Chrome,2,1709091183,1709091185,1709091185.719691,-21600,,
com.leomehlig.today,4,1709091179,1709091183,1709091183.1969051,-21600,,
com.google.Chrome,1,1709091178,1709091179,1709091179.156959,-21600,,
com.leomehlig.today,2,1709091176,1709091178,1709091178.2330918,-21600,,
com.google.Chrome,1,1709091175,1709091176,1709091176.103444,-21600,,
com.leomehlig.today,3,1709091172,1709091175,1709091175.244519,-21600,,
com.google.Chrome,1,1709091171,1709091172,1709091172.606983,-21600,,
com.leomehlig.today,5,1709091166,1709091171,1709091171.624762,-21600,,
com.google.Chrome,5,1709091161,1709091166,1709091166.0404692,-21600,,
com.leomehlig.today,10,1709091151,1709091161,1709091161.106534,-21600,,
com.google.Chrome,5,1709091146,1709091151,1709091151.057609,-21600,,
com.leomehlig.today,5,1709091141,1709091146,1709091146.329138,-21600,,
com.google.Chrome,1,1709091140,1709091141,1709091141.416414,-21600,,
com.leomehlig.today,1,1709091139,1709091140,1709091140.4754639,-21600,,
com.google.Chrome,2,1709091137,1709091139,1709091139.383586,-21600,,
com.leomehlig.today,11,1709091126,1709091137,1709091137.968555,-21600,,
com.google.Chrome,2,1709091124,1709091126,1709091126.465822,-21600,,
com.leomehlig.today,3,1709091121,1709091124,1709091124.477769,-21600,,
com.google.Chrome,1,1709091120,1709091121,1709091121.4670482,-21600,,
com.leomehlig.today,0,1709091120,1709091120,1709091121.022232,-21600,,
com.google.Chrome,1,1709091119,1709091120,1709091120.09429,-21600,,
com.leomehlig.today,9,1709091110,1709091119,1709091119.121264,-21600,,
com.google.Chrome,4,1709091106,1709091110,1709091110.0630221,-21600,,
com.leomehlig.today,8,1709091098,1709091106,1709091106.275881,-21600,,
com.google.Chrome,3,1709091095,1709091098,1709091098.096216,-21600,,
com.leomehlig.today,15,1709091080,1709091095,1709091095.442329,-21600,,
com.google.Chrome,1,1709091079,1709091080,1709091080.995706,-21600,,
com.leomehlig.today,10,1709091069,1709091079,1709091079.36368,-21600,,
com.google.Chrome,0,1709091069,1709091069,1709091069.913762,-21600,,
com.leomehlig.today,1,1709091068,1709091069,1709091069.165369,-21600,,
com.google.Chrome,2,1709091066,1709091068,1709091068.440135,-21600,,
com.leomehlig.today,9,1709091057,1709091066,1709091066.366136,-21600,,
com.google.Chrome,2,1709091055,1709091057,1709091057.757083,-21600,,
com.leomehlig.today,4,1709091051,1709091055,1709091055.6188688,-21600,,
com.google.Chrome,3,1709091048,1709091051,1709091051.267947,-21600,,
com.leomehlig.today,13,1709091035,1709091048,1709091048.502259,-21600,,
com.google.Chrome,2,1709091033,1709091035,1709091035.253096,-21600,,
com.leomehlig.today,8,1709091025,1709091033,1709091033.894762,-21600,,
com.google.Chrome,4,1709091021,1709091025,1709091025.836458,-21600,,
com.leomehlig.today,17,1709091004,1709091021,1709091022.0260491,-21600,,
com.google.Chrome,3,1709091001,1709091004,1709091004.997935,-21600,,
com.leomehlig.today,11,1709090990,1709091001,1709091001.1411061,-21600,,
com.google.Chrome,1,1709090989,1709090990,1709090990.208782,-21600,,
com.leomehlig.today,8,1709090981,1709090989,1709090989.108944,-21600,,
com.google.Chrome,1,1709090980,1709090981,1709090981.991081,-21600,,
com.leomehlig.today,1,1709090979,1709090980,1709090980.209537,-21600,,
com.google.Chrome,1,1709090978,1709090979,1709090979.474272,-21600,,
com.leomehlig.today,4,1709090974,1709090978,1709090978.527497,-21600,,
com.google.Chrome,6,1709090968,1709090974,1709090974.7160602,-21600,,
com.leomehlig.today,7,1709090961,1709090968,1709090968.961374,-21600,,
com.google.Chrome,6,1709090955,1709090961,1709090961.29768,-21600,,
com.leomehlig.today,2,1709090953,1709090955,1709090955.87271,-21600,,
com.google.Chrome,3,1709090950,1709090953,1709090953.463591,-21600,,
com.leomehlig.today,7,1709090943,1709090950,1709090950.881429,-21600,,
com.google.Chrome,8,1709090935,1709090943,1709090943.245012,-21600,,
com.leomehlig.today,8,1709090927,1709090935,1709090935.9292421,-21600,,
com.google.Chrome,2,1709090925,1709090927,1709090927.432105,-21600,,
com.leomehlig.today,3,1709090922,1709090925,1709090925.630759,-21600,,
com.google.Chrome,2,1709090920,1709090922,1709090922.327399,-21600,,
com.leomehlig.today,5,1709090915,1709090920,1709090920.784548,-21600,,
com.google.Chrome,3,1709090912,1709090915,1709090915.148895,-21600,,
com.leomehlig.today,2,1709090910,1709090912,1709090912.560264,-21600,,
com.google.Chrome,1,1709090909,1709090910,1709090910.493417,-21600,,
com.leomehlig.today,1,1709090908,1709090909,1709090909.6248388,-21600,,
com.google.Chrome,2,1709090906,1709090908,1709090908.293057,-21600,,
com.leomehlig.today,12,1709090894,1709090906,1709090906.258558,-21600,,
com.google.Chrome,5,1709090889,1709090894,1709090894.262495,-21600,,
com.leomehlig.today,5,1709090884,1709090889,1709090889.112189,-21600,,
com.google.Chrome,0,1709090884,1709090884,1709090884.9950361,-21600,,
com.leomehlig.today,3,1709090881,1709090884,1709090884.615984,-21600,,
com.google.Chrome,3,1709090878,1709090881,1709090881.0820851,-21600,,
com.leomehlig.today,6,1709090872,1709090878,1709090878.8443499,-21600,,
com.google.Chrome,2,1709090870,1709090872,1709090872.347132,-21600,,
com.leomehlig.today,1,1709090869,1709090870,1709090870.803975,-21600,,
com.google.Chrome,5,1709090864,1709090869,1709090869.158197,-21600,,
com.leomehlig.today,6,1709090858,1709090864,1709090865.0290709,-21600,,
com.google.Chrome,4,1709090854,1709090858,1709090858.2291641,-21600,,
com.leomehlig.today,5,1709090849,1709090854,1709090854.25144,-21600,,
com.google.Chrome,3,1709090846,1709090849,1709090849.0820441,-21600,,
com.leomehlig.today,17,1709090829,1709090846,1709090846.500214,-21600,,
com.google.Chrome,7,1709090822,1709090829,1709090829.390822,-21600,,
com.leomehlig.today,20,1709090802,1709090822,1709090822.464915,-21600,,
com.google.Chrome,6,1709090796,1709090802,1709090802.1025019,-21600,,
com.leomehlig.today,12,1709090784,1709090796,1709090796.776476,-21600,,
com.google.Chrome,1,1709090783,1709090784,1709090784.797237,-21600,,
com.leomehlig.today,4,1709090779,1709090783,1709090783.463712,-21600,,
com.google.Chrome,1,1709090778,1709090779,1709090780.012663,-21600,,
com.leomehlig.today,3,1709090775,1709090778,1709090778.288379,-21600,,
com.google.Chrome,3,1709090772,1709090775,1709090775.043056,-21600,,
com.leomehlig.today,12,1709090760,1709090772,1709090772.3620791,-21600,,
com.google.Chrome,3,1709090757,1709090760,1709090760.346084,-21600,,
com.leomehlig.today,26,1709090731,1709090757,1709090757.817315,-21600,,
com.google.Chrome,3,1709090728,1709090731,1709090731.526235,-21600,,
com.leomehlig.today,3,1709090725,1709090728,1709090728.734617,-21600,,
com.google.Chrome,2,1709090723,1709090725,1709090725.624809,-21600,,
com.leomehlig.today,3,1709090720,1709090723,1709090723.654109,-21600,,
com.google.Chrome,3,1709090717,1709090720,1709090720.913996,-21600,,
com.leomehlig.today,3,1709090714,1709090717,1709090717.697778,-21600,,
com.google.Chrome,1,1709090713,1709090714,1709090714.437491,-21600,,
com.leomehlig.today,3,1709090710,1709090713,1709090713.141883,-21600,,
com.google.Chrome,1,1709090709,1709090710,1709090710.542117,-21600,,
com.leomehlig.today,0,1709090709,1709090709,1709090709.545505,-21600,,
com.google.Chrome,1,1709090708,1709090709,1709090709.199213,-21600,,
com.leomehlig.today,2,1709090706,1709090708,1709090708.2690911,-21600,,
com.google.Chrome,1,1709090705,1709090706,1709090706.85634,-21600,,
com.leomehlig.today,6,1709090699,1709090705,1709090705.8653479,-21600,,
com.google.Chrome,3,1709090696,1709090699,1709090699.05562,-21600,,
com.leomehlig.today,4,1709090692,1709090696,1709090696.4077559,-21600,,
com.google.Chrome,1,1709090691,1709090692,1709090693.002912,-21600,,
com.leomehlig.today,10,1709090681,1709090691,1709090691.285465,-21600,,
com.google.Chrome,2,1709090679,1709090681,1709090681.902468,-21600,,
com.leomehlig.today,1,1709090678,1709090679,1709090679.921293,-21600,,
com.google.Chrome,3,1709090675,1709090678,1709090678.2388291,-21600,,
com.leomehlig.today,5,1709090670,1709090675,1709090675.872808,-21600,,
com.google.Chrome,3,1709090667,1709090670,1709090670.421476,-21600,,
com.leomehlig.today,3,1709090664,1709090667,1709090667.223267,-21600,,
com.google.Chrome,3,1709090661,1709090664,1709090664.7633262,-21600,,
com.leomehlig.today,7,1709090654,1709090661,1709090661.7725492,-21600,,
com.google.Chrome,1,1709090653,1709090654,1709090654.652868,-21600,,
com.leomehlig.today,0,1709090653,1709090653,1709090653.872118,-21600,,
com.google.Chrome,1,1709090652,1709090653,1709090653.430399,-21600,,
com.leomehlig.today,4,1709090648,1709090652,1709090652.573633,-21600,,
com.google.Chrome,10,1709090638,1709090648,1709090648.571684,-21600,,
com.leomehlig.today,5,1709090633,1709090638,1709090638.270362,-21600,,
com.google.Chrome,8,1709090625,1709090633,1709090633.7815971,-21600,,
com.leomehlig.today,3,1709090622,1709090625,1709090625.405182,-21600,,
com.google.Chrome,6,1709090616,1709090622,1709090622.882786,-21600,,
com.leomehlig.today,5,1709090611,1709090616,1709090616.92073,-21600,,
com.google.Chrome,2,1709090609,1709090611,1709090611.538279,-21600,,
com.leomehlig.today,4,1709090605,1709090609,1709090609.0921788,-21600,,
com.google.Chrome,3,1709090602,1709090605,1709090605.121566,-21600,,
com.leomehlig.today,10,1709090592,1709090602,1709090602.575711,-21600,,
com.google.Chrome,2,1709090590,1709090592,1709090592.592153,-21600,,
com.leomehlig.today,1,1709090589,1709090590,1709090590.4110332,-21600,,
com.google.Chrome,1,1709090588,1709090589,1709090589.561084,-21600,,
com.leomehlig.today,9,1709090579,1709090588,1709090588.9123921,-21600,,
com.google.Chrome,4,1709090575,1709090579,1709090579.4299421,-21600,,
com.leomehlig.today,5,1709090570,1709090575,1709090575.36181,-21600,,
com.google.Chrome,6,1709090564,1709090570,1709090570.0424771,-21600,,
com.leomehlig.today,5,1709090559,1709090564,1709090564.916074,-21600,,
com.google.Chrome,5,1709090554,1709090559,1709090559.160757,-21600,,
com.leomehlig.today,1,1709090553,1709090554,1709090554.154858,-21600,,
com.google.Chrome,2,1709090551,1709090553,1709090553.40869,-21600,,
com.leomehlig.today,6,1709090545,1709090551,1709090551.363435,-21600,,
com.google.Chrome,3,1709090542,1709090545,1709090545.6775079,-21600,,
com.leomehlig.today,2,1709090540,1709090542,1709090542.5099878,-21600,,
com.google.Chrome,1,1709090539,1709090540,1709090540.879118,-21600,,
com.leomehlig.today,1,1709090538,1709090539,1709090539.994487,-21600,,
com.google.Chrome,0,1709090538,1709090538,1709090538.748829,-21600,,
com.leomehlig.today,2,1709090536,1709090538,1709090538.0839481,-21600,,
com.google.Chrome,2,1709090534,1709090536,1709090536.6599379,-21600,,
com.leomehlig.today,1,1709090533,1709090534,1709090534.687498,-21600,,
com.google.Chrome,1,1709090532,1709090533,1709090533.630012,-21600,,
com.leomehlig.today,7,1709090525,1709090532,1709090533.012228,-21600,,
com.google.Chrome,3,1709090522,1709090525,1709090525.2638931,-21600,,
com.leomehlig.today,2,1709090520,1709090522,1709090522.912148,-21600,,
com.google.Chrome,3,1709090517,1709090520,1709090520.346076,-21600,,
com.leomehlig.today,13,1709090504,1709090517,1709090517.746758,-21600,,
com.google.Chrome,5,1709090499,1709090504,1709090504.6391358,-21600,,
com.leomehlig.today,20,1709090479,1709090499,1709090499.968317,-21600,,
com.google.Chrome,5,1709090474,1709090479,1709090479.320076,-21600,,
com.leomehlig.today,2,1709090472,1709090474,1709090474.6938171,-21600,,
com.google.Chrome,2,1709090470,1709090472,1709090472.805412,-21600,,
com.leomehlig.today,6,1709090464,1709090470,1709090470.523446,-21600,,
com.google.Chrome,7,1709090457,1709090464,1709090464.1007519,-21600,,
com.leomehlig.today,2,1709090455,1709090457,1709090457.711622,-21600,,
com.google.Chrome,1,1709090454,1709090455,1709090455.83664,-21600,,
com.leomehlig.today,4,1709090450,1709090454,1709090454.706392,-21600,,
com.google.Chrome,1,1709090449,1709090450,1709090450.9053879,-21600,,
com.leomehlig.today,2,1709090447,1709090449,1709090449.357305,-21600,,
com.google.Chrome,2,1709090445,1709090447,1709090447.5248442,-21600,,
com.leomehlig.today,9,1709090436,1709090445,1709090445.5261579,-21600,,
com.google.Chrome,3,1709090433,1709090436,1709090436.722128,-21600,,
com.leomehlig.today,4,1709090429,1709090433,1709090433.819261,-21600,,
com.google.Chrome,2,1709090427,1709090429,1709090429.849442,-21600,,
com.leomehlig.today,1,1709090426,1709090427,1709090427.588378,-21600,,
com.google.Chrome,1,1709090425,1709090426,1709090426.222793,-21600,,
com.leomehlig.today,2,1709090423,1709090425,1709090425.729893,-21600,,
com.google.Chrome,3,1709090420,1709090423,1709090423.495259,-21600,,
com.leomehlig.today,3,1709090417,1709090420,1709090420.472827,-21600,,
com.google.Chrome,2,1709090415,1709090417,1709090417.165783,-21600,,
com.leomehlig.today,11,1709090404,1709090415,1709090415.3243442,-21600,,
com.google.Chrome,15,1709090389,1709090404,1709090404.2335181,-21600,,
com.leomehlig.today,11,1709090378,1709090389,1709090389.291053,-21600,,
com.google.Chrome,3,1709090375,1709090378,1709090378.481827,-21600,,
com.leomehlig.today,1,1709090374,1709090375,1709090375.0453591,-21600,,
com.google.Chrome,3,1709090371,1709090374,1709090374.1692472,-21600,,
com.leomehlig.today,3,1709090368,1709090371,1709090371.807572,-21600,,
com.google.Chrome,1,1709090367,1709090368,1709090368.687377,-21600,,
com.leomehlig.today,4,1709090363,1709090367,1709090367.257591,-21600,,
com.google.Chrome,5,1709090358,1709090363,1709090363.174127,-21600,,
com.leomehlig.today,2,1709090356,1709090358,1709090358.696292,-21600,,
com.google.Chrome,2,1709090354,1709090356,1709090356.273196,-21600,,
com.leomehlig.today,14,1709090340,1709090354,1709090354.96494,-21600,,
com.google.Chrome,3,1709090337,1709090340,1709090340.832145,-21600,,
com.leomehlig.today,10,1709090327,1709090337,1709090337.231577,-21600,,
com.google.Chrome,3,1709090324,1709090327,1709090327.3402739,-21600,,
com.leomehlig.today,41,1709090283,1709090324,1709090324.907332,-21600,,
com.google.Chrome,2,1709090281,1709090283,1709090283.2009358,-21600,,
com.leomehlig.today,2,1709090279,1709090281,1709090281.384276,-21600,,
com.google.Chrome,4,1709090275,1709090279,1709090279.8392758,-21600,,
com.leomehlig.today,10,1709090265,1709090275,1709090275.176508,-21600,,
com.google.Chrome,5,1709090260,1709090265,1709090265.223526,-21600,,
com.leomehlig.today,4,1709090256,1709090260,1709090260.856296,-21600,,
com.google.Chrome,6,1709090250,1709090256,1709090256.204187,-21600,,
com.leomehlig.today,3,1709090247,1709090250,1709090250.5715861,-21600,,
com.google.Chrome,1,1709090246,1709090247,1709090247.594166,-21600,,
com.leomehlig.today,5,1709090241,1709090246,1709090246.663145,-21600,,
com.google.Chrome,2,1709090239,1709090241,1709090241.8026938,-21600,,
com.leomehlig.today,1,1709090238,1709090239,1709090239.2481909,-21600,,
com.google.Chrome,4,1709090234,1709090238,1709090238.339021,-21600,,
com.leomehlig.today,13,1709090221,1709090234,1709090234.166342,-21600,,
com.google.Chrome,1,1709090220,1709090221,1709090221.987807,-21600,,
com.leomehlig.today,7,1709090213,1709090220,1709090220.548909,-21600,,
com.google.Chrome,4,1709090209,1709090213,1709090213.077702,-21600,,
com.leomehlig.today,1,1709090208,1709090209,1709090209.867425,-21600,,
com.google.Chrome,4,1709090204,1709090208,1709090209.000381,-21600,,
com.leomehlig.today,7,1709090197,1709090204,1709090204.63372,-21600,,
com.google.Chrome,1,1709090196,1709090197,1709090197.3132792,-21600,,
com.leomehlig.today,4,1709090192,1709090196,1709090196.712367,-21600,,
com.google.Chrome,1,1709090191,1709090192,1709090192.571464,-21600,,
com.leomehlig.today,7,1709090184,1709090191,1709090191.743195,-21600,,
com.google.Chrome,7,1709090177,1709090184,1709090184.0273309,-21600,,
com.leomehlig.today,1,1709090176,1709090177,1709090177.74751,-21600,,
com.google.Chrome,3,1709090173,1709090176,1709090176.2990398,-21600,,
com.leomehlig.today,16,1709090157,1709090173,1709090173.5479388,-21600,,
com.google.Chrome,6,1709090151,1709090157,1709090157.469929,-21600,,
com.leomehlig.today,5,1709090146,1709090151,1709090151.871101,-21600,,
com.google.Chrome,3,1709090143,1709090146,1709090146.750945,-21600,,
com.leomehlig.today,5,1709090138,1709090143,1709090143.147016,-21600,,
com.google.Chrome,7,1709090131,1709090138,1709090138.675043,-21600,,
com.leomehlig.today,2,1709090129,1709090131,1709090131.18838,-21600,,
com.google.Chrome,3,1709090126,1709090129,1709090129.471904,-21600,,
com.leomehlig.today,4,1709090122,1709090126,1709090126.218752,-21600,,
com.google.Chrome,28,1709090094,1709090122,1709090122.327023,-21600,,
com.leomehlig.today,9,1709090085,1709090094,1709090094.5241451,-21600,,
com.google.Chrome,3,1709090082,1709090085,1709090085.674666,-21600,,
com.leomehlig.today,4,1709090078,1709090082,1709090082.749757,-21600,,
com.google.Chrome,3,1709090075,1709090078,1709090078.7496228,-21600,,
com.leomehlig.today,1,1709090074,1709090075,1709090075.489437,-21600,,
com.google.Chrome,3,1709090071,1709090074,1709090074.561602,-21600,,
com.leomehlig.today,2,1709090069,1709090071,1709090071.137214,-21600,,
com.google.Chrome,5,1709090064,1709090069,1709090069.5075011,-21600,,
com.leomehlig.today,4,1709090060,1709090064,1709090064.978014,-21600,,
com.google.Chrome,15,1709090045,1709090060,1709090060.4423761,-21600,,
com.leomehlig.today,2,1709090043,1709090045,1709090045.755347,-21600,,
com.google.Chrome,16,1709090027,1709090043,1709090043.426486,-21600,,
com.leomehlig.today,75,1709089952,1709090027,1709090027.570528,-21600,,
com.google.Chrome,108,1709089844,1709089952,1709089952.247007,-21600,,
com.apple.Music,26,1709089818,1709089844,1709089844.78681,-21600,,
com.google.Chrome,316,1709089502,1709089818,1709089818.32356,-21600,,
com.leomehlig.today,6,1709089496,1709089502,1709089502.6725001,-21600,,
com.google.Chrome,3,1709089493,1709089496,1709089496.155678,-21600,,
com.leomehlig.today,30,1709089463,1709089493,1709089493.936957,-21600,,
com.google.Chrome,9,1709089454,1709089463,1709089463.1454868,-21600,,
com.google.Chrome,319,1709088515,1709088834,1709088834.14436,-21600,,
com.google.Chrome,362,1709087612,1709087974,1709087974.979882,-21600,,
com.leomehlig.today,7,1709087605,1709087612,1709087612.489386,-21600,,
com.google.Chrome,911,1709086694,1709087605,1709087605.204906,-21600,,
com.google.Chrome,313,1709086174,1709086487,1709086487.875247,-21600,,
com.apple.MobileSMS,3,1709086068,1709086071,1709086071.409892,-21600,,
com.google.Chrome,27,1709086041,1709086068,1709086068.421465,-21600,,
com.leomehlig.today,8,1709086033,1709086041,1709086041.295017,-21600,,
com.apple.MobileSMS,32,1709086001,1709086033,1709086033.489876,-21600,,
com.leomehlig.today,19,1709085982,1709086001,1709086001.297987,-21600,,
com.google.Chrome,25,1709085957,1709085982,1709085982.430979,-21600,,
com.apple.MobileSMS,14,1709085943,1709085957,1709085958.032047,-21600,,
com.google.Chrome,796,1709085147,1709085943,1709085943.246856,-21600,,
com.leomehlig.today,9,1709085138,1709085147,1709085147.342897,-21600,,
com.google.Chrome,24,1709085114,1709085138,1709085138.7291842,-21600,,
com.leomehlig.today,19,1709085095,1709085114,1709085114.210824,-21600,,
com.google.Chrome,130,1709084965,1709085095,1709085095.3463612,-21600,,
com.leomehlig.today,2,1709084963,1709084965,1709084965.994996,-21600,,
com.leomehlig.today,48,1709084809,1709084857,1709084857.449312,-21600,,
com.google.Chrome,4,1709084805,1709084809,1709084809.917225,-21600,,
com.apple.MobileSMS,30,1709084775,1709084805,1709084805.235361,-21600,,
com.google.Chrome,79,1709084696,1709084775,1709084775.4177399,-21600,,
com.apple.MobileSMS,202,1709084494,1709084696,1709084696.055002,-21600,,
com.google.Chrome,7,1709084487,1709084494,1709084494.785073,-21600,,
com.apple.MobileSMS,53,1709084409,1709084462,1709084462.426089,-21600,,
com.leomehlig.today,75,1709084334,1709084409,1709084409.298039,-21600,,
com.google.Chrome,356,1709083978,1709084334,1709084334.528064,-21600,,
com.microsoft.VSCode,3,1709083975,1709083978,1709083978.065696,-21600,,
com.google.Chrome,17,1709083958,1709083975,1709083975.673575,-21600,,
com.microsoft.VSCode,40,1709083918,1709083958,1709083958.4605498,-21600,,
com.leomehlig.today,12,1709083906,1709083918,1709083918.7648978,-21600,,
com.apple.iCal,2,1709083904,1709083906,1709083906.25227,-21600,,
com.leomehlig.today,19,1709083885,1709083904,1709083904.114537,-21600,,
com.microsoft.VSCode,523,1709083362,1709083885,1709083885.966471,-21600,,
com.google.Chrome,18,1709083344,1709083362,1709083362.523793,-21600,,
com.google.Chrome,324,1709069025,1709069349,1709069349.5612268,-21600,,
com.apple.Notes,1,1709069024,1709069025,1709069025.5930471,-21600,,
com.google.Chrome,143,1709068881,1709069024,1709069024.7244492,-21600,,
com.apple.Notes,6,1709068875,1709068881,1709068881.868253,-21600,,
com.google.Chrome,16,1709068859,1709068875,1709068875.8188481,-21600,,
us.zoom.xos,23,1709068836,1709068859,1709068859.6549358,-21600,,
us.zoom.xos,301,1709068489,1709068790,1709068790.8173308,-21600,,
com.google.Chrome,249,1709068240,1709068489,1709068489.1161032,-21600,,
us.zoom.xos,5,1709068235,1709068240,1709068240.463231,-21600,,
com.google.Chrome,294,1709067941,1709068235,1709068235.082464,-21600,,
us.zoom.xos,223,1709067670,1709067893,1709067893.842616,-21600,,
com.google.Chrome,111,1709067559,1709067670,1709067670.065361,-21600,,
us.zoom.xos,16,1709067543,1709067559,1709067559.610639,-21600,,
com.google.Chrome,284,1709067259,1709067543,1709067543.404026,-21600,,
us.zoom.xos,4,1709067255,1709067259,1709067259.183465,-21600,,
com.google.Chrome,1,1709067254,1709067255,1709067255.469408,-21600,,
com.apple.Notes,167,1709067087,1709067254,1709067254.946772,-21600,,
com.google.Chrome,20,1709067067,1709067087,1709067087.643125,-21600,,
us.zoom.xos,17,1709067050,1709067067,1709067067.3929849,-21600,,
com.google.Chrome,82,1709066968,1709067050,1709067050.642319,-21600,,
us.zoom.xos,0,1709066968,1709066968,1709066968.747727,-21600,,
us.zoom.xos,302,1709066661,1709066963,1709066963.9894881,-21600,,
com.google.Chrome,112,1709066549,1709066661,1709066661.512933,-21600,,
com.microsoft.VSCode,34,1709066515,1709066549,1709066549.56128,-21600,,
us.zoom.xos,5,1709066510,1709066515,1709066515.376618,-21600,,
com.microsoft.VSCode,54,1709066456,1709066510,1709066510.547539,-21600,,
us.zoom.xos,1,1709066455,1709066456,1709066456.589009,-21600,,
com.microsoft.VSCode,52,1709066403,1709066455,1709066455.586932,-21600,,
us.zoom.xos,16,1709066387,1709066403,1709066403.8980742,-21600,,
com.microsoft.VSCode,5,1709066382,1709066387,1709066387.788525,-21600,,
us.zoom.xos,47,1709066335,1709066382,1709066382.6541271,-21600,,
com.microsoft.VSCode,4,1709066331,1709066335,1709066335.222007,-21600,,
com.google.Chrome,145,1709066186,1709066331,1709066331.936706,-21600,,
com.leomehlig.today,2,1709066184,1709066186,1709066186.784919,-21600,,
us.zoom.xos,197,1709065987,1709066184,1709066184.299057,-21600,,
us.zoom.xos,355,1709065613,1709065968,1709065968.276483,-21600,,
us.zoom.xos,303,1709064928,1709065231,1709065231.693732,-21600,,
com.leomehlig.today,130,1709064798,1709064928,1709064929.031808,-21600,,
us.zoom.xos,50,1709064748,1709064798,1709064798.293194,-21600,,
com.leomehlig.today,21,1709064727,1709064748,1709064748.682337,-21600,,
com.apple.iCal,68,1709064659,1709064727,1709064727.218264,-21600,,
us.zoom.xos,44,1709064615,1709064659,1709064659.7652988,-21600,,
com.apple.iCal,16,1709064599,1709064615,1709064615.600696,-21600,,
us.zoom.xos,123,1709064476,1709064599,1709064599.9664578,-21600,,
com.google.Chrome,1,1709064475,1709064476,1709064476.693169,-21600,,
com.apple.Preview,1,1709064474,1709064475,1709064475.762573,-21600,,
com.google.Chrome,62,1709064412,1709064474,1709064474.474992,-21600,,
us.zoom.xos,3,1709064409,1709064412,1709064412.257093,-21600,,
com.google.Chrome,0,1709064409,1709064409,1709064409.549395,-21600,,
us.zoom.xos,2,1709064407,1709064409,1709064409.218192,-21600,,
com.google.Chrome,0,1709064407,1709064407,1709064407.978472,-21600,,
us.zoom.xos,1,1709064406,1709064407,1709064407.628931,-21600,,
com.google.Chrome,18,1709064388,1709064406,1709064406.7031388,-21600,,
us.zoom.xos,3,1709064385,1709064388,1709064388.09494,-21600,,
com.google.Chrome,54,1709064331,1709064385,1709064386.0513182,-21600,,
com.apple.finder,38,1709064293,1709064331,1709064331.592698,-21600,,
com.google.Chrome,100,1709064193,1709064293,1709064293.291994,-21600,,
com.apple.finder,53,1709064140,1709064193,1709064193.3091621,-21600,,
com.google.Chrome,17,1709064123,1709064140,1709064140.132113,-21600,,
com.apple.finder,9,1709064114,1709064123,1709064123.080914,-21600,,
com.google.Chrome,32,1709064082,1709064114,1709064114.60362,-21600,,
com.apple.finder,2,1709064080,1709064082,1709064082.581492,-21600,,
com.google.Chrome,8,1709064072,1709064080,1709064080.919424,-21600,,
com.apple.finder,43,1709064029,1709064072,1709064072.5256572,-21600,,
com.google.Chrome,16,1709064013,1709064029,1709064029.928512,-21600,,
us.zoom.xos,38,1709063975,1709064013,1709064013.1100311,-21600,,
com.google.Chrome,4,1709063971,1709063975,1709063975.347888,-21600,,
us.zoom.xos,1,1709063970,1709063971,1709063971.430625,-21600,,
com.google.Chrome,25,1709063945,1709063970,1709063970.819608,-21600,,
com.apple.finder,26,1709063919,1709063945,1709063945.8314772,-21600,,
com.google.Chrome,29,1709063890,1709063919,1709063919.290993,-21600,,
com.apple.finder,4,1709063886,1709063890,1709063890.6882792,-21600,,
com.google.Chrome,64,1709063822,1709063886,1709063886.723002,-21600,,
com.apple.finder,42,1709063780,1709063822,1709063822.147258,-21600,,
com.apple.MobileSMS,38,1709063742,1709063780,1709063780.5147,-21600,,
com.google.Chrome,3,1709063739,1709063742,1709063742.5642328,-21600,,
com.leomehlig.today,2,1709063737,1709063739,1709063739.120445,-21600,,
com.google.Chrome,1,1709063736,1709063737,1709063737.785346,-21600,,
com.leomehlig.today,11,1709063725,1709063736,1709063736.87074,-21600,,
com.apple.finder,1,1709063724,1709063725,1709063725.452507,-21600,,
com.microsoft.VSCode,1,1709063723,1709063724,1709063724.645718,-21600,,
com.google.Chrome,604,1709063119,1709063723,1709063723.820219,-21600,,
com.microsoft.VSCode,2,1709063117,1709063119,1709063119.311238,-21600,,
com.apple.MobileSMS,3,1709063114,1709063117,1709063117.641576,-21600,,
com.microsoft.VSCode,86,1709063028,1709063114,1709063114.709058,-21600,,
com.apple.MobileSMS,19,1709063009,1709063028,1709063028.6510382,-21600,,
com.microsoft.VSCode,11,1709062998,1709063009,1709063009.585223,-21600,,
com.apple.MobileSMS,92,1709062906,1709062998,1709062998.221914,-21600,,
com.apple.finder,23,1709062883,1709062906,1709062906.87113,-21600,,
com.apple.MobileSMS,1,1709062882,1709062883,1709062883.362268,-21600,,
com.apple.finder,3,1709062879,1709062882,1709062882.279922,-21600,,
com.apple.MobileSMS,2,1709062877,1709062879,1709062879.8186898,-21600,,
com.apple.finder,10,1709062867,1709062877,1709062877.277361,-21600,,
com.microsoft.VSCode,60,1709062807,1709062867,1709062867.201895,-21600,,
com.google.Chrome,196,1709062611,1709062807,1709062807.39497,-21600,,
com.microsoft.VSCode,71,1709062540,1709062611,1709062611.503753,-21600,,
com.google.Chrome,110,1709062430,1709062540,1709062540.70533,-21600,,
com.microsoft.VSCode,108,1709062322,1709062430,1709062430.2100391,-21600,,
com.google.Chrome,80,1709062242,1709062322,1709062322.359539,-21600,,
com.microsoft.VSCode,300,1709061942,1709062242,1709062242.9563298,-21600,,
com.apple.finder,1,1709061941,1709061942,1709061942.0969381,-21600,,
com.microsoft.VSCode,48,1709061893,1709061941,1709061941.23826,-21600,,
com.apple.finder,5,1709061888,1709061893,1709061893.4389691,-21600,,
com.microsoft.VSCode,15,1709061873,1709061888,1709061888.7159982,-21600,,
com.microsoft.VSCode,309,1709061496,1709061805,1709061805.486645,-21600,,
com.google.Chrome,16,1709061480,1709061496,1709061496.6916099,-21600,,
com.apple.iWork.Numbers,18,1709061462,1709061480,1709061480.403874,-21600,,
com.google.Chrome,124,1709061338,1709061462,1709061462.840905,-21600,,
com.leomehlig.today,45,1709061293,1709061338,1709061338.223284,-21600,,
com.google.Chrome,16,1709061277,1709061293,1709061293.592348,-21600,,
com.leomehlig.today,112,1709061165,1709061277,1709061277.494724,-21600,,
com.google.Chrome,1,1709061164,1709061165,1709061165.6867042,-21600,,
com.leomehlig.today,10,1709061154,1709061164,1709061164.122083,-21600,,
com.google.Chrome,17,1709061137,1709061154,1709061154.7573571,-21600,,
com.apple.finder,11,1709061126,1709061137,1709061137.544255,-21600,,
com.google.Chrome,3,1709061123,1709061126,1709061126.4353352,-21600,,
com.apple.finder,11,1709061112,1709061123,1709061123.503844,-21600,,
com.apple.Preview,39,1709061073,1709061112,1709061112.1654139,-21600,,
com.apple.finder,32,1709061041,1709061073,1709061073.2423592,-21600,,
com.apple.archiveutility,0,1709061041,1709061041,1709061042.060036,-21600,,
com.apple.finder,11,1709061030,1709061041,1709061041.7333322,-21600,,
com.google.Chrome,27,1709061003,1709061030,1709061030.148285,-21600,,
com.leomehlig.today,4,1709060999,1709061003,1709061004.567823,-21600,,
com.microsoft.VSCode,528,1709060471,1709060999,1709060999.713716,-21600,,
com.google.Chrome,8,1709060463,1709060471,1709060471.374099,-21600,,
com.microsoft.VSCode,1,1709060462,1709060463,1709060463.90873,-21600,,
com.google.Chrome,7,1709060455,1709060462,1709060462.801087,-21600,,
com.google.Chrome,1194,1709052026,1709053220,1709053220.4180021,-21600,,
com.leomehlig.today,17,1709052009,1709052026,1709052027.013764,-21600,,
com.google.Chrome,29,1709051980,1709052009,1709052009.814406,-21600,,
com.leomehlig.today,8,1709051972,1709051980,1709051980.781982,-21600,,
com.google.Chrome,1694,1709050278,1709051972,1709051972.574156,-21600,,
com.leomehlig.today,65,1709050213,1709050278,1709050278.358222,-21600,,
com.google.Chrome,91,1709050122,1709050213,1709050213.763483,-21600,,
com.apple.finder,81,1709050041,1709050122,1709050122.684849,-21600,,
com.apple.weather,3,1709049622,1709049625,1709049625.212484,-21600,EB445137-D7F5-57EC-87DA-1DB460D64046,"iPhone13,2"
com.apple.weather,6,1709049616,1709049622,1709049622.5411139,-21600,EB445137-D7F5-57EC-87DA-1DB460D64046,"iPhone13,2"
com.apple.Maps,3,1709049613,1709049616,1709049617.049263,-21600,EB445137-D7F5-57EC-87DA-1DB460D64046,"iPhone13,2"
com.apple.Maps,10,1709049300,1709049310,1709049310.346925,-21600,EB445137-D7F5-57EC-87DA-1DB460D64046,"iPhone13,2"
com.apple.Maps,10,1709047735,1709047745,1709047745.8797631,-21600,EB445137-D7F5-57EC-87DA-1DB460D64046,"iPhone13,2"
com.apple.Maps,10,1709047199,1709047209,1709047209.218666,-21600,EB445137-D7F5-57EC-87DA-1DB460D64046,"iPhone13,2"
com.apple.Maps,10,1709046505,1709046515,1709046515.2136211,-21600,EB445137-D7F5-57EC-87DA-1DB460D64046,"iPhone13,2"
com.apple.Maps,9,1709045857,1709045866,1709045866.303173,-21600,EB445137-D7F5-57EC-87DA-1DB460D64046,"iPhone13,2"
com.apple.Maps,42,1709045813,1709045855,1709045855.432656,-21600,EB445137-D7F5-57EC-87DA-1DB460D64046,"iPhone13,2"
com.apple.Health,3,1709045767,1709045770,1709045771.837731,-21600,EB445137-D7F5-57EC-87DA-1DB460D64046,"iPhone13,2"
com.apple.Health,9,1709045757,1709045766,1709045766.32727,-21600,EB445137-D7F5-57EC-87DA-1DB460D64046,"iPhone13,2"
com.apple.Health,14,1709045736,1709045750,1709045750.180375,-21600,EB445137-D7F5-57EC-87DA-1DB460D64046,"iPhone13,2"
com.apple.Health,8,1709045563,1709045571,1709045571.541228,-21600,EB445137-D7F5-57EC-87DA-1DB460D64046,"iPhone13,2"
com.apple.Health,7,1709045553,1709045560,1709045560.683497,-21600,EB445137-D7F5-57EC-87DA-1DB460D64046,"iPhone13,2"
com.goodreads.Goodreads,53,1709012662,1709012715,1709012715.7084641,-21600,EB445137-D7F5-57EC-87DA-1DB460D64046,"iPhone13,2"
com.thestorygraph.thestorygraph,2,1709012660,1709012662,1709012662.0359712,-21600,EB445137-D7F5-57EC-87DA-1DB460D64046,"iPhone13,2"
com.goodreads.Goodreads,2,1709012658,1709012660,1709012660.1146111,-21600,EB445137-D7F5-57EC-87DA-1DB460D64046,"iPhone13,2"
com.thestorygraph.thestorygraph,13,1709012644,1709012657,1709012657.748986,-21600,EB445137-D7F5-57EC-87DA-1DB460D64046,"iPhone13,2"
com.apple.camera,0,1709010220,1709010220,1709010220.7558742,-21600,EB445137-D7F5-57EC-87DA-1DB460D64046,"iPhone13,2"
com.thestorygraph.thestorygraph,26,1709010187,1709010213,1709010213.837061,-21600,EB445137-D7F5-57EC-87DA-1DB460D64046,"iPhone13,2"
com.apple.journal,432,1709008697,1709009129,1709009129.95224,-21600,EB445137-D7F5-57EC-87DA-1DB460D64046,"iPhone13,2"
com.thestorygraph.thestorygraph,187,1709008507,1709008694,1709008694.7797189,-21600,EB445137-D7F5-57EC-87DA-1DB460D64046,"iPhone13,2"
com.apple.Health,13,1709008493,1709008506,1709008506.957501,-21600,EB445137-D7F5-57EC-87DA-1DB460D64046,"iPhone13,2"
com.apple.Health,12,1709008201,1709008213,1709008213.428183,-21600,EB445137-D7F5-57EC-87DA-1DB460D64046,"iPhone13,2"
com.apple.Health,10,1709008143,1709008153,1709008153.525517,-21600,EB445137-D7F5-57EC-87DA-1DB460D64046,"iPhone13,2"
com.apple.Health,10,1709008121,1709008131,1709008131.173092,-21600,EB445137-D7F5-57EC-87DA-1DB460D64046,"iPhone13,2"
com.apple.Health,10,1709007753,1709007763,1709007763.267441,-21600,EB445137-D7F5-57EC-87DA-1DB460D64046,"iPhone13,2"
com.apple.Health,2,1709007580,1709007582,1709007582.815971,-21600,EB445137-D7F5-57EC-87DA-1DB460D64046,"iPhone13,2"
com.apple.Health,13,1709007016,1709007029,1709007029.760777,-21600,EB445137-D7F5-57EC-87DA-1DB460D64046,"iPhone13,2"
com.apple.weather,2,1709007014,1709007016,1709007016.816965,-21600,EB445137-D7F5-57EC-87DA-1DB460D64046,"iPhone13,2"
com.apple.weather,0,1709005911,1709005911,1709005911.9391131,-21600,EB445137-D7F5-57EC-87DA-1DB460D64046,"iPhone13,2"
com.apple.journal,12,1709004694,1709004706,1709004706.817106,-21600,EB445137-D7F5-57EC-87DA-1DB460D64046,"iPhone13,2"
com.burbn.instagram,31,1709004653,1709004684,1709004684.728445,-21600,EB445137-D7F5-57EC-87DA-1DB460D64046,"iPhone13,2"
com.burbn.instagram,60,1709004442,1709004502,1709004502.648449,-21600,EB445137-D7F5-57EC-87DA-1DB460D64046,"iPhone13,2"
com.strava.stravaride,30,1709004260,1709004290,1709004290.688896,-21600,EB445137-D7F5-57EC-87DA-1DB460D64046,"iPhone13,2"
com.apple.findmy,12,1709003320,1709003332,1709003333.231596,-21600,EB445137-D7F5-57EC-87DA-1DB460D64046,"iPhone13,2"
com.apple.Music,3,1709003317,1709003320,1709003320.49246,-21600,EB445137-D7F5-57EC-87DA-1DB460D64046,"iPhone13,2"
com.apple.Music,3,1709003298,1709003301,1709003301.319201,-21600,EB445137-D7F5-57EC-87DA-1DB460D64046,"iPhone13,2"
com.apple.Music,29,1709003207,1709003236,1709003238.159631,-21600,EB445137-D7F5-57EC-87DA-1DB460D64046,"iPhone13,2"
com.toyopagroup.picaboo,24,1709003181,1709003205,1709003205.680766,-21600,EB445137-D7F5-57EC-87DA-1DB460D64046,"iPhone13,2"
com.leomehlig.today,5,1709003176,1709003181,1709003181.2287211,-21600,EB445137-D7F5-57EC-87DA-1DB460D64046,"iPhone13,2"
com.leomehlig.today,8,1709002939,1709002947,1709002947.539032,-21600,EB445137-D7F5-57EC-87DA-1DB460D64046,"iPhone13,2"
com.apple.finder,3,1709002931,1709002934,1709002934.2062712,-21600,,
com.google.Chrome,21,1709002910,1709002931,1709002931.512628,-21600,,
com.microsoft.VSCode,512,1709002398,1709002910,1709002910.609158,-21600,,
com.apple.finder,1,1709002397,1709002398,1709002398.803122,-21600,,
com.microsoft.VSCode,174,1709002223,1709002397,1709002397.500225,-21600,,
com.apple.finder,35,1709002188,1709002223,1709002223.647688,-21600,,
com.google.Chrome,45,1709002143,1709002188,1709002188.408607,-21600,,
com.leomehlig.today,6,1709002137,1709002143,1709002143.34004,-21600,,
com.google.Chrome,35,1709002102,1709002137,1709002137.6586509,-21600,,
com.leomehlig.today,7,1709002095,1709002102,1709002102.5251498,-21600,,
com.google.Chrome,10,1709002085,1709002095,1709002095.3094249,-21600,,
com.leomehlig.today,3,1709002082,1709002085,1709002085.860038,-21600,,
com.google.Chrome,12,1709002070,1709002082,1709002082.2167668,-21600,,
com.leomehlig.today,9,1709002061,1709002070,1709002070.8786302,-21600,,
com.google.Chrome,19,1709002042,1709002061,1709002061.4046612,-21600,,
com.leomehlig.today,3,1709002039,1709002042,1709002042.6325722,-21600,,
com.google.Chrome,26,1709002013,1709002039,1709002039.4725718,-21600,,
com.leomehlig.today,4,1709002009,1709002013,1709002013.401325,-21600,,
com.google.Chrome,15,1709001994,1709002009,1709002009.616303,-21600,,
com.leomehlig.today,4,1709001990,1709001994,1709001994.196896,-21600,,
com.google.Chrome,8,1709001982,1709001990,1709001990.711925,-21600,,
com.leomehlig.today,5,1709001977,1709001982,1709001982.679359,-21600,,
com.google.Chrome,14,1709001963,1709001977,1709001977.701374,-21600,,
com.leomehlig.today,7,1709001956,1709001963,1709001963.593206,-21600,,
com.google.Chrome,8,1709001948,1709001956,1709001956.525476,-21600,,
com.leomehlig.today,4,1709001944,1709001948,1709001948.6834168,-21600,,
com.google.Chrome,11,1709001933,1709001944,1709001944.509788,-21600,,
com.leomehlig.today,22,1709001911,1709001933,1709001933.293388,-21600,,
com.google.Chrome,34,1709001877,1709001911,1709001911.793386,-21600,,
com.leomehlig.today,15,1709001862,1709001877,1709001877.451857,-21600,,
com.google.Chrome,11,1709001851,1709001862,1709001862.962714,-21600,,
com.leomehlig.today,5,1709001846,1709001851,1709001851.7026649,-21600,,
com.google.Chrome,60,1709001786,1709001846,1709001846.357421,-21600,,
com.leomehlig.today,19,1709001767,1709001786,1709001786.436132,-21600,,
com.google.Chrome,8,1709001759,1709001767,1709001767.648581,-21600,,
com.leomehlig.today,7,1709001752,1709001759,1709001759.710161,-21600,,
com.google.Chrome,22,1709001730,1709001752,1709001752.354168,-21600,,
com.leomehlig.today,2,1709001728,1709001730,1709001730.177993,-21600,,
com.google.Chrome,12,1709001716,1709001728,1709001728.080076,-21600,,
com.leomehlig.today,5,1709001711,1709001716,1709001716.773076,-21600,,
com.google.Chrome,4,1709001707,1709001711,1709001711.725706,-21600,,
com.leomehlig.today,4,1709001703,1709001707,1709001707.649878,-21600,,
com.google.Chrome,9,1709001694,1709001703,1709001703.1975842,-21600,,
com.leomehlig.today,10,1709001684,1709001694,1709001694.3760471,-21600,,
com.google.Chrome,23,1709001661,1709001684,1709001684.301203,-21600,,
com.leomehlig.today,5,1709001656,1709001661,1709001661.201532,-21600,,
com.google.Chrome,18,1709001638,1709001656,1709001656.903728,-21600,,
com.leomehlig.today,3,1709001635,1709001638,1709001638.851616,-21600,,
com.google.Chrome,41,1709001594,1709001635,1709001635.3074389,-21600,,
com.leomehlig.today,14,1709001580,1709001594,1709001594.930382,-21600,,
com.google.Chrome,3,1709001577,1709001580,1709001580.82568,-21600,,
com.leomehlig.today,10,1709001567,1709001577,1709001577.577187,-21600,,
com.google.Chrome,12,1709001555,1709001567,1709001567.974642,-21600,,
com.leomehlig.today,8,1709001547,1709001555,1709001555.6329432,-21600,,
com.google.Chrome,3,1709001544,1709001547,1709001547.757519,-21600,,
com.leomehlig.today,8,1709001536,1709001544,1709001544.2312222,-21600,,
com.google.Chrome,21,1709001515,1709001536,1709001536.334149,-21600,,
com.leomehlig.today,13,1709001502,1709001515,1709001515.7146878,-21600,,
com.google.Chrome,31,1709001471,1709001502,1709001502.5255852,-21600,,
com.leomehlig.today,29,1709001442,1709001471,1709001472.030024,-21600,,
com.google.Chrome,22,1709001420,1709001442,1709001442.56564,-21600,,
com.leomehlig.today,9,1709001411,1709001420,1709001420.525033,-21600,,
com.google.Chrome,14,1709001397,1709001411,1709001411.196073,-21600,,
com.leomehlig.today,7,1709001390,1709001397,1709001397.2075129,-21600,,
com.google.Chrome,16,1709001374,1709001390,1709001390.981509,-21600,,
com.leomehlig.today,5,1709001369,1709001374,1709001374.166998,-21600,,
com.google.Chrome,34,1709001335,1709001369,1709001369.909297,-21600,,
com.leomehlig.today,6,1709001329,1709001335,1709001335.1357589,-21600,,
com.google.Chrome,9,1709001320,1709001329,1709001329.254459,-21600,,
com.leomehlig.today,5,1709001315,1709001320,1709001320.511623,-21600,,
com.google.Chrome,15,1709001300,1709001315,1709001315.411508,-21600,,
com.leomehlig.today,3,1709001297,1709001300,1709001300.593246,-21600,,
com.google.Chrome,19,1709001278,1709001297,1709001297.864537,-21600,,
com.leomehlig.today,11,1709001267,1709001278,1709001278.72653,-21600,,
com.google.Chrome,8,1709001259,1709001267,1709001267.4017692,-21600,,
com.leomehlig.today,4,1709001255,1709001259,1709001259.6723208,-21600,,
com.google.Chrome,9,1709001246,1709001255,1709001255.889762,-21600,,
com.leomehlig.today,3,1709001243,1709001246,1709001246.857223,-21600,,
com.google.Chrome,10,1709001233,1709001243,1709001243.522954,-21600,,
com.leomehlig.today,4,1709001229,1709001233,1709001233.26266,-21600,,
com.google.Chrome,9,1709001220,1709001229,1709001229.89621,-21600,,
com.leomehlig.today,3,1709001217,1709001220,1709001220.554914,-21600,,
com.google.Chrome,5,1709001212,1709001217,1709001217.1425219,-21600,,
com.leomehlig.today,5,1709001207,1709001212,1709001212.1846151,-21600,,
com.google.Chrome,11,1709001196,1709001207,1709001207.361308,-21600,,
com.leomehlig.today,8,1709001188,1709001196,1709001197.0178251,-21600,,
com.google.Chrome,13,1709001175,1709001188,1709001188.377627,-21600,,
com.leomehlig.today,5,1709001170,1709001175,1709001175.9678168,-21600,,
com.google.Chrome,6,1709001164,1709001170,1709001170.21279,-21600,,
com.leomehlig.today,12,1709001152,1709001164,1709001164.27877,-21600,,
com.hammerandchisel.discord,4,1709001133,1709001137,1709001137.1774979,-21600,EB445137-D7F5-57EC-87DA-1DB460D64046,"iPhone13,2"
com.microsoft.Office.Outlook,6,1709001127,1709001133,1709001133.235303,-21600,EB445137-D7F5-57EC-87DA-1DB460D64046,"iPhone13,2"
com.google.Chrome,61,1709001091,1709001152,1709001152.724042,-21600,,
com.apple.iCal,6,1709001085,1709001091,1709001091.19999,-21600,,
com.google.Chrome,62,1709001023,1709001085,1709001085.539325,-21600,,
com.leomehlig.today,174,1709000849,1709001023,1709001023.3936849,-21600,,
com.google.Chrome,1,1709000848,1709000849,1709000849.4824948,-21600,,
com.leomehlig.today,18,1709000830,1709000848,1709000848.8187509,-21600,,
com.google.Chrome,1,1709000829,1709000830,1709000830.376638,-21600,,
com.apple.Photos,3,1709000826,1709000829,1709000829.381991,-21600,,
com.google.Chrome,787,1709000039,1709000826,1709000826.968999,-21600,,
com.apple.Photos,3,1709000036,1709000039,1709000039.104994,-21600,,
com.google.Chrome,2,1709000034,1709000036,1709000036.530468,-21600,,
com.apple.Photos,5,1709000029,1709000034,1709000034.74505,-21600,,
com.microsoft.Office.Outlook,84,1708999963,1709000047,1709000047.507588,-21600,EB445137-D7F5-57EC-87DA-1DB460D64046,"iPhone13,2"
com.hammerandchisel.discord,6,1708999956,1708999962,1708999962.0953689,-21600,EB445137-D7F5-57EC-87DA-1DB460D64046,"iPhone13,2"
com.google.Chrome,335,1708999694,1709000029,1709000029.2685618,-21600,,
com.google.Chrome,646,1708998984,1708999630,1708999630.539555,-21600,,
com.apple.Preview,6,1708998978,1708998984,1708998984.381431,-21600,,
com.google.Chrome,1,1708998977,1708998978,1708998978.371355,-21600,,
com.apple.Preview,1,1708998976,1708998977,1708998977.664309,-21600,,
com.leomehlig.today,7,1708998969,1708998976,1708998976.801569,-21600,,
com.apple.Preview,1,1708998968,1708998969,1708998969.341928,-21600,,
com.google.Chrome,259,1708998709,1708998968,1708998968.412354,-21600,,
com.hammerandchisel.discord,5,1708998667,1708998672,1708998672.033571,-21600,EB445137-D7F5-57EC-87DA-1DB460D64046,"iPhone13,2"
com.hammerandchisel.discord,19,1708998324,1708998343,1708998343.56022,-21600,EB445137-D7F5-57EC-87DA-1DB460D64046,"iPhone13,2"
com.microsoft.Office.Outlook,6,1708998240,1708998246,1708998246.381019,-21600,EB445137-D7F5-57EC-87DA-1DB460D64046,"iPhone13,2"
com.google.Chrome,639,1708997937,1708998576,1708998576.431322,-21600,,
com.leomehlig.today,4,1708997933,1708997937,1708997938.016605,-21600,,
com.google.Chrome,133,1708997800,1708997933,1708997933.499233,-21600,,
com.hammerandchisel.discord,447,1708997792,1708998239,1708998239.516648,-21600,EB445137-D7F5-57EC-87DA-1DB460D64046,"iPhone13,2"
com.intsig.CamScannerLite,32,1708997760,1708997792,1708997792.1895828,-21600,EB445137-D7F5-57EC-87DA-1DB460D64046,"iPhone13,2"
com.hammerandchisel.discord,173,1708997587,1708997760,1708997761.028249,-21600,EB445137-D7F5-57EC-87DA-1DB460D64046,"iPhone13,2"
com.intsig.CamScannerLite,46,1708997541,1708997587,1708997587.3105779,-21600,EB445137-D7F5-57EC-87DA-1DB460D64046,"iPhone13,2"
com.hammerandchisel.discord,64,1708997475,1708997539,1708997539.2188458,-21600,EB445137-D7F5-57EC-87DA-1DB460D64046,"iPhone13,2"
com.strava.stravaride,15,1708997460,1708997475,1708997475.956118,-21600,EB445137-D7F5-57EC-87DA-1DB460D64046,"iPhone13,2"
com.hammerandchisel.discord,95,1708997363,1708997458,1708997458.695633,-21600,EB445137-D7F5-57EC-87DA-1DB460D64046,"iPhone13,2"
com.hammerandchisel.discord,79,1708997256,1708997335,1708997335.0124469,-21600,EB445137-D7F5-57EC-87DA-1DB460D64046,"iPhone13,2"
com.apple.MobileSMS,3,1708997253,1708997256,1708997256.754982,-21600,EB445137-D7F5-57EC-87DA-1DB460D64046,"iPhone13,2"
com.microsoft.Office.Outlook,4,1708997249,1708997253,1708997253.4283838,-21600,EB445137-D7F5-57EC-87DA-1DB460D64046,"iPhone13,2"
com.google.Chrome,483,1708997052,1708997535,1708997535.491846,-21600,,
com.apple.Preview,44,1708997008,1708997052,1708997052.8465629,-21600,,
com.google.Chrome,24,1708996984,1708997008,1708997008.705975,-21600,,
com.apple.Preview,23,1708996961,1708996984,1708996984.55897,-21600,,
com.google.Chrome,174,1708996787,1708996961,1708996961.618927,-21600,,
com.apple.Preview,45,1708996742,1708996787,1708996787.6616611,-21600,,
com.google.Chrome,94,1708996648,1708996742,1708996742.88131,-21600,,
com.apple.Preview,31,1708996617,1708996648,1708996648.473887,-21600,,
com.google.Chrome,3,1708996614,1708996617,1708996617.707869,-21600,,
com.apple.Preview,16,1708996598,1708996614,1708996614.435297,-21600,,
com.google.Chrome,131,1708996467,1708996598,1708996598.878397,-21600,,
com.apple.Preview,2,1708996465,1708996467,1708996467.076468,-21600,,
com.leomehlig.today,10,1708996455,1708996465,1708996465.555831,-21600,,
com.apple.Preview,1,1708996454,1708996455,1708996455.466247,-21600,,
com.google.Chrome,259,1708996195,1708996454,1708996454.467451,-21600,,
com.apple.Preview,11,1708996184,1708996195,1708996195.797441,-21600,,
com.google.Chrome,41,1708996143,1708996184,1708996185.0102081,-21600,,
com.apple.Preview,25,1708996118,1708996143,1708996143.221762,-21600,,
com.google.Chrome,4,1708996114,1708996118,1708996118.1863232,-21600,,
com.apple.Preview,3,1708996111,1708996114,1708996114.385765,-21600,,
com.google.Chrome,27,1708996084,1708996111,1708996111.837646,-21600,,
com.apple.Preview,33,1708996051,1708996084,1708996084.800871,-21600,,
com.leomehlig.today,6,1708996045,1708996051,1708996051.58975,-21600,,
com.apple.Preview,179,1708995866,1708996045,1708996046.039597,-21600,,
com.google.Chrome,489,1708995377,1708995866,1708995866.4148111,-21600,,
com.apple.Preview,20,1708995357,1708995377,1708995377.6339111,-21600,,
com.google.Chrome,4,1708995353,1708995357,1708995357.60481,-21600,,
com.apple.Preview,77,1708995276,1708995353,1708995353.7344189,-21600,,
com.google.Chrome,68,1708995208,1708995276,1708995276.989779,-21600,,
com.apple.Preview,30,1708995178,1708995208,1708995208.484788,-21600,,
com.google.Chrome,11,1708995167,1708995178,1708995178.952828,-21600,,
com.apple.Preview,76,1708995091,1708995167,1708995168.0252361,-21600,,
com.google.Chrome,80,1708995011,1708995091,1708995091.565376,-21600,,
com.apple.Preview,0,1708995011,1708995011,1708995011.812303,-21600,,
com.leomehlig.today,3,1708995008,1708995011,1708995011.067774,-21600,,
com.apple.Preview,1,1708995007,1708995008,1708995008.824312,-21600,,
com.microsoft.Office.Outlook,1,1708995004,1708995005,1708995005.709196,-21600,EB445137-D7F5-57EC-87DA-1DB460D64046,"iPhone13,2"
com.google.Chrome,347,1708994660,1708995007,1708995007.740093,-21600,,
com.apple.Preview,56,1708994604,1708994660,1708994660.328843,-21600,,
com.google.Chrome,103,1708994501,1708994604,1708994604.249742,-21600,,
com.apple.finder,27,1708994474,1708994501,1708994501.081327,-21600,,
com.google.Chrome,39,1708994435,1708994474,1708994474.577882,-21600,,
com.apple.Preview,207,1708994228,1708994435,1708994435.838898,-21600,,
com.google.Chrome,7,1708994221,1708994228,1708994228.6220589,-21600,,
com.apple.Preview,29,1708994192,1708994221,1708994221.7591372,-21600,,
com.google.Chrome,2,1708994190,1708994192,1708994192.296054,-21600,,
com.apple.Preview,85,1708994105,1708994190,1708994190.81388,-21600,,
com.google.Chrome,4,1708994101,1708994105,1708994105.7781239,-21600,,
com.apple.Preview,2,1708994099,1708994101,1708994101.746912,-21600,,
com.google.Chrome,26,1708994073,1708994099,1708994099.353993,-21600,,
com.apple.Preview,2,1708994071,1708994073,1708994073.453745,-21600,,
com.google.Chrome,330,1708993741,1708994071,1708994071.514916,-21600,,
com.apple.Preview,37,1708993704,1708993741,1708993741.481174,-21600,,
com.google.Chrome,45,1708993659,1708993704,1708993704.037611,-21600,,
com.apple.Preview,47,1708993612,1708993659,1708993659.442617,-21600,,
com.google.Chrome,3,1708993609,1708993612,1708993612.559005,-21600,,
com.apple.Preview,2,1708993607,1708993609,1708993609.805454,-21600,,
com.microsoft.Office.Outlook,19,1708993301,1708993320,1708993320.3479118,-21600,EB445137-D7F5-57EC-87DA-1DB460D64046,"iPhone13,2"
com.instructure.icanvas,1,1708993300,1708993301,1708993301.999718,-21600,EB445137-D7F5-57EC-87DA-1DB460D64046,"iPhone13,2"
com.apple.Preview,300,1708993130,1708993430,1708993430.821014,-21600,,
com.google.Chrome,19,1708993111,1708993130,1708993130.8378072,-21600,,
com.apple.Preview,3,1708993108,1708993111,1708993111.488326,-21600,,
com.google.Chrome,3,1708993105,1708993108,1708993108.13662,-21600,,
com.apple.Preview,2,1708993103,1708993105,1708993105.347429,-21600,,
com.google.Chrome,89,1708993014,1708993103,1708993103.494467,-21600,,
com.apple.Preview,239,1708992775,1708993014,1708993014.748802,-21600,,
com.google.Chrome,129,1708992646,1708992775,1708992775.427906,-21600,,
com.apple.Preview,82,1708992564,1708992646,1708992647.043322,-21600,,
com.google.Chrome,33,1708992531,1708992564,1708992564.6141648,-21600,,
com.apple.Preview,73,1708992458,1708992531,1708992531.623373,-21600,,
com.google.Chrome,191,1708992267,1708992458,1708992458.3772311,-21600,,
com.google.Chrome,300,1708991960,1708992260,1708992260.24716,-21600,,
com.apple.Preview,93,1708991867,1708991960,1708991960.298116,-21600,,
com.google.Chrome,14,1708991853,1708991867,1708991867.529331,-21600,,
com.apple.Preview,55,1708991798,1708991853,1708991853.33546,-21600,,
com.apple.finder,3,1708991795,1708991798,1708991798.785531,-21600,,
com.apple.Preview,2,1708991793,1708991795,1708991795.754902,-21600,,
com.apple.finder,2,1708991791,1708991793,1708991793.28244,-21600,,
com.apple.Preview,1,1708991790,1708991791,1708991792.0295038,-21600,,
com.google.Chrome,187,1708991603,1708991790,1708991790.610333,-21600,,
com.leomehlig.today,15,1708991588,1708991603,1708991604.479168,-21600,,
com.google.Chrome,26,1708991562,1708991588,1708991588.598911,-21600,,
com.instructure.icanvas,21,1708990980,1708991001,1708991001.94122,-21600,EB445137-D7F5-57EC-87DA-1DB460D64046,"iPhone13,2"
com.instructure.icanvas,8,1708990972,1708990980,1708990980.593528,-21600,EB445137-D7F5-57EC-87DA-1DB460D64046,"iPhone13,2"
com.instructure.icanvas,300,1708990186,1708990486,1708990486.144604,-21600,EB445137-D7F5-57EC-87DA-1DB460D64046,"iPhone13,2"
com.google.Chrome,814,1708988595,1708989409,1708989409.4476,-21600,,
com.leomehlig.today,22,1708988573,1708988595,1708988595.833847,-21600,,
edu.illinois.rokwire.ios,50,1708988128,1708988178,1708988178.829309,-21600,EB445137-D7F5-57EC-87DA-1DB460D64046,"iPhone13,2"
com.burbn.instagram,4,1708988109,1708988113,1708988113.1708732,-21600,EB445137-D7F5-57EC-87DA-1DB460D64046,"iPhone13,2"
com.burbn.instagram,56,1708987744,1708987800,1708987801.071813,-21600,EB445137-D7F5-57EC-87DA-1DB460D64046,"iPhone13,2"
com.burbn.instagram,139,1708986959,1708987098,1708987098.8427,-21600,EB445137-D7F5-57EC-87DA-1DB460D64046,"iPhone13,2"
com.google.chrome.ios,6,1708986945,1708986951,1708986951.145979,-21600,EB445137-D7F5-57EC-87DA-1DB460D64046,"iPhone13,2"
com.google.chrome.ios,38,1708986870,1708986908,1708986909.031331,-21600,EB445137-D7F5-57EC-87DA-1DB460D64046,"iPhone13,2"
com.apple.news,3,1708986867,1708986870,1708986870.609132,-21600,EB445137-D7F5-57EC-87DA-1DB460D64046,"iPhone13,2"
com.apple.news,5,1708986706,1708986711,1708986711.1949558,-21600,EB445137-D7F5-57EC-87DA-1DB460D64046,"iPhone13,2"
com.apple.news,4,1708986690,1708986694,1708986694.3744512,-21600,EB445137-D7F5-57EC-87DA-1DB460D64046,"iPhone13,2"
com.apple.news,6,1708986683,1708986689,1708986689.341038,-21600,EB445137-D7F5-57EC-87DA-1DB460D64046,"iPhone13,2"
com.apple.news,6,1708986676,1708986682,1708986682.3892999,-21600,EB445137-D7F5-57EC-87DA-1DB460D64046,"iPhone13,2"
com.apple.news,120,1708986474,1708986594,1708986594.7873821,-21600,EB445137-D7F5-57EC-87DA-1DB460D64046,"iPhone13,2"
com.hammerandchisel.discord,113,1708986352,1708986465,1708986465.981059,-21600,EB445137-D7F5-57EC-87DA-1DB460D64046,"iPhone13,2"
com.burbn.instagram,217,1708982151,1708982368,1708982368.987513,-21600,EB445137-D7F5-57EC-87DA-1DB460D64046,"iPhone13,2"
com.microsoft.Office.Outlook,43,1708982095,1708982138,1708982138.485048,-21600,EB445137-D7F5-57EC-87DA-1DB460D64046,"iPhone13,2"
Astrospheric.Astrospheric,3,1708982092,1708982095,1708982096.377732,-21600,EB445137-D7F5-57EC-87DA-1DB460D64046,"iPhone13,2"
Astrospheric.Astrospheric,8,1708981961,1708981969,1708981970.582232,-21600,EB445137-D7F5-57EC-87DA-1DB460D64046,"iPhone13,2"
com.ryansponzilli.DeepSkyCatalog,3,1708981955,1708981958,1708981958.387202,-21600,EB445137-D7F5-57EC-87DA-1DB460D64046,"iPhone13,2"
com.ryansponzilli.DeepSkyCatalog,10,1708981415,1708981425,1708981425.9255009,-21600,EB445137-D7F5-57EC-87DA-1DB460D64046,"iPhone13,2"
com.ryansponzilli.DeepSkyCatalog,5,1708981408,1708981413,1708981413.684077,-21600,EB445137-D7F5-57EC-87DA-1DB460D64046,"iPhone13,2"
com.ryansponzilli.DeepSkyCatalog,2,1708981400,1708981402,1708981402.855109,-21600,EB445137-D7F5-57EC-87DA-1DB460D64046,"iPhone13,2"
com.ryansponzilli.DeepSkyCatalog,67,1708980531,1708980598,1708980598.923193,-21600,EB445137-D7F5-57EC-87DA-1DB460D64046,"iPhone13,2"
com.google.chrome.ios,65,1708979604,1708979669,1708979669.294343,-21600,EB445137-D7F5-57EC-87DA-1DB460D64046,"iPhone13,2"
com.google.ios.youtube,1,1708979603,1708979604,1708979604.6143389,-21600,EB445137-D7F5-57EC-87DA-1DB460D64046,"iPhone13,2"
com.apple.Health,39,1708979564,1708979603,1708979603.476299,-21600,EB445137-D7F5-57EC-87DA-1DB460D64046,"iPhone13,2"
edu.illinois.rokwire.ios,34,1708977556,1708977590,1708977590.206604,-21600,EB445137-D7F5-57EC-87DA-1DB460D64046,"iPhone13,2"
com.strava.stravaride,17,1708977538,1708977555,1708977555.516046,-21600,EB445137-D7F5-57EC-87DA-1DB460D64046,"iPhone13,2"
com.burbn.instagram,2,1708977536,1708977538,1708977538.804162,-21600,EB445137-D7F5-57EC-87DA-1DB460D64046,"iPhone13,2"
com.leomehlig.today,19,1708977512,1708977531,1708977531.438956,-21600,,
com.microsoft.Outlook,14,1708977498,1708977512,1708977513.038292,-21600,,
com.apple.iCal,11,1708977487,1708977498,1708977498.3358479,-21600,,
com.microsoft.Outlook,5,1708977482,1708977487,1708977487.363287,-21600,,
com.apple.iCal,11,1708977471,1708977482,1708977482.998248,-21600,,
com.microsoft.Outlook,17,1708977454,1708977471,1708977471.36382,-21600,,
com.apple.iCal,13,1708977441,1708977454,1708977454.679875,-21600,,
com.microsoft.Outlook,3,1708977438,1708977441,1708977441.696589,-21600,,
com.apple.iCal,4,1708977434,1708977438,1708977438.9299998,-21600,,
com.microsoft.Outlook,6,1708977428,1708977434,1708977434.666261,-21600,,
com.apple.iCal,8,1708977420,1708977428,1708977428.475266,-21600,,
com.microsoft.Outlook,30,1708977390,1708977420,1708977420.945307,-21600,,
com.google.Chrome,3,1708977386,1708977389,1708977390.012854,-21600,,
com.burbn.instagram,171,1708973833,1708974004,1708974004.8440862,-21600,EB445137-D7F5-57EC-87DA-1DB460D64046,"iPhone13,2"
com.apple.findmy,15,1708973817,1708973832,1708973832.3903751,-21600,EB445137-D7F5-57EC-87DA-1DB460D64046,"iPhone13,2"
com.apple.findmy,8,1708972740,1708972748,1708972748.406351,-21600,EB445137-D7F5-57EC-87DA-1DB460D64046,"iPhone13,2"
com.burbn.instagram,296,1708972032,1708972328,1708972328.317576,-21600,EB445137-D7F5-57EC-87DA-1DB460D64046,"iPhone13,2"
com.strava.stravaride,74,1708971958,1708972032,1708972032.276355,-21600,EB445137-D7F5-57EC-87DA-1DB460D64046,"iPhone13,2"
com.microsoft.Office.Outlook,116,1708971808,1708971924,1708971924.136487,-21600,EB445137-D7F5-57EC-87DA-1DB460D64046,"iPhone13,2"
com.apple.camera,8,1708971338,1708971346,1708971348.033519,-21600,EB445137-D7F5-57EC-87DA-1DB460D64046,"iPhone13,2"
com.google.Maps,7,1708971336,1708971343,1708971347.609768,-21600,EB445137-D7F5-57EC-87DA-1DB460D64046,"iPhone13,2"
com.google.Maps,15,1708969909,1708969924,1708969924.339555,-21600,EB445137-D7F5-57EC-87DA-1DB460D64046,"iPhone13,2"
com.google.Maps,59,1708969840,1708969899,1708969899.178232,-21600,EB445137-D7F5-57EC-87DA-1DB460D64046,"iPhone13,2"
com.google.chrome.ios,5,1708969830,1708969835,1708969835.695094,-21600,EB445137-D7F5-57EC-87DA-1DB460D64046,"iPhone13,2"
com.google.chrome.ios,8,1708967587,1708967595,1708967596.262282,-21600,EB445137-D7F5-57EC-87DA-1DB460D64046,"iPhone13,2"
com.apple.weather,3,1708967583,1708967586,1708967587.4408,-21600,EB445137-D7F5-57EC-87DA-1DB460D64046,"iPhone13,2"
com.apple.weather,6,1708966974,1708966980,1708966980.522421,-21600,EB445137-D7F5-57EC-87DA-1DB460D64046,"iPhone13,2"
com.apple.weather,12,1708966958,1708966970,1708966970.886104,-21600,EB445137-D7F5-57EC-87DA-1DB460D64046,"iPhone13,2"
com.reddit.Reddit,31,1708966927,1708966958,1708966958.531869,-21600,EB445137-D7F5-57EC-87DA-1DB460D64046,"iPhone13,2"
com.google.chrome.ios,44,1708966883,1708966927,1708966927.252274,-21600,EB445137-D7F5-57EC-87DA-1DB460D64046,"iPhone13,2"
com.google.chrome.ios,54,1708966828,1708966882,1708966883.079341,-21600,EB445137-D7F5-57EC-87DA-1DB460D64046,"iPhone13,2"
com.google.Maps,3,1708966824,1708966827,1708966828.052041,-21600,EB445137-D7F5-57EC-87DA-1DB460D64046,"iPhone13,2"
com.google.Maps,47,1708966554,1708966601,1708966601.279526,-21600,EB445137-D7F5-57EC-87DA-1DB460D64046,"iPhone13,2"
com.toyopagroup.picaboo,16,1708966515,1708966531,1708966532.095484,-21600,EB445137-D7F5-57EC-87DA-1DB460D64046,"iPhone13,2"
com.thestorygraph.thestorygraph,2,1708966513,1708966515,1708966516.326869,-21600,EB445137-D7F5-57EC-87DA-1DB460D64046,"iPhone13,2"
com.thestorygraph.thestorygraph,13,1708965652,1708965665,1708965665.092282,-21600,EB445137-D7F5-57EC-87DA-1DB460D64046,"iPhone13,2"
com.toyopagroup.picaboo,3,1708965645,1708965648,1708965649.15716,-21600,EB445137-D7F5-57EC-87DA-1DB460D64046,"iPhone13,2"
com.toyopagroup.picaboo,13,1708965611,1708965624,1708965624.876248,-21600,EB445137-D7F5-57EC-87DA-1DB460D64046,"iPhone13,2"
com.apple.Bridge,2,1708965609,1708965611,1708965611.0793219,-21600,EB445137-D7F5-57EC-87DA-1DB460D64046,"iPhone13,2"
com.apple.Bridge,1,1708965269,1708965270,1708965271.020969,-21600,EB445137-D7F5-57EC-87DA-1DB460D64046,"iPhone13,2"
com.apple.Bridge,22,1708965241,1708965263,1708965263.475338,-21600,EB445137-D7F5-57EC-87DA-1DB460D64046,"iPhone13,2"
edu.illinois.rokwire.ios,6,1708965210,1708965216,1708965216.5931602,-21600,EB445137-D7F5-57EC-87DA-1DB460D64046,"iPhone13,2"
edu.illinois.rokwire.ios,3,1708965206,1708965209,1708965209.657918,-21600,EB445137-D7F5-57EC-87DA-1DB460D64046,"iPhone13,2"
edu.illinois.rokwire.ios,49,1708965064,1708965113,1708965113.584364,-21600,EB445137-D7F5-57EC-87DA-1DB460D64046,"iPhone13,2"
com.strava.stravaride,60,1708964985,1708965045,1708965045.23236,-21600,EB445137-D7F5-57EC-87DA-1DB460D64046,"iPhone13,2"
com.apple.Fitness,55,1708964922,1708964977,1708964977.8189511,-21600,EB445137-D7F5-57EC-87DA-1DB460D64046,"iPhone13,2"
com.robinhood.release.Robinhood,91,1708964503,1708964594,1708964594.4007611,-21600,EB445137-D7F5-57EC-87DA-1DB460D64046,"iPhone13,2"
com.google.Chrome,231,1708964371,1708964602,1708964603.1668081,-21600,,
com.apple.systempreferences,1,1708964370,1708964371,1708964371.665865,-21600,,
com.google.Chrome,47,1708964317,1708964364,1708964364.2738972,-21600,,
com.leomehlig.today,13,1708964304,1708964317,1708964317.161335,-21600,,
com.tier9digital.sundial,23,1708964274,1708964297,1708964297.129276,-21600,EB445137-D7F5-57EC-87DA-1DB460D64046,"iPhone13,2"
Astrospheric.Astrospheric,35,1708964239,1708964274,1708964274.670978,-21600,EB445137-D7F5-57EC-87DA-1DB460D64046,"iPhone13,2"
com.hammerandchisel.discord,8,1708964227,1708964235,1708964235.4371839,-21600,EB445137-D7F5-57EC-87DA-1DB460D64046,"iPhone13,2"
com.google.Chrome,107,1708964197,1708964304,1708964304.7252002,-21600,,
com.leomehlig.today,17,1708964180,1708964197,1708964197.8934588,-21600,,
com.google.Chrome,15,1708964165,1708964180,1708964180.7966309,-21600,,
com.apple.finder,10,1708964155,1708964165,1708964166.024582,-21600,,
com.google.Chrome,3,1708964152,1708964155,1708964155.8590999,-21600,,
com.apple.finder,18,1708964134,1708964152,1708964152.1354299,-21600,,
com.apple.Preview,208,1708963926,1708964134,1708964134.6882691,-21600,,
com.google.Chrome,349,1708963577,1708963926,1708963926.1145592,-21600,,
com.apple.Preview,120,1708963457,1708963577,1708963577.940284,-21600,,
com.google.Chrome,31,1708963426,1708963457,1708963457.470334,-21600,,
com.leomehlig.today,21,1708963405,1708963426,1708963426.592047,-21600,,
com.apple.finder,2,1708963403,1708963405,1708963405.962594,-21600,,
com.hammerandchisel.discord,71,1708961876,1708961947,1708961947.3960428,-21600,EB445137-D7F5-57EC-87DA-1DB460D64046,"iPhone13,2"
com.thestorygraph.thestorygraph,61,1708961796,1708961857,1708961857.866205,-21600,EB445137-D7F5-57EC-87DA-1DB460D64046,"iPhone13,2"
com.goodreads.Goodreads,11,1708961784,1708961795,1708961795.2723331,-21600,EB445137-D7F5-57EC-87DA-1DB460D64046,"iPhone13,2"
com.thestorygraph.thestorygraph,7,1708961776,1708961783,1708961783.5179,-21600,EB445137-D7F5-57EC-87DA-1DB460D64046,"iPhone13,2"
com.markhambly.APOD,33,1708961587,1708961620,1708961620.621386,-21600,EB445137-D7F5-57EC-87DA-1DB460D64046,"iPhone13,2"
com.google.ios.youtube,3,1708961584,1708961587,1708961587.651122,-21600,EB445137-D7F5-57EC-87DA-1DB460D64046,"iPhone13,2"
com.markhambly.APOD,9,1708961575,1708961584,1708961584.6490278,-21600,EB445137-D7F5-57EC-87DA-1DB460D64046,"iPhone13,2"
com.apple.Fitness,6,1708961566,1708961572,1708961572.2607331,-21600,EB445137-D7F5-57EC-87DA-1DB460D64046,"iPhone13,2"
com.google.Maps,3,1708961560,1708961563,1708961563.54535,-21600,EB445137-D7F5-57EC-87DA-1DB460D64046,"iPhone13,2"
com.google.Maps,9,1708959378,1708959387,1708959387.147811,-21600,EB445137-D7F5-57EC-87DA-1DB460D64046,"iPhone13,2"
com.google.Maps,141,1708959235,1708959376,1708959376.721096,-21600,EB445137-D7F5-57EC-87DA-1DB460D64046,"iPhone13,2"
com.apple.Health,2,1708959233,1708959235,1708959235.2230859,-21600,EB445137-D7F5-57EC-87DA-1DB460D64046,"iPhone13,2"
com.apple.Health,6,1708959210,1708959216,1708959216.641485,-21600,EB445137-D7F5-57EC-87DA-1DB460D64046,"iPhone13,2"
com.apple.Health,6,1708959170,1708959176,1708959176.633842,-21600,EB445137-D7F5-57EC-87DA-1DB460D64046,"iPhone13,2"
com.apple.Health,12,1708959116,1708959128,1708959128.751573,-21600,EB445137-D7F5-57EC-87DA-1DB460D64046,"iPhone13,2"
com.apple.Health,42,1708958698,1708958740,1708958740.980701,-21600,EB445137-D7F5-57EC-87DA-1DB460D64046,"iPhone13,2"
com.apple.Health,49,1708958645,1708958694,1708958694.8122358,-21600,EB445137-D7F5-57EC-87DA-1DB460D64046,"iPhone13,2"
com.apple.finder,4,1708921138,1708921142,1708921142.8135939,-21600,,
com.google.Chrome,7,1708921131,1708921138,1708921138.895721,-21600,,
com.apple.MobileSMS,2,1708921129,1708921131,1708921131.486181,-21600,,
com.google.Chrome,88,1708921041,1708921129,1708921129.7948132,-21600,,
com.apple.MobileSMS,10,1708921031,1708921041,1708921041.322263,-21600,,
com.google.Chrome,633,1708920398,1708921031,1708921031.510715,-21600,,
com.apple.finder,40,1708920358,1708920398,1708920398.912599,-21600,,
com.google.Chrome,322,1708920036,1708920358,1708920358.516354,-21600,,
com.apple.finder,2,1708918134,1708918136,1708918136.643128,-21600,,
com.apple.finder,4,1708914579,1708914583,1708914583.4099898,-21600,,
com.microsoft.VSCode,126,1708914453,1708914579,1708914579.928431,-21600,,
com.leomehlig.today,40,1708914413,1708914453,1708914453.6969419,-21600,,
com.google.Chrome,265,1708914148,1708914413,1708914413.678083,-21600,,
com.leomehlig.today,143,1708914005,1708914148,1708914149.0290852,-21600,,
com.google.Chrome,2,1708914003,1708914005,1708914005.145778,-21600,,
com.leomehlig.today,31,1708913972,1708914003,1708914003.455217,-21600,,
com.google.Chrome,893,1708913079,1708913972,1708913972.6015759,-21600,,
com.leomehlig.today,12,1708913067,1708913079,1708913079.379832,-21600,,
com.apple.Preview,400,1708912667,1708913067,1708913067.821533,-21600,,
com.google.Chrome,5,1708912662,1708912667,1708912667.5569139,-21600,,
com.microsoft.VSCode,2,1708912660,1708912662,1708912662.939558,-21600,,
com.google.Chrome,7,1708912653,1708912660,1708912660.599125,-21600,,
com.apple.Preview,547,1708912106,1708912653,1708912653.199493,-21600,,
com.google.Chrome,2,1708912104,1708912106,1708912106.1666532,-21600,,
com.leomehlig.today,9,1708912095,1708912104,1708912104.1763968,-21600,,
com.apple.Preview,38,1708912057,1708912095,1708912095.613006,-21600,,
com.leomehlig.today,3,1708912054,1708912057,1708912057.352803,-21600,,
com.apple.Preview,19,1708912035,1708912054,1708912054.9836059,-21600,,
com.google.Chrome,30,1708912005,1708912035,1708912035.9266238,-21600,,
com.apple.Preview,23,1708911982,1708912005,1708912005.1463718,-21600,,
com.google.Chrome,2,1708911980,1708911982,1708911982.463187,-21600,,
com.apple.Preview,214,1708911766,1708911980,1708911980.539468,-21600,,
com.google.Chrome,4,1708911762,1708911766,1708911766.495523,-21600,,
com.apple.Preview,1,1708911761,1708911762,1708911762.55407,-21600,,
com.google.Chrome,2,1708911759,1708911761,1708911761.3387542,-21600,,
com.apple.Preview,211,1708911548,1708911759,1708911759.616819,-21600,,
com.google.Chrome,11,1708911537,1708911548,1708911548.42735,-21600,,
com.apple.Preview,246,1708911291,1708911537,1708911537.2303991,-21600,,
com.google.Chrome,4,1708911287,1708911291,1708911291.1478539,-21600,,
com.apple.Preview,94,1708911193,1708911287,1708911287.136344,-21600,,
com.google.Chrome,11,1708911182,1708911193,1708911193.9723558,-21600,,
com.apple.Preview,2,1708911180,1708911182,1708911182.779625,-21600,,
com.google.Chrome,41,1708911139,1708911180,1708911180.57568,-21600,,
com.apple.Preview,1522,1708909617,1708911139,1708911140.0247998,-21600,,
com.leomehlig.today,14,1708909603,1708909617,1708909617.371688,-21600,,
com.google.Chrome,7,1708909596,1708909603,1708909603.0463738,-21600,,
com.leomehlig.today,4,1708909592,1708909596,1708909596.45755,-21600,,
com.google.Chrome,462,1708909130,1708909592,1708909592.850299,-21600,,
com.leomehlig.today,9,1708909121,1708909130,1708909130.816283,-21600,,
com.google.Chrome,10,1708909111,1708909121,1708909121.649782,-21600,,
com.leomehlig.today,1,1708909110,1708909111,1708909111.7489839,-21600,,
com.google.Chrome,312,1708908798,1708909110,1708909110.562087,-21600,,
com.leomehlig.today,5,1708908793,1708908798,1708908798.9534059,-21600,,
com.google.Chrome,11,1708908782,1708908793,1708908793.04458,-21600,,
com.google.Chrome,709,1708907962,1708908671,1708908671.9916449,-21600,,
com.microsoft.VSCode,265,1708907697,1708907962,1708907962.770668,-21600,,
com.google.Chrome,4,1708907693,1708907697,1708907697.184249,-21600,,
com.microsoft.VSCode,13,1708907680,1708907693,1708907693.714025,-21600,,
com.google.Chrome,19,1708907661,1708907680,1708907680.965585,-21600,,
com.microsoft.VSCode,140,1708907521,1708907661,1708907661.279275,-21600,,
com.google.Chrome,278,1708907243,1708907521,1708907521.6520538,-21600,,
com.leomehlig.today,29,1708907214,1708907243,1708907243.777946,-21600,,
com.leomehlig.today,23,1708900893,1708900916,1708900916.205505,-21600,,
com.apple.Preview,3,1708900890,1708900893,1708900893.2669039,-21600,,
com.apple.Preview,67,1708900813,1708900880,1708900880.977511,-21600,,
com.google.Chrome,24,1708900789,1708900813,1708900813.360338,-21600,,
com.apple.Preview,232,1708900557,1708900789,1708900789.524116,-21600,,
com.apple.Preview,524,1708900032,1708900556,1708900556.2203689,-21600,,
com.google.Chrome,13,1708900019,1708900032,1708900032.307307,-21600,,
com.apple.Preview,7,1708900012,1708900019,1708900019.372236,-21600,,
com.google.Chrome,9,1708900003,1708900012,1708900012.402862,-21600,,
com.apple.Preview,20,1708899983,1708900003,1708900003.9614592,-21600,,
com.google.Chrome,77,1708899906,1708899983,1708899983.9157162,-21600,,
com.leomehlig.today,54,1708899852,1708899906,1708899906.1578379,-21600,,
com.google.Chrome,34,1708899818,1708899852,1708899852.962563,-21600,,
com.leomehlig.today,24,1708899794,1708899818,1708899818.2216702,-21600,,
com.google.Chrome,30,1708899764,1708899794,1708899795.024652,-21600,,
com.leomehlig.today,1,1708899763,1708899764,1708899764.9727821,-21600,,
com.google.Chrome,4,1708899759,1708899763,1708899763.633195,-21600,,
com.leomehlig.today,1,1708899758,1708899759,1708899759.376955,-21600,,
com.google.Chrome,39,1708899719,1708899758,1708899758.379298,-21600,,
com.leomehlig.today,11,1708899708,1708899719,1708899720.2312322,-21600,,
com.google.Chrome,4,1708899704,1708899708,1708899708.564517,-21600,,
com.apple.Notes,71,1708899633,1708899704,1708899704.778283,-21600,,
com.google.Chrome,7,1708899626,1708899633,1708899633.084769,-21600,,
com.apple.Notes,4,1708899622,1708899626,1708899626.426053,-21600,,
com.google.Chrome,5,1708899617,1708899622,1708899622.15546,-21600,,
com.apple.Notes,1,1708899616,1708899617,1708899617.6005878,-21600,,
com.google.Chrome,3,1708899613,1708899616,1708899616.11945,-21600,,
com.apple.Notes,3,1708899610,1708899613,1708899613.7359018,-21600,,
com.google.Chrome,4,1708899606,1708899610,1708899610.389972,-21600,,
com.apple.Notes,2,1708899604,1708899606,1708899607.064537,-21600,,
com.google.Chrome,3,1708899601,1708899604,1708899604.311482,-21600,,
com.apple.Notes,11,1708899590,1708899601,1708899601.9293761,-21600,,
com.google.Chrome,2,1708899588,1708899590,1708899590.902168,-21600,,
com.apple.Notes,31,1708899557,1708899588,1708899588.1131082,-21600,,
com.google.Chrome,2,1708899555,1708899557,1708899557.567364,-21600,,
com.apple.Notes,188,1708899367,1708899555,1708899555.906026,-21600,,
com.leomehlig.today,17,1708899350,1708899367,1708899367.617835,-21600,,
com.apple.Notes,63,1708899287,1708899350,1708899351.0694299,-21600,,
com.google.Chrome,5,1708899282,1708899287,1708899287.404183,-21600,,
com.apple.Notes,5,1708899277,1708899282,1708899282.2222528,-21600,,
com.google.Chrome,2,1708899275,1708899277,1708899277.836523,-21600,,
com.apple.Notes,3,1708899272,1708899275,1708899275.622016,-21600,,
com.google.Chrome,6,1708899266,1708899272,1708899272.054707,-21600,,
com.apple.Notes,4,1708899262,1708899266,1708899266.967113,-21600,,
com.google.Chrome,3,1708899259,1708899262,1708899262.1657891,-21600,,
com.apple.Notes,6,1708899253,1708899259,1708899259.891484,-21600,,
com.google.Chrome,6,1708899247,1708899253,1708899253.4620261,-21600,,
com.apple.Notes,2,1708899245,1708899247,1708899247.461931,-21600,,
com.google.Chrome,4,1708899241,1708899245,1708899245.137713,-21600,,
com.apple.Notes,1,1708899240,1708899241,1708899241.2764559,-21600,,
com.google.Chrome,1,1708899239,1708899240,1708899240.41641,-21600,,
com.apple.Notes,3,1708899236,1708899239,1708899239.810165,-21600,,
com.google.Chrome,2,1708899234,1708899236,1708899236.747467,-21600,,
com.apple.Notes,8,1708899226,1708899234,1708899234.636627,-21600,,
com.google.Chrome,3,1708899223,1708899226,1708899226.560749,-21600,,
com.apple.Notes,6,1708899217,1708899223,1708899223.942138,-21600,,
com.google.Chrome,2,1708899215,1708899217,1708899217.935182,-21600,,
com.apple.Notes,9,1708899206,1708899215,1708899215.209804,-21600,,
com.google.Chrome,6,1708899200,1708899206,1708899206.147355,-21600,,
com.apple.Notes,2,1708899198,1708899200,1708899200.428564,-21600,,
com.google.Chrome,12,1708899186,1708899198,1708899198.652967,-21600,,
com.apple.Notes,9,1708899177,1708899186,1708899186.297318,-21600,,
com.google.Chrome,3,1708899174,1708899177,1708899178.008323,-21600,,
com.apple.Notes,2,1708899172,1708899174,1708899174.578776,-21600,,
com.google.Chrome,41,1708899131,1708899172,1708899172.4696832,-21600,,
com.apple.Notes,1,1708899130,1708899131,1708899131.881013,-21600,,
com.google.Chrome,3,1708899127,1708899130,1708899130.289815,-21600,,
com.apple.Notes,2,1708899125,1708899127,1708899127.425183,-21600,,
com.google.Chrome,2,1708899123,1708899125,1708899125.8672051,-21600,,
com.apple.Notes,3,1708899120,1708899123,1708899123.574434,-21600,,
com.google.Chrome,5,1708899115,1708899120,1708899120.499487,-21600,,
com.apple.Notes,1,1708899114,1708899115,1708899115.454283,-21600,,
com.google.Chrome,0,1708899114,1708899114,1708899114.928025,-21600,,
com.apple.Notes,2,1708899112,1708899114,1708899114.704072,-21600,,
com.google.Chrome,3,1708899109,1708899112,1708899112.18682,-21600,,
com.apple.Notes,3,1708899106,1708899109,1708899109.3687592,-21600,,
com.google.Chrome,12,1708899094,1708899106,1708899106.379376,-21600,,
com.apple.Notes,11,1708899083,1708899094,1708899094.820263,-21600,,
com.google.Chrome,14,1708899069,1708899083,1708899083.9021769,-21600,,
com.apple.Notes,6,1708899063,1708899069,1708899069.5124831,-21600,,
com.google.Chrome,17,1708899046,1708899063,1708899063.6024342,-21600,,
com.apple.Notes,68,1708898978,1708899046,1708899046.954288,-21600,,
com.apple.Preview,0,1708898978,1708898978,1708898978.781663,-21600,,
com.apple.Notes,5,1708898973,1708898978,1708898978.31053,-21600,,
com.apple.Preview,10,1708898963,1708898973,1708898973.759202,-21600,,
com.apple.Notes,4,1708898959,1708898963,1708898963.105225,-21600,,
com.apple.Preview,15,1708898944,1708898959,1708898959.83409,-21600,,
com.apple.Notes,3,1708898941,1708898944,1708898944.546356,-21600,,
com.apple.Preview,7,1708898934,1708898941,1708898941.3544412,-21600,,
com.apple.Notes,3,1708898931,1708898934,1708898934.827005,-21600,,
com.apple.Preview,10,1708898921,1708898931,1708898931.312204,-21600,,
com.apple.Notes,5,1708898916,1708898921,1708898921.8183641,-21600,,
com.apple.Preview,6,1708898910,1708898916,1708898916.38505,-21600,,
com.apple.Notes,6,1708898904,1708898910,1708898910.114531,-21600,,
com.apple.Preview,21,1708898883,1708898904,1708898904.654918,-21600,,
com.apple.Notes,5,1708898878,1708898883,1708898883.7691169,-21600,,
com.apple.Preview,11,1708898867,1708898878,1708898878.779091,-21600,,
com.apple.Notes,5,1708898862,1708898867,1708898867.297143,-21600,,
com.apple.Preview,11,1708898851,1708898862,1708898862.9274402,-21600,,
com.apple.Notes,3,1708898848,1708898851,1708898851.562417,-21600,,
com.apple.Preview,14,1708898834,1708898848,1708898848.1433182,-21600,,
com.apple.Notes,4,1708898830,1708898834,1708898834.851316,-21600,,
com.apple.Preview,6,1708898824,1708898830,1708898830.766471,-21600,,
com.apple.Notes,5,1708898819,1708898824,1708898824.313595,-21600,,
com.apple.Preview,16,1708898803,1708898819,1708898819.5681748,-21600,,
com.apple.Notes,1,1708898802,1708898803,1708898803.635884,-21600,,
com.apple.Preview,24,1708898778,1708898802,1708898802.446589,-21600,,
com.apple.Notes,24,1708898754,1708898778,1708898778.361105,-21600,,
com.google.Chrome,11,1708898743,1708898754,1708898754.922472,-21600,,
com.apple.Notes,1,1708898742,1708898743,1708898743.406201,-21600,,
com.google.Chrome,3,1708898739,1708898742,1708898742.341311,-21600,,
com.apple.Notes,2,1708898737,1708898739,1708898739.5650039,-21600,,
com.google.Chrome,13,1708898724,1708898737,1708898737.4995608,-21600,,
com.apple.Notes,3,1708898721,1708898724,1708898724.865586,-21600,,
com.google.Chrome,4,1708898717,1708898721,1708898721.88935,-21600,,
com.apple.Notes,3,1708898714,1708898717,1708898717.409436,-21600,,
com.google.Chrome,1,1708898713,1708898714,1708898714.793402,-21600,,
com.apple.Notes,1,1708898712,1708898713,1708898713.90656,-21600,,
com.google.Chrome,2,1708898710,1708898712,1708898712.377006,-21600,,
com.apple.Notes,2,1708898708,1708898710,1708898710.333545,-21600,,
com.google.Chrome,4,1708898704,1708898708,1708898708.50895,-21600,,
com.apple.Notes,12,1708898692,1708898704,1708898704.8427439,-21600,,
com.google.Chrome,15,1708898677,1708898692,1708898692.483922,-21600,,
com.apple.Notes,13,1708898664,1708898677,1708898677.3979359,-21600,,
com.google.Chrome,1,1708898663,1708898664,1708898664.724187,-21600,,
com.apple.Notes,2,1708898661,1708898663,1708898663.608177,-21600,,
com.google.Chrome,26,1708898635,1708898661,1708898661.5177011,-21600,,
com.apple.Notes,18,1708898617,1708898635,1708898635.8512192,-21600,,
com.google.Chrome,15,1708898602,1708898617,1708898617.5028992,-21600,,
com.apple.Notes,5,1708898597,1708898602,1708898602.48986,-21600,,
com.google.Chrome,20,1708898577,1708898597,1708898597.8795838,-21600,,
com.apple.Notes,15,1708898562,1708898577,1708898577.634032,-21600,,
com.google.Chrome,24,1708898538,1708898562,1708898562.908908,-21600,,
com.apple.Notes,4,1708898534,1708898538,1708898538.718205,-21600,,
com.google.Chrome,51,1708898483,1708898534,1708898534.505106,-21600,,
com.apple.Notes,16,1708898467,1708898483,1708898483.886879,-21600,,
com.google.Chrome,19,1708898448,1708898467,1708898467.884017,-21600,,
com.apple.Notes,25,1708898423,1708898448,1708898448.793854,-21600,,
com.google.Chrome,4,1708898419,1708898423,1708898423.522816,-21600,,
com.apple.Notes,6,1708898413,1708898419,1708898419.242029,-21600,,
com.google.Chrome,4,1708898409,1708898413,1708898413.453259,-21600,,
com.apple.Notes,5,1708898404,1708898409,1708898410.0583081,-21600,,
com.google.Chrome,1,1708898403,1708898404,1708898405.049557,-21600,,
com.apple.Notes,8,1708898395,1708898403,1708898403.46819,-21600,,
com.google.Chrome,0,1708898395,1708898395,1708898395.705626,-21600,,
com.apple.Notes,18,1708898377,1708898395,1708898395.175568,-21600,,
com.apple.Preview,1,1708898376,1708898377,1708898377.812918,-21600,,
com.google.Chrome,6,1708898370,1708898376,1708898376.873702,-21600,,
com.apple.Notes,3,1708898367,1708898370,1708898370.856869,-21600,,
com.google.Chrome,4,1708898363,1708898367,1708898367.30647,-21600,,
com.apple.Notes,6,1708898357,1708898363,1708898363.3469748,-21600,,
com.google.Chrome,19,1708898338,1708898357,1708898357.6855412,-21600,,
com.apple.Notes,6,1708898332,1708898338,1708898338.61029,-21600,,
com.google.Chrome,5,1708898327,1708898332,1708898332.385253,-21600,,
com.apple.Notes,8,1708898319,1708898327,1708898327.1066709,-21600,,
com.google.Chrome,8,1708898311,1708898319,1708898319.172961,-21600,,
com.apple.Notes,14,1708898297,1708898311,1708898311.748989,-21600,,
com.google.Chrome,6,1708898291,1708898297,1708898297.916992,-21600,,
com.apple.Notes,3,1708898288,1708898291,1708898291.286396,-21600,,
com.google.Chrome,5,1708898283,1708898288,1708898288.190147,-21600,,
com.apple.Notes,9,1708898274,1708898283,1708898283.936538,-21600,,
com.google.Chrome,1,1708898273,1708898274,1708898274.458852,-21600,,
com.apple.Notes,2,1708898271,1708898273,1708898273.955649,-21600,,
com.google.Chrome,2,1708898269,1708898271,1708898271.832232,-21600,,
com.apple.Notes,6,1708898263,1708898269,1708898269.353543,-21600,,
com.google.Chrome,1,1708898262,1708898263,1708898263.9472752,-21600,,
com.apple.Notes,6,1708898256,1708898262,1708898262.2236362,-21600,,
com.google.Chrome,15,1708898241,1708898256,1708898256.877255,-21600,,
com.apple.Notes,6,1708898235,1708898241,1708898241.6443,-21600,,
com.google.Chrome,5,1708898230,1708898235,1708898235.419982,-21600,,
com.apple.Preview,2,1708898228,1708898230,1708898230.344456,-21600,,
com.apple.Notes,5,1708898223,1708898228,1708898228.971171,-21600,,
com.apple.Preview,1,1708898222,1708898223,1708898223.153047,-21600,,
com.google.Chrome,3,1708898219,1708898222,1708898222.426968,-21600,,
com.apple.Preview,1,1708898218,1708898219,1708898219.313514,-21600,,
com.apple.Notes,14,1708898204,1708898218,1708898218.3037992,-21600,,
com.apple.Preview,1,1708898203,1708898204,1708898204.872497,-21600,,
com.google.Chrome,3,1708898200,1708898203,1708898204.001205,-21600,,
com.apple.Preview,1,1708898199,1708898200,1708898200.4927459,-21600,,
com.apple.Notes,36,1708898163,1708898199,1708898199.325515,-21600,,
com.apple.Preview,1,1708898162,1708898163,1708898163.752322,-21600,,
com.apple.Notes,2,1708898160,1708898162,1708898162.436573,-21600,,
com.apple.Preview,6,1708898154,1708898160,1708898160.8955479,-21600,,
com.apple.Notes,22,1708898132,1708898154,1708898154.613673,-21600,,
com.google.Chrome,1,1708898131,1708898132,1708898132.8879619,-21600,,
com.apple.Notes,4,1708898127,1708898131,1708898132.051107,-21600,,
com.google.Chrome,1,1708898126,1708898127,1708898127.6726022,-21600,,
com.apple.Notes,2,1708898124,1708898126,1708898126.76984,-21600,,
com.google.Chrome,1,1708898123,1708898124,1708898124.513947,-21600,,
com.apple.Notes,3,1708898120,1708898123,1708898123.147821,-21600,,
com.google.Chrome,1,1708898119,1708898120,1708898120.196371,-21600,,
com.apple.Notes,5,1708898114,1708898119,1708898119.554852,-21600,,
com.google.Chrome,9,1708898105,1708898114,1708898114.951342,-21600,,
com.apple.Notes,2,1708898103,1708898105,1708898105.876826,-21600,,
com.google.Chrome,1,1708898102,1708898103,1708898103.578421,-21600,,
com.apple.Notes,3,1708898099,1708898102,1708898102.602673,-21600,,
com.google.Chrome,3,1708898096,1708898099,1708898099.081655,-21600,,
com.apple.Notes,5,1708898091,1708898096,1708898096.410306,-21600,,
com.google.Chrome,2,1708898089,1708898091,1708898091.7636142,-21600,,
com.apple.Notes,6,1708898083,1708898089,1708898089.735002,-21600,,
com.google.Chrome,2,1708898081,1708898083,1708898083.8399749,-21600,,
com.apple.Notes,3,1708898078,1708898081,1708898081.4462671,-21600,,
com.google.Chrome,6,1708898072,1708898078,1708898078.633667,-21600,,
com.apple.Notes,23,1708898049,1708898072,1708898072.279105,-21600,,
com.google.Chrome,1,1708898048,1708898049,1708898049.2151399,-21600,,
com.apple.Notes,6,1708898042,1708898048,1708898048.201383,-21600,,
com.google.Chrome,1,1708898041,1708898042,1708898042.861024,-21600,,
com.apple.Notes,3,1708898038,1708898041,1708898041.5371552,-21600,,
com.google.Chrome,1,1708898037,1708898038,1708898038.9015908,-21600,,
com.apple.Notes,4,1708898033,1708898037,1708898037.663588,-21600,,
com.google.Chrome,1,1708898032,1708898033,1708898033.5293632,-21600,,
com.apple.Notes,2,1708898030,1708898032,1708898032.79672,-21600,,
com.google.Chrome,1,1708898029,1708898030,1708898030.040854,-21600,,
com.apple.Notes,6,1708898023,1708898029,1708898029.0792751,-21600,,
com.google.Chrome,1,1708898022,1708898023,1708898023.654974,-21600,,
com.apple.Notes,8,1708898014,1708898022,1708898022.607744,-21600,,
com.google.Chrome,9,1708898005,1708898014,1708898014.740992,-21600,,
com.apple.Notes,4,1708898001,1708898005,1708898005.0829759,-21600,,
com.google.Chrome,6,1708897995,1708898001,1708898001.472754,-21600,,
com.apple.Notes,7,1708897988,1708897995,1708897995.202711,-21600,,
com.google.Chrome,2,1708897986,1708897988,1708897988.188336,-21600,,
com.apple.Notes,9,1708897977,1708897986,1708897986.7911658,-21600,,
com.google.Chrome,1,1708897976,1708897977,1708897977.932733,-21600,,
com.apple.Notes,6,1708897970,1708897976,1708897976.932901,-21600,,
com.google.Chrome,2,1708897968,1708897970,1708897970.104387,-21600,,
com.apple.Notes,3,1708897965,1708897968,1708897968.977567,-21600,,
com.google.Chrome,1,1708897964,1708897965,1708897965.72724,-21600,,
com.apple.Notes,2,1708897962,1708897964,1708897964.9563851,-21600,,
com.google.Chrome,3,1708897959,1708897962,1708897962.1427069,-21600,,
com.apple.Notes,0,1708897959,1708897959,1708897959.80365,-21600,,
com.google.Chrome,2,1708897957,1708897959,1708897959.2827458,-21600,,
com.apple.Notes,5,1708897952,1708897957,1708897958.061122,-21600,,
com.google.Chrome,8,1708897944,1708897952,1708897952.646589,-21600,,
com.apple.Notes,9,1708897935,1708897944,1708897944.661052,-21600,,
com.google.Chrome,1,1708897934,1708897935,1708897935.8346338,-21600,,
com.apple.Notes,0,1708897934,1708897934,1708897934.747892,-21600,,
com.google.Chrome,5,1708897929,1708897934,1708897934.57129,-21600,,
com.apple.Notes,9,1708897920,1708897929,1708897929.960559,-21600,,
com.google.Chrome,1,1708897919,1708897920,1708897920.57795,-21600,,
com.apple.Notes,7,1708897912,1708897919,1708897919.820633,-21600,,
com.google.Chrome,4,1708897908,1708897912,1708897912.380324,-21600,,
com.apple.Notes,3,1708897905,1708897908,1708897908.445575,-21600,,
com.google.Chrome,1,1708897904,1708897905,1708897905.6191301,-21600,,
com.apple.Notes,3,1708897901,1708897904,1708897904.819819,-21600,,
com.google.Chrome,1,1708897900,1708897901,1708897901.4248738,-21600,,
com.apple.Notes,8,1708897892,1708897900,1708897900.110292,-21600,,
com.google.Chrome,7,1708897885,1708897892,1708897892.558751,-21600,,
com.apple.Notes,5,1708897880,1708897885,1708897885.402934,-21600,,
com.google.Chrome,34,1708897846,1708897880,1708897880.193373,-21600,,
com.apple.Notes,6,1708897840,1708897846,1708897846.290362,-21600,,
com.google.Chrome,2,1708897838,1708897840,1708897840.226841,-21600,,
com.apple.Notes,9,1708897829,1708897838,1708897838.7569299,-21600,,
com.google.Chrome,1,1708897828,1708897829,1708897829.30808,-21600,,
com.apple.Notes,5,1708897823,1708897828,1708897828.414053,-21600,,
com.google.Chrome,1,1708897822,1708897823,1708897823.393369,-21600,,
com.apple.Notes,5,1708897817,1708897822,1708897822.646496,-21600,,
com.google.Chrome,13,1708897804,1708897817,1708897817.9731889,-21600,,
com.apple.Notes,7,1708897797,1708897804,1708897804.467483,-21600,,
com.google.Chrome,6,1708897791,1708897797,1708897797.916394,-21600,,
com.apple.Notes,4,1708897787,1708897791,1708897791.98033,-21600,,
com.google.Chrome,1,1708897786,1708897787,1708897787.1977649,-21600,,
com.apple.Notes,2,1708897784,1708897786,1708897786.7367969,-21600,,
com.google.Chrome,1,1708897783,1708897784,1708897784.565205,-21600,,
com.apple.Notes,2,1708897781,1708897783,1708897784.0728102,-21600,,
com.google.Chrome,8,1708897773,1708897781,1708897781.119008,-21600,,
com.apple.Notes,8,1708897765,1708897773,1708897774.080298,-21600,,
com.google.Chrome,16,1708897749,1708897765,1708897765.266545,-21600,,
com.apple.Notes,13,1708897736,1708897749,1708897749.406636,-21600,,
com.google.Chrome,1,1708897735,1708897736,1708897736.2084122,-21600,,
com.apple.Notes,4,1708897731,1708897735,1708897735.229179,-21600,,
com.google.Chrome,4,1708897727,1708897731,1708897731.959382,-21600,,
com.apple.Notes,6,1708897721,1708897727,1708897727.426285,-21600,,
com.google.Chrome,0,1708897721,1708897721,1708897722.0413752,-21600,,
com.apple.Notes,8,1708897713,1708897721,1708897721.443768,-21600,,
com.google.Chrome,6,1708897707,1708897713,1708897713.118669,-21600,,
com.apple.Notes,11,1708897696,1708897707,1708897707.5471191,-21600,,
com.google.Chrome,1,1708897695,1708897696,1708897696.660197,-21600,,
com.apple.Notes,5,1708897690,1708897695,1708897695.734694,-21600,,
com.google.Chrome,1,1708897689,1708897690,1708897690.693316,-21600,,
com.apple.Notes,1,1708897688,1708897689,1708897689.807335,-21600,,
com.google.Chrome,3,1708897685,1708897688,1708897688.5599,-21600,,
com.apple.Notes,11,1708897674,1708897685,1708897685.580638,-21600,,
com.google.Chrome,12,1708897662,1708897674,1708897674.8846068,-21600,,
com.apple.Notes,5,1708897657,1708897662,1708897663.044986,-21600,,
com.google.Chrome,3,1708897654,1708897657,1708897657.324122,-21600,,
com.apple.Notes,7,1708897647,1708897654,1708897654.761917,-21600,,
com.google.Chrome,16,1708897631,1708897647,1708897647.7312288,-21600,,
com.apple.Notes,5,1708897626,1708897631,1708897631.370348,-21600,,
com.google.Chrome,2,1708897624,1708897626,1708897626.789819,-21600,,
com.apple.Notes,11,1708897613,1708897624,1708897624.540657,-21600,,
com.google.Chrome,4,1708897609,1708897613,1708897613.180451,-21600,,
com.apple.Notes,3,1708897606,1708897609,1708897609.92803,-21600,,
com.google.Chrome,17,1708897589,1708897606,1708897606.258325,-21600,,
com.apple.Notes,4,1708897585,1708897589,1708897589.4002619,-21600,,
com.google.Chrome,1,1708897584,1708897585,1708897585.894156,-21600,,
com.apple.Notes,8,1708897576,1708897584,1708897584.571373,-21600,,
com.google.Chrome,6,1708897570,1708897576,1708897576.536388,-21600,,
com.apple.Notes,5,1708897565,1708897570,1708897570.921794,-21600,,
com.google.Chrome,5,1708897560,1708897565,1708897565.732335,-21600,,
com.apple.Notes,7,1708897553,1708897560,1708897560.52523,-21600,,
com.google.Chrome,1,1708897552,1708897553,1708897553.221757,-21600,,
com.apple.Notes,11,1708897541,1708897552,1708897552.414213,-21600,,
com.google.Chrome,13,1708897528,1708897541,1708897541.144723,-21600,,
com.apple.Notes,4,1708897524,1708897528,1708897528.487849,-21600,,
com.google.Chrome,0,1708897524,1708897524,1708897524.74092,-21600,,
com.apple.Notes,4,1708897520,1708897524,1708897524.19284,-21600,,
com.google.Chrome,1,1708897519,1708897520,1708897520.063568,-21600,,
com.apple.Notes,7,1708897512,1708897519,1708897519.258034,-21600,,
com.google.Chrome,32,1708897480,1708897512,1708897512.705205,-21600,,
com.apple.Notes,7,1708897473,1708897480,1708897481.038995,-21600,,
com.google.Chrome,14,1708897459,1708897473,1708897474.049664,-21600,,
com.apple.Notes,19,1708897440,1708897459,1708897459.535108,-21600,,
com.google.Chrome,12,1708897428,1708897440,1708897440.492852,-21600,,
com.apple.Notes,8,1708897420,1708897428,1708897428.428118,-21600,,
com.google.Chrome,1,1708897419,1708897420,1708897420.1309118,-21600,,
com.apple.Notes,1,1708897418,1708897419,1708897419.711257,-21600,,
com.google.Chrome,1,1708897417,1708897418,1708897418.405927,-21600,,
com.apple.Notes,3,1708897414,1708897417,1708897417.9056392,-21600,,
com.google.Chrome,0,1708897414,1708897414,1708897414.9416041,-21600,,
com.apple.Notes,6,1708897408,1708897414,1708897414.082366,-21600,,
com.google.Chrome,4,1708897404,1708897408,1708897408.4425411,-21600,,
com.apple.Notes,4,1708897400,1708897404,1708897404.876986,-21600,,
com.google.Chrome,1,1708897399,1708897400,1708897400.194456,-21600,,
com.apple.Notes,3,1708897396,1708897399,1708897399.750914,-21600,,
com.google.Chrome,1,1708897395,1708897396,1708897396.532722,-21600,,
com.apple.Notes,3,1708897392,1708897395,1708897395.5145888,-21600,,
com.google.Chrome,9,1708897383,1708897392,1708897392.3469,-21600,,
com.apple.Notes,5,1708897378,1708897383,1708897383.517719,-21600,,
com.google.Chrome,4,1708897374,1708897378,1708897378.749856,-21600,,
com.apple.Notes,3,1708897371,1708897374,1708897374.170669,-21600,,
com.google.Chrome,13,1708897358,1708897371,1708897371.908465,-21600,,
com.apple.Notes,23,1708897335,1708897358,1708897358.4026918,-21600,,
com.google.Chrome,8,1708897327,1708897335,1708897335.622992,-21600,,
com.apple.Notes,18,1708897309,1708897327,1708897327.781471,-21600,,
com.google.Chrome,71,1708897238,1708897309,1708897309.68151,-21600,,
com.leomehlig.today,23,1708897215,1708897238,1708897238.5033112,-21600,,
com.google.Chrome,2,1708897213,1708897215,1708897215.721672,-21600,,
com.leomehlig.today,9,1708897204,1708897213,1708897213.0868502,-21600,,
com.google.Chrome,1,1708897203,1708897204,1708897204.455505,-21600,,
com.leomehlig.today,6,1708897197,1708897203,1708897203.899179,-21600,,
com.google.Chrome,483,1708896714,1708897197,1708897197.858495,-21600,,
com.google.Chrome,763,1708895847,1708896610,1708896610.337294,-21600,,
com.google.Chrome,447,1708895373,1708895820,1708895820.536274,-21600,,
com.leomehlig.today,59,1708895314,1708895373,1708895373.706071,-21600,,
com.google.Chrome,5,1708895309,1708895314,1708895314.9617581,-21600,,
com.leomehlig.today,6,1708895303,1708895309,1708895309.07164,-21600,,
com.google.Chrome,142,1708895161,1708895303,1708895303.673121,-21600,,
com.apple.Notes,8,1708895153,1708895161,1708895161.691117,-21600,,
com.google.Chrome,22,1708895131,1708895153,1708895153.191687,-21600,,
com.leomehlig.today,1,1708895130,1708895131,1708895131.544608,-21600,,
com.google.Chrome,226,1708894904,1708895130,1708895130.284635,-21600,,
com.apple.Preview,54,1708894850,1708894904,1708894904.5517058,-21600,,
com.google.Chrome,8,1708894842,1708894850,1708894850.1573029,-21600,,
com.apple.Preview,78,1708894764,1708894842,1708894842.188117,-21600,,
com.google.Chrome,4,1708894760,1708894764,1708894764.2228189,-21600,,
com.apple.Preview,4,1708894756,1708894760,1708894760.1292791,-21600,,
com.google.Chrome,51,1708894705,1708894756,1708894756.600899,-21600,,
com.apple.Preview,267,1708894438,1708894705,1708894705.353623,-21600,,
com.google.Chrome,4,1708894434,1708894438,1708894438.6135468,-21600,,
com.apple.Preview,99,1708894335,1708894434,1708894435.057622,-21600,,
com.leomehlig.today,2,1708894333,1708894335,1708894335.4961119,-21600,,
com.apple.Preview,1,1708894332,1708894333,1708894333.9622731,-21600,,
com.google.Chrome,688,1708893644,1708894332,1708894332.526998,-21600,,
com.apple.Preview,25,1708893619,1708893644,1708893644.684894,-21600,,
com.google.Chrome,17,1708893602,1708893619,1708893619.815384,-21600,,
com.apple.Preview,113,1708893489,1708893602,1708893602.1035671,-21600,,
com.google.Chrome,1053,1708892436,1708893489,1708893489.980443,-21600,,
com.apple.Preview,58,1708892378,1708892436,1708892436.182928,-21600,,
com.google.Chrome,4,1708892374,1708892378,1708892378.776451,-21600,,
com.apple.Preview,6,1708892368,1708892374,1708892374.889731,-21600,,
com.google.Chrome,4,1708892364,1708892368,1708892368.488975,-21600,,
com.apple.Preview,23,1708892341,1708892364,1708892364.699901,-21600,,
com.apple.finder,2,1708892339,1708892341,1708892342.016953,-21600,,
com.google.Chrome,3,1708892336,1708892339,1708892339.88885,-21600,,
com.apple.iCal,79,1708892257,1708892336,1708892336.855575,-21600,,
com.google.Chrome,145,1708892112,1708892257,1708892257.2370539,-21600,,
com.leomehlig.today,32,1708892080,1708892112,1708892112.255877,-21600,,
com.apple.finder,3,1708892077,1708892080,1708892080.469293,-21600,,
com.leomehlig.today,3,1708892074,1708892077,1708892077.573475,-21600,,
com.google.Chrome,1,1708892073,1708892074,1708892075.0818481,-21600,,
com.google.Chrome,26,1708884159,1708884185,1708884185.2198339,-21600,,
com.microsoft.VSCode,168,1708883991,1708884159,1708884159.2119122,-21600,,
com.apple.finder,5,1708883986,1708883991,1708883991.289983,-21600,,
com.microsoft.VSCode,331,1708883655,1708883986,1708883986.985121,-21600,,
com.apple.finder,37,1708883618,1708883655,1708883655.959379,-21600,,
com.apple.iWork.Numbers,1,1708883617,1708883618,1708883618.5194778,-21600,,
com.google.Chrome,279,1708883338,1708883617,1708883617.853029,-21600,,
com.microsoft.VSCode,100,1708883238,1708883338,1708883339.0576038,-21600,,
com.apple.finder,9,1708883229,1708883238,1708883238.469008,-21600,,
com.apple.archiveutility,2,1708883227,1708883229,1708883229.244904,-21600,,
com.apple.finder,44,1708883183,1708883227,1708883227.072774,-21600,,
com.google.Chrome,3,1708883180,1708883183,1708883183.762066,-21600,,
com.google.Chrome,75,1708882788,1708882863,1708882863.565112,-21600,,
com.microsoft.VSCode,215,1708882573,1708882788,1708882788.070823,-21600,,
com.leomehlig.today,178,1708882395,1708882573,1708882574.010344,-21600,,
com.microsoft.VSCode,486,1708881909,1708882395,1708882395.74874,-21600,,
com.apple.finder,6,1708881903,1708881909,1708881909.691173,-21600,,
com.microsoft.VSCode,18,1708881885,1708881903,1708881903.361305,-21600,,
com.apple.finder,1,1708881884,1708881885,1708881885.7402658,-21600,,
com.microsoft.VSCode,27,1708881857,1708881884,1708881884.686438,-21600,,
com.apple.finder,8,1708881849,1708881857,1708881857.200897,-21600,,
com.microsoft.VSCode,9,1708881840,1708881849,1708881849.3577142,-21600,,
com.apple.finder,15,1708881825,1708881840,1708881840.5114908,-21600,,
com.microsoft.VSCode,16,1708881809,1708881825,1708881825.404038,-21600,,
com.apple.finder,1,1708881808,1708881809,1708881809.600943,-21600,,
com.microsoft.VSCode,46,1708881762,1708881808,1708881808.188466,-21600,,
com.apple.finder,1,1708881761,1708881762,1708881762.329807,-21600,,
com.microsoft.VSCode,4,1708881757,1708881761,1708881761.3323689,-21600,,
com.apple.finder,1,1708881756,1708881757,1708881757.3691769,-21600,,
com.microsoft.VSCode,12,1708881744,1708881756,1708881756.4806871,-21600,,
com.apple.finder,1,1708881743,1708881744,1708881744.6368709,-21600,,
com.microsoft.VSCode,6,1708881737,1708881743,1708881743.339406,-21600,,
com.apple.finder,1,1708881736,1708881737,1708881737.6939979,-21600,,
com.microsoft.VSCode,28,1708881708,1708881736,1708881736.7538838,-21600,,
com.apple.finder,17,1708881691,1708881708,1708881708.875459,-21600,,
com.microsoft.VSCode,52,1708881639,1708881691,1708881691.083345,-21600,,
com.apple.finder,11,1708881628,1708881639,1708881639.602833,-21600,,
com.microsoft.VSCode,2,1708881626,1708881628,1708881628.152852,-21600,,
com.apple.finder,23,1708881603,1708881626,1708881627.035511,-21600,,
com.microsoft.VSCode,21,1708881582,1708881603,1708881603.130796,-21600,,
com.apple.finder,10,1708881572,1708881582,1708881582.749182,-21600,,
com.microsoft.VSCode,24,1708881548,1708881572,1708881572.363357,-21600,,
com.apple.finder,57,1708881491,1708881548,1708881548.775459,-21600,,
com.microsoft.VSCode,7,1708881484,1708881491,1708881491.335555,-21600,,
com.apple.finder,4,1708881480,1708881484,1708881484.5435262,-21600,,
com.microsoft.VSCode,615,1708880865,1708881480,1708881480.408453,-21600,,
com.microsoft.VSCode,193,1708878595,1708878788,1708878789.035845,-21600,,
com.apple.Dictionary,1,1708878594,1708878595,1708878595.980914,-21600,,
com.microsoft.VSCode,683,1708877911,1708878594,1708878594.333745,-21600,,
com.thestorygraph.thestorygraph,19,1708840318,1708840337,1708840337.971525,-21600,EB445137-D7F5-57EC-87DA-1DB460D64046,"iPhone13,2"
com.apple.camera,7,1708837841,1708837848,1708837848.324173,-21600,EB445137-D7F5-57EC-87DA-1DB460D64046,"iPhone13,2"
com.apple.MobileSMS,4,1708837364,1708837368,1708837368.6609569,-21600,EB445137-D7F5-57EC-87DA-1DB460D64046,"iPhone13,2"
com.toyopagroup.picaboo,41,1708837322,1708837363,1708837363.424139,-21600,EB445137-D7F5-57EC-87DA-1DB460D64046,"iPhone13,2"
com.apple.Health,43,1708837274,1708837317,1708837317.551419,-21600,EB445137-D7F5-57EC-87DA-1DB460D64046,"iPhone13,2"
com.apple.journal,588,1708836682,1708837270,1708837270.653398,-21600,EB445137-D7F5-57EC-87DA-1DB460D64046,"iPhone13,2"
edu.illinois.rokwire.ios,3,1708835452,1708835455,1708835455.772567,-21600,EB445137-D7F5-57EC-87DA-1DB460D64046,"iPhone13,2"
edu.illinois.rokwire.ios,4,1708835342,1708835346,1708835346.479213,-21600,EB445137-D7F5-57EC-87DA-1DB460D64046,"iPhone13,2"
edu.illinois.rokwire.ios,35,1708835278,1708835313,1708835313.672241,-21600,EB445137-D7F5-57EC-87DA-1DB460D64046,"iPhone13,2"
com.burbn.instagram,9,1708835268,1708835277,1708835277.730602,-21600,EB445137-D7F5-57EC-87DA-1DB460D64046,"iPhone13,2"
com.burbn.instagram,6,1708835251,1708835257,1708835257.891825,-21600,EB445137-D7F5-57EC-87DA-1DB460D64046,"iPhone13,2"
com.burbn.instagram,5,1708835162,1708835167,1708835167.298598,-21600,EB445137-D7F5-57EC-87DA-1DB460D64046,"iPhone13,2"
com.burbn.instagram,3,1708835068,1708835071,1708835071.017277,-21600,EB445137-D7F5-57EC-87DA-1DB460D64046,"iPhone13,2"
com.burbn.instagram,14,1708834563,1708834577,1708834577.8801289,-21600,EB445137-D7F5-57EC-87DA-1DB460D64046,"iPhone13,2"
com.burbn.instagram,95,1708833926,1708834021,1708834021.6960459,-21600,EB445137-D7F5-57EC-87DA-1DB460D64046,"iPhone13,2"
com.apple.Health,4,1708833866,1708833870,1708833870.599317,-21600,EB445137-D7F5-57EC-87DA-1DB460D64046,"iPhone13,2"
com.apple.Health,10,1708833763,1708833773,1708833773.0304809,-21600,EB445137-D7F5-57EC-87DA-1DB460D64046,"iPhone13,2"
com.apple.Health,7,1708833752,1708833759,1708833759.67796,-21600,EB445137-D7F5-57EC-87DA-1DB460D64046,"iPhone13,2"
com.apple.Health,10,1708833687,1708833697,1708833697.094671,-21600,EB445137-D7F5-57EC-87DA-1DB460D64046,"iPhone13,2"
com.apple.Health,6,1708833671,1708833677,1708833677.113501,-21600,EB445137-D7F5-57EC-87DA-1DB460D64046,"iPhone13,2"
com.apple.Health,3,1708833599,1708833602,1708833602.5657558,-21600,EB445137-D7F5-57EC-87DA-1DB460D64046,"iPhone13,2"
com.apple.Health,1,1708833598,1708833599,1708833599.0626268,-21600,EB445137-D7F5-57EC-87DA-1DB460D64046,"iPhone13,2"
com.microsoft.VSCode,191,1708833400,1708833591,1708833592.0037642,-21600,,
com.google.Chrome,6,1708833394,1708833400,1708833400.853397,-21600,,
com.microsoft.VSCode,5,1708833389,1708833394,1708833394.406337,-21600,,
com.google.Chrome,40,1708833349,1708833389,1708833390.06352,-21600,,
com.microsoft.VSCode,181,1708833168,1708833349,1708833349.8018079,-21600,,
com.google.Chrome,5,1708833163,1708833168,1708833168.2297258,-21600,,
com.microsoft.VSCode,20,1708833143,1708833163,1708833163.50835,-21600,,
com.google.Chrome,10,1708833133,1708833143,1708833143.121739,-21600,,
com.microsoft.VSCode,2,1708833131,1708833133,1708833133.775769,-21600,,
com.google.Chrome,2,1708833129,1708833131,1708833131.446986,-21600,,
com.microsoft.VSCode,4,1708833125,1708833129,1708833129.81197,-21600,,
com.google.Chrome,2,1708833123,1708833125,1708833125.952952,-21600,,
com.microsoft.VSCode,4,1708833119,1708833123,1708833123.939848,-21600,,
com.google.Chrome,2,1708833117,1708833119,1708833119.1179318,-21600,,
com.microsoft.VSCode,6,1708833111,1708833117,1708833117.63148,-21600,,
com.google.Chrome,49,1708833062,1708833111,1708833111.5393991,-21600,,
com.microsoft.VSCode,1,1708833061,1708833062,1708833062.613102,-21600,,
com.google.Chrome,5,1708833056,1708833061,1708833061.449472,-21600,,
com.apple.Health,116,1708832793,1708832909,1708832909.33398,-21600,EB445137-D7F5-57EC-87DA-1DB460D64046,"iPhone13,2"
com.apple.Health,242,1708832423,1708832665,1708832665.08047,-21600,EB445137-D7F5-57EC-87DA-1DB460D64046,"iPhone13,2"
com.toyopagroup.picaboo,2,1708832421,1708832423,1708832423.374316,-21600,EB445137-D7F5-57EC-87DA-1DB460D64046,"iPhone13,2"
com.apple.Health,2,1708832419,1708832421,1708832421.856508,-21600,EB445137-D7F5-57EC-87DA-1DB460D64046,"iPhone13,2"
com.apple.Health,97,1708832117,1708832214,1708832214.212018,-21600,EB445137-D7F5-57EC-87DA-1DB460D64046,"iPhone13,2"
com.facebook.Facebook,6,1708831518,1708831524,1708831524.578049,-21600,EB445137-D7F5-57EC-87DA-1DB460D64046,"iPhone13,2"
com.microsoft.Office.Outlook,6,1708831512,1708831518,1708831518.142592,-21600,EB445137-D7F5-57EC-87DA-1DB460D64046,"iPhone13,2"
com.apple.Health,6,1708831506,1708831512,1708831512.873711,-21600,EB445137-D7F5-57EC-87DA-1DB460D64046,"iPhone13,2"
com.apple.Health,10,1708831412,1708831422,1708831422.349074,-21600,EB445137-D7F5-57EC-87DA-1DB460D64046,"iPhone13,2"
com.apple.Health,132,1708831270,1708831402,1708831402.9758449,-21600,EB445137-D7F5-57EC-87DA-1DB460D64046,"iPhone13,2"
com.apple.Health,177,1708830598,1708830775,1708830775.401967,-21600,EB445137-D7F5-57EC-87DA-1DB460D64046,"iPhone13,2"
com.microsoft.VSCode,2664,1708830392,1708833056,1708833056.570925,-21600,,
com.apple.Health,58,1708830260,1708830318,1708830318.610451,-21600,EB445137-D7F5-57EC-87DA-1DB460D64046,"iPhone13,2"
com.apple.Health,7,1708830213,1708830220,1708830220.583242,-21600,EB445137-D7F5-57EC-87DA-1DB460D64046,"iPhone13,2"
com.apple.Health,68,1708829937,1708830005,1708830005.787092,-21600,EB445137-D7F5-57EC-87DA-1DB460D64046,"iPhone13,2"
com.apple.Health,170,1708829765,1708829935,1708829935.90806,-21600,EB445137-D7F5-57EC-87DA-1DB460D64046,"iPhone13,2"
com.apple.Health,140,1708829578,1708829718,1708829718.656739,-21600,EB445137-D7F5-57EC-87DA-1DB460D64046,"iPhone13,2"
com.apple.Health,6,1708828831,1708828837,1708828837.7887192,-21600,EB445137-D7F5-57EC-87DA-1DB460D64046,"iPhone13,2"
com.apple.Health,15,1708828360,1708828375,1708828375.4304152,-21600,EB445137-D7F5-57EC-87DA-1DB460D64046,"iPhone13,2"
com.toyopagroup.picaboo,3,1708828357,1708828360,1708828360.724822,-21600,EB445137-D7F5-57EC-87DA-1DB460D64046,"iPhone13,2"
com.toyopagroup.picaboo,85,1708827175,1708827260,1708827260.597064,-21600,EB445137-D7F5-57EC-87DA-1DB460D64046,"iPhone13,2"
com.apple.Health,5,1708827170,1708827175,1708827175.545432,-21600,EB445137-D7F5-57EC-87DA-1DB460D64046,"iPhone13,2"
com.apple.Health,132,1708826733,1708826865,1708826865.75172,-21600,EB445137-D7F5-57EC-87DA-1DB460D64046,"iPhone13,2"
edu.illinois.rokwire.ios,5,1708826728,1708826733,1708826733.5463061,-21600,EB445137-D7F5-57EC-87DA-1DB460D64046,"iPhone13,2"
com.microsoft.VSCode,3808,1708826386,1708830194,1708830195.030806,-21600,,
edu.illinois.rokwire.ios,11,1708824943,1708824954,1708824954.287468,-21600,EB445137-D7F5-57EC-87DA-1DB460D64046,"iPhone13,2"
edu.illinois.rokwire.ios,3,1708824939,1708824942,1708824942.173806,-21600,EB445137-D7F5-57EC-87DA-1DB460D64046,"iPhone13,2"
edu.illinois.rokwire.ios,8,1708824285,1708824293,1708824293.563333,-21600,EB445137-D7F5-57EC-87DA-1DB460D64046,"iPhone13,2"
edu.illinois.rokwire.ios,1,1708824283,1708824284,1708824284.83749,-21600,EB445137-D7F5-57EC-87DA-1DB460D64046,"iPhone13,2"
edu.illinois.rokwire.ios,22,1708824220,1708824242,1708824242.160459,-21600,EB445137-D7F5-57EC-87DA-1DB460D64046,"iPhone13,2"
com.apple.MobileSMS,6,1708824213,1708824219,1708824219.770668,-21600,EB445137-D7F5-57EC-87DA-1DB460D64046,"iPhone13,2"
com.apple.MobileSMS,40,1708822999,1708823039,1708823039.759495,-21600,EB445137-D7F5-57EC-87DA-1DB460D64046,"iPhone13,2"
com.apple.MobileSMS,13,1708822146,1708822159,1708822159.714683,-21600,EB445137-D7F5-57EC-87DA-1DB460D64046,"iPhone13,2"
edu.illinois.rokwire.ios,2,1708822144,1708822146,1708822146.3325582,-21600,EB445137-D7F5-57EC-87DA-1DB460D64046,"iPhone13,2"
edu.illinois.rokwire.ios,34,1708821946,1708821980,1708821980.232703,-21600,EB445137-D7F5-57EC-87DA-1DB460D64046,"iPhone13,2"
com.apple.MobileSMS,4,1708821940,1708821944,1708821944.657038,-21600,EB445137-D7F5-57EC-87DA-1DB460D64046,"iPhone13,2"
com.microsoft.VSCode,4,1708821761,1708821765,1708821765.534492,-21600,,
com.apple.MobileSMS,2,1708821751,1708821753,1708821753.820825,-21600,EB445137-D7F5-57EC-87DA-1DB460D64046,"iPhone13,2"
com.apple.MobileSMS,201,1708821428,1708821629,1708821629.358,-21600,EB445137-D7F5-57EC-87DA-1DB460D64046,"iPhone13,2"
com.apple.MobileSMS,17,1708821406,1708821423,1708821423.6097531,-21600,EB445137-D7F5-57EC-87DA-1DB460D64046,"iPhone13,2"
com.apple.Health,2,1708821403,1708821405,1708821406.0518708,-21600,EB445137-D7F5-57EC-87DA-1DB460D64046,"iPhone13,2"
com.apple.Health,86,1708821316,1708821402,1708821402.2546968,-21600,EB445137-D7F5-57EC-87DA-1DB460D64046,"iPhone13,2"
edu.illinois.rokwire.ios,4,1708821309,1708821313,1708821313.372715,-21600,EB445137-D7F5-57EC-87DA-1DB460D64046,"iPhone13,2"
edu.illinois.rokwire.ios,3,1708820695,1708820698,1708820698.075706,-21600,EB445137-D7F5-57EC-87DA-1DB460D64046,"iPhone13,2"
com.hammerandchisel.discord,33,1708820654,1708820687,1708820687.562865,-21600,EB445137-D7F5-57EC-87DA-1DB460D64046,"iPhone13,2"
edu.illinois.rokwire.ios,23,1708820628,1708820651,1708820651.807162,-21600,EB445137-D7F5-57EC-87DA-1DB460D64046,"iPhone13,2"
com.microsoft.Office.Outlook,2,1708820626,1708820628,1708820628.142854,-21600,EB445137-D7F5-57EC-87DA-1DB460D64046,"iPhone13,2"
com.microsoft.VSCode,1746,1708819947,1708821693,1708821693.634728,-21600,,
com.google.Chrome,41,1708819906,1708819947,1708819947.7768378,-21600,,
com.microsoft.VSCode,505,1708819401,1708819906,1708819906.5015469,-21600,,
com.google.Chrome,13,1708819388,1708819401,1708819401.978452,-21600,,
com.microsoft.VSCode,786,1708818602,1708819388,1708819388.309442,-21600,,
com.google.ios.youtube,868,1708817541,1708818409,1708818409.4495769,-21600,EB445137-D7F5-57EC-87DA-1DB460D64046,"iPhone13,2"
com.goodreads.Goodreads,36,1708817463,1708817499,1708817499.864654,-21600,EB445137-D7F5-57EC-87DA-1DB460D64046,"iPhone13,2"
com.thestorygraph.thestorygraph,18,1708817445,1708817463,1708817463.201657,-21600,EB445137-D7F5-57EC-87DA-1DB460D64046,"iPhone13,2"
com.thestorygraph.thestorygraph,69,1708817373,1708817442,1708817442.802308,-21600,EB445137-D7F5-57EC-87DA-1DB460D64046,"iPhone13,2"
com.toyopagroup.picaboo,15,1708815019,1708815034,1708815034.239104,-21600,EB445137-D7F5-57EC-87DA-1DB460D64046,"iPhone13,2"
com.toyopagroup.picaboo,2,1708813968,1708813970,1708813970.516211,-21600,EB445137-D7F5-57EC-87DA-1DB460D64046,"iPhone13,2"
com.toyopagroup.picaboo,4,1708813198,1708813202,1708813202.9708462,-21600,EB445137-D7F5-57EC-87DA-1DB460D64046,"iPhone13,2"
com.toyopagroup.picaboo,4,1708813035,1708813039,1708813039.8093061,-21600,EB445137-D7F5-57EC-87DA-1DB460D64046,"iPhone13,2"
com.toyopagroup.picaboo,3,1708812973,1708812976,1708812976.483259,-21600,EB445137-D7F5-57EC-87DA-1DB460D64046,"iPhone13,2"
com.toyopagroup.picaboo,7,1708812964,1708812971,1708812971.202873,-21600,EB445137-D7F5-57EC-87DA-1DB460D64046,"iPhone13,2"
com.apple.MobileSMS,3,1708812960,1708812963,1708812963.036172,-21600,EB445137-D7F5-57EC-87DA-1DB460D64046,"iPhone13,2"
com.toyopagroup.picaboo,2,1708812949,1708812951,1708812951.5221062,-21600,EB445137-D7F5-57EC-87DA-1DB460D64046,"iPhone13,2"
com.toyopagroup.picaboo,1,1708812939,1708812940,1708812940.6370401,-21600,EB445137-D7F5-57EC-87DA-1DB460D64046,"iPhone13,2"
com.toyopagroup.picaboo,18,1708812920,1708812938,1708812938.546307,-21600,EB445137-D7F5-57EC-87DA-1DB460D64046,"iPhone13,2"
com.toyopagroup.picaboo,2,1708812914,1708812916,1708812916.556531,-21600,EB445137-D7F5-57EC-87DA-1DB460D64046,"iPhone13,2"
com.apple.MobileSMS,3,1708812911,1708812914,1708812914.129232,-21600,EB445137-D7F5-57EC-87DA-1DB460D64046,"iPhone13,2"
com.apple.MobileSMS,61,1708812524,1708812585,1708812585.5478249,-21600,EB445137-D7F5-57EC-87DA-1DB460D64046,"iPhone13,2"
com.toyopagroup.picaboo,3,1708812520,1708812523,1708812523.0315552,-21600,EB445137-D7F5-57EC-87DA-1DB460D64046,"iPhone13,2"
com.apple.MobileSMS,8,1708812512,1708812520,1708812520.676199,-21600,EB445137-D7F5-57EC-87DA-1DB460D64046,"iPhone13,2"
com.apple.Fitness,32,1708812480,1708812512,1708812512.6358109,-21600,EB445137-D7F5-57EC-87DA-1DB460D64046,"iPhone13,2"
com.microsoft.VSCode,4,1708811974,1708811978,1708811978.366198,-21600,,
com.microsoft.VSCode,120,1708811852,1708811972,1708811972.9748511,-21600,,
com.google.Chrome,56,1708811796,1708811852,1708811852.253814,-21600,,
com.microsoft.VSCode,28,1708811768,1708811796,1708811796.426064,-21600,,
com.google.Chrome,10,1708811758,1708811768,1708811768.544776,-21600,,
com.microsoft.VSCode,46,1708811712,1708811758,1708811759.043186,-21600,,
com.google.Chrome,11,1708811701,1708811712,1708811713.0249639,-21600,,
com.microsoft.VSCode,10,1708811691,1708811701,1708811701.70468,-21600,,
com.google.Chrome,7,1708811684,1708811691,1708811691.07553,-21600,,
com.microsoft.VSCode,18,1708811666,1708811684,1708811684.596209,-21600,,
com.google.Chrome,1,1708811665,1708811666,1708811666.905837,-21600,,
com.microsoft.VSCode,5,1708811660,1708811665,1708811665.518362,-21600,,
com.google.Chrome,9,1708811651,1708811660,1708811660.436543,-21600,,
com.microsoft.VSCode,15,1708811636,1708811651,1708811651.373685,-21600,,
com.google.Chrome,4,1708811632,1708811636,1708811636.317703,-21600,,
com.microsoft.VSCode,7,1708811625,1708811632,1708811632.6031651,-21600,,
com.google.Chrome,1,1708811624,1708811625,1708811625.189952,-21600,,
com.microsoft.VSCode,11,1708811613,1708811624,1708811624.495216,-21600,,
com.google.Chrome,1,1708811612,1708811613,1708811613.473069,-21600,,
com.microsoft.VSCode,2,1708811610,1708811612,1708811612.554281,-21600,,
com.google.Chrome,1,1708811609,1708811610,1708811610.821496,-21600,,
com.microsoft.VSCode,7,1708811602,1708811609,1708811609.8064241,-21600,,
com.google.Chrome,1,1708811601,1708811602,1708811602.906896,-21600,,
com.microsoft.VSCode,0,1708811601,1708811601,1708811601.67453,-21600,,
com.google.Chrome,1,1708811600,1708811601,1708811601.465716,-21600,,
com.microsoft.VSCode,3,1708811597,1708811600,1708811600.114579,-21600,,
com.google.Chrome,36,1708811561,1708811597,1708811597.674872,-21600,,
com.microsoft.VSCode,12,1708811549,1708811561,1708811561.996109,-21600,,
com.google.Chrome,11,1708811538,1708811549,1708811549.996325,-21600,,
com.microsoft.VSCode,10,1708811528,1708811538,1708811539.0272179,-21600,,
com.google.Chrome,31,1708811497,1708811528,1708811528.432949,-21600,,
com.microsoft.VSCode,1060,1708810437,1708811497,1708811497.456945,-21600,,
com.apple.Fitness,130,1708810225,1708810355,1708810355.2664351,-21600,EB445137-D7F5-57EC-87DA-1DB460D64046,"iPhone13,2"
com.apple.Fitness,84,1708810123,1708810207,1708810207.357328,-21600,EB445137-D7F5-57EC-87DA-1DB460D64046,"iPhone13,2"
com.hammerandchisel.discord,35,1708810042,1708810077,1708810077.364111,-21600,EB445137-D7F5-57EC-87DA-1DB460D64046,"iPhone13,2"
com.apple.Health,3,1708810024,1708810027,1708810028.094732,-21600,EB445137-D7F5-57EC-87DA-1DB460D64046,"iPhone13,2"
com.microsoft.VSCode,1252,1708809030,1708810282,1708810282.76,-21600,,
com.google.Chrome,12,1708809018,1708809030,1708809030.133821,-21600,,
com.microsoft.VSCode,6,1708809012,1708809018,1708809018.4179978,-21600,,
com.google.Chrome,25,1708808987,1708809012,1708809012.9052382,-21600,,
com.microsoft.VSCode,272,1708808715,1708808987,1708808987.302871,-21600,,
com.google.Chrome,96,1708808619,1708808715,1708808715.210978,-21600,,
com.microsoft.VSCode,403,1708808216,1708808619,1708808619.533936,-21600,,
com.google.Chrome,67,1708808149,1708808216,1708808216.465366,-21600,,
com.microsoft.VSCode,23,1708808126,1708808149,1708808149.340966,-21600,,
com.google.Chrome,75,1708808051,1708808126,1708808126.880941,-21600,,
com.microsoft.VSCode,17,1708808034,1708808051,1708808052.117245,-21600,,
com.apple.finder,11,1708808023,1708808034,1708808034.795038,-21600,,
com.microsoft.VSCode,112,1708807911,1708808023,1708808024.105736,-21600,,
com.apple.finder,7,1708807904,1708807911,1708807911.572598,-21600,,
com.microsoft.VSCode,460,1708807444,1708807904,1708807904.7377071,-21600,,
com.apple.finder,4,1708807440,1708807444,1708807444.738646,-21600,,
com.apple.iWork.Numbers,6,1708807434,1708807440,1708807440.738992,-21600,,
com.apple.finder,8,1708807426,1708807434,1708807434.205502,-21600,,
com.microsoft.VSCode,24,1708807402,1708807426,1708807426.496348,-21600,,
com.apple.finder,3,1708807399,1708807402,1708807402.553395,-21600,,
com.microsoft.VSCode,27,1708807372,1708807399,1708807399.242177,-21600,,
com.apple.finder,3,1708807369,1708807372,1708807372.1037621,-21600,,
com.microsoft.VSCode,23,1708807346,1708807369,1708807369.516848,-21600,,
com.apple.finder,9,1708807337,1708807346,1708807346.378608,-21600,,
com.microsoft.VSCode,1,1708807336,1708807337,1708807337.8904839,-21600,,
com.apple.finder,10,1708807326,1708807336,1708807337.015983,-21600,,
com.microsoft.VSCode,21,1708807305,1708807326,1708807326.170752,-21600,,
com.apple.finder,3,1708807302,1708807305,1708807305.401787,-21600,,
com.microsoft.VSCode,100,1708807202,1708807302,1708807302.668913,-21600,,
com.apple.finder,1,1708807201,1708807202,1708807202.315722,-21600,,
com.microsoft.VSCode,1,1708807200,1708807201,1708807201.252672,-21600,,
com.apple.finder,15,1708807185,1708807200,1708807200.619042,-21600,,
com.microsoft.VSCode,1,1708807184,1708807185,1708807185.1866322,-21600,,
com.apple.finder,0,1708807184,1708807184,1708807184.7890139,-21600,,
com.microsoft.VSCode,4,1708807180,1708807184,1708807184.554412,-21600,,
com.apple.finder,2,1708807178,1708807180,1708807180.259787,-21600,,
com.microsoft.VSCode,2,1708807176,1708807178,1708807178.606557,-21600,,
com.apple.finder,9,1708807167,1708807176,1708807176.100957,-21600,,
com.microsoft.VSCode,598,1708806569,1708807167,1708807167.333348,-21600,,
com.apple.finder,4,1708806565,1708806569,1708806569.401161,-21600,,
com.microsoft.VSCode,77,1708806488,1708806565,1708806565.676929,-21600,,
com.apple.finder,2,1708806486,1708806488,1708806488.94993,-21600,,
com.microsoft.VSCode,14,1708806472,1708806486,1708806486.456609,-21600,,
com.apple.finder,62,1708806410,1708806472,1708806473.081145,-21600,,
com.microsoft.VSCode,31,1708806379,1708806410,1708806410.203758,-21600,,
com.google.Chrome,6,1708806373,1708806379,1708806380.028448,-21600,,
com.leomehlig.today,136,1708806237,1708806373,1708806373.226355,-21600,,
com.google.Chrome,1579,1708804658,1708806237,1708806237.157493,-21600,,
com.google.Chrome,337,1708804319,1708804656,1708804656.6278071,-21600,,
com.google.Chrome,648,1708803670,1708804318,1708804318.0296469,-21600,,
com.leomehlig.today,1,1708803669,1708803670,1708803670.754991,-21600,,
com.google.Chrome,2,1708803667,1708803669,1708803669.637619,-21600,,
com.leomehlig.today,11,1708803656,1708803667,1708803667.603684,-21600,,
com.google.Chrome,686,1708802970,1708803656,1708803656.193016,-21600,,
com.leomehlig.today,25,1708802945,1708802970,1708802970.330083,-21600,,
com.microsoft.VSCode,831,1708802114,1708802945,1708802945.198117,-21600,,
com.google.Chrome,109,1708802005,1708802114,1708802114.40592,-21600,,
com.google.Chrome,340,1708801207,1708801547,1708801547.877135,-21600,,
com.microsoft.VSCode,1397,1708799810,1708801207,1708801207.915873,-21600,,
com.google.Chrome,79,1708799731,1708799810,1708799810.4408631,-21600,,
com.apple.finder,28,1708799703,1708799731,1708799731.330306,-21600,,
com.google.Chrome,65,1708799638,1708799703,1708799703.8445039,-21600,,
com.apple.finder,21,1708799617,1708799638,1708799638.875061,-21600,,
com.google.Chrome,307,1708799310,1708799617,1708799617.432395,-21600,,
com.apple.finder,37,1708799273,1708799310,1708799310.2678661,-21600,,
com.google.Chrome,57,1708799216,1708799273,1708799273.399471,-21600,,
com.apple.finder,12,1708799204,1708799216,1708799216.064633,-21600,,
com.google.Chrome,39,1708799165,1708799204,1708799205.06523,-21600,,
com.apple.finder,19,1708799146,1708799165,1708799165.699085,-21600,,
com.google.Chrome,56,1708799090,1708799146,1708799146.993233,-21600,,
com.apple.finder,35,1708799055,1708799090,1708799090.220027,-21600,,
com.google.Chrome,5,1708799050,1708799055,1708799056.0187922,-21600,,
com.apple.finder,28,1708799022,1708799050,1708799050.877042,-21600,,
com.google.Chrome,67,1708798955,1708799022,1708799022.51037,-21600,,
com.leomehlig.today,27,1708798928,1708798955,1708798955.38735,-21600,,
com.google.Chrome,17,1708798911,1708798928,1708798928.186806,-21600,,
com.leomehlig.today,83,1708798828,1708798911,1708798911.673573,-21600,,
com.google.Chrome,8,1708798820,1708798828,1708798828.188658,-21600,,
com.google.Chrome,300,1708752004,1708752304,1708752304.3705192,-21600,,
com.leomehlig.today,8,1708751996,1708752004,1708752004.226527,-21600,,
com.microsoft.VSCode,146,1708751850,1708751996,1708751996.134901,-21600,,
com.google.Chrome,2,1708751848,1708751850,1708751850.504067,-21600,,
com.microsoft.VSCode,1,1708751847,1708751848,1708751848.7122478,-21600,,
com.google.Chrome,33,1708751814,1708751847,1708751847.044097,-21600,,
com.microsoft.VSCode,10,1708751804,1708751814,1708751814.3873959,-21600,,
com.apple.finder,10,1708751794,1708751804,1708751804.349879,-21600,,
com.microsoft.VSCode,8,1708751786,1708751794,1708751794.7036319,-21600,,
com.google.Chrome,8,1708751778,1708751786,1708751786.295731,-21600,,
com.microsoft.VSCode,11,1708751767,1708751778,1708751778.595642,-21600,,
com.google.Chrome,3,1708751764,1708751767,1708751767.26279,-21600,,
com.microsoft.VSCode,2,1708751762,1708751764,1708751764.886395,-21600,,
com.google.Chrome,2,1708751760,1708751762,1708751762.075861,-21600,,
com.microsoft.VSCode,9,1708751751,1708751760,1708751760.6196,-21600,,
com.google.Chrome,10,1708751741,1708751751,1708751751.223119,-21600,,
com.microsoft.VSCode,155,1708751586,1708751741,1708751742.0425391,-21600,,
com.microsoft.VSCode,1374,1708728562,1708729936,1708729937.160729,-21600,,
com.google.Chrome,15,1708728547,1708728562,1708728562.429868,-21600,,
com.microsoft.VSCode,25,1708728522,1708728547,1708728547.389738,-21600,,
com.google.Chrome,10,1708728512,1708728522,1708728522.4571772,-21600,,
com.microsoft.VSCode,9,1708728503,1708728512,1708728512.1208038,-21600,,
com.apple.finder,4,1708728499,1708728503,1708728503.349987,-21600,,
com.microsoft.VSCode,7,1708728492,1708728499,1708728499.536495,-21600,,
com.google.Chrome,7,1708728485,1708728492,1708728492.081917,-21600,,
com.microsoft.VSCode,13,1708728472,1708728485,1708728485.6301842,-21600,,
com.google.Chrome,209,1708728263,1708728472,1708728472.47077,-21600,,
com.microsoft.VSCode,62,1708728201,1708728263,1708728263.4707189,-21600,,
com.apple.finder,8,1708728193,1708728201,1708728201.590819,-21600,,
com.microsoft.VSCode,42,1708728151,1708728193,1708728193.6586962,-21600,,
com.google.Chrome,170,1708727981,1708728151,1708728151.547106,-21600,,
com.apple.MobileSMS,6,1708727975,1708727981,1708727981.149386,-21600,,
com.apple.MobileSMS,112,1708724017,1708724129,1708724129.497474,-21600,,
com.google.Chrome,107,1708723910,1708724017,1708724017.1036239,-21600,,
com.apple.MobileSMS,3,1708723907,1708723910,1708723910.18686,-21600,,
com.google.Chrome,1,1708723906,1708723907,1708723907.0641398,-21600,,
com.apple.MobileSMS,11,1708723895,1708723906,1708723906.632873,-21600,,
com.google.Chrome,8,1708723887,1708723895,1708723895.377456,-21600,,
com.google.Chrome,158,1708723687,1708723845,1708723845.646789,-21600,,
com.apple.MobileSMS,132,1708723555,1708723687,1708723687.43209,-21600,,
com.google.Chrome,14,1708723541,1708723555,1708723555.399003,-21600,,
com.apple.MobileSMS,16,1708723525,1708723541,1708723541.463711,-21600,,
com.google.Chrome,0,1708723525,1708723525,1708723525.8126578,-21600,,
com.apple.MobileSMS,5,1708723520,1708723525,1708723525.082851,-21600,,
com.google.Chrome,1,1708723519,1708723520,1708723520.5037,-21600,,
com.apple.MobileSMS,6,1708723513,1708723519,1708723519.234359,-21600,,
com.google.Chrome,17,1708723496,1708723513,1708723513.231732,-21600,,
com.apple.MobileSMS,4,1708723492,1708723496,1708723496.7974281,-21600,,
com.google.Chrome,14,1708723478,1708723492,1708723492.870059,-21600,,
com.apple.MobileSMS,1,1708723477,1708723478,1708723479.619437,-21600,,
com.leomehlig.today,3,1708723474,1708723477,1708723477.697904,-21600,,
com.toyopagroup.picaboo,75,1708720842,1708720917,1708720917.6452332,-21600,EB445137-D7F5-57EC-87DA-1DB460D64046,"iPhone13,2"
com.leomehlig.today,101,1708720818,1708720919,1708720919.493315,-21600,,
com.apple.finder,15,1708720803,1708720818,1708720818.4337049,-21600,,
com.leomehlig.today,2,1708720801,1708720803,1708720803.638165,-21600,,
com.microsoft.VSCode,6,1708720795,1708720801,1708720801.957252,-21600,,
com.google.Chrome,180,1708720615,1708720795,1708720796.035059,-21600,,
com.microsoft.VSCode,4,1708720611,1708720615,1708720615.143931,-21600,,
com.google.Chrome,7,1708720604,1708720611,1708720611.859787,-21600,,
com.microsoft.VSCode,3,1708720601,1708720604,1708720604.4471412,-21600,,
com.google.Chrome,3,1708720598,1708720601,1708720601.850532,-21600,,
com.microsoft.VSCode,18,1708720580,1708720598,1708720598.1936831,-21600,,
com.google.Chrome,5,1708720575,1708720580,1708720580.5389829,-21600,,
com.microsoft.VSCode,25,1708720550,1708720575,1708720575.07858,-21600,,
com.google.Chrome,15,1708720535,1708720550,1708720550.560729,-21600,,
com.microsoft.VSCode,0,1708720535,1708720535,1708720535.992516,-21600,,
com.google.Chrome,18,1708720517,1708720535,1708720535.510838,-21600,,
com.microsoft.VSCode,2,1708720515,1708720517,1708720517.6173449,-21600,,
com.google.Chrome,5,1708720510,1708720515,1708720515.759282,-21600,,
com.microsoft.VSCode,6,1708720504,1708720510,1708720510.701792,-21600,,
com.google.Chrome,15,1708720489,1708720504,1708720504.348353,-21600,,
com.microsoft.VSCode,38,1708720451,1708720489,1708720489.120852,-21600,,
com.google.Chrome,14,1708720437,1708720451,1708720451.308109,-21600,,
com.microsoft.VSCode,2,1708720435,1708720437,1708720437.706264,-21600,,
com.google.Chrome,13,1708720422,1708720435,1708720435.9345741,-21600,,
com.microsoft.VSCode,0,1708720422,1708720422,1708720422.885298,-21600,,
com.google.Chrome,68,1708720354,1708720422,1708720422.482755,-21600,,
com.microsoft.VSCode,20,1708720334,1708720354,1708720354.2208328,-21600,,
com.google.Chrome,76,1708720258,1708720334,1708720334.461841,-21600,,
com.microsoft.VSCode,5,1708720253,1708720258,1708720258.1807451,-21600,,
com.google.Chrome,148,1708720105,1708720253,1708720254.059576,-21600,,
com.microsoft.VSCode,9,1708720096,1708720105,1708720105.9655519,-21600,,
com.google.Chrome,32,1708720064,1708720096,1708720096.194361,-21600,,
com.microsoft.VSCode,2,1708720062,1708720064,1708720064.113003,-21600,,
com.google.Chrome,5,1708720057,1708720062,1708720062.489151,-21600,,
com.microsoft.VSCode,2,1708720055,1708720057,1708720057.076377,-21600,,
com.google.Chrome,3,1708720052,1708720055,1708720055.476295,-21600,,
com.microsoft.VSCode,3,1708720049,1708720052,1708720052.913319,-21600,,
com.google.Chrome,53,1708719996,1708720049,1708720049.995163,-21600,,
com.microsoft.VSCode,39,1708719957,1708719996,1708719996.3983579,-21600,,
com.google.Chrome,18,1708719939,1708719957,1708719957.384819,-21600,,
com.microsoft.VSCode,2,1708719937,1708719939,1708719939.323175,-21600,,
com.google.Chrome,10,1708719927,1708719937,1708719937.6151,-21600,,
com.microsoft.VSCode,1,1708719926,1708719927,1708719927.6227698,-21600,,
com.google.Chrome,29,1708719897,1708719926,1708719926.108663,-21600,,
com.microsoft.VSCode,1,1708719896,1708719897,1708719897.4339771,-21600,,
com.google.Chrome,3,1708719893,1708719896,1708719896.558927,-21600,,
com.microsoft.VSCode,2,1708719891,1708719893,1708719893.2327971,-21600,,
com.google.Chrome,4,1708719887,1708719891,1708719891.814186,-21600,,
com.microsoft.VSCode,0,1708719887,1708719887,1708719887.7378721,-21600,,
com.google.Chrome,4,1708719883,1708719887,1708719887.169918,-21600,,
com.microsoft.VSCode,1,1708719882,1708719883,1708719883.447454,-21600,,
com.google.Chrome,2,1708719880,1708719882,1708719882.826106,-21600,,
com.microsoft.VSCode,13,1708719867,1708719880,1708719880.861742,-21600,,
com.google.Chrome,8,1708719859,1708719867,1708719867.936127,-21600,,
com.microsoft.VSCode,6,1708719853,1708719859,1708719859.077867,-21600,,
com.google.Chrome,6,1708719847,1708719853,1708719853.415101,-21600,,
com.microsoft.VSCode,28,1708719819,1708719847,1708719847.452869,-21600,,
com.google.Chrome,40,1708719779,1708719819,1708719819.320699,-21600,,
com.microsoft.VSCode,18,1708719761,1708719779,1708719779.842705,-21600,,
com.google.Chrome,28,1708719733,1708719761,1708719761.893402,-21600,,
com.microsoft.VSCode,18,1708719715,1708719733,1708719734.0567331,-21600,,
com.google.Chrome,72,1708719643,1708719715,1708719715.28203,-21600,,
com.microsoft.VSCode,4,1708719639,1708719643,1708719643.549844,-21600,,
com.google.Chrome,4,1708719635,1708719639,1708719639.7452059,-21600,,
com.microsoft.VSCode,3,1708719632,1708719635,1708719635.545642,-21600,,
com.google.Chrome,5,1708719627,1708719632,1708719632.147332,-21600,,
com.microsoft.VSCode,3,1708719624,1708719627,1708719627.3256068,-21600,,
com.google.Chrome,4,1708719620,1708719624,1708719624.9979239,-21600,,
com.microsoft.VSCode,4,1708719616,1708719620,1708719620.685367,-21600,,
com.google.Chrome,8,1708719608,1708719616,1708719617.060324,-21600,,
com.microsoft.VSCode,37,1708719571,1708719608,1708719608.565157,-21600,,
com.google.Chrome,8,1708719563,1708719571,1708719571.4108891,-21600,,
com.microsoft.VSCode,34,1708719529,1708719563,1708719563.270805,-21600,,
com.google.Chrome,9,1708719520,1708719529,1708719529.561428,-21600,,
com.microsoft.VSCode,68,1708719452,1708719520,1708719520.356759,-21600,,
com.google.Chrome,64,1708719388,1708719452,1708719452.918789,-21600,,
com.toyopagroup.picaboo,6,1708719352,1708719358,1708719358.7481952,-21600,EB445137-D7F5-57EC-87DA-1DB460D64046,"iPhone13,2"
com.microsoft.Outlook,66,1708719322,1708719388,1708719388.2872329,-21600,,
com.toyopagroup.picaboo,5,1708719088,1708719093,1708719093.959835,-21600,EB445137-D7F5-57EC-87DA-1DB460D64046,"iPhone13,2"
com.google.Chrome,253,1708719069,1708719322,1708719322.501509,-21600,,
com.microsoft.Outlook,1,1708719068,1708719069,1708719070.027003,-21600,,
com.google.Chrome,13,1708719055,1708719068,1708719068.490093,-21600,,
com.microsoft.Outlook,39,1708719016,1708719055,1708719055.414445,-21600,,
com.google.Chrome,5,1708719011,1708719016,1708719016.680427,-21600,,
com.leomehlig.today,41,1708718970,1708719011,1708719011.410584,-21600,,
com.apple.Preview,7,1708718963,1708718970,1708718970.462632,-21600,,
com.apple.MobileSMS,2,1708718795,1708718797,1708718797.366932,-21600,EB445137-D7F5-57EC-87DA-1DB460D64046,"iPhone13,2"
com.apple.InCallService,1,1708718794,1708718795,1708718795.18847,-21600,EB445137-D7F5-57EC-87DA-1DB460D64046,"iPhone13,2"
com.apple.InCallService,3,1708718473,1708718476,1708718476.587738,-21600,EB445137-D7F5-57EC-87DA-1DB460D64046,"iPhone13,2"
com.apple.MobileSMS,4,1708718469,1708718473,1708718474.168376,-21600,EB445137-D7F5-57EC-87DA-1DB460D64046,"iPhone13,2"
com.apple.findmy,9,1708718459,1708718468,1708718469.374704,-21600,EB445137-D7F5-57EC-87DA-1DB460D64046,"iPhone13,2"
com.apple.MobileSMS,11,1708718448,1708718459,1708718459.507757,-21600,EB445137-D7F5-57EC-87DA-1DB460D64046,"iPhone13,2"
com.apple.MobileSMS,4,1708718415,1708718419,1708718419.6821609,-21600,EB445137-D7F5-57EC-87DA-1DB460D64046,"iPhone13,2"
com.toyopagroup.picaboo,10,1708718369,1708718379,1708718379.267478,-21600,EB445137-D7F5-57EC-87DA-1DB460D64046,"iPhone13,2"
com.microsoft.Office.Outlook,1,1708718343,1708718344,1708718344.644374,-21600,EB445137-D7F5-57EC-87DA-1DB460D64046,"iPhone13,2"
com.microsoft.Office.Outlook,2,1708718339,1708718341,1708718341.637899,-21600,EB445137-D7F5-57EC-87DA-1DB460D64046,"iPhone13,2"
com.microsoft.Office.Outlook,3,1708718329,1708718332,1708718332.715338,-21600,EB445137-D7F5-57EC-87DA-1DB460D64046,"iPhone13,2"
com.microsoft.Office.Outlook,3,1708718305,1708718308,1708718308.820576,-21600,EB445137-D7F5-57EC-87DA-1DB460D64046,"iPhone13,2"
com.microsoft.Office.Outlook,11,1708718003,1708718014,1708718014.692099,-21600,EB445137-D7F5-57EC-87DA-1DB460D64046,"iPhone13,2"
com.toyopagroup.picaboo,2,1708717995,1708717997,1708717997.810323,-21600,EB445137-D7F5-57EC-87DA-1DB460D64046,"iPhone13,2"
com.toyopagroup.picaboo,18,1708714820,1708714838,1708714838.9788241,-21600,EB445137-D7F5-57EC-87DA-1DB460D64046,"iPhone13,2"
com.whentowork.iOS.WhenToWork-Employee-Scheduling,3,1708714817,1708714820,1708714820.143207,-21600,EB445137-D7F5-57EC-87DA-1DB460D64046,"iPhone13,2"
com.whentowork.iOS.WhenToWork-Employee-Scheduling,15,1708714777,1708714792,1708714792.429251,-21600,EB445137-D7F5-57EC-87DA-1DB460D64046,"iPhone13,2"
com.apple.Preview,1759,1708713026,1708714785,1708714786.1250129,-21600,,
com.leomehlig.today,3,1708713023,1708713026,1708713026.853761,-21600,,
com.apple.Preview,2,1708713021,1708713023,1708713023.176892,-21600,,
com.apple.finder,3,1708713018,1708713021,1708713021.322083,-21600,,
com.google.Chrome,10,1708713008,1708713018,1708713018.716903,-21600,,
com.apple.iCal,32,1708712976,1708713008,1708713008.588706,-21600,,
com.google.Chrome,11,1708712965,1708712976,1708712976.54277,-21600,,
com.apple.iCal,1,1708712964,1708712965,1708712965.991369,-21600,,
com.google.Chrome,13,1708712951,1708712964,1708712964.650321,-21600,,
com.apple.iCal,8,1708712943,1708712951,1708712951.802928,-21600,,
com.google.Chrome,1,1708712942,1708712943,1708712943.065187,-21600,,
com.apple.iCal,1,1708712941,1708712942,1708712942.6615791,-21600,,
com.google.Chrome,6,1708712935,1708712941,1708712941.428386,-21600,,
com.apple.iCal,13,1708712922,1708712935,1708712935.67121,-21600,,
com.google.Chrome,17,1708712905,1708712922,1708712922.272482,-21600,,
com.whentowork.iOS.WhenToWork-Employee-Scheduling,163,1708712837,1708713000,1708713000.3720288,-21600,EB445137-D7F5-57EC-87DA-1DB460D64046,"iPhone13,2"
com.apple.iCal,69,1708712836,1708712905,1708712905.480156,-21600,,
com.apple.MobileSMS,1,1708712835,1708712836,1708712836.559686,-21600,,
com.google.Chrome,96,1708712739,1708712835,1708712835.971415,-21600,,
com.whentowork.iOS.WhenToWork-Employee-Scheduling,69,1708712609,1708712678,1708712678.87465,-21600,EB445137-D7F5-57EC-87DA-1DB460D64046,"iPhone13,2"
com.duosecurity.DuoMobile,5,1708712602,1708712607,1708712607.110814,-21600,EB445137-D7F5-57EC-87DA-1DB460D64046,"iPhone13,2"
com.leomehlig.today,2,1708712571,1708712573,1708712573.766922,-21600,,
com.instructure.icanvas,3,1708711629,1708711632,1708711632.9595351,-21600,EB445137-D7F5-57EC-87DA-1DB460D64046,"iPhone13,2"
com.instructure.icanvas,14,1708709821,1708709835,1708709835.0795941,-21600,EB445137-D7F5-57EC-87DA-1DB460D64046,"iPhone13,2"
com.apple.MobileSMS,3,1708709817,1708709820,1708709820.9019399,-21600,EB445137-D7F5-57EC-87DA-1DB460D64046,"iPhone13,2"
com.apple.MobileSMS,30,1708709561,1708709591,1708709591.686456,-21600,EB445137-D7F5-57EC-87DA-1DB460D64046,"iPhone13,2"
edu.illinois.rokwire.ios,77,1708708698,1708708775,1708708775.358477,-21600,EB445137-D7F5-57EC-87DA-1DB460D64046,"iPhone13,2"
com.leomehlig.today,50,1708707821,1708707871,1708707871.441237,-21600,,
com.apple.Notes,1,1708707820,1708707821,1708707821.333468,-21600,,
com.leomehlig.today,8,1708707812,1708707820,1708707820.1124659,-21600,,
com.apple.Notes,8,1708707804,1708707812,1708707812.289534,-21600,,
com.leomehlig.today,71,1708707733,1708707804,1708707805.040874,-21600,,
com.google.Chrome,9,1708707724,1708707733,1708707733.924612,-21600,,
com.leomehlig.today,62,1708707662,1708707724,1708707724.411973,-21600,,
com.apple.Notes,20,1708707642,1708707662,1708707662.252574,-21600,,
com.leomehlig.today,26,1708707616,1708707642,1708707642.7850099,-21600,,
com.google.Chrome,6,1708707610,1708707616,1708707617.093344,-21600,,
Astrospheric.Astrospheric,0,1708705517,1708705517,1708705518.06326,-21600,EB445137-D7F5-57EC-87DA-1DB460D64046,"iPhone13,2"
Astrospheric.Astrospheric,2,1708705514,1708705516,1708705516.532467,-21600,EB445137-D7F5-57EC-87DA-1DB460D64046,"iPhone13,2"
Astrospheric.Astrospheric,8,1708703414,1708703422,1708703422.765081,-21600,EB445137-D7F5-57EC-87DA-1DB460D64046,"iPhone13,2"
Astrospheric.Astrospheric,2,1708703397,1708703399,1708703399.945226,-21600,EB445137-D7F5-57EC-87DA-1DB460D64046,"iPhone13,2"
com.google.Chrome,157,1708703229,1708703386,1708703386.605001,-21600,,
us.zoom.xos,15,1708703214,1708703229,1708703229.920754,-21600,,
com.google.Chrome,37,1708703177,1708703214,1708703214.171682,-21600,,
us.zoom.xos,0,1708703177,1708703177,1708703177.933982,-21600,,
com.google.Chrome,4,1708703173,1708703177,1708703177.583218,-21600,,
us.zoom.xos,4,1708703169,1708703173,1708703173.501502,-21600,,
com.google.Chrome,2391,1708700778,1708703169,1708703169.707593,-21600,,
us.zoom.xos,10,1708700768,1708700778,1708700778.717255,-21600,,
com.google.Chrome,13,1708700755,1708700768,1708700768.153345,-21600,,
us.zoom.xos,5,1708700750,1708700755,1708700755.474288,-21600,,
com.google.Chrome,3,1708700747,1708700750,1708700750.6369739,-21600,,
us.zoom.xos,1,1708700746,1708700747,1708700747.83622,-21600,,
com.google.Chrome,4,1708700742,1708700746,1708700746.914124,-21600,,
us.zoom.xos,1,1708700741,1708700742,1708700742.905463,-21600,,
com.google.Chrome,4,1708700737,1708700741,1708700741.108045,-21600,,
us.zoom.xos,2,1708700735,1708700737,1708700737.312247,-21600,,
com.google.Chrome,6,1708700729,1708700735,1708700735.784881,-21600,,
us.zoom.xos,2,1708700727,1708700729,1708700729.513438,-21600,,
com.google.Chrome,4,1708700723,1708700727,1708700727.702327,-21600,,
us.zoom.xos,1,1708700722,1708700723,1708700723.8171802,-21600,,
com.google.Chrome,4,1708700718,1708700722,1708700722.284908,-21600,,
us.zoom.xos,1,1708700717,1708700718,1708700718.70067,-21600,,
com.google.Chrome,1,1708700716,1708700717,1708700717.813754,-21600,,
us.zoom.xos,2,1708700714,1708700716,1708700716.148818,-21600,,
com.google.Chrome,2,1708700712,1708700714,1708700714.820157,-21600,,
us.zoom.xos,232,1708700480,1708700712,1708700712.180953,-21600,,
com.google.Chrome,41,1708700439,1708700480,1708700480.451853,-21600,,
us.zoom.xos,1,1708700438,1708700439,1708700439.74922,-21600,,
com.google.Chrome,4,1708700434,1708700438,1708700438.716796,-21600,,
us.zoom.xos,7,1708700427,1708700434,1708700434.08142,-21600,,
com.google.Chrome,0,1708700427,1708700427,1708700427.725224,-21600,,
us.zoom.xos,2,1708700425,1708700427,1708700427.411711,-21600,,
com.google.Chrome,15,1708700410,1708700425,1708700425.1576371,-21600,,
us.zoom.xos,10,1708700400,1708700410,1708700410.5304332,-21600,,
com.google.Chrome,0,1708700400,1708700400,1708700400.7245011,-21600,,
us.zoom.xos,1,1708700399,1708700400,1708700400.641923,-21600,,
com.google.Chrome,5,1708700394,1708700399,1708700399.133761,-21600,,
us.zoom.xos,0,1708700394,1708700394,1708700394.319531,-21600,,
com.google.Chrome,7,1708700387,1708700394,1708700394.275101,-21600,,
Astrospheric.Astrospheric,16,1708700346,1708700362,1708700362.759605,-21600,EB445137-D7F5-57EC-87DA-1DB460D64046,"iPhone13,2"
com.apple.weather,10,1708700336,1708700346,1708700346.456892,-21600,EB445137-D7F5-57EC-87DA-1DB460D64046,"iPhone13,2"
com.apple.Health,227,1708700104,1708700331,1708700331.6281462,-21600,EB445137-D7F5-57EC-87DA-1DB460D64046,"iPhone13,2"
com.apple.MobileSMS,20,1708700048,1708700068,1708700068.579715,-21600,EB445137-D7F5-57EC-87DA-1DB460D64046,"iPhone13,2"
com.apple.Preferences,19,1708700028,1708700047,1708700047.713341,-21600,EB445137-D7F5-57EC-87DA-1DB460D64046,"iPhone13,2"
com.google.Chrome,629,1708699683,1708700312,1708700312.922862,-21600,,
com.google.Chrome,5,1708662504,1708662509,1708662509.5343351,-21600,,
com.google.Chrome,318,1708662088,1708662406,1708662406.887171,-21600,,
com.leomehlig.today,3,1708662085,1708662088,1708662088.237792,-21600,,
com.google.Chrome,0,1708662085,1708662085,1708662085.6724238,-21600,,
com.leomehlig.today,1,1708662084,1708662085,1708662085.071995,-21600,,
com.hnc.Discord,3,1708662081,1708662084,1708662084.762796,-21600,,
com.google.Chrome,279,1708661802,1708662081,1708662081.766183,-21600,,
com.hnc.Discord,7,1708661795,1708661802,1708661802.1268358,-21600,,
com.google.Chrome,307,1708661488,1708661795,1708661795.2606292,-21600,,
com.hnc.Discord,5,1708661483,1708661488,1708661488.807097,-21600,,
com.google.Chrome,4,1708661479,1708661483,1708661483.5957851,-21600,,
com.hnc.Discord,12,1708661467,1708661479,1708661479.633153,-21600,,
com.google.Chrome,2,1708661465,1708661467,1708661467.257823,-21600,,
com.hnc.Discord,0,1708661465,1708661465,1708661465.748654,-21600,,
com.google.Chrome,5,1708661460,1708661465,1708661465.205759,-21600,,
com.hnc.Discord,8,1708661452,1708661460,1708661460.7730289,-21600,,
com.google.Chrome,2,1708661450,1708661452,1708661452.680882,-21600,,
com.hnc.Discord,7,1708661443,1708661450,1708661450.560322,-21600,,
com.google.Chrome,45,1708661398,1708661443,1708661443.7259831,-21600,,
com.hnc.Discord,2,1708661396,1708661398,1708661398.601815,-21600,,
com.google.Chrome,1,1708661395,1708661396,1708661396.9133592,-21600,,
com.hnc.Discord,5,1708661390,1708661395,1708661395.723792,-21600,,
com.google.Chrome,13,1708661377,1708661390,1708661390.0917702,-21600,,
com.hnc.Discord,2,1708661375,1708661377,1708661377.364984,-21600,,
com.google.Chrome,3,1708661372,1708661375,1708661375.245878,-21600,,
com.microsoft.VSCode,2,1708661370,1708661372,1708661372.597762,-21600,,
com.leomehlig.today,21,1708661349,1708661370,1708661370.199212,-21600,,
com.apple.finder,19,1708661330,1708661349,1708661349.526671,-21600,,
com.apple.finder,2,1708638144,1708638146,1708638146.966258,-21600,,
com.apple.MobileSMS,78,1708638066,1708638144,1708638144.862941,-21600,,
com.apple.finder,15,1708638051,1708638066,1708638067.222605,-21600,,
com.leomehlig.today,2,1708638049,1708638051,1708638051.320838,-21600,,
com.leomehlig.today,29,1708630743,1708630772,1708630772.957302,-21600,,
com.microsoft.VSCode,1,1708630742,1708630743,1708630743.939745,-21600,,
com.google.Chrome,589,1708630153,1708630742,1708630742.543497,-21600,,
com.apple.finder,101,1708630052,1708630153,1708630153.340467,-21600,,
com.microsoft.Outlook,3,1708630049,1708630052,1708630052.799323,-21600,,
com.apple.finder,5,1708630044,1708630049,1708630049.8666081,-21600,,
com.microsoft.VSCode,14,1708630030,1708630044,1708630044.1679878,-21600,,
com.google.Chrome,77,1708629953,1708630030,1708630030.7856,-21600,,
com.microsoft.Outlook,5,1708629948,1708629953,1708629953.392542,-21600,,
com.google.Chrome,4,1708629944,1708629948,1708629948.6085238,-21600,,
com.microsoft.VSCode,6,1708629938,1708629944,1708629944.54301,-21600,,
com.google.Chrome,11,1708629927,1708629938,1708629938.5572228,-21600,,
com.microsoft.VSCode,257,1708629670,1708629927,1708629927.155676,-21600,,
com.apple.finder,5,1708629665,1708629670,1708629670.4473882,-21600,,
com.microsoft.Outlook,38,1708629627,1708629665,1708629665.57464,-21600,,
com.google.Chrome,3,1708629624,1708629627,1708629627.3589969,-21600,,
com.apple.MobileSMS,1,1708629623,1708629624,1708629625.0502272,-21600,,
com.google.Chrome,53,1708629570,1708629623,1708629623.2266889,-21600,,
com.apple.MobileSMS,2,1708629568,1708629570,1708629571.682956,-21600,,
com.leomehlig.today,17,1708629551,1708629568,1708629568.241867,-21600,,
com.leomehlig.today,302,1708628483,1708628785,1708628785.6333718,-21600,,
com.apple.Preview,4,1708628479,1708628483,1708628483.470896,-21600,,
com.google.Chrome,92,1708628387,1708628479,1708628479.7525182,-21600,,
com.apple.Preview,224,1708628163,1708628387,1708628387.755559,-21600,,
com.apple.finder,1,1708628162,1708628163,1708628163.917573,-21600,,
com.apple.Preview,48,1708628114,1708628162,1708628162.908444,-21600,,
com.apple.finder,13,1708628101,1708628114,1708628114.9252,-21600,,
com.google.Chrome,6,1708628095,1708628101,1708628101.4558902,-21600,,
com.google.Chrome,251,1708626706,1708626957,1708626958.105546,-21600,,
com.leomehlig.today,38,1708626668,1708626706,1708626706.906488,-21600,,
com.google.Chrome,79,1708626589,1708626668,1708626669.019069,-21600,,
com.google.Chrome,439,1708626054,1708626493,1708626493.477024,-21600,,
com.leomehlig.today,6,1708626048,1708626054,1708626054.696491,-21600,,
com.google.Chrome,315,1708625733,1708626048,1708626049.0769382,-21600,,
com.apple.MobileSMS,2,1708625731,1708625733,1708625733.228459,-21600,,
com.google.Chrome,19,1708625712,1708625731,1708625732.0781798,-21600,,
com.apple.MobileSMS,15,1708625697,1708625712,1708625712.9635081,-21600,,
com.google.Chrome,682,1708625015,1708625697,1708625697.831672,-21600,,
com.leomehlig.today,22,1708624993,1708625015,1708625015.609386,-21600,,
com.google.Chrome,3,1708624990,1708624993,1708624993.7441149,-21600,,
com.google.Chrome,4,1708622391,1708622395,1708622396.0012078,-21600,,
com.apple.Preview,3,1708622388,1708622391,1708622391.291851,-21600,,
com.google.Chrome,35,1708622353,1708622388,1708622388.885827,-21600,,
com.apple.finder,18,1708622335,1708622353,1708622353.799768,-21600,,
com.google.Chrome,46,1708622289,1708622335,1708622335.500356,-21600,,
com.apple.finder,32,1708622257,1708622289,1708622289.5454159,-21600,,
com.google.Chrome,8,1708622249,1708622257,1708622257.2245011,-21600,,
com.apple.finder,3,1708622246,1708622249,1708622249.1398668,-21600,,
com.apple.Preview,2,1708622244,1708622246,1708622246.4872909,-21600,,
com.google.Chrome,17,1708622227,1708622244,1708622244.1466079,-21600,,
com.apple.Preview,12,1708622215,1708622227,1708622227.447103,-21600,,
com.google.Chrome,20,1708622195,1708622215,1708622215.494896,-21600,,
com.apple.Preview,35,1708622160,1708622195,1708622195.331832,-21600,,
com.google.Chrome,25,1708622135,1708622160,1708622160.141351,-21600,,
com.apple.Preview,75,1708622060,1708622135,1708622135.492271,-21600,,
com.google.Chrome,11,1708622049,1708622060,1708622060.805311,-21600,,
com.apple.Preview,5,1708622044,1708622049,1708622049.190961,-21600,,
com.google.Chrome,13,1708622031,1708622044,1708622044.187786,-21600,,
com.apple.Preview,8,1708622023,1708622031,1708622031.902314,-21600,,
com.apple.finder,7,1708622016,1708622023,1708622023.880245,-21600,,
com.google.Chrome,59,1708621957,1708622016,1708622016.928668,-21600,,
com.apple.Preview,238,1708621719,1708621957,1708621958.0026941,-21600,,
com.google.Chrome,18,1708621701,1708621719,1708621719.327462,-21600,,
com.apple.Preview,148,1708621553,1708621701,1708621701.3305259,-21600,,
com.google.Chrome,52,1708621501,1708621553,1708621553.274963,-21600,,
com.apple.Preview,54,1708621447,1708621501,1708621501.346421,-21600,,
com.google.Chrome,11,1708621436,1708621447,1708621447.8747091,-21600,,
com.apple.Preview,1,1708621435,1708621436,1708621437.030504,-21600,,
com.google.Chrome,3,1708621432,1708621435,1708621435.12837,-21600,,
com.apple.Preview,120,1708621312,1708621432,1708621432.832212,-21600,,
com.google.Chrome,13,1708621299,1708621312,1708621312.725621,-21600,,
com.apple.Preview,39,1708621260,1708621299,1708621299.2408571,-21600,,
com.google.Chrome,87,1708621173,1708621260,1708621260.8330579,-21600,,
com.apple.Preview,34,1708621139,1708621173,1708621173.475599,-21600,,
com.google.Chrome,11,1708621128,1708621139,1708621139.8161879,-21600,,
com.apple.Preview,99,1708621029,1708621128,1708621128.08109,-21600,,
com.google.Chrome,54,1708620975,1708621029,1708621029.923664,-21600,,
com.apple.Preview,276,1708620699,1708620975,1708620975.85784,-21600,,
com.google.Chrome,21,1708620678,1708620699,1708620699.072062,-21600,,
com.apple.Preview,102,1708620576,1708620678,1708620678.537624,-21600,,
com.google.Chrome,28,1708620548,1708620576,1708620576.802641,-21600,,
com.apple.Preview,11,1708620537,1708620548,1708620548.792399,-21600,,
com.google.Chrome,53,1708620484,1708620537,1708620537.300808,-21600,,
com.apple.Preview,4,1708620480,1708620484,1708620484.2348661,-21600,,
com.google.Chrome,5,1708620475,1708620480,1708620480.129565,-21600,,
com.apple.Preview,13,1708620462,1708620475,1708620475.468779,-21600,,
com.google.Chrome,13,1708620449,1708620462,1708620462.833847,-21600,,
com.apple.Preview,4,1708620445,1708620449,1708620449.064095,-21600,,
com.google.Chrome,4,1708620441,1708620445,1708620445.893204,-21600,,
com.apple.Preview,25,1708620416,1708620441,1708620441.8945088,-21600,,
com.google.Chrome,22,1708620394,1708620416,1708620416.163885,-21600,,
com.apple.Preview,90,1708620304,1708620394,1708620394.694992,-21600,,
com.google.Chrome,20,1708620284,1708620304,1708620305.048868,-21600,,
com.apple.Preview,6,1708620278,1708620284,1708620285.023196,-21600,,
com.google.Chrome,5,1708620273,1708620278,1708620278.812727,-21600,,
com.apple.Preview,5,1708620268,1708620273,1708620273.342595,-21600,,
com.google.Chrome,0,1708620268,1708620268,1708620268.640089,-21600,,
com.apple.Preview,30,1708620238,1708620268,1708620268.1270251,-21600,,
com.google.Chrome,3,1708620235,1708620238,1708620238.722095,-21600,,
com.apple.Preview,7,1708620228,1708620235,1708620235.795281,-21600,,
com.google.Chrome,44,1708620184,1708620228,1708620228.0603008,-21600,,
com.apple.Preview,63,1708620121,1708620184,1708620184.958362,-21600,,
com.google.Chrome,1,1708620120,1708620121,1708620121.975638,-21600,,
com.apple.Preview,11,1708620109,1708620120,1708620120.997659,-21600,,
com.google.Chrome,82,1708620027,1708620109,1708620109.5232239,-21600,,
com.apple.Preview,33,1708619994,1708620027,1708620027.1726952,-21600,,
com.google.Chrome,13,1708619981,1708619994,1708619994.4339309,-21600,,
com.apple.Preview,103,1708619878,1708619981,1708619981.53599,-21600,,
com.google.Chrome,30,1708619848,1708619878,1708619878.100018,-21600,,
com.apple.Preview,67,1708619781,1708619848,1708619848.6604571,-21600,,
com.google.Chrome,2,1708619779,1708619781,1708619781.221115,-21600,,
com.apple.Preview,3,1708619776,1708619779,1708619779.263176,-21600,,
com.google.Chrome,4,1708619772,1708619776,1708619776.364706,-21600,,
com.apple.Preview,84,1708619688,1708619772,1708619772.1672,-21600,,
com.google.Chrome,42,1708619646,1708619688,1708619688.745076,-21600,,
com.apple.Preview,1,1708619645,1708619646,1708619646.534764,-21600,,
com.google.Chrome,0,1708619645,1708619645,1708619645.912231,-21600,,
com.apple.Preview,158,1708619487,1708619645,1708619645.11305,-21600,,
com.google.Chrome,10,1708619477,1708619487,1708619487.980811,-21600,,
com.apple.Preview,34,1708619443,1708619477,1708619477.572988,-21600,,
com.google.Chrome,38,1708619405,1708619443,1708619443.391299,-21600,,
com.apple.Preview,27,1708619378,1708619405,1708619406.04229,-21600,,
com.google.Chrome,24,1708619354,1708619378,1708619378.8177428,-21600,,
com.apple.Preview,107,1708619247,1708619354,1708619354.426306,-21600,,
com.google.Chrome,3,1708619244,1708619247,1708619247.368892,-21600,,
com.apple.Preview,5,1708619239,1708619244,1708619244.6863542,-21600,,
com.google.Chrome,48,1708619191,1708619239,1708619239.6564631,-21600,,
com.apple.Preview,180,1708619011,1708619191,1708619191.733622,-21600,,
com.apple.Preview,300,1708618662,1708618962,1708618962.959498,-21600,,
com.apple.Preview,300,1708618361,1708618661,1708618661.556826,-21600,,
com.google.Chrome,188,1708618173,1708618361,1708618361.102462,-21600,,
com.apple.Preview,64,1708618109,1708618173,1708618173.882567,-21600,,
com.apple.finder,4,1708618105,1708618109,1708618109.702796,-21600,,
com.google.Chrome,44,1708618061,1708618105,1708618105.37503,-21600,,
com.apple.Preview,33,1708618028,1708618061,1708618061.630415,-21600,,
com.google.Chrome,30,1708617998,1708618028,1708618028.8751001,-21600,,
com.apple.Preview,13,1708617985,1708617998,1708617998.226939,-21600,,
com.apple.finder,55,1708617930,1708617985,1708617985.693109,-21600,,
com.google.Chrome,143,1708617787,1708617930,1708617930.5539079,-21600,,
com.google.Chrome,864,1708615164,1708616028,1708616028.372215,-21600,,
com.leomehlig.today,1,1708615163,1708615164,1708615164.117284,-21600,,
com.google.Chrome,491,1708614672,1708615163,1708615163.336818,-21600,,
com.leomehlig.today,7,1708614665,1708614672,1708614672.149756,-21600,,
com.apple.finder,3,1708614662,1708614665,1708614665.188861,-21600,,
com.apple.MobileSMS,3,1708614659,1708614662,1708614662.7593741,-21600,,
com.apple.finder,5,1708614654,1708614659,1708614659.354545,-21600,,
com.apple.Health,23,1708578224,1708578247,1708578247.702302,-21600,EB445137-D7F5-57EC-87DA-1DB460D64046,"iPhone13,2"
com.thestorygraph.thestorygraph,200,1708578021,1708578221,1708578221.27712,-21600,EB445137-D7F5-57EC-87DA-1DB460D64046,"iPhone13,2"
com.thestorygraph.thestorygraph,10,1708577863,1708577873,1708577873.418823,-21600,EB445137-D7F5-57EC-87DA-1DB460D64046,"iPhone13,2"
com.thestorygraph.thestorygraph,2,1708577497,1708577499,1708577499.168999,-21600,EB445137-D7F5-57EC-87DA-1DB460D64046,"iPhone13,2"
com.thestorygraph.thestorygraph,4,1708576203,1708576207,1708576207.13147,-21600,EB445137-D7F5-57EC-87DA-1DB460D64046,"iPhone13,2"
com.thestorygraph.thestorygraph,4,1708576155,1708576159,1708576159.902847,-21600,EB445137-D7F5-57EC-87DA-1DB460D64046,"iPhone13,2"
com.thestorygraph.thestorygraph,139,1708574897,1708575036,1708575036.661979,-21600,EB445137-D7F5-57EC-87DA-1DB460D64046,"iPhone13,2"
com.google.chrome.ios,575,1708574316,1708574891,1708574891.475796,-21600,EB445137-D7F5-57EC-87DA-1DB460D64046,"iPhone13,2"
com.facebook.Facebook,20,1708574278,1708574298,1708574298.041651,-21600,EB445137-D7F5-57EC-87DA-1DB460D64046,"iPhone13,2"
com.facebook.Facebook,215,1708574063,1708574278,1708574278.372967,-21600,EB445137-D7F5-57EC-87DA-1DB460D64046,"iPhone13,2"
com.microsoft.Office.Outlook,52,1708574006,1708574058,1708574058.655644,-21600,EB445137-D7F5-57EC-87DA-1DB460D64046,"iPhone13,2"
com.apple.weather,4,1708574001,1708574005,1708574005.219102,-21600,EB445137-D7F5-57EC-87DA-1DB460D64046,"iPhone13,2"
com.apple.weather,40,1708573797,1708573837,1708573838.235516,-21600,EB445137-D7F5-57EC-87DA-1DB460D64046,"iPhone13,2"
Astrospheric.Astrospheric,2,1708573795,1708573797,1708573797.9245481,-21600,EB445137-D7F5-57EC-87DA-1DB460D64046,"iPhone13,2"
Astrospheric.Astrospheric,9,1708572550,1708572559,1708572559.910069,-21600,EB445137-D7F5-57EC-87DA-1DB460D64046,"iPhone13,2"
com.apple.Music,2,1708572546,1708572548,1708572548.7519588,-21600,EB445137-D7F5-57EC-87DA-1DB460D64046,"iPhone13,2"
com.apple.Music,32,1708572452,1708572484,1708572484.925115,-21600,EB445137-D7F5-57EC-87DA-1DB460D64046,"iPhone13,2"
com.apple.finder,4,1708572335,1708572339,1708572339.956307,-21600,,
com.microsoft.VSCode,1,1708572334,1708572335,1708572335.804445,-21600,,
com.leomehlig.today,43,1708572291,1708572334,1708572334.1206598,-21600,,
com.apple.Preview,570,1708571721,1708572291,1708572292.10997,-21600,,
com.leomehlig.today,77,1708571644,1708571721,1708571722.053077,-21600,,
com.apple.Preview,288,1708571356,1708571644,1708571644.593711,-21600,,
com.apple.finder,2,1708571354,1708571356,1708571356.8114219,-21600,,
com.apple.Preview,992,1708570362,1708571354,1708571354.392994,-21600,,
com.google.Chrome,172,1708570190,1708570362,1708570362.066498,-21600,,
com.apple.Preview,257,1708569933,1708570190,1708570190.7896419,-21600,,
com.leomehlig.today,153,1708569780,1708569933,1708569933.218727,-21600,,
com.google.Chrome,84,1708569696,1708569780,1708569781.07604,-21600,,
com.google.Chrome,301,1708569393,1708569694,1708569694.673512,-21600,,
com.apple.news,607,1708569170,1708569777,1708569777.628686,-21600,EB445137-D7F5-57EC-87DA-1DB460D64046,"iPhone13,2"
com.microsoft.Office.Outlook,6,1708569140,1708569146,1708569146.254076,-21600,EB445137-D7F5-57EC-87DA-1DB460D64046,"iPhone13,2"
com.toyopagroup.picaboo,40,1708569099,1708569139,1708569139.605696,-21600,EB445137-D7F5-57EC-87DA-1DB460D64046,"iPhone13,2"
com.google.Chrome,305,1708569087,1708569392,1708569392.707399,-21600,,
com.apple.Preview,87,1708569000,1708569087,1708569087.496469,-21600,,
com.apple.finder,1,1708568999,1708569000,1708569001.02929,-21600,,
com.apple.Preview,119,1708568880,1708568999,1708568999.16297,-21600,,
com.apple.finder,1,1708568879,1708568880,1708568880.4590878,-21600,,
com.apple.Preview,1371,1708567508,1708568879,1708568879.905891,-21600,,
com.apple.finder,2,1708567506,1708567508,1708567509.079668,-21600,,
com.apple.Preview,514,1708566992,1708567506,1708567506.9944391,-21600,,
com.apple.finder,3,1708566989,1708566992,1708566992.173742,-21600,,
com.apple.Preview,883,1708566106,1708566989,1708566989.993495,-21600,,
com.leomehlig.today,44,1708566062,1708566106,1708566106.478581,-21600,,
com.apple.Preview,712,1708565350,1708566062,1708566063.092506,-21600,,
com.google.Chrome,341,1708565009,1708565350,1708565350.4810228,-21600,,
com.burbn.instagram,14,1708564147,1708564161,1708564161.9923081,-21600,EB445137-D7F5-57EC-87DA-1DB460D64046,"iPhone13,2"
com.burbn.instagram,34,1708564105,1708564139,1708564139.19854,-21600,EB445137-D7F5-57EC-87DA-1DB460D64046,"iPhone13,2"
com.apple.Preview,1433,1708563576,1708565009,1708565009.437552,-21600,,
com.leomehlig.today,6,1708563570,1708563576,1708563577.0581322,-21600,,
com.apple.Preview,4,1708563566,1708563570,1708563570.877734,-21600,,
com.apple.finder,1,1708563565,1708563566,1708563566.9695969,-21600,,
com.apple.Preview,947,1708562618,1708563565,1708563565.937667,-21600,,
com.apple.finder,1,1708562617,1708562618,1708562618.793149,-21600,,
com.apple.Preview,29,1708562588,1708562617,1708562617.285146,-21600,,
com.apple.finder,55,1708562533,1708562588,1708562588.7623901,-21600,,
com.google.Chrome,144,1708562389,1708562533,1708562533.956419,-21600,,
com.apple.finder,40,1708562349,1708562389,1708562389.4974952,-21600,,
com.microsoft.Office.Outlook,5,1708561923,1708561928,1708561928.8335872,-21600,EB445137-D7F5-57EC-87DA-1DB460D64046,"iPhone13,2"
com.toyopagroup.picaboo,4,1708561919,1708561923,1708561923.319042,-21600,EB445137-D7F5-57EC-87DA-1DB460D64046,"iPhone13,2"
com.toyopagroup.picaboo,1,1708561795,1708561796,1708561796.8663611,-21600,EB445137-D7F5-57EC-87DA-1DB460D64046,"iPhone13,2"
com.toyopagroup.picaboo,6,1708561788,1708561794,1708561794.668738,-21600,EB445137-D7F5-57EC-87DA-1DB460D64046,"iPhone13,2"
com.toyopagroup.picaboo,9,1708561779,1708561788,1708561788.12111,-21600,EB445137-D7F5-57EC-87DA-1DB460D64046,"iPhone13,2"
com.toyopagroup.picaboo,2,1708561664,1708561666,1708561666.3012872,-21600,EB445137-D7F5-57EC-87DA-1DB460D64046,"iPhone13,2"
com.toyopagroup.picaboo,6,1708558719,1708558725,1708558725.855243,-21600,EB445137-D7F5-57EC-87DA-1DB460D64046,"iPhone13,2"
com.toyopagroup.picaboo,15,1708558703,1708558718,1708558718.817844,-21600,EB445137-D7F5-57EC-87DA-1DB460D64046,"iPhone13,2"
com.burbn.instagram,275,1708558372,1708558647,1708558647.083726,-21600,EB445137-D7F5-57EC-87DA-1DB460D64046,"iPhone13,2"
edu.illinois.rokwire.ios,54,1708558271,1708558325,1708558325.457588,-21600,EB445137-D7F5-57EC-87DA-1DB460D64046,"iPhone13,2"
com.toyopagroup.picaboo,33,1708558237,1708558270,1708558270.520689,-21600,EB445137-D7F5-57EC-87DA-1DB460D64046,"iPhone13,2"
com.truebill.truebillnative,4,1708558233,1708558237,1708558237.571466,-21600,EB445137-D7F5-57EC-87DA-1DB460D64046,"iPhone13,2"
com.apple.finder,8,1708558026,1708558034,1708558034.207995,-21600,,
com.google.Chrome,7,1708558019,1708558026,1708558026.256808,-21600,,
com.leomehlig.today,3,1708558016,1708558019,1708558019.115155,-21600,,
com.microsoft.VSCode,205,1708557811,1708558016,1708558016.257993,-21600,,
com.google.Chrome,17,1708557794,1708557811,1708557811.513888,-21600,,
com.microsoft.VSCode,304,1708557490,1708557794,1708557794.171974,-21600,,
com.google.Chrome,85,1708557405,1708557490,1708557490.647215,-21600,,
com.microsoft.VSCode,259,1708557146,1708557405,1708557405.8178911,-21600,,
com.leomehlig.today,9,1708557137,1708557146,1708557147.006268,-21600,,
com.microsoft.VSCode,554,1708556583,1708557137,1708557137.966577,-21600,,
com.truebill.truebillnative,94,1708556371,1708556465,1708556465.999535,-21600,EB445137-D7F5-57EC-87DA-1DB460D64046,"iPhone13,2"
com.toyopagroup.picaboo,1,1708556366,1708556367,1708556367.879581,-21600,EB445137-D7F5-57EC-87DA-1DB460D64046,"iPhone13,2"
com.thestorygraph.thestorygraph,250,1708556111,1708556361,1708556361.38692,-21600,EB445137-D7F5-57EC-87DA-1DB460D64046,"iPhone13,2"
com.toyopagroup.picaboo,6,1708556085,1708556091,1708556091.596554,-21600,EB445137-D7F5-57EC-87DA-1DB460D64046,"iPhone13,2"
com.apple.camera,1,1708555043,1708555044,1708555044.4052591,-21600,EB445137-D7F5-57EC-87DA-1DB460D64046,"iPhone13,2"
com.burbn.instagram,406,1708551753,1708552159,1708552159.384064,-21600,EB445137-D7F5-57EC-87DA-1DB460D64046,"iPhone13,2"
com.toyopagroup.picaboo,2,1708551751,1708551753,1708551753.614386,-21600,EB445137-D7F5-57EC-87DA-1DB460D64046,"iPhone13,2"
com.burbn.instagram,158,1708551593,1708551751,1708551751.637207,-21600,EB445137-D7F5-57EC-87DA-1DB460D64046,"iPhone13,2"
com.toyopagroup.picaboo,3,1708551588,1708551591,1708551591.809844,-21600,EB445137-D7F5-57EC-87DA-1DB460D64046,"iPhone13,2"
com.burbn.instagram,32,1708551556,1708551588,1708551588.861397,-21600,EB445137-D7F5-57EC-87DA-1DB460D64046,"iPhone13,2"
com.apple.AppStore,2,1708551554,1708551556,1708551556.871221,-21600,EB445137-D7F5-57EC-87DA-1DB460D64046,"iPhone13,2"
com.burbn.instagram,52,1708551502,1708551554,1708551554.7230182,-21600,EB445137-D7F5-57EC-87DA-1DB460D64046,"iPhone13,2"
com.toyopagroup.picaboo,3,1708551499,1708551502,1708551502.794858,-21600,EB445137-D7F5-57EC-87DA-1DB460D64046,"iPhone13,2"
com.burbn.instagram,45,1708551454,1708551499,1708551499.484116,-21600,EB445137-D7F5-57EC-87DA-1DB460D64046,"iPhone13,2"
com.microsoft.Office.Outlook,8,1708551442,1708551450,1708551450.815905,-21600,EB445137-D7F5-57EC-87DA-1DB460D64046,"iPhone13,2"
com.toyopagroup.picaboo,17,1708551423,1708551440,1708551440.533068,-21600,EB445137-D7F5-57EC-87DA-1DB460D64046,"iPhone13,2"
com.leomehlig.today,24,1708551399,1708551423,1708551423.409766,-21600,EB445137-D7F5-57EC-87DA-1DB460D64046,"iPhone13,2"
com.toyopagroup.picaboo,7,1708551392,1708551399,1708551399.2874599,-21600,EB445137-D7F5-57EC-87DA-1DB460D64046,"iPhone13,2"
com.leomehlig.today,13,1708551379,1708551392,1708551392.601722,-21600,EB445137-D7F5-57EC-87DA-1DB460D64046,"iPhone13,2"
com.toyopagroup.picaboo,5,1708551374,1708551379,1708551379.520327,-21600,EB445137-D7F5-57EC-87DA-1DB460D64046,"iPhone13,2"
com.leomehlig.today,19,1708551355,1708551374,1708551374.865056,-21600,EB445137-D7F5-57EC-87DA-1DB460D64046,"iPhone13,2"
com.toyopagroup.picaboo,42,1708551291,1708551333,1708551333.7033958,-21600,EB445137-D7F5-57EC-87DA-1DB460D64046,"iPhone13,2"
com.burbn.instagram,44,1708551247,1708551291,1708551291.977171,-21600,EB445137-D7F5-57EC-87DA-1DB460D64046,"iPhone13,2"
com.toyopagroup.picaboo,3,1708551242,1708551245,1708551246.062543,-21600,EB445137-D7F5-57EC-87DA-1DB460D64046,"iPhone13,2"
com.instructure.icanvas,7,1708551235,1708551242,1708551242.9274049,-21600,EB445137-D7F5-57EC-87DA-1DB460D64046,"iPhone13,2"
com.toyopagroup.picaboo,22,1708550931,1708550953,1708550953.5399551,-21600,EB445137-D7F5-57EC-87DA-1DB460D64046,"iPhone13,2"
com.apple.MobileSMS,2,1708550926,1708550928,1708550928.5160332,-21600,EB445137-D7F5-57EC-87DA-1DB460D64046,"iPhone13,2"
com.apple.InCallService,2,1708550924,1708550926,1708550926.075193,-21600,EB445137-D7F5-57EC-87DA-1DB460D64046,"iPhone13,2"
com.apple.InCallService,2,1708549837,1708549839,1708549839.856625,-21600,EB445137-D7F5-57EC-87DA-1DB460D64046,"iPhone13,2"
com.apple.MobileSMS,5,1708549832,1708549837,1708549838.1776261,-21600,EB445137-D7F5-57EC-87DA-1DB460D64046,"iPhone13,2"
com.apple.findmy,3,1708549828,1708549831,1708549832.129798,-21600,EB445137-D7F5-57EC-87DA-1DB460D64046,"iPhone13,2"
com.apple.findmy,25,1708549785,1708549810,1708549810.915114,-21600,EB445137-D7F5-57EC-87DA-1DB460D64046,"iPhone13,2"
com.apple.findmy,6,1708549705,1708549711,1708549711.159806,-21600,EB445137-D7F5-57EC-87DA-1DB460D64046,"iPhone13,2"
com.apple.findmy,1,1708549703,1708549704,1708549704.627167,-21600,EB445137-D7F5-57EC-87DA-1DB460D64046,"iPhone13,2"
com.apple.findmy,18,1708549682,1708549700,1708549700.625788,-21600,EB445137-D7F5-57EC-87DA-1DB460D64046,"iPhone13,2"
com.apple.findmy,1,1708549584,1708549585,1708549585.604899,-21600,EB445137-D7F5-57EC-87DA-1DB460D64046,"iPhone13,2"
com.apple.findmy,26,1708549557,1708549583,1708549583.693502,-21600,EB445137-D7F5-57EC-87DA-1DB460D64046,"iPhone13,2"
com.apple.findmy,5,1708549403,1708549408,1708549408.887075,-21600,EB445137-D7F5-57EC-87DA-1DB460D64046,"iPhone13,2"
com.apple.findmy,11,1708549390,1708549401,1708549401.998147,-21600,EB445137-D7F5-57EC-87DA-1DB460D64046,"iPhone13,2"
com.apple.camera,1,1708549366,1708549367,1708549367.792001,-21600,EB445137-D7F5-57EC-87DA-1DB460D64046,"iPhone13,2"
com.apple.findmy,8,1708549365,1708549373,1708549373.827114,-21600,EB445137-D7F5-57EC-87DA-1DB460D64046,"iPhone13,2"
com.apple.findmy,29,1708549330,1708549359,1708549360.2837791,-21600,EB445137-D7F5-57EC-87DA-1DB460D64046,"iPhone13,2"
com.apple.news,2,1708549328,1708549330,1708549330.235534,-21600,EB445137-D7F5-57EC-87DA-1DB460D64046,"iPhone13,2"
com.apple.news,1,1708549171,1708549172,1708549173.452301,-21600,EB445137-D7F5-57EC-87DA-1DB460D64046,"iPhone13,2"
com.apple.news,9,1708546702,1708546711,1708546711.524174,-21600,EB445137-D7F5-57EC-87DA-1DB460D64046,"iPhone13,2"
com.microsoft.Office.Outlook,112,1708545442,1708545554,1708545554.31709,-21600,EB445137-D7F5-57EC-87DA-1DB460D64046,"iPhone13,2"
com.microsoft.Office.Outlook,19,1708543720,1708543739,1708543739.944799,-21600,EB445137-D7F5-57EC-87DA-1DB460D64046,"iPhone13,2"
com.apple.news,4,1708543716,1708543720,1708543721.376581,-21600,EB445137-D7F5-57EC-87DA-1DB460D64046,"iPhone13,2"
com.apple.news,115,1708541896,1708542011,1708542011.667467,-21600,EB445137-D7F5-57EC-87DA-1DB460D64046,"iPhone13,2"
com.google.Maps,7,1708541880,1708541887,1708541887.297317,-21600,EB445137-D7F5-57EC-87DA-1DB460D64046,"iPhone13,2"
com.microsoft.VSCode,483,1708541354,1708541837,1708541837.700717,-21600,,
com.apple.finder,1,1708541353,1708541354,1708541354.649457,-21600,,
com.leomehlig.today,6,1708541347,1708541353,1708541353.9701838,-21600,,
com.apple.finder,1,1708541346,1708541347,1708541347.155107,-21600,,
com.microsoft.VSCode,14,1708541332,1708541346,1708541346.126913,-21600,,
com.google.Maps,1,1708539491,1708539492,1708539492.830478,-21600,EB445137-D7F5-57EC-87DA-1DB460D64046,"iPhone13,2"
com.apple.Preview,1890,1708539442,1708541332,1708541333.087858,-21600,,
com.apple.finder,2,1708539440,1708539442,1708539442.39043,-21600,,
com.leomehlig.today,25,1708539415,1708539440,1708539440.5783281,-21600,,
com.google.Maps,4,1708538021,1708538025,1708538025.460456,-21600,EB445137-D7F5-57EC-87DA-1DB460D64046,"iPhone13,2"
com.apple.MobileSMS,3,1708538015,1708538018,1708538018.450934,-21600,EB445137-D7F5-57EC-87DA-1DB460D64046,"iPhone13,2"
com.apple.MobileSMS,3,1708538011,1708538014,1708538014.8194861,-21600,EB445137-D7F5-57EC-87DA-1DB460D64046,"iPhone13,2"
com.apple.MobileSMS,3,1708538007,1708538010,1708538010.304724,-21600,EB445137-D7F5-57EC-87DA-1DB460D64046,"iPhone13,2"
com.apple.InCallService,1,1708538006,1708538007,1708538007.228625,-21600,EB445137-D7F5-57EC-87DA-1DB460D64046,"iPhone13,2"
com.apple.InCallService,4,1708537955,1708537959,1708537959.962593,-21600,EB445137-D7F5-57EC-87DA-1DB460D64046,"iPhone13,2"
com.apple.MobileSMS,5,1708537950,1708537955,1708537955.968223,-21600,EB445137-D7F5-57EC-87DA-1DB460D64046,"iPhone13,2"
com.apple.mobilephone,18,1708537778,1708537796,1708537796.973566,-21600,EB445137-D7F5-57EC-87DA-1DB460D64046,"iPhone13,2"
com.apple.MobileSMS,6,1708537240,1708537246,1708537246.084619,-21600,EB445137-D7F5-57EC-87DA-1DB460D64046,"iPhone13,2"
com.apple.MobileSMS,85,1708537119,1708537204,1708537204.950237,-21600,EB445137-D7F5-57EC-87DA-1DB460D64046,"iPhone13,2"
com.toyopagroup.picaboo,30,1708536439,1708536469,1708536469.3466249,-21600,EB445137-D7F5-57EC-87DA-1DB460D64046,"iPhone13,2"
edu.illinois.rokwire.ios,118,1708535851,1708535969,1708535969.1659288,-21600,EB445137-D7F5-57EC-87DA-1DB460D64046,"iPhone13,2"
com.apple.mobilecal,206,1708534890,1708535096,1708535096.447412,-21600,EB445137-D7F5-57EC-87DA-1DB460D64046,"iPhone13,2"
com.microsoft.Office.Outlook,2,1708534888,1708534890,1708534890.618633,-21600,EB445137-D7F5-57EC-87DA-1DB460D64046,"iPhone13,2"
com.leomehlig.today,84,1708534706,1708534790,1708534791.172233,-21600,,
com.microsoft.VSCode,94,1708534612,1708534706,1708534706.1946092,-21600,,
com.google.Chrome,8,1708534604,1708534612,1708534612.3741999,-21600,,
com.microsoft.VSCode,12,1708534592,1708534604,1708534604.481837,-21600,,
com.google.Chrome,5,1708534587,1708534592,1708534592.573443,-21600,,
com.microsoft.VSCode,48,1708534539,1708534587,1708534587.3606381,-21600,,
com.google.Chrome,59,1708534480,1708534539,1708534539.9178371,-21600,,
com.microsoft.VSCode,213,1708534267,1708534480,1708534480.422606,-21600,,
com.microsoft.Office.Outlook,30,1708534186,1708534216,1708534216.296484,-21600,EB445137-D7F5-57EC-87DA-1DB460D64046,"iPhone13,2"
com.instructure.icanvas,12,1708534174,1708534186,1708534187.695308,-21600,EB445137-D7F5-57EC-87DA-1DB460D64046,"iPhone13,2"
com.apple.mobilecal,2,1708534172,1708534174,1708534174.8556561,-21600,EB445137-D7F5-57EC-87DA-1DB460D64046,"iPhone13,2"
com.apple.mobilecal,4,1708534156,1708534160,1708534160.0574641,-21600,EB445137-D7F5-57EC-87DA-1DB460D64046,"iPhone13,2"
com.microsoft.VSCode,268,1708532765,1708533033,1708533033.1762009,-21600,,
com.google.Chrome,8,1708532757,1708532765,1708532765.702395,-21600,,
com.microsoft.VSCode,300,1708532457,1708532757,1708532757.88641,-21600,,
com.google.Chrome,53,1708532404,1708532457,1708532457.996671,-21600,,
com.microsoft.VSCode,76,1708532328,1708532404,1708532404.9569468,-21600,,
com.google.Chrome,6,1708532322,1708532328,1708532328.7141252,-21600,,
com.microsoft.VSCode,194,1708532128,1708532322,1708532322.449329,-21600,,
com.google.Chrome,3,1708532125,1708532128,1708532128.568386,-21600,,
com.microsoft.VSCode,75,1708532050,1708532125,1708532126.028333,-21600,,
com.google.Chrome,2,1708532048,1708532050,1708532050.372034,-21600,,
com.microsoft.VSCode,2,1708532046,1708532048,1708532048.4894052,-21600,,
com.google.Chrome,72,1708531974,1708532046,1708532046.8035579,-21600,,
com.microsoft.VSCode,2456,1708529518,1708531974,1708531974.9372501,-21600,,
com.google.Chrome,4,1708529514,1708529518,1708529518.631506,-21600,,
com.microsoft.VSCode,4,1708529510,1708529514,1708529514.32462,-21600,,
com.google.Chrome,15,1708529495,1708529510,1708529510.9878259,-21600,,
com.microsoft.VSCode,14,1708529481,1708529495,1708529495.513422,-21600,,
com.google.Chrome,36,1708529445,1708529481,1708529481.7452068,-21600,,
com.apple.finder,4,1708529441,1708529445,1708529446.818671,-21600,,
com.apple.mobilecal,1,1708529345,1708529346,1708529346.8509588,-21600,EB445137-D7F5-57EC-87DA-1DB460D64046,"iPhone13,2"
com.apple.mobilecal,1,1708529273,1708529274,1708529274.377389,-21600,EB445137-D7F5-57EC-87DA-1DB460D64046,"iPhone13,2"
com.apple.mobilecal,1,1708529091,1708529092,1708529092.802064,-21600,EB445137-D7F5-57EC-87DA-1DB460D64046,"iPhone13,2"
com.apple.mobilecal,1,1708528972,1708528973,1708528973.374596,-21600,EB445137-D7F5-57EC-87DA-1DB460D64046,"iPhone13,2"
com.apple.mobilecal,6,1708528793,1708528799,1708528799.097666,-21600,EB445137-D7F5-57EC-87DA-1DB460D64046,"iPhone13,2"
com.apple.mobilecal,1,1708528791,1708528792,1708528792.204702,-21600,EB445137-D7F5-57EC-87DA-1DB460D64046,"iPhone13,2"
com.apple.mobilecal,1,1708528715,1708528716,1708528716.466476,-21600,EB445137-D7F5-57EC-87DA-1DB460D64046,"iPhone13,2"
com.apple.mobilecal,5,1708528573,1708528578,1708528578.796092,-21600,EB445137-D7F5-57EC-87DA-1DB460D64046,"iPhone13,2"
com.microsoft.Office.Outlook,11,1708528561,1708528572,1708528572.084882,-21600,EB445137-D7F5-57EC-87DA-1DB460D64046,"iPhone13,2"
com.apple.Health,11,1708528188,1708528199,1708528199.501756,-21600,EB445137-D7F5-57EC-87DA-1DB460D64046,"iPhone13,2"
com.goodreads.Goodreads,14,1708494116,1708494130,1708494130.382478,-21600,EB445137-D7F5-57EC-87DA-1DB460D64046,"iPhone13,2"
com.thestorygraph.thestorygraph,14,1708494101,1708494115,1708494115.8990579,-21600,EB445137-D7F5-57EC-87DA-1DB460D64046,"iPhone13,2"
com.apple.Health,46,1708494049,1708494095,1708494095.6369162,-21600,EB445137-D7F5-57EC-87DA-1DB460D64046,"iPhone13,2"
com.apple.Health,10,1708493393,1708493403,1708493403.45452,-21600,EB445137-D7F5-57EC-87DA-1DB460D64046,"iPhone13,2"
com.apple.Health,52,1708492666,1708492718,1708492718.6914911,-21600,EB445137-D7F5-57EC-87DA-1DB460D64046,"iPhone13,2"
com.google.ios.youtube,41,1708492622,1708492663,1708492663.7263122,-21600,EB445137-D7F5-57EC-87DA-1DB460D64046,"iPhone13,2"
com.apple.news,304,1708491126,1708491430,1708491431.515603,-21600,EB445137-D7F5-57EC-87DA-1DB460D64046,"iPhone13,2"
com.apple.journal,951,1708490086,1708491037,1708491037.61008,-21600,EB445137-D7F5-57EC-87DA-1DB460D64046,"iPhone13,2"
com.apple.Health,106,1708489969,1708490075,1708490075.182684,-21600,EB445137-D7F5-57EC-87DA-1DB460D64046,"iPhone13,2"
com.goodreads.Goodreads,47,1708489919,1708489966,1708489966.8952808,-21600,EB445137-D7F5-57EC-87DA-1DB460D64046,"iPhone13,2"
com.thestorygraph.thestorygraph,12,1708489906,1708489918,1708489918.807181,-21600,EB445137-D7F5-57EC-87DA-1DB460D64046,"iPhone13,2"
com.thestorygraph.thestorygraph,41,1708489402,1708489443,1708489443.519943,-21600,EB445137-D7F5-57EC-87DA-1DB460D64046,"iPhone13,2"
com.microsoft.Office.Outlook,81,1708487306,1708487387,1708487387.038463,-21600,EB445137-D7F5-57EC-87DA-1DB460D64046,"iPhone13,2"
com.apple.Preferences,9,1708487296,1708487305,1708487305.2743878,-21600,EB445137-D7F5-57EC-87DA-1DB460D64046,"iPhone13,2"
com.apple.finder,5,1708487249,1708487254,1708487254.484777,-21600,,
com.apple.Preferences,10,1708487079,1708487089,1708487089.712409,-21600,EB445137-D7F5-57EC-87DA-1DB460D64046,"iPhone13,2"
com.microsoft.VSCode,678,1708486571,1708487249,1708487249.17501,-21600,,
com.leomehlig.today,6,1708486565,1708486571,1708486571.1757832,-21600,,
com.leomehlig.today,3,1708486542,1708486545,1708486545.6216002,-21600,,
com.apple.finder,4,1708486538,1708486542,1708486542.530441,-21600,,
com.microsoft.onenote.mac,3,1708486535,1708486538,1708486538.871491,-21600,,
com.apple.Terminal,3,1708486532,1708486535,1708486535.746851,-21600,,
com.apple.finder,4,1708486528,1708486532,1708486532.958373,-21600,,
com.microsoft.VSCode,53,1708486475,1708486528,1708486528.151669,-21600,,
com.microsoft.onenote.mac,49,1708486426,1708486475,1708486475.8949242,-21600,,
com.google.Chrome,84,1708486342,1708486426,1708486426.705729,-21600,,
com.microsoft.VSCode,450,1708485892,1708486342,1708486343.022011,-21600,,
com.apple.finder,4,1708485888,1708485892,1708485892.8803139,-21600,,
com.microsoft.VSCode,12,1708485876,1708485888,1708485888.10036,-21600,,
com.apple.finder,4,1708485872,1708485876,1708485876.246197,-21600,,
com.microsoft.VSCode,148,1708485724,1708485872,1708485872.998938,-21600,,
com.apple.finder,10,1708485714,1708485724,1708485725.003605,-21600,,
com.apple.Terminal,41,1708485673,1708485714,1708485714.5760732,-21600,,
com.apple.finder,4,1708485669,1708485673,1708485673.835814,-21600,,
com.apple.Terminal,3,1708485666,1708485669,1708485670.089756,-21600,,
com.apple.finder,13,1708485653,1708485666,1708485666.228226,-21600,,
com.microsoft.VSCode,120,1708485533,1708485653,1708485653.3110251,-21600,,
com.apple.Preferences,196,1708485383,1708485579,1708485579.4612641,-21600,EB445137-D7F5-57EC-87DA-1DB460D64046,"iPhone13,2"
com.leomehlig.today,413,1708485120,1708485533,1708485533.240169,-21600,,
com.google.Chrome,17,1708485103,1708485120,1708485120.549789,-21600,,
com.toyopagroup.picaboo,48,1708484091,1708484139,1708484139.854796,-21600,EB445137-D7F5-57EC-87DA-1DB460D64046,"iPhone13,2"
com.google.Chrome,401,1708484058,1708484459,1708484459.62035,-21600,,
com.leomehlig.today,19,1708484039,1708484058,1708484058.743542,-21600,,
com.google.Chrome,663,1708483376,1708484039,1708484039.323549,-21600,,
com.microsoft.VSCode,1,1708483375,1708483376,1708483376.812344,-21600,,
com.leomehlig.today,12,1708483363,1708483375,1708483375.5343971,-21600,,
com.apple.finder,4,1708483359,1708483363,1708483363.4468389,-21600,,
com.google.Chrome,27,1708483332,1708483359,1708483359.3581161,-21600,,
com.apple.finder,13,1708483319,1708483332,1708483332.133291,-21600,,
com.google.Chrome,7,1708483312,1708483319,1708483319.749174,-21600,,
com.apple.Preview,4,1708483308,1708483312,1708483312.472132,-21600,,
com.apple.finder,0,1708483308,1708483308,1708483308.581783,-21600,,
com.apple.Preview,7,1708483301,1708483308,1708483308.280622,-21600,,
com.google.Chrome,7,1708483294,1708483301,1708483301.382226,-21600,,
com.apple.Preview,104,1708483190,1708483294,1708483294.129226,-21600,,
com.google.Chrome,13,1708483177,1708483190,1708483191.030916,-21600,,
com.apple.Preview,26,1708483151,1708483177,1708483178.003943,-21600,,
com.google.Chrome,2,1708483149,1708483151,1708483151.9183989,-21600,,
com.apple.Preview,4,1708483145,1708483149,1708483149.880491,-21600,,
com.google.Chrome,9,1708483136,1708483145,1708483145.1641421,-21600,,
com.apple.Preview,28,1708483108,1708483136,1708483136.58444,-21600,,
com.google.Chrome,48,1708483060,1708483108,1708483108.967122,-21600,,
com.apple.Preview,28,1708483032,1708483060,1708483060.205301,-21600,,
com.google.Chrome,3,1708483029,1708483032,1708483032.119595,-21600,,
com.apple.Preview,40,1708482989,1708483029,1708483029.9928951,-21600,,
com.google.Chrome,2,1708482987,1708482989,1708482989.813257,-21600,,
com.apple.Preview,70,1708482917,1708482987,1708482987.342344,-21600,,
com.google.Chrome,70,1708482847,1708482917,1708482917.6740499,-21600,,
com.apple.Preview,82,1708482765,1708482847,1708482847.411841,-21600,,
com.google.Chrome,89,1708482676,1708482765,1708482765.906385,-21600,,
com.apple.Preview,14,1708482662,1708482676,1708482676.612539,-21600,,
com.google.Chrome,21,1708482641,1708482662,1708482663.026083,-21600,,
com.apple.Preview,10,1708482631,1708482641,1708482641.227108,-21600,,
com.apple.finder,7,1708482624,1708482631,1708482631.420322,-21600,,
com.google.Chrome,32,1708482592,1708482624,1708482624.595926,-21600,,
com.leomehlig.today,38,1708482554,1708482592,1708482592.393176,-21600,,
com.google.Chrome,22,1708482532,1708482554,1708482554.381689,-21600,,
com.microsoft.VSCode,3,1708482529,1708482532,1708482533.390387,-21600,,
com.google.chrome.ios,36,1708480685,1708480721,1708480721.908366,-21600,EB445137-D7F5-57EC-87DA-1DB460D64046,"iPhone13,2"
com.apple.camera,11,1708480673,1708480684,1708480685.464116,-21600,EB445137-D7F5-57EC-87DA-1DB460D64046,"iPhone13,2"
com.apple.news,15,1708480670,1708480685,1708480686.089997,-21600,EB445137-D7F5-57EC-87DA-1DB460D64046,"iPhone13,2"
com.apple.news,1,1708480656,1708480657,1708480657.486603,-21600,EB445137-D7F5-57EC-87DA-1DB460D64046,"iPhone13,2"
com.apple.news,507,1708479854,1708480361,1708480361.4183512,-21600,EB445137-D7F5-57EC-87DA-1DB460D64046,"iPhone13,2"
com.apple.news,5,1708479164,1708479169,1708479169.370296,-21600,EB445137-D7F5-57EC-87DA-1DB460D64046,"iPhone13,2"
com.apple.Health,14,1708477300,1708477314,1708477314.493382,-21600,EB445137-D7F5-57EC-87DA-1DB460D64046,"iPhone13,2"
com.apple.MobileSMS,6,1708477294,1708477300,1708477300.14873,-21600,EB445137-D7F5-57EC-87DA-1DB460D64046,"iPhone13,2"
com.apple.MobileSMS,1,1708477244,1708477245,1708477246.192282,-21600,EB445137-D7F5-57EC-87DA-1DB460D64046,"iPhone13,2"
com.apple.Music,5,1708477239,1708477244,1708477244.180754,-21600,EB445137-D7F5-57EC-87DA-1DB460D64046,"iPhone13,2"
com.apple.Music,2,1708477131,1708477133,1708477133.335118,-21600,EB445137-D7F5-57EC-87DA-1DB460D64046,"iPhone13,2"
com.apple.Music,2,1708476819,1708476821,1708476821.093462,-21600,EB445137-D7F5-57EC-87DA-1DB460D64046,"iPhone13,2"
com.apple.Music,53,1708476382,1708476435,1708476436.0759869,-21600,EB445137-D7F5-57EC-87DA-1DB460D64046,"iPhone13,2"
com.apple.MobileSMS,2,1708476375,1708476377,1708476377.523571,-21600,EB445137-D7F5-57EC-87DA-1DB460D64046,"iPhone13,2"
com.leomehlig.today,3,1708476372,1708476375,1708476375.6148272,-21600,EB445137-D7F5-57EC-87DA-1DB460D64046,"iPhone13,2"
com.leomehlig.today,11,1708476168,1708476179,1708476179.605856,-21600,EB445137-D7F5-57EC-87DA-1DB460D64046,"iPhone13,2"
com.microsoft.Office.Outlook,2,1708476162,1708476164,1708476164.791136,-21600,EB445137-D7F5-57EC-87DA-1DB460D64046,"iPhone13,2"
com.microsoft.VSCode,29,1708476142,1708476171,1708476171.727304,-21600,,
com.microsoft.VSCode,189,1708475951,1708476140,1708476141.018259,-21600,,
com.apple.MobileSMS,2,1708475949,1708475951,1708475951.6752791,-21600,,
com.microsoft.VSCode,115,1708475834,1708475949,1708475949.050983,-21600,,
com.google.Chrome,6,1708475828,1708475834,1708475834.124782,-21600,,
com.apple.MobileSMS,2,1708475826,1708475828,1708475828.900594,-21600,,
com.google.Chrome,3,1708475823,1708475826,1708475826.8733249,-21600,,
com.apple.MobileSMS,11,1708475812,1708475823,1708475823.110271,-21600,,
com.google.Chrome,21,1708475791,1708475812,1708475812.350198,-21600,,
com.apple.MobileSMS,1,1708475790,1708475791,1708475791.724156,-21600,,
com.microsoft.VSCode,8,1708475782,1708475790,1708475790.74305,-21600,,
com.apple.MobileSMS,1,1708475781,1708475782,1708475782.8965678,-21600,,
com.google.Chrome,20,1708475761,1708475781,1708475781.191736,-21600,,
com.apple.MobileSMS,2,1708475759,1708475761,1708475761.103747,-21600,,
com.microsoft.VSCode,1,1708475758,1708475759,1708475759.8193278,-21600,,
com.apple.MobileSMS,1,1708475757,1708475758,1708475758.475702,-21600,,
com.microsoft.VSCode,7,1708475750,1708475757,1708475757.067037,-21600,,
com.apple.MobileSMS,30,1708475720,1708475750,1708475750.649812,-21600,,
com.microsoft.VSCode,543,1708475177,1708475720,1708475720.198775,-21600,,
com.google.Chrome,42,1708475135,1708475177,1708475177.570858,-21600,,
com.microsoft.VSCode,250,1708474885,1708475135,1708475135.746317,-21600,,
com.apple.finder,3,1708474882,1708474885,1708474885.428584,-21600,,
com.apple.iWork.Numbers,2,1708474880,1708474882,1708474882.3186278,-21600,,
com.microsoft.VSCode,28,1708474852,1708474880,1708474880.312406,-21600,,
com.apple.iWork.Numbers,9,1708474843,1708474852,1708474852.392921,-21600,,
com.apple.finder,10,1708474833,1708474843,1708474843.535297,-21600,,
com.microsoft.Office.Outlook,7,1708474619,1708474626,1708474626.7050629,-21600,EB445137-D7F5-57EC-87DA-1DB460D64046,"iPhone13,2"
com.apple.Health,5,1708474614,1708474619,1708474619.49072,-21600,EB445137-D7F5-57EC-87DA-1DB460D64046,"iPhone13,2"
com.microsoft.VSCode,668,1708474165,1708474833,1708474833.332016,-21600,,
com.apple.finder,3,1708474162,1708474165,1708474166.017013,-21600,,
com.microsoft.VSCode,68,1708474094,1708474162,1708474162.1769528,-21600,,
com.apple.finder,44,1708474050,1708474094,1708474094.967917,-21600,,
com.apple.Health,537,1708473554,1708474091,1708474091.41709,-21600,EB445137-D7F5-57EC-87DA-1DB460D64046,"iPhone13,2"
com.apple.MobileSMS,23,1708473531,1708473554,1708473554.164155,-21600,EB445137-D7F5-57EC-87DA-1DB460D64046,"iPhone13,2"
com.microsoft.Excel,764,1708473286,1708474050,1708474050.838777,-21600,,
com.apple.Music,7,1708473279,1708473286,1708473286.916689,-21600,,
com.apple.MobileSMS,9,1708473270,1708473279,1708473279.176739,-21600,,
com.apple.Music,3,1708473267,1708473270,1708473270.412842,-21600,,
com.apple.MobileSMS,4,1708473263,1708473267,1708473267.222724,-21600,,
com.apple.Health,479,1708473052,1708473531,1708473531.751655,-21600,EB445137-D7F5-57EC-87DA-1DB460D64046,"iPhone13,2"
com.microsoft.Excel,222,1708473041,1708473263,1708473263.939649,-21600,,
com.microsoft.onenote.mac,33,1708473008,1708473041,1708473041.723212,-21600,,
com.microsoft.Excel,6,1708473002,1708473008,1708473008.856945,-21600,,
com.apple.MobileSMS,3,1708473001,1708473004,1708473004.466388,-21600,EB445137-D7F5-57EC-87DA-1DB460D64046,"iPhone13,2"
com.apple.finder,12,1708472990,1708473002,1708473002.996125,-21600,,
com.microsoft.Outlook,7,1708472983,1708472990,1708472990.168283,-21600,,
com.apple.finder,14,1708472969,1708472983,1708472983.754908,-21600,,
com.apple.MobileSMS,50,1708472919,1708472969,1708472969.282942,-21600,,
com.apple.finder,4,1708472915,1708472919,1708472919.5934849,-21600,,
com.apple.MobileSMS,26,1708472352,1708472378,1708472378.97394,-21600,EB445137-D7F5-57EC-87DA-1DB460D64046,"iPhone13,2"
com.apple.MobileSMS,13,1708471260,1708471273,1708471273.1851702,-21600,EB445137-D7F5-57EC-87DA-1DB460D64046,"iPhone13,2"
edu.illinois.rokwire.ios,4,1708471256,1708471260,1708471260.7927,-21600,EB445137-D7F5-57EC-87DA-1DB460D64046,"iPhone13,2"
edu.illinois.rokwire.ios,23,1708468300,1708468323,1708468323.937362,-21600,EB445137-D7F5-57EC-87DA-1DB460D64046,"iPhone13,2"
edu.illinois.rokwire.ios,3,1708468297,1708468300,1708468300.976653,-21600,EB445137-D7F5-57EC-87DA-1DB460D64046,"iPhone13,2"
edu.illinois.rokwire.ios,77,1708468215,1708468292,1708468292.72439,-21600,EB445137-D7F5-57EC-87DA-1DB460D64046,"iPhone13,2"
edu.illinois.rokwire.ios,20,1708467789,1708467809,1708467809.673763,-21600,EB445137-D7F5-57EC-87DA-1DB460D64046,"iPhone13,2"
com.apple.MobileSMS,5,1708466938,1708466943,1708466943.886125,-21600,EB445137-D7F5-57EC-87DA-1DB460D64046,"iPhone13,2"
com.apple.MobileSMS,1,1708466849,1708466850,1708466850.227032,-21600,EB445137-D7F5-57EC-87DA-1DB460D64046,"iPhone13,2"
com.apple.MobileSMS,1,1708466655,1708466656,1708466656.850169,-21600,EB445137-D7F5-57EC-87DA-1DB460D64046,"iPhone13,2"
com.apple.MobileSMS,1,1708466137,1708466138,1708466138.7642841,-21600,EB445137-D7F5-57EC-87DA-1DB460D64046,"iPhone13,2"
com.apple.MobileSMS,2,1708465241,1708465243,1708465243.737083,-21600,EB445137-D7F5-57EC-87DA-1DB460D64046,"iPhone13,2"
com.toyopagroup.picaboo,1,1708465103,1708465104,1708465104.1621609,-21600,EB445137-D7F5-57EC-87DA-1DB460D64046,"iPhone13,2"
com.apple.finder,2,1708465067,1708465069,1708465069.7783608,-21600,,
com.leomehlig.today,55,1708465012,1708465067,1708465067.072236,-21600,,
com.google.Chrome,11,1708465001,1708465012,1708465012.7182941,-21600,,
com.apple.MobileSMS,8,1708464993,1708465001,1708465001.929879,-21600,,
com.google.Chrome,260,1708464733,1708464993,1708464993.3891358,-21600,,
com.leomehlig.today,25,1708464708,1708464733,1708464733.446605,-21600,,
com.google.Chrome,7,1708464701,1708464708,1708464708.846031,-21600,,
com.apple.shortcuts,30,1708464671,1708464701,1708464701.879496,-21600,,
com.apple.finder,21,1708464650,1708464671,1708464671.277816,-21600,,
com.apple.shortcuts,2,1708464648,1708464650,1708464650.364593,-21600,,
com.google.Chrome,3,1708464645,1708464648,1708464648.826882,-21600,,
com.apple.shortcuts,0,1708464645,1708464645,1708464645.8866591,-21600,,
com.apple.finder,17,1708464628,1708464645,1708464645.106847,-21600,,
com.apple.shortcuts,2,1708464626,1708464628,1708464628.1386929,-21600,,
com.google.Chrome,4,1708464622,1708464626,1708464626.858931,-21600,,
com.apple.shortcuts,1,1708464621,1708464622,1708464622.1150599,-21600,,
com.apple.finder,7,1708464614,1708464621,1708464621.178252,-21600,,
com.apple.shortcuts,8,1708464606,1708464614,1708464614.96179,-21600,,
com.google.Chrome,16,1708464590,1708464606,1708464606.4935222,-21600,,
com.apple.shortcuts,3,1708464587,1708464590,1708464590.615691,-21600,,
com.google.Chrome,49,1708464538,1708464587,1708464587.944864,-21600,,
com.apple.shortcuts,1,1708464537,1708464538,1708464538.196159,-21600,,
com.google.Chrome,59,1708464478,1708464537,1708464537.1858149,-21600,,
com.apple.shortcuts,77,1708464401,1708464478,1708464478.2278419,-21600,,
com.apple.finder,7,1708464394,1708464401,1708464401.1333652,-21600,,
com.apple.shortcuts,22,1708464372,1708464394,1708464394.266221,-21600,,
com.apple.finder,10,1708464362,1708464372,1708464372.25813,-21600,,
com.apple.Terminal,3,1708464359,1708464362,1708464362.1748528,-21600,,
com.apple.shortcuts,1,1708464358,1708464359,1708464359.278291,-21600,,
com.apple.Terminal,3,1708464355,1708464358,1708464358.3655891,-21600,,
com.apple.shortcuts,3,1708464352,1708464355,1708464355.397925,-21600,,
com.apple.Terminal,2,1708464350,1708464352,1708464353.040084,-21600,,
com.apple.shortcuts,37,1708464313,1708464350,1708464350.748358,-21600,,
com.apple.Terminal,27,1708464286,1708464313,1708464313.307146,-21600,,
com.apple.shortcuts,1,1708464285,1708464286,1708464286.390901,-21600,,
com.apple.Terminal,2,1708464283,1708464285,1708464285.102711,-21600,,
com.apple.shortcuts,37,1708464246,1708464283,1708464283.977232,-21600,,
com.google.Chrome,18,1708464228,1708464246,1708464246.825134,-21600,,
com.apple.shortcuts,6,1708464222,1708464228,1708464228.202862,-21600,,
com.apple.finder,18,1708464173,1708464191,1708464191.693363,-21600,,
com.apple.shortcuts,74,1708464099,1708464173,1708464173.524489,-21600,,
com.google.Chrome,34,1708464065,1708464099,1708464099.379099,-21600,,
com.leomehlig.today,1,1708464064,1708464065,1708464065.641222,-21600,,
us.zoom.xos,7,1708464057,1708464064,1708464064.985244,-21600,,
com.leomehlig.today,41,1708464016,1708464057,1708464057.490586,-21600,,
com.google.Chrome,18,1708463998,1708464016,1708464016.927837,-21600,,
com.leomehlig.today,1,1708463997,1708463998,1708463998.532428,-21600,,
com.apple.MobileSMS,11,1708463986,1708463997,1708463997.581596,-21600,,
com.leomehlig.today,3,1708463983,1708463986,1708463986.7746348,-21600,,
com.google.Chrome,14,1708463969,1708463983,1708463983.602597,-21600,,
com.microsoft.VSCode,110,1708463859,1708463969,1708463970.0808039,-21600,,
com.google.Chrome,28,1708463831,1708463859,1708463859.4243321,-21600,,
com.microsoft.VSCode,67,1708463764,1708463831,1708463831.7052178,-21600,,
com.google.Chrome,3,1708463761,1708463764,1708463764.2003,-21600,,
com.apple.finder,2,1708463759,1708463761,1708463762.080956,-21600,,
us.zoom.xos,2,1708463757,1708463759,1708463759.110328,-21600,,
com.google.Chrome,3,1708463754,1708463757,1708463757.383037,-21600,,
us.zoom.xos,8,1708463746,1708463754,1708463754.760507,-21600,,
com.apple.finder,0,1708463746,1708463746,1708463746.726188,-21600,,
com.microsoft.VSCode,90,1708463656,1708463746,1708463746.1942291,-21600,,
com.apple.finder,0,1708463656,1708463656,1708463657.036897,-21600,,
com.microsoft.VSCode,166,1708463490,1708463656,1708463656.398195,-21600,,
com.apple.finder,0,1708463490,1708463490,1708463491.062798,-21600,,
com.microsoft.VSCode,23,1708463467,1708463490,1708463490.0778332,-21600,,
com.apple.finder,33,1708463434,1708463467,1708463467.331181,-21600,,
com.microsoft.Office.Outlook,3,1708463355,1708463358,1708463359.479022,-21600,EB445137-D7F5-57EC-87DA-1DB460D64046,"iPhone13,2"
com.microsoft.VSCode,160,1708463274,1708463434,1708463434.235797,-21600,,
us.zoom.xos,6,1708463268,1708463274,1708463274.1607552,-21600,,
com.microsoft.VSCode,176,1708463092,1708463268,1708463268.624784,-21600,,
com.google.Chrome,8,1708463084,1708463092,1708463092.928273,-21600,,
com.microsoft.VSCode,200,1708462884,1708463084,1708463084.165679,-21600,,
com.google.Chrome,29,1708462855,1708462884,1708462884.36485,-21600,,
com.microsoft.VSCode,84,1708462771,1708462855,1708462855.753615,-21600,,
us.zoom.xos,5,1708462766,1708462771,1708462771.481996,-21600,,
com.microsoft.VSCode,127,1708462639,1708462766,1708462766.376432,-21600,,
com.google.Chrome,15,1708462624,1708462639,1708462639.433502,-21600,,
com.microsoft.VSCode,16,1708462608,1708462624,1708462624.381166,-21600,,
com.google.Chrome,42,1708462566,1708462608,1708462608.6608481,-21600,,
com.microsoft.VSCode,163,1708462403,1708462566,1708462567.041225,-21600,,
com.apple.finder,6,1708462397,1708462403,1708462403.154045,-21600,,
com.microsoft.VSCode,85,1708462312,1708462397,1708462397.981261,-21600,,
us.zoom.xos,23,1708462289,1708462312,1708462312.523807,-21600,,
com.apple.systempreferences,6,1708462283,1708462289,1708462289.39892,-21600,,
com.apple.reminders,39,1708462244,1708462283,1708462283.6470351,-21600,,
com.apple.systempreferences,9,1708462235,1708462244,1708462244.740724,-21600,,
us.zoom.xos,2,1708462233,1708462235,1708462236.027941,-21600,,
com.apple.systempreferences,40,1708462193,1708462233,1708462233.063112,-21600,,
us.zoom.xos,5,1708462182,1708462187,1708462187.174444,-21600,,
com.microsoft.VSCode,170,1708462012,1708462182,1708462182.7095351,-21600,,
com.google.Chrome,2,1708462010,1708462012,1708462012.087827,-21600,,
com.microsoft.VSCode,20,1708461990,1708462010,1708462010.2995439,-21600,,
com.google.Chrome,6,1708461984,1708461990,1708461990.55204,-21600,,
com.microsoft.VSCode,11,1708461973,1708461984,1708461985.051547,-21600,,
com.google.Chrome,2,1708461971,1708461973,1708461973.724884,-21600,,
us.zoom.xos,1,1708461970,1708461971,1708461971.719636,-21600,,
com.microsoft.Office.Outlook,36,1708461824,1708461860,1708461860.972184,-21600,EB445137-D7F5-57EC-87DA-1DB460D64046,"iPhone13,2"
com.google.Chrome,193,1708461777,1708461970,1708461970.862428,-21600,,
us.zoom.xos,2,1708461775,1708461777,1708461777.305826,-21600,,
com.microsoft.VSCode,24,1708461751,1708461775,1708461775.9636722,-21600,,
us.zoom.xos,2,1708461749,1708461751,1708461751.250221,-21600,,
com.google.Chrome,11,1708461738,1708461749,1708461749.9666739,-21600,,
us.zoom.xos,1,1708461737,1708461738,1708461738.4047909,-21600,,
com.google.Chrome,6,1708461731,1708461737,1708461737.224994,-21600,,
com.microsoft.VSCode,72,1708461659,1708461731,1708461731.726388,-21600,,
us.zoom.xos,0,1708461659,1708461659,1708461660.034807,-21600,,
com.microsoft.VSCode,75,1708461584,1708461659,1708461659.269479,-21600,,
com.google.Chrome,5,1708461579,1708461584,1708461584.2490082,-21600,,
com.microsoft.VSCode,28,1708461551,1708461579,1708461579.840864,-21600,,
com.google.Chrome,36,1708461515,1708461551,1708461551.804347,-21600,,
com.microsoft.VSCode,20,1708461495,1708461515,1708461515.39362,-21600,,
com.google.Chrome,1,1708461494,1708461495,1708461495.678803,-21600,,
com.microsoft.VSCode,8,1708461486,1708461494,1708461494.952461,-21600,,
com.google.Chrome,3,1708461483,1708461486,1708461486.739548,-21600,,
com.microsoft.VSCode,2,1708461481,1708461483,1708461483.2304978,-21600,,
com.google.Chrome,8,1708461473,1708461481,1708461481.7291288,-21600,,
com.microsoft.VSCode,1,1708461472,1708461473,1708461473.9817939,-21600,,
com.google.Chrome,0,1708461472,1708461472,1708461472.900635,-21600,,
com.microsoft.VSCode,1,1708461471,1708461472,1708461472.411174,-21600,,
us.zoom.xos,1,1708461470,1708461471,1708461471.456365,-21600,,
com.microsoft.VSCode,7,1708461463,1708461470,1708461470.4040399,-21600,,
us.zoom.xos,0,1708461463,1708461463,1708461464.003076,-21600,,
com.microsoft.VSCode,4,1708461459,1708461463,1708461463.47453,-21600,,
com.google.Chrome,3,1708461456,1708461459,1708461459.164139,-21600,,
com.microsoft.VSCode,10,1708461446,1708461456,1708461456.238801,-21600,,
com.google.Chrome,32,1708461414,1708461446,1708461446.368184,-21600,,
com.microsoft.VSCode,8,1708461406,1708461414,1708461414.589042,-21600,,
com.google.Chrome,13,1708461393,1708461406,1708461406.49247,-21600,,
com.microsoft.VSCode,20,1708461373,1708461393,1708461393.827362,-21600,,
com.apple.finder,19,1708461354,1708461373,1708461373.669379,-21600,,
com.google.Chrome,3,1708461351,1708461354,1708461354.582032,-21600,,
com.apple.systempreferences,33,1708461318,1708461351,1708461351.727405,-21600,,
com.google.Chrome,72,1708461240,1708461312,1708461312.506024,-21600,,
com.apple.finder,66,1708461174,1708461240,1708461240.6294699,-21600,,
com.apple.Terminal,15,1708461159,1708461174,1708461174.9288568,-21600,,
com.google.Chrome,2,1708461157,1708461159,1708461159.823092,-21600,,
com.apple.systempreferences,13,1708461144,1708461157,1708461157.2819982,-21600,,
com.google.Chrome,29,1708461108,1708461137,1708461137.467733,-21600,,
com.apple.Terminal,8,1708461100,1708461108,1708461108.840687,-21600,,
com.google.Chrome,92,1708461008,1708461100,1708461100.335679,-21600,,
com.apple.Terminal,11,1708460997,1708461008,1708461008.35152,-21600,,
com.google.Chrome,2,1708460995,1708460997,1708460997.346947,-21600,,
com.apple.Terminal,16,1708460979,1708460995,1708460995.301978,-21600,,
com.google.Chrome,4,1708460975,1708460979,1708460979.0824971,-21600,,
com.apple.Terminal,8,1708460967,1708460975,1708460975.596099,-21600,,
com.apple.finder,3,1708460964,1708460967,1708460967.711384,-21600,,
com.apple.Terminal,3,1708460961,1708460964,1708460964.490505,-21600,,
com.apple.finder,25,1708460936,1708460961,1708460961.901972,-21600,,
com.google.Chrome,149,1708460787,1708460936,1708460936.964627,-21600,,
us.zoom.xos,6,1708460781,1708460787,1708460788.005115,-21600,,
com.google.Chrome,311,1708460470,1708460781,1708460781.337215,-21600,,
us.zoom.xos,2,1708460468,1708460470,1708460470.866157,-21600,,
com.google.Chrome,12,1708460456,1708460468,1708460468.595169,-21600,,
us.zoom.xos,9,1708460447,1708460456,1708460456.79162,-21600,,
com.google.Chrome,303,1708460144,1708460447,1708460447.798633,-21600,,
us.zoom.xos,7,1708460137,1708460144,1708460145.0070539,-21600,,
com.google.Chrome,93,1708460044,1708460137,1708460137.8384671,-21600,,
us.zoom.xos,3,1708460041,1708460044,1708460044.726944,-21600,,
com.google.Chrome,7,1708460034,1708460041,1708460041.881882,-21600,,
us.zoom.xos,9,1708460025,1708460034,1708460034.349504,-21600,,
com.google.Chrome,6,1708460019,1708460025,1708460025.3993158,-21600,,
us.zoom.xos,45,1708459974,1708460019,1708460019.468214,-21600,,
com.google.Chrome,38,1708459936,1708459974,1708459974.624034,-21600,,
us.zoom.xos,33,1708459903,1708459936,1708459936.864921,-21600,,
com.google.Chrome,34,1708459869,1708459903,1708459903.597106,-21600,,
com.microsoft.VSCode,122,1708459747,1708459869,1708459869.142113,-21600,,
us.zoom.xos,2,1708459745,1708459747,1708459747.331349,-21600,,
com.microsoft.VSCode,269,1708459476,1708459745,1708459745.250618,-21600,,
us.zoom.xos,25,1708459451,1708459476,1708459476.464838,-21600,,
com.microsoft.VSCode,54,1708459397,1708459451,1708459451.2822351,-21600,,
com.apple.finder,4,1708459393,1708459397,1708459398.090832,-21600,,
com.microsoft.VSCode,28,1708459365,1708459393,1708459393.871479,-21600,,
com.apple.finder,12,1708459353,1708459365,1708459365.573175,-21600,,
com.microsoft.VSCode,11,1708459342,1708459353,1708459353.931899,-21600,,
com.google.Chrome,8,1708459334,1708459342,1708459343.047793,-21600,,
com.microsoft.onenote.mac,2,1708459332,1708459334,1708459334.689884,-21600,,
com.google.Chrome,5,1708459327,1708459332,1708459332.326305,-21600,,
com.apple.systempreferences,2,1708459325,1708459327,1708459328.634583,-21600,,
com.google.Chrome,2,1708459323,1708459325,1708459325.29036,-21600,,
com.apple.iCal,60,1708459263,1708459323,1708459323.109005,-21600,,
com.apple.Maps,18,1708459245,1708459263,1708459264.045558,-21600,,
com.apple.iCal,12,1708459233,1708459245,1708459245.8123631,-21600,,
us.zoom.xos,21,1708459212,1708459233,1708459233.920335,-21600,,
com.google.Chrome,1,1708459211,1708459212,1708459212.89213,-21600,,
us.zoom.xos,2,1708459209,1708459211,1708459211.3213692,-21600,,
com.google.Chrome,21,1708459188,1708459209,1708459209.460853,-21600,,
com.microsoft.VSCode,53,1708459135,1708459188,1708459188.912751,-21600,,
com.apple.finder,13,1708459122,1708459135,1708459136.0138168,-21600,,
com.microsoft.VSCode,10,1708459112,1708459122,1708459122.601367,-21600,,
com.apple.finder,6,1708459106,1708459112,1708459112.703491,-21600,,
com.microsoft.VSCode,102,1708459004,1708459106,1708459106.176135,-21600,,
com.apple.finder,26,1708458978,1708459004,1708459004.740641,-21600,,
com.apple.Notes,37,1708458941,1708458978,1708458979.075924,-21600,,
com.tinyspeck.chatlyio,2,1708458807,1708458809,1708458809.467822,-21600,EB445137-D7F5-57EC-87DA-1DB460D64046,"iPhone13,2"
com.apple.finder,282,1708458659,1708458941,1708458941.9461179,-21600,,
com.tinyspeck.chatlyio,1,1708458642,1708458643,1708458643.850162,-21600,EB445137-D7F5-57EC-87DA-1DB460D64046,"iPhone13,2"
com.apple.Health,4,1708458638,1708458642,1708458642.5006819,-21600,EB445137-D7F5-57EC-87DA-1DB460D64046,"iPhone13,2"
com.tinyspeck.chatlyio,29,1708458607,1708458636,1708458636.243198,-21600,EB445137-D7F5-57EC-87DA-1DB460D64046,"iPhone13,2"
com.apple.Health,2,1708458603,1708458605,1708458605.5826359,-21600,EB445137-D7F5-57EC-87DA-1DB460D64046,"iPhone13,2"
com.apple.MobileSMS,13,1708458588,1708458601,1708458601.5765991,-21600,EB445137-D7F5-57EC-87DA-1DB460D64046,"iPhone13,2"
com.apple.Health,33,1708458555,1708458588,1708458588.864647,-21600,EB445137-D7F5-57EC-87DA-1DB460D64046,"iPhone13,2"
com.microsoft.onenote.mac,158,1708458501,1708458659,1708458659.600243,-21600,,
com.apple.Notes,9,1708458492,1708458501,1708458501.762651,-21600,,
com.apple.finder,49,1708458443,1708458492,1708458492.6446018,-21600,,
com.google.Chrome,26,1708458417,1708458443,1708458443.973628,-21600,,
com.intsig.CamScannerLite,5,1708458308,1708458313,1708458314.026383,-21600,EB445137-D7F5-57EC-87DA-1DB460D64046,"iPhone13,2"
com.intsig.CamScannerLite,4,1708458172,1708458176,1708458176.901647,-21600,EB445137-D7F5-57EC-87DA-1DB460D64046,"iPhone13,2"
com.leomehlig.today,448,1708457969,1708458417,1708458418.845159,-21600,,
com.intsig.CamScannerLite,113,1708457648,1708457761,1708457761.9315948,-21600,EB445137-D7F5-57EC-87DA-1DB460D64046,"iPhone13,2"
com.google.Chrome,713,1708457256,1708457969,1708457969.5906348,-21600,,
edu.illinois.rokwire.ios,35,1708457211,1708457246,1708457246.0925322,-21600,EB445137-D7F5-57EC-87DA-1DB460D64046,"iPhone13,2"
edu.illinois.rokwire.ios,42,1708457169,1708457211,1708457211.9023519,-21600,EB445137-D7F5-57EC-87DA-1DB460D64046,"iPhone13,2"
com.microsoft.Office.Outlook,10,1708457157,1708457167,1708457167.5427818,-21600,EB445137-D7F5-57EC-87DA-1DB460D64046,"iPhone13,2"
com.apple.Preview,284,1708456972,1708457256,1708457256.645839,-21600,,
com.apple.Preview,311,1708456660,1708456971,1708456971.4399772,-21600,,
com.google.Chrome,56,1708456604,1708456660,1708456660.319337,-21600,,
com.hnc.Discord,53,1708456551,1708456604,1708456604.301966,-21600,,
com.google.Chrome,24,1708456527,1708456551,1708456552.0380402,-21600,,
com.apple.Preview,1,1708456526,1708456527,1708456527.9186358,-21600,,
com.google.Chrome,36,1708456490,1708456526,1708456526.961344,-21600,,
com.apple.Preview,264,1708456226,1708456490,1708456490.38527,-21600,,
com.google.Chrome,29,1708456197,1708456226,1708456226.921461,-21600,,
com.apple.Preview,71,1708456126,1708456197,1708456197.84249,-21600,,
com.google.Chrome,2,1708456124,1708456126,1708456126.808796,-21600,,
com.apple.Preview,27,1708456097,1708456124,1708456124.6102371,-21600,,
com.google.Chrome,17,1708456080,1708456097,1708456097.754581,-21600,,
com.apple.Preview,51,1708456029,1708456080,1708456080.26331,-21600,,
com.apple.finder,1,1708456028,1708456029,1708456029.4911652,-21600,,
com.apple.Preview,185,1708455843,1708456028,1708456029.06036,-21600,,
com.apple.finder,3,1708455840,1708455843,1708455843.54706,-21600,,
com.microsoft.Office.Outlook,12,1708455837,1708455849,1708455849.071793,-21600,EB445137-D7F5-57EC-87DA-1DB460D64046,"iPhone13,2"
com.google.Chrome,53,1708455787,1708455840,1708455840.748503,-21600,,
com.leomehlig.today,5,1708455782,1708455787,1708455788.4977732,-21600,,
com.microsoft.VSCode,22,1708455760,1708455782,1708455782.333745,-21600,,
com.microsoft.Office.Outlook,50,1708455475,1708455525,1708455525.231419,-21600,EB445137-D7F5-57EC-87DA-1DB460D64046,"iPhone13,2"
com.apple.MobileSMS,2,1708455471,1708455473,1708455473.953373,-21600,EB445137-D7F5-57EC-87DA-1DB460D64046,"iPhone13,2"
com.apple.MobileSMS,15,1708455260,1708455275,1708455276.7077389,-21600,EB445137-D7F5-57EC-87DA-1DB460D64046,"iPhone13,2"
com.google.chrome.ios,2,1708455258,1708455260,1708455261.5207849,-21600,EB445137-D7F5-57EC-87DA-1DB460D64046,"iPhone13,2"
com.google.chrome.ios,6,1708455056,1708455062,1708455062.294242,-21600,EB445137-D7F5-57EC-87DA-1DB460D64046,"iPhone13,2"
com.google.chrome.ios,21,1708454988,1708455009,1708455010.2166948,-21600,EB445137-D7F5-57EC-87DA-1DB460D64046,"iPhone13,2"
com.reddit.Reddit,36,1708454952,1708454988,1708454988.665835,-21600,EB445137-D7F5-57EC-87DA-1DB460D64046,"iPhone13,2"
com.google.chrome.ios,18,1708454934,1708454952,1708454952.8036308,-21600,EB445137-D7F5-57EC-87DA-1DB460D64046,"iPhone13,2"
com.apple.news,521,1708454413,1708454934,1708454934.185935,-21600,EB445137-D7F5-57EC-87DA-1DB460D64046,"iPhone13,2"
com.toyopagroup.picaboo,138,1708454274,1708454412,1708454412.7037292,-21600,EB445137-D7F5-57EC-87DA-1DB460D64046,"iPhone13,2"
com.google.chrome.ios,61,1708452154,1708452215,1708452216.284666,-21600,EB445137-D7F5-57EC-87DA-1DB460D64046,"iPhone13,2"
com.leomehlig.today,36,1708452115,1708452151,1708452151.938542,-21600,EB445137-D7F5-57EC-87DA-1DB460D64046,"iPhone13,2"
com.apple.mobilecal,10,1708452102,1708452112,1708452112.488637,-21600,EB445137-D7F5-57EC-87DA-1DB460D64046,"iPhone13,2"
com.tinyspeck.chatlyio,4,1708452098,1708452102,1708452102.120261,-21600,EB445137-D7F5-57EC-87DA-1DB460D64046,"iPhone13,2"
com.google.Sheets,40,1708452058,1708452098,1708452099.101654,-21600,EB445137-D7F5-57EC-87DA-1DB460D64046,"iPhone13,2"
com.tinyspeck.chatlyio,26,1708452032,1708452058,1708452058.918443,-21600,EB445137-D7F5-57EC-87DA-1DB460D64046,"iPhone13,2"
com.apple.mobilecal,3,1708452026,1708452029,1708452030.230051,-21600,EB445137-D7F5-57EC-87DA-1DB460D64046,"iPhone13,2"
com.apple.mobilecal,4,1708451866,1708451870,1708451870.6826959,-21600,EB445137-D7F5-57EC-87DA-1DB460D64046,"iPhone13,2"
com.instructure.icanvas,2,1708451864,1708451866,1708451866.68372,-21600,EB445137-D7F5-57EC-87DA-1DB460D64046,"iPhone13,2"
com.instructure.icanvas,12,1708451821,1708451833,1708451833.850292,-21600,EB445137-D7F5-57EC-87DA-1DB460D64046,"iPhone13,2"
com.instructure.icanvas,132,1708451638,1708451770,1708451770.9182138,-21600,EB445137-D7F5-57EC-87DA-1DB460D64046,"iPhone13,2"
com.apple.news,6,1708451629,1708451635,1708451636.338417,-21600,EB445137-D7F5-57EC-87DA-1DB460D64046,"iPhone13,2"
com.apple.news,1,1708451627,1708451628,1708451628.999436,-21600,EB445137-D7F5-57EC-87DA-1DB460D64046,"iPhone13,2"
com.apple.news,2,1708451137,1708451139,1708451139.9277658,-21600,EB445137-D7F5-57EC-87DA-1DB460D64046,"iPhone13,2"
com.apple.news,299,1708450728,1708451027,1708451028.020854,-21600,EB445137-D7F5-57EC-87DA-1DB460D64046,"iPhone13,2"
com.microsoft.Office.Outlook,30,1708449738,1708449768,1708449768.974094,-21600,EB445137-D7F5-57EC-87DA-1DB460D64046,"iPhone13,2"
edu.illinois.rokwire.ios,33,1708449705,1708449738,1708449738.127749,-21600,EB445137-D7F5-57EC-87DA-1DB460D64046,"iPhone13,2"
edu.illinois.rokwire.ios,24,1708449583,1708449607,1708449607.56846,-21600,EB445137-D7F5-57EC-87DA-1DB460D64046,"iPhone13,2"
com.microsoft.VSCode,3,1708449307,1708449310,1708449310.4903831,-21600,,
com.microsoft.VSCode,2,1708449304,1708449306,1708449306.235925,-21600,,
com.google.Chrome,15,1708449289,1708449304,1708449305.019763,-21600,,
com.leomehlig.today,25,1708449264,1708449289,1708449289.783918,-21600,,
com.google.Chrome,12,1708449252,1708449264,1708449264.273396,-21600,,
com.microsoft.VSCode,97,1708449155,1708449252,1708449252.49598,-21600,,
com.google.Chrome,16,1708449139,1708449155,1708449155.763023,-21600,,
com.microsoft.VSCode,57,1708449082,1708449139,1708449140.019949,-21600,,
com.google.Chrome,33,1708449049,1708449082,1708449082.514792,-21600,,
com.microsoft.VSCode,14,1708449035,1708449049,1708449049.963192,-21600,,
com.google.Chrome,6,1708449029,1708449035,1708449035.306294,-21600,,
com.microsoft.VSCode,16,1708449013,1708449029,1708449030.020859,-21600,,
com.google.Chrome,4,1708449009,1708449013,1708449013.080358,-21600,,
com.microsoft.VSCode,177,1708448832,1708449009,1708449009.524891,-21600,,
com.google.Chrome,1,1708448831,1708448832,1708448832.968534,-21600,,
com.microsoft.VSCode,1,1708448830,1708448831,1708448831.344707,-21600,,
com.google.Chrome,2,1708448828,1708448830,1708448830.562224,-21600,,
com.microsoft.VSCode,2,1708448826,1708448828,1708448828.6895509,-21600,,
com.google.Chrome,1,1708448825,1708448826,1708448826.980689,-21600,,
com.microsoft.VSCode,37,1708448788,1708448825,1708448825.5122108,-21600,,
com.google.Chrome,1,1708448787,1708448788,1708448788.534826,-21600,,
com.microsoft.VSCode,10,1708448777,1708448787,1708448787.242113,-21600,,
com.google.Chrome,11,1708448766,1708448777,1708448777.747855,-21600,,
com.microsoft.VSCode,28,1708448738,1708448766,1708448766.053453,-21600,,
com.google.Chrome,5,1708448733,1708448738,1708448738.763274,-21600,,
com.microsoft.VSCode,6,1708448727,1708448733,1708448733.8330011,-21600,,
com.google.Chrome,52,1708448675,1708448727,1708448727.7730942,-21600,,
com.microsoft.VSCode,76,1708448592,1708448668,1708448668.860238,-21600,,
com.google.Chrome,46,1708448546,1708448592,1708448592.797192,-21600,,
com.google.chrome.ios,20,1708448453,1708448473,1708448473.2408562,-21600,EB445137-D7F5-57EC-87DA-1DB460D64046,"iPhone13,2"
com.google.Gmail,10,1708448443,1708448453,1708448453.5819468,-21600,EB445137-D7F5-57EC-87DA-1DB460D64046,"iPhone13,2"
com.microsoft.Office.Outlook,6,1708448437,1708448443,1708448444.0043612,-21600,EB445137-D7F5-57EC-87DA-1DB460D64046,"iPhone13,2"
com.microsoft.VSCode,399,1708447958,1708448357,1708448357.109414,-21600,,
com.google.Chrome,3,1708447955,1708447958,1708447958.897717,-21600,,
com.leomehlig.today,1,1708447954,1708447955,1708447955.8090072,-21600,,
com.google.Chrome,39,1708447915,1708447954,1708447954.966368,-21600,,
com.leomehlig.today,2,1708447913,1708447915,1708447915.206522,-21600,,
com.google.Chrome,1,1708447912,1708447913,1708447913.856611,-21600,,
com.microsoft.VSCode,48,1708447864,1708447912,1708447912.641142,-21600,,
com.google.Chrome,11,1708447853,1708447864,1708447864.5992398,-21600,,
com.microsoft.Office.Outlook,14,1708447289,1708447303,1708447303.892047,-21600,EB445137-D7F5-57EC-87DA-1DB460D64046,"iPhone13,2"
com.microsoft.VSCode,1113,1708446740,1708447853,1708447854.851974,-21600,,
com.leomehlig.today,2,1708446738,1708446740,1708446740.363402,-21600,,
com.microsoft.VSCode,597,1708446141,1708446738,1708446738.489685,-21600,,
com.leomehlig.today,48,1708446093,1708446141,1708446141.943303,-21600,,
com.microsoft.VSCode,5,1708446088,1708446093,1708446093.7670379,-21600,,
com.apple.Health,3,1708446067,1708446070,1708446070.214902,-21600,EB445137-D7F5-57EC-87DA-1DB460D64046,"iPhone13,2"
com.google.Chrome,23,1708446065,1708446088,1708446088.894208,-21600,,
com.apple.Health,35,1708446029,1708446064,1708446064.5700622,-21600,EB445137-D7F5-57EC-87DA-1DB460D64046,"iPhone13,2"
com.google.Maps,2,1708446027,1708446029,1708446029.342942,-21600,EB445137-D7F5-57EC-87DA-1DB460D64046,"iPhone13,2"
com.apple.Health,83,1708445944,1708446027,1708446027.6413279,-21600,EB445137-D7F5-57EC-87DA-1DB460D64046,"iPhone13,2"
com.google.Maps,6,1708445938,1708445944,1708445944.557404,-21600,EB445137-D7F5-57EC-87DA-1DB460D64046,"iPhone13,2"
com.google.Maps,10,1708444431,1708444441,1708444441.174453,-21600,EB445137-D7F5-57EC-87DA-1DB460D64046,"iPhone13,2"
com.google.Maps,6,1708443941,1708443947,1708443947.209116,-21600,EB445137-D7F5-57EC-87DA-1DB460D64046,"iPhone13,2"
com.google.Maps,2,1708443314,1708443316,1708443316.300966,-21600,EB445137-D7F5-57EC-87DA-1DB460D64046,"iPhone13,2"
com.google.Maps,11,1708443300,1708443311,1708443311.919364,-21600,EB445137-D7F5-57EC-87DA-1DB460D64046,"iPhone13,2"
com.peacocktv.peacock,1947,1708441219,1708443166,1708443167.072192,-21600,EB445137-D7F5-57EC-87DA-1DB460D64046,"iPhone13,2"
com.google.ios.youtube,45,1708441172,1708441217,1708441217.171361,-21600,EB445137-D7F5-57EC-87DA-1DB460D64046,"iPhone13,2"
com.instructure.icanvas,138,1708440552,1708440690,1708440690.3071299,-21600,EB445137-D7F5-57EC-87DA-1DB460D64046,"iPhone13,2"
com.facebook.Facebook,6,1708440465,1708440471,1708440471.358866,-21600,EB445137-D7F5-57EC-87DA-1DB460D64046,"iPhone13,2"
com.apple.MobileSMS,12,1708440452,1708440464,1708440464.2488499,-21600,EB445137-D7F5-57EC-87DA-1DB460D64046,"iPhone13,2"
com.apple.Health,26,1708440425,1708440451,1708440451.5190969,-21600,EB445137-D7F5-57EC-87DA-1DB460D64046,"iPhone13,2"
com.google.Maps,12,1708440409,1708440421,1708440421.493908,-21600,EB445137-D7F5-57EC-87DA-1DB460D64046,"iPhone13,2"
com.thestorygraph.thestorygraph,49,1708407121,1708407170,1708407170.8972468,-21600,EB445137-D7F5-57EC-87DA-1DB460D64046,"iPhone13,2"
com.thestorygraph.thestorygraph,14,1708407106,1708407120,1708407120.709105,-21600,EB445137-D7F5-57EC-87DA-1DB460D64046,"iPhone13,2"
com.thestorygraph.thestorygraph,12,1708407066,1708407078,1708407078.5920959,-21600,EB445137-D7F5-57EC-87DA-1DB460D64046,"iPhone13,2"
com.google.chrome.ios,92,1708404757,1708404849,1708404849.2542381,-21600,EB445137-D7F5-57EC-87DA-1DB460D64046,"iPhone13,2"
com.thestorygraph.thestorygraph,2,1708404755,1708404757,1708404757.494844,-21600,EB445137-D7F5-57EC-87DA-1DB460D64046,"iPhone13,2"
com.thestorygraph.thestorygraph,3,1708404682,1708404685,1708404685.243953,-21600,EB445137-D7F5-57EC-87DA-1DB460D64046,"iPhone13,2"
com.thestorygraph.thestorygraph,24,1708403892,1708403916,1708403916.2620149,-21600,EB445137-D7F5-57EC-87DA-1DB460D64046,"iPhone13,2"
com.apple.Health,20,1708403723,1708403743,1708403743.9765859,-21600,EB445137-D7F5-57EC-87DA-1DB460D64046,"iPhone13,2"
com.apple.MobileSMS,14,1708403705,1708403719,1708403719.149116,-21600,EB445137-D7F5-57EC-87DA-1DB460D64046,"iPhone13,2"
com.google.chrome.ios,235,1708403470,1708403705,1708403705.783315,-21600,EB445137-D7F5-57EC-87DA-1DB460D64046,"iPhone13,2"
com.apple.MobileSMS,11,1708403459,1708403470,1708403470.187275,-21600,EB445137-D7F5-57EC-87DA-1DB460D64046,"iPhone13,2"
com.google.Chrome,564,1708403301,1708403865,1708403865.5589728,-21600,,
com.google.Chrome,301,1708402597,1708402898,1708402898.0697908,-21600,,
com.toyopagroup.picaboo,22,1708402493,1708402515,1708402516.0110788,-21600,EB445137-D7F5-57EC-87DA-1DB460D64046,"iPhone13,2"
com.apple.Health,9,1708402483,1708402492,1708402492.97396,-21600,EB445137-D7F5-57EC-87DA-1DB460D64046,"iPhone13,2"
com.apple.Health,8,1708402206,1708402214,1708402214.1312141,-21600,EB445137-D7F5-57EC-87DA-1DB460D64046,"iPhone13,2"
com.google.Chrome,515,1708402051,1708402566,1708402566.9987211,-21600,,
com.apple.finder,29,1708402022,1708402051,1708402052.045062,-21600,,
com.apple.Health,5,1708400316,1708400321,1708400322.366761,-21600,EB445137-D7F5-57EC-87DA-1DB460D64046,"iPhone13,2"
com.apple.Health,23,1708400181,1708400204,1708400205.110417,-21600,EB445137-D7F5-57EC-87DA-1DB460D64046,"iPhone13,2"
com.hammerandchisel.discord,7,1708400170,1708400177,1708400177.986906,-21600,EB445137-D7F5-57EC-87DA-1DB460D64046,"iPhone13,2"
com.hammerandchisel.discord,6,1708396179,1708396185,1708396185.837037,-21600,EB445137-D7F5-57EC-87DA-1DB460D64046,"iPhone13,2"
com.apple.Health,4,1708396175,1708396179,1708396179.456044,-21600,EB445137-D7F5-57EC-87DA-1DB460D64046,"iPhone13,2"
com.apple.finder,36,1708395720,1708395756,1708395756.1178288,-21600,,
com.microsoft.VSCode,3,1708395717,1708395720,1708395720.6422791,-21600,,
com.apple.finder,46,1708395671,1708395717,1708395717.176326,-21600,,
com.apple.Health,132,1708395446,1708395578,1708395578.7173429,-21600,EB445137-D7F5-57EC-87DA-1DB460D64046,"iPhone13,2"
com.microsoft.VSCode,474,1708395197,1708395671,1708395672.01335,-21600,,
com.apple.finder,5,1708395192,1708395197,1708395197.3444982,-21600,,
com.microsoft.VSCode,56,1708395136,1708395192,1708395192.878331,-21600,,
com.apple.MobileSMS,4,1708394999,1708395003,1708395003.593287,-21600,EB445137-D7F5-57EC-87DA-1DB460D64046,"iPhone13,2"
com.hammerandchisel.discord,11,1708394988,1708394999,1708394999.3858662,-21600,EB445137-D7F5-57EC-87DA-1DB460D64046,"iPhone13,2"
com.microsoft.Office.Outlook,5,1708394983,1708394988,1708394989.1025748,-21600,EB445137-D7F5-57EC-87DA-1DB460D64046,"iPhone13,2"
com.apple.finder,162,1708394974,1708395136,1708395136.62572,-21600,,
com.microsoft.VSCode,21,1708394953,1708394974,1708394975.0318952,-21600,,
com.leomehlig.today,136,1708394817,1708394953,1708394953.5874748,-21600,,
com.apple.Notes,4,1708394813,1708394817,1708394817.196281,-21600,,
com.leomehlig.today,6,1708394807,1708394813,1708394814.052475,-21600,,
com.apple.Notes,44,1708394763,1708394807,1708394807.1563,-21600,,
com.leomehlig.today,25,1708394738,1708394763,1708394763.942451,-21600,,
com.google.Chrome,20,1708394718,1708394738,1708394738.3281689,-21600,,
com.leomehlig.today,33,1708394685,1708394718,1708394718.108742,-21600,,
com.google.Chrome,14,1708394671,1708394685,1708394685.723302,-21600,,
com.leomehlig.today,38,1708394633,1708394671,1708394671.226314,-21600,,
com.google.Chrome,135,1708394498,1708394633,1708394633.659696,-21600,,
com.leomehlig.today,180,1708394318,1708394498,1708394498.319902,-21600,,
com.microsoft.VSCode,133,1708394185,1708394318,1708394318.52585,-21600,,
com.google.Chrome,1,1708394184,1708394185,1708394185.292221,-21600,,
com.microsoft.VSCode,2,1708394182,1708394184,1708394184.198108,-21600,,
com.google.Chrome,1,1708394181,1708394182,1708394182.780581,-21600,,
com.microsoft.VSCode,110,1708394071,1708394181,1708394181.8613272,-21600,,
com.google.Chrome,0,1708394071,1708394071,1708394071.910845,-21600,,
com.microsoft.VSCode,12,1708394059,1708394071,1708394071.114083,-21600,,
com.google.Chrome,1,1708394058,1708394059,1708394059.529824,-21600,,
com.microsoft.Office.Outlook,5,1708394013,1708394018,1708394018.3596911,-21600,EB445137-D7F5-57EC-87DA-1DB460D64046,"iPhone13,2"
com.microsoft.VSCode,768,1708393290,1708394058,1708394059.008925,-21600,,
com.google.Chrome,5,1708393285,1708393290,1708393290.767486,-21600,,
com.microsoft.VSCode,11,1708393274,1708393285,1708393285.23416,-21600,,
com.google.Chrome,140,1708393134,1708393274,1708393274.812402,-21600,,
com.microsoft.Office.Outlook,6,1708392754,1708392760,1708392760.140549,-21600,EB445137-D7F5-57EC-87DA-1DB460D64046,"iPhone13,2"
com.microsoft.Office.Outlook,2,1708392751,1708392753,1708392753.050181,-21600,EB445137-D7F5-57EC-87DA-1DB460D64046,"iPhone13,2"
com.microsoft.VSCode,393,1708392741,1708393134,1708393135.757895,-21600,,
com.apple.finder,4,1708392737,1708392741,1708392741.197581,-21600,,
com.google.Chrome,8,1708392729,1708392737,1708392737.5820742,-21600,,
com.leomehlig.today,33,1708392696,1708392729,1708392729.316815,-21600,,
com.google.Chrome,218,1708392478,1708392696,1708392696.792354,-21600,,
com.apple.Preview,76,1708392402,1708392478,1708392478.932891,-21600,,
com.microsoft.Office.Outlook,2,1708391873,1708391875,1708391875.7316499,-21600,EB445137-D7F5-57EC-87DA-1DB460D64046,"iPhone13,2"
com.google.Chrome,530,1708391872,1708392402,1708392402.84863,-21600,,
com.google.Chrome,301,1708391568,1708391869,1708391869.0250359,-21600,,
com.google.Chrome,588,1708390978,1708391566,1708391566.1292171,-21600,,
com.leomehlig.today,1,1708390977,1708390978,1708390979.0039902,-21600,,
com.microsoft.Office.Outlook,6,1708390779,1708390785,1708390785.645067,-21600,EB445137-D7F5-57EC-87DA-1DB460D64046,"iPhone13,2"
com.microsoft.Office.Outlook,1,1708390777,1708390778,1708390778.8141131,-21600,EB445137-D7F5-57EC-87DA-1DB460D64046,"iPhone13,2"
com.microsoft.Office.Outlook,4,1708390772,1708390776,1708390776.948875,-21600,EB445137-D7F5-57EC-87DA-1DB460D64046,"iPhone13,2"
com.apple.Preview,211,1708390766,1708390977,1708390978.0546532,-21600,,
com.leomehlig.today,11,1708390755,1708390766,1708390766.2975311,-21600,,
com.apple.Preview,0,1708390755,1708390755,1708390756.097011,-21600,,
com.microsoft.Office.Outlook,12,1708390204,1708390216,1708390216.268643,-21600,EB445137-D7F5-57EC-87DA-1DB460D64046,"iPhone13,2"
com.google.Chrome,697,1708390058,1708390755,1708390755.5294518,-21600,,
com.google.Chrome,434,1708389622,1708390056,1708390056.9435658,-21600,,
com.microsoft.Office.Outlook,3,1708389593,1708389596,1708389596.879957,-21600,EB445137-D7F5-57EC-87DA-1DB460D64046,"iPhone13,2"
com.google.Chrome,313,1708389308,1708389621,1708389621.0220342,-21600,,
com.apple.Preview,33,1708389275,1708389308,1708389308.179731,-21600,,
com.google.Chrome,73,1708389202,1708389275,1708389275.515818,-21600,,
com.apple.Preview,131,1708389071,1708389202,1708389202.327458,-21600,,
com.google.Chrome,2,1708389069,1708389071,1708389071.132976,-21600,,
com.apple.Preview,231,1708388838,1708389069,1708389069.5659618,-21600,,
com.google.Chrome,12,1708388826,1708388838,1708388838.796047,-21600,,
com.apple.Preview,5,1708388821,1708388826,1708388826.740556,-21600,,
com.google.Chrome,3,1708388818,1708388821,1708388821.620671,-21600,,
com.apple.Preview,7,1708388811,1708388818,1708388818.191897,-21600,,
com.google.Chrome,1,1708388810,1708388811,1708388811.910404,-21600,,
com.apple.Preview,23,1708388787,1708388810,1708388810.2403069,-21600,,
com.google.Chrome,11,1708388776,1708388787,1708388787.82247,-21600,,
com.apple.Preview,26,1708388750,1708388776,1708388776.436034,-21600,,
com.google.Chrome,43,1708388707,1708388750,1708388750.582748,-21600,,
com.apple.Preview,2,1708388705,1708388707,1708388707.337261,-21600,,
com.google.Chrome,5,1708388700,1708388705,1708388705.266944,-21600,,
com.apple.Preview,6,1708388694,1708388700,1708388700.985172,-21600,,
com.google.Chrome,38,1708388656,1708388694,1708388694.74436,-21600,,
com.apple.Preview,11,1708388645,1708388656,1708388656.846375,-21600,,
com.google.Chrome,4,1708388641,1708388645,1708388645.553098,-21600,,
com.apple.Preview,6,1708388635,1708388641,1708388641.508847,-21600,,
com.google.Chrome,42,1708388593,1708388635,1708388635.9499788,-21600,,
com.apple.Preview,6,1708388587,1708388593,1708388593.4146008,-21600,,
com.google.Chrome,5,1708388582,1708388587,1708388587.265215,-21600,,
com.apple.Preview,17,1708388565,1708388582,1708388582.745595,-21600,,
com.google.Chrome,65,1708388500,1708388565,1708388565.7958999,-21600,,
com.leomehlig.today,48,1708388452,1708388500,1708388500.144831,-21600,,
com.apple.iCal,28,1708388424,1708388452,1708388453.065486,-21600,,
com.leomehlig.today,11,1708388413,1708388424,1708388424.609107,-21600,,
com.microsoft.Office.Outlook,19,1708388275,1708388294,1708388294.613778,-21600,EB445137-D7F5-57EC-87DA-1DB460D64046,"iPhone13,2"
com.google.Chrome,139,1708388274,1708388413,1708388413.111682,-21600,,
edu.illinois.rokwire.ios,8,1708388267,1708388275,1708388276.012167,-21600,EB445137-D7F5-57EC-87DA-1DB460D64046,"iPhone13,2"
com.apple.Preview,218,1708387366,1708387584,1708387584.7634559,-21600,,
com.apple.finder,2,1708387364,1708387366,1708387366.416702,-21600,,
edu.illinois.rokwire.ios,13,1708386847,1708386860,1708386860.794512,-21600,EB445137-D7F5-57EC-87DA-1DB460D64046,"iPhone13,2"
com.google.Chrome,557,1708386807,1708387364,1708387364.738576,-21600,,
edu.illinois.rokwire.ios,5,1708386670,1708386675,1708386675.431521,-21600,EB445137-D7F5-57EC-87DA-1DB460D64046,"iPhone13,2"
edu.illinois.rokwire.ios,9,1708385796,1708385805,1708385805.3181949,-21600,EB445137-D7F5-57EC-87DA-1DB460D64046,"iPhone13,2"
edu.illinois.rokwire.ios,13,1708385781,1708385794,1708385794.19853,-21600,EB445137-D7F5-57EC-87DA-1DB460D64046,"iPhone13,2"
com.apple.mobileslideshow,2,1708385775,1708385777,1708385777.99819,-21600,EB445137-D7F5-57EC-87DA-1DB460D64046,"iPhone13,2"
com.apple.mobileslideshow,4,1708385513,1708385517,1708385517.518036,-21600,EB445137-D7F5-57EC-87DA-1DB460D64046,"iPhone13,2"
com.apple.mobileslideshow,130,1708384715,1708384845,1708384845.6556349,-21600,EB445137-D7F5-57EC-87DA-1DB460D64046,"iPhone13,2"
com.apple.journal,4,1708384698,1708384702,1708384702.1312962,-21600,EB445137-D7F5-57EC-87DA-1DB460D64046,"iPhone13,2"
com.apple.journal,1,1708384694,1708384695,1708384695.837452,-21600,EB445137-D7F5-57EC-87DA-1DB460D64046,"iPhone13,2"
com.apple.journal,146,1708384337,1708384483,1708384483.017304,-21600,EB445137-D7F5-57EC-87DA-1DB460D64046,"iPhone13,2"
com.google.Chrome,408,1708383758,1708384166,1708384166.5693111,-21600,,
com.apple.finder,157,1708383601,1708383758,1708383758.1768122,-21600,,
com.apple.MobileSMS,7,1708383304,1708383311,1708383311.877764,-21600,EB445137-D7F5-57EC-87DA-1DB460D64046,"iPhone13,2"
com.toyopagroup.picaboo,76,1708383226,1708383302,1708383302.8835459,-21600,EB445137-D7F5-57EC-87DA-1DB460D64046,"iPhone13,2"
com.hammerandchisel.discord,2,1708383224,1708383226,1708383226.200633,-21600,EB445137-D7F5-57EC-87DA-1DB460D64046,"iPhone13,2"
com.hammerandchisel.discord,185,1708383038,1708383223,1708383223.40908,-21600,EB445137-D7F5-57EC-87DA-1DB460D64046,"iPhone13,2"
com.truebill.truebillnative,76,1708382940,1708383016,1708383016.134074,-21600,EB445137-D7F5-57EC-87DA-1DB460D64046,"iPhone13,2"
com.microsoft.Office.Outlook,70,1708382863,1708382933,1708382933.7670898,-21600,EB445137-D7F5-57EC-87DA-1DB460D64046,"iPhone13,2"
com.thestorygraph.thestorygraph,220,1708382639,1708382859,1708382859.756781,-21600,EB445137-D7F5-57EC-87DA-1DB460D64046,"iPhone13,2"
com.google.chrome.ios,63,1708382576,1708382639,1708382639.958133,-21600,EB445137-D7F5-57EC-87DA-1DB460D64046,"iPhone13,2"
com.thestorygraph.thestorygraph,30,1708382546,1708382576,1708382576.496479,-21600,EB445137-D7F5-57EC-87DA-1DB460D64046,"iPhone13,2"
com.google.chrome.ios,4,1708382542,1708382546,1708382546.7203689,-21600,EB445137-D7F5-57EC-87DA-1DB460D64046,"iPhone13,2"
com.thestorygraph.thestorygraph,15,1708382527,1708382542,1708382542.191227,-21600,EB445137-D7F5-57EC-87DA-1DB460D64046,"iPhone13,2"
com.google.chrome.ios,88,1708382439,1708382527,1708382527.032033,-21600,EB445137-D7F5-57EC-87DA-1DB460D64046,"iPhone13,2"
com.thestorygraph.thestorygraph,68,1708382370,1708382438,1708382438.5931249,-21600,EB445137-D7F5-57EC-87DA-1DB460D64046,"iPhone13,2"
com.apple.mobileslideshow,87,1708382261,1708382348,1708382348.270646,-21600,EB445137-D7F5-57EC-87DA-1DB460D64046,"iPhone13,2"
edu.illinois.rokwire.ios,3,1708382255,1708382258,1708382258.101088,-21600,EB445137-D7F5-57EC-87DA-1DB460D64046,"iPhone13,2"
edu.illinois.rokwire.ios,6,1708382204,1708382210,1708382210.6446009,-21600,EB445137-D7F5-57EC-87DA-1DB460D64046,"iPhone13,2"
edu.illinois.rokwire.ios,18,1708382165,1708382183,1708382183.049166,-21600,EB445137-D7F5-57EC-87DA-1DB460D64046,"iPhone13,2"
com.google.ios.youtube,551,1708381598,1708382149,1708382150.0382462,-21600,EB445137-D7F5-57EC-87DA-1DB460D64046,"iPhone13,2"
com.reddit.Reddit,4,1708381592,1708381596,1708381596.219583,-21600,EB445137-D7F5-57EC-87DA-1DB460D64046,"iPhone13,2"
com.reddit.Reddit,9,1708380418,1708380427,1708380427.152334,-21600,EB445137-D7F5-57EC-87DA-1DB460D64046,"iPhone13,2"
com.reddit.Reddit,1,1708378439,1708378440,1708378440.8534389,-21600,EB445137-D7F5-57EC-87DA-1DB460D64046,"iPhone13,2"
com.reddit.Reddit,53,1708378371,1708378424,1708378424.515518,-21600,EB445137-D7F5-57EC-87DA-1DB460D64046,"iPhone13,2"
com.google.chrome.ios,231,1708378140,1708378371,1708378371.1995978,-21600,EB445137-D7F5-57EC-87DA-1DB460D64046,"iPhone13,2"
com.google.ios.youtube,116,1708378024,1708378140,1708378140.367172,-21600,EB445137-D7F5-57EC-87DA-1DB460D64046,"iPhone13,2"
com.google.chrome.ios,50,1708377974,1708378024,1708378024.432242,-21600,EB445137-D7F5-57EC-87DA-1DB460D64046,"iPhone13,2"
com.google.ios.youtube,205,1708377769,1708377974,1708377974.444238,-21600,EB445137-D7F5-57EC-87DA-1DB460D64046,"iPhone13,2"
com.google.chrome.ios,3,1708377766,1708377769,1708377769.1008182,-21600,EB445137-D7F5-57EC-87DA-1DB460D64046,"iPhone13,2"
com.apple.Music,11,1708377753,1708377764,1708377764.927607,-21600,EB445137-D7F5-57EC-87DA-1DB460D64046,"iPhone13,2"
com.apple.Music,6,1708377632,1708377638,1708377638.491729,-21600,EB445137-D7F5-57EC-87DA-1DB460D64046,"iPhone13,2"
com.apple.Music,5,1708377460,1708377465,1708377465.102481,-21600,EB445137-D7F5-57EC-87DA-1DB460D64046,"iPhone13,2"
com.apple.Music,3,1708377319,1708377322,1708377322.058803,-21600,EB445137-D7F5-57EC-87DA-1DB460D64046,"iPhone13,2"
com.apple.Music,5,1708377164,1708377169,1708377169.5148191,-21600,EB445137-D7F5-57EC-87DA-1DB460D64046,"iPhone13,2"
com.apple.Music,6,1708377106,1708377112,1708377112.484136,-21600,EB445137-D7F5-57EC-87DA-1DB460D64046,"iPhone13,2"
com.apple.Music,13,1708377090,1708377103,1708377103.920259,-21600,EB445137-D7F5-57EC-87DA-1DB460D64046,"iPhone13,2"
com.instructure.icanvas,0,1708377024,1708377024,1708377024.623285,-21600,EB445137-D7F5-57EC-87DA-1DB460D64046,"iPhone13,2"
com.instructure.icanvas,2,1708377021,1708377023,1708377023.8416982,-21600,EB445137-D7F5-57EC-87DA-1DB460D64046,"iPhone13,2"
com.instructure.icanvas,11,1708376883,1708376894,1708376894.688268,-21600,EB445137-D7F5-57EC-87DA-1DB460D64046,"iPhone13,2"
com.instructure.icanvas,3,1708376877,1708376880,1708376880.938091,-21600,EB445137-D7F5-57EC-87DA-1DB460D64046,"iPhone13,2"
com.instructure.icanvas,6,1708375196,1708375202,1708375202.393649,-21600,EB445137-D7F5-57EC-87DA-1DB460D64046,"iPhone13,2"
com.instructure.icanvas,17,1708375032,1708375049,1708375049.138276,-21600,EB445137-D7F5-57EC-87DA-1DB460D64046,"iPhone13,2"
com.microsoft.Office.Outlook,7,1708375025,1708375032,1708375032.529484,-21600,EB445137-D7F5-57EC-87DA-1DB460D64046,"iPhone13,2"
com.microsoft.Office.Outlook,10,1708375014,1708375024,1708375024.398103,-21600,EB445137-D7F5-57EC-87DA-1DB460D64046,"iPhone13,2"
com.microsoft.Office.Outlook,80,1708374918,1708374998,1708374998.3511438,-21600,EB445137-D7F5-57EC-87DA-1DB460D64046,"iPhone13,2"
com.apple.news,31,1708372918,1708372949,1708372950.0193648,-21600,EB445137-D7F5-57EC-87DA-1DB460D64046,"iPhone13,2"
com.apple.news,160,1708372723,1708372883,1708372883.3140569,-21600,EB445137-D7F5-57EC-87DA-1DB460D64046,"iPhone13,2"
com.tier9digital.sundial,14,1708372680,1708372694,1708372694.8869271,-21600,EB445137-D7F5-57EC-87DA-1DB460D64046,"iPhone13,2"
Astrospheric.Astrospheric,109,1708372567,1708372676,1708372676.450536,-21600,EB445137-D7F5-57EC-87DA-1DB460D64046,"iPhone13,2"
com.apple.weather,6,1708372560,1708372566,1708372566.8497,-21600,EB445137-D7F5-57EC-87DA-1DB460D64046,"iPhone13,2"
com.google.chrome.ios,73,1708369003,1708369076,1708369076.3241758,-21600,EB445137-D7F5-57EC-87DA-1DB460D64046,"iPhone13,2"
com.leomehlig.today,21,1708368978,1708368999,1708368999.298592,-21600,EB445137-D7F5-57EC-87DA-1DB460D64046,"iPhone13,2"
com.apple.mobilecal,11,1708368964,1708368975,1708368975.8625011,-21600,EB445137-D7F5-57EC-87DA-1DB460D64046,"iPhone13,2"
com.apple.camera,4,1708368775,1708368779,1708368779.746021,-21600,EB445137-D7F5-57EC-87DA-1DB460D64046,"iPhone13,2"
com.burbn.instagram,7,1708367596,1708367603,1708367603.495785,-21600,EB445137-D7F5-57EC-87DA-1DB460D64046,"iPhone13,2"
com.burbn.instagram,62,1708367126,1708367188,1708367188.9856238,-21600,EB445137-D7F5-57EC-87DA-1DB460D64046,"iPhone13,2"
edu.illinois.rokwire.ios,20,1708367105,1708367125,1708367125.634128,-21600,EB445137-D7F5-57EC-87DA-1DB460D64046,"iPhone13,2"
edu.illinois.rokwire.ios,10,1708366488,1708366498,1708366498.428644,-21600,EB445137-D7F5-57EC-87DA-1DB460D64046,"iPhone13,2"
edu.illinois.rokwire.ios,3,1708366483,1708366486,1708366486.7464771,-21600,EB445137-D7F5-57EC-87DA-1DB460D64046,"iPhone13,2"
edu.illinois.rokwire.ios,2,1708366467,1708366469,1708366469.8593311,-21600,EB445137-D7F5-57EC-87DA-1DB460D64046,"iPhone13,2"
edu.illinois.rokwire.ios,32,1708365059,1708365091,1708365091.826182,-21600,EB445137-D7F5-57EC-87DA-1DB460D64046,"iPhone13,2"
com.apple.Health,5,1708365053,1708365058,1708365058.581198,-21600,EB445137-D7F5-57EC-87DA-1DB460D64046,"iPhone13,2"
com.apple.Health,155,1708364090,1708364245,1708364245.6885371,-21600,EB445137-D7F5-57EC-87DA-1DB460D64046,"iPhone13,2"
com.microsoft.Office.Outlook,5,1708364085,1708364090,1708364090.737475,-21600,EB445137-D7F5-57EC-87DA-1DB460D64046,"iPhone13,2"
com.microsoft.Office.Outlook,6,1708364076,1708364082,1708364082.610949,-21600,EB445137-D7F5-57EC-87DA-1DB460D64046,"iPhone13,2"
com.microsoft.Office.Outlook,35,1708363482,1708363517,1708363517.959406,-21600,EB445137-D7F5-57EC-87DA-1DB460D64046,"iPhone13,2"
com.apple.MobileSMS,3,1708363210,1708363213,1708363213.52313,-21600,EB445137-D7F5-57EC-87DA-1DB460D64046,"iPhone13,2"
com.instructure.icanvas,8,1708363199,1708363207,1708363207.3521519,-21600,EB445137-D7F5-57EC-87DA-1DB460D64046,"iPhone13,2"
com.microsoft.Office.Outlook,13,1708363184,1708363197,1708363197.3521461,-21600,EB445137-D7F5-57EC-87DA-1DB460D64046,"iPhone13,2"
com.toyopagroup.picaboo,67,1708363116,1708363183,1708363183.774582,-21600,EB445137-D7F5-57EC-87DA-1DB460D64046,"iPhone13,2"
com.apple.MobileSMS,4,1708362133,1708362137,1708362137.3884091,-21600,EB445137-D7F5-57EC-87DA-1DB460D64046,"iPhone13,2"
com.apple.MobileSMS,2,1708361022,1708361024,1708361024.919435,-21600,EB445137-D7F5-57EC-87DA-1DB460D64046,"iPhone13,2"
com.apple.weather,6,1708361016,1708361022,1708361022.730702,-21600,EB445137-D7F5-57EC-87DA-1DB460D64046,"iPhone13,2"
com.apple.weather,3,1708360920,1708360923,1708360923.4722018,-21600,EB445137-D7F5-57EC-87DA-1DB460D64046,"iPhone13,2"
com.apple.weather,7,1708360574,1708360581,1708360581.930167,-21600,EB445137-D7F5-57EC-87DA-1DB460D64046,"iPhone13,2"
com.apple.Health,3,1708360571,1708360574,1708360574.3110418,-21600,EB445137-D7F5-57EC-87DA-1DB460D64046,"iPhone13,2"
com.apple.Health,1,1708360503,1708360504,1708360504.468627,-21600,EB445137-D7F5-57EC-87DA-1DB460D64046,"iPhone13,2"
com.apple.Health,14,1708360481,1708360495,1708360495.3963308,-21600,EB445137-D7F5-57EC-87DA-1DB460D64046,"iPhone13,2"
com.microsoft.Office.Outlook,12,1708360381,1708360393,1708360393.1286302,-21600,EB445137-D7F5-57EC-87DA-1DB460D64046,"iPhone13,2"
com.toyopagroup.picaboo,3,1708359514,1708359517,1708359517.808749,-21600,EB445137-D7F5-57EC-87DA-1DB460D64046,"iPhone13,2"
com.apple.MobileSMS,8,1708359506,1708359514,1708359515.1675348,-21600,EB445137-D7F5-57EC-87DA-1DB460D64046,"iPhone13,2"
com.apple.MobileSMS,10,1708358432,1708358442,1708358442.730113,-21600,EB445137-D7F5-57EC-87DA-1DB460D64046,"iPhone13,2"
com.apple.MobileSMS,9,1708357887,1708357896,1708357896.0454512,-21600,EB445137-D7F5-57EC-87DA-1DB460D64046,"iPhone13,2"
com.apple.MobileSMS,5,1708357878,1708357883,1708357883.884225,-21600,EB445137-D7F5-57EC-87DA-1DB460D64046,"iPhone13,2"
com.apple.mobilecal,24,1708357854,1708357878,1708357878.7142591,-21600,EB445137-D7F5-57EC-87DA-1DB460D64046,"iPhone13,2"
com.apple.MobileSMS,14,1708357838,1708357852,1708357852.6880279,-21600,EB445137-D7F5-57EC-87DA-1DB460D64046,"iPhone13,2"
com.apple.MobileSMS,8,1708357728,1708357736,1708357736.8727012,-21600,EB445137-D7F5-57EC-87DA-1DB460D64046,"iPhone13,2"
com.apple.MobileSMS,2,1708357722,1708357724,1708357724.6783252,-21600,EB445137-D7F5-57EC-87DA-1DB460D64046,"iPhone13,2"
com.hammerandchisel.discord,32,1708357689,1708357721,1708357722.07816,-21600,EB445137-D7F5-57EC-87DA-1DB460D64046,"iPhone13,2"
com.apple.findmy,2,1708357687,1708357689,1708357690.007334,-21600,EB445137-D7F5-57EC-87DA-1DB460D64046,"iPhone13,2"
com.apple.MobileSMS,7,1708357678,1708357685,1708357685.888324,-21600,EB445137-D7F5-57EC-87DA-1DB460D64046,"iPhone13,2"
com.apple.findmy,5,1708357673,1708357678,1708357678.684118,-21600,EB445137-D7F5-57EC-87DA-1DB460D64046,"iPhone13,2"
com.hammerandchisel.discord,2,1708357670,1708357672,1708357673.0519152,-21600,EB445137-D7F5-57EC-87DA-1DB460D64046,"iPhone13,2"
co.hinge.mobile.ios,24,1708357645,1708357669,1708357669.486722,-21600,EB445137-D7F5-57EC-87DA-1DB460D64046,"iPhone13,2"
com.apple.MobileSMS,15,1708357628,1708357643,1708357643.364434,-21600,EB445137-D7F5-57EC-87DA-1DB460D64046,"iPhone13,2"
com.google.Maps,2,1708357626,1708357628,1708357629.143852,-21600,EB445137-D7F5-57EC-87DA-1DB460D64046,"iPhone13,2"
com.google.Maps,6,1708357478,1708357484,1708357484.529807,-21600,EB445137-D7F5-57EC-87DA-1DB460D64046,"iPhone13,2"
com.google.Maps,6,1708357471,1708357477,1708357477.678577,-21600,EB445137-D7F5-57EC-87DA-1DB460D64046,"iPhone13,2"
com.google.Maps,6,1708357309,1708357315,1708357315.527894,-21600,EB445137-D7F5-57EC-87DA-1DB460D64046,"iPhone13,2"
com.google.Maps,10,1708356814,1708356824,1708356824.774531,-21600,EB445137-D7F5-57EC-87DA-1DB460D64046,"iPhone13,2"
com.apple.Music,3,1708356811,1708356814,1708356814.0773249,-21600,EB445137-D7F5-57EC-87DA-1DB460D64046,"iPhone13,2"
com.apple.Music,3,1708356700,1708356703,1708356703.849666,-21600,EB445137-D7F5-57EC-87DA-1DB460D64046,"iPhone13,2"
com.apple.Music,41,1708356626,1708356667,1708356667.073149,-21600,EB445137-D7F5-57EC-87DA-1DB460D64046,"iPhone13,2"
com.peacocktv.peacock,1518,1708355112,1708356630,1708356630.655562,-21600,EB445137-D7F5-57EC-87DA-1DB460D64046,"iPhone13,2"
com.google.Maps,7,1708355100,1708355107,1708355107.1479158,-21600,EB445137-D7F5-57EC-87DA-1DB460D64046,"iPhone13,2"
com.google.Maps,6,1708355019,1708355025,1708355025.5890188,-21600,EB445137-D7F5-57EC-87DA-1DB460D64046,"iPhone13,2"
com.google.Maps,6,1708354894,1708354900,1708354900.748643,-21600,EB445137-D7F5-57EC-87DA-1DB460D64046,"iPhone13,2"
com.google.Maps,17,1708354379,1708354396,1708354396.112895,-21600,EB445137-D7F5-57EC-87DA-1DB460D64046,"iPhone13,2"
com.apple.Health,38,1708354341,1708354379,1708354379.723987,-21600,EB445137-D7F5-57EC-87DA-1DB460D64046,"iPhone13,2"
com.microsoft.Office.Outlook,22,1708354236,1708354258,1708354259.026888,-21600,EB445137-D7F5-57EC-87DA-1DB460D64046,"iPhone13,2"
com.apple.Health,28,1708320575,1708320603,1708320603.4222999,-21600,EB445137-D7F5-57EC-87DA-1DB460D64046,"iPhone13,2"
com.thestorygraph.thestorygraph,9,1708320561,1708320570,1708320570.616463,-21600,EB445137-D7F5-57EC-87DA-1DB460D64046,"iPhone13,2"
com.goodreads.Goodreads,2,1708320559,1708320561,1708320561.86532,-21600,EB445137-D7F5-57EC-87DA-1DB460D64046,"iPhone13,2"
com.goodreads.Goodreads,10,1708320467,1708320477,1708320477.373692,-21600,EB445137-D7F5-57EC-87DA-1DB460D64046,"iPhone13,2"
com.goodreads.Goodreads,9,1708320381,1708320390,1708320390.137968,-21600,EB445137-D7F5-57EC-87DA-1DB460D64046,"iPhone13,2"
com.goodreads.Goodreads,2,1708319998,1708320000,1708320000.216031,-21600,EB445137-D7F5-57EC-87DA-1DB460D64046,"iPhone13,2"
com.goodreads.Goodreads,11,1708319447,1708319458,1708319458.909998,-21600,EB445137-D7F5-57EC-87DA-1DB460D64046,"iPhone13,2"
com.goodreads.Goodreads,3,1708319432,1708319435,1708319435.451847,-21600,EB445137-D7F5-57EC-87DA-1DB460D64046,"iPhone13,2"
com.goodreads.Goodreads,10,1708319327,1708319337,1708319337.65829,-21600,EB445137-D7F5-57EC-87DA-1DB460D64046,"iPhone13,2"
com.goodreads.Goodreads,18,1708319308,1708319326,1708319326.3246121,-21600,EB445137-D7F5-57EC-87DA-1DB460D64046,"iPhone13,2"
com.thestorygraph.thestorygraph,17,1708319291,1708319308,1708319308.220099,-21600,EB445137-D7F5-57EC-87DA-1DB460D64046,"iPhone13,2"
com.toyopagroup.picaboo,17,1708319273,1708319290,1708319290.234116,-21600,EB445137-D7F5-57EC-87DA-1DB460D64046,"iPhone13,2"
com.google.chrome.ios,311,1708318867,1708319178,1708319178.207447,-21600,EB445137-D7F5-57EC-87DA-1DB460D64046,"iPhone13,2"
com.thestorygraph.thestorygraph,8,1708318858,1708318866,1708318867.088722,-21600,EB445137-D7F5-57EC-87DA-1DB460D64046,"iPhone13,2"
com.thestorygraph.thestorygraph,2,1708318856,1708318858,1708318858.336261,-21600,EB445137-D7F5-57EC-87DA-1DB460D64046,"iPhone13,2"
com.apple.camera,0,1708318856,1708318856,1708318857.004016,-21600,EB445137-D7F5-57EC-87DA-1DB460D64046,"iPhone13,2"
com.thestorygraph.thestorygraph,10,1708318834,1708318844,1708318844.860777,-21600,EB445137-D7F5-57EC-87DA-1DB460D64046,"iPhone13,2"
com.thestorygraph.thestorygraph,67,1708318740,1708318807,1708318807.995442,-21600,EB445137-D7F5-57EC-87DA-1DB460D64046,"iPhone13,2"
com.google.chrome.ios,9,1708318731,1708318740,1708318740.715975,-21600,EB445137-D7F5-57EC-87DA-1DB460D64046,"iPhone13,2"
com.apple.finder,5,1708316523,1708316528,1708316528.1374369,-21600,,
com.google.Chrome,2,1708316521,1708316523,1708316523.589344,-21600,,
com.apple.Preview,1,1708316520,1708316521,1708316521.73943,-21600,,
com.apple.finder,2,1708316518,1708316520,1708316520.6084352,-21600,,
com.apple.iCal,15,1708316503,1708316518,1708316518.82612,-21600,,
com.google.Chrome,7,1708316496,1708316503,1708316503.801948,-21600,,
com.apple.iCal,27,1708316469,1708316496,1708316496.931573,-21600,,
com.apple.finder,4,1708316465,1708316469,1708316469.089395,-21600,,
com.microsoft.Outlook,3,1708316462,1708316465,1708316465.717823,-21600,,
com.google.Chrome,1600,1708314862,1708316462,1708316462.512066,-21600,,
com.apple.Preview,6,1708314856,1708314862,1708314862.217197,-21600,,
com.apple.journal,775,1708313659,1708314434,1708314434.624331,-21600,EB445137-D7F5-57EC-87DA-1DB460D64046,"iPhone13,2"
com.burbn.instagram,4,1708313653,1708313657,1708313657.4192162,-21600,EB445137-D7F5-57EC-87DA-1DB460D64046,"iPhone13,2"
com.apple.Preview,302,1708313647,1708313949,1708313949.438376,-21600,,
com.leomehlig.today,4,1708313643,1708313647,1708313647.9052281,-21600,,
com.apple.AppStore,27,1708313616,1708313643,1708313643.666841,-21600,,
com.leomehlig.today,2,1708313614,1708313616,1708313616.612416,-21600,,
com.burbn.instagram,583,1708313029,1708313612,1708313613.010267,-21600,EB445137-D7F5-57EC-87DA-1DB460D64046,"iPhone13,2"
com.toyopagroup.picaboo,12,1708313003,1708313015,1708313015.5396109,-21600,EB445137-D7F5-57EC-87DA-1DB460D64046,"iPhone13,2"
com.leomehlig.today,428,1708312869,1708313297,1708313297.0429559,-21600,,
com.apple.Preview,1421,1708311448,1708312869,1708312869.140328,-21600,,
com.apple.finder,2,1708311446,1708311448,1708311448.379278,-21600,,
com.leomehlig.today,54,1708311392,1708311446,1708311446.755889,-21600,,
com.google.Chrome,25,1708311367,1708311392,1708311392.882498,-21600,,
com.leomehlig.today,2,1708311365,1708311367,1708311367.600172,-21600,,
com.google.Chrome,2,1708311363,1708311365,1708311365.805491,-21600,,
com.toyopagroup.picaboo,57,1708310667,1708310724,1708310724.109538,-21600,EB445137-D7F5-57EC-87DA-1DB460D64046,"iPhone13,2"
com.toyopagroup.picaboo,4,1708310408,1708310412,1708310412.946938,-21600,EB445137-D7F5-57EC-87DA-1DB460D64046,"iPhone13,2"
com.burbn.instagram,3,1708310405,1708310408,1708310408.746685,-21600,EB445137-D7F5-57EC-87DA-1DB460D64046,"iPhone13,2"
com.burbn.instagram,39,1708310338,1708310377,1708310378.0195022,-21600,EB445137-D7F5-57EC-87DA-1DB460D64046,"iPhone13,2"
com.toyopagroup.picaboo,2,1708310318,1708310320,1708310321.044076,-21600,EB445137-D7F5-57EC-87DA-1DB460D64046,"iPhone13,2"
com.google.Chrome,449,1708310246,1708310695,1708310695.349822,-21600,,
com.google.Chrome,300,1708309815,1708310115,1708310115.728549,-21600,,
com.clairmail.fth.client,10,1708309081,1708309091,1708309091.723668,-21600,EB445137-D7F5-57EC-87DA-1DB460D64046,"iPhone13,2"
com.toyopagroup.picaboo,1,1708309078,1708309079,1708309080.119646,-21600,EB445137-D7F5-57EC-87DA-1DB460D64046,"iPhone13,2"
com.toyopagroup.picaboo,3,1708309068,1708309071,1708309071.305398,-21600,EB445137-D7F5-57EC-87DA-1DB460D64046,"iPhone13,2"
com.thestorygraph.thestorygraph,5,1708309063,1708309068,1708309068.766583,-21600,EB445137-D7F5-57EC-87DA-1DB460D64046,"iPhone13,2"
com.google.Chrome,556,1708309026,1708309582,1708309582.101527,-21600,,
com.leomehlig.today,7,1708309019,1708309026,1708309026.919348,-21600,,
com.thestorygraph.thestorygraph,61,1708308681,1708308742,1708308742.596642,-21600,EB445137-D7F5-57EC-87DA-1DB460D64046,"iPhone13,2"
com.clairmail.fth.client,3,1708308674,1708308677,1708308677.850617,-21600,EB445137-D7F5-57EC-87DA-1DB460D64046,"iPhone13,2"
com.clairmail.fth.client,26,1708308620,1708308646,1708308646.5564141,-21600,EB445137-D7F5-57EC-87DA-1DB460D64046,"iPhone13,2"
com.google.Chrome,563,1708308456,1708309019,1708309019.2818089,-21600,,
com.microsoft.Outlook,49,1708308407,1708308456,1708308456.1885939,-21600,,
com.google.Chrome,41,1708308366,1708308407,1708308407.389128,-21600,,
com.google.Chrome,631,1708304332,1708304963,1708304963.5691519,-21600,,
com.toyopagroup.picaboo,14,1708304280,1708304294,1708304294.829262,-21600,EB445137-D7F5-57EC-87DA-1DB460D64046,"iPhone13,2"
com.apple.findmy,6,1708304257,1708304263,1708304263.1592932,-21600,EB445137-D7F5-57EC-87DA-1DB460D64046,"iPhone13,2"
com.toyopagroup.picaboo,86,1708304167,1708304253,1708304254.1048222,-21600,EB445137-D7F5-57EC-87DA-1DB460D64046,"iPhone13,2"
com.robinhood.release.Robinhood,34,1708304123,1708304157,1708304157.450317,-21600,EB445137-D7F5-57EC-87DA-1DB460D64046,"iPhone13,2"
com.apple.Health,50,1708304069,1708304119,1708304120.055945,-21600,EB445137-D7F5-57EC-87DA-1DB460D64046,"iPhone13,2"
com.leomehlig.today,396,1708303936,1708304332,1708304333.1440349,-21600,,
com.apple.iCal,6,1708303930,1708303936,1708303936.9703221,-21600,,
com.leomehlig.today,3,1708303927,1708303930,1708303930.953773,-21600,,
com.google.Chrome,464,1708303463,1708303927,1708303927.281261,-21600,,
com.microsoft.Outlook,85,1708303378,1708303463,1708303463.609252,-21600,,
com.apple.finder,4,1708303374,1708303378,1708303378.446721,-21600,,
com.toyopagroup.picaboo,11,1708302686,1708302697,1708302698.506423,-21600,EB445137-D7F5-57EC-87DA-1DB460D64046,"iPhone13,2"
com.google.chrome.ios,3,1708302683,1708302686,1708302686.883065,-21600,EB445137-D7F5-57EC-87DA-1DB460D64046,"iPhone13,2"
com.google.chrome.ios,23,1708299310,1708299333,1708299333.382961,-21600,EB445137-D7F5-57EC-87DA-1DB460D64046,"iPhone13,2"
com.burbn.instagram,9,1708299301,1708299310,1708299310.247559,-21600,EB445137-D7F5-57EC-87DA-1DB460D64046,"iPhone13,2"
com.burbn.instagram,2,1708298698,1708298700,1708298700.648374,-21600,EB445137-D7F5-57EC-87DA-1DB460D64046,"iPhone13,2"
com.burbn.instagram,26,1708298658,1708298684,1708298684.795917,-21600,EB445137-D7F5-57EC-87DA-1DB460D64046,"iPhone13,2"
com.burbn.instagram,1,1708298622,1708298623,1708298623.460514,-21600,EB445137-D7F5-57EC-87DA-1DB460D64046,"iPhone13,2"
com.burbn.instagram,57,1708298513,1708298570,1708298570.419856,-21600,EB445137-D7F5-57EC-87DA-1DB460D64046,"iPhone13,2"
com.instructure.icanvas,111,1708298397,1708298508,1708298508.921822,-21600,EB445137-D7F5-57EC-87DA-1DB460D64046,"iPhone13,2"
com.microsoft.Office.Outlook,4,1708298389,1708298393,1708298393.64117,-21600,EB445137-D7F5-57EC-87DA-1DB460D64046,"iPhone13,2"
com.toyopagroup.picaboo,3,1708298383,1708298386,1708298387.138113,-21600,EB445137-D7F5-57EC-87DA-1DB460D64046,"iPhone13,2"
com.instructure.icanvas,50,1708298333,1708298383,1708298383.470055,-21600,EB445137-D7F5-57EC-87DA-1DB460D64046,"iPhone13,2"
com.toyopagroup.picaboo,3,1708297829,1708297832,1708297832.916641,-21600,EB445137-D7F5-57EC-87DA-1DB460D64046,"iPhone13,2"
com.microsoft.Office.Outlook,4,1708297825,1708297829,1708297830.066805,-21600,EB445137-D7F5-57EC-87DA-1DB460D64046,"iPhone13,2"
com.microsoft.Office.Outlook,2,1708297807,1708297809,1708297809.903211,-21600,EB445137-D7F5-57EC-87DA-1DB460D64046,"iPhone13,2"
com.microsoft.Office.Outlook,11,1708296934,1708296945,1708296945.016492,-21600,EB445137-D7F5-57EC-87DA-1DB460D64046,"iPhone13,2"
com.microsoft.Office.Outlook,58,1708294593,1708294651,1708294651.689589,-21600,EB445137-D7F5-57EC-87DA-1DB460D64046,"iPhone13,2"
com.toyopagroup.picaboo,5,1708294588,1708294593,1708294594.109848,-21600,EB445137-D7F5-57EC-87DA-1DB460D64046,"iPhone13,2"
com.apple.news,4,1708294584,1708294588,1708294588.399631,-21600,EB445137-D7F5-57EC-87DA-1DB460D64046,"iPhone13,2"
com.apple.news,118,1708293161,1708293279,1708293280.1087232,-21600,EB445137-D7F5-57EC-87DA-1DB460D64046,"iPhone13,2"
com.burbn.instagram,3,1708293158,1708293161,1708293161.213856,-21600,EB445137-D7F5-57EC-87DA-1DB460D64046,"iPhone13,2"
com.burbn.instagram,27,1708293112,1708293139,1708293139.247457,-21600,EB445137-D7F5-57EC-87DA-1DB460D64046,"iPhone13,2"
com.burbn.instagram,50,1708292943,1708292993,1708292995.3248858,-21600,EB445137-D7F5-57EC-87DA-1DB460D64046,"iPhone13,2"
com.toyopagroup.picaboo,4,1708292917,1708292921,1708292921.65889,-21600,EB445137-D7F5-57EC-87DA-1DB460D64046,"iPhone13,2"
com.toyopagroup.picaboo,2,1708291395,1708291397,1708291398.1986132,-21600,EB445137-D7F5-57EC-87DA-1DB460D64046,"iPhone13,2"
com.hammerandchisel.discord,2,1708291393,1708291395,1708291396.4307442,-21600,EB445137-D7F5-57EC-87DA-1DB460D64046,"iPhone13,2"
com.hammerandchisel.discord,38,1708290639,1708290677,1708290677.142241,-21600,EB445137-D7F5-57EC-87DA-1DB460D64046,"iPhone13,2"
com.hammerandchisel.discord,24,1708290600,1708290624,1708290624.981374,-21600,EB445137-D7F5-57EC-87DA-1DB460D64046,"iPhone13,2"
com.toyopagroup.picaboo,8,1708290590,1708290598,1708290598.475432,-21600,EB445137-D7F5-57EC-87DA-1DB460D64046,"iPhone13,2"
com.toyopagroup.picaboo,2,1708290566,1708290568,1708290568.8624868,-21600,EB445137-D7F5-57EC-87DA-1DB460D64046,"iPhone13,2"
com.toyopagroup.picaboo,36,1708289235,1708289271,1708289271.0577931,-21600,EB445137-D7F5-57EC-87DA-1DB460D64046,"iPhone13,2"
com.whentowork.iOS.WhenToWork-Employee-Scheduling,1,1708289234,1708289235,1708289236.3637838,-21600,EB445137-D7F5-57EC-87DA-1DB460D64046,"iPhone13,2"
com.whentowork.iOS.WhenToWork-Employee-Scheduling,1,1708289232,1708289233,1708289233.639824,-21600,EB445137-D7F5-57EC-87DA-1DB460D64046,"iPhone13,2"
com.whentowork.iOS.WhenToWork-Employee-Scheduling,3,1708286264,1708286267,1708286267.5544171,-21600,EB445137-D7F5-57EC-87DA-1DB460D64046,"iPhone13,2"
com.clairmail.fth.client,3,1708286260,1708286263,1708286263.11777,-21600,EB445137-D7F5-57EC-87DA-1DB460D64046,"iPhone13,2"
com.toyopagroup.picaboo,4,1708285941,1708285945,1708285945.745611,-21600,EB445137-D7F5-57EC-87DA-1DB460D64046,"iPhone13,2"
com.whentowork.iOS.WhenToWork-Employee-Scheduling,2,1708285939,1708285941,1708285941.550921,-21600,EB445137-D7F5-57EC-87DA-1DB460D64046,"iPhone13,2"
com.whentowork.iOS.WhenToWork-Employee-Scheduling,5,1708285517,1708285522,1708285522.7769341,-21600,EB445137-D7F5-57EC-87DA-1DB460D64046,"iPhone13,2"
com.apple.news,5,1708285510,1708285515,1708285515.181833,-21600,EB445137-D7F5-57EC-87DA-1DB460D64046,"iPhone13,2"
com.apple.news,6,1708285301,1708285307,1708285307.6911159,-21600,EB445137-D7F5-57EC-87DA-1DB460D64046,"iPhone13,2"
com.apple.news,155,1708285145,1708285300,1708285300.923439,-21600,EB445137-D7F5-57EC-87DA-1DB460D64046,"iPhone13,2"
com.apple.podcasts,41,1708285096,1708285137,1708285137.470738,-21600,EB445137-D7F5-57EC-87DA-1DB460D64046,"iPhone13,2"
com.microsoft.Office.Outlook,6,1708285080,1708285086,1708285087.017133,-21600,EB445137-D7F5-57EC-87DA-1DB460D64046,"iPhone13,2"
com.thestorygraph.thestorygraph,46,1708284977,1708285023,1708285024.0018759,-21600,EB445137-D7F5-57EC-87DA-1DB460D64046,"iPhone13,2"
com.burbn.instagram,4,1708284968,1708284972,1708284972.542131,-21600,EB445137-D7F5-57EC-87DA-1DB460D64046,"iPhone13,2"
com.burbn.instagram,31,1708284932,1708284963,1708284963.709337,-21600,EB445137-D7F5-57EC-87DA-1DB460D64046,"iPhone13,2"
com.apple.MobileSMS,7,1708284908,1708284915,1708284915.363669,-21600,EB445137-D7F5-57EC-87DA-1DB460D64046,"iPhone13,2"
com.zhiliaoapp.musically,15,1708284893,1708284908,1708284908.2459831,-21600,EB445137-D7F5-57EC-87DA-1DB460D64046,"iPhone13,2"
com.apple.MobileSMS,29,1708284864,1708284893,1708284893.820496,-21600,EB445137-D7F5-57EC-87DA-1DB460D64046,"iPhone13,2"
com.apple.camera,3,1708284859,1708284862,1708284862.796533,-21600,EB445137-D7F5-57EC-87DA-1DB460D64046,"iPhone13,2"
com.apple.camera,0,1708283525,1708283525,1708283525.6100469,-21600,EB445137-D7F5-57EC-87DA-1DB460D64046,"iPhone13,2"
com.whentowork.iOS.WhenToWork-Employee-Scheduling,26,1708282923,1708282949,1708282949.5474958,-21600,EB445137-D7F5-57EC-87DA-1DB460D64046,"iPhone13,2"
com.apple.finder,3,1708282653,1708282656,1708282656.244876,-21600,,
com.leomehlig.today,1,1708282652,1708282653,1708282653.8392382,-21600,,
com.apple.finder,4,1708282648,1708282652,1708282652.460935,-21600,,
com.apple.Music,4,1708282644,1708282648,1708282648.716728,-21600,,
com.google.Chrome,2,1708282642,1708282644,1708282644.8483129,-21600,,
com.leomehlig.today,74,1708282568,1708282642,1708282642.359726,-21600,,
com.apple.Notes,11,1708282557,1708282568,1708282568.497179,-21600,,
com.leomehlig.today,32,1708282525,1708282557,1708282557.801053,-21600,,
com.microsoft.VSCode,63,1708282462,1708282525,1708282525.5022202,-21600,,
com.google.Chrome,3,1708282459,1708282462,1708282462.575118,-21600,,
com.microsoft.VSCode,32,1708282427,1708282459,1708282459.869279,-21600,,
com.google.Chrome,3,1708282424,1708282427,1708282427.061048,-21600,,
com.microsoft.VSCode,28,1708282396,1708282424,1708282424.867147,-21600,,
com.google.Chrome,2,1708282394,1708282396,1708282396.092525,-21600,,
com.microsoft.VSCode,9,1708282385,1708282394,1708282394.67455,-21600,,
com.google.Chrome,50,1708282335,1708282385,1708282385.153059,-21600,,
com.microsoft.VSCode,585,1708281750,1708282335,1708282335.524605,-21600,,
com.apple.Music,69,1708281681,1708281750,1708281750.848349,-21600,,
com.apple.finder,17,1708281664,1708281681,1708281681.83094,-21600,,
com.apple.Health,16,1708281636,1708281652,1708281652.5429568,-21600,EB445137-D7F5-57EC-87DA-1DB460D64046,"iPhone13,2"
com.apple.Health,47,1708281586,1708281633,1708281634.009386,-21600,EB445137-D7F5-57EC-87DA-1DB460D64046,"iPhone13,2"
com.google.Chrome,1,1708281579,1708281580,1708281580.335542,-21600,,
com.leomehlig.today,1,1708281578,1708281579,1708281579.151833,-21600,,
com.microsoft.VSCode,11,1708281567,1708281578,1708281579.083178,-21600,,
com.leomehlig.today,2,1708281565,1708281567,1708281567.901732,-21600,,
com.microsoft.VSCode,571,1708280994,1708281565,1708281565.750418,-21600,,
com.google.Chrome,5,1708280989,1708280994,1708280994.413704,-21600,,
com.leomehlig.today,36,1708280953,1708280989,1708280989.411396,-21600,,
com.google.Chrome,273,1708280680,1708280953,1708280953.464879,-21600,,
com.leomehlig.today,2,1708280678,1708280680,1708280680.138803,-21600,,
com.google.Chrome,2221,1708278457,1708280678,1708280678.321775,-21600,,
com.leomehlig.today,43,1708278414,1708278457,1708278457.704299,-21600,,
com.google.Chrome,2,1708278412,1708278414,1708278414.6016831,-21600,,
com.apple.Health,13,1708278263,1708278276,1708278277.445576,-21600,EB445137-D7F5-57EC-87DA-1DB460D64046,"iPhone13,2"
com.apple.news,3,1708278260,1708278263,1708278264.26637,-21600,EB445137-D7F5-57EC-87DA-1DB460D64046,"iPhone13,2"
com.apple.news,3,1708278214,1708278217,1708278217.109414,-21600,EB445137-D7F5-57EC-87DA-1DB460D64046,"iPhone13,2"
com.apple.news,612,1708277423,1708278035,1708278035.434225,-21600,EB445137-D7F5-57EC-87DA-1DB460D64046,"iPhone13,2"
com.apple.news,32,1708277364,1708277396,1708277396.426075,-21600,EB445137-D7F5-57EC-87DA-1DB460D64046,"iPhone13,2"
com.apple.news,408,1708276955,1708277363,1708277363.0351439,-21600,EB445137-D7F5-57EC-87DA-1DB460D64046,"iPhone13,2"
edu.illinois.rokwire.ios,13,1708276928,1708276941,1708276941.936032,-21600,EB445137-D7F5-57EC-87DA-1DB460D64046,"iPhone13,2"
edu.illinois.rokwire.ios,10,1708276323,1708276333,1708276333.108087,-21600,EB445137-D7F5-57EC-87DA-1DB460D64046,"iPhone13,2"
edu.illinois.rokwire.ios,12,1708276279,1708276291,1708276291.617755,-21600,EB445137-D7F5-57EC-87DA-1DB460D64046,"iPhone13,2"
edu.illinois.rokwire.ios,6,1708275375,1708275381,1708275381.95472,-21600,EB445137-D7F5-57EC-87DA-1DB460D64046,"iPhone13,2"
edu.illinois.rokwire.ios,16,1708274454,1708274470,1708274470.913727,-21600,EB445137-D7F5-57EC-87DA-1DB460D64046,"iPhone13,2"
com.apple.news,3,1708274450,1708274453,1708274453.757884,-21600,EB445137-D7F5-57EC-87DA-1DB460D64046,"iPhone13,2"
com.apple.news,300,1708273245,1708273545,1708273545.465489,-21600,EB445137-D7F5-57EC-87DA-1DB460D64046,"iPhone13,2"
com.hammerandchisel.discord,43,1708273196,1708273239,1708273239.196055,-21600,EB445137-D7F5-57EC-87DA-1DB460D64046,"iPhone13,2"
com.markhambly.APOD,13,1708273180,1708273193,1708273193.526147,-21600,EB445137-D7F5-57EC-87DA-1DB460D64046,"iPhone13,2"
com.apple.Health,138,1708273040,1708273178,1708273178.155243,-21600,EB445137-D7F5-57EC-87DA-1DB460D64046,"iPhone13,2"
com.apple.MobileSMS,3,1708273033,1708273036,1708273037.001795,-21600,EB445137-D7F5-57EC-87DA-1DB460D64046,"iPhone13,2"
com.facebook.Facebook,6,1708273027,1708273033,1708273033.154955,-21600,EB445137-D7F5-57EC-87DA-1DB460D64046,"iPhone13,2"
com.apple.Preferences,61,1708272965,1708273026,1708273026.801381,-21600,EB445137-D7F5-57EC-87DA-1DB460D64046,"iPhone13,2"
com.apple.mobiletimer,7,1708270733,1708270740,1708270740.234025,-21600,EB445137-D7F5-57EC-87DA-1DB460D64046,"iPhone13,2"
com.google.chrome.ios,7,1708270726,1708270733,1708270733.678407,-21600,EB445137-D7F5-57EC-87DA-1DB460D64046,"iPhone13,2"
com.google.chrome.ios,10,1708270507,1708270517,1708270517.966696,-21600,EB445137-D7F5-57EC-87DA-1DB460D64046,"iPhone13,2"
com.google.chrome.ios,10,1708268827,1708268837,1708268837.584029,-21600,EB445137-D7F5-57EC-87DA-1DB460D64046,"iPhone13,2"
com.google.chrome.ios,15,1708244515,1708244530,1708244530.215024,-21600,EB445137-D7F5-57EC-87DA-1DB460D64046,"iPhone13,2"
com.google.chrome.ios,2,1708244512,1708244514,1708244514.769968,-21600,EB445137-D7F5-57EC-87DA-1DB460D64046,"iPhone13,2"
com.apple.mobiletimer,11,1708244501,1708244512,1708244512.657981,-21600,EB445137-D7F5-57EC-87DA-1DB460D64046,"iPhone13,2"
com.google.chrome.ios,17,1708244495,1708244512,1708244512.655857,-21600,EB445137-D7F5-57EC-87DA-1DB460D64046,"iPhone13,2"
com.google.chrome.ios,14,1708244118,1708244132,1708244132.408356,-21600,EB445137-D7F5-57EC-87DA-1DB460D64046,"iPhone13,2"
com.google.chrome.ios,8,1708239504,1708239512,1708239512.590358,-21600,EB445137-D7F5-57EC-87DA-1DB460D64046,"iPhone13,2"
com.google.chrome.ios,3,1708239486,1708239489,1708239489.688333,-21600,EB445137-D7F5-57EC-87DA-1DB460D64046,"iPhone13,2"
com.google.chrome.ios,43,1708239387,1708239430,1708239430.635553,-21600,EB445137-D7F5-57EC-87DA-1DB460D64046,"iPhone13,2"
com.reddit.Reddit,6,1708239381,1708239387,1708239387.31826,-21600,EB445137-D7F5-57EC-87DA-1DB460D64046,"iPhone13,2"
com.clairmail.fth.client,55,1708239326,1708239381,1708239381.6156,-21600,EB445137-D7F5-57EC-87DA-1DB460D64046,"iPhone13,2"
com.clairmail.fth.client,10,1708238052,1708238062,1708238062.77757,-21600,EB445137-D7F5-57EC-87DA-1DB460D64046,"iPhone13,2"
com.clairmail.fth.client,77,1708237938,1708238015,1708238016.010551,-21600,EB445137-D7F5-57EC-87DA-1DB460D64046,"iPhone13,2"
com.reddit.Reddit,99,1708237833,1708237932,1708237932.4867601,-21600,EB445137-D7F5-57EC-87DA-1DB460D64046,"iPhone13,2"
com.google.chrome.ios,4,1708237829,1708237833,1708237833.781608,-21600,EB445137-D7F5-57EC-87DA-1DB460D64046,"iPhone13,2"
com.reddit.Reddit,16,1708237813,1708237829,1708237829.9883409,-21600,EB445137-D7F5-57EC-87DA-1DB460D64046,"iPhone13,2"
com.google.chrome.ios,23,1708237790,1708237813,1708237813.975445,-21600,EB445137-D7F5-57EC-87DA-1DB460D64046,"iPhone13,2"
edu.illinois.rokwire.ios,7,1708237782,1708237789,1708237790.022338,-21600,EB445137-D7F5-57EC-87DA-1DB460D64046,"iPhone13,2"
edu.illinois.rokwire.ios,3,1708237290,1708237293,1708237293.2868009,-21600,EB445137-D7F5-57EC-87DA-1DB460D64046,"iPhone13,2"
edu.illinois.rokwire.ios,75,1708236557,1708236632,1708236632.452416,-21600,EB445137-D7F5-57EC-87DA-1DB460D64046,"iPhone13,2"
com.apple.Health,43,1708234177,1708234220,1708234220.134482,-21600,EB445137-D7F5-57EC-87DA-1DB460D64046,"iPhone13,2"
com.toyopagroup.picaboo,36,1708224500,1708224536,1708224536.570125,-21600,EB445137-D7F5-57EC-87DA-1DB460D64046,"iPhone13,2"
com.google.Chrome,613,1708210600,1708211213,1708211213.762284,-21600,,
com.google.Chrome,430,1708210095,1708210525,1708210525.986774,-21600,,
com.google.Chrome,492,1708209484,1708209976,1708209976.035692,-21600,,
com.google.Chrome,302,1708208935,1708209237,1708209237.06187,-21600,,
com.google.Chrome,593,1708207905,1708208498,1708208499.010225,-21600,,
edu.illinois.rokwire.ios,3,1708207904,1708207907,1708207907.632024,-21600,EB445137-D7F5-57EC-87DA-1DB460D64046,"iPhone13,2"
com.toyopagroup.picaboo,4,1708207899,1708207903,1708207903.7473931,-21600,EB445137-D7F5-57EC-87DA-1DB460D64046,"iPhone13,2"
com.google.Chrome,491,1708207178,1708207669,1708207669.255515,-21600,,
com.apple.InCallService,794,1708206337,1708207131,1708207131.69248,-21600,EB445137-D7F5-57EC-87DA-1DB460D64046,"iPhone13,2"
com.apple.MobileSMS,38,1708206299,1708206337,1708206339.0325952,-21600,EB445137-D7F5-57EC-87DA-1DB460D64046,"iPhone13,2"
com.apple.InCallService,4,1708206295,1708206299,1708206299.3507671,-21600,EB445137-D7F5-57EC-87DA-1DB460D64046,"iPhone13,2"
com.apple.MobileSMS,20,1708206275,1708206295,1708206296.1999578,-21600,EB445137-D7F5-57EC-87DA-1DB460D64046,"iPhone13,2"
com.apple.MobileSMS,6,1708206198,1708206204,1708206204.1105871,-21600,EB445137-D7F5-57EC-87DA-1DB460D64046,"iPhone13,2"
com.apple.MobileSMS,3,1708206183,1708206186,1708206186.841761,-21600,EB445137-D7F5-57EC-87DA-1DB460D64046,"iPhone13,2"
com.apple.findmy,10,1708206173,1708206183,1708206183.981595,-21600,EB445137-D7F5-57EC-87DA-1DB460D64046,"iPhone13,2"
com.truebill.truebillnative,2,1708206169,1708206171,1708206171.913381,-21600,EB445137-D7F5-57EC-87DA-1DB460D64046,"iPhone13,2"
com.google.Chrome,36,1708206149,1708206185,1708206186.1660829,-21600,,
com.apple.finder,9,1708206140,1708206149,1708206149.71915,-21600,,
com.truebill.truebillnative,13,1708206139,1708206152,1708206152.3760061,-21600,EB445137-D7F5-57EC-87DA-1DB460D64046,"iPhone13,2"
com.apple.FaceTime,2,1708206138,1708206140,1708206140.6075869,-21600,,
com.google.Chrome,83,1708206055,1708206138,1708206139.141111,-21600,,
com.google.Chrome,579,1708205455,1708206034,1708206035.0067391,-21600,,
com.google.Chrome,626,1708204162,1708204788,1708204788.921492,-21600,,
com.apple.finder,4,1708204158,1708204162,1708204162.9825358,-21600,,
com.truebill.truebillnative,10,1708204001,1708204011,1708204011.841634,-21600,EB445137-D7F5-57EC-87DA-1DB460D64046,"iPhone13,2"
com.truebill.truebillnative,179,1708203821,1708204000,1708204000.694643,-21600,EB445137-D7F5-57EC-87DA-1DB460D64046,"iPhone13,2"
com.microsoft.Office.Outlook,11,1708203788,1708203799,1708203799.740045,-21600,EB445137-D7F5-57EC-87DA-1DB460D64046,"iPhone13,2"
com.apple.mobilenotes,2,1708203756,1708203758,1708203758.3726869,-21600,EB445137-D7F5-57EC-87DA-1DB460D64046,"iPhone13,2"
com.thestorygraph.thestorygraph,61,1708203692,1708203753,1708203753.3108869,-21600,EB445137-D7F5-57EC-87DA-1DB460D64046,"iPhone13,2"
com.facebook.Facebook,15,1708203675,1708203690,1708203690.30035,-21600,EB445137-D7F5-57EC-87DA-1DB460D64046,"iPhone13,2"
com.apple.finder,2,1708199596,1708199598,1708199599.3124042,-21600,,
com.google.Chrome,8,1708199588,1708199596,1708199596.760715,-21600,,
com.leomehlig.today,61,1708199527,1708199588,1708199588.802078,-21600,,
com.google.Chrome,23,1708199504,1708199527,1708199527.747164,-21600,,
com.leomehlig.today,8,1708199496,1708199504,1708199504.5352678,-21600,,
com.google.Chrome,114,1708199382,1708199496,1708199496.572711,-21600,,
com.apple.Preview,1,1708199381,1708199382,1708199382.98083,-21600,,
com.google.Chrome,53,1708199328,1708199381,1708199381.6074939,-21600,,
com.apple.Preview,63,1708199265,1708199328,1708199329.044394,-21600,,
com.google.Chrome,10,1708199255,1708199265,1708199265.473402,-21600,,
com.apple.Preview,9,1708199246,1708199255,1708199255.9726691,-21600,,
com.apple.news,386,1708198860,1708199246,1708199246.358208,-21600,EB445137-D7F5-57EC-87DA-1DB460D64046,"iPhone13,2"
edu.illinois.rokwire.ios,3,1708198833,1708198836,1708198836.368609,-21600,EB445137-D7F5-57EC-87DA-1DB460D64046,"iPhone13,2"
com.apple.Preview,301,1708198828,1708199129,1708199129.946498,-21600,,
com.google.Chrome,76,1708198752,1708198828,1708198828.586492,-21600,,
com.apple.Preview,77,1708198675,1708198752,1708198752.9013572,-21600,,
com.google.Chrome,58,1708198617,1708198675,1708198675.631093,-21600,,
edu.illinois.rokwire.ios,2,1708198600,1708198602,1708198602.887053,-21600,EB445137-D7F5-57EC-87DA-1DB460D64046,"iPhone13,2"
edu.illinois.rokwire.ios,3,1708198596,1708198599,1708198599.78925,-21600,EB445137-D7F5-57EC-87DA-1DB460D64046,"iPhone13,2"
edu.illinois.rokwire.ios,14,1708198512,1708198526,1708198526.850323,-21600,EB445137-D7F5-57EC-87DA-1DB460D64046,"iPhone13,2"
com.toyopagroup.picaboo,75,1708198437,1708198512,1708198512.886199,-21600,EB445137-D7F5-57EC-87DA-1DB460D64046,"iPhone13,2"
edu.illinois.rokwire.ios,10,1708198427,1708198437,1708198437.5047178,-21600,EB445137-D7F5-57EC-87DA-1DB460D64046,"iPhone13,2"
com.burbn.instagram,7,1708198419,1708198426,1708198426.484355,-21600,EB445137-D7F5-57EC-87DA-1DB460D64046,"iPhone13,2"
com.toyopagroup.picaboo,6,1708198413,1708198419,1708198420.054822,-21600,EB445137-D7F5-57EC-87DA-1DB460D64046,"iPhone13,2"
com.burbn.instagram,47,1708198366,1708198413,1708198413.138706,-21600,EB445137-D7F5-57EC-87DA-1DB460D64046,"iPhone13,2"
com.toyopagroup.picaboo,2,1708198364,1708198366,1708198366.8937712,-21600,EB445137-D7F5-57EC-87DA-1DB460D64046,"iPhone13,2"
com.burbn.instagram,8,1708198356,1708198364,1708198364.9791908,-21600,EB445137-D7F5-57EC-87DA-1DB460D64046,"iPhone13,2"
com.toyopagroup.picaboo,15,1708198341,1708198356,1708198356.340966,-21600,EB445137-D7F5-57EC-87DA-1DB460D64046,"iPhone13,2"
com.burbn.instagram,28,1708198313,1708198341,1708198341.358897,-21600,EB445137-D7F5-57EC-87DA-1DB460D64046,"iPhone13,2"
com.toyopagroup.picaboo,19,1708198290,1708198309,1708198309.934828,-21600,EB445137-D7F5-57EC-87DA-1DB460D64046,"iPhone13,2"
com.toyopagroup.picaboo,34,1708198253,1708198287,1708198287.5391831,-21600,EB445137-D7F5-57EC-87DA-1DB460D64046,"iPhone13,2"
com.toyopagroup.picaboo,10,1708198213,1708198223,1708198223.072441,-21600,EB445137-D7F5-57EC-87DA-1DB460D64046,"iPhone13,2"
com.google.Chrome,399,1708198110,1708198509,1708198509.2071981,-21600,,
com.apple.Preview,49,1708198061,1708198110,1708198110.2253242,-21600,,
com.google.Chrome,33,1708198028,1708198061,1708198061.190115,-21600,,
com.apple.Preview,46,1708197982,1708198028,1708198028.208941,-21600,,
com.toyopagroup.picaboo,28,1708197921,1708197949,1708197949.630935,-21600,EB445137-D7F5-57EC-87DA-1DB460D64046,"iPhone13,2"
com.google.Chrome,102,1708197880,1708197982,1708197982.786485,-21600,,
com.apple.Preview,49,1708197831,1708197880,1708197880.8397598,-21600,,
com.google.Chrome,3,1708197828,1708197831,1708197831.24365,-21600,,
com.toyopagroup.picaboo,6,1708197709,1708197715,1708197715.874465,-21600,EB445137-D7F5-57EC-87DA-1DB460D64046,"iPhone13,2"
com.toyopagroup.picaboo,75,1708197620,1708197695,1708197695.506196,-21600,EB445137-D7F5-57EC-87DA-1DB460D64046,"iPhone13,2"
com.toyopagroup.picaboo,10,1708197527,1708197537,1708197537.892391,-21600,EB445137-D7F5-57EC-87DA-1DB460D64046,"iPhone13,2"
com.google.Chrome,300,1708197525,1708197825,1708197825.955174,-21600,,
com.apple.Preview,12,1708197513,1708197525,1708197525.965294,-21600,,
com.google.Chrome,23,1708197490,1708197513,1708197513.852155,-21600,,
com.apple.Preview,41,1708197449,1708197490,1708197490.619245,-21600,,
com.google.Chrome,2,1708197447,1708197449,1708197449.201277,-21600,,
com.toyopagroup.picaboo,242,1708197177,1708197419,1708197419.838922,-21600,EB445137-D7F5-57EC-87DA-1DB460D64046,"iPhone13,2"
com.apple.Health,4,1708197173,1708197177,1708197177.580071,-21600,EB445137-D7F5-57EC-87DA-1DB460D64046,"iPhone13,2"
com.apple.Preview,286,1708197161,1708197447,1708197447.740772,-21600,,
com.google.Chrome,4,1708197157,1708197161,1708197161.269875,-21600,,
com.apple.Preview,30,1708197127,1708197157,1708197157.256321,-21600,,
com.google.Chrome,135,1708196992,1708197127,1708197128.029626,-21600,,
com.apple.Preview,448,1708196544,1708196992,1708196992.4163132,-21600,,
com.google.Chrome,10,1708196534,1708196544,1708196544.86271,-21600,,
com.apple.Preview,11,1708196523,1708196534,1708196534.924821,-21600,,
com.google.Chrome,719,1708195804,1708196523,1708196523.765682,-21600,,
com.google.Chrome,468,1708195336,1708195804,1708195804.421885,-21600,,
com.google.Chrome,300,1708195030,1708195330,1708195330.669445,-21600,,
com.apple.Preview,40,1708194990,1708195030,1708195030.633841,-21600,,
com.google.Chrome,31,1708194959,1708194990,1708194990.567816,-21600,,
com.apple.Preview,205,1708194754,1708194959,1708194959.7584429,-21600,,
com.apple.finder,1,1708194753,1708194754,1708194754.635353,-21600,,
com.google.Chrome,151,1708194602,1708194753,1708194753.226676,-21600,,
com.leomehlig.today,51,1708194551,1708194602,1708194602.9197989,-21600,,
com.apple.iCal,8,1708194543,1708194551,1708194551.27986,-21600,,
com.leomehlig.today,11,1708194532,1708194543,1708194543.62344,-21600,,
com.google.Chrome,16,1708194516,1708194532,1708194532.72997,-21600,,
com.microsoft.VSCode,6,1708194510,1708194516,1708194516.9918919,-21600,,
com.apple.Health,5,1708193784,1708193789,1708193789.554127,-21600,EB445137-D7F5-57EC-87DA-1DB460D64046,"iPhone13,2"
com.apple.Health,6,1708193677,1708193683,1708193683.2360458,-21600,EB445137-D7F5-57EC-87DA-1DB460D64046,"iPhone13,2"
com.apple.Health,27,1708193630,1708193657,1708193657.4387388,-21600,EB445137-D7F5-57EC-87DA-1DB460D64046,"iPhone13,2"
com.thestorygraph.thestorygraph,5,1708193625,1708193630,1708193631.0589871,-21600,EB445137-D7F5-57EC-87DA-1DB460D64046,"iPhone13,2"
com.thestorygraph.thestorygraph,13,1708191136,1708191149,1708191150.024034,-21600,EB445137-D7F5-57EC-87DA-1DB460D64046,"iPhone13,2"
edu.illinois.rokwire.ios,4,1708191129,1708191133,1708191133.2234511,-21600,EB445137-D7F5-57EC-87DA-1DB460D64046,"iPhone13,2"
edu.illinois.rokwire.ios,4,1708189726,1708189730,1708189730.247915,-21600,EB445137-D7F5-57EC-87DA-1DB460D64046,"iPhone13,2"
com.apple.Health,140,1708189586,1708189726,1708189727.038625,-21600,EB445137-D7F5-57EC-87DA-1DB460D64046,"iPhone13,2"
edu.illinois.rokwire.ios,56,1708189526,1708189582,1708189582.435093,-21600,EB445137-D7F5-57EC-87DA-1DB460D64046,"iPhone13,2"
com.apple.MobileSMS,3,1708185932,1708185935,1708185936.122504,-21600,EB445137-D7F5-57EC-87DA-1DB460D64046,"iPhone13,2"
com.apple.weather,20,1708183712,1708183732,1708183732.865629,-21600,EB445137-D7F5-57EC-87DA-1DB460D64046,"iPhone13,2"
com.apple.MobileSMS,22,1708183685,1708183707,1708183707.152369,-21600,EB445137-D7F5-57EC-87DA-1DB460D64046,"iPhone13,2"
com.burbn.instagram,66,1708183604,1708183670,1708183670.97012,-21600,EB445137-D7F5-57EC-87DA-1DB460D64046,"iPhone13,2"
com.apple.Music,7,1708183595,1708183602,1708183602.2574701,-21600,EB445137-D7F5-57EC-87DA-1DB460D64046,"iPhone13,2"
com.apple.Music,46,1708183161,1708183207,1708183207.499594,-21600,EB445137-D7F5-57EC-87DA-1DB460D64046,"iPhone13,2"
com.apple.Music,13,1708182867,1708182880,1708182882.685656,-21600,EB445137-D7F5-57EC-87DA-1DB460D64046,"iPhone13,2"
com.apple.mobilecal,6,1708182831,1708182837,1708182837.069038,-21600,EB445137-D7F5-57EC-87DA-1DB460D64046,"iPhone13,2"
com.whentowork.iOS.WhenToWork-Employee-Scheduling,12,1708182816,1708182828,1708182828.1310081,-21600,EB445137-D7F5-57EC-87DA-1DB460D64046,"iPhone13,2"
com.microsoft.Office.Outlook,14,1708182791,1708182805,1708182805.532639,-21600,EB445137-D7F5-57EC-87DA-1DB460D64046,"iPhone13,2"
com.apple.Health,69,1708182717,1708182786,1708182786.717047,-21600,EB445137-D7F5-57EC-87DA-1DB460D64046,"iPhone13,2"
com.apple.Health,40,1708182676,1708182716,1708182716.8743649,-21600,EB445137-D7F5-57EC-87DA-1DB460D64046,"iPhone13,2"
com.google.Maps,4,1708182672,1708182676,1708182676.9711962,-21600,EB445137-D7F5-57EC-87DA-1DB460D64046,"iPhone13,2"
com.google.Maps,10,1708181357,1708181367,1708181367.957756,-21600,EB445137-D7F5-57EC-87DA-1DB460D64046,"iPhone13,2"
com.google.Maps,22,1708181314,1708181336,1708181336.749199,-21600,EB445137-D7F5-57EC-87DA-1DB460D64046,"iPhone13,2"
com.google.Maps,13,1708180923,1708180936,1708180936.7690248,-21600,EB445137-D7F5-57EC-87DA-1DB460D64046,"iPhone13,2"
com.apple.weather,6,1708180914,1708180920,1708180920.5657768,-21600,EB445137-D7F5-57EC-87DA-1DB460D64046,"iPhone13,2"
com.whentowork.iOS.WhenToWork-Employee-Scheduling,14,1708151572,1708151586,1708151586.994645,-21600,EB445137-D7F5-57EC-87DA-1DB460D64046,"iPhone13,2"
com.whentowork.iOS.WhenToWork-Employee-Scheduling,1,1708151392,1708151393,1708151393.902195,-21600,EB445137-D7F5-57EC-87DA-1DB460D64046,"iPhone13,2"
com.whentowork.iOS.WhenToWork-Employee-Scheduling,37,1708151353,1708151390,1708151390.3594189,-21600,EB445137-D7F5-57EC-87DA-1DB460D64046,"iPhone13,2"
com.apple.camera,1,1708148311,1708148312,1708148312.78449,-21600,EB445137-D7F5-57EC-87DA-1DB460D64046,"iPhone13,2"
com.whentowork.iOS.WhenToWork-Employee-Scheduling,30,1708148274,1708148304,1708148304.6858459,-21600,EB445137-D7F5-57EC-87DA-1DB460D64046,"iPhone13,2"
com.apple.MobileSMS,12,1708145795,1708145807,1708145807.3898392,-21600,EB445137-D7F5-57EC-87DA-1DB460D64046,"iPhone13,2"
com.apple.MobileSMS,3,1708145780,1708145783,1708145783.282157,-21600,EB445137-D7F5-57EC-87DA-1DB460D64046,"iPhone13,2"
com.apple.MobileSMS,15,1708145239,1708145254,1708145254.8725162,-21600,EB445137-D7F5-57EC-87DA-1DB460D64046,"iPhone13,2"
com.apple.InCallService,141,1708144703,1708144844,1708144844.42487,-21600,EB445137-D7F5-57EC-87DA-1DB460D64046,"iPhone13,2"
com.apple.MobileSMS,8,1708144695,1708144703,1708144704.16614,-21600,EB445137-D7F5-57EC-87DA-1DB460D64046,"iPhone13,2"
com.apple.findmy,10,1708144684,1708144694,1708144695.0083761,-21600,EB445137-D7F5-57EC-87DA-1DB460D64046,"iPhone13,2"
com.apple.MobileSMS,4,1708144660,1708144664,1708144664.799973,-21600,EB445137-D7F5-57EC-87DA-1DB460D64046,"iPhone13,2"
com.toyopagroup.picaboo,6,1708144653,1708144659,1708144660.235451,-21600,EB445137-D7F5-57EC-87DA-1DB460D64046,"iPhone13,2"
com.toyopagroup.picaboo,19,1708143103,1708143122,1708143122.548671,-21600,EB445137-D7F5-57EC-87DA-1DB460D64046,"iPhone13,2"
com.toyopagroup.picaboo,6,1708143014,1708143020,1708143020.9403648,-21600,EB445137-D7F5-57EC-87DA-1DB460D64046,"iPhone13,2"
com.toyopagroup.picaboo,6,1708142409,1708142415,1708142415.592421,-21600,EB445137-D7F5-57EC-87DA-1DB460D64046,"iPhone13,2"
com.toyopagroup.picaboo,12,1708142349,1708142361,1708142361.897829,-21600,EB445137-D7F5-57EC-87DA-1DB460D64046,"iPhone13,2"
com.microsoft.VSCode,161,1708132243,1708132404,1708132404.561911,-21600,,
com.apple.finder,39,1708132204,1708132243,1708132243.9526381,-21600,,
com.microsoft.VSCode,289,1708131915,1708132204,1708132204.432152,-21600,,
com.google.Chrome,9,1708131906,1708131915,1708131915.273219,-21600,,
com.microsoft.VSCode,11,1708131895,1708131906,1708131906.786814,-21600,,
com.google.Chrome,7,1708131888,1708131895,1708131895.478679,-21600,,
com.microsoft.VSCode,27,1708131861,1708131888,1708131888.644028,-21600,,
com.google.Chrome,8,1708131853,1708131861,1708131861.296648,-21600,,
com.microsoft.VSCode,53,1708131800,1708131853,1708131853.33818,-21600,,
com.google.Chrome,21,1708131779,1708131800,1708131800.992281,-21600,,
com.microsoft.VSCode,242,1708131537,1708131779,1708131779.478251,-21600,,
com.google.Chrome,23,1708131514,1708131537,1708131537.589102,-21600,,
com.microsoft.VSCode,2,1708131512,1708131514,1708131516.076961,-21600,,
com.google.Gmail,38,1708131272,1708131310,1708131310.753564,-21600,EB445137-D7F5-57EC-87DA-1DB460D64046,"iPhone13,2"
com.toyopagroup.picaboo,6,1708131266,1708131272,1708131272.633655,-21600,EB445137-D7F5-57EC-87DA-1DB460D64046,"iPhone13,2"
com.google.Chrome,268,1708131244,1708131512,1708131513.0154572,-21600,,
com.microsoft.VSCode,90,1708131154,1708131244,1708131244.9156342,-21600,,
com.google.Chrome,8,1708131146,1708131154,1708131154.1655889,-21600,,
com.microsoft.VSCode,93,1708131053,1708131146,1708131146.476345,-21600,,
com.google.Chrome,1,1708131052,1708131053,1708131054.091743,-21600,,
com.microsoft.Excel,25,1708131027,1708131052,1708131052.798459,-21600,,
com.apple.finder,6,1708131021,1708131027,1708131027.592373,-21600,,
com.google.Chrome,0,1708131021,1708131021,1708131022.0180101,-21600,,
com.microsoft.Excel,5,1708131016,1708131021,1708131021.07858,-21600,,
com.google.Chrome,28,1708130988,1708131016,1708131016.794301,-21600,,
com.microsoft.VSCode,30,1708130958,1708130988,1708130988.412111,-21600,,
com.microsoft.Excel,5,1708130953,1708130958,1708130958.191413,-21600,,
com.microsoft.VSCode,17,1708130936,1708130953,1708130953.8616328,-21600,,
com.microsoft.Excel,1,1708130935,1708130936,1708130936.479001,-21600,,
com.microsoft.VSCode,17,1708130918,1708130935,1708130935.144366,-21600,,
com.microsoft.Excel,6,1708130912,1708130918,1708130918.406528,-21600,,
com.microsoft.VSCode,48,1708130864,1708130912,1708130912.610879,-21600,,
com.apple.finder,3,1708130861,1708130864,1708130864.159439,-21600,,
com.microsoft.Excel,2,1708130859,1708130861,1708130861.439338,-21600,,
com.microsoft.VSCode,29,1708130830,1708130859,1708130859.881763,-21600,,
com.microsoft.Excel,0,1708130830,1708130830,1708130830.9820461,-21600,,
com.microsoft.VSCode,23,1708130807,1708130830,1708130830.0689979,-21600,,
com.microsoft.Excel,3,1708130804,1708130807,1708130807.842226,-21600,,
com.microsoft.VSCode,43,1708130761,1708130804,1708130804.4591,-21600,,
com.apple.finder,1,1708130760,1708130761,1708130761.6806931,-21600,,
com.microsoft.Excel,23,1708130737,1708130760,1708130760.527021,-21600,,
com.apple.finder,5,1708130732,1708130737,1708130737.8829908,-21600,,
com.microsoft.VSCode,22,1708130710,1708130732,1708130732.9631,-21600,,
com.microsoft.Excel,1,1708130709,1708130710,1708130710.521903,-21600,,
com.microsoft.VSCode,2,1708130707,1708130709,1708130709.213321,-21600,,
com.apple.finder,27,1708130680,1708130707,1708130707.1789432,-21600,,
com.microsoft.Excel,109,1708130571,1708130680,1708130680.6181889,-21600,,
com.google.Chrome,51,1708130520,1708130571,1708130571.365382,-21600,,
com.microsoft.Excel,7,1708130513,1708130520,1708130520.9858088,-21600,,
com.google.Chrome,19,1708130494,1708130513,1708130513.494951,-21600,,
com.microsoft.Excel,2,1708130492,1708130494,1708130494.929165,-21600,,
com.google.Chrome,305,1708130187,1708130492,1708130492.928273,-21600,,
com.apple.MobileSMS,41,1708130146,1708130187,1708130187.266933,-21600,,
com.google.Chrome,478,1708129668,1708130146,1708130146.938071,-21600,,
com.apple.iWork.Numbers,65,1708129603,1708129668,1708129668.550723,-21600,,
com.google.Chrome,74,1708129529,1708129603,1708129603.761231,-21600,,
com.apple.MobileSMS,4,1708129525,1708129529,1708129529.1238852,-21600,,
com.google.Chrome,112,1708129413,1708129525,1708129525.168109,-21600,,
com.apple.iWork.Numbers,46,1708129367,1708129413,1708129413.081532,-21600,,
com.google.Chrome,141,1708129226,1708129367,1708129367.604299,-21600,,
com.apple.iWork.Numbers,41,1708129185,1708129226,1708129226.7223969,-21600,,
com.google.Chrome,101,1708129084,1708129185,1708129186.0354419,-21600,,
com.apple.iWork.Numbers,31,1708129053,1708129084,1708129084.52707,-21600,,
com.google.Chrome,111,1708128942,1708129053,1708129053.512969,-21600,,
com.microsoft.VSCode,43,1708128899,1708128942,1708128942.721889,-21600,,
com.google.Chrome,85,1708128814,1708128899,1708128899.2538261,-21600,,
com.microsoft.VSCode,189,1708128625,1708128814,1708128814.311244,-21600,,
com.google.Chrome,12,1708128613,1708128625,1708128625.52252,-21600,,
com.microsoft.VSCode,148,1708128465,1708128613,1708128613.97735,-21600,,
com.apple.finder,7,1708128458,1708128465,1708128465.3624759,-21600,,
com.microsoft.VSCode,9,1708128449,1708128458,1708128458.667533,-21600,,
com.google.Chrome,1,1708128448,1708128449,1708128449.440983,-21600,,
com.apple.MobileSMS,27,1708128421,1708128448,1708128448.088502,-21600,,
com.google.Chrome,77,1708128344,1708128421,1708128421.864398,-21600,,
com.apple.finder,12,1708128332,1708128344,1708128344.115886,-21600,,
com.apple.archiveutility,1,1708128331,1708128332,1708128332.173311,-21600,,
com.apple.finder,2,1708128329,1708128331,1708128331.8450332,-21600,,
com.google.Chrome,54,1708128275,1708128329,1708128329.319915,-21600,,
com.apple.MobileSMS,6,1708128269,1708128275,1708128275.3367019,-21600,,
com.apple.finder,48,1708128221,1708128269,1708128269.7,-21600,,
com.toyopagroup.picaboo,4,1708128160,1708128164,1708128164.1633248,-21600,EB445137-D7F5-57EC-87DA-1DB460D64046,"iPhone13,2"
com.google.Chrome,93,1708128128,1708128221,1708128222.0527081,-21600,,
com.apple.MobileSMS,44,1708128084,1708128128,1708128128.70935,-21600,,
com.microsoft.VSCode,3,1708128081,1708128084,1708128084.617127,-21600,,
com.apple.dt.Xcode,16,1708128065,1708128081,1708128081.941767,-21600,,
com.toyopagroup.picaboo,3,1708127859,1708127862,1708127862.729082,-21600,EB445137-D7F5-57EC-87DA-1DB460D64046,"iPhone13,2"
com.toyopagroup.picaboo,1,1708126886,1708126887,1708126887.969693,-21600,EB445137-D7F5-57EC-87DA-1DB460D64046,"iPhone13,2"
com.toyopagroup.picaboo,3,1708125534,1708125537,1708125537.542688,-21600,EB445137-D7F5-57EC-87DA-1DB460D64046,"iPhone13,2"
