app,usage,start_time,end_time,created_at,tz,device_id,device_model
com.apple.finder,3,1750124923,1750124926,1750124926.0861769,-18000,,
com.apple.Terminal,11,1750124912,1750124923,1750124923.768503,-18000,,
com.apple.finder,4,1750124908,1750124912,1750124912.7634192,-18000,,
com.apple.Terminal,1,1750124907,1750124908,1750124908.270697,-18000,,
com.apple.finder,19,1750124888,1750124907,1750124907.2849731,-18000,,
com.apple.Notes,5,1750124883,1750124888,1750124888.530381,-18000,,
com.microsoft.VSCode,6,1750124877,1750124883,1750124884.0511398,-18000,,
com.google.Chrome,286,1750124591,1750124877,1750124877.34481,-18000,,
com.microsoft.VSCode,34,1750124557,1750124591,1750124591.159138,-18000,,
com.google.Chrome,10,1750124547,1750124557,1750124557.914356,-18000,,
com.microsoft.VSCode,2,1750124545,1750124547,1750124547.2300491,-18000,,
com.google.Chrome,2,1750124543,1750124545,1750124545.746731,-18000,,
com.microsoft.VSCode,2,1750124541,1750124543,1750124543.517205,-18000,,
com.google.Chrome,6,1750124535,1750124541,1750124541.8558788,-18000,,
com.microsoft.VSCode,5,1750124530,1750124535,1750124535.451377,-18000,,
com.google.Chrome,39,1750124491,1750124530,1750124530.185979,-18000,,
com.microsoft.VSCode,4,1750124487,1750124491,1750124491.544183,-18000,,
com.google.Chrome,3,1750124484,1750124487,1750124487.7860699,-18000,,
com.microsoft.VSCode,4,1750124480,1750124484,1750124484.4283872,-18000,,
com.google.Chrome,336,1750124144,1750124480,1750124480.260685,-18000,,
com.microsoft.VSCode,1,1750124143,1750124144,1750124144.274338,-18000,,
com.google.Chrome,129,1750124014,1750124143,1750124143.6307058,-18000,,
com.microsoft.VSCode,1,1750124013,1750124014,1750124014.0446,-18000,,
com.google.Chrome,309,1750123704,1750124013,1750124013.378542,-18000,,
com.microsoft.VSCode,3,1750123701,1750123704,1750123704.168586,-18000,,
com.google.Chrome,240,1750123461,1750123701,1750123701.1476011,-18000,,
com.microsoft.VSCode,1,1750123460,1750123461,1750123461.72861,-18000,,
com.apple.Notes,0,1750123460,1750123460,1750123460.988562,-18000,,
com.microsoft.VSCode,2,1750123458,1750123460,1750123460.074679,-18000,,
com.google.Chrome,52,1750123406,1750123458,1750123458.385988,-18000,,
com.microsoft.VSCode,2,1750123404,1750123406,1750123406.760693,-18000,,
com.google.Chrome,10,1750123394,1750123404,1750123405.034079,-18000,,
com.microsoft.VSCode,1,1750123393,1750123394,1750123394.447277,-18000,,
com.google.Chrome,12,1750123381,1750123393,1750123393.555855,-18000,,
com.microsoft.VSCode,17,1750123364,1750123381,1750123381.9224272,-18000,,
com.google.Chrome,347,1750123017,1750123364,1750123364.525269,-18000,,
com.google.Chrome,380,1750122627,1750123007,1750123007.653953,-18000,,
com.microsoft.VSCode,3,1750122624,1750122627,1750122627.5963879,-18000,,
com.google.Chrome,169,1750122455,1750122624,1750122624.082907,-18000,,
com.microsoft.VSCode,25,1750122430,1750122455,1750122455.1069288,-18000,,
com.google.Chrome,15,1750122415,1750122430,1750122430.492518,-18000,,
com.microsoft.VSCode,21,1750122394,1750122415,1750122415.1301022,-18000,,
com.google.Chrome,101,1750122293,1750122394,1750122394.262827,-18000,,
com.microsoft.VSCode,5,1750122288,1750122293,1750122293.678751,-18000,,
com.google.Chrome,3,1750122285,1750122288,1750122289.007901,-18000,,
com.microsoft.VSCode,4,1750122281,1750122285,1750122285.713772,-18000,,
com.google.Chrome,46,1750122235,1750122281,1750122281.932697,-18000,,
com.microsoft.VSCode,2,1750122233,1750122235,1750122235.607846,-18000,,
com.google.Chrome,96,1750122137,1750122233,1750122233.395639,-18000,,
com.microsoft.VSCode,1,1750122136,1750122137,1750122137.773528,-18000,,
com.google.Chrome,8,1750122128,1750122136,1750122136.298223,-18000,,
com.microsoft.VSCode,1,1750122127,1750122128,1750122128.864087,-18000,,
com.google.Chrome,1,1750122126,1750122127,1750122127.899368,-18000,,
com.microsoft.VSCode,1,1750122125,1750122126,1750122126.624758,-18000,,
com.google.Chrome,7,1750122118,1750122125,1750122125.231363,-18000,,
com.microsoft.VSCode,13,1750122105,1750122118,1750122118.6902962,-18000,,
com.google.Chrome,86,1750122019,1750122105,1750122105.119996,-18000,,
com.microsoft.VSCode,172,1750121847,1750122019,1750122019.655683,-18000,,
com.google.Chrome,36,1750121811,1750121847,1750121847.586739,-18000,,
com.microsoft.VSCode,352,1750121459,1750121811,1750121811.747338,-18000,,
com.google.Chrome,36,1750121423,1750121459,1750121459.639202,-18000,,
com.microsoft.VSCode,383,1750121040,1750121423,1750121423.890804,-18000,,
com.google.Chrome,2,1750121038,1750121040,1750121041.032594,-18000,,
com.microsoft.VSCode,6,1750121032,1750121038,1750121038.4597712,-18000,,
com.google.Chrome,2,1750121030,1750121032,1750121032.876573,-18000,,
com.microsoft.VSCode,7,1750121023,1750121030,1750121030.403343,-18000,,
com.google.Chrome,3,1750121020,1750121023,1750121023.655848,-18000,,
com.microsoft.VSCode,19,1750121001,1750121020,1750121020.514849,-18000,,
com.google.Chrome,6,1750120995,1750121001,1750121001.217012,-18000,,
com.microsoft.VSCode,25,1750120970,1750120995,1750120995.8711128,-18000,,
com.google.Chrome,3,1750120967,1750120970,1750120970.383899,-18000,,
com.microsoft.VSCode,0,1750120967,1750120967,1750120967.842176,-18000,,
com.google.Chrome,3,1750120964,1750120967,1750120967.40956,-18000,,
com.microsoft.VSCode,18,1750120946,1750120964,1750120964.7974238,-18000,,
com.google.Chrome,11,1750120935,1750120946,1750120946.523563,-18000,,
com.microsoft.VSCode,184,1750120751,1750120935,1750120935.5794291,-18000,,
com.apple.Notes,11,1750120740,1750120751,1750120751.316261,-18000,,
com.microsoft.VSCode,4,1750120736,1750120740,1750120740.1948318,-18000,,
com.apple.Notes,1,1750120735,1750120736,1750120736.509572,-18000,,
com.microsoft.VSCode,19,1750120716,1750120735,1750120735.6964312,-18000,,
com.apple.Notes,4,1750120712,1750120716,1750120717.024517,-18000,,
com.microsoft.VSCode,54,1750120658,1750120712,1750120712.349494,-18000,,
com.apple.Notes,157,1750120501,1750120658,1750120658.558501,-18000,,
com.microsoft.VSCode,1,1750120500,1750120501,1750120501.673119,-18000,,
com.apple.Notes,7,1750120493,1750120500,1750120500.9547,-18000,,
com.microsoft.VSCode,7,1750120486,1750120493,1750120493.798497,-18000,,
com.apple.Notes,3,1750120483,1750120486,1750120486.58408,-18000,,
com.microsoft.VSCode,3,1750120480,1750120483,1750120483.5068789,-18000,,
com.apple.Notes,12,1750120468,1750120480,1750120480.972003,-18000,,
com.microsoft.VSCode,11,1750120457,1750120468,1750120468.635511,-18000,,
com.apple.Notes,10,1750120447,1750120457,1750120457.303646,-18000,,
com.microsoft.VSCode,4,1750120443,1750120447,1750120447.944624,-18000,,
com.apple.Notes,2,1750120441,1750120443,1750120443.6396232,-18000,,
com.microsoft.VSCode,9,1750120432,1750120441,1750120441.4253058,-18000,,
com.apple.Notes,2,1750120430,1750120432,1750120432.665406,-18000,,
com.microsoft.VSCode,5,1750120425,1750120430,1750120430.494618,-18000,,
com.apple.Notes,45,1750120380,1750120425,1750120425.742875,-18000,,
com.google.Chrome,28,1750120352,1750120380,1750120380.084625,-18000,,
com.apple.Notes,6,1750120346,1750120352,1750120352.18419,-18000,,
com.microsoft.VSCode,54,1750120292,1750120346,1750120346.557744,-18000,,
com.apple.Notes,11,1750120281,1750120292,1750120292.2550201,-18000,,
com.google.Chrome,1226,1750119055,1750120281,1750120281.509004,-18000,,
com.apple.Notes,5,1750119050,1750119055,1750119056.8236,-18000,,
com.apple.finder,1,1750119049,1750119050,1750119050.7898831,-18000,,
com.leomehlig.today,4,1750119045,1750119049,1750119049.5196,-18000,,
com.apple.iCal,2,1750119043,1750119045,1750119045.34204,-18000,,
com.google.Chrome,7,1750119036,1750119043,1750119044.460617,-18000,,
com.google.Chrome,948,1750117074,1750118022,1750118022.567555,-18000,,
com.google.Chrome,451,1750115828,1750116279,1750116279.062718,-18000,,
com.apple.iCal,69,1750115759,1750115828,1750115828.148715,-18000,,
com.leomehlig.today,152,1750115607,1750115759,1750115759.9310389,-18000,,
com.apple.iCal,35,1750115572,1750115607,1750115607.673207,-18000,,
com.leomehlig.today,99,1750115473,1750115572,1750115572.027893,-18000,,
com.google.Chrome,2,1750115471,1750115473,1750115473.517342,-18000,,
com.google.Chrome,312,1750111397,1750111709,1750111709.440226,-18000,,
com.google.Chrome,311,1749858155,1749858466,1749858466.8485022,-25200,,
com.google.Chrome,368,1749851481,1749851849,1749851849.5780602,-25200,,
com.apple.finder,15,1749851466,1749851481,1749851481.3842812,-25200,,
com.google.Chrome,806,1749850660,1749851466,1749851466.8802428,-25200,,
com.apple.Notes,1,1749850659,1749850660,1749850660.5056581,-25200,,
com.google.Chrome,29,1749850630,1749850659,1749850659.955852,-25200,,
com.apple.Notes,6,1749850624,1749850630,1749850630.982215,-25200,,
com.google.Chrome,6,1749850618,1749850624,1749850624.5987,-25200,,
com.apple.finder,6,1749850612,1749850618,1749850618.1857271,-25200,,
com.google.Chrome,199,1749850413,1749850612,1749850612.118895,-25200,,
com.apple.Maps,11,1749656017,1749656028,1749656028.218507,-25200,EB445137-D7F5-57EC-87DA-1DB460D64046,"iPhone13,2"
com.apple.Maps,12,1749655819,1749655831,1749655831.167171,-25200,EB445137-D7F5-57EC-87DA-1DB460D64046,"iPhone13,2"
com.apple.Maps,50,1749655688,1749655738,1749655738.257873,-25200,EB445137-D7F5-57EC-87DA-1DB460D64046,"iPhone13,2"
com.apple.Maps,24,1749655652,1749655676,1749655676.110059,-25200,EB445137-D7F5-57EC-87DA-1DB460D64046,"iPhone13,2"
com.apple.Maps,9,1749655419,1749655428,1749655428.236042,-25200,EB445137-D7F5-57EC-87DA-1DB460D64046,"iPhone13,2"
com.apple.Maps,63,1749654989,1749655052,1749655052.9522228,-25200,EB445137-D7F5-57EC-87DA-1DB460D64046,"iPhone13,2"
com.apple.Maps,7,1749654888,1749654895,1749654895.764826,-25200,EB445137-D7F5-57EC-87DA-1DB460D64046,"iPhone13,2"
com.apple.Maps,7,1749654789,1749654796,1749654796.276554,-25200,EB445137-D7F5-57EC-87DA-1DB460D64046,"iPhone13,2"
com.apple.Maps,10,1749654659,1749654669,1749654669.413439,-25200,EB445137-D7F5-57EC-87DA-1DB460D64046,"iPhone13,2"
com.apple.Maps,6,1749654405,1749654411,1749654411.286417,-25200,EB445137-D7F5-57EC-87DA-1DB460D64046,"iPhone13,2"
com.apple.Maps,19,1749654326,1749654345,1749654345.7064152,-25200,EB445137-D7F5-57EC-87DA-1DB460D64046,"iPhone13,2"
com.apple.Maps,7,1749654074,1749654081,1749654081.4155421,-25200,EB445137-D7F5-57EC-87DA-1DB460D64046,"iPhone13,2"
com.apple.Maps,70,1749653975,1749654045,1749654045.214328,-25200,EB445137-D7F5-57EC-87DA-1DB460D64046,"iPhone13,2"
com.apple.Maps,133,1749653841,1749653974,1749653974.419869,-25200,EB445137-D7F5-57EC-87DA-1DB460D64046,"iPhone13,2"
com.apple.Maps,66,1749652617,1749652683,1749652684.004163,-25200,EB445137-D7F5-57EC-87DA-1DB460D64046,"iPhone13,2"
com.apple.Maps,106,1749652222,1749652328,1749652328.933986,-25200,EB445137-D7F5-57EC-87DA-1DB460D64046,"iPhone13,2"
com.apple.Maps,37,1749652047,1749652084,1749652084.927172,-25200,EB445137-D7F5-57EC-87DA-1DB460D64046,"iPhone13,2"
com.apple.Maps,17,1749651993,1749652010,1749652010.4950728,-25200,EB445137-D7F5-57EC-87DA-1DB460D64046,"iPhone13,2"
com.apple.Maps,67,1749651906,1749651973,1749651973.559875,-25200,EB445137-D7F5-57EC-87DA-1DB460D64046,"iPhone13,2"
com.apple.Maps,22,1749651821,1749651843,1749651843.740895,-25200,EB445137-D7F5-57EC-87DA-1DB460D64046,"iPhone13,2"
com.apple.Maps,3,1749651756,1749651759,1749651760.039359,-25200,EB445137-D7F5-57EC-87DA-1DB460D64046,"iPhone13,2"
com.apple.Maps,28,1749651378,1749651406,1749651406.726253,-25200,EB445137-D7F5-57EC-87DA-1DB460D64046,"iPhone13,2"
com.apple.Maps,12,1749651042,1749651054,1749651054.806442,-25200,EB445137-D7F5-57EC-87DA-1DB460D64046,"iPhone13,2"
com.apple.Maps,5,1749650851,1749650856,1749650856.459305,-25200,EB445137-D7F5-57EC-87DA-1DB460D64046,"iPhone13,2"
com.apple.Maps,8,1749650798,1749650806,1749650806.530641,-25200,EB445137-D7F5-57EC-87DA-1DB460D64046,"iPhone13,2"
com.apple.Maps,6,1749650595,1749650601,1749650601.7535849,-25200,EB445137-D7F5-57EC-87DA-1DB460D64046,"iPhone13,2"
com.apple.Maps,6,1749650426,1749650432,1749650432.772346,-25200,EB445137-D7F5-57EC-87DA-1DB460D64046,"iPhone13,2"
com.apple.Maps,22,1749650399,1749650421,1749650421.131112,-25200,EB445137-D7F5-57EC-87DA-1DB460D64046,"iPhone13,2"
com.apple.Maps,18,1749650350,1749650368,1749650368.513499,-25200,EB445137-D7F5-57EC-87DA-1DB460D64046,"iPhone13,2"
com.apple.Maps,11,1749650214,1749650225,1749650225.870399,-25200,EB445137-D7F5-57EC-87DA-1DB460D64046,"iPhone13,2"
com.apple.Maps,6,1749650076,1749650082,1749650082.31686,-25200,EB445137-D7F5-57EC-87DA-1DB460D64046,"iPhone13,2"
com.apple.Maps,68,1749649934,1749650002,1749650002.597451,-25200,EB445137-D7F5-57EC-87DA-1DB460D64046,"iPhone13,2"
com.apple.Maps,30,1749649892,1749649922,1749649922.140894,-25200,EB445137-D7F5-57EC-87DA-1DB460D64046,"iPhone13,2"
com.apple.Maps,105,1749649729,1749649834,1749649834.57404,-25200,EB445137-D7F5-57EC-87DA-1DB460D64046,"iPhone13,2"
com.apple.Maps,9,1749649605,1749649614,1749649614.1239228,-25200,EB445137-D7F5-57EC-87DA-1DB460D64046,"iPhone13,2"
com.apple.Maps,37,1749649247,1749649284,1749649285.0358992,-25200,EB445137-D7F5-57EC-87DA-1DB460D64046,"iPhone13,2"
com.apple.Maps,176,1749648057,1749648233,1749648233.2275,-25200,EB445137-D7F5-57EC-87DA-1DB460D64046,"iPhone13,2"
com.apple.weather,68,1749647948,1749648016,1749648016.948348,-25200,EB445137-D7F5-57EC-87DA-1DB460D64046,"iPhone13,2"
com.apple.news,3,1749647945,1749647948,1749647948.468237,-25200,EB445137-D7F5-57EC-87DA-1DB460D64046,"iPhone13,2"
com.apple.weather,28,1749647917,1749647945,1749647945.6137772,-25200,EB445137-D7F5-57EC-87DA-1DB460D64046,"iPhone13,2"
com.apple.Maps,65,1749647852,1749647917,1749647917.157696,-25200,EB445137-D7F5-57EC-87DA-1DB460D64046,"iPhone13,2"
com.apple.mobiletimer,4,1749646948,1749646952,1749646952.1103048,-25200,EB445137-D7F5-57EC-87DA-1DB460D64046,"iPhone13,2"
com.apple.mobiletimer,17,1749619590,1749619607,1749619607.7252722,-25200,EB445137-D7F5-57EC-87DA-1DB460D64046,"iPhone13,2"
com.apple.journal,2,1749619588,1749619590,1749619591.027065,-25200,EB445137-D7F5-57EC-87DA-1DB460D64046,"iPhone13,2"
com.apple.journal,374,1749619213,1749619587,1749619587.158206,-25200,EB445137-D7F5-57EC-87DA-1DB460D64046,"iPhone13,2"
com.apple.Maps,12,1749619201,1749619213,1749619213.4935741,-25200,EB445137-D7F5-57EC-87DA-1DB460D64046,"iPhone13,2"
com.apple.CoreAuthUI,4,1749618676,1749618680,1749618680.9271321,-25200,EB445137-D7F5-57EC-87DA-1DB460D64046,"iPhone13,2"
com.apple.journal,523,1749618675,1749619198,1749619198.7023149,-25200,EB445137-D7F5-57EC-87DA-1DB460D64046,"iPhone13,2"
com.apple.Health,48,1749618625,1749618673,1749618673.494903,-25200,EB445137-D7F5-57EC-87DA-1DB460D64046,"iPhone13,2"
com.thestorygraph.thestorygraph,18,1749618457,1749618475,1749618475.930101,-25200,EB445137-D7F5-57EC-87DA-1DB460D64046,"iPhone13,2"
com.google.Chrome,6,1749616138,1749616144,1749616144.485795,-25200,,
com.apple.iCal,14,1749616124,1749616138,1749616138.0863562,-25200,,
com.google.Chrome,816,1749615308,1749616124,1749616124.457695,-25200,,
com.apple.Maps,5,1749615303,1749615308,1749615308.95464,-25200,,
com.google.Chrome,27,1749615276,1749615303,1749615303.844668,-25200,,
com.apple.mobileslideshow,63,1749613599,1749613662,1749613662.469182,-25200,EB445137-D7F5-57EC-87DA-1DB460D64046,"iPhone13,2"
com.apple.Maps,0,1749613599,1749613599,1749613599.986326,-25200,EB445137-D7F5-57EC-87DA-1DB460D64046,"iPhone13,2"
com.apple.Maps,7,1749612914,1749612921,1749612921.754607,-25200,EB445137-D7F5-57EC-87DA-1DB460D64046,"iPhone13,2"
com.apple.Maps,35,1749609302,1749609337,1749609337.218072,-25200,EB445137-D7F5-57EC-87DA-1DB460D64046,"iPhone13,2"
com.apple.weather,1,1749609301,1749609302,1749609302.9123049,-25200,EB445137-D7F5-57EC-87DA-1DB460D64046,"iPhone13,2"
com.google.Chrome,242,1749608209,1749608451,1749608451.513171,-25200,,
com.apple.Maps,937,1749607272,1749608209,1749608209.700519,-25200,,
com.google.Chrome,1,1749607271,1749607272,1749607272.1892781,-25200,,
com.apple.Maps,58,1749607213,1749607271,1749607271.1899471,-25200,,
com.apple.mobilenotes,32,1749606379,1749606411,1749606411.832896,-25200,EB445137-D7F5-57EC-87DA-1DB460D64046,"iPhone13,2"
com.apple.mobilenotes,31,1749606311,1749606342,1749606342.3839521,-25200,EB445137-D7F5-57EC-87DA-1DB460D64046,"iPhone13,2"
com.apple.mobilenotes,31,1749606268,1749606299,1749606299.1116571,-25200,EB445137-D7F5-57EC-87DA-1DB460D64046,"iPhone13,2"
com.apple.mobilenotes,91,1749606011,1749606102,1749606102.2511659,-25200,EB445137-D7F5-57EC-87DA-1DB460D64046,"iPhone13,2"
com.apple.weather,2,1749606009,1749606011,1749606011.712431,-25200,EB445137-D7F5-57EC-87DA-1DB460D64046,"iPhone13,2"
com.apple.weather,56,1749605787,1749605843,1749605843.129655,-25200,EB445137-D7F5-57EC-87DA-1DB460D64046,"iPhone13,2"
com.apple.Maps,2,1749605785,1749605787,1749605787.23719,-25200,EB445137-D7F5-57EC-87DA-1DB460D64046,"iPhone13,2"
com.google.Chrome,1909,1749605304,1749607213,1749607213.380832,-25200,,
com.apple.Maps,35,1749605257,1749605292,1749605292.876225,-25200,EB445137-D7F5-57EC-87DA-1DB460D64046,"iPhone13,2"
com.apple.Maps,170,1749604628,1749604798,1749604798.924515,-25200,EB445137-D7F5-57EC-87DA-1DB460D64046,"iPhone13,2"
com.apple.mobilenotes,12,1749604616,1749604628,1749604628.8486052,-25200,EB445137-D7F5-57EC-87DA-1DB460D64046,"iPhone13,2"
com.apple.Maps,5,1749604611,1749604616,1749604616.266345,-25200,EB445137-D7F5-57EC-87DA-1DB460D64046,"iPhone13,2"
com.apple.mobilenotes,27,1749604584,1749604611,1749604611.591732,-25200,EB445137-D7F5-57EC-87DA-1DB460D64046,"iPhone13,2"
com.google.Maps,43,1749604541,1749604584,1749604584.575156,-25200,EB445137-D7F5-57EC-87DA-1DB460D64046,"iPhone13,2"
com.apple.mobilenotes,14,1749604527,1749604541,1749604541.669646,-25200,EB445137-D7F5-57EC-87DA-1DB460D64046,"iPhone13,2"
com.google.chrome.ios,2,1749604525,1749604527,1749604527.634396,-25200,EB445137-D7F5-57EC-87DA-1DB460D64046,"iPhone13,2"
com.apple.mobilenotes,87,1749604438,1749604525,1749604525.590528,-25200,EB445137-D7F5-57EC-87DA-1DB460D64046,"iPhone13,2"
com.google.Maps,71,1749604367,1749604438,1749604439.002639,-25200,EB445137-D7F5-57EC-87DA-1DB460D64046,"iPhone13,2"
com.apple.mobilenotes,4,1749604363,1749604367,1749604367.8335981,-25200,EB445137-D7F5-57EC-87DA-1DB460D64046,"iPhone13,2"
com.google.Maps,89,1749604274,1749604363,1749604363.9948769,-25200,EB445137-D7F5-57EC-87DA-1DB460D64046,"iPhone13,2"
com.apple.mobilenotes,143,1749604131,1749604274,1749604274.230521,-25200,EB445137-D7F5-57EC-87DA-1DB460D64046,"iPhone13,2"
com.google.Maps,43,1749604088,1749604131,1749604131.285336,-25200,EB445137-D7F5-57EC-87DA-1DB460D64046,"iPhone13,2"
com.google.Maps,96,1749603968,1749604064,1749604064.780981,-25200,EB445137-D7F5-57EC-87DA-1DB460D64046,"iPhone13,2"
com.google.Maps,306,1749603653,1749603959,1749603959.31784,-25200,EB445137-D7F5-57EC-87DA-1DB460D64046,"iPhone13,2"
com.google.Maps,67,1749603562,1749603629,1749603629.317264,-25200,EB445137-D7F5-57EC-87DA-1DB460D64046,"iPhone13,2"
com.google.chrome.ios,309,1749603253,1749603562,1749603562.2947059,-25200,EB445137-D7F5-57EC-87DA-1DB460D64046,"iPhone13,2"
com.google.Maps,27,1749603226,1749603253,1749603253.308814,-25200,EB445137-D7F5-57EC-87DA-1DB460D64046,"iPhone13,2"
com.google.chrome.ios,12,1749603211,1749603223,1749603223.196706,-25200,EB445137-D7F5-57EC-87DA-1DB460D64046,"iPhone13,2"
com.apple.Maps,11,1749603191,1749603202,1749603202.427092,-25200,EB445137-D7F5-57EC-87DA-1DB460D64046,"iPhone13,2"
com.apple.Maps,45,1749601738,1749601783,1749601783.6199222,-25200,EB445137-D7F5-57EC-87DA-1DB460D64046,"iPhone13,2"
com.google.chrome.ios,3,1749601735,1749601738,1749601738.127614,-25200,EB445137-D7F5-57EC-87DA-1DB460D64046,"iPhone13,2"
com.google.Chrome,304,1749601504,1749601808,1749601808.928475,-25200,,
com.apple.Maps,11,1749601493,1749601504,1749601504.9957252,-25200,,
com.google.chrome.ios,69,1749601387,1749601456,1749601456.37462,-25200,EB445137-D7F5-57EC-87DA-1DB460D64046,"iPhone13,2"
com.google.Chrome,288,1749601205,1749601493,1749601493.170954,-25200,,
com.apple.weather,16,1749600817,1749600833,1749600833.7648978,-25200,EB445137-D7F5-57EC-87DA-1DB460D64046,"iPhone13,2"
com.google.chrome.ios,2,1749600815,1749600817,1749600817.3646,-25200,EB445137-D7F5-57EC-87DA-1DB460D64046,"iPhone13,2"
com.google.chrome.ios,119,1749600636,1749600755,1749600755.708692,-25200,EB445137-D7F5-57EC-87DA-1DB460D64046,"iPhone13,2"
com.apple.Maps,73,1749600562,1749600635,1749600636.01375,-25200,EB445137-D7F5-57EC-87DA-1DB460D64046,"iPhone13,2"
com.apple.weather,2,1749600560,1749600562,1749600562.062212,-25200,EB445137-D7F5-57EC-87DA-1DB460D64046,"iPhone13,2"
com.apple.weather,22,1749598710,1749598732,1749598732.168575,-25200,EB445137-D7F5-57EC-87DA-1DB460D64046,"iPhone13,2"
com.apple.Maps,1,1749598708,1749598709,1749598709.990182,-25200,EB445137-D7F5-57EC-87DA-1DB460D64046,"iPhone13,2"
com.apple.Maps,70,1749596795,1749596865,1749596865.3788419,-25200,EB445137-D7F5-57EC-87DA-1DB460D64046,"iPhone13,2"
com.google.chrome.ios,6,1749596789,1749596795,1749596795.126711,-25200,EB445137-D7F5-57EC-87DA-1DB460D64046,"iPhone13,2"
com.apple.weather,4,1749596785,1749596789,1749596789.759479,-25200,EB445137-D7F5-57EC-87DA-1DB460D64046,"iPhone13,2"
com.apple.weather,4,1749596736,1749596740,1749596740.9951758,-25200,EB445137-D7F5-57EC-87DA-1DB460D64046,"iPhone13,2"
com.apple.Preferences,69,1749596600,1749596669,1749596669.882689,-25200,EB445137-D7F5-57EC-87DA-1DB460D64046,"iPhone13,2"
com.google.chrome.ios,6,1749596594,1749596600,1749596600.178903,-25200,EB445137-D7F5-57EC-87DA-1DB460D64046,"iPhone13,2"
com.google.chrome.ios,61,1749596151,1749596212,1749596212.8666759,-25200,EB445137-D7F5-57EC-87DA-1DB460D64046,"iPhone13,2"
com.google.chrome.ios,159,1749595992,1749596151,1749596152.250266,-25200,EB445137-D7F5-57EC-87DA-1DB460D64046,"iPhone13,2"
com.apple.Maps,3,1749595936,1749595939,1749595939.654814,-25200,EB445137-D7F5-57EC-87DA-1DB460D64046,"iPhone13,2"
com.apple.Maps,48,1749594893,1749594941,1749594941.676765,-25200,EB445137-D7F5-57EC-87DA-1DB460D64046,"iPhone13,2"
com.apple.mobilenotes,7,1749594870,1749594877,1749594877.801982,-25200,EB445137-D7F5-57EC-87DA-1DB460D64046,"iPhone13,2"
com.apple.Maps,15,1749594807,1749594822,1749594822.389734,-25200,EB445137-D7F5-57EC-87DA-1DB460D64046,"iPhone13,2"
com.apple.Maps,70,1749594642,1749594712,1749594712.978754,-25200,EB445137-D7F5-57EC-87DA-1DB460D64046,"iPhone13,2"
com.apple.Maps,18,1749594153,1749594171,1749594171.0735378,-25200,EB445137-D7F5-57EC-87DA-1DB460D64046,"iPhone13,2"
com.apple.Maps,71,1749593817,1749593888,1749593888.829958,-25200,EB445137-D7F5-57EC-87DA-1DB460D64046,"iPhone13,2"
com.apple.Maps,8,1749592765,1749592773,1749592773.212624,-25200,EB445137-D7F5-57EC-87DA-1DB460D64046,"iPhone13,2"
com.apple.Maps,0,1749592764,1749592764,1749592764.9015121,-25200,EB445137-D7F5-57EC-87DA-1DB460D64046,"iPhone13,2"
com.apple.Maps,40,1749592713,1749592753,1749592753.501312,-25200,EB445137-D7F5-57EC-87DA-1DB460D64046,"iPhone13,2"
com.apple.Maps,3,1749592709,1749592712,1749592712.584259,-25200,EB445137-D7F5-57EC-87DA-1DB460D64046,"iPhone13,2"
com.apple.Maps,222,1749592257,1749592479,1749592480.333521,-25200,EB445137-D7F5-57EC-87DA-1DB460D64046,"iPhone13,2"
com.google.chrome.ios,53,1749592204,1749592257,1749592257.296623,-25200,EB445137-D7F5-57EC-87DA-1DB460D64046,"iPhone13,2"
com.apple.mobileslideshow,105,1749591446,1749591551,1749591551.178866,-25200,EB445137-D7F5-57EC-87DA-1DB460D64046,"iPhone13,2"
com.apple.mobileslideshow,22,1749589331,1749589353,1749589353.5724401,-25200,EB445137-D7F5-57EC-87DA-1DB460D64046,"iPhone13,2"
com.apple.mobilenotes,0,1749589331,1749589331,1749589332.4337049,-25200,EB445137-D7F5-57EC-87DA-1DB460D64046,"iPhone13,2"
com.apple.mobilenotes,173,1749587633,1749587806,1749587806.177767,-25200,EB445137-D7F5-57EC-87DA-1DB460D64046,"iPhone13,2"
com.apple.Maps,1,1749587629,1749587630,1749587630.856107,-25200,EB445137-D7F5-57EC-87DA-1DB460D64046,"iPhone13,2"
com.apple.Maps,44,1749587534,1749587578,1749587578.9845629,-25200,EB445137-D7F5-57EC-87DA-1DB460D64046,"iPhone13,2"
com.apple.Fitness,1,1749587532,1749587533,1749587533.772437,-25200,EB445137-D7F5-57EC-87DA-1DB460D64046,"iPhone13,2"
com.apple.Fitness,58,1749586503,1749586561,1749586561.940299,-25200,EB445137-D7F5-57EC-87DA-1DB460D64046,"iPhone13,2"
com.apple.Fitness,50,1749586452,1749586502,1749586502.66424,-25200,EB445137-D7F5-57EC-87DA-1DB460D64046,"iPhone13,2"
com.facebook.Facebook,1,1749586444,1749586445,1749586445.787183,-25200,EB445137-D7F5-57EC-87DA-1DB460D64046,"iPhone13,2"
com.facebook.Facebook,2,1749586301,1749586303,1749586303.827646,-25200,EB445137-D7F5-57EC-87DA-1DB460D64046,"iPhone13,2"
com.apple.mobileslideshow,17,1749586284,1749586301,1749586301.281841,-25200,EB445137-D7F5-57EC-87DA-1DB460D64046,"iPhone13,2"
com.facebook.Facebook,52,1749586232,1749586284,1749586284.3959088,-25200,EB445137-D7F5-57EC-87DA-1DB460D64046,"iPhone13,2"
com.apple.mobileslideshow,4,1749586225,1749586229,1749586229.966411,-25200,EB445137-D7F5-57EC-87DA-1DB460D64046,"iPhone13,2"
com.apple.mobileslideshow,36,1749586184,1749586220,1749586220.203467,-25200,EB445137-D7F5-57EC-87DA-1DB460D64046,"iPhone13,2"
com.google.Sheets,296,1749585885,1749586181,1749586181.867041,-25200,EB445137-D7F5-57EC-87DA-1DB460D64046,"iPhone13,2"
com.apple.Maps,48,1749583873,1749583921,1749583921.488426,-25200,EB445137-D7F5-57EC-87DA-1DB460D64046,"iPhone13,2"
com.apple.Maps,33,1749583616,1749583649,1749583649.2655811,-25200,EB445137-D7F5-57EC-87DA-1DB460D64046,"iPhone13,2"
com.apple.news,256,1749583038,1749583294,1749583294.6378431,-25200,EB445137-D7F5-57EC-87DA-1DB460D64046,"iPhone13,2"
com.strava.stravaride,20,1749582628,1749582648,1749582648.5834398,-25200,EB445137-D7F5-57EC-87DA-1DB460D64046,"iPhone13,2"
com.apple.mobileslideshow,11,1749582617,1749582628,1749582628.854248,-25200,EB445137-D7F5-57EC-87DA-1DB460D64046,"iPhone13,2"
com.strava.stravaride,248,1749582369,1749582617,1749582617.416863,-25200,EB445137-D7F5-57EC-87DA-1DB460D64046,"iPhone13,2"
com.apple.news,65,1749582206,1749582271,1749582271.25967,-25200,EB445137-D7F5-57EC-87DA-1DB460D64046,"iPhone13,2"
com.apple.weather,2,1749582196,1749582198,1749582198.964363,-25200,EB445137-D7F5-57EC-87DA-1DB460D64046,"iPhone13,2"
com.apple.weather,10,1749580573,1749580583,1749580584.218662,-25200,EB445137-D7F5-57EC-87DA-1DB460D64046,"iPhone13,2"
com.apple.Maps,18,1749575494,1749575512,1749575512.361728,-25200,EB445137-D7F5-57EC-87DA-1DB460D64046,"iPhone13,2"
com.apple.Maps,36,1749575018,1749575054,1749575054.487823,-25200,EB445137-D7F5-57EC-87DA-1DB460D64046,"iPhone13,2"
com.apple.Maps,53,1749574712,1749574765,1749574765.320858,-25200,EB445137-D7F5-57EC-87DA-1DB460D64046,"iPhone13,2"
com.apple.Music,27,1749574632,1749574659,1749574659.960219,-25200,EB445137-D7F5-57EC-87DA-1DB460D64046,"iPhone13,2"
com.apple.musicrecognition,3,1749574629,1749574632,1749574632.689795,-25200,EB445137-D7F5-57EC-87DA-1DB460D64046,"iPhone13,2"
com.facebook.Facebook,145,1749573220,1749573365,1749573365.357521,-25200,EB445137-D7F5-57EC-87DA-1DB460D64046,"iPhone13,2"
com.apple.Maps,599,1749572475,1749573074,1749573075.060615,-25200,EB445137-D7F5-57EC-87DA-1DB460D64046,"iPhone13,2"
com.apple.Maps,55,1749571260,1749571315,1749571315.5475678,-25200,EB445137-D7F5-57EC-87DA-1DB460D64046,"iPhone13,2"
com.doordash.dasher,2,1749571253,1749571255,1749571255.9757051,-25200,EB445137-D7F5-57EC-87DA-1DB460D64046,"iPhone13,2"
com.apple.MobileSMS,7,1749571188,1749571195,1749571195.747596,-25200,EB445137-D7F5-57EC-87DA-1DB460D64046,"iPhone13,2"
com.apple.mobileslideshow,27,1749569161,1749569188,1749569188.916651,-25200,EB445137-D7F5-57EC-87DA-1DB460D64046,"iPhone13,2"
com.apple.mobileslideshow,16,1749569081,1749569097,1749569098.304864,-25200,EB445137-D7F5-57EC-87DA-1DB460D64046,"iPhone13,2"
com.apple.mobileslideshow,145,1749568904,1749569049,1749569049.11538,-25200,EB445137-D7F5-57EC-87DA-1DB460D64046,"iPhone13,2"
com.apple.mobilenotes,14,1749568888,1749568902,1749568902.128813,-25200,EB445137-D7F5-57EC-87DA-1DB460D64046,"iPhone13,2"
com.google.chrome.ios,2,1749568886,1749568888,1749568888.563889,-25200,EB445137-D7F5-57EC-87DA-1DB460D64046,"iPhone13,2"
com.google.chrome.ios,186,1749568547,1749568733,1749568733.554524,-25200,EB445137-D7F5-57EC-87DA-1DB460D64046,"iPhone13,2"
com.strava.stravaride,96,1749568280,1749568376,1749568376.131114,-25200,EB445137-D7F5-57EC-87DA-1DB460D64046,"iPhone13,2"
com.apple.mobilenotes,3,1749568266,1749568269,1749568269.211269,-25200,EB445137-D7F5-57EC-87DA-1DB460D64046,"iPhone13,2"
com.apple.mobilenotes,17,1749567811,1749567828,1749567828.1341481,-25200,EB445137-D7F5-57EC-87DA-1DB460D64046,"iPhone13,2"
com.apple.MobileSMS,3,1749567806,1749567809,1749567809.1445498,-25200,EB445137-D7F5-57EC-87DA-1DB460D64046,"iPhone13,2"
com.apple.MobileSMS,4,1749567782,1749567786,1749567786.3514051,-25200,EB445137-D7F5-57EC-87DA-1DB460D64046,"iPhone13,2"
com.apple.MobileSMS,198,1749567584,1749567782,1749567782.2384791,-25200,EB445137-D7F5-57EC-87DA-1DB460D64046,"iPhone13,2"
com.apple.Health,25,1749566295,1749566320,1749566320.898109,-25200,EB445137-D7F5-57EC-87DA-1DB460D64046,"iPhone13,2"
com.apple.MobileSMS,2,1749566292,1749566294,1749566294.585822,-25200,EB445137-D7F5-57EC-87DA-1DB460D64046,"iPhone13,2"
com.apple.MobileSMS,77,1749566165,1749566242,1749566242.259244,-25200,EB445137-D7F5-57EC-87DA-1DB460D64046,"iPhone13,2"
com.strava.stravaride,51,1749566082,1749566133,1749566133.8277411,-25200,EB445137-D7F5-57EC-87DA-1DB460D64046,"iPhone13,2"
com.apple.mobiletimer,0,1749566082,1749566082,1749566082.877411,-25200,EB445137-D7F5-57EC-87DA-1DB460D64046,"iPhone13,2"
com.apple.mobiletimer,14,1749531419,1749531433,1749531434.017282,-25200,EB445137-D7F5-57EC-87DA-1DB460D64046,"iPhone13,2"
com.thestorygraph.thestorygraph,18,1749531399,1749531417,1749531417.503202,-25200,EB445137-D7F5-57EC-87DA-1DB460D64046,"iPhone13,2"
com.apple.MobileSMS,127,1749529037,1749529164,1749529164.904642,-25200,EB445137-D7F5-57EC-87DA-1DB460D64046,"iPhone13,2"
com.apple.mobilenotes,37,1749529000,1749529037,1749529037.54232,-25200,EB445137-D7F5-57EC-87DA-1DB460D64046,"iPhone13,2"
com.apple.MobileSMS,2,1749528998,1749529000,1749529000.483696,-25200,EB445137-D7F5-57EC-87DA-1DB460D64046,"iPhone13,2"
com.apple.mobilenotes,379,1749528619,1749528998,1749528998.51014,-25200,EB445137-D7F5-57EC-87DA-1DB460D64046,"iPhone13,2"
com.apple.MobileSMS,2,1749528616,1749528618,1749528618.984541,-25200,EB445137-D7F5-57EC-87DA-1DB460D64046,"iPhone13,2"
com.apple.journal,87,1749528529,1749528616,1749528616.69655,-25200,EB445137-D7F5-57EC-87DA-1DB460D64046,"iPhone13,2"
com.apple.Maps,17,1749528512,1749528529,1749528529.468443,-25200,EB445137-D7F5-57EC-87DA-1DB460D64046,"iPhone13,2"
com.apple.journal,98,1749528414,1749528512,1749528512.986407,-25200,EB445137-D7F5-57EC-87DA-1DB460D64046,"iPhone13,2"
com.apple.journal,90,1749528307,1749528397,1749528397.556299,-25200,EB445137-D7F5-57EC-87DA-1DB460D64046,"iPhone13,2"
com.apple.Maps,13,1749528294,1749528307,1749528307.64608,-25200,EB445137-D7F5-57EC-87DA-1DB460D64046,"iPhone13,2"
com.apple.journal,1245,1749527049,1749528294,1749528294.662085,-25200,EB445137-D7F5-57EC-87DA-1DB460D64046,"iPhone13,2"
com.apple.mobileslideshow,29,1749527020,1749527049,1749527049.2702122,-25200,EB445137-D7F5-57EC-87DA-1DB460D64046,"iPhone13,2"
com.apple.journal,57,1749526952,1749527009,1749527009.7218971,-25200,EB445137-D7F5-57EC-87DA-1DB460D64046,"iPhone13,2"
com.apple.journal,334,1749526602,1749526936,1749526936.347093,-25200,EB445137-D7F5-57EC-87DA-1DB460D64046,"iPhone13,2"
com.apple.CoreAuthUI,2,1749526532,1749526534,1749526534.4231992,-25200,EB445137-D7F5-57EC-87DA-1DB460D64046,"iPhone13,2"
com.apple.journal,24,1749526531,1749526555,1749526555.657792,-25200,EB445137-D7F5-57EC-87DA-1DB460D64046,"iPhone13,2"
com.apple.Health,3,1749526522,1749526525,1749526525.8876061,-25200,EB445137-D7F5-57EC-87DA-1DB460D64046,"iPhone13,2"
com.apple.Health,1,1749526521,1749526522,1749526522.159696,-25200,EB445137-D7F5-57EC-87DA-1DB460D64046,"iPhone13,2"
com.apple.Health,2,1749525190,1749525192,1749525192.687272,-25200,EB445137-D7F5-57EC-87DA-1DB460D64046,"iPhone13,2"
com.apple.calculator,12,1749525178,1749525190,1749525190.2181659,-25200,EB445137-D7F5-57EC-87DA-1DB460D64046,"iPhone13,2"
com.apple.Health,35,1749525143,1749525178,1749525178.2542129,-25200,EB445137-D7F5-57EC-87DA-1DB460D64046,"iPhone13,2"
com.apple.Fitness,49,1749525093,1749525142,1749525142.195095,-25200,EB445137-D7F5-57EC-87DA-1DB460D64046,"iPhone13,2"
com.apple.Fitness,137,1749524845,1749524982,1749524982.833401,-25200,EB445137-D7F5-57EC-87DA-1DB460D64046,"iPhone13,2"
com.google.chrome.ios,3,1749524815,1749524818,1749524818.756556,-25200,EB445137-D7F5-57EC-87DA-1DB460D64046,"iPhone13,2"
com.google.chrome.ios,11,1749523639,1749523650,1749523650.162531,-25200,EB445137-D7F5-57EC-87DA-1DB460D64046,"iPhone13,2"
com.apple.mobileslideshow,3,1749523636,1749523639,1749523639.1545901,-25200,EB445137-D7F5-57EC-87DA-1DB460D64046,"iPhone13,2"
com.apple.mobileslideshow,1,1749523635,1749523636,1749523636.475614,-25200,EB445137-D7F5-57EC-87DA-1DB460D64046,"iPhone13,2"
com.apple.mobileslideshow,15,1749523484,1749523499,1749523499.566526,-25200,EB445137-D7F5-57EC-87DA-1DB460D64046,"iPhone13,2"
com.google.chrome.ios,2,1749523482,1749523484,1749523484.327456,-25200,EB445137-D7F5-57EC-87DA-1DB460D64046,"iPhone13,2"
com.google.chrome.ios,16,1749521924,1749521940,1749521940.74973,-25200,EB445137-D7F5-57EC-87DA-1DB460D64046,"iPhone13,2"
com.apple.Maps,18,1749521906,1749521924,1749521924.268908,-25200,EB445137-D7F5-57EC-87DA-1DB460D64046,"iPhone13,2"
com.apple.Maps,22,1749521585,1749521607,1749521607.482994,-25200,EB445137-D7F5-57EC-87DA-1DB460D64046,"iPhone13,2"
com.google.chrome.ios,1,1749521584,1749521585,1749521585.861707,-25200,EB445137-D7F5-57EC-87DA-1DB460D64046,"iPhone13,2"
com.google.chrome.ios,18,1749521446,1749521464,1749521464.452651,-25200,EB445137-D7F5-57EC-87DA-1DB460D64046,"iPhone13,2"
com.google.chrome.ios,10,1749521410,1749521420,1749521420.14184,-25200,EB445137-D7F5-57EC-87DA-1DB460D64046,"iPhone13,2"
com.apple.Maps,2,1749521408,1749521410,1749521410.531302,-25200,EB445137-D7F5-57EC-87DA-1DB460D64046,"iPhone13,2"
com.apple.Maps,8,1749521385,1749521393,1749521393.223034,-25200,EB445137-D7F5-57EC-87DA-1DB460D64046,"iPhone13,2"
com.apple.Maps,21,1749521271,1749521292,1749521292.416369,-25200,EB445137-D7F5-57EC-87DA-1DB460D64046,"iPhone13,2"
edu.cornell.birds.merlin,53,1749521046,1749521099,1749521099.185014,-25200,EB445137-D7F5-57EC-87DA-1DB460D64046,"iPhone13,2"
edu.cornell.birds.merlin,12,1749521028,1749521040,1749521040.24127,-25200,EB445137-D7F5-57EC-87DA-1DB460D64046,"iPhone13,2"
com.apple.Maps,2,1749521024,1749521026,1749521026.870312,-25200,EB445137-D7F5-57EC-87DA-1DB460D64046,"iPhone13,2"
com.apple.Maps,15,1749520880,1749520895,1749520895.45407,-25200,EB445137-D7F5-57EC-87DA-1DB460D64046,"iPhone13,2"
com.apple.Maps,8,1749520838,1749520846,1749520847.011565,-25200,EB445137-D7F5-57EC-87DA-1DB460D64046,"iPhone13,2"
com.apple.Maps,48,1749520760,1749520808,1749520808.120331,-25200,EB445137-D7F5-57EC-87DA-1DB460D64046,"iPhone13,2"
com.google.chrome.ios,2,1749520758,1749520760,1749520760.0401,-25200,EB445137-D7F5-57EC-87DA-1DB460D64046,"iPhone13,2"
com.google.chrome.ios,29,1749520661,1749520690,1749520690.229078,-25200,EB445137-D7F5-57EC-87DA-1DB460D64046,"iPhone13,2"
com.apple.Maps,3,1749520658,1749520661,1749520661.3403502,-25200,EB445137-D7F5-57EC-87DA-1DB460D64046,"iPhone13,2"
com.apple.Maps,5,1749519920,1749519925,1749519925.669631,-25200,EB445137-D7F5-57EC-87DA-1DB460D64046,"iPhone13,2"
com.apple.Maps,5,1749519330,1749519335,1749519335.7234778,-25200,EB445137-D7F5-57EC-87DA-1DB460D64046,"iPhone13,2"
com.google.chrome.ios,1,1749519220,1749519221,1749519221.976039,-25200,EB445137-D7F5-57EC-87DA-1DB460D64046,"iPhone13,2"
com.google.chrome.ios,63,1749519113,1749519176,1749519176.686977,-25200,EB445137-D7F5-57EC-87DA-1DB460D64046,"iPhone13,2"
com.apple.Maps,2,1749519111,1749519113,1749519113.057386,-25200,EB445137-D7F5-57EC-87DA-1DB460D64046,"iPhone13,2"
com.apple.Maps,30,1749518966,1749518996,1749518996.202694,-25200,EB445137-D7F5-57EC-87DA-1DB460D64046,"iPhone13,2"
com.google.chrome.ios,2,1749518964,1749518966,1749518966.568624,-25200,EB445137-D7F5-57EC-87DA-1DB460D64046,"iPhone13,2"
com.google.chrome.ios,40,1749518170,1749518210,1749518210.45187,-25200,EB445137-D7F5-57EC-87DA-1DB460D64046,"iPhone13,2"
com.apple.Maps,342,1749517828,1749518170,1749518171.052058,-25200,EB445137-D7F5-57EC-87DA-1DB460D64046,"iPhone13,2"
com.google.chrome.ios,201,1749517627,1749517828,1749517828.3390121,-25200,EB445137-D7F5-57EC-87DA-1DB460D64046,"iPhone13,2"
com.apple.Maps,28,1749517599,1749517627,1749517627.803659,-25200,EB445137-D7F5-57EC-87DA-1DB460D64046,"iPhone13,2"
com.google.chrome.ios,13,1749517586,1749517599,1749517599.345159,-25200,EB445137-D7F5-57EC-87DA-1DB460D64046,"iPhone13,2"
com.google.chrome.ios,313,1749517217,1749517530,1749517530.70069,-25200,EB445137-D7F5-57EC-87DA-1DB460D64046,"iPhone13,2"
com.google.chrome.ios,29,1749516952,1749516981,1749516981.8851218,-25200,EB445137-D7F5-57EC-87DA-1DB460D64046,"iPhone13,2"
com.google.chrome.ios,2,1749516949,1749516951,1749516951.084103,-25200,EB445137-D7F5-57EC-87DA-1DB460D64046,"iPhone13,2"
com.google.chrome.ios,172,1749516280,1749516452,1749516452.6792932,-25200,EB445137-D7F5-57EC-87DA-1DB460D64046,"iPhone13,2"
com.apple.mobilenotes,2,1749516278,1749516280,1749516280.209525,-25200,EB445137-D7F5-57EC-87DA-1DB460D64046,"iPhone13,2"
com.apple.mobilenotes,60,1749515579,1749515639,1749515639.951589,-25200,EB445137-D7F5-57EC-87DA-1DB460D64046,"iPhone13,2"
com.openai.chat,2,1749515577,1749515579,1749515579.142581,-25200,EB445137-D7F5-57EC-87DA-1DB460D64046,"iPhone13,2"
com.openai.chat,1,1749515576,1749515577,1749515577.1687431,-25200,EB445137-D7F5-57EC-87DA-1DB460D64046,"iPhone13,2"
com.openai.chat,7,1749514247,1749514254,1749514255.23882,-25200,EB445137-D7F5-57EC-87DA-1DB460D64046,"iPhone13,2"
com.google.chrome.ios,44,1749514203,1749514247,1749514247.0623488,-25200,EB445137-D7F5-57EC-87DA-1DB460D64046,"iPhone13,2"
com.apple.findmy,3,1749514200,1749514203,1749514204.140454,-25200,EB445137-D7F5-57EC-87DA-1DB460D64046,"iPhone13,2"
com.apple.findmy,23,1749513954,1749513977,1749513977.49184,-25200,EB445137-D7F5-57EC-87DA-1DB460D64046,"iPhone13,2"
com.apple.mobileslideshow,2,1749513952,1749513954,1749513954.1710691,-25200,EB445137-D7F5-57EC-87DA-1DB460D64046,"iPhone13,2"
com.apple.mobileslideshow,11,1749513684,1749513695,1749513696.015228,-25200,EB445137-D7F5-57EC-87DA-1DB460D64046,"iPhone13,2"
com.apple.mobileslideshow,75,1749513585,1749513660,1749513661.3670979,-25200,EB445137-D7F5-57EC-87DA-1DB460D64046,"iPhone13,2"
com.facebook.Facebook,43,1749513540,1749513583,1749513583.956833,-25200,EB445137-D7F5-57EC-87DA-1DB460D64046,"iPhone13,2"
com.toyopagroup.picaboo,52,1749513484,1749513536,1749513536.925424,-25200,EB445137-D7F5-57EC-87DA-1DB460D64046,"iPhone13,2"
com.apple.Maps,0,1749513484,1749513484,1749513485.086094,-25200,EB445137-D7F5-57EC-87DA-1DB460D64046,"iPhone13,2"
com.apple.Maps,130,1749512706,1749512836,1749512836.791541,-25200,EB445137-D7F5-57EC-87DA-1DB460D64046,"iPhone13,2"
com.google.chrome.ios,4,1749512702,1749512706,1749512706.301338,-25200,EB445137-D7F5-57EC-87DA-1DB460D64046,"iPhone13,2"
com.apple.CoreAuthUI,1,1749512353,1749512354,1749512354.947947,-25200,EB445137-D7F5-57EC-87DA-1DB460D64046,"iPhone13,2"
com.apple.CoreAuthUI,2,1749512170,1749512172,1749512172.155916,-25200,EB445137-D7F5-57EC-87DA-1DB460D64046,"iPhone13,2"
com.truebill.truebillnative,200,1749512161,1749512361,1749512361.1978168,-25200,EB445137-D7F5-57EC-87DA-1DB460D64046,"iPhone13,2"
com.google.chrome.ios,84,1749512067,1749512151,1749512151.875712,-25200,EB445137-D7F5-57EC-87DA-1DB460D64046,"iPhone13,2"
com.apple.mobileslideshow,29,1749512033,1749512062,1749512062.6576319,-25200,EB445137-D7F5-57EC-87DA-1DB460D64046,"iPhone13,2"
com.apple.news,138,1749511618,1749511756,1749511756.1830292,-25200,EB445137-D7F5-57EC-87DA-1DB460D64046,"iPhone13,2"
com.apple.Health,5,1749511608,1749511613,1749511613.820565,-25200,EB445137-D7F5-57EC-87DA-1DB460D64046,"iPhone13,2"
com.strava.stravaride,74,1749511531,1749511605,1749511605.1914148,-25200,EB445137-D7F5-57EC-87DA-1DB460D64046,"iPhone13,2"
com.thestorygraph.thestorygraph,51,1749511477,1749511528,1749511528.5759702,-25200,EB445137-D7F5-57EC-87DA-1DB460D64046,"iPhone13,2"
com.thestorygraph.thestorygraph,61,1749511414,1749511475,1749511475.46027,-25200,EB445137-D7F5-57EC-87DA-1DB460D64046,"iPhone13,2"
com.apple.mobileslideshow,2,1749511409,1749511411,1749511411.52023,-25200,EB445137-D7F5-57EC-87DA-1DB460D64046,"iPhone13,2"
com.apple.mobileslideshow,9,1749507712,1749507721,1749507722.142167,-25200,EB445137-D7F5-57EC-87DA-1DB460D64046,"iPhone13,2"
com.apple.mobileslideshow,110,1749507599,1749507709,1749507719.080505,-25200,EB445137-D7F5-57EC-87DA-1DB460D64046,"iPhone13,2"
com.apple.mobileslideshow,202,1749507306,1749507508,1749507508.424756,-25200,EB445137-D7F5-57EC-87DA-1DB460D64046,"iPhone13,2"
com.apple.mobileslideshow,222,1749506842,1749507064,1749507064.99667,-25200,EB445137-D7F5-57EC-87DA-1DB460D64046,"iPhone13,2"
com.google.chrome.ios,603,1749503446,1749504049,1749504049.663035,-25200,EB445137-D7F5-57EC-87DA-1DB460D64046,"iPhone13,2"
com.apple.Maps,6,1749502814,1749502820,1749502820.8314261,-25200,EB445137-D7F5-57EC-87DA-1DB460D64046,"iPhone13,2"
com.apple.Maps,11,1749500393,1749500404,1749500404.096873,-25200,EB445137-D7F5-57EC-87DA-1DB460D64046,"iPhone13,2"
com.apple.Maps,12,1749500344,1749500356,1749500356.767424,-25200,EB445137-D7F5-57EC-87DA-1DB460D64046,"iPhone13,2"
com.apple.Maps,102,1749499975,1749500077,1749500077.915375,-25200,EB445137-D7F5-57EC-87DA-1DB460D64046,"iPhone13,2"
com.apple.mobilenotes,3,1749499972,1749499975,1749499975.6501698,-25200,EB445137-D7F5-57EC-87DA-1DB460D64046,"iPhone13,2"
com.apple.mobilenotes,11,1749499764,1749499775,1749499775.690157,-25200,EB445137-D7F5-57EC-87DA-1DB460D64046,"iPhone13,2"
com.strava.stravaride,41,1749499719,1749499760,1749499760.536932,-25200,EB445137-D7F5-57EC-87DA-1DB460D64046,"iPhone13,2"
com.strava.stravaride,172,1749499048,1749499220,1749499220.791985,-25200,EB445137-D7F5-57EC-87DA-1DB460D64046,"iPhone13,2"
com.apple.Health,30,1749498810,1749498840,1749498840.9694772,-25200,EB445137-D7F5-57EC-87DA-1DB460D64046,"iPhone13,2"
com.apple.Health,30,1749498777,1749498807,1749498807.846365,-25200,EB445137-D7F5-57EC-87DA-1DB460D64046,"iPhone13,2"
com.apple.mobileslideshow,3,1749498761,1749498764,1749498764.778909,-25200,EB445137-D7F5-57EC-87DA-1DB460D64046,"iPhone13,2"
com.apple.mobileslideshow,0,1749498760,1749498760,1749498760.930398,-25200,EB445137-D7F5-57EC-87DA-1DB460D64046,"iPhone13,2"
com.apple.mobileslideshow,47,1749498382,1749498429,1749498429.845438,-25200,EB445137-D7F5-57EC-87DA-1DB460D64046,"iPhone13,2"
com.apple.weather,14,1749497439,1749497453,1749497453.492626,-25200,EB445137-D7F5-57EC-87DA-1DB460D64046,"iPhone13,2"
com.apple.Maps,23,1749497356,1749497379,1749497379.878353,-25200,EB445137-D7F5-57EC-87DA-1DB460D64046,"iPhone13,2"
com.apple.Maps,9,1749497023,1749497032,1749497032.314815,-25200,EB445137-D7F5-57EC-87DA-1DB460D64046,"iPhone13,2"
com.apple.Maps,13,1749496926,1749496939,1749496939.836206,-25200,EB445137-D7F5-57EC-87DA-1DB460D64046,"iPhone13,2"
com.apple.Maps,145,1749496473,1749496618,1749496618.294464,-25200,EB445137-D7F5-57EC-87DA-1DB460D64046,"iPhone13,2"
com.apple.MobileSMS,3,1749496073,1749496076,1749496076.404784,-25200,EB445137-D7F5-57EC-87DA-1DB460D64046,"iPhone13,2"
com.apple.Maps,0,1749496073,1749496073,1749496074.2368011,-25200,EB445137-D7F5-57EC-87DA-1DB460D64046,"iPhone13,2"
com.apple.Maps,176,1749495508,1749495684,1749495684.939811,-25200,EB445137-D7F5-57EC-87DA-1DB460D64046,"iPhone13,2"
com.strava.stravaride,115,1749495270,1749495385,1749495385.957994,-25200,EB445137-D7F5-57EC-87DA-1DB460D64046,"iPhone13,2"
com.strava.stravaride,76,1749495137,1749495213,1749495213.763037,-25200,EB445137-D7F5-57EC-87DA-1DB460D64046,"iPhone13,2"
com.apple.MobileSMS,33,1749495104,1749495137,1749495137.554088,-25200,EB445137-D7F5-57EC-87DA-1DB460D64046,"iPhone13,2"
com.apple.MobileSMS,5,1749494029,1749494034,1749494034.689512,-25200,EB445137-D7F5-57EC-87DA-1DB460D64046,"iPhone13,2"
com.apple.findmy,21,1749494008,1749494029,1749494029.866051,-25200,EB445137-D7F5-57EC-87DA-1DB460D64046,"iPhone13,2"
com.apple.findmy,67,1749493916,1749493983,1749493984.705198,-25200,EB445137-D7F5-57EC-87DA-1DB460D64046,"iPhone13,2"
com.apple.findmy,24,1749493856,1749493880,1749493880.584248,-25200,EB445137-D7F5-57EC-87DA-1DB460D64046,"iPhone13,2"
com.apple.MobileSMS,4,1749493848,1749493852,1749493852.382745,-25200,EB445137-D7F5-57EC-87DA-1DB460D64046,"iPhone13,2"
com.apple.MobileSMS,14,1749493784,1749493798,1749493798.554336,-25200,EB445137-D7F5-57EC-87DA-1DB460D64046,"iPhone13,2"
com.apple.findmy,2,1749493782,1749493784,1749493785.580823,-25200,EB445137-D7F5-57EC-87DA-1DB460D64046,"iPhone13,2"
com.apple.findmy,35,1749493739,1749493774,1749493774.905055,-25200,EB445137-D7F5-57EC-87DA-1DB460D64046,"iPhone13,2"
com.apple.Maps,3,1749493736,1749493739,1749493739.807617,-25200,EB445137-D7F5-57EC-87DA-1DB460D64046,"iPhone13,2"
com.apple.Maps,10,1749490934,1749490944,1749490944.1081228,-25200,EB445137-D7F5-57EC-87DA-1DB460D64046,"iPhone13,2"
com.apple.mobileslideshow,64,1749490794,1749490858,1749490858.336168,-25200,EB445137-D7F5-57EC-87DA-1DB460D64046,"iPhone13,2"
com.apple.MobileSMS,0,1749490794,1749490794,1749490794.567245,-25200,EB445137-D7F5-57EC-87DA-1DB460D64046,"iPhone13,2"
com.apple.MobileSMS,2,1749490449,1749490451,1749490451.330354,-25200,EB445137-D7F5-57EC-87DA-1DB460D64046,"iPhone13,2"
com.apple.MobileSMS,15,1749490415,1749490430,1749490430.8348641,-25200,EB445137-D7F5-57EC-87DA-1DB460D64046,"iPhone13,2"
com.apple.Maps,2,1749490413,1749490415,1749490415.854461,-25200,EB445137-D7F5-57EC-87DA-1DB460D64046,"iPhone13,2"
com.apple.Maps,0,1749490412,1749490412,1749490413.216254,-25200,EB445137-D7F5-57EC-87DA-1DB460D64046,"iPhone13,2"
com.apple.Maps,22,1749490076,1749490098,1749490098.2125978,-25200,EB445137-D7F5-57EC-87DA-1DB460D64046,"iPhone13,2"
com.apple.Maps,3,1749490035,1749490038,1749490038.7429938,-25200,EB445137-D7F5-57EC-87DA-1DB460D64046,"iPhone13,2"
com.apple.Maps,10,1749489216,1749489226,1749489226.720176,-25200,EB445137-D7F5-57EC-87DA-1DB460D64046,"iPhone13,2"
com.apple.findmy,20,1749489196,1749489216,1749489216.203804,-25200,EB445137-D7F5-57EC-87DA-1DB460D64046,"iPhone13,2"
com.apple.Maps,20,1749489176,1749489196,1749489196.251995,-25200,EB445137-D7F5-57EC-87DA-1DB460D64046,"iPhone13,2"
com.apple.Maps,30,1749488319,1749488349,1749488349.227134,-25200,EB445137-D7F5-57EC-87DA-1DB460D64046,"iPhone13,2"
com.apple.findmy,66,1749488106,1749488172,1749488172.4268808,-25200,EB445137-D7F5-57EC-87DA-1DB460D64046,"iPhone13,2"
com.apple.findmy,15,1749487322,1749487337,1749487337.648905,-25200,EB445137-D7F5-57EC-87DA-1DB460D64046,"iPhone13,2"
com.apple.findmy,20,1749486523,1749486543,1749486543.290347,-25200,EB445137-D7F5-57EC-87DA-1DB460D64046,"iPhone13,2"
com.apple.MobileSMS,2,1749486520,1749486522,1749486522.278434,-25200,EB445137-D7F5-57EC-87DA-1DB460D64046,"iPhone13,2"
com.apple.MobileSMS,6,1749486398,1749486404,1749486404.76585,-25200,EB445137-D7F5-57EC-87DA-1DB460D64046,"iPhone13,2"
com.apple.Maps,1,1749486397,1749486398,1749486398.8891978,-25200,EB445137-D7F5-57EC-87DA-1DB460D64046,"iPhone13,2"
com.apple.Maps,4,1749486242,1749486246,1749486246.970938,-25200,EB445137-D7F5-57EC-87DA-1DB460D64046,"iPhone13,2"
com.apple.MobileSMS,5,1749486233,1749486238,1749486238.271865,-25200,EB445137-D7F5-57EC-87DA-1DB460D64046,"iPhone13,2"
com.apple.MobileSMS,15,1749485993,1749486008,1749486008.569374,-25200,EB445137-D7F5-57EC-87DA-1DB460D64046,"iPhone13,2"
com.apple.Maps,79,1749483195,1749483274,1749483274.089264,-25200,EB445137-D7F5-57EC-87DA-1DB460D64046,"iPhone13,2"
com.apple.Maps,4,1749478545,1749478549,1749478549.56072,-25200,EB445137-D7F5-57EC-87DA-1DB460D64046,"iPhone13,2"
com.apple.Maps,16,1749478196,1749478212,1749478212.8467731,-25200,EB445137-D7F5-57EC-87DA-1DB460D64046,"iPhone13,2"
com.apple.Maps,33,1749478131,1749478164,1749478164.439821,-25200,EB445137-D7F5-57EC-87DA-1DB460D64046,"iPhone13,2"
com.apple.Maps,5,1749478110,1749478115,1749478115.283891,-25200,EB445137-D7F5-57EC-87DA-1DB460D64046,"iPhone13,2"
com.apple.Maps,3,1749478104,1749478107,1749478107.442707,-25200,EB445137-D7F5-57EC-87DA-1DB460D64046,"iPhone13,2"
com.apple.Maps,283,1749477580,1749477863,1749477864.036973,-25200,EB445137-D7F5-57EC-87DA-1DB460D64046,"iPhone13,2"
com.apple.Maps,29,1749477514,1749477543,1749477543.836312,-25200,EB445137-D7F5-57EC-87DA-1DB460D64046,"iPhone13,2"
com.apple.Maps,192,1749477248,1749477440,1749477440.171401,-25200,EB445137-D7F5-57EC-87DA-1DB460D64046,"iPhone13,2"
com.google.chrome.ios,48,1749477200,1749477248,1749477248.666603,-25200,EB445137-D7F5-57EC-87DA-1DB460D64046,"iPhone13,2"
com.apple.Maps,30,1749477170,1749477200,1749477200.322933,-25200,EB445137-D7F5-57EC-87DA-1DB460D64046,"iPhone13,2"
com.google.chrome.ios,23,1749476814,1749476837,1749476837.030624,-25200,EB445137-D7F5-57EC-87DA-1DB460D64046,"iPhone13,2"
com.apple.mobileslideshow,71,1749476693,1749476764,1749476765.016447,-25200,EB445137-D7F5-57EC-87DA-1DB460D64046,"iPhone13,2"
com.apple.MobileSMS,2,1749476688,1749476690,1749476690.5065432,-25200,EB445137-D7F5-57EC-87DA-1DB460D64046,"iPhone13,2"
com.google.chrome.ios,0,1749476688,1749476688,1749476688.939719,-25200,EB445137-D7F5-57EC-87DA-1DB460D64046,"iPhone13,2"
com.google.chrome.ios,9,1749475071,1749475080,1749475081.056229,-25200,EB445137-D7F5-57EC-87DA-1DB460D64046,"iPhone13,2"
com.apple.MobileSMS,3,1749473887,1749473890,1749473890.9178,-25200,EB445137-D7F5-57EC-87DA-1DB460D64046,"iPhone13,2"
com.apple.CoreAuthUI,1,1749473851,1749473852,1749473852.936188,-25200,EB445137-D7F5-57EC-87DA-1DB460D64046,"iPhone13,2"
com.clairmail.fth.client,43,1749473844,1749473887,1749473887.975692,-25200,EB445137-D7F5-57EC-87DA-1DB460D64046,"iPhone13,2"
com.google.Chrome,2040,1749342837,1749344877,1749344877.884058,-18000,,
com.google.Chrome,332,1749342482,1749342814,1749342814.562591,-18000,,
com.apple.finder,2,1749342480,1749342482,1749342482.755508,-18000,,
com.apple.finder,2,1749332128,1749332130,1749332130.74122,-18000,,
com.leomehlig.today,3,1749332125,1749332128,1749332129.018591,-18000,,
com.google.Chrome,23,1749332102,1749332125,1749332125.762368,-18000,,
com.google.Chrome,327,1749331377,1749331704,1749331704.257035,-18000,,
com.leomehlig.today,2,1749330937,1749330939,1749330939.187686,-18000,,
com.google.Chrome,2353,1749328584,1749330937,1749330937.416387,-18000,,
com.leomehlig.today,16,1749328568,1749328584,1749328584.324489,-18000,,
com.google.Chrome,2,1749328566,1749328568,1749328568.974506,-18000,,
com.google.Chrome,1248,1749327084,1749328332,1749328332.788817,-18000,,
com.google.Chrome,760,1749326316,1749327076,1749327076.5063062,-18000,,
com.apple.MobileSMS,11,1749326305,1749326316,1749326316.2762508,-18000,,
com.apple.news,106,1749326199,1749326305,1749326305.478632,-18000,,
com.apple.MobileSMS,7,1749326192,1749326199,1749326199.1655831,-18000,,
com.google.Chrome,4,1749326188,1749326192,1749326192.7696261,-18000,,
com.leomehlig.today,37,1749326151,1749326188,1749326189.27655,-18000,,
com.google.Chrome,35,1749326116,1749326151,1749326151.404224,-18000,,
com.leomehlig.today,1,1749326115,1749326116,1749326117.861424,-18000,,
com.google.Chrome,4,1749326111,1749326115,1749326115.888976,-18000,,
com.google.Chrome,298,1749319783,1749320081,1749320081.261092,-18000,,
com.apple.finder,1,1749319782,1749319783,1749319783.7481341,-18000,,
com.apple.finder,275,1749245795,1749246070,1749246070.91292,-18000,,
com.apple.Music,139,1749245656,1749245795,1749245795.658611,-18000,,
com.apple.finder,7,1749245649,1749245656,1749245656.127863,-18000,,
com.apple.finder,20,1749245566,1749245586,1749245586.290065,-18000,,
com.leomehlig.today,3,1749245563,1749245566,1749245566.954517,-18000,,
com.apple.finder,2,1749245561,1749245563,1749245563.472106,-18000,,
com.apple.MobileSMS,33,1749245528,1749245561,1749245561.405281,-18000,,
com.apple.finder,24,1749245504,1749245528,1749245528.417516,-18000,,
com.apple.Notes,1,1749245503,1749245504,1749245504.3777719,-18000,,
com.leomehlig.today,6,1749245497,1749245503,1749245503.162977,-18000,,
com.apple.Preview,0,1749245497,1749245497,1749245497.9687,-18000,,
com.google.Chrome,54,1749245443,1749245497,1749245497.2432442,-18000,,
com.apple.Preview,8,1749244676,1749244684,1749244685.017195,-18000,,
com.google.Chrome,85,1749244591,1749244676,1749244676.911117,-18000,,
com.apple.Preview,293,1749244298,1749244591,1749244591.2706351,-18000,,
com.leomehlig.today,6,1749244292,1749244298,1749244298.479447,-18000,,
com.apple.Preview,8,1749244284,1749244292,1749244292.999627,-18000,,
com.apple.Notes,34,1749244250,1749244284,1749244284.932431,-18000,,
com.apple.Preview,105,1749244145,1749244250,1749244250.385602,-18000,,
com.google.Chrome,58,1749244087,1749244145,1749244145.877449,-18000,,
com.apple.Preview,849,1749243238,1749244087,1749244087.885655,-18000,,
com.apple.finder,3,1749243235,1749243238,1749243238.3868132,-18000,,
com.google.Chrome,308,1749242927,1749243235,1749243235.771298,-18000,,
com.apple.finder,1,1749242926,1749242927,1749242927.7029672,-18000,,
com.apple.Preview,6,1749242920,1749242926,1749242926.900861,-18000,,
com.apple.finder,2,1749242918,1749242920,1749242920.766152,-18000,,
com.google.Chrome,47,1749242871,1749242918,1749242918.743734,-18000,,
com.apple.finder,1,1749242870,1749242871,1749242871.274125,-18000,,
com.apple.Preview,8,1749242862,1749242870,1749242870.338974,-18000,,
com.apple.finder,1,1749242861,1749242862,1749242862.5110059,-18000,,
com.google.Chrome,66,1749242795,1749242861,1749242861.062609,-18000,,
com.apple.Preview,1182,1749241613,1749242795,1749242795.128974,-18000,,
com.apple.finder,10,1749241603,1749241613,1749241613.726774,-18000,,
com.google.Chrome,1,1749241602,1749241603,1749241603.3296762,-18000,,
com.apple.Notes,48,1749240439,1749240487,1749240487.5168362,-18000,,
com.google.Chrome,4,1749240435,1749240439,1749240439.410797,-18000,,
com.apple.finder,1,1749240434,1749240435,1749240435.9634,-18000,,
com.leomehlig.today,92,1749240342,1749240434,1749240434.926168,-18000,,
com.google.Chrome,183,1749240159,1749240342,1749240342.12726,-18000,,
com.google.Chrome,331,1749223094,1749223425,1749223425.27499,-18000,,
com.google.Chrome,1038,1749221918,1749222956,1749222956.799687,-18000,,
com.google.Chrome,301,1749221366,1749221667,1749221667.382084,-18000,,
com.google.Chrome,300,1749220702,1749221002,1749221002.5522962,-18000,,
com.google.Chrome,305,1749219827,1749220132,1749220132.010781,-18000,,
com.google.Chrome,601,1749219045,1749219646,1749219646.575523,-18000,,
com.google.Chrome,1196,1749217732,1749218928,1749218928.971216,-18000,,
com.apple.finder,9,1749217723,1749217732,1749217732.4999409,-18000,,
com.apple.finder,58,1749167047,1749167105,1749167105.597196,-18000,,
com.leomehlig.today,11,1749167036,1749167047,1749167047.1171,-18000,,
com.apple.finder,9,1749167027,1749167036,1749167036.535725,-18000,,
com.apple.finder,4,1749164837,1749164841,1749164841.4901562,-18000,,
com.leomehlig.today,14,1749164823,1749164837,1749164837.246552,-18000,,
com.google.Chrome,97,1749164726,1749164823,1749164823.7508268,-18000,,
com.leomehlig.today,30,1749164684,1749164714,1749164714.488646,-18000,,
com.apple.finder,3,1749164681,1749164684,1749164684.258882,-18000,,
com.microsoft.VSCode,20,1749164661,1749164681,1749164681.796627,-18000,,
com.apple.Notes,1,1749164660,1749164661,1749164661.372548,-18000,,
com.google.Chrome,33,1749164627,1749164660,1749164660.326548,-18000,,
com.apple.Notes,10,1749164617,1749164627,1749164627.652679,-18000,,
com.google.Chrome,17,1749164600,1749164617,1749164617.155658,-18000,,
com.apple.MobileSMS,49,1749164551,1749164600,1749164600.704736,-18000,,
com.google.Chrome,26,1749164525,1749164551,1749164551.108027,-18000,,
com.apple.MobileSMS,63,1749164462,1749164525,1749164525.6345282,-18000,,
com.google.Chrome,2,1749164460,1749164462,1749164462.212204,-18000,,
com.apple.findmy,6,1749164454,1749164460,1749164460.720695,-18000,,
com.google.Chrome,141,1749164313,1749164454,1749164454.9421,-18000,,
com.apple.Notes,14,1749164299,1749164313,1749164313.2049608,-18000,,
com.microsoft.VSCode,1,1749164298,1749164299,1749164299.771071,-18000,,
com.google.Chrome,29,1749164269,1749164298,1749164298.473511,-18000,,
com.microsoft.VSCode,19,1749164250,1749164269,1749164269.085763,-18000,,
com.apple.finder,10,1749164240,1749164250,1749164250.8004398,-18000,,
com.microsoft.VSCode,5,1749164235,1749164240,1749164240.736582,-18000,,
com.apple.finder,17,1749164218,1749164235,1749164235.7832642,-18000,,
com.google.Chrome,1,1749164217,1749164218,1749164218.296741,-18000,,
com.apple.finder,16,1749164201,1749164217,1749164217.598042,-18000,,
com.microsoft.VSCode,22,1749164179,1749164201,1749164201.350615,-18000,,
com.apple.Notes,41,1749164138,1749164179,1749164180.059808,-18000,,
com.leomehlig.today,3,1749164135,1749164138,1749164138.70444,-18000,,
com.google.Chrome,1410,1749162725,1749164135,1749164135.8113508,-18000,,
com.apple.finder,2,1749162723,1749162725,1749162725.638164,-18000,,
com.google.Chrome,152,1749162571,1749162723,1749162723.357295,-18000,,
com.apple.finder,1,1749162570,1749162571,1749162571.3768048,-18000,,
com.google.Chrome,3,1749162567,1749162570,1749162570.469166,-18000,,
com.apple.finder,1,1749162566,1749162567,1749162567.417352,-18000,,
com.google.Chrome,2,1749162564,1749162566,1749162566.4314919,-18000,,
com.apple.finder,2,1749162562,1749162564,1749162564.200591,-18000,,
com.google.Chrome,2,1749162560,1749162562,1749162562.862733,-18000,,
com.apple.finder,1,1749162559,1749162560,1749162560.72821,-18000,,
com.google.Chrome,2,1749162557,1749162559,1749162559.6952271,-18000,,
com.apple.finder,1,1749162556,1749162557,1749162557.594404,-18000,,
com.google.Chrome,4,1749162552,1749162556,1749162556.275213,-18000,,
com.apple.finder,1,1749162551,1749162552,1749162552.754901,-18000,,
com.google.Chrome,7,1749162544,1749162551,1749162551.5420508,-18000,,
com.apple.finder,2,1749162542,1749162544,1749162544.514319,-18000,,
com.google.Chrome,14,1749162528,1749162542,1749162542.461576,-18000,,
com.apple.finder,0,1749162528,1749162528,1749162528.9696,-18000,,
com.google.Chrome,4,1749162524,1749162528,1749162528.0416632,-18000,,
com.apple.finder,1,1749162523,1749162524,1749162524.807667,-18000,,
com.google.Chrome,4,1749162519,1749162523,1749162523.959188,-18000,,
com.apple.finder,2,1749162517,1749162519,1749162519.2498,-18000,,
com.google.Chrome,13,1749162504,1749162517,1749162517.9824018,-18000,,
com.apple.finder,7,1749162497,1749162504,1749162504.5178761,-18000,,
com.apple.Notes,2,1749162495,1749162497,1749162497.3950682,-18000,,
com.google.Chrome,321,1749162174,1749162495,1749162495.279659,-18000,,
com.apple.finder,3,1749162171,1749162174,1749162174.710022,-18000,,
com.google.Chrome,8,1749162163,1749162171,1749162171.509906,-18000,,
com.apple.finder,24,1749162139,1749162163,1749162163.322226,-18000,,
com.microsoft.VSCode,7,1749162132,1749162139,1749162139.678807,-18000,,
com.google.Chrome,10,1749162122,1749162132,1749162132.92453,-18000,,
com.microsoft.VSCode,71,1749162051,1749162122,1749162122.4688048,-18000,,
com.apple.finder,7,1749162044,1749162051,1749162051.1376948,-18000,,
com.microsoft.VSCode,127,1749161917,1749162044,1749162044.590527,-18000,,
com.apple.Preview,66,1749161851,1749161917,1749161917.364999,-18000,,
com.apple.finder,20,1749161831,1749161851,1749161851.693478,-18000,,
com.google.Chrome,16,1749161815,1749161831,1749161831.541074,-18000,,
com.apple.finder,12,1749161803,1749161815,1749161816.000701,-18000,,
com.microsoft.VSCode,32,1749161771,1749161803,1749161803.5238361,-18000,,
com.apple.finder,18,1749161753,1749161771,1749161771.536604,-18000,,
com.microsoft.VSCode,20,1749161733,1749161753,1749161753.959908,-18000,,
com.apple.finder,30,1749161703,1749161733,1749161733.264426,-18000,,
com.microsoft.VSCode,603,1749161100,1749161703,1749161703.7920818,-18000,,
com.apple.Notes,14,1749161086,1749161100,1749161100.469039,-18000,,
com.google.Chrome,2,1749161084,1749161086,1749161086.811713,-18000,,
com.microsoft.VSCode,80,1749161004,1749161084,1749161084.669158,-18000,,
com.apple.Notes,27,1749160977,1749161004,1749161004.4293242,-18000,,
com.google.Chrome,95,1749160882,1749160977,1749160977.226859,-18000,,
com.apple.Notes,4,1749160878,1749160882,1749160883.544893,-18000,,
com.apple.finder,2,1749160876,1749160878,1749160878.961482,-18000,,
com.leomehlig.today,54,1749160822,1749160876,1749160876.768774,-18000,,
com.apple.finder,7,1749160815,1749160822,1749160822.215623,-18000,,
com.apple.finder,7,1749131865,1749131872,1749131872.0330858,-18000,,
com.apple.Passwords,0,1749131865,1749131865,1749131865.896408,-18000,,
com.apple.finder,1,1749131864,1749131865,1749131865.35128,-18000,,
com.apple.keychainaccess,1,1749131863,1749131864,1749131864.385571,-18000,,
com.google.Chrome,143,1749131720,1749131863,1749131863.762501,-18000,,
com.apple.Passwords,4,1749131716,1749131720,1749131720.84299,-18000,,
com.google.Chrome,6,1749131710,1749131716,1749131716.735327,-18000,,
com.apple.Passwords,17,1749131693,1749131710,1749131710.033019,-18000,,
com.google.Chrome,12,1749131681,1749131693,1749131693.3552132,-18000,,
com.apple.keychainaccess,2,1749131647,1749131649,1749131649.435172,-18000,,
com.google.Chrome,48,1749131599,1749131647,1749131648.026833,-18000,,
com.apple.keychainaccess,2,1749131597,1749131599,1749131599.03727,-18000,,
com.google.Chrome,13,1749131569,1749131582,1749131582.729455,-18000,,
com.apple.finder,9,1749131299,1749131308,1749131308.275025,-18000,,
com.leomehlig.today,20,1749131279,1749131299,1749131299.756705,-18000,,
com.apple.Preview,1,1749131278,1749131279,1749131279.7910671,-18000,,
com.google.Chrome,53,1749131225,1749131278,1749131278.894682,-18000,,
com.leomehlig.today,2,1749131200,1749131202,1749131202.055927,-18000,,
com.apple.Notes,1,1749131199,1749131200,1749131200.543828,-18000,,
com.leomehlig.today,31,1749131168,1749131199,1749131199.676165,-18000,,
com.apple.Notes,13,1749131155,1749131168,1749131168.328608,-18000,,
TeXShop,5,1749131150,1749131155,1749131155.0650702,-18000,,
com.apple.Notes,1,1749131149,1749131150,1749131150.8324761,-18000,,
com.google.Chrome,424,1749130725,1749131149,1749131149.91489,-18000,,
com.apple.Preview,4,1749130721,1749130725,1749130725.521531,-18000,,
com.google.Chrome,81,1749130640,1749130721,1749130721.7186809,-18000,,
com.apple.Preview,1,1749130639,1749130640,1749130640.683055,-18000,,
com.google.Chrome,60,1749130579,1749130639,1749130639.524302,-18000,,
com.apple.Preview,6,1749130573,1749130579,1749130579.748056,-18000,,
com.google.Chrome,62,1749130511,1749130573,1749130573.310577,-18000,,
com.apple.Preview,17,1749130494,1749130511,1749130511.630313,-18000,,
com.apple.finder,17,1749130477,1749130494,1749130494.057867,-18000,,
com.google.Chrome,646,1749129831,1749130477,1749130477.618212,-18000,,
TeXShop,4,1749129827,1749129831,1749129831.2362518,-18000,,
com.google.Chrome,359,1749129468,1749129827,1749129827.665314,-18000,,
TeXShop,5,1749129463,1749129468,1749129468.690795,-18000,,
com.google.Chrome,436,1749129027,1749129463,1749129464.036798,-18000,,
com.apple.TextEdit,12,1749128996,1749129008,1749129008.898439,-18000,,
com.google.Chrome,467,1749128529,1749128996,1749128997.020663,-18000,,
com.apple.Notes,1,1749128528,1749128529,1749128529.0939589,-18000,,
com.google.Chrome,203,1749128325,1749128528,1749128528.211164,-18000,,
com.apple.Notes,2,1749128323,1749128325,1749128325.522464,-18000,,
com.google.Chrome,17,1749128306,1749128323,1749128323.063904,-18000,,
com.google.Chrome,695,1749093041,1749093736,1749093736.471483,-18000,,
com.google.Chrome,5,1749088816,1749088821,1749088821.6788092,-18000,,
com.leomehlig.today,24,1749088792,1749088816,1749088816.646319,-18000,,
com.apple.iCal,77,1749088715,1749088792,1749088792.989857,-18000,,
com.leomehlig.today,77,1749088638,1749088715,1749088715.625362,-18000,,
com.google.Chrome,20,1749088618,1749088638,1749088638.9555101,-18000,,
com.apple.systempreferences,10,1749088608,1749088618,1749088618.1196299,-18000,,
com.google.Chrome,215,1749088386,1749088601,1749088601.3968592,-18000,,
com.google.Chrome,458,1749087672,1749088130,1749088130.905854,-18000,,
com.apple.MobileSMS,72,1749087600,1749087672,1749087672.3043761,-18000,,
com.google.Chrome,497,1749087103,1749087600,1749087600.3491921,-18000,,
com.apple.iCal,81,1749087022,1749087103,1749087103.144034,-18000,,
com.apple.MobileSMS,25,1749086997,1749087022,1749087022.083239,-18000,,
com.apple.iCal,25,1749086972,1749086997,1749086997.660314,-18000,,
com.apple.MobileSMS,127,1749086845,1749086972,1749086972.554894,-18000,,
com.apple.iCal,73,1749086772,1749086845,1749086845.070335,-18000,,
com.apple.MobileSMS,33,1749086739,1749086772,1749086772.703049,-18000,,
com.apple.iCal,58,1749086681,1749086739,1749086739.148168,-18000,,
com.apple.MobileSMS,19,1749086662,1749086681,1749086681.248351,-18000,,
com.apple.iCal,38,1749086624,1749086662,1749086662.979234,-18000,,
com.apple.MobileSMS,4,1749086620,1749086624,1749086624.181487,-18000,,
com.apple.iCal,9,1749086611,1749086620,1749086620.749786,-18000,,
com.apple.MobileSMS,30,1749086581,1749086611,1749086612.009076,-18000,,
com.apple.iCal,5,1749086576,1749086581,1749086581.342623,-18000,,
com.apple.MobileSMS,7,1749086569,1749086576,1749086576.612149,-18000,,
com.apple.iCal,3,1749086566,1749086569,1749086569.8363218,-18000,,
com.apple.MobileSMS,13,1749086553,1749086566,1749086566.868684,-18000,,
com.apple.iCal,10,1749086543,1749086553,1749086554.1048908,-18000,,
com.apple.MobileSMS,1,1749086542,1749086543,1749086543.500119,-18000,,
com.apple.iCal,3,1749086539,1749086542,1749086542.813124,-18000,,
com.apple.MobileSMS,17,1749086522,1749086539,1749086539.289575,-18000,,
com.apple.iCal,1,1749086521,1749086522,1749086522.285338,-18000,,
com.apple.MobileSMS,6,1749086515,1749086521,1749086521.4363198,-18000,,
com.apple.iCal,12,1749086503,1749086515,1749086515.283694,-18000,,
com.apple.MobileSMS,2,1749086501,1749086503,1749086503.495609,-18000,,
com.apple.iCal,7,1749086494,1749086501,1749086501.591587,-18000,,
com.apple.MobileSMS,53,1749086441,1749086494,1749086494.840605,-18000,,
com.google.Chrome,85,1749086356,1749086441,1749086441.521659,-18000,,
com.apple.MobileSMS,2,1749086354,1749086356,1749086356.809762,-18000,,
com.apple.iCal,56,1749086298,1749086354,1749086355.014993,-18000,,
com.apple.MobileSMS,22,1749086276,1749086298,1749086298.3347158,-18000,,
com.apple.iCal,20,1749086256,1749086276,1749086276.1284199,-18000,,
com.apple.Notes,7,1749086249,1749086256,1749086256.467897,-18000,,
com.apple.iCal,2,1749086247,1749086249,1749086249.859628,-18000,,
com.microsoft.VSCode,3,1749086244,1749086247,1749086248.303498,-18000,,
com.apple.iCal,2,1749086242,1749086244,1749086244.0742521,-18000,,
com.electron.carta,2,1749086240,1749086242,1749086242.485478,-18000,,
com.apple.iCal,36,1749086204,1749086240,1749086240.431504,-18000,,
com.apple.MobileSMS,122,1749086082,1749086204,1749086204.917999,-18000,,
com.apple.iCal,0,1749086082,1749086082,1749086082.9026031,-18000,,
com.apple.MobileSMS,1,1749086081,1749086082,1749086082.5173411,-18000,,
com.apple.iCal,7,1749086074,1749086081,1749086081.185782,-18000,,
com.apple.MobileSMS,3,1749086071,1749086074,1749086074.1270099,-18000,,
com.apple.iCal,4,1749086067,1749086071,1749086071.634608,-18000,,
com.apple.MobileSMS,70,1749085997,1749086067,1749086067.18884,-18000,,
com.apple.iCal,21,1749085976,1749085997,1749085997.3413749,-18000,,
com.apple.MobileSMS,18,1749085958,1749085976,1749085976.1701689,-18000,,
com.apple.iCal,13,1749085945,1749085958,1749085958.208755,-18000,,
com.google.Chrome,2,1749085943,1749085945,1749085949.036491,-18000,,
com.google.Chrome,85,1749081014,1749081099,1749081099.852234,-18000,,
com.apple.finder,2,1749081000,1749081002,1749081004.7850761,-18000,,
com.apple.finder,3,1749078052,1749078055,1749078055.65691,-18000,,
com.google.Chrome,260,1749077792,1749078052,1749078052.952532,-18000,,
com.apple.Notes,1,1749077791,1749077792,1749077792.127163,-18000,,
com.google.Chrome,228,1749077563,1749077791,1749077791.2438521,-18000,,
com.apple.Notes,1,1749077562,1749077563,1749077563.656197,-18000,,
com.google.Chrome,182,1749077380,1749077562,1749077562.725173,-18000,,
com.apple.Notes,44,1749077336,1749077380,1749077380.960285,-18000,,
com.google.Chrome,24,1749077312,1749077336,1749077336.37047,-18000,,
com.apple.Notes,13,1749077299,1749077312,1749077312.7723641,-18000,,
com.google.Chrome,296,1749077003,1749077299,1749077299.198389,-18000,,
com.apple.Notes,3,1749077000,1749077003,1749077003.758298,-18000,,
com.google.Chrome,2,1749076998,1749077000,1749077000.880176,-18000,,
com.apple.Notes,19,1749076979,1749076998,1749076998.601807,-18000,,
com.google.Chrome,203,1749076776,1749076979,1749076980.035806,-18000,,
com.apple.Notes,15,1749076761,1749076776,1749076776.83095,-18000,,
com.google.Chrome,141,1749076620,1749076761,1749076761.487125,-18000,,
com.apple.Notes,4,1749076616,1749076620,1749076620.7111259,-18000,,
com.apple.finder,1,1749076615,1749076616,1749076617.020986,-18000,,
com.google.Chrome,73,1749076542,1749076615,1749076615.457303,-18000,,
com.apple.finder,2,1749076540,1749076542,1749076542.5494308,-18000,,
com.google.Chrome,0,1749076540,1749076540,1749076540.944584,-18000,,
com.apple.finder,3,1749076537,1749076540,1749076540.306315,-18000,,
com.microsoft.VSCode,127,1749076410,1749076537,1749076537.223655,-18000,,
com.google.Chrome,221,1749076189,1749076410,1749076410.473446,-18000,,
com.apple.finder,2,1749076187,1749076189,1749076189.537077,-18000,,
com.google.Chrome,6,1749076181,1749076187,1749076187.198441,-18000,,
com.apple.finder,3,1749076178,1749076181,1749076181.1046538,-18000,,
com.microsoft.VSCode,39,1749076139,1749076178,1749076178.429368,-18000,,
com.apple.finder,1,1749076138,1749076139,1749076139.197484,-18000,,
com.microsoft.VSCode,69,1749076069,1749076138,1749076138.309867,-18000,,
com.apple.finder,1,1749076068,1749076069,1749076070.003398,-18000,,
com.google.Chrome,16,1749076052,1749076068,1749076068.772011,-18000,,
com.apple.finder,1,1749076051,1749076052,1749076052.559253,-18000,,
com.microsoft.VSCode,38,1749076013,1749076051,1749076051.7214131,-18000,,
com.apple.finder,2,1749076011,1749076013,1749076013.597995,-18000,,
com.google.Chrome,75,1749075936,1749076011,1749076011.215695,-18000,,
com.apple.finder,8,1749075928,1749075936,1749075936.2194018,-18000,,
com.google.Chrome,3,1749075925,1749075928,1749075929.01936,-18000,,
com.apple.finder,2,1749075923,1749075925,1749075925.4556298,-18000,,
com.microsoft.VSCode,151,1749075772,1749075923,1749075923.8402739,-18000,,
com.apple.finder,6,1749075766,1749075772,1749075772.241981,-18000,,
com.microsoft.VSCode,107,1749075659,1749075766,1749075766.121881,-18000,,
com.apple.Notes,1,1749075658,1749075659,1749075659.629807,-18000,,
com.microsoft.VSCode,5,1749075653,1749075658,1749075658.506799,-18000,,
com.apple.Notes,1,1749075652,1749075653,1749075653.6938171,-18000,,
com.microsoft.VSCode,7,1749075645,1749075652,1749075652.853918,-18000,,
com.apple.Notes,0,1749075645,1749075645,1749075646.0369911,-18000,,
com.microsoft.VSCode,3,1749075642,1749075645,1749075645.397812,-18000,,
com.apple.Notes,0,1749075642,1749075642,1749075643.007684,-18000,,
com.microsoft.VSCode,4,1749075638,1749075642,1749075642.1310492,-18000,,
com.apple.Notes,0,1749075638,1749075638,1749075639.061928,-18000,,
com.microsoft.VSCode,5,1749075633,1749075638,1749075638.212518,-18000,,
com.apple.Notes,1,1749075632,1749075633,1749075633.339326,-18000,,
com.microsoft.VSCode,201,1749075431,1749075632,1749075632.330515,-18000,,
com.apple.Notes,0,1749075431,1749075431,1749075431.993106,-18000,,
com.apple.MobileSMS,3,1749075428,1749075431,1749075431.728251,-18000,,
com.apple.Notes,12,1749075416,1749075428,1749075428.500965,-18000,,
com.apple.finder,4,1749075412,1749075416,1749075416.287082,-18000,,
com.apple.Preview,3,1749075409,1749075412,1749075412.52388,-18000,,
com.apple.finder,10,1749075399,1749075409,1749075409.2618752,-18000,,
com.apple.Notes,8,1749075391,1749075399,1749075399.438767,-18000,,
com.apple.finder,19,1749075372,1749075391,1749075391.243392,-18000,,
com.apple.Notes,2,1749075370,1749075372,1749075372.370686,-18000,,
com.apple.finder,5,1749075365,1749075370,1749075370.08288,-18000,,
com.apple.Notes,4,1749075361,1749075365,1749075365.637955,-18000,,
com.apple.finder,34,1749075327,1749075361,1749075361.186956,-18000,,
com.apple.Notes,31,1749075296,1749075327,1749075327.394166,-18000,,
com.apple.finder,58,1749075238,1749075296,1749075296.167594,-18000,,
com.apple.Notes,3,1749075235,1749075238,1749075238.83398,-18000,,
com.apple.finder,63,1749075172,1749075235,1749075235.275485,-18000,,
com.apple.Notes,1,1749075171,1749075172,1749075173.0809069,-18000,,
com.apple.finder,1,1749075170,1749075171,1749075171.7109442,-18000,,
com.apple.Notes,3,1749075167,1749075170,1749075170.433876,-18000,,
com.apple.finder,1,1749075166,1749075167,1749075167.237596,-18000,,
com.apple.Notes,21,1749075145,1749075166,1749075166.460763,-18000,,
com.apple.finder,82,1749075063,1749075145,1749075145.9318008,-18000,,
com.google.Chrome,35,1749075028,1749075063,1749075063.550261,-18000,,
com.apple.MobileSMS,1,1749075027,1749075028,1749075028.325399,-18000,,
com.apple.Notes,1,1749075026,1749075027,1749075027.56171,-18000,,
com.apple.MobileSMS,2,1749075024,1749075026,1749075026.447102,-18000,,
com.google.Chrome,40,1749074984,1749075024,1749075024.95608,-18000,,
com.apple.MobileSMS,3,1749074981,1749074984,1749074984.325992,-18000,,
com.apple.iCal,16,1749074965,1749074981,1749074981.7868838,-18000,,
com.apple.MobileSMS,56,1749074909,1749074965,1749074965.035691,-18000,,
com.google.Chrome,22,1749074887,1749074909,1749074909.618907,-18000,,
com.apple.Notes,7,1749074880,1749074887,1749074887.8998451,-18000,,
com.google.Chrome,11,1749074869,1749074880,1749074880.695578,-18000,,
com.apple.iCal,8,1749074861,1749074869,1749074869.795007,-18000,,
com.apple.MobileSMS,78,1749074783,1749074861,1749074861.857942,-18000,,
com.apple.iCal,3,1749074780,1749074783,1749074783.038455,-18000,,
com.apple.MobileSMS,35,1749074745,1749074780,1749074780.780549,-18000,,
com.apple.iCal,4,1749074741,1749074745,1749074745.781581,-18000,,
com.apple.MobileSMS,6,1749074735,1749074741,1749074741.551985,-18000,,
com.apple.iCal,6,1749074729,1749074735,1749074735.860285,-18000,,
com.google.Chrome,2,1749074727,1749074729,1749074729.124083,-18000,,
com.leomehlig.today,18,1749074709,1749074727,1749074727.589716,-18000,,
com.leomehlig.today,87,1749069443,1749069530,1749069530.91775,-18000,,
com.google.Chrome,32,1749069411,1749069443,1749069444.016628,-18000,,
com.apple.finder,13,1749069398,1749069411,1749069411.619247,-18000,,
com.google.Chrome,4,1749069394,1749069398,1749069398.2424831,-18000,,
com.apple.Notes,17,1749069364,1749069381,1749069381.941931,-18000,,
com.google.Chrome,10,1749069354,1749069364,1749069364.989003,-18000,,
com.apple.Notes,4,1749069350,1749069354,1749069354.981227,-18000,,
com.google.Chrome,9,1749069341,1749069350,1749069350.5435228,-18000,,
com.apple.Notes,182,1749069159,1749069341,1749069341.6866221,-18000,,
com.apple.finder,3,1749069156,1749069159,1749069159.77079,-18000,,
com.apple.Notes,12,1749069144,1749069156,1749069156.446916,-18000,,
com.apple.finder,3,1749069141,1749069144,1749069144.505542,-18000,,
com.apple.Notes,14,1749069127,1749069141,1749069141.804054,-18000,,
com.google.Chrome,4,1749069123,1749069127,1749069127.7623448,-18000,,
us.zoom.xos,33,1749069090,1749069123,1749069124.0490289,-18000,,
com.google.Chrome,6,1749069084,1749069090,1749069090.224381,-18000,,
us.zoom.xos,19,1749069065,1749069084,1749069084.105297,-18000,,
com.google.Chrome,18,1749069047,1749069065,1749069065.2395182,-18000,,
com.apple.finder,58,1749068989,1749069047,1749069047.881579,-18000,,
us.zoom.xos,112,1749068877,1749068989,1749068989.257386,-18000,,
com.google.Chrome,5,1749068872,1749068877,1749068877.933261,-18000,,
us.zoom.xos,29,1749068843,1749068872,1749068872.7416968,-18000,,
com.google.Chrome,14,1749068829,1749068843,1749068843.115724,-18000,,
us.zoom.xos,12,1749068817,1749068829,1749068829.574809,-18000,,
com.google.Chrome,33,1749068784,1749068817,1749068817.223269,-18000,,
us.zoom.xos,1,1749068783,1749068784,1749068784.278605,-18000,,
com.electron.carta,420,1749068363,1749068783,1749068783.13454,-18000,,
us.zoom.xos,1,1749068362,1749068363,1749068363.156519,-18000,,
com.apple.finder,331,1749068031,1749068362,1749068362.341779,-18000,,
us.zoom.xos,9,1749068022,1749068031,1749068031.623832,-18000,,
com.apple.Notes,3,1749068019,1749068022,1749068022.2777839,-18000,,
us.zoom.xos,23,1749067996,1749068019,1749068019.0706658,-18000,,
com.apple.Notes,5,1749067991,1749067996,1749067996.600281,-18000,,
us.zoom.xos,55,1749067936,1749067991,1749067991.257423,-18000,,
com.apple.Notes,4,1749067932,1749067936,1749067936.738792,-18000,,
us.zoom.xos,155,1749067777,1749067932,1749067933.000865,-18000,,
com.google.Chrome,4,1749067773,1749067777,1749067777.405429,-18000,,
us.zoom.xos,10,1749067763,1749067773,1749067773.472528,-18000,,
com.google.Chrome,2,1749067761,1749067763,1749067763.924207,-18000,,
us.zoom.xos,8,1749067753,1749067761,1749067761.441747,-18000,,
com.google.Chrome,12,1749067741,1749067753,1749067753.3317819,-18000,,
us.zoom.xos,244,1749067497,1749067741,1749067741.533834,-18000,,
com.google.Chrome,23,1749067474,1749067497,1749067497.839038,-18000,,
us.zoom.xos,64,1749067410,1749067474,1749067474.550013,-18000,,
com.google.Chrome,1,1749067409,1749067410,1749067410.954402,-18000,,
us.zoom.xos,14,1749067395,1749067409,1749067409.133807,-18000,,
com.google.Chrome,49,1749067346,1749067395,1749067395.927639,-18000,,
us.zoom.xos,21,1749067325,1749067346,1749067346.6678162,-18000,,
com.google.Chrome,3,1749067322,1749067325,1749067325.670609,-18000,,
us.zoom.xos,91,1749067231,1749067322,1749067322.056844,-18000,,
com.google.Chrome,3,1749067228,1749067231,1749067231.302532,-18000,,
us.zoom.xos,83,1749067145,1749067228,1749067228.874881,-18000,,
com.google.Chrome,49,1749067096,1749067145,1749067145.321868,-18000,,
us.zoom.xos,23,1749067073,1749067096,1749067096.548418,-18000,,
com.google.Chrome,125,1749066948,1749067073,1749067073.380662,-18000,,
com.apple.Notes,9,1749066939,1749066948,1749066948.763949,-18000,,
com.microsoft.VSCode,7,1749066932,1749066939,1749066940.104607,-18000,,
com.apple.Notes,4,1749066928,1749066932,1749066932.7706409,-18000,,
com.apple.Terminal,0,1749066928,1749066928,1749066928.777135,-18000,,
com.apple.Notes,1,1749066927,1749066928,1749066928.3380141,-18000,,
com.cisco.secureclient.gui,6,1749066921,1749066927,1749066927.302592,-18000,,
com.apple.Notes,93,1749066828,1749066921,1749066921.221129,-18000,,
com.apple.finder,336,1749066492,1749066828,1749066828.7995648,-18000,,
com.apple.Notes,42,1749066450,1749066492,1749066492.517276,-18000,,
com.google.Chrome,125,1749066325,1749066450,1749066450.38678,-18000,,
us.zoom.xos,54,1749066271,1749066325,1749066325.2824621,-18000,,
com.google.Chrome,2,1749066269,1749066271,1749066271.460747,-18000,,
com.leomehlig.today,6,1749066263,1749066269,1749066269.37071,-18000,,
com.google.Chrome,101,1749066162,1749066263,1749066263.39669,-18000,,
com.electron.carta,17,1749066145,1749066162,1749066162.63137,-18000,,
com.apple.Notes,23,1749066122,1749066145,1749066145.95261,-18000,,
com.electron.carta,201,1749065921,1749066122,1749066122.23735,-18000,,
com.apple.Terminal,12,1749065909,1749065921,1749065921.2509189,-18000,,
com.apple.finder,37,1749065872,1749065909,1749065909.4382439,-18000,,
com.google.Chrome,1,1749065871,1749065872,1749065872.5963988,-18000,,
com.apple.finder,8,1749065863,1749065871,1749065871.964973,-18000,,
com.google.Chrome,8,1749065855,1749065863,1749065863.709645,-18000,,
com.apple.finder,11,1749065844,1749065855,1749065855.241015,-18000,,
com.electron.carta,19,1749065825,1749065844,1749065844.759932,-18000,,
com.apple.finder,2,1749065823,1749065825,1749065825.433895,-18000,,
com.apple.Terminal,38,1749065785,1749065823,1749065823.568502,-18000,,
com.cisco.secureclient.gui,39,1749065746,1749065785,1749065785.4004269,-18000,,
com.apple.Terminal,6,1749065740,1749065746,1749065746.060199,-18000,,
com.apple.finder,14,1749065726,1749065740,1749065741.0005012,-18000,,
com.google.Chrome,28,1749065698,1749065726,1749065726.5591369,-18000,,
com.apple.finder,31,1749065667,1749065698,1749065698.3808851,-18000,,
com.apple.Notes,119,1749065548,1749065667,1749065667.466793,-18000,,
com.google.Chrome,45,1749065503,1749065548,1749065548.495305,-18000,,
com.apple.iCal,49,1749065454,1749065503,1749065503.412241,-18000,,
com.google.Chrome,39,1749065415,1749065454,1749065455.031667,-18000,,
com.apple.iCal,7,1749065408,1749065415,1749065415.6700249,-18000,,
com.google.Chrome,7,1749065401,1749065408,1749065408.508203,-18000,,
com.apple.iCal,5,1749065396,1749065401,1749065401.768035,-18000,,
com.google.Chrome,3,1749065393,1749065396,1749065396.4775171,-18000,,
com.apple.iCal,14,1749065379,1749065393,1749065393.2662349,-18000,,
com.google.Chrome,7,1749065372,1749065379,1749065380.033046,-18000,,
com.apple.iCal,13,1749065359,1749065372,1749065372.030048,-18000,,
com.google.Chrome,3,1749065356,1749065359,1749065359.468775,-18000,,
com.apple.iCal,1,1749065355,1749065356,1749065356.5099502,-18000,,
com.apple.Notes,4,1749065351,1749065355,1749065356.01576,-18000,,
com.apple.Notes,322,1749064902,1749065224,1749065224.846537,-18000,,
com.apple.finder,1,1749064901,1749064902,1749064902.688624,-18000,,
com.google.Chrome,12,1749064889,1749064901,1749064901.8116899,-18000,,
com.apple.Preview,34,1749064855,1749064889,1749064889.7119842,-18000,,
com.apple.finder,5,1749064850,1749064855,1749064855.690629,-18000,,
com.google.Chrome,48,1749064802,1749064850,1749064850.086355,-18000,,
com.apple.Notes,101,1749064701,1749064802,1749064802.7162042,-18000,,
com.google.Chrome,88,1749064613,1749064701,1749064701.247634,-18000,,
com.apple.Notes,31,1749064582,1749064613,1749064613.705535,-18000,,
com.microsoft.VSCode,98,1749064484,1749064582,1749064582.6419759,-18000,,
com.apple.Notes,4,1749064480,1749064484,1749064484.3136082,-18000,,
com.microsoft.VSCode,14,1749064466,1749064480,1749064480.130156,-18000,,
com.apple.finder,90,1749064376,1749064466,1749064466.489769,-18000,,
com.microsoft.VSCode,30,1749064346,1749064376,1749064376.8483949,-18000,,
com.apple.Notes,483,1749063863,1749064346,1749064346.647359,-18000,,
com.apple.Preview,41,1749063822,1749063863,1749063863.28204,-18000,,
com.apple.Notes,5,1749063817,1749063822,1749063822.399771,-18000,,
com.apple.Preview,213,1749063604,1749063817,1749063817.859936,-18000,,
com.apple.finder,9,1749063595,1749063604,1749063604.180685,-18000,,
com.google.Chrome,108,1749063487,1749063595,1749063595.605425,-18000,,
com.apple.finder,8,1749063479,1749063487,1749063487.9706101,-18000,,
com.google.Chrome,258,1749063221,1749063479,1749063479.2897758,-18000,,
com.apple.Notes,13,1749063208,1749063221,1749063221.348051,-18000,,
com.apple.finder,15,1749063193,1749063208,1749063208.347746,-18000,,
com.apple.Notes,35,1749063158,1749063193,1749063193.53686,-18000,,
com.apple.finder,12,1749063146,1749063158,1749063158.659719,-18000,,
com.google.Chrome,1,1749063145,1749063146,1749063146.8932118,-18000,,
com.apple.Notes,3,1749063142,1749063145,1749063145.933998,-18000,,
com.google.Chrome,1,1749063141,1749063142,1749063142.719969,-18000,,
com.apple.Notes,34,1749063107,1749063141,1749063141.310981,-18000,,
com.apple.finder,6,1749063101,1749063107,1749063107.2160711,-18000,,
com.google.Chrome,1,1749063100,1749063101,1749063101.2926521,-18000,,
com.apple.Notes,3,1749063097,1749063100,1749063100.629741,-18000,,
com.google.Chrome,2,1749063095,1749063097,1749063097.143299,-18000,,
com.apple.Notes,53,1749063042,1749063095,1749063095.761173,-18000,,
com.apple.finder,5,1749063037,1749063042,1749063042.757982,-18000,,
com.apple.Notes,1,1749063036,1749063037,1749063037.129873,-18000,,
com.google.Chrome,2,1749063034,1749063036,1749063036.4293551,-18000,,
com.apple.Notes,67,1749062967,1749063034,1749063034.811749,-18000,,
com.apple.finder,8,1749062959,1749062967,1749062967.545224,-18000,,
com.google.Chrome,1,1749062958,1749062959,1749062959.35632,-18000,,
com.apple.Notes,4,1749062954,1749062958,1749062958.4477859,-18000,,
com.google.Chrome,3,1749062951,1749062954,1749062954.98482,-18000,,
com.apple.Notes,64,1749062887,1749062951,1749062951.174989,-18000,,
com.apple.finder,7,1749062880,1749062887,1749062887.2564402,-18000,,
com.apple.Notes,1,1749062879,1749062880,1749062880.813159,-18000,,
com.google.Chrome,2,1749062877,1749062879,1749062879.3055282,-18000,,
com.apple.Notes,12,1749062865,1749062877,1749062877.522537,-18000,,
com.apple.finder,11,1749062854,1749062865,1749062865.4545012,-18000,,
com.apple.Notes,10,1749062844,1749062854,1749062854.356384,-18000,,
com.apple.finder,6,1749062838,1749062844,1749062844.16018,-18000,,
com.google.Chrome,2,1749062836,1749062838,1749062838.087419,-18000,,
com.apple.Notes,6,1749062830,1749062836,1749062836.984546,-18000,,
com.google.Chrome,3,1749062827,1749062830,1749062830.4726439,-18000,,
com.apple.Notes,42,1749062785,1749062827,1749062827.870882,-18000,,
com.apple.finder,6,1749062779,1749062785,1749062785.839474,-18000,,
com.apple.Notes,19,1749062760,1749062779,1749062779.862136,-18000,,
com.apple.finder,15,1749062745,1749062760,1749062760.583538,-18000,,
com.apple.Notes,5,1749062740,1749062745,1749062745.67845,-18000,,
com.apple.finder,3,1749062737,1749062740,1749062740.7827091,-18000,,
com.apple.Notes,14,1749062723,1749062737,1749062737.878563,-18000,,
com.apple.finder,23,1749062700,1749062723,1749062723.12796,-18000,,
com.apple.Notes,24,1749062676,1749062700,1749062700.7920961,-18000,,
com.apple.finder,54,1749062622,1749062676,1749062676.5157862,-18000,,
com.apple.Notes,17,1749062605,1749062622,1749062622.34922,-18000,,
com.google.Chrome,36,1749062569,1749062605,1749062605.846549,-18000,,
com.apple.finder,19,1749062550,1749062569,1749062569.741664,-18000,,
com.google.Chrome,1,1749062549,1749062550,1749062550.8889241,-18000,,
com.apple.finder,118,1749062431,1749062549,1749062549.949439,-18000,,
com.google.Chrome,35,1749062396,1749062431,1749062431.7713962,-18000,,
com.apple.finder,79,1749062317,1749062396,1749062396.680973,-18000,,
com.microsoft.VSCode,42,1749062275,1749062317,1749062317.155778,-18000,,
com.google.Chrome,36,1749062239,1749062275,1749062275.332217,-18000,,
com.microsoft.VSCode,3,1749062236,1749062239,1749062239.310817,-18000,,
com.apple.Notes,10,1749062226,1749062236,1749062236.2985148,-18000,,
com.google.Chrome,470,1749061756,1749062226,1749062226.149881,-18000,,
com.apple.Notes,36,1749061720,1749061756,1749061756.7610621,-18000,,
com.google.Chrome,27,1749061693,1749061720,1749061720.73158,-18000,,
com.apple.finder,2,1749061691,1749061693,1749061693.569848,-18000,,
com.apple.Notes,9,1749061682,1749061691,1749061691.7455049,-18000,,
com.google.Chrome,53,1749061629,1749061682,1749061682.060406,-18000,,
com.apple.finder,1,1749061628,1749061629,1749061630.282789,-18000,,
com.leomehlig.today,4,1749061624,1749061628,1749061628.490953,-18000,,
com.apple.finder,9,1749061615,1749061624,1749061624.769804,-18000,,
com.apple.finder,8,1749050123,1749050131,1749050131.240037,-18000,,
com.apple.iCal,1,1749050122,1749050123,1749050124.0390959,-18000,,
com.google.Chrome,538,1749049584,1749050122,1749050122.6044679,-18000,,
com.apple.iCal,25,1749049559,1749049584,1749049584.8612552,-18000,,
com.google.Chrome,395,1749049164,1749049559,1749049560.016899,-18000,,
com.apple.finder,3,1749049161,1749049164,1749049164.4443421,-18000,,
com.google.Chrome,33,1749049128,1749049161,1749049161.896266,-18000,,
com.google.Chrome,835,1749006633,1749007468,1749007468.590956,-18000,,
com.apple.finder,4,1749006629,1749006633,1749006634.0111961,-18000,,
com.apple.finder,3,1749005547,1749005550,1749005550.62241,-18000,,
com.microsoft.onenote.mac,83,1749005464,1749005547,1749005547.896254,-18000,,
com.microsoft.onenote.mac,354,1749005062,1749005416,1749005416.5841808,-18000,,
com.apple.finder,45,1749005017,1749005062,1749005062.256387,-18000,,
com.apple.finder,4,1749004580,1749004584,1749004584.6170259,-18000,,
com.apple.Notes,3,1749004577,1749004580,1749004580.252625,-18000,,
com.leomehlig.today,10,1749004567,1749004577,1749004577.350573,-18000,,
com.apple.calculator,1,1749004566,1749004567,1749004567.622178,-18000,,
com.google.Chrome,542,1749004024,1749004566,1749004567.006691,-18000,,
com.apple.calculator,5,1749004019,1749004024,1749004025.06218,-18000,,
com.google.Chrome,4,1749004015,1749004019,1749004019.947233,-18000,,
com.apple.calculator,8,1749004007,1749004015,1749004016.062532,-18000,,
com.google.Chrome,5,1749004002,1749004007,1749004007.7556,-18000,,
com.apple.calculator,8,1749003994,1749004002,1749004002.602439,-18000,,
com.google.Chrome,5,1749003989,1749003994,1749003994.698787,-18000,,
com.apple.calculator,1,1749003988,1749003989,1749003989.508809,-18000,,
com.google.Chrome,2,1749003986,1749003988,1749003988.580375,-18000,,
com.apple.calculator,11,1749003975,1749003986,1749003986.1362882,-18000,,
com.google.Chrome,5,1749003970,1749003975,1749003975.689159,-18000,,
com.apple.calculator,14,1749003956,1749003970,1749003970.635818,-18000,,
com.google.Chrome,4,1749003952,1749003956,1749003956.9483938,-18000,,
com.apple.calculator,16,1749003936,1749003952,1749003952.093909,-18000,,
com.google.Chrome,7,1749003929,1749003936,1749003936.7686682,-18000,,
com.apple.calculator,1,1749003928,1749003929,1749003929.289909,-18000,,
com.google.Chrome,2,1749003926,1749003928,1749003928.6043758,-18000,,
com.apple.calculator,19,1749003907,1749003926,1749003926.937917,-18000,,
com.google.Chrome,33,1749003874,1749003907,1749003907.048913,-18000,,
com.apple.calculator,74,1749003800,1749003874,1749003874.533268,-18000,,
com.google.Chrome,6,1749003794,1749003800,1749003800.643896,-18000,,
com.apple.calculator,15,1749003779,1749003794,1749003794.8803802,-18000,,
com.google.Chrome,1,1749003778,1749003779,1749003779.769031,-18000,,
com.apple.calculator,11,1749003767,1749003778,1749003778.5051131,-18000,,
com.google.Chrome,86,1749003681,1749003767,1749003767.2726989,-18000,,
com.apple.calculator,10,1749003671,1749003681,1749003682.004688,-18000,,
com.google.Chrome,216,1749003455,1749003671,1749003671.495868,-18000,,
com.leomehlig.today,18,1749003437,1749003455,1749003455.282401,-18000,,
com.google.Chrome,4,1749003433,1749003437,1749003437.112966,-18000,,
com.leomehlig.today,14,1749003419,1749003433,1749003433.636075,-18000,,
com.google.Chrome,4,1749003415,1749003419,1749003419.986905,-18000,,
com.leomehlig.today,14,1749003401,1749003415,1749003415.181829,-18000,,
com.google.Chrome,1,1749003400,1749003401,1749003401.876833,-18000,,
com.apple.iCal,4,1749003396,1749003400,1749003400.344945,-18000,,
com.google.Chrome,9,1749003387,1749003396,1749003396.6304278,-18000,,
com.apple.iCal,1,1749003386,1749003387,1749003387.463392,-18000,,
com.google.Chrome,1,1749003385,1749003386,1749003386.094142,-18000,,
com.apple.iCal,6,1749003379,1749003385,1749003385.1617541,-18000,,
com.google.Chrome,217,1749003162,1749003379,1749003379.749876,-18000,,
com.leomehlig.today,24,1749003138,1749003162,1749003162.19435,-18000,,
com.google.Chrome,37,1749003101,1749003138,1749003138.385318,-18000,,
com.apple.Notes,10,1749003091,1749003101,1749003101.410534,-18000,,
com.google.Chrome,1,1749003090,1749003091,1749003091.102762,-18000,,
com.apple.Notes,61,1749003029,1749003090,1749003090.4504662,-18000,,
com.google.Chrome,1530,1749001499,1749003029,1749003029.984353,-18000,,
com.apple.Notes,299,1749000669,1749000968,1749000968.0838618,-18000,,
com.google.Chrome,990,1748999679,1749000669,1749000669.561136,-18000,,
com.apple.Notes,3,1748999676,1748999679,1748999679.324229,-18000,,
com.google.Chrome,266,1748999410,1748999676,1748999677.000442,-18000,,
com.apple.Notes,7,1748999403,1748999410,1748999410.692869,-18000,,
com.google.Chrome,36,1748999367,1748999403,1748999403.582294,-18000,,
com.google.Chrome,2378,1748987321,1748989699,1748989699.332871,-18000,,
com.google.Chrome,526,1748986786,1748987312,1748987312.460083,-18000,,
com.google.Chrome,781,1748985977,1748986758,1748986758.967109,-18000,,
com.google.Chrome,460,1748985505,1748985965,1748985965.1879191,-18000,,
com.google.Chrome,302,1748985030,1748985332,1748985332.617704,-18000,,
com.google.Chrome,1401,1748983447,1748984848,1748984848.897447,-18000,,
com.google.Chrome,665,1748982745,1748983410,1748983410.6197639,-18000,,
com.google.Chrome,1303,1748981434,1748982737,1748982737.6682281,-18000,,
com.google.Chrome,786,1748980353,1748981139,1748981139.021483,-18000,,
com.google.Chrome,553,1748979576,1748980129,1748980129.6828818,-18000,,
com.leomehlig.today,26,1748979550,1748979576,1748979577.0521789,-18000,,
com.leomehlig.today,358,1748962133,1748962491,1748962491.105616,-18000,,
com.google.Chrome,25,1748962108,1748962133,1748962133.9042668,-18000,,
com.apple.Notes,19,1748962089,1748962108,1748962108.5440469,-18000,,
com.leomehlig.today,12,1748962077,1748962089,1748962089.182555,-18000,,
com.google.Chrome,3,1748962074,1748962077,1748962078.0074968,-18000,,
com.google.Chrome,789,1748911965,1748912754,1748912754.8105578,-18000,,
com.apple.finder,5,1748911960,1748911965,1748911966.484859,-18000,,
com.apple.finder,312,1748910810,1748911122,1748911122.0768971,-18000,,
com.apple.MobileSMS,62,1748910748,1748910810,1748910810.7249022,-18000,,
com.apple.finder,2,1748910746,1748910748,1748910748.9647532,-18000,,
com.apple.Notes,1,1748910745,1748910746,1748910746.121196,-18000,,
com.apple.finder,1,1748910744,1748910745,1748910745.436765,-18000,,
com.leomehlig.today,127,1748910617,1748910744,1748910744.5012,-18000,,
com.leomehlig.today,49,1748896294,1748896343,1748896343.9457889,-18000,,
com.apple.finder,3,1748896291,1748896294,1748896294.74262,-18000,,
com.apple.Preview,0,1748896291,1748896291,1748896291.918567,-18000,,
com.google.Chrome,282,1748896009,1748896291,1748896291.74755,-18000,,
com.apple.Preview,9,1748896000,1748896009,1748896009.773107,-18000,,
com.google.Chrome,36,1748895964,1748896000,1748896000.581808,-18000,,
com.apple.Preview,123,1748895841,1748895964,1748895964.698081,-18000,,
com.apple.finder,7,1748895834,1748895841,1748895841.1136498,-18000,,
com.google.Chrome,89,1748895745,1748895834,1748895834.40618,-18000,,
com.apple.finder,6,1748895739,1748895745,1748895745.073931,-18000,,
com.google.Chrome,627,1748895112,1748895739,1748895739.952776,-18000,,
com.apple.finder,17,1748895095,1748895112,1748895112.8721452,-18000,,
com.google.Chrome,3,1748895092,1748895095,1748895095.650923,-18000,,
com.apple.finder,17,1748895075,1748895092,1748895092.07915,-18000,,
com.google.Chrome,1715,1748893360,1748895075,1748895075.4071531,-18000,,
com.leomehlig.today,13,1748893347,1748893360,1748893360.179255,-18000,,
com.google.Chrome,144,1748893203,1748893347,1748893347.358302,-18000,,
com.apple.Notes,16,1748893187,1748893203,1748893203.5279841,-18000,,
com.google.Chrome,73,1748893114,1748893187,1748893187.351224,-18000,,
com.apple.Notes,2,1748893112,1748893114,1748893114.440906,-18000,,
com.google.Chrome,10,1748893102,1748893112,1748893112.2672849,-18000,,
com.apple.Notes,13,1748893089,1748893102,1748893102.493655,-18000,,
com.google.Chrome,1656,1748891433,1748893089,1748893089.74924,-18000,,
com.leomehlig.today,1,1748891432,1748891433,1748891433.49839,-18000,,
com.apple.MobileSMS,39,1748891393,1748891432,1748891432.460927,-18000,,
com.leomehlig.today,33,1748891360,1748891393,1748891393.860681,-18000,,
com.leomehlig.today,57,1748879070,1748879127,1748879127.816483,-18000,,
com.google.Chrome,6,1748879064,1748879070,1748879070.6104,-18000,,
com.apple.MobileSMS,17,1748879047,1748879064,1748879064.6098819,-18000,,
com.google.Chrome,29,1748879018,1748879047,1748879048.013276,-18000,,
com.apple.Notes,6,1748875904,1748875910,1748875911.036999,-18000,,
com.google.Chrome,3,1748875901,1748875904,1748875904.119266,-18000,,
com.apple.Notes,5,1748875896,1748875901,1748875901.723209,-18000,,
com.google.Chrome,11,1748875885,1748875896,1748875896.58775,-18000,,
com.google.Chrome,183,1748820142,1748820325,1748820325.2311559,-18000,,
com.apple.finder,2,1748820140,1748820142,1748820142.215217,-18000,,
com.apple.finder,1,1748818399,1748818400,1748818400.583729,-18000,,
com.leomehlig.today,68,1748818331,1748818399,1748818399.174792,-18000,,
com.apple.finder,2,1748818329,1748818331,1748818331.8684149,-18000,,
com.apple.finder,3,1748818281,1748818284,1748818284.671818,-18000,,
com.apple.iCal,14,1748818267,1748818281,1748818281.734211,-18000,,
com.apple.Notes,1,1748818266,1748818267,1748818267.140811,-18000,,
com.google.Chrome,1,1748818265,1748818266,1748818266.847327,-18000,,
com.apple.MobileSMS,1,1748818264,1748818265,1748818265.4143372,-18000,,
com.microsoft.VSCode,3,1748818261,1748818264,1748818264.724073,-18000,,
com.google.Chrome,43,1748818218,1748818261,1748818261.462572,-18000,,
com.microsoft.VSCode,39,1748817061,1748817100,1748817100.0384579,-18000,,
com.apple.MobileSMS,100,1748816961,1748817061,1748817062.015496,-18000,,
com.microsoft.VSCode,4,1748816957,1748816961,1748816961.31072,-18000,,
com.apple.MobileSMS,13,1748816944,1748816957,1748816957.6585832,-18000,,
com.microsoft.VSCode,1852,1748815092,1748816944,1748816944.145938,-18000,,
com.google.Chrome,184,1748814908,1748815092,1748815092.3646998,-18000,,
com.apple.Notes,1,1748814907,1748814908,1748814908.4794888,-18000,,
com.google.Chrome,81,1748814826,1748814907,1748814907.163303,-18000,,
com.apple.Notes,11,1748814815,1748814826,1748814826.040512,-18000,,
com.google.Chrome,12,1748814803,1748814815,1748814815.384084,-18000,,
com.apple.Music,5,1748814798,1748814803,1748814803.6390538,-18000,,
com.apple.Music,195,1748813450,1748813645,1748813645.045566,-18000,,
com.google.Chrome,2620,1748810830,1748813450,1748813450.9934402,-18000,,
com.apple.MobileSMS,28,1748801967,1748801995,1748801995.874491,-18000,EB445137-D7F5-57EC-87DA-1DB460D64046,"iPhone13,2"
com.apple.findmy,19,1748801948,1748801967,1748801968.4875479,-18000,EB445137-D7F5-57EC-87DA-1DB460D64046,"iPhone13,2"
com.apple.MobileSMS,3,1748801945,1748801948,1748801948.418303,-18000,EB445137-D7F5-57EC-87DA-1DB460D64046,"iPhone13,2"
com.microsoft.Office.Outlook,4,1748801933,1748801937,1748801937.703682,-18000,EB445137-D7F5-57EC-87DA-1DB460D64046,"iPhone13,2"
com.apple.MobileSMS,13,1748801919,1748801932,1748801932.481242,-18000,EB445137-D7F5-57EC-87DA-1DB460D64046,"iPhone13,2"
com.hammerandchisel.discord,7,1748801912,1748801919,1748801919.674135,-18000,EB445137-D7F5-57EC-87DA-1DB460D64046,"iPhone13,2"
com.apple.MobileSMS,1,1748801911,1748801912,1748801912.227209,-18000,EB445137-D7F5-57EC-87DA-1DB460D64046,"iPhone13,2"
com.apple.MobileSMS,47,1748801862,1748801909,1748801909.789685,-18000,EB445137-D7F5-57EC-87DA-1DB460D64046,"iPhone13,2"
com.doordash.dasher,20,1748798644,1748798664,1748798664.209909,-18000,EB445137-D7F5-57EC-87DA-1DB460D64046,"iPhone13,2"
com.apple.Music,1,1748798642,1748798643,1748798643.735853,-18000,EB445137-D7F5-57EC-87DA-1DB460D64046,"iPhone13,2"
com.apple.Music,7,1748790668,1748790675,1748790675.773134,-18000,EB445137-D7F5-57EC-87DA-1DB460D64046,"iPhone13,2"
com.toyopagroup.picaboo,10,1748790642,1748790652,1748790652.1866841,-18000,EB445137-D7F5-57EC-87DA-1DB460D64046,"iPhone13,2"
com.apple.MobileSMS,2,1748790635,1748790637,1748790637.125146,-18000,EB445137-D7F5-57EC-87DA-1DB460D64046,"iPhone13,2"
com.apple.weather,0,1748790635,1748790635,1748790635.5208302,-18000,EB445137-D7F5-57EC-87DA-1DB460D64046,"iPhone13,2"
com.apple.weather,6,1748789843,1748789849,1748789849.7859569,-18000,EB445137-D7F5-57EC-87DA-1DB460D64046,"iPhone13,2"
com.renpho.health,17,1748789825,1748789842,1748789842.938644,-18000,EB445137-D7F5-57EC-87DA-1DB460D64046,"iPhone13,2"
com.apple.MobileSMS,35,1748789790,1748789825,1748789825.083646,-18000,EB445137-D7F5-57EC-87DA-1DB460D64046,"iPhone13,2"
com.apple.findmy,2,1748789788,1748789790,1748789794.944174,-18000,EB445137-D7F5-57EC-87DA-1DB460D64046,"iPhone13,2"
com.apple.findmy,75,1748789291,1748789366,1748789367.086088,-18000,EB445137-D7F5-57EC-87DA-1DB460D64046,"iPhone13,2"
com.apple.findmy,68,1748786620,1748786688,1748786689.198575,-18000,EB445137-D7F5-57EC-87DA-1DB460D64046,"iPhone13,2"
com.toyopagroup.picaboo,20,1748786579,1748786599,1748786599.3733,-18000,EB445137-D7F5-57EC-87DA-1DB460D64046,"iPhone13,2"
com.apple.mobiletimer,2,1748786547,1748786549,1748786550.188345,-18000,EB445137-D7F5-57EC-87DA-1DB460D64046,"iPhone13,2"
com.apple.mobiletimer,6,1748747046,1748747052,1748747052.957377,-18000,EB445137-D7F5-57EC-87DA-1DB460D64046,"iPhone13,2"
com.toyopagroup.picaboo,9,1748747024,1748747033,1748747033.612428,-18000,EB445137-D7F5-57EC-87DA-1DB460D64046,"iPhone13,2"
com.apple.MobileSMS,0,1748747024,1748747024,1748747024.5852761,-18000,EB445137-D7F5-57EC-87DA-1DB460D64046,"iPhone13,2"
com.apple.MobileSMS,2,1748747021,1748747023,1748747023.080957,-18000,EB445137-D7F5-57EC-87DA-1DB460D64046,"iPhone13,2"
com.toyopagroup.picaboo,25,1748744339,1748744364,1748744364.5536141,-18000,EB445137-D7F5-57EC-87DA-1DB460D64046,"iPhone13,2"
com.apple.MobileSMS,38,1748744299,1748744337,1748744337.382978,-18000,EB445137-D7F5-57EC-87DA-1DB460D64046,"iPhone13,2"
com.apple.weather,0,1748744299,1748744299,1748744300.241432,-18000,EB445137-D7F5-57EC-87DA-1DB460D64046,"iPhone13,2"
com.apple.weather,10,1748743947,1748743957,1748743957.538063,-18000,EB445137-D7F5-57EC-87DA-1DB460D64046,"iPhone13,2"
com.apple.MobileSMS,4,1748741834,1748741838,1748741838.815658,-18000,EB445137-D7F5-57EC-87DA-1DB460D64046,"iPhone13,2"
com.apple.MobileSMS,103,1748739245,1748739348,1748739348.683104,-18000,EB445137-D7F5-57EC-87DA-1DB460D64046,"iPhone13,2"
com.apple.MobileSMS,133,1748739047,1748739180,1748739180.9541302,-18000,EB445137-D7F5-57EC-87DA-1DB460D64046,"iPhone13,2"
com.apple.Maps,0,1748739047,1748739047,1748739047.977684,-18000,EB445137-D7F5-57EC-87DA-1DB460D64046,"iPhone13,2"
com.apple.Maps,5,1748738638,1748738643,1748738643.530221,-18000,EB445137-D7F5-57EC-87DA-1DB460D64046,"iPhone13,2"
com.apple.Maps,29,1748738605,1748738634,1748738634.914372,-18000,EB445137-D7F5-57EC-87DA-1DB460D64046,"iPhone13,2"
com.toyopagroup.picaboo,2,1748738601,1748738603,1748738603.736349,-18000,EB445137-D7F5-57EC-87DA-1DB460D64046,"iPhone13,2"
com.toyopagroup.picaboo,9,1748738579,1748738588,1748738589.1761441,-18000,EB445137-D7F5-57EC-87DA-1DB460D64046,"iPhone13,2"
com.apple.MobileSMS,0,1748738579,1748738579,1748738579.481402,-18000,EB445137-D7F5-57EC-87DA-1DB460D64046,"iPhone13,2"
com.apple.MobileSMS,24,1748738333,1748738357,1748738357.541133,-18000,EB445137-D7F5-57EC-87DA-1DB460D64046,"iPhone13,2"
com.apple.MobileSMS,66,1748738106,1748738172,1748738172.8160372,-18000,EB445137-D7F5-57EC-87DA-1DB460D64046,"iPhone13,2"
com.hammerandchisel.discord,8,1748738098,1748738106,1748738106.2102408,-18000,EB445137-D7F5-57EC-87DA-1DB460D64046,"iPhone13,2"
com.toyopagroup.picaboo,59,1748735707,1748735766,1748735766.280685,-18000,EB445137-D7F5-57EC-87DA-1DB460D64046,"iPhone13,2"
com.google.chrome.ios,5,1748727118,1748727123,1748727123.4811149,-18000,EB445137-D7F5-57EC-87DA-1DB460D64046,"iPhone13,2"
com.apple.weather,1,1748727117,1748727118,1748727118.1353788,-18000,EB445137-D7F5-57EC-87DA-1DB460D64046,"iPhone13,2"
com.strava.stravaride,227,1748726880,1748727107,1748727107.744736,-18000,EB445137-D7F5-57EC-87DA-1DB460D64046,"iPhone13,2"
com.google.chrome.ios,25,1748726855,1748726880,1748726880.782261,-18000,EB445137-D7F5-57EC-87DA-1DB460D64046,"iPhone13,2"
com.apple.findmy,7,1748723441,1748723448,1748723448.92273,-18000,EB445137-D7F5-57EC-87DA-1DB460D64046,"iPhone13,2"
com.google.Chrome,637,1748721393,1748722030,1748722030.186413,-18000,,
com.letterboxd.LetterboxdApp,5,1748721332,1748721337,1748721337.351766,-18000,EB445137-D7F5-57EC-87DA-1DB460D64046,"iPhone13,2"
com.strava.stravaride,9,1748721321,1748721330,1748721330.7807112,-18000,EB445137-D7F5-57EC-87DA-1DB460D64046,"iPhone13,2"
com.apple.news,1445,1748714135,1748715580,1748715580.970036,-18000,EB445137-D7F5-57EC-87DA-1DB460D64046,"iPhone13,2"
com.apple.findmy,19,1748714108,1748714127,1748714127.8803282,-18000,EB445137-D7F5-57EC-87DA-1DB460D64046,"iPhone13,2"
com.google.Chrome,900,1748713210,1748714110,1748714110.2507138,-18000,,
com.apple.iCal,23,1748713187,1748713210,1748713211.201037,-18000,,
com.google.Chrome,295,1748712892,1748713187,1748713187.143544,-18000,,
com.leomehlig.today,67,1748712825,1748712892,1748712892.5438762,-18000,,
com.apple.iCal,15,1748712810,1748712825,1748712825.476372,-18000,,
com.leomehlig.today,6,1748712804,1748712810,1748712810.948957,-18000,,
com.google.Chrome,34,1748712770,1748712804,1748712804.636342,-18000,,
com.leomehlig.today,14,1748712747,1748712761,1748712761.393409,-18000,,
com.google.Chrome,12,1748712735,1748712747,1748712747.7230659,-18000,,
com.apple.Notes,164,1748712571,1748712735,1748712735.1403918,-18000,,
com.google.Chrome,6,1748712565,1748712571,1748712571.249589,-18000,,
com.apple.Notes,27,1748712538,1748712565,1748712565.98392,-18000,,
com.google.Chrome,146,1748712392,1748712538,1748712538.409997,-18000,,
Astrospheric.Astrospheric,21,1748712283,1748712304,1748712304.70324,-18000,EB445137-D7F5-57EC-87DA-1DB460D64046,"iPhone13,2"
com.hammerandchisel.discord,31,1748712251,1748712282,1748712282.418974,-18000,EB445137-D7F5-57EC-87DA-1DB460D64046,"iPhone13,2"
com.facebook.Facebook,96,1748712141,1748712237,1748712237.842442,-18000,EB445137-D7F5-57EC-87DA-1DB460D64046,"iPhone13,2"
com.google.chrome.ios,15,1748712126,1748712141,1748712141.401783,-18000,EB445137-D7F5-57EC-87DA-1DB460D64046,"iPhone13,2"
com.facebook.Facebook,84,1748712042,1748712126,1748712126.1635919,-18000,EB445137-D7F5-57EC-87DA-1DB460D64046,"iPhone13,2"
com.apple.MobileSMS,17,1748712025,1748712042,1748712042.192264,-18000,EB445137-D7F5-57EC-87DA-1DB460D64046,"iPhone13,2"
com.facebook.Facebook,16,1748712009,1748712025,1748712025.560467,-18000,EB445137-D7F5-57EC-87DA-1DB460D64046,"iPhone13,2"
com.google.Chrome,300,1748711971,1748712271,1748712271.977604,-18000,,
com.apple.MobileSMS,15,1748711956,1748711971,1748711971.9003549,-18000,,
com.google.Chrome,84,1748711872,1748711956,1748711956.799978,-18000,,
com.apple.MobileSMS,2,1748711870,1748711872,1748711872.810519,-18000,,
com.google.Chrome,3,1748711867,1748711870,1748711870.645149,-18000,,
com.apple.MobileSMS,41,1748711826,1748711867,1748711867.572433,-18000,,
com.google.Chrome,4,1748711822,1748711826,1748711826.2651792,-18000,,
com.apple.MobileSMS,50,1748711772,1748711822,1748711822.813813,-18000,,
com.google.Chrome,68,1748711704,1748711772,1748711772.8621578,-18000,,
com.apple.MobileSMS,29,1748711675,1748711704,1748711704.301614,-18000,,
com.strava.stravaride,48,1748711424,1748711472,1748711472.98631,-18000,EB445137-D7F5-57EC-87DA-1DB460D64046,"iPhone13,2"
com.apple.MobileSMS,2,1748711410,1748711412,1748711413.0480242,-18000,EB445137-D7F5-57EC-87DA-1DB460D64046,"iPhone13,2"
com.google.Chrome,657,1748711018,1748711675,1748711675.2526221,-18000,,
com.apple.MobileSMS,6,1748711012,1748711018,1748711018.168501,-18000,,
com.google.Chrome,306,1748710706,1748711012,1748711012.62061,-18000,,
com.apple.MobileSMS,2,1748710704,1748710706,1748710706.119287,-18000,,
com.google.Chrome,17,1748710687,1748710704,1748710704.293015,-18000,,
com.apple.MobileSMS,34,1748710653,1748710687,1748710687.706748,-18000,,
com.google.Chrome,31,1748710622,1748710653,1748710653.312747,-18000,,
com.apple.finder,2,1748710620,1748710622,1748710622.9253368,-18000,,
com.leomehlig.today,44,1748710576,1748710620,1748710620.430304,-18000,,
com.apple.iCal,13,1748710563,1748710576,1748710576.683646,-18000,,
com.leomehlig.today,3,1748710560,1748710563,1748710563.3749251,-18000,,
com.apple.finder,39,1748710521,1748710560,1748710560.4375238,-18000,,
com.apple.MobileSMS,97,1748710432,1748710529,1748710529.326754,-18000,EB445137-D7F5-57EC-87DA-1DB460D64046,"iPhone13,2"
com.apple.CoreAuthUI,2,1748710127,1748710129,1748710129.9772038,-18000,EB445137-D7F5-57EC-87DA-1DB460D64046,"iPhone13,2"
com.clairmail.fth.client,18,1748710124,1748710142,1748710142.2718391,-18000,EB445137-D7F5-57EC-87DA-1DB460D64046,"iPhone13,2"
com.apple.findmy,2,1748709193,1748709195,1748709196.056448,-18000,EB445137-D7F5-57EC-87DA-1DB460D64046,"iPhone13,2"
com.apple.findmy,6,1748708278,1748708284,1748708284.641963,-18000,EB445137-D7F5-57EC-87DA-1DB460D64046,"iPhone13,2"
com.apple.findmy,5,1748708179,1748708184,1748708185.171609,-18000,EB445137-D7F5-57EC-87DA-1DB460D64046,"iPhone13,2"
com.google.chrome.ios,2,1748708177,1748708179,1748708179.0953388,-18000,EB445137-D7F5-57EC-87DA-1DB460D64046,"iPhone13,2"
com.google.chrome.ios,38,1748707719,1748707757,1748707757.6239219,-18000,EB445137-D7F5-57EC-87DA-1DB460D64046,"iPhone13,2"
com.apple.findmy,11,1748707708,1748707719,1748707719.868653,-18000,EB445137-D7F5-57EC-87DA-1DB460D64046,"iPhone13,2"
com.google.Gmail,4,1748707689,1748707693,1748707694.013342,-18000,EB445137-D7F5-57EC-87DA-1DB460D64046,"iPhone13,2"
com.google.chrome.ios,6,1748707683,1748707689,1748707689.8182821,-18000,EB445137-D7F5-57EC-87DA-1DB460D64046,"iPhone13,2"
com.google.Gmail,5,1748707678,1748707683,1748707683.5597959,-18000,EB445137-D7F5-57EC-87DA-1DB460D64046,"iPhone13,2"
com.strava.stravaride,32,1748707640,1748707672,1748707672.0563579,-18000,EB445137-D7F5-57EC-87DA-1DB460D64046,"iPhone13,2"
com.apple.MobileSMS,85,1748707312,1748707397,1748707397.444233,-18000,EB445137-D7F5-57EC-87DA-1DB460D64046,"iPhone13,2"
com.apple.findmy,2,1748707310,1748707312,1748707312.5678291,-18000,EB445137-D7F5-57EC-87DA-1DB460D64046,"iPhone13,2"
com.apple.findmy,12,1748707295,1748707307,1748707307.734108,-18000,EB445137-D7F5-57EC-87DA-1DB460D64046,"iPhone13,2"
com.doordash.dasher,8,1748707286,1748707294,1748707294.412856,-18000,EB445137-D7F5-57EC-87DA-1DB460D64046,"iPhone13,2"
com.apple.mobilecal,2,1748707282,1748707284,1748707284.085485,-18000,EB445137-D7F5-57EC-87DA-1DB460D64046,"iPhone13,2"
com.apple.mobilecal,1,1748707172,1748707173,1748707173.5470939,-18000,EB445137-D7F5-57EC-87DA-1DB460D64046,"iPhone13,2"
com.apple.mobilecal,19,1748706673,1748706692,1748706692.824801,-18000,EB445137-D7F5-57EC-87DA-1DB460D64046,"iPhone13,2"
com.google.chrome.ios,1,1748706672,1748706673,1748706673.9102368,-18000,EB445137-D7F5-57EC-87DA-1DB460D64046,"iPhone13,2"
com.apple.mobilecal,8,1748706664,1748706672,1748706672.650501,-18000,EB445137-D7F5-57EC-87DA-1DB460D64046,"iPhone13,2"
com.google.chrome.ios,5,1748706659,1748706664,1748706664.295053,-18000,EB445137-D7F5-57EC-87DA-1DB460D64046,"iPhone13,2"
com.apple.mobilecal,3,1748706655,1748706658,1748706658.977304,-18000,EB445137-D7F5-57EC-87DA-1DB460D64046,"iPhone13,2"
com.apple.findmy,8,1748704744,1748704752,1748704752.345861,-18000,EB445137-D7F5-57EC-87DA-1DB460D64046,"iPhone13,2"
com.apple.findmy,3,1748704674,1748704677,1748704677.853754,-18000,EB445137-D7F5-57EC-87DA-1DB460D64046,"iPhone13,2"
com.apple.Maps,8,1748704492,1748704500,1748704500.0645242,-18000,EB445137-D7F5-57EC-87DA-1DB460D64046,"iPhone13,2"
com.apple.CoreAuthUI,2,1748704434,1748704436,1748704436.061748,-18000,EB445137-D7F5-57EC-87DA-1DB460D64046,"iPhone13,2"
com.truebill.truebillnative,39,1748704430,1748704469,1748704469.77391,-18000,EB445137-D7F5-57EC-87DA-1DB460D64046,"iPhone13,2"
com.apple.findmy,9,1748704416,1748704425,1748704426.060401,-18000,EB445137-D7F5-57EC-87DA-1DB460D64046,"iPhone13,2"
com.strava.stravaride,61,1748704354,1748704415,1748704415.883154,-18000,EB445137-D7F5-57EC-87DA-1DB460D64046,"iPhone13,2"
com.apple.news,9,1748704342,1748704351,1748704351.3771691,-18000,EB445137-D7F5-57EC-87DA-1DB460D64046,"iPhone13,2"
com.doordash.dasher,17,1748704313,1748704330,1748704330.831563,-18000,EB445137-D7F5-57EC-87DA-1DB460D64046,"iPhone13,2"
com.apple.Health,26,1748700834,1748700860,1748700860.769753,-18000,EB445137-D7F5-57EC-87DA-1DB460D64046,"iPhone13,2"
com.apple.Health,27,1748700639,1748700666,1748700666.4747128,-18000,EB445137-D7F5-57EC-87DA-1DB460D64046,"iPhone13,2"
com.apple.Health,25,1748700612,1748700637,1748700637.72889,-18000,EB445137-D7F5-57EC-87DA-1DB460D64046,"iPhone13,2"
com.apple.findmy,0,1748700612,1748700612,1748700612.926862,-18000,EB445137-D7F5-57EC-87DA-1DB460D64046,"iPhone13,2"
com.apple.findmy,5,1748700598,1748700603,1748700604.687669,-18000,EB445137-D7F5-57EC-87DA-1DB460D64046,"iPhone13,2"
com.apple.finder,300,1748700141,1748700441,1748700441.273528,-18000,,
com.leomehlig.today,30,1748700111,1748700141,1748700141.099052,-18000,,
com.apple.finder,3,1748700108,1748700111,1748700111.553409,-18000,,
com.apple.MobileSMS,5,1748700103,1748700108,1748700108.9986072,-18000,,
com.apple.finder,45,1748700058,1748700103,1748700103.7885761,-18000,,
com.apple.findmy,13,1748699654,1748699667,1748699667.566832,-18000,EB445137-D7F5-57EC-87DA-1DB460D64046,"iPhone13,2"
com.apple.finder,4,1748637797,1748637801,1748637801.9905028,-18000,,
com.leomehlig.today,1,1748637796,1748637797,1748637797.310183,-18000,,
com.google.Chrome,54,1748637742,1748637796,1748637797.131541,-18000,,
com.leomehlig.today,4,1748637730,1748637734,1748637734.0503302,-18000,,
com.google.Chrome,259,1748637471,1748637730,1748637730.8415809,-18000,,
com.google.Chrome,1436,1748635933,1748637369,1748637369.4136682,-18000,,
com.leomehlig.today,8,1748635925,1748635933,1748635933.1317592,-18000,,
com.google.Chrome,577,1748635348,1748635925,1748635925.3633041,-18000,,
com.apple.finder,0,1748635348,1748635348,1748635348.9145122,-18000,,
com.google.Chrome,1390,1748633958,1748635348,1748635348.14752,-18000,,
com.apple.Notes,5,1748633953,1748633958,1748633958.744843,-18000,,
com.google.Chrome,3,1748633950,1748633953,1748633953.54141,-18000,,
com.apple.finder,4,1748633946,1748633950,1748633950.072546,-18000,,
com.leomehlig.today,26,1748633920,1748633946,1748633946.055177,-18000,,
com.google.Chrome,4,1748633916,1748633920,1748633920.9764838,-18000,,
com.google.Chrome,405,1748633256,1748633661,1748633661.740642,-18000,,
com.apple.findmy,2,1748633254,1748633256,1748633256.504884,-18000,,
com.apple.findmy,309,1748621283,1748621592,1748621592.836886,-18000,,
com.google.Chrome,5,1748621278,1748621283,1748621283.307936,-18000,,
com.google.Chrome,273,1748614352,1748614625,1748614626.414761,-18000,,
com.google.Chrome,565,1748613484,1748614049,1748614049.593979,-18000,,
com.google.Chrome,415,1748612679,1748613094,1748613094.321373,-18000,,
com.google.Chrome,660,1748611797,1748612457,1748612457.3621469,-18000,,
com.google.Chrome,126,1748580913,1748581039,1748581039.3701549,-18000,,
com.google.Chrome,298,1748565811,1748566109,1748566110.0642118,-18000,,
com.google.Chrome,1439,1748563647,1748565086,1748565086.383772,-18000,,
com.google.Chrome,321,1748563292,1748563613,1748563613.097641,-18000,,
com.google.Chrome,806,1748562388,1748563194,1748563194.818403,-18000,,
com.letterboxd.LetterboxdApp,80,1748561529,1748561609,1748561609.268419,-18000,EB445137-D7F5-57EC-87DA-1DB460D64046,"iPhone13,2"
com.apple.MobileSMS,3,1748561525,1748561528,1748561528.855547,-18000,EB445137-D7F5-57EC-87DA-1DB460D64046,"iPhone13,2"
com.google.Chrome,469,1748561457,1748561926,1748561926.278099,-18000,,
com.toyopagroup.picaboo,88,1748561435,1748561523,1748561523.938146,-18000,EB445137-D7F5-57EC-87DA-1DB460D64046,"iPhone13,2"
com.leomehlig.today,41,1748561416,1748561457,1748561458.177886,-18000,,
com.apple.iCal,17,1748561399,1748561416,1748561416.7132978,-18000,,
com.leomehlig.today,125,1748561274,1748561399,1748561399.265894,-18000,,
com.toyopagroup.picaboo,50,1748561222,1748561272,1748561272.2044868,-18000,EB445137-D7F5-57EC-87DA-1DB460D64046,"iPhone13,2"
com.amazon.Amazon,1,1748561219,1748561220,1748561220.6480432,-18000,EB445137-D7F5-57EC-87DA-1DB460D64046,"iPhone13,2"
com.apple.MobileSMS,72,1748561202,1748561274,1748561274.936857,-18000,,
com.leomehlig.today,23,1748561179,1748561202,1748561202.417231,-18000,,
com.amazon.Amazon,17,1748561118,1748561135,1748561136.050103,-18000,EB445137-D7F5-57EC-87DA-1DB460D64046,"iPhone13,2"
com.apple.news,107,1748559448,1748559555,1748559555.875132,-18000,EB445137-D7F5-57EC-87DA-1DB460D64046,"iPhone13,2"
com.apple.news,708,1748558739,1748559447,1748559447.2896872,-18000,EB445137-D7F5-57EC-87DA-1DB460D64046,"iPhone13,2"
com.doordash.dasher,77,1748558575,1748558652,1748558652.6281018,-18000,EB445137-D7F5-57EC-87DA-1DB460D64046,"iPhone13,2"
com.doordash.dasher,2,1748558570,1748558572,1748558572.8127341,-18000,EB445137-D7F5-57EC-87DA-1DB460D64046,"iPhone13,2"
com.doordash.dasher,1168,1748557210,1748558378,1748558378.237746,-18000,EB445137-D7F5-57EC-87DA-1DB460D64046,"iPhone13,2"
com.doordash.dasher,7,1748557146,1748557153,1748557153.126031,-18000,EB445137-D7F5-57EC-87DA-1DB460D64046,"iPhone13,2"
com.doordash.dasher,111,1748556920,1748557031,1748557031.57197,-18000,EB445137-D7F5-57EC-87DA-1DB460D64046,"iPhone13,2"
com.doordash.dasher,2,1748556918,1748556920,1748556920.183786,-18000,EB445137-D7F5-57EC-87DA-1DB460D64046,"iPhone13,2"
com.doordash.dasher,11,1748556901,1748556912,1748556912.8598862,-18000,EB445137-D7F5-57EC-87DA-1DB460D64046,"iPhone13,2"
com.apple.InCallService,42,1748556857,1748556899,1748556899.362135,-18000,EB445137-D7F5-57EC-87DA-1DB460D64046,"iPhone13,2"
com.apple.InCallService,249,1748556604,1748556853,1748556853.558043,-18000,EB445137-D7F5-57EC-87DA-1DB460D64046,"iPhone13,2"
com.apple.BusinessChatViewService,1,1748556603,1748556604,1748556604.2055922,-18000,EB445137-D7F5-57EC-87DA-1DB460D64046,"iPhone13,2"
com.doordash.dasher,359,1748556245,1748556604,1748556604.7459512,-18000,EB445137-D7F5-57EC-87DA-1DB460D64046,"iPhone13,2"
com.apple.InCallService,8,1748556237,1748556245,1748556245.2875881,-18000,EB445137-D7F5-57EC-87DA-1DB460D64046,"iPhone13,2"
com.apple.BusinessChatViewService,2,1748556235,1748556237,1748556237.467109,-18000,EB445137-D7F5-57EC-87DA-1DB460D64046,"iPhone13,2"
com.doordash.dasher,341,1748555896,1748556237,1748556238.3427482,-18000,EB445137-D7F5-57EC-87DA-1DB460D64046,"iPhone13,2"
com.doordash.dasher,74,1748555803,1748555877,1748555877.355803,-18000,EB445137-D7F5-57EC-87DA-1DB460D64046,"iPhone13,2"
com.doordash.dasher,11,1748555728,1748555739,1748555739.9610748,-18000,EB445137-D7F5-57EC-87DA-1DB460D64046,"iPhone13,2"
com.tinyspeck.chatlyio,12,1748555716,1748555728,1748555728.072833,-18000,EB445137-D7F5-57EC-87DA-1DB460D64046,"iPhone13,2"
com.apple.Music,10,1748555703,1748555713,1748555713.193575,-18000,EB445137-D7F5-57EC-87DA-1DB460D64046,"iPhone13,2"
com.tinyspeck.chatlyio,2,1748555700,1748555702,1748555702.87324,-18000,EB445137-D7F5-57EC-87DA-1DB460D64046,"iPhone13,2"
com.tinyspeck.chatlyio,15,1748555683,1748555698,1748555698.407115,-18000,EB445137-D7F5-57EC-87DA-1DB460D64046,"iPhone13,2"
com.doordash.dasher,17,1748555666,1748555683,1748555683.3645859,-18000,EB445137-D7F5-57EC-87DA-1DB460D64046,"iPhone13,2"
com.tinyspeck.chatlyio,12,1748555654,1748555666,1748555666.964089,-18000,EB445137-D7F5-57EC-87DA-1DB460D64046,"iPhone13,2"
com.doordash.dasher,0,1748555654,1748555654,1748555654.897315,-18000,EB445137-D7F5-57EC-87DA-1DB460D64046,"iPhone13,2"
com.doordash.dasher,128,1748555525,1748555653,1748555654.037292,-18000,EB445137-D7F5-57EC-87DA-1DB460D64046,"iPhone13,2"
com.doordash.dasher,117,1748555390,1748555507,1748555507.804906,-18000,EB445137-D7F5-57EC-87DA-1DB460D64046,"iPhone13,2"
com.doordash.dasher,178,1748555180,1748555358,1748555358.859282,-18000,EB445137-D7F5-57EC-87DA-1DB460D64046,"iPhone13,2"
com.doordash.dasher,373,1748554737,1748555110,1748555110.805928,-18000,EB445137-D7F5-57EC-87DA-1DB460D64046,"iPhone13,2"
com.ebay.iphone,16,1748554721,1748554737,1748554737.7352529,-18000,EB445137-D7F5-57EC-87DA-1DB460D64046,"iPhone13,2"
com.strava.stravaride,21,1748554691,1748554712,1748554712.345964,-18000,EB445137-D7F5-57EC-87DA-1DB460D64046,"iPhone13,2"
com.doordash.dasher,0,1748554691,1748554691,1748554691.8323789,-18000,EB445137-D7F5-57EC-87DA-1DB460D64046,"iPhone13,2"
com.doordash.dasher,1130,1748553558,1748554688,1748554688.527845,-18000,EB445137-D7F5-57EC-87DA-1DB460D64046,"iPhone13,2"
com.doordash.dasher,46,1748553456,1748553502,1748553502.461812,-18000,EB445137-D7F5-57EC-87DA-1DB460D64046,"iPhone13,2"
com.doordash.dasher,2,1748553265,1748553267,1748553267.562357,-18000,EB445137-D7F5-57EC-87DA-1DB460D64046,"iPhone13,2"
com.doordash.dasher,84,1748553054,1748553138,1748553138.101478,-18000,EB445137-D7F5-57EC-87DA-1DB460D64046,"iPhone13,2"
com.leomehlig.today,7,1748552941,1748552948,1748552948.830102,-18000,,
com.apple.finder,0,1748552941,1748552941,1748552941.923512,-18000,,
com.leomehlig.today,1,1748552940,1748552941,1748552941.549465,-18000,,
com.apple.Notes,0,1748552940,1748552940,1748552941.027868,-18000,,
com.leomehlig.today,1,1748552939,1748552940,1748552940.7415938,-18000,,
com.apple.finder,1,1748552938,1748552939,1748552939.579331,-18000,,
com.apple.Preview,2,1748552936,1748552938,1748552939.097667,-18000,,
com.google.Chrome,1509,1748551427,1748552936,1748552937.7639651,-18000,,
com.apple.Preview,6,1748551421,1748551427,1748551427.653189,-18000,,
com.google.Chrome,1,1748551420,1748551421,1748551421.673407,-18000,,
com.apple.Preview,0,1748551420,1748551420,1748551420.466888,-18000,,
com.google.Chrome,60,1748551360,1748551420,1748551420.111362,-18000,,
com.apple.Preview,61,1748551299,1748551360,1748551360.50802,-18000,,
com.apple.finder,6,1748551293,1748551299,1748551299.03708,-18000,,
com.google.Chrome,97,1748551196,1748551293,1748551293.403811,-18000,,
com.apple.finder,1,1748551195,1748551196,1748551196.312811,-18000,,
com.apple.Preview,17,1748551178,1748551195,1748551195.664888,-18000,,
com.apple.finder,1,1748551177,1748551178,1748551178.8207278,-18000,,
com.google.Chrome,4,1748551173,1748551177,1748551177.0471869,-18000,,
com.apple.finder,1,1748551172,1748551173,1748551173.7954311,-18000,,
com.apple.Preview,25,1748551147,1748551172,1748551173.011262,-18000,,
com.apple.finder,3,1748551144,1748551147,1748551147.250725,-18000,,
com.google.Chrome,1,1748551143,1748551144,1748551144.159216,-18000,,
com.apple.Notes,9,1748551134,1748551143,1748551143.290029,-18000,,
com.google.Chrome,382,1748550752,1748551134,1748551134.67679,-18000,,
com.apple.Preview,4,1748550748,1748550752,1748550752.346798,-18000,,
com.google.Chrome,7,1748550741,1748550748,1748550748.386842,-18000,,
com.apple.Preview,8,1748550733,1748550741,1748550741.6944652,-18000,,
com.google.Chrome,15,1748550718,1748550733,1748550733.093396,-18000,,
com.apple.Preview,1,1748550717,1748550718,1748550718.7455611,-18000,,
com.google.Chrome,2,1748550715,1748550717,1748550717.399811,-18000,,
com.apple.Preview,1,1748550714,1748550715,1748550715.960421,-18000,,
com.google.Chrome,1,1748550713,1748550714,1748550714.877327,-18000,,
com.apple.Preview,1,1748550712,1748550713,1748550713.517389,-18000,,
com.google.Chrome,2,1748550710,1748550712,1748550712.72586,-18000,,
com.apple.Preview,2,1748550708,1748550710,1748550710.889484,-18000,,
com.google.Chrome,0,1748550708,1748550708,1748550708.731921,-18000,,
com.apple.Preview,1,1748550707,1748550708,1748550708.111825,-18000,,
com.google.Chrome,2,1748550705,1748550707,1748550707.433388,-18000,,
com.apple.Preview,4,1748550701,1748550705,1748550705.524307,-18000,,
com.google.Chrome,1,1748550700,1748550701,1748550701.53268,-18000,,
com.apple.Preview,5,1748550695,1748550700,1748550700.053979,-18000,,
com.google.Chrome,18,1748550677,1748550695,1748550695.1359072,-18000,,
com.apple.Preview,16,1748550661,1748550677,1748550677.35126,-18000,,
com.google.Chrome,15,1748550646,1748550661,1748550661.069207,-18000,,
com.apple.Preview,36,1748550610,1748550646,1748550646.5684052,-18000,,
com.google.Chrome,1,1748550609,1748550610,1748550610.2013159,-18000,,
com.apple.Preview,8,1748550601,1748550609,1748550609.125845,-18000,,
com.google.Chrome,59,1748550542,1748550601,1748550602.041965,-18000,,
com.apple.Preview,1,1748550541,1748550542,1748550542.92472,-18000,,
com.google.Chrome,12,1748550529,1748550541,1748550541.988287,-18000,,
com.apple.Preview,1,1748550528,1748550529,1748550529.561722,-18000,,
com.google.Chrome,10,1748550518,1748550528,1748550528.619605,-18000,,
com.apple.Preview,1,1748550517,1748550518,1748550518.935699,-18000,,
com.google.Chrome,16,1748550501,1748550517,1748550517.031827,-18000,,
com.apple.Preview,12,1748550489,1748550501,1748550501.3054461,-18000,,
com.google.Chrome,7,1748550482,1748550489,1748550489.417204,-18000,,
com.apple.Preview,1,1748550481,1748550482,1748550482.534231,-18000,,
com.apple.finder,1,1748550480,1748550481,1748550481.607074,-18000,,
com.apple.Preview,43,1748550437,1748550480,1748550480.9673629,-18000,,
com.apple.finder,1,1748550436,1748550437,1748550437.042454,-18000,,
com.apple.Preview,95,1748550341,1748550436,1748550436.492368,-18000,,
com.apple.finder,4,1748550337,1748550341,1748550341.884664,-18000,,
com.google.Chrome,948,1748549389,1748550337,1748550337.6974669,-18000,,
com.leomehlig.today,9,1748549380,1748549389,1748549389.3420591,-18000,,
com.apple.iCal,5,1748549375,1748549380,1748549380.941617,-18000,,
com.doordash.dasher,19,1748549339,1748549358,1748549358.3426728,-18000,EB445137-D7F5-57EC-87DA-1DB460D64046,"iPhone13,2"
com.apple.camera,2,1748549337,1748549339,1748549339.552085,-18000,EB445137-D7F5-57EC-87DA-1DB460D64046,"iPhone13,2"
com.leomehlig.today,46,1748549329,1748549375,1748549375.542581,-18000,,
com.apple.camera,331,1748545970,1748546301,1748546302.208281,-18000,EB445137-D7F5-57EC-87DA-1DB460D64046,"iPhone13,2"
com.apple.findmy,2,1748543513,1748543515,1748543515.8883429,-18000,EB445137-D7F5-57EC-87DA-1DB460D64046,"iPhone13,2"
com.apple.findmy,1,1748542545,1748542546,1748542547.306464,-18000,EB445137-D7F5-57EC-87DA-1DB460D64046,"iPhone13,2"
com.apple.findmy,199,1748542141,1748542340,1748542340.813394,-18000,EB445137-D7F5-57EC-87DA-1DB460D64046,"iPhone13,2"
com.doordash.dasher,214,1748541659,1748541873,1748541873.24466,-18000,EB445137-D7F5-57EC-87DA-1DB460D64046,"iPhone13,2"
com.doordash.dasher,259,1748541365,1748541624,1748541624.884028,-18000,EB445137-D7F5-57EC-87DA-1DB460D64046,"iPhone13,2"
com.doordash.dasher,866,1748540497,1748541363,1748541363.488198,-18000,EB445137-D7F5-57EC-87DA-1DB460D64046,"iPhone13,2"
com.doordash.dasher,154,1748540339,1748540493,1748540493.731848,-18000,EB445137-D7F5-57EC-87DA-1DB460D64046,"iPhone13,2"
com.apple.news,20,1748540319,1748540339,1748540339.107136,-18000,EB445137-D7F5-57EC-87DA-1DB460D64046,"iPhone13,2"
com.apple.news,8,1748540311,1748540319,1748540321.074555,-18000,EB445137-D7F5-57EC-87DA-1DB460D64046,"iPhone13,2"
com.doordash.dasher,198,1748540098,1748540296,1748540296.365567,-18000,EB445137-D7F5-57EC-87DA-1DB460D64046,"iPhone13,2"
com.doordash.dasher,21,1748540065,1748540086,1748540087.041809,-18000,EB445137-D7F5-57EC-87DA-1DB460D64046,"iPhone13,2"
com.google.chrome.ios,61,1748540004,1748540065,1748540065.221856,-18000,EB445137-D7F5-57EC-87DA-1DB460D64046,"iPhone13,2"
com.apple.MobileSMS,9,1748539995,1748540004,1748540004.4451308,-18000,EB445137-D7F5-57EC-87DA-1DB460D64046,"iPhone13,2"
com.google.chrome.ios,85,1748539910,1748539995,1748539996.148988,-18000,EB445137-D7F5-57EC-87DA-1DB460D64046,"iPhone13,2"
com.apple.MobileSMS,22,1748539887,1748539909,1748539910.073003,-18000,EB445137-D7F5-57EC-87DA-1DB460D64046,"iPhone13,2"
com.apple.mobilecal,13,1748539873,1748539886,1748539886.4920511,-18000,EB445137-D7F5-57EC-87DA-1DB460D64046,"iPhone13,2"
com.apple.weather,41,1748539819,1748539860,1748539860.8843951,-18000,EB445137-D7F5-57EC-87DA-1DB460D64046,"iPhone13,2"
com.apple.camera,17,1748539784,1748539801,1748539801.056273,-18000,EB445137-D7F5-57EC-87DA-1DB460D64046,"iPhone13,2"
com.doordash.dasher,2,1748539759,1748539761,1748539761.4466991,-18000,EB445137-D7F5-57EC-87DA-1DB460D64046,"iPhone13,2"
com.ebay.iphone,19,1748539740,1748539759,1748539759.480999,-18000,EB445137-D7F5-57EC-87DA-1DB460D64046,"iPhone13,2"
com.doordash.dasher,3,1748539735,1748539738,1748539738.473517,-18000,EB445137-D7F5-57EC-87DA-1DB460D64046,"iPhone13,2"
com.doordash.dasher,4,1748539728,1748539732,1748539732.734,-18000,EB445137-D7F5-57EC-87DA-1DB460D64046,"iPhone13,2"
com.facebook.Facebook,114,1748539614,1748539728,1748539728.8080668,-18000,EB445137-D7F5-57EC-87DA-1DB460D64046,"iPhone13,2"
com.doordash.dasher,6,1748539598,1748539604,1748539604.7969751,-18000,EB445137-D7F5-57EC-87DA-1DB460D64046,"iPhone13,2"
com.apple.mobilecal,9,1748539589,1748539598,1748539598.7835832,-18000,EB445137-D7F5-57EC-87DA-1DB460D64046,"iPhone13,2"
com.microsoft.onenote,34,1748539552,1748539586,1748539586.337791,-18000,EB445137-D7F5-57EC-87DA-1DB460D64046,"iPhone13,2"
com.apple.journal,6,1748539546,1748539552,1748539552.132057,-18000,EB445137-D7F5-57EC-87DA-1DB460D64046,"iPhone13,2"
com.microsoft.onenote,28,1748539518,1748539546,1748539546.797943,-18000,EB445137-D7F5-57EC-87DA-1DB460D64046,"iPhone13,2"
com.apple.journal,21,1748539497,1748539518,1748539518.757547,-18000,EB445137-D7F5-57EC-87DA-1DB460D64046,"iPhone13,2"
com.microsoft.onenote,5,1748539492,1748539497,1748539497.299518,-18000,EB445137-D7F5-57EC-87DA-1DB460D64046,"iPhone13,2"
com.apple.CoreAuthUI,2,1748539473,1748539475,1748539475.5505,-18000,EB445137-D7F5-57EC-87DA-1DB460D64046,"iPhone13,2"
com.apple.journal,20,1748539472,1748539492,1748539492.365938,-18000,EB445137-D7F5-57EC-87DA-1DB460D64046,"iPhone13,2"
com.microsoft.onenote,21,1748539449,1748539470,1748539470.56743,-18000,EB445137-D7F5-57EC-87DA-1DB460D64046,"iPhone13,2"
com.apple.mobilecal,13,1748539436,1748539449,1748539449.776814,-18000,EB445137-D7F5-57EC-87DA-1DB460D64046,"iPhone13,2"
com.apple.CoreAuthUI,2,1748539426,1748539428,1748539428.722789,-18000,EB445137-D7F5-57EC-87DA-1DB460D64046,"iPhone13,2"
com.microsoft.onenote,18,1748539416,1748539434,1748539434.840616,-18000,EB445137-D7F5-57EC-87DA-1DB460D64046,"iPhone13,2"
com.doordash.dasher,5,1748539408,1748539413,1748539413.6040711,-18000,EB445137-D7F5-57EC-87DA-1DB460D64046,"iPhone13,2"
com.doordash.dasher,696,1748538709,1748539405,1748539405.120727,-18000,EB445137-D7F5-57EC-87DA-1DB460D64046,"iPhone13,2"
com.doordash.dasher,552,1748538151,1748538703,1748538703.132567,-18000,EB445137-D7F5-57EC-87DA-1DB460D64046,"iPhone13,2"
com.apple.Maps,87,1748538064,1748538151,1748538152.003263,-18000,EB445137-D7F5-57EC-87DA-1DB460D64046,"iPhone13,2"
com.doordash.dasher,153,1748537911,1748538064,1748538064.55587,-18000,EB445137-D7F5-57EC-87DA-1DB460D64046,"iPhone13,2"
com.apple.Health,20,1748537891,1748537911,1748537911.2549438,-18000,EB445137-D7F5-57EC-87DA-1DB460D64046,"iPhone13,2"
com.doordash.dasher,9,1748537882,1748537891,1748537891.986579,-18000,EB445137-D7F5-57EC-87DA-1DB460D64046,"iPhone13,2"
com.apple.Health,140,1748537737,1748537877,1748537877.2638168,-18000,EB445137-D7F5-57EC-87DA-1DB460D64046,"iPhone13,2"
com.strava.stravaride,50,1748537680,1748537730,1748537730.157017,-18000,EB445137-D7F5-57EC-87DA-1DB460D64046,"iPhone13,2"
com.toyopagroup.picaboo,16,1748537662,1748537678,1748537678.1378942,-18000,EB445137-D7F5-57EC-87DA-1DB460D64046,"iPhone13,2"
com.strava.stravaride,4,1748537656,1748537660,1748537660.600266,-18000,EB445137-D7F5-57EC-87DA-1DB460D64046,"iPhone13,2"
com.apple.MobileSMS,40,1748537612,1748537652,1748537652.840104,-18000,EB445137-D7F5-57EC-87DA-1DB460D64046,"iPhone13,2"
com.doordash.dasher,1,1748537611,1748537612,1748537612.504035,-18000,EB445137-D7F5-57EC-87DA-1DB460D64046,"iPhone13,2"
com.doordash.dasher,577,1748537031,1748537608,1748537608.7533221,-18000,EB445137-D7F5-57EC-87DA-1DB460D64046,"iPhone13,2"
com.doordash.dasher,159,1748536720,1748536879,1748536879.780566,-18000,EB445137-D7F5-57EC-87DA-1DB460D64046,"iPhone13,2"
com.apple.MobileSMS,26,1748536694,1748536720,1748536720.4167361,-18000,EB445137-D7F5-57EC-87DA-1DB460D64046,"iPhone13,2"
com.doordash.dasher,1,1748536693,1748536694,1748536694.374792,-18000,EB445137-D7F5-57EC-87DA-1DB460D64046,"iPhone13,2"
com.doordash.dasher,156,1748536536,1748536692,1748536692.2523541,-18000,EB445137-D7F5-57EC-87DA-1DB460D64046,"iPhone13,2"
com.apple.InCallService,32,1748536504,1748536536,1748536536.338228,-18000,EB445137-D7F5-57EC-87DA-1DB460D64046,"iPhone13,2"
com.apple.BusinessChatViewService,1,1748536502,1748536503,1748536504.18771,-18000,EB445137-D7F5-57EC-87DA-1DB460D64046,"iPhone13,2"
com.doordash.dasher,392,1748536112,1748536504,1748536504.557576,-18000,EB445137-D7F5-57EC-87DA-1DB460D64046,"iPhone13,2"
com.doordash.dasher,5,1748536049,1748536054,1748536054.722193,-18000,EB445137-D7F5-57EC-87DA-1DB460D64046,"iPhone13,2"
com.doordash.dasher,53,1748535881,1748535934,1748535934.9114819,-18000,EB445137-D7F5-57EC-87DA-1DB460D64046,"iPhone13,2"
com.apple.news,79,1748535802,1748535881,1748535881.976526,-18000,EB445137-D7F5-57EC-87DA-1DB460D64046,"iPhone13,2"
com.doordash.dasher,57,1748535742,1748535799,1748535799.372222,-18000,EB445137-D7F5-57EC-87DA-1DB460D64046,"iPhone13,2"
com.doordash.dasher,1,1748535741,1748535742,1748535742.0900822,-18000,EB445137-D7F5-57EC-87DA-1DB460D64046,"iPhone13,2"
com.doordash.dasher,21,1748535718,1748535739,1748535739.647505,-18000,EB445137-D7F5-57EC-87DA-1DB460D64046,"iPhone13,2"
com.doordash.dasher,62,1748535648,1748535710,1748535710.73857,-18000,EB445137-D7F5-57EC-87DA-1DB460D64046,"iPhone13,2"
com.doordash.dasher,95,1748535551,1748535646,1748535646.699966,-18000,EB445137-D7F5-57EC-87DA-1DB460D64046,"iPhone13,2"
com.doordash.dasher,9,1748535542,1748535551,1748535551.599553,-18000,EB445137-D7F5-57EC-87DA-1DB460D64046,"iPhone13,2"
com.apple.mobileslideshow,62,1748535480,1748535542,1748535542.699163,-18000,EB445137-D7F5-57EC-87DA-1DB460D64046,"iPhone13,2"
com.doordash.dasher,0,1748535480,1748535480,1748535480.271404,-18000,EB445137-D7F5-57EC-87DA-1DB460D64046,"iPhone13,2"
com.doordash.dasher,424,1748535054,1748535478,1748535478.265617,-18000,EB445137-D7F5-57EC-87DA-1DB460D64046,"iPhone13,2"
com.apple.Music,18,1748535036,1748535054,1748535054.209989,-18000,EB445137-D7F5-57EC-87DA-1DB460D64046,"iPhone13,2"
com.apple.Preferences,10,1748535026,1748535036,1748535036.56481,-18000,EB445137-D7F5-57EC-87DA-1DB460D64046,"iPhone13,2"
com.apple.MusicUIService,3,1748535004,1748535007,1748535007.249088,-18000,EB445137-D7F5-57EC-87DA-1DB460D64046,"iPhone13,2"
com.apple.Music,33,1748534992,1748535025,1748535025.972443,-18000,EB445137-D7F5-57EC-87DA-1DB460D64046,"iPhone13,2"
com.doordash.dasher,3,1748534989,1748534992,1748534992.868089,-18000,EB445137-D7F5-57EC-87DA-1DB460D64046,"iPhone13,2"
com.doordash.dasher,202,1748534660,1748534862,1748534862.212175,-18000,EB445137-D7F5-57EC-87DA-1DB460D64046,"iPhone13,2"
com.strava.stravaride,49,1748532540,1748532589,1748532589.5357308,-18000,EB445137-D7F5-57EC-87DA-1DB460D64046,"iPhone13,2"
com.doordash.dasher,9,1748532531,1748532540,1748532540.430872,-18000,EB445137-D7F5-57EC-87DA-1DB460D64046,"iPhone13,2"
com.toyopagroup.picaboo,60,1748529648,1748529708,1748529708.343474,-18000,EB445137-D7F5-57EC-87DA-1DB460D64046,"iPhone13,2"
com.leomehlig.today,33,1748529369,1748529402,1748529402.62739,-18000,,
com.apple.iCal,10,1748529359,1748529369,1748529369.809564,-18000,,
com.leomehlig.today,73,1748529286,1748529359,1748529359.980902,-18000,,
com.google.Chrome,44,1748529242,1748529286,1748529286.2636418,-18000,,
com.apple.finder,1,1748528886,1748528887,1748528887.4724941,-18000,,
com.apple.Health,10,1748527300,1748527310,1748527310.2133908,-18000,EB445137-D7F5-57EC-87DA-1DB460D64046,"iPhone13,2"
com.letterboxd.LetterboxdApp,0,1748527300,1748527300,1748527300.7690659,-18000,EB445137-D7F5-57EC-87DA-1DB460D64046,"iPhone13,2"
com.google.Chrome,2279,1748526607,1748528886,1748528886.751665,-18000,,
com.apple.finder,6,1748526601,1748526607,1748526607.58616,-18000,,
com.google.Chrome,35,1748526566,1748526601,1748526601.0848289,-18000,,
com.apple.Preview,10,1748526556,1748526566,1748526566.636829,-18000,,
com.apple.finder,12,1748526544,1748526556,1748526556.503457,-18000,,
com.google.Chrome,841,1748525703,1748526544,1748526544.234,-18000,,
com.letterboxd.LetterboxdApp,175,1748525459,1748525634,1748525634.372332,-18000,EB445137-D7F5-57EC-87DA-1DB460D64046,"iPhone13,2"
com.ebay.iphone,33,1748525173,1748525206,1748525206.722007,-18000,EB445137-D7F5-57EC-87DA-1DB460D64046,"iPhone13,2"
com.apple.news,748,1748524401,1748525149,1748525149.4526448,-18000,EB445137-D7F5-57EC-87DA-1DB460D64046,"iPhone13,2"
com.apple.CoreAuthUI,2,1748524374,1748524376,1748524376.365742,-18000,EB445137-D7F5-57EC-87DA-1DB460D64046,"iPhone13,2"
com.robinhood.release.Robinhood,29,1748524372,1748524401,1748524401.745586,-18000,EB445137-D7F5-57EC-87DA-1DB460D64046,"iPhone13,2"
com.apple.news,54,1748524314,1748524368,1748524368.015057,-18000,EB445137-D7F5-57EC-87DA-1DB460D64046,"iPhone13,2"
com.apple.weather,4,1748524304,1748524308,1748524308.4097462,-18000,EB445137-D7F5-57EC-87DA-1DB460D64046,"iPhone13,2"
com.apple.weather,67,1748524237,1748524304,1748524304.350185,-18000,EB445137-D7F5-57EC-87DA-1DB460D64046,"iPhone13,2"
com.renpho.health,3,1748524218,1748524221,1748524221.861257,-18000,EB445137-D7F5-57EC-87DA-1DB460D64046,"iPhone13,2"
com.renpho.health,102,1748524109,1748524211,1748524211.396826,-18000,EB445137-D7F5-57EC-87DA-1DB460D64046,"iPhone13,2"
com.apple.journal,1005,1748490495,1748491500,1748491500.469403,-18000,EB445137-D7F5-57EC-87DA-1DB460D64046,"iPhone13,2"
com.google.Chrome,717,1748486212,1748486929,1748486930.329136,-18000,,
com.apple.finder,12,1748486200,1748486212,1748486212.585892,-18000,,
com.apple.finder,5,1748475008,1748475013,1748475013.301465,-18000,,
com.apple.MobileSMS,4,1748474993,1748474997,1748474997.508027,-18000,,
com.apple.finder,3,1748474990,1748474993,1748474993.349526,-18000,,
com.leomehlig.today,2,1748474988,1748474990,1748474990.1594071,-18000,,
com.apple.iCal,4,1748474984,1748474988,1748474988.578619,-18000,,
com.leomehlig.today,8,1748474976,1748474984,1748474984.5431252,-18000,,
com.apple.finder,1,1748474975,1748474976,1748474976.440336,-18000,,
com.apple.Notes,1,1748474974,1748474975,1748474975.291861,-18000,,
com.google.Chrome,57,1748474917,1748474974,1748474974.443135,-18000,,
com.google.Chrome,1711,1748471439,1748473150,1748473150.470187,-18000,,
com.google.Chrome,2196,1748468834,1748471030,1748471030.197524,-18000,,
com.apple.Preview,758,1748468076,1748468834,1748468834.695997,-18000,,
com.apple.finder,20,1748468056,1748468076,1748468076.3534079,-18000,,
com.google.Chrome,896,1748467160,1748468056,1748468056.819457,-18000,,
com.apple.finder,141,1748467019,1748467160,1748467160.572983,-18000,,
com.google.Chrome,105,1748466914,1748467019,1748467020.031657,-18000,,
com.leomehlig.today,6,1748466908,1748466914,1748466914.9090629,-18000,,
com.google.Chrome,96,1748466812,1748466908,1748466908.169423,-18000,,
com.apple.Notes,14,1748466798,1748466812,1748466812.547453,-18000,,
com.google.Chrome,426,1748466372,1748466798,1748466798.349279,-18000,,
com.apple.Notes,59,1748466313,1748466372,1748466372.373074,-18000,,
com.google.Chrome,22,1748466291,1748466313,1748466313.604094,-18000,,
com.apple.Notes,12,1748466279,1748466291,1748466291.5155702,-18000,,
com.google.Chrome,6,1748466273,1748466279,1748466279.129245,-18000,,
com.apple.Notes,13,1748466260,1748466273,1748466273.365421,-18000,,
com.google.Chrome,61,1748466199,1748466260,1748466260.370708,-18000,,
com.apple.Notes,170,1748466029,1748466199,1748466199.763887,-18000,,
com.google.Chrome,112,1748465917,1748466029,1748466029.319106,-18000,,
com.leomehlig.today,25,1748465892,1748465917,1748465917.142241,-18000,,
com.apple.iCal,6,1748465886,1748465892,1748465892.1788259,-18000,,
com.leomehlig.today,56,1748465830,1748465886,1748465886.3952441,-18000,,
com.google.Chrome,9,1748465821,1748465830,1748465830.79467,-18000,,
com.google.Chrome,23,1748378510,1748378533,1748378533.029469,-18000,,
com.leomehlig.today,2,1748378508,1748378510,1748378510.90273,-18000,,
com.google.Chrome,1772,1748376736,1748378508,1748378508.910407,-18000,,
com.apple.finder,27,1748376709,1748376736,1748376736.898159,-18000,,
com.google.Chrome,962,1748375747,1748376709,1748376709.869909,-18000,,
com.apple.iCal,15,1748375732,1748375747,1748375747.6923718,-18000,,
com.google.Chrome,103,1748375629,1748375732,1748375732.99351,-18000,,
com.apple.finder,3,1748375089,1748375092,1748375093.024401,-18000,,
com.leomehlig.today,134,1748374955,1748375089,1748375089.323839,-18000,,
com.apple.finder,2,1748374953,1748374955,1748374955.575248,-18000,,
com.apple.finder,8,1748312529,1748312537,1748312537.478784,-18000,,
com.leomehlig.today,3,1748312526,1748312529,1748312529.470711,-18000,,
com.apple.finder,2,1748312524,1748312526,1748312526.1890202,-18000,,
com.apple.iCal,2,1748312522,1748312524,1748312524.1609678,-18000,,
com.google.Chrome,783,1748311739,1748312522,1748312522.169033,-18000,,
com.google.Chrome,443,1748310835,1748311278,1748311278.150933,-18000,,
com.google.Chrome,312,1748309729,1748310041,1748310041.5081248,-18000,,
com.google.Chrome,301,1748309185,1748309486,1748309486.1109061,-18000,,
com.google.Chrome,649,1748308378,1748309027,1748309027.651267,-18000,,
com.google.Chrome,325,1748307135,1748307460,1748307460.464085,-18000,,
com.google.Chrome,781,1748306119,1748306900,1748306900.087075,-18000,,
com.google.Chrome,378,1748305311,1748305689,1748305689.763294,-18000,,
com.google.Chrome,302,1748304830,1748305132,1748305132.519724,-18000,,
com.google.Chrome,321,1748303362,1748303683,1748303683.298629,-18000,,
com.google.Chrome,333,1748302874,1748303207,1748303207.292674,-18000,,
com.google.Chrome,901,1748301843,1748302744,1748302744.1040092,-18000,,
com.google.Chrome,825,1748300988,1748301813,1748301813.8659492,-18000,,
com.google.Chrome,569,1748299946,1748300515,1748300515.976136,-18000,,
com.apple.iCal,95,1748299851,1748299946,1748299946.748911,-18000,,
com.google.Chrome,406,1748299445,1748299851,1748299851.698452,-18000,,
com.apple.finder,1,1748299444,1748299445,1748299445.920835,-18000,,
com.apple.finder,2,1748296597,1748296599,1748296599.6371942,-18000,,
com.apple.Notes,0,1748296597,1748296597,1748296597.777574,-18000,,
com.apple.finder,4,1748296593,1748296597,1748296597.106874,-18000,,
com.leomehlig.today,1,1748296592,1748296593,1748296593.626645,-18000,,
com.google.Chrome,57,1748296535,1748296592,1748296592.9988341,-18000,,
com.leomehlig.today,21,1748296508,1748296529,1748296529.9722161,-18000,,
com.google.Chrome,1940,1748294568,1748296508,1748296509.036337,-18000,,
com.apple.finder,156,1748294412,1748294568,1748294568.90242,-18000,,
com.google.Chrome,643,1748293769,1748294412,1748294412.3823981,-18000,,
com.apple.finder,304,1748293465,1748293769,1748293769.611493,-18000,,
com.google.Chrome,3,1748293462,1748293465,1748293465.7608252,-18000,,
com.apple.finder,31,1748293431,1748293462,1748293462.3986921,-18000,,
com.google.Chrome,11,1748293420,1748293431,1748293431.484851,-18000,,
com.apple.finder,18,1748293402,1748293420,1748293420.2493892,-18000,,
com.google.Chrome,632,1748292770,1748293402,1748293402.5216799,-18000,,
com.google.Chrome,323,1748292030,1748292353,1748292353.548458,-18000,,
com.google.Chrome,107,1748291844,1748291951,1748291951.097808,-18000,,
com.google.Chrome,575,1748289484,1748290059,1748290059.1302938,-18000,,
com.google.Chrome,692,1748288765,1748289457,1748289457.7822208,-18000,,
com.google.Chrome,300,1748288065,1748288365,1748288365.614857,-18000,,
com.google.Chrome,671,1748287008,1748287679,1748287679.5369139,-18000,,
com.google.Chrome,621,1748286081,1748286702,1748286702.9449592,-18000,,
com.google.Chrome,329,1748285276,1748285605,1748285605.169969,-18000,,
com.leomehlig.today,2,1748285274,1748285276,1748285276.777614,-18000,,
com.leomehlig.today,315,1748282860,1748283175,1748283175.36251,-18000,,
com.google.Chrome,3038,1748279822,1748282860,1748282860.210578,-18000,,
com.apple.finder,2,1748279820,1748279822,1748279822.423671,-18000,,
com.leomehlig.today,68,1748279752,1748279820,1748279820.42152,-18000,,
com.google.Chrome,6,1748279746,1748279752,1748279752.622747,-18000,,
com.google.Chrome,277,1748267948,1748268225,1748268225.545113,-18000,,
com.google.Chrome,364,1748264430,1748264794,1748264794.9148111,-18000,,
com.google.Chrome,574,1748225088,1748225662,1748225662.7434711,-18000,,
com.apple.finder,1,1748225087,1748225088,1748225089.145134,-18000,,
com.apple.Music,2,1748225085,1748225087,1748225087.926847,-18000,,
com.google.Chrome,2,1748225083,1748225085,1748225085.028767,-18000,,
com.google.Chrome,1668,1748223063,1748224731,1748224731.6846151,-18000,,
com.apple.Music,251,1748222812,1748223063,1748223063.959063,-18000,,
com.google.Chrome,475,1748222337,1748222812,1748222812.287631,-18000,,
com.google.Chrome,338,1748221631,1748221969,1748221969.6177468,-18000,,
com.google.Chrome,317,1748221263,1748221580,1748221580.64802,-18000,,
com.google.Chrome,324,1748220354,1748220678,1748220678.7134662,-18000,,
com.google.Chrome,1325,1748218242,1748219567,1748219567.124255,-18000,,
com.google.Chrome,1988,1748213581,1748215569,1748215570.132262,-18000,,
com.google.Chrome,116,1748187509,1748187625,1748187625.82832,-18000,,
com.google.Chrome,3209,1748180184,1748183393,1748183393.316187,-18000,,
com.google.Chrome,303,1748178138,1748178441,1748178441.796743,-18000,,
com.google.Chrome,982,1748176976,1748177958,1748177958.117317,-18000,,
com.apple.MobileSMS,1,1748176975,1748176976,1748176976.183028,-18000,,
com.google.Chrome,4,1748176971,1748176975,1748176975.082633,-18000,,
com.google.Chrome,1386,1748132405,1748133791,1748133792.0065188,-18000,,
com.apple.finder,1,1748132404,1748132405,1748132405.78217,-18000,,
com.google.Chrome,870,1748131534,1748132404,1748132404.32625,-18000,,
com.apple.Music,102,1748131432,1748131534,1748131534.4354038,-18000,,
com.google.Chrome,117,1748131315,1748131432,1748131432.112403,-18000,,
com.apple.MobileSMS,2,1748131313,1748131315,1748131315.627341,-18000,,
com.google.Chrome,19,1748131294,1748131313,1748131313.999536,-18000,,
com.apple.MobileSMS,12,1748131282,1748131294,1748131294.968502,-18000,,
com.google.Chrome,20,1748131262,1748131282,1748131282.261189,-18000,,
com.apple.MobileSMS,12,1748131250,1748131262,1748131262.707738,-18000,,
com.hnc.Discord,16,1748131234,1748131250,1748131250.591601,-18000,,
com.apple.MobileSMS,23,1748131211,1748131234,1748131234.471294,-18000,,
com.hnc.Discord,12,1748131199,1748131211,1748131211.617373,-18000,,
com.apple.MobileSMS,51,1748131148,1748131199,1748131199.107949,-18000,,
com.google.Chrome,4,1748131144,1748131148,1748131148.8221312,-18000,,
com.apple.MobileSMS,1,1748131143,1748131144,1748131144.712977,-18000,,
com.google.Chrome,2,1748131141,1748131143,1748131143.910804,-18000,,
com.apple.MobileSMS,6,1748131004,1748131010,1748131010.383484,-18000,EB445137-D7F5-57EC-87DA-1DB460D64046,"iPhone13,2"
com.apple.MobileSMS,75,1748129853,1748129928,1748129928.75227,-18000,EB445137-D7F5-57EC-87DA-1DB460D64046,"iPhone13,2"
com.apple.CoreAuthUI,1,1748129734,1748129735,1748129735.830398,-18000,EB445137-D7F5-57EC-87DA-1DB460D64046,"iPhone13,2"
com.google.chrome.ios,137,1748129716,1748129853,1748129853.754136,-18000,EB445137-D7F5-57EC-87DA-1DB460D64046,"iPhone13,2"
com.google.chrome.ios,41,1748129675,1748129716,1748129716.3295789,-18000,EB445137-D7F5-57EC-87DA-1DB460D64046,"iPhone13,2"
com.google.chrome.ios,31,1748129641,1748129672,1748129672.862043,-18000,EB445137-D7F5-57EC-87DA-1DB460D64046,"iPhone13,2"
com.google.chrome.ios,16,1748129422,1748129438,1748129438.5765219,-18000,EB445137-D7F5-57EC-87DA-1DB460D64046,"iPhone13,2"
com.google.chrome.ios,71,1748129351,1748129422,1748129422.826904,-18000,EB445137-D7F5-57EC-87DA-1DB460D64046,"iPhone13,2"
com.hammerandchisel.discord,7,1748129267,1748129274,1748129274.519154,-18000,EB445137-D7F5-57EC-87DA-1DB460D64046,"iPhone13,2"
com.apple.weather,57,1748121056,1748121113,1748121113.957063,-18000,EB445137-D7F5-57EC-87DA-1DB460D64046,"iPhone13,2"
com.google.chrome.ios,2,1748121054,1748121056,1748121056.6620212,-18000,EB445137-D7F5-57EC-87DA-1DB460D64046,"iPhone13,2"
com.google.chrome.ios,301,1748120642,1748120943,1748120943.241373,-18000,EB445137-D7F5-57EC-87DA-1DB460D64046,"iPhone13,2"
com.strava.stravaride,39,1748117019,1748117058,1748117058.939828,-18000,EB445137-D7F5-57EC-87DA-1DB460D64046,"iPhone13,2"
com.google.Chrome,324,1748109651,1748109975,1748109975.843714,-18000,,
com.apple.finder,1,1748109650,1748109651,1748109651.212271,-18000,,
com.google.chrome.ios,241,1748108684,1748108925,1748108925.498848,-18000,EB445137-D7F5-57EC-87DA-1DB460D64046,"iPhone13,2"
com.apple.Fitness,2,1748108679,1748108681,1748108681.8047051,-18000,EB445137-D7F5-57EC-87DA-1DB460D64046,"iPhone13,2"
com.apple.Fitness,54,1748108540,1748108594,1748108595.036851,-18000,EB445137-D7F5-57EC-87DA-1DB460D64046,"iPhone13,2"
com.apple.Fitness,0,1748108540,1748108540,1748108540.854433,-18000,EB445137-D7F5-57EC-87DA-1DB460D64046,"iPhone13,2"
com.apple.Fitness,100,1748108434,1748108534,1748108534.802452,-18000,EB445137-D7F5-57EC-87DA-1DB460D64046,"iPhone13,2"
com.strava.stravaride,15,1748108416,1748108431,1748108431.313282,-18000,EB445137-D7F5-57EC-87DA-1DB460D64046,"iPhone13,2"
com.apple.weather,4,1748108121,1748108125,1748108125.4857621,-18000,EB445137-D7F5-57EC-87DA-1DB460D64046,"iPhone13,2"
com.apple.Maps,214,1748107905,1748108119,1748108120.029551,-18000,EB445137-D7F5-57EC-87DA-1DB460D64046,"iPhone13,2"
com.apple.Health,115,1748107547,1748107662,1748107662.2118201,-18000,EB445137-D7F5-57EC-87DA-1DB460D64046,"iPhone13,2"
com.apple.Health,111,1748107379,1748107490,1748107491.114749,-18000,EB445137-D7F5-57EC-87DA-1DB460D64046,"iPhone13,2"
com.apple.Health,22,1748107357,1748107379,1748107379.172875,-18000,EB445137-D7F5-57EC-87DA-1DB460D64046,"iPhone13,2"
com.strava.stravaride,78,1748107277,1748107355,1748107355.90682,-18000,EB445137-D7F5-57EC-87DA-1DB460D64046,"iPhone13,2"
com.apple.MobileSMS,4,1748106975,1748106979,1748106979.477044,-18000,EB445137-D7F5-57EC-87DA-1DB460D64046,"iPhone13,2"
com.apple.MobileSMS,13,1748105607,1748105620,1748105620.124342,-18000,EB445137-D7F5-57EC-87DA-1DB460D64046,"iPhone13,2"
com.apple.MobileSMS,30,1748105569,1748105599,1748105599.490133,-18000,EB445137-D7F5-57EC-87DA-1DB460D64046,"iPhone13,2"
com.apple.findmy,2,1748105567,1748105569,1748105570.248991,-18000,EB445137-D7F5-57EC-87DA-1DB460D64046,"iPhone13,2"
com.apple.findmy,97,1748105047,1748105144,1748105145.018999,-18000,EB445137-D7F5-57EC-87DA-1DB460D64046,"iPhone13,2"
com.strava.stravaride,214,1748104628,1748104842,1748104842.377764,-18000,EB445137-D7F5-57EC-87DA-1DB460D64046,"iPhone13,2"
com.apple.MobileSMS,2,1748104615,1748104617,1748104617.3918009,-18000,EB445137-D7F5-57EC-87DA-1DB460D64046,"iPhone13,2"
com.apple.MobileSMS,11,1748100863,1748100874,1748100874.756688,-18000,EB445137-D7F5-57EC-87DA-1DB460D64046,"iPhone13,2"
com.apple.findmy,10,1748100279,1748100289,1748100289.7413769,-18000,EB445137-D7F5-57EC-87DA-1DB460D64046,"iPhone13,2"
com.apple.findmy,7,1748099874,1748099881,1748099882.0342422,-18000,EB445137-D7F5-57EC-87DA-1DB460D64046,"iPhone13,2"
com.google.chrome.ios,2,1748099872,1748099874,1748099874.123722,-18000,EB445137-D7F5-57EC-87DA-1DB460D64046,"iPhone13,2"
com.google.chrome.ios,16,1748099823,1748099839,1748099840.1276789,-18000,EB445137-D7F5-57EC-87DA-1DB460D64046,"iPhone13,2"
com.apple.Maps,4,1748099819,1748099823,1748099823.3727899,-18000,EB445137-D7F5-57EC-87DA-1DB460D64046,"iPhone13,2"
com.apple.Maps,74,1748099666,1748099740,1748099740.397588,-18000,EB445137-D7F5-57EC-87DA-1DB460D64046,"iPhone13,2"
com.apple.findmy,5,1748099660,1748099665,1748099665.9683409,-18000,EB445137-D7F5-57EC-87DA-1DB460D64046,"iPhone13,2"
com.apple.findmy,2,1748099658,1748099660,1748099660.497127,-18000,EB445137-D7F5-57EC-87DA-1DB460D64046,"iPhone13,2"
com.apple.findmy,7,1748099076,1748099083,1748099083.578648,-18000,EB445137-D7F5-57EC-87DA-1DB460D64046,"iPhone13,2"
tv.trakt.trakt,191,1748097736,1748097927,1748097927.6841478,-18000,EB445137-D7F5-57EC-87DA-1DB460D64046,"iPhone13,2"
com.renpho.health,2,1748095124,1748095126,1748095126.316885,-18000,EB445137-D7F5-57EC-87DA-1DB460D64046,"iPhone13,2"
com.renpho.health,19,1748094824,1748094843,1748094843.718089,-18000,EB445137-D7F5-57EC-87DA-1DB460D64046,"iPhone13,2"
com.doordash.dasher,65,1748058878,1748058943,1748058943.339971,-18000,EB445137-D7F5-57EC-87DA-1DB460D64046,"iPhone13,2"
com.apple.Health,28,1748057388,1748057416,1748057416.555492,-18000,EB445137-D7F5-57EC-87DA-1DB460D64046,"iPhone13,2"
com.thestorygraph.thestorygraph,18,1748057369,1748057387,1748057387.1404982,-18000,EB445137-D7F5-57EC-87DA-1DB460D64046,"iPhone13,2"
com.thestorygraph.thestorygraph,26,1748056193,1748056219,1748056219.289534,-18000,EB445137-D7F5-57EC-87DA-1DB460D64046,"iPhone13,2"
com.thestorygraph.thestorygraph,23,1748056168,1748056191,1748056191.45816,-18000,EB445137-D7F5-57EC-87DA-1DB460D64046,"iPhone13,2"
com.facebook.Facebook,161,1748055955,1748056116,1748056116.506289,-18000,EB445137-D7F5-57EC-87DA-1DB460D64046,"iPhone13,2"
com.hammerandchisel.discord,15,1748055914,1748055929,1748055929.925712,-18000,EB445137-D7F5-57EC-87DA-1DB460D64046,"iPhone13,2"
com.apple.finder,2,1748055165,1748055167,1748055167.185389,-18000,,
com.leomehlig.today,3,1748055162,1748055165,1748055165.893489,-18000,,
com.google.Chrome,677,1748054485,1748055162,1748055162.6046739,-18000,,
com.google.Chrome,300,1748053860,1748054160,1748054160.8674011,-18000,,
com.google.Chrome,420,1748052968,1748053388,1748053388.8288631,-18000,,
com.google.Chrome,302,1748051988,1748052290,1748052290.567875,-18000,,
com.google.Chrome,1620,1748050072,1748051692,1748051693.019676,-18000,,
com.leomehlig.today,224,1748049848,1748050072,1748050072.324139,-18000,,
com.apple.iCal,7,1748049841,1748049848,1748049848.493565,-18000,,
com.leomehlig.today,21,1748049820,1748049841,1748049841.311192,-18000,,
com.apple.iCal,25,1748049795,1748049820,1748049820.092876,-18000,,
com.leomehlig.today,46,1748049749,1748049795,1748049795.66356,-18000,,
com.google.Chrome,2493,1748047256,1748049749,1748049749.317708,-18000,,
com.apple.mobilecal,26,1748045883,1748045909,1748045909.278497,-18000,EB445137-D7F5-57EC-87DA-1DB460D64046,"iPhone13,2"
com.apple.findmy,3,1748045878,1748045881,1748045881.243469,-18000,EB445137-D7F5-57EC-87DA-1DB460D64046,"iPhone13,2"
com.apple.findmy,20,1748045546,1748045566,1748045566.863909,-18000,EB445137-D7F5-57EC-87DA-1DB460D64046,"iPhone13,2"
com.doordash.dasher,20,1748044803,1748044823,1748044824.016022,-18000,EB445137-D7F5-57EC-87DA-1DB460D64046,"iPhone13,2"
com.apple.findmy,11,1748044791,1748044802,1748044802.1905742,-18000,EB445137-D7F5-57EC-87DA-1DB460D64046,"iPhone13,2"
com.apple.findmy,13,1748043919,1748043932,1748043933.0587559,-18000,EB445137-D7F5-57EC-87DA-1DB460D64046,"iPhone13,2"
com.apple.findmy,6,1748043406,1748043412,1748043412.3141031,-18000,EB445137-D7F5-57EC-87DA-1DB460D64046,"iPhone13,2"
com.doordash.dasher,2,1748043404,1748043406,1748043406.6060991,-18000,EB445137-D7F5-57EC-87DA-1DB460D64046,"iPhone13,2"
com.doordash.dasher,7,1748043345,1748043352,1748043352.569067,-18000,EB445137-D7F5-57EC-87DA-1DB460D64046,"iPhone13,2"
com.apple.findmy,11,1748043334,1748043345,1748043345.753017,-18000,EB445137-D7F5-57EC-87DA-1DB460D64046,"iPhone13,2"
com.doordash.dasher,6,1748043328,1748043334,1748043334.324689,-18000,EB445137-D7F5-57EC-87DA-1DB460D64046,"iPhone13,2"
com.doordash.dasher,33,1748042841,1748042874,1748042874.743513,-18000,EB445137-D7F5-57EC-87DA-1DB460D64046,"iPhone13,2"
com.google.Chrome,65,1748032182,1748032247,1748032247.830051,-18000,,
com.leomehlig.today,6,1748032176,1748032182,1748032182.275446,-18000,,
com.google.Chrome,1416,1748030760,1748032176,1748032176.909771,-18000,,
com.apple.finder,52,1748030708,1748030760,1748030760.713268,-18000,,
com.google.Chrome,316,1748030392,1748030708,1748030708.831911,-18000,,
com.apple.Preview,10,1748030382,1748030392,1748030392.575516,-18000,,
com.google.Chrome,23,1748030359,1748030382,1748030382.73788,-18000,,
com.apple.Preview,267,1748030092,1748030359,1748030360.017133,-18000,,
com.apple.finder,2,1748030090,1748030092,1748030092.811358,-18000,,
com.google.Chrome,15,1748030075,1748030090,1748030090.9537249,-18000,,
com.apple.finder,18,1748030057,1748030075,1748030075.495748,-18000,,
com.google.Chrome,1138,1748028919,1748030057,1748030057.829637,-18000,,
com.apple.news,111,1748028808,1748028919,1748028919.133776,-18000,,
com.google.Chrome,50,1748028758,1748028808,1748028808.417649,-18000,,
com.apple.news,26,1748028732,1748028758,1748028758.655277,-18000,,
com.google.Chrome,85,1748028647,1748028732,1748028732.113432,-18000,,
com.apple.Notes,2,1748028645,1748028647,1748028647.423209,-18000,,
com.google.Chrome,443,1748028202,1748028645,1748028645.356,-18000,,
com.apple.Notes,0,1748028202,1748028202,1748028202.9578161,-18000,,
com.apple.systempreferences,3,1748028199,1748028202,1748028202.418977,-18000,,
com.apple.Notes,1,1748028198,1748028199,1748028199.359477,-18000,,
com.apple.systempreferences,1,1748028191,1748028192,1748028193.204451,-18000,,
com.google.Chrome,2515,1748025676,1748028191,1748028191.657092,-18000,,
com.leomehlig.today,99,1748025577,1748025676,1748025676.2110891,-18000,,
com.google.Chrome,5,1748025572,1748025577,1748025577.486699,-18000,,
com.google.Maps,51,1747954537,1747954588,1747954588.684741,-18000,EB445137-D7F5-57EC-87DA-1DB460D64046,"iPhone13,2"
com.facebook.Facebook,47,1747954316,1747954363,1747954364.142816,-18000,EB445137-D7F5-57EC-87DA-1DB460D64046,"iPhone13,2"
com.apple.weather,5,1747952645,1747952650,1747952650.1436272,-18000,EB445137-D7F5-57EC-87DA-1DB460D64046,"iPhone13,2"
com.doordash.dasher,41,1747950585,1747950626,1747950626.706828,-18000,EB445137-D7F5-57EC-87DA-1DB460D64046,"iPhone13,2"
com.apple.findmy,6,1747950579,1747950585,1747950585.909699,-18000,EB445137-D7F5-57EC-87DA-1DB460D64046,"iPhone13,2"
com.strava.stravaride,20,1747950450,1747950470,1747950470.611858,-18000,EB445137-D7F5-57EC-87DA-1DB460D64046,"iPhone13,2"
com.doordash.dasher,1062,1747948686,1747949748,1747949748.592577,-18000,EB445137-D7F5-57EC-87DA-1DB460D64046,"iPhone13,2"
com.apple.Passbook,40,1747948638,1747948678,1747948678.1075702,-18000,EB445137-D7F5-57EC-87DA-1DB460D64046,"iPhone13,2"
com.apple.MobileSMS,4,1747948626,1747948630,1747948630.4379768,-18000,EB445137-D7F5-57EC-87DA-1DB460D64046,"iPhone13,2"
com.doordash.dasher,1,1747948625,1747948626,1747948626.174662,-18000,EB445137-D7F5-57EC-87DA-1DB460D64046,"iPhone13,2"
com.doordash.dasher,432,1747948192,1747948624,1747948624.985529,-18000,EB445137-D7F5-57EC-87DA-1DB460D64046,"iPhone13,2"
com.apple.CoreAuthUI,2,1747948051,1747948053,1747948053.8251262,-18000,EB445137-D7F5-57EC-87DA-1DB460D64046,"iPhone13,2"
com.truebill.truebillnative,140,1747948046,1747948186,1747948187.05189,-18000,EB445137-D7F5-57EC-87DA-1DB460D64046,"iPhone13,2"
com.microsoft.Office.Outlook,26,1747947983,1747948009,1747948009.465024,-18000,EB445137-D7F5-57EC-87DA-1DB460D64046,"iPhone13,2"
com.doordash.dasher,37,1747947942,1747947979,1747947979.8962479,-18000,EB445137-D7F5-57EC-87DA-1DB460D64046,"iPhone13,2"
com.apple.findmy,46,1747947896,1747947942,1747947942.651988,-18000,EB445137-D7F5-57EC-87DA-1DB460D64046,"iPhone13,2"
com.doordash.dasher,3,1747947893,1747947896,1747947896.680561,-18000,EB445137-D7F5-57EC-87DA-1DB460D64046,"iPhone13,2"
com.doordash.dasher,580,1747947267,1747947847,1747947847.776211,-18000,EB445137-D7F5-57EC-87DA-1DB460D64046,"iPhone13,2"
com.apple.MobileSMS,7,1747947260,1747947267,1747947267.227419,-18000,EB445137-D7F5-57EC-87DA-1DB460D64046,"iPhone13,2"
com.doordash.dasher,111,1747947149,1747947260,1747947261.200166,-18000,EB445137-D7F5-57EC-87DA-1DB460D64046,"iPhone13,2"
com.apple.MobileSMS,10,1747947139,1747947149,1747947149.563859,-18000,EB445137-D7F5-57EC-87DA-1DB460D64046,"iPhone13,2"
com.doordash.dasher,77,1747947062,1747947139,1747947139.2110171,-18000,EB445137-D7F5-57EC-87DA-1DB460D64046,"iPhone13,2"
com.apple.MobileSMS,46,1747946967,1747947013,1747947013.524364,-18000,EB445137-D7F5-57EC-87DA-1DB460D64046,"iPhone13,2"
com.doordash.dasher,2,1747946965,1747946967,1747946967.9027739,-18000,EB445137-D7F5-57EC-87DA-1DB460D64046,"iPhone13,2"
com.doordash.dasher,17,1747946896,1747946913,1747946914.0436912,-18000,EB445137-D7F5-57EC-87DA-1DB460D64046,"iPhone13,2"
com.doordash.dasher,9,1747946767,1747946776,1747946777.217188,-18000,EB445137-D7F5-57EC-87DA-1DB460D64046,"iPhone13,2"
com.doordash.dasher,276,1747946363,1747946639,1747946639.838233,-18000,EB445137-D7F5-57EC-87DA-1DB460D64046,"iPhone13,2"
com.apple.MobileSMS,39,1747946324,1747946363,1747946363.647538,-18000,EB445137-D7F5-57EC-87DA-1DB460D64046,"iPhone13,2"
com.doordash.dasher,1,1747946323,1747946324,1747946324.158977,-18000,EB445137-D7F5-57EC-87DA-1DB460D64046,"iPhone13,2"
com.doordash.dasher,758,1747945565,1747946323,1747946323.717298,-18000,EB445137-D7F5-57EC-87DA-1DB460D64046,"iPhone13,2"
com.apple.InCallService,2,1747945563,1747945565,1747945566.290176,-18000,EB445137-D7F5-57EC-87DA-1DB460D64046,"iPhone13,2"
com.doordash.dasher,35,1747945528,1747945563,1747945563.648367,-18000,EB445137-D7F5-57EC-87DA-1DB460D64046,"iPhone13,2"
com.doordash.dasher,26,1747945444,1747945470,1747945471.260227,-18000,EB445137-D7F5-57EC-87DA-1DB460D64046,"iPhone13,2"
com.apple.Preferences,47,1747945397,1747945444,1747945444.350462,-18000,EB445137-D7F5-57EC-87DA-1DB460D64046,"iPhone13,2"
com.apple.news,129,1747945267,1747945396,1747945396.83844,-18000,EB445137-D7F5-57EC-87DA-1DB460D64046,"iPhone13,2"
com.doordash.dasher,14,1747945253,1747945267,1747945267.6177258,-18000,EB445137-D7F5-57EC-87DA-1DB460D64046,"iPhone13,2"
com.apple.news,285,1747944968,1747945253,1747945253.317877,-18000,EB445137-D7F5-57EC-87DA-1DB460D64046,"iPhone13,2"
com.apple.MobileSMS,9,1747944952,1747944961,1747944961.295264,-18000,EB445137-D7F5-57EC-87DA-1DB460D64046,"iPhone13,2"
com.doordash.dasher,650,1747944301,1747944951,1747944951.447319,-18000,EB445137-D7F5-57EC-87DA-1DB460D64046,"iPhone13,2"
com.apple.Music,8,1747944293,1747944301,1747944302.030703,-18000,EB445137-D7F5-57EC-87DA-1DB460D64046,"iPhone13,2"
com.doordash.dasher,170,1747944123,1747944293,1747944294.773364,-18000,EB445137-D7F5-57EC-87DA-1DB460D64046,"iPhone13,2"
com.doordash.dasher,40,1747944029,1747944069,1747944070.0966501,-18000,EB445137-D7F5-57EC-87DA-1DB460D64046,"iPhone13,2"
com.google.Chrome,2,1747943905,1747943907,1747943907.864824,-18000,,
com.leomehlig.today,8,1747943897,1747943905,1747943905.589723,-18000,,
com.google.Chrome,56,1747943841,1747943897,1747943897.233659,-18000,,
com.apple.MobileSMS,11,1747943815,1747943826,1747943826.5848188,-18000,,
com.google.Chrome,983,1747942832,1747943815,1747943815.557507,-18000,,
com.apple.Preview,29,1747942803,1747942832,1747942832.25475,-18000,,
com.apple.finder,2,1747942801,1747942803,1747942803.738482,-18000,,
com.apple.Preview,22,1747942779,1747942801,1747942801.5643358,-18000,,
com.apple.finder,6,1747942773,1747942779,1747942779.3959389,-18000,,
com.apple.Preview,689,1747942084,1747942773,1747942773.63654,-18000,,
com.apple.Notes,6,1747942078,1747942084,1747942084.1188788,-18000,,
com.apple.Preview,5,1747942073,1747942078,1747942078.929687,-18000,,
com.apple.Notes,5,1747942068,1747942073,1747942074.010913,-18000,,
com.facebook.Facebook,87,1747941921,1747942008,1747942008.865913,-18000,EB445137-D7F5-57EC-87DA-1DB460D64046,"iPhone13,2"
com.apple.Preview,693,1747941375,1747942068,1747942068.852514,-18000,,
com.apple.finder,48,1747941327,1747941375,1747941375.617588,-18000,,
com.google.Chrome,499,1747940828,1747941327,1747941327.794162,-18000,,
com.apple.MobileSMS,70,1747940758,1747940828,1747940828.174635,-18000,,
com.google.Chrome,722,1747940036,1747940758,1747940758.0841,-18000,,
com.apple.finder,5,1747940031,1747940036,1747940036.051575,-18000,,
com.google.Chrome,8,1747940023,1747940031,1747940031.373044,-18000,,
com.apple.finder,21,1747940002,1747940023,1747940023.431728,-18000,,
com.google.Chrome,365,1747939637,1747940002,1747940002.517031,-18000,,
com.apple.Notes,7,1747939630,1747939637,1747939637.402137,-18000,,
com.google.Chrome,110,1747939520,1747939630,1747939630.8248448,-18000,,
com.apple.Notes,8,1747939512,1747939520,1747939520.359082,-18000,,
com.google.Chrome,221,1747939291,1747939512,1747939512.394175,-18000,,
com.apple.finder,2,1747939289,1747939291,1747939291.188911,-18000,,
com.leomehlig.today,73,1747939216,1747939289,1747939289.82014,-18000,,
com.apple.iCal,12,1747939204,1747939216,1747939216.671392,-18000,,
com.google.Chrome,6,1747939198,1747939204,1747939204.409199,-18000,,
com.doordash.dasher,15,1747938971,1747938986,1747938986.23138,-18000,EB445137-D7F5-57EC-87DA-1DB460D64046,"iPhone13,2"
com.doordash.dasher,13,1747938736,1747938749,1747938749.3960361,-18000,EB445137-D7F5-57EC-87DA-1DB460D64046,"iPhone13,2"
com.doordash.dasher,39,1747933420,1747933459,1747933459.6239672,-18000,EB445137-D7F5-57EC-87DA-1DB460D64046,"iPhone13,2"
com.apple.MobileSMS,2,1747933418,1747933420,1747933420.708493,-18000,EB445137-D7F5-57EC-87DA-1DB460D64046,"iPhone13,2"
com.apple.MobileSMS,2,1747933254,1747933256,1747933256.573272,-18000,EB445137-D7F5-57EC-87DA-1DB460D64046,"iPhone13,2"
com.apple.MobileSMS,12,1747933071,1747933083,1747933083.3570762,-18000,EB445137-D7F5-57EC-87DA-1DB460D64046,"iPhone13,2"
com.apple.MobileSMS,4,1747933067,1747933071,1747933071.885795,-18000,EB445137-D7F5-57EC-87DA-1DB460D64046,"iPhone13,2"
com.apple.MobileSMS,31,1747933033,1747933064,1747933064.6829472,-18000,EB445137-D7F5-57EC-87DA-1DB460D64046,"iPhone13,2"
com.apple.findmy,12,1747933016,1747933028,1747933028.7573562,-18000,EB445137-D7F5-57EC-87DA-1DB460D64046,"iPhone13,2"
com.apple.Maps,2,1747933014,1747933016,1747933016.70051,-18000,EB445137-D7F5-57EC-87DA-1DB460D64046,"iPhone13,2"
com.apple.Maps,11,1747932892,1747932903,1747932903.901655,-18000,EB445137-D7F5-57EC-87DA-1DB460D64046,"iPhone13,2"
com.apple.weather,3,1747932888,1747932891,1747932892.0411181,-18000,EB445137-D7F5-57EC-87DA-1DB460D64046,"iPhone13,2"
com.apple.weather,4,1747932480,1747932484,1747932484.8075309,-18000,EB445137-D7F5-57EC-87DA-1DB460D64046,"iPhone13,2"
com.apple.Preferences,13,1747931892,1747931905,1747931905.517695,-18000,EB445137-D7F5-57EC-87DA-1DB460D64046,"iPhone13,2"
com.apple.Preferences,81,1747930960,1747931041,1747931041.642524,-18000,EB445137-D7F5-57EC-87DA-1DB460D64046,"iPhone13,2"
com.apple.Preferences,82,1747930855,1747930937,1747930937.805674,-18000,EB445137-D7F5-57EC-87DA-1DB460D64046,"iPhone13,2"
com.strava.stravaride,1,1747930854,1747930855,1747930855.937084,-18000,EB445137-D7F5-57EC-87DA-1DB460D64046,"iPhone13,2"
com.strava.stravaride,53,1747930342,1747930395,1747930396.1629372,-18000,EB445137-D7F5-57EC-87DA-1DB460D64046,"iPhone13,2"
com.microsoft.Office.Outlook,5,1747930337,1747930342,1747930342.753166,-18000,EB445137-D7F5-57EC-87DA-1DB460D64046,"iPhone13,2"
com.google.chrome.ios,65,1747930272,1747930337,1747930338.0161638,-18000,EB445137-D7F5-57EC-87DA-1DB460D64046,"iPhone13,2"
com.microsoft.Office.Outlook,10,1747930262,1747930272,1747930272.905992,-18000,EB445137-D7F5-57EC-87DA-1DB460D64046,"iPhone13,2"
com.microsoft.Office.Outlook,2,1747930254,1747930256,1747930257.501368,-18000,EB445137-D7F5-57EC-87DA-1DB460D64046,"iPhone13,2"
com.apple.Preferences,3,1747930234,1747930237,1747930237.632114,-18000,EB445137-D7F5-57EC-87DA-1DB460D64046,"iPhone13,2"
com.apple.Preferences,23,1747926775,1747926798,1747926799.4251652,-18000,EB445137-D7F5-57EC-87DA-1DB460D64046,"iPhone13,2"
com.apple.Music,100,1747926674,1747926774,1747926774.2991738,-18000,EB445137-D7F5-57EC-87DA-1DB460D64046,"iPhone13,2"
com.apple.Music,143,1747926512,1747926655,1747926656.268687,-18000,EB445137-D7F5-57EC-87DA-1DB460D64046,"iPhone13,2"
com.apple.Music,169,1747925930,1747926099,1747926100.376936,-18000,EB445137-D7F5-57EC-87DA-1DB460D64046,"iPhone13,2"
com.apple.Music,88,1747925776,1747925864,1747925865.7463598,-18000,EB445137-D7F5-57EC-87DA-1DB460D64046,"iPhone13,2"
com.apple.Preferences,30,1747925746,1747925776,1747925777.1020699,-18000,EB445137-D7F5-57EC-87DA-1DB460D64046,"iPhone13,2"
com.apple.Music,27,1747925719,1747925746,1747925746.634412,-18000,EB445137-D7F5-57EC-87DA-1DB460D64046,"iPhone13,2"
com.apple.Preferences,213,1747925480,1747925693,1747925693.6697211,-18000,EB445137-D7F5-57EC-87DA-1DB460D64046,"iPhone13,2"
com.apple.CoreAuthUI,2,1747925477,1747925479,1747925479.674014,-18000,EB445137-D7F5-57EC-87DA-1DB460D64046,"iPhone13,2"
com.apple.Preferences,176,1747925302,1747925478,1747925478.231622,-18000,EB445137-D7F5-57EC-87DA-1DB460D64046,"iPhone13,2"
com.intsig.CamScannerLite,38,1747925264,1747925302,1747925302.85002,-18000,EB445137-D7F5-57EC-87DA-1DB460D64046,"iPhone13,2"
com.apple.Preferences,27,1747925232,1747925259,1747925259.6101289,-18000,EB445137-D7F5-57EC-87DA-1DB460D64046,"iPhone13,2"
com.doordash.dasher,31,1747925193,1747925224,1747925224.297062,-18000,EB445137-D7F5-57EC-87DA-1DB460D64046,"iPhone13,2"
com.apple.weather,11,1747925143,1747925154,1747925154.92255,-18000,EB445137-D7F5-57EC-87DA-1DB460D64046,"iPhone13,2"
com.strava.stravaride,31,1747925112,1747925143,1747925143.5695338,-18000,EB445137-D7F5-57EC-87DA-1DB460D64046,"iPhone13,2"
com.doordash.dasher,98,1747922435,1747922533,1747922533.35341,-18000,EB445137-D7F5-57EC-87DA-1DB460D64046,"iPhone13,2"
com.apple.Health,23,1747922400,1747922423,1747922424.075922,-18000,EB445137-D7F5-57EC-87DA-1DB460D64046,"iPhone13,2"
com.apple.Health,70,1747921733,1747921803,1747921803.5141249,-18000,EB445137-D7F5-57EC-87DA-1DB460D64046,"iPhone13,2"
com.apple.Health,82,1747921646,1747921728,1747921729.3010879,-18000,EB445137-D7F5-57EC-87DA-1DB460D64046,"iPhone13,2"
com.doordash.dasher,0,1747921646,1747921646,1747921647.297546,-18000,EB445137-D7F5-57EC-87DA-1DB460D64046,"iPhone13,2"
com.doordash.dasher,19,1747921368,1747921387,1747921387.552311,-18000,EB445137-D7F5-57EC-87DA-1DB460D64046,"iPhone13,2"
com.apple.findmy,3,1747921360,1747921363,1747921363.313833,-18000,EB445137-D7F5-57EC-87DA-1DB460D64046,"iPhone13,2"
com.apple.findmy,4,1747921293,1747921297,1747921297.92619,-18000,EB445137-D7F5-57EC-87DA-1DB460D64046,"iPhone13,2"
com.google.chrome.ios,2,1747921291,1747921293,1747921293.644208,-18000,EB445137-D7F5-57EC-87DA-1DB460D64046,"iPhone13,2"
com.google.chrome.ios,11,1747921232,1747921243,1747921244.119499,-18000,EB445137-D7F5-57EC-87DA-1DB460D64046,"iPhone13,2"
com.letterboxd.LetterboxdApp,26,1747921206,1747921232,1747921232.3796859,-18000,EB445137-D7F5-57EC-87DA-1DB460D64046,"iPhone13,2"
com.renpho.health,91,1747921113,1747921204,1747921204.95076,-18000,EB445137-D7F5-57EC-87DA-1DB460D64046,"iPhone13,2"
com.apple.findmy,9,1747918519,1747918528,1747918528.543786,-18000,EB445137-D7F5-57EC-87DA-1DB460D64046,"iPhone13,2"
com.apple.news,39,1747884691,1747884730,1747884730.506414,-18000,EB445137-D7F5-57EC-87DA-1DB460D64046,"iPhone13,2"
com.apple.news,57,1747884586,1747884643,1747884644.048073,-18000,EB445137-D7F5-57EC-87DA-1DB460D64046,"iPhone13,2"
com.letterboxd.LetterboxdApp,93,1747884237,1747884330,1747884330.4913101,-18000,EB445137-D7F5-57EC-87DA-1DB460D64046,"iPhone13,2"
com.apple.MobileSMS,6,1747884203,1747884209,1747884209.967527,-18000,EB445137-D7F5-57EC-87DA-1DB460D64046,"iPhone13,2"
com.apple.CoreAuthUI,2,1747884201,1747884203,1747884203.973917,-18000,EB445137-D7F5-57EC-87DA-1DB460D64046,"iPhone13,2"
com.truebill.truebillnative,4,1747884199,1747884203,1747884203.825588,-18000,EB445137-D7F5-57EC-87DA-1DB460D64046,"iPhone13,2"
com.google.Chrome,101,1747883192,1747883293,1747883293.544055,-18000,,
com.apple.iCal,2,1747883190,1747883192,1747883192.978976,-18000,,
com.google.Chrome,5,1747883185,1747883190,1747883190.111871,-18000,,
com.apple.iCal,7,1747883178,1747883185,1747883185.86273,-18000,,
com.google.Chrome,76,1747883102,1747883178,1747883178.52913,-18000,,
com.google.Chrome,172,1747882916,1747883088,1747883088.2474651,-18000,,
com.apple.iCal,4,1747882912,1747882916,1747882916.8353748,-18000,,
com.google.Chrome,6,1747882906,1747882912,1747882912.080192,-18000,,
com.apple.iCal,4,1747882902,1747882906,1747882906.2697458,-18000,,
com.apple.CoreAuthUI,2,1747882789,1747882791,1747882791.725443,-18000,EB445137-D7F5-57EC-87DA-1DB460D64046,"iPhone13,2"
com.truebill.truebillnative,68,1747882781,1747882849,1747882849.5935302,-18000,EB445137-D7F5-57EC-87DA-1DB460D64046,"iPhone13,2"
com.apple.weather,3,1747882778,1747882781,1747882782.652123,-18000,EB445137-D7F5-57EC-87DA-1DB460D64046,"iPhone13,2"
com.google.Chrome,204,1747882698,1747882902,1747882902.197969,-18000,,
com.leomehlig.today,2,1747882696,1747882698,1747882698.819831,-18000,,
com.google.Chrome,70,1747882626,1747882696,1747882696.333817,-18000,,
com.apple.weather,17,1747881603,1747881620,1747881621.267513,-18000,EB445137-D7F5-57EC-87DA-1DB460D64046,"iPhone13,2"
com.letterboxd.LetterboxdApp,7,1747881596,1747881603,1747881603.7627978,-18000,EB445137-D7F5-57EC-87DA-1DB460D64046,"iPhone13,2"
com.letterboxd.LetterboxdApp,20,1747881371,1747881391,1747881392.017735,-18000,EB445137-D7F5-57EC-87DA-1DB460D64046,"iPhone13,2"
com.letterboxd.LetterboxdApp,219,1747880227,1747880446,1747880446.883463,-18000,EB445137-D7F5-57EC-87DA-1DB460D64046,"iPhone13,2"
com.hammerandchisel.discord,2,1747880225,1747880227,1747880227.673687,-18000,EB445137-D7F5-57EC-87DA-1DB460D64046,"iPhone13,2"
com.hammerandchisel.discord,8,1747879873,1747879881,1747879881.291613,-18000,EB445137-D7F5-57EC-87DA-1DB460D64046,"iPhone13,2"
com.google.Chrome,222,1747879643,1747879865,1747879865.343803,-18000,,
com.google.Chrome,301,1747879252,1747879553,1747879553.157495,-18000,,
com.google.Chrome,391,1747878587,1747878978,1747878978.91894,-18000,,
com.hammerandchisel.discord,6,1747878420,1747878426,1747878426.510989,-18000,EB445137-D7F5-57EC-87DA-1DB460D64046,"iPhone13,2"
com.google.Gmail,2,1747878418,1747878420,1747878420.786109,-18000,EB445137-D7F5-57EC-87DA-1DB460D64046,"iPhone13,2"
com.google.Chrome,853,1747877703,1747878556,1747878556.216125,-18000,,
com.google.Gmail,87,1747877209,1747877296,1747877297.229473,-18000,EB445137-D7F5-57EC-87DA-1DB460D64046,"iPhone13,2"
com.hammerandchisel.discord,2,1747877198,1747877200,1747877200.736407,-18000,EB445137-D7F5-57EC-87DA-1DB460D64046,"iPhone13,2"
com.hammerandchisel.discord,0,1747877198,1747877198,1747877199.024692,-18000,EB445137-D7F5-57EC-87DA-1DB460D64046,"iPhone13,2"
com.hammerandchisel.discord,31,1747876998,1747877029,1747877029.885264,-18000,EB445137-D7F5-57EC-87DA-1DB460D64046,"iPhone13,2"
com.hammerandchisel.discord,18,1747876977,1747876995,1747876995.862403,-18000,EB445137-D7F5-57EC-87DA-1DB460D64046,"iPhone13,2"
com.letterboxd.LetterboxdApp,1,1747876976,1747876977,1747876977.378053,-18000,EB445137-D7F5-57EC-87DA-1DB460D64046,"iPhone13,2"
com.google.Chrome,392,1747876890,1747877282,1747877282.243215,-18000,,
com.google.Chrome,301,1747876410,1747876711,1747876711.307131,-18000,,
com.letterboxd.LetterboxdApp,51,1747876329,1747876380,1747876380.615272,-18000,EB445137-D7F5-57EC-87DA-1DB460D64046,"iPhone13,2"
com.hammerandchisel.discord,11,1747876313,1747876324,1747876325.129582,-18000,EB445137-D7F5-57EC-87DA-1DB460D64046,"iPhone13,2"
com.apple.Music,33,1747875999,1747876032,1747876032.809083,-18000,EB445137-D7F5-57EC-87DA-1DB460D64046,"iPhone13,2"
com.letterboxd.LetterboxdApp,3,1747875995,1747875998,1747875998.488157,-18000,EB445137-D7F5-57EC-87DA-1DB460D64046,"iPhone13,2"
com.google.Chrome,641,1747875721,1747876362,1747876362.851735,-18000,,
com.google.Chrome,428,1747875175,1747875603,1747875603.220282,-18000,,
com.letterboxd.LetterboxdApp,43,1747874572,1747874615,1747874615.920306,-18000,EB445137-D7F5-57EC-87DA-1DB460D64046,"iPhone13,2"
com.letterboxd.LetterboxdApp,88,1747874468,1747874556,1747874556.471328,-18000,EB445137-D7F5-57EC-87DA-1DB460D64046,"iPhone13,2"
com.google.Chrome,595,1747874313,1747874908,1747874908.062037,-18000,,
com.apple.finder,1,1747874312,1747874313,1747874313.928956,-18000,,
com.leomehlig.today,63,1747874249,1747874312,1747874312.456397,-18000,,
com.doordash.dasher,172,1747873986,1747874158,1747874159.229725,-18000,EB445137-D7F5-57EC-87DA-1DB460D64046,"iPhone13,2"
com.apple.MobileSMS,45,1747871905,1747871950,1747871950.710573,-18000,EB445137-D7F5-57EC-87DA-1DB460D64046,"iPhone13,2"
com.strava.stravaride,31,1747871873,1747871904,1747871904.7403731,-18000,EB445137-D7F5-57EC-87DA-1DB460D64046,"iPhone13,2"
com.apple.findmy,1,1747871872,1747871873,1747871873.739172,-18000,EB445137-D7F5-57EC-87DA-1DB460D64046,"iPhone13,2"
com.apple.findmy,45,1747868617,1747868662,1747868662.381696,-18000,EB445137-D7F5-57EC-87DA-1DB460D64046,"iPhone13,2"
com.apple.findmy,14,1747868307,1747868321,1747868321.273917,-18000,EB445137-D7F5-57EC-87DA-1DB460D64046,"iPhone13,2"
com.apple.findmy,18,1747868092,1747868110,1747868111.12203,-18000,EB445137-D7F5-57EC-87DA-1DB460D64046,"iPhone13,2"
com.apple.calculator,7,1747867926,1747867933,1747867933.5330892,-18000,EB445137-D7F5-57EC-87DA-1DB460D64046,"iPhone13,2"
com.doordash.dasher,12,1747867914,1747867926,1747867926.492008,-18000,EB445137-D7F5-57EC-87DA-1DB460D64046,"iPhone13,2"
com.strava.stravaride,14,1747867377,1747867391,1747867391.8954148,-18000,EB445137-D7F5-57EC-87DA-1DB460D64046,"iPhone13,2"
com.apple.MobileSMS,6,1747867369,1747867375,1747867375.862362,-18000,EB445137-D7F5-57EC-87DA-1DB460D64046,"iPhone13,2"
com.doordash.dasher,1770,1747865235,1747867005,1747867005.657094,-18000,EB445137-D7F5-57EC-87DA-1DB460D64046,"iPhone13,2"
com.doordash.dasher,80,1747865153,1747865233,1747865233.8459811,-18000,EB445137-D7F5-57EC-87DA-1DB460D64046,"iPhone13,2"
com.apple.Health,10,1747865143,1747865153,1747865153.2126532,-18000,EB445137-D7F5-57EC-87DA-1DB460D64046,"iPhone13,2"
com.microsoft.Office.Outlook,18,1747865122,1747865140,1747865140.601008,-18000,EB445137-D7F5-57EC-87DA-1DB460D64046,"iPhone13,2"
com.apple.findmy,19,1747865103,1747865122,1747865122.798068,-18000,EB445137-D7F5-57EC-87DA-1DB460D64046,"iPhone13,2"
com.doordash.dasher,59,1747865044,1747865103,1747865103.572527,-18000,EB445137-D7F5-57EC-87DA-1DB460D64046,"iPhone13,2"
com.apple.calculator,7,1747865037,1747865044,1747865044.338894,-18000,EB445137-D7F5-57EC-87DA-1DB460D64046,"iPhone13,2"
com.doordash.dasher,11,1747865026,1747865037,1747865037.22358,-18000,EB445137-D7F5-57EC-87DA-1DB460D64046,"iPhone13,2"
com.apple.calculator,6,1747865020,1747865026,1747865026.651808,-18000,EB445137-D7F5-57EC-87DA-1DB460D64046,"iPhone13,2"
com.doordash.dasher,23,1747864997,1747865020,1747865020.662436,-18000,EB445137-D7F5-57EC-87DA-1DB460D64046,"iPhone13,2"
com.doordash.dasher,2,1747864995,1747864997,1747864997.3491,-18000,EB445137-D7F5-57EC-87DA-1DB460D64046,"iPhone13,2"
com.doordash.dasher,2,1747864992,1747864994,1747864994.741984,-18000,EB445137-D7F5-57EC-87DA-1DB460D64046,"iPhone13,2"
com.doordash.dasher,227,1747864756,1747864983,1747864983.995185,-18000,EB445137-D7F5-57EC-87DA-1DB460D64046,"iPhone13,2"
com.apple.MobileSMS,7,1747864749,1747864756,1747864756.497377,-18000,EB445137-D7F5-57EC-87DA-1DB460D64046,"iPhone13,2"
com.doordash.dasher,2,1747864747,1747864749,1747864749.514045,-18000,EB445137-D7F5-57EC-87DA-1DB460D64046,"iPhone13,2"
com.doordash.dasher,708,1747864024,1747864732,1747864732.6355639,-18000,EB445137-D7F5-57EC-87DA-1DB460D64046,"iPhone13,2"
com.doordash.dasher,135,1747863871,1747864006,1747864006.807942,-18000,EB445137-D7F5-57EC-87DA-1DB460D64046,"iPhone13,2"
com.doordash.dasher,417,1747863454,1747863871,1747863871.60379,-18000,EB445137-D7F5-57EC-87DA-1DB460D64046,"iPhone13,2"
com.doordash.dasher,44,1747863407,1747863451,1747863451.6339731,-18000,EB445137-D7F5-57EC-87DA-1DB460D64046,"iPhone13,2"
com.apple.MobileSMS,42,1747863365,1747863407,1747863407.929481,-18000,EB445137-D7F5-57EC-87DA-1DB460D64046,"iPhone13,2"
com.apple.camera,36,1747863327,1747863363,1747863386.838351,-18000,EB445137-D7F5-57EC-87DA-1DB460D64046,"iPhone13,2"
com.doordash.dasher,1480,1747861847,1747863327,1747863327.525233,-18000,EB445137-D7F5-57EC-87DA-1DB460D64046,"iPhone13,2"
com.doordash.dasher,209,1747861611,1747861820,1747861821.056314,-18000,EB445137-D7F5-57EC-87DA-1DB460D64046,"iPhone13,2"
com.doordash.dasher,562,1747860972,1747861534,1747861535.451264,-18000,EB445137-D7F5-57EC-87DA-1DB460D64046,"iPhone13,2"
com.doordash.dasher,186,1747860782,1747860968,1747860969.129276,-18000,EB445137-D7F5-57EC-87DA-1DB460D64046,"iPhone13,2"
com.doordash.dasher,244,1747860534,1747860778,1747860778.3931289,-18000,EB445137-D7F5-57EC-87DA-1DB460D64046,"iPhone13,2"
com.doordash.dasher,914,1747859569,1747860483,1747860484.304276,-18000,EB445137-D7F5-57EC-87DA-1DB460D64046,"iPhone13,2"
com.doordash.dasher,61,1747859181,1747859242,1747859242.782669,-18000,EB445137-D7F5-57EC-87DA-1DB460D64046,"iPhone13,2"
com.doordash.dasher,143,1747859008,1747859151,1747859151.60283,-18000,EB445137-D7F5-57EC-87DA-1DB460D64046,"iPhone13,2"
com.doordash.dasher,459,1747858521,1747858980,1747858980.785674,-18000,EB445137-D7F5-57EC-87DA-1DB460D64046,"iPhone13,2"
com.doordash.dasher,685,1747857835,1747858520,1747858520.362015,-18000,EB445137-D7F5-57EC-87DA-1DB460D64046,"iPhone13,2"
com.doordash.dasher,19,1747857779,1747857798,1747857798.720403,-18000,EB445137-D7F5-57EC-87DA-1DB460D64046,"iPhone13,2"
Astrospheric.Astrospheric,4,1747857775,1747857779,1747857780.0951118,-18000,EB445137-D7F5-57EC-87DA-1DB460D64046,"iPhone13,2"
com.leomehlig.today,3,1747857685,1747857688,1747857688.8955579,-18000,,
com.apple.finder,2,1747857683,1747857685,1747857685.344557,-18000,,
com.apple.Notes,1,1747857682,1747857683,1747857683.2439098,-18000,,
com.apple.finder,1,1747857681,1747857682,1747857682.842751,-18000,,
com.apple.Preview,0,1747857681,1747857681,1747857681.711053,-18000,,
com.google.Chrome,67,1747857614,1747857681,1747857681.580992,-18000,,
com.apple.finder,5,1747857163,1747857168,1747857168.2977629,-18000,,
com.google.Chrome,804,1747856359,1747857163,1747857163.066588,-18000,,
Astrospheric.Astrospheric,22,1747855798,1747855820,1747855820.77162,-18000,EB445137-D7F5-57EC-87DA-1DB460D64046,"iPhone13,2"
com.hammerandchisel.discord,5,1747855790,1747855795,1747855795.890967,-18000,EB445137-D7F5-57EC-87DA-1DB460D64046,"iPhone13,2"
com.apple.finder,586,1747855773,1747856359,1747856359.118668,-18000,,
com.google.Chrome,60,1747855713,1747855773,1747855773.620624,-18000,,
com.apple.finder,4,1747855709,1747855713,1747855713.424897,-18000,,
com.microsoft.VSCode,11,1747855698,1747855709,1747855709.783317,-18000,,
com.apple.news,78,1747855620,1747855698,1747855698.585229,-18000,,
com.microsoft.VSCode,17,1747855603,1747855620,1747855620.223411,-18000,,
com.apple.MobileSMS,41,1747855562,1747855603,1747855603.175169,-18000,,
com.microsoft.VSCode,197,1747855365,1747855562,1747855562.660037,-18000,,
com.apple.finder,3,1747855362,1747855365,1747855365.5930018,-18000,,
com.microsoft.VSCode,121,1747855241,1747855362,1747855362.96762,-18000,,
com.apple.finder,2,1747855239,1747855241,1747855241.332691,-18000,,
com.microsoft.VSCode,39,1747855200,1747855239,1747855239.174145,-18000,,
com.apple.finder,13,1747855187,1747855200,1747855200.105509,-18000,,
com.microsoft.VSCode,191,1747854996,1747855187,1747855187.048963,-18000,,
com.apple.finder,21,1747854975,1747854996,1747854997.010925,-18000,,
com.microsoft.VSCode,75,1747854900,1747854975,1747854975.8130689,-18000,,
com.apple.finder,25,1747854875,1747854900,1747854900.906869,-18000,,
com.microsoft.VSCode,5,1747854870,1747854875,1747854875.7050939,-18000,,
com.apple.finder,19,1747854851,1747854870,1747854870.081852,-18000,,
com.microsoft.VSCode,206,1747854645,1747854851,1747854851.80188,-18000,,
com.apple.finder,3,1747854642,1747854645,1747854645.9447088,-18000,,
com.microsoft.VSCode,4,1747854638,1747854642,1747854642.20081,-18000,,
com.apple.finder,12,1747854626,1747854638,1747854638.807672,-18000,,
com.apple.MobileSMS,98,1747854523,1747854621,1747854622.03097,-18000,EB445137-D7F5-57EC-87DA-1DB460D64046,"iPhone13,2"
com.microsoft.VSCode,285,1747854341,1747854626,1747854626.078784,-18000,,
com.google.Chrome,14,1747854327,1747854341,1747854341.174129,-18000,,
com.google.Chrome,6,1747854046,1747854052,1747854052.2622209,-18000,,
com.apple.iCal,83,1747853963,1747854046,1747854046.950988,-18000,,
com.doordash.dasher,24,1747852376,1747852400,1747852400.77303,-18000,EB445137-D7F5-57EC-87DA-1DB460D64046,"iPhone13,2"
com.google.Chrome,1870,1747852093,1747853963,1747853964.014976,-18000,,
com.apple.Preview,26,1747852067,1747852093,1747852093.745332,-18000,,
com.apple.finder,9,1747852058,1747852067,1747852067.5841231,-18000,,
com.google.Chrome,18,1747852040,1747852058,1747852058.824841,-18000,,
com.apple.Preview,78,1747851962,1747852040,1747852040.212469,-18000,,
com.apple.finder,5,1747851957,1747851962,1747851962.785348,-18000,,
com.apple.Preview,2,1747851955,1747851957,1747851957.25799,-18000,,
com.apple.finder,9,1747851946,1747851955,1747851955.111658,-18000,,
com.google.Chrome,1488,1747850458,1747851946,1747851946.17205,-18000,,
com.apple.Notes,1,1747850457,1747850458,1747850458.487822,-18000,,
com.google.Chrome,7,1747850450,1747850457,1747850457.405328,-18000,,
com.apple.Notes,20,1747850430,1747850450,1747850450.204874,-18000,,
com.google.Chrome,211,1747850219,1747850430,1747850430.044224,-18000,,
com.apple.finder,1,1747850218,1747850219,1747850219.9015179,-18000,,
com.leomehlig.today,82,1747850136,1747850218,1747850218.7454371,-18000,,
com.apple.MobileSMS,8,1747850128,1747850136,1747850136.7686892,-18000,,
com.leomehlig.today,25,1747850103,1747850128,1747850128.5871491,-18000,,
com.apple.finder,3,1747850100,1747850103,1747850103.493181,-18000,,
com.hammerandchisel.discord,5,1747849848,1747849853,1747849853.129493,-18000,EB445137-D7F5-57EC-87DA-1DB460D64046,"iPhone13,2"
com.doordash.dasher,773,1747848858,1747849631,1747849631.125485,-18000,EB445137-D7F5-57EC-87DA-1DB460D64046,"iPhone13,2"
com.doordash.dasher,15,1747848814,1747848829,1747848830.1148648,-18000,EB445137-D7F5-57EC-87DA-1DB460D64046,"iPhone13,2"
com.doordash.dasher,971,1747847805,1747848776,1747848777.497741,-18000,EB445137-D7F5-57EC-87DA-1DB460D64046,"iPhone13,2"
com.apple.findmy,3,1747847471,1747847474,1747847474.861467,-18000,EB445137-D7F5-57EC-87DA-1DB460D64046,"iPhone13,2"
com.apple.findmy,34,1747847435,1747847469,1747847469.4773932,-18000,EB445137-D7F5-57EC-87DA-1DB460D64046,"iPhone13,2"
com.doordash.dasher,2,1747847432,1747847434,1747847434.060035,-18000,EB445137-D7F5-57EC-87DA-1DB460D64046,"iPhone13,2"
com.doordash.dasher,101,1747847326,1747847427,1747847428.01715,-18000,EB445137-D7F5-57EC-87DA-1DB460D64046,"iPhone13,2"
com.doordash.dasher,1345,1747845915,1747847260,1747847261.229351,-18000,EB445137-D7F5-57EC-87DA-1DB460D64046,"iPhone13,2"
com.doordash.dasher,123,1747845781,1747845904,1747845905.36803,-18000,EB445137-D7F5-57EC-87DA-1DB460D64046,"iPhone13,2"
com.doordash.dasher,61,1747845577,1747845638,1747845639.172029,-18000,EB445137-D7F5-57EC-87DA-1DB460D64046,"iPhone13,2"
com.apple.news,161,1747845416,1747845577,1747845577.734427,-18000,EB445137-D7F5-57EC-87DA-1DB460D64046,"iPhone13,2"
com.doordash.dasher,273,1747845139,1747845412,1747845412.245973,-18000,EB445137-D7F5-57EC-87DA-1DB460D64046,"iPhone13,2"
com.apple.Music,23,1747845116,1747845139,1747845139.4105291,-18000,EB445137-D7F5-57EC-87DA-1DB460D64046,"iPhone13,2"
com.doordash.dasher,6,1747845109,1747845115,1747845115.851644,-18000,EB445137-D7F5-57EC-87DA-1DB460D64046,"iPhone13,2"
com.doordash.dasher,5,1747845055,1747845060,1747845060.2767658,-18000,EB445137-D7F5-57EC-87DA-1DB460D64046,"iPhone13,2"
com.apple.weather,7,1747845048,1747845055,1747845055.45689,-18000,EB445137-D7F5-57EC-87DA-1DB460D64046,"iPhone13,2"
com.doordash.dasher,2,1747845046,1747845048,1747845048.3584008,-18000,EB445137-D7F5-57EC-87DA-1DB460D64046,"iPhone13,2"
com.doordash.dasher,15,1747845016,1747845031,1747845031.995164,-18000,EB445137-D7F5-57EC-87DA-1DB460D64046,"iPhone13,2"
com.strava.stravaride,134,1747844836,1747844970,1747844970.793741,-18000,EB445137-D7F5-57EC-87DA-1DB460D64046,"iPhone13,2"
com.doordash.dasher,4,1747844826,1747844830,1747844830.468451,-18000,EB445137-D7F5-57EC-87DA-1DB460D64046,"iPhone13,2"
com.strava.stravaride,2,1747844824,1747844826,1747844827.3236299,-18000,EB445137-D7F5-57EC-87DA-1DB460D64046,"iPhone13,2"
com.toyopagroup.picaboo,17,1747844594,1747844611,1747844611.395145,-18000,EB445137-D7F5-57EC-87DA-1DB460D64046,"iPhone13,2"
com.google.chrome.ios,0,1747844594,1747844594,1747844595.8811378,-18000,EB445137-D7F5-57EC-87DA-1DB460D64046,"iPhone13,2"
com.google.chrome.ios,73,1747844455,1747844528,1747844528.7775578,-18000,EB445137-D7F5-57EC-87DA-1DB460D64046,"iPhone13,2"
com.letterboxd.LetterboxdApp,132,1747844323,1747844455,1747844455.6430311,-18000,EB445137-D7F5-57EC-87DA-1DB460D64046,"iPhone13,2"
com.apple.mobilecal,46,1747844277,1747844323,1747844323.721778,-18000,EB445137-D7F5-57EC-87DA-1DB460D64046,"iPhone13,2"
com.doordash.dasher,10,1747843863,1747843873,1747843873.804117,-18000,EB445137-D7F5-57EC-87DA-1DB460D64046,"iPhone13,2"
com.apple.Health,0,1747843863,1747843863,1747843864.434888,-18000,EB445137-D7F5-57EC-87DA-1DB460D64046,"iPhone13,2"
com.apple.Health,48,1747841310,1747841358,1747841359.192257,-18000,EB445137-D7F5-57EC-87DA-1DB460D64046,"iPhone13,2"
com.strava.stravaride,79,1747841230,1747841309,1747841310.4095569,-18000,EB445137-D7F5-57EC-87DA-1DB460D64046,"iPhone13,2"
com.doordash.dasher,48,1747839163,1747839211,1747839211.465745,-18000,EB445137-D7F5-57EC-87DA-1DB460D64046,"iPhone13,2"
com.apple.weather,3,1747839157,1747839160,1747839160.15408,-18000,EB445137-D7F5-57EC-87DA-1DB460D64046,"iPhone13,2"
com.apple.weather,10,1747838530,1747838540,1747838540.831022,-18000,EB445137-D7F5-57EC-87DA-1DB460D64046,"iPhone13,2"
com.apple.findmy,2,1747838528,1747838530,1747838530.865221,-18000,EB445137-D7F5-57EC-87DA-1DB460D64046,"iPhone13,2"
com.apple.findmy,10,1747838487,1747838497,1747838498.335462,-18000,EB445137-D7F5-57EC-87DA-1DB460D64046,"iPhone13,2"
com.letterboxd.LetterboxdApp,2,1747838480,1747838482,1747838482.814711,-18000,EB445137-D7F5-57EC-87DA-1DB460D64046,"iPhone13,2"
com.letterboxd.LetterboxdApp,47,1747838426,1747838473,1747838473.856565,-18000,EB445137-D7F5-57EC-87DA-1DB460D64046,"iPhone13,2"
com.letterboxd.LetterboxdApp,80,1747838333,1747838413,1747838414.275436,-18000,EB445137-D7F5-57EC-87DA-1DB460D64046,"iPhone13,2"
com.letterboxd.LetterboxdApp,79,1747832420,1747832499,1747832500.040571,-18000,EB445137-D7F5-57EC-87DA-1DB460D64046,"iPhone13,2"
com.google.chrome.ios,17,1747832378,1747832395,1747832395.3800611,-18000,EB445137-D7F5-57EC-87DA-1DB460D64046,"iPhone13,2"
com.renpho.health,34,1747832133,1747832167,1747832168.2175,-18000,EB445137-D7F5-57EC-87DA-1DB460D64046,"iPhone13,2"
com.apple.Health,9,1747831995,1747832004,1747832004.4144092,-18000,EB445137-D7F5-57EC-87DA-1DB460D64046,"iPhone13,2"
com.letterboxd.LetterboxdApp,60,1747831929,1747831989,1747831990.116856,-18000,EB445137-D7F5-57EC-87DA-1DB460D64046,"iPhone13,2"
com.google.chrome.ios,3,1747831926,1747831929,1747831930.1402779,-18000,EB445137-D7F5-57EC-87DA-1DB460D64046,"iPhone13,2"
com.letterboxd.LetterboxdApp,39,1747831887,1747831926,1747831926.6394858,-18000,EB445137-D7F5-57EC-87DA-1DB460D64046,"iPhone13,2"
com.apple.findmy,22,1747831843,1747831865,1747831866.3701282,-18000,EB445137-D7F5-57EC-87DA-1DB460D64046,"iPhone13,2"
com.apple.weather,18,1747831817,1747831835,1747831835.963485,-18000,EB445137-D7F5-57EC-87DA-1DB460D64046,"iPhone13,2"
com.doordash.dasher,50,1747798243,1747798293,1747798293.238086,-18000,EB445137-D7F5-57EC-87DA-1DB460D64046,"iPhone13,2"
com.apple.journal,17,1747798223,1747798240,1747798240.914521,-18000,EB445137-D7F5-57EC-87DA-1DB460D64046,"iPhone13,2"
com.apple.CoreAuthUI,2,1747797369,1747797371,1747797371.295768,-18000,EB445137-D7F5-57EC-87DA-1DB460D64046,"iPhone13,2"
com.apple.journal,853,1747797368,1747798221,1747798221.3875818,-18000,EB445137-D7F5-57EC-87DA-1DB460D64046,"iPhone13,2"
com.apple.Health,16,1747797348,1747797364,1747797364.878438,-18000,EB445137-D7F5-57EC-87DA-1DB460D64046,"iPhone13,2"
com.goodreads.Goodreads,40,1747797124,1747797164,1747797164.305857,-18000,EB445137-D7F5-57EC-87DA-1DB460D64046,"iPhone13,2"
com.thestorygraph.thestorygraph,27,1747797097,1747797124,1747797124.451237,-18000,EB445137-D7F5-57EC-87DA-1DB460D64046,"iPhone13,2"
com.apple.finder,1,1747793469,1747793470,1747793471.258451,-18000,,
com.leomehlig.today,22,1747793447,1747793469,1747793469.141715,-18000,,
com.doordash.dasher,208,1747793222,1747793430,1747793430.8613229,-18000,EB445137-D7F5-57EC-87DA-1DB460D64046,"iPhone13,2"
com.letterboxd.LetterboxdApp,2,1747793217,1747793219,1747793219.963505,-18000,EB445137-D7F5-57EC-87DA-1DB460D64046,"iPhone13,2"
com.microsoft.Excel,694,1747792753,1747793447,1747793447.3270721,-18000,,
com.leomehlig.today,27,1747792726,1747792753,1747792753.1844401,-18000,,
com.letterboxd.LetterboxdApp,139,1747792373,1747792512,1747792513.041132,-18000,EB445137-D7F5-57EC-87DA-1DB460D64046,"iPhone13,2"
com.google.Chrome,655,1747792071,1747792726,1747792726.61972,-18000,,
com.letterboxd.LetterboxdApp,198,1747791197,1747791395,1747791397.115056,-18000,EB445137-D7F5-57EC-87DA-1DB460D64046,"iPhone13,2"
com.apple.MobileSMS,4,1747791191,1747791195,1747791195.907908,-18000,EB445137-D7F5-57EC-87DA-1DB460D64046,"iPhone13,2"
com.letterboxd.LetterboxdApp,0,1747791191,1747791191,1747791192.440096,-18000,EB445137-D7F5-57EC-87DA-1DB460D64046,"iPhone13,2"
com.google.Chrome,301,1747790477,1747790778,1747790778.438211,-18000,,
com.google.Chrome,550,1747789902,1747790452,1747790452.08798,-18000,,
com.google.Chrome,1211,1747788664,1747789875,1747789875.592284,-18000,,
com.apple.news,56,1747788608,1747788664,1747788664.898273,-18000,,
com.google.Chrome,58,1747788550,1747788608,1747788608.3145962,-18000,,
com.google.Chrome,310,1747787776,1747788086,1747788086.4068851,-18000,,
com.letterboxd.LetterboxdApp,21,1747786890,1747786911,1747786911.75065,-18000,EB445137-D7F5-57EC-87DA-1DB460D64046,"iPhone13,2"
com.letterboxd.LetterboxdApp,77,1747786791,1747786868,1747786868.672946,-18000,EB445137-D7F5-57EC-87DA-1DB460D64046,"iPhone13,2"
com.apple.PosterBoard,1,1747786791,1747786792,1747786792.923832,-18000,EB445137-D7F5-57EC-87DA-1DB460D64046,"iPhone13,2"
com.letterboxd.LetterboxdApp,17,1747786684,1747786701,1747786701.782898,-18000,EB445137-D7F5-57EC-87DA-1DB460D64046,"iPhone13,2"
com.letterboxd.LetterboxdApp,181,1747786497,1747786678,1747786679.623001,-18000,EB445137-D7F5-57EC-87DA-1DB460D64046,"iPhone13,2"
com.letterboxd.LetterboxdApp,34,1747786429,1747786463,1747786464.4159799,-18000,EB445137-D7F5-57EC-87DA-1DB460D64046,"iPhone13,2"
com.letterboxd.LetterboxdApp,12,1747786321,1747786333,1747786334.057553,-18000,EB445137-D7F5-57EC-87DA-1DB460D64046,"iPhone13,2"
com.instructure.icanvas,7,1747786314,1747786321,1747786321.6028662,-18000,EB445137-D7F5-57EC-87DA-1DB460D64046,"iPhone13,2"
com.google.Chrome,1272,1747786307,1747787579,1747787579.1226702,-18000,,
com.apple.finder,20,1747786287,1747786307,1747786307.309824,-18000,,
com.instructure.icanvas,33,1747786212,1747786245,1747786246.245858,-18000,EB445137-D7F5-57EC-87DA-1DB460D64046,"iPhone13,2"
com.instructure.icanvas,23,1747786189,1747786212,1747786212.504689,-18000,EB445137-D7F5-57EC-87DA-1DB460D64046,"iPhone13,2"
com.google.chrome.ios,0,1747786189,1747786189,1747786190.4857678,-18000,EB445137-D7F5-57EC-87DA-1DB460D64046,"iPhone13,2"
com.google.chrome.ios,281,1747785874,1747786155,1747786156.4826632,-18000,EB445137-D7F5-57EC-87DA-1DB460D64046,"iPhone13,2"
com.apple.finder,3,1747785728,1747785731,1747785731.190639,-18000,,
com.apple.MobileSMS,5,1747785723,1747785728,1747785728.789197,-18000,,
com.apple.finder,2,1747785721,1747785723,1747785723.766613,-18000,,
com.apple.Photos,1,1747785720,1747785721,1747785722.035833,-18000,,
com.apple.MobileSMS,35,1747785685,1747785720,1747785720.7152228,-18000,,
com.apple.Photos,22,1747785663,1747785685,1747785685.738059,-18000,,
com.apple.MobileSMS,117,1747785546,1747785663,1747785663.087137,-18000,,
com.apple.finder,3,1747785543,1747785546,1747785547.4102988,-18000,,
com.doordash.dasher,45,1747784414,1747784459,1747784459.847748,-18000,EB445137-D7F5-57EC-87DA-1DB460D64046,"iPhone13,2"
com.instructure.icanvas,4,1747784409,1747784413,1747784413.377733,-18000,EB445137-D7F5-57EC-87DA-1DB460D64046,"iPhone13,2"
com.instructure.icanvas,59,1747784094,1747784153,1747784153.264226,-18000,EB445137-D7F5-57EC-87DA-1DB460D64046,"iPhone13,2"
com.apple.findmy,0,1747784094,1747784094,1747784095.590421,-18000,EB445137-D7F5-57EC-87DA-1DB460D64046,"iPhone13,2"
com.apple.findmy,6,1747783767,1747783773,1747783775.0051332,-18000,EB445137-D7F5-57EC-87DA-1DB460D64046,"iPhone13,2"
com.apple.Maps,160,1747782827,1747782987,1747782987.354867,-18000,EB445137-D7F5-57EC-87DA-1DB460D64046,"iPhone13,2"
com.doordash.dasher,2,1747782825,1747782827,1747782828.952869,-18000,EB445137-D7F5-57EC-87DA-1DB460D64046,"iPhone13,2"
com.doordash.dasher,1758,1747781066,1747782824,1747782824.969804,-18000,EB445137-D7F5-57EC-87DA-1DB460D64046,"iPhone13,2"
com.apple.MobileSMS,11,1747781055,1747781066,1747781067.117992,-18000,EB445137-D7F5-57EC-87DA-1DB460D64046,"iPhone13,2"
com.doordash.dasher,0,1747781055,1747781055,1747781055.864812,-18000,EB445137-D7F5-57EC-87DA-1DB460D64046,"iPhone13,2"
com.doordash.dasher,57,1747780998,1747781055,1747781055.0975819,-18000,EB445137-D7F5-57EC-87DA-1DB460D64046,"iPhone13,2"
com.doordash.dasher,130,1747780863,1747780993,1747780993.613935,-18000,EB445137-D7F5-57EC-87DA-1DB460D64046,"iPhone13,2"
com.doordash.dasher,1177,1747779628,1747780805,1747780806.4663439,-18000,EB445137-D7F5-57EC-87DA-1DB460D64046,"iPhone13,2"
com.doordash.dasher,166,1747779416,1747779582,1747779582.4886909,-18000,EB445137-D7F5-57EC-87DA-1DB460D64046,"iPhone13,2"
com.doordash.dasher,908,1747778491,1747779399,1747779400.21284,-18000,EB445137-D7F5-57EC-87DA-1DB460D64046,"iPhone13,2"
com.doordash.dasher,29,1747778435,1747778464,1747778464.969493,-18000,EB445137-D7F5-57EC-87DA-1DB460D64046,"iPhone13,2"
com.doordash.dasher,223,1747778201,1747778424,1747778424.328311,-18000,EB445137-D7F5-57EC-87DA-1DB460D64046,"iPhone13,2"
com.doordash.dasher,30,1747778020,1747778050,1747778050.266574,-18000,EB445137-D7F5-57EC-87DA-1DB460D64046,"iPhone13,2"
com.google.chrome.ios,36,1747777984,1747778020,1747778020.8854442,-18000,EB445137-D7F5-57EC-87DA-1DB460D64046,"iPhone13,2"
com.letterboxd.LetterboxdApp,45,1747777939,1747777984,1747777985.125798,-18000,EB445137-D7F5-57EC-87DA-1DB460D64046,"iPhone13,2"
com.doordash.dasher,5,1747777934,1747777939,1747777939.8016539,-18000,EB445137-D7F5-57EC-87DA-1DB460D64046,"iPhone13,2"
com.letterboxd.LetterboxdApp,139,1747777795,1747777934,1747777934.882526,-18000,EB445137-D7F5-57EC-87DA-1DB460D64046,"iPhone13,2"
com.doordash.dasher,17,1747777778,1747777795,1747777795.939755,-18000,EB445137-D7F5-57EC-87DA-1DB460D64046,"iPhone13,2"
com.apple.findmy,22,1747777756,1747777778,1747777779.336093,-18000,EB445137-D7F5-57EC-87DA-1DB460D64046,"iPhone13,2"
com.strava.stravaride,9,1747777747,1747777756,1747777756.645883,-18000,EB445137-D7F5-57EC-87DA-1DB460D64046,"iPhone13,2"
com.doordash.dasher,18,1747777706,1747777724,1747777724.30866,-18000,EB445137-D7F5-57EC-87DA-1DB460D64046,"iPhone13,2"
com.apple.weather,11,1747777695,1747777706,1747777707.110811,-18000,EB445137-D7F5-57EC-87DA-1DB460D64046,"iPhone13,2"
com.doordash.dasher,40,1747777655,1747777695,1747777695.628833,-18000,EB445137-D7F5-57EC-87DA-1DB460D64046,"iPhone13,2"
com.microsoft.Office.Outlook,20,1747777617,1747777637,1747777637.744121,-18000,EB445137-D7F5-57EC-87DA-1DB460D64046,"iPhone13,2"
com.apple.CoreAuthUI,2,1747777575,1747777577,1747777577.121594,-18000,EB445137-D7F5-57EC-87DA-1DB460D64046,"iPhone13,2"
com.google.chrome.ios,45,1747777572,1747777617,1747777617.275671,-18000,EB445137-D7F5-57EC-87DA-1DB460D64046,"iPhone13,2"
com.doordash.dasher,6,1747777566,1747777572,1747777572.786488,-18000,EB445137-D7F5-57EC-87DA-1DB460D64046,"iPhone13,2"
com.google.chrome.ios,22,1747777544,1747777566,1747777566.3114371,-18000,EB445137-D7F5-57EC-87DA-1DB460D64046,"iPhone13,2"
com.doordash.dasher,6,1747777538,1747777544,1747777544.918127,-18000,EB445137-D7F5-57EC-87DA-1DB460D64046,"iPhone13,2"
com.doordash.dasher,1635,1747775876,1747777511,1747777511.899059,-18000,EB445137-D7F5-57EC-87DA-1DB460D64046,"iPhone13,2"
com.doordash.dasher,21,1747775798,1747775819,1747775820.005224,-18000,EB445137-D7F5-57EC-87DA-1DB460D64046,"iPhone13,2"
com.doordash.dasher,272,1747775524,1747775796,1747775796.516029,-18000,EB445137-D7F5-57EC-87DA-1DB460D64046,"iPhone13,2"
com.doordash.dasher,61,1747775457,1747775518,1747775518.4510589,-18000,EB445137-D7F5-57EC-87DA-1DB460D64046,"iPhone13,2"
com.doordash.dasher,173,1747775225,1747775398,1747775398.508167,-18000,EB445137-D7F5-57EC-87DA-1DB460D64046,"iPhone13,2"
com.doordash.dasher,1483,1747773691,1747775174,1747775175.759152,-18000,EB445137-D7F5-57EC-87DA-1DB460D64046,"iPhone13,2"
com.apple.news,112,1747773561,1747773673,1747773673.989983,-18000,EB445137-D7F5-57EC-87DA-1DB460D64046,"iPhone13,2"
com.doordash.dasher,9,1747773552,1747773561,1747773562.091751,-18000,EB445137-D7F5-57EC-87DA-1DB460D64046,"iPhone13,2"
com.apple.news,197,1747773355,1747773552,1747773552.129986,-18000,EB445137-D7F5-57EC-87DA-1DB460D64046,"iPhone13,2"
com.doordash.dasher,8,1747773347,1747773355,1747773355.2498899,-18000,EB445137-D7F5-57EC-87DA-1DB460D64046,"iPhone13,2"
com.apple.news,6,1747773341,1747773347,1747773347.843343,-18000,EB445137-D7F5-57EC-87DA-1DB460D64046,"iPhone13,2"
com.apple.Music,16,1747773325,1747773341,1747773341.364574,-18000,EB445137-D7F5-57EC-87DA-1DB460D64046,"iPhone13,2"
com.apple.news,192,1747773133,1747773325,1747773325.856948,-18000,EB445137-D7F5-57EC-87DA-1DB460D64046,"iPhone13,2"
com.apple.Music,6,1747773127,1747773133,1747773136.602981,-18000,EB445137-D7F5-57EC-87DA-1DB460D64046,"iPhone13,2"
com.doordash.dasher,6,1747773121,1747773127,1747773127.608128,-18000,EB445137-D7F5-57EC-87DA-1DB460D64046,"iPhone13,2"
com.apple.news,123,1747772998,1747773121,1747773121.6852121,-18000,EB445137-D7F5-57EC-87DA-1DB460D64046,"iPhone13,2"
com.apple.Music,70,1747772924,1747772994,1747772995.341764,-18000,EB445137-D7F5-57EC-87DA-1DB460D64046,"iPhone13,2"
com.doordash.dasher,2,1747772922,1747772924,1747772926.487376,-18000,EB445137-D7F5-57EC-87DA-1DB460D64046,"iPhone13,2"
com.doordash.dasher,1622,1747771292,1747772914,1747772914.695187,-18000,EB445137-D7F5-57EC-87DA-1DB460D64046,"iPhone13,2"
com.apple.Music,11,1747771281,1747771292,1747771292.142411,-18000,EB445137-D7F5-57EC-87DA-1DB460D64046,"iPhone13,2"
com.doordash.dasher,457,1747770824,1747771281,1747771281.988158,-18000,EB445137-D7F5-57EC-87DA-1DB460D64046,"iPhone13,2"
com.apple.Music,2,1747770822,1747770824,1747770824.37936,-18000,EB445137-D7F5-57EC-87DA-1DB460D64046,"iPhone13,2"
com.doordash.dasher,20,1747770802,1747770822,1747770822.258193,-18000,EB445137-D7F5-57EC-87DA-1DB460D64046,"iPhone13,2"
com.apple.Music,7,1747770795,1747770802,1747770802.251522,-18000,EB445137-D7F5-57EC-87DA-1DB460D64046,"iPhone13,2"
com.doordash.dasher,569,1747770226,1747770795,1747770795.339581,-18000,EB445137-D7F5-57EC-87DA-1DB460D64046,"iPhone13,2"
com.apple.Music,94,1747770132,1747770226,1747770226.842551,-18000,EB445137-D7F5-57EC-87DA-1DB460D64046,"iPhone13,2"
com.doordash.dasher,5,1747770127,1747770132,1747770132.70226,-18000,EB445137-D7F5-57EC-87DA-1DB460D64046,"iPhone13,2"
com.apple.Music,4,1747770123,1747770127,1747770127.40068,-18000,EB445137-D7F5-57EC-87DA-1DB460D64046,"iPhone13,2"
com.google.chrome.ios,23,1747770100,1747770123,1747770123.50835,-18000,EB445137-D7F5-57EC-87DA-1DB460D64046,"iPhone13,2"
com.apple.Music,170,1747769930,1747770100,1747770100.490364,-18000,EB445137-D7F5-57EC-87DA-1DB460D64046,"iPhone13,2"
com.doordash.dasher,46,1747769884,1747769930,1747769931.086619,-18000,EB445137-D7F5-57EC-87DA-1DB460D64046,"iPhone13,2"
com.apple.Music,47,1747769837,1747769884,1747769884.46378,-18000,EB445137-D7F5-57EC-87DA-1DB460D64046,"iPhone13,2"
com.doordash.dasher,7,1747769830,1747769837,1747769848.468715,-18000,EB445137-D7F5-57EC-87DA-1DB460D64046,"iPhone13,2"
com.apple.Preferences,19,1747769811,1747769830,1747769848.440341,-18000,EB445137-D7F5-57EC-87DA-1DB460D64046,"iPhone13,2"
com.apple.Music,14,1747769786,1747769800,1747769800.9783092,-18000,EB445137-D7F5-57EC-87DA-1DB460D64046,"iPhone13,2"
com.doordash.dasher,61,1747769725,1747769786,1747769786.8399491,-18000,EB445137-D7F5-57EC-87DA-1DB460D64046,"iPhone13,2"
com.apple.Music,3,1747769717,1747769720,1747769720.216043,-18000,EB445137-D7F5-57EC-87DA-1DB460D64046,"iPhone13,2"
com.doordash.dasher,7,1747769710,1747769717,1747769717.095179,-18000,EB445137-D7F5-57EC-87DA-1DB460D64046,"iPhone13,2"
com.doordash.dasher,8,1747769681,1747769689,1747769689.386148,-18000,EB445137-D7F5-57EC-87DA-1DB460D64046,"iPhone13,2"
com.doordash.dasher,22,1747769621,1747769643,1747769644.061379,-18000,EB445137-D7F5-57EC-87DA-1DB460D64046,"iPhone13,2"
com.doordash.dasher,8,1747769519,1747769527,1747769527.407353,-18000,EB445137-D7F5-57EC-87DA-1DB460D64046,"iPhone13,2"
com.doordash.dasher,3,1747769337,1747769340,1747769340.605856,-18000,EB445137-D7F5-57EC-87DA-1DB460D64046,"iPhone13,2"
com.doordash.dasher,15,1747769278,1747769293,1747769293.890081,-18000,EB445137-D7F5-57EC-87DA-1DB460D64046,"iPhone13,2"
com.doordash.dasher,29,1747769191,1747769220,1747769220.693939,-18000,EB445137-D7F5-57EC-87DA-1DB460D64046,"iPhone13,2"
com.apple.Health,23,1747769165,1747769188,1747769188.225648,-18000,EB445137-D7F5-57EC-87DA-1DB460D64046,"iPhone13,2"
com.doordash.dasher,0,1747769165,1747769165,1747769165.7815251,-18000,EB445137-D7F5-57EC-87DA-1DB460D64046,"iPhone13,2"
com.doordash.dasher,69,1747769086,1747769155,1747769155.8580241,-18000,EB445137-D7F5-57EC-87DA-1DB460D64046,"iPhone13,2"
com.apple.Music,4,1747769082,1747769086,1747769087.2487001,-18000,EB445137-D7F5-57EC-87DA-1DB460D64046,"iPhone13,2"
com.doordash.dasher,111,1747768968,1747769079,1747769079.771317,-18000,EB445137-D7F5-57EC-87DA-1DB460D64046,"iPhone13,2"
com.apple.Music,183,1747768783,1747768966,1747768966.411425,-18000,EB445137-D7F5-57EC-87DA-1DB460D64046,"iPhone13,2"
com.doordash.dasher,213,1747768570,1747768783,1747768783.4239001,-18000,EB445137-D7F5-57EC-87DA-1DB460D64046,"iPhone13,2"
com.apple.Music,16,1747768554,1747768570,1747768570.492104,-18000,EB445137-D7F5-57EC-87DA-1DB460D64046,"iPhone13,2"
com.doordash.dasher,8,1747768546,1747768554,1747768554.086152,-18000,EB445137-D7F5-57EC-87DA-1DB460D64046,"iPhone13,2"
com.doordash.dasher,607,1747767937,1747768544,1747768544.3597798,-18000,EB445137-D7F5-57EC-87DA-1DB460D64046,"iPhone13,2"
com.apple.Music,49,1747767888,1747767937,1747767937.553801,-18000,EB445137-D7F5-57EC-87DA-1DB460D64046,"iPhone13,2"
com.doordash.dasher,61,1747767827,1747767888,1747767889.642035,-18000,EB445137-D7F5-57EC-87DA-1DB460D64046,"iPhone13,2"
com.apple.Music,91,1747767736,1747767827,1747767827.973392,-18000,EB445137-D7F5-57EC-87DA-1DB460D64046,"iPhone13,2"
com.doordash.dasher,20,1747767716,1747767736,1747767736.1995978,-18000,EB445137-D7F5-57EC-87DA-1DB460D64046,"iPhone13,2"
com.apple.findmy,16,1747767700,1747767716,1747767716.951178,-18000,EB445137-D7F5-57EC-87DA-1DB460D64046,"iPhone13,2"
com.apple.mobilephone,3,1747767650,1747767653,1747767653.777306,-18000,EB445137-D7F5-57EC-87DA-1DB460D64046,"iPhone13,2"
com.apple.mobilephone,2,1747767648,1747767650,1747767651.0417051,-18000,EB445137-D7F5-57EC-87DA-1DB460D64046,"iPhone13,2"
com.strava.stravaride,9,1747767637,1747767646,1747767646.084933,-18000,EB445137-D7F5-57EC-87DA-1DB460D64046,"iPhone13,2"
com.apple.Music,8,1747767627,1747767635,1747767635.387896,-18000,EB445137-D7F5-57EC-87DA-1DB460D64046,"iPhone13,2"
com.doordash.dasher,16,1747767611,1747767627,1747767627.62514,-18000,EB445137-D7F5-57EC-87DA-1DB460D64046,"iPhone13,2"
com.doordash.dasher,54,1747767504,1747767558,1747767558.93026,-18000,EB445137-D7F5-57EC-87DA-1DB460D64046,"iPhone13,2"
com.apple.Music,112,1747767388,1747767500,1747767500.3471498,-18000,EB445137-D7F5-57EC-87DA-1DB460D64046,"iPhone13,2"
com.apple.weather,5,1747767306,1747767311,1747767311.44158,-18000,EB445137-D7F5-57EC-87DA-1DB460D64046,"iPhone13,2"
com.apple.finder,5,1747767073,1747767078,1747767078.5008059,-18000,,
com.leomehlig.today,3,1747767070,1747767073,1747767073.661977,-18000,,
com.microsoft.Office.Outlook,6,1747767005,1747767011,1747767012.1846318,-18000,EB445137-D7F5-57EC-87DA-1DB460D64046,"iPhone13,2"
com.apple.MobileSMS,3,1747767001,1747767004,1747767004.226139,-18000,EB445137-D7F5-57EC-87DA-1DB460D64046,"iPhone13,2"
com.instacart.shopper,8,1747766993,1747767001,1747767001.356492,-18000,EB445137-D7F5-57EC-87DA-1DB460D64046,"iPhone13,2"
com.apple.MobileSMS,21,1747766972,1747766993,1747766993.502348,-18000,EB445137-D7F5-57EC-87DA-1DB460D64046,"iPhone13,2"
com.instacart.shopper,63,1747766909,1747766972,1747766972.970231,-18000,EB445137-D7F5-57EC-87DA-1DB460D64046,"iPhone13,2"
com.apple.MobileSMS,10,1747766899,1747766909,1747766909.4404612,-18000,EB445137-D7F5-57EC-87DA-1DB460D64046,"iPhone13,2"
com.instacart.shopper,5,1747766894,1747766899,1747766899.532088,-18000,EB445137-D7F5-57EC-87DA-1DB460D64046,"iPhone13,2"
com.google.Chrome,190,1747766880,1747767070,1747767070.613511,-18000,,
com.leomehlig.today,10,1747766870,1747766880,1747766880.098057,-18000,,
com.apple.MobileSMS,36,1747766858,1747766894,1747766894.317333,-18000,EB445137-D7F5-57EC-87DA-1DB460D64046,"iPhone13,2"
com.instacart.shopper,3,1747766855,1747766858,1747766858.4526892,-18000,EB445137-D7F5-57EC-87DA-1DB460D64046,"iPhone13,2"
com.apple.MobileSMS,23,1747766832,1747766855,1747766855.893584,-18000,EB445137-D7F5-57EC-87DA-1DB460D64046,"iPhone13,2"
com.instacart.shopper,35,1747766797,1747766832,1747766832.773905,-18000,EB445137-D7F5-57EC-87DA-1DB460D64046,"iPhone13,2"
com.apple.AppStore,17,1747766780,1747766797,1747766798.054956,-18000,EB445137-D7F5-57EC-87DA-1DB460D64046,"iPhone13,2"
com.google.Chrome,177,1747766693,1747766870,1747766870.367679,-18000,,
com.apple.PassbookUIService,6,1747766668,1747766674,1747766675.040436,-18000,EB445137-D7F5-57EC-87DA-1DB460D64046,"iPhone13,2"
com.apple.AppStore,82,1747766653,1747766735,1747766736.2860131,-18000,EB445137-D7F5-57EC-87DA-1DB460D64046,"iPhone13,2"
com.apple.MobileSMS,43,1747766604,1747766647,1747766648.103163,-18000,EB445137-D7F5-57EC-87DA-1DB460D64046,"iPhone13,2"
com.apple.MobileSMS,77,1747766520,1747766597,1747766597.695401,-18000,EB445137-D7F5-57EC-87DA-1DB460D64046,"iPhone13,2"
com.apple.findmy,1,1747766519,1747766520,1747766520.7449222,-18000,EB445137-D7F5-57EC-87DA-1DB460D64046,"iPhone13,2"
com.apple.findmy,24,1747766493,1747766517,1747766518.116397,-18000,EB445137-D7F5-57EC-87DA-1DB460D64046,"iPhone13,2"
com.burbn.instagram,2,1747766491,1747766493,1747766493.437501,-18000,EB445137-D7F5-57EC-87DA-1DB460D64046,"iPhone13,2"
com.apple.Preview,22,1747766378,1747766400,1747766400.2424278,-18000,,
com.google.Chrome,1601,1747764777,1747766378,1747766378.4014091,-18000,,
com.apple.Preview,15,1747764762,1747764777,1747764777.9965758,-18000,,
com.apple.finder,3,1747764759,1747764762,1747764762.454822,-18000,,
com.google.Chrome,214,1747764545,1747764759,1747764759.72022,-18000,,
com.apple.Preview,6,1747764539,1747764545,1747764545.592046,-18000,,
com.apple.finder,3,1747764536,1747764539,1747764539.0598578,-18000,,
com.google.Chrome,508,1747764028,1747764536,1747764536.656739,-18000,,
com.apple.Preview,4,1747764024,1747764028,1747764028.924842,-18000,,
com.apple.finder,8,1747764016,1747764024,1747764024.640271,-18000,,
com.apple.Preview,41,1747763975,1747764016,1747764016.818866,-18000,,
com.apple.finder,2,1747763973,1747763975,1747763975.7376308,-18000,,
com.apple.Preview,8,1747763965,1747763973,1747763973.1708112,-18000,,
com.apple.finder,2,1747763963,1747763965,1747763966.0095239,-18000,,
com.google.Chrome,21,1747763942,1747763963,1747763963.0634918,-18000,,
com.apple.finder,2,1747763940,1747763942,1747763942.198728,-18000,,
com.apple.Preview,8,1747763932,1747763940,1747763940.935507,-18000,,
com.apple.finder,0,1747763932,1747763932,1747763933.043205,-18000,,
com.apple.Preview,368,1747763564,1747763932,1747763932.711436,-18000,,
com.apple.finder,1,1747763563,1747763564,1747763564.7618089,-18000,,
com.apple.Preview,2,1747763561,1747763563,1747763563.458733,-18000,,
com.apple.finder,8,1747763553,1747763561,1747763561.48841,-18000,,
com.apple.Preview,27,1747763526,1747763553,1747763553.642559,-18000,,
com.google.Chrome,449,1747763077,1747763526,1747763526.0727382,-18000,,
com.apple.Preview,187,1747762890,1747763077,1747763077.9625359,-18000,,
com.apple.finder,5,1747762885,1747762890,1747762890.463798,-18000,,
com.google.Chrome,31,1747762854,1747762885,1747762885.660291,-18000,,
com.apple.Preview,6,1747762848,1747762854,1747762855.000083,-18000,,
com.google.Chrome,6,1747762842,1747762848,1747762848.679031,-18000,,
com.apple.Preview,40,1747762802,1747762842,1747762842.2424479,-18000,,
com.google.Chrome,19,1747762783,1747762802,1747762802.75495,-18000,,
com.apple.Preview,13,1747762770,1747762783,1747762783.389927,-18000,,
com.google.Chrome,10,1747762760,1747762770,1747762770.082954,-18000,,
com.apple.Preview,14,1747762746,1747762760,1747762760.869468,-18000,,
com.google.Chrome,4,1747762742,1747762746,1747762746.33574,-18000,,
com.apple.Preview,399,1747762343,1747762742,1747762742.2030668,-18000,,
com.google.Chrome,12,1747762331,1747762343,1747762343.9980679,-18000,,
com.apple.Preview,4,1747762327,1747762331,1747762331.8198318,-18000,,
com.google.Chrome,16,1747762311,1747762327,1747762327.321662,-18000,,
com.apple.Preview,4,1747762307,1747762311,1747762311.837533,-18000,,
com.google.Chrome,17,1747762290,1747762307,1747762307.046474,-18000,,
com.apple.Preview,804,1747761486,1747762290,1747762290.6921968,-18000,,
com.google.Chrome,10,1747761476,1747761486,1747761486.118026,-18000,,
com.apple.Preview,7,1747761469,1747761476,1747761476.932294,-18000,,
com.google.Chrome,17,1747761452,1747761469,1747761469.257196,-18000,,
com.apple.Preview,2,1747761450,1747761452,1747761452.9699159,-18000,,
com.google.Chrome,6,1747761444,1747761450,1747761450.173291,-18000,,
com.apple.Preview,4,1747761440,1747761444,1747761444.722677,-18000,,
com.apple.finder,1,1747761439,1747761440,1747761440.901645,-18000,,
com.google.Chrome,2,1747761437,1747761439,1747761439.347615,-18000,,
com.apple.finder,19,1747761418,1747761437,1747761437.427278,-18000,,
com.google.Chrome,19,1747761399,1747761418,1747761418.227839,-18000,,
com.apple.finder,5,1747761394,1747761399,1747761399.077383,-18000,,
com.apple.Notes,12,1747761382,1747761394,1747761394.950616,-18000,,
com.google.Chrome,19,1747761363,1747761382,1747761382.372613,-18000,,
com.apple.finder,2,1747761361,1747761363,1747761363.335871,-18000,,
com.leomehlig.today,6,1747761355,1747761361,1747761361.2956219,-18000,,
com.apple.finder,1,1747761354,1747761355,1747761355.041723,-18000,,
com.apple.Music,1,1747761353,1747761354,1747761354.282143,-18000,,
com.google.Chrome,6,1747761347,1747761353,1747761353.836858,-18000,,
com.burbn.instagram,73,1747760771,1747760844,1747760844.7523189,-18000,EB445137-D7F5-57EC-87DA-1DB460D64046,"iPhone13,2"
com.google.chrome.ios,131,1747760640,1747760771,1747760772.0398722,-18000,EB445137-D7F5-57EC-87DA-1DB460D64046,"iPhone13,2"
com.burbn.instagram,90,1747760548,1747760638,1747760639.078178,-18000,EB445137-D7F5-57EC-87DA-1DB460D64046,"iPhone13,2"
com.letterboxd.LetterboxdApp,169,1747760376,1747760545,1747760545.975779,-18000,EB445137-D7F5-57EC-87DA-1DB460D64046,"iPhone13,2"
com.apple.Music,236,1747760139,1747760375,1747760376.058284,-18000,EB445137-D7F5-57EC-87DA-1DB460D64046,"iPhone13,2"
com.letterboxd.LetterboxdApp,148,1747759445,1747759593,1747759593.278029,-18000,EB445137-D7F5-57EC-87DA-1DB460D64046,"iPhone13,2"
com.tinyspeck.chatlyio,23,1747759413,1747759436,1747759436.73531,-18000,EB445137-D7F5-57EC-87DA-1DB460D64046,"iPhone13,2"
com.google.chrome.ios,2,1747759408,1747759410,1747759410.8409781,-18000,EB445137-D7F5-57EC-87DA-1DB460D64046,"iPhone13,2"
com.google.chrome.ios,24,1747759324,1747759348,1747759348.655394,-18000,EB445137-D7F5-57EC-87DA-1DB460D64046,"iPhone13,2"
com.google.chrome.ios,66,1747754751,1747754817,1747754817.53685,-18000,EB445137-D7F5-57EC-87DA-1DB460D64046,"iPhone13,2"
com.google.chrome.ios,33,1747754304,1747754337,1747754337.241488,-18000,EB445137-D7F5-57EC-87DA-1DB460D64046,"iPhone13,2"
com.google.chrome.ios,15,1747752968,1747752983,1747752983.9912992,-18000,EB445137-D7F5-57EC-87DA-1DB460D64046,"iPhone13,2"
com.apple.findmy,2,1747752966,1747752968,1747752968.896095,-18000,EB445137-D7F5-57EC-87DA-1DB460D64046,"iPhone13,2"
com.apple.findmy,7,1747752949,1747752956,1747752956.8586621,-18000,EB445137-D7F5-57EC-87DA-1DB460D64046,"iPhone13,2"
com.google.chrome.ios,2,1747752946,1747752948,1747752948.464963,-18000,EB445137-D7F5-57EC-87DA-1DB460D64046,"iPhone13,2"
com.google.chrome.ios,19,1747752687,1747752706,1747752706.913166,-18000,EB445137-D7F5-57EC-87DA-1DB460D64046,"iPhone13,2"
com.google.chrome.ios,5,1747752389,1747752394,1747752394.699837,-18000,EB445137-D7F5-57EC-87DA-1DB460D64046,"iPhone13,2"
com.leomehlig.today,91,1747752298,1747752389,1747752389.645111,-18000,EB445137-D7F5-57EC-87DA-1DB460D64046,"iPhone13,2"
com.google.chrome.ios,69,1747752200,1747752269,1747752269.2144299,-18000,EB445137-D7F5-57EC-87DA-1DB460D64046,"iPhone13,2"
com.renpho.health,1,1747752199,1747752200,1747752200.669348,-18000,EB445137-D7F5-57EC-87DA-1DB460D64046,"iPhone13,2"
com.renpho.health,61,1747751393,1747751454,1747751454.48821,-18000,EB445137-D7F5-57EC-87DA-1DB460D64046,"iPhone13,2"
com.microsoft.Office.Outlook,26,1747751366,1747751392,1747751392.446457,-18000,EB445137-D7F5-57EC-87DA-1DB460D64046,"iPhone13,2"
com.apple.findmy,1,1747751365,1747751366,1747751366.1961021,-18000,EB445137-D7F5-57EC-87DA-1DB460D64046,"iPhone13,2"
com.apple.findmy,14,1747750278,1747750292,1747750294.0008469,-18000,EB445137-D7F5-57EC-87DA-1DB460D64046,"iPhone13,2"
com.apple.weather,5,1747750273,1747750278,1747750279.26047,-18000,EB445137-D7F5-57EC-87DA-1DB460D64046,"iPhone13,2"
com.apple.news,486,1747749786,1747750272,1747750272.55675,-18000,EB445137-D7F5-57EC-87DA-1DB460D64046,"iPhone13,2"
com.truebill.truebillnative,2,1747749784,1747749786,1747749786.146498,-18000,EB445137-D7F5-57EC-87DA-1DB460D64046,"iPhone13,2"
com.google.chrome.ios,183,1747749598,1747749781,1747749781.750129,-18000,EB445137-D7F5-57EC-87DA-1DB460D64046,"iPhone13,2"
com.google.Maps,87,1747749511,1747749598,1747749599.0527139,-18000,EB445137-D7F5-57EC-87DA-1DB460D64046,"iPhone13,2"
com.apple.Maps,15,1747749491,1747749506,1747749506.782992,-18000,EB445137-D7F5-57EC-87DA-1DB460D64046,"iPhone13,2"
com.strava.stravaride,38,1747749453,1747749491,1747749491.059294,-18000,EB445137-D7F5-57EC-87DA-1DB460D64046,"iPhone13,2"
com.apple.weather,27,1747749399,1747749426,1747749426.975143,-18000,EB445137-D7F5-57EC-87DA-1DB460D64046,"iPhone13,2"
com.leomehlig.today,37,1747749362,1747749399,1747749399.296097,-18000,EB445137-D7F5-57EC-87DA-1DB460D64046,"iPhone13,2"
com.apple.CoreAuthUI,8,1747748600,1747748608,1747748608.55703,-18000,EB445137-D7F5-57EC-87DA-1DB460D64046,"iPhone13,2"
com.apple.journal,736,1747748599,1747749335,1747749335.496393,-18000,EB445137-D7F5-57EC-87DA-1DB460D64046,"iPhone13,2"
com.apple.mobiletimer,13,1747748532,1747748545,1747748545.340616,-18000,EB445137-D7F5-57EC-87DA-1DB460D64046,"iPhone13,2"
com.apple.weather,5,1747714238,1747714243,1747714243.8467011,-18000,EB445137-D7F5-57EC-87DA-1DB460D64046,"iPhone13,2"
com.instructure.icanvas,1,1747714237,1747714238,1747714238.8599849,-18000,EB445137-D7F5-57EC-87DA-1DB460D64046,"iPhone13,2"
com.instructure.icanvas,1,1747714211,1747714212,1747714213.123353,-18000,EB445137-D7F5-57EC-87DA-1DB460D64046,"iPhone13,2"
com.instructure.icanvas,65,1747714142,1747714207,1747714207.3478389,-18000,EB445137-D7F5-57EC-87DA-1DB460D64046,"iPhone13,2"
com.toyopagroup.picaboo,0,1747714142,1747714142,1747714142.859678,-18000,EB445137-D7F5-57EC-87DA-1DB460D64046,"iPhone13,2"
com.toyopagroup.picaboo,9,1747708001,1747708010,1747708011.232229,-18000,EB445137-D7F5-57EC-87DA-1DB460D64046,"iPhone13,2"
com.apple.MobileSMS,9,1747707249,1747707258,1747707258.604138,-18000,EB445137-D7F5-57EC-87DA-1DB460D64046,"iPhone13,2"
com.apple.MobileSMS,3,1747705995,1747705998,1747705998.8801599,-18000,EB445137-D7F5-57EC-87DA-1DB460D64046,"iPhone13,2"
com.apple.findmy,0,1747705995,1747705995,1747705995.41451,-18000,EB445137-D7F5-57EC-87DA-1DB460D64046,"iPhone13,2"
com.apple.findmy,17,1747705941,1747705958,1747705959.354157,-18000,EB445137-D7F5-57EC-87DA-1DB460D64046,"iPhone13,2"
com.apple.CoreAuthUI,2,1747705851,1747705853,1747705853.309324,-18000,EB445137-D7F5-57EC-87DA-1DB460D64046,"iPhone13,2"
com.truebill.truebillnative,92,1747705845,1747705937,1747705937.18677,-18000,EB445137-D7F5-57EC-87DA-1DB460D64046,"iPhone13,2"
com.apple.findmy,14,1747705824,1747705838,1747705839.0692558,-18000,EB445137-D7F5-57EC-87DA-1DB460D64046,"iPhone13,2"
com.apple.findmy,8,1747705774,1747705782,1747705782.766117,-18000,EB445137-D7F5-57EC-87DA-1DB460D64046,"iPhone13,2"
com.apple.findmy,6,1747705547,1747705553,1747705553.727515,-18000,EB445137-D7F5-57EC-87DA-1DB460D64046,"iPhone13,2"
com.apple.MobileSMS,13,1747705380,1747705393,1747705393.331728,-18000,EB445137-D7F5-57EC-87DA-1DB460D64046,"iPhone13,2"
com.apple.findmy,5,1747705254,1747705259,1747705259.743262,-18000,EB445137-D7F5-57EC-87DA-1DB460D64046,"iPhone13,2"
com.toyopagroup.picaboo,71,1747704985,1747705056,1747705056.580931,-18000,EB445137-D7F5-57EC-87DA-1DB460D64046,"iPhone13,2"
com.toyopagroup.picaboo,50,1747704895,1747704945,1747704945.897162,-18000,EB445137-D7F5-57EC-87DA-1DB460D64046,"iPhone13,2"
com.apple.MobileSMS,1,1747704894,1747704895,1747704895.2870278,-18000,EB445137-D7F5-57EC-87DA-1DB460D64046,"iPhone13,2"
com.apple.MobileSMS,4,1747704853,1747704857,1747704858.707293,-18000,EB445137-D7F5-57EC-87DA-1DB460D64046,"iPhone13,2"
com.apple.findmy,5,1747704848,1747704853,1747704854.153491,-18000,EB445137-D7F5-57EC-87DA-1DB460D64046,"iPhone13,2"
com.apple.MobileSMS,6,1747704842,1747704848,1747704849.248378,-18000,EB445137-D7F5-57EC-87DA-1DB460D64046,"iPhone13,2"
com.apple.MobileSMS,29,1747699365,1747699394,1747699394.370728,-18000,EB445137-D7F5-57EC-87DA-1DB460D64046,"iPhone13,2"
com.apple.MobileSMS,3,1747699290,1747699293,1747699294.238257,-18000,EB445137-D7F5-57EC-87DA-1DB460D64046,"iPhone13,2"
com.google.chrome.ios,22,1747699268,1747699290,1747699290.9257998,-18000,EB445137-D7F5-57EC-87DA-1DB460D64046,"iPhone13,2"
com.apple.MobileSMS,2,1747699266,1747699268,1747699268.342396,-18000,EB445137-D7F5-57EC-87DA-1DB460D64046,"iPhone13,2"
com.apple.MobileSMS,8,1747698272,1747698280,1747698280.030915,-18000,EB445137-D7F5-57EC-87DA-1DB460D64046,"iPhone13,2"
com.apple.MobileSMS,26,1747698206,1747698232,1747698234.0425072,-18000,EB445137-D7F5-57EC-87DA-1DB460D64046,"iPhone13,2"
com.google.Chrome,878,1747695502,1747696380,1747696380.135001,-18000,,
com.google.Chrome,543,1747694916,1747695459,1747695459.5504851,-18000,,
com.apple.finder,3,1747694913,1747694916,1747694916.1910372,-18000,,
com.leomehlig.today,16,1747694897,1747694913,1747694913.3563828,-18000,,
com.google.Chrome,3,1747694894,1747694897,1747694897.425322,-18000,,
com.apple.findmy,19,1747694506,1747694525,1747694525.381219,-18000,EB445137-D7F5-57EC-87DA-1DB460D64046,"iPhone13,2"
com.doordash.dasher,129,1747694372,1747694501,1747694501.583342,-18000,EB445137-D7F5-57EC-87DA-1DB460D64046,"iPhone13,2"
com.doordash.dasher,449,1747693384,1747693833,1747693833.994832,-18000,EB445137-D7F5-57EC-87DA-1DB460D64046,"iPhone13,2"
com.apple.Music,4,1747693380,1747693384,1747693384.48052,-18000,EB445137-D7F5-57EC-87DA-1DB460D64046,"iPhone13,2"
com.doordash.dasher,33,1747693347,1747693380,1747693380.9060268,-18000,EB445137-D7F5-57EC-87DA-1DB460D64046,"iPhone13,2"
com.doordash.dasher,1779,1747691552,1747693331,1747693332.1874862,-18000,EB445137-D7F5-57EC-87DA-1DB460D64046,"iPhone13,2"
com.doordash.dasher,167,1747691377,1747691544,1747691544.8616672,-18000,EB445137-D7F5-57EC-87DA-1DB460D64046,"iPhone13,2"
com.apple.Music,8,1747691364,1747691372,1747691372.415236,-18000,EB445137-D7F5-57EC-87DA-1DB460D64046,"iPhone13,2"
com.doordash.dasher,138,1747691226,1747691364,1747691364.54336,-18000,EB445137-D7F5-57EC-87DA-1DB460D64046,"iPhone13,2"
com.doordash.dasher,8,1747691138,1747691146,1747691146.625299,-18000,EB445137-D7F5-57EC-87DA-1DB460D64046,"iPhone13,2"
com.doordash.dasher,168,1747690914,1747691082,1747691082.674079,-18000,EB445137-D7F5-57EC-87DA-1DB460D64046,"iPhone13,2"
com.doordash.dasher,47,1747690851,1747690898,1747690898.925359,-18000,EB445137-D7F5-57EC-87DA-1DB460D64046,"iPhone13,2"
com.apple.calculator,5,1747690846,1747690851,1747690851.6000528,-18000,EB445137-D7F5-57EC-87DA-1DB460D64046,"iPhone13,2"
com.doordash.dasher,8,1747690838,1747690846,1747690846.733477,-18000,EB445137-D7F5-57EC-87DA-1DB460D64046,"iPhone13,2"
com.doordash.dasher,298,1747690529,1747690827,1747690827.833068,-18000,EB445137-D7F5-57EC-87DA-1DB460D64046,"iPhone13,2"
com.doordash.dasher,794,1747689728,1747690522,1747690522.055835,-18000,EB445137-D7F5-57EC-87DA-1DB460D64046,"iPhone13,2"
com.doordash.dasher,1068,1747688650,1747689718,1747689718.567504,-18000,EB445137-D7F5-57EC-87DA-1DB460D64046,"iPhone13,2"
com.instructure.icanvas,20,1747688630,1747688650,1747688650.078687,-18000,EB445137-D7F5-57EC-87DA-1DB460D64046,"iPhone13,2"
com.doordash.dasher,111,1747688516,1747688627,1747688627.162393,-18000,EB445137-D7F5-57EC-87DA-1DB460D64046,"iPhone13,2"
com.doordash.dasher,2,1747688503,1747688505,1747688505.377606,-18000,EB445137-D7F5-57EC-87DA-1DB460D64046,"iPhone13,2"
com.doordash.dasher,3,1747688489,1747688492,1747688492.295003,-18000,EB445137-D7F5-57EC-87DA-1DB460D64046,"iPhone13,2"
com.doordash.dasher,3,1747688332,1747688335,1747688335.828275,-18000,EB445137-D7F5-57EC-87DA-1DB460D64046,"iPhone13,2"
com.apple.news,191,1747688141,1747688332,1747688333.014744,-18000,EB445137-D7F5-57EC-87DA-1DB460D64046,"iPhone13,2"
com.doordash.dasher,8,1747688133,1747688141,1747688141.2089028,-18000,EB445137-D7F5-57EC-87DA-1DB460D64046,"iPhone13,2"
com.apple.news,123,1747688010,1747688133,1747688133.320601,-18000,EB445137-D7F5-57EC-87DA-1DB460D64046,"iPhone13,2"
com.doordash.dasher,18,1747687992,1747688010,1747688010.3790622,-18000,EB445137-D7F5-57EC-87DA-1DB460D64046,"iPhone13,2"
com.doordash.dasher,36,1747687951,1747687987,1747687987.721221,-18000,EB445137-D7F5-57EC-87DA-1DB460D64046,"iPhone13,2"
com.doordash.dasher,118,1747687766,1747687884,1747687884.837062,-18000,EB445137-D7F5-57EC-87DA-1DB460D64046,"iPhone13,2"
com.apple.news,153,1747687613,1747687766,1747687766.962472,-18000,EB445137-D7F5-57EC-87DA-1DB460D64046,"iPhone13,2"
com.doordash.dasher,11,1747687591,1747687602,1747687603.014621,-18000,EB445137-D7F5-57EC-87DA-1DB460D64046,"iPhone13,2"
com.doordash.dasher,1097,1747686479,1747687576,1747687576.530559,-18000,EB445137-D7F5-57EC-87DA-1DB460D64046,"iPhone13,2"
com.apple.Music,3,1747686476,1747686479,1747686479.930568,-18000,EB445137-D7F5-57EC-87DA-1DB460D64046,"iPhone13,2"
com.doordash.dasher,180,1747686296,1747686476,1747686476.4441838,-18000,EB445137-D7F5-57EC-87DA-1DB460D64046,"iPhone13,2"
com.doordash.dasher,162,1747685813,1747685975,1747685975.933241,-18000,EB445137-D7F5-57EC-87DA-1DB460D64046,"iPhone13,2"
com.apple.Maps,6,1747685807,1747685813,1747685813.319766,-18000,EB445137-D7F5-57EC-87DA-1DB460D64046,"iPhone13,2"
com.doordash.dasher,23,1747685784,1747685807,1747685807.8220701,-18000,EB445137-D7F5-57EC-87DA-1DB460D64046,"iPhone13,2"
com.leomehlig.today,96,1747685688,1747685784,1747685784.317431,-18000,EB445137-D7F5-57EC-87DA-1DB460D64046,"iPhone13,2"
com.doordash.dasher,447,1747685236,1747685683,1747685683.486936,-18000,EB445137-D7F5-57EC-87DA-1DB460D64046,"iPhone13,2"
com.apple.findmy,33,1747685203,1747685236,1747685236.592118,-18000,EB445137-D7F5-57EC-87DA-1DB460D64046,"iPhone13,2"
com.doordash.dasher,155,1747685048,1747685203,1747685203.533969,-18000,EB445137-D7F5-57EC-87DA-1DB460D64046,"iPhone13,2"
com.apple.Music,30,1747685018,1747685048,1747685048.6514091,-18000,EB445137-D7F5-57EC-87DA-1DB460D64046,"iPhone13,2"
com.toyopagroup.picaboo,29,1747684986,1747685015,1747685015.88624,-18000,EB445137-D7F5-57EC-87DA-1DB460D64046,"iPhone13,2"
com.doordash.dasher,1,1747684985,1747684986,1747684986.1660619,-18000,EB445137-D7F5-57EC-87DA-1DB460D64046,"iPhone13,2"
com.doordash.dasher,186,1747684796,1747684982,1747684982.823892,-18000,EB445137-D7F5-57EC-87DA-1DB460D64046,"iPhone13,2"
com.toyopagroup.picaboo,20,1747684771,1747684791,1747684791.4827108,-18000,EB445137-D7F5-57EC-87DA-1DB460D64046,"iPhone13,2"
com.apple.Health,43,1747684722,1747684765,1747684766.002976,-18000,EB445137-D7F5-57EC-87DA-1DB460D64046,"iPhone13,2"
com.doordash.dasher,41,1747683412,1747683453,1747683453.43956,-18000,EB445137-D7F5-57EC-87DA-1DB460D64046,"iPhone13,2"
com.apple.Music,0,1747683371,1747683371,1747683373.016221,-18000,EB445137-D7F5-57EC-87DA-1DB460D64046,"iPhone13,2"
