app,usage,start_time,end_time,created_at,tz,device_id,device_model
com.apple.finder,115,1739547641,1739547756,1739547756.1730108,-21600,,
com.google.Chrome,175,1739547466,1739547641,1739547641.8392649,-21600,,
com.microsoft.VSCode,14,1739547393,1739547407,1739547407.043123,-21600,,
com.google.Chrome,331,1739547062,1739547393,1739547393.432969,-21600,,
com.microsoft.VSCode,3,1739546975,1739546978,1739546978.1184402,-21600,,
com.microsoft.VSCode,484,1739545311,1739545795,1739545795.6804051,-21600,,
com.google.Chrome,48,1739545263,1739545311,1739545311.822452,-21600,,
com.microsoft.VSCode,77,1739545186,1739545263,1739545263.652285,-21600,,
com.leomehlig.today,3,1739545183,1739545186,1739545186.633508,-21600,,
com.apple.news,91,1739545092,1739545183,1739545183.910181,-21600,,
com.leomehlig.today,21,1739545071,1739545092,1739545092.4331179,-21600,,
com.apple.finder,1,1739545070,1739545071,1739545071.8532891,-21600,,
com.apple.finder,1,1739501362,1739501363,1739501363.776927,-21600,,
com.google.Chrome,1,1739501361,1739501362,1739501362.199393,-21600,,
com.apple.finder,1,1739501360,1739501361,1739501361.430176,-21600,,
com.leomehlig.today,98,1739501262,1739501360,1739501360.179461,-21600,,
com.apple.iCal,9,1739501253,1739501262,1739501262.8199558,-21600,,
com.leomehlig.today,33,1739501220,1739501253,1739501254.010727,-21600,,
com.apple.MobileSMS,7,1739501213,1739501220,1739501220.102608,-21600,,
com.apple.MobileSMS,52,1739501000,1739501052,1739501052.720653,-21600,,
com.leomehlig.today,13,1739500987,1739501000,1739501000.266712,-21600,,
com.microsoft.VSCode,8,1739500979,1739500987,1739500987.522918,-21600,,
com.google.Chrome,54,1739500925,1739500979,1739500979.4103389,-21600,,
com.microsoft.VSCode,1,1739500924,1739500925,1739500925.6337461,-21600,,
com.google.Chrome,7,1739500917,1739500924,1739500924.1084142,-21600,,
com.microsoft.VSCode,320,1739500597,1739500917,1739500917.62293,-21600,,
com.google.Chrome,17,1739500580,1739500597,1739500597.223671,-21600,,
com.microsoft.VSCode,39,1739500541,1739500580,1739500580.9484491,-21600,,
com.google.Chrome,4,1739500537,1739500541,1739500541.599752,-21600,,
com.microsoft.VSCode,664,1739499873,1739500537,1739500537.386005,-21600,,
com.google.Chrome,25,1739499848,1739499873,1739499873.136056,-21600,,
com.microsoft.VSCode,300,1739499548,1739499848,1739499848.682623,-21600,,
com.google.Chrome,4,1739499544,1739499548,1739499548.781258,-21600,,
com.microsoft.VSCode,31,1739499513,1739499544,1739499544.360458,-21600,,
com.google.Chrome,1,1739499512,1739499513,1739499513.950035,-21600,,
com.microsoft.VSCode,10,1739499502,1739499512,1739499512.721535,-21600,,
com.google.Chrome,4,1739499498,1739499502,1739499502.1641011,-21600,,
com.microsoft.VSCode,5,1739499493,1739499498,1739499498.46799,-21600,,
com.google.Chrome,1,1739499492,1739499493,1739499493.849691,-21600,,
com.microsoft.VSCode,3,1739499489,1739499492,1739499492.663219,-21600,,
com.google.Chrome,1,1739499488,1739499489,1739499489.556305,-21600,,
com.microsoft.VSCode,5,1739499483,1739499488,1739499488.410265,-21600,,
com.google.Chrome,3,1739499480,1739499483,1739499483.3432431,-21600,,
com.microsoft.VSCode,10,1739499470,1739499480,1739499480.7621598,-21600,,
com.google.Chrome,1,1739499469,1739499470,1739499470.207705,-21600,,
com.microsoft.VSCode,1,1739499468,1739499469,1739499469.538363,-21600,,
com.leomehlig.today,2,1739499466,1739499468,1739499468.578372,-21600,,
com.google.Chrome,84,1739499382,1739499466,1739499466.939849,-21600,,
com.leomehlig.today,7,1739499375,1739499382,1739499382.7049289,-21600,,
com.google.Chrome,3,1739499372,1739499375,1739499375.7577028,-21600,,
com.microsoft.VSCode,35,1739499337,1739499372,1739499372.164002,-21600,,
com.google.Chrome,2,1739499335,1739499337,1739499337.507556,-21600,,
com.microsoft.VSCode,9,1739499326,1739499335,1739499335.875505,-21600,,
com.google.Chrome,1,1739499325,1739499326,1739499326.148501,-21600,,
com.microsoft.VSCode,2,1739499323,1739499325,1739499325.331475,-21600,,
com.google.Chrome,1,1739499322,1739499323,1739499323.632903,-21600,,
com.microsoft.VSCode,8,1739499314,1739499322,1739499322.8146129,-21600,,
com.google.Chrome,4,1739499310,1739499314,1739499314.7124581,-21600,,
com.microsoft.VSCode,5,1739499305,1739499310,1739499311.020124,-21600,,
com.google.Chrome,2,1739499303,1739499305,1739499305.558347,-21600,,
com.microsoft.VSCode,13,1739499290,1739499303,1739499303.91557,-21600,,
com.google.Chrome,5,1739499285,1739499290,1739499290.965069,-21600,,
com.microsoft.VSCode,1,1739499284,1739499285,1739499285.649931,-21600,,
com.google.Chrome,1,1739499283,1739499284,1739499284.660631,-21600,,
com.microsoft.VSCode,2,1739499281,1739499283,1739499283.857661,-21600,,
com.google.Chrome,0,1739499281,1739499281,1739499281.801597,-21600,,
com.microsoft.VSCode,3,1739499278,1739499281,1739499281.1166282,-21600,,
com.google.Chrome,2,1739499276,1739499278,1739499278.686657,-21600,,
com.microsoft.VSCode,5,1739499271,1739499276,1739499276.824096,-21600,,
com.google.Chrome,3,1739499268,1739499271,1739499271.444594,-21600,,
com.microsoft.VSCode,7,1739499261,1739499268,1739499268.1330972,-21600,,
com.google.Chrome,8,1739499253,1739499261,1739499262.072105,-21600,,
com.microsoft.VSCode,7,1739499246,1739499253,1739499253.724472,-21600,,
com.google.Chrome,2,1739499244,1739499246,1739499246.046442,-21600,,
com.microsoft.VSCode,76,1739499168,1739499244,1739499244.390439,-21600,,
com.google.Chrome,0,1739499168,1739499168,1739499168.5230122,-21600,,
com.microsoft.VSCode,55,1739499113,1739499168,1739499168.070648,-21600,,
com.google.Chrome,1,1739499112,1739499113,1739499113.899146,-21600,,
com.microsoft.VSCode,4,1739499108,1739499112,1739499112.73525,-21600,,
com.google.Chrome,10,1739499098,1739499108,1739499108.327275,-21600,,
com.microsoft.VSCode,35,1739499063,1739499098,1739499099.001204,-21600,,
com.google.Chrome,3,1739499060,1739499063,1739499063.246741,-21600,,
com.microsoft.VSCode,3,1739499057,1739499060,1739499060.849986,-21600,,
com.google.Chrome,21,1739499036,1739499057,1739499057.327413,-21600,,
com.microsoft.VSCode,200,1739498836,1739499036,1739499036.625081,-21600,,
com.apple.Dictionary,0,1739498836,1739498836,1739498836.850528,-21600,,
com.microsoft.VSCode,2,1739498834,1739498836,1739498836.184727,-21600,,
com.apple.Dictionary,2,1739498832,1739498834,1739498834.19033,-21600,,
com.microsoft.VSCode,32,1739498800,1739498832,1739498832.745986,-21600,,
com.google.Chrome,4,1739498796,1739498800,1739498800.769424,-21600,,
com.microsoft.VSCode,31,1739498765,1739498796,1739498796.9308639,-21600,,
com.google.Chrome,2,1739498763,1739498765,1739498765.0856519,-21600,,
com.microsoft.VSCode,3,1739498760,1739498763,1739498763.597557,-21600,,
com.google.Chrome,43,1739498717,1739498760,1739498760.2024431,-21600,,
com.microsoft.VSCode,273,1739498444,1739498717,1739498717.9079041,-21600,,
com.google.Chrome,3,1739498441,1739498444,1739498444.484892,-21600,,
com.microsoft.VSCode,8,1739498433,1739498441,1739498441.677182,-21600,,
com.google.Chrome,4,1739498429,1739498433,1739498433.395778,-21600,,
com.microsoft.VSCode,48,1739498381,1739498429,1739498429.0735888,-21600,,
com.google.Chrome,169,1739498212,1739498381,1739498381.070959,-21600,,
com.microsoft.VSCode,12,1739498200,1739498212,1739498212.384237,-21600,,
com.google.Chrome,85,1739498115,1739498200,1739498200.908256,-21600,,
com.microsoft.VSCode,73,1739498042,1739498115,1739498115.878734,-21600,,
com.google.Chrome,34,1739498008,1739498042,1739498042.723768,-21600,,
com.microsoft.VSCode,6,1739498002,1739498008,1739498008.396601,-21600,,
com.leomehlig.today,12,1739497990,1739498002,1739498002.381681,-21600,,
com.microsoft.VSCode,1,1739497989,1739497990,1739497990.267638,-21600,,
com.leomehlig.today,23,1739497966,1739497989,1739497989.541357,-21600,,
com.microsoft.VSCode,12,1739497954,1739497966,1739497966.875183,-21600,,
com.google.Chrome,19,1739497935,1739497954,1739497954.8640962,-21600,,
com.microsoft.VSCode,13,1739497922,1739497935,1739497935.700324,-21600,,
com.google.Chrome,17,1739497905,1739497922,1739497922.29899,-21600,,
com.microsoft.VSCode,23,1739497882,1739497905,1739497905.6957731,-21600,,
com.google.Chrome,1,1739497881,1739497882,1739497882.723819,-21600,,
com.microsoft.VSCode,12,1739497869,1739497881,1739497881.628708,-21600,,
com.google.Chrome,8,1739497861,1739497869,1739497869.223505,-21600,,
com.microsoft.VSCode,202,1739497659,1739497861,1739497861.682971,-21600,,
com.google.Chrome,4,1739497655,1739497659,1739497659.326312,-21600,,
com.microsoft.VSCode,20,1739497635,1739497655,1739497655.241823,-21600,,
com.google.Chrome,1,1739497634,1739497635,1739497635.2379,-21600,,
com.microsoft.VSCode,50,1739497584,1739497634,1739497634.065889,-21600,,
com.google.Chrome,8,1739497576,1739497584,1739497584.309212,-21600,,
com.microsoft.VSCode,42,1739497534,1739497576,1739497576.9107409,-21600,,
com.google.Chrome,11,1739497523,1739497534,1739497534.6825671,-21600,,
com.microsoft.VSCode,374,1739497149,1739497523,1739497523.4904652,-21600,,
com.google.Chrome,8,1739497141,1739497149,1739497149.343703,-21600,,
com.microsoft.VSCode,41,1739497100,1739497141,1739497141.278142,-21600,,
com.google.Chrome,6,1739497094,1739497100,1739497100.1623769,-21600,,
com.microsoft.VSCode,17,1739497077,1739497094,1739497094.915452,-21600,,
com.google.Chrome,1,1739497076,1739497077,1739497077.8586268,-21600,,
com.microsoft.VSCode,21,1739497055,1739497076,1739497076.191051,-21600,,
com.google.Chrome,4,1739497051,1739497055,1739497055.614242,-21600,,
com.microsoft.VSCode,2,1739497049,1739497051,1739497051.267065,-21600,,
com.google.Chrome,4,1739497045,1739497049,1739497049.1548162,-21600,,
com.microsoft.VSCode,73,1739496972,1739497045,1739497045.084986,-21600,,
com.google.Chrome,2,1739496970,1739496972,1739496972.182846,-21600,,
com.microsoft.VSCode,2,1739496968,1739496970,1739496970.460279,-21600,,
com.google.Chrome,12,1739496956,1739496968,1739496968.3907142,-21600,,
com.microsoft.VSCode,306,1739496650,1739496956,1739496956.324017,-21600,,
com.google.Chrome,7,1739496643,1739496650,1739496650.9260201,-21600,,
com.microsoft.VSCode,13,1739496630,1739496643,1739496643.085171,-21600,,
com.google.Chrome,1,1739496629,1739496630,1739496630.7312012,-21600,,
com.microsoft.VSCode,11,1739496618,1739496629,1739496629.471122,-21600,,
com.google.Chrome,5,1739496613,1739496618,1739496618.1904612,-21600,,
com.microsoft.VSCode,11,1739496602,1739496613,1739496613.350214,-21600,,
com.google.Chrome,1,1739496601,1739496602,1739496603.026984,-21600,,
com.microsoft.VSCode,2,1739496599,1739496601,1739496601.31306,-21600,,
com.google.Chrome,1,1739496598,1739496599,1739496600.0549788,-21600,,
com.microsoft.VSCode,52,1739496546,1739496598,1739496598.885209,-21600,,
com.google.Chrome,4,1739496542,1739496546,1739496546.232771,-21600,,
com.microsoft.VSCode,15,1739496527,1739496542,1739496542.848592,-21600,,
com.google.Chrome,3,1739496524,1739496527,1739496527.064935,-21600,,
com.microsoft.VSCode,2,1739496522,1739496524,1739496524.668692,-21600,,
com.google.Chrome,2,1739496520,1739496522,1739496522.112782,-21600,,
com.microsoft.VSCode,7,1739496513,1739496520,1739496520.567223,-21600,,
com.google.Chrome,5,1739496508,1739496513,1739496513.553761,-21600,,
com.microsoft.VSCode,6,1739496502,1739496508,1739496508.2321382,-21600,,
com.google.Chrome,1,1739496501,1739496502,1739496502.680218,-21600,,
com.microsoft.VSCode,8,1739496493,1739496501,1739496501.379425,-21600,,
com.google.Chrome,0,1739496493,1739496493,1739496493.652811,-21600,,
com.microsoft.VSCode,2,1739496491,1739496493,1739496493.290519,-21600,,
com.google.Chrome,21,1739496470,1739496491,1739496491.540248,-21600,,
com.microsoft.VSCode,31,1739496439,1739496470,1739496470.87255,-21600,,
com.google.Chrome,16,1739496423,1739496439,1739496440.009601,-21600,,
com.microsoft.VSCode,71,1739496352,1739496423,1739496423.279636,-21600,,
com.google.Chrome,1,1739496351,1739496352,1739496352.918985,-21600,,
com.microsoft.VSCode,47,1739496304,1739496351,1739496351.513104,-21600,,
com.google.Chrome,0,1739496304,1739496304,1739496304.433261,-21600,,
com.microsoft.VSCode,8,1739496296,1739496304,1739496304.0535479,-21600,,
com.google.Chrome,7,1739496289,1739496296,1739496296.39123,-21600,,
com.microsoft.VSCode,11,1739496278,1739496289,1739496289.111666,-21600,,
com.google.Chrome,8,1739496270,1739496278,1739496278.574065,-21600,,
com.microsoft.VSCode,73,1739496197,1739496270,1739496270.2840729,-21600,,
com.google.Chrome,78,1739496119,1739496197,1739496197.181951,-21600,,
com.microsoft.VSCode,205,1739495914,1739496119,1739496120.0402942,-21600,,
com.google.Chrome,34,1739495880,1739495914,1739495914.8067431,-21600,,
com.microsoft.VSCode,99,1739495781,1739495880,1739495880.26176,-21600,,
com.google.Chrome,1,1739495780,1739495781,1739495781.2747889,-21600,,
com.microsoft.VSCode,24,1739495756,1739495780,1739495780.7195082,-21600,,
com.google.Chrome,0,1739495756,1739495756,1739495756.525459,-21600,,
com.microsoft.VSCode,43,1739495713,1739495756,1739495756.201394,-21600,,
com.google.Chrome,5,1739495708,1739495713,1739495713.271101,-21600,,
com.microsoft.VSCode,3,1739495705,1739495708,1739495708.164019,-21600,,
com.google.Chrome,1,1739495704,1739495705,1739495705.592576,-21600,,
com.microsoft.VSCode,1,1739495703,1739495704,1739495704.9424438,-21600,,
com.google.Chrome,3,1739495700,1739495703,1739495703.591031,-21600,,
com.microsoft.VSCode,2,1739495698,1739495700,1739495700.4977489,-21600,,
com.google.Chrome,1,1739495697,1739495698,1739495698.534851,-21600,,
com.microsoft.VSCode,1,1739495696,1739495697,1739495697.647952,-21600,,
com.google.Chrome,18,1739495678,1739495696,1739495696.2481298,-21600,,
com.microsoft.VSCode,1,1739495677,1739495678,1739495678.967502,-21600,,
com.google.Chrome,2,1739495675,1739495677,1739495677.2429318,-21600,,
com.microsoft.VSCode,1,1739495674,1739495675,1739495675.966401,-21600,,
com.google.Chrome,2,1739495672,1739495674,1739495674.313496,-21600,,
com.microsoft.VSCode,1,1739495671,1739495672,1739495672.826922,-21600,,
com.google.Chrome,2,1739495669,1739495671,1739495671.145598,-21600,,
com.microsoft.VSCode,2,1739495667,1739495669,1739495669.640353,-21600,,
com.google.Chrome,1,1739495666,1739495667,1739495667.584056,-21600,,
com.microsoft.VSCode,3,1739495663,1739495666,1739495666.045998,-21600,,
com.google.Chrome,2,1739495661,1739495663,1739495663.610512,-21600,,
com.microsoft.VSCode,1,1739495660,1739495661,1739495661.9475179,-21600,,
com.google.Chrome,2,1739495658,1739495660,1739495660.210356,-21600,,
com.microsoft.VSCode,2,1739495656,1739495658,1739495658.784216,-21600,,
com.google.Chrome,2,1739495654,1739495656,1739495657.021006,-21600,,
com.microsoft.VSCode,2,1739495652,1739495654,1739495654.8110042,-21600,,
com.google.Chrome,1,1739495651,1739495652,1739495652.904988,-21600,,
com.microsoft.VSCode,3,1739495648,1739495651,1739495651.2526069,-21600,,
com.google.Chrome,2,1739495646,1739495648,1739495649.0162911,-21600,,
com.microsoft.VSCode,2,1739495644,1739495646,1739495646.890143,-21600,,
com.google.Chrome,2,1739495642,1739495644,1739495645.016817,-21600,,
com.microsoft.VSCode,1,1739495641,1739495642,1739495642.9310331,-21600,,
com.google.Chrome,3,1739495638,1739495641,1739495641.094009,-21600,,
com.microsoft.VSCode,2,1739495636,1739495638,1739495638.119319,-21600,,
com.google.Chrome,2,1739495634,1739495636,1739495636.10458,-21600,,
com.microsoft.VSCode,2,1739495632,1739495634,1739495634.57371,-21600,,
com.google.Chrome,10,1739495622,1739495632,1739495632.4665818,-21600,,
com.microsoft.VSCode,1,1739495621,1739495622,1739495622.818842,-21600,,
com.google.Chrome,3,1739495618,1739495621,1739495621.2261229,-21600,,
com.microsoft.VSCode,2,1739495616,1739495618,1739495618.155748,-21600,,
com.google.Chrome,25,1739495591,1739495616,1739495617.019547,-21600,,
com.microsoft.VSCode,4,1739495587,1739495591,1739495591.853837,-21600,,
com.google.Chrome,4,1739495583,1739495587,1739495587.209937,-21600,,
com.microsoft.VSCode,3,1739495580,1739495583,1739495584.0202909,-21600,,
com.google.Chrome,8,1739495572,1739495580,1739495580.076013,-21600,,
com.microsoft.VSCode,32,1739495540,1739495572,1739495572.995106,-21600,,
com.google.Chrome,161,1739495379,1739495540,1739495540.3847709,-21600,,
com.leomehlig.today,12,1739495367,1739495379,1739495380.02864,-21600,,
com.google.Chrome,32,1739495335,1739495367,1739495367.681525,-21600,,
com.apple.finder,52,1739495283,1739495335,1739495335.103599,-21600,,
com.google.Chrome,330,1739494953,1739495283,1739495283.77427,-21600,,
com.google.Chrome,578,1739494374,1739494952,1739494952.9888182,-21600,,
com.google.Chrome,751,1739493087,1739493838,1739493838.285265,-21600,,
com.leomehlig.today,2,1739493046,1739493048,1739493048.0657182,-21600,,
com.google.Chrome,734,1739492312,1739493046,1739493046.086571,-21600,,
com.google.Chrome,594,1739491716,1739492310,1739492311.0077991,-21600,,
com.leomehlig.today,2,1739491714,1739491716,1739491717.091721,-21600,,
com.microsoft.VSCode,5,1739491709,1739491714,1739491714.991798,-21600,,
com.google.Chrome,20,1739491689,1739491709,1739491709.310402,-21600,,
com.leomehlig.today,43,1739491646,1739491689,1739491690.02899,-21600,,
com.leomehlig.today,4,1739489678,1739489682,1739489683.018964,-21600,,
com.apple.MobileSMS,1,1739489677,1739489678,1739489678.848469,-21600,,
com.leomehlig.today,1,1739489676,1739489677,1739489677.9633589,-21600,,
com.apple.CoreAuthUI,3,1739489628,1739489631,1739489631.2806458,-21600,EB445137-D7F5-57EC-87DA-1DB460D64046,"iPhone13,2"
com.truebill.truebillnative,12,1739489625,1739489637,1739489637.1878982,-21600,EB445137-D7F5-57EC-87DA-1DB460D64046,"iPhone13,2"
com.ally.MobileBanking,2,1739489621,1739489623,1739489623.336205,-21600,EB445137-D7F5-57EC-87DA-1DB460D64046,"iPhone13,2"
com.robinhood.release.Robinhood,3,1739489618,1739489621,1739489621.3077688,-21600,EB445137-D7F5-57EC-87DA-1DB460D64046,"iPhone13,2"
com.apple.FaceTime,110,1739489566,1739489676,1739489676.897136,-21600,,
com.apple.Photos,1,1739489565,1739489566,1739489566.875746,-21600,,
com.apple.FaceTime,3,1739489562,1739489565,1739489565.636273,-21600,,
com.leomehlig.today,29,1739489533,1739489562,1739489562.578806,-21600,,
com.apple.FaceTime,1,1739489532,1739489533,1739489534.021991,-21600,,
com.leomehlig.today,20,1739489512,1739489532,1739489532.5663018,-21600,,
com.apple.FaceTime,2,1739489510,1739489512,1739489512.729971,-21600,,
com.leomehlig.today,3,1739489507,1739489510,1739489510.90569,-21600,,
com.apple.MobileSMS,2,1739489505,1739489507,1739489507.1756449,-21600,,
com.apple.Preferences,12,1739489471,1739489483,1739489483.322279,-21600,EB445137-D7F5-57EC-87DA-1DB460D64046,"iPhone13,2"
com.apple.FaceTime,225,1739489280,1739489505,1739489506.021577,-21600,,
com.apple.mobilephone,4,1739489147,1739489151,1739489151.9400458,-21600,EB445137-D7F5-57EC-87DA-1DB460D64046,"iPhone13,2"
com.apple.MobileSMS,11,1739489017,1739489028,1739489029.022015,-21600,EB445137-D7F5-57EC-87DA-1DB460D64046,"iPhone13,2"
com.microsoft.Office.Outlook,10,1739489006,1739489016,1739489016.348445,-21600,EB445137-D7F5-57EC-87DA-1DB460D64046,"iPhone13,2"
Astrospheric.Astrospheric,11,1739488992,1739489003,1739489003.807625,-21600,EB445137-D7F5-57EC-87DA-1DB460D64046,"iPhone13,2"
com.apple.weather,2,1739488988,1739488990,1739488990.467619,-21600,EB445137-D7F5-57EC-87DA-1DB460D64046,"iPhone13,2"
com.myfitnesspal.mfp,2,1739488986,1739488988,1739488988.416329,-21600,EB445137-D7F5-57EC-87DA-1DB460D64046,"iPhone13,2"
com.apple.FaceTime,311,1739488113,1739488424,1739488424.580276,-21600,,
com.apple.MobileSMS,1,1739488112,1739488113,1739488113.8978949,-21600,,
com.apple.MobileSMS,303,1739487654,1739487957,1739487957.465839,-21600,,
com.apple.FaceTime,5,1739487649,1739487654,1739487654.375067,-21600,,
com.apple.MobileSMS,9,1739487640,1739487649,1739487649.0885549,-21600,,
com.google.Chrome,2,1739487638,1739487640,1739487640.143789,-21600,,
com.apple.FaceTime,5,1739487633,1739487638,1739487638.471154,-21600,,
com.google.Chrome,3,1739487630,1739487633,1739487633.859079,-21600,,
com.apple.findmy,30,1739487600,1739487630,1739487630.333801,-21600,,
com.google.Chrome,66,1739487534,1739487600,1739487600.138938,-21600,,
com.myfitnesspal.mfp,71,1739487403,1739487474,1739487474.6472368,-21600,EB445137-D7F5-57EC-87DA-1DB460D64046,"iPhone13,2"
com.apple.findmy,2,1739487401,1739487403,1739487404.9971209,-21600,EB445137-D7F5-57EC-87DA-1DB460D64046,"iPhone13,2"
com.apple.findmy,7,1739486290,1739486297,1739486298.702979,-21600,EB445137-D7F5-57EC-87DA-1DB460D64046,"iPhone13,2"
com.tinyspeck.chatlyio,7,1739486281,1739486288,1739486288.605839,-21600,EB445137-D7F5-57EC-87DA-1DB460D64046,"iPhone13,2"
com.google.Gmail,2,1739486276,1739486278,1739486278.828795,-21600,EB445137-D7F5-57EC-87DA-1DB460D64046,"iPhone13,2"
com.google.Gmail,8,1739486266,1739486274,1739486275.318296,-21600,EB445137-D7F5-57EC-87DA-1DB460D64046,"iPhone13,2"
com.apple.shortcuts,0,1739486266,1739486266,1739486267.58036,-21600,EB445137-D7F5-57EC-87DA-1DB460D64046,"iPhone13,2"
com.google.Chrome,219,1739485885,1739486104,1739486104.187835,-21600,,
com.microsoft.VSCode,31,1739485854,1739485885,1739485885.632787,-21600,,
com.google.Chrome,575,1739485279,1739485854,1739485854.803115,-21600,,
com.leomehlig.today,10,1739485269,1739485279,1739485279.2365088,-21600,,
com.google.Chrome,2,1739485267,1739485269,1739485269.595006,-21600,,
com.apple.Passwords,1,1739485266,1739485267,1739485267.903975,-21600,,
com.google.Chrome,1,1739485265,1739485266,1739485266.79859,-21600,,
com.microsoft.Word,4,1739485261,1739485265,1739485265.4216151,-21600,,
com.google.Chrome,15,1739485246,1739485261,1739485261.815227,-21600,,
com.apple.news,77,1739485169,1739485246,1739485246.4482079,-21600,,
com.google.Chrome,958,1739484211,1739485169,1739485169.388617,-21600,,
com.apple.finder,74,1739484137,1739484211,1739484211.54777,-21600,,
com.google.Chrome,222,1739483915,1739484137,1739484137.1149821,-21600,,
com.microsoft.Word,5,1739483910,1739483915,1739483915.4194021,-21600,,
com.apple.finder,5,1739483905,1739483910,1739483910.563693,-21600,,
com.google.Chrome,91,1739483814,1739483905,1739483905.372997,-21600,,
com.google.Chrome,314,1739483010,1739483324,1739483324.650866,-21600,,
com.apple.Photos,12,1739482998,1739483010,1739483010.5509949,-21600,,
com.google.Chrome,273,1739482725,1739482998,1739482998.8755322,-21600,,
com.microsoft.Word,3,1739482722,1739482725,1739482725.925904,-21600,,
com.apple.finder,8,1739482714,1739482722,1739482722.618974,-21600,,
com.google.Chrome,95,1739482619,1739482714,1739482714.953494,-21600,,
com.apple.Passwords,6,1739482608,1739482614,1739482615.048471,-21600,,
com.google.Chrome,175,1739482433,1739482608,1739482608.201186,-21600,,
com.leomehlig.today,50,1739482383,1739482433,1739482434.312868,-21600,,
com.google.Chrome,753,1739481630,1739482383,1739482383.4910688,-21600,,
com.leomehlig.today,13,1739481617,1739481630,1739481630.385363,-21600,,
com.apple.iCal,13,1739481604,1739481617,1739481618.015007,-21600,,
com.leomehlig.today,3,1739481601,1739481604,1739481604.463756,-21600,,
com.apple.shortcuts,24,1739481422,1739481446,1739481446.3561149,-21600,EB445137-D7F5-57EC-87DA-1DB460D64046,"iPhone13,2"
com.apple.mobileslideshow,1,1739481418,1739481419,1739481419.8926601,-21600,EB445137-D7F5-57EC-87DA-1DB460D64046,"iPhone13,2"
com.google.Chrome,188,1739481413,1739481601,1739481601.649279,-21600,,
com.apple.mobileslideshow,8,1739481323,1739481331,1739481331.469726,-21600,EB445137-D7F5-57EC-87DA-1DB460D64046,"iPhone13,2"
com.instructure.icanvas,2,1739481313,1739481315,1739481316.007942,-21600,EB445137-D7F5-57EC-87DA-1DB460D64046,"iPhone13,2"
com.google.Chrome,2,1739480834,1739480836,1739480836.828922,-21600,,
com.apple.calculator,19,1739480815,1739480834,1739480834.4880319,-21600,,
com.google.Chrome,6,1739480809,1739480815,1739480815.82062,-21600,,
com.apple.calculator,37,1739480772,1739480809,1739480809.183589,-21600,,
com.google.Chrome,4,1739480768,1739480772,1739480772.662951,-21600,,
com.apple.calculator,24,1739480744,1739480768,1739480768.419179,-21600,,
com.google.Chrome,5,1739480739,1739480744,1739480744.0435739,-21600,,
com.apple.calculator,51,1739480688,1739480739,1739480739.9471679,-21600,,
com.google.Chrome,25,1739480663,1739480688,1739480688.66892,-21600,,
com.apple.calculator,10,1739480653,1739480663,1739480663.618497,-21600,,
com.google.Chrome,9,1739480644,1739480653,1739480653.592545,-21600,,
com.apple.calculator,13,1739480631,1739480644,1739480644.750138,-21600,,
com.google.Chrome,0,1739480631,1739480631,1739480631.867679,-21600,,
com.apple.calculator,3,1739480628,1739480631,1739480631.573528,-21600,,
com.google.Chrome,3,1739480625,1739480628,1739480629.021116,-21600,,
com.apple.calculator,11,1739480614,1739480625,1739480625.159812,-21600,,
com.google.Chrome,72,1739480542,1739480614,1739480614.746849,-21600,,
com.instructure.icanvas,63,1739480388,1739480451,1739480451.058248,-21600,EB445137-D7F5-57EC-87DA-1DB460D64046,"iPhone13,2"
com.intsig.CamScannerLite,1,1739480387,1739480388,1739480388.453514,-21600,EB445137-D7F5-57EC-87DA-1DB460D64046,"iPhone13,2"
com.apple.finder,215,1739480327,1739480542,1739480542.121172,-21600,,
com.google.Chrome,9,1739480318,1739480327,1739480327.096877,-21600,,
com.intsig.CamScannerLite,57,1739480280,1739480337,1739480337.687125,-21600,EB445137-D7F5-57EC-87DA-1DB460D64046,"iPhone13,2"
com.google.Chrome,377,1739479884,1739480261,1739480261.0651932,-21600,,
com.apple.calculator,33,1739479851,1739479884,1739479884.956162,-21600,,
com.google.Chrome,1,1739479850,1739479851,1739479851.483125,-21600,,
com.apple.calculator,0,1739479850,1739479850,1739479850.867001,-21600,,
com.google.Chrome,1,1739479849,1739479850,1739479850.132411,-21600,,
com.apple.calculator,15,1739479834,1739479849,1739479849.283616,-21600,,
com.google.Chrome,267,1739479567,1739479834,1739479834.819767,-21600,,
com.apple.calculator,46,1739479521,1739479567,1739479567.523456,-21600,,
com.google.Chrome,2,1739479519,1739479521,1739479521.678596,-21600,,
com.google.Chrome,327,1739479191,1739479518,1739479518.8418388,-21600,,
com.apple.calculator,43,1739479148,1739479191,1739479191.443949,-21600,,
com.google.Chrome,261,1739478887,1739479148,1739479148.973531,-21600,,
com.apple.calculator,371,1739478516,1739478887,1739478888.042046,-21600,,
com.google.Chrome,310,1739478206,1739478516,1739478516.491325,-21600,,
com.google.Chrome,301,1739477816,1739478117,1739478117.124546,-21600,,
com.google.Chrome,330,1739476873,1739477203,1739477203.106725,-21600,,
com.apple.Passwords,7,1739476866,1739476873,1739476873.690084,-21600,,
com.google.Chrome,21,1739476845,1739476866,1739476866.979298,-21600,,
com.google.Chrome,401,1739475186,1739475587,1739475587.094428,-21600,,
com.leomehlig.today,11,1739475175,1739475186,1739475186.850568,-21600,,
com.apple.Music,3,1739475103,1739475106,1739475106.5337548,-21600,EB445137-D7F5-57EC-87DA-1DB460D64046,"iPhone13,2"
com.apple.Music,8,1739473817,1739473825,1739473826.129875,-21600,EB445137-D7F5-57EC-87DA-1DB460D64046,"iPhone13,2"
com.apple.mobiletimer,5,1739473812,1739473817,1739473817.275327,-21600,EB445137-D7F5-57EC-87DA-1DB460D64046,"iPhone13,2"
com.apple.mobiletimer,38,1739473403,1739473441,1739473441.6675658,-21600,EB445137-D7F5-57EC-87DA-1DB460D64046,"iPhone13,2"
com.apple.mobiletimer,71,1739473279,1739473350,1739473351.7575212,-21600,EB445137-D7F5-57EC-87DA-1DB460D64046,"iPhone13,2"
com.apple.mobiletimer,90,1739473186,1739473276,1739473276.7656112,-21600,EB445137-D7F5-57EC-87DA-1DB460D64046,"iPhone13,2"
com.apple.Music,6,1739473180,1739473186,1739473186.459383,-21600,EB445137-D7F5-57EC-87DA-1DB460D64046,"iPhone13,2"
com.apple.Music,1,1739473179,1739473180,1739473180.820018,-21600,EB445137-D7F5-57EC-87DA-1DB460D64046,"iPhone13,2"
com.apple.Music,37,1739472931,1739472968,1739472968.933457,-21600,EB445137-D7F5-57EC-87DA-1DB460D64046,"iPhone13,2"
com.hammerandchisel.discord,0,1739472931,1739472931,1739472931.675651,-21600,EB445137-D7F5-57EC-87DA-1DB460D64046,"iPhone13,2"
com.hammerandchisel.discord,21,1739472910,1739472931,1739472931.33323,-21600,EB445137-D7F5-57EC-87DA-1DB460D64046,"iPhone13,2"
com.apple.Health,66,1739472834,1739472900,1739472900.025751,-21600,EB445137-D7F5-57EC-87DA-1DB460D64046,"iPhone13,2"
com.apple.CoreAuthUI,2,1739472778,1739472780,1739472780.9101539,-21600,EB445137-D7F5-57EC-87DA-1DB460D64046,"iPhone13,2"
com.truebill.truebillnative,61,1739472773,1739472834,1739472834.3652291,-21600,EB445137-D7F5-57EC-87DA-1DB460D64046,"iPhone13,2"
com.apple.mobiletimer,3,1739472640,1739472643,1739472643.926996,-21600,EB445137-D7F5-57EC-87DA-1DB460D64046,"iPhone13,2"
com.apple.mobiletimer,5,1739472138,1739472143,1739472143.4688659,-21600,EB445137-D7F5-57EC-87DA-1DB460D64046,"iPhone13,2"
com.apple.mobiletimer,0,1739472138,1739472138,1739472139.0185308,-21600,EB445137-D7F5-57EC-87DA-1DB460D64046,"iPhone13,2"
com.apple.mobiletimer,39,1739471918,1739471957,1739471957.3496919,-21600,EB445137-D7F5-57EC-87DA-1DB460D64046,"iPhone13,2"
com.apple.news,47,1739471871,1739471918,1739471918.8275518,-21600,EB445137-D7F5-57EC-87DA-1DB460D64046,"iPhone13,2"
com.apple.mobiletimer,2,1739471869,1739471871,1739471871.2394161,-21600,EB445137-D7F5-57EC-87DA-1DB460D64046,"iPhone13,2"
com.apple.news,91,1739471778,1739471869,1739471869.809613,-21600,EB445137-D7F5-57EC-87DA-1DB460D64046,"iPhone13,2"
com.apple.mobiletimer,2,1739471776,1739471778,1739471778.9816089,-21600,EB445137-D7F5-57EC-87DA-1DB460D64046,"iPhone13,2"
com.apple.mobiletimer,2,1739471730,1739471732,1739471732.640724,-21600,EB445137-D7F5-57EC-87DA-1DB460D64046,"iPhone13,2"
com.apple.news,53,1739471677,1739471730,1739471730.7801862,-21600,EB445137-D7F5-57EC-87DA-1DB460D64046,"iPhone13,2"
com.apple.mobiletimer,1,1739471676,1739471677,1739471677.663172,-21600,EB445137-D7F5-57EC-87DA-1DB460D64046,"iPhone13,2"
com.apple.news,33,1739471643,1739471676,1739471676.3632622,-21600,EB445137-D7F5-57EC-87DA-1DB460D64046,"iPhone13,2"
com.leomehlig.today,4,1739469471,1739469475,1739469475.161844,-21600,,
com.google.Chrome,847,1739468624,1739469471,1739469471.91782,-21600,,
com.google.Chrome,341,1739468263,1739468604,1739468604.4286652,-21600,,
com.leomehlig.today,14,1739468249,1739468263,1739468263.811541,-21600,,
com.leomehlig.today,29,1739467524,1739467553,1739467553.798489,-21600,,
com.apple.finder,22,1739467502,1739467524,1739467524.9164739,-21600,,
com.apple.Notes,2,1739467500,1739467502,1739467502.630373,-21600,,
com.google.Chrome,96,1739467404,1739467500,1739467500.985776,-21600,,
com.apple.Notes,7,1739467397,1739467404,1739467404.893178,-21600,,
com.google.Chrome,4,1739467388,1739467392,1739467392.119275,-21600,,
com.electron.carta,12,1739467376,1739467388,1739467388.13662,-21600,,
com.google.Chrome,26,1739467350,1739467376,1739467376.067698,-21600,,
com.electron.carta,3,1739467347,1739467350,1739467350.9667969,-21600,,
com.google.Chrome,331,1739467016,1739467347,1739467347.953,-21600,,
com.electron.carta,1,1739467015,1739467016,1739467016.852174,-21600,,
com.jinzhenyu.ruler,1,1739467014,1739467015,1739467015.214432,-21600,,
com.google.Chrome,81,1739466933,1739467014,1739467014.323631,-21600,,
com.jinzhenyu.ruler,58,1739466875,1739466933,1739466933.532378,-21600,,
com.google.Chrome,4,1739466871,1739466875,1739466875.658705,-21600,,
com.jinzhenyu.ruler,110,1739466761,1739466871,1739466871.307445,-21600,,
com.electron.carta,81,1739466680,1739466761,1739466761.729419,-21600,,
com.jinzhenyu.ruler,4,1739466676,1739466680,1739466680.33013,-21600,,
com.google.Chrome,11,1739466665,1739466676,1739466676.621783,-21600,,
com.jinzhenyu.ruler,10,1739466655,1739466665,1739466665.811039,-21600,,
com.google.Chrome,9,1739466646,1739466655,1739466655.321276,-21600,,
com.jinzhenyu.ruler,16,1739466630,1739466646,1739466646.5067968,-21600,,
com.electron.carta,10,1739466620,1739466630,1739466630.226937,-21600,,
com.jinzhenyu.ruler,17,1739466603,1739466620,1739466620.1283588,-21600,,
com.electron.carta,3,1739466600,1739466603,1739466603.1002312,-21600,,
com.jinzhenyu.ruler,27,1739466573,1739466600,1739466600.659744,-21600,,
com.electron.carta,83,1739466490,1739466573,1739466573.602246,-21600,,
com.google.Chrome,30,1739466460,1739466490,1739466490.189214,-21600,,
com.electron.carta,11,1739466449,1739466460,1739466460.3162088,-21600,,
com.google.Chrome,42,1739466407,1739466449,1739466449.527889,-21600,,
com.electron.carta,432,1739465975,1739466407,1739466407.937562,-21600,,
com.jinzhenyu.ruler,0,1739465975,1739465975,1739465975.907263,-21600,,
com.electron.carta,2,1739465973,1739465975,1739465975.548009,-21600,,
com.apple.Preview,2,1739465971,1739465973,1739465973.226428,-21600,,
com.apple.finder,23,1739465948,1739465971,1739465971.233832,-21600,,
com.apple.Preview,17,1739465931,1739465948,1739465948.616076,-21600,,
com.apple.finder,25,1739465906,1739465931,1739465931.1263552,-21600,,
com.apple.Preview,4,1739465902,1739465906,1739465906.545495,-21600,,
com.electron.carta,11,1739465891,1739465902,1739465902.638887,-21600,,
com.google.Chrome,50,1739465841,1739465891,1739465891.6012459,-21600,,
com.leomehlig.today,22,1739465819,1739465841,1739465841.407562,-21600,,
com.google.Chrome,8,1739465811,1739465819,1739465819.182063,-21600,,
com.jinzhenyu.ruler,2,1739465809,1739465811,1739465811.935462,-21600,,
com.google.Chrome,37,1739465772,1739465809,1739465809.482759,-21600,,
com.jinzhenyu.ruler,15,1739465757,1739465772,1739465772.352992,-21600,,
com.google.Chrome,3,1739465754,1739465757,1739465757.4067369,-21600,,
com.jinzhenyu.ruler,21,1739465733,1739465754,1739465754.731339,-21600,,
com.electron.carta,107,1739465626,1739465733,1739465733.481343,-21600,,
com.jinzhenyu.ruler,7,1739465619,1739465626,1739465626.079437,-21600,,
com.electron.carta,2,1739465617,1739465619,1739465619.59699,-21600,,
com.google.Chrome,3,1739465614,1739465617,1739465617.362784,-21600,,
com.electron.carta,4,1739465610,1739465614,1739465614.451009,-21600,,
com.google.Chrome,4,1739465606,1739465610,1739465610.716546,-21600,,
com.jinzhenyu.ruler,11,1739465595,1739465606,1739465606.121523,-21600,,
com.google.Chrome,5,1739465590,1739465595,1739465595.511095,-21600,,
com.jinzhenyu.ruler,19,1739465571,1739465590,1739465590.218833,-21600,,
com.google.Chrome,8,1739465563,1739465571,1739465571.742327,-21600,,
com.jinzhenyu.ruler,19,1739465544,1739465563,1739465563.704298,-21600,,
com.electron.carta,108,1739465436,1739465544,1739465544.221472,-21600,,
com.google.Chrome,40,1739465396,1739465436,1739465436.4397411,-21600,,
com.apple.Preview,3,1739465393,1739465396,1739465396.4464278,-21600,,
com.electron.carta,1,1739465392,1739465393,1739465393.775258,-21600,,
com.apple.Preview,2,1739465390,1739465392,1739465392.9327831,-21600,,
com.electron.carta,20,1739465370,1739465390,1739465390.904283,-21600,,
com.google.Chrome,12,1739465358,1739465370,1739465370.3788319,-21600,,
com.electron.carta,278,1739465080,1739465358,1739465358.071916,-21600,,
com.apple.Preview,5,1739465075,1739465080,1739465080.891664,-21600,,
com.apple.finder,4,1739465071,1739465075,1739465075.083651,-21600,,
com.apple.Preview,1,1739465070,1739465071,1739465071.6151118,-21600,,
com.apple.finder,6,1739465064,1739465070,1739465070.870191,-21600,,
com.apple.Preview,14,1739465050,1739465064,1739465064.739321,-21600,,
com.google.Chrome,0,1739465050,1739465050,1739465050.841251,-21600,,
com.apple.Preview,2,1739465048,1739465050,1739465050.603966,-21600,,
com.apple.finder,13,1739465035,1739465048,1739465048.4761229,-21600,,
com.apple.Preview,4,1739465031,1739465035,1739465035.694953,-21600,,
com.electron.carta,7,1739465024,1739465031,1739465031.30577,-21600,,
com.jinzhenyu.ruler,1,1739465023,1739465024,1739465024.058209,-21600,,
com.electron.carta,1,1739465022,1739465023,1739465023.4213228,-21600,,
com.jinzhenyu.ruler,0,1739465022,1739465022,1739465022.884963,-21600,,
com.electron.carta,3,1739465019,1739465022,1739465022.626161,-21600,,
com.jinzhenyu.ruler,2,1739465017,1739465019,1739465019.251111,-21600,,
com.electron.carta,2,1739465015,1739465017,1739465017.7409868,-21600,,
com.google.Chrome,256,1739464759,1739465015,1739465015.229552,-21600,,
com.jinzhenyu.ruler,8,1739464751,1739464759,1739464759.066465,-21600,,
com.google.Chrome,11,1739464740,1739464751,1739464751.115755,-21600,,
com.jinzhenyu.ruler,29,1739464711,1739464740,1739464740.895855,-21600,,
com.electron.carta,10,1739464701,1739464711,1739464711.88294,-21600,,
com.google.Chrome,32,1739464669,1739464701,1739464701.510205,-21600,,
com.electron.carta,158,1739464511,1739464669,1739464669.171228,-21600,,
com.apple.Preview,4,1739464507,1739464511,1739464511.622241,-21600,,
com.electron.carta,24,1739464483,1739464507,1739464507.787506,-21600,,
com.google.Chrome,5,1739464478,1739464483,1739464483.237634,-21600,,
com.electron.carta,140,1739464338,1739464478,1739464479.029839,-21600,,
com.jinzhenyu.ruler,3,1739464335,1739464338,1739464338.9455628,-21600,,
com.electron.carta,4,1739464331,1739464335,1739464335.943883,-21600,,
com.google.Chrome,4,1739464327,1739464331,1739464331.088651,-21600,,
com.apple.Preview,4,1739464323,1739464327,1739464327.7098222,-21600,,
com.google.Chrome,4,1739464319,1739464323,1739464323.581084,-21600,,
com.apple.Preview,3,1739464316,1739464319,1739464319.906754,-21600,,
com.apple.finder,8,1739464308,1739464316,1739464316.6505141,-21600,,
com.apple.Preview,1,1739464307,1739464308,1739464308.614221,-21600,,
com.apple.finder,3,1739464304,1739464307,1739464307.388434,-21600,,
com.apple.Preview,7,1739464297,1739464304,1739464304.3389502,-21600,,
com.electron.carta,7,1739464290,1739464297,1739464297.926457,-21600,,
com.google.Chrome,56,1739464234,1739464290,1739464290.0533319,-21600,,
com.jinzhenyu.ruler,16,1739464218,1739464234,1739464234.446286,-21600,,
com.google.Chrome,6,1739464212,1739464218,1739464218.532166,-21600,,
com.jinzhenyu.ruler,17,1739464195,1739464212,1739464212.299592,-21600,,
com.electron.carta,66,1739464129,1739464195,1739464195.515952,-21600,,
com.jinzhenyu.ruler,15,1739464114,1739464129,1739464129.476156,-21600,,
com.google.Chrome,8,1739464106,1739464114,1739464114.141489,-21600,,
com.jinzhenyu.ruler,26,1739464080,1739464106,1739464106.985973,-21600,,
com.electron.carta,3,1739464077,1739464080,1739464080.4261332,-21600,,
com.google.Chrome,13,1739464064,1739464077,1739464077.034621,-21600,,
com.electron.carta,1,1739464063,1739464064,1739464064.329076,-21600,,
com.jinzhenyu.ruler,25,1739464038,1739464063,1739464063.187592,-21600,,
com.electron.carta,136,1739463902,1739464038,1739464038.9068909,-21600,,
com.google.Chrome,26,1739463876,1739463902,1739463902.422874,-21600,,
com.electron.carta,61,1739463815,1739463876,1739463876.3067598,-21600,,
com.google.Chrome,21,1739463794,1739463815,1739463815.602829,-21600,,
com.electron.carta,59,1739463735,1739463794,1739463794.114603,-21600,,
com.apple.Preview,5,1739463730,1739463735,1739463735.265737,-21600,,
com.electron.carta,7,1739463723,1739463730,1739463730.239665,-21600,,
com.google.Chrome,24,1739463699,1739463723,1739463723.135633,-21600,,
com.electron.carta,81,1739463618,1739463699,1739463699.9496698,-21600,,
com.apple.Music,53,1739463565,1739463618,1739463618.912706,-21600,,
com.electron.carta,112,1739463453,1739463565,1739463566.013582,-21600,,
com.apple.Preview,8,1739463445,1739463453,1739463453.662355,-21600,,
com.google.Chrome,1,1739463444,1739463445,1739463445.141886,-21600,,
com.apple.Preview,5,1739463439,1739463444,1739463444.4089909,-21600,,
com.apple.finder,14,1739463425,1739463439,1739463439.999886,-21600,,
com.electron.carta,13,1739463412,1739463425,1739463425.3279262,-21600,,
com.jinzhenyu.ruler,4,1739463408,1739463412,1739463412.270247,-21600,,
com.google.Chrome,133,1739463275,1739463408,1739463408.432746,-21600,,
com.electron.carta,1,1739463274,1739463275,1739463275.675659,-21600,,
com.jinzhenyu.ruler,12,1739463262,1739463274,1739463274.071588,-21600,,
com.electron.carta,3,1739463259,1739463262,1739463262.257544,-21600,,
com.google.Chrome,25,1739463234,1739463259,1739463259.221662,-21600,,
com.jinzhenyu.ruler,20,1739463214,1739463234,1739463234.8122392,-21600,,
com.google.Chrome,49,1739463165,1739463214,1739463214.40656,-21600,,
com.electron.carta,86,1739463079,1739463165,1739463165.155469,-21600,,
com.jinzhenyu.ruler,5,1739463074,1739463079,1739463079.2339659,-21600,,
com.google.Chrome,6,1739463068,1739463074,1739463074.924479,-21600,,
com.jinzhenyu.ruler,12,1739463056,1739463068,1739463068.279488,-21600,,
com.google.Chrome,3,1739463053,1739463056,1739463056.531687,-21600,,
com.jinzhenyu.ruler,1,1739463052,1739463053,1739463053.376536,-21600,,
com.electron.carta,5,1739463047,1739463052,1739463052.7879062,-21600,,
com.jinzhenyu.ruler,3,1739463044,1739463047,1739463047.3767319,-21600,,
com.electron.carta,1,1739463043,1739463044,1739463044.6068501,-21600,,
com.jinzhenyu.ruler,5,1739463038,1739463043,1739463043.466392,-21600,,
com.google.Chrome,3,1739463035,1739463038,1739463038.4919062,-21600,,
com.electron.carta,62,1739462973,1739463035,1739463035.263531,-21600,,
com.apple.Preview,13,1739462960,1739462973,1739462973.9233909,-21600,,
com.electron.carta,48,1739462912,1739462960,1739462960.207257,-21600,,
com.jinzhenyu.ruler,4,1739462908,1739462912,1739462912.534398,-21600,,
com.google.Chrome,93,1739462815,1739462908,1739462908.434041,-21600,,
com.jinzhenyu.ruler,14,1739462801,1739462815,1739462815.552428,-21600,,
com.google.Chrome,8,1739462793,1739462801,1739462801.422017,-21600,,
com.jinzhenyu.ruler,53,1739462740,1739462793,1739462793.668875,-21600,,
com.electron.carta,130,1739462610,1739462740,1739462740.131913,-21600,,
com.jinzhenyu.ruler,8,1739462602,1739462610,1739462610.176569,-21600,,
com.google.Chrome,33,1739462569,1739462602,1739462602.11499,-21600,,
com.apple.MobileSMS,134,1739462435,1739462569,1739462569.963735,-21600,,
com.google.Chrome,11,1739462424,1739462435,1739462435.2967172,-21600,,
com.electron.carta,13,1739462411,1739462424,1739462425.070088,-21600,,
com.jinzhenyu.ruler,3,1739462408,1739462411,1739462411.372185,-21600,,
com.electron.carta,3,1739462405,1739462408,1739462408.1697621,-21600,,
com.jinzhenyu.ruler,3,1739462402,1739462405,1739462405.951422,-21600,,
com.electron.carta,25,1739462377,1739462402,1739462402.436692,-21600,,
com.google.Chrome,9,1739462368,1739462377,1739462378.043209,-21600,,
com.electron.carta,74,1739462294,1739462368,1739462368.481328,-21600,,
com.google.Chrome,28,1739462266,1739462294,1739462294.747359,-21600,,
com.electron.carta,61,1739462205,1739462266,1739462266.490957,-21600,,
com.google.Chrome,32,1739462173,1739462205,1739462205.6258821,-21600,,
com.apple.Preview,10,1739462163,1739462173,1739462173.455524,-21600,,
com.electron.carta,9,1739462154,1739462163,1739462163.253561,-21600,,
com.apple.Preview,4,1739462150,1739462154,1739462154.811594,-21600,,
com.electron.carta,305,1739461845,1739462150,1739462150.8181748,-21600,,
com.google.Chrome,11,1739461834,1739461845,1739461845.82041,-21600,,
com.apple.Preview,23,1739461811,1739461834,1739461834.389816,-21600,,
com.google.Chrome,11,1739461800,1739461811,1739461811.4352798,-21600,,
com.apple.Preview,3,1739461797,1739461800,1739461800.2304292,-21600,,
com.electron.carta,49,1739461748,1739461797,1739461797.103611,-21600,,
com.apple.Preview,2,1739461746,1739461748,1739461748.6012158,-21600,,
com.electron.carta,3,1739461743,1739461746,1739461746.313194,-21600,,
com.apple.Preview,37,1739461706,1739461743,1739461743.8641849,-21600,,
com.jinzhenyu.ruler,1,1739461705,1739461706,1739461706.195353,-21600,,
com.apple.Preview,21,1739461684,1739461705,1739461705.739161,-21600,,
com.google.Chrome,24,1739461660,1739461684,1739461684.132613,-21600,,
com.electron.carta,7,1739461653,1739461660,1739461660.561959,-21600,,
com.apple.Preview,1,1739461652,1739461653,1739461653.432969,-21600,,
com.jinzhenyu.ruler,1,1739461651,1739461652,1739461652.545336,-21600,,
com.apple.Preview,1,1739461650,1739461651,1739461652.0057158,-21600,,
com.google.Chrome,13,1739461637,1739461650,1739461650.619389,-21600,,
com.apple.Preview,22,1739461615,1739461637,1739461637.714633,-21600,,
com.apple.finder,2,1739461613,1739461615,1739461615.435639,-21600,,
com.electron.carta,21,1739461592,1739461613,1739461613.7834392,-21600,,
com.jinzhenyu.ruler,4,1739461588,1739461592,1739461592.885174,-21600,,
com.electron.carta,4,1739461584,1739461588,1739461588.993155,-21600,,
com.apple.finder,5,1739461579,1739461584,1739461584.929356,-21600,,
com.apple.Preview,9,1739461570,1739461579,1739461579.2428288,-21600,,
com.electron.carta,21,1739461549,1739461570,1739461570.610405,-21600,,
com.google.Chrome,30,1739461519,1739461549,1739461549.065987,-21600,,
com.jinzhenyu.ruler,2,1739461517,1739461519,1739461519.664936,-21600,,
com.google.Chrome,11,1739461506,1739461517,1739461517.9247131,-21600,,
com.jinzhenyu.ruler,46,1739461460,1739461506,1739461506.4373698,-21600,,
com.electron.carta,80,1739461380,1739461460,1739461460.3307571,-21600,,
com.jinzhenyu.ruler,5,1739461375,1739461380,1739461380.7575932,-21600,,
com.electron.carta,13,1739461362,1739461375,1739461375.206308,-21600,,
com.jinzhenyu.ruler,11,1739461351,1739461362,1739461362.208987,-21600,,
com.google.Chrome,0,1739461351,1739461351,1739461351.884743,-21600,,
com.electron.carta,2,1739461349,1739461351,1739461351.338776,-21600,,
com.google.Chrome,183,1739461166,1739461349,1739461349.984751,-21600,,
com.jinzhenyu.ruler,24,1739461142,1739461166,1739461167.0484328,-21600,,
com.google.Chrome,28,1739461114,1739461142,1739461142.805095,-21600,,
com.electron.carta,41,1739461073,1739461114,1739461115.075156,-21600,,
com.jinzhenyu.ruler,7,1739461066,1739461073,1739461073.484294,-21600,,
com.electron.carta,2,1739461064,1739461066,1739461067.0318131,-21600,,
com.jinzhenyu.ruler,1,1739461063,1739461064,1739461064.588577,-21600,,
com.electron.carta,2,1739461061,1739461063,1739461063.475274,-21600,,
com.jinzhenyu.ruler,21,1739461040,1739461061,1739461061.083479,-21600,,
com.electron.carta,304,1739460736,1739461040,1739461040.813353,-21600,,
com.jinzhenyu.ruler,5,1739460731,1739460736,1739460736.153092,-21600,,
com.google.Chrome,446,1739460285,1739460731,1739460731.8787432,-21600,,
com.jinzhenyu.ruler,3,1739460282,1739460285,1739460285.756671,-21600,,
com.google.Chrome,18,1739460264,1739460282,1739460282.509094,-21600,,
com.jinzhenyu.ruler,26,1739460238,1739460264,1739460264.361992,-21600,,
com.electron.carta,3,1739460235,1739460238,1739460238.510942,-21600,,
com.google.Chrome,182,1739460053,1739460235,1739460236.024154,-21600,,
com.electron.carta,3,1739460050,1739460053,1739460053.601728,-21600,,
com.google.Chrome,33,1739460017,1739460050,1739460050.704776,-21600,,
com.electron.carta,15,1739460002,1739460017,1739460017.9658709,-21600,,
com.jinzhenyu.ruler,4,1739459998,1739460002,1739460002.2525039,-21600,,
com.electron.carta,42,1739459956,1739459998,1739459998.357564,-21600,,
com.jinzhenyu.ruler,6,1739459950,1739459956,1739459956.362091,-21600,,
com.electron.carta,0,1739459950,1739459950,1739459950.610816,-21600,,
com.jinzhenyu.ruler,1,1739459949,1739459950,1739459950.081644,-21600,,
com.electron.carta,6,1739459943,1739459949,1739459949.998277,-21600,,
com.jinzhenyu.ruler,1,1739459942,1739459943,1739459944.002039,-21600,,
com.electron.carta,4,1739459938,1739459942,1739459942.197455,-21600,,
com.jinzhenyu.ruler,2,1739459936,1739459938,1739459938.6523619,-21600,,
com.electron.carta,156,1739459780,1739459936,1739459936.06021,-21600,,
com.jinzhenyu.ruler,55,1739459725,1739459780,1739459780.431354,-21600,,
com.electron.carta,1,1739459724,1739459725,1739459725.877454,-21600,,
com.jinzhenyu.ruler,52,1739459672,1739459724,1739459724.159474,-21600,,
com.electron.carta,3,1739459669,1739459672,1739459672.170082,-21600,,
com.jinzhenyu.ruler,18,1739459651,1739459669,1739459669.8922691,-21600,,
com.electron.carta,301,1739459350,1739459651,1739459651.1625528,-21600,,
com.apple.finder,4,1739459346,1739459350,1739459350.527762,-21600,,
com.apple.Preview,3,1739459343,1739459346,1739459346.600837,-21600,,
com.google.Chrome,6,1739459337,1739459343,1739459343.7115211,-21600,,
com.apple.Notes,0,1739459337,1739459337,1739459337.93169,-21600,,
com.google.Chrome,21,1739459316,1739459337,1739459337.564816,-21600,,
com.apple.Notes,3,1739459313,1739459316,1739459316.506978,-21600,,
com.google.Chrome,34,1739459279,1739459313,1739459313.4802032,-21600,,
com.apple.Preview,12,1739459267,1739459279,1739459279.633915,-21600,,
com.apple.finder,38,1739459229,1739459267,1739459267.644527,-21600,,
com.google.Chrome,5,1739459224,1739459229,1739459229.401781,-21600,,
com.apple.finder,17,1739459207,1739459224,1739459224.199314,-21600,,
com.google.Chrome,4,1739459203,1739459207,1739459207.434064,-21600,,
com.apple.finder,30,1739459173,1739459203,1739459203.283766,-21600,,
com.google.Chrome,30,1739459143,1739459173,1739459173.184828,-21600,,
com.apple.Notes,6,1739459137,1739459143,1739459144.061966,-21600,,
com.google.Chrome,2,1739459135,1739459137,1739459137.617838,-21600,,
com.apple.Notes,6,1739459129,1739459135,1739459135.1411738,-21600,,
com.google.Chrome,354,1739458775,1739459129,1739459130.0812879,-21600,,
com.apple.finder,3,1739458772,1739458775,1739458775.282188,-21600,,
com.google.Chrome,22,1739458750,1739458772,1739458772.445016,-21600,,
com.apple.keychainaccess,19,1739458709,1739458728,1739458728.4189792,-21600,,
com.apple.finder,240,1739458467,1739458707,1739458707.976914,-21600,,
com.apple.finder,5,1739420144,1739420149,1739420149.30618,-21600,,
com.microsoft.VSCode,297,1739419847,1739420144,1739420145.071804,-21600,,
com.google.Chrome,102,1739419745,1739419847,1739419847.807129,-21600,,
com.microsoft.VSCode,187,1739419558,1739419745,1739419745.788159,-21600,,
com.leomehlig.today,135,1739419423,1739419558,1739419558.8975291,-21600,,
com.microsoft.VSCode,12,1739419411,1739419423,1739419423.5341501,-21600,,
com.apple.finder,5,1739419406,1739419411,1739419411.530437,-21600,,
com.google.Chrome,2,1739419404,1739419406,1739419406.6849508,-21600,,
com.electron.carta,2,1739419402,1739419404,1739419404.439845,-21600,,
com.google.Chrome,6,1739419396,1739419402,1739419402.6435928,-21600,,
com.apple.Notes,149,1739419247,1739419396,1739419396.709605,-21600,,
com.google.Chrome,232,1739419015,1739419247,1739419248.032471,-21600,,
com.apple.finder,13,1739418982,1739418995,1739418995.764557,-21600,,
com.google.Chrome,246,1739418736,1739418982,1739418982.730082,-21600,,
com.apple.finder,7,1739418729,1739418736,1739418736.443013,-21600,,
com.google.Chrome,8,1739418721,1739418729,1739418729.304676,-21600,,
com.apple.finder,13,1739418708,1739418721,1739418721.4380631,-21600,,
com.google.Chrome,3,1739418705,1739418708,1739418708.586731,-21600,,
com.apple.finder,1,1739418704,1739418705,1739418705.7104468,-21600,,
com.google.Chrome,23,1739418681,1739418704,1739418704.335278,-21600,,
com.apple.finder,12,1739418669,1739418681,1739418681.542248,-21600,,
com.google.Chrome,5,1739418664,1739418669,1739418669.4109988,-21600,,
com.apple.finder,2,1739418662,1739418664,1739418664.934208,-21600,,
com.google.Chrome,36,1739418626,1739418662,1739418662.40399,-21600,,
com.apple.finder,16,1739418610,1739418626,1739418626.815686,-21600,,
com.apple.Preview,17,1739418593,1739418610,1739418610.4898372,-21600,,
com.google.Chrome,46,1739418547,1739418593,1739418593.581105,-21600,,
com.apple.finder,9,1739418538,1739418547,1739418547.191926,-21600,,
com.google.Chrome,12,1739418526,1739418538,1739418538.545308,-21600,,
com.apple.finder,18,1739418508,1739418526,1739418526.0550861,-21600,,
com.google.Chrome,2,1739418506,1739418508,1739418508.821693,-21600,,
com.apple.finder,1,1739418505,1739418506,1739418506.860554,-21600,,
com.google.Chrome,7,1739418498,1739418505,1739418505.64952,-21600,,
com.electron.carta,21,1739418477,1739418498,1739418498.147243,-21600,,
com.google.Chrome,320,1739418157,1739418477,1739418477.5168428,-21600,,
com.cisco.secureclient.gui,8,1739418149,1739418157,1739418157.209832,-21600,,
com.apple.Notes,33,1739418116,1739418149,1739418149.5607672,-21600,,
com.google.Chrome,43,1739418073,1739418116,1739418116.2449942,-21600,,
com.apple.Notes,13,1739418060,1739418073,1739418073.201993,-21600,,
com.google.Chrome,94,1739417966,1739418060,1739418060.3316932,-21600,,
com.apple.Preview,30,1739417936,1739417966,1739417966.3472,-21600,,
com.apple.finder,12,1739417924,1739417936,1739417936.490131,-21600,,
com.google.Chrome,66,1739417858,1739417924,1739417924.796993,-21600,,
com.electron.carta,11,1739417847,1739417858,1739417858.902262,-21600,,
com.google.Chrome,20,1739417827,1739417847,1739417847.334446,-21600,,
com.electron.carta,74,1739417753,1739417827,1739417827.6049361,-21600,,
com.jinzhenyu.ruler,1,1739417752,1739417753,1739417753.659857,-21600,,
com.electron.carta,6,1739417746,1739417752,1739417752.262209,-21600,,
com.jinzhenyu.ruler,3,1739417743,1739417746,1739417746.430429,-21600,,
com.electron.carta,28,1739417715,1739417743,1739417743.4170542,-21600,,
com.apple.Notes,59,1739417656,1739417715,1739417715.778578,-21600,,
com.electron.carta,54,1739417602,1739417656,1739417657.017964,-21600,,
com.apple.Notes,33,1739417569,1739417602,1739417602.40744,-21600,,
com.google.Chrome,32,1739417537,1739417569,1739417569.113117,-21600,,
com.apple.Notes,29,1739417508,1739417537,1739417537.97781,-21600,,
com.electron.carta,37,1739417471,1739417508,1739417508.966264,-21600,,
com.jinzhenyu.ruler,101,1739417370,1739417471,1739417471.343244,-21600,,
com.electron.carta,6,1739417364,1739417370,1739417370.808694,-21600,,
com.jinzhenyu.ruler,8,1739417356,1739417364,1739417364.5329309,-21600,,
com.electron.carta,9,1739417347,1739417356,1739417356.1413121,-21600,,
com.jinzhenyu.ruler,0,1739417347,1739417347,1739417347.605247,-21600,,
com.electron.carta,3,1739417344,1739417347,1739417347.4985309,-21600,,
com.jinzhenyu.ruler,11,1739417333,1739417344,1739417344.275786,-21600,,
com.electron.carta,1,1739417332,1739417333,1739417333.910283,-21600,,
com.jinzhenyu.ruler,7,1739417325,1739417332,1739417332.185483,-21600,,
com.electron.carta,34,1739417291,1739417325,1739417325.208247,-21600,,
com.jinzhenyu.ruler,24,1739417267,1739417291,1739417291.7263222,-21600,,
com.apple.AppStore,6,1739417261,1739417267,1739417267.148861,-21600,,
com.jinzhenyu.ruler,4,1739417257,1739417261,1739417261.9644,-21600,,
com.electron.carta,2,1739417255,1739417257,1739417257.4671788,-21600,,
com.jinzhenyu.ruler,6,1739417249,1739417255,1739417256.021419,-21600,,
com.apple.AppStore,0,1739417249,1739417249,1739417249.6804929,-21600,,
com.jinzhenyu.ruler,0,1739417249,1739417249,1739417249.5508242,-21600,,
com.apple.AppStore,1,1739417248,1739417249,1739417249.365984,-21600,,
com.electron.carta,42,1739417206,1739417248,1739417248.676128,-21600,,
com.apple.AppStore,6,1739417200,1739417206,1739417206.883411,-21600,,
com.google.Chrome,14,1739417168,1739417182,1739417182.073563,-21600,,
com.electron.carta,35,1739417133,1739417168,1739417168.9368892,-21600,,
com.google.Chrome,84,1739417049,1739417133,1739417134.021544,-21600,,
com.electron.carta,24,1739417025,1739417049,1739417049.334855,-21600,,
com.google.Chrome,90,1739416935,1739417025,1739417025.313901,-21600,,
com.electron.carta,245,1739416690,1739416935,1739416935.325529,-21600,,
com.apple.Notes,11,1739416679,1739416690,1739416690.478857,-21600,,
com.electron.carta,22,1739416657,1739416679,1739416679.889379,-21600,,
com.apple.Notes,18,1739416639,1739416657,1739416658.047787,-21600,,
com.electron.carta,13,1739416626,1739416639,1739416639.8469582,-21600,,
com.apple.Notes,25,1739416601,1739416626,1739416626.220608,-21600,,
com.electron.carta,32,1739416569,1739416601,1739416601.544858,-21600,,
com.apple.Notes,9,1739416560,1739416569,1739416569.8461452,-21600,,
com.electron.carta,132,1739416428,1739416560,1739416560.3245559,-21600,,
com.apple.Preview,5,1739416423,1739416428,1739416428.747926,-21600,,
com.electron.carta,26,1739416397,1739416423,1739416423.1304069,-21600,,
com.apple.finder,5,1739416392,1739416397,1739416397.173799,-21600,,
com.microsoft.VSCode,59,1739416333,1739416392,1739416392.4319968,-21600,,
com.apple.finder,6,1739416327,1739416333,1739416333.187217,-21600,,
com.microsoft.VSCode,1,1739416326,1739416327,1739416327.9158459,-21600,,
com.apple.finder,3,1739416323,1739416326,1739416327.0008988,-21600,,
com.microsoft.VSCode,156,1739416167,1739416323,1739416323.244374,-21600,,
com.apple.finder,3,1739416164,1739416167,1739416167.0502892,-21600,,
com.microsoft.VSCode,2,1739416162,1739416164,1739416164.746933,-21600,,
com.apple.finder,5,1739416157,1739416162,1739416162.738164,-21600,,
com.microsoft.VSCode,15,1739416142,1739416157,1739416157.949893,-21600,,
com.apple.finder,21,1739416121,1739416142,1739416142.231975,-21600,,
com.microsoft.VSCode,12,1739416109,1739416121,1739416121.1314158,-21600,,
com.cisco.secureclient.gui,41,1739416068,1739416109,1739416109.9096289,-21600,,
com.microsoft.VSCode,470,1739415598,1739416068,1739416068.93355,-21600,,
com.electron.carta,82,1739415516,1739415598,1739415598.912072,-21600,,
com.apple.Preview,19,1739415497,1739415516,1739415516.9878678,-21600,,
com.apple.finder,3,1739415494,1739415497,1739415497.8989,-21600,,
com.apple.Notes,112,1739415382,1739415494,1739415494.298976,-21600,,
com.electron.carta,115,1739415267,1739415382,1739415382.867146,-21600,,
com.apple.finder,128,1739415139,1739415267,1739415267.841292,-21600,,
com.microsoft.VSCode,7,1739415132,1739415139,1739415139.790402,-21600,,
com.apple.finder,19,1739415113,1739415132,1739415132.816328,-21600,,
com.microsoft.VSCode,651,1739414462,1739415113,1739415114.017672,-21600,,
com.apple.finder,5,1739414457,1739414462,1739414462.639246,-21600,,
com.microsoft.VSCode,20,1739414437,1739414457,1739414457.501437,-21600,,
com.apple.finder,6,1739414431,1739414437,1739414437.525985,-21600,,
com.microsoft.VSCode,18,1739414413,1739414431,1739414432.009985,-21600,,
com.apple.finder,1,1739414412,1739414413,1739414413.617074,-21600,,
com.microsoft.VSCode,35,1739414377,1739414412,1739414412.1903172,-21600,,
com.apple.finder,14,1739414363,1739414377,1739414377.1011019,-21600,,
com.microsoft.VSCode,19,1739414344,1739414363,1739414363.1046019,-21600,,
com.apple.finder,164,1739414180,1739414344,1739414344.424628,-21600,,
com.apple.Notes,3,1739414177,1739414180,1739414180.5109649,-21600,,
com.electron.carta,9,1739414168,1739414177,1739414177.4226751,-21600,,
com.apple.finder,38,1739414130,1739414168,1739414168.229846,-21600,,
com.apple.Notes,13,1739414117,1739414130,1739414130.7427511,-21600,,
com.microsoft.VSCode,6,1739414111,1739414117,1739414117.934969,-21600,,
com.apple.finder,1,1739414110,1739414111,1739414111.972173,-21600,,
com.microsoft.VSCode,10,1739414100,1739414110,1739414110.625536,-21600,,
com.apple.finder,5,1739414095,1739414100,1739414100.171031,-21600,,
com.google.Chrome,6,1739414089,1739414095,1739414095.273658,-21600,,
com.apple.Notes,3,1739414086,1739414089,1739414089.890277,-21600,,
com.google.Chrome,2,1739414084,1739414086,1739414086.301142,-21600,,
com.microsoft.VSCode,1,1739414083,1739414084,1739414084.264683,-21600,,
com.apple.Notes,6,1739414077,1739414083,1739414083.593165,-21600,,
com.leomehlig.today,1,1739414076,1739414077,1739414077.4389381,-21600,,
com.apple.Notes,2,1739414074,1739414076,1739414076.203278,-21600,,
com.apple.iCal,0,1739414074,1739414074,1739414074.9422312,-21600,,
com.microsoft.VSCode,5,1739414069,1739414074,1739414074.622847,-21600,,
com.apple.Notes,19,1739414050,1739414069,1739414069.837582,-21600,,
com.microsoft.VSCode,43,1739414007,1739414050,1739414050.4303632,-21600,,
com.leomehlig.today,17,1739413972,1739413989,1739413989.35607,-21600,,
com.microsoft.VSCode,288,1739413684,1739413972,1739413972.5702338,-21600,,
com.google.Chrome,2,1739413682,1739413684,1739413684.1172562,-21600,,
com.microsoft.VSCode,1,1739413681,1739413682,1739413682.631878,-21600,,
com.google.Chrome,1,1739413680,1739413681,1739413681.410081,-21600,,
com.microsoft.VSCode,1,1739413679,1739413680,1739413680.624248,-21600,,
com.google.Chrome,1,1739413678,1739413679,1739413679.715341,-21600,,
com.microsoft.VSCode,2,1739413676,1739413678,1739413678.4135718,-21600,,
com.google.Chrome,3,1739413673,1739413676,1739413676.176863,-21600,,
com.microsoft.VSCode,2,1739413671,1739413673,1739413673.737318,-21600,,
com.google.Chrome,0,1739413671,1739413671,1739413671.80374,-21600,,
com.microsoft.VSCode,6,1739413665,1739413671,1739413671.358041,-21600,,
com.google.Chrome,1,1739413664,1739413665,1739413665.731875,-21600,,
com.apple.iCal,1,1739413663,1739413664,1739413664.151262,-21600,,
com.google.Chrome,3,1739413660,1739413663,1739413663.1492682,-21600,,
com.apple.iCal,1,1739413659,1739413660,1739413660.488879,-21600,,
com.google.Chrome,1,1739413658,1739413659,1739413659.4030519,-21600,,
com.apple.iCal,2,1739413656,1739413658,1739413658.176587,-21600,,
com.microsoft.VSCode,47,1739413609,1739413656,1739413656.714589,-21600,,
com.apple.iCal,3,1739413606,1739413609,1739413609.226482,-21600,,
com.microsoft.VSCode,11,1739413595,1739413606,1739413606.5271978,-21600,,
com.apple.iCal,1,1739413594,1739413595,1739413595.0857248,-21600,,
com.google.Chrome,23,1739413571,1739413594,1739413594.05543,-21600,,
com.apple.iCal,2,1739413569,1739413571,1739413571.059783,-21600,,
com.microsoft.VSCode,130,1739413439,1739413569,1739413569.399878,-21600,,
com.apple.iCal,6,1739413433,1739413439,1739413439.090647,-21600,,
com.microsoft.VSCode,10,1739413423,1739413433,1739413433.0882912,-21600,,
com.google.Chrome,12,1739413411,1739413423,1739413423.1341,-21600,,
com.microsoft.VSCode,4,1739413407,1739413411,1739413411.340781,-21600,,
com.google.Chrome,38,1739413369,1739413407,1739413407.914062,-21600,,
com.apple.iCal,1,1739413368,1739413369,1739413369.442266,-21600,,
com.microsoft.VSCode,11,1739413357,1739413368,1739413368.501848,-21600,,
com.apple.iCal,6,1739413351,1739413357,1739413357.638722,-21600,,
com.microsoft.VSCode,2,1739413349,1739413351,1739413351.495991,-21600,,
com.google.Chrome,44,1739413305,1739413349,1739413349.642695,-21600,,
com.microsoft.VSCode,5,1739413300,1739413305,1739413306.005326,-21600,,
com.google.Chrome,5,1739413295,1739413300,1739413300.891372,-21600,,
com.microsoft.VSCode,45,1739413250,1739413295,1739413295.605166,-21600,,
com.google.Chrome,103,1739413147,1739413250,1739413251.038224,-21600,,
com.microsoft.VSCode,3,1739413144,1739413147,1739413147.135188,-21600,,
com.google.Chrome,32,1739413112,1739413144,1739413144.062952,-21600,,
com.apple.iCal,22,1739413090,1739413112,1739413112.897739,-21600,,
com.google.Chrome,36,1739413054,1739413090,1739413090.452901,-21600,,
com.apple.iCal,1,1739413053,1739413054,1739413054.671632,-21600,,
com.microsoft.VSCode,7,1739413046,1739413053,1739413053.455107,-21600,,
com.apple.iCal,3,1739413043,1739413046,1739413046.826477,-21600,,
com.google.Chrome,90,1739412953,1739413043,1739413043.8421059,-21600,,
com.apple.iCal,226,1739412727,1739412953,1739412953.290509,-21600,,
org.name.serializdmobile,85,1739412641,1739412726,1739412726.840294,-21600,EB445137-D7F5-57EC-87DA-1DB460D64046,"iPhone13,2"
com.apple.Music,2,1739412578,1739412580,1739412580.545361,-21600,EB445137-D7F5-57EC-87DA-1DB460D64046,"iPhone13,2"
com.google.Chrome,166,1739412561,1739412727,1739412727.306083,-21600,,
com.microsoft.VSCode,98,1739412463,1739412561,1739412561.3978748,-21600,,
com.google.Chrome,7,1739412456,1739412463,1739412463.577846,-21600,,
com.apple.finder,8,1739412448,1739412456,1739412456.8007,-21600,,
com.google.Chrome,5,1739412443,1739412448,1739412448.24241,-21600,,
com.apple.Music,1,1739412125,1739412126,1739412126.888139,-21600,EB445137-D7F5-57EC-87DA-1DB460D64046,"iPhone13,2"
com.google.Chrome,507,1739410362,1739410869,1739410869.851527,-21600,,
com.apple.Music,12,1739410012,1739410024,1739410024.357868,-21600,EB445137-D7F5-57EC-87DA-1DB460D64046,"iPhone13,2"
com.apple.Music,2,1739409145,1739409147,1739409147.778903,-21600,EB445137-D7F5-57EC-87DA-1DB460D64046,"iPhone13,2"
com.apple.Music,17,1739409121,1739409138,1739409139.358975,-21600,EB445137-D7F5-57EC-87DA-1DB460D64046,"iPhone13,2"
com.apple.mobilenotes,1,1739408382,1739408383,1739408384.160705,-21600,EB445137-D7F5-57EC-87DA-1DB460D64046,"iPhone13,2"
com.google.Chrome,13,1739408344,1739408357,1739408357.288528,-21600,,
com.apple.finder,3,1739408341,1739408344,1739408344.063654,-21600,,
com.apple.Notes,2,1739408339,1739408341,1739408341.254235,-21600,,
com.apple.finder,2,1739408337,1739408339,1739408339.263239,-21600,,
com.microsoft.Outlook,1,1739408336,1739408337,1739408337.7382689,-21600,,
com.apple.Preview,7,1739408329,1739408336,1739408337.029508,-21600,,
com.apple.finder,3,1739408326,1739408329,1739408329.4317322,-21600,,
com.leomehlig.today,109,1739408217,1739408326,1739408326.8972569,-21600,,
com.google.Chrome,10,1739408207,1739408217,1739408217.1899471,-21600,,
com.leomehlig.today,16,1739408191,1739408207,1739408207.993413,-21600,,
com.apple.finder,46,1739408145,1739408191,1739408191.1083632,-21600,,
com.google.Chrome,21,1739408124,1739408145,1739408145.650372,-21600,,
com.leomehlig.today,39,1739408085,1739408124,1739408124.762268,-21600,,
com.google.Chrome,2,1739408083,1739408085,1739408085.104703,-21600,,
com.apple.iCal,1,1739408082,1739408083,1739408083.2656689,-21600,,
com.google.Chrome,20,1739408062,1739408082,1739408082.279326,-21600,,
com.apple.iCal,64,1739407998,1739408062,1739408062.648223,-21600,,
com.google.Chrome,1470,1739406528,1739407998,1739407998.379977,-21600,,
com.leomehlig.today,29,1739406499,1739406528,1739406528.350246,-21600,,
com.google.Chrome,505,1739405994,1739406499,1739406499.71855,-21600,,
com.microsoft.VSCode,57,1739405937,1739405994,1739405994.4670758,-21600,,
com.google.Chrome,4,1739405933,1739405937,1739405937.697362,-21600,,
com.microsoft.Outlook,10,1739404969,1739404979,1739404979.679161,-21600,,
com.google.Chrome,38,1739404931,1739404969,1739404969.36708,-21600,,
com.leomehlig.today,17,1739404914,1739404931,1739404931.3073978,-21600,,
com.apple.CoreAuthUI,3,1739404556,1739404559,1739404559.1341882,-21600,EB445137-D7F5-57EC-87DA-1DB460D64046,"iPhone13,2"
com.robinhood.release.Robinhood,10,1739404553,1739404563,1739404563.932856,-21600,EB445137-D7F5-57EC-87DA-1DB460D64046,"iPhone13,2"
com.apple.weather,23,1739404512,1739404535,1739404535.701894,-21600,EB445137-D7F5-57EC-87DA-1DB460D64046,"iPhone13,2"
com.apple.Health,5,1739404491,1739404496,1739404497.124069,-21600,EB445137-D7F5-57EC-87DA-1DB460D64046,"iPhone13,2"
com.leomehlig.today,317,1739404466,1739404783,1739404783.9229999,-21600,,
com.apple.Health,10,1739403469,1739403479,1739403479.711698,-21600,EB445137-D7F5-57EC-87DA-1DB460D64046,"iPhone13,2"
com.google.Chrome,1164,1739403302,1739404466,1739404466.145554,-21600,,
com.leomehlig.today,2,1739403300,1739403302,1739403302.81009,-21600,,
com.apple.reminders,5,1739403295,1739403300,1739403300.799865,-21600,,
com.google.Chrome,357,1739402938,1739403295,1739403295.700735,-21600,,
com.microsoft.Office.Outlook,5,1739402475,1739402480,1739402480.075201,-21600,EB445137-D7F5-57EC-87DA-1DB460D64046,"iPhone13,2"
com.microsoft.Office.Outlook,10,1739402464,1739402474,1739402474.3020658,-21600,EB445137-D7F5-57EC-87DA-1DB460D64046,"iPhone13,2"
com.google.ios.youtube,310,1739401981,1739402291,1739402291.477878,-21600,EB445137-D7F5-57EC-87DA-1DB460D64046,"iPhone13,2"
com.google.ios.youtube,843,1739401134,1739401977,1739401977.818794,-21600,EB445137-D7F5-57EC-87DA-1DB460D64046,"iPhone13,2"
com.apple.Health,9,1739401125,1739401134,1739401135.290362,-21600,EB445137-D7F5-57EC-87DA-1DB460D64046,"iPhone13,2"
com.google.ios.youtube,6,1739401116,1739401122,1739401122.6010041,-21600,EB445137-D7F5-57EC-87DA-1DB460D64046,"iPhone13,2"
com.apple.weather,3,1739401110,1739401113,1739401113.084326,-21600,EB445137-D7F5-57EC-87DA-1DB460D64046,"iPhone13,2"
com.google.Chrome,300,1739401096,1739401396,1739401396.0662189,-21600,,
com.leomehlig.today,14,1739401082,1739401096,1739401096.141222,-21600,,
com.google.Chrome,43,1739401039,1739401082,1739401082.339189,-21600,,
com.apple.Notes,41,1739400985,1739401026,1739401026.120985,-21600,,
com.apple.finder,38,1739400947,1739400985,1739400985.448986,-21600,,
com.microsoft.VSCode,17,1739400925,1739400942,1739400942.402008,-21600,,
com.apple.weather,18,1739400905,1739400923,1739400924.199332,-21600,EB445137-D7F5-57EC-87DA-1DB460D64046,"iPhone13,2"
com.myfitnesspal.mfp,35,1739400868,1739400903,1739400903.2035918,-21600,EB445137-D7F5-57EC-87DA-1DB460D64046,"iPhone13,2"
com.apple.Notes,122,1739400803,1739400925,1739400925.356945,-21600,,
com.apple.finder,47,1739400756,1739400803,1739400803.247639,-21600,,
com.microsoft.VSCode,9,1739400747,1739400756,1739400757.001694,-21600,,
com.apple.finder,4,1739400743,1739400747,1739400747.24548,-21600,,
com.microsoft.VSCode,84,1739400659,1739400743,1739400743.4625158,-21600,,
com.apple.finder,28,1739400631,1739400659,1739400659.1934772,-21600,,
com.microsoft.VSCode,10,1739400621,1739400631,1739400631.098814,-21600,,
com.apple.finder,4,1739400617,1739400621,1739400621.7396631,-21600,,
com.microsoft.VSCode,116,1739400501,1739400617,1739400617.3981671,-21600,,
com.google.Chrome,25,1739400476,1739400501,1739400501.892643,-21600,,
com.microsoft.VSCode,2,1739400474,1739400476,1739400476.151428,-21600,,
com.google.Chrome,11,1739400463,1739400474,1739400474.509444,-21600,,
com.microsoft.VSCode,29,1739400434,1739400463,1739400463.4935188,-21600,,
com.google.Chrome,40,1739400394,1739400434,1739400434.395177,-21600,,
com.microsoft.VSCode,36,1739400358,1739400394,1739400394.5140638,-21600,,
com.google.Chrome,12,1739400346,1739400358,1739400358.9239979,-21600,,
com.microsoft.VSCode,12,1739400334,1739400346,1739400346.539966,-21600,,
com.google.Chrome,1,1739400333,1739400334,1739400334.573122,-21600,,
com.microsoft.VSCode,2,1739400331,1739400333,1739400333.7298741,-21600,,
com.google.Chrome,1,1739400330,1739400331,1739400331.778054,-21600,,
com.microsoft.VSCode,8,1739400322,1739400330,1739400330.419771,-21600,,
com.google.Chrome,24,1739400298,1739400322,1739400322.1728501,-21600,,
com.microsoft.VSCode,83,1739400215,1739400298,1739400298.6800709,-21600,,
com.google.Chrome,16,1739400199,1739400215,1739400215.768066,-21600,,
com.microsoft.VSCode,23,1739400176,1739400199,1739400199.137648,-21600,,
com.google.Chrome,2,1739400174,1739400176,1739400177.040247,-21600,,
com.microsoft.VSCode,2,1739400172,1739400174,1739400174.701647,-21600,,
com.google.Chrome,4,1739400168,1739400172,1739400172.843034,-21600,,
com.microsoft.VSCode,5,1739400163,1739400168,1739400168.947044,-21600,,
com.google.Chrome,3,1739400160,1739400163,1739400163.584632,-21600,,
com.microsoft.VSCode,27,1739400133,1739400160,1739400161.030319,-21600,,
com.google.Chrome,6,1739400127,1739400133,1739400133.292467,-21600,,
com.microsoft.VSCode,9,1739400118,1739400127,1739400127.480308,-21600,,
com.google.Chrome,32,1739400086,1739400118,1739400118.367909,-21600,,
com.microsoft.VSCode,9,1739400077,1739400086,1739400086.855958,-21600,,
com.google.Chrome,11,1739400066,1739400077,1739400077.541772,-21600,,
com.microsoft.VSCode,6,1739400060,1739400066,1739400067.0091949,-21600,,
com.apple.finder,14,1739400046,1739400060,1739400060.5783892,-21600,,
com.microsoft.VSCode,6,1739400040,1739400046,1739400046.5248718,-21600,,
com.apple.finder,1,1739400039,1739400040,1739400040.064928,-21600,,
com.apple.Preview,2,1739400037,1739400039,1739400039.379811,-21600,,
com.apple.finder,15,1739400022,1739400037,1739400037.3073459,-21600,,
com.microsoft.VSCode,9,1739400013,1739400022,1739400022.69453,-21600,,
com.apple.finder,2,1739400011,1739400013,1739400013.172895,-21600,,
com.microsoft.VSCode,3,1739400008,1739400011,1739400012.001981,-21600,,
com.apple.finder,12,1739399996,1739400008,1739400008.8196,-21600,,
com.microsoft.VSCode,8,1739399988,1739399996,1739399996.988328,-21600,,
com.apple.finder,5,1739399983,1739399988,1739399988.634866,-21600,,
com.microsoft.VSCode,1,1739399982,1739399983,1739399983.8171139,-21600,,
com.apple.finder,2,1739399980,1739399982,1739399982.778216,-21600,,
com.microsoft.VSCode,27,1739399953,1739399980,1739399980.623498,-21600,,
com.apple.finder,8,1739399945,1739399953,1739399953.834074,-21600,,
com.apple.Preview,10,1739399935,1739399945,1739399945.9834619,-21600,,
com.apple.finder,15,1739399920,1739399935,1739399935.171076,-21600,,
com.microsoft.VSCode,38,1739399882,1739399920,1739399920.4004521,-21600,,
com.apple.finder,5,1739399877,1739399882,1739399882.768085,-21600,,
com.microsoft.VSCode,9,1739399868,1739399877,1739399877.7171102,-21600,,
com.apple.finder,12,1739399856,1739399868,1739399868.2228022,-21600,,
com.microsoft.VSCode,1,1739399855,1739399856,1739399856.0583138,-21600,,
com.apple.finder,14,1739399841,1739399855,1739399855.3914409,-21600,,
com.microsoft.VSCode,34,1739399807,1739399841,1739399841.124876,-21600,,
com.apple.Preview,87,1739399720,1739399807,1739399807.052791,-21600,,
com.apple.finder,4,1739399716,1739399720,1739399720.229398,-21600,,
com.google.Chrome,19,1739399697,1739399716,1739399716.418675,-21600,,
com.microsoft.VSCode,9,1739399688,1739399697,1739399697.626257,-21600,,
com.google.Chrome,5,1739399683,1739399688,1739399688.710435,-21600,,
com.microsoft.VSCode,7,1739399676,1739399683,1739399683.6937652,-21600,,
com.google.Chrome,11,1739399665,1739399676,1739399676.14215,-21600,,
com.microsoft.VSCode,19,1739399646,1739399665,1739399665.974997,-21600,,
com.apple.Preview,17,1739399629,1739399646,1739399647.0299,-21600,,
com.apple.finder,8,1739399621,1739399629,1739399629.672429,-21600,,
com.microsoft.VSCode,8,1739399613,1739399621,1739399621.859921,-21600,,
com.apple.Preview,5,1739399608,1739399613,1739399613.565425,-21600,,
com.microsoft.VSCode,12,1739399596,1739399608,1739399608.9470649,-21600,,
com.apple.Preview,2,1739399594,1739399596,1739399596.625232,-21600,,
com.apple.finder,1,1739399593,1739399594,1739399594.634316,-21600,,
com.apple.Preview,3,1739399590,1739399593,1739399593.931553,-21600,,
com.apple.finder,2,1739399588,1739399590,1739399590.399976,-21600,,
com.microsoft.VSCode,19,1739399569,1739399588,1739399588.403761,-21600,,
com.apple.finder,1,1739399568,1739399569,1739399569.6672878,-21600,,
com.apple.Preview,10,1739399558,1739399568,1739399568.882492,-21600,,
com.apple.finder,8,1739399550,1739399558,1739399558.5945659,-21600,,
com.microsoft.VSCode,99,1739399451,1739399550,1739399550.875379,-21600,,
com.apple.finder,26,1739399425,1739399451,1739399451.2902,-21600,,
com.microsoft.VSCode,48,1739399377,1739399425,1739399425.500664,-21600,,
com.apple.Notes,70,1739399307,1739399377,1739399377.328953,-21600,,
com.microsoft.VSCode,267,1739399040,1739399307,1739399307.998444,-21600,,
com.apple.Dictionary,2,1739399038,1739399040,1739399040.74455,-21600,,
com.microsoft.VSCode,323,1739398715,1739399038,1739399038.757288,-21600,,
com.google.Chrome,24,1739398691,1739398715,1739398715.264595,-21600,,
com.microsoft.VSCode,43,1739398648,1739398691,1739398691.153434,-21600,,
com.google.Chrome,21,1739398627,1739398648,1739398648.549844,-21600,,
com.microsoft.VSCode,65,1739398562,1739398627,1739398627.1597629,-21600,,
com.google.Chrome,18,1739398544,1739398562,1739398562.528831,-21600,,
com.microsoft.VSCode,7,1739398537,1739398544,1739398544.877573,-21600,,
com.google.Chrome,3,1739398534,1739398537,1739398537.306823,-21600,,
com.microsoft.VSCode,9,1739398525,1739398534,1739398534.648343,-21600,,
com.google.Chrome,18,1739398507,1739398525,1739398525.306038,-21600,,
com.microsoft.VSCode,537,1739397970,1739398507,1739398507.455853,-21600,,
com.google.Chrome,1,1739397969,1739397970,1739397970.078027,-21600,,
com.google.Chrome,300,1739397544,1739397844,1739397844.9336782,-21600,,
com.leomehlig.today,46,1739397279,1739397325,1739397325.5631928,-21600,,
com.microsoft.VSCode,3,1739397276,1739397279,1739397279.379605,-21600,,
com.google.Chrome,7,1739397269,1739397276,1739397276.484919,-21600,,
Astrospheric.Astrospheric,15,1739396527,1739396542,1739396542.510538,-21600,EB445137-D7F5-57EC-87DA-1DB460D64046,"iPhone13,2"
com.apple.MobileSMS,2,1739396520,1739396522,1739396522.789109,-21600,EB445137-D7F5-57EC-87DA-1DB460D64046,"iPhone13,2"
com.apple.MobileSMS,60,1739396144,1739396204,1739396205.2086911,-21600,EB445137-D7F5-57EC-87DA-1DB460D64046,"iPhone13,2"
com.apple.MobileSMS,93,1739395966,1739396059,1739396059.207447,-21600,EB445137-D7F5-57EC-87DA-1DB460D64046,"iPhone13,2"
com.apple.mobilecal,13,1739395953,1739395966,1739395966.763706,-21600,EB445137-D7F5-57EC-87DA-1DB460D64046,"iPhone13,2"
com.apple.MobileSMS,36,1739395914,1739395950,1739395950.5522308,-21600,EB445137-D7F5-57EC-87DA-1DB460D64046,"iPhone13,2"
com.apple.mobilenotes,4,1739395904,1739395908,1739395908.949928,-21600,EB445137-D7F5-57EC-87DA-1DB460D64046,"iPhone13,2"
com.apple.mobilenotes,190,1739395653,1739395843,1739395843.400595,-21600,EB445137-D7F5-57EC-87DA-1DB460D64046,"iPhone13,2"
com.apple.Maps,2,1739395651,1739395653,1739395653.379745,-21600,EB445137-D7F5-57EC-87DA-1DB460D64046,"iPhone13,2"
com.apple.Maps,65,1739390374,1739390439,1739390439.923352,-21600,EB445137-D7F5-57EC-87DA-1DB460D64046,"iPhone13,2"
com.apple.Maps,51,1739390274,1739390325,1739390325.961606,-21600,EB445137-D7F5-57EC-87DA-1DB460D64046,"iPhone13,2"
com.apple.Maps,1,1739390273,1739390274,1739390274.716974,-21600,EB445137-D7F5-57EC-87DA-1DB460D64046,"iPhone13,2"
com.apple.Maps,5,1739390244,1739390249,1739390249.4879022,-21600,EB445137-D7F5-57EC-87DA-1DB460D64046,"iPhone13,2"
com.apple.Maps,20,1739390210,1739390230,1739390230.202508,-21600,EB445137-D7F5-57EC-87DA-1DB460D64046,"iPhone13,2"
com.apple.weather,11,1739390198,1739390209,1739390210.0832481,-21600,EB445137-D7F5-57EC-87DA-1DB460D64046,"iPhone13,2"
com.apple.weather,3,1739390191,1739390194,1739390194.211745,-21600,EB445137-D7F5-57EC-87DA-1DB460D64046,"iPhone13,2"
com.apple.weather,9,1739390081,1739390090,1739390091.905291,-21600,EB445137-D7F5-57EC-87DA-1DB460D64046,"iPhone13,2"
com.google.Gmail,2,1739390079,1739390081,1739390081.6023011,-21600,EB445137-D7F5-57EC-87DA-1DB460D64046,"iPhone13,2"
com.google.Gmail,19,1739389809,1739389828,1739389829.0390549,-21600,EB445137-D7F5-57EC-87DA-1DB460D64046,"iPhone13,2"
com.apple.MobileSMS,3,1739388864,1739388867,1739388867.406445,-21600,EB445137-D7F5-57EC-87DA-1DB460D64046,"iPhone13,2"
com.microsoft.Office.Outlook,0,1739388864,1739388864,1739388865.632166,-21600,EB445137-D7F5-57EC-87DA-1DB460D64046,"iPhone13,2"
com.microsoft.Office.Outlook,97,1739388428,1739388525,1739388526.2960339,-21600,EB445137-D7F5-57EC-87DA-1DB460D64046,"iPhone13,2"
com.apple.MobileSMS,2,1739388425,1739388427,1739388427.250936,-21600,EB445137-D7F5-57EC-87DA-1DB460D64046,"iPhone13,2"
com.apple.MobileSMS,49,1739387335,1739387384,1739387384.796279,-21600,EB445137-D7F5-57EC-87DA-1DB460D64046,"iPhone13,2"
com.apple.MobileSMS,50,1739387184,1739387234,1739387234.778234,-21600,EB445137-D7F5-57EC-87DA-1DB460D64046,"iPhone13,2"
com.apple.MobileSMS,9,1739387149,1739387158,1739387158.8522,-21600,EB445137-D7F5-57EC-87DA-1DB460D64046,"iPhone13,2"
com.apple.MobileSMS,180,1739386954,1739387134,1739387135.275624,-21600,EB445137-D7F5-57EC-87DA-1DB460D64046,"iPhone13,2"
com.apple.MobileSMS,9,1739386903,1739386912,1739386913.1956859,-21600,EB445137-D7F5-57EC-87DA-1DB460D64046,"iPhone13,2"
com.apple.MobileSMS,79,1739386745,1739386824,1739386824.946608,-21600,EB445137-D7F5-57EC-87DA-1DB460D64046,"iPhone13,2"
com.apple.MobileSMS,62,1739386656,1739386718,1739386718.8736901,-21600,EB445137-D7F5-57EC-87DA-1DB460D64046,"iPhone13,2"
com.apple.news,95,1739386561,1739386656,1739386656.645087,-21600,EB445137-D7F5-57EC-87DA-1DB460D64046,"iPhone13,2"
com.apple.MobileSMS,21,1739386532,1739386553,1739386553.782771,-21600,EB445137-D7F5-57EC-87DA-1DB460D64046,"iPhone13,2"
com.apple.Maps,5,1739386527,1739386532,1739386533.0628738,-21600,EB445137-D7F5-57EC-87DA-1DB460D64046,"iPhone13,2"
com.apple.MobileSMS,18,1739386508,1739386526,1739386526.912436,-21600,EB445137-D7F5-57EC-87DA-1DB460D64046,"iPhone13,2"
com.apple.MobileSMS,113,1739386363,1739386476,1739386476.7061481,-21600,EB445137-D7F5-57EC-87DA-1DB460D64046,"iPhone13,2"
com.tinyspeck.chatlyio,25,1739386338,1739386363,1739386363.316957,-21600,EB445137-D7F5-57EC-87DA-1DB460D64046,"iPhone13,2"
com.apple.MobileSMS,6,1739386330,1739386336,1739386336.6913729,-21600,EB445137-D7F5-57EC-87DA-1DB460D64046,"iPhone13,2"
com.apple.MobileSMS,36,1739386286,1739386322,1739386322.601582,-21600,EB445137-D7F5-57EC-87DA-1DB460D64046,"iPhone13,2"
com.google.chrome.ios,10,1739386276,1739386286,1739386286.722105,-21600,EB445137-D7F5-57EC-87DA-1DB460D64046,"iPhone13,2"
com.apple.MobileSMS,16,1739386259,1739386275,1739386276.057983,-21600,EB445137-D7F5-57EC-87DA-1DB460D64046,"iPhone13,2"
com.toyopagroup.picaboo,15,1739386244,1739386259,1739386259.7626572,-21600,EB445137-D7F5-57EC-87DA-1DB460D64046,"iPhone13,2"
com.apple.MobileSMS,0,1739386244,1739386244,1739386245.3197088,-21600,EB445137-D7F5-57EC-87DA-1DB460D64046,"iPhone13,2"
com.apple.MobileSMS,14,1739386230,1739386244,1739386244.1341019,-21600,EB445137-D7F5-57EC-87DA-1DB460D64046,"iPhone13,2"
com.myfitnesspal.mfp,37,1739385516,1739385553,1739385553.668538,-21600,EB445137-D7F5-57EC-87DA-1DB460D64046,"iPhone13,2"
com.google.Chrome,164,1739385115,1739385279,1739385279.75154,-21600,,
com.microsoft.VSCode,2,1739384344,1739384346,1739384346.646729,-21600,,
com.myfitnesspal.mfp,43,1739383733,1739383776,1739383777.208844,-21600,EB445137-D7F5-57EC-87DA-1DB460D64046,"iPhone13,2"
com.toyopagroup.picaboo,1,1739383727,1739383728,1739383728.881484,-21600,EB445137-D7F5-57EC-87DA-1DB460D64046,"iPhone13,2"
com.toyopagroup.picaboo,5,1739382737,1739382742,1739382742.88152,-21600,EB445137-D7F5-57EC-87DA-1DB460D64046,"iPhone13,2"
com.microsoft.Office.Outlook,2,1739382735,1739382737,1739382737.0896869,-21600,EB445137-D7F5-57EC-87DA-1DB460D64046,"iPhone13,2"
com.microsoft.Office.Outlook,3,1739382637,1739382640,1739382640.678149,-21600,EB445137-D7F5-57EC-87DA-1DB460D64046,"iPhone13,2"
com.toyopagroup.picaboo,30,1739382607,1739382637,1739382637.091638,-21600,EB445137-D7F5-57EC-87DA-1DB460D64046,"iPhone13,2"
com.apple.mobilecal,27,1739382576,1739382603,1739382603.1477041,-21600,EB445137-D7F5-57EC-87DA-1DB460D64046,"iPhone13,2"
com.toyopagroup.picaboo,10,1739382562,1739382572,1739382572.222085,-21600,EB445137-D7F5-57EC-87DA-1DB460D64046,"iPhone13,2"
com.apple.Health,51,1739379460,1739379511,1739379511.623692,-21600,EB445137-D7F5-57EC-87DA-1DB460D64046,"iPhone13,2"
com.apple.Health,113,1739379345,1739379458,1739379458.2450209,-21600,EB445137-D7F5-57EC-87DA-1DB460D64046,"iPhone13,2"
com.apple.weather,54,1739379284,1739379338,1739379338.8253288,-21600,EB445137-D7F5-57EC-87DA-1DB460D64046,"iPhone13,2"
com.myfitnesspal.mfp,8,1739379239,1739379247,1739379247.422214,-21600,EB445137-D7F5-57EC-87DA-1DB460D64046,"iPhone13,2"
com.myfitnesspal.mfp,66,1739378875,1739378941,1739378942.128779,-21600,EB445137-D7F5-57EC-87DA-1DB460D64046,"iPhone13,2"
com.apple.weather,7,1739378856,1739378863,1739378863.876371,-21600,EB445137-D7F5-57EC-87DA-1DB460D64046,"iPhone13,2"
com.apple.news,77,1739378770,1739378847,1739378847.709702,-21600,EB445137-D7F5-57EC-87DA-1DB460D64046,"iPhone13,2"
com.microsoft.Office.Outlook,14,1739378743,1739378757,1739378757.610806,-21600,EB445137-D7F5-57EC-87DA-1DB460D64046,"iPhone13,2"
com.apple.weather,1,1739378742,1739378743,1739378744.175458,-21600,EB445137-D7F5-57EC-87DA-1DB460D64046,"iPhone13,2"
com.microsoft.VSCode,102,1739374528,1739374630,1739374630.93308,-21600,,
com.google.Chrome,3,1739374525,1739374528,1739374528.1305861,-21600,,
com.google.Chrome,58,1739374145,1739374203,1739374203.7714272,-21600,,
com.google.Chrome,141,1739373025,1739373166,1739373166.029947,-21600,,
com.apple.finder,1,1739373024,1739373025,1739373026.316479,-21600,,
com.apple.finder,5,1739372876,1739372881,1739372881.7136621,-21600,,
com.apple.calculator,1,1739372875,1739372876,1739372876.936573,-21600,,
com.apple.CoreAuthUI,1,1739372788,1739372789,1739372790.052534,-21600,EB445137-D7F5-57EC-87DA-1DB460D64046,"iPhone13,2"
com.clairmail.fth.client,105,1739372783,1739372888,1739372888.679796,-21600,EB445137-D7F5-57EC-87DA-1DB460D64046,"iPhone13,2"
com.apple.Notes,112,1739372763,1739372875,1739372875.5848598,-21600,,
com.apple.calculator,6,1739372757,1739372763,1739372763.893595,-21600,,
com.apple.Notes,8,1739372749,1739372757,1739372757.2474852,-21600,,
com.apple.calculator,5,1739372744,1739372749,1739372749.167088,-21600,,
com.apple.Notes,9,1739372735,1739372744,1739372744.057982,-21600,,
com.apple.calculator,1,1739372734,1739372735,1739372735.249156,-21600,,
com.apple.Notes,45,1739372689,1739372734,1739372734.671424,-21600,,
com.apple.calculator,3,1739372686,1739372689,1739372689.274797,-21600,,
com.apple.Notes,1,1739372685,1739372686,1739372686.791026,-21600,,
com.apple.calculator,0,1739372685,1739372685,1739372685.6341,-21600,,
com.apple.Notes,1,1739372684,1739372685,1739372685.187039,-21600,,
com.apple.calculator,4,1739372680,1739372684,1739372684.56232,-21600,,
com.apple.finder,4,1739372676,1739372680,1739372680.566328,-21600,,
com.apple.calculator,97,1739372579,1739372676,1739372676.1003919,-21600,,
com.apple.CoreAuthUI,2,1739372577,1739372579,1739372579.241696,-21600,EB445137-D7F5-57EC-87DA-1DB460D64046,"iPhone13,2"
com.truebill.truebillnative,207,1739372573,1739372780,1739372781.041449,-21600,EB445137-D7F5-57EC-87DA-1DB460D64046,"iPhone13,2"
com.renpho.health,2,1739372560,1739372562,1739372562.9839668,-21600,EB445137-D7F5-57EC-87DA-1DB460D64046,"iPhone13,2"
com.apple.finder,38,1739372541,1739372579,1739372579.899777,-21600,,
com.leomehlig.today,99,1739372442,1739372541,1739372541.1037378,-21600,,
com.google.Chrome,9,1739372433,1739372442,1739372442.320224,-21600,,
com.renpho.health,61,1739370603,1739370664,1739370664.6861591,-21600,EB445137-D7F5-57EC-87DA-1DB460D64046,"iPhone13,2"
com.apple.Health,1,1739370601,1739370602,1739370602.676629,-21600,EB445137-D7F5-57EC-87DA-1DB460D64046,"iPhone13,2"
com.apple.Health,2,1739370598,1739370600,1739370600.9426389,-21600,EB445137-D7F5-57EC-87DA-1DB460D64046,"iPhone13,2"
com.apple.Health,13,1739369779,1739369792,1739369793.356472,-21600,EB445137-D7F5-57EC-87DA-1DB460D64046,"iPhone13,2"
com.apple.weather,9,1739369767,1739369776,1739369776.155562,-21600,EB445137-D7F5-57EC-87DA-1DB460D64046,"iPhone13,2"
com.apple.journal,2,1739337678,1739337680,1739337681.12105,-21600,EB445137-D7F5-57EC-87DA-1DB460D64046,"iPhone13,2"
com.apple.CoreAuthUI,2,1739337151,1739337153,1739337154.026226,-21600,EB445137-D7F5-57EC-87DA-1DB460D64046,"iPhone13,2"
com.apple.journal,527,1739337150,1739337677,1739337677.931387,-21600,EB445137-D7F5-57EC-87DA-1DB460D64046,"iPhone13,2"
com.apple.Health,34,1739337113,1739337147,1739337147.709622,-21600,EB445137-D7F5-57EC-87DA-1DB460D64046,"iPhone13,2"
com.groupme.iphone-app,34,1739337071,1739337105,1739337105.90279,-21600,EB445137-D7F5-57EC-87DA-1DB460D64046,"iPhone13,2"
com.thestorygraph.thestorygraph,27,1739337038,1739337065,1739337065.474757,-21600,EB445137-D7F5-57EC-87DA-1DB460D64046,"iPhone13,2"
com.google.Chrome,15,1739334777,1739334792,1739334792.564968,-21600,,
com.apple.finder,9,1739334768,1739334777,1739334777.121588,-21600,,
com.apple.Health,26,1739334595,1739334621,1739334621.2559052,-21600,EB445137-D7F5-57EC-87DA-1DB460D64046,"iPhone13,2"
com.apple.Music,76,1739333543,1739333619,1739333620.1151772,-21600,EB445137-D7F5-57EC-87DA-1DB460D64046,"iPhone13,2"
com.apple.Music,62,1739332188,1739332250,1739332251.069127,-21600,EB445137-D7F5-57EC-87DA-1DB460D64046,"iPhone13,2"
com.apple.finder,3,1739331917,1739331920,1739331920.158053,-21600,,
com.leomehlig.today,91,1739331826,1739331917,1739331917.28846,-21600,,
com.google.Chrome,55,1739331771,1739331826,1739331826.472861,-21600,,
com.apple.finder,9,1739331762,1739331771,1739331771.553082,-21600,,
com.google.Chrome,45,1739331717,1739331762,1739331762.117593,-21600,,
com.leomehlig.today,3,1739331701,1739331704,1739331704.793538,-21600,,
com.apple.finder,8,1739331693,1739331701,1739331701.230011,-21600,,
com.electron.carta,5,1739331688,1739331693,1739331693.749028,-21600,,
com.apple.finder,8,1739331680,1739331688,1739331688.486527,-21600,,
com.apple.Notes,52,1739331628,1739331680,1739331680.761899,-21600,,
com.apple.finder,48,1739331580,1739331628,1739331628.685576,-21600,,
com.apple.Notes,14,1739331566,1739331580,1739331580.323813,-21600,,
com.electron.carta,63,1739331503,1739331566,1739331566.364501,-21600,,
com.apple.finder,4,1739331499,1739331503,1739331503.6532621,-21600,,
com.apple.Notes,13,1739331486,1739331499,1739331499.206674,-21600,,
com.apple.finder,2,1739331484,1739331486,1739331486.27702,-21600,,
com.apple.Notes,6,1739331478,1739331484,1739331484.85916,-21600,,
com.apple.finder,5,1739331473,1739331478,1739331478.42738,-21600,,
com.apple.Notes,5,1739331468,1739331473,1739331473.298619,-21600,,
com.apple.Preview,7,1739331461,1739331468,1739331468.8881721,-21600,,
com.apple.Notes,6,1739331455,1739331461,1739331461.09699,-21600,,
com.apple.finder,3,1739331452,1739331455,1739331455.291357,-21600,,
com.apple.Notes,15,1739331437,1739331452,1739331452.341224,-21600,,
com.electron.carta,43,1739331394,1739331437,1739331437.798215,-21600,,
com.apple.Notes,10,1739331384,1739331394,1739331394.267284,-21600,,
com.apple.finder,5,1739331379,1739331384,1739331384.671661,-21600,,
com.apple.Notes,9,1739331370,1739331379,1739331379.3833652,-21600,,
com.apple.finder,4,1739331366,1739331370,1739331370.18416,-21600,,
com.apple.Notes,4,1739331362,1739331366,1739331366.475141,-21600,,
com.apple.Preview,8,1739331354,1739331362,1739331362.9935699,-21600,,
com.apple.Notes,8,1739331346,1739331354,1739331354.868239,-21600,,
com.apple.finder,3,1739331343,1739331346,1739331346.504641,-21600,,
com.apple.Notes,16,1739331327,1739331343,1739331343.849627,-21600,,
com.electron.carta,43,1739331284,1739331327,1739331327.1427279,-21600,,
com.apple.Notes,11,1739331273,1739331284,1739331284.399034,-21600,,
com.apple.finder,1,1739331272,1739331273,1739331273.8566709,-21600,,
com.apple.Notes,2,1739331270,1739331272,1739331272.911837,-21600,,
com.apple.finder,1,1739331269,1739331270,1739331270.15871,-21600,,
com.apple.Notes,3,1739331266,1739331269,1739331269.305341,-21600,,
com.apple.Preview,4,1739331262,1739331266,1739331266.7950969,-21600,,
com.apple.Notes,9,1739331253,1739331262,1739331262.575172,-21600,,
com.apple.finder,1,1739331252,1739331253,1739331253.900034,-21600,,
com.apple.Notes,1,1739331251,1739331252,1739331252.082417,-21600,,
com.apple.finder,8,1739331243,1739331251,1739331251.7606769,-21600,,
com.electron.carta,21,1739331222,1739331243,1739331243.457601,-21600,,
com.apple.Notes,17,1739331205,1739331222,1739331222.592036,-21600,,
com.electron.carta,1,1739331204,1739331205,1739331205.48928,-21600,,
com.apple.Notes,21,1739331183,1739331204,1739331204.0854712,-21600,,
com.electron.carta,24,1739331159,1739331183,1739331183.713056,-21600,,
com.apple.finder,1,1739331158,1739331159,1739331159.137529,-21600,,
com.electron.carta,14,1739331144,1739331158,1739331158.0437698,-21600,,
com.apple.finder,0,1739331144,1739331144,1739331144.9856172,-21600,,
com.electron.carta,2,1739331142,1739331144,1739331144.259986,-21600,,
com.apple.finder,0,1739331142,1739331142,1739331142.8840852,-21600,,
com.electron.carta,8,1739331134,1739331142,1739331142.033206,-21600,,
com.apple.finder,1,1739331133,1739331134,1739331134.645153,-21600,,
com.electron.carta,0,1739331133,1739331133,1739331133.7583451,-21600,,
com.apple.finder,1,1739331132,1739331133,1739331133.2726722,-21600,,
com.electron.carta,14,1739331118,1739331132,1739331132.247301,-21600,,
com.apple.finder,4,1739331114,1739331118,1739331118.067041,-21600,,
com.electron.carta,14,1739331100,1739331114,1739331115.0037398,-21600,,
com.apple.Notes,19,1739331081,1739331100,1739331101.008178,-21600,,
com.apple.finder,4,1739331077,1739331081,1739331081.368211,-21600,,
com.apple.Notes,1,1739331076,1739331077,1739331077.420823,-21600,,
com.apple.finder,1,1739331075,1739331076,1739331076.396323,-21600,,
com.apple.Notes,0,1739331075,1739331075,1739331075.7429361,-21600,,
com.apple.finder,5,1739331070,1739331075,1739331075.067004,-21600,,
com.apple.Notes,4,1739331066,1739331070,1739331071.0268102,-21600,,
com.apple.finder,2,1739331064,1739331066,1739331066.6481218,-21600,,
com.apple.Notes,5,1739331059,1739331064,1739331064.511447,-21600,,
com.apple.finder,2,1739331057,1739331059,1739331059.2096891,-21600,,
com.apple.Notes,6,1739331051,1739331057,1739331057.856903,-21600,,
com.apple.finder,8,1739331043,1739331051,1739331051.704211,-21600,,
com.apple.Notes,31,1739331012,1739331043,1739331043.533517,-21600,,
com.apple.Preview,4,1739331008,1739331012,1739331013.016408,-21600,,
com.apple.Notes,6,1739331002,1739331008,1739331008.2217278,-21600,,
com.apple.finder,3,1739330999,1739331002,1739331002.3830152,-21600,,
com.apple.Notes,5,1739330994,1739330999,1739330999.6373382,-21600,,
com.electron.carta,4,1739330990,1739330994,1739330994.8497338,-21600,,
com.apple.Notes,2,1739330988,1739330990,1739330990.640812,-21600,,
com.electron.carta,2,1739330986,1739330988,1739330988.134336,-21600,,
com.apple.Notes,11,1739330975,1739330986,1739330986.0943952,-21600,,
com.electron.carta,14,1739330961,1739330975,1739330976.019146,-21600,,
com.apple.finder,0,1739330961,1739330961,1739330961.8646069,-21600,,
com.electron.carta,3,1739330958,1739330961,1739330961.075251,-21600,,
com.apple.finder,1,1739330957,1739330958,1739330958.707236,-21600,,
com.electron.carta,1,1739330956,1739330957,1739330957.6992931,-21600,,
com.apple.finder,1,1739330955,1739330956,1739330956.340952,-21600,,
com.electron.carta,1,1739330954,1739330955,1739330955.735454,-21600,,
com.apple.finder,1,1739330953,1739330954,1739330954.241106,-21600,,
com.electron.carta,18,1739330935,1739330953,1739330953.05821,-21600,,
com.apple.finder,3,1739330932,1739330935,1739330935.064518,-21600,,
com.electron.carta,22,1739330910,1739330932,1739330932.173911,-21600,,
com.apple.Notes,10,1739330900,1739330910,1739330910.26515,-21600,,
com.apple.finder,8,1739330892,1739330900,1739330900.4981189,-21600,,
com.apple.Notes,49,1739330843,1739330892,1739330892.669599,-21600,,
com.apple.Preview,6,1739330837,1739330843,1739330843.475761,-21600,,
com.apple.Notes,11,1739330826,1739330837,1739330837.713635,-21600,,
com.apple.finder,5,1739330821,1739330826,1739330826.2631001,-21600,,
com.apple.Preview,1,1739330820,1739330821,1739330821.823952,-21600,,
com.apple.Notes,6,1739330814,1739330820,1739330820.588807,-21600,,
com.apple.finder,1,1739330813,1739330814,1739330814.862536,-21600,,
com.electron.carta,37,1739330776,1739330813,1739330813.879334,-21600,,
com.apple.finder,1,1739330775,1739330776,1739330776.607388,-21600,,
com.apple.Notes,32,1739330743,1739330775,1739330775.74184,-21600,,
com.apple.finder,4,1739330739,1739330743,1739330743.208945,-21600,,
com.apple.Notes,5,1739330734,1739330739,1739330739.652735,-21600,,
com.apple.finder,3,1739330731,1739330734,1739330734.633762,-21600,,
com.apple.Notes,7,1739330724,1739330731,1739330731.076527,-21600,,
com.apple.finder,1,1739330723,1739330724,1739330724.5773711,-21600,,
com.apple.Notes,0,1739330723,1739330723,1739330724.066053,-21600,,
com.apple.finder,1,1739330722,1739330723,1739330723.32478,-21600,,
com.apple.Notes,8,1739330714,1739330722,1739330722.5506902,-21600,,
com.apple.finder,1,1739330713,1739330714,1739330714.643317,-21600,,
com.electron.carta,44,1739330669,1739330713,1739330713.7937531,-21600,,
com.apple.finder,1,1739330668,1739330669,1739330669.577481,-21600,,
com.electron.carta,37,1739330631,1739330668,1739330668.616823,-21600,,
com.apple.Notes,1,1739330630,1739330631,1739330631.816462,-21600,,
com.electron.carta,6,1739330624,1739330630,1739330630.93202,-21600,,
com.apple.Notes,17,1739330607,1739330624,1739330624.76495,-21600,,
com.apple.finder,1,1739330606,1739330607,1739330607.60607,-21600,,
com.apple.Notes,7,1739330599,1739330606,1739330606.7653809,-21600,,
com.apple.finder,2,1739330597,1739330599,1739330599.756715,-21600,,
com.apple.Notes,2,1739330595,1739330597,1739330597.3547769,-21600,,
com.apple.finder,5,1739330590,1739330595,1739330595.154697,-21600,,
com.apple.Notes,3,1739330587,1739330590,1739330590.66097,-21600,,
com.apple.finder,13,1739330574,1739330587,1739330587.724911,-21600,,
com.apple.Notes,34,1739330540,1739330574,1739330574.4818501,-21600,,
com.apple.Preview,4,1739330536,1739330540,1739330540.473398,-21600,,
com.apple.Notes,7,1739330529,1739330536,1739330536.55821,-21600,,
com.apple.finder,6,1739330523,1739330529,1739330529.173118,-21600,,
com.apple.Notes,15,1739330508,1739330523,1739330523.446155,-21600,,
com.electron.carta,1,1739330507,1739330508,1739330508.568742,-21600,,
com.apple.Preview,2,1739330505,1739330507,1739330507.056431,-21600,,
com.electron.carta,2,1739330503,1739330505,1739330505.761592,-21600,,
com.apple.Notes,3,1739330500,1739330503,1739330503.734438,-21600,,
com.apple.finder,2,1739330498,1739330500,1739330500.3638759,-21600,,
com.apple.Notes,13,1739330485,1739330498,1739330498.838557,-21600,,
com.apple.finder,1,1739330484,1739330485,1739330485.2511358,-21600,,
com.electron.carta,23,1739330461,1739330484,1739330484.1988711,-21600,,
com.apple.finder,1,1739330460,1739330461,1739330461.444299,-21600,,
com.apple.Notes,21,1739330439,1739330460,1739330460.351964,-21600,,
com.apple.finder,3,1739330436,1739330439,1739330439.5124831,-21600,,
com.apple.Notes,2,1739330434,1739330436,1739330436.155132,-21600,,
com.electron.carta,95,1739330339,1739330434,1739330434.438325,-21600,,
com.apple.finder,4,1739330335,1739330339,1739330339.382467,-21600,,
com.apple.Notes,2,1739330333,1739330335,1739330335.438035,-21600,,
com.apple.finder,160,1739330173,1739330333,1739330333.359344,-21600,,
com.apple.Notes,27,1739330146,1739330173,1739330173.387605,-21600,,
com.apple.finder,17,1739330129,1739330146,1739330146.586131,-21600,,
com.apple.Preview,2,1739330127,1739330129,1739330129.961973,-21600,,
com.apple.Notes,5,1739330122,1739330127,1739330127.939261,-21600,,
com.apple.Preview,6,1739330116,1739330122,1739330123.019682,-21600,,
com.apple.Notes,6,1739330110,1739330116,1739330116.462363,-21600,,
com.apple.Preview,9,1739330101,1739330110,1739330110.125073,-21600,,
com.apple.Notes,6,1739330095,1739330101,1739330101.599823,-21600,,
com.apple.Preview,3,1739330092,1739330095,1739330095.4737148,-21600,,
com.apple.Notes,11,1739330081,1739330092,1739330092.3838248,-21600,,
com.apple.finder,3,1739330078,1739330081,1739330081.478426,-21600,,
com.apple.Notes,11,1739330067,1739330078,1739330078.630087,-21600,,
com.electron.carta,26,1739330041,1739330067,1739330067.524232,-21600,,
com.apple.finder,1,1739330040,1739330041,1739330041.070314,-21600,,
com.electron.carta,4,1739330036,1739330040,1739330040.33985,-21600,,
com.apple.finder,1,1739330035,1739330036,1739330036.068925,-21600,,
com.electron.carta,1,1739330034,1739330035,1739330035.194596,-21600,,
com.apple.finder,2,1739330032,1739330034,1739330034.5459518,-21600,,
com.electron.carta,0,1739330032,1739330032,1739330032.8381128,-21600,,
com.apple.Notes,1,1739330031,1739330032,1739330032.32997,-21600,,
com.electron.carta,31,1739330000,1739330031,1739330031.553077,-21600,,
com.apple.Notes,1,1739329999,1739330000,1739330000.48521,-21600,,
com.electron.carta,8,1739329991,1739329999,1739329999.3751621,-21600,,
com.apple.Notes,10,1739329981,1739329991,1739329991.197268,-21600,,
com.apple.finder,1,1739329980,1739329981,1739329981.917366,-21600,,
com.apple.Notes,6,1739329974,1739329980,1739329980.9562259,-21600,,
com.apple.finder,4,1739329970,1739329974,1739329974.33691,-21600,,
com.apple.Notes,4,1739329966,1739329970,1739329971.031424,-21600,,
com.apple.finder,10,1739329956,1739329966,1739329966.910372,-21600,,
com.apple.Notes,2,1739329954,1739329956,1739329956.853112,-21600,,
com.apple.Preview,2,1739329952,1739329954,1739329954.273275,-21600,,
com.apple.Notes,6,1739329946,1739329952,1739329952.736755,-21600,,
com.apple.Preview,4,1739329942,1739329946,1739329947.033145,-21600,,
com.apple.Notes,9,1739329933,1739329942,1739329942.523067,-21600,,
com.apple.finder,2,1739329931,1739329933,1739329934.025526,-21600,,
com.apple.Notes,29,1739329902,1739329931,1739329931.2038789,-21600,,
com.apple.finder,4,1739329898,1739329902,1739329902.505814,-21600,,
com.apple.Notes,8,1739329890,1739329898,1739329898.848803,-21600,,
com.apple.finder,5,1739329885,1739329890,1739329890.663074,-21600,,
com.apple.Notes,5,1739329880,1739329885,1739329885.237953,-21600,,
com.apple.finder,4,1739329876,1739329880,1739329880.642945,-21600,,
com.electron.carta,1,1739329875,1739329876,1739329876.8104792,-21600,,
com.apple.Notes,4,1739329871,1739329875,1739329875.613107,-21600,,
com.electron.carta,1,1739329870,1739329871,1739329871.710981,-21600,,
com.apple.finder,1,1739329869,1739329870,1739329870.750855,-21600,,
com.electron.carta,2,1739329867,1739329869,1739329869.091481,-21600,,
com.apple.Notes,36,1739329831,1739329867,1739329867.770581,-21600,,
com.electron.carta,1,1739329830,1739329831,1739329831.8926811,-21600,,
com.apple.Notes,11,1739329819,1739329830,1739329830.934044,-21600,,
com.electron.carta,1,1739329818,1739329819,1739329819.8085032,-21600,,
com.apple.Notes,8,1739329810,1739329818,1739329818.4691072,-21600,,
com.electron.carta,6,1739329804,1739329810,1739329810.740192,-21600,,
com.apple.Notes,2,1739329802,1739329804,1739329804.881926,-21600,,
com.electron.carta,5,1739329797,1739329802,1739329802.137167,-21600,,
com.apple.Notes,4,1739329793,1739329797,1739329797.6013908,-21600,,
com.electron.carta,1,1739329792,1739329793,1739329793.264684,-21600,,
com.apple.Notes,8,1739329784,1739329792,1739329792.6726809,-21600,,
com.electron.carta,45,1739329739,1739329784,1739329784.883078,-21600,,
com.apple.finder,1,1739329738,1739329739,1739329739.078336,-21600,,
com.electron.carta,7,1739329731,1739329738,1739329738.2177892,-21600,,
com.apple.finder,1,1739329730,1739329731,1739329731.924931,-21600,,
com.electron.carta,16,1739329714,1739329730,1739329730.840156,-21600,,
com.apple.finder,1,1739329713,1739329714,1739329714.961232,-21600,,
com.electron.carta,103,1739329610,1739329713,1739329713.858965,-21600,,
com.apple.finder,7,1739329603,1739329610,1739329610.182016,-21600,,
com.apple.Notes,1,1739329602,1739329603,1739329603.538358,-21600,,
com.apple.finder,65,1739329537,1739329602,1739329602.934751,-21600,,
com.apple.Preview,3,1739329534,1739329537,1739329537.248479,-21600,,
com.apple.Notes,57,1739329477,1739329534,1739329534.96575,-21600,,
com.apple.finder,1,1739329476,1739329477,1739329477.146533,-21600,,
com.apple.Notes,14,1739329462,1739329476,1739329476.419205,-21600,,
com.apple.finder,1,1739329461,1739329462,1739329462.390077,-21600,,
com.electron.carta,65,1739329396,1739329461,1739329461.555543,-21600,,
com.apple.finder,1,1739329395,1739329396,1739329396.1725311,-21600,,
com.apple.Notes,27,1739329368,1739329395,1739329395.120156,-21600,,
com.apple.finder,1,1739329367,1739329368,1739329368.4061232,-21600,,
com.electron.carta,19,1739329348,1739329367,1739329367.1383672,-21600,,
com.apple.finder,1,1739329347,1739329348,1739329348.7566009,-21600,,
com.electron.carta,10,1739329337,1739329347,1739329347.854751,-21600,,
com.apple.finder,1,1739329336,1739329337,1739329337.365625,-21600,,
com.electron.carta,3,1739329333,1739329336,1739329336.6585479,-21600,,
com.apple.finder,0,1739329333,1739329333,1739329333.831305,-21600,,
com.electron.carta,7,1739329326,1739329333,1739329333.073954,-21600,,
com.apple.finder,2,1739329324,1739329326,1739329326.295168,-21600,,
com.electron.carta,15,1739329309,1739329324,1739329324.781764,-21600,,
com.apple.finder,2,1739329307,1739329309,1739329309.137011,-21600,,
com.electron.carta,7,1739329300,1739329307,1739329307.732805,-21600,,
com.apple.finder,2,1739329298,1739329300,1739329300.231384,-21600,,
com.electron.carta,0,1739329298,1739329298,1739329298.7882318,-21600,,
com.apple.finder,2,1739329296,1739329298,1739329298.152417,-21600,,
com.electron.carta,0,1739329296,1739329296,1739329296.9038758,-21600,,
com.apple.Notes,1,1739329295,1739329296,1739329296.3723512,-21600,,
com.electron.carta,35,1739329260,1739329295,1739329295.43254,-21600,,
com.apple.Notes,2,1739329258,1739329260,1739329260.957227,-21600,,
com.apple.finder,2,1739329256,1739329258,1739329258.120435,-21600,,
com.apple.Notes,7,1739329249,1739329256,1739329256.2165751,-21600,,
com.apple.finder,4,1739329245,1739329249,1739329249.2216768,-21600,,
com.apple.Notes,10,1739329235,1739329245,1739329245.515348,-21600,,
com.apple.finder,2,1739329233,1739329235,1739329235.856958,-21600,,
com.apple.Notes,12,1739329221,1739329233,1739329233.108731,-21600,,
com.apple.finder,2,1739329219,1739329221,1739329221.595974,-21600,,
com.apple.Notes,3,1739329216,1739329219,1739329219.337234,-21600,,
com.apple.finder,2,1739329214,1739329216,1739329216.904288,-21600,,
com.apple.Notes,11,1739329203,1739329214,1739329214.514457,-21600,,
com.apple.Preview,3,1739329200,1739329203,1739329203.905946,-21600,,
com.apple.Notes,7,1739329193,1739329200,1739329200.086585,-21600,,
com.apple.Preview,4,1739329189,1739329193,1739329193.3276892,-21600,,
com.apple.Notes,5,1739329184,1739329189,1739329189.175765,-21600,,
com.apple.finder,2,1739329182,1739329184,1739329184.043237,-21600,,
com.apple.Notes,2,1739329180,1739329182,1739329182.1174622,-21600,,
com.apple.finder,20,1739329160,1739329180,1739329180.846271,-21600,,
com.apple.Notes,4,1739329156,1739329160,1739329160.3594809,-21600,,
com.electron.carta,3,1739329153,1739329156,1739329156.156526,-21600,,
com.apple.Notes,13,1739329140,1739329153,1739329153.418909,-21600,,
com.electron.carta,2,1739329138,1739329140,1739329140.620861,-21600,,
com.apple.Notes,12,1739329126,1739329138,1739329138.578597,-21600,,
com.electron.carta,8,1739329118,1739329126,1739329126.98418,-21600,,
com.apple.Notes,5,1739329113,1739329118,1739329118.7756019,-21600,,
com.electron.carta,4,1739329109,1739329113,1739329113.967884,-21600,,
com.apple.Notes,1,1739329108,1739329109,1739329109.800064,-21600,,
com.google.Chrome,52,1739329056,1739329108,1739329108.9118562,-21600,,
com.apple.Notes,14,1739329042,1739329056,1739329056.5639791,-21600,,
com.electron.carta,25,1739329017,1739329042,1739329042.918233,-21600,,
com.apple.Notes,11,1739329006,1739329017,1739329017.041733,-21600,,
com.electron.carta,132,1739328874,1739329006,1739329006.036413,-21600,,
com.apple.finder,1,1739328873,1739328874,1739328874.8258271,-21600,,
com.electron.carta,11,1739328862,1739328873,1739328873.735478,-21600,,
com.apple.finder,4,1739328858,1739328862,1739328862.8614979,-21600,,
com.apple.Notes,11,1739328847,1739328858,1739328858.123011,-21600,,
com.apple.finder,5,1739328842,1739328847,1739328847.782391,-21600,,
com.apple.Notes,7,1739328835,1739328842,1739328842.793088,-21600,,
com.apple.Preview,4,1739328831,1739328835,1739328835.61695,-21600,,
com.electron.carta,1,1739328830,1739328831,1739328831.8298202,-21600,,
com.apple.Notes,6,1739328824,1739328830,1739328830.97373,-21600,,
com.apple.finder,5,1739328819,1739328824,1739328824.787415,-21600,,
com.apple.Notes,23,1739328796,1739328819,1739328819.1211581,-21600,,
com.electron.carta,29,1739328767,1739328796,1739328796.342016,-21600,,
com.apple.Notes,2,1739328765,1739328767,1739328767.8560739,-21600,,
com.apple.finder,1,1739328764,1739328765,1739328765.112108,-21600,,
com.electron.carta,49,1739328715,1739328764,1739328764.244736,-21600,,
com.apple.finder,5,1739328710,1739328715,1739328715.948277,-21600,,
com.apple.Notes,22,1739328688,1739328710,1739328710.729917,-21600,,
com.apple.finder,1,1739328687,1739328688,1739328688.141705,-21600,,
com.apple.Notes,12,1739328675,1739328687,1739328687.471386,-21600,,
com.apple.finder,5,1739328670,1739328675,1739328675.796335,-21600,,
com.apple.Notes,9,1739328661,1739328670,1739328670.878183,-21600,,
com.apple.Preview,8,1739328653,1739328661,1739328661.8098822,-21600,,
com.apple.Notes,7,1739328646,1739328653,1739328653.3113198,-21600,,
com.apple.finder,5,1739328641,1739328646,1739328646.5643811,-21600,,
com.apple.Notes,9,1739328632,1739328641,1739328641.349413,-21600,,
com.apple.finder,12,1739328620,1739328632,1739328632.896785,-21600,,
com.apple.Notes,37,1739328583,1739328620,1739328620.217784,-21600,,
com.apple.finder,7,1739328576,1739328583,1739328583.522084,-21600,,
com.apple.Preview,6,1739328570,1739328576,1739328576.253417,-21600,,
com.apple.finder,14,1739328556,1739328570,1739328570.858392,-21600,,
com.apple.Notes,6,1739328550,1739328556,1739328556.8312268,-21600,,
com.electron.carta,6,1739328544,1739328550,1739328550.597252,-21600,,
com.apple.Notes,29,1739328515,1739328544,1739328544.584578,-21600,,
com.electron.carta,48,1739328467,1739328515,1739328515.334642,-21600,,
com.apple.finder,2,1739328465,1739328467,1739328467.559705,-21600,,
com.apple.Notes,2,1739328463,1739328465,1739328465.131205,-21600,,
com.electron.carta,31,1739328432,1739328463,1739328464.011945,-21600,,
com.apple.Notes,9,1739328423,1739328432,1739328432.682345,-21600,,
com.electron.carta,38,1739328385,1739328423,1739328423.24681,-21600,,
com.apple.Notes,34,1739328351,1739328385,1739328385.8863049,-21600,,
com.electron.carta,4,1739328347,1739328351,1739328351.912617,-21600,,
com.apple.Notes,14,1739328333,1739328347,1739328347.60092,-21600,,
com.apple.finder,2,1739328331,1739328333,1739328333.383762,-21600,,
com.apple.Notes,5,1739328326,1739328331,1739328331.281022,-21600,,
com.apple.finder,8,1739328318,1739328326,1739328326.942161,-21600,,
com.apple.Notes,1,1739328317,1739328318,1739328318.057261,-21600,,
com.apple.finder,1,1739328316,1739328317,1739328317.664651,-21600,,
com.apple.Preview,1,1739328315,1739328316,1739328316.405933,-21600,,
com.apple.Notes,27,1739328288,1739328315,1739328315.072363,-21600,,
com.apple.Preview,4,1739328284,1739328288,1739328288.962975,-21600,,
com.apple.Notes,6,1739328278,1739328284,1739328284.339201,-21600,,
com.apple.finder,6,1739328272,1739328278,1739328278.828912,-21600,,
com.apple.Notes,47,1739328225,1739328272,1739328272.139843,-21600,,
com.electron.carta,1,1739328224,1739328225,1739328226.0146918,-21600,,
com.apple.Notes,13,1739328211,1739328224,1739328224.141971,-21600,,
com.electron.carta,2,1739328209,1739328211,1739328211.837044,-21600,,
com.apple.Notes,7,1739328202,1739328209,1739328209.90526,-21600,,
com.electron.carta,90,1739328112,1739328202,1739328202.633061,-21600,,
com.apple.Notes,2,1739328110,1739328112,1739328112.963925,-21600,,
com.electron.carta,10,1739328100,1739328110,1739328110.449957,-21600,,
com.apple.finder,3,1739328097,1739328100,1739328100.753824,-21600,,
com.apple.Notes,12,1739328085,1739328097,1739328097.785948,-21600,,
com.apple.finder,0,1739328085,1739328085,1739328085.8239179,-21600,,
com.apple.Notes,11,1739328074,1739328085,1739328085.436444,-21600,,
com.apple.finder,9,1739328065,1739328074,1739328074.149946,-21600,,
com.apple.Notes,5,1739328060,1739328065,1739328065.62641,-21600,,
com.apple.finder,8,1739328052,1739328060,1739328060.8195539,-21600,,
com.apple.Notes,12,1739328040,1739328052,1739328052.90699,-21600,,
com.apple.Preview,6,1739328034,1739328040,1739328040.1130939,-21600,,
com.apple.Notes,9,1739328025,1739328034,1739328034.359669,-21600,,
com.apple.finder,8,1739328017,1739328025,1739328025.157968,-21600,,
com.apple.Notes,8,1739328009,1739328017,1739328017.339305,-21600,,
com.apple.finder,6,1739328003,1739328009,1739328009.256195,-21600,,
com.apple.Notes,3,1739328000,1739328003,1739328003.808578,-21600,,
com.apple.finder,12,1739327988,1739328000,1739328000.753972,-21600,,
com.electron.carta,2,1739327986,1739327988,1739327988.271822,-21600,,
com.apple.Notes,18,1739327968,1739327986,1739327986.138597,-21600,,
com.electron.carta,8,1739327960,1739327968,1739327968.7102962,-21600,,
com.apple.Notes,7,1739327953,1739327960,1739327960.830117,-21600,,
com.electron.carta,19,1739327934,1739327953,1739327953.658103,-21600,,
com.apple.Notes,35,1739327899,1739327934,1739327934.881062,-21600,,
com.electron.carta,48,1739327851,1739327899,1739327899.7440848,-21600,,
com.apple.Notes,11,1739327840,1739327851,1739327851.848484,-21600,,
com.electron.carta,2,1739327838,1739327840,1739327840.3684049,-21600,,
com.apple.Notes,26,1739327812,1739327838,1739327838.7247071,-21600,,
com.electron.carta,1,1739327811,1739327812,1739327812.2487612,-21600,,
com.apple.Notes,20,1739327791,1739327811,1739327811.198623,-21600,,
com.electron.carta,1,1739327790,1739327791,1739327791.835998,-21600,,
com.apple.Notes,17,1739327773,1739327790,1739327790.742271,-21600,,
com.electron.carta,0,1739327773,1739327773,1739327773.9826689,-21600,,
com.apple.Notes,10,1739327763,1739327773,1739327773.214079,-21600,,
com.electron.carta,2,1739327761,1739327763,1739327763.078157,-21600,,
com.apple.Notes,1,1739327760,1739327761,1739327761.049202,-21600,,
com.electron.carta,3,1739327757,1739327760,1739327760.533833,-21600,,
com.apple.Notes,2,1739327755,1739327757,1739327757.3486218,-21600,,
com.electron.carta,2,1739327753,1739327755,1739327755.3449368,-21600,,
com.apple.Notes,1,1739327752,1739327753,1739327753.747593,-21600,,
com.electron.carta,4,1739327748,1739327752,1739327752.0866551,-21600,,
com.apple.Notes,14,1739327734,1739327748,1739327748.625699,-21600,,
com.electron.carta,117,1739327617,1739327734,1739327734.662967,-21600,,
com.apple.Notes,16,1739327601,1739327617,1739327617.6979198,-21600,,
com.electron.carta,148,1739327453,1739327601,1739327601.905802,-21600,,
com.apple.Notes,6,1739327447,1739327453,1739327453.420434,-21600,,
com.apple.finder,1,1739327446,1739327447,1739327447.742052,-21600,,
com.apple.Notes,3,1739327443,1739327446,1739327446.050873,-21600,,
com.apple.finder,3,1739327440,1739327443,1739327443.823719,-21600,,
com.apple.Notes,2,1739327438,1739327440,1739327440.294518,-21600,,
com.apple.finder,2,1739327436,1739327438,1739327438.173905,-21600,,
com.apple.Notes,10,1739327426,1739327436,1739327436.7374182,-21600,,
com.apple.finder,1,1739327425,1739327426,1739327426.201314,-21600,,
com.apple.Notes,2,1739327423,1739327425,1739327425.718543,-21600,,
com.apple.finder,3,1739327420,1739327423,1739327423.479669,-21600,,
com.apple.Notes,8,1739327412,1739327420,1739327420.646371,-21600,,
com.apple.finder,0,1739327412,1739327412,1739327412.956532,-21600,,
com.apple.Notes,2,1739327410,1739327412,1739327412.457409,-21600,,
com.apple.finder,8,1739327402,1739327410,1739327410.890862,-21600,,
com.apple.Notes,4,1739327398,1739327402,1739327402.9900699,-21600,,
com.apple.finder,1,1739327397,1739327398,1739327398.953201,-21600,,
com.apple.Notes,5,1739327392,1739327397,1739327397.6615539,-21600,,
com.apple.finder,2,1739327390,1739327392,1739327392.0828881,-21600,,
com.apple.Notes,15,1739327375,1739327390,1739327390.895956,-21600,,
com.apple.finder,5,1739327370,1739327375,1739327375.8836908,-21600,,
com.apple.Notes,11,1739327359,1739327370,1739327370.205565,-21600,,
com.apple.Preview,1,1739327358,1739327359,1739327359.270369,-21600,,
com.apple.finder,6,1739327352,1739327358,1739327358.42373,-21600,,
com.apple.Preview,1,1739327351,1739327352,1739327352.415749,-21600,,
com.apple.Notes,5,1739327346,1739327351,1739327351.3271132,-21600,,
com.apple.Preview,1,1739327345,1739327346,1739327346.986824,-21600,,
com.apple.Notes,6,1739327339,1739327345,1739327345.8613172,-21600,,
com.apple.Preview,9,1739327330,1739327339,1739327339.191815,-21600,,
com.apple.finder,0,1739327330,1739327330,1739327330.944176,-21600,,
com.apple.Notes,3,1739327327,1739327330,1739327330.18102,-21600,,
com.apple.finder,28,1739327299,1739327327,1739327327.827416,-21600,,
com.apple.Preview,1,1739327298,1739327299,1739327299.558825,-21600,,
com.apple.finder,2,1739327296,1739327298,1739327298.1152759,-21600,,
com.apple.Preview,54,1739327242,1739327296,1739327296.6349978,-21600,,
com.apple.finder,5,1739327237,1739327242,1739327242.845043,-21600,,
com.apple.Preview,8,1739327229,1739327237,1739327237.553409,-21600,,
com.apple.finder,2,1739327227,1739327229,1739327229.535204,-21600,,
com.apple.Notes,6,1739327221,1739327227,1739327227.683251,-21600,,
com.apple.finder,6,1739327215,1739327221,1739327221.526752,-21600,,
com.apple.Notes,2,1739327213,1739327215,1739327215.9194422,-21600,,
com.apple.finder,76,1739327137,1739327213,1739327213.287169,-21600,,
com.apple.Notes,23,1739327114,1739327137,1739327137.730599,-21600,,
com.apple.finder,1,1739327113,1739327114,1739327114.17555,-21600,,
com.apple.Notes,6,1739327107,1739327113,1739327113.482794,-21600,,
com.apple.finder,3,1739327104,1739327107,1739327107.054189,-21600,,
com.apple.Notes,1,1739327103,1739327104,1739327104.335701,-21600,,
com.apple.finder,2,1739327101,1739327103,1739327103.518484,-21600,,
com.apple.Notes,3,1739327098,1739327101,1739327101.3600678,-21600,,
com.apple.finder,1,1739327097,1739327098,1739327098.375629,-21600,,
com.apple.Notes,7,1739327090,1739327097,1739327097.3282251,-21600,,
com.apple.finder,50,1739327040,1739327090,1739327090.9225569,-21600,,
com.apple.Preview,2,1739327038,1739327040,1739327040.901362,-21600,,
com.google.Chrome,2,1739327036,1739327038,1739327038.543995,-21600,,
com.apple.Preview,3,1739327033,1739327036,1739327036.080871,-21600,,
com.apple.Notes,3,1739327030,1739327033,1739327033.581665,-21600,,
com.apple.Preview,26,1739327004,1739327030,1739327030.9671578,-21600,,
com.apple.Notes,11,1739326993,1739327004,1739327004.1339989,-21600,,
com.apple.Preview,22,1739326971,1739326993,1739326993.378851,-21600,,
com.apple.finder,3,1739326968,1739326971,1739326971.458065,-21600,,
com.apple.Preview,1,1739326967,1739326968,1739326968.941021,-21600,,
com.apple.finder,18,1739326949,1739326967,1739326967.966855,-21600,,
com.apple.Notes,2,1739326947,1739326949,1739326949.1009312,-21600,,
com.apple.finder,1,1739326946,1739326947,1739326947.297423,-21600,,
com.apple.Notes,2,1739326944,1739326946,1739326946.350665,-21600,,
com.apple.finder,1,1739326943,1739326944,1739326944.814003,-21600,,
com.apple.Notes,1,1739326942,1739326943,1739326943.614528,-21600,,
com.apple.finder,2,1739326940,1739326942,1739326942.084525,-21600,,
com.apple.Notes,7,1739326933,1739326940,1739326940.9162412,-21600,,
com.apple.finder,14,1739326919,1739326933,1739326933.646442,-21600,,
com.apple.Notes,1,1739326918,1739326919,1739326919.9581308,-21600,,
com.apple.finder,3,1739326915,1739326918,1739326918.306473,-21600,,
com.apple.Notes,2,1739326913,1739326915,1739326915.0615659,-21600,,
com.apple.finder,46,1739326867,1739326913,1739326913.612321,-21600,,
com.apple.Notes,10,1739326857,1739326867,1739326867.62719,-21600,,
com.apple.finder,4,1739326853,1739326857,1739326857.969605,-21600,,
com.leomehlig.today,0,1739326853,1739326853,1739326853.8171868,-21600,,
com.google.Chrome,7,1739326846,1739326853,1739326853.398532,-21600,,
com.leomehlig.today,13,1739326833,1739326846,1739326846.911442,-21600,,
com.apple.weather,20,1739326271,1739326291,1739326292.0162249,-21600,EB445137-D7F5-57EC-87DA-1DB460D64046,"iPhone13,2"
com.apple.news,19,1739326251,1739326270,1739326270.661701,-21600,EB445137-D7F5-57EC-87DA-1DB460D64046,"iPhone13,2"
com.apple.news,58,1739326192,1739326250,1739326250.826448,-21600,EB445137-D7F5-57EC-87DA-1DB460D64046,"iPhone13,2"
com.intsig.CamScannerLite,4,1739326164,1739326168,1739326168.4879189,-21600,EB445137-D7F5-57EC-87DA-1DB460D64046,"iPhone13,2"
com.google.Chrome,723,1739326110,1739326833,1739326833.573845,-21600,,
com.google.Chrome,1092,1739324672,1739325764,1739325764.943115,-21600,,
com.leomehlig.today,6,1739324666,1739324672,1739324672.730904,-21600,,
com.google.Chrome,393,1739324273,1739324666,1739324666.326631,-21600,,
com.leomehlig.today,12,1739323770,1739323782,1739323783.365728,-21600,,
com.apple.Preview,6,1739323764,1739323770,1739323770.298707,-21600,,
com.intsig.CamScannerLite,168,1739323619,1739323787,1739323788.074891,-21600,EB445137-D7F5-57EC-87DA-1DB460D64046,"iPhone13,2"
com.apple.Health,2,1739323617,1739323619,1739323619.1630921,-21600,EB445137-D7F5-57EC-87DA-1DB460D64046,"iPhone13,2"
com.google.Chrome,177,1739323587,1739323764,1739323764.570579,-21600,,
com.apple.Preview,1,1739323586,1739323587,1739323587.701096,-21600,,
com.apple.Health,20,1739323487,1739323507,1739323507.725821,-21600,EB445137-D7F5-57EC-87DA-1DB460D64046,"iPhone13,2"
com.myfitnesspal.mfp,9,1739323471,1739323480,1739323480.3338342,-21600,EB445137-D7F5-57EC-87DA-1DB460D64046,"iPhone13,2"
com.google.chrome.ios,208,1739323262,1739323470,1739323470.475554,-21600,EB445137-D7F5-57EC-87DA-1DB460D64046,"iPhone13,2"
com.google.Gmail,5,1739323257,1739323262,1739323262.183949,-21600,EB445137-D7F5-57EC-87DA-1DB460D64046,"iPhone13,2"
com.apple.Preview,300,1739323083,1739323383,1739323383.8025799,-21600,,
com.microsoft.Office.Outlook,13,1739321892,1739321905,1739321905.829568,-21600,EB445137-D7F5-57EC-87DA-1DB460D64046,"iPhone13,2"
com.apple.news,0,1739321892,1739321892,1739321893.034972,-21600,EB445137-D7F5-57EC-87DA-1DB460D64046,"iPhone13,2"
com.apple.Preview,1339,1739321743,1739323082,1739323082.6034741,-21600,,
com.apple.Preview,301,1739321429,1739321730,1739321730.2118502,-21600,,
com.apple.Preview,783,1739320594,1739321377,1739321377.113168,-21600,,
com.google.Chrome,2,1739320592,1739320594,1739320594.932949,-21600,,
com.apple.Preview,8,1739320584,1739320592,1739320592.8780951,-21600,,
com.google.Chrome,1,1739320583,1739320584,1739320584.295661,-21600,,
com.apple.Preview,15,1739320568,1739320583,1739320583.0584211,-21600,,
com.google.Chrome,6,1739320562,1739320568,1739320568.842694,-21600,,
com.apple.Preview,9,1739320553,1739320562,1739320562.089511,-21600,,
com.google.Chrome,5,1739320548,1739320553,1739320553.766038,-21600,,
com.apple.Preview,116,1739320432,1739320548,1739320548.531626,-21600,,
com.google.Chrome,12,1739320420,1739320432,1739320432.699846,-21600,,
com.apple.Preview,18,1739320402,1739320420,1739320420.556491,-21600,,
com.apple.finder,2,1739320400,1739320402,1739320402.1428142,-21600,,
com.apple.Preview,4,1739320396,1739320400,1739320400.248873,-21600,,
com.google.Chrome,4,1739320392,1739320396,1739320396.370709,-21600,,
com.apple.Preview,13,1739320379,1739320392,1739320392.8855128,-21600,,
com.apple.finder,2,1739320377,1739320379,1739320379.722163,-21600,,
com.apple.Preview,1,1739320376,1739320377,1739320377.686294,-21600,,
com.apple.finder,4,1739320372,1739320376,1739320376.4765549,-21600,,
com.google.Chrome,2,1739320370,1739320372,1739320372.717749,-21600,,
com.leomehlig.today,29,1739320341,1739320370,1739320370.063081,-21600,,
com.apple.finder,9,1739320332,1739320341,1739320341.511991,-21600,,
com.google.Chrome,18,1739320314,1739320332,1739320332.953772,-21600,,
com.apple.Preview,94,1739320207,1739320301,1739320301.8987541,-21600,,
com.google.Chrome,333,1739319874,1739320207,1739320207.6341438,-21600,,
com.apple.Preview,2,1739319872,1739319874,1739319874.069907,-21600,,
com.apple.Preview,309,1739319556,1739319865,1739319865.31067,-21600,,
com.apple.news,142,1739319041,1739319183,1739319183.917027,-21600,EB445137-D7F5-57EC-87DA-1DB460D64046,"iPhone13,2"
com.microsoft.Office.Outlook,32,1739318998,1739319030,1739319030.8306708,-21600,EB445137-D7F5-57EC-87DA-1DB460D64046,"iPhone13,2"
com.apple.weather,5,1739318993,1739318998,1739318998.275958,-21600,EB445137-D7F5-57EC-87DA-1DB460D64046,"iPhone13,2"
com.google.Chrome,1180,1739318376,1739319556,1739319556.217828,-21600,,
com.apple.Preview,108,1739318268,1739318376,1739318377.031044,-21600,,
com.google.Chrome,130,1739318138,1739318268,1739318268.304111,-21600,,
com.google.Chrome,498,1739317524,1739318022,1739318022.271389,-21600,,
com.apple.Preview,653,1739316871,1739317524,1739317525.021755,-21600,,
com.apple.finder,4,1739316867,1739316871,1739316871.190158,-21600,,
com.apple.Preview,3,1739316864,1739316867,1739316867.351109,-21600,,
com.apple.finder,17,1739316847,1739316864,1739316864.8633552,-21600,,
com.apple.Preview,1,1739316846,1739316847,1739316847.9906878,-21600,,
com.apple.finder,8,1739316838,1739316846,1739316846.806213,-21600,,
com.leomehlig.today,61,1739316777,1739316838,1739316838.667953,-21600,,
com.apple.shortcuts,1,1739316776,1739316777,1739316777.756491,-21600,,
com.leomehlig.today,2,1739316774,1739316776,1739316776.573463,-21600,,
com.apple.shortcuts,4,1739316770,1739316774,1739316774.042098,-21600,,
com.leomehlig.today,21,1739316749,1739316770,1739316770.9419432,-21600,,
com.apple.iCal,7,1739316742,1739316749,1739316749.596661,-21600,,
com.leomehlig.today,13,1739316729,1739316742,1739316742.814087,-21600,,
com.apple.finder,1,1739316728,1739316729,1739316730.014817,-21600,,
com.microsoft.Word,1,1739316727,1739316728,1739316728.065234,-21600,,
com.google.Chrome,9,1739316718,1739316727,1739316727.164009,-21600,,
com.apple.weather,47,1739315251,1739315298,1739315298.50617,-21600,EB445137-D7F5-57EC-87DA-1DB460D64046,"iPhone13,2"
com.myfitnesspal.mfp,1,1739315250,1739315251,1739315251.9461331,-21600,EB445137-D7F5-57EC-87DA-1DB460D64046,"iPhone13,2"
com.google.Chrome,644,1739314525,1739315169,1739315169.60196,-21600,,
com.myfitnesspal.mfp,48,1739313423,1739313471,1739313472.214731,-21600,EB445137-D7F5-57EC-87DA-1DB460D64046,"iPhone13,2"
com.apple.weather,2,1739313420,1739313422,1739313423.0722198,-21600,EB445137-D7F5-57EC-87DA-1DB460D64046,"iPhone13,2"
com.google.Chrome,155,1739313023,1739313178,1739313178.677253,-21600,,
com.microsoft.Word,57,1739312966,1739313023,1739313023.7372541,-21600,,
com.apple.finder,50,1739312916,1739312966,1739312966.531771,-21600,,
com.microsoft.Word,37,1739312879,1739312916,1739312916.5291018,-21600,,
com.google.Chrome,2,1739312877,1739312879,1739312879.954646,-21600,,
com.crystalmaker.crystalmaker.v11,1,1739312876,1739312877,1739312877.805787,-21600,,
com.google.Chrome,1,1739312875,1739312876,1739312876.855042,-21600,,
com.microsoft.Powerpoint,2,1739312873,1739312875,1739312875.252862,-21600,,
com.google.Chrome,22,1739312851,1739312873,1739312873.344452,-21600,,
com.microsoft.Word,11,1739312827,1739312838,1739312839.042547,-21600,,
com.leomehlig.today,16,1739312811,1739312827,1739312827.253665,-21600,,
com.google.Chrome,8,1739312803,1739312811,1739312811.354347,-21600,,
com.microsoft.Powerpoint,5,1739312798,1739312803,1739312804.032249,-21600,,
com.microsoft.Word,59,1739312739,1739312798,1739312798.5403152,-21600,,
com.microsoft.Powerpoint,8,1739312731,1739312739,1739312739.5356278,-21600,,
com.microsoft.Word,12,1739312719,1739312731,1739312731.652214,-21600,,
com.microsoft.Powerpoint,2,1739312717,1739312719,1739312719.084348,-21600,,
com.microsoft.Word,9,1739312708,1739312717,1739312717.28333,-21600,,
com.microsoft.Powerpoint,3,1739312705,1739312708,1739312708.503059,-21600,,
com.microsoft.Word,19,1739312686,1739312705,1739312705.244166,-21600,,
com.microsoft.Powerpoint,4,1739312682,1739312686,1739312686.7759008,-21600,,
com.microsoft.Word,164,1739312518,1739312682,1739312682.781662,-21600,,
com.microsoft.Powerpoint,22,1739312496,1739312518,1739312518.5722198,-21600,,
com.microsoft.Word,269,1739312227,1739312496,1739312496.595127,-21600,,
com.google.Chrome,9,1739312218,1739312227,1739312227.346767,-21600,,
com.microsoft.Word,28,1739312190,1739312218,1739312219.000575,-21600,,
com.google.Chrome,6,1739312184,1739312190,1739312190.4397202,-21600,,
com.microsoft.Word,203,1739311981,1739312184,1739312184.515615,-21600,,
com.microsoft.Powerpoint,52,1739311929,1739311981,1739311981.9165149,-21600,,
com.microsoft.Word,16,1739311913,1739311929,1739311929.168704,-21600,,
com.microsoft.Powerpoint,69,1739311844,1739311913,1739311913.85535,-21600,,
com.microsoft.Word,24,1739311820,1739311844,1739311844.450865,-21600,,
com.microsoft.Powerpoint,41,1739311779,1739311820,1739311820.543333,-21600,,
com.microsoft.Word,68,1739311711,1739311779,1739311780.035833,-21600,,
com.microsoft.Powerpoint,10,1739311701,1739311711,1739311711.1416101,-21600,,
com.microsoft.Word,31,1739311670,1739311701,1739311701.906363,-21600,,
com.microsoft.Powerpoint,52,1739311618,1739311670,1739311670.857216,-21600,,
com.microsoft.Word,34,1739311584,1739311618,1739311618.879437,-21600,,
com.microsoft.Powerpoint,56,1739311528,1739311584,1739311584.378695,-21600,,
com.microsoft.Word,337,1739311191,1739311528,1739311528.91062,-21600,,
com.microsoft.Powerpoint,32,1739311159,1739311191,1739311191.6531029,-21600,,
com.microsoft.Word,132,1739311027,1739311159,1739311159.079443,-21600,,
com.microsoft.Powerpoint,213,1739310814,1739311027,1739311027.493483,-21600,,
com.microsoft.Word,630,1739310184,1739310814,1739310814.520825,-21600,,
com.microsoft.Powerpoint,25,1739310159,1739310184,1739310184.557321,-21600,,
com.microsoft.Word,133,1739310026,1739310159,1739310159.338985,-21600,,
com.microsoft.Powerpoint,38,1739309988,1739310026,1739310026.130096,-21600,,
com.microsoft.Word,178,1739309810,1739309988,1739309988.194,-21600,,
com.microsoft.Powerpoint,5,1739309805,1739309810,1739309810.1562982,-21600,,
com.microsoft.Word,175,1739309630,1739309805,1739309805.710688,-21600,,
com.microsoft.Powerpoint,93,1739309537,1739309630,1739309630.620826,-21600,,
com.microsoft.Word,165,1739309372,1739309537,1739309537.4631581,-21600,,
com.microsoft.Powerpoint,2,1739309370,1739309372,1739309372.19016,-21600,,
com.microsoft.Word,1,1739309369,1739309370,1739309370.747256,-21600,,
com.google.Chrome,8,1739309361,1739309369,1739309369.691186,-21600,,
com.microsoft.Word,4,1739309357,1739309361,1739309361.322085,-21600,,
com.google.Chrome,6,1739309351,1739309357,1739309357.838793,-21600,,
com.microsoft.Word,1,1739309350,1739309351,1739309351.156466,-21600,,
com.google.Chrome,13,1739309337,1739309350,1739309350.513618,-21600,,
com.microsoft.Word,110,1739309227,1739309337,1739309337.794606,-21600,,
com.crystalmaker.crystalmaker.v11,55,1739309172,1739309227,1739309227.852322,-21600,,
com.apple.finder,12,1739309160,1739309172,1739309172.717176,-21600,,
com.apple.archiveutility,1,1739309159,1739309160,1739309160.755571,-21600,,
com.apple.finder,5,1739309154,1739309159,1739309159.5512109,-21600,,
com.microsoft.Word,278,1739308876,1739309154,1739309154.753868,-21600,,
com.microsoft.Powerpoint,1,1739308875,1739308876,1739308876.3541532,-21600,,
com.google.Chrome,17,1739308858,1739308875,1739308875.936202,-21600,,
com.microsoft.Word,1,1739308857,1739308858,1739308858.463171,-21600,,
com.microsoft.Powerpoint,80,1739308777,1739308857,1739308857.697054,-21600,,
com.microsoft.Word,1,1739308776,1739308777,1739308777.493616,-21600,,
com.google.Chrome,15,1739308761,1739308776,1739308776.19259,-21600,,
com.microsoft.Word,25,1739308736,1739308761,1739308761.096329,-21600,,
com.microsoft.Powerpoint,17,1739308719,1739308736,1739308736.685457,-21600,,
com.microsoft.Word,31,1739308688,1739308719,1739308719.977889,-21600,,
com.google.Chrome,13,1739308675,1739308688,1739308688.338886,-21600,,
com.microsoft.Word,98,1739308577,1739308675,1739308675.989194,-21600,,
com.google.Chrome,5,1739308572,1739308577,1739308577.518283,-21600,,
com.microsoft.Word,2,1739308570,1739308572,1739308572.44894,-21600,,
com.google.Chrome,15,1739308555,1739308570,1739308570.969674,-21600,,
com.microsoft.Word,197,1739308358,1739308555,1739308555.9246821,-21600,,
com.microsoft.Powerpoint,36,1739308322,1739308358,1739308359.015131,-21600,,
com.microsoft.Word,25,1739308297,1739308322,1739308322.8091512,-21600,,
com.microsoft.Powerpoint,5,1739308292,1739308297,1739308297.697243,-21600,,
com.microsoft.Word,280,1739308012,1739308292,1739308292.789486,-21600,,
com.apple.calculator,6,1739308006,1739308012,1739308012.368216,-21600,,
com.microsoft.Word,18,1739307988,1739308006,1739308006.402622,-21600,,
com.apple.calculator,5,1739307983,1739307988,1739307988.415019,-21600,,
com.microsoft.Word,5,1739307978,1739307983,1739307983.9939442,-21600,,
com.apple.calculator,4,1739307974,1739307978,1739307978.5049992,-21600,,
com.microsoft.Word,8,1739307966,1739307974,1739307974.3345299,-21600,,
com.apple.calculator,5,1739307961,1739307966,1739307966.1140962,-21600,,
com.microsoft.Word,9,1739307952,1739307961,1739307961.0445461,-21600,,
com.apple.calculator,5,1739307947,1739307952,1739307952.766962,-21600,,
com.microsoft.Word,5,1739307942,1739307947,1739307947.9106221,-21600,,
com.apple.calculator,4,1739307938,1739307942,1739307942.591404,-21600,,
com.microsoft.Word,13,1739307925,1739307938,1739307938.549062,-21600,,
com.apple.calculator,6,1739307919,1739307925,1739307925.921955,-21600,,
com.microsoft.Word,5,1739307914,1739307919,1739307919.912774,-21600,,
com.apple.calculator,4,1739307910,1739307914,1739307914.8405728,-21600,,
com.microsoft.Word,6,1739307904,1739307910,1739307910.513214,-21600,,
com.apple.calculator,12,1739307892,1739307904,1739307904.375221,-21600,,
com.microsoft.Word,115,1739307777,1739307892,1739307892.0265698,-21600,,
com.microsoft.Powerpoint,30,1739307747,1739307777,1739307777.335258,-21600,,
com.apple.weather,19,1739307728,1739307747,1739307747.691165,-21600,,
com.microsoft.Powerpoint,674,1739307054,1739307728,1739307728.182503,-21600,,
com.microsoft.Word,3,1739307051,1739307054,1739307054.1174731,-21600,,
com.microsoft.Powerpoint,0,1739307051,1739307051,1739307051.800332,-21600,,
com.google.Chrome,44,1739307007,1739307051,1739307051.337846,-21600,,
com.microsoft.Word,202,1739306805,1739307007,1739307007.8487191,-21600,,
com.microsoft.Powerpoint,2,1739306803,1739306805,1739306805.3931952,-21600,,
com.apple.shortcuts,31,1739306772,1739306803,1739306803.410399,-21600,,
com.microsoft.Powerpoint,2,1739306770,1739306772,1739306772.353509,-21600,,
com.google.Chrome,319,1739306451,1739306770,1739306770.574472,-21600,,
com.microsoft.Powerpoint,1,1739306450,1739306451,1739306451.718683,-21600,,
com.apple.shortcuts,60,1739306390,1739306450,1739306450.36871,-21600,,
com.microsoft.Word,22,1739306368,1739306390,1739306390.562454,-21600,,
com.microsoft.Powerpoint,99,1739306269,1739306368,1739306368.822573,-21600,,
com.microsoft.Word,107,1739306162,1739306269,1739306269.345778,-21600,,
com.microsoft.Powerpoint,13,1739306149,1739306162,1739306162.849056,-21600,,
com.microsoft.Word,0,1739306149,1739306149,1739306149.6120272,-21600,,
com.google.Chrome,58,1739306091,1739306149,1739306149.163909,-21600,,
com.microsoft.Word,12,1739306079,1739306091,1739306091.563232,-21600,,
com.microsoft.Powerpoint,17,1739306062,1739306079,1739306079.469701,-21600,,
com.google.Chrome,9,1739306053,1739306062,1739306062.047838,-21600,,
com.microsoft.Word,71,1739305982,1739306053,1739306053.9800382,-21600,,
com.google.Chrome,5,1739305977,1739305982,1739305982.5214849,-21600,,
com.microsoft.Word,1,1739305976,1739305977,1739305977.496789,-21600,,
com.apple.finder,15,1739305961,1739305976,1739305976.777931,-21600,,
com.google.Chrome,26,1739305935,1739305961,1739305961.3412461,-21600,,
com.google.Chrome,86,1739302775,1739302861,1739302861.288682,-21600,,
com.apple.weather,5,1739302731,1739302736,1739302736.380568,-21600,EB445137-D7F5-57EC-87DA-1DB460D64046,"iPhone13,2"
com.google.chrome.ios,2,1739302729,1739302731,1739302731.353507,-21600,EB445137-D7F5-57EC-87DA-1DB460D64046,"iPhone13,2"
com.google.chrome.ios,31,1739301504,1739301535,1739301536.0821872,-21600,EB445137-D7F5-57EC-87DA-1DB460D64046,"iPhone13,2"
com.google.chrome.ios,19,1739301085,1739301104,1739301105.3524709,-21600,EB445137-D7F5-57EC-87DA-1DB460D64046,"iPhone13,2"
com.apple.news,2,1739301081,1739301083,1739301083.8363829,-21600,EB445137-D7F5-57EC-87DA-1DB460D64046,"iPhone13,2"
com.apple.news,116,1739300393,1739300509,1739300510.542367,-21600,EB445137-D7F5-57EC-87DA-1DB460D64046,"iPhone13,2"
com.apple.news,13,1739300269,1739300282,1739300282.804354,-21600,EB445137-D7F5-57EC-87DA-1DB460D64046,"iPhone13,2"
com.google.Maps,33,1739300236,1739300269,1739300270.130903,-21600,EB445137-D7F5-57EC-87DA-1DB460D64046,"iPhone13,2"
com.apple.news,52,1739300180,1739300232,1739300232.882601,-21600,EB445137-D7F5-57EC-87DA-1DB460D64046,"iPhone13,2"
com.apple.Health,2,1739300177,1739300179,1739300179.505384,-21600,EB445137-D7F5-57EC-87DA-1DB460D64046,"iPhone13,2"
com.apple.Health,39,1739300036,1739300075,1739300076.132149,-21600,EB445137-D7F5-57EC-87DA-1DB460D64046,"iPhone13,2"
com.apple.Health,28,1739299990,1739300018,1739300018.926867,-21600,EB445137-D7F5-57EC-87DA-1DB460D64046,"iPhone13,2"
com.apple.Music,0,1739299990,1739299990,1739299990.9178848,-21600,EB445137-D7F5-57EC-87DA-1DB460D64046,"iPhone13,2"
com.apple.Music,11,1739298679,1739298690,1739298690.7272391,-21600,EB445137-D7F5-57EC-87DA-1DB460D64046,"iPhone13,2"
com.myfitnesspal.mfp,0,1739298679,1739298679,1739298680.198483,-21600,EB445137-D7F5-57EC-87DA-1DB460D64046,"iPhone13,2"
com.myfitnesspal.mfp,6,1739297888,1739297894,1739297894.403716,-21600,EB445137-D7F5-57EC-87DA-1DB460D64046,"iPhone13,2"
com.myfitnesspal.mfp,356,1739296951,1739297307,1739297307.248012,-21600,EB445137-D7F5-57EC-87DA-1DB460D64046,"iPhone13,2"
com.apple.calculator,2,1739296949,1739296951,1739296951.409091,-21600,EB445137-D7F5-57EC-87DA-1DB460D64046,"iPhone13,2"
com.google.Chrome,934,1739296608,1739297542,1739297542.768049,-21600,,
com.leomehlig.today,3,1739296605,1739296608,1739296608.9430761,-21600,,
com.apple.calculator,6,1739295719,1739295725,1739295725.744474,-21600,EB445137-D7F5-57EC-87DA-1DB460D64046,"iPhone13,2"
com.myfitnesspal.mfp,208,1739293799,1739294007,1739294007.902781,-21600,EB445137-D7F5-57EC-87DA-1DB460D64046,"iPhone13,2"
com.myfitnesspal.mfp,72,1739293594,1739293666,1739293666.3935661,-21600,EB445137-D7F5-57EC-87DA-1DB460D64046,"iPhone13,2"
com.myfitnesspal.mfp,278,1739293233,1739293511,1739293512.243911,-21600,EB445137-D7F5-57EC-87DA-1DB460D64046,"iPhone13,2"
com.leomehlig.today,101,1739293073,1739293174,1739293174.582159,-21600,,
com.google.Chrome,9,1739293064,1739293073,1739293073.30259,-21600,,
com.leomehlig.today,36,1739293028,1739293064,1739293065.021833,-21600,,
com.google.Chrome,253,1739292775,1739293028,1739293028.521373,-21600,,
com.leomehlig.today,35,1739292740,1739292775,1739292775.491405,-21600,,
com.google.Maps,33,1739292528,1739292561,1739292561.481268,-21600,EB445137-D7F5-57EC-87DA-1DB460D64046,"iPhone13,2"
com.apple.mobilecal,1,1739292522,1739292523,1739292523.558362,-21600,EB445137-D7F5-57EC-87DA-1DB460D64046,"iPhone13,2"
com.google.Chrome,646,1739292094,1739292740,1739292740.2547488,-21600,,
com.leomehlig.today,0,1739292094,1739292094,1739292094.708322,-21600,,
com.google.Chrome,186,1739291908,1739292094,1739292094.291864,-21600,,
com.leomehlig.today,1,1739291907,1739291908,1739291909.0313392,-21600,,
com.google.Chrome,367,1739291540,1739291907,1739291907.865468,-21600,,
com.leomehlig.today,38,1739291502,1739291540,1739291540.2571611,-21600,,
com.google.Chrome,300,1739291202,1739291502,1739291502.257601,-21600,,
com.google.Chrome,337,1739290654,1739290991,1739290991.604926,-21600,,
com.apple.Preview,45,1739290609,1739290654,1739290654.972626,-21600,,
com.apple.finder,5,1739290604,1739290609,1739290609.4940128,-21600,,
com.apple.Preview,1,1739290603,1739290604,1739290604.956357,-21600,,
com.google.Chrome,362,1739290241,1739290603,1739290603.5780392,-21600,,
com.hnc.Discord,8,1739290233,1739290241,1739290241.96913,-21600,,
com.apple.MobileSMS,14,1739290219,1739290233,1739290233.245105,-21600,,
com.hnc.Discord,5,1739290214,1739290219,1739290219.299762,-21600,,
com.apple.mobilecal,26,1739290171,1739290197,1739290197.876118,-21600,EB445137-D7F5-57EC-87DA-1DB460D64046,"iPhone13,2"
com.apple.Maps,23,1739290143,1739290166,1739290166.086776,-21600,EB445137-D7F5-57EC-87DA-1DB460D64046,"iPhone13,2"
com.apple.mobileslideshow,2,1739290141,1739290143,1739290143.211742,-21600,EB445137-D7F5-57EC-87DA-1DB460D64046,"iPhone13,2"
com.apple.MobileSMS,169,1739290045,1739290214,1739290214.554374,-21600,,
com.hnc.Discord,76,1739289969,1739290045,1739290045.241465,-21600,,
com.google.Chrome,13,1739289956,1739289969,1739289969.804295,-21600,,
com.hnc.Discord,17,1739289939,1739289956,1739289957.690189,-21600,,
com.google.Chrome,16,1739289923,1739289939,1739289939.5136662,-21600,,
com.hnc.Discord,2,1739289921,1739289923,1739289923.883646,-21600,,
com.google.Chrome,136,1739289785,1739289921,1739289921.18712,-21600,,
com.google.Chrome,300,1739289454,1739289754,1739289754.861625,-21600,,
com.apple.Preview,70,1739289384,1739289454,1739289454.787794,-21600,,
com.google.Chrome,9,1739289375,1739289384,1739289384.37303,-21600,,
com.apple.Preview,104,1739289271,1739289375,1739289375.23083,-21600,,
com.apple.finder,9,1739289262,1739289271,1739289271.927527,-21600,,
com.google.Chrome,218,1739289044,1739289262,1739289262.7183452,-21600,,
com.leomehlig.today,16,1739288980,1739288996,1739288996.709398,-21600,,
com.apple.Preview,5,1739288975,1739288980,1739288980.949265,-21600,,
com.apple.Preview,302,1739286575,1739286877,1739286877.384062,-21600,,
com.apple.finder,7,1739286568,1739286575,1739286575.6995811,-21600,,
com.google.Chrome,15,1739286553,1739286568,1739286568.095693,-21600,,
com.apple.mobileslideshow,36,1739285860,1739285896,1739285896.6213732,-21600,EB445137-D7F5-57EC-87DA-1DB460D64046,"iPhone13,2"
com.apple.weather,2,1739285855,1739285857,1739285857.838789,-21600,EB445137-D7F5-57EC-87DA-1DB460D64046,"iPhone13,2"
com.apple.weather,72,1739284606,1739284678,1739284678.999012,-21600,EB445137-D7F5-57EC-87DA-1DB460D64046,"iPhone13,2"
com.renpho.health,63,1739284543,1739284606,1739284607.261283,-21600,EB445137-D7F5-57EC-87DA-1DB460D64046,"iPhone13,2"
com.apple.Health,31,1739283400,1739283431,1739283431.7317219,-21600,EB445137-D7F5-57EC-87DA-1DB460D64046,"iPhone13,2"
com.google.Chrome,472,1739246139,1739246611,1739246611.7014642,-21600,,
com.apple.iCal,81,1739246058,1739246139,1739246140.607631,-21600,,
com.apple.iCal,54,1739245232,1739245286,1739245286.231522,-21600,,
com.microsoft.VSCode,54,1739245178,1739245232,1739245232.88868,-21600,,
com.google.Chrome,4,1739245174,1739245178,1739245178.549955,-21600,,
com.microsoft.VSCode,61,1739245113,1739245174,1739245175.71848,-21600,,
com.google.Chrome,103,1739245010,1739245113,1739245113.993253,-21600,,
com.microsoft.VSCode,65,1739244945,1739245010,1739245010.330986,-21600,,
com.google.Chrome,50,1739244895,1739244945,1739244945.509326,-21600,,
com.microsoft.VSCode,4,1739244891,1739244895,1739244895.4409719,-21600,,
com.google.Chrome,44,1739244847,1739244891,1739244891.833319,-21600,,
com.microsoft.VSCode,5,1739244842,1739244847,1739244847.1284518,-21600,,
com.google.Chrome,5,1739244837,1739244842,1739244842.865118,-21600,,
com.microsoft.VSCode,2,1739244835,1739244837,1739244837.064235,-21600,,
com.google.Chrome,1,1739244834,1739244835,1739244835.4410272,-21600,,
com.microsoft.VSCode,4,1739244830,1739244834,1739244834.178324,-21600,,
com.google.Chrome,125,1739244705,1739244830,1739244830.79175,-21600,,
com.microsoft.VSCode,1,1739244704,1739244705,1739244705.289371,-21600,,
com.google.Chrome,19,1739244685,1739244704,1739244704.461773,-21600,,
com.microsoft.VSCode,4,1739244681,1739244685,1739244685.90936,-21600,,
com.google.Chrome,9,1739244672,1739244681,1739244681.059463,-21600,,
com.microsoft.VSCode,5,1739244667,1739244672,1739244672.6439738,-21600,,
com.google.Chrome,1,1739244666,1739244667,1739244668.02507,-21600,,
com.microsoft.VSCode,5,1739244661,1739244666,1739244666.599527,-21600,,
com.google.Chrome,1,1739244660,1739244661,1739244661.589919,-21600,,
com.microsoft.VSCode,4,1739244656,1739244660,1739244660.232459,-21600,,
com.google.Chrome,22,1739244634,1739244656,1739244657.056075,-21600,,
com.microsoft.VSCode,7,1739244627,1739244634,1739244634.240653,-21600,,
com.google.Chrome,14,1739244613,1739244627,1739244627.836205,-21600,,
com.microsoft.VSCode,4,1739244609,1739244613,1739244613.092982,-21600,,
com.google.Chrome,111,1739244498,1739244609,1739244609.2685862,-21600,,
com.apple.iCal,7,1739244491,1739244498,1739244498.568569,-21600,,
com.google.Chrome,13,1739244478,1739244491,1739244491.816553,-21600,,
com.apple.iCal,12,1739244466,1739244478,1739244478.654424,-21600,,
com.google.Chrome,113,1739244353,1739244466,1739244466.956873,-21600,,
com.microsoft.VSCode,8,1739244345,1739244353,1739244353.260077,-21600,,
com.google.Chrome,2,1739244343,1739244345,1739244345.7139158,-21600,,
com.microsoft.VSCode,6,1739244337,1739244343,1739244343.9057832,-21600,,
com.google.Chrome,1,1739244336,1739244337,1739244337.7055922,-21600,,
com.microsoft.VSCode,23,1739244313,1739244336,1739244336.898206,-21600,,
com.google.Chrome,409,1739243904,1739244313,1739244313.4954472,-21600,,
com.leomehlig.today,22,1739243882,1739243904,1739243904.8395839,-21600,,
com.leomehlig.today,120,1739241185,1739241305,1739241305.5646172,-21600,,
com.google.Chrome,106,1739241079,1739241185,1739241185.1709008,-21600,,
com.apple.finder,3,1739241076,1739241079,1739241079.6255,-21600,,
com.google.Chrome,7,1739241069,1739241076,1739241076.810447,-21600,,
com.leomehlig.today,15,1739241041,1739241056,1739241057.716528,-21600,,
com.apple.Notes,11,1739241030,1739241041,1739241041.605791,-21600,,
com.apple.finder,19,1739241011,1739241030,1739241031.009563,-21600,,
com.apple.Notes,10,1739241001,1739241011,1739241011.7336931,-21600,,
com.electron.carta,23,1739240978,1739241001,1739241001.3172898,-21600,,
com.apple.Notes,1,1739240977,1739240978,1739240978.5748749,-21600,,
com.electron.carta,2,1739240975,1739240977,1739240977.304525,-21600,,
com.apple.Notes,1,1739240974,1739240975,1739240975.804213,-21600,,
com.electron.carta,65,1739240909,1739240974,1739240974.379684,-21600,,
com.apple.Notes,2,1739240907,1739240909,1739240909.740203,-21600,,
com.electron.carta,4,1739240903,1739240907,1739240907.7095098,-21600,,
com.apple.Notes,2,1739240901,1739240903,1739240903.72432,-21600,,
com.electron.carta,16,1739240885,1739240901,1739240901.6429791,-21600,,
com.apple.Notes,4,1739240881,1739240885,1739240885.4398599,-21600,,
com.electron.carta,2,1739240879,1739240881,1739240881.482764,-21600,,
com.apple.Notes,1,1739240878,1739240879,1739240879.991863,-21600,,
com.electron.carta,8,1739240870,1739240878,1739240878.5139399,-21600,,
com.apple.Notes,1,1739240869,1739240870,1739240870.9099379,-21600,,
com.electron.carta,2,1739240867,1739240869,1739240869.242388,-21600,,
com.apple.Notes,1,1739240866,1739240867,1739240867.787631,-21600,,
com.electron.carta,1,1739240865,1739240866,1739240866.592681,-21600,,
com.apple.Notes,3,1739240862,1739240865,1739240865.204345,-21600,,
com.electron.carta,186,1739240676,1739240862,1739240862.5073361,-21600,,
com.apple.Notes,3,1739240673,1739240676,1739240676.421371,-21600,,
com.electron.carta,1,1739240672,1739240673,1739240674.027869,-21600,,
com.apple.Notes,4,1739240668,1739240672,1739240672.793611,-21600,,
com.electron.carta,2,1739240666,1739240668,1739240668.610939,-21600,,
com.apple.Notes,5,1739240661,1739240666,1739240666.233509,-21600,,
com.electron.carta,55,1739240606,1739240661,1739240661.838517,-21600,,
com.apple.Notes,12,1739240594,1739240606,1739240606.876396,-21600,,
com.electron.carta,2,1739240592,1739240594,1739240594.2965078,-21600,,
com.apple.Notes,1,1739240591,1739240592,1739240592.611885,-21600,,
com.electron.carta,3,1739240588,1739240591,1739240591.491633,-21600,,
com.apple.Notes,3,1739240585,1739240588,1739240588.540786,-21600,,
com.electron.carta,0,1739240585,1739240585,1739240585.880587,-21600,,
com.apple.Notes,4,1739240581,1739240585,1739240585.1410751,-21600,,
com.electron.carta,1,1739240580,1739240581,1739240581.577431,-21600,,
com.apple.Notes,1,1739240579,1739240580,1739240580.4851189,-21600,,
com.electron.carta,6,1739240573,1739240579,1739240579.336155,-21600,,
com.apple.Notes,20,1739240553,1739240573,1739240573.879928,-21600,,
com.electron.carta,3,1739240550,1739240553,1739240553.964435,-21600,,
com.apple.Notes,3,1739240547,1739240550,1739240550.8766909,-21600,,
com.electron.carta,4,1739240543,1739240547,1739240547.7172189,-21600,,
com.apple.Notes,9,1739240534,1739240543,1739240543.078948,-21600,,
com.electron.carta,30,1739240504,1739240534,1739240534.58082,-21600,,
com.apple.Notes,17,1739240487,1739240504,1739240504.55826,-21600,,
com.electron.carta,4,1739240483,1739240487,1739240487.133541,-21600,,
com.apple.Notes,11,1739240472,1739240483,1739240483.907331,-21600,,
com.electron.carta,82,1739240390,1739240472,1739240472.061645,-21600,,
com.apple.Notes,2,1739240388,1739240390,1739240390.9974189,-21600,,
com.electron.carta,22,1739240366,1739240388,1739240388.686841,-21600,,
com.apple.Notes,2,1739240364,1739240366,1739240366.422659,-21600,,
com.electron.carta,2,1739240362,1739240364,1739240364.710218,-21600,,
com.apple.Notes,1,1739240361,1739240362,1739240363.017295,-21600,,
com.electron.carta,15,1739240346,1739240361,1739240361.127012,-21600,,
com.apple.Notes,1,1739240345,1739240346,1739240346.87905,-21600,,
com.electron.carta,10,1739240335,1739240345,1739240345.448577,-21600,,
com.apple.Notes,14,1739240321,1739240335,1739240335.55505,-21600,,
com.electron.carta,16,1739240305,1739240321,1739240321.481782,-21600,,
com.apple.Notes,1,1739240304,1739240305,1739240305.8894691,-21600,,
com.electron.carta,2,1739240302,1739240304,1739240304.441235,-21600,,
com.apple.Notes,0,1739240302,1739240302,1739240303.0274282,-21600,,
com.electron.carta,11,1739240291,1739240302,1739240302.063314,-21600,,
com.apple.Notes,2,1739240289,1739240291,1739240291.193331,-21600,,
com.electron.carta,1,1739240288,1739240289,1739240289.586088,-21600,,
com.apple.Notes,2,1739240286,1739240288,1739240288.053205,-21600,,
com.electron.carta,22,1739240264,1739240286,1739240286.433206,-21600,,
com.apple.Notes,27,1739240237,1739240264,1739240264.167725,-21600,,
com.electron.carta,9,1739240228,1739240237,1739240237.5092459,-21600,,
com.apple.Notes,1,1739240227,1739240228,1739240229.013375,-21600,,
com.electron.carta,2,1739240225,1739240227,1739240227.413338,-21600,,
com.apple.Notes,6,1739240219,1739240225,1739240225.2405229,-21600,,
com.electron.carta,46,1739240173,1739240219,1739240219.681004,-21600,,
com.apple.Notes,14,1739240159,1739240173,1739240173.4477549,-21600,,
com.electron.carta,5,1739240154,1739240159,1739240159.750897,-21600,,
com.apple.Notes,3,1739240151,1739240154,1739240154.952745,-21600,,
com.electron.carta,5,1739240146,1739240151,1739240151.21412,-21600,,
com.apple.Notes,6,1739240140,1739240146,1739240146.3514838,-21600,,
com.electron.carta,51,1739240089,1739240140,1739240140.849059,-21600,,
com.apple.Notes,1,1739240088,1739240089,1739240090.041743,-21600,,
com.electron.carta,2,1739240086,1739240088,1739240088.316317,-21600,,
com.apple.Notes,1,1739240085,1739240086,1739240086.868433,-21600,,
com.electron.carta,19,1739240066,1739240085,1739240085.3151,-21600,,
com.apple.Notes,2,1739240064,1739240066,1739240066.3868232,-21600,,
com.electron.carta,1,1739240063,1739240064,1739240064.927211,-21600,,
com.apple.Notes,1,1739240062,1739240063,1739240063.574647,-21600,,
com.electron.carta,15,1739240047,1739240062,1739240062.327516,-21600,,
com.apple.Notes,1,1739240046,1739240047,1739240047.339116,-21600,,
com.electron.carta,17,1739240029,1739240046,1739240046.162621,-21600,,
com.apple.Notes,2,1739240027,1739240029,1739240029.683589,-21600,,
com.electron.carta,5,1739240022,1739240027,1739240027.692508,-21600,,
com.apple.Notes,30,1739239992,1739240022,1739240022.4525762,-21600,,
com.electron.carta,7,1739239985,1739239992,1739239992.928275,-21600,,
com.apple.Notes,8,1739239977,1739239985,1739239985.141111,-21600,,
com.electron.carta,54,1739239923,1739239977,1739239977.328217,-21600,,
com.apple.Notes,1,1739239922,1739239923,1739239923.843871,-21600,,
com.electron.carta,0,1739239922,1739239922,1739239922.7103019,-21600,,
com.apple.Notes,1,1739239921,1739239922,1739239922.270057,-21600,,
com.electron.carta,2,1739239919,1739239921,1739239921.242795,-21600,,
com.apple.Notes,3,1739239916,1739239919,1739239919.905566,-21600,,
com.electron.carta,141,1739239775,1739239916,1739239916.839919,-21600,,
com.apple.Notes,2,1739239773,1739239775,1739239775.145777,-21600,,
com.electron.carta,1,1739239772,1739239773,1739239773.566721,-21600,,
com.apple.Notes,3,1739239769,1739239772,1739239772.210545,-21600,,
com.electron.carta,0,1739239769,1739239769,1739239769.645623,-21600,,
com.apple.Notes,1,1739239768,1739239769,1739239769.203188,-21600,,
com.electron.carta,5,1739239763,1739239768,1739239768.089298,-21600,,
com.apple.Notes,1,1739239762,1739239763,1739239763.7037969,-21600,,
com.electron.carta,3,1739239759,1739239762,1739239762.198164,-21600,,
com.apple.Notes,3,1739239756,1739239759,1739239759.164767,-21600,,
com.electron.carta,1,1739239755,1739239756,1739239757.015933,-21600,,
com.apple.Notes,2,1739239753,1739239755,1739239755.607487,-21600,,
com.electron.carta,7,1739239746,1739239753,1739239753.644967,-21600,,
com.apple.Notes,2,1739239744,1739239746,1739239746.633648,-21600,,
com.electron.carta,2,1739239742,1739239744,1739239744.3547668,-21600,,
com.apple.Notes,7,1739239735,1739239742,1739239742.88941,-21600,,
com.electron.carta,202,1739239533,1739239735,1739239735.665684,-21600,,
com.apple.finder,14,1739239519,1739239533,1739239533.99881,-21600,,
com.electron.carta,15,1739239504,1739239519,1739239519.794561,-21600,,
com.apple.finder,27,1739239477,1739239504,1739239504.5941281,-21600,,
com.electron.carta,43,1739239434,1739239477,1739239477.9858398,-21600,,
com.apple.Terminal,29,1739239405,1739239434,1739239434.4578671,-21600,,
com.apple.finder,9,1739239396,1739239405,1739239405.745481,-21600,,
com.apple.Terminal,24,1739239372,1739239396,1739239396.89298,-21600,,
com.electron.carta,1,1739239371,1739239372,1739239372.6649718,-21600,,
com.apple.finder,0,1739239371,1739239371,1739239371.7373781,-21600,,
com.electron.carta,1,1739239370,1739239371,1739239371.46298,-21600,,
com.apple.finder,1,1739239369,1739239370,1739239370.57338,-21600,,
com.apple.Terminal,78,1739239291,1739239369,1739239369.379751,-21600,,
com.apple.finder,38,1739239253,1739239291,1739239291.463447,-21600,,
com.electron.carta,67,1739239186,1739239253,1739239253.801851,-21600,,
com.apple.finder,1,1739239185,1739239186,1739239186.661144,-21600,,
com.electron.carta,18,1739239167,1739239185,1739239185.664613,-21600,,
com.apple.finder,1,1739239166,1739239167,1739239167.9731789,-21600,,
com.electron.carta,5,1739239161,1739239166,1739239166.3682551,-21600,,
com.apple.finder,6,1739239155,1739239161,1739239161.8848119,-21600,,
com.electron.carta,24,1739239131,1739239155,1739239155.781917,-21600,,
com.apple.finder,19,1739239112,1739239131,1739239131.742907,-21600,,
com.apple.Preview,19,1739239093,1739239112,1739239112.3120708,-21600,,
com.apple.Terminal,101,1739238992,1739239093,1739239093.133343,-21600,,
com.apple.finder,3,1739238989,1739238992,1739238992.18752,-21600,,
com.apple.Preview,8,1739238981,1739238989,1739238989.452251,-21600,,
com.apple.Terminal,259,1739238722,1739238981,1739238981.2916598,-21600,,
com.apple.Preview,60,1739238662,1739238722,1739238722.90219,-21600,,
com.apple.finder,10,1739238652,1739238662,1739238662.350788,-21600,,
com.apple.Terminal,82,1739238570,1739238652,1739238652.889093,-21600,,
com.apple.finder,2,1739238568,1739238570,1739238570.485445,-21600,,
com.cisco.secureclient.gui,8,1739238560,1739238568,1739238568.824419,-21600,,
com.apple.finder,4,1739238556,1739238560,1739238560.540973,-21600,,
com.cisco.secureclient.gui,38,1739238518,1739238556,1739238556.734631,-21600,,
com.apple.finder,11,1739238507,1739238518,1739238518.5682402,-21600,,
com.apple.finder,574,1739237792,1739238366,1739238366.242959,-21600,,
com.apple.finder,795,1739236935,1739237730,1739237730.499682,-21600,,
com.leomehlig.today,379,1739236556,1739236935,1739236935.628316,-21600,,
com.apple.finder,2,1739236554,1739236556,1739236556.870491,-21600,,
com.google.Chrome,248,1739236306,1739236554,1739236554.603075,-21600,,
com.apple.finder,65,1739236241,1739236306,1739236306.751329,-21600,,
com.google.Chrome,1396,1739234845,1739236241,1739236241.683998,-21600,,
com.google.Chrome,372,1739234434,1739234806,1739234806.6132421,-21600,,
com.apple.finder,110,1739234324,1739234434,1739234434.2929459,-21600,,
com.apple.Preview,1,1739234323,1739234324,1739234325.01317,-21600,,
com.google.Chrome,1,1739234322,1739234323,1739234323.3684359,-21600,,
com.apple.iCal,163,1739234159,1739234322,1739234322.5314999,-21600,,
com.google.Chrome,6,1739234153,1739234159,1739234159.5377011,-21600,,
com.apple.iCal,31,1739234122,1739234153,1739234153.1764,-21600,,
com.apple.finder,3,1739234119,1739234122,1739234122.802075,-21600,,
com.apple.iCal,15,1739234104,1739234119,1739234119.6838121,-21600,,
com.apple.finder,2,1739234102,1739234104,1739234104.569975,-21600,,
com.apple.iCal,1,1739234101,1739234102,1739234103.034364,-21600,,
com.apple.finder,22,1739234079,1739234101,1739234101.583809,-21600,,
com.apple.Preview,799,1739233280,1739234079,1739234079.477851,-21600,,
com.google.Chrome,47,1739233233,1739233280,1739233280.061336,-21600,,
com.apple.Preview,958,1739232275,1739233233,1739233233.2229872,-21600,,
com.leomehlig.today,2,1739232273,1739232275,1739232275.239357,-21600,,
com.apple.Preview,106,1739232167,1739232273,1739232273.149961,-21600,,
com.google.Chrome,46,1739232121,1739232167,1739232167.329777,-21600,,
com.apple.Preview,4,1739232117,1739232121,1739232121.808119,-21600,,
com.google.Chrome,28,1739232089,1739232117,1739232117.901578,-21600,,
com.apple.Preview,7,1739232082,1739232089,1739232089.752605,-21600,,
com.google.Chrome,38,1739232044,1739232082,1739232082.7080731,-21600,,
com.apple.Preview,105,1739231939,1739232044,1739232044.972796,-21600,,
com.google.Chrome,207,1739231732,1739231939,1739231939.764717,-21600,,
com.apple.Preview,140,1739231592,1739231732,1739231732.1441998,-21600,,
com.google.Chrome,147,1739231445,1739231592,1739231592.505167,-21600,,
com.apple.Preview,1,1739231444,1739231445,1739231445.633572,-21600,,
com.google.Chrome,25,1739231419,1739231444,1739231444.981498,-21600,,
com.apple.Preview,4,1739231415,1739231419,1739231419.58828,-21600,,
com.google.Chrome,3,1739231412,1739231415,1739231415.597952,-21600,,
com.apple.Preview,6,1739231406,1739231412,1739231412.785491,-21600,,
com.google.Chrome,93,1739231313,1739231406,1739231406.091007,-21600,,
com.apple.Preview,16,1739231297,1739231313,1739231313.5399718,-21600,,
com.google.Chrome,190,1739231107,1739231297,1739231297.507623,-21600,,
com.apple.Preview,111,1739230996,1739231107,1739231107.0715408,-21600,,
com.google.Chrome,248,1739230748,1739230996,1739230996.213674,-21600,,
com.apple.Preview,86,1739230662,1739230748,1739230748.844495,-21600,,
com.apple.finder,36,1739230626,1739230662,1739230662.121107,-21600,,
com.apple.Preview,3,1739230623,1739230626,1739230626.934756,-21600,,
com.apple.finder,6,1739230617,1739230623,1739230623.790031,-21600,,
com.apple.Preview,349,1739230268,1739230617,1739230617.225498,-21600,,
com.apple.finder,1,1739230267,1739230268,1739230268.607911,-21600,,
com.leomehlig.today,1,1739230266,1739230267,1739230267.214345,-21600,,
com.apple.finder,3,1739230263,1739230266,1739230266.517668,-21600,,
com.apple.Preview,0,1739230263,1739230263,1739230263.874557,-21600,,
com.apple.finder,12,1739230251,1739230263,1739230263.064468,-21600,,
com.leomehlig.today,2,1739230249,1739230251,1739230251.240762,-21600,,
com.apple.Photos,1,1739230248,1739230249,1739230249.67397,-21600,,
com.leomehlig.today,7,1739230241,1739230248,1739230248.556518,-21600,,
com.leomehlig.today,4,1739228576,1739228580,1739228580.736305,-21600,,
com.apple.finder,2,1739228574,1739228576,1739228576.0450912,-21600,,
com.leomehlig.today,1,1739228573,1739228574,1739228574.6875181,-21600,,
com.google.Chrome,9,1739228564,1739228573,1739228573.067353,-21600,,
com.google.Chrome,730,1739227557,1739228287,1739228287.9746451,-21600,,
com.leomehlig.today,4,1739227553,1739227557,1739227557.60492,-21600,,
com.leomehlig.today,142,1739226511,1739226653,1739226653.7173371,-21600,,
com.google.Chrome,549,1739225962,1739226511,1739226511.439951,-21600,,
com.apple.Preview,656,1739225306,1739225962,1739225962.340399,-21600,,
com.apple.finder,32,1739225274,1739225306,1739225306.970602,-21600,,
com.leomehlig.today,0,1739225274,1739225274,1739225274.6164079,-21600,,
com.apple.finder,3,1739225271,1739225274,1739225274.2690039,-21600,,
com.google.Chrome,47,1739225224,1739225271,1739225271.528759,-21600,,
com.microsoft.Excel,19,1739225205,1739225224,1739225224.276061,-21600,,
com.apple.Preview,1,1739225204,1739225205,1739225205.204369,-21600,,
com.microsoft.Excel,1,1739225203,1739225204,1739225204.2757611,-21600,,
com.google.Chrome,50,1739225153,1739225203,1739225203.075567,-21600,,
com.microsoft.Excel,95,1739225058,1739225153,1739225153.673703,-21600,,
com.apple.Preview,4,1739225054,1739225058,1739225058.245144,-21600,,
com.apple.finder,2,1739225052,1739225054,1739225054.475178,-21600,,
com.google.Chrome,17,1739225035,1739225052,1739225052.635528,-21600,,
com.apple.finder,9,1739225014,1739225023,1739225023.177548,-21600,,
com.apple.Preview,3,1739225011,1739225014,1739225014.7240639,-21600,,
com.microsoft.Excel,8,1739225003,1739225011,1739225011.842756,-21600,,
com.apple.Preview,6,1739224997,1739225003,1739225003.263488,-21600,,
com.microsoft.Excel,1,1739224996,1739224997,1739224997.221998,-21600,,
com.apple.Preview,2,1739224994,1739224996,1739224996.2669458,-21600,,
com.apple.finder,6,1739224988,1739224994,1739224994.0472522,-21600,,
com.microsoft.Excel,8,1739224980,1739224988,1739224988.526027,-21600,,
com.apple.finder,9,1739224971,1739224980,1739224980.64637,-21600,,
com.leomehlig.today,7,1739224964,1739224971,1739224971.7974582,-21600,,
com.google.Chrome,4,1739224960,1739224964,1739224964.93956,-21600,,
com.leomehlig.today,46,1739224914,1739224960,1739224960.665734,-21600,,
com.google.Chrome,2,1739224912,1739224914,1739224914.847145,-21600,,
com.microsoft.VSCode,22,1739224885,1739224907,1739224908.4461741,-21600,,
com.google.Chrome,29,1739224856,1739224885,1739224885.7520552,-21600,,
com.microsoft.VSCode,209,1739224647,1739224856,1739224856.553022,-21600,,
com.google.Chrome,8,1739224639,1739224647,1739224647.422126,-21600,,
com.google.Chrome,470,1739223894,1739224364,1739224364.184695,-21600,,
com.microsoft.VSCode,9,1739223885,1739223894,1739223894.5182838,-21600,,
com.google.Chrome,69,1739223816,1739223885,1739223885.8337178,-21600,,
com.google.Chrome,6,1739223779,1739223785,1739223785.598021,-21600,,
com.apple.Passwords,7,1739223772,1739223779,1739223779.849245,-21600,,
com.google.Chrome,11,1739223761,1739223772,1739223772.66903,-21600,,
com.google.Chrome,3,1739223758,1739223761,1739223761.4982429,-21600,,
com.microsoft.VSCode,16,1739223742,1739223758,1739223758.710396,-21600,,
com.google.Chrome,2,1739223740,1739223742,1739223742.847764,-21600,,
com.microsoft.VSCode,49,1739223691,1739223740,1739223740.608645,-21600,,
com.google.Chrome,5,1739223686,1739223691,1739223692.0266109,-21600,,
com.microsoft.VSCode,1,1739223685,1739223686,1739223686.728832,-21600,,
com.google.Chrome,40,1739223645,1739223685,1739223685.051128,-21600,,
com.microsoft.VSCode,4,1739223641,1739223645,1739223645.512062,-21600,,
com.google.Chrome,12,1739223629,1739223641,1739223641.120871,-21600,,
com.microsoft.VSCode,3,1739223626,1739223629,1739223629.244547,-21600,,
com.google.Chrome,24,1739223602,1739223626,1739223626.638616,-21600,,
com.microsoft.VSCode,148,1739223454,1739223602,1739223602.440423,-21600,,
com.google.Chrome,1,1739223453,1739223454,1739223454.7703218,-21600,,
com.microsoft.VSCode,2,1739223451,1739223453,1739223454.035627,-21600,,
com.google.Chrome,9,1739223442,1739223451,1739223451.188972,-21600,,
com.microsoft.VSCode,1,1739223441,1739223442,1739223442.2850509,-21600,,
com.google.Chrome,1,1739223440,1739223441,1739223441.304915,-21600,,
com.microsoft.VSCode,13,1739223427,1739223440,1739223440.252944,-21600,,
com.google.Chrome,25,1739223402,1739223427,1739223427.4261,-21600,,
com.microsoft.VSCode,234,1739223168,1739223402,1739223403.018413,-21600,,
com.google.Chrome,107,1739223061,1739223168,1739223168.31676,-21600,,
com.microsoft.VSCode,3,1739223058,1739223061,1739223061.588,-21600,,
com.google.Chrome,13,1739223045,1739223058,1739223059.0042,-21600,,
com.apple.Notes,5,1739223040,1739223045,1739223045.8734698,-21600,,
com.apple.Passwords,1,1739223039,1739223040,1739223040.285726,-21600,,
com.apple.Notes,246,1739222793,1739223039,1739223039.672442,-21600,,
com.leomehlig.today,38,1739222755,1739222793,1739222794.006099,-21600,,
com.google.Chrome,5,1739222750,1739222755,1739222755.194438,-21600,,
com.google.Chrome,134,1739213292,1739213426,1739213426.61209,-21600,,
com.leomehlig.today,81,1739213211,1739213292,1739213292.9909282,-21600,,
com.google.Chrome,66,1739213145,1739213211,1739213211.2032251,-21600,,
com.google.Chrome,675,1739211123,1739211798,1739211798.908983,-21600,,
com.microsoft.VSCode,6,1739211117,1739211123,1739211123.249083,-21600,,
com.leomehlig.today,2,1739211115,1739211117,1739211117.1060271,-21600,,
com.google.Chrome,9,1739211106,1739211115,1739211115.658383,-21600,,
com.leomehlig.today,0,1739211106,1739211106,1739211107.0376039,-21600,,
com.leomehlig.today,17,1739206047,1739206064,1739206064.902401,-21600,,
com.microsoft.VSCode,3,1739206044,1739206047,1739206047.732728,-21600,,
com.microsoft.VSCode,18,1739201470,1739201488,1739201488.5102448,-21600,,
com.google.Chrome,76,1739201394,1739201470,1739201470.564392,-21600,,
com.google.Chrome,2,1739200348,1739200350,1739200350.2160258,-21600,,
com.google.Chrome,613,1739199275,1739199888,1739199888.0961351,-21600,,
com.microsoft.VSCode,97,1739199178,1739199275,1739199275.562259,-21600,,
com.google.Chrome,12,1739199166,1739199178,1739199178.962029,-21600,,
com.microsoft.VSCode,2,1739199164,1739199166,1739199167.018745,-21600,,
com.google.Chrome,4,1739199160,1739199164,1739199164.868712,-21600,,
com.google.Chrome,300,1739198510,1739198810,1739198810.81509,-21600,,
com.microsoft.VSCode,2,1739198508,1739198510,1739198510.825173,-21600,,
com.google.Chrome,11,1739198497,1739198508,1739198508.5417972,-21600,,
com.microsoft.VSCode,7,1739198490,1739198497,1739198497.040564,-21600,,
com.google.Chrome,23,1739198467,1739198490,1739198490.920589,-21600,,
com.microsoft.VSCode,22,1739198445,1739198467,1739198467.6973162,-21600,,
com.google.Chrome,9,1739198436,1739198445,1739198453.571248,-21600,,
com.apple.Passwords,10,1739198426,1739198436,1739198448.7310848,-21600,,
com.google.Chrome,4,1739198422,1739198426,1739198438.9225159,-21600,,
com.microsoft.VSCode,2,1739198420,1739198422,1739198430.307918,-21600,,
com.apple.finder,1,1739198350,1739198351,1739198351.534484,-21600,,
com.microsoft.VSCode,0,1739198350,1739198350,1739198350.95084,-21600,,
com.google.Chrome,30,1739198259,1739198289,1739198289.651475,-21600,,
com.microsoft.VSCode,17,1739198242,1739198259,1739198259.421195,-21600,,
com.google.Chrome,1,1739198241,1739198242,1739198242.4918962,-21600,,
com.microsoft.VSCode,37,1739198204,1739198241,1739198241.472155,-21600,,
com.google.Chrome,349,1739197855,1739198204,1739198204.271743,-21600,,
com.leomehlig.today,9,1739197846,1739197855,1739197856.5954309,-21600,,
com.leomehlig.today,2,1739163205,1739163207,1739163207.7420921,-21600,,
com.apple.shortcuts,2,1739163203,1739163205,1739163205.2871141,-21600,,
com.leomehlig.today,68,1739163135,1739163203,1739163203.665858,-21600,,
com.apple.shortcuts,6,1739163129,1739163135,1739163135.4983258,-21600,,
com.apple.finder,4,1739163125,1739163129,1739163129.948419,-21600,,
com.microsoft.VSCode,530,1739162595,1739163125,1739163125.810576,-21600,,
com.apple.finder,8,1739162587,1739162595,1739162595.260985,-21600,,
com.apple.shortcuts,1,1739162586,1739162587,1739162587.721914,-21600,,
com.apple.finder,16,1739162546,1739162562,1739162562.811549,-21600,,
com.apple.shortcuts,5,1739162541,1739162546,1739162546.639822,-21600,,
com.apple.finder,2,1739162539,1739162541,1739162541.792293,-21600,,
com.google.Chrome,3,1739162536,1739162539,1739162539.880927,-21600,,
com.google.Chrome,698,1739161597,1739162295,1739162295.92645,-21600,,
com.google.Chrome,3,1739161078,1739161081,1739161081.46823,-21600,,
com.apple.finder,4,1739161074,1739161078,1739161078.2231998,-21600,,
com.apple.systempreferences,3,1739161071,1739161074,1739161074.700515,-21600,,
com.google.Chrome,5,1739161066,1739161071,1739161071.3581629,-21600,,
com.microsoft.VSCode,57,1739161009,1739161066,1739161067.5455,-21600,,
com.google.Chrome,38,1739160971,1739161009,1739161009.459553,-21600,,
com.microsoft.VSCode,13,1739160958,1739160971,1739160971.4962258,-21600,,
com.microsoft.VSCode,302,1739160118,1739160420,1739160420.9784179,-21600,,
com.google.Chrome,1,1739160117,1739160118,1739160118.478801,-21600,,
com.google.Chrome,4,1739160113,1739160117,1739160117.477804,-21600,,
com.microsoft.VSCode,3,1739160110,1739160113,1739160113.415986,-21600,,
com.google.Chrome,42,1739160068,1739160110,1739160110.0918322,-21600,,
com.microsoft.VSCode,1,1739160067,1739160068,1739160068.449575,-21600,,
com.google.Chrome,7,1739160060,1739160067,1739160067.219102,-21600,,
com.microsoft.VSCode,5,1739160055,1739160060,1739160060.842939,-21600,,
com.google.Chrome,17,1739160038,1739160055,1739160055.4185119,-21600,,
com.microsoft.VSCode,38,1739160000,1739160038,1739160038.764853,-21600,,
com.google.Chrome,8,1739159992,1739160000,1739160000.3179169,-21600,,
com.microsoft.VSCode,115,1739159877,1739159992,1739159992.1948252,-21600,,
com.google.Chrome,2,1739159875,1739159877,1739159877.059421,-21600,,
com.microsoft.VSCode,11,1739159864,1739159875,1739159875.467019,-21600,,
com.google.Chrome,78,1739159786,1739159864,1739159864.702149,-21600,,
com.google.Chrome,1,1739159785,1739159786,1739159786.444984,-21600,,
com.microsoft.VSCode,204,1739159581,1739159785,1739159785.408776,-21600,,
com.google.Chrome,381,1739159200,1739159581,1739159581.197269,-21600,,
com.google.Chrome,125,1739159075,1739159200,1739159200.247705,-21600,,
com.google.Chrome,403,1739157278,1739157681,1739157681.615909,-21600,,
com.microsoft.VSCode,12,1739157266,1739157278,1739157278.657298,-21600,,
com.apple.systempreferences,63,1739157203,1739157266,1739157266.704012,-21600,,
com.google.Chrome,19,1739157184,1739157203,1739157203.0417209,-21600,,
com.apple.Passwords,6,1739157178,1739157184,1739157184.381254,-21600,,
com.google.Chrome,7,1739157171,1739157178,1739157178.7969189,-21600,,
com.microsoft.VSCode,28,1739157143,1739157171,1739157171.245467,-21600,,
com.microsoft.VSCode,313,1739156443,1739156756,1739156756.2133322,-21600,,
com.google.Chrome,2,1739156441,1739156443,1739156443.371032,-21600,,
com.apple.Passwords,7,1739156434,1739156441,1739156441.115237,-21600,,
com.google.Chrome,8,1739156426,1739156434,1739156434.4502301,-21600,,
com.microsoft.VSCode,127,1739156299,1739156426,1739156426.8881412,-21600,,
com.google.Chrome,20,1739156279,1739156299,1739156300.091413,-21600,,
com.microsoft.VSCode,46,1739156233,1739156279,1739156279.458369,-21600,,
com.google.Chrome,2,1739156231,1739156233,1739156233.451498,-21600,,
com.microsoft.VSCode,4,1739156227,1739156231,1739156231.528524,-21600,,
com.google.Chrome,111,1739156116,1739156227,1739156227.237287,-21600,,
com.microsoft.VSCode,125,1739155991,1739156116,1739156116.473126,-21600,,
com.google.Chrome,10,1739155981,1739155991,1739155991.669086,-21600,,
com.microsoft.VSCode,25,1739155956,1739155981,1739155981.714267,-21600,,
com.google.Chrome,10,1739155946,1739155956,1739155956.2433062,-21600,,
com.microsoft.VSCode,74,1739155872,1739155946,1739155946.390462,-21600,,
com.google.Chrome,2,1739155870,1739155872,1739155872.1236439,-21600,,
com.microsoft.VSCode,39,1739155831,1739155870,1739155870.654059,-21600,,
com.google.Chrome,32,1739155799,1739155831,1739155831.434515,-21600,,
com.google.Chrome,93,1739155706,1739155799,1739155799.603455,-21600,,
com.microsoft.VSCode,12,1739155694,1739155706,1739155706.2161999,-21600,,
com.google.Chrome,80,1739155614,1739155694,1739155694.8638859,-21600,,
com.microsoft.VSCode,28,1739155586,1739155614,1739155614.385786,-21600,,
com.google.Chrome,6,1739155580,1739155586,1739155586.111854,-21600,,
com.microsoft.VSCode,186,1739155394,1739155580,1739155581.0564442,-21600,,
com.google.Chrome,36,1739155358,1739155394,1739155394.3829288,-21600,,
com.microsoft.VSCode,11,1739155347,1739155358,1739155358.352535,-21600,,
com.google.Chrome,11,1739155336,1739155347,1739155347.720224,-21600,,
com.microsoft.VSCode,21,1739155315,1739155336,1739155336.4995131,-21600,,
com.google.Chrome,29,1739155286,1739155315,1739155315.5033178,-21600,,
com.google.Chrome,1,1739155285,1739155286,1739155286.1024032,-21600,,
com.microsoft.VSCode,147,1739155138,1739155285,1739155285.493215,-21600,,
com.google.Chrome,10,1739155128,1739155138,1739155139.022198,-21600,,
com.microsoft.VSCode,14,1739155114,1739155128,1739155128.379396,-21600,,
com.google.Chrome,6,1739155108,1739155114,1739155115.037636,-21600,,
com.microsoft.VSCode,437,1739154671,1739155108,1739155108.30234,-21600,,
com.google.Chrome,1,1739154670,1739154671,1739154671.56516,-21600,,
com.microsoft.VSCode,9,1739154661,1739154670,1739154670.972213,-21600,,
com.google.Chrome,1,1739154660,1739154661,1739154661.476444,-21600,,
com.microsoft.VSCode,207,1739154453,1739154660,1739154660.082419,-21600,,
com.google.Chrome,2,1739154451,1739154453,1739154453.7948132,-21600,,
com.google.Chrome,3,1739154448,1739154451,1739154451.822497,-21600,,
com.google.Chrome,42,1739154406,1739154448,1739154448.51984,-21600,,
com.google.Chrome,2,1739154404,1739154406,1739154406.67128,-21600,,
com.microsoft.VSCode,98,1739154306,1739154404,1739154404.846406,-21600,,
com.google.Chrome,15,1739154291,1739154306,1739154306.609995,-21600,,
com.microsoft.VSCode,84,1739154207,1739154291,1739154291.412035,-21600,,
com.google.Chrome,12,1739154195,1739154207,1739154207.268085,-21600,,
com.microsoft.VSCode,7,1739154188,1739154195,1739154195.819526,-21600,,
com.google.Chrome,8,1739154180,1739154188,1739154188.5994558,-21600,,
com.microsoft.VSCode,24,1739154156,1739154180,1739154180.9430141,-21600,,
com.google.Chrome,1,1739154155,1739154156,1739154156.540695,-21600,,
com.microsoft.VSCode,68,1739154087,1739154155,1739154155.247171,-21600,,
com.google.Chrome,57,1739154030,1739154087,1739154087.500824,-21600,,
com.microsoft.VSCode,12,1739154018,1739154030,1739154030.2313771,-21600,,
com.google.Chrome,18,1739154000,1739154018,1739154018.944588,-21600,,
com.microsoft.VSCode,90,1739153910,1739154000,1739154000.265442,-21600,,
com.google.Chrome,17,1739153893,1739153910,1739153910.694216,-21600,,
com.microsoft.VSCode,8,1739153885,1739153893,1739153893.979172,-21600,,
com.google.Chrome,1,1739153884,1739153885,1739153885.5095,-21600,,
com.microsoft.VSCode,32,1739153852,1739153884,1739153884.1398869,-21600,,
com.google.Chrome,1,1739153851,1739153852,1739153852.545483,-21600,,
com.microsoft.VSCode,53,1739153798,1739153851,1739153851.0994759,-21600,,
com.google.Chrome,2,1739153796,1739153798,1739153798.097317,-21600,,
com.microsoft.VSCode,27,1739153769,1739153796,1739153796.283266,-21600,,
com.google.Chrome,20,1739153749,1739153769,1739153769.9788651,-21600,,
com.apple.Passwords,7,1739153742,1739153749,1739153749.46258,-21600,,
com.google.Chrome,9,1739153733,1739153742,1739153742.6696959,-21600,,
com.microsoft.VSCode,4,1739153729,1739153733,1739153733.467551,-21600,,
com.google.Chrome,2,1739153727,1739153729,1739153729.9866881,-21600,,
com.microsoft.VSCode,16,1739153711,1739153727,1739153727.49016,-21600,,
com.google.Chrome,12,1739153699,1739153711,1739153711.811751,-21600,,
com.microsoft.VSCode,25,1739153674,1739153699,1739153699.370347,-21600,,
com.google.Chrome,1,1739153673,1739153674,1739153674.647716,-21600,,
com.microsoft.VSCode,55,1739153618,1739153673,1739153673.230112,-21600,,
com.google.Chrome,15,1739153603,1739153618,1739153618.7445269,-21600,,
com.microsoft.VSCode,26,1739153577,1739153603,1739153603.865049,-21600,,
com.google.Chrome,2,1739153575,1739153577,1739153577.1722999,-21600,,
com.microsoft.VSCode,11,1739153564,1739153575,1739153575.289503,-21600,,
com.google.Chrome,11,1739153553,1739153564,1739153564.234943,-21600,,
com.microsoft.VSCode,57,1739153496,1739153553,1739153553.898596,-21600,,
com.google.Chrome,35,1739153461,1739153496,1739153496.66641,-21600,,
com.microsoft.VSCode,11,1739153450,1739153461,1739153462.007371,-21600,,
com.google.Chrome,2,1739153448,1739153450,1739153450.6774368,-21600,,
com.microsoft.VSCode,29,1739153419,1739153448,1739153448.162942,-21600,,
com.google.Chrome,2,1739153417,1739153419,1739153419.6667662,-21600,,
com.microsoft.VSCode,9,1739153408,1739153417,1739153417.373004,-21600,,
com.google.Chrome,1,1739153407,1739153408,1739153408.789788,-21600,,
com.google.Chrome,11,1739153396,1739153407,1739153407.410612,-21600,,
com.google.Chrome,5,1739153391,1739153396,1739153396.965498,-21600,,
com.microsoft.VSCode,16,1739153375,1739153391,1739153391.644477,-21600,,
com.google.Chrome,2,1739153373,1739153375,1739153375.9137812,-21600,,
com.microsoft.VSCode,19,1739153354,1739153373,1739153373.463892,-21600,,
com.google.Chrome,2,1739153352,1739153354,1739153354.1490998,-21600,,
com.google.Chrome,8,1739153344,1739153352,1739153352.7438269,-21600,,
com.google.Chrome,30,1739153314,1739153344,1739153344.820668,-21600,,
com.google.Chrome,1,1739153313,1739153314,1739153314.4185739,-21600,,
com.microsoft.VSCode,9,1739153304,1739153313,1739153313.4592528,-21600,,
com.google.Chrome,25,1739153279,1739153304,1739153304.3152652,-21600,,
com.google.Chrome,22,1739153257,1739153279,1739153280.038194,-21600,,
com.google.Chrome,24,1739153233,1739153257,1739153257.4808831,-21600,,
com.google.Chrome,83,1739153150,1739153233,1739153233.172622,-21600,,
com.microsoft.VSCode,35,1739153115,1739153150,1739153150.137254,-21600,,
com.google.Chrome,3,1739153112,1739153115,1739153115.382947,-21600,,
com.microsoft.VSCode,22,1739153090,1739153112,1739153112.290609,-21600,,
com.google.Chrome,37,1739153053,1739153090,1739153090.6081738,-21600,,
com.microsoft.VSCode,40,1739153013,1739153053,1739153053.773573,-21600,,
com.google.Chrome,3,1739153010,1739153013,1739153013.8060122,-21600,,
com.microsoft.VSCode,41,1739152969,1739153010,1739153010.2809958,-21600,,
com.google.Chrome,11,1739152958,1739152969,1739152970.013352,-21600,,
com.microsoft.VSCode,2,1739152956,1739152958,1739152958.364084,-21600,,
com.google.Chrome,4,1739152952,1739152956,1739152956.354508,-21600,,
com.apple.Passwords,8,1739152944,1739152952,1739152952.354922,-21600,,
com.google.Chrome,7,1739152933,1739152940,1739152940.903658,-21600,,
com.microsoft.VSCode,77,1739152856,1739152933,1739152933.061265,-21600,,
com.google.Chrome,12,1739152844,1739152856,1739152856.200875,-21600,,
com.microsoft.VSCode,38,1739152806,1739152844,1739152844.1810222,-21600,,
com.google.Chrome,18,1739152788,1739152806,1739152806.2732902,-21600,,
com.microsoft.VSCode,54,1739152734,1739152788,1739152788.120028,-21600,,
com.google.Chrome,6,1739152728,1739152734,1739152734.768357,-21600,,
com.microsoft.VSCode,13,1739152715,1739152728,1739152728.208403,-21600,,
com.microsoft.VSCode,96,1739152602,1739152698,1739152698.111573,-21600,,
com.microsoft.VSCode,8,1739152587,1739152595,1739152595.832478,-21600,,
com.microsoft.VSCode,5,1739152571,1739152576,1739152576.17658,-21600,,
com.microsoft.VSCode,2,1739152560,1739152562,1739152562.289019,-21600,,
com.google.Chrome,7,1739152538,1739152545,1739152545.897653,-21600,,
com.apple.Passwords,6,1739152532,1739152538,1739152539.789144,-21600,,
com.google.Chrome,11,1739152521,1739152532,1739152539.303234,-21600,,
com.microsoft.VSCode,11,1739152510,1739152521,1739152536.146877,-21600,,
com.apple.findmy,7,1739152478,1739152485,1739152485.7849731,-21600,EB445137-D7F5-57EC-87DA-1DB460D64046,"iPhone13,2"
com.microsoft.VSCode,1,1739152456,1739152457,1739152457.226656,-21600,,
com.apple.Health,55,1739152415,1739152470,1739152470.932904,-21600,EB445137-D7F5-57EC-87DA-1DB460D64046,"iPhone13,2"
com.apple.Health,2,1739152403,1739152405,1739152405.439929,-21600,EB445137-D7F5-57EC-87DA-1DB460D64046,"iPhone13,2"
com.apple.Health,10,1739152279,1739152289,1739152289.636528,-21600,EB445137-D7F5-57EC-87DA-1DB460D64046,"iPhone13,2"
com.microsoft.VSCode,160,1739152233,1739152393,1739152393.918933,-21600,,
com.google.Chrome,1,1739152232,1739152233,1739152233.767276,-21600,,
com.microsoft.VSCode,51,1739152181,1739152232,1739152232.861459,-21600,,
com.google.Chrome,14,1739152167,1739152181,1739152181.6397228,-21600,,
com.microsoft.VSCode,58,1739152109,1739152167,1739152167.2697701,-21600,,
com.google.Chrome,81,1739152028,1739152109,1739152109.822712,-21600,,
com.leomehlig.today,1,1739152027,1739152028,1739152028.147726,-21600,,
com.microsoft.VSCode,30,1739151997,1739152027,1739152027.4478521,-21600,,
com.leomehlig.today,2,1739151995,1739151997,1739151997.208152,-21600,,
com.microsoft.VSCode,52,1739151943,1739151995,1739151996.057888,-21600,,
com.leomehlig.today,20,1739151923,1739151943,1739151943.846161,-21600,,
com.google.Chrome,5,1739151918,1739151923,1739151923.637697,-21600,,
com.leomehlig.today,53,1739151865,1739151918,1739151918.98849,-21600,,
com.apple.MobileSMS,144,1739151714,1739151858,1739151858.845289,-21600,EB445137-D7F5-57EC-87DA-1DB460D64046,"iPhone13,2"
com.myfitnesspal.mfp,63,1739151264,1739151327,1739151327.9676008,-21600,EB445137-D7F5-57EC-87DA-1DB460D64046,"iPhone13,2"
com.apple.calculator,2,1739150537,1739150539,1739150539.9407601,-21600,EB445137-D7F5-57EC-87DA-1DB460D64046,"iPhone13,2"
com.apple.calculator,5,1739149701,1739149706,1739149706.468402,-21600,EB445137-D7F5-57EC-87DA-1DB460D64046,"iPhone13,2"
com.truebill.truebillnative,2,1739149699,1739149701,1739149701.9267511,-21600,EB445137-D7F5-57EC-87DA-1DB460D64046,"iPhone13,2"
com.apple.calculator,4,1739149695,1739149699,1739149699.632647,-21600,EB445137-D7F5-57EC-87DA-1DB460D64046,"iPhone13,2"
com.truebill.truebillnative,3,1739149692,1739149695,1739149695.545745,-21600,EB445137-D7F5-57EC-87DA-1DB460D64046,"iPhone13,2"
com.apple.calculator,4,1739149688,1739149692,1739149692.777094,-21600,EB445137-D7F5-57EC-87DA-1DB460D64046,"iPhone13,2"
com.apple.CoreAuthUI,2,1739149550,1739149552,1739149552.424683,-21600,EB445137-D7F5-57EC-87DA-1DB460D64046,"iPhone13,2"
com.truebill.truebillnative,143,1739149545,1739149688,1739149688.8500118,-21600,EB445137-D7F5-57EC-87DA-1DB460D64046,"iPhone13,2"
com.apple.MobileSMS,10,1739149523,1739149533,1739149533.635689,-21600,EB445137-D7F5-57EC-87DA-1DB460D64046,"iPhone13,2"
com.apple.Health,10,1739149508,1739149518,1739149518.297464,-21600,EB445137-D7F5-57EC-87DA-1DB460D64046,"iPhone13,2"
com.myfitnesspal.mfp,15,1739149493,1739149508,1739149509.276104,-21600,EB445137-D7F5-57EC-87DA-1DB460D64046,"iPhone13,2"
com.apple.Health,7,1739149486,1739149493,1739149493.267023,-21600,EB445137-D7F5-57EC-87DA-1DB460D64046,"iPhone13,2"
com.myfitnesspal.mfp,26,1739149460,1739149486,1739149486.713306,-21600,EB445137-D7F5-57EC-87DA-1DB460D64046,"iPhone13,2"
com.apple.Health,41,1739149418,1739149459,1739149459.364133,-21600,EB445137-D7F5-57EC-87DA-1DB460D64046,"iPhone13,2"
com.apple.AuthKitUIService,2,1739149415,1739149417,1739149417.557472,-21600,EB445137-D7F5-57EC-87DA-1DB460D64046,"iPhone13,2"
com.netflix.Netflix,6,1739149408,1739149414,1739149415.168037,-21600,EB445137-D7F5-57EC-87DA-1DB460D64046,"iPhone13,2"
com.google.chrome.ios,3,1739149405,1739149408,1739149408.586646,-21600,EB445137-D7F5-57EC-87DA-1DB460D64046,"iPhone13,2"
com.apple.MobileSMS,16,1739149389,1739149405,1739149405.487107,-21600,EB445137-D7F5-57EC-87DA-1DB460D64046,"iPhone13,2"
com.apple.MobileSMS,1,1739149387,1739149388,1739149389.209638,-21600,EB445137-D7F5-57EC-87DA-1DB460D64046,"iPhone13,2"
com.apple.MobileSMS,49,1739149143,1739149192,1739149192.310154,-21600,EB445137-D7F5-57EC-87DA-1DB460D64046,"iPhone13,2"
com.apple.MobileSMS,4,1739149136,1739149140,1739149140.692627,-21600,EB445137-D7F5-57EC-87DA-1DB460D64046,"iPhone13,2"
com.apple.news,16,1739148957,1739148973,1739148973.6917338,-21600,EB445137-D7F5-57EC-87DA-1DB460D64046,"iPhone13,2"
com.apple.Health,5,1739148943,1739148948,1739148948.490096,-21600,EB445137-D7F5-57EC-87DA-1DB460D64046,"iPhone13,2"
com.apple.MobileSMS,36,1739148906,1739148942,1739148943.0625582,-21600,EB445137-D7F5-57EC-87DA-1DB460D64046,"iPhone13,2"
com.microsoft.Office.Outlook,7,1739148899,1739148906,1739148906.287368,-21600,EB445137-D7F5-57EC-87DA-1DB460D64046,"iPhone13,2"
com.apple.Health,11,1739148877,1739148888,1739148888.620055,-21600,EB445137-D7F5-57EC-87DA-1DB460D64046,"iPhone13,2"
com.google.Gmail,7,1739148869,1739148876,1739148876.788197,-21600,EB445137-D7F5-57EC-87DA-1DB460D64046,"iPhone13,2"
com.apple.Maps,0,1739148869,1739148869,1739148870.09442,-21600,EB445137-D7F5-57EC-87DA-1DB460D64046,"iPhone13,2"
com.apple.Maps,8,1739148538,1739148546,1739148546.553097,-21600,EB445137-D7F5-57EC-87DA-1DB460D64046,"iPhone13,2"
com.apple.Music,5,1739148531,1739148536,1739148536.2499871,-21600,EB445137-D7F5-57EC-87DA-1DB460D64046,"iPhone13,2"
com.apple.Music,9,1739147459,1739147468,1739147468.739641,-21600,EB445137-D7F5-57EC-87DA-1DB460D64046,"iPhone13,2"
com.apple.MobileSMS,2,1739147455,1739147457,1739147457.8945742,-21600,EB445137-D7F5-57EC-87DA-1DB460D64046,"iPhone13,2"
com.apple.MobileSMS,2,1739147318,1739147320,1739147320.618105,-21600,EB445137-D7F5-57EC-87DA-1DB460D64046,"iPhone13,2"
com.apple.InCallService,1,1739147317,1739147318,1739147318.479229,-21600,EB445137-D7F5-57EC-87DA-1DB460D64046,"iPhone13,2"
com.apple.InCallService,5,1739147295,1739147300,1739147300.253015,-21600,EB445137-D7F5-57EC-87DA-1DB460D64046,"iPhone13,2"
com.apple.MobileSMS,2,1739147293,1739147295,1739147295.905147,-21600,EB445137-D7F5-57EC-87DA-1DB460D64046,"iPhone13,2"
com.apple.InCallService,6,1739147287,1739147293,1739147293.517524,-21600,EB445137-D7F5-57EC-87DA-1DB460D64046,"iPhone13,2"
com.apple.InCallService,2,1739147263,1739147265,1739147265.20479,-21600,EB445137-D7F5-57EC-87DA-1DB460D64046,"iPhone13,2"
com.apple.MobileSMS,5,1739147258,1739147263,1739147264.010328,-21600,EB445137-D7F5-57EC-87DA-1DB460D64046,"iPhone13,2"
com.apple.news,1,1739147257,1739147258,1739147259.045829,-21600,EB445137-D7F5-57EC-87DA-1DB460D64046,"iPhone13,2"
com.leomehlig.today,103,1739146981,1739147084,1739147084.73417,-21600,,
com.google.Chrome,1,1739146980,1739146981,1739146981.8913631,-21600,,
com.leomehlig.today,1,1739146979,1739146980,1739146980.4658551,-21600,,
com.google.Chrome,29,1739146950,1739146979,1739146979.587409,-21600,,
com.leomehlig.today,33,1739146917,1739146950,1739146950.826334,-21600,,
com.apple.Notes,11,1739146906,1739146917,1739146917.896967,-21600,,
com.leomehlig.today,53,1739146853,1739146906,1739146906.289156,-21600,,
com.google.Chrome,122,1739146731,1739146853,1739146853.226997,-21600,,
com.apple.iCal,4,1739146727,1739146731,1739146731.940236,-21600,,
com.google.Chrome,45,1739146682,1739146727,1739146727.726403,-21600,,
com.apple.finder,1,1739146681,1739146682,1739146682.234672,-21600,,
com.google.Chrome,82,1739146599,1739146681,1739146681.370205,-21600,,
com.apple.finder,29,1739146570,1739146599,1739146600.001999,-21600,,
com.leomehlig.today,1,1739146569,1739146570,1739146570.7736669,-21600,,
com.microsoft.Word,138,1739146431,1739146569,1739146569.886409,-21600,,
com.leomehlig.today,5,1739146426,1739146431,1739146431.902919,-21600,,
com.microsoft.Word,1,1739146425,1739146426,1739146426.160042,-21600,,
com.google.Chrome,102,1739146323,1739146425,1739146425.135113,-21600,,
com.leomehlig.today,2,1739144051,1739144053,1739144054.747271,-21600,,
com.apple.news,159,1739143803,1739143962,1739143963.0657911,-21600,EB445137-D7F5-57EC-87DA-1DB460D64046,"iPhone13,2"
com.leomehlig.today,29,1739143727,1739143756,1739143756.042337,-21600,,
com.apple.Preview,593,1739143134,1739143727,1739143727.987798,-21600,,
com.apple.finder,2,1739143132,1739143134,1739143134.582927,-21600,,
com.apple.MobileSMS,2,1739142411,1739142413,1739142413.735128,-21600,EB445137-D7F5-57EC-87DA-1DB460D64046,"iPhone13,2"
com.apple.MobileSMS,29,1739142382,1739142411,1739142411.1121368,-21600,EB445137-D7F5-57EC-87DA-1DB460D64046,"iPhone13,2"
com.apple.Preview,785,1739142347,1739143132,1739143132.406293,-21600,,
com.apple.finder,6,1739142341,1739142347,1739142347.75194,-21600,,
com.leomehlig.today,51,1739142290,1739142341,1739142341.460527,-21600,,
com.google.Chrome,355,1739141935,1739142290,1739142290.637264,-21600,,
com.toyopagroup.picaboo,26,1739141286,1739141312,1739141312.3497481,-21600,EB445137-D7F5-57EC-87DA-1DB460D64046,"iPhone13,2"
com.google.Chrome,351,1739141254,1739141605,1739141605.573976,-21600,,
com.leomehlig.today,40,1739140242,1739140282,1739140282.262454,-21600,,
com.google.Chrome,314,1739139928,1739140242,1739140242.772231,-21600,,
com.apple.Preview,688,1739139240,1739139928,1739139928.458569,-21600,,
com.leomehlig.today,7,1739139233,1739139240,1739139240.569047,-21600,,
com.toyopagroup.picaboo,5,1739139222,1739139227,1739139227.348888,-21600,EB445137-D7F5-57EC-87DA-1DB460D64046,"iPhone13,2"
com.toyopagroup.picaboo,13,1739138471,1739138484,1739138484.26243,-21600,EB445137-D7F5-57EC-87DA-1DB460D64046,"iPhone13,2"
com.apple.Health,1,1739138470,1739138471,1739138471.5321488,-21600,EB445137-D7F5-57EC-87DA-1DB460D64046,"iPhone13,2"
com.apple.Preview,881,1739138352,1739139233,1739139234.124053,-21600,,
com.apple.finder,39,1739138313,1739138352,1739138352.8116832,-21600,,
com.apple.iCal,6,1739138307,1739138313,1739138313.843059,-21600,,
com.apple.finder,3,1739138304,1739138307,1739138307.6480079,-21600,,
com.apple.iCal,11,1739138293,1739138304,1739138304.511378,-21600,,
com.apple.finder,17,1739138276,1739138293,1739138293.888639,-21600,,
com.apple.Health,20,1739137968,1739137988,1739137988.5247889,-21600,EB445137-D7F5-57EC-87DA-1DB460D64046,"iPhone13,2"
com.apple.shortcuts,90,1739137878,1739137968,1739137968.867828,-21600,EB445137-D7F5-57EC-87DA-1DB460D64046,"iPhone13,2"
com.apple.Health,3,1739137872,1739137875,1739137875.701222,-21600,EB445137-D7F5-57EC-87DA-1DB460D64046,"iPhone13,2"
com.toyopagroup.picaboo,2,1739137867,1739137869,1739137869.598349,-21600,EB445137-D7F5-57EC-87DA-1DB460D64046,"iPhone13,2"
com.toyopagroup.picaboo,5,1739137818,1739137823,1739137824.03252,-21600,EB445137-D7F5-57EC-87DA-1DB460D64046,"iPhone13,2"
com.myfitnesspal.mfp,2,1739137816,1739137818,1739137818.466182,-21600,EB445137-D7F5-57EC-87DA-1DB460D64046,"iPhone13,2"
com.apple.Preview,587,1739137689,1739138276,1739138277.0567598,-21600,,
com.google.Chrome,78,1739137611,1739137689,1739137689.448938,-21600,,
com.myfitnesspal.mfp,79,1739137589,1739137668,1739137669.334126,-21600,EB445137-D7F5-57EC-87DA-1DB460D64046,"iPhone13,2"
com.toyopagroup.picaboo,13,1739137576,1739137589,1739137589.831335,-21600,EB445137-D7F5-57EC-87DA-1DB460D64046,"iPhone13,2"
com.apple.Preview,255,1739137356,1739137611,1739137611.572897,-21600,,
com.toyopagroup.picaboo,76,1739137141,1739137217,1739137217.912346,-21600,EB445137-D7F5-57EC-87DA-1DB460D64046,"iPhone13,2"
com.apple.Preview,300,1739137055,1739137355,1739137355.58997,-21600,,
com.toyopagroup.picaboo,49,1739136983,1739137032,1739137033.152547,-21600,EB445137-D7F5-57EC-87DA-1DB460D64046,"iPhone13,2"
com.myfitnesspal.mfp,0,1739136983,1739136983,1739136983.354426,-21600,EB445137-D7F5-57EC-87DA-1DB460D64046,"iPhone13,2"
com.myfitnesspal.mfp,44,1739136934,1739136978,1739136978.9089642,-21600,EB445137-D7F5-57EC-87DA-1DB460D64046,"iPhone13,2"
com.toyopagroup.picaboo,58,1739136851,1739136909,1739136909.99439,-21600,EB445137-D7F5-57EC-87DA-1DB460D64046,"iPhone13,2"
com.myfitnesspal.mfp,0,1739136851,1739136851,1739136852.2271662,-21600,EB445137-D7F5-57EC-87DA-1DB460D64046,"iPhone13,2"
com.myfitnesspal.mfp,35,1739136815,1739136850,1739136850.589993,-21600,EB445137-D7F5-57EC-87DA-1DB460D64046,"iPhone13,2"
com.google.Chrome,285,1739136770,1739137055,1739137055.616809,-21600,,
com.apple.Preview,1,1739136769,1739136770,1739136770.7690148,-21600,,
com.toyopagroup.picaboo,66,1739136747,1739136813,1739136814.098252,-21600,EB445137-D7F5-57EC-87DA-1DB460D64046,"iPhone13,2"
com.facebook.Facebook,218,1739136524,1739136742,1739136742.588852,-21600,EB445137-D7F5-57EC-87DA-1DB460D64046,"iPhone13,2"
com.apple.Preview,328,1739136408,1739136736,1739136736.7026029,-21600,,
com.leomehlig.today,3,1739136405,1739136408,1739136408.3214688,-21600,,
com.apple.Preview,71,1739136334,1739136405,1739136405.216496,-21600,,
com.apple.Preview,300,1739136033,1739136333,1739136333.331376,-21600,,
com.google.Chrome,13,1739136020,1739136033,1739136033.31107,-21600,,
com.apple.Preview,135,1739135885,1739136020,1739136020.29031,-21600,,
com.google.Chrome,1,1739135884,1739135885,1739135885.376585,-21600,,
com.apple.Preview,43,1739135841,1739135884,1739135884.810279,-21600,,
com.google.Chrome,23,1739135818,1739135841,1739135841.114081,-21600,,
com.apple.Preview,24,1739135794,1739135818,1739135818.620831,-21600,,
com.google.Chrome,148,1739135646,1739135794,1739135794.704629,-21600,,
com.apple.Preview,2,1739135644,1739135646,1739135646.713253,-21600,,
com.google.Chrome,131,1739135513,1739135644,1739135644.613986,-21600,,
com.apple.Preview,2,1739135511,1739135513,1739135514.010524,-21600,,
com.google.Chrome,5,1739135506,1739135511,1739135511.061891,-21600,,
com.apple.Preview,17,1739135489,1739135506,1739135506.4084911,-21600,,
com.google.Chrome,18,1739135471,1739135489,1739135489.176769,-21600,,
com.apple.Preview,62,1739135409,1739135471,1739135471.1799731,-21600,,
com.google.Chrome,136,1739135273,1739135409,1739135409.819559,-21600,,
com.apple.Preview,697,1739134576,1739135273,1739135273.724359,-21600,,
com.apple.finder,17,1739134559,1739134576,1739134576.928978,-21600,,
com.google.Chrome,46,1739134513,1739134559,1739134559.9961429,-21600,,
com.apple.Preview,20,1739134493,1739134513,1739134513.11348,-21600,,
com.google.Chrome,101,1739134392,1739134493,1739134493.940347,-21600,,
com.apple.Preview,22,1739134370,1739134392,1739134392.842068,-21600,,
com.google.Chrome,8,1739134362,1739134370,1739134370.835737,-21600,,
com.apple.finder,4,1739134358,1739134362,1739134362.126524,-21600,,
com.apple.Preview,1,1739134357,1739134358,1739134358.559999,-21600,,
com.apple.finder,1,1739134356,1739134357,1739134357.623121,-21600,,
com.google.Chrome,755,1739133601,1739134356,1739134356.115202,-21600,,
com.apple.finder,61,1739133540,1739133601,1739133601.203226,-21600,,
com.intsig.CamScannerLite,92,1739133452,1739133544,1739133545.0680141,-21600,EB445137-D7F5-57EC-87DA-1DB460D64046,"iPhone13,2"
com.apple.iCal,95,1739133445,1739133540,1739133540.713337,-21600,,
com.toyopagroup.picaboo,63,1739133355,1739133418,1739133418.426738,-21600,EB445137-D7F5-57EC-87DA-1DB460D64046,"iPhone13,2"
com.apple.Health,48,1739133307,1739133355,1739133355.522564,-21600,EB445137-D7F5-57EC-87DA-1DB460D64046,"iPhone13,2"
com.myfitnesspal.mfp,104,1739133201,1739133305,1739133305.179301,-21600,EB445137-D7F5-57EC-87DA-1DB460D64046,"iPhone13,2"
com.toyopagroup.picaboo,40,1739133157,1739133197,1739133197.694744,-21600,EB445137-D7F5-57EC-87DA-1DB460D64046,"iPhone13,2"
com.apple.weather,0,1739133157,1739133157,1739133157.8400378,-21600,EB445137-D7F5-57EC-87DA-1DB460D64046,"iPhone13,2"
com.apple.iCal,314,1739133130,1739133444,1739133444.8224602,-21600,,
com.apple.finder,73,1739133057,1739133130,1739133130.840819,-21600,,
com.google.Chrome,14,1739133043,1739133057,1739133057.3876638,-21600,,
com.apple.finder,89,1739132954,1739133043,1739133043.708943,-21600,,
com.apple.dt.Xcode,5,1739132949,1739132954,1739132954.6168709,-21600,,
com.google.Chrome,23,1739132926,1739132949,1739132949.806992,-21600,,
com.leomehlig.today,71,1739132750,1739132821,1739132822.0340328,-21600,,
com.apple.weather,4,1739131254,1739131258,1739131258.7425342,-21600,EB445137-D7F5-57EC-87DA-1DB460D64046,"iPhone13,2"
com.apple.weather,2,1739131252,1739131254,1739131254.414022,-21600,EB445137-D7F5-57EC-87DA-1DB460D64046,"iPhone13,2"
com.leomehlig.today,3,1739130517,1739130520,1739130520.917132,-21600,,
com.google.ios.youtube,50,1739130463,1739130513,1739130513.639914,-21600,EB445137-D7F5-57EC-87DA-1DB460D64046,"iPhone13,2"
com.google.ios.youtube,58,1739130399,1739130457,1739130457.6101341,-21600,EB445137-D7F5-57EC-87DA-1DB460D64046,"iPhone13,2"
com.apple.MobileSMS,2,1739130397,1739130399,1739130399.837461,-21600,EB445137-D7F5-57EC-87DA-1DB460D64046,"iPhone13,2"
com.myfitnesspal.mfp,1,1739130396,1739130397,1739130398.0669131,-21600,EB445137-D7F5-57EC-87DA-1DB460D64046,"iPhone13,2"
com.myfitnesspal.mfp,3,1739130392,1739130395,1739130395.517387,-21600,EB445137-D7F5-57EC-87DA-1DB460D64046,"iPhone13,2"
com.microsoft.VSCode,2,1739130115,1739130117,1739130118.272794,-21600,,
com.apple.InCallService,304,1739130088,1739130392,1739130392.487093,-21600,EB445137-D7F5-57EC-87DA-1DB460D64046,"iPhone13,2"
com.myfitnesspal.mfp,33,1739130055,1739130088,1739130088.888918,-21600,EB445137-D7F5-57EC-87DA-1DB460D64046,"iPhone13,2"
com.google.Chrome,163,1739129952,1739130115,1739130115.5378141,-21600,,
com.google.Chrome,368,1739129582,1739129950,1739129950.589137,-21600,,
com.microsoft.VSCode,17,1739129565,1739129582,1739129582.056294,-21600,,
com.apple.InCallService,577,1739129477,1739130054,1739130054.698512,-21600,EB445137-D7F5-57EC-87DA-1DB460D64046,"iPhone13,2"
com.apple.InCallService,162,1739129306,1739129468,1739129468.7797961,-21600,EB445137-D7F5-57EC-87DA-1DB460D64046,"iPhone13,2"
com.apple.InCallService,2,1739128403,1739128405,1739128405.4314408,-21600,EB445137-D7F5-57EC-87DA-1DB460D64046,"iPhone13,2"
com.apple.MobileSMS,7,1739128396,1739128403,1739128403.995494,-21600,EB445137-D7F5-57EC-87DA-1DB460D64046,"iPhone13,2"
com.apple.InCallService,1,1739128395,1739128396,1739128397.2047791,-21600,EB445137-D7F5-57EC-87DA-1DB460D64046,"iPhone13,2"
com.apple.InCallService,2,1739128388,1739128390,1739128390.2864208,-21600,EB445137-D7F5-57EC-87DA-1DB460D64046,"iPhone13,2"
com.apple.MobileSMS,9,1739128379,1739128388,1739128388.191077,-21600,EB445137-D7F5-57EC-87DA-1DB460D64046,"iPhone13,2"
com.apple.MobileSMS,5,1739127384,1739127389,1739127390.049697,-21600,EB445137-D7F5-57EC-87DA-1DB460D64046,"iPhone13,2"
com.apple.findmy,8,1739127376,1739127384,1739127384.293994,-21600,EB445137-D7F5-57EC-87DA-1DB460D64046,"iPhone13,2"
com.apple.MobileSMS,45,1739127331,1739127376,1739127376.601273,-21600,EB445137-D7F5-57EC-87DA-1DB460D64046,"iPhone13,2"
com.microsoft.Office.Outlook,41,1739127290,1739127331,1739127331.198372,-21600,EB445137-D7F5-57EC-87DA-1DB460D64046,"iPhone13,2"
com.microsoft.Office.Outlook,3,1739127234,1739127237,1739127237.227865,-21600,EB445137-D7F5-57EC-87DA-1DB460D64046,"iPhone13,2"
com.leomehlig.today,131,1739127102,1739127233,1739127233.51513,-21600,EB445137-D7F5-57EC-87DA-1DB460D64046,"iPhone13,2"
com.apple.MobileSMS,7,1739127093,1739127100,1739127100.868268,-21600,EB445137-D7F5-57EC-87DA-1DB460D64046,"iPhone13,2"
com.apple.Music,0,1739127093,1739127093,1739127094.44206,-21600,EB445137-D7F5-57EC-87DA-1DB460D64046,"iPhone13,2"
com.apple.Music,29,1739125942,1739125971,1739125972.063762,-21600,EB445137-D7F5-57EC-87DA-1DB460D64046,"iPhone13,2"
com.apple.MobileSMS,1,1739125941,1739125942,1739125943.1028109,-21600,EB445137-D7F5-57EC-87DA-1DB460D64046,"iPhone13,2"
com.apple.MobileSMS,39,1739125271,1739125310,1739125310.593437,-21600,EB445137-D7F5-57EC-87DA-1DB460D64046,"iPhone13,2"
com.google.ios.youtube,21,1739125250,1739125271,1739125272.066325,-21600,EB445137-D7F5-57EC-87DA-1DB460D64046,"iPhone13,2"
com.apple.MobileSMS,6,1739125244,1739125250,1739125250.4794831,-21600,EB445137-D7F5-57EC-87DA-1DB460D64046,"iPhone13,2"
com.myfitnesspal.mfp,2,1739125242,1739125244,1739125244.2835732,-21600,EB445137-D7F5-57EC-87DA-1DB460D64046,"iPhone13,2"
com.myfitnesspal.mfp,13,1739124622,1739124635,1739124635.2803779,-21600,EB445137-D7F5-57EC-87DA-1DB460D64046,"iPhone13,2"
com.myfitnesspal.mfp,15,1739124581,1739124596,1739124596.4894571,-21600,EB445137-D7F5-57EC-87DA-1DB460D64046,"iPhone13,2"
com.myfitnesspal.mfp,38,1739124516,1739124554,1739124554.498152,-21600,EB445137-D7F5-57EC-87DA-1DB460D64046,"iPhone13,2"
com.apple.weather,4,1739124512,1739124516,1739124516.8721771,-21600,EB445137-D7F5-57EC-87DA-1DB460D64046,"iPhone13,2"
com.apple.weather,61,1739124003,1739124064,1739124064.831571,-21600,EB445137-D7F5-57EC-87DA-1DB460D64046,"iPhone13,2"
com.microsoft.VSCode,7,1739123011,1739123018,1739123018.9829159,-21600,,
com.google.Chrome,1,1739123010,1739123011,1739123011.554477,-21600,,
com.microsoft.VSCode,124,1739122886,1739123010,1739123010.46686,-21600,,
com.google.Chrome,1,1739122885,1739122886,1739122886.797111,-21600,,
com.apple.systempreferences,2,1739122883,1739122885,1739122885.987863,-21600,,
com.google.Chrome,36,1739122847,1739122883,1739122883.481648,-21600,,
com.microsoft.VSCode,26,1739122821,1739122847,1739122847.375883,-21600,,
com.google.Chrome,11,1739122810,1739122821,1739122821.85446,-21600,,
com.microsoft.VSCode,24,1739122786,1739122810,1739122810.278647,-21600,,
com.google.Chrome,22,1739122764,1739122786,1739122786.4501848,-21600,,
com.microsoft.VSCode,24,1739122740,1739122764,1739122764.261831,-21600,,
com.google.Chrome,18,1739122722,1739122740,1739122740.229713,-21600,,
com.microsoft.VSCode,44,1739122678,1739122722,1739122722.580487,-21600,,
com.google.Chrome,115,1739122563,1739122678,1739122678.636232,-21600,,
com.apple.iCal,7,1739122544,1739122551,1739122551.606101,-21600,,
com.leomehlig.today,29,1739122515,1739122544,1739122544.777879,-21600,,
com.apple.iCal,4,1739122511,1739122515,1739122515.241524,-21600,,
com.google.Chrome,11,1739122500,1739122511,1739122511.2463388,-21600,,
com.microsoft.VSCode,193,1739122307,1739122500,1739122500.291137,-21600,,
com.google.Chrome,68,1739122239,1739122307,1739122307.609889,-21600,,
com.microsoft.VSCode,41,1739122182,1739122223,1739122223.745801,-21600,,
com.apple.finder,9,1739122173,1739122182,1739122182.6814852,-21600,,
com.leomehlig.today,1,1739122172,1739122173,1739122173.9000921,-21600,,
com.apple.finder,5,1739122167,1739122172,1739122172.790327,-21600,,
com.apple.mobileslideshow,59,1739122025,1739122084,1739122084.54105,-21600,EB445137-D7F5-57EC-87DA-1DB460D64046,"iPhone13,2"
com.apple.MobileSMS,4,1739122011,1739122015,1739122015.482507,-21600,EB445137-D7F5-57EC-87DA-1DB460D64046,"iPhone13,2"
com.apple.MobileSMS,5,1739121977,1739121982,1739121983.063478,-21600,EB445137-D7F5-57EC-87DA-1DB460D64046,"iPhone13,2"
com.apple.Health,122,1739121854,1739121976,1739121976.180416,-21600,EB445137-D7F5-57EC-87DA-1DB460D64046,"iPhone13,2"
com.apple.MobileSMS,4,1739121836,1739121840,1739121840.1797671,-21600,EB445137-D7F5-57EC-87DA-1DB460D64046,"iPhone13,2"
com.microsoft.Office.Outlook,9,1739121825,1739121834,1739121834.733944,-21600,EB445137-D7F5-57EC-87DA-1DB460D64046,"iPhone13,2"
com.apple.weather,30,1739121754,1739121784,1739121784.5997992,-21600,EB445137-D7F5-57EC-87DA-1DB460D64046,"iPhone13,2"
com.microsoft.Office.Outlook,5,1739121731,1739121736,1739121736.1312618,-21600,EB445137-D7F5-57EC-87DA-1DB460D64046,"iPhone13,2"
com.microsoft.Office.Outlook,12,1739121655,1739121667,1739121667.562541,-21600,EB445137-D7F5-57EC-87DA-1DB460D64046,"iPhone13,2"
com.myfitnesspal.mfp,0,1739121655,1739121655,1739121656.6614509,-21600,EB445137-D7F5-57EC-87DA-1DB460D64046,"iPhone13,2"
com.myfitnesspal.mfp,134,1739121462,1739121596,1739121596.5449061,-21600,EB445137-D7F5-57EC-87DA-1DB460D64046,"iPhone13,2"
com.apple.MobileSMS,12,1739121450,1739121462,1739121462.893983,-21600,EB445137-D7F5-57EC-87DA-1DB460D64046,"iPhone13,2"
com.myfitnesspal.mfp,3,1739121447,1739121450,1739121450.1989741,-21600,EB445137-D7F5-57EC-87DA-1DB460D64046,"iPhone13,2"
com.apple.MobileSMS,3,1739121423,1739121426,1739121426.283741,-21600,EB445137-D7F5-57EC-87DA-1DB460D64046,"iPhone13,2"
com.apple.finder,304,1739120387,1739120691,1739120691.671346,-21600,,
com.leomehlig.today,2,1739120385,1739120387,1739120387.538813,-21600,,
com.apple.finder,4,1739120381,1739120385,1739120385.448473,-21600,,
com.microsoft.VSCode,38,1739120343,1739120381,1739120381.686923,-21600,,
com.apple.finder,153,1739120190,1739120343,1739120343.1059132,-21600,,
com.microsoft.VSCode,10,1739120180,1739120190,1739120190.073145,-21600,,
com.apple.finder,37,1739120143,1739120180,1739120180.7908092,-21600,,
com.microsoft.VSCode,4,1739120139,1739120143,1739120143.3795428,-21600,,
com.leomehlig.today,44,1739120095,1739120139,1739120139.379528,-21600,,
com.microsoft.VSCode,4,1739120091,1739120095,1739120095.407432,-21600,,
com.google.Chrome,155,1739119936,1739120091,1739120091.618448,-21600,,
com.microsoft.Outlook,56,1739119863,1739119919,1739119919.53822,-21600,,
com.google.Chrome,3,1739119860,1739119863,1739119863.541398,-21600,,
com.microsoft.VSCode,103,1739119742,1739119845,1739119845.5675302,-21600,,
com.google.Chrome,29,1739119713,1739119742,1739119742.745823,-21600,,
com.microsoft.VSCode,85,1739119628,1739119713,1739119713.1673222,-21600,,
com.apple.finder,28,1739119600,1739119628,1739119628.4855309,-21600,,
com.microsoft.VSCode,9,1739119591,1739119600,1739119600.362208,-21600,,
com.apple.finder,9,1739119582,1739119591,1739119592.031793,-21600,,
com.microsoft.VSCode,11,1739119571,1739119582,1739119582.7145162,-21600,,
com.apple.finder,22,1739119549,1739119571,1739119571.412123,-21600,,
com.microsoft.VSCode,16,1739119533,1739119549,1739119549.876346,-21600,,
com.apple.finder,11,1739119522,1739119533,1739119533.957415,-21600,,
com.microsoft.VSCode,267,1739119255,1739119522,1739119522.926134,-21600,,
com.google.Chrome,30,1739119225,1739119255,1739119255.7368221,-21600,,
com.microsoft.VSCode,24,1739119201,1739119225,1739119226.0205421,-21600,,
com.google.Chrome,75,1739119126,1739119201,1739119201.902755,-21600,,
com.microsoft.VSCode,3,1739119123,1739119126,1739119126.359957,-21600,,
com.google.Chrome,9,1739119114,1739119123,1739119123.781166,-21600,,
com.microsoft.VSCode,8,1739119106,1739119114,1739119114.173856,-21600,,
com.apple.finder,196,1739118690,1739118886,1739118886.1830812,-21600,,
com.apple.MobileSMS,2,1739118686,1739118688,1739118689.110986,-21600,EB445137-D7F5-57EC-87DA-1DB460D64046,"iPhone13,2"
com.clairmail.fth.client,0,1739118686,1739118686,1739118687.289356,-21600,EB445137-D7F5-57EC-87DA-1DB460D64046,"iPhone13,2"
com.microsoft.VSCode,27,1739118663,1739118690,1739118690.0703192,-21600,,
com.apple.finder,2,1739118661,1739118663,1739118663.104531,-21600,,
com.apple.Preview,19,1739118642,1739118661,1739118661.859095,-21600,,
com.apple.Preview,437,1739117605,1739118042,1739118042.765547,-21600,,
com.apple.finder,8,1739117597,1739117605,1739117605.0893002,-21600,,
com.microsoft.VSCode,1,1739117596,1739117597,1739117597.954212,-21600,,
com.apple.finder,1,1739117595,1739117596,1739117596.48138,-21600,,
com.microsoft.VSCode,2,1739117593,1739117595,1739117595.150432,-21600,,
com.apple.CoreAuthUI,2,1739117415,1739117417,1739117417.705637,-21600,EB445137-D7F5-57EC-87DA-1DB460D64046,"iPhone13,2"
com.clairmail.fth.client,21,1739117411,1739117432,1739117432.9180179,-21600,EB445137-D7F5-57EC-87DA-1DB460D64046,"iPhone13,2"
com.apple.weather,2,1739117404,1739117406,1739117406.6222172,-21600,EB445137-D7F5-57EC-87DA-1DB460D64046,"iPhone13,2"
com.microsoft.VSCode,300,1739117138,1739117438,1739117438.2995749,-21600,,
com.google.Chrome,3,1739117135,1739117138,1739117138.333359,-21600,,
com.google.Chrome,310,1739116785,1739117095,1739117095.099057,-21600,,
com.microsoft.VSCode,2,1739116783,1739116785,1739116785.452898,-21600,,
com.apple.weather,1,1739116782,1739116783,1739116783.536979,-21600,EB445137-D7F5-57EC-87DA-1DB460D64046,"iPhone13,2"
com.microsoft.Office.Outlook,29,1739116750,1739116779,1739116779.710562,-21600,EB445137-D7F5-57EC-87DA-1DB460D64046,"iPhone13,2"
com.tinyspeck.chatlyio,26,1739116723,1739116749,1739116749.419905,-21600,EB445137-D7F5-57EC-87DA-1DB460D64046,"iPhone13,2"
com.microsoft.VSCode,303,1739115808,1739116111,1739116111.421149,-21600,,
com.apple.finder,17,1739115791,1739115808,1739115808.401802,-21600,,
com.microsoft.VSCode,27,1739115764,1739115791,1739115791.746965,-21600,,
com.google.Chrome,7,1739115757,1739115764,1739115764.407676,-21600,,
com.microsoft.VSCode,177,1739115580,1739115757,1739115757.904166,-21600,,
com.apple.finder,30,1739115550,1739115580,1739115580.944474,-21600,,
com.microsoft.VSCode,98,1739115452,1739115550,1739115550.550432,-21600,,
com.apple.finder,45,1739115407,1739115452,1739115452.073806,-21600,,
com.apple.MobileSMS,246,1739115031,1739115277,1739115277.768758,-21600,EB445137-D7F5-57EC-87DA-1DB460D64046,"iPhone13,2"
com.apple.mobileslideshow,14,1739115017,1739115031,1739115032.2373981,-21600,EB445137-D7F5-57EC-87DA-1DB460D64046,"iPhone13,2"
com.apple.MobileSMS,13,1739115004,1739115017,1739115017.900373,-21600,EB445137-D7F5-57EC-87DA-1DB460D64046,"iPhone13,2"
com.apple.news,0,1739115004,1739115004,1739115004.9035912,-21600,EB445137-D7F5-57EC-87DA-1DB460D64046,"iPhone13,2"
com.apple.news,24,1739114952,1739114976,1739114976.405992,-21600,EB445137-D7F5-57EC-87DA-1DB460D64046,"iPhone13,2"
com.apple.MobileSMS,44,1739114900,1739114944,1739114944.297591,-21600,EB445137-D7F5-57EC-87DA-1DB460D64046,"iPhone13,2"
com.apple.calculator,45,1739114855,1739114900,1739114900.6425118,-21600,EB445137-D7F5-57EC-87DA-1DB460D64046,"iPhone13,2"
com.apple.Health,9,1739114843,1739114852,1739114852.9936829,-21600,EB445137-D7F5-57EC-87DA-1DB460D64046,"iPhone13,2"
com.renpho.health,2,1739114837,1739114839,1739114839.9750729,-21600,EB445137-D7F5-57EC-87DA-1DB460D64046,"iPhone13,2"
com.apple.finder,312,1739114793,1739115105,1739115105.4467402,-21600,,
com.microsoft.VSCode,15,1739114778,1739114793,1739114793.988663,-21600,,
com.apple.finder,13,1739114765,1739114778,1739114778.102796,-21600,,
com.microsoft.VSCode,155,1739114610,1739114765,1739114765.74596,-21600,,
com.google.Chrome,0,1739114610,1739114610,1739114611.0025969,-21600,,
com.microsoft.VSCode,2,1739114608,1739114610,1739114610.400166,-21600,,
com.google.Chrome,44,1739114564,1739114608,1739114608.37569,-21600,,
com.microsoft.VSCode,105,1739114459,1739114564,1739114564.236959,-21600,,
com.google.Chrome,1,1739114458,1739114459,1739114459.775737,-21600,,
com.microsoft.VSCode,38,1739114420,1739114458,1739114459.422534,-21600,,
com.google.Chrome,17,1739114403,1739114420,1739114420.079148,-21600,,
com.microsoft.VSCode,29,1739114374,1739114403,1739114403.603109,-21600,,
com.google.Chrome,5,1739114369,1739114374,1739114374.827232,-21600,,
com.microsoft.VSCode,60,1739114309,1739114369,1739114369.88988,-21600,,
com.google.Chrome,4,1739114305,1739114309,1739114309.229391,-21600,,
com.microsoft.VSCode,4,1739114301,1739114305,1739114305.109714,-21600,,
com.google.Chrome,13,1739114288,1739114301,1739114302.039293,-21600,,
com.microsoft.VSCode,5,1739114283,1739114288,1739114289.067941,-21600,,
com.google.Chrome,11,1739114272,1739114283,1739114283.974325,-21600,,
com.microsoft.VSCode,88,1739114184,1739114272,1739114273.0579271,-21600,,
com.google.Chrome,1,1739114183,1739114184,1739114184.509877,-21600,,
com.microsoft.VSCode,5,1739114178,1739114183,1739114183.813373,-21600,,
com.google.Chrome,1,1739114177,1739114178,1739114178.820323,-21600,,
com.microsoft.VSCode,3,1739114174,1739114177,1739114177.668124,-21600,,
com.google.Chrome,1,1739114173,1739114174,1739114174.539443,-21600,,
com.microsoft.VSCode,2,1739114171,1739114173,1739114173.864565,-21600,,
com.google.Chrome,1,1739114170,1739114171,1739114171.696795,-21600,,
com.microsoft.VSCode,4,1739114166,1739114170,1739114170.6398358,-21600,,
com.google.Chrome,1,1739114165,1739114166,1739114166.767813,-21600,,
com.microsoft.VSCode,4,1739114161,1739114165,1739114165.235776,-21600,,
com.google.Chrome,1,1739114160,1739114161,1739114161.9476628,-21600,,
com.microsoft.VSCode,4,1739114156,1739114160,1739114160.785503,-21600,,
com.google.Chrome,4,1739114152,1739114156,1739114156.894681,-21600,,
com.microsoft.VSCode,6,1739114146,1739114152,1739114152.487174,-21600,,
com.google.Chrome,45,1739114101,1739114146,1739114146.854577,-21600,,
com.microsoft.VSCode,110,1739113991,1739114101,1739114101.858694,-21600,,
com.google.Chrome,81,1739113910,1739113991,1739113991.733691,-21600,,
com.microsoft.VSCode,37,1739113873,1739113910,1739113910.899609,-21600,,
com.apple.finder,71,1739113802,1739113873,1739113873.0780602,-21600,,
com.microsoft.VSCode,135,1739113667,1739113802,1739113802.1343,-21600,,
com.apple.finder,19,1739113648,1739113667,1739113667.371546,-21600,,
com.microsoft.VSCode,21,1739113627,1739113648,1739113648.42454,-21600,,
com.apple.finder,1,1739113626,1739113627,1739113627.893194,-21600,,
com.microsoft.VSCode,17,1739113609,1739113626,1739113626.760147,-21600,,
com.apple.finder,9,1739113600,1739113609,1739113609.722003,-21600,,
com.microsoft.VSCode,48,1739113552,1739113600,1739113600.9621592,-21600,,
com.apple.finder,2,1739113550,1739113552,1739113553.0202842,-21600,,
com.cisco.secureclient.gui,5,1739113545,1739113550,1739113550.3467522,-21600,,
com.google.Chrome,2,1739113543,1739113545,1739113545.749871,-21600,,
com.renpho.health,26,1739112613,1739112639,1739112639.4815311,-21600,EB445137-D7F5-57EC-87DA-1DB460D64046,"iPhone13,2"
com.google.ios.youtube,222,1739111198,1739111420,1739111420.139648,-21600,EB445137-D7F5-57EC-87DA-1DB460D64046,"iPhone13,2"
com.intsig.CamScannerLite,2,1739082286,1739082288,1739082288.355743,-21600,EB445137-D7F5-57EC-87DA-1DB460D64046,"iPhone13,2"
com.intsig.CamScannerLite,14,1739082270,1739082284,1739082284.889299,-21600,EB445137-D7F5-57EC-87DA-1DB460D64046,"iPhone13,2"
com.apple.Health,26,1739082239,1739082265,1739082265.457942,-21600,EB445137-D7F5-57EC-87DA-1DB460D64046,"iPhone13,2"
com.apple.Health,20,1739082218,1739082238,1739082238.238236,-21600,EB445137-D7F5-57EC-87DA-1DB460D64046,"iPhone13,2"
com.google.Chrome,8,1739082147,1739082155,1739082155.988102,-21600,,
com.apple.finder,22,1739082125,1739082147,1739082147.339515,-21600,,
com.apple.finder,307,1739081589,1739081896,1739081896.716579,-21600,,
com.microsoft.VSCode,15,1739081574,1739081589,1739081589.1954799,-21600,,
com.apple.finder,2,1739081572,1739081574,1739081574.88252,-21600,,
com.microsoft.VSCode,4,1739081568,1739081572,1739081572.656217,-21600,,
com.apple.finder,4,1739081564,1739081568,1739081568.6843839,-21600,,
com.apple.MobileSMS,3,1739074420,1739074423,1739074423.658041,-21600,EB445137-D7F5-57EC-87DA-1DB460D64046,"iPhone13,2"
com.apple.MobileSMS,6,1739073701,1739073707,1739073707.962733,-21600,EB445137-D7F5-57EC-87DA-1DB460D64046,"iPhone13,2"
com.apple.MobileSMS,2,1739072899,1739072901,1739072901.574202,-21600,EB445137-D7F5-57EC-87DA-1DB460D64046,"iPhone13,2"
com.apple.MobileSMS,3,1739072881,1739072884,1739072884.646055,-21600,EB445137-D7F5-57EC-87DA-1DB460D64046,"iPhone13,2"
com.apple.MobileSMS,317,1739072540,1739072857,1739072857.556854,-21600,EB445137-D7F5-57EC-87DA-1DB460D64046,"iPhone13,2"
com.google.chrome.ios,67,1739072473,1739072540,1739072540.125257,-21600,EB445137-D7F5-57EC-87DA-1DB460D64046,"iPhone13,2"
com.netflix.Netflix,4,1739072469,1739072473,1739072473.9553308,-21600,EB445137-D7F5-57EC-87DA-1DB460D64046,"iPhone13,2"
com.apple.camera,3,1739072466,1739072469,1739072469.854653,-21600,EB445137-D7F5-57EC-87DA-1DB460D64046,"iPhone13,2"
com.netflix.Netflix,14,1739072450,1739072464,1739072464.19259,-21600,EB445137-D7F5-57EC-87DA-1DB460D64046,"iPhone13,2"
com.apple.MobileSMS,0,1739072450,1739072450,1739072451.320493,-21600,EB445137-D7F5-57EC-87DA-1DB460D64046,"iPhone13,2"
com.apple.MobileSMS,121,1739072226,1739072347,1739072347.2793798,-21600,EB445137-D7F5-57EC-87DA-1DB460D64046,"iPhone13,2"
com.apple.finder,303,1739072117,1739072420,1739072420.6278,-21600,,
com.google.ios.youtube,138,1739071834,1739071972,1739071973.312978,-21600,EB445137-D7F5-57EC-87DA-1DB460D64046,"iPhone13,2"
com.apple.MobileSMS,11,1739071779,1739071790,1739071790.154893,-21600,EB445137-D7F5-57EC-87DA-1DB460D64046,"iPhone13,2"
com.apple.news,679,1739071095,1739071774,1739071774.810017,-21600,EB445137-D7F5-57EC-87DA-1DB460D64046,"iPhone13,2"
com.apple.Health,28,1739071055,1739071083,1739071083.1549811,-21600,EB445137-D7F5-57EC-87DA-1DB460D64046,"iPhone13,2"
com.apple.finder,312,1739070968,1739071280,1739071280.6568809,-21600,,
com.apple.MobileSMS,2,1739070942,1739070944,1739070944.900321,-21600,EB445137-D7F5-57EC-87DA-1DB460D64046,"iPhone13,2"
com.apple.MobileSMS,3,1739070893,1739070896,1739070896.078205,-21600,EB445137-D7F5-57EC-87DA-1DB460D64046,"iPhone13,2"
com.apple.MobileSMS,3,1739070878,1739070881,1739070881.494224,-21600,EB445137-D7F5-57EC-87DA-1DB460D64046,"iPhone13,2"
com.google.chrome.ios,73,1739070804,1739070877,1739070877.165626,-21600,EB445137-D7F5-57EC-87DA-1DB460D64046,"iPhone13,2"
com.google.chrome.ios,60,1739070743,1739070803,1739070803.603972,-21600,EB445137-D7F5-57EC-87DA-1DB460D64046,"iPhone13,2"
com.apple.MobileSMS,7,1739070736,1739070743,1739070743.188807,-21600,EB445137-D7F5-57EC-87DA-1DB460D64046,"iPhone13,2"
com.netflix.Netflix,6,1739070730,1739070736,1739070737.0798512,-21600,EB445137-D7F5-57EC-87DA-1DB460D64046,"iPhone13,2"
com.apple.MobileSMS,19,1739070706,1739070725,1739070725.085747,-21600,EB445137-D7F5-57EC-87DA-1DB460D64046,"iPhone13,2"
com.apple.MobileSMS,2,1739070695,1739070697,1739070697.9403028,-21600,EB445137-D7F5-57EC-87DA-1DB460D64046,"iPhone13,2"
com.apple.MobileSMS,5,1739070656,1739070661,1739070661.918766,-21600,EB445137-D7F5-57EC-87DA-1DB460D64046,"iPhone13,2"
com.apple.MobileSMS,33,1739070614,1739070647,1739070647.3411431,-21600,EB445137-D7F5-57EC-87DA-1DB460D64046,"iPhone13,2"
com.apple.MobileSMS,38,1739070575,1739070613,1739070613.749878,-21600,EB445137-D7F5-57EC-87DA-1DB460D64046,"iPhone13,2"
com.apple.MobileSMS,6,1739070561,1739070567,1739070567.2859812,-21600,EB445137-D7F5-57EC-87DA-1DB460D64046,"iPhone13,2"
com.google.chrome.ios,17,1739070544,1739070561,1739070561.515668,-21600,EB445137-D7F5-57EC-87DA-1DB460D64046,"iPhone13,2"
com.apple.MobileSMS,14,1739070530,1739070544,1739070544.329942,-21600,EB445137-D7F5-57EC-87DA-1DB460D64046,"iPhone13,2"
com.apple.findmy,6,1739070524,1739070530,1739070531.30217,-21600,EB445137-D7F5-57EC-87DA-1DB460D64046,"iPhone13,2"
com.apple.MobileSMS,58,1739070466,1739070524,1739070524.3727741,-21600,EB445137-D7F5-57EC-87DA-1DB460D64046,"iPhone13,2"
com.google.chrome.ios,10,1739070456,1739070466,1739070466.054925,-21600,EB445137-D7F5-57EC-87DA-1DB460D64046,"iPhone13,2"
com.google.chrome.ios,170,1739070282,1739070452,1739070452.34025,-21600,EB445137-D7F5-57EC-87DA-1DB460D64046,"iPhone13,2"
com.netflix.Netflix,43,1739070238,1739070281,1739070282.302984,-21600,EB445137-D7F5-57EC-87DA-1DB460D64046,"iPhone13,2"
com.apple.finder,304,1739069255,1739069559,1739069559.894168,-21600,,
com.apple.finder,310,1739063732,1739064042,1739064042.4574242,-21600,,
com.apple.weather,42,1739063544,1739063586,1739063586.068022,-21600,EB445137-D7F5-57EC-87DA-1DB460D64046,"iPhone13,2"
com.apple.weather,4,1739063500,1739063504,1739063504.187906,-21600,EB445137-D7F5-57EC-87DA-1DB460D64046,"iPhone13,2"
com.apple.weather,0,1739063491,1739063491,1739063492.063832,-21600,EB445137-D7F5-57EC-87DA-1DB460D64046,"iPhone13,2"
com.apple.weather,20,1739063471,1739063491,1739063491.079496,-21600,EB445137-D7F5-57EC-87DA-1DB460D64046,"iPhone13,2"
com.apple.weather,65,1739063355,1739063420,1739063421.070918,-21600,EB445137-D7F5-57EC-87DA-1DB460D64046,"iPhone13,2"
com.apple.news,75,1739063260,1739063335,1739063335.924687,-21600,EB445137-D7F5-57EC-87DA-1DB460D64046,"iPhone13,2"
com.apple.calculator,1,1739063194,1739063195,1739063195.9364572,-21600,EB445137-D7F5-57EC-87DA-1DB460D64046,"iPhone13,2"
com.apple.calculator,8,1739062728,1739062736,1739062736.599544,-21600,EB445137-D7F5-57EC-87DA-1DB460D64046,"iPhone13,2"
com.apple.finder,314,1739062570,1739062884,1739062884.082104,-21600,,
com.microsoft.VSCode,8,1739062562,1739062570,1739062570.8056831,-21600,,
com.apple.finder,18,1739062544,1739062562,1739062562.148752,-21600,,
com.microsoft.VSCode,31,1739062513,1739062544,1739062544.084484,-21600,,
com.cisco.secureclient.gui,20,1739062493,1739062513,1739062513.2907271,-21600,,
com.microsoft.VSCode,28,1739062465,1739062493,1739062493.663563,-21600,,
com.apple.finder,15,1739062450,1739062465,1739062465.499197,-21600,,
com.microsoft.VSCode,4,1739062446,1739062450,1739062450.0682979,-21600,,
com.leomehlig.today,7,1739062423,1739062430,1739062430.46172,-21600,,
com.leomehlig.today,103,1739062274,1739062377,1739062377.4942322,-21600,EB445137-D7F5-57EC-87DA-1DB460D64046,"iPhone13,2"
com.apple.mobilenotes,56,1739062213,1739062269,1739062269.556754,-21600,EB445137-D7F5-57EC-87DA-1DB460D64046,"iPhone13,2"
com.myfitnesspal.mfp,70,1739062141,1739062211,1739062211.4484859,-21600,EB445137-D7F5-57EC-87DA-1DB460D64046,"iPhone13,2"
com.myfitnesspal.mfp,121,1739061904,1739062025,1739062026.098734,-21600,EB445137-D7F5-57EC-87DA-1DB460D64046,"iPhone13,2"
com.myfitnesspal.mfp,2,1739061901,1739061903,1739061903.4506369,-21600,EB445137-D7F5-57EC-87DA-1DB460D64046,"iPhone13,2"
com.myfitnesspal.mfp,22,1739060746,1739060768,1739060768.907116,-21600,EB445137-D7F5-57EC-87DA-1DB460D64046,"iPhone13,2"
com.microsoft.Office.Outlook,7,1739060737,1739060744,1739060744.22825,-21600,EB445137-D7F5-57EC-87DA-1DB460D64046,"iPhone13,2"
com.apple.MobileSMS,3,1739060733,1739060736,1739060736.606672,-21600,EB445137-D7F5-57EC-87DA-1DB460D64046,"iPhone13,2"
com.apple.MobileSMS,31,1739057644,1739057675,1739057675.91499,-21600,EB445137-D7F5-57EC-87DA-1DB460D64046,"iPhone13,2"
com.apple.MobileSMS,39,1739057444,1739057483,1739057484.1435208,-21600,EB445137-D7F5-57EC-87DA-1DB460D64046,"iPhone13,2"
com.apple.MobileSMS,57,1739057330,1739057387,1739057387.741277,-21600,EB445137-D7F5-57EC-87DA-1DB460D64046,"iPhone13,2"
com.apple.MobileSMS,3,1739057267,1739057270,1739057270.268993,-21600,EB445137-D7F5-57EC-87DA-1DB460D64046,"iPhone13,2"
com.apple.MobileSMS,155,1739057000,1739057155,1739057155.9083018,-21600,EB445137-D7F5-57EC-87DA-1DB460D64046,"iPhone13,2"
com.apple.MobileSMS,109,1739056890,1739056999,1739056999.322186,-21600,EB445137-D7F5-57EC-87DA-1DB460D64046,"iPhone13,2"
com.apple.mobileslideshow,19,1739056871,1739056890,1739056891.094697,-21600,EB445137-D7F5-57EC-87DA-1DB460D64046,"iPhone13,2"
com.apple.MobileSMS,19,1739056850,1739056869,1739056869.3431091,-21600,EB445137-D7F5-57EC-87DA-1DB460D64046,"iPhone13,2"
com.google.chrome.ios,0,1739056850,1739056850,1739056851.4749641,-21600,EB445137-D7F5-57EC-87DA-1DB460D64046,"iPhone13,2"
com.leomehlig.today,301,1739056806,1739057107,1739057107.219396,-21600,,
com.google.Chrome,1694,1739055112,1739056806,1739056807.029567,-21600,,
com.leomehlig.today,1,1739055111,1739055112,1739055112.071132,-21600,,
com.google.Chrome,10,1739055101,1739055111,1739055111.281069,-21600,,
com.leomehlig.today,1,1739055100,1739055101,1739055101.744178,-21600,,
com.google.Chrome,285,1739054815,1739055100,1739055100.36095,-21600,,
com.leomehlig.today,7,1739054808,1739054815,1739054815.918709,-21600,,
com.apple.finder,2,1739054806,1739054808,1739054809.009479,-21600,,
com.microsoft.VSCode,246,1739054560,1739054806,1739054807.680887,-21600,,
com.apple.finder,11,1739054549,1739054560,1739054560.485846,-21600,,
com.microsoft.VSCode,424,1739054125,1739054549,1739054549.351351,-21600,,
com.google.Chrome,96,1739054029,1739054125,1739054126.032795,-21600,,
com.apple.Notes,2,1739054015,1739054017,1739054017.709748,-21600,,
com.apple.Preview,6,1739054009,1739054015,1739054015.364754,-21600,,
com.apple.Preview,604,1739053307,1739053911,1739053911.056107,-21600,,
com.apple.finder,11,1739053296,1739053307,1739053307.732904,-21600,,
com.google.Chrome,1,1739053295,1739053296,1739053296.785995,-21600,,
com.google.Chrome,367,1739052915,1739053282,1739053282.142606,-21600,,
com.apple.Notes,109,1739052793,1739052902,1739052903.651622,-21600,,
com.apple.Notes,663,1739052128,1739052791,1739052791.3560228,-21600,,
com.leomehlig.today,258,1739051870,1739052128,1739052128.870841,-21600,,
com.google.Chrome,6,1739051864,1739051870,1739051870.190539,-21600,,
com.apple.CoreAuthUI,1,1739051675,1739051676,1739051677.010272,-21600,EB445137-D7F5-57EC-87DA-1DB460D64046,"iPhone13,2"
com.google.chrome.ios,26,1739051666,1739051692,1739051692.235641,-21600,EB445137-D7F5-57EC-87DA-1DB460D64046,"iPhone13,2"
com.apple.camera,6,1739051660,1739051666,1739051667.137384,-21600,EB445137-D7F5-57EC-87DA-1DB460D64046,"iPhone13,2"
edu.illinois.rokwire.ios,3,1739051657,1739051660,1739051660.588222,-21600,EB445137-D7F5-57EC-87DA-1DB460D64046,"iPhone13,2"
edu.illinois.rokwire.ios,117,1739051503,1739051620,1739051620.200375,-21600,EB445137-D7F5-57EC-87DA-1DB460D64046,"iPhone13,2"
com.intsig.CamScannerLite,2,1739051500,1739051502,1739051502.620376,-21600,EB445137-D7F5-57EC-87DA-1DB460D64046,"iPhone13,2"
com.google.Chrome,152,1739051461,1739051613,1739051613.718394,-21600,,
com.apple.finder,24,1739051437,1739051461,1739051461.437895,-21600,,
com.google.Chrome,33,1739051404,1739051437,1739051437.999979,-21600,,
com.apple.finder,7,1739051397,1739051404,1739051404.760133,-21600,,
com.google.Chrome,1,1739051396,1739051397,1739051397.582078,-21600,,
com.apple.finder,1,1739051395,1739051396,1739051396.8558478,-21600,,
com.google.Chrome,54,1739051341,1739051395,1739051395.1468,-21600,,
com.apple.finder,15,1739051315,1739051330,1739051330.393235,-21600,,
com.apple.Preview,160,1739051155,1739051315,1739051315.498533,-21600,,
com.apple.finder,42,1739051113,1739051155,1739051155.1697989,-21600,,
com.intsig.CamScannerLite,113,1739051056,1739051169,1739051169.836241,-21600,EB445137-D7F5-57EC-87DA-1DB460D64046,"iPhone13,2"
com.truebill.truebillnative,2,1739051054,1739051056,1739051056.7443829,-21600,EB445137-D7F5-57EC-87DA-1DB460D64046,"iPhone13,2"
com.google.Chrome,588,1739050525,1739051113,1739051113.482726,-21600,,
com.google.Chrome,1054,1739049463,1739050517,1739050517.0482469,-21600,,
com.google.Chrome,847,1739048615,1739049462,1739049462.710895,-21600,,
com.apple.CoreAuthUI,2,1739048462,1739048464,1739048464.4007,-21600,EB445137-D7F5-57EC-87DA-1DB460D64046,"iPhone13,2"
com.truebill.truebillnative,55,1739048459,1739048514,1739048514.794114,-21600,EB445137-D7F5-57EC-87DA-1DB460D64046,"iPhone13,2"
com.leomehlig.today,83,1739048361,1739048444,1739048444.155802,-21600,EB445137-D7F5-57EC-87DA-1DB460D64046,"iPhone13,2"
com.apple.news,42,1739048317,1739048359,1739048360.101176,-21600,EB445137-D7F5-57EC-87DA-1DB460D64046,"iPhone13,2"
com.google.Chrome,88,1739048157,1739048245,1739048245.392127,-21600,,
com.google.chrome.ios,141,1739047855,1739047996,1739047996.686102,-21600,EB445137-D7F5-57EC-87DA-1DB460D64046,"iPhone13,2"
com.apple.news,160,1739047692,1739047852,1739047852.228997,-21600,EB445137-D7F5-57EC-87DA-1DB460D64046,"iPhone13,2"
com.google.Chrome,300,1739047487,1739047787,1739047787.290008,-21600,,
com.google.Chrome,301,1739047172,1739047473,1739047473.1027288,-21600,,
com.google.Chrome,300,1739046871,1739047171,1739047171.747562,-21600,,
com.google.Chrome,336,1739046534,1739046870,1739046870.122009,-21600,,
com.google.Chrome,858,1739045674,1739046532,1739046532.982353,-21600,,
com.google.Chrome,426,1739045214,1739045640,1739045640.1948109,-21600,,
com.leomehlig.today,2,1739045212,1739045214,1739045214.8704848,-21600,,
com.google.Chrome,53,1739045159,1739045212,1739045212.130537,-21600,,
com.apple.Preview,718,1739044441,1739045159,1739045159.508816,-21600,,
com.google.Chrome,3,1739044438,1739044441,1739044441.3237581,-21600,,
com.apple.Preview,1,1739044437,1739044438,1739044438.4890652,-21600,,
com.google.Chrome,0,1739044437,1739044437,1739044437.99576,-21600,,
com.apple.Preview,1,1739044436,1739044437,1739044437.095937,-21600,,
com.leomehlig.today,3,1739044433,1739044436,1739044436.242615,-21600,,
com.apple.Preview,4,1739044429,1739044433,1739044433.44552,-21600,,
com.leomehlig.today,88,1739044341,1739044429,1739044429.3753371,-21600,,
com.google.Chrome,11,1739044330,1739044341,1739044341.598026,-21600,,
com.leomehlig.today,226,1739044104,1739044330,1739044331.7283049,-21600,,
com.apple.Preview,213,1739043891,1739044104,1739044104.10988,-21600,,
com.apple.finder,3,1739043888,1739043891,1739043891.3573031,-21600,,
com.apple.Preview,3,1739043885,1739043888,1739043888.525789,-21600,,
com.apple.finder,240,1739043645,1739043885,1739043885.931853,-21600,,
com.apple.finder,385,1739043050,1739043435,1739043435.734754,-21600,,
com.google.Chrome,77,1739042973,1739043050,1739043051.043783,-21600,,
com.apple.Preview,124,1739042837,1739042961,1739042961.8279362,-21600,,
com.apple.finder,22,1739042815,1739042837,1739042837.5911589,-21600,,
com.apple.Health,19,1739042629,1739042648,1739042649.002065,-21600,EB445137-D7F5-57EC-87DA-1DB460D64046,"iPhone13,2"
com.intsig.CamScannerLite,0,1739042629,1739042629,1739042630.008395,-21600,EB445137-D7F5-57EC-87DA-1DB460D64046,"iPhone13,2"
com.apple.Preview,235,1739042580,1739042815,1739042815.798902,-21600,,
com.apple.finder,4,1739042576,1739042580,1739042580.191028,-21600,,
com.apple.Preview,2,1739042574,1739042576,1739042576.2861009,-21600,,
com.apple.finder,47,1739042527,1739042574,1739042574.1804008,-21600,,
com.intsig.CamScannerLite,215,1739042382,1739042597,1739042598.240703,-21600,EB445137-D7F5-57EC-87DA-1DB460D64046,"iPhone13,2"
com.intsig.CamScannerLite,2,1739042380,1739042382,1739042382.357813,-21600,EB445137-D7F5-57EC-87DA-1DB460D64046,"iPhone13,2"
com.leomehlig.today,176,1739042351,1739042527,1739042527.2267342,-21600,,
com.intsig.CamScannerLite,97,1739042209,1739042306,1739042306.783152,-21600,EB445137-D7F5-57EC-87DA-1DB460D64046,"iPhone13,2"
com.apple.MobileSMS,2,1739042206,1739042208,1739042208.820987,-21600,EB445137-D7F5-57EC-87DA-1DB460D64046,"iPhone13,2"
com.google.Chrome,722,1739041629,1739042351,1739042351.181538,-21600,,
com.leomehlig.today,38,1739041576,1739041614,1739041614.4665298,-21600,,
com.apple.MobileSMS,15,1739041205,1739041220,1739041220.7823992,-21600,EB445137-D7F5-57EC-87DA-1DB460D64046,"iPhone13,2"
com.apple.news,0,1739041205,1739041205,1739041205.860114,-21600,EB445137-D7F5-57EC-87DA-1DB460D64046,"iPhone13,2"
com.leomehlig.today,439,1739040674,1739041113,1739041113.2827659,-21600,,
com.apple.news,55,1739040600,1739040655,1739040655.450484,-21600,EB445137-D7F5-57EC-87DA-1DB460D64046,"iPhone13,2"
com.apple.MobileSMS,6,1739040477,1739040483,1739040483.2891731,-21600,EB445137-D7F5-57EC-87DA-1DB460D64046,"iPhone13,2"
com.apple.MobileSMS,30,1739039844,1739039874,1739039874.9428449,-21600,EB445137-D7F5-57EC-87DA-1DB460D64046,"iPhone13,2"
com.apple.Health,2,1739039842,1739039844,1739039844.560085,-21600,EB445137-D7F5-57EC-87DA-1DB460D64046,"iPhone13,2"
com.apple.Health,14,1739039183,1739039197,1739039197.450172,-21600,EB445137-D7F5-57EC-87DA-1DB460D64046,"iPhone13,2"
com.apple.weather,3,1739039180,1739039183,1739039183.492782,-21600,EB445137-D7F5-57EC-87DA-1DB460D64046,"iPhone13,2"
com.apple.weather,4,1739039011,1739039015,1739039015.206913,-21600,EB445137-D7F5-57EC-87DA-1DB460D64046,"iPhone13,2"
com.myfitnesspal.mfp,1,1739039010,1739039011,1739039011.930647,-21600,EB445137-D7F5-57EC-87DA-1DB460D64046,"iPhone13,2"
com.myfitnesspal.mfp,24,1739038865,1739038889,1739038890.057016,-21600,EB445137-D7F5-57EC-87DA-1DB460D64046,"iPhone13,2"
com.myfitnesspal.mfp,18,1739038793,1739038811,1739038811.133632,-21600,EB445137-D7F5-57EC-87DA-1DB460D64046,"iPhone13,2"
com.myfitnesspal.mfp,110,1739038668,1739038778,1739038778.99807,-21600,EB445137-D7F5-57EC-87DA-1DB460D64046,"iPhone13,2"
com.apple.camera,19,1739038649,1739038668,1739038668.6457062,-21600,EB445137-D7F5-57EC-87DA-1DB460D64046,"iPhone13,2"
com.myfitnesspal.mfp,2,1739038647,1739038649,1739038649.789438,-21600,EB445137-D7F5-57EC-87DA-1DB460D64046,"iPhone13,2"
com.apple.camera,6,1739038641,1739038647,1739038647.824847,-21600,EB445137-D7F5-57EC-87DA-1DB460D64046,"iPhone13,2"
com.myfitnesspal.mfp,8,1739038633,1739038641,1739038641.966251,-21600,EB445137-D7F5-57EC-87DA-1DB460D64046,"iPhone13,2"
com.apple.camera,4,1739038629,1739038633,1739038633.724043,-21600,EB445137-D7F5-57EC-87DA-1DB460D64046,"iPhone13,2"
com.myfitnesspal.mfp,18,1739038611,1739038629,1739038630.000601,-21600,EB445137-D7F5-57EC-87DA-1DB460D64046,"iPhone13,2"
com.apple.camera,2,1739038609,1739038611,1739038613.57179,-21600,EB445137-D7F5-57EC-87DA-1DB460D64046,"iPhone13,2"
com.apple.camera,15,1739038588,1739038603,1739038604.7086802,-21600,EB445137-D7F5-57EC-87DA-1DB460D64046,"iPhone13,2"
com.apple.weather,3,1739038578,1739038581,1739038581.672951,-21600,EB445137-D7F5-57EC-87DA-1DB460D64046,"iPhone13,2"
com.apple.weather,67,1739038412,1739038479,1739038479.840001,-21600,EB445137-D7F5-57EC-87DA-1DB460D64046,"iPhone13,2"
com.leomehlig.today,5,1739038343,1739038348,1739038348.300132,-21600,,
com.apple.finder,0,1739038343,1739038343,1739038343.856055,-21600,,
com.microsoft.VSCode,139,1739038204,1739038343,1739038343.157981,-21600,,
com.google.Chrome,1,1739038203,1739038204,1739038204.6953158,-21600,,
com.microsoft.VSCode,5,1739038198,1739038203,1739038203.834111,-21600,,
com.google.Chrome,4,1739038194,1739038198,1739038198.4694781,-21600,,
com.microsoft.VSCode,1,1739038193,1739038194,1739038194.502054,-21600,,
com.google.Chrome,5,1739038188,1739038193,1739038193.951999,-21600,,
com.microsoft.VSCode,5,1739038183,1739038188,1739038188.50967,-21600,,
com.google.Chrome,3,1739038180,1739038183,1739038183.196157,-21600,,
com.microsoft.VSCode,10,1739038170,1739038180,1739038180.0604692,-21600,,
com.google.Chrome,22,1739038148,1739038170,1739038170.379243,-21600,,
com.microsoft.VSCode,2,1739038146,1739038148,1739038148.261792,-21600,,
com.google.Chrome,2,1739038144,1739038146,1739038146.301121,-21600,,
com.microsoft.VSCode,3,1739038141,1739038144,1739038144.942177,-21600,,
com.google.Chrome,18,1739038123,1739038141,1739038141.555956,-21600,,
com.microsoft.VSCode,44,1739038079,1739038123,1739038123.4508638,-21600,,
com.google.Chrome,7,1739038072,1739038079,1739038079.169395,-21600,,
com.microsoft.VSCode,1,1739038071,1739038072,1739038073.006773,-21600,,
com.google.Chrome,1,1739038070,1739038071,1739038071.4888082,-21600,,
com.microsoft.VSCode,2,1739038068,1739038070,1739038070.312639,-21600,,
com.google.Chrome,5,1739038063,1739038068,1739038069.041528,-21600,,
com.microsoft.VSCode,3,1739038060,1739038063,1739038063.431777,-21600,,
com.google.Chrome,4,1739038056,1739038060,1739038060.97383,-21600,,
com.microsoft.VSCode,3,1739038053,1739038056,1739038056.612925,-21600,,
com.google.Chrome,9,1739038044,1739038053,1739038053.768622,-21600,,
com.microsoft.VSCode,2,1739038042,1739038044,1739038044.8224149,-21600,,
com.google.Chrome,1,1739038041,1739038042,1739038042.063812,-21600,,
com.google.Chrome,1,1739038040,1739038041,1739038041.4091392,-21600,,
com.microsoft.VSCode,43,1739037997,1739038040,1739038040.34779,-21600,,
com.google.Chrome,1,1739037996,1739037997,1739037997.2179809,-21600,,
com.google.Chrome,2,1739037994,1739037996,1739037996.547348,-21600,,
com.google.Chrome,1,1739037993,1739037994,1739037994.4141002,-21600,,
com.microsoft.VSCode,37,1739037956,1739037993,1739037993.2480721,-21600,,
com.google.Chrome,1,1739037955,1739037956,1739037956.622256,-21600,,
com.google.Chrome,13,1739037942,1739037955,1739037955.644808,-21600,,
com.google.Chrome,1,1739037941,1739037942,1739037942.27064,-21600,,
com.microsoft.VSCode,25,1739037916,1739037941,1739037941.0522242,-21600,,
com.google.Chrome,1,1739037915,1739037916,1739037916.383421,-21600,,
com.google.Chrome,45,1739037870,1739037915,1739037915.124939,-21600,,
com.google.Chrome,0,1739037870,1739037870,1739037870.895515,-21600,,
com.microsoft.VSCode,21,1739037849,1739037870,1739037870.17241,-21600,,
com.google.Chrome,1,1739037848,1739037849,1739037849.492786,-21600,,
com.google.Chrome,12,1739037836,1739037848,1739037848.1651192,-21600,,
com.google.Chrome,2,1739037834,1739037836,1739037836.071096,-21600,,
com.microsoft.VSCode,36,1739037798,1739037834,1739037834.4378018,-21600,,
com.google.Chrome,2,1739037796,1739037798,1739037798.447572,-21600,,
com.microsoft.VSCode,5,1739037791,1739037796,1739037796.494299,-21600,,
com.google.Chrome,2,1739037789,1739037791,1739037791.846565,-21600,,
com.microsoft.VSCode,9,1739037780,1739037789,1739037789.1456342,-21600,,
com.google.Chrome,4,1739037776,1739037780,1739037780.863535,-21600,,
com.microsoft.VSCode,3,1739037773,1739037776,1739037776.783231,-21600,,
com.google.Chrome,17,1739037756,1739037773,1739037773.284872,-21600,,
com.microsoft.VSCode,1,1739037755,1739037756,1739037756.8285608,-21600,,
com.google.Chrome,2,1739037753,1739037755,1739037755.290348,-21600,,
com.microsoft.VSCode,4,1739037749,1739037753,1739037753.580817,-21600,,
com.google.Chrome,10,1739037739,1739037749,1739037750.01945,-21600,,
com.microsoft.VSCode,10,1739037729,1739037739,1739037739.7860131,-21600,,
com.google.Chrome,4,1739037725,1739037729,1739037729.7423959,-21600,,
com.microsoft.VSCode,8,1739037717,1739037725,1739037725.488267,-21600,,
com.google.Chrome,0,1739037717,1739037717,1739037717.473371,-21600,,
com.microsoft.VSCode,5,1739037712,1739037717,1739037717.0771508,-21600,,
com.google.Chrome,6,1739037706,1739037712,1739037712.3040118,-21600,,
com.microsoft.VSCode,9,1739037697,1739037706,1739037706.684838,-21600,,
com.google.Chrome,16,1739037681,1739037697,1739037697.742877,-21600,,
com.microsoft.VSCode,11,1739037670,1739037681,1739037682.0076199,-21600,,
com.google.Chrome,1,1739037669,1739037670,1739037670.5118341,-21600,,
com.microsoft.VSCode,6,1739037663,1739037669,1739037669.5706038,-21600,,
com.google.Chrome,21,1739037642,1739037663,1739037663.8161821,-21600,,
com.microsoft.VSCode,38,1739037604,1739037642,1739037643.0350552,-21600,,
com.google.Chrome,4,1739037600,1739037604,1739037604.874821,-21600,,
com.microsoft.VSCode,13,1739037587,1739037600,1739037600.918874,-21600,,
com.google.Chrome,11,1739037576,1739037587,1739037587.869607,-21600,,
com.microsoft.VSCode,0,1739037576,1739037576,1739037576.9502149,-21600,,
com.google.Chrome,7,1739037569,1739037576,1739037576.0993772,-21600,,
com.microsoft.VSCode,1,1739037568,1739037569,1739037569.684688,-21600,,
com.google.Chrome,3,1739037565,1739037568,1739037568.1459389,-21600,,
com.microsoft.VSCode,6,1739037559,1739037565,1739037565.092546,-21600,,
com.google.Chrome,9,1739037550,1739037559,1739037559.137095,-21600,,
com.microsoft.VSCode,1,1739037549,1739037550,1739037550.846177,-21600,,
com.google.Chrome,2,1739037547,1739037549,1739037549.456884,-21600,,
com.microsoft.VSCode,0,1739037547,1739037547,1739037547.790561,-21600,,
com.google.Chrome,7,1739037540,1739037547,1739037547.1786098,-21600,,
com.microsoft.VSCode,20,1739037520,1739037540,1739037540.352828,-21600,,
com.google.Chrome,6,1739037514,1739037520,1739037520.706609,-21600,,
com.microsoft.VSCode,7,1739037507,1739037514,1739037514.693738,-21600,,
com.google.Chrome,2,1739037505,1739037507,1739037507.1714768,-21600,,
com.microsoft.VSCode,5,1739037500,1739037505,1739037505.036968,-21600,,
com.google.Chrome,3,1739037497,1739037500,1739037500.669409,-21600,,
com.microsoft.VSCode,1,1739037496,1739037497,1739037497.3090491,-21600,,
com.google.Chrome,5,1739037491,1739037496,1739037496.340765,-21600,,
com.microsoft.VSCode,9,1739037482,1739037491,1739037491.711693,-21600,,
com.google.Chrome,3,1739037479,1739037482,1739037482.548065,-21600,,
com.microsoft.VSCode,9,1739037470,1739037479,1739037479.758502,-21600,,
com.google.Chrome,5,1739037465,1739037470,1739037471.03644,-21600,,
com.microsoft.VSCode,3,1739037462,1739037465,1739037465.418635,-21600,,
com.google.Chrome,3,1739037459,1739037462,1739037462.8594651,-21600,,
com.microsoft.VSCode,3,1739037456,1739037459,1739037459.155703,-21600,,
com.google.Chrome,5,1739037451,1739037456,1739037456.402586,-21600,,
com.microsoft.VSCode,1,1739037450,1739037451,1739037451.558521,-21600,,
com.google.Chrome,2,1739037448,1739037450,1739037450.67539,-21600,,
com.microsoft.VSCode,20,1739037428,1739037448,1739037448.275356,-21600,,
com.google.Chrome,0,1739037428,1739037428,1739037428.7574692,-21600,,
com.microsoft.VSCode,4,1739037424,1739037428,1739037428.1607041,-21600,,
com.google.Chrome,6,1739037418,1739037424,1739037424.866893,-21600,,
com.microsoft.VSCode,12,1739037406,1739037418,1739037418.4283252,-21600,,
com.google.Chrome,1,1739037405,1739037406,1739037406.31675,-21600,,
com.microsoft.VSCode,11,1739037394,1739037405,1739037405.558825,-21600,,
com.google.Chrome,2,1739037392,1739037394,1739037394.5402908,-21600,,
com.microsoft.VSCode,5,1739037387,1739037392,1739037392.654036,-21600,,
com.google.Chrome,3,1739037384,1739037387,1739037387.2569041,-21600,,
com.microsoft.VSCode,7,1739037377,1739037384,1739037384.558542,-21600,,
com.google.Chrome,4,1739037373,1739037377,1739037377.471857,-21600,,
com.microsoft.VSCode,4,1739037369,1739037373,1739037373.151414,-21600,,
com.google.Chrome,3,1739037366,1739037369,1739037369.482583,-21600,,
com.microsoft.VSCode,1,1739037365,1739037366,1739037366.4718409,-21600,,
com.google.Chrome,8,1739037357,1739037365,1739037365.959024,-21600,,
com.microsoft.VSCode,6,1739037351,1739037357,1739037357.89905,-21600,,
com.google.Chrome,2,1739037349,1739037351,1739037351.437045,-21600,,
com.microsoft.VSCode,3,1739037346,1739037349,1739037349.7466888,-21600,,
com.google.Chrome,5,1739037341,1739037346,1739037346.386877,-21600,,
com.microsoft.VSCode,3,1739037338,1739037341,1739037341.44855,-21600,,
com.google.Chrome,6,1739037332,1739037338,1739037338.427567,-21600,,
com.microsoft.VSCode,15,1739037317,1739037332,1739037332.746588,-21600,,
com.google.Chrome,2,1739037315,1739037317,1739037317.883449,-21600,,
com.microsoft.VSCode,16,1739037299,1739037315,1739037315.8652,-21600,,
com.google.Chrome,14,1739037285,1739037299,1739037299.526424,-21600,,
com.microsoft.VSCode,10,1739037275,1739037285,1739037285.273772,-21600,,
com.google.Chrome,0,1739037275,1739037275,1739037276.003631,-21600,,
com.microsoft.VSCode,21,1739037254,1739037275,1739037275.205245,-21600,,
com.google.Chrome,19,1739037235,1739037254,1739037254.471589,-21600,,
com.microsoft.VSCode,7,1739037228,1739037235,1739037235.135009,-21600,,
com.google.Chrome,16,1739037212,1739037228,1739037228.1543941,-21600,,
com.microsoft.VSCode,7,1739037205,1739037212,1739037212.651201,-21600,,
com.google.Chrome,3,1739037202,1739037205,1739037205.058868,-21600,,
com.microsoft.VSCode,5,1739037197,1739037202,1739037202.943162,-21600,,
com.google.Chrome,13,1739037184,1739037197,1739037197.316957,-21600,,
com.microsoft.VSCode,5,1739037179,1739037184,1739037184.3439121,-21600,,
com.google.Chrome,2,1739037177,1739037179,1739037179.7198439,-21600,,
com.microsoft.VSCode,30,1739037147,1739037177,1739037177.31832,-21600,,
com.google.Chrome,2,1739037145,1739037147,1739037147.810357,-21600,,
com.microsoft.VSCode,159,1739036986,1739037145,1739037145.560635,-21600,,
com.google.Chrome,25,1739036961,1739036986,1739036986.417025,-21600,,
com.microsoft.VSCode,31,1739036930,1739036961,1739036961.115835,-21600,,
com.google.Chrome,2,1739036928,1739036930,1739036930.955024,-21600,,
com.microsoft.VSCode,13,1739036915,1739036928,1739036928.574655,-21600,,
com.google.Chrome,16,1739036899,1739036915,1739036915.7251492,-21600,,
com.microsoft.VSCode,21,1739036878,1739036899,1739036899.831917,-21600,,
com.google.Chrome,1,1739036877,1739036878,1739036878.686432,-21600,,
com.google.Chrome,29,1739036848,1739036877,1739036877.5822148,-21600,,
com.google.Chrome,7,1739036841,1739036848,1739036848.1110868,-21600,,
com.microsoft.VSCode,22,1739036819,1739036841,1739036841.355486,-21600,,
com.google.Chrome,2,1739036817,1739036819,1739036819.8133988,-21600,,
com.microsoft.VSCode,2,1739036815,1739036817,1739036817.681274,-21600,,
com.google.Chrome,5,1739036810,1739036815,1739036815.988638,-21600,,
com.microsoft.VSCode,0,1739036810,1739036810,1739036810.893343,-21600,,
com.google.Chrome,2,1739036808,1739036810,1739036810.172171,-21600,,
com.microsoft.VSCode,39,1739036769,1739036808,1739036808.574887,-21600,,
com.google.Chrome,11,1739036758,1739036769,1739036769.9556441,-21600,,
com.microsoft.VSCode,23,1739036735,1739036758,1739036758.5767999,-21600,,
com.google.Chrome,29,1739036706,1739036735,1739036735.881953,-21600,,
com.microsoft.VSCode,11,1739036695,1739036706,1739036706.8967462,-21600,,
com.google.Chrome,20,1739036675,1739036695,1739036695.355432,-21600,,
com.microsoft.VSCode,15,1739036660,1739036675,1739036675.1759648,-21600,,
com.google.Chrome,2,1739036658,1739036660,1739036660.399179,-21600,,
com.microsoft.VSCode,5,1739036653,1739036658,1739036658.4364638,-21600,,
com.google.Chrome,26,1739036627,1739036653,1739036653.565038,-21600,,
com.apple.Passwords,8,1739036619,1739036627,1739036627.140681,-21600,,
com.google.Chrome,17,1739036602,1739036619,1739036619.941375,-21600,,
com.microsoft.VSCode,82,1739036520,1739036602,1739036603.0323992,-21600,,
com.leomehlig.today,11,1739036509,1739036520,1739036520.329042,-21600,,
com.leomehlig.today,4,1739036135,1739036139,1739036139.201297,-21600,,
com.leomehlig.today,173,1739035952,1739036125,1739036125.534223,-21600,,
com.apple.finder,1,1739035951,1739035952,1739035952.771833,-21600,,
com.cisco.secureclient.gui,6,1739035945,1739035951,1739035951.093499,-21600,,
com.apple.finder,1,1739035944,1739035945,1739035945.4759421,-21600,,
com.apple.Terminal,4,1739035940,1739035944,1739035944.2315202,-21600,,
com.google.Chrome,29,1739035911,1739035940,1739035940.913682,-21600,,
com.apple.finder,2,1739035897,1739035899,1739035899.6967158,-21600,,
com.apple.Notes,0,1739035897,1739035897,1739035898.151322,-21600,,
com.apple.finder,2,1739035895,1739035897,1739035897.485993,-21600,,
com.microsoft.VSCode,170,1739035725,1739035895,1739035896.16006,-21600,,
com.apple.finder,15,1739035710,1739035725,1739035725.5592031,-21600,,
com.microsoft.VSCode,987,1739034723,1739035710,1739035710.5579681,-21600,,
com.apple.finder,18,1739034705,1739034723,1739034723.0529652,-21600,,
com.microsoft.VSCode,176,1739034529,1739034705,1739034705.666099,-21600,,
com.apple.finder,1,1739034528,1739034529,1739034529.6454659,-21600,,
com.microsoft.VSCode,5,1739034523,1739034528,1739034528.5831962,-21600,,
com.apple.finder,63,1739034460,1739034523,1739034523.75084,-21600,,
com.microsoft.VSCode,1,1739034459,1739034460,1739034460.950834,-21600,,
com.apple.finder,71,1739034388,1739034459,1739034460.050184,-21600,,
com.microsoft.VSCode,21,1739034367,1739034388,1739034388.1100988,-21600,,
com.apple.Notes,47,1739034320,1739034367,1739034367.2765188,-21600,,
com.microsoft.VSCode,1,1739034319,1739034320,1739034320.1023169,-21600,,
com.apple.Notes,16,1739034303,1739034319,1739034319.4039521,-21600,,
com.microsoft.VSCode,0,1739034303,1739034303,1739034304.016938,-21600,,
com.apple.Notes,1,1739034302,1739034303,1739034303.358897,-21600,,
com.microsoft.VSCode,2,1739034300,1739034302,1739034302.1514149,-21600,,
com.apple.Notes,49,1739034251,1739034300,1739034300.543439,-21600,,
com.microsoft.VSCode,10,1739034241,1739034251,1739034252.024012,-21600,,
com.apple.finder,52,1739034189,1739034241,1739034241.373209,-21600,,
com.microsoft.VSCode,48,1739034141,1739034189,1739034189.689034,-21600,,
com.apple.finder,8,1739034133,1739034141,1739034141.1619282,-21600,,
com.microsoft.VSCode,11,1739034122,1739034133,1739034133.232119,-21600,,
com.apple.finder,28,1739034094,1739034122,1739034122.9184499,-21600,,
com.microsoft.VSCode,95,1739033999,1739034094,1739034094.410022,-21600,,
com.google.Chrome,2,1739033997,1739033999,1739034000.004317,-21600,,
com.microsoft.VSCode,7,1739033990,1739033997,1739033997.6847,-21600,,
com.google.Chrome,11,1739033979,1739033990,1739033990.708435,-21600,,
com.microsoft.VSCode,641,1739033320,1739033961,1739033961.5971751,-21600,,
com.apple.finder,15,1739033305,1739033320,1739033320.234181,-21600,,
com.microsoft.VSCode,46,1739033259,1739033305,1739033305.802833,-21600,,
com.apple.Terminal,8,1739033251,1739033259,1739033259.120682,-21600,,
com.apple.finder,36,1739033215,1739033251,1739033251.849978,-21600,,
com.apple.Terminal,53,1739033162,1739033215,1739033215.471957,-21600,,
com.apple.finder,15,1739033147,1739033162,1739033162.737234,-21600,,
com.apple.Terminal,71,1739033076,1739033147,1739033147.126385,-21600,,
com.google.Chrome,1,1739033075,1739033076,1739033076.093957,-21600,,
com.apple.Terminal,14,1739033061,1739033075,1739033075.5764189,-21600,,
com.google.Chrome,0,1739033061,1739033061,1739033061.5006862,-21600,,
com.apple.Terminal,52,1739033009,1739033061,1739033061.083136,-21600,,
com.google.Chrome,1,1739033008,1739033009,1739033009.3448858,-21600,,
com.apple.Terminal,116,1739032892,1739033008,1739033008.633566,-21600,,
com.google.Chrome,2,1739032890,1739032892,1739032892.520499,-21600,,
com.apple.Terminal,8,1739032882,1739032890,1739032890.990154,-21600,,
com.google.Chrome,1,1739032881,1739032882,1739032882.8239,-21600,,
com.apple.Terminal,3,1739032878,1739032881,1739032881.864969,-21600,,
com.google.Chrome,1,1739032877,1739032878,1739032878.744345,-21600,,
com.apple.Terminal,18,1739032859,1739032877,1739032877.551543,-21600,,
com.google.Chrome,3,1739032856,1739032859,1739032859.4385371,-21600,,
com.microsoft.VSCode,1,1739032855,1739032856,1739032856.860204,-21600,,
com.apple.Terminal,7,1739032848,1739032855,1739032855.7421079,-21600,,
com.microsoft.VSCode,1,1739032847,1739032848,1739032848.790553,-21600,,
com.google.Chrome,28,1739032819,1739032847,1739032847.170618,-21600,,
com.microsoft.VSCode,65,1739032754,1739032819,1739032819.193811,-21600,,
com.apple.Terminal,107,1739032647,1739032754,1739032754.2558122,-21600,,
com.apple.finder,29,1739032618,1739032647,1739032647.654413,-21600,,
com.duosecurity.DuoMobile,17,1739032610,1739032627,1739032627.776692,-21600,EB445137-D7F5-57EC-87DA-1DB460D64046,"iPhone13,2"
com.apple.weather,1,1739032609,1739032610,1739032610.307178,-21600,EB445137-D7F5-57EC-87DA-1DB460D64046,"iPhone13,2"
com.cisco.secureclient.gui,73,1739032545,1739032618,1739032618.768124,-21600,,
com.microsoft.VSCode,90,1739032455,1739032545,1739032545.930653,-21600,,
com.google.Chrome,31,1739032424,1739032455,1739032455.439629,-21600,,
com.microsoft.VSCode,43,1739032381,1739032424,1739032424.455296,-21600,,
com.google.Chrome,1,1739032380,1739032381,1739032381.4468288,-21600,,
com.microsoft.VSCode,2,1739032378,1739032380,1739032380.3191938,-21600,,
com.google.Chrome,3,1739032375,1739032378,1739032378.36061,-21600,,
com.microsoft.VSCode,13,1739032362,1739032375,1739032375.703651,-21600,,
com.google.Chrome,125,1739032237,1739032362,1739032362.3052568,-21600,,
com.apple.Preview,49,1739031702,1739031751,1739031751.4449182,-21600,,
com.apple.finder,2,1739031700,1739031702,1739031702.1966949,-21600,,
com.google.Chrome,3016,1739028684,1739031700,1739031700.144413,-21600,,
com.apple.finder,40,1739028644,1739028684,1739028684.940226,-21600,,
com.google.Chrome,8,1739028636,1739028644,1739028645.012253,-21600,,
com.apple.finder,10,1739028626,1739028636,1739028636.14166,-21600,,
com.google.Chrome,3,1739028623,1739028626,1739028626.7887712,-21600,,
com.microsoft.VSCode,38,1739028585,1739028623,1739028624.0489678,-21600,,
com.google.Chrome,98,1739028487,1739028585,1739028585.897828,-21600,,
com.microsoft.VSCode,47,1739028440,1739028487,1739028487.129513,-21600,,
com.google.Chrome,5,1739028435,1739028440,1739028440.850574,-21600,,
com.microsoft.VSCode,2,1739028433,1739028435,1739028435.6181998,-21600,,
com.google.Chrome,7,1739028426,1739028433,1739028433.552356,-21600,,
com.microsoft.VSCode,14,1739028412,1739028426,1739028426.5430079,-21600,,
com.google.Chrome,6,1739028406,1739028412,1739028412.7196422,-21600,,
com.microsoft.VSCode,2,1739028404,1739028406,1739028406.901645,-21600,,
com.google.Chrome,6,1739028398,1739028404,1739028404.6444259,-21600,,
com.microsoft.VSCode,5,1739028393,1739028398,1739028398.781399,-21600,,
com.google.Chrome,11,1739028382,1739028393,1739028393.687388,-21600,,
com.microsoft.VSCode,13,1739028369,1739028382,1739028382.568056,-21600,,
com.google.Chrome,122,1739028247,1739028369,1739028369.863089,-21600,,
com.microsoft.VSCode,25,1739028222,1739028247,1739028247.296942,-21600,,
com.google.Chrome,4,1739028218,1739028222,1739028222.3299341,-21600,,
com.microsoft.VSCode,14,1739028204,1739028218,1739028218.8505812,-21600,,
com.google.Chrome,5,1739028199,1739028204,1739028204.641841,-21600,,
com.microsoft.VSCode,1,1739028198,1739028199,1739028199.601228,-21600,,
com.apple.Passwords,1,1739028197,1739028198,1739028198.945195,-21600,,
com.microsoft.VSCode,9,1739028188,1739028197,1739028197.961981,-21600,,
com.google.Chrome,15,1739028173,1739028188,1739028188.7433739,-21600,,
com.google.Chrome,1,1739028172,1739028173,1739028174.018149,-21600,,
com.microsoft.VSCode,21,1739028151,1739028172,1739028172.5142941,-21600,,
com.apple.Passwords,1,1739028150,1739028151,1739028151.504552,-21600,,
com.google.Chrome,2,1739028148,1739028150,1739028150.051816,-21600,,
com.google.Chrome,2,1739028146,1739028148,1739028148.900457,-21600,,
com.google.Chrome,8,1739028138,1739028146,1739028146.7893682,-21600,,
com.google.Chrome,2,1739028136,1739028138,1739028138.24241,-21600,,
com.microsoft.VSCode,20,1739028116,1739028136,1739028136.648927,-21600,,
com.google.Chrome,11,1739028105,1739028116,1739028116.273983,-21600,,
com.microsoft.VSCode,19,1739028086,1739028105,1739028105.833991,-21600,,
com.google.Chrome,19,1739028067,1739028086,1739028086.22234,-21600,,
com.microsoft.VSCode,42,1739028025,1739028067,1739028067.421091,-21600,,
com.google.Chrome,1,1739028024,1739028025,1739028025.846548,-21600,,
com.google.Chrome,35,1739027989,1739028024,1739028024.938808,-21600,,
com.google.Chrome,34,1739027955,1739027989,1739027989.038721,-21600,,
com.microsoft.VSCode,10,1739027945,1739027955,1739027955.815851,-21600,,
com.google.Chrome,3,1739027942,1739027945,1739027945.490418,-21600,,
com.microsoft.VSCode,11,1739027931,1739027942,1739027942.29582,-21600,,
com.google.Chrome,8,1739027923,1739027931,1739027931.7414908,-21600,,
com.google.Chrome,1,1739027922,1739027923,1739027923.6464381,-21600,,
com.microsoft.VSCode,15,1739027907,1739027922,1739027922.46928,-21600,,
com.google.Chrome,2,1739027905,1739027907,1739027907.3156118,-21600,,
com.google.Chrome,43,1739027862,1739027905,1739027905.496525,-21600,,
com.google.Chrome,53,1739027809,1739027862,1739027862.666349,-21600,,
com.microsoft.VSCode,59,1739027750,1739027809,1739027809.5546489,-21600,,
com.google.Chrome,18,1739027732,1739027750,1739027750.429079,-21600,,
com.microsoft.VSCode,18,1739027714,1739027732,1739027732.670089,-21600,,
com.google.Chrome,69,1739027645,1739027714,1739027714.358931,-21600,,
com.microsoft.VSCode,1,1739027644,1739027645,1739027646.027477,-21600,,
com.google.Chrome,11,1739027633,1739027644,1739027644.15066,-21600,,
com.microsoft.VSCode,37,1739027596,1739027633,1739027633.367331,-21600,,
com.google.Chrome,46,1739027550,1739027596,1739027596.9178681,-21600,,
com.microsoft.VSCode,4,1739027546,1739027550,1739027550.3483539,-21600,,
com.google.Chrome,8,1739027538,1739027546,1739027546.955482,-21600,,
com.microsoft.VSCode,11,1739027527,1739027538,1739027538.375122,-21600,,
com.google.Chrome,8,1739027519,1739027527,1739027527.4011722,-21600,,
com.microsoft.VSCode,8,1739027511,1739027519,1739027519.678824,-21600,,
com.google.Chrome,26,1739027485,1739027511,1739027511.1513739,-21600,,
com.microsoft.VSCode,4,1739027481,1739027485,1739027485.617013,-21600,,
com.google.Chrome,10,1739027471,1739027481,1739027482.0243502,-21600,,
com.microsoft.VSCode,7,1739027464,1739027471,1739027471.262311,-21600,,
com.google.Chrome,26,1739027438,1739027464,1739027464.749162,-21600,,
com.apple.Passwords,10,1739027428,1739027438,1739027438.238925,-21600,,
com.google.Chrome,12,1739027416,1739027428,1739027428.496041,-21600,,
com.microsoft.VSCode,7,1739027409,1739027416,1739027416.794879,-21600,,
com.google.Chrome,7,1739027402,1739027409,1739027409.801766,-21600,,
com.microsoft.VSCode,9,1739027393,1739027402,1739027402.242725,-21600,,
com.apple.finder,5,1739027388,1739027393,1739027393.389196,-21600,,
com.apple.systempreferences,31,1739027357,1739027388,1739027389.798439,-21600,,
com.apple.weather,7,1739027334,1739027341,1739027341.152134,-21600,EB445137-D7F5-57EC-87DA-1DB460D64046,"iPhone13,2"
com.apple.finder,1,1739027286,1739027287,1739027287.996691,-21600,,
com.microsoft.VSCode,1,1739027285,1739027286,1739027287.036083,-21600,,
com.google.Chrome,1,1739027168,1739027169,1739027170.000962,-21600,,
com.microsoft.VSCode,100,1739027068,1739027168,1739027168.43848,-21600,,
com.google.Chrome,22,1739027046,1739027068,1739027068.584414,-21600,,
com.microsoft.VSCode,22,1739027024,1739027046,1739027046.1113582,-21600,,
com.google.Chrome,18,1739027006,1739027024,1739027024.689118,-21600,,
com.myfitnesspal.mfp,186,1739026778,1739026964,1739026964.470066,-21600,EB445137-D7F5-57EC-87DA-1DB460D64046,"iPhone13,2"
com.apple.Health,12,1739026762,1739026774,1739026774.562911,-21600,EB445137-D7F5-57EC-87DA-1DB460D64046,"iPhone13,2"
com.apple.news,21,1739025803,1739025824,1739025824.823573,-21600,EB445137-D7F5-57EC-87DA-1DB460D64046,"iPhone13,2"
com.apple.weather,19,1739025771,1739025790,1739025790.668282,-21600,EB445137-D7F5-57EC-87DA-1DB460D64046,"iPhone13,2"
com.renpho.health,2,1739025769,1739025771,1739025771.384155,-21600,EB445137-D7F5-57EC-87DA-1DB460D64046,"iPhone13,2"
com.renpho.health,27,1739025712,1739025739,1739025740.059041,-21600,EB445137-D7F5-57EC-87DA-1DB460D64046,"iPhone13,2"
com.apple.news,118,1739024599,1739024717,1739024717.586539,-21600,EB445137-D7F5-57EC-87DA-1DB460D64046,"iPhone13,2"
com.apple.weather,72,1738992906,1738992978,1738992978.525593,-21600,EB445137-D7F5-57EC-87DA-1DB460D64046,"iPhone13,2"
com.instructure.icanvas,51,1738990443,1738990494,1738990494.544549,-21600,EB445137-D7F5-57EC-87DA-1DB460D64046,"iPhone13,2"
com.instructure.icanvas,90,1738989629,1738989719,1738989719.9557729,-21600,EB445137-D7F5-57EC-87DA-1DB460D64046,"iPhone13,2"
com.instructure.icanvas,53,1738989569,1738989622,1738989622.8246799,-21600,EB445137-D7F5-57EC-87DA-1DB460D64046,"iPhone13,2"
com.apple.news,0,1738989569,1738989569,1738989570.158895,-21600,EB445137-D7F5-57EC-87DA-1DB460D64046,"iPhone13,2"
com.google.Chrome,257,1738989163,1738989420,1738989421.2024422,-21600,,
com.apple.news,70,1738989042,1738989112,1738989112.213237,-21600,EB445137-D7F5-57EC-87DA-1DB460D64046,"iPhone13,2"
com.apple.weather,23,1738989019,1738989042,1738989042.101193,-21600,EB445137-D7F5-57EC-87DA-1DB460D64046,"iPhone13,2"
com.apple.mobileslideshow,60,1738988953,1738989013,1738989014.357121,-21600,EB445137-D7F5-57EC-87DA-1DB460D64046,"iPhone13,2"
com.apple.news,96,1738988802,1738988898,1738988898.239509,-21600,EB445137-D7F5-57EC-87DA-1DB460D64046,"iPhone13,2"
com.apple.weather,8,1738988794,1738988802,1738988802.649208,-21600,EB445137-D7F5-57EC-87DA-1DB460D64046,"iPhone13,2"
com.apple.news,12,1738988781,1738988793,1738988793.25956,-21600,EB445137-D7F5-57EC-87DA-1DB460D64046,"iPhone13,2"
com.zhiliaoapp.musically,39,1738988728,1738988767,1738988768.044712,-21600,EB445137-D7F5-57EC-87DA-1DB460D64046,"iPhone13,2"
com.zhiliaoapp.musically,93,1738988606,1738988699,1738988700.2649121,-21600,EB445137-D7F5-57EC-87DA-1DB460D64046,"iPhone13,2"
com.google.chrome.ios,14,1738988592,1738988606,1738988606.261239,-21600,EB445137-D7F5-57EC-87DA-1DB460D64046,"iPhone13,2"
com.burbn.instagram,46,1738988546,1738988592,1738988592.619076,-21600,EB445137-D7F5-57EC-87DA-1DB460D64046,"iPhone13,2"
com.google.chrome.ios,16,1738988530,1738988546,1738988546.9861321,-21600,EB445137-D7F5-57EC-87DA-1DB460D64046,"iPhone13,2"
com.burbn.instagram,12,1738988518,1738988530,1738988530.469944,-21600,EB445137-D7F5-57EC-87DA-1DB460D64046,"iPhone13,2"
com.google.chrome.ios,22,1738988496,1738988518,1738988518.242679,-21600,EB445137-D7F5-57EC-87DA-1DB460D64046,"iPhone13,2"
com.google.ios.youtube,45,1738988451,1738988496,1738988496.4461331,-21600,EB445137-D7F5-57EC-87DA-1DB460D64046,"iPhone13,2"
com.google.chrome.ios,59,1738988389,1738988448,1738988448.598629,-21600,EB445137-D7F5-57EC-87DA-1DB460D64046,"iPhone13,2"
com.google.Chrome,391,1738988158,1738988549,1738988549.987421,-21600,,
com.apple.finder,1,1738988102,1738988103,1738988104.416008,-21600,,
com.google.Chrome,176,1738987926,1738988102,1738988102.184986,-21600,,
com.microsoft.VSCode,24,1738987902,1738987926,1738987926.390893,-21600,,
com.myfitnesspal.mfp,28,1738987824,1738987852,1738987852.105377,-21600,EB445137-D7F5-57EC-87DA-1DB460D64046,"iPhone13,2"
com.apple.mobileslideshow,88,1738987736,1738987824,1738987824.48352,-21600,EB445137-D7F5-57EC-87DA-1DB460D64046,"iPhone13,2"
com.google.chrome.ios,128,1738987602,1738987730,1738987730.6107411,-21600,EB445137-D7F5-57EC-87DA-1DB460D64046,"iPhone13,2"
com.instructure.icanvas,12,1738987590,1738987602,1738987602.375015,-21600,EB445137-D7F5-57EC-87DA-1DB460D64046,"iPhone13,2"
com.instructure.icanvas,2,1738987588,1738987590,1738987590.0620952,-21600,EB445137-D7F5-57EC-87DA-1DB460D64046,"iPhone13,2"
com.instructure.icanvas,37,1738987529,1738987566,1738987566.773302,-21600,EB445137-D7F5-57EC-87DA-1DB460D64046,"iPhone13,2"
com.myfitnesspal.mfp,0,1738987529,1738987529,1738987530.286037,-21600,EB445137-D7F5-57EC-87DA-1DB460D64046,"iPhone13,2"
com.microsoft.VSCode,41,1738986986,1738987027,1738987027.758061,-21600,,
com.myfitnesspal.mfp,77,1738986796,1738986873,1738986873.373071,-21600,EB445137-D7F5-57EC-87DA-1DB460D64046,"iPhone13,2"
com.instructure.icanvas,2,1738986783,1738986785,1738986785.4983358,-21600,EB445137-D7F5-57EC-87DA-1DB460D64046,"iPhone13,2"
com.instructure.icanvas,75,1738986704,1738986779,1738986779.8143458,-21600,EB445137-D7F5-57EC-87DA-1DB460D64046,"iPhone13,2"
com.instructure.icanvas,26,1738986677,1738986703,1738986703.9815822,-21600,EB445137-D7F5-57EC-87DA-1DB460D64046,"iPhone13,2"
com.apple.news,1,1738986676,1738986677,1738986677.641273,-21600,EB445137-D7F5-57EC-87DA-1DB460D64046,"iPhone13,2"
com.apple.news,414,1738979777,1738980191,1738980192.154201,-21600,EB445137-D7F5-57EC-87DA-1DB460D64046,"iPhone13,2"
com.myfitnesspal.mfp,25,1738979710,1738979735,1738979735.7077122,-21600,EB445137-D7F5-57EC-87DA-1DB460D64046,"iPhone13,2"
com.hammerandchisel.discord,134,1738979576,1738979710,1738979710.824864,-21600,EB445137-D7F5-57EC-87DA-1DB460D64046,"iPhone13,2"
com.myfitnesspal.mfp,2,1738979573,1738979575,1738979575.511895,-21600,EB445137-D7F5-57EC-87DA-1DB460D64046,"iPhone13,2"
com.myfitnesspal.mfp,85,1738979455,1738979540,1738979540.669613,-21600,EB445137-D7F5-57EC-87DA-1DB460D64046,"iPhone13,2"
com.microsoft.Office.Outlook,9,1738979444,1738979453,1738979453.914178,-21600,EB445137-D7F5-57EC-87DA-1DB460D64046,"iPhone13,2"
com.myfitnesspal.mfp,0,1738979444,1738979444,1738979445.281612,-21600,EB445137-D7F5-57EC-87DA-1DB460D64046,"iPhone13,2"
com.myfitnesspal.mfp,67,1738977893,1738977960,1738977960.966274,-21600,EB445137-D7F5-57EC-87DA-1DB460D64046,"iPhone13,2"
com.apple.MobileSMS,2,1738977887,1738977889,1738977889.838975,-21600,EB445137-D7F5-57EC-87DA-1DB460D64046,"iPhone13,2"
com.apple.MobileSMS,12,1738977363,1738977375,1738977375.319895,-21600,EB445137-D7F5-57EC-87DA-1DB460D64046,"iPhone13,2"
com.apple.mobiletimer,1,1738977362,1738977363,1738977363.793284,-21600,EB445137-D7F5-57EC-87DA-1DB460D64046,"iPhone13,2"
com.apple.mobiletimer,4,1738976792,1738976796,1738976797.0282059,-21600,EB445137-D7F5-57EC-87DA-1DB460D64046,"iPhone13,2"
com.apple.mobiletimer,9,1738976228,1738976237,1738976237.643705,-21600,EB445137-D7F5-57EC-87DA-1DB460D64046,"iPhone13,2"
com.myfitnesspal.mfp,147,1738975808,1738975955,1738975955.511405,-21600,EB445137-D7F5-57EC-87DA-1DB460D64046,"iPhone13,2"
com.myfitnesspal.mfp,1,1738975797,1738975798,1738975798.952045,-21600,EB445137-D7F5-57EC-87DA-1DB460D64046,"iPhone13,2"
com.myfitnesspal.mfp,154,1738975633,1738975787,1738975788.0364308,-21600,EB445137-D7F5-57EC-87DA-1DB460D64046,"iPhone13,2"
com.apple.mobileslideshow,5,1738975626,1738975631,1738975632.221834,-21600,EB445137-D7F5-57EC-87DA-1DB460D64046,"iPhone13,2"
com.google.chrome.ios,8,1738975615,1738975623,1738975623.4797401,-21600,EB445137-D7F5-57EC-87DA-1DB460D64046,"iPhone13,2"
com.google.chrome.ios,17,1738974892,1738974909,1738974909.676152,-21600,EB445137-D7F5-57EC-87DA-1DB460D64046,"iPhone13,2"
com.meijer.mobile.Meijer,7,1738970166,1738970173,1738970173.2081041,-21600,EB445137-D7F5-57EC-87DA-1DB460D64046,"iPhone13,2"
com.meijer.mobile.Meijer,88,1738969970,1738970058,1738970058.91717,-21600,EB445137-D7F5-57EC-87DA-1DB460D64046,"iPhone13,2"
com.apple.mobilenotes,7,1738969963,1738969970,1738969970.598026,-21600,EB445137-D7F5-57EC-87DA-1DB460D64046,"iPhone13,2"
com.apple.mobilenotes,5,1738969940,1738969945,1738969945.942113,-21600,EB445137-D7F5-57EC-87DA-1DB460D64046,"iPhone13,2"
com.apple.mobilenotes,5,1738969864,1738969869,1738969869.729409,-21600,EB445137-D7F5-57EC-87DA-1DB460D64046,"iPhone13,2"
com.apple.mobilenotes,3,1738968427,1738968430,1738968430.949041,-21600,EB445137-D7F5-57EC-87DA-1DB460D64046,"iPhone13,2"
com.apple.mobilenotes,5,1738968199,1738968204,1738968205.535785,-21600,EB445137-D7F5-57EC-87DA-1DB460D64046,"iPhone13,2"
com.apple.mobilenotes,3,1738968192,1738968195,1738968195.7247992,-21600,EB445137-D7F5-57EC-87DA-1DB460D64046,"iPhone13,2"
com.apple.mobilenotes,10,1738968139,1738968149,1738968151.013998,-21600,EB445137-D7F5-57EC-87DA-1DB460D64046,"iPhone13,2"
com.microsoft.VSCode,16,1738965925,1738965941,1738965941.221922,-21600,,
com.google.Chrome,2,1738965923,1738965925,1738965925.587086,-21600,,
com.google.Chrome,1,1738965922,1738965923,1738965923.445447,-21600,,
com.google.Chrome,21,1738965901,1738965922,1738965922.118546,-21600,,
com.google.Chrome,0,1738965901,1738965901,1738965901.77522,-21600,,
com.microsoft.VSCode,6,1738965895,1738965901,1738965901.126853,-21600,,
com.google.Chrome,9,1738965886,1738965895,1738965895.767472,-21600,,
com.microsoft.VSCode,33,1738965853,1738965886,1738965887.010107,-21600,,
com.google.Chrome,5,1738965848,1738965853,1738965853.3970308,-21600,,
com.google.Chrome,1,1738965847,1738965848,1738965848.553765,-21600,,
com.microsoft.VSCode,9,1738965838,1738965847,1738965847.2879372,-21600,,
com.google.Chrome,11,1738965827,1738965838,1738965838.159507,-21600,,
com.microsoft.VSCode,33,1738965794,1738965827,1738965827.8736792,-21600,,
com.google.Chrome,24,1738965770,1738965794,1738965794.096986,-21600,,
com.microsoft.VSCode,2,1738965768,1738965770,1738965770.213532,-21600,,
com.google.Chrome,6,1738965762,1738965768,1738965769.061739,-21600,,
com.microsoft.VSCode,9,1738965753,1738965762,1738965762.417941,-21600,,
com.google.Chrome,33,1738965720,1738965753,1738965753.363554,-21600,,
com.microsoft.VSCode,19,1738965701,1738965720,1738965720.7321029,-21600,,
com.google.Chrome,2,1738965699,1738965701,1738965701.7831879,-21600,,
com.microsoft.VSCode,8,1738965691,1738965699,1738965699.291935,-21600,,
com.google.Chrome,12,1738965679,1738965691,1738965691.1220942,-21600,,
com.microsoft.VSCode,8,1738965671,1738965679,1738965679.894433,-21600,,
com.google.Chrome,42,1738965629,1738965671,1738965671.79302,-21600,,
com.microsoft.VSCode,3,1738965626,1738965629,1738965629.986512,-21600,,
com.google.Chrome,2,1738965624,1738965626,1738965626.412751,-21600,,
com.google.Chrome,1,1738965623,1738965624,1738965624.702527,-21600,,
com.microsoft.VSCode,2,1738965621,1738965623,1738965623.622328,-21600,,
com.google.Chrome,7,1738965614,1738965621,1738965621.137648,-21600,,
com.apple.Passwords,8,1738965606,1738965614,1738965614.456569,-21600,,
com.google.Chrome,8,1738965598,1738965606,1738965606.6798081,-21600,,
com.apple.Passwords,10,1738965588,1738965598,1738965598.876278,-21600,,
com.google.Chrome,68,1738965520,1738965588,1738965589.02723,-21600,,
com.google.Chrome,51,1738965469,1738965520,1738965520.4536638,-21600,,
com.apple.Passwords,9,1738965460,1738965469,1738965469.79916,-21600,,
com.google.Chrome,6,1738965454,1738965460,1738965460.715271,-21600,,
com.microsoft.VSCode,1,1738965453,1738965454,1738965454.554364,-21600,,
com.google.Chrome,1,1738965452,1738965453,1738965453.699893,-21600,,
com.microsoft.VSCode,40,1738965412,1738965452,1738965452.855599,-21600,,
com.google.Chrome,6,1738965406,1738965412,1738965412.594384,-21600,,
com.microsoft.VSCode,20,1738965386,1738965406,1738965406.319886,-21600,,
com.google.Chrome,2,1738965384,1738965386,1738965386.809596,-21600,,
com.microsoft.VSCode,11,1738965373,1738965384,1738965384.3641648,-21600,,
com.google.Chrome,105,1738965268,1738965373,1738965373.927332,-21600,,
com.microsoft.VSCode,2,1738965266,1738965268,1738965268.2020512,-21600,,
com.google.Chrome,129,1738965137,1738965266,1738965266.297365,-21600,,
com.microsoft.VSCode,4,1738965133,1738965137,1738965137.810555,-21600,,
com.google.Chrome,2,1738965131,1738965133,1738965133.485344,-21600,,
com.apple.finder,2,1738965129,1738965131,1738965131.1640902,-21600,,
com.microsoft.VSCode,1,1738965128,1738965129,1738965129.6015902,-21600,,
com.google.Chrome,8,1738965120,1738965128,1738965128.3331509,-21600,,
com.microsoft.VSCode,1,1738965119,1738965120,1738965120.6192532,-21600,,
com.google.Chrome,142,1738964977,1738965119,1738965119.867035,-21600,,
com.microsoft.VSCode,15,1738964962,1738964977,1738964977.49271,-21600,,
com.google.Chrome,1,1738964961,1738964962,1738964962.864667,-21600,,
com.microsoft.VSCode,64,1738964897,1738964961,1738964961.617924,-21600,,
com.google.Chrome,3,1738964894,1738964897,1738964898.055013,-21600,,
com.microsoft.VSCode,8,1738964886,1738964894,1738964894.6487641,-21600,,
com.google.Chrome,0,1738964886,1738964886,1738964886.938466,-21600,,
com.microsoft.VSCode,2,1738964884,1738964886,1738964886.464707,-21600,,
com.google.Chrome,55,1738964829,1738964884,1738964884.9485369,-21600,,
com.toyopagroup.picaboo,7,1738964807,1738964814,1738964814.926101,-21600,EB445137-D7F5-57EC-87DA-1DB460D64046,"iPhone13,2"
com.microsoft.VSCode,92,1738964737,1738964829,1738964829.256952,-21600,,
com.google.Chrome,130,1738964607,1738964737,1738964737.0282621,-21600,,
com.microsoft.VSCode,8,1738964599,1738964607,1738964607.611181,-21600,,
com.google.Chrome,24,1738964575,1738964599,1738964599.629404,-21600,,
com.microsoft.VSCode,15,1738964560,1738964575,1738964575.782475,-21600,,
com.google.Chrome,12,1738964548,1738964560,1738964560.527219,-21600,,
com.microsoft.VSCode,8,1738964540,1738964548,1738964548.722412,-21600,,
com.google.Chrome,187,1738964353,1738964540,1738964540.094815,-21600,,
com.apple.finder,4,1738964349,1738964353,1738964353.775852,-21600,,
com.toyopagroup.picaboo,16,1738964332,1738964348,1738964349.210555,-21600,EB445137-D7F5-57EC-87DA-1DB460D64046,"iPhone13,2"
com.apple.findmy,41,1738964308,1738964349,1738964349.761728,-21600,,
com.apple.finder,3,1738964305,1738964308,1738964308.819518,-21600,,
com.apple.MobileSMS,6,1738964299,1738964305,1738964306.032298,-21600,,
com.apple.finder,1,1738964298,1738964299,1738964299.441994,-21600,,
com.apple.Music,4,1738964294,1738964298,1738964298.4759011,-21600,,
com.apple.finder,1,1738964293,1738964294,1738964294.267713,-21600,,
com.apple.news,101,1738964186,1738964287,1738964288.219075,-21600,EB445137-D7F5-57EC-87DA-1DB460D64046,"iPhone13,2"
com.toyopagroup.picaboo,27,1738964138,1738964165,1738964165.546677,-21600,EB445137-D7F5-57EC-87DA-1DB460D64046,"iPhone13,2"
com.myfitnesspal.mfp,1,1738964137,1738964138,1738964138.969623,-21600,EB445137-D7F5-57EC-87DA-1DB460D64046,"iPhone13,2"
com.microsoft.VSCode,170,1738964123,1738964293,1738964293.523322,-21600,,
com.apple.finder,4,1738964119,1738964123,1738964123.120027,-21600,,
com.apple.Music,25,1738964094,1738964119,1738964119.171681,-21600,,
com.apple.MobileSMS,6,1738964088,1738964094,1738964094.5549521,-21600,,
com.apple.Notes,40,1738964048,1738964088,1738964088.786494,-21600,,
com.apple.Notes,375,1738963179,1738963554,1738963554.746788,-21600,,
com.apple.finder,1,1738963178,1738963179,1738963179.714869,-21600,,
com.google.Chrome,1,1738963177,1738963178,1738963178.572581,-21600,,
com.apple.Notes,14,1738963163,1738963177,1738963177.237863,-21600,,
com.google.Chrome,1,1738963162,1738963163,1738963163.334465,-21600,,
com.apple.Notes,423,1738962739,1738963162,1738963162.104714,-21600,,
com.google.Chrome,10,1738962729,1738962739,1738962742.209877,-21600,,
com.myfitnesspal.mfp,19,1738962567,1738962586,1738962587.0953,-21600,EB445137-D7F5-57EC-87DA-1DB460D64046,"iPhone13,2"
com.groupme.iphone-app,8,1738961820,1738961828,1738961828.84734,-21600,EB445137-D7F5-57EC-87DA-1DB460D64046,"iPhone13,2"
com.instructure.icanvas,0,1738961820,1738961820,1738961821.1677809,-21600,EB445137-D7F5-57EC-87DA-1DB460D64046,"iPhone13,2"
com.instructure.icanvas,15,1738958254,1738958269,1738958269.874874,-21600,EB445137-D7F5-57EC-87DA-1DB460D64046,"iPhone13,2"
com.instructure.icanvas,8,1738958208,1738958216,1738958218.179439,-21600,EB445137-D7F5-57EC-87DA-1DB460D64046,"iPhone13,2"
com.apple.news,2,1738958205,1738958207,1738958207.768468,-21600,EB445137-D7F5-57EC-87DA-1DB460D64046,"iPhone13,2"
com.google.Chrome,151,1738957452,1738957603,1738957603.751639,-21600,,
com.apple.finder,2,1738957450,1738957452,1738957453.394464,-21600,,
com.apple.news,184,1738956951,1738957135,1738957136.775148,-21600,EB445137-D7F5-57EC-87DA-1DB460D64046,"iPhone13,2"
com.apple.news,107,1738955796,1738955903,1738955903.963433,-21600,EB445137-D7F5-57EC-87DA-1DB460D64046,"iPhone13,2"
com.apple.news,132,1738955526,1738955658,1738955659.0747452,-21600,EB445137-D7F5-57EC-87DA-1DB460D64046,"iPhone13,2"
com.microsoft.Office.Outlook,2,1738955497,1738955499,1738955499.470911,-21600,EB445137-D7F5-57EC-87DA-1DB460D64046,"iPhone13,2"
com.microsoft.Office.Outlook,4,1738955230,1738955234,1738955234.2647161,-21600,EB445137-D7F5-57EC-87DA-1DB460D64046,"iPhone13,2"
com.google.chrome.ios,8,1738955221,1738955229,1738955229.738676,-21600,EB445137-D7F5-57EC-87DA-1DB460D64046,"iPhone13,2"
com.apple.mobilecal,65,1738955155,1738955220,1738955220.1944098,-21600,EB445137-D7F5-57EC-87DA-1DB460D64046,"iPhone13,2"
com.apple.CoreAuthUI,2,1738955092,1738955094,1738955094.982646,-21600,EB445137-D7F5-57EC-87DA-1DB460D64046,"iPhone13,2"
com.google.chrome.ios,82,1738955069,1738955151,1738955151.5894089,-21600,EB445137-D7F5-57EC-87DA-1DB460D64046,"iPhone13,2"
com.leomehlig.today,2,1738955067,1738955069,1738955069.380544,-21600,EB445137-D7F5-57EC-87DA-1DB460D64046,"iPhone13,2"
com.leomehlig.today,42,1738954981,1738955023,1738955023.6861758,-21600,EB445137-D7F5-57EC-87DA-1DB460D64046,"iPhone13,2"
com.myfitnesspal.mfp,1,1738954975,1738954976,1738954976.868115,-21600,EB445137-D7F5-57EC-87DA-1DB460D64046,"iPhone13,2"
com.apple.finder,1,1738954922,1738954923,1738954923.451047,-21600,,
com.microsoft.VSCode,9,1738954913,1738954922,1738954922.163453,-21600,,
com.google.Chrome,43,1738954870,1738954913,1738954914.3210459,-21600,,
com.microsoft.VSCode,7,1738954789,1738954796,1738954796.865384,-21600,,
com.google.Chrome,16,1738954773,1738954789,1738954789.475935,-21600,,
com.microsoft.VSCode,13,1738954760,1738954773,1738954773.437993,-21600,,
com.google.Chrome,30,1738954730,1738954760,1738954760.553086,-21600,,
com.microsoft.VSCode,1,1738954729,1738954730,1738954730.994652,-21600,,
com.google.Chrome,10,1738954719,1738954729,1738954729.128427,-21600,,
com.microsoft.VSCode,1,1738954718,1738954719,1738954719.838604,-21600,,
com.google.Chrome,7,1738954711,1738954718,1738954718.540039,-21600,,
com.microsoft.VSCode,11,1738954700,1738954711,1738954711.288928,-21600,,
com.google.Chrome,9,1738954691,1738954700,1738954700.749162,-21600,,
com.microsoft.VSCode,2,1738954689,1738954691,1738954691.7485209,-21600,,
com.google.Chrome,10,1738954679,1738954689,1738954689.481574,-21600,,
com.microsoft.VSCode,7,1738954672,1738954679,1738954679.151701,-21600,,
com.google.Chrome,29,1738954643,1738954672,1738954672.6306372,-21600,,
com.microsoft.VSCode,2,1738954641,1738954643,1738954643.8936539,-21600,,
com.google.Chrome,14,1738954627,1738954641,1738954641.913992,-21600,,
com.microsoft.VSCode,2,1738954625,1738954627,1738954627.712572,-21600,,
com.google.Chrome,11,1738954614,1738954625,1738954625.1968598,-21600,,
com.microsoft.VSCode,3,1738954611,1738954614,1738954614.576066,-21600,,
com.google.Chrome,14,1738954597,1738954611,1738954611.930038,-21600,,
com.microsoft.VSCode,3,1738954594,1738954597,1738954597.460746,-21600,,
com.google.Chrome,30,1738954564,1738954594,1738954594.2666411,-21600,,
com.microsoft.VSCode,19,1738954545,1738954564,1738954564.064663,-21600,,
com.google.Chrome,1,1738954544,1738954545,1738954545.3227959,-21600,,
com.microsoft.VSCode,7,1738954537,1738954544,1738954544.2381449,-21600,,
com.google.Chrome,6,1738954531,1738954537,1738954537.4046102,-21600,,
com.microsoft.VSCode,285,1738954246,1738954531,1738954531.474122,-21600,,
com.google.Chrome,10,1738954236,1738954246,1738954246.266186,-21600,,
com.apple.finder,1,1738954235,1738954236,1738954236.552113,-21600,,
com.microsoft.VSCode,17,1738954218,1738954235,1738954235.145722,-21600,,
com.apple.finder,2,1738954216,1738954218,1738954218.574171,-21600,,
com.google.Chrome,7,1738954209,1738954216,1738954216.878447,-21600,,
com.apple.finder,31,1738954178,1738954209,1738954209.1573591,-21600,,
com.microsoft.VSCode,1,1738954177,1738954178,1738954178.207242,-21600,,
com.apple.Terminal,3,1738954174,1738954177,1738954177.0805159,-21600,,
com.microsoft.VSCode,71,1738954103,1738954174,1738954174.067277,-21600,,
com.google.Chrome,1,1738954102,1738954103,1738954103.068006,-21600,,
com.apple.finder,6,1738954096,1738954102,1738954102.252065,-21600,,
com.google.Chrome,1,1738954095,1738954096,1738954096.2952108,-21600,,
com.microsoft.VSCode,20,1738954075,1738954095,1738954095.356004,-21600,,
com.google.Chrome,6,1738954069,1738954075,1738954075.272811,-21600,,
com.microsoft.VSCode,9,1738954060,1738954069,1738954069.972009,-21600,,
com.google.Chrome,15,1738954045,1738954060,1738954060.450083,-21600,,
com.microsoft.VSCode,6,1738954039,1738954045,1738954045.347759,-21600,,
com.apple.finder,34,1738954005,1738954039,1738954039.2399879,-21600,,
com.microsoft.VSCode,15,1738953990,1738954005,1738954005.644532,-21600,,
com.google.Chrome,4,1738953986,1738953990,1738953990.6156511,-21600,,
com.microsoft.VSCode,19,1738953967,1738953986,1738953986.6652598,-21600,,
com.google.Chrome,3,1738953964,1738953967,1738953967.0827088,-21600,,
com.microsoft.VSCode,12,1738953952,1738953964,1738953964.967536,-21600,,
com.google.Chrome,89,1738953863,1738953952,1738953952.837914,-21600,,
com.microsoft.VSCode,3,1738953860,1738953863,1738953863.1898952,-21600,,
com.microsoft.VSCode,379,1738952595,1738952974,1738952974.655459,-21600,,
com.google.Chrome,4,1738952591,1738952595,1738952595.860862,-21600,,
com.microsoft.VSCode,6,1738952585,1738952591,1738952591.838255,-21600,,
com.google.Chrome,42,1738952543,1738952585,1738952585.533921,-21600,,
com.microsoft.VSCode,122,1738952421,1738952543,1738952543.123588,-21600,,
com.google.Chrome,1,1738952420,1738952421,1738952421.935413,-21600,,
com.microsoft.VSCode,3,1738952417,1738952420,1738952420.703825,-21600,,
com.google.Chrome,1,1738952416,1738952417,1738952417.166675,-21600,,
com.microsoft.VSCode,4,1738952412,1738952416,1738952416.358002,-21600,,
com.google.Chrome,4,1738952408,1738952412,1738952412.077256,-21600,,
com.microsoft.VSCode,2,1738952406,1738952408,1738952408.9070091,-21600,,
com.google.Chrome,26,1738952380,1738952406,1738952406.197653,-21600,,
com.microsoft.VSCode,147,1738952233,1738952380,1738952380.070785,-21600,,
com.google.Chrome,1,1738952232,1738952233,1738952233.8926048,-21600,,
com.microsoft.VSCode,163,1738952069,1738952232,1738952232.496072,-21600,,
com.google.Chrome,105,1738951964,1738952069,1738952069.6287751,-21600,,
com.microsoft.VSCode,106,1738951858,1738951964,1738951964.360019,-21600,,
com.myfitnesspal.mfp,72,1738951771,1738951843,1738951844.146451,-21600,EB445137-D7F5-57EC-87DA-1DB460D64046,"iPhone13,2"
com.google.chrome.ios,3,1738951768,1738951771,1738951771.225369,-21600,EB445137-D7F5-57EC-87DA-1DB460D64046,"iPhone13,2"
com.google.chrome.ios,29,1738947882,1738947911,1738947911.549313,-21600,EB445137-D7F5-57EC-87DA-1DB460D64046,"iPhone13,2"
com.hammerandchisel.discord,86,1738947475,1738947561,1738947561.547855,-21600,EB445137-D7F5-57EC-87DA-1DB460D64046,"iPhone13,2"
com.hammerandchisel.discord,2,1738947473,1738947475,1738947475.244425,-21600,EB445137-D7F5-57EC-87DA-1DB460D64046,"iPhone13,2"
com.microsoft.Office.Outlook,8,1738947258,1738947266,1738947266.677521,-21600,EB445137-D7F5-57EC-87DA-1DB460D64046,"iPhone13,2"
com.groupme.iphone-app,5,1738947251,1738947256,1738947256.393992,-21600,EB445137-D7F5-57EC-87DA-1DB460D64046,"iPhone13,2"
com.leomehlig.today,0,1738947251,1738947251,1738947251.8008618,-21600,EB445137-D7F5-57EC-87DA-1DB460D64046,"iPhone13,2"
com.microsoft.VSCode,137,1738947055,1738947192,1738947192.8424811,-21600,,
com.google.Chrome,1,1738947054,1738947055,1738947055.3565521,-21600,,
com.microsoft.VSCode,2,1738947052,1738947054,1738947054.1559072,-21600,,
com.google.Chrome,1,1738947051,1738947052,1738947052.465143,-21600,,
com.microsoft.VSCode,6,1738947045,1738947051,1738947051.607356,-21600,,
com.google.Chrome,3,1738947042,1738947045,1738947045.37601,-21600,,
com.microsoft.VSCode,188,1738946854,1738947042,1738947042.896271,-21600,,
com.google.Chrome,2,1738946852,1738946854,1738946855.020904,-21600,,
com.microsoft.VSCode,133,1738946719,1738946852,1738946853.033153,-21600,,
com.google.Chrome,17,1738946702,1738946719,1738946719.5389562,-21600,,
com.microsoft.VSCode,2,1738946700,1738946702,1738946702.2406769,-21600,,
com.google.Chrome,1,1738946699,1738946700,1738946700.135757,-21600,,
com.microsoft.VSCode,2,1738946697,1738946699,1738946699.2324882,-21600,,
com.google.Chrome,2,1738946695,1738946697,1738946697.3457599,-21600,,
com.microsoft.VSCode,2,1738946693,1738946695,1738946695.2343469,-21600,,
com.google.Chrome,1,1738946692,1738946693,1738946693.308436,-21600,,
com.microsoft.VSCode,2,1738946690,1738946692,1738946692.146216,-21600,,
com.google.Chrome,2,1738946688,1738946690,1738946690.235246,-21600,,
com.microsoft.VSCode,2,1738946686,1738946688,1738946688.5413718,-21600,,
com.google.Chrome,1,1738946685,1738946686,1738946686.903328,-21600,,
com.microsoft.VSCode,1,1738946684,1738946685,1738946685.9010792,-21600,,
com.google.Chrome,2,1738946682,1738946684,1738946684.124059,-21600,,
com.microsoft.VSCode,2,1738946680,1738946682,1738946682.4750829,-21600,,
com.google.Chrome,1,1738946679,1738946680,1738946680.415523,-21600,,
com.microsoft.VSCode,2,1738946677,1738946679,1738946679.492574,-21600,,
com.google.Chrome,1,1738946676,1738946677,1738946678.006058,-21600,,
com.microsoft.VSCode,2,1738946674,1738946676,1738946676.46228,-21600,,
com.google.Chrome,1,1738946673,1738946674,1738946674.7531419,-21600,,
com.microsoft.VSCode,2,1738946671,1738946673,1738946673.2511492,-21600,,
com.google.Chrome,2,1738946669,1738946671,1738946671.6222029,-21600,,
com.microsoft.VSCode,2,1738946667,1738946669,1738946669.3785892,-21600,,
com.google.Chrome,1,1738946666,1738946667,1738946667.941669,-21600,,
com.microsoft.VSCode,2,1738946664,1738946666,1738946666.951079,-21600,,
com.google.Chrome,2,1738946662,1738946664,1738946664.447402,-21600,,
com.microsoft.VSCode,1,1738946661,1738946662,1738946662.6932201,-21600,,
com.google.Chrome,1,1738946660,1738946661,1738946661.1377149,-21600,,
com.microsoft.VSCode,1,1738946659,1738946660,1738946660.123752,-21600,,
com.google.Chrome,1,1738946658,1738946659,1738946659.396327,-21600,,
com.microsoft.VSCode,38,1738946620,1738946658,1738946658.2794151,-21600,,
com.google.Chrome,2,1738946618,1738946620,1738946620.786447,-21600,,
com.microsoft.VSCode,5,1738946613,1738946618,1738946618.808559,-21600,,
com.google.Chrome,3,1738946610,1738946613,1738946613.1253262,-21600,,
com.microsoft.VSCode,41,1738946569,1738946610,1738946610.148339,-21600,,
com.google.Chrome,2,1738946567,1738946569,1738946569.454104,-21600,,
com.microsoft.VSCode,5,1738946562,1738946567,1738946567.892757,-21600,,
com.google.Chrome,4,1738946558,1738946562,1738946562.511451,-21600,,
com.microsoft.VSCode,7,1738946551,1738946558,1738946558.774434,-21600,,
com.google.Chrome,2,1738946549,1738946551,1738946551.414779,-21600,,
com.microsoft.VSCode,13,1738946536,1738946549,1738946549.0770721,-21600,,
com.google.Chrome,4,1738946532,1738946536,1738946536.9587312,-21600,,
com.microsoft.VSCode,124,1738946408,1738946532,1738946532.1925511,-21600,,
com.google.Chrome,5,1738946403,1738946408,1738946409.03935,-21600,,
com.microsoft.VSCode,3,1738946400,1738946403,1738946403.47731,-21600,,
com.google.Chrome,1,1738946399,1738946400,1738946400.444525,-21600,,
com.microsoft.VSCode,4,1738946395,1738946399,1738946399.262126,-21600,,
com.google.Chrome,2,1738946393,1738946395,1738946395.8935971,-21600,,
com.microsoft.VSCode,46,1738946347,1738946393,1738946393.656276,-21600,,
com.google.Chrome,3,1738946344,1738946347,1738946347.4874182,-21600,,
com.microsoft.VSCode,3,1738946341,1738946344,1738946344.083524,-21600,,
com.google.Chrome,1,1738946340,1738946341,1738946342.007678,-21600,,
com.microsoft.VSCode,2,1738946338,1738946340,1738946340.589134,-21600,,
com.google.Chrome,1,1738946337,1738946338,1738946338.818167,-21600,,
com.microsoft.VSCode,3,1738946334,1738946337,1738946337.5239491,-21600,,
com.google.Chrome,1,1738946333,1738946334,1738946334.981807,-21600,,
com.microsoft.VSCode,3,1738946330,1738946333,1738946333.168466,-21600,,
com.google.Chrome,2,1738946328,1738946330,1738946330.701882,-21600,,
com.microsoft.VSCode,2,1738946326,1738946328,1738946328.947394,-21600,,
com.google.Chrome,1,1738946325,1738946326,1738946326.702509,-21600,,
com.microsoft.VSCode,3,1738946322,1738946325,1738946325.719223,-21600,,
com.google.Chrome,2,1738946320,1738946322,1738946322.496142,-21600,,
com.microsoft.VSCode,2,1738946318,1738946320,1738946320.9089742,-21600,,
com.google.Chrome,2,1738946316,1738946318,1738946318.3046498,-21600,,
com.microsoft.VSCode,3,1738946313,1738946316,1738946316.635246,-21600,,
com.google.Chrome,4,1738946309,1738946313,1738946313.191588,-21600,,
com.microsoft.VSCode,3,1738946306,1738946309,1738946309.162394,-21600,,
com.google.Chrome,2,1738946304,1738946306,1738946306.354671,-21600,,
com.microsoft.VSCode,2,1738946302,1738946304,1738946304.7993789,-21600,,
com.google.Chrome,1,1738946301,1738946302,1738946302.8443751,-21600,,
com.microsoft.VSCode,4,1738946297,1738946301,1738946301.541699,-21600,,
com.google.Chrome,1,1738946296,1738946297,1738946297.769587,-21600,,
com.microsoft.VSCode,2,1738946294,1738946296,1738946296.7877111,-21600,,
com.google.Chrome,2,1738946292,1738946294,1738946294.070097,-21600,,
com.microsoft.VSCode,3,1738946289,1738946292,1738946292.397394,-21600,,
com.google.Chrome,1,1738946288,1738946289,1738946289.984628,-21600,,
com.microsoft.VSCode,3,1738946285,1738946288,1738946288.43526,-21600,,
com.google.Chrome,1,1738946284,1738946285,1738946285.8600202,-21600,,
com.microsoft.VSCode,18,1738946266,1738946284,1738946284.806013,-21600,,
com.google.Chrome,1,1738946265,1738946266,1738946266.54281,-21600,,
com.microsoft.VSCode,48,1738946217,1738946265,1738946265.060275,-21600,,
com.google.Chrome,22,1738946195,1738946217,1738946217.119184,-21600,,
com.microsoft.VSCode,11,1738946184,1738946195,1738946195.986422,-21600,,
com.google.Chrome,10,1738946174,1738946184,1738946184.50948,-21600,,
com.microsoft.VSCode,4,1738946170,1738946174,1738946174.419464,-21600,,
com.google.Chrome,16,1738946154,1738946170,1738946170.66498,-21600,,
com.microsoft.VSCode,42,1738946112,1738946154,1738946154.490423,-21600,,
com.google.Chrome,2,1738946110,1738946112,1738946112.165588,-21600,,
com.microsoft.VSCode,32,1738946078,1738946110,1738946110.2849321,-21600,,
com.google.Chrome,3,1738946075,1738946078,1738946078.332052,-21600,,
com.google.Chrome,473,1738944539,1738945012,1738945012.025717,-21600,,
com.microsoft.VSCode,3,1738944536,1738944539,1738944539.827468,-21600,,
com.leomehlig.today,17,1738943811,1738943828,1738943828.3754148,-21600,EB445137-D7F5-57EC-87DA-1DB460D64046,"iPhone13,2"
com.groupme.iphone-app,22,1738943780,1738943802,1738943802.5389981,-21600,EB445137-D7F5-57EC-87DA-1DB460D64046,"iPhone13,2"
com.microsoft.VSCode,125,1738942238,1738942363,1738942363.739698,-21600,,
com.apple.weather,4,1738942135,1738942139,1738942139.2488,-21600,EB445137-D7F5-57EC-87DA-1DB460D64046,"iPhone13,2"
com.microsoft.VSCode,61,1738941180,1738941241,1738941242.453968,-21600,,
com.apple.Terminal,1,1738941179,1738941180,1738941180.092242,-21600,,
com.google.Chrome,5,1738941174,1738941179,1738941179.3370628,-21600,,
com.apple.Terminal,1,1738941173,1738941174,1738941174.6174269,-21600,,
com.google.Chrome,1,1738941172,1738941173,1738941173.384862,-21600,,
com.microsoft.VSCode,52,1738941120,1738941172,1738941172.7072458,-21600,,
com.google.Chrome,19,1738941101,1738941120,1738941120.3030128,-21600,,
com.microsoft.VSCode,3,1738941098,1738941101,1738941101.482383,-21600,,
com.google.Chrome,10,1738941088,1738941098,1738941098.307592,-21600,,
com.microsoft.VSCode,24,1738941064,1738941088,1738941088.402935,-21600,,
com.google.Chrome,17,1738941047,1738941064,1738941064.5813031,-21600,,
com.apple.Terminal,5,1738941042,1738941047,1738941047.486415,-21600,,
com.google.Chrome,22,1738941020,1738941042,1738941042.829874,-21600,,
com.apple.Terminal,15,1738941005,1738941020,1738941020.2739592,-21600,,
com.google.Chrome,3,1738941002,1738941005,1738941006.001041,-21600,,
com.apple.finder,2,1738941000,1738941002,1738941002.149382,-21600,,
com.google.Chrome,29,1738940971,1738941000,1738941000.06175,-21600,,
com.apple.finder,2,1738940969,1738940971,1738940971.4995952,-21600,,
com.google.Chrome,14,1738940955,1738940969,1738940969.347667,-21600,,
com.apple.finder,1,1738940954,1738940955,1738940955.770478,-21600,,
com.microsoft.VSCode,52,1738940902,1738940954,1738940954.6791658,-21600,,
com.apple.finder,5,1738940897,1738940902,1738940903.034422,-21600,,
com.microsoft.VSCode,23,1738940874,1738940897,1738940897.7328491,-21600,,
com.apple.finder,44,1738940830,1738940874,1738940874.598548,-21600,,
com.microsoft.VSCode,8,1738940822,1738940830,1738940830.074872,-21600,,
com.google.Chrome,2,1738940820,1738940822,1738940822.272408,-21600,,
com.microsoft.VSCode,0,1738940820,1738940820,1738940820.702676,-21600,,
com.google.Chrome,1,1738940819,1738940820,1738940820.3366718,-21600,,
com.microsoft.VSCode,7,1738940812,1738940819,1738940819.372229,-21600,,
com.google.Chrome,19,1738940793,1738940812,1738940812.459724,-21600,,
com.microsoft.VSCode,69,1738940724,1738940793,1738940793.7384,-21600,,
com.google.Chrome,2,1738940722,1738940724,1738940724.8893619,-21600,,
com.microsoft.VSCode,85,1738940637,1738940722,1738940723.3944569,-21600,,
com.google.Chrome,9,1738940628,1738940637,1738940637.956835,-21600,,
com.microsoft.VSCode,61,1738940567,1738940628,1738940628.715275,-21600,,
com.google.Chrome,74,1738940493,1738940567,1738940567.133442,-21600,,
com.microsoft.VSCode,174,1738940319,1738940493,1738940493.9212499,-21600,,
com.google.Chrome,9,1738940310,1738940319,1738940319.687041,-21600,,
com.apple.weather,4,1738939392,1738939396,1738939397.003357,-21600,EB445137-D7F5-57EC-87DA-1DB460D64046,"iPhone13,2"
com.apple.weather,4,1738939387,1738939391,1738939391.187183,-21600,EB445137-D7F5-57EC-87DA-1DB460D64046,"iPhone13,2"
com.renpho.health,136,1738939211,1738939347,1738939347.349114,-21600,EB445137-D7F5-57EC-87DA-1DB460D64046,"iPhone13,2"
com.apple.Health,2,1738939209,1738939211,1738939211.280823,-21600,EB445137-D7F5-57EC-87DA-1DB460D64046,"iPhone13,2"
com.apple.Health,64,1738938092,1738938156,1738938157.8699222,-21600,EB445137-D7F5-57EC-87DA-1DB460D64046,"iPhone13,2"
com.groupme.iphone-app,25,1738938064,1738938089,1738938089.32459,-21600,EB445137-D7F5-57EC-87DA-1DB460D64046,"iPhone13,2"
com.thestorygraph.thestorygraph,11,1738905416,1738905427,1738905427.540098,-21600,EB445137-D7F5-57EC-87DA-1DB460D64046,"iPhone13,2"
com.apple.Health,31,1738904664,1738904695,1738904695.9770021,-21600,EB445137-D7F5-57EC-87DA-1DB460D64046,"iPhone13,2"
com.apple.CoreAuthUI,2,1738903871,1738903873,1738903873.813562,-21600,EB445137-D7F5-57EC-87DA-1DB460D64046,"iPhone13,2"
com.apple.journal,791,1738903870,1738904661,1738904661.131994,-21600,EB445137-D7F5-57EC-87DA-1DB460D64046,"iPhone13,2"
com.google.Chrome,107,1738903669,1738903776,1738903776.4059238,-21600,,
com.thestorygraph.thestorygraph,19,1738903507,1738903526,1738903526.539304,-21600,EB445137-D7F5-57EC-87DA-1DB460D64046,"iPhone13,2"
com.apple.mobilenotes,2,1738903504,1738903506,1738903506.643821,-21600,EB445137-D7F5-57EC-87DA-1DB460D64046,"iPhone13,2"
com.apple.mobilenotes,17,1738903297,1738903314,1738903314.419125,-21600,EB445137-D7F5-57EC-87DA-1DB460D64046,"iPhone13,2"
com.apple.Preferences,2,1738903292,1738903294,1738903294.473065,-21600,EB445137-D7F5-57EC-87DA-1DB460D64046,"iPhone13,2"
com.google.Chrome,8,1738902564,1738902572,1738902572.8634129,-21600,,
com.microsoft.VSCode,2181,1738900383,1738902564,1738902565.151933,-21600,,
com.google.Chrome,2,1738900381,1738900383,1738900383.9962559,-21600,,
com.microsoft.VSCode,90,1738900291,1738900381,1738900381.918601,-21600,,
com.google.Chrome,52,1738900239,1738900291,1738900291.7808762,-21600,,
com.apple.Preferences,95,1738899933,1738900028,1738900028.985714,-21600,EB445137-D7F5-57EC-87DA-1DB460D64046,"iPhone13,2"
com.apple.Health,52,1738899879,1738899931,1738899931.334187,-21600,EB445137-D7F5-57EC-87DA-1DB460D64046,"iPhone13,2"
com.hammerandchisel.discord,44,1738899835,1738899879,1738899879.572497,-21600,EB445137-D7F5-57EC-87DA-1DB460D64046,"iPhone13,2"
com.hammerandchisel.discord,5,1738899828,1738899833,1738899833.781631,-21600,EB445137-D7F5-57EC-87DA-1DB460D64046,"iPhone13,2"
com.microsoft.VSCode,422,1738899817,1738900239,1738900239.6079211,-21600,,
com.microsoft.onenote.mac,49,1738899768,1738899817,1738899817.2518492,-21600,,
com.google.Chrome,10,1738899758,1738899768,1738899768.146933,-21600,,
com.leomehlig.today,13,1738899745,1738899758,1738899758.174269,-21600,,
com.google.Chrome,6,1738899739,1738899745,1738899745.920553,-21600,,
com.apple.Music,26,1738896643,1738896669,1738896669.5342789,-21600,EB445137-D7F5-57EC-87DA-1DB460D64046,"iPhone13,2"
com.apple.weather,6,1738896497,1738896503,1738896503.813417,-21600,EB445137-D7F5-57EC-87DA-1DB460D64046,"iPhone13,2"
com.hammerandchisel.discord,1,1738896496,1738896497,1738896498.0705929,-21600,EB445137-D7F5-57EC-87DA-1DB460D64046,"iPhone13,2"
com.google.Chrome,35,1738896341,1738896376,1738896376.934938,-21600,,
com.apple.finder,2,1738896339,1738896341,1738896341.999094,-21600,,
com.leomehlig.today,101,1738896238,1738896339,1738896339.200357,-21600,,
com.google.Chrome,15,1738896223,1738896238,1738896238.804652,-21600,,
com.leomehlig.today,149,1738896074,1738896223,1738896223.421624,-21600,,
com.google.Chrome,42,1738896032,1738896074,1738896074.83786,-21600,,
com.leomehlig.today,17,1738896002,1738896019,1738896019.9095821,-21600,,
com.leomehlig.today,34,1738894780,1738894814,1738894814.534636,-21600,,
com.microsoft.VSCode,4,1738894776,1738894780,1738894780.991895,-21600,,
com.hammerandchisel.discord,6,1738894606,1738894612,1738894612.503984,-21600,EB445137-D7F5-57EC-87DA-1DB460D64046,"iPhone13,2"
com.google.Chrome,212,1738894564,1738894776,1738894776.779757,-21600,,
com.microsoft.VSCode,7,1738894557,1738894564,1738894564.583137,-21600,,
com.google.Chrome,1,1738894556,1738894557,1738894557.295147,-21600,,
com.microsoft.VSCode,65,1738894491,1738894556,1738894556.629918,-21600,,
com.google.Chrome,8,1738894483,1738894491,1738894491.054747,-21600,,
com.microsoft.VSCode,515,1738893968,1738894483,1738894483.067762,-21600,,
com.google.Chrome,9,1738893959,1738893968,1738893968.900079,-21600,,
com.microsoft.VSCode,12,1738893947,1738893959,1738893959.852334,-21600,,
com.google.Chrome,1,1738893946,1738893947,1738893947.4084492,-21600,,
com.microsoft.VSCode,0,1738893946,1738893946,1738893946.6503282,-21600,,
com.google.Chrome,1,1738893945,1738893946,1738893946.328614,-21600,,
com.microsoft.VSCode,4,1738893941,1738893945,1738893945.8925261,-21600,,
com.google.Chrome,3,1738893938,1738893941,1738893941.974629,-21600,,
com.microsoft.VSCode,92,1738893846,1738893938,1738893938.755079,-21600,,
com.google.Chrome,1,1738893845,1738893846,1738893846.1749902,-21600,,
com.microsoft.VSCode,10,1738893835,1738893845,1738893845.2415261,-21600,,
com.google.Chrome,3,1738893832,1738893835,1738893835.722526,-21600,,
com.microsoft.VSCode,101,1738893731,1738893832,1738893832.196681,-21600,,
com.google.Chrome,0,1738893731,1738893731,1738893731.974073,-21600,,
com.microsoft.VSCode,1,1738893730,1738893731,1738893731.440332,-21600,,
com.google.Chrome,70,1738893660,1738893730,1738893731.01209,-21600,,
com.microsoft.VSCode,27,1738893633,1738893660,1738893660.9989629,-21600,,
com.google.Chrome,19,1738893614,1738893633,1738893633.547817,-21600,,
com.microsoft.VSCode,196,1738893418,1738893614,1738893614.472816,-21600,,
com.leomehlig.today,106,1738893312,1738893418,1738893418.685264,-21600,,
com.hammerandchisel.discord,27,1738893263,1738893290,1738893290.5408258,-21600,EB445137-D7F5-57EC-87DA-1DB460D64046,"iPhone13,2"
com.microsoft.VSCode,116,1738893196,1738893312,1738893312.2766871,-21600,,
com.google.Chrome,11,1738893185,1738893196,1738893196.565614,-21600,,
com.microsoft.VSCode,744,1738892441,1738893185,1738893185.172801,-21600,,
com.google.Chrome,3,1738892438,1738892441,1738892441.481441,-21600,,
com.microsoft.VSCode,1,1738892437,1738892438,1738892438.698258,-21600,,
com.google.Chrome,13,1738892424,1738892437,1738892438.0680141,-21600,,
com.microsoft.VSCode,170,1738892254,1738892424,1738892424.5653949,-21600,,
com.google.Chrome,24,1738892230,1738892254,1738892254.276763,-21600,,
com.microsoft.VSCode,33,1738892197,1738892230,1738892230.207474,-21600,,
com.google.Chrome,4,1738892193,1738892197,1738892197.719847,-21600,,
com.microsoft.VSCode,9,1738892184,1738892193,1738892193.899257,-21600,,
com.google.Chrome,6,1738892178,1738892184,1738892184.227223,-21600,,
com.microsoft.VSCode,7,1738892171,1738892178,1738892178.2574801,-21600,,
com.google.Chrome,1,1738892170,1738892171,1738892171.0408878,-21600,,
com.microsoft.VSCode,2,1738892168,1738892170,1738892170.064884,-21600,,
com.google.Chrome,2,1738892166,1738892168,1738892168.785305,-21600,,
com.microsoft.VSCode,7,1738892159,1738892166,1738892166.4427562,-21600,,
com.google.Chrome,2,1738892157,1738892159,1738892159.939759,-21600,,
com.microsoft.VSCode,26,1738892131,1738892157,1738892157.611368,-21600,,
com.google.Chrome,3,1738892128,1738892131,1738892131.385638,-21600,,
com.microsoft.VSCode,46,1738892082,1738892128,1738892128.678484,-21600,,
com.google.Chrome,5,1738892077,1738892082,1738892082.6946058,-21600,,
com.microsoft.VSCode,23,1738892054,1738892077,1738892077.761393,-21600,,
com.google.Chrome,5,1738892049,1738892054,1738892054.894892,-21600,,
com.microsoft.VSCode,3,1738892046,1738892049,1738892049.4041672,-21600,,
com.google.Chrome,30,1738892016,1738892046,1738892046.106989,-21600,,
com.microsoft.VSCode,35,1738891981,1738892016,1738892016.458455,-21600,,
com.google.Chrome,20,1738891961,1738891981,1738891981.3245869,-21600,,
com.microsoft.VSCode,39,1738891922,1738891961,1738891961.253892,-21600,,
com.google.Chrome,4,1738891918,1738891922,1738891922.111333,-21600,,
com.microsoft.VSCode,54,1738891864,1738891918,1738891918.375675,-21600,,
com.google.Chrome,3,1738891861,1738891864,1738891864.933982,-21600,,
com.microsoft.VSCode,2,1738891859,1738891861,1738891861.512151,-21600,,
com.google.Chrome,17,1738891842,1738891859,1738891859.9626532,-21600,,
com.microsoft.VSCode,60,1738891782,1738891842,1738891842.673668,-21600,,
com.google.Chrome,2,1738891780,1738891782,1738891782.873225,-21600,,
com.microsoft.VSCode,28,1738891752,1738891780,1738891780.3405252,-21600,,
com.google.Chrome,16,1738891736,1738891752,1738891752.3438702,-21600,,
com.microsoft.VSCode,18,1738891718,1738891736,1738891736.0617309,-21600,,
com.leomehlig.today,1,1738891717,1738891718,1738891718.887076,-21600,,
com.google.Chrome,38,1738891679,1738891717,1738891717.7681332,-21600,,
com.leomehlig.today,2,1738891677,1738891679,1738891679.44156,-21600,,
com.google.Chrome,48,1738891629,1738891677,1738891677.586214,-21600,,
com.microsoft.VSCode,11,1738891618,1738891629,1738891629.751206,-21600,,
com.google.Chrome,13,1738891605,1738891618,1738891618.121053,-21600,,
com.microsoft.VSCode,230,1738891375,1738891605,1738891605.858623,-21600,,
com.google.Chrome,1,1738891374,1738891375,1738891375.369544,-21600,,
com.microsoft.VSCode,4,1738891370,1738891374,1738891374.853788,-21600,,
com.google.Chrome,0,1738891370,1738891370,1738891370.7981539,-21600,,
com.microsoft.VSCode,4,1738891366,1738891370,1738891370.057282,-21600,,
com.google.Chrome,1,1738891365,1738891366,1738891366.6952991,-21600,,
com.microsoft.VSCode,131,1738891234,1738891365,1738891365.915958,-21600,,
com.google.Chrome,19,1738891215,1738891234,1738891234.663957,-21600,,
com.microsoft.VSCode,72,1738891143,1738891215,1738891215.849592,-21600,,
com.google.Chrome,2,1738891141,1738891143,1738891143.164885,-21600,,
com.apple.finder,1,1738891140,1738891141,1738891141.510247,-21600,,
com.microsoft.VSCode,70,1738891070,1738891140,1738891140.614017,-21600,,
com.apple.finder,1,1738891069,1738891070,1738891070.763226,-21600,,
com.google.Chrome,1,1738891068,1738891069,1738891069.961818,-21600,,
com.apple.finder,1,1738891067,1738891068,1738891068.49641,-21600,,
com.microsoft.VSCode,6,1738891061,1738891067,1738891067.600637,-21600,,
com.apple.finder,6,1738891055,1738891061,1738891061.282228,-21600,,
com.microsoft.VSCode,5,1738891050,1738891055,1738891055.919287,-21600,,
com.apple.finder,21,1738891029,1738891050,1738891050.0785332,-21600,,
com.microsoft.VSCode,24,1738891005,1738891029,1738891029.213345,-21600,,
com.google.Chrome,108,1738890897,1738891005,1738891005.803199,-21600,,
com.microsoft.VSCode,37,1738890860,1738890897,1738890897.719421,-21600,,
com.google.Chrome,17,1738890843,1738890860,1738890860.992382,-21600,,
com.microsoft.VSCode,0,1738890843,1738890843,1738890843.870521,-21600,,
com.google.Chrome,37,1738890806,1738890843,1738890843.259155,-21600,,
com.microsoft.VSCode,107,1738890699,1738890806,1738890806.332718,-21600,,
com.google.Chrome,4,1738890695,1738890699,1738890699.2319632,-21600,,
com.microsoft.VSCode,20,1738890675,1738890695,1738890695.63814,-21600,,
com.google.Chrome,6,1738890669,1738890675,1738890675.075603,-21600,,
com.microsoft.VSCode,19,1738890650,1738890669,1738890669.5993562,-21600,,
com.google.Chrome,7,1738890643,1738890650,1738890650.284466,-21600,,
com.microsoft.VSCode,87,1738890556,1738890643,1738890643.4491482,-21600,,
com.google.Chrome,1,1738890555,1738890556,1738890556.548851,-21600,,
com.microsoft.VSCode,1,1738890554,1738890555,1738890555.161475,-21600,,
com.google.Chrome,2,1738890552,1738890554,1738890554.653026,-21600,,
com.microsoft.VSCode,46,1738890506,1738890552,1738890552.234205,-21600,,
com.google.Chrome,53,1738890453,1738890506,1738890506.5218291,-21600,,
com.microsoft.VSCode,5,1738890448,1738890453,1738890453.2895021,-21600,,
com.google.Chrome,11,1738890437,1738890448,1738890448.111459,-21600,,
com.microsoft.VSCode,1,1738890436,1738890437,1738890437.080811,-21600,,
com.google.Chrome,2,1738890434,1738890436,1738890436.442926,-21600,,
com.microsoft.VSCode,0,1738890434,1738890434,1738890434.789252,-21600,,
com.google.Chrome,2,1738890432,1738890434,1738890434.212929,-21600,,
com.microsoft.VSCode,1,1738890431,1738890432,1738890432.386852,-21600,,
com.google.Chrome,3,1738890428,1738890431,1738890431.6974149,-21600,,
com.microsoft.VSCode,0,1738890428,1738890428,1738890428.995873,-21600,,
com.google.Chrome,2,1738890426,1738890428,1738890428.375756,-21600,,
com.microsoft.VSCode,1,1738890425,1738890426,1738890426.554008,-21600,,
com.google.Chrome,1,1738890424,1738890425,1738890425.965445,-21600,,
com.microsoft.VSCode,1,1738890418,1738890419,1738890419.052823,-21600,,
com.google.Chrome,3,1738890415,1738890418,1738890418.452777,-21600,,
com.microsoft.VSCode,0,1738890415,1738890415,1738890416.061997,-21600,,
com.google.Chrome,2,1738890413,1738890415,1738890415.374598,-21600,,
com.microsoft.VSCode,1,1738890412,1738890413,1738890413.195832,-21600,,
com.google.Chrome,1,1738890411,1738890412,1738890412.6439881,-21600,,
com.microsoft.VSCode,1,1738890410,1738890411,1738890411.034133,-21600,,
com.google.Chrome,2,1738890408,1738890410,1738890410.4058762,-21600,,
com.microsoft.VSCode,1,1738890407,1738890408,1738890408.3625832,-21600,,
com.google.Chrome,1,1738890406,1738890407,1738890407.663249,-21600,,
com.microsoft.VSCode,3,1738890403,1738890406,1738890406.9779248,-21600,,
com.google.Chrome,2,1738890401,1738890403,1738890403.877458,-21600,,
com.microsoft.VSCode,3,1738890398,1738890401,1738890401.214854,-21600,,
com.google.Chrome,1,1738890397,1738890398,1738890398.965482,-21600,,
com.microsoft.VSCode,2,1738890395,1738890397,1738890397.312739,-21600,,
com.google.Chrome,2,1738890393,1738890395,1738890395.511557,-21600,,
com.microsoft.VSCode,2,1738890391,1738890393,1738890393.846477,-21600,,
com.google.Chrome,2,1738890389,1738890391,1738890391.737747,-21600,,
com.microsoft.VSCode,2,1738890387,1738890389,1738890389.67732,-21600,,
com.google.Chrome,3,1738890384,1738890387,1738890387.750465,-21600,,
com.microsoft.VSCode,2,1738890382,1738890384,1738890385.0148292,-21600,,
com.google.Chrome,2,1738890380,1738890382,1738890382.68981,-21600,,
com.microsoft.VSCode,4,1738890376,1738890380,1738890380.1044102,-21600,,
com.google.Chrome,2,1738890374,1738890376,1738890376.1169171,-21600,,
com.microsoft.VSCode,1,1738890373,1738890374,1738890374.836072,-21600,,
com.google.Chrome,2,1738890371,1738890373,1738890373.0957,-21600,,
com.microsoft.VSCode,2,1738890369,1738890371,1738890371.547782,-21600,,
com.google.Chrome,2,1738890367,1738890369,1738890369.5200129,-21600,,
com.microsoft.VSCode,2,1738890365,1738890367,1738890367.9724178,-21600,,
com.google.Chrome,1,1738890364,1738890365,1738890365.87237,-21600,,
com.microsoft.VSCode,2,1738890362,1738890364,1738890364.539783,-21600,,
com.google.Chrome,1,1738890361,1738890362,1738890362.665704,-21600,,
com.microsoft.VSCode,3,1738890358,1738890361,1738890361.43893,-21600,,
com.google.Chrome,1,1738890357,1738890358,1738890358.987722,-21600,,
com.microsoft.VSCode,5,1738890352,1738890357,1738890357.298732,-21600,,
com.google.Chrome,1,1738890351,1738890352,1738890352.77523,-21600,,
com.microsoft.VSCode,4,1738890347,1738890351,1738890351.052217,-21600,,
com.google.Chrome,1,1738890346,1738890347,1738890347.250802,-21600,,
com.microsoft.VSCode,1,1738890345,1738890346,1738890346.5884008,-21600,,
com.google.Chrome,5,1738890340,1738890345,1738890345.262963,-21600,,
com.microsoft.VSCode,2,1738890338,1738890340,1738890340.3451061,-21600,,
com.google.Chrome,11,1738890327,1738890338,1738890339.0058122,-21600,,
com.microsoft.VSCode,1,1738890326,1738890327,1738890327.163748,-21600,,
com.google.Chrome,2,1738890324,1738890326,1738890326.078567,-21600,,
com.microsoft.VSCode,1,1738890323,1738890324,1738890324.775039,-21600,,
com.google.Chrome,1,1738890322,1738890323,1738890323.625148,-21600,,
com.microsoft.VSCode,2,1738890320,1738890322,1738890322.48739,-21600,,
com.google.Chrome,1,1738890319,1738890320,1738890320.79923,-21600,,
com.microsoft.VSCode,1,1738890318,1738890319,1738890319.594143,-21600,,
com.google.Chrome,1,1738890317,1738890318,1738890318.491895,-21600,,
com.microsoft.VSCode,1,1738890316,1738890317,1738890317.4432158,-21600,,
com.google.Chrome,1,1738890315,1738890316,1738890316.3078098,-21600,,
com.microsoft.VSCode,2,1738890313,1738890315,1738890315.21153,-21600,,
com.google.Chrome,2,1738890311,1738890313,1738890313.6549249,-21600,,
com.microsoft.VSCode,0,1738890311,1738890311,1738890311.997365,-21600,,
com.google.Chrome,3,1738890308,1738890311,1738890311.290731,-21600,,
com.microsoft.VSCode,3,1738890305,1738890308,1738890308.686955,-21600,,
com.google.Chrome,4,1738890301,1738890305,1738890305.412736,-21600,,
com.microsoft.VSCode,1,1738890300,1738890301,1738890301.810699,-21600,,
com.google.Chrome,2,1738890298,1738890300,1738890300.36011,-21600,,
com.microsoft.VSCode,1,1738890297,1738890298,1738890298.771522,-21600,,
com.google.Chrome,2,1738890295,1738890297,1738890297.593873,-21600,,
com.microsoft.VSCode,1,1738890294,1738890295,1738890295.657557,-21600,,
com.google.Chrome,2,1738890292,1738890294,1738890294.21985,-21600,,
com.microsoft.VSCode,1,1738890291,1738890292,1738890292.449084,-21600,,
com.google.Chrome,3,1738890288,1738890291,1738890291.733218,-21600,,
com.microsoft.VSCode,1,1738890287,1738890288,1738890288.235591,-21600,,
com.google.Chrome,4,1738890283,1738890287,1738890287.461313,-21600,,
com.microsoft.VSCode,1,1738890282,1738890283,1738890283.694117,-21600,,
com.google.Chrome,1,1738890281,1738890282,1738890282.9367409,-21600,,
com.microsoft.VSCode,1,1738890280,1738890281,1738890281.65701,-21600,,
com.google.Chrome,10,1738890270,1738890280,1738890280.6825042,-21600,,
com.microsoft.VSCode,3,1738890267,1738890270,1738890270.720901,-21600,,
com.google.Chrome,22,1738890245,1738890267,1738890267.87748,-21600,,
com.microsoft.VSCode,2,1738890243,1738890245,1738890245.127942,-21600,,
com.google.Chrome,2,1738890241,1738890243,1738890243.339141,-21600,,
com.microsoft.VSCode,76,1738890165,1738890241,1738890241.89224,-21600,,
com.google.Chrome,1,1738890164,1738890165,1738890165.920284,-21600,,
com.microsoft.VSCode,4,1738890160,1738890164,1738890164.869317,-21600,,
com.google.Chrome,1,1738890159,1738890160,1738890160.619977,-21600,,
com.microsoft.VSCode,1,1738890158,1738890159,1738890159.4158769,-21600,,
com.google.Chrome,4,1738890154,1738890158,1738890158.2179961,-21600,,
com.microsoft.VSCode,8,1738890146,1738890154,1738890154.98806,-21600,,
com.google.Chrome,17,1738890129,1738890146,1738890146.8595738,-21600,,
com.microsoft.VSCode,2,1738890127,1738890129,1738890129.3548589,-21600,,
com.google.Chrome,2,1738890125,1738890127,1738890127.872882,-21600,,
com.microsoft.VSCode,0,1738890125,1738890125,1738890125.960583,-21600,,
com.google.Chrome,4,1738890121,1738890125,1738890125.075543,-21600,,
com.microsoft.VSCode,25,1738890096,1738890121,1738890121.932197,-21600,,
com.google.Chrome,2,1738890094,1738890096,1738890096.074678,-21600,,
com.leomehlig.today,0,1738890094,1738890094,1738890095.013799,-21600,,
com.google.Chrome,3,1738890091,1738890094,1738890094.770811,-21600,,
com.leomehlig.today,0,1738890091,1738890091,1738890091.9314651,-21600,,
com.microsoft.VSCode,7,1738890084,1738890091,1738890091.118382,-21600,,
com.leomehlig.today,2,1738890082,1738890084,1738890084.151905,-21600,,
com.google.Chrome,23,1738890059,1738890082,1738890082.627215,-21600,,
com.leomehlig.today,1,1738890058,1738890059,1738890059.32234,-21600,,
com.microsoft.VSCode,20,1738890038,1738890058,1738890058.3342881,-21600,,
com.leomehlig.today,18,1738890020,1738890038,1738890038.462106,-21600,,
com.microsoft.VSCode,1,1738890019,1738890020,1738890020.7399158,-21600,,
com.google.Chrome,90,1738889929,1738890019,1738890019.519223,-21600,,
com.microsoft.VSCode,1,1738889928,1738889929,1738889929.386028,-21600,,
com.google.Chrome,4,1738889924,1738889928,1738889928.319592,-21600,,
com.microsoft.VSCode,1,1738889923,1738889924,1738889924.128469,-21600,,
com.hammerandchisel.discord,11,1738889697,1738889708,1738889709.0642571,-21600,EB445137-D7F5-57EC-87DA-1DB460D64046,"iPhone13,2"
com.google.Chrome,278,1738889645,1738889923,1738889923.72592,-21600,,
com.microsoft.VSCode,2,1738889643,1738889645,1738889645.739283,-21600,,
com.google.Chrome,2,1738889641,1738889643,1738889643.317332,-21600,,
com.microsoft.VSCode,2,1738889639,1738889641,1738889641.270568,-21600,,
com.google.Chrome,3,1738889636,1738889639,1738889639.648062,-21600,,
com.microsoft.VSCode,2,1738889634,1738889636,1738889636.379086,-21600,,
com.google.Chrome,3,1738889631,1738889634,1738889634.697363,-21600,,
com.microsoft.VSCode,2,1738889629,1738889631,1738889631.643359,-21600,,
com.google.Chrome,1,1738889628,1738889629,1738889629.966765,-21600,,
com.microsoft.VSCode,3,1738889625,1738889628,1738889628.379673,-21600,,
com.google.Chrome,6,1738889619,1738889625,1738889625.7653441,-21600,,
com.microsoft.VSCode,7,1738889612,1738889619,1738889619.759482,-21600,,
com.google.Chrome,1,1738889611,1738889612,1738889612.5507941,-21600,,
com.microsoft.VSCode,2,1738889609,1738889611,1738889611.804184,-21600,,
com.google.Chrome,2,1738889607,1738889609,1738889609.0788999,-21600,,
com.microsoft.VSCode,2,1738889605,1738889607,1738889607.8167272,-21600,,
com.google.Chrome,3,1738889602,1738889605,1738889605.517209,-21600,,
com.microsoft.VSCode,11,1738889591,1738889602,1738889602.839227,-21600,,
com.google.Chrome,2,1738889589,1738889591,1738889591.764085,-21600,,
com.microsoft.VSCode,8,1738889581,1738889589,1738889589.5632439,-21600,,
com.google.Chrome,1,1738889580,1738889581,1738889581.6071901,-21600,,
com.microsoft.VSCode,3,1738889577,1738889580,1738889580.270753,-21600,,
com.google.Chrome,2,1738889575,1738889577,1738889577.0784721,-21600,,
com.microsoft.VSCode,5,1738889570,1738889575,1738889575.749896,-21600,,
com.google.Chrome,2,1738889568,1738889570,1738889570.469325,-21600,,
com.microsoft.VSCode,3,1738889565,1738889568,1738889568.815388,-21600,,
com.google.Chrome,0,1738889565,1738889565,1738889566.00278,-21600,,
com.microsoft.VSCode,6,1738889559,1738889565,1738889565.3409739,-21600,,
com.google.Chrome,1,1738889558,1738889559,1738889559.272198,-21600,,
com.microsoft.VSCode,5,1738889553,1738889558,1738889558.1743069,-21600,,
com.google.Chrome,1,1738889552,1738889553,1738889553.548255,-21600,,
com.microsoft.VSCode,6,1738889546,1738889552,1738889552.6330109,-21600,,
com.google.Chrome,0,1738889546,1738889546,1738889546.769723,-21600,,
com.microsoft.VSCode,4,1738889542,1738889546,1738889546.110488,-21600,,
com.google.Chrome,1,1738889541,1738889542,1738889542.864172,-21600,,
com.microsoft.VSCode,1,1738889540,1738889541,1738889542.068985,-21600,,
com.google.Chrome,7,1738889533,1738889540,1738889540.948139,-21600,,
com.microsoft.VSCode,2,1738889531,1738889533,1738889533.486154,-21600,,
com.google.Chrome,2,1738889529,1738889531,1738889531.126748,-21600,,
com.microsoft.VSCode,6,1738889523,1738889529,1738889529.503402,-21600,,
com.google.Chrome,2,1738889521,1738889523,1738889523.119464,-21600,,
com.microsoft.VSCode,5,1738889516,1738889521,1738889521.5066972,-21600,,
com.google.Chrome,5,1738889511,1738889516,1738889516.9913359,-21600,,
com.microsoft.VSCode,8,1738889503,1738889511,1738889511.1921868,-21600,,
com.google.Chrome,1,1738889502,1738889503,1738889503.950361,-21600,,
com.microsoft.VSCode,11,1738889491,1738889502,1738889502.347079,-21600,,
com.google.Chrome,1,1738889490,1738889491,1738889491.504664,-21600,,
com.microsoft.VSCode,3,1738889487,1738889490,1738889490.501161,-21600,,
com.google.Chrome,1,1738889486,1738889487,1738889487.857563,-21600,,
com.microsoft.VSCode,10,1738889476,1738889486,1738889486.998256,-21600,,
com.google.Chrome,2,1738889474,1738889476,1738889477.023967,-21600,,
com.microsoft.VSCode,3,1738889471,1738889474,1738889474.5463061,-21600,,
com.google.Chrome,1,1738889470,1738889471,1738889471.95819,-21600,,
com.microsoft.VSCode,3,1738889467,1738889470,1738889470.645608,-21600,,
com.google.Chrome,5,1738889462,1738889467,1738889467.945105,-21600,,
com.microsoft.VSCode,20,1738889442,1738889462,1738889462.4428658,-21600,,
com.google.Chrome,0,1738889442,1738889442,1738889442.743967,-21600,,
com.microsoft.VSCode,1,1738889441,1738889442,1738889442.245259,-21600,,
com.google.Chrome,3,1738889438,1738889441,1738889441.634655,-21600,,
com.microsoft.VSCode,4,1738889434,1738889438,1738889438.7286382,-21600,,
com.google.Chrome,1,1738889433,1738889434,1738889434.7550058,-21600,,
com.microsoft.VSCode,4,1738889429,1738889433,1738889433.800123,-21600,,
com.google.Chrome,3,1738889426,1738889429,1738889429.56271,-21600,,
com.microsoft.VSCode,6,1738889420,1738889426,1738889426.7761521,-21600,,
com.google.Chrome,1,1738889419,1738889420,1738889420.693163,-21600,,
com.microsoft.VSCode,20,1738889399,1738889419,1738889419.3627748,-21600,,
com.google.Chrome,1,1738889398,1738889399,1738889399.237834,-21600,,
com.microsoft.VSCode,63,1738889335,1738889398,1738889398.276047,-21600,,
com.google.Chrome,2,1738889333,1738889335,1738889335.109534,-21600,,
com.microsoft.VSCode,10,1738889323,1738889333,1738889333.654125,-21600,,
com.google.Chrome,1,1738889322,1738889323,1738889323.373568,-21600,,
com.microsoft.VSCode,1,1738889321,1738889322,1738889322.2483711,-21600,,
com.google.Chrome,2,1738889319,1738889321,1738889321.831497,-21600,,
com.microsoft.VSCode,3,1738889316,1738889319,1738889319.448811,-21600,,
com.google.Chrome,1,1738889315,1738889316,1738889316.1627479,-21600,,
com.microsoft.VSCode,11,1738889304,1738889315,1738889315.2702851,-21600,,
com.google.Chrome,13,1738889291,1738889304,1738889304.0353541,-21600,,
com.microsoft.VSCode,21,1738889270,1738889291,1738889291.8596048,-21600,,
com.google.Chrome,2,1738889268,1738889270,1738889270.576947,-21600,,
com.microsoft.VSCode,8,1738889260,1738889268,1738889268.447293,-21600,,
com.google.Chrome,2,1738889258,1738889260,1738889260.860443,-21600,,
com.microsoft.VSCode,8,1738889250,1738889258,1738889258.117354,-21600,,
com.google.Chrome,14,1738889236,1738889250,1738889250.507029,-21600,,
com.microsoft.VSCode,29,1738889207,1738889236,1738889236.132808,-21600,,
com.google.Chrome,57,1738889150,1738889207,1738889207.697303,-21600,,
com.leomehlig.today,164,1738888986,1738889150,1738889150.92696,-21600,,
com.google.Chrome,200,1738888786,1738888986,1738888986.33589,-21600,,
com.hammerandchisel.discord,10,1738888107,1738888117,1738888117.675987,-21600,EB445137-D7F5-57EC-87DA-1DB460D64046,"iPhone13,2"
com.hammerandchisel.discord,5,1738887930,1738887935,1738887935.2318358,-21600,EB445137-D7F5-57EC-87DA-1DB460D64046,"iPhone13,2"
com.google.Chrome,906,1738887732,1738888638,1738888638.5317369,-21600,,
com.leomehlig.today,4,1738887728,1738887732,1738887732.238028,-21600,,
com.hammerandchisel.discord,8,1738887695,1738887703,1738887703.522367,-21600,EB445137-D7F5-57EC-87DA-1DB460D64046,"iPhone13,2"
com.google.Chrome,61,1738887667,1738887728,1738887728.9145079,-21600,,
com.hammerandchisel.discord,5,1738887465,1738887470,1738887470.806522,-21600,EB445137-D7F5-57EC-87DA-1DB460D64046,"iPhone13,2"
com.microsoft.Outlook,17,1738887411,1738887428,1738887428.143842,-21600,,
com.hnc.Discord,7,1738887404,1738887411,1738887411.728451,-21600,,
com.google.Chrome,6,1738887398,1738887404,1738887404.653481,-21600,,
com.hnc.Discord,27,1738887371,1738887398,1738887398.7459888,-21600,,
com.google.Chrome,9,1738887362,1738887371,1738887371.568682,-21600,,
com.hnc.Discord,22,1738887340,1738887362,1738887362.990394,-21600,,
com.google.Chrome,2,1738887338,1738887340,1738887340.727289,-21600,,
com.hnc.Discord,14,1738887324,1738887338,1738887338.878855,-21600,,
com.google.Chrome,67,1738887257,1738887324,1738887324.817123,-21600,,
com.hnc.Discord,39,1738887218,1738887257,1738887257.275732,-21600,,
com.google.Chrome,8,1738887210,1738887218,1738887218.7298012,-21600,,
com.hnc.Discord,6,1738887204,1738887210,1738887210.654067,-21600,,
com.google.Chrome,27,1738887177,1738887204,1738887204.913938,-21600,,
com.microsoft.Outlook,37,1738887140,1738887177,1738887178.1361918,-21600,,
com.google.Chrome,6,1738887134,1738887140,1738887140.761043,-21600,,
com.groupme.iphone-app,10,1738886548,1738886558,1738886558.477973,-21600,EB445137-D7F5-57EC-87DA-1DB460D64046,"iPhone13,2"
com.hammerandchisel.discord,27,1738886515,1738886542,1738886542.169663,-21600,EB445137-D7F5-57EC-87DA-1DB460D64046,"iPhone13,2"
com.apple.weather,0,1738886515,1738886515,1738886516.600225,-21600,EB445137-D7F5-57EC-87DA-1DB460D64046,"iPhone13,2"
com.apple.weather,40,1738885550,1738885590,1738885590.763074,-21600,EB445137-D7F5-57EC-87DA-1DB460D64046,"iPhone13,2"
com.myfitnesspal.mfp,43,1738885505,1738885548,1738885548.1409879,-21600,EB445137-D7F5-57EC-87DA-1DB460D64046,"iPhone13,2"
com.google.Chrome,333,1738885142,1738885475,1738885475.75422,-21600,,
com.apple.Health,9,1738885072,1738885081,1738885081.2274861,-21600,EB445137-D7F5-57EC-87DA-1DB460D64046,"iPhone13,2"
com.apple.Health,90,1738884832,1738884922,1738884922.687927,-21600,EB445137-D7F5-57EC-87DA-1DB460D64046,"iPhone13,2"
com.myfitnesspal.mfp,66,1738884766,1738884832,1738884832.69431,-21600,EB445137-D7F5-57EC-87DA-1DB460D64046,"iPhone13,2"
com.apple.news,50,1738884681,1738884731,1738884731.9100962,-21600,EB445137-D7F5-57EC-87DA-1DB460D64046,"iPhone13,2"
com.burbn.instagram,21,1738884596,1738884617,1738884617.236116,-21600,EB445137-D7F5-57EC-87DA-1DB460D64046,"iPhone13,2"
com.google.Chrome,533,1738884326,1738884859,1738884859.3514519,-21600,,
com.leomehlig.today,4,1738884322,1738884326,1738884326.470131,-21600,,
com.google.Chrome,2,1738884320,1738884322,1738884322.22616,-21600,,
com.leomehlig.today,60,1738884260,1738884320,1738884320.1525621,-21600,,
com.google.Chrome,5,1738884255,1738884260,1738884260.228847,-21600,,
com.leomehlig.today,1,1738884254,1738884255,1738884255.5595279,-21600,,
com.google.Chrome,4,1738884250,1738884254,1738884254.2751908,-21600,,
com.leomehlig.today,21,1738884229,1738884250,1738884250.273195,-21600,,
com.google.Chrome,3,1738884226,1738884229,1738884230.004781,-21600,,
com.apple.FaceTime,0,1738884226,1738884226,1738884226.939486,-21600,,
com.google.Chrome,178,1738884048,1738884226,1738884226.3645082,-21600,,
com.burbn.instagram,148,1738884001,1738884149,1738884149.5103521,-21600,EB445137-D7F5-57EC-87DA-1DB460D64046,"iPhone13,2"
com.microsoft.Office.Outlook,8,1738883281,1738883289,1738883289.4167309,-21600,EB445137-D7F5-57EC-87DA-1DB460D64046,"iPhone13,2"
com.google.Chrome,969,1738882120,1738883089,1738883089.3247728,-21600,,
com.leomehlig.today,18,1738882102,1738882120,1738882120.1531649,-21600,,
com.google.Chrome,86,1738882016,1738882102,1738882102.3558621,-21600,,
com.leomehlig.today,14,1738882002,1738882016,1738882016.9376721,-21600,,
com.apple.iCal,13,1738881989,1738882002,1738882002.8336391,-21600,,
com.leomehlig.today,1,1738881988,1738881989,1738881989.6506228,-21600,,
com.microsoft.Outlook,1,1738881987,1738881988,1738881988.145082,-21600,,
com.google.Chrome,6,1738881981,1738881987,1738881987.181686,-21600,,
com.leomehlig.today,18,1738881262,1738881280,1738881280.4759068,-21600,EB445137-D7F5-57EC-87DA-1DB460D64046,"iPhone13,2"
com.toyopagroup.picaboo,22,1738881214,1738881236,1738881236.8680859,-21600,EB445137-D7F5-57EC-87DA-1DB460D64046,"iPhone13,2"
com.google.Chrome,1791,1738879189,1738880980,1738880980.911025,-21600,,
com.leomehlig.today,3,1738879186,1738879189,1738879189.707556,-21600,,
com.google.Chrome,302,1738878884,1738879186,1738879186.189862,-21600,,
com.leomehlig.today,2,1738878882,1738878884,1738878884.4289289,-21600,,
com.tinyspeck.chatlyio,27,1738878839,1738878866,1738878866.746807,-21600,EB445137-D7F5-57EC-87DA-1DB460D64046,"iPhone13,2"
com.google.chrome.ios,26,1738878813,1738878839,1738878839.486395,-21600,EB445137-D7F5-57EC-87DA-1DB460D64046,"iPhone13,2"
com.tinyspeck.chatlyio,11,1738878802,1738878813,1738878813.993915,-21600,EB445137-D7F5-57EC-87DA-1DB460D64046,"iPhone13,2"
com.apple.news,0,1738878802,1738878802,1738878803.1165462,-21600,EB445137-D7F5-57EC-87DA-1DB460D64046,"iPhone13,2"
com.leomehlig.today,49,1738878539,1738878588,1738878588.8404942,-21600,,
com.google.Chrome,105,1738878434,1738878539,1738878539.879897,-21600,,
com.leomehlig.today,26,1738878408,1738878434,1738878434.157901,-21600,,
com.google.Chrome,1086,1738877322,1738878408,1738878408.4510689,-21600,,
com.apple.finder,20,1738877302,1738877322,1738877322.477412,-21600,,
com.google.Chrome,665,1738876637,1738877302,1738877302.703928,-21600,,
com.microsoft.Outlook,11,1738876626,1738876637,1738876638.168824,-21600,,
com.google.Chrome,15,1738876611,1738876626,1738876627.0088959,-21600,,
com.leomehlig.today,5,1738876606,1738876611,1738876611.323725,-21600,,
com.apple.finder,4,1738876602,1738876606,1738876606.349131,-21600,,
com.google.Chrome,3,1738876599,1738876602,1738876602.401468,-21600,,
com.apple.iCal,12,1738876587,1738876599,1738876599.08358,-21600,,
com.google.Chrome,4,1738876583,1738876587,1738876587.286117,-21600,,
com.apple.news,33,1738875656,1738875689,1738875690.120541,-21600,EB445137-D7F5-57EC-87DA-1DB460D64046,"iPhone13,2"
com.intsig.CamScannerLite,2,1738875649,1738875651,1738875651.586535,-21600,EB445137-D7F5-57EC-87DA-1DB460D64046,"iPhone13,2"
com.google.Chrome,544,1738875623,1738876167,1738876168.0532842,-21600,,
com.apple.finder,23,1738875600,1738875623,1738875623.07921,-21600,,
com.intsig.CamScannerLite,45,1738875557,1738875602,1738875603.166281,-21600,EB445137-D7F5-57EC-87DA-1DB460D64046,"iPhone13,2"
com.google.Chrome,1145,1738874455,1738875600,1738875600.591613,-21600,,
com.google.Chrome,596,1738872005,1738872601,1738872601.960983,-21600,,
com.apple.finder,2,1738871988,1738871990,1738871991.208925,-21600,,
com.leomehlig.today,2,1738871986,1738871988,1738871988.808113,-21600,,
com.microsoft.Office.Outlook,15,1738871050,1738871065,1738871065.292346,-21600,EB445137-D7F5-57EC-87DA-1DB460D64046,"iPhone13,2"
com.microsoft.Office.Outlook,45,1738870905,1738870950,1738870950.885717,-21600,EB445137-D7F5-57EC-87DA-1DB460D64046,"iPhone13,2"
com.apple.weather,3,1738870900,1738870903,1738870903.7968059,-21600,EB445137-D7F5-57EC-87DA-1DB460D64046,"iPhone13,2"
com.apple.weather,5,1738870566,1738870571,1738870571.187868,-21600,EB445137-D7F5-57EC-87DA-1DB460D64046,"iPhone13,2"
com.apple.Music,1,1738870565,1738870566,1738870566.734237,-21600,EB445137-D7F5-57EC-87DA-1DB460D64046,"iPhone13,2"
com.leomehlig.today,319,1738870064,1738870383,1738870383.572691,-21600,,
com.google.Chrome,4,1738870060,1738870064,1738870064.96526,-21600,,
com.apple.Music,10,1738868674,1738868684,1738868687.24318,-21600,EB445137-D7F5-57EC-87DA-1DB460D64046,"iPhone13,2"
com.apple.news,1,1738868673,1738868674,1738868675.320205,-21600,EB445137-D7F5-57EC-87DA-1DB460D64046,"iPhone13,2"
com.apple.news,173,1738867326,1738867499,1738867499.727899,-21600,EB445137-D7F5-57EC-87DA-1DB460D64046,"iPhone13,2"
com.apple.news,138,1738867134,1738867272,1738867272.954668,-21600,EB445137-D7F5-57EC-87DA-1DB460D64046,"iPhone13,2"
com.apple.news,52,1738867033,1738867085,1738867086.337296,-21600,EB445137-D7F5-57EC-87DA-1DB460D64046,"iPhone13,2"
com.apple.news,4,1738867020,1738867024,1738867024.52794,-21600,EB445137-D7F5-57EC-87DA-1DB460D64046,"iPhone13,2"
com.apple.news,1,1738867019,1738867020,1738867020.64888,-21600,EB445137-D7F5-57EC-87DA-1DB460D64046,"iPhone13,2"
com.google.Chrome,219,1738864786,1738865005,1738865005.626498,-21600,,
com.apple.news,486,1738864469,1738864955,1738864955.951879,-21600,EB445137-D7F5-57EC-87DA-1DB460D64046,"iPhone13,2"
com.myfitnesspal.mfp,6,1738864451,1738864457,1738864457.631706,-21600,EB445137-D7F5-57EC-87DA-1DB460D64046,"iPhone13,2"
com.google.Chrome,311,1738864290,1738864601,1738864601.157531,-21600,,
com.myfitnesspal.mfp,25,1738864040,1738864065,1738864065.867262,-21600,EB445137-D7F5-57EC-87DA-1DB460D64046,"iPhone13,2"
com.myfitnesspal.mfp,73,1738863954,1738864027,1738864027.444078,-21600,EB445137-D7F5-57EC-87DA-1DB460D64046,"iPhone13,2"
com.apple.weather,2,1738863952,1738863954,1738863954.2457151,-21600,EB445137-D7F5-57EC-87DA-1DB460D64046,"iPhone13,2"
com.google.Chrome,488,1738863672,1738864160,1738864160.258467,-21600,,
com.google.Chrome,576,1738862668,1738863244,1738863244.576127,-21600,,
com.leomehlig.today,2,1738862666,1738862668,1738862669.5047832,-21600,,
com.apple.weather,6,1738862613,1738862619,1738862619.128281,-21600,EB445137-D7F5-57EC-87DA-1DB460D64046,"iPhone13,2"
com.leomehlig.today,56,1738861947,1738862003,1738862003.768301,-21600,,
com.google.Chrome,83,1738861864,1738861947,1738861947.60671,-21600,,
com.apple.finder,4,1738861860,1738861864,1738861864.261252,-21600,,
com.intsig.CamScannerLite,178,1738861672,1738861850,1738861850.863847,-21600,EB445137-D7F5-57EC-87DA-1DB460D64046,"iPhone13,2"
com.google.Chrome,527,1738861333,1738861860,1738861860.67171,-21600,,
com.apple.finder,2,1738861331,1738861333,1738861333.236228,-21600,,
com.microsoft.Office.Outlook,5,1738861203,1738861208,1738861208.494701,-21600,EB445137-D7F5-57EC-87DA-1DB460D64046,"iPhone13,2"
com.toyopagroup.picaboo,26,1738861159,1738861185,1738861185.526568,-21600,EB445137-D7F5-57EC-87DA-1DB460D64046,"iPhone13,2"
com.intsig.CamScannerLite,1,1738861158,1738861159,1738861159.5939,-21600,EB445137-D7F5-57EC-87DA-1DB460D64046,"iPhone13,2"
com.google.Chrome,359,1738860972,1738861331,1738861332.033828,-21600,,
com.apple.finder,20,1738860952,1738860972,1738860973.031774,-21600,,
com.google.Chrome,1161,1738859791,1738860952,1738860952.92291,-21600,,
com.apple.finder,13,1738859778,1738859791,1738859791.837616,-21600,,
com.google.Chrome,842,1738858936,1738859778,1738859778.302908,-21600,,
com.apple.finder,50,1738858886,1738858936,1738858936.081996,-21600,,
com.google.Chrome,5,1738858881,1738858886,1738858886.7712998,-21600,,
com.apple.finder,49,1738858832,1738858881,1738858881.395087,-21600,,
com.google.Chrome,33,1738858799,1738858832,1738858832.0418491,-21600,,
com.apple.finder,2,1738858779,1738858781,1738858781.648709,-21600,,
com.leomehlig.today,1,1738858778,1738858779,1738858779.674516,-21600,,
com.google.Chrome,75,1738858703,1738858778,1738858778.96787,-21600,,
com.apple.finder,49,1738858640,1738858689,1738858690.873189,-21600,,
com.apple.Preview,3,1738858637,1738858640,1738858640.8892941,-21600,,
com.apple.finder,8,1738858629,1738858637,1738858637.6450071,-21600,,
com.apple.Preview,6,1738858623,1738858629,1738858629.075207,-21600,,
com.apple.finder,4,1738858619,1738858623,1738858623.444261,-21600,,
com.apple.Preview,15,1738858604,1738858619,1738858619.120051,-21600,,
com.apple.finder,1,1738858603,1738858604,1738858605.0123591,-21600,,
com.apple.Preview,15,1738858588,1738858603,1738858603.3812761,-21600,,
com.apple.finder,2,1738858586,1738858588,1738858588.478581,-21600,,
com.apple.Preview,20,1738858566,1738858586,1738858586.119077,-21600,,
com.apple.finder,2,1738858564,1738858566,1738858566.9642591,-21600,,
com.apple.Preview,2,1738858562,1738858564,1738858564.0837731,-21600,,
com.apple.finder,15,1738858547,1738858562,1738858563.004488,-21600,,
com.intsig.CamScannerLite,81,1738858522,1738858603,1738858604.0693989,-21600,EB445137-D7F5-57EC-87DA-1DB460D64046,"iPhone13,2"
com.microsoft.Word,78,1738858469,1738858547,1738858547.96375,-21600,,
com.apple.finder,13,1738858456,1738858469,1738858469.345279,-21600,,
com.microsoft.Word,42,1738858414,1738858456,1738858456.7842789,-21600,,
com.google.Chrome,639,1738857775,1738858414,1738858414.811218,-21600,,
com.apple.Preview,4,1738857771,1738857775,1738857775.857582,-21600,,
com.google.Chrome,4,1738857767,1738857771,1738857771.258224,-21600,,
com.microsoft.Word,3,1738857764,1738857767,1738857767.817168,-21600,,
com.apple.finder,29,1738857735,1738857764,1738857764.975686,-21600,,
com.apple.Preview,7,1738857728,1738857735,1738857735.411875,-21600,,
com.apple.finder,6,1738857722,1738857728,1738857728.742403,-21600,,
com.apple.Preview,3,1738857719,1738857722,1738857722.330395,-21600,,
com.google.Chrome,24,1738857695,1738857719,1738857719.125705,-21600,,
com.apple.Preview,1,1738857694,1738857695,1738857695.3194098,-21600,,
com.leomehlig.today,17,1738857677,1738857694,1738857694.2246032,-21600,,
com.google.Chrome,210,1738857467,1738857677,1738857677.269186,-21600,,
com.apple.finder,5,1738857462,1738857467,1738857467.792548,-21600,,
com.apple.Preview,4,1738857458,1738857462,1738857462.5776691,-21600,,
com.apple.finder,57,1738857401,1738857458,1738857458.838229,-21600,,
com.google.Chrome,1,1738857400,1738857401,1738857401.97926,-21600,,
com.microsoft.Word,3,1738857397,1738857400,1738857400.246999,-21600,,
com.leomehlig.today,0,1738857397,1738857397,1738857398.0243468,-21600,,
com.microsoft.Word,198,1738857199,1738857397,1738857397.5301619,-21600,,
com.microsoft.Word,443,1738856754,1738857197,1738857197.68717,-21600,,
com.apple.Preview,75,1738856679,1738856754,1738856754.570736,-21600,,
com.microsoft.Word,331,1738856348,1738856679,1738856679.590337,-21600,,
com.apple.Preview,3,1738856345,1738856348,1738856348.16954,-21600,,
com.microsoft.Word,2,1738856343,1738856345,1738856345.379739,-21600,,
com.leomehlig.today,33,1738856310,1738856343,1738856343.9972181,-21600,,
com.microsoft.Word,275,1738856035,1738856310,1738856310.920138,-21600,,
com.apple.Preview,2,1738856033,1738856035,1738856035.5625792,-21600,,
com.microsoft.Word,0,1738856033,1738856033,1738856033.86022,-21600,,
com.google.Chrome,13,1738856020,1738856033,1738856033.346046,-21600,,
com.microsoft.Word,269,1738855751,1738856020,1738856020.9082751,-21600,,
com.apple.Preview,4,1738855747,1738855751,1738855751.591614,-21600,,
com.microsoft.Word,1,1738855746,1738855747,1738855747.479227,-21600,,
com.google.Chrome,24,1738855722,1738855746,1738855746.487091,-21600,,
com.microsoft.Word,66,1738855656,1738855722,1738855722.699218,-21600,,
com.apple.Preview,5,1738855651,1738855656,1738855656.0720658,-21600,,
com.microsoft.Word,85,1738855566,1738855651,1738855651.41067,-21600,,
com.google.Chrome,22,1738855544,1738855566,1738855566.591423,-21600,,
com.microsoft.Word,7,1738855537,1738855544,1738855544.539731,-21600,,
com.google.Chrome,1,1738855536,1738855537,1738855537.612948,-21600,,
com.microsoft.Word,4,1738855532,1738855536,1738855536.956033,-21600,,
com.google.Chrome,2,1738855530,1738855532,1738855532.1617088,-21600,,
com.microsoft.Word,46,1738855484,1738855530,1738855530.6314402,-21600,,
com.google.Chrome,79,1738855405,1738855484,1738855484.717926,-21600,,
com.microsoft.Word,8,1738855397,1738855405,1738855405.127592,-21600,,
com.google.Chrome,5,1738855392,1738855397,1738855397.144733,-21600,,
com.microsoft.Word,4,1738855388,1738855392,1738855392.219641,-21600,,
com.google.Chrome,11,1738855377,1738855388,1738855388.32848,-21600,,
com.microsoft.Word,18,1738855359,1738855377,1738855377.5463738,-21600,,
com.google.Chrome,42,1738855317,1738855359,1738855359.603837,-21600,,
com.microsoft.Word,424,1738854893,1738855317,1738855317.865787,-21600,,
com.apple.Preview,10,1738854883,1738854893,1738854893.476698,-21600,,
com.apple.MobileSMS,2,1738854869,1738854871,1738854871.685257,-21600,EB445137-D7F5-57EC-87DA-1DB460D64046,"iPhone13,2"
com.microsoft.Word,44,1738854839,1738854883,1738854883.37712,-21600,,
com.apple.Preview,1,1738854838,1738854839,1738854839.057035,-21600,,
com.microsoft.Word,2,1738854836,1738854838,1738854838.075426,-21600,,
com.google.Chrome,51,1738854785,1738854836,1738854836.365938,-21600,,
com.microsoft.Word,128,1738854657,1738854785,1738854786.113735,-21600,,
com.apple.Preview,16,1738854641,1738854657,1738854657.561922,-21600,,
com.microsoft.Word,480,1738854161,1738854641,1738854641.694409,-21600,,
com.apple.Preview,16,1738854145,1738854161,1738854162.040966,-21600,,
com.microsoft.Word,37,1738854108,1738854145,1738854145.529611,-21600,,
com.apple.Preview,4,1738854104,1738854108,1738854108.3840652,-21600,,
com.microsoft.Word,29,1738854075,1738854104,1738854104.120966,-21600,,
com.apple.Preview,7,1738854068,1738854075,1738854075.633943,-21600,,
com.microsoft.Word,13,1738854055,1738854068,1738854068.4829168,-21600,,
com.apple.Preview,4,1738854051,1738854055,1738854055.5767798,-21600,,
com.microsoft.Word,6,1738854045,1738854051,1738854051.674355,-21600,,
com.apple.Preview,6,1738854039,1738854045,1738854045.5125508,-21600,,
com.microsoft.Word,11,1738854028,1738854039,1738854039.243991,-21600,,
com.apple.Preview,6,1738854022,1738854028,1738854029.028192,-21600,,
com.microsoft.Word,11,1738854011,1738854022,1738854022.115144,-21600,,
com.apple.Preview,4,1738854007,1738854011,1738854011.923558,-21600,,
com.microsoft.Word,22,1738853985,1738854007,1738854007.758616,-21600,,
com.apple.Preview,2,1738853983,1738853985,1738853985.786621,-21600,,
com.apple.finder,2,1738853981,1738853983,1738853984.025758,-21600,,
com.apple.Preview,2,1738853979,1738853981,1738853981.504695,-21600,,
com.apple.finder,7,1738853972,1738853979,1738853979.9719272,-21600,,
com.microsoft.Word,5,1738853967,1738853972,1738853972.3101869,-21600,,
com.apple.finder,1,1738853966,1738853967,1738853968.002126,-21600,,
com.apple.Preview,5,1738853961,1738853966,1738853966.062725,-21600,,
com.apple.finder,4,1738853957,1738853961,1738853961.2202082,-21600,,
com.apple.Preview,4,1738853953,1738853957,1738853957.9057798,-21600,,
com.apple.finder,9,1738853944,1738853953,1738853953.505672,-21600,,
com.apple.Preview,2,1738853942,1738853944,1738853944.818462,-21600,,
com.microsoft.Word,12,1738853930,1738853942,1738853942.218215,-21600,,
com.apple.Preview,5,1738853925,1738853930,1738853930.716769,-21600,,
com.apple.finder,0,1738853925,1738853925,1738853925.878483,-21600,,
com.apple.Preview,1,1738853924,1738853925,1738853925.3777099,-21600,,
com.apple.finder,13,1738853911,1738853924,1738853924.316205,-21600,,
com.leomehlig.today,1,1738853910,1738853911,1738853911.486594,-21600,,
com.google.Chrome,3,1738853907,1738853910,1738853911.226438,-21600,,
com.leomehlig.today,15,1738853892,1738853907,1738853909.629678,-21600,,
com.apple.MobileSMS,19,1738853795,1738853814,1738853814.622262,-21600,EB445137-D7F5-57EC-87DA-1DB460D64046,"iPhone13,2"
com.apple.MobileSMS,45,1738853665,1738853710,1738853710.5644112,-21600,EB445137-D7F5-57EC-87DA-1DB460D64046,"iPhone13,2"
com.renpho.health,1,1738853664,1738853665,1738853665.7496018,-21600,EB445137-D7F5-57EC-87DA-1DB460D64046,"iPhone13,2"
com.renpho.health,35,1738852797,1738852832,1738852833.083356,-21600,EB445137-D7F5-57EC-87DA-1DB460D64046,"iPhone13,2"
com.apple.news,2,1738852793,1738852795,1738852795.769302,-21600,EB445137-D7F5-57EC-87DA-1DB460D64046,"iPhone13,2"
com.apple.news,84,1738851802,1738851886,1738851886.91591,-21600,EB445137-D7F5-57EC-87DA-1DB460D64046,"iPhone13,2"
com.apple.Health,85,1738851716,1738851801,1738851801.47908,-21600,EB445137-D7F5-57EC-87DA-1DB460D64046,"iPhone13,2"
com.apple.Health,39,1738820708,1738820747,1738820747.771492,-21600,EB445137-D7F5-57EC-87DA-1DB460D64046,"iPhone13,2"
com.thestorygraph.thestorygraph,0,1738820708,1738820708,1738820709.526531,-21600,EB445137-D7F5-57EC-87DA-1DB460D64046,"iPhone13,2"
com.thestorygraph.thestorygraph,18,1738820673,1738820691,1738820692.158865,-21600,EB445137-D7F5-57EC-87DA-1DB460D64046,"iPhone13,2"
com.leomehlig.today,4,1738818659,1738818663,1738818663.594784,-21600,,
com.apple.news,234,1738818386,1738818620,1738818620.831605,-21600,EB445137-D7F5-57EC-87DA-1DB460D64046,"iPhone13,2"
com.google.Chrome,287,1738818372,1738818659,1738818659.299855,-21600,,
com.google.Chrome,316,1738817994,1738818310,1738818310.092843,-21600,,
com.myfitnesspal.mfp,126,1738817721,1738817847,1738817847.768429,-21600,EB445137-D7F5-57EC-87DA-1DB460D64046,"iPhone13,2"
com.apple.Health,99,1738817619,1738817718,1738817718.2542272,-21600,EB445137-D7F5-57EC-87DA-1DB460D64046,"iPhone13,2"
com.apple.Music,2,1738817342,1738817344,1738817344.63114,-21600,EB445137-D7F5-57EC-87DA-1DB460D64046,"iPhone13,2"
com.apple.Music,24,1738817315,1738817339,1738817340.076261,-21600,EB445137-D7F5-57EC-87DA-1DB460D64046,"iPhone13,2"
com.google.Chrome,337,1738817301,1738817638,1738817638.154135,-21600,,
com.google.Chrome,637,1738816482,1738817119,1738817119.770391,-21600,,
com.apple.news,96,1738816386,1738816482,1738816482.72738,-21600,,
com.google.Chrome,21,1738816365,1738816386,1738816386.858642,-21600,,
com.apple.finder,1,1738816364,1738816365,1738816365.831126,-21600,,
com.apple.Notes,67,1738816297,1738816364,1738816364.629012,-21600,,
com.apple.finder,2,1738816295,1738816297,1738816297.351079,-21600,,
com.leomehlig.today,9,1738816286,1738816295,1738816295.138537,-21600,,
com.apple.finder,14,1738816272,1738816286,1738816286.4847012,-21600,,
com.apple.Music,5,1738814150,1738814155,1738814155.739167,-21600,EB445137-D7F5-57EC-87DA-1DB460D64046,"iPhone13,2"
com.apple.Music,27,1738813242,1738813269,1738813271.0691562,-21600,EB445137-D7F5-57EC-87DA-1DB460D64046,"iPhone13,2"
com.apple.weather,7,1738813191,1738813198,1738813198.689008,-21600,EB445137-D7F5-57EC-87DA-1DB460D64046,"iPhone13,2"
com.apple.shortcuts,1,1738813189,1738813190,1738813191.0245519,-21600,EB445137-D7F5-57EC-87DA-1DB460D64046,"iPhone13,2"
com.apple.finder,2,1738813001,1738813003,1738813003.837175,-21600,,
com.leomehlig.today,4,1738812997,1738813001,1738813001.251133,-21600,,
com.apple.finder,3,1738812994,1738812997,1738812997.0443292,-21600,,
com.leomehlig.today,2,1738812992,1738812994,1738812994.2925448,-21600,,
com.hnc.Discord,6,1738812986,1738812992,1738812993.04567,-21600,,
com.leomehlig.today,2,1738812984,1738812986,1738812986.769645,-21600,,
com.apple.Photos,1,1738812983,1738812984,1738812984.655589,-21600,,
com.google.Chrome,1,1738812982,1738812983,1738812983.463121,-21600,,
com.leomehlig.today,32,1738812950,1738812982,1738812982.3909369,-21600,,
com.google.Chrome,75,1738812875,1738812950,1738812950.9363198,-21600,,
com.leomehlig.today,23,1738812852,1738812875,1738812875.083961,-21600,,
com.google.Chrome,25,1738812827,1738812852,1738812852.803123,-21600,,
com.leomehlig.today,101,1738812726,1738812827,1738812827.969915,-21600,,
com.google.Chrome,14,1738812712,1738812726,1738812726.098671,-21600,,
com.leomehlig.today,70,1738812642,1738812712,1738812712.904315,-21600,,
com.apple.finder,25,1738812617,1738812642,1738812642.660009,-21600,,
com.leomehlig.today,94,1738812523,1738812617,1738812617.493308,-21600,,
com.google.Chrome,10,1738812513,1738812523,1738812523.462424,-21600,,
com.leomehlig.today,38,1738812475,1738812513,1738812513.235225,-21600,,
com.google.Chrome,5,1738812470,1738812475,1738812475.96748,-21600,,
com.leomehlig.today,4,1738812466,1738812470,1738812470.668167,-21600,,
com.google.Chrome,1127,1738811339,1738812466,1738812466.905314,-21600,,
com.google.Chrome,301,1738810973,1738811274,1738811274.879109,-21600,,
com.apple.finder,46,1738810927,1738810973,1738810974.0161572,-21600,,
com.google.Chrome,226,1738810701,1738810927,1738810927.2164478,-21600,,
com.leomehlig.today,2,1738810699,1738810701,1738810701.696223,-21600,,
com.google.Chrome,554,1738810145,1738810699,1738810699.871294,-21600,,
com.apple.Photos,1,1738810144,1738810145,1738810145.509316,-21600,,
com.google.Chrome,702,1738809442,1738810144,1738810144.645057,-21600,,
com.apple.Photos,39,1738809403,1738809442,1738809442.6579509,-21600,,
com.google.Chrome,94,1738809309,1738809403,1738809403.580624,-21600,,
com.apple.Photos,88,1738809221,1738809309,1738809309.227766,-21600,,
com.google.Chrome,73,1738809148,1738809221,1738809221.354902,-21600,,
com.apple.Photos,30,1738809118,1738809148,1738809148.563428,-21600,,
com.google.Chrome,97,1738809021,1738809118,1738809118.539262,-21600,,
com.leomehlig.today,59,1738808962,1738809021,1738809021.617567,-21600,,
com.google.Chrome,313,1738808649,1738808962,1738808963.189056,-21600,,
com.apple.Preview,14,1738808635,1738808649,1738808649.525198,-21600,,
com.apple.finder,9,1738808626,1738808635,1738808635.819478,-21600,,
com.google.Chrome,3,1738808623,1738808626,1738808626.485307,-21600,,
com.microsoft.Word,3,1738808620,1738808623,1738808623.857356,-21600,,
com.google.Chrome,255,1738808365,1738808620,1738808621.0721679,-21600,,
com.apple.finder,314,1738808051,1738808365,1738808365.800435,-21600,,
com.google.Chrome,229,1738807822,1738808051,1738808051.392548,-21600,,
com.apple.Photos,38,1738807784,1738807822,1738807822.868137,-21600,,
com.google.Chrome,34,1738807750,1738807784,1738807784.248568,-21600,,
com.apple.Photos,4,1738807746,1738807750,1738807750.09655,-21600,,
com.google.Chrome,36,1738807710,1738807746,1738807746.768282,-21600,,
com.apple.Photos,2,1738807708,1738807710,1738807710.728194,-21600,,
com.hnc.Discord,1,1738807707,1738807708,1738807708.957148,-21600,,
com.apple.Photos,1,1738807706,1738807707,1738807707.952105,-21600,,
com.hnc.Discord,97,1738807609,1738807706,1738807706.946535,-21600,,
com.apple.Photos,25,1738807584,1738807609,1738807609.694767,-21600,,
com.hnc.Discord,7,1738807577,1738807584,1738807584.274183,-21600,,
com.apple.Photos,28,1738807549,1738807577,1738807577.454891,-21600,,
com.google.Chrome,2,1738807547,1738807549,1738807549.283698,-21600,,
com.apple.Photos,2,1738807545,1738807547,1738807547.078539,-21600,,
com.google.Chrome,5,1738807540,1738807545,1738807545.533523,-21600,,
com.apple.Photos,8,1738807532,1738807540,1738807540.299055,-21600,,
com.google.Chrome,3,1738807529,1738807532,1738807532.125386,-21600,,
com.apple.Photos,6,1738807523,1738807529,1738807529.6271,-21600,,
com.google.Chrome,40,1738807483,1738807523,1738807524.0416331,-21600,,
com.apple.Photos,71,1738807412,1738807483,1738807484.008322,-21600,,
com.google.Chrome,3,1738807409,1738807412,1738807412.7512941,-21600,,
com.apple.Photos,34,1738807375,1738807409,1738807409.903177,-21600,,
com.google.Chrome,97,1738807278,1738807375,1738807375.952462,-21600,,
com.leomehlig.today,216,1738807047,1738807263,1738807263.4167519,-21600,,
com.google.Chrome,13,1738807034,1738807047,1738807047.362648,-21600,,
com.apple.shortcuts,18,1738806909,1738806927,1738806928.2683911,-21600,EB445137-D7F5-57EC-87DA-1DB460D64046,"iPhone13,2"
com.leomehlig.today,169,1738806865,1738807034,1738807036.020989,-21600,,
com.leomehlig.today,23,1738806699,1738806722,1738806722.749747,-21600,,
com.apple.finder,23,1738806676,1738806699,1738806699.589719,-21600,,
com.leomehlig.today,22,1738806654,1738806676,1738806676.62774,-21600,,
com.microsoft.Word,48,1738806606,1738806654,1738806654.9279718,-21600,,
com.google.Chrome,35,1738806571,1738806606,1738806606.929781,-21600,,
com.microsoft.Word,546,1738806025,1738806571,1738806571.63827,-21600,,
com.apple.Preview,7,1738806018,1738806025,1738806025.7045689,-21600,,
com.microsoft.Word,338,1738805680,1738806018,1738806018.313056,-21600,,
com.leomehlig.today,2,1738805678,1738805680,1738805680.989775,-21600,,
com.microsoft.Word,174,1738805504,1738805678,1738805678.906219,-21600,,
com.apple.Preview,2,1738805502,1738805504,1738805504.58652,-21600,,
com.microsoft.Word,2,1738805500,1738805502,1738805502.488143,-21600,,
com.google.Chrome,14,1738805486,1738805500,1738805500.6948419,-21600,,
com.microsoft.Word,13,1738805473,1738805486,1738805486.670858,-21600,,
com.google.Chrome,197,1738805276,1738805473,1738805473.890881,-21600,,
com.microsoft.Word,83,1738805193,1738805276,1738805276.3121119,-21600,,
com.google.Chrome,15,1738805178,1738805193,1738805193.494681,-21600,,
com.microsoft.Word,5,1738805173,1738805178,1738805178.070188,-21600,,
com.google.Chrome,98,1738805075,1738805173,1738805173.242984,-21600,,
com.microsoft.Word,27,1738805048,1738805075,1738805075.8455849,-21600,,
com.google.Chrome,3,1738805045,1738805048,1738805048.13797,-21600,,
com.microsoft.Word,47,1738804998,1738805045,1738805045.7446651,-21600,,
com.google.Chrome,23,1738804975,1738804998,1738804998.727806,-21600,,
com.microsoft.Word,366,1738804609,1738804975,1738804975.602993,-21600,,
com.apple.Preview,0,1738804609,1738804609,1738804609.961117,-21600,,
com.google.Chrome,204,1738804405,1738804609,1738804609.491296,-21600,,
com.microsoft.Word,283,1738804122,1738804405,1738804405.24128,-21600,,
com.apple.Preview,33,1738804089,1738804122,1738804122.656995,-21600,,
com.microsoft.Word,119,1738803970,1738804089,1738804089.503965,-21600,,
com.google.Chrome,55,1738803915,1738803970,1738803970.286483,-21600,,
com.apple.Preview,8,1738803907,1738803915,1738803915.60752,-21600,,
com.google.Chrome,14,1738803893,1738803907,1738803907.1645532,-21600,,
com.apple.Preview,1,1738803892,1738803893,1738803893.311425,-21600,,
com.microsoft.Word,103,1738803789,1738803892,1738803892.620089,-21600,,
com.apple.Preview,1,1738803788,1738803789,1738803789.3450499,-21600,,
com.google.Chrome,31,1738803757,1738803788,1738803788.045236,-21600,,
com.microsoft.Word,1,1738803756,1738803757,1738803757.731801,-21600,,
com.apple.Preview,1,1738803755,1738803756,1738803756.9159188,-21600,,
com.microsoft.Word,1,1738803754,1738803755,1738803755.7681699,-21600,,
com.google.Chrome,56,1738803698,1738803754,1738803754.937395,-21600,,
com.microsoft.Word,75,1738803623,1738803698,1738803698.8179898,-21600,,
com.apple.Preview,1,1738803622,1738803623,1738803623.833064,-21600,,
com.microsoft.Word,2,1738803620,1738803622,1738803622.8486729,-21600,,
com.google.Chrome,79,1738803541,1738803620,1738803620.869885,-21600,,
com.microsoft.Word,107,1738803434,1738803541,1738803541.812251,-21600,,
com.apple.Preview,51,1738803383,1738803434,1738803434.343927,-21600,,
com.microsoft.Word,232,1738803151,1738803383,1738803383.5796108,-21600,,
com.apple.news,251,1738802960,1738803211,1738803211.936685,-21600,EB445137-D7F5-57EC-87DA-1DB460D64046,"iPhone13,2"
com.hammerandchisel.discord,11,1738802939,1738802950,1738802950.490547,-21600,EB445137-D7F5-57EC-87DA-1DB460D64046,"iPhone13,2"
com.microsoft.Word,467,1738802679,1738803146,1738803146.657428,-21600,,
com.google.Chrome,19,1738802660,1738802679,1738802680.052587,-21600,,
com.microsoft.Word,5,1738802655,1738802660,1738802660.7973871,-21600,,
com.google.Chrome,1,1738802654,1738802655,1738802655.53608,-21600,,
com.microsoft.Word,10,1738802644,1738802654,1738802654.1857939,-21600,,
com.google.Chrome,102,1738802542,1738802644,1738802644.343643,-21600,,
com.microsoft.Word,5,1738802537,1738802542,1738802542.617272,-21600,,
com.google.Chrome,11,1738802526,1738802537,1738802537.859981,-21600,,
com.microsoft.Word,387,1738802139,1738802526,1738802527.7073588,-21600,,
com.apple.Preview,40,1738802099,1738802139,1738802139.15081,-21600,,
com.microsoft.Word,490,1738801609,1738802099,1738802099.0965471,-21600,,
com.apple.Preview,17,1738801592,1738801609,1738801609.6546788,-21600,,
com.microsoft.Word,8,1738801584,1738801592,1738801592.4759831,-21600,,
com.apple.Preview,7,1738801577,1738801584,1738801584.822833,-21600,,
com.apple.finder,3,1738801574,1738801577,1738801577.423338,-21600,,
com.apple.Preview,5,1738801569,1738801574,1738801574.275341,-21600,,
com.apple.finder,2,1738801567,1738801569,1738801569.359204,-21600,,
com.apple.Preview,25,1738801542,1738801567,1738801567.826077,-21600,,
com.apple.finder,6,1738801536,1738801542,1738801542.702132,-21600,,
com.apple.Preview,3,1738801533,1738801536,1738801536.8746471,-21600,,
com.apple.finder,41,1738801492,1738801533,1738801533.591557,-21600,,
com.microsoft.Word,17,1738801475,1738801492,1738801492.171362,-21600,,
com.apple.Preview,10,1738801465,1738801475,1738801475.599206,-21600,,
com.microsoft.Word,10,1738801455,1738801465,1738801465.0706801,-21600,,
com.apple.Preview,4,1738801451,1738801455,1738801455.790391,-21600,,
com.microsoft.Word,8,1738801443,1738801451,1738801451.6995459,-21600,,
com.apple.Preview,4,1738801439,1738801443,1738801443.544842,-21600,,
com.microsoft.Word,7,1738801432,1738801439,1738801439.5808039,-21600,,
com.apple.Preview,5,1738801427,1738801432,1738801432.228777,-21600,,
com.microsoft.Word,11,1738801416,1738801427,1738801427.4147139,-21600,,
com.apple.Preview,5,1738801411,1738801416,1738801416.147241,-21600,,
com.microsoft.Word,8,1738801403,1738801411,1738801411.0818439,-21600,,
com.apple.Preview,5,1738801398,1738801403,1738801403.945321,-21600,,
com.microsoft.Word,8,1738801390,1738801398,1738801398.214549,-21600,,
com.apple.Preview,7,1738801383,1738801390,1738801390.189492,-21600,,
com.microsoft.Word,13,1738801370,1738801383,1738801383.5155802,-21600,,
com.apple.Preview,5,1738801365,1738801370,1738801370.24354,-21600,,
com.microsoft.Word,9,1738801356,1738801365,1738801365.9089332,-21600,,
com.apple.Preview,8,1738801348,1738801356,1738801356.594804,-21600,,
com.microsoft.Word,14,1738801334,1738801348,1738801348.128278,-21600,,
com.apple.Preview,10,1738801324,1738801334,1738801334.0907102,-21600,,
com.microsoft.Word,3,1738801321,1738801324,1738801325.015603,-21600,,
com.apple.Preview,8,1738801313,1738801321,1738801321.1674352,-21600,,
com.microsoft.Word,1,1738801312,1738801313,1738801313.277038,-21600,,
com.apple.Preview,6,1738801306,1738801312,1738801312.275052,-21600,,
com.microsoft.Word,13,1738801293,1738801306,1738801306.453349,-21600,,
com.apple.finder,6,1738801287,1738801293,1738801293.2369099,-21600,,
com.leomehlig.today,1,1738801286,1738801287,1738801287.235935,-21600,,
com.google.Chrome,2,1738801284,1738801286,1738801286.183944,-21600,,
com.apple.finder,11,1738801273,1738801284,1738801284.1365008,-21600,,
com.google.Chrome,5,1738801268,1738801273,1738801273.645369,-21600,,
com.apple.finder,5,1738801263,1738801268,1738801268.075201,-21600,,
com.microsoft.Word,13,1738801250,1738801263,1738801263.417233,-21600,,
com.apple.finder,2,1738801248,1738801250,1738801250.818932,-21600,,
com.apple.Preview,2,1738801246,1738801248,1738801248.407824,-21600,,
com.google.Chrome,1,1738801245,1738801246,1738801246.348077,-21600,,
com.apple.Preview,2,1738801243,1738801245,1738801245.376319,-21600,,
com.apple.finder,27,1738801216,1738801243,1738801244.0006928,-21600,,
com.google.Chrome,17,1738801199,1738801216,1738801216.581599,-21600,,
com.apple.finder,24,1738801160,1738801184,1738801184.959371,-21600,,
com.apple.mobiletimer,2,1738801115,1738801117,1738801117.230472,-21600,EB445137-D7F5-57EC-87DA-1DB460D64046,"iPhone13,2"
com.apple.Health,35,1738801079,1738801114,1738801114.268662,-21600,EB445137-D7F5-57EC-87DA-1DB460D64046,"iPhone13,2"
com.leomehlig.today,3,1738801076,1738801079,1738801079.5700622,-21600,EB445137-D7F5-57EC-87DA-1DB460D64046,"iPhone13,2"
com.leomehlig.today,86,1738801074,1738801160,1738801160.2487888,-21600,,
com.leomehlig.today,70,1738799647,1738799717,1738799718.039063,-21600,EB445137-D7F5-57EC-87DA-1DB460D64046,"iPhone13,2"
com.apple.Health,3,1738799638,1738799641,1738799641.5504599,-21600,EB445137-D7F5-57EC-87DA-1DB460D64046,"iPhone13,2"
com.apple.Health,24,1738799558,1738799582,1738799582.913624,-21600,EB445137-D7F5-57EC-87DA-1DB460D64046,"iPhone13,2"
com.myfitnesspal.mfp,1,1738799557,1738799558,1738799558.990868,-21600,EB445137-D7F5-57EC-87DA-1DB460D64046,"iPhone13,2"
com.myfitnesspal.mfp,4,1738799434,1738799438,1738799439.1486058,-21600,EB445137-D7F5-57EC-87DA-1DB460D64046,"iPhone13,2"
com.myfitnesspal.mfp,82,1738799349,1738799431,1738799431.662821,-21600,EB445137-D7F5-57EC-87DA-1DB460D64046,"iPhone13,2"
com.apple.calculator,5,1738799344,1738799349,1738799349.103704,-21600,EB445137-D7F5-57EC-87DA-1DB460D64046,"iPhone13,2"
com.myfitnesspal.mfp,163,1738799181,1738799344,1738799344.089165,-21600,EB445137-D7F5-57EC-87DA-1DB460D64046,"iPhone13,2"
com.leomehlig.today,9,1738798703,1738798712,1738798712.4841661,-21600,,
com.apple.finder,2,1738798701,1738798703,1738798703.078604,-21600,,
com.microsoft.Word,5,1738798696,1738798701,1738798701.058454,-21600,,
com.google.Chrome,4,1738798692,1738798696,1738798696.109812,-21600,,
com.apple.finder,1,1738798691,1738798692,1738798692.815963,-21600,,
com.microsoft.Word,3,1738798688,1738798691,1738798691.56986,-21600,,
com.apple.finder,24,1738798664,1738798688,1738798688.953109,-21600,,
com.google.Chrome,34,1738798630,1738798664,1738798665.005806,-21600,,
com.microsoft.VSCode,9,1738798621,1738798630,1738798631.0006552,-21600,,
com.apple.Terminal,87,1738798534,1738798621,1738798621.963692,-21600,,
com.microsoft.VSCode,2,1738798532,1738798534,1738798534.436404,-21600,,
com.apple.Terminal,8,1738798524,1738798532,1738798532.228081,-21600,,
com.microsoft.VSCode,152,1738798372,1738798524,1738798524.835905,-21600,,
com.apple.Terminal,0,1738798372,1738798372,1738798372.842794,-21600,,
com.google.Chrome,1,1738798371,1738798372,1738798372.0470529,-21600,,
com.apple.Terminal,1,1738798370,1738798371,1738798371.7856169,-21600,,
com.microsoft.VSCode,63,1738798307,1738798370,1738798370.2774339,-21600,,
com.apple.Terminal,20,1738798287,1738798307,1738798307.51075,-21600,,
com.microsoft.VSCode,101,1738798186,1738798287,1738798288.010511,-21600,,
com.google.Chrome,13,1738798173,1738798186,1738798186.935056,-21600,,
com.microsoft.VSCode,44,1738798129,1738798173,1738798173.49769,-21600,,
com.apple.Terminal,9,1738798120,1738798129,1738798129.9254441,-21600,,
com.microsoft.VSCode,9,1738798111,1738798120,1738798120.243912,-21600,,
com.apple.Terminal,6,1738798105,1738798111,1738798111.733846,-21600,,
com.microsoft.VSCode,3,1738798102,1738798105,1738798105.587624,-21600,,
com.apple.Terminal,4,1738798098,1738798102,1738798102.337177,-21600,,
com.microsoft.VSCode,1,1738798097,1738798098,1738798098.554106,-21600,,
com.apple.Terminal,62,1738798035,1738798097,1738798097.339581,-21600,,
com.microsoft.VSCode,2,1738798033,1738798035,1738798035.618266,-21600,,
com.apple.Terminal,40,1738797993,1738798033,1738798033.790797,-21600,,
com.microsoft.VSCode,11,1738797982,1738797993,1738797993.319899,-21600,,
com.apple.Terminal,170,1738797812,1738797982,1738797982.498791,-21600,,
com.google.Chrome,70,1738797742,1738797812,1738797812.6177301,-21600,,
com.apple.Terminal,138,1738797604,1738797742,1738797742.396285,-21600,,
com.google.Chrome,56,1738797548,1738797604,1738797604.317203,-21600,,
com.apple.Terminal,148,1738797400,1738797548,1738797548.415093,-21600,,
com.google.Chrome,12,1738797388,1738797400,1738797400.319312,-21600,,
com.apple.Terminal,68,1738797320,1738797388,1738797388.793429,-21600,,
com.microsoft.rdc.macos,26,1738797294,1738797320,1738797320.1610188,-21600,,
com.apple.Terminal,15,1738797279,1738797294,1738797294.101365,-21600,,
com.apple.Terminal,306,1738796304,1738796610,1738796610.193043,-21600,,
com.toyopagroup.picaboo,8,1738795893,1738795901,1738795901.4230409,-21600,EB445137-D7F5-57EC-87DA-1DB460D64046,"iPhone13,2"
com.myfitnesspal.mfp,1,1738795892,1738795893,1738795893.5267348,-21600,EB445137-D7F5-57EC-87DA-1DB460D64046,"iPhone13,2"
com.apple.Terminal,305,1738795881,1738796186,1738796186.9931989,-21600,,
com.myfitnesspal.mfp,12,1738795585,1738795597,1738795598.056802,-21600,EB445137-D7F5-57EC-87DA-1DB460D64046,"iPhone13,2"
com.myfitnesspal.mfp,42,1738795442,1738795484,1738795484.830577,-21600,EB445137-D7F5-57EC-87DA-1DB460D64046,"iPhone13,2"
com.apple.Terminal,318,1738795409,1738795727,1738795727.4072251,-21600,,
com.apple.Terminal,311,1738794538,1738794849,1738794849.8565989,-21600,,
com.apple.Terminal,300,1738793989,1738794289,1738794289.830044,-21600,,
com.google.Chrome,41,1738793948,1738793989,1738793989.838853,-21600,,
com.apple.Terminal,58,1738793874,1738793932,1738793932.6180382,-21600,,
com.google.Chrome,43,1738793831,1738793874,1738793875.0163798,-21600,,
com.apple.Terminal,4,1738793827,1738793831,1738793831.173596,-21600,,
com.google.Chrome,25,1738793802,1738793827,1738793827.1069431,-21600,,
com.apple.CoreAuthUI,4,1738793721,1738793725,1738793725.422182,-21600,EB445137-D7F5-57EC-87DA-1DB460D64046,"iPhone13,2"
com.truebill.truebillnative,9,1738793720,1738793729,1738793729.411448,-21600,EB445137-D7F5-57EC-87DA-1DB460D64046,"iPhone13,2"
com.apple.Terminal,130,1738793672,1738793802,1738793802.4482079,-21600,,
com.google.Chrome,23,1738793649,1738793672,1738793672.934335,-21600,,
com.apple.Terminal,41,1738793608,1738793649,1738793649.855088,-21600,,
com.google.Chrome,2,1738793606,1738793608,1738793608.813424,-21600,,
com.apple.Terminal,55,1738793551,1738793606,1738793606.1627002,-21600,,
com.google.Chrome,2,1738793549,1738793551,1738793551.781528,-21600,,
com.apple.Terminal,27,1738793522,1738793549,1738793549.978637,-21600,,
com.microsoft.VSCode,15,1738793507,1738793522,1738793522.541889,-21600,,
com.apple.Terminal,15,1738793492,1738793507,1738793507.7150679,-21600,,
com.google.Chrome,1,1738793491,1738793492,1738793492.588372,-21600,,
com.apple.Terminal,10,1738793481,1738793491,1738793491.7907739,-21600,,
com.google.Chrome,11,1738793470,1738793481,1738793481.732397,-21600,,
com.apple.Terminal,53,1738793417,1738793470,1738793470.233223,-21600,,
com.google.Chrome,2,1738793415,1738793417,1738793417.584124,-21600,,
com.apple.Terminal,26,1738793389,1738793415,1738793415.570962,-21600,,
com.google.Chrome,13,1738793376,1738793389,1738793389.9395041,-21600,,
com.apple.Terminal,38,1738793338,1738793376,1738793376.144281,-21600,,
com.microsoft.rdc.macos,137,1738793201,1738793338,1738793338.715101,-21600,,
com.apple.Terminal,11,1738793190,1738793201,1738793201.5201879,-21600,,
com.google.Chrome,20,1738793170,1738793190,1738793190.829566,-21600,,
com.apple.Terminal,97,1738793073,1738793170,1738793170.859201,-21600,,
com.google.Chrome,16,1738793057,1738793073,1738793073.628411,-21600,,
com.apple.Terminal,3,1738793054,1738793057,1738793058.0457249,-21600,,
com.google.Chrome,75,1738792979,1738793054,1738793054.154686,-21600,,
com.apple.CoreAuthUI,2,1738792820,1738792822,1738792822.173074,-21600,EB445137-D7F5-57EC-87DA-1DB460D64046,"iPhone13,2"
com.truebill.truebillnative,24,1738792817,1738792841,1738792841.629722,-21600,EB445137-D7F5-57EC-87DA-1DB460D64046,"iPhone13,2"
com.apple.CoreAuthUI,1,1738792794,1738792795,1738792796.0613499,-21600,EB445137-D7F5-57EC-87DA-1DB460D64046,"iPhone13,2"
com.robinhood.release.Robinhood,16,1738792788,1738792804,1738792804.6003032,-21600,EB445137-D7F5-57EC-87DA-1DB460D64046,"iPhone13,2"
com.apple.Terminal,490,1738792489,1738792979,1738792979.7607698,-21600,,
com.microsoft.VSCode,297,1738792192,1738792489,1738792489.043114,-21600,,
com.apple.Terminal,28,1738792164,1738792192,1738792192.29065,-21600,,
com.microsoft.VSCode,24,1738792140,1738792164,1738792164.172898,-21600,,
com.apple.Terminal,9,1738792131,1738792140,1738792140.759211,-21600,,
com.microsoft.VSCode,6,1738792125,1738792131,1738792131.574831,-21600,,
com.apple.Terminal,12,1738792113,1738792125,1738792125.177369,-21600,,
com.microsoft.VSCode,6,1738792107,1738792113,1738792113.402192,-21600,,
com.apple.Terminal,14,1738792093,1738792107,1738792107.204566,-21600,,
com.microsoft.VSCode,10,1738792083,1738792093,1738792093.934551,-21600,,
com.apple.Terminal,47,1738792036,1738792083,1738792083.2991118,-21600,,
com.microsoft.VSCode,1,1738792035,1738792036,1738792036.937206,-21600,,
com.cisco.secureclient.gui,37,1738791998,1738792035,1738792035.4733949,-21600,,
com.microsoft.VSCode,263,1738791735,1738791998,1738791998.614419,-21600,,
com.apple.Health,5,1738791479,1738791484,1738791484.280386,-21600,EB445137-D7F5-57EC-87DA-1DB460D64046,"iPhone13,2"
com.myfitnesspal.mfp,24,1738790960,1738790984,1738790985.0157418,-21600,EB445137-D7F5-57EC-87DA-1DB460D64046,"iPhone13,2"
com.apple.mobilenotes,38,1738790293,1738790331,1738790331.752054,-21600,EB445137-D7F5-57EC-87DA-1DB460D64046,"iPhone13,2"
com.microsoft.VSCode,246,1738789928,1738790174,1738790175.070528,-21600,,
com.microsoft.VSCode,696,1738789231,1738789927,1738789927.204134,-21600,,
com.google.Chrome,2,1738789229,1738789231,1738789231.296999,-21600,,
com.groupme.iphone-app,8,1738789143,1738789151,1738789151.755096,-21600,EB445137-D7F5-57EC-87DA-1DB460D64046,"iPhone13,2"
com.leomehlig.today,8,1738788782,1738788790,1738788791.228991,-21600,EB445137-D7F5-57EC-87DA-1DB460D64046,"iPhone13,2"
com.google.Drive,2,1738788779,1738788781,1738788781.9776669,-21600,EB445137-D7F5-57EC-87DA-1DB460D64046,"iPhone13,2"
com.apple.weather,25,1738785494,1738785519,1738785520.013766,-21600,EB445137-D7F5-57EC-87DA-1DB460D64046,"iPhone13,2"
com.apple.weather,5,1738785175,1738785180,1738785180.915688,-21600,EB445137-D7F5-57EC-87DA-1DB460D64046,"iPhone13,2"
com.apple.weather,11,1738785160,1738785171,1738785171.5792,-21600,EB445137-D7F5-57EC-87DA-1DB460D64046,"iPhone13,2"
com.microsoft.Office.Outlook,2,1738785158,1738785160,1738785163.082483,-21600,EB445137-D7F5-57EC-87DA-1DB460D64046,"iPhone13,2"
com.microsoft.Office.Outlook,64,1738782816,1738782880,1738782880.936716,-21600,EB445137-D7F5-57EC-87DA-1DB460D64046,"iPhone13,2"
com.microsoft.Office.Outlook,1,1738782814,1738782815,1738782815.472207,-21600,EB445137-D7F5-57EC-87DA-1DB460D64046,"iPhone13,2"
com.google.chrome.ios,34,1738782780,1738782814,1738782814.216127,-21600,EB445137-D7F5-57EC-87DA-1DB460D64046,"iPhone13,2"
com.microsoft.Office.Outlook,33,1738782747,1738782780,1738782780.210552,-21600,EB445137-D7F5-57EC-87DA-1DB460D64046,"iPhone13,2"
com.google.Chrome,8,1738781957,1738781965,1738781965.1477551,-21600,,
com.microsoft.Word,435,1738781522,1738781957,1738781957.1305342,-21600,,
com.google.Chrome,0,1738781522,1738781522,1738781522.918616,-21600,,
com.microsoft.Word,17,1738781505,1738781522,1738781522.198351,-21600,,
com.google.Chrome,34,1738781471,1738781505,1738781505.210806,-21600,,
com.microsoft.Word,462,1738781009,1738781471,1738781471.9985409,-21600,,
com.microsoft.Word,510,1738779695,1738780205,1738780205.834506,-21600,,
com.google.Chrome,7,1738779688,1738779695,1738779695.5084162,-21600,,
com.microsoft.Word,80,1738779608,1738779688,1738779688.4127002,-21600,,
com.google.Chrome,38,1738779570,1738779608,1738779608.048839,-21600,,
com.microsoft.Word,15,1738779555,1738779570,1738779570.676796,-21600,,
com.google.Chrome,51,1738779504,1738779555,1738779555.258301,-21600,,
com.microsoft.Word,118,1738779374,1738779492,1738779493.825733,-21600,,
com.apple.finder,13,1738779361,1738779374,1738779374.112269,-21600,,
com.microsoft.VSCode,107,1738779254,1738779361,1738779361.4538522,-21600,,
com.google.chrome.ios,11,1738774801,1738774812,1738774812.42367,-21600,EB445137-D7F5-57EC-87DA-1DB460D64046,"iPhone13,2"
com.leomehlig.today,18,1738774783,1738774801,1738774802.143228,-21600,EB445137-D7F5-57EC-87DA-1DB460D64046,"iPhone13,2"
com.google.chrome.ios,33,1738774750,1738774783,1738774783.7025042,-21600,EB445137-D7F5-57EC-87DA-1DB460D64046,"iPhone13,2"
com.microsoft.Office.Outlook,3,1738774747,1738774750,1738774750.419639,-21600,EB445137-D7F5-57EC-87DA-1DB460D64046,"iPhone13,2"
com.google.chrome.ios,60,1738774687,1738774747,1738774747.321608,-21600,EB445137-D7F5-57EC-87DA-1DB460D64046,"iPhone13,2"
com.microsoft.Office.Outlook,5,1738774682,1738774687,1738774687.3706598,-21600,EB445137-D7F5-57EC-87DA-1DB460D64046,"iPhone13,2"
com.google.chrome.ios,2,1738774680,1738774682,1738774682.372284,-21600,EB445137-D7F5-57EC-87DA-1DB460D64046,"iPhone13,2"
com.leomehlig.today,29,1738774651,1738774680,1738774680.691534,-21600,EB445137-D7F5-57EC-87DA-1DB460D64046,"iPhone13,2"
com.google.chrome.ios,96,1738774551,1738774647,1738774647.551948,-21600,EB445137-D7F5-57EC-87DA-1DB460D64046,"iPhone13,2"
com.microsoft.VSCode,129,1738774150,1738774279,1738774279.322455,-21600,,
com.google.Chrome,15,1738774135,1738774150,1738774150.097466,-21600,,
com.google.Chrome,301,1738770755,1738771056,1738771056.108436,-21600,,
com.google.Chrome,425,1738770329,1738770754,1738770754.575921,-21600,,
com.microsoft.VSCode,6,1738770319,1738770325,1738770325.6132998,-21600,,
com.google.chrome.ios,37,1738769849,1738769886,1738769888.203028,-21600,EB445137-D7F5-57EC-87DA-1DB460D64046,"iPhone13,2"
com.microsoft.Office.Outlook,58,1738769791,1738769849,1738769849.701822,-21600,EB445137-D7F5-57EC-87DA-1DB460D64046,"iPhone13,2"
com.apple.Health,3,1738769784,1738769787,1738769787.094912,-21600,EB445137-D7F5-57EC-87DA-1DB460D64046,"iPhone13,2"
com.microsoft.VSCode,90,1738769535,1738769625,1738769625.0628161,-21600,,
com.google.Chrome,4,1738769531,1738769535,1738769535.545116,-21600,,
com.apple.Health,22,1738769414,1738769436,1738769436.9113941,-21600,EB445137-D7F5-57EC-87DA-1DB460D64046,"iPhone13,2"
com.google.Chrome,6,1738768252,1738768258,1738768258.202087,-21600,,
com.leomehlig.today,9,1738768243,1738768252,1738768252.60396,-21600,,
com.apple.MobileSMS,5,1738768238,1738768243,1738768243.206248,-21600,,
com.microsoft.Office.Outlook,13,1738768217,1738768230,1738768230.308552,-21600,EB445137-D7F5-57EC-87DA-1DB460D64046,"iPhone13,2"
com.google.Chrome,96,1738768142,1738768238,1738768238.548777,-21600,,
com.apple.AddressBook,3,1738768139,1738768142,1738768142.6755772,-21600,,
com.google.Chrome,6,1738768133,1738768139,1738768139.712079,-21600,,
com.apple.finder,1,1738768132,1738768133,1738768133.590098,-21600,,
com.apple.AddressBook,1,1738768131,1738768132,1738768132.802328,-21600,,
com.apple.MobileSMS,1,1738768130,1738768131,1738768131.901205,-21600,,
com.apple.AddressBook,6,1738768124,1738768130,1738768130.943188,-21600,,
com.apple.MobileSMS,7,1738768117,1738768124,1738768124.0560632,-21600,,
com.apple.finder,4,1738768113,1738768117,1738768117.753727,-21600,,
com.google.Chrome,21,1738768092,1738768113,1738768113.379566,-21600,,
com.apple.keychainaccess,2,1738768090,1738768092,1738768092.73648,-21600,,
com.google.Chrome,1,1738768089,1738768090,1738768090.8070621,-21600,,
com.apple.keychainaccess,1,1738768088,1738768089,1738768089.910263,-21600,,
com.google.Chrome,1,1738768087,1738768088,1738768088.259969,-21600,,
com.apple.keychainaccess,2,1738768085,1738768087,1738768087.100893,-21600,,
com.google.Chrome,49,1738768036,1738768085,1738768085.9387798,-21600,,
com.apple.keychainaccess,3,1738768033,1738768036,1738768036.341666,-21600,,
com.google.Chrome,2,1738768031,1738768033,1738768033.948744,-21600,,
com.apple.keychainaccess,3,1738768028,1738768031,1738768031.2988849,-21600,,
com.google.Chrome,24,1738767990,1738768014,1738768014.903919,-21600,,
com.apple.keychainaccess,1,1738767989,1738767990,1738767990.504992,-21600,,
com.google.Chrome,31,1738767955,1738767986,1738767986.682374,-21600,,
com.microsoft.Office.Outlook,76,1738767936,1738768012,1738768012.798345,-21600,EB445137-D7F5-57EC-87DA-1DB460D64046,"iPhone13,2"
com.apple.Health,5,1738767925,1738767930,1738767930.283571,-21600,EB445137-D7F5-57EC-87DA-1DB460D64046,"iPhone13,2"
com.apple.MobileSMS,15,1738767900,1738767915,1738767915.573412,-21600,EB445137-D7F5-57EC-87DA-1DB460D64046,"iPhone13,2"
com.leomehlig.today,95,1738767847,1738767942,1738767944.4805799,-21600,,
com.apple.news,60,1738767840,1738767900,1738767900.851592,-21600,EB445137-D7F5-57EC-87DA-1DB460D64046,"iPhone13,2"
com.apple.MobileSMS,4,1738767836,1738767840,1738767840.713028,-21600,EB445137-D7F5-57EC-87DA-1DB460D64046,"iPhone13,2"
com.apple.Health,0,1738767836,1738767836,1738767837.819623,-21600,EB445137-D7F5-57EC-87DA-1DB460D64046,"iPhone13,2"
com.apple.Health,16,1738766482,1738766498,1738766498.613503,-21600,EB445137-D7F5-57EC-87DA-1DB460D64046,"iPhone13,2"
com.apple.weather,25,1738766453,1738766478,1738766478.612362,-21600,EB445137-D7F5-57EC-87DA-1DB460D64046,"iPhone13,2"
com.renpho.health,1,1738766452,1738766453,1738766453.687362,-21600,EB445137-D7F5-57EC-87DA-1DB460D64046,"iPhone13,2"
com.renpho.health,43,1738766379,1738766422,1738766423.5907469,-21600,EB445137-D7F5-57EC-87DA-1DB460D64046,"iPhone13,2"
com.toyopagroup.picaboo,6,1738765370,1738765376,1738765376.872679,-21600,EB445137-D7F5-57EC-87DA-1DB460D64046,"iPhone13,2"
com.apple.shortcuts,105,1738733983,1738734088,1738734088.209173,-21600,EB445137-D7F5-57EC-87DA-1DB460D64046,"iPhone13,2"
com.apple.Preferences,2,1738733980,1738733982,1738733982.336448,-21600,EB445137-D7F5-57EC-87DA-1DB460D64046,"iPhone13,2"
com.thestorygraph.thestorygraph,33,1738733945,1738733978,1738733979.067776,-21600,EB445137-D7F5-57EC-87DA-1DB460D64046,"iPhone13,2"
com.leomehlig.today,79,1738732485,1738732564,1738732564.53928,-21600,,
com.apple.Health,144,1738732307,1738732451,1738732452.1168609,-21600,EB445137-D7F5-57EC-87DA-1DB460D64046,"iPhone13,2"
com.apple.news,2,1738732305,1738732307,1738732307.176106,-21600,EB445137-D7F5-57EC-87DA-1DB460D64046,"iPhone13,2"
com.apple.news,115,1738732114,1738732229,1738732229.958693,-21600,EB445137-D7F5-57EC-87DA-1DB460D64046,"iPhone13,2"
com.google.Chrome,479,1738732006,1738732485,1738732485.832227,-21600,,
com.apple.news,171,1738731532,1738731703,1738731703.669488,-21600,EB445137-D7F5-57EC-87DA-1DB460D64046,"iPhone13,2"
com.apple.Health,59,1738731410,1738731469,1738731469.3000379,-21600,EB445137-D7F5-57EC-87DA-1DB460D64046,"iPhone13,2"
com.apple.Health,45,1738731151,1738731196,1738731197.226094,-21600,EB445137-D7F5-57EC-87DA-1DB460D64046,"iPhone13,2"
com.apple.Health,369,1738730749,1738731118,1738731119.330337,-21600,EB445137-D7F5-57EC-87DA-1DB460D64046,"iPhone13,2"
com.apple.news,2,1738730744,1738730746,1738730746.398281,-21600,EB445137-D7F5-57EC-87DA-1DB460D64046,"iPhone13,2"
com.apple.news,108,1738730618,1738730726,1738730726.8359408,-21600,EB445137-D7F5-57EC-87DA-1DB460D64046,"iPhone13,2"
com.google.Chrome,1466,1738730536,1738732002,1738732002.1364322,-21600,,
com.leomehlig.today,12,1738730524,1738730536,1738730536.9522262,-21600,,
com.microsoft.VSCode,147,1738730377,1738730524,1738730524.722805,-21600,,
com.leomehlig.today,15,1738730362,1738730377,1738730377.655826,-21600,,
com.microsoft.VSCode,1,1738730361,1738730362,1738730362.783257,-21600,,
com.leomehlig.today,3,1738730358,1738730361,1738730361.924504,-21600,,
com.toyopagroup.picaboo,16,1738727654,1738727670,1738727670.9474602,-21600,EB445137-D7F5-57EC-87DA-1DB460D64046,"iPhone13,2"
com.apple.Music,5,1738727649,1738727654,1738727654.414957,-21600,EB445137-D7F5-57EC-87DA-1DB460D64046,"iPhone13,2"
com.apple.Music,11,1738727627,1738727638,1738727638.271275,-21600,EB445137-D7F5-57EC-87DA-1DB460D64046,"iPhone13,2"
com.apple.Health,50,1738727506,1738727556,1738727556.386431,-21600,EB445137-D7F5-57EC-87DA-1DB460D64046,"iPhone13,2"
com.toyopagroup.picaboo,2,1738727503,1738727505,1738727505.7891688,-21600,EB445137-D7F5-57EC-87DA-1DB460D64046,"iPhone13,2"
com.toyopagroup.picaboo,12,1738727487,1738727499,1738727499.61831,-21600,EB445137-D7F5-57EC-87DA-1DB460D64046,"iPhone13,2"
com.leomehlig.today,43,1738727285,1738727328,1738727328.610465,-21600,,
com.google.Chrome,4,1738727281,1738727285,1738727285.958811,-21600,,
com.leomehlig.today,68,1738727213,1738727281,1738727282.052388,-21600,,
com.google.Chrome,50,1738727163,1738727213,1738727213.133765,-21600,,
com.microsoft.VSCode,1808,1738725342,1738727150,1738727150.509647,-21600,,
com.google.Chrome,7,1738725335,1738725342,1738725342.409085,-21600,,
com.microsoft.VSCode,13,1738725322,1738725335,1738725335.2953901,-21600,,
com.google.Chrome,22,1738725300,1738725322,1738725322.122755,-21600,,
com.microsoft.VSCode,372,1738724928,1738725300,1738725300.592921,-21600,,
com.google.Chrome,18,1738724910,1738724928,1738724928.990137,-21600,,
com.microsoft.VSCode,448,1738724462,1738724910,1738724910.472639,-21600,,
com.google.Chrome,4,1738724458,1738724462,1738724462.735477,-21600,,
com.microsoft.VSCode,163,1738724295,1738724458,1738724458.9533281,-21600,,
com.google.Chrome,12,1738724283,1738724295,1738724295.725009,-21600,,
com.leomehlig.today,57,1738724226,1738724283,1738724283.203989,-21600,,
com.google.Chrome,1,1738724225,1738724226,1738724226.386564,-21600,,
com.leomehlig.today,16,1738723028,1738723044,1738723044.2879891,-21600,EB445137-D7F5-57EC-87DA-1DB460D64046,"iPhone13,2"
com.apple.Health,2,1738723009,1738723011,1738723011.3316941,-21600,EB445137-D7F5-57EC-87DA-1DB460D64046,"iPhone13,2"
com.apple.Health,78,1738721655,1738721733,1738721733.899702,-21600,EB445137-D7F5-57EC-87DA-1DB460D64046,"iPhone13,2"
com.google.Chrome,4,1738721646,1738721650,1738721650.697185,-21600,,
com.apple.finder,31,1738721615,1738721646,1738721646.439677,-21600,,
com.google.Chrome,7,1738721608,1738721615,1738721615.9292312,-21600,,
com.leomehlig.today,37,1738721571,1738721608,1738721608.357599,-21600,,
com.myfitnesspal.mfp,53,1738720795,1738720848,1738720848.7778559,-21600,EB445137-D7F5-57EC-87DA-1DB460D64046,"iPhone13,2"
com.tmsoft.WhiteNoiseLite,7,1738720780,1738720787,1738720787.962002,-21600,EB445137-D7F5-57EC-87DA-1DB460D64046,"iPhone13,2"
com.google.Chrome,793,1738720778,1738721571,1738721571.440897,-21600,,
com.apple.Music,2,1738720776,1738720778,1738720778.213018,-21600,,
com.google.Chrome,84,1738720692,1738720776,1738720776.243789,-21600,,
com.apple.Preview,18,1738720674,1738720692,1738720692.538859,-21600,,
com.google.Chrome,748,1738719926,1738720674,1738720674.80686,-21600,,
com.tmsoft.WhiteNoiseLite,24,1738719226,1738719250,1738719250.179645,-21600,EB445137-D7F5-57EC-87DA-1DB460D64046,"iPhone13,2"
com.apple.news,3,1738719206,1738719209,1738719209.2232451,-21600,EB445137-D7F5-57EC-87DA-1DB460D64046,"iPhone13,2"
com.apple.Preview,1675,1738718251,1738719926,1738719927.243675,-21600,,
com.apple.finder,9,1738718242,1738718251,1738718251.274365,-21600,,
com.leomehlig.today,3,1738718239,1738718242,1738718242.4023728,-21600,,
com.google.Chrome,2,1738718237,1738718239,1738718239.6995192,-21600,,
com.apple.finder,92,1738718145,1738718237,1738718237.362355,-21600,,
com.google.Chrome,1311,1738716834,1738718145,1738718145.307831,-21600,,
com.leomehlig.today,3,1738716831,1738716834,1738716834.208363,-21600,,
com.google.Chrome,957,1738715874,1738716831,1738716831.401703,-21600,,
com.leomehlig.today,3,1738715643,1738715646,1738715646.915142,-21600,,
com.google.Chrome,253,1738715390,1738715643,1738715644.0791202,-21600,,
com.apple.news,39,1738715348,1738715387,1738715387.974362,-21600,EB445137-D7F5-57EC-87DA-1DB460D64046,"iPhone13,2"
com.toyopagroup.picaboo,14,1738715326,1738715340,1738715340.543298,-21600,EB445137-D7F5-57EC-87DA-1DB460D64046,"iPhone13,2"
com.leomehlig.today,77,1738715313,1738715390,1738715390.606669,-21600,,
com.apple.finder,3,1738715310,1738715313,1738715313.200457,-21600,,
com.leomehlig.today,13,1738715297,1738715310,1738715310.147002,-21600,,
com.groupme.iphone-app,33,1738714075,1738714108,1738714108.787761,-21600,EB445137-D7F5-57EC-87DA-1DB460D64046,"iPhone13,2"
com.apple.weather,1,1738714074,1738714075,1738714075.8217568,-21600,EB445137-D7F5-57EC-87DA-1DB460D64046,"iPhone13,2"
com.apple.weather,5,1738713302,1738713307,1738713307.9447699,-21600,EB445137-D7F5-57EC-87DA-1DB460D64046,"iPhone13,2"
com.leomehlig.today,2,1738713167,1738713169,1738713170.128792,-21600,,
com.apple.news,74,1738713056,1738713130,1738713130.594164,-21600,EB445137-D7F5-57EC-87DA-1DB460D64046,"iPhone13,2"
com.google.Chrome,177,1738712990,1738713167,1738713167.558199,-21600,,
com.apple.mobilenotes,93,1738712692,1738712785,1738712786.065316,-21600,EB445137-D7F5-57EC-87DA-1DB460D64046,"iPhone13,2"
com.instructure.icanvas,4,1738712664,1738712668,1738712668.303403,-21600,EB445137-D7F5-57EC-87DA-1DB460D64046,"iPhone13,2"
com.microsoft.onenote,35,1738712614,1738712649,1738712649.954598,-21600,EB445137-D7F5-57EC-87DA-1DB460D64046,"iPhone13,2"
com.apple.mobilecal,3,1738712611,1738712614,1738712614.696378,-21600,EB445137-D7F5-57EC-87DA-1DB460D64046,"iPhone13,2"
com.microsoft.onenote,17,1738712594,1738712611,1738712611.9712481,-21600,EB445137-D7F5-57EC-87DA-1DB460D64046,"iPhone13,2"
com.apple.mobilecal,7,1738712587,1738712594,1738712594.574014,-21600,EB445137-D7F5-57EC-87DA-1DB460D64046,"iPhone13,2"
com.apple.CoreAuthUI,2,1738712570,1738712572,1738712574.09451,-21600,EB445137-D7F5-57EC-87DA-1DB460D64046,"iPhone13,2"
com.microsoft.onenote,24,1738712563,1738712587,1738712587.379664,-21600,EB445137-D7F5-57EC-87DA-1DB460D64046,"iPhone13,2"
com.apple.weather,18,1738712485,1738712503,1738712504.149006,-21600,EB445137-D7F5-57EC-87DA-1DB460D64046,"iPhone13,2"
com.apple.news,167,1738712314,1738712481,1738712481.802999,-21600,EB445137-D7F5-57EC-87DA-1DB460D64046,"iPhone13,2"
com.instructure.icanvas,7,1738712300,1738712307,1738712307.984885,-21600,EB445137-D7F5-57EC-87DA-1DB460D64046,"iPhone13,2"
com.microsoft.Office.Outlook,6,1738712291,1738712297,1738712297.977869,-21600,EB445137-D7F5-57EC-87DA-1DB460D64046,"iPhone13,2"
com.groupme.iphone-app,3,1738712284,1738712287,1738712288.0626059,-21600,EB445137-D7F5-57EC-87DA-1DB460D64046,"iPhone13,2"
com.myfitnesspal.mfp,0,1738712284,1738712284,1738712284.9607282,-21600,EB445137-D7F5-57EC-87DA-1DB460D64046,"iPhone13,2"
com.myfitnesspal.mfp,98,1738712004,1738712102,1738712102.673943,-21600,EB445137-D7F5-57EC-87DA-1DB460D64046,"iPhone13,2"
com.google.Chrome,668,1738711996,1738712664,1738712664.5404549,-21600,,
com.google.Chrome,300,1738711637,1738711937,1738711937.345897,-21600,,
com.google.Chrome,321,1738711259,1738711580,1738711580.842447,-21600,,
com.leomehlig.today,8,1738711251,1738711259,1738711259.901523,-21600,,
com.myfitnesspal.mfp,245,1738710837,1738711082,1738711083.189847,-21600,EB445137-D7F5-57EC-87DA-1DB460D64046,"iPhone13,2"
com.leomehlig.today,1,1738710778,1738710779,1738710779.629003,-21600,,
com.microsoft.Excel,2,1738710776,1738710778,1738710778.327553,-21600,,
com.leomehlig.today,45,1738710731,1738710776,1738710776.620934,-21600,,
com.apple.finder,49,1738710682,1738710731,1738710731.726053,-21600,,
com.microsoft.Excel,8,1738710674,1738710682,1738710682.098002,-21600,,
com.google.Chrome,8,1738710666,1738710674,1738710674.628728,-21600,,
com.toyopagroup.picaboo,5,1738709502,1738709507,1738709508.240649,-21600,EB445137-D7F5-57EC-87DA-1DB460D64046,"iPhone13,2"
com.google.Chrome,3,1738709339,1738709342,1738709342.8785791,-21600,,
com.google.Chrome,619,1738708720,1738709339,1738709339.74794,-21600,,
com.google.Chrome,300,1738707877,1738708177,1738708177.448833,-21600,,
com.google.Chrome,757,1738707115,1738707872,1738707872.486336,-21600,,
com.microsoft.Excel,1,1738707114,1738707115,1738707115.419462,-21600,,
com.microsoft.Excel,455,1738705609,1738706064,1738706064.176044,-21600,,
com.microsoft.Excel,306,1738705262,1738705568,1738705568.4944959,-21600,,
com.apple.finder,15,1738705247,1738705262,1738705262.672971,-21600,,
com.google.Chrome,6,1738705241,1738705247,1738705247.572321,-21600,,
com.apple.finder,23,1738705218,1738705241,1738705241.469077,-21600,,
com.google.Chrome,2,1738705216,1738705218,1738705218.6017098,-21600,,
com.leomehlig.today,4,1738705212,1738705216,1738705216.359025,-21600,,
com.google.Chrome,4,1738705208,1738705212,1738705212.7550979,-21600,,
com.microsoft.Powerpoint,3,1738705205,1738705208,1738705208.729123,-21600,,
com.google.Chrome,25,1738705180,1738705205,1738705205.1088948,-21600,,
com.apple.weather,28,1738704930,1738704958,1738704958.5528011,-21600,EB445137-D7F5-57EC-87DA-1DB460D64046,"iPhone13,2"
com.apple.shortcuts,8,1738704896,1738704904,1738704904.739709,-21600,EB445137-D7F5-57EC-87DA-1DB460D64046,"iPhone13,2"
com.google.chrome.ios,0,1738704896,1738704896,1738704896.9453511,-21600,EB445137-D7F5-57EC-87DA-1DB460D64046,"iPhone13,2"
com.google.Chrome,612,1738704294,1738704906,1738704906.788652,-21600,,
com.leomehlig.today,31,1738704263,1738704294,1738704294.196425,-21600,,
com.google.chrome.ios,7,1738703328,1738703335,1738703336.629047,-21600,EB445137-D7F5-57EC-87DA-1DB460D64046,"iPhone13,2"
com.groupme.iphone-app,12,1738703316,1738703328,1738703328.972276,-21600,EB445137-D7F5-57EC-87DA-1DB460D64046,"iPhone13,2"
com.google.Chrome,965,1738703298,1738704263,1738704263.393255,-21600,,
com.instructure.icanvas,216,1738703099,1738703315,1738703315.9349818,-21600,EB445137-D7F5-57EC-87DA-1DB460D64046,"iPhone13,2"
com.google.Chrome,64,1738698061,1738698125,1738698125.955676,-21600,,
com.leomehlig.today,1,1738698039,1738698040,1738698040.843602,-21600,,
com.groupme.iphone-app,59,1738697635,1738697694,1738697694.9660149,-21600,EB445137-D7F5-57EC-87DA-1DB460D64046,"iPhone13,2"
com.microsoft.Office.Outlook,27,1738697604,1738697631,1738697631.904951,-21600,EB445137-D7F5-57EC-87DA-1DB460D64046,"iPhone13,2"
com.microsoft.VSCode,449,1738697590,1738698039,1738698039.928101,-21600,,
com.leomehlig.today,105,1738697485,1738697590,1738697590.719372,-21600,,
com.apple.Preview,1298,1738696187,1738697485,1738697485.245892,-21600,,
com.apple.finder,1,1738696186,1738696187,1738696187.199809,-21600,,
com.apple.Preview,5,1738696181,1738696186,1738696186.198709,-21600,,
com.apple.finder,6,1738696175,1738696181,1738696181.147186,-21600,,
com.leomehlig.today,284,1738695891,1738696175,1738696175.692383,-21600,,
com.leomehlig.today,9,1738692103,1738692112,1738692112.956524,-21600,,
com.google.Chrome,20,1738692083,1738692103,1738692103.048634,-21600,,
com.instructure.icanvas,8,1738691757,1738691765,1738691765.207706,-21600,EB445137-D7F5-57EC-87DA-1DB460D64046,"iPhone13,2"
com.microsoft.Office.Outlook,13,1738691744,1738691757,1738691757.297821,-21600,EB445137-D7F5-57EC-87DA-1DB460D64046,"iPhone13,2"
com.apple.weather,8,1738691734,1738691742,1738691742.1185498,-21600,EB445137-D7F5-57EC-87DA-1DB460D64046,"iPhone13,2"
com.google.Chrome,339,1738691565,1738691904,1738691904.65548,-21600,,
com.apple.news,143,1738691499,1738691642,1738691642.32147,-21600,EB445137-D7F5-57EC-87DA-1DB460D64046,"iPhone13,2"
com.truebill.truebillnative,78,1738691344,1738691422,1738691422.287722,-21600,EB445137-D7F5-57EC-87DA-1DB460D64046,"iPhone13,2"
com.apple.CoreAuthUI,3,1738691333,1738691336,1738691336.441001,-21600,EB445137-D7F5-57EC-87DA-1DB460D64046,"iPhone13,2"
com.robinhood.release.Robinhood,13,1738691331,1738691344,1738691344.203028,-21600,EB445137-D7F5-57EC-87DA-1DB460D64046,"iPhone13,2"
com.apple.CoreAuthUI,5,1738691290,1738691295,1738691295.7981439,-21600,EB445137-D7F5-57EC-87DA-1DB460D64046,"iPhone13,2"
com.truebill.truebillnative,40,1738691286,1738691326,1738691326.878083,-21600,EB445137-D7F5-57EC-87DA-1DB460D64046,"iPhone13,2"
com.myfitnesspal.mfp,168,1738691115,1738691283,1738691283.561956,-21600,EB445137-D7F5-57EC-87DA-1DB460D64046,"iPhone13,2"
com.apple.news,201,1738690887,1738691088,1738691088.501885,-21600,EB445137-D7F5-57EC-87DA-1DB460D64046,"iPhone13,2"
com.google.Chrome,326,1738690768,1738691094,1738691094.172678,-21600,,
com.google.Chrome,6,1738690385,1738690391,1738690392.00212,-21600,,
com.leomehlig.today,43,1738690342,1738690385,1738690385.0750751,-21600,,
com.google.Chrome,675,1738689667,1738690342,1738690342.9176168,-21600,,
com.leomehlig.today,7,1738689660,1738689667,1738689667.60025,-21600,,
com.google.Chrome,201,1738689459,1738689660,1738689661.038447,-21600,,
com.apple.finder,1,1738689458,1738689459,1738689460.004684,-21600,,
com.leomehlig.today,1,1738689457,1738689458,1738689458.5393,-21600,,
com.google.Chrome,732,1738688725,1738689457,1738689457.5726628,-21600,,
com.leomehlig.today,1,1738688724,1738688725,1738688725.419358,-21600,,
com.google.Chrome,6,1738688718,1738688724,1738688724.778856,-21600,,
com.leomehlig.today,1,1738688717,1738688718,1738688718.525259,-21600,,
com.google.Chrome,40,1738688677,1738688717,1738688717.892702,-21600,,
com.leomehlig.today,0,1738688677,1738688677,1738688677.7901502,-21600,,
com.google.Chrome,8,1738688669,1738688677,1738688677.1377568,-21600,,
com.leomehlig.today,0,1738688669,1738688669,1738688669.6436691,-21600,,
com.google.Chrome,625,1738688044,1738688669,1738688669.2095308,-21600,,
com.instructure.icanvas,181,1738687231,1738687412,1738687412.9304628,-21600,EB445137-D7F5-57EC-87DA-1DB460D64046,"iPhone13,2"
com.apple.MobileSMS,0,1738687231,1738687231,1738687232.286499,-21600,EB445137-D7F5-57EC-87DA-1DB460D64046,"iPhone13,2"
com.google.Chrome,808,1738687209,1738688017,1738688017.881398,-21600,,
com.leomehlig.today,23,1738687186,1738687209,1738687209.499782,-21600,,
com.google.Chrome,800,1738686386,1738687186,1738687186.507924,-21600,,
com.leomehlig.today,38,1738686348,1738686386,1738686387.0257769,-21600,,
com.apple.Preview,522,1738685826,1738686348,1738686348.462933,-21600,,
com.apple.MobileSMS,2,1738685762,1738685764,1738685765.3542352,-21600,EB445137-D7F5-57EC-87DA-1DB460D64046,"iPhone13,2"
com.apple.Health,0,1738685762,1738685762,1738685763.375101,-21600,EB445137-D7F5-57EC-87DA-1DB460D64046,"iPhone13,2"
com.apple.Health,12,1738684370,1738684382,1738684382.199856,-21600,EB445137-D7F5-57EC-87DA-1DB460D64046,"iPhone13,2"
com.leomehlig.today,12,1738684353,1738684365,1738684365.7939072,-21600,EB445137-D7F5-57EC-87DA-1DB460D64046,"iPhone13,2"
com.leomehlig.today,27,1738684123,1738684150,1738684150.543046,-21600,EB445137-D7F5-57EC-87DA-1DB460D64046,"iPhone13,2"
com.instructure.icanvas,17,1738684098,1738684115,1738684116.048913,-21600,EB445137-D7F5-57EC-87DA-1DB460D64046,"iPhone13,2"
com.instructure.icanvas,15,1738684068,1738684083,1738684083.483742,-21600,EB445137-D7F5-57EC-87DA-1DB460D64046,"iPhone13,2"
com.apple.mobileslideshow,0,1738684068,1738684068,1738684068.836516,-21600,EB445137-D7F5-57EC-87DA-1DB460D64046,"iPhone13,2"
com.apple.Preview,336,1738683639,1738683975,1738683976.013195,-21600,,
com.apple.Preview,302,1738683209,1738683511,1738683511.5191178,-21600,,
com.apple.Preview,524,1738682683,1738683207,1738683207.4866738,-21600,,
com.apple.Preview,299,1738681927,1738682226,1738682226.819659,-21600,,
com.apple.finder,5,1738681922,1738681927,1738681927.139511,-21600,,
com.google.Chrome,1,1738681921,1738681922,1738681922.3748732,-21600,,
com.apple.mobileslideshow,33,1738681729,1738681762,1738681762.263114,-21600,EB445137-D7F5-57EC-87DA-1DB460D64046,"iPhone13,2"
com.apple.MobileSMS,8,1738681457,1738681465,1738681465.896791,-21600,EB445137-D7F5-57EC-87DA-1DB460D64046,"iPhone13,2"
com.groupme.iphone-app,31,1738681425,1738681456,1738681457.052779,-21600,EB445137-D7F5-57EC-87DA-1DB460D64046,"iPhone13,2"
com.apple.MobileSMS,4,1738681417,1738681421,1738681421.890726,-21600,EB445137-D7F5-57EC-87DA-1DB460D64046,"iPhone13,2"
com.apple.MobileSMS,20,1738680985,1738681005,1738681006.051378,-21600,EB445137-D7F5-57EC-87DA-1DB460D64046,"iPhone13,2"
com.apple.weather,0,1738680985,1738680985,1738680985.971993,-21600,EB445137-D7F5-57EC-87DA-1DB460D64046,"iPhone13,2"
com.apple.weather,6,1738680909,1738680915,1738680915.3566818,-21600,EB445137-D7F5-57EC-87DA-1DB460D64046,"iPhone13,2"
com.renpho.health,1,1738680908,1738680909,1738680909.723623,-21600,EB445137-D7F5-57EC-87DA-1DB460D64046,"iPhone13,2"
com.renpho.health,63,1738679877,1738679940,1738679940.3556418,-21600,EB445137-D7F5-57EC-87DA-1DB460D64046,"iPhone13,2"
com.apple.CoreAuthUI,3,1738647522,1738647525,1738647525.209424,-21600,EB445137-D7F5-57EC-87DA-1DB460D64046,"iPhone13,2"
com.apple.journal,890,1738647521,1738648411,1738648411.354836,-21600,EB445137-D7F5-57EC-87DA-1DB460D64046,"iPhone13,2"
com.apple.Health,31,1738647486,1738647517,1738647518.027493,-21600,EB445137-D7F5-57EC-87DA-1DB460D64046,"iPhone13,2"
com.apple.news,0,1738647486,1738647486,1738647487.1327848,-21600,EB445137-D7F5-57EC-87DA-1DB460D64046,"iPhone13,2"
com.google.Chrome,122,1738647177,1738647299,1738647300.100003,-21600,,
com.google.Chrome,998,1738645556,1738646554,1738646554.4619641,-21600,,
com.apple.finder,1,1738645555,1738645556,1738645556.2391381,-21600,,
com.apple.Notes,2,1738645553,1738645555,1738645555.871634,-21600,,
com.google.Chrome,1,1738645552,1738645553,1738645553.428773,-21600,,
com.apple.finder,1,1738645551,1738645552,1738645552.531601,-21600,,
com.google.Chrome,77,1738645474,1738645551,1738645551.19648,-21600,,
com.apple.finder,1,1738645473,1738645474,1738645474.351341,-21600,,
com.microsoft.VSCode,80,1738645393,1738645473,1738645473.172585,-21600,,
com.google.Chrome,5,1738645388,1738645393,1738645393.824445,-21600,,
com.microsoft.VSCode,1,1738645387,1738645388,1738645388.531536,-21600,,
com.google.Chrome,23,1738645364,1738645387,1738645387.224391,-21600,,
com.microsoft.VSCode,2,1738645362,1738645364,1738645364.367208,-21600,,
com.google.Chrome,11,1738645351,1738645362,1738645362.129045,-21600,,
com.microsoft.VSCode,2,1738645349,1738645351,1738645351.7564502,-21600,,
com.google.Chrome,1,1738645348,1738645349,1738645349.7741709,-21600,,
com.microsoft.VSCode,2,1738645346,1738645348,1738645348.048449,-21600,,
com.google.Chrome,27,1738645319,1738645346,1738645346.869048,-21600,,
com.microsoft.VSCode,2,1738645317,1738645319,1738645319.1096768,-21600,,
com.google.Chrome,215,1738645102,1738645317,1738645317.5819302,-21600,,
com.microsoft.VSCode,39,1738645063,1738645102,1738645102.27074,-21600,,
com.google.Chrome,1,1738645062,1738645063,1738645064.033782,-21600,,
com.microsoft.VSCode,2,1738645060,1738645062,1738645062.772882,-21600,,
com.google.Chrome,17,1738645043,1738645060,1738645061.0175261,-21600,,
com.microsoft.VSCode,2,1738645041,1738645043,1738645043.7169771,-21600,,
com.google.Chrome,1,1738645040,1738645041,1738645041.621923,-21600,,
com.microsoft.VSCode,1,1738645039,1738645040,1738645040.572675,-21600,,
com.google.Chrome,8,1738645031,1738645039,1738645039.6208692,-21600,,
com.microsoft.VSCode,2,1738645029,1738645031,1738645031.571255,-21600,,
com.apple.news,75,1738644956,1738645031,1738645031.7159672,-21600,EB445137-D7F5-57EC-87DA-1DB460D64046,"iPhone13,2"
com.google.Chrome,205,1738644824,1738645029,1738645029.840723,-21600,,
com.microsoft.VSCode,111,1738644713,1738644824,1738644824.8995972,-21600,,
com.google.Chrome,29,1738644684,1738644713,1738644713.667911,-21600,,
com.microsoft.VSCode,2,1738644682,1738644684,1738644684.481642,-21600,,
com.google.Chrome,28,1738644654,1738644682,1738644682.877336,-21600,,
com.microsoft.VSCode,2,1738644652,1738644654,1738644654.192421,-21600,,
com.google.Chrome,28,1738644624,1738644652,1738644652.4985209,-21600,,
com.microsoft.VSCode,2,1738644622,1738644624,1738644624.263031,-21600,,
com.google.Chrome,2,1738644620,1738644622,1738644622.5229092,-21600,,
com.microsoft.VSCode,3,1738644617,1738644620,1738644620.320894,-21600,,
com.google.Chrome,179,1738644438,1738644617,1738644617.933803,-21600,,
com.microsoft.VSCode,26,1738644412,1738644438,1738644438.545639,-21600,,
com.google.Chrome,12,1738644400,1738644412,1738644412.730929,-21600,,
com.microsoft.VSCode,1,1738644399,1738644400,1738644400.501869,-21600,,
com.google.Chrome,1,1738644398,1738644399,1738644399.139216,-21600,,
com.microsoft.VSCode,27,1738644371,1738644398,1738644398.052324,-21600,,
com.google.Chrome,20,1738644351,1738644371,1738644371.1324182,-21600,,
com.microsoft.VSCode,2,1738644349,1738644351,1738644352.013761,-21600,,
com.google.Chrome,31,1738644318,1738644349,1738644349.647562,-21600,,
com.microsoft.VSCode,5,1738644313,1738644318,1738644318.536727,-21600,,
com.apple.news,152,1738644157,1738644309,1738644309.265472,-21600,EB445137-D7F5-57EC-87DA-1DB460D64046,"iPhone13,2"
com.google.Chrome,215,1738644098,1738644313,1738644313.822321,-21600,,
com.microsoft.VSCode,19,1738644079,1738644098,1738644098.472959,-21600,,
com.google.Chrome,25,1738644054,1738644079,1738644079.7968102,-21600,,
com.microsoft.VSCode,165,1738643889,1738644054,1738644054.1690679,-21600,,
com.google.Chrome,0,1738643889,1738643889,1738643889.923857,-21600,,
com.microsoft.VSCode,46,1738643843,1738643889,1738643889.269174,-21600,,
com.google.Chrome,1,1738643842,1738643843,1738643843.5209398,-21600,,
com.microsoft.VSCode,1,1738643841,1738643842,1738643842.207478,-21600,,
com.apple.Music,3,1738643830,1738643833,1738643833.0938148,-21600,EB445137-D7F5-57EC-87DA-1DB460D64046,"iPhone13,2"
com.google.Chrome,22,1738643819,1738643841,1738643841.370806,-21600,,
com.microsoft.VSCode,2,1738643817,1738643819,1738643819.550091,-21600,,
com.google.Chrome,19,1738643798,1738643817,1738643817.492652,-21600,,
com.microsoft.VSCode,1,1738643797,1738643798,1738643798.083261,-21600,,
com.google.Chrome,16,1738643781,1738643797,1738643797.028192,-21600,,
com.microsoft.VSCode,1,1738643780,1738643781,1738643781.219071,-21600,,
com.google.Chrome,5,1738643775,1738643780,1738643780.230356,-21600,,
com.microsoft.VSCode,4,1738643771,1738643775,1738643775.092373,-21600,,
com.google.Chrome,18,1738643753,1738643771,1738643771.5246,-21600,,
com.microsoft.VSCode,1,1738643752,1738643753,1738643753.726057,-21600,,
com.leomehlig.today,7,1738643745,1738643752,1738643752.504992,-21600,,
com.apple.Music,6,1738642797,1738642803,1738642803.297895,-21600,EB445137-D7F5-57EC-87DA-1DB460D64046,"iPhone13,2"
com.microsoft.VSCode,963,1738642782,1738643745,1738643745.947259,-21600,,
com.apple.Music,5,1738642777,1738642782,1738642783.010116,-21600,,
com.microsoft.VSCode,411,1738642366,1738642777,1738642777.6086721,-21600,,
com.leomehlig.today,2,1738642364,1738642366,1738642366.224716,-21600,,
com.apple.Music,29,1738640415,1738640444,1738640445.59389,-21600,EB445137-D7F5-57EC-87DA-1DB460D64046,"iPhone13,2"
com.leomehlig.today,37,1738640137,1738640174,1738640177.0161982,-21600,,
com.apple.Notes,43,1738640094,1738640137,1738640137.2961102,-21600,,
com.leomehlig.today,28,1738640066,1738640094,1738640094.594845,-21600,,
com.google.Chrome,61,1738640005,1738640066,1738640066.8340921,-21600,,
com.leomehlig.today,4,1738639871,1738639875,1738639875.5394459,-21600,,
com.google.Chrome,18,1738639853,1738639871,1738639871.625099,-21600,,
com.myfitnesspal.mfp,15,1738639749,1738639764,1738639765.118628,-21600,EB445137-D7F5-57EC-87DA-1DB460D64046,"iPhone13,2"
com.apple.Health,4,1738639745,1738639749,1738639749.434667,-21600,EB445137-D7F5-57EC-87DA-1DB460D64046,"iPhone13,2"
com.myfitnesspal.mfp,16,1738639729,1738639745,1738639745.423616,-21600,EB445137-D7F5-57EC-87DA-1DB460D64046,"iPhone13,2"
com.apple.Health,20,1738639709,1738639729,1738639729.885604,-21600,EB445137-D7F5-57EC-87DA-1DB460D64046,"iPhone13,2"
com.myfitnesspal.mfp,14,1738639693,1738639707,1738639707.359304,-21600,EB445137-D7F5-57EC-87DA-1DB460D64046,"iPhone13,2"
com.toyopagroup.picaboo,13,1738639674,1738639687,1738639687.609305,-21600,EB445137-D7F5-57EC-87DA-1DB460D64046,"iPhone13,2"
com.apple.weather,13,1738639571,1738639584,1738639584.222632,-21600,EB445137-D7F5-57EC-87DA-1DB460D64046,"iPhone13,2"
com.microsoft.Office.Outlook,2,1738639569,1738639571,1738639573.504088,-21600,EB445137-D7F5-57EC-87DA-1DB460D64046,"iPhone13,2"
com.microsoft.VSCode,516,1738639337,1738639853,1738639853.9043689,-21600,,
com.google.Chrome,72,1738639265,1738639337,1738639337.220376,-21600,,
com.microsoft.Office.Outlook,11,1738638993,1738639004,1738639004.956935,-21600,EB445137-D7F5-57EC-87DA-1DB460D64046,"iPhone13,2"
com.microsoft.Office.Outlook,9,1738638983,1738638992,1738638992.766381,-21600,EB445137-D7F5-57EC-87DA-1DB460D64046,"iPhone13,2"
com.microsoft.VSCode,728,1738638537,1738639265,1738639265.981005,-21600,,
com.google.Chrome,5,1738638532,1738638537,1738638537.853784,-21600,,
com.microsoft.VSCode,53,1738638479,1738638532,1738638532.5746531,-21600,,
com.google.Chrome,5,1738638474,1738638479,1738638480.000623,-21600,,
com.microsoft.VSCode,5,1738638469,1738638474,1738638474.667694,-21600,,
com.google.Chrome,28,1738638441,1738638469,1738638469.905017,-21600,,
com.microsoft.VSCode,168,1738638273,1738638441,1738638441.551652,-21600,,
com.google.Chrome,7,1738638266,1738638273,1738638273.455848,-21600,,
com.microsoft.VSCode,2,1738638264,1738638266,1738638266.391681,-21600,,
com.google.Chrome,1,1738638263,1738638264,1738638264.9382029,-21600,,
com.microsoft.VSCode,346,1738637917,1738638263,1738638263.942109,-21600,,
com.apple.finder,3,1738637914,1738637917,1738637917.805952,-21600,,
com.microsoft.VSCode,4,1738637910,1738637914,1738637915.033701,-21600,,
com.apple.finder,2,1738637908,1738637910,1738637910.123438,-21600,,
com.microsoft.VSCode,38,1738637870,1738637908,1738637908.386045,-21600,,
com.apple.finder,0,1738637870,1738637870,1738637870.888894,-21600,,
com.microsoft.VSCode,7,1738637863,1738637870,1738637870.440658,-21600,,
com.apple.finder,2,1738637861,1738637863,1738637863.636862,-21600,,
com.microsoft.VSCode,1,1738637860,1738637861,1738637861.8331451,-21600,,
com.apple.finder,3,1738637857,1738637860,1738637860.5026278,-21600,,
com.microsoft.VSCode,6,1738637851,1738637857,1738637857.264625,-21600,,
com.apple.finder,13,1738637838,1738637851,1738637851.975121,-21600,,
com.microsoft.VSCode,80,1738637758,1738637838,1738637838.544695,-21600,,
com.apple.finder,3,1738637755,1738637758,1738637758.324328,-21600,,
com.microsoft.VSCode,2,1738637753,1738637755,1738637755.744241,-21600,,
com.google.Chrome,54,1738637699,1738637753,1738637754.031365,-21600,,
com.microsoft.VSCode,87,1738637612,1738637699,1738637699.098347,-21600,,
com.google.Chrome,1,1738637611,1738637612,1738637612.485851,-21600,,
com.microsoft.VSCode,2,1738637609,1738637611,1738637611.4137201,-21600,,
com.google.Chrome,2,1738637607,1738637609,1738637609.182539,-21600,,
com.microsoft.VSCode,38,1738637569,1738637607,1738637607.177398,-21600,,
com.google.Chrome,15,1738637554,1738637569,1738637569.516649,-21600,,
com.microsoft.VSCode,8,1738637546,1738637554,1738637554.399389,-21600,,
com.google.Chrome,77,1738637469,1738637546,1738637546.476945,-21600,,
com.microsoft.VSCode,17,1738637452,1738637469,1738637469.057056,-21600,,
com.google.Chrome,6,1738637446,1738637452,1738637452.35882,-21600,,
com.microsoft.VSCode,39,1738637407,1738637446,1738637446.976511,-21600,,
com.google.Chrome,20,1738637387,1738637407,1738637407.845708,-21600,,
com.microsoft.VSCode,2,1738637385,1738637387,1738637387.0795388,-21600,,
com.google.Chrome,53,1738637332,1738637385,1738637386.0425758,-21600,,
com.microsoft.VSCode,3,1738637329,1738637332,1738637333.022239,-21600,,
com.google.Chrome,4,1738637325,1738637329,1738637329.338478,-21600,,
com.microsoft.VSCode,45,1738637280,1738637325,1738637325.9547749,-21600,,
com.google.Chrome,9,1738637271,1738637280,1738637280.544308,-21600,,
com.microsoft.VSCode,125,1738637146,1738637271,1738637272.038465,-21600,,
com.google.Chrome,3,1738637143,1738637146,1738637146.993649,-21600,,
com.microsoft.VSCode,2,1738637141,1738637143,1738637143.990869,-21600,,
com.google.Chrome,2,1738637139,1738637141,1738637141.1284041,-21600,,
com.microsoft.VSCode,5,1738637134,1738637139,1738637139.888517,-21600,,
com.google.Chrome,5,1738637129,1738637134,1738637134.6152868,-21600,,
com.microsoft.VSCode,4,1738637125,1738637129,1738637129.796828,-21600,,
com.google.Chrome,2,1738637123,1738637125,1738637125.316298,-21600,,
com.microsoft.VSCode,3,1738637120,1738637123,1738637124.0199661,-21600,,
com.google.Chrome,1,1738637119,1738637120,1738637120.121422,-21600,,
com.microsoft.VSCode,4,1738637115,1738637119,1738637119.286868,-21600,,
com.google.Chrome,13,1738637102,1738637115,1738637115.186345,-21600,,
com.microsoft.VSCode,84,1738637018,1738637102,1738637102.218096,-21600,,
com.google.Chrome,12,1738637006,1738637018,1738637018.59093,-21600,,
com.microsoft.VSCode,1,1738637005,1738637006,1738637006.221791,-21600,,
com.google.Chrome,10,1738636995,1738637005,1738637005.065579,-21600,,
com.microsoft.VSCode,311,1738636684,1738636995,1738636995.7872481,-21600,,
com.google.Chrome,4,1738636680,1738636684,1738636684.396914,-21600,,
com.apple.finder,7,1738636673,1738636680,1738636680.444355,-21600,,
com.google.Chrome,247,1738636426,1738636673,1738636673.728094,-21600,,
com.apple.finder,2,1738636424,1738636426,1738636426.189608,-21600,,
com.google.Chrome,99,1738636325,1738636424,1738636424.514389,-21600,,
com.apple.Preview,19,1738636306,1738636325,1738636325.373987,-21600,,
com.apple.finder,7,1738636299,1738636306,1738636306.378988,-21600,,
com.google.Chrome,11,1738636288,1738636299,1738636299.828835,-21600,,
com.leomehlig.today,10,1738636278,1738636288,1738636288.965179,-21600,,
com.leomehlig.today,62,1738636103,1738636165,1738636165.7339559,-21600,,
com.apple.finder,24,1738636079,1738636103,1738636103.4918342,-21600,,
com.leomehlig.today,79,1738636000,1738636079,1738636079.4923801,-21600,,
com.apple.Notes,201,1738635799,1738636000,1738636000.3375092,-21600,,
com.apple.shortcuts,200,1738635796,1738635996,1738635996.583538,-21600,EB445137-D7F5-57EC-87DA-1DB460D64046,"iPhone13,2"
com.apple.shortcuts,11,1738635788,1738635799,1738635799.588739,-21600,,
com.apple.mobilecal,96,1738635700,1738635796,1738635796.417361,-21600,EB445137-D7F5-57EC-87DA-1DB460D64046,"iPhone13,2"
com.apple.shortcuts,1,1738635693,1738635694,1738635694.466844,-21600,EB445137-D7F5-57EC-87DA-1DB460D64046,"iPhone13,2"
com.google.Chrome,109,1738635679,1738635788,1738635788.6569061,-21600,,
com.apple.shortcuts,2,1738635665,1738635667,1738635667.117371,-21600,,
com.apple.Notes,8,1738635657,1738635665,1738635665.670905,-21600,,
com.apple.shortcuts,47,1738635610,1738635657,1738635657.619668,-21600,,
com.apple.Notes,7,1738635603,1738635610,1738635610.476165,-21600,,
com.apple.shortcuts,91,1738635512,1738635603,1738635603.846105,-21600,,
com.apple.Notes,7,1738635505,1738635512,1738635512.1531081,-21600,,
com.apple.shortcuts,60,1738635445,1738635505,1738635505.9277592,-21600,,
com.apple.Notes,1,1738635444,1738635445,1738635446.039514,-21600,,
com.apple.shortcuts,19,1738635425,1738635444,1738635444.7970638,-21600,,
com.apple.Notes,9,1738635416,1738635425,1738635425.700566,-21600,,
com.apple.shortcuts,67,1738635349,1738635416,1738635416.6050181,-21600,,
com.apple.Notes,15,1738635334,1738635349,1738635349.093241,-21600,,
com.apple.shortcuts,107,1738635279,1738635386,1738635386.7458038,-21600,EB445137-D7F5-57EC-87DA-1DB460D64046,"iPhone13,2"
com.apple.shortcuts,149,1738635185,1738635334,1738635334.3730679,-21600,,
com.google.Chrome,8,1738635177,1738635185,1738635185.53167,-21600,,
com.apple.shortcuts,102,1738635127,1738635229,1738635229.641231,-21600,EB445137-D7F5-57EC-87DA-1DB460D64046,"iPhone13,2"
com.apple.Preferences,16,1738635111,1738635127,1738635127.5289168,-21600,EB445137-D7F5-57EC-87DA-1DB460D64046,"iPhone13,2"
com.apple.shortcuts,2,1738635109,1738635111,1738635111.810213,-21600,EB445137-D7F5-57EC-87DA-1DB460D64046,"iPhone13,2"
com.apple.Preferences,21,1738635088,1738635109,1738635109.411879,-21600,EB445137-D7F5-57EC-87DA-1DB460D64046,"iPhone13,2"
com.apple.shortcuts,75,1738635013,1738635088,1738635088.441263,-21600,EB445137-D7F5-57EC-87DA-1DB460D64046,"iPhone13,2"
com.apple.shortcuts,200,1738634977,1738635177,1738635177.417426,-21600,,
com.leomehlig.today,60,1738634917,1738634977,1738634977.74009,-21600,,
com.apple.Preview,1017,1738633900,1738634917,1738634917.716949,-21600,,
com.apple.finder,4,1738633896,1738633900,1738633900.162507,-21600,,
com.google.Chrome,19,1738633877,1738633896,1738633896.9248152,-21600,,
com.apple.finder,2,1738633875,1738633877,1738633877.788043,-21600,,
com.google.Chrome,5,1738633870,1738633875,1738633875.2342381,-21600,,
com.apple.finder,2,1738633868,1738633870,1738633870.2085671,-21600,,
com.google.Chrome,33,1738633835,1738633868,1738633868.077691,-21600,,
com.apple.finder,4,1738633831,1738633835,1738633835.056548,-21600,,
com.google.Chrome,1,1738633830,1738633831,1738633831.441628,-21600,,
com.apple.finder,0,1738633830,1738633830,1738633830.925757,-21600,,
com.google.Chrome,156,1738633674,1738633830,1738633830.3971992,-21600,,
com.apple.finder,1,1738633673,1738633674,1738633674.532538,-21600,,
com.google.Chrome,57,1738633616,1738633673,1738633673.1340408,-21600,,
com.apple.finder,4,1738633612,1738633616,1738633616.53446,-21600,,
com.leomehlig.today,1,1738633611,1738633612,1738633612.4723291,-21600,,
com.google.Chrome,181,1738633430,1738633611,1738633611.35609,-21600,,
com.leomehlig.today,10,1738633420,1738633430,1738633430.85267,-21600,,
com.google.Chrome,80,1738633340,1738633420,1738633420.774932,-21600,,
com.apple.finder,3,1738633337,1738633340,1738633340.995969,-21600,,
com.google.Chrome,13,1738633324,1738633337,1738633337.653211,-21600,,
com.apple.finder,3,1738633321,1738633324,1738633324.660399,-21600,,
com.google.Chrome,46,1738633275,1738633321,1738633321.9270868,-21600,,
com.apple.finder,1,1738633274,1738633275,1738633275.83629,-21600,,
com.google.Chrome,5,1738633269,1738633274,1738633274.606467,-21600,,
com.apple.finder,0,1738633269,1738633269,1738633269.936623,-21600,,
com.google.Chrome,3,1738633266,1738633269,1738633269.1189818,-21600,,
com.apple.finder,2,1738633264,1738633266,1738633266.493695,-21600,,
com.google.Chrome,17,1738633247,1738633264,1738633264.711752,-21600,,
com.apple.finder,2,1738633245,1738633247,1738633247.8274589,-21600,,
com.google.Chrome,14,1738633231,1738633245,1738633245.658629,-21600,,
com.apple.finder,5,1738633226,1738633231,1738633232.029701,-21600,,
com.google.Chrome,5,1738633221,1738633226,1738633226.92605,-21600,,
com.apple.finder,8,1738633213,1738633221,1738633221.078669,-21600,,
com.leomehlig.today,2,1738633211,1738633213,1738633213.923106,-21600,,
com.apple.finder,1,1738633210,1738633211,1738633211.442432,-21600,,
com.google.Chrome,143,1738633067,1738633210,1738633210.636976,-21600,,
com.apple.finder,10,1738633057,1738633067,1738633067.45682,-21600,,
com.google.Chrome,610,1738632447,1738633057,1738633057.803671,-21600,,
com.apple.Preview,1,1738632446,1738632447,1738632447.718902,-21600,,
com.google.Chrome,1,1738632445,1738632446,1738632446.8066049,-21600,,
com.leomehlig.today,2,1738632443,1738632445,1738632445.550895,-21600,,
com.google.Chrome,1,1738632442,1738632443,1738632443.954225,-21600,,
com.leomehlig.today,1,1738632441,1738632442,1738632442.341728,-21600,,
com.google.Chrome,3,1738632438,1738632441,1738632441.28301,-21600,,
com.leomehlig.today,1,1738632437,1738632438,1738632439.038507,-21600,,
com.google.Chrome,560,1738631877,1738632437,1738632438.058272,-21600,,
com.apple.Preview,4,1738631873,1738631877,1738631877.55035,-21600,,
com.google.Chrome,51,1738631822,1738631873,1738631873.8700728,-21600,,
com.apple.Preview,876,1738630946,1738631822,1738631822.56479,-21600,,
com.apple.Preview,301,1738630640,1738630941,1738630941.920051,-21600,,
com.apple.Preview,301,1738630161,1738630462,1738630462.969954,-21600,,
com.apple.finder,5,1738630156,1738630161,1738630161.600008,-21600,,
com.leomehlig.today,3,1738630153,1738630156,1738630156.501762,-21600,,
com.apple.Health,14,1738630139,1738630153,1738630153.8586268,-21600,EB445137-D7F5-57EC-87DA-1DB460D64046,"iPhone13,2"
com.leomehlig.today,14,1738630022,1738630036,1738630036.372943,-21600,,
com.google.Chrome,74,1738629948,1738630022,1738630022.3802772,-21600,,
com.microsoft.Word,2,1738629946,1738629948,1738629948.7806711,-21600,,
com.apple.finder,21,1738629925,1738629946,1738629946.9561582,-21600,,
com.apple.Preview,28,1738629897,1738629925,1738629925.83184,-21600,,
com.apple.finder,1,1738629896,1738629897,1738629897.297101,-21600,,
com.apple.Preview,3,1738629893,1738629896,1738629896.485822,-21600,,
com.apple.finder,12,1738629881,1738629893,1738629893.9545689,-21600,,
com.microsoft.Word,23,1738629858,1738629881,1738629881.759269,-21600,,
com.google.Chrome,1,1738629857,1738629858,1738629858.167443,-21600,,
com.apple.finder,1,1738629856,1738629857,1738629857.4663591,-21600,,
com.google.Chrome,21,1738629835,1738629856,1738629856.046797,-21600,,
com.microsoft.Word,11,1738629824,1738629835,1738629836.014153,-21600,,
com.google.Chrome,3,1738629821,1738629824,1738629824.382865,-21600,,
com.microsoft.Word,19,1738629802,1738629821,1738629821.107852,-21600,,
com.google.Chrome,4,1738629798,1738629802,1738629802.78528,-21600,,
com.microsoft.Word,9,1738629789,1738629798,1738629798.185755,-21600,,
com.google.Chrome,5,1738629784,1738629789,1738629789.987237,-21600,,
com.microsoft.Word,4,1738629780,1738629784,1738629784.256079,-21600,,
com.google.Chrome,0,1738629780,1738629780,1738629780.996499,-21600,,
com.microsoft.Word,8,1738629772,1738629780,1738629780.29197,-21600,,
com.google.Chrome,17,1738629755,1738629772,1738629772.94594,-21600,,
com.microsoft.Word,5,1738629750,1738629755,1738629755.838105,-21600,,
com.google.Chrome,23,1738629727,1738629750,1738629750.34898,-21600,,
com.microsoft.Word,6,1738629721,1738629727,1738629727.394278,-21600,,
com.google.Chrome,158,1738629563,1738629721,1738629722.035133,-21600,,
com.microsoft.Word,8,1738629555,1738629563,1738629563.593676,-21600,,
com.google.Chrome,344,1738629211,1738629555,1738629555.496248,-21600,,
com.microsoft.Word,10,1738629201,1738629211,1738629212.0042129,-21600,,
com.google.Chrome,78,1738629123,1738629201,1738629201.244825,-21600,,
com.microsoft.Word,3,1738629120,1738629123,1738629123.730836,-21600,,
com.google.Chrome,131,1738628989,1738629120,1738629120.578971,-21600,,
com.microsoft.Word,6,1738628983,1738628989,1738628990.066606,-21600,,
com.google.Chrome,13,1738628970,1738628983,1738628983.473946,-21600,,
com.microsoft.Word,1,1738628969,1738628970,1738628970.7870278,-21600,,
com.google.Chrome,9,1738628960,1738628969,1738628969.267266,-21600,,
com.microsoft.Word,1,1738628959,1738628960,1738628960.364461,-21600,,
com.google.Chrome,2,1738628957,1738628959,1738628959.5541391,-21600,,
com.microsoft.Word,12,1738628945,1738628957,1738628957.660063,-21600,,
com.google.Chrome,6,1738628939,1738628945,1738628945.859291,-21600,,
com.microsoft.Word,355,1738628584,1738628939,1738628939.900212,-21600,,
com.google.Chrome,4,1738628580,1738628584,1738628584.778182,-21600,,
com.microsoft.Word,774,1738627806,1738628580,1738628580.5356221,-21600,,
com.google.Chrome,68,1738627738,1738627806,1738627806.62448,-21600,,
com.microsoft.Word,8,1738627730,1738627738,1738627738.627109,-21600,,
com.google.Chrome,1,1738627729,1738627730,1738627730.470499,-21600,,
com.microsoft.Word,3,1738627726,1738627729,1738627729.069298,-21600,,
com.google.Chrome,2,1738627724,1738627726,1738627726.542139,-21600,,
com.microsoft.Word,24,1738627700,1738627724,1738627724.303803,-21600,,
com.google.Chrome,1,1738627699,1738627700,1738627700.0638099,-21600,,
com.microsoft.Word,12,1738627687,1738627699,1738627699.1940331,-21600,,
com.google.Chrome,1,1738627686,1738627687,1738627687.9083738,-21600,,
com.microsoft.Word,4,1738627682,1738627686,1738627686.0682611,-21600,,
com.google.Chrome,3,1738627679,1738627682,1738627682.182046,-21600,,
com.microsoft.Word,6,1738627673,1738627679,1738627679.766967,-21600,,
com.google.Chrome,1,1738627672,1738627673,1738627673.893032,-21600,,
com.microsoft.Word,3,1738627669,1738627672,1738627672.365443,-21600,,
com.google.Chrome,2,1738627667,1738627669,1738627669.289933,-21600,,
com.microsoft.Word,2,1738627665,1738627667,1738627667.192735,-21600,,
com.google.Chrome,10,1738627655,1738627665,1738627665.863553,-21600,,
com.microsoft.Word,3,1738627652,1738627655,1738627655.5530748,-21600,,
com.google.Chrome,6,1738627646,1738627652,1738627652.449709,-21600,,
com.microsoft.Word,10,1738627636,1738627646,1738627646.12492,-21600,,
com.google.Chrome,69,1738627567,1738627636,1738627636.8536,-21600,,
com.microsoft.Word,3,1738627564,1738627567,1738627567.6871939,-21600,,
com.google.Chrome,3,1738627561,1738627564,1738627564.290523,-21600,,
com.microsoft.Word,8,1738627553,1738627561,1738627561.25057,-21600,,
com.google.Chrome,1,1738627552,1738627553,1738627553.208784,-21600,,
com.microsoft.Word,68,1738627484,1738627552,1738627552.743896,-21600,,
com.google.Chrome,198,1738627286,1738627484,1738627484.294917,-21600,,
com.microsoft.Word,79,1738627207,1738627286,1738627286.467566,-21600,,
com.microsoft.Word,300,1738626827,1738627127,1738627127.391918,-21600,,
com.microsoft.Word,322,1738626502,1738626824,1738626824.4767509,-21600,,
com.google.Chrome,49,1738626453,1738626502,1738626502.741384,-21600,,
com.leomehlig.today,42,1738626411,1738626453,1738626453.157505,-21600,,
com.google.Chrome,17,1738626394,1738626411,1738626411.4458299,-21600,,
com.apple.finder,1,1738626381,1738626382,1738626382.5069041,-21600,,
com.google.Chrome,2,1738626379,1738626381,1738626381.697355,-21600,,
com.leomehlig.today,18,1738626361,1738626379,1738626379.68437,-21600,,
com.apple.finder,1,1738626360,1738626361,1738626361.492527,-21600,,
com.google.Chrome,3,1738626357,1738626360,1738626360.46868,-21600,,
com.microsoft.VSCode,254,1738626103,1738626357,1738626358.627997,-21600,,
com.google.Chrome,11,1738626092,1738626103,1738626103.055489,-21600,,
com.microsoft.VSCode,146,1738625946,1738626092,1738626092.736092,-21600,,
com.apple.weather,2,1738624707,1738624709,1738624709.612866,-21600,EB445137-D7F5-57EC-87DA-1DB460D64046,"iPhone13,2"
com.apple.weather,8,1738624382,1738624390,1738624391.0471191,-21600,EB445137-D7F5-57EC-87DA-1DB460D64046,"iPhone13,2"
com.leomehlig.today,1,1738624381,1738624382,1738624382.756093,-21600,EB445137-D7F5-57EC-87DA-1DB460D64046,"iPhone13,2"
com.leomehlig.today,170,1738624113,1738624283,1738624283.962829,-21600,EB445137-D7F5-57EC-87DA-1DB460D64046,"iPhone13,2"
com.apple.mobilecal,2,1738624108,1738624110,1738624110.711138,-21600,EB445137-D7F5-57EC-87DA-1DB460D64046,"iPhone13,2"
com.myfitnesspal.mfp,62,1738624038,1738624100,1738624100.899513,-21600,EB445137-D7F5-57EC-87DA-1DB460D64046,"iPhone13,2"
com.instructure.icanvas,4,1738624034,1738624038,1738624038.9909348,-21600,EB445137-D7F5-57EC-87DA-1DB460D64046,"iPhone13,2"
com.instructure.icanvas,5,1738622756,1738622761,1738622761.4692822,-21600,EB445137-D7F5-57EC-87DA-1DB460D64046,"iPhone13,2"
com.apple.Maps,0,1738622756,1738622756,1738622756.8561,-21600,EB445137-D7F5-57EC-87DA-1DB460D64046,"iPhone13,2"
com.apple.Maps,45,1738622702,1738622747,1738622748.142427,-21600,EB445137-D7F5-57EC-87DA-1DB460D64046,"iPhone13,2"
com.groupme.iphone-app,2,1738622586,1738622588,1738622588.5545201,-21600,EB445137-D7F5-57EC-87DA-1DB460D64046,"iPhone13,2"
com.instructure.icanvas,8,1738622578,1738622586,1738622586.8978062,-21600,EB445137-D7F5-57EC-87DA-1DB460D64046,"iPhone13,2"
com.apple.mobilecal,6,1738622572,1738622578,1738622578.421459,-21600,EB445137-D7F5-57EC-87DA-1DB460D64046,"iPhone13,2"
com.instructure.icanvas,16,1738622553,1738622569,1738622569.873376,-21600,EB445137-D7F5-57EC-87DA-1DB460D64046,"iPhone13,2"
com.groupme.iphone-app,18,1738622530,1738622548,1738622548.7869081,-21600,EB445137-D7F5-57EC-87DA-1DB460D64046,"iPhone13,2"
com.apple.news,124,1738622403,1738622527,1738622527.203278,-21600,EB445137-D7F5-57EC-87DA-1DB460D64046,"iPhone13,2"
com.microsoft.VSCode,535,1738621394,1738621929,1738621929.04618,-21600,,
com.google.Chrome,424,1738620970,1738621394,1738621394.970187,-21600,,
com.microsoft.VSCode,1006,1738619964,1738620970,1738620970.534522,-21600,,
com.google.Chrome,76,1738619888,1738619964,1738619964.1139731,-21600,,
com.microsoft.Office.Outlook,2,1738619566,1738619568,1738619568.517644,-21600,EB445137-D7F5-57EC-87DA-1DB460D64046,"iPhone13,2"
com.microsoft.Office.Outlook,7,1738619236,1738619243,1738619244.164443,-21600,EB445137-D7F5-57EC-87DA-1DB460D64046,"iPhone13,2"
com.myfitnesspal.mfp,2,1738619233,1738619235,1738619235.191159,-21600,EB445137-D7F5-57EC-87DA-1DB460D64046,"iPhone13,2"
com.microsoft.VSCode,1391,1738618497,1738619888,1738619888.6030002,-21600,,
com.apple.finder,18,1738618479,1738618497,1738618497.472553,-21600,,
com.microsoft.VSCode,35,1738618444,1738618479,1738618479.6925678,-21600,,
com.myfitnesspal.mfp,25,1738618403,1738618428,1738618428.7975059,-21600,EB445137-D7F5-57EC-87DA-1DB460D64046,"iPhone13,2"
com.myfitnesspal.mfp,72,1738616687,1738616759,1738616760.156393,-21600,EB445137-D7F5-57EC-87DA-1DB460D64046,"iPhone13,2"
com.apple.MobileSMS,5,1738616677,1738616682,1738616682.2320929,-21600,EB445137-D7F5-57EC-87DA-1DB460D64046,"iPhone13,2"
com.apple.MobileSMS,6,1738616438,1738616444,1738616445.1584039,-21600,EB445137-D7F5-57EC-87DA-1DB460D64046,"iPhone13,2"
com.apple.findmy,10,1738616416,1738616426,1738616427.0081968,-21600,EB445137-D7F5-57EC-87DA-1DB460D64046,"iPhone13,2"
com.apple.mobilephone,2,1738616414,1738616416,1738616416.244317,-21600,EB445137-D7F5-57EC-87DA-1DB460D64046,"iPhone13,2"
com.apple.mobilephone,1,1738616369,1738616370,1738616371.471564,-21600,EB445137-D7F5-57EC-87DA-1DB460D64046,"iPhone13,2"
com.apple.InCallService,2,1738616367,1738616369,1738616369.602903,-21600,EB445137-D7F5-57EC-87DA-1DB460D64046,"iPhone13,2"
com.apple.InCallService,1,1738616338,1738616339,1738616339.851182,-21600,EB445137-D7F5-57EC-87DA-1DB460D64046,"iPhone13,2"
com.apple.mobilephone,3,1738616335,1738616338,1738616338.9094,-21600,EB445137-D7F5-57EC-87DA-1DB460D64046,"iPhone13,2"
com.apple.mobilephone,3,1738616297,1738616300,1738616300.495988,-21600,EB445137-D7F5-57EC-87DA-1DB460D64046,"iPhone13,2"
com.apple.mobilephone,3,1738616068,1738616071,1738616071.5208821,-21600,EB445137-D7F5-57EC-87DA-1DB460D64046,"iPhone13,2"
com.apple.mobilephone,4,1738616063,1738616067,1738616067.4994268,-21600,EB445137-D7F5-57EC-87DA-1DB460D64046,"iPhone13,2"
com.apple.mobilephone,2,1738616058,1738616060,1738616060.613785,-21600,EB445137-D7F5-57EC-87DA-1DB460D64046,"iPhone13,2"
com.google.Gmail,9,1738616045,1738616054,1738616055.1801991,-21600,EB445137-D7F5-57EC-87DA-1DB460D64046,"iPhone13,2"
com.google.chrome.ios,1,1738616044,1738616045,1738616046.778611,-21600,EB445137-D7F5-57EC-87DA-1DB460D64046,"iPhone13,2"
com.google.chrome.ios,20,1738612762,1738612782,1738612783.109215,-21600,EB445137-D7F5-57EC-87DA-1DB460D64046,"iPhone13,2"
com.groupme.iphone-app,7,1738612755,1738612762,1738612762.731492,-21600,EB445137-D7F5-57EC-87DA-1DB460D64046,"iPhone13,2"
com.microsoft.VSCode,730,1738608337,1738609067,1738609068.052501,-21600,,
com.toyopagroup.picaboo,17,1738608114,1738608131,1738608131.245357,-21600,EB445137-D7F5-57EC-87DA-1DB460D64046,"iPhone13,2"
Astrospheric.Astrospheric,0,1738608114,1738608114,1738608116.4809508,-21600,EB445137-D7F5-57EC-87DA-1DB460D64046,"iPhone13,2"
com.microsoft.VSCode,788,1738606789,1738607577,1738607577.060525,-21600,,
com.apple.finder,22,1738606767,1738606789,1738606789.946114,-21600,,
com.apple.shortcuts,4,1738606763,1738606767,1738606767.3475962,-21600,,
com.apple.finder,13,1738606349,1738606362,1738606362.689783,-21600,,
com.apple.shortcuts,1,1738606348,1738606349,1738606349.476475,-21600,,
Astrospheric.Astrospheric,17,1738605523,1738605540,1738605540.752048,-21600,EB445137-D7F5-57EC-87DA-1DB460D64046,"iPhone13,2"
com.google.chrome.ios,2,1738605520,1738605522,1738605522.401231,-21600,EB445137-D7F5-57EC-87DA-1DB460D64046,"iPhone13,2"
com.google.chrome.ios,10,1738605486,1738605496,1738605498.244285,-21600,EB445137-D7F5-57EC-87DA-1DB460D64046,"iPhone13,2"
com.google.Gmail,12,1738605474,1738605486,1738605486.525363,-21600,EB445137-D7F5-57EC-87DA-1DB460D64046,"iPhone13,2"
com.tinyspeck.chatlyio,2,1738605471,1738605473,1738605473.766931,-21600,EB445137-D7F5-57EC-87DA-1DB460D64046,"iPhone13,2"
com.apple.shortcuts,176,1738601837,1738602013,1738602013.108041,-21600,,
com.microsoft.VSCode,1,1738601836,1738601837,1738601837.284062,-21600,,
com.apple.finder,19,1738601817,1738601836,1738601836.306942,-21600,,
com.microsoft.VSCode,1,1738601816,1738601817,1738601817.402611,-21600,,
com.microsoft.VSCode,10,1738601528,1738601538,1738601538.663331,-21600,,
com.apple.finder,1,1738601527,1738601528,1738601528.312107,-21600,,
com.apple.shortcuts,2,1738601525,1738601527,1738601527.676477,-21600,,
com.microsoft.VSCode,63,1738601419,1738601482,1738601482.8173819,-21600,,
com.leomehlig.today,14,1738601405,1738601419,1738601419.956269,-21600,,
com.microsoft.VSCode,7,1738601398,1738601405,1738601405.5281758,-21600,,
com.apple.finder,29,1738601369,1738601398,1738601398.858947,-21600,,
com.apple.TextEdit,3,1738601366,1738601369,1738601369.269055,-21600,,
com.apple.finder,13,1738601353,1738601366,1738601366.332917,-21600,,
com.apple.shortcuts,1,1738601352,1738601353,1738601353.5460181,-21600,,
com.microsoft.VSCode,111,1738601193,1738601304,1738601304.901987,-21600,,
com.tinyspeck.chatlyio,46,1738600995,1738601041,1738601042.201788,-21600,EB445137-D7F5-57EC-87DA-1DB460D64046,"iPhone13,2"
com.apple.weather,10,1738600985,1738600995,1738600995.9300408,-21600,EB445137-D7F5-57EC-87DA-1DB460D64046,"iPhone13,2"
com.microsoft.Office.Outlook,3,1738600982,1738600985,1738600985.971947,-21600,EB445137-D7F5-57EC-87DA-1DB460D64046,"iPhone13,2"
com.microsoft.Office.Outlook,27,1738599897,1738599924,1738599924.941115,-21600,EB445137-D7F5-57EC-87DA-1DB460D64046,"iPhone13,2"
com.microsoft.VSCode,112,1738596652,1738596764,1738596764.4560971,-21600,,
com.apple.finder,15,1738596637,1738596652,1738596652.241023,-21600,,
com.apple.shortcuts,4,1738596633,1738596637,1738596637.740006,-21600,,
com.microsoft.VSCode,5,1738596583,1738596588,1738596588.338484,-21600,,
com.apple.Health,31,1738596489,1738596520,1738596521.039366,-21600,EB445137-D7F5-57EC-87DA-1DB460D64046,"iPhone13,2"
com.apple.mobilecal,0,1738596489,1738596489,1738596490.936781,-21600,EB445137-D7F5-57EC-87DA-1DB460D64046,"iPhone13,2"
com.microsoft.VSCode,46,1738595520,1738595566,1738595566.8948212,-21600,,
com.apple.finder,8,1738595512,1738595520,1738595520.507811,-21600,,
com.microsoft.VSCode,6,1738595506,1738595512,1738595512.940882,-21600,,
com.apple.finder,16,1738595490,1738595506,1738595506.7270122,-21600,,
com.microsoft.VSCode,21,1738595469,1738595490,1738595490.237961,-21600,,
com.apple.finder,6,1738595463,1738595469,1738595469.557094,-21600,,
com.microsoft.VSCode,15,1738595448,1738595463,1738595463.9904609,-21600,,
com.apple.dt.Xcode,5,1738595443,1738595448,1738595448.137008,-21600,,
com.apple.finder,27,1738595416,1738595443,1738595443.155781,-21600,,
com.microsoft.VSCode,397,1738595019,1738595416,1738595416.8334498,-21600,,
com.google.Chrome,2,1738595017,1738595019,1738595019.453418,-21600,,
com.microsoft.VSCode,5,1738595012,1738595017,1738595017.88308,-21600,,
com.google.Chrome,28,1738594984,1738595012,1738595012.3508592,-21600,,
com.microsoft.VSCode,150,1738594834,1738594984,1738594986.1211371,-21600,,
com.leomehlig.today,2,1738594832,1738594834,1738594834.46084,-21600,,
com.apple.finder,35,1738594797,1738594832,1738594832.537722,-21600,,
com.apple.shortcuts,3,1738594794,1738594797,1738594797.205812,-21600,,
com.apple.mobilecal,70,1738594709,1738594779,1738594779.2509232,-21600,EB445137-D7F5-57EC-87DA-1DB460D64046,"iPhone13,2"
com.apple.finder,2,1738594682,1738594684,1738594684.385323,-21600,,
com.apple.shortcuts,1,1738594681,1738594682,1738594682.784215,-21600,,
com.apple.mobilecal,93,1738594574,1738594667,1738594667.157724,-21600,EB445137-D7F5-57EC-87DA-1DB460D64046,"iPhone13,2"
com.renpho.health,1,1738594571,1738594572,1738594573.027653,-21600,EB445137-D7F5-57EC-87DA-1DB460D64046,"iPhone13,2"
com.apple.finder,3,1738594546,1738594549,1738594549.235914,-21600,,
com.apple.shortcuts,6,1738594459,1738594465,1738594466.026754,-21600,,
com.leomehlig.today,4,1738594455,1738594459,1738594459.307347,-21600,,
com.microsoft.VSCode,6,1738594449,1738594455,1738594455.073897,-21600,,
com.google.Chrome,8,1738594441,1738594449,1738594450.0900068,-21600,,
com.renpho.health,65,1738593295,1738593360,1738593360.959762,-21600,EB445137-D7F5-57EC-87DA-1DB460D64046,"iPhone13,2"
com.google.Chrome,9,1738562291,1738562300,1738562300.2939448,-21600,,
com.google.Chrome,397,1738561794,1738562191,1738562191.250301,-21600,,
com.google.Chrome,337,1738560152,1738560489,1738560489.739083,-21600,,
com.leomehlig.today,2962,1738559324,1738562286,1738562286.237365,-21600,EB445137-D7F5-57EC-87DA-1DB460D64046,"iPhone13,2"
com.google.Chrome,318,1738559280,1738559598,1738559598.5184011,-21600,,
com.leomehlig.today,91,1738559189,1738559280,1738559280.210233,-21600,,
com.apple.Notes,6,1738559108,1738559114,1738559114.9139152,-21600,,
com.leomehlig.today,111,1738558997,1738559108,1738559108.743401,-21600,,
com.google.Chrome,2,1738558995,1738558997,1738558997.270942,-21600,,
com.google.Chrome,913,1738558006,1738558919,1738558919.559445,-21600,,
com.leomehlig.today,3,1738558003,1738558006,1738558006.877726,-21600,,
com.leomehlig.today,4,1738557436,1738557440,1738557440.651933,-21600,,
com.apple.Notes,1,1738557435,1738557436,1738557437.029465,-21600,,
com.leomehlig.today,2,1738557433,1738557435,1738557435.872422,-21600,,
com.microsoft.VSCode,88,1738557345,1738557433,1738557433.787669,-21600,,
com.leomehlig.today,34,1738557311,1738557345,1738557345.941124,-21600,,
com.microsoft.VSCode,76,1738557235,1738557311,1738557311.293791,-21600,,
com.apple.finder,3,1738557232,1738557235,1738557235.54767,-21600,,
com.leomehlig.today,0,1738557232,1738557232,1738557232.792494,-21600,,
com.apple.Music,73,1738555321,1738555394,1738555394.503124,-21600,EB445137-D7F5-57EC-87DA-1DB460D64046,"iPhone13,2"
com.apple.Music,47,1738555264,1738555311,1738555314.1574469,-21600,EB445137-D7F5-57EC-87DA-1DB460D64046,"iPhone13,2"
com.toyopagroup.picaboo,1,1738555258,1738555259,1738555260.8367,-21600,EB445137-D7F5-57EC-87DA-1DB460D64046,"iPhone13,2"
com.leomehlig.today,3,1738555028,1738555031,1738555031.5267758,-21600,,
com.apple.Notes,19,1738555009,1738555028,1738555028.865839,-21600,,
com.google.Chrome,4,1738555005,1738555009,1738555009.287353,-21600,,
com.microsoft.VSCode,137,1738554868,1738555005,1738555005.967998,-21600,,
com.apple.finder,6,1738554862,1738554868,1738554868.911226,-21600,,
com.apple.shortcuts,1,1738554861,1738554862,1738554862.643511,-21600,,
com.apple.finder,2,1738554837,1738554839,1738554839.388243,-21600,,
com.apple.shortcuts,27,1738554810,1738554837,1738554837.0422192,-21600,,
com.apple.finder,1,1738554809,1738554810,1738554810.846449,-21600,,
com.microsoft.VSCode,6,1738554803,1738554809,1738554809.330158,-21600,,
com.apple.finder,7,1738554796,1738554803,1738554803.105489,-21600,,
com.apple.shortcuts,1,1738554795,1738554796,1738554796.4143028,-21600,,
com.apple.finder,3,1738554746,1738554749,1738554749.5803928,-21600,,
com.apple.shortcuts,18,1738554728,1738554746,1738554746.975741,-21600,,
com.microsoft.VSCode,3,1738554725,1738554728,1738554728.546067,-21600,,
com.apple.shortcuts,8,1738554717,1738554725,1738554725.7637901,-21600,,
com.microsoft.VSCode,12,1738554705,1738554717,1738554717.228259,-21600,,
com.apple.finder,1,1738554704,1738554705,1738554705.83236,-21600,,
com.microsoft.VSCode,31,1738554673,1738554704,1738554704.743137,-21600,,
com.apple.finder,10,1738554663,1738554673,1738554673.784655,-21600,,
com.apple.iCal,2,1738554661,1738554663,1738554663.48806,-21600,,
com.apple.shortcuts,1,1738554660,1738554661,1738554661.689985,-21600,,
com.apple.iCal,9,1738554621,1738554630,1738554630.418786,-21600,,
com.apple.shortcuts,3,1738554618,1738554621,1738554621.071848,-21600,,
com.microsoft.VSCode,3,1738554589,1738554592,1738554592.1784,-21600,,
com.apple.shortcuts,6,1738554583,1738554589,1738554589.283081,-21600,,
com.microsoft.VSCode,3,1738554580,1738554583,1738554583.938113,-21600,,
com.apple.shortcuts,0,1738554580,1738554580,1738554580.747622,-21600,,
com.microsoft.VSCode,2,1738554578,1738554580,1738554580.178719,-21600,,
com.apple.shortcuts,12,1738554566,1738554578,1738554578.657944,-21600,,
com.microsoft.VSCode,3,1738554563,1738554566,1738554566.875767,-21600,,
com.apple.shortcuts,11,1738554552,1738554563,1738554563.332711,-21600,,
com.microsoft.VSCode,8,1738554544,1738554552,1738554552.327081,-21600,,
com.apple.shortcuts,57,1738554487,1738554544,1738554544.604697,-21600,,
com.apple.iCal,2,1738554463,1738554465,1738554465.9006271,-21600,,
com.apple.shortcuts,0,1738554463,1738554463,1738554463.668642,-21600,,
com.apple.iCal,2,1738554461,1738554463,1738554463.1244268,-21600,,
com.apple.shortcuts,26,1738554435,1738554461,1738554461.2727618,-21600,,
com.apple.iCal,15,1738554420,1738554435,1738554435.099121,-21600,,
com.microsoft.VSCode,421,1738553999,1738554420,1738554420.91193,-21600,,
com.apple.finder,11,1738553988,1738553999,1738553999.2705688,-21600,,
com.microsoft.VSCode,127,1738553861,1738553988,1738553988.9586911,-21600,,
com.google.Chrome,6,1738553855,1738553861,1738553861.868548,-21600,,
com.microsoft.VSCode,15,1738553840,1738553855,1738553855.755774,-21600,,
com.google.Chrome,7,1738553833,1738553840,1738553840.569021,-21600,,
com.microsoft.VSCode,17,1738553816,1738553833,1738553833.330707,-21600,,
com.google.Chrome,5,1738553811,1738553816,1738553816.427727,-21600,,
com.microsoft.VSCode,3,1738553808,1738553811,1738553811.162113,-21600,,
com.google.Chrome,19,1738553789,1738553808,1738553808.577331,-21600,,
com.apple.Terminal,35,1738553754,1738553789,1738553789.775076,-21600,,
com.google.Chrome,1,1738553753,1738553754,1738553755.015125,-21600,,
com.apple.Terminal,34,1738553719,1738553753,1738553753.338043,-21600,,
com.google.Chrome,7,1738553712,1738553719,1738553719.409138,-21600,,
com.apple.Terminal,8,1738553704,1738553712,1738553712.270772,-21600,,
com.google.Chrome,7,1738553697,1738553704,1738553704.644843,-21600,,
com.apple.Terminal,16,1738553681,1738553697,1738553697.73379,-21600,,
com.toyopagroup.picaboo,10,1738553584,1738553594,1738553594.688146,-21600,EB445137-D7F5-57EC-87DA-1DB460D64046,"iPhone13,2"
com.microsoft.VSCode,334,1738553347,1738553681,1738553681.872474,-21600,,
com.apple.finder,10,1738553337,1738553347,1738553348.025182,-21600,,
com.apple.shortcuts,0,1738553337,1738553337,1738553337.931572,-21600,,
com.apple.finder,1,1738553320,1738553321,1738553321.097464,-21600,,
com.apple.shortcuts,1,1738553319,1738553320,1738553320.4304152,-21600,,
com.apple.finder,3,1738553201,1738553204,1738553204.487268,-21600,,
com.apple.shortcuts,2,1738553199,1738553201,1738553201.548905,-21600,,
com.apple.finder,5,1738553082,1738553087,1738553087.8603868,-21600,,
com.apple.shortcuts,1,1738553081,1738553082,1738553082.726958,-21600,,
com.apple.finder,1,1738553066,1738553067,1738553067.8157701,-21600,,
com.apple.shortcuts,6,1738553060,1738553066,1738553066.2251391,-21600,,
com.apple.finder,12,1738553048,1738553060,1738553060.187396,-21600,,
com.apple.shortcuts,2,1738553046,1738553048,1738553048.40958,-21600,,
com.microsoft.VSCode,56,1738552892,1738552948,1738552948.746076,-21600,,
com.google.Chrome,2,1738552890,1738552892,1738552892.358856,-21600,,
com.microsoft.VSCode,3,1738552887,1738552890,1738552890.791548,-21600,,
com.google.Chrome,16,1738552871,1738552887,1738552887.4532151,-21600,,
com.microsoft.VSCode,305,1738552566,1738552871,1738552871.736398,-21600,,
com.google.Chrome,7,1738552559,1738552566,1738552566.834033,-21600,,
com.microsoft.VSCode,11,1738552548,1738552559,1738552559.2854428,-21600,,
com.google.Chrome,17,1738552531,1738552548,1738552548.401124,-21600,,
com.microsoft.VSCode,703,1738551828,1738552531,1738552531.279087,-21600,,
com.apple.Terminal,26,1738551802,1738551828,1738551828.900404,-21600,,
com.microsoft.VSCode,51,1738551751,1738551802,1738551802.8594642,-21600,,
com.apple.finder,27,1738551724,1738551751,1738551751.0966768,-21600,,
com.microsoft.VSCode,130,1738551594,1738551724,1738551724.770251,-21600,,
com.apple.finder,49,1738551545,1738551594,1738551594.2631001,-21600,,
com.apple.shortcuts,1,1738551544,1738551545,1738551545.844428,-21600,,
com.apple.finder,22,1738551502,1738551524,1738551524.427061,-21600,,
com.apple.shortcuts,78,1738551424,1738551502,1738551502.558281,-21600,,
com.apple.finder,14,1738551410,1738551424,1738551424.250369,-21600,,
com.apple.shortcuts,12,1738551398,1738551410,1738551410.842248,-21600,,
com.apple.finder,9,1738551355,1738551364,1738551364.627352,-21600,,
com.apple.shortcuts,4,1738551351,1738551355,1738551355.321548,-21600,,
com.google.Chrome,7,1738551145,1738551152,1738551152.0952,-21600,,
com.apple.shortcuts,12,1738551133,1738551145,1738551145.576657,-21600,,
com.google.Chrome,1,1738551132,1738551133,1738551133.464072,-21600,,
com.apple.shortcuts,2,1738551130,1738551132,1738551132.574607,-21600,,
com.google.Chrome,19,1738551111,1738551130,1738551130.971315,-21600,,
com.apple.shortcuts,116,1738550995,1738551111,1738551111.125626,-21600,,
com.google.Chrome,34,1738550961,1738550995,1738550995.8395019,-21600,,
com.apple.shortcuts,79,1738550882,1738550961,1738550961.381717,-21600,,
com.apple.Notes,3,1738550760,1738550763,1738550764.015222,-21600,,
com.apple.dt.Xcode,25,1738550735,1738550760,1738550760.751598,-21600,,
com.apple.Notes,5,1738550730,1738550735,1738550735.208123,-21600,,
com.apple.shortcuts,12,1738550718,1738550730,1738550730.7007809,-21600,,
com.apple.MobileSMS,6,1738550285,1738550291,1738550291.047203,-21600,,
com.apple.shortcuts,36,1738550249,1738550285,1738550285.579795,-21600,,
com.google.Chrome,7,1738549094,1738549101,1738549101.8723679,-21600,,
com.leomehlig.today,27,1738549067,1738549094,1738549094.6962829,-21600,,
com.google.Chrome,224,1738548843,1738549067,1738549067.370497,-21600,,
com.apple.Preview,21,1738548822,1738548843,1738548843.599777,-21600,,
com.apple.finder,9,1738548813,1738548822,1738548823.02427,-21600,,
com.google.Chrome,266,1738548547,1738548813,1738548813.9281502,-21600,,
com.apple.finder,24,1738548523,1738548547,1738548547.2460241,-21600,,
com.google.Chrome,727,1738547796,1738548523,1738548523.738982,-21600,,
com.apple.finder,2,1738547794,1738547796,1738547796.848212,-21600,,
com.google.Chrome,257,1738547537,1738547794,1738547794.708616,-21600,,
com.apple.Preview,5,1738547520,1738547525,1738547525.12152,-21600,,
com.google.Chrome,7,1738547513,1738547520,1738547520.220855,-21600,,
com.apple.Preview,2,1738547511,1738547513,1738547513.3115559,-21600,,
com.google.Chrome,7,1738547504,1738547511,1738547511.883009,-21600,,
com.apple.Preview,25,1738547479,1738547504,1738547504.062221,-21600,,
com.apple.finder,4,1738547475,1738547479,1738547479.508975,-21600,,
com.google.Chrome,20,1738547455,1738547475,1738547475.8856769,-21600,,
com.leomehlig.today,24,1738547431,1738547455,1738547455.656818,-21600,,
com.apple.finder,1,1738547430,1738547431,1738547431.920605,-21600,,
com.google.Chrome,12,1738547418,1738547430,1738547430.816633,-21600,,
com.apple.finder,18,1738547400,1738547418,1738547418.60747,-21600,,
com.microsoft.Word,5,1738547395,1738547400,1738547400.58623,-21600,,
com.apple.finder,2,1738547393,1738547395,1738547395.9051208,-21600,,
com.microsoft.Word,6,1738547387,1738547393,1738547393.9198909,-21600,,
com.apple.finder,6,1738547381,1738547387,1738547387.942267,-21600,,
com.microsoft.Word,415,1738546966,1738547381,1738547382.021868,-21600,,
com.google.Chrome,6,1738546960,1738546966,1738546966.181229,-21600,,
com.microsoft.Word,55,1738546905,1738546960,1738546960.964089,-21600,,
com.google.Chrome,1,1738546904,1738546905,1738546905.560966,-21600,,
com.microsoft.Word,2,1738546902,1738546904,1738546904.5647469,-21600,,
com.google.Chrome,0,1738546902,1738546902,1738546902.9311318,-21600,,
com.microsoft.Word,2,1738546900,1738546902,1738546902.168042,-21600,,
com.google.Chrome,1,1738546899,1738546900,1738546900.0893002,-21600,,
com.microsoft.Word,10,1738546889,1738546899,1738546899.1951652,-21600,,
com.google.Chrome,1,1738546888,1738546889,1738546889.821459,-21600,,
com.microsoft.Word,3,1738546885,1738546888,1738546888.899755,-21600,,
com.google.Chrome,2,1738546883,1738546885,1738546886.046846,-21600,,
com.microsoft.Word,262,1738546621,1738546883,1738546883.9722471,-21600,,
com.google.Chrome,23,1738546598,1738546621,1738546621.9636111,-21600,,
com.google.Chrome,342,1738545939,1738546281,1738546281.1336699,-21600,,
com.google.Chrome,949,1738544515,1738545464,1738545464.57892,-21600,,
com.leomehlig.today,95,1738544420,1738544515,1738544516.047276,-21600,,
com.google.Chrome,2,1738544418,1738544420,1738544420.533279,-21600,,
com.intsig.CamScannerLite,2,1738544022,1738544024,1738544024.742886,-21600,EB445137-D7F5-57EC-87DA-1DB460D64046,"iPhone13,2"
com.google.Chrome,417,1738543608,1738544025,1738544025.869876,-21600,,
com.leomehlig.today,1,1738543607,1738543608,1738543608.724903,-21600,,
com.google.Chrome,4,1738543603,1738543607,1738543607.300891,-21600,,
com.microsoft.Word,530,1738543073,1738543603,1738543603.8722649,-21600,,
com.apple.finder,25,1738543048,1738543073,1738543073.716166,-21600,,
com.intsig.CamScannerLite,0,1738542521,1738542521,1738542521.93519,-21600,EB445137-D7F5-57EC-87DA-1DB460D64046,"iPhone13,2"
com.instructure.icanvas,37,1738542484,1738542521,1738542521.2113008,-21600,EB445137-D7F5-57EC-87DA-1DB460D64046,"iPhone13,2"
com.instructure.icanvas,17,1738542467,1738542484,1738542484.2895741,-21600,EB445137-D7F5-57EC-87DA-1DB460D64046,"iPhone13,2"
com.intsig.CamScannerLite,0,1738542467,1738542467,1738542468.4064531,-21600,EB445137-D7F5-57EC-87DA-1DB460D64046,"iPhone13,2"
com.google.Chrome,1317,1738541731,1738543048,1738543048.1697369,-21600,,
com.google.Chrome,300,1738541430,1738541730,1738541730.653753,-21600,,
com.google.Chrome,332,1738541095,1738541427,1738541427.914752,-21600,,
com.apple.finder,7,1738541088,1738541095,1738541095.910466,-21600,,
com.intsig.CamScannerLite,90,1738541021,1738541111,1738541111.837685,-21600,EB445137-D7F5-57EC-87DA-1DB460D64046,"iPhone13,2"
com.apple.news,1,1738541019,1738541020,1738541020.797738,-21600,EB445137-D7F5-57EC-87DA-1DB460D64046,"iPhone13,2"
com.google.Chrome,130,1738540958,1738541088,1738541088.2581558,-21600,,
com.apple.finder,2,1738540956,1738540958,1738540958.4446201,-21600,,
com.google.Chrome,9,1738540947,1738540956,1738540956.444532,-21600,,
com.apple.finder,6,1738540941,1738540947,1738540947.243682,-21600,,
com.apple.news,90,1738540756,1738540846,1738540847.273638,-21600,EB445137-D7F5-57EC-87DA-1DB460D64046,"iPhone13,2"
com.apple.MobileSMS,4,1738540745,1738540749,1738540749.3109012,-21600,EB445137-D7F5-57EC-87DA-1DB460D64046,"iPhone13,2"
com.google.Chrome,210,1738540731,1738540941,1738540941.760375,-21600,,
com.leomehlig.today,16,1738540703,1738540719,1738540719.613286,-21600,,
com.google.Chrome,369,1738540334,1738540703,1738540704.1011171,-21600,,
com.google.Chrome,318,1738539826,1738540144,1738540144.32971,-21600,,
com.google.Chrome,471,1738539321,1738539792,1738539792.422893,-21600,,
com.leomehlig.today,13,1738539308,1738539321,1738539321.8737411,-21600,,
com.google.Chrome,8,1738539300,1738539308,1738539309.68205,-21600,,
com.apple.MobileSMS,2,1738538898,1738538900,1738538900.839898,-21600,EB445137-D7F5-57EC-87DA-1DB460D64046,"iPhone13,2"
com.apple.MobileSMS,81,1738538737,1738538818,1738538818.978105,-21600,EB445137-D7F5-57EC-87DA-1DB460D64046,"iPhone13,2"
com.tinyspeck.chatlyio,0,1738538737,1738538737,1738538738.552071,-21600,EB445137-D7F5-57EC-87DA-1DB460D64046,"iPhone13,2"
com.tinyspeck.chatlyio,44,1738538285,1738538329,1738538329.3417501,-21600,EB445137-D7F5-57EC-87DA-1DB460D64046,"iPhone13,2"
com.apple.Health,2,1738538283,1738538285,1738538285.73341,-21600,EB445137-D7F5-57EC-87DA-1DB460D64046,"iPhone13,2"
com.apple.Health,18,1738538024,1738538042,1738538043.017961,-21600,EB445137-D7F5-57EC-87DA-1DB460D64046,"iPhone13,2"
com.apple.Music,2,1738538022,1738538024,1738538024.3212008,-21600,EB445137-D7F5-57EC-87DA-1DB460D64046,"iPhone13,2"
com.apple.Music,3,1738538003,1738538006,1738538007.31652,-21600,EB445137-D7F5-57EC-87DA-1DB460D64046,"iPhone13,2"
com.apple.findmy,9,1738537994,1738538003,1738538003.929541,-21600,EB445137-D7F5-57EC-87DA-1DB460D64046,"iPhone13,2"
com.apple.mobilephone,1,1738537993,1738537994,1738537994.95502,-21600,EB445137-D7F5-57EC-87DA-1DB460D64046,"iPhone13,2"
com.apple.Music,1,1738537991,1738537992,1738537993.0719872,-21600,EB445137-D7F5-57EC-87DA-1DB460D64046,"iPhone13,2"
com.apple.Music,7,1738537948,1738537955,1738537955.958329,-21600,EB445137-D7F5-57EC-87DA-1DB460D64046,"iPhone13,2"
com.google.Chrome,3,1738537652,1738537655,1738537655.907837,-21600,,
com.apple.CoreAuthUI,2,1738537597,1738537599,1738537599.7862148,-21600,EB445137-D7F5-57EC-87DA-1DB460D64046,"iPhone13,2"
com.truebill.truebillnative,41,1738537596,1738537637,1738537637.92767,-21600,EB445137-D7F5-57EC-87DA-1DB460D64046,"iPhone13,2"
com.apple.CoreAuthUI,3,1738537584,1738537587,1738537587.113487,-21600,EB445137-D7F5-57EC-87DA-1DB460D64046,"iPhone13,2"
com.ally.MobileBanking,18,1738537576,1738537594,1738537594.404212,-21600,EB445137-D7F5-57EC-87DA-1DB460D64046,"iPhone13,2"
com.apple.Health,26,1738537523,1738537549,1738537549.8871288,-21600,EB445137-D7F5-57EC-87DA-1DB460D64046,"iPhone13,2"
com.myfitnesspal.mfp,39,1738537440,1738537479,1738537479.5128698,-21600,EB445137-D7F5-57EC-87DA-1DB460D64046,"iPhone13,2"
com.google.Chrome,586,1738537016,1738537602,1738537602.680973,-21600,,
com.leomehlig.today,34,1738536982,1738537016,1738537016.481773,-21600,,
com.google.Chrome,6,1738536976,1738536982,1738536982.4334822,-21600,,
com.apple.Notes,63,1738536913,1738536976,1738536976.71175,-21600,,
com.google.Chrome,4,1738536909,1738536913,1738536913.52628,-21600,,
com.apple.Notes,1,1738536908,1738536909,1738536909.992167,-21600,,
com.myfitnesspal.mfp,85,1738536872,1738536957,1738536958.102638,-21600,EB445137-D7F5-57EC-87DA-1DB460D64046,"iPhone13,2"
com.myfitnesspal.mfp,81,1738536782,1738536863,1738536863.431477,-21600,EB445137-D7F5-57EC-87DA-1DB460D64046,"iPhone13,2"
com.google.Chrome,205,1738536703,1738536908,1738536908.6734672,-21600,,
com.google.Chrome,328,1738536267,1738536595,1738536595.829252,-21600,,
com.leomehlig.today,7,1738536260,1738536267,1738536267.339779,-21600,,
com.myfitnesspal.mfp,47,1738535735,1738535782,1738535782.670175,-21600,EB445137-D7F5-57EC-87DA-1DB460D64046,"iPhone13,2"
com.microsoft.Office.Outlook,5,1738534887,1738534892,1738534892.654042,-21600,EB445137-D7F5-57EC-87DA-1DB460D64046,"iPhone13,2"
com.intsig.CamScannerLite,4,1738534882,1738534886,1738534887.875506,-21600,EB445137-D7F5-57EC-87DA-1DB460D64046,"iPhone13,2"
com.leomehlig.today,13,1738534360,1738534373,1738534373.631289,-21600,,
com.google.Chrome,718,1738533642,1738534360,1738534360.098748,-21600,,
com.apple.Preview,3,1738533639,1738533642,1738533642.842257,-21600,,
com.apple.finder,133,1738533506,1738533639,1738533639.665287,-21600,,
com.intsig.CamScannerLite,110,1738533397,1738533507,1738533508.03234,-21600,EB445137-D7F5-57EC-87DA-1DB460D64046,"iPhone13,2"
com.apple.camera,1,1738533395,1738533396,1738533397.438179,-21600,EB445137-D7F5-57EC-87DA-1DB460D64046,"iPhone13,2"
com.apple.camera,70,1738533268,1738533338,1738533338.746499,-21600,EB445137-D7F5-57EC-87DA-1DB460D64046,"iPhone13,2"
com.apple.news,1,1738533264,1738533265,1738533265.8740149,-21600,EB445137-D7F5-57EC-87DA-1DB460D64046,"iPhone13,2"
com.google.Chrome,914,1738532592,1738533506,1738533506.519874,-21600,,
com.leomehlig.today,1,1738532591,1738532592,1738532592.645084,-21600,,
com.google.Chrome,1371,1738531220,1738532591,1738532591.5233788,-21600,,
com.google.Chrome,970,1738530244,1738531214,1738531214.583163,-21600,,
com.leomehlig.today,1,1738530243,1738530244,1738530244.353698,-21600,,
com.google.Chrome,851,1738529392,1738530243,1738530243.134948,-21600,,
com.leomehlig.today,0,1738529392,1738529392,1738529392.7699661,-21600,,
com.google.Chrome,0,1738529392,1738529392,1738529392.471106,-21600,,
com.leomehlig.today,1,1738529391,1738529392,1738529392.204068,-21600,,
com.google.Chrome,0,1738529391,1738529391,1738529391.9414701,-21600,,
com.leomehlig.today,4,1738529387,1738529391,1738529391.3143048,-21600,,
com.google.Chrome,90,1738529297,1738529387,1738529387.111683,-21600,,
com.apple.news,157,1738528372,1738528529,1738528530.8409839,-21600,EB445137-D7F5-57EC-87DA-1DB460D64046,"iPhone13,2"
com.google.Chrome,1203,1738528093,1738529296,1738529296.474392,-21600,,
com.google.Chrome,343,1738527735,1738528078,1738528078.795064,-21600,,
com.leomehlig.today,38,1738527697,1738527735,1738527735.256038,-21600,,
com.google.Chrome,1237,1738526460,1738527697,1738527697.31302,-21600,,
com.google.Chrome,1092,1738524959,1738526051,1738526051.4166121,-21600,,
com.google.Chrome,108,1738523736,1738523844,1738523844.932307,-21600,,
com.leomehlig.today,2,1738523734,1738523736,1738523736.4569001,-21600,,
com.leomehlig.today,2,1738523720,1738523722,1738523722.785007,-21600,,
com.apple.iCal,2,1738523718,1738523720,1738523720.287569,-21600,,
com.leomehlig.today,1,1738523717,1738523718,1738523718.642314,-21600,,
com.apple.shortcuts,21,1738523696,1738523717,1738523717.958768,-21600,,
com.leomehlig.today,7,1738523689,1738523696,1738523696.775883,-21600,,
com.apple.shortcuts,3,1738523686,1738523689,1738523689.261106,-21600,,
com.leomehlig.today,5,1738523681,1738523686,1738523686.2508569,-21600,,
com.apple.shortcuts,6,1738523675,1738523681,1738523681.984469,-21600,,
com.leomehlig.today,4,1738523671,1738523675,1738523675.320166,-21600,,
com.apple.shortcuts,4,1738523667,1738523671,1738523671.291168,-21600,,
com.leomehlig.today,4,1738523663,1738523667,1738523667.373321,-21600,,
com.apple.shortcuts,318,1738523345,1738523663,1738523663.449397,-21600,,
com.leomehlig.today,2,1738523343,1738523345,1738523345.40498,-21600,,
com.apple.shortcuts,3,1738523340,1738523343,1738523343.493531,-21600,,
com.leomehlig.today,4,1738523308,1738523312,1738523312.922004,-21600,,
com.apple.shortcuts,4,1738523304,1738523308,1738523308.405857,-21600,,
com.leomehlig.today,3,1738523301,1738523304,1738523304.3876019,-21600,,
com.apple.shortcuts,7,1738523294,1738523301,1738523301.811952,-21600,,
com.leomehlig.today,7,1738523287,1738523294,1738523294.327536,-21600,,
com.apple.shortcuts,5,1738523282,1738523287,1738523287.3130121,-21600,,
com.leomehlig.today,5,1738523277,1738523282,1738523282.542747,-21600,,
com.apple.shortcuts,3,1738523274,1738523277,1738523277.544812,-21600,,
com.leomehlig.today,3,1738523249,1738523252,1738523252.793277,-21600,,
com.apple.iCal,2,1738523247,1738523249,1738523249.742559,-21600,,
com.apple.finder,1,1738523246,1738523247,1738523247.423985,-21600,,
com.leomehlig.today,2,1738523244,1738523246,1738523246.539894,-21600,,
com.apple.shortcuts,240,1738523004,1738523244,1738523244.393979,-21600,,
com.leomehlig.today,20,1738522984,1738523004,1738523004.705227,-21600,,
com.google.Chrome,11,1738522973,1738522984,1738522984.284704,-21600,,
com.groupme.iphone-app,67,1738522671,1738522738,1738522738.6280189,-21600,EB445137-D7F5-57EC-87DA-1DB460D64046,"iPhone13,2"
com.toyopagroup.picaboo,40,1738522629,1738522669,1738522669.1380439,-21600,EB445137-D7F5-57EC-87DA-1DB460D64046,"iPhone13,2"
com.groupme.iphone-app,1,1738522628,1738522629,1738522629.121101,-21600,EB445137-D7F5-57EC-87DA-1DB460D64046,"iPhone13,2"
com.groupme.iphone-app,32,1738522593,1738522625,1738522625.378851,-21600,EB445137-D7F5-57EC-87DA-1DB460D64046,"iPhone13,2"
com.apple.shortcuts,1,1738522532,1738522533,1738522533.6479359,-21600,EB445137-D7F5-57EC-87DA-1DB460D64046,"iPhone13,2"
com.apple.shortcuts,3,1738522514,1738522517,1738522517.313242,-21600,EB445137-D7F5-57EC-87DA-1DB460D64046,"iPhone13,2"
com.apple.shortcuts,30,1738520160,1738520190,1738520191.047584,-21600,EB445137-D7F5-57EC-87DA-1DB460D64046,"iPhone13,2"
com.leomehlig.today,2,1738520155,1738520157,1738520157.359655,-21600,EB445137-D7F5-57EC-87DA-1DB460D64046,"iPhone13,2"
com.leomehlig.today,32,1738520056,1738520088,1738520088.539532,-21600,EB445137-D7F5-57EC-87DA-1DB460D64046,"iPhone13,2"
com.apple.AppStore,34,1738520013,1738520047,1738520048.4201078,-21600,EB445137-D7F5-57EC-87DA-1DB460D64046,"iPhone13,2"
com.leomehlig.today,15,1738519995,1738520010,1738520010.124679,-21600,EB445137-D7F5-57EC-87DA-1DB460D64046,"iPhone13,2"
com.leomehlig.today,76,1738519539,1738519615,1738519615.963729,-21600,EB445137-D7F5-57EC-87DA-1DB460D64046,"iPhone13,2"
com.microsoft.Office.Outlook,2,1738519535,1738519537,1738519537.719266,-21600,EB445137-D7F5-57EC-87DA-1DB460D64046,"iPhone13,2"
com.microsoft.Office.Outlook,5,1738517883,1738517888,1738517888.2543092,-21600,EB445137-D7F5-57EC-87DA-1DB460D64046,"iPhone13,2"
com.google.Chrome,192,1738517865,1738518057,1738518057.236432,-21600,,
com.microsoft.Office.Outlook,61,1738517229,1738517290,1738517290.4986591,-21600,EB445137-D7F5-57EC-87DA-1DB460D64046,"iPhone13,2"
com.myfitnesspal.mfp,396,1738516821,1738517217,1738517217.261071,-21600,EB445137-D7F5-57EC-87DA-1DB460D64046,"iPhone13,2"
com.google.Chrome,346,1738516684,1738517030,1738517030.5583491,-21600,,
com.leomehlig.today,9,1738516675,1738516684,1738516684.101136,-21600,,
com.leomehlig.today,6,1738515894,1738515900,1738515900.3737001,-21600,,
com.google.Chrome,1,1738515893,1738515894,1738515894.482233,-21600,,
com.leomehlig.today,5,1738515888,1738515893,1738515893.4270248,-21600,,
com.electron.carta,1,1738515887,1738515888,1738515888.1411939,-21600,,
com.leomehlig.today,1,1738515886,1738515887,1738515887.485786,-21600,,
com.microsoft.VSCode,25,1738515861,1738515886,1738515886.640152,-21600,,
com.leomehlig.today,1,1738515860,1738515861,1738515861.857115,-21600,,
com.google.Chrome,30,1738515830,1738515860,1738515860.577749,-21600,,
com.leomehlig.today,3,1738515827,1738515830,1738515830.084584,-21600,,
com.google.Chrome,193,1738515634,1738515827,1738515827.306407,-21600,,
com.microsoft.VSCode,9,1738515625,1738515634,1738515634.5779371,-21600,,
com.google.Chrome,40,1738515585,1738515625,1738515625.985688,-21600,,
com.microsoft.VSCode,4,1738515581,1738515585,1738515585.7673821,-21600,,
com.google.Chrome,1,1738515580,1738515581,1738515581.9661078,-21600,,
com.apple.finder,1,1738515579,1738515580,1738515580.1436849,-21600,,
com.microsoft.VSCode,4,1738515575,1738515579,1738515579.110223,-21600,,
com.apple.finder,1,1738515574,1738515575,1738515575.6802878,-21600,,
com.google.Chrome,5,1738515569,1738515574,1738515574.3087878,-21600,,
com.apple.finder,1,1738515568,1738515569,1738515569.398823,-21600,,
com.microsoft.VSCode,16,1738515552,1738515568,1738515568.4043531,-21600,,
com.apple.finder,1,1738515551,1738515552,1738515552.118287,-21600,,
com.google.Chrome,3,1738515548,1738515551,1738515551.388763,-21600,,
com.apple.finder,1,1738515547,1738515548,1738515548.824676,-21600,,
com.google.Chrome,9,1738515538,1738515547,1738515547.634332,-21600,,
com.apple.finder,1,1738515537,1738515538,1738515539.02275,-21600,,
com.microsoft.VSCode,24,1738515513,1738515537,1738515537.759132,-21600,,
com.apple.finder,1,1738515512,1738515513,1738515513.631885,-21600,,
com.google.Chrome,12,1738515500,1738515512,1738515512.7707338,-21600,,
com.apple.finder,1,1738515499,1738515500,1738515500.860492,-21600,,
com.microsoft.VSCode,33,1738515466,1738515499,1738515499.8607879,-21600,,
com.apple.finder,12,1738515454,1738515466,1738515466.860086,-21600,,
com.microsoft.VSCode,24,1738515430,1738515454,1738515454.108336,-21600,,
com.google.Chrome,52,1738515378,1738515430,1738515430.852672,-21600,,
com.microsoft.VSCode,980,1738514398,1738515378,1738515379.000688,-21600,,
com.electron.carta,2,1738514396,1738514398,1738514398.6807098,-21600,,
com.leomehlig.today,1,1738514395,1738514396,1738514396.716889,-21600,,
com.google.Chrome,8,1738514387,1738514395,1738514395.5942612,-21600,,
com.leomehlig.today,1,1738514386,1738514387,1738514387.945056,-21600,,
com.microsoft.VSCode,203,1738514183,1738514386,1738514386.827726,-21600,,
com.leomehlig.today,1,1738514182,1738514183,1738514183.752955,-21600,,
com.google.Chrome,72,1738514110,1738514182,1738514182.122112,-21600,,
com.leomehlig.today,1,1738514109,1738514110,1738514110.574734,-21600,,
com.microsoft.VSCode,249,1738513860,1738514109,1738514109.413639,-21600,,
com.leomehlig.today,1,1738513859,1738513860,1738513860.616444,-21600,,
com.google.Chrome,86,1738513773,1738513859,1738513859.758951,-21600,,
com.leomehlig.today,1,1738513772,1738513773,1738513773.4565902,-21600,,
com.microsoft.VSCode,32,1738513740,1738513772,1738513772.281465,-21600,,
com.leomehlig.today,1,1738513739,1738513740,1738513740.4525309,-21600,,
com.google.Chrome,30,1738513709,1738513739,1738513739.3559608,-21600,,
com.leomehlig.today,1,1738513708,1738513709,1738513709.6634722,-21600,,
com.microsoft.VSCode,132,1738513576,1738513708,1738513708.822819,-21600,,
com.leomehlig.today,1,1738513575,1738513576,1738513576.912538,-21600,,
com.google.Chrome,6,1738513569,1738513575,1738513575.92729,-21600,,
com.leomehlig.today,0,1738513569,1738513569,1738513570.015383,-21600,,
com.microsoft.VSCode,55,1738513514,1738513569,1738513569.108183,-21600,,
com.leomehlig.today,31,1738513483,1738513514,1738513514.2841291,-21600,,
com.microsoft.VSCode,325,1738513158,1738513483,1738513483.493501,-21600,,
com.google.Chrome,51,1738513107,1738513158,1738513158.150405,-21600,,
com.microsoft.VSCode,550,1738512557,1738513107,1738513107.957171,-21600,,
com.google.Chrome,29,1738512528,1738512557,1738512557.763663,-21600,,
com.microsoft.VSCode,133,1738512395,1738512528,1738512528.3994179,-21600,,
com.google.Chrome,2,1738512393,1738512395,1738512395.9005451,-21600,,
com.microsoft.VSCode,9,1738512384,1738512393,1738512393.397476,-21600,,
com.google.Chrome,1,1738512383,1738512384,1738512384.538971,-21600,,
com.microsoft.VSCode,14,1738512369,1738512383,1738512383.051104,-21600,,
com.google.Chrome,18,1738512351,1738512369,1738512369.5922441,-21600,,
com.microsoft.VSCode,53,1738512298,1738512351,1738512351.5187979,-21600,,
com.google.Chrome,15,1738512283,1738512298,1738512298.80378,-21600,,
com.microsoft.VSCode,2,1738512281,1738512283,1738512283.214859,-21600,,
com.google.Chrome,44,1738512237,1738512281,1738512281.3872771,-21600,,
com.microsoft.VSCode,2,1738512235,1738512237,1738512237.249238,-21600,,
com.google.Chrome,17,1738512218,1738512235,1738512235.299457,-21600,,
com.microsoft.VSCode,3,1738512215,1738512218,1738512218.998386,-21600,,
com.google.Chrome,1,1738512214,1738512215,1738512215.804237,-21600,,
com.microsoft.VSCode,40,1738512174,1738512214,1738512214.663173,-21600,,
com.google.Chrome,12,1738512162,1738512174,1738512174.5953069,-21600,,
com.microsoft.VSCode,2,1738512160,1738512162,1738512162.825933,-21600,,
com.google.Chrome,4,1738512156,1738512160,1738512160.8210711,-21600,,
com.microsoft.VSCode,244,1738511912,1738512156,1738512156.1195111,-21600,,
com.google.Chrome,3,1738511909,1738511912,1738511912.7863169,-21600,,
com.microsoft.VSCode,7,1738511902,1738511909,1738511909.303481,-21600,,
com.google.Chrome,0,1738511902,1738511902,1738511902.845047,-21600,,
com.microsoft.VSCode,2,1738511900,1738511902,1738511902.057622,-21600,,
com.google.Chrome,2,1738511898,1738511900,1738511900.346477,-21600,,
com.microsoft.VSCode,1,1738511897,1738511898,1738511898.360837,-21600,,
com.google.Chrome,3,1738511894,1738511897,1738511897.3108459,-21600,,
com.microsoft.VSCode,3,1738511891,1738511894,1738511894.8867931,-21600,,
com.google.Chrome,4,1738511887,1738511891,1738511891.080589,-21600,,
com.microsoft.VSCode,4,1738511883,1738511887,1738511887.323652,-21600,,
com.google.Chrome,2,1738511881,1738511883,1738511883.5507522,-21600,,
com.microsoft.VSCode,18,1738511863,1738511881,1738511881.738783,-21600,,
com.google.Chrome,1,1738511862,1738511863,1738511863.3202329,-21600,,
com.microsoft.VSCode,9,1738511853,1738511862,1738511862.128063,-21600,,
com.google.Chrome,3,1738511850,1738511853,1738511853.78202,-21600,,
com.microsoft.VSCode,231,1738511619,1738511850,1738511850.965332,-21600,,
com.google.Chrome,130,1738511489,1738511619,1738511619.744913,-21600,,
com.microsoft.VSCode,573,1738510916,1738511489,1738511489.378216,-21600,,
com.google.Chrome,8,1738510908,1738510916,1738510916.376435,-21600,,
com.microsoft.VSCode,556,1738510352,1738510908,1738510908.204801,-21600,,
com.google.Chrome,6,1738510346,1738510352,1738510352.2030668,-21600,,
com.microsoft.VSCode,68,1738510278,1738510346,1738510346.6261768,-21600,,
com.google.Chrome,23,1738510255,1738510278,1738510278.458609,-21600,,
com.microsoft.VSCode,23,1738510232,1738510255,1738510255.172684,-21600,,
com.google.Chrome,23,1738510209,1738510232,1738510232.2323642,-21600,,
com.microsoft.VSCode,4,1738510205,1738510209,1738510209.9772348,-21600,,
com.google.Chrome,10,1738510195,1738510205,1738510206.058167,-21600,,
com.microsoft.VSCode,10,1738510185,1738510195,1738510195.6710439,-21600,,
com.google.Chrome,13,1738510172,1738510185,1738510185.8006601,-21600,,
com.microsoft.VSCode,641,1738509531,1738510172,1738510172.59863,-21600,,
com.google.Chrome,137,1738509394,1738509531,1738509531.6847482,-21600,,
com.microsoft.VSCode,627,1738508767,1738509394,1738509394.9047651,-21600,,
com.electron.carta,2,1738508765,1738508767,1738508767.6088471,-21600,,
com.microsoft.VSCode,0,1738508765,1738508765,1738508765.919362,-21600,,
com.electron.carta,2,1738508763,1738508765,1738508765.044812,-21600,,
com.microsoft.VSCode,1,1738508762,1738508763,1738508763.246228,-21600,,
com.electron.carta,65,1738508697,1738508762,1738508762.398645,-21600,,
com.microsoft.VSCode,80,1738508617,1738508697,1738508697.324109,-21600,,
com.google.Chrome,2,1738508615,1738508617,1738508617.657263,-21600,,
com.microsoft.VSCode,4,1738508611,1738508615,1738508615.272574,-21600,,
com.google.Chrome,93,1738508518,1738508611,1738508611.499737,-21600,,
com.leomehlig.today,18,1738508483,1738508501,1738508503.301089,-21600,,
com.google.Chrome,11,1738508472,1738508483,1738508483.753824,-21600,,
com.google.chrome.ios,52,1738508356,1738508408,1738508408.659803,-21600,EB445137-D7F5-57EC-87DA-1DB460D64046,"iPhone13,2"
com.apple.weather,1,1738508355,1738508356,1738508357.140091,-21600,EB445137-D7F5-57EC-87DA-1DB460D64046,"iPhone13,2"
com.apple.weather,8,1738508150,1738508158,1738508158.740426,-21600,EB445137-D7F5-57EC-87DA-1DB460D64046,"iPhone13,2"
com.apple.Health,24,1738508123,1738508147,1738508147.43348,-21600,EB445137-D7F5-57EC-87DA-1DB460D64046,"iPhone13,2"
com.microsoft.Office.Outlook,8,1738508113,1738508121,1738508121.674123,-21600,EB445137-D7F5-57EC-87DA-1DB460D64046,"iPhone13,2"
com.renpho.health,1,1738508112,1738508113,1738508113.65736,-21600,EB445137-D7F5-57EC-87DA-1DB460D64046,"iPhone13,2"
com.renpho.health,22,1738507374,1738507396,1738507397.051447,-21600,EB445137-D7F5-57EC-87DA-1DB460D64046,"iPhone13,2"
com.apple.news,2,1738507370,1738507372,1738507372.790293,-21600,EB445137-D7F5-57EC-87DA-1DB460D64046,"iPhone13,2"
com.google.Chrome,42,1738475670,1738475712,1738475713.083888,-21600,,
com.google.Chrome,1165,1738474109,1738475274,1738475274.4861689,-21600,,
com.apple.news,36,1738474015,1738474051,1738474051.924582,-21600,EB445137-D7F5-57EC-87DA-1DB460D64046,"iPhone13,2"
com.apple.news,29,1738473927,1738473956,1738473956.8826241,-21600,EB445137-D7F5-57EC-87DA-1DB460D64046,"iPhone13,2"
com.google.Chrome,300,1738473593,1738473893,1738473893.3890991,-21600,,
com.google.Chrome,523,1738473033,1738473556,1738473556.971823,-21600,,
com.apple.finder,1,1738473032,1738473033,1738473033.9485068,-21600,,
com.google.Chrome,100,1738472932,1738473032,1738473033.541069,-21600,,
com.leomehlig.today,110,1738472816,1738472926,1738472926.105998,-21600,,
com.google.Chrome,10,1738472806,1738472816,1738472816.811994,-21600,,
com.leomehlig.today,6,1738472800,1738472806,1738472806.17315,-21600,,
com.google.Chrome,9,1738472791,1738472800,1738472801.0382628,-21600,,
com.leomehlig.today,4,1738472787,1738472791,1738472792.00454,-21600,,
com.google.Chrome,4,1738472783,1738472787,1738472787.411635,-21600,,
com.leomehlig.today,15,1738472768,1738472783,1738472783.535036,-21600,,
com.google.Chrome,7,1738472761,1738472768,1738472768.68489,-21600,,
com.leomehlig.today,3,1738472758,1738472761,1738472761.450933,-21600,,
com.google.Chrome,3,1738472755,1738472758,1738472758.794674,-21600,,
com.leomehlig.today,4,1738472751,1738472755,1738472755.63768,-21600,,
com.google.Chrome,10,1738472741,1738472751,1738472751.2177858,-21600,,
com.leomehlig.today,5,1738472736,1738472741,1738472741.0630522,-21600,,
com.google.Chrome,7,1738472729,1738472736,1738472736.6512861,-21600,,
com.leomehlig.today,8,1738472721,1738472729,1738472729.742626,-21600,,
com.apple.finder,1,1738472720,1738472721,1738472721.410578,-21600,,
com.microsoft.onenote.mac,5,1738472715,1738472720,1738472720.752588,-21600,,
com.google.Chrome,77,1738472638,1738472715,1738472715.779774,-21600,,
com.microsoft.onenote.mac,13,1738472625,1738472638,1738472638.610398,-21600,,
com.google.Chrome,1,1738472624,1738472625,1738472625.33269,-21600,,
com.microsoft.onenote.mac,33,1738472591,1738472624,1738472624.493404,-21600,,
com.google.Chrome,8,1738472577,1738472585,1738472585.166088,-21600,,
com.apple.Health,82,1738472503,1738472585,1738472585.292544,-21600,EB445137-D7F5-57EC-87DA-1DB460D64046,"iPhone13,2"
com.google.chrome.ios,0,1738472503,1738472503,1738472504.4203439,-21600,EB445137-D7F5-57EC-87DA-1DB460D64046,"iPhone13,2"
com.google.chrome.ios,51,1738465513,1738465564,1738465564.474035,-21600,EB445137-D7F5-57EC-87DA-1DB460D64046,"iPhone13,2"
com.apple.GameOverlayUI,6,1738463631,1738463637,1738463637.946126,-21600,EB445137-D7F5-57EC-87DA-1DB460D64046,"iPhone13,2"
com.supercell.magic,111,1738463627,1738463738,1738463738.554663,-21600,EB445137-D7F5-57EC-87DA-1DB460D64046,"iPhone13,2"
com.apple.Health,139,1738463467,1738463606,1738463606.785634,-21600,EB445137-D7F5-57EC-87DA-1DB460D64046,"iPhone13,2"
com.apple.Health,129,1738463277,1738463406,1738463407.036783,-21600,EB445137-D7F5-57EC-87DA-1DB460D64046,"iPhone13,2"
com.myfitnesspal.mfp,4,1738463270,1738463274,1738463274.7096062,-21600,EB445137-D7F5-57EC-87DA-1DB460D64046,"iPhone13,2"
com.myfitnesspal.mfp,26,1738463238,1738463264,1738463264.166563,-21600,EB445137-D7F5-57EC-87DA-1DB460D64046,"iPhone13,2"
com.google.chrome.ios,90,1738463088,1738463178,1738463178.698911,-21600,EB445137-D7F5-57EC-87DA-1DB460D64046,"iPhone13,2"
com.apple.news,122,1738462965,1738463087,1738463087.406985,-21600,EB445137-D7F5-57EC-87DA-1DB460D64046,"iPhone13,2"
com.apple.GameOverlayUI,7,1738462539,1738462546,1738462546.1288571,-21600,EB445137-D7F5-57EC-87DA-1DB460D64046,"iPhone13,2"
com.supercell.magic,426,1738462526,1738462952,1738462952.9450622,-21600,EB445137-D7F5-57EC-87DA-1DB460D64046,"iPhone13,2"
com.apple.CoreAuthUI,1,1738462497,1738462498,1738462498.297402,-21600,EB445137-D7F5-57EC-87DA-1DB460D64046,"iPhone13,2"
com.robinhood.release.Robinhood,2,1738462496,1738462498,1738462498.263414,-21600,EB445137-D7F5-57EC-87DA-1DB460D64046,"iPhone13,2"
com.apple.CoreAuthUI,2,1738462395,1738462397,1738462397.74101,-21600,EB445137-D7F5-57EC-87DA-1DB460D64046,"iPhone13,2"
com.robinhood.release.Robinhood,14,1738462390,1738462404,1738462404.496737,-21600,EB445137-D7F5-57EC-87DA-1DB460D64046,"iPhone13,2"
com.apple.MobileSMS,7,1738462321,1738462328,1738462328.620507,-21600,EB445137-D7F5-57EC-87DA-1DB460D64046,"iPhone13,2"
com.apple.MobileSMS,21,1738462282,1738462303,1738462303.793357,-21600,EB445137-D7F5-57EC-87DA-1DB460D64046,"iPhone13,2"
com.myfitnesspal.mfp,0,1738462282,1738462282,1738462283.0219169,-21600,EB445137-D7F5-57EC-87DA-1DB460D64046,"iPhone13,2"
com.myfitnesspal.mfp,5,1738453666,1738453671,1738453672.705529,-21600,EB445137-D7F5-57EC-87DA-1DB460D64046,"iPhone13,2"
com.leomehlig.today,2,1738453664,1738453666,1738453667.6644769,-21600,EB445137-D7F5-57EC-87DA-1DB460D64046,"iPhone13,2"
com.apple.news,1,1738453663,1738453664,1738453664.69678,-21600,EB445137-D7F5-57EC-87DA-1DB460D64046,"iPhone13,2"
com.apple.news,17,1738453341,1738453358,1738453358.73398,-21600,EB445137-D7F5-57EC-87DA-1DB460D64046,"iPhone13,2"
com.apple.news,128,1738453186,1738453314,1738453314.3546119,-21600,EB445137-D7F5-57EC-87DA-1DB460D64046,"iPhone13,2"
com.leomehlig.today,323,1738452782,1738453105,1738453105.8577209,-21600,EB445137-D7F5-57EC-87DA-1DB460D64046,"iPhone13,2"
com.myfitnesspal.mfp,2,1738452777,1738452779,1738452779.672894,-21600,EB445137-D7F5-57EC-87DA-1DB460D64046,"iPhone13,2"
com.myfitnesspal.mfp,40,1738452419,1738452459,1738452459.641127,-21600,EB445137-D7F5-57EC-87DA-1DB460D64046,"iPhone13,2"
com.myfitnesspal.mfp,26,1738452041,1738452067,1738452068.3584619,-21600,EB445137-D7F5-57EC-87DA-1DB460D64046,"iPhone13,2"
com.myfitnesspal.mfp,8,1738452003,1738452011,1738452011.987258,-21600,EB445137-D7F5-57EC-87DA-1DB460D64046,"iPhone13,2"
com.myfitnesspal.mfp,121,1738451876,1738451997,1738451997.3891091,-21600,EB445137-D7F5-57EC-87DA-1DB460D64046,"iPhone13,2"
com.apple.MobileSMS,27,1738451849,1738451876,1738451876.525762,-21600,EB445137-D7F5-57EC-87DA-1DB460D64046,"iPhone13,2"
com.google.Chrome,63,1738449927,1738449990,1738449990.194584,-21600,,
com.apple.MobileSMS,2,1738449891,1738449893,1738449893.7111201,-21600,,
com.microsoft.VSCode,957,1738448934,1738449891,1738449891.663801,-21600,,
com.apple.MobileSMS,2,1738448932,1738448934,1738448934.805198,-21600,,
com.microsoft.VSCode,110,1738448822,1738448932,1738448932.858222,-21600,,
com.apple.MobileSMS,1,1738448821,1738448822,1738448822.939343,-21600,,
com.microsoft.VSCode,13,1738448808,1738448821,1738448821.696165,-21600,,
com.apple.MobileSMS,1,1738448807,1738448808,1738448808.857987,-21600,,
com.google.Chrome,16,1738448791,1738448807,1738448807.4538422,-21600,,
com.apple.MobileSMS,2,1738448789,1738448791,1738448791.547205,-21600,,
com.google.Chrome,1,1738448788,1738448789,1738448789.54385,-21600,,
com.apple.MobileSMS,1,1738448787,1738448788,1738448788.3913589,-21600,,
com.google.Chrome,5,1738448782,1738448787,1738448787.220335,-21600,,
com.apple.MobileSMS,14,1738448768,1738448782,1738448782.578862,-21600,,
com.google.Chrome,17,1738448751,1738448768,1738448768.058866,-21600,,
com.microsoft.VSCode,5,1738448746,1738448751,1738448751.227841,-21600,,
com.google.Chrome,18,1738448728,1738448746,1738448746.94228,-21600,,
com.microsoft.VSCode,420,1738448308,1738448728,1738448728.7252688,-21600,,
com.google.Chrome,6,1738448302,1738448308,1738448308.173656,-21600,,
com.microsoft.VSCode,164,1738448138,1738448302,1738448302.3011441,-21600,,
com.google.Chrome,4,1738448134,1738448138,1738448139.0242481,-21600,,
com.microsoft.VSCode,67,1738448067,1738448134,1738448134.442527,-21600,,
com.google.Chrome,2,1738448065,1738448067,1738448067.501993,-21600,,
com.microsoft.VSCode,5,1738448060,1738448065,1738448065.23019,-21600,,
com.google.Chrome,14,1738448046,1738448060,1738448060.7739139,-21600,,
com.microsoft.VSCode,1,1738448045,1738448046,1738448046.0654268,-21600,,
com.google.Chrome,32,1738448013,1738448045,1738448045.4572558,-21600,,
com.microsoft.VSCode,105,1738447908,1738448013,1738448013.974215,-21600,,
com.google.Chrome,12,1738447896,1738447908,1738447908.6998692,-21600,,
com.microsoft.VSCode,337,1738447559,1738447896,1738447896.368682,-21600,,
com.google.Chrome,2,1738447557,1738447559,1738447559.7067099,-21600,,
com.microsoft.VSCode,26,1738447531,1738447557,1738447557.364568,-21600,,
com.google.Chrome,9,1738447522,1738447531,1738447531.093523,-21600,,
com.microsoft.VSCode,295,1738447227,1738447522,1738447522.2916288,-21600,,
com.google.Chrome,20,1738447207,1738447227,1738447227.196237,-21600,,
com.microsoft.VSCode,1,1738447206,1738447207,1738447210.023135,-21600,,
com.leomehlig.today,9,1738447197,1738447206,1738447207.188968,-21600,,
com.intsig.CamScannerLite,2,1738447190,1738447192,1738447192.555752,-21600,EB445137-D7F5-57EC-87DA-1DB460D64046,"iPhone13,2"
com.apple.finder,11,1738447186,1738447197,1738447200.802145,-21600,,
com.apple.MobileSMS,32,1738447154,1738447186,1738447186.363889,-21600,,
com.apple.finder,8,1738447146,1738447154,1738447154.241121,-21600,,
com.apple.MobileSMS,5,1738447141,1738447146,1738447146.939268,-21600,,
com.google.Chrome,56,1738447085,1738447141,1738447141.387311,-21600,,
com.leomehlig.today,28,1738447046,1738447074,1738447074.664452,-21600,,
com.google.Chrome,1088,1738445958,1738447046,1738447046.7222428,-21600,,
com.leomehlig.today,1,1738445957,1738445958,1738445958.844388,-21600,,
com.google.Chrome,633,1738445324,1738445957,1738445957.100251,-21600,,
com.apple.finder,6,1738445299,1738445305,1738445305.43561,-21600,,
com.intsig.CamScannerLite,200,1738445131,1738445331,1738445332.283372,-21600,EB445137-D7F5-57EC-87DA-1DB460D64046,"iPhone13,2"
com.apple.MobileSMS,12,1738445118,1738445130,1738445130.159875,-21600,EB445137-D7F5-57EC-87DA-1DB460D64046,"iPhone13,2"
com.google.Chrome,295,1738445004,1738445299,1738445299.938765,-21600,,
com.leomehlig.today,9,1738444995,1738445004,1738445005.7851539,-21600,,
com.apple.MobileSMS,2,1738444803,1738444805,1738444805.226585,-21600,EB445137-D7F5-57EC-87DA-1DB460D64046,"iPhone13,2"
com.leomehlig.today,3,1738444800,1738444803,1738444803.20057,-21600,EB445137-D7F5-57EC-87DA-1DB460D64046,"iPhone13,2"
com.apple.MobileSMS,5,1738444794,1738444799,1738444799.687628,-21600,EB445137-D7F5-57EC-87DA-1DB460D64046,"iPhone13,2"
com.leomehlig.today,18,1738444776,1738444794,1738444794.107737,-21600,EB445137-D7F5-57EC-87DA-1DB460D64046,"iPhone13,2"
com.apple.MobileSMS,35,1738444741,1738444776,1738444776.8752298,-21600,EB445137-D7F5-57EC-87DA-1DB460D64046,"iPhone13,2"
com.leomehlig.today,166,1738444574,1738444740,1738444740.19997,-21600,EB445137-D7F5-57EC-87DA-1DB460D64046,"iPhone13,2"
com.leomehlig.today,322,1738444491,1738444813,1738444813.598055,-21600,,
com.google.Chrome,497,1738443994,1738444491,1738444491.478081,-21600,,
com.leomehlig.today,2,1738443992,1738443994,1738443994.1224,-21600,,
com.google.Chrome,912,1738443080,1738443992,1738443992.527489,-21600,,
com.google.Chrome,300,1738442717,1738443017,1738443017.092515,-21600,,
com.leomehlig.today,41,1738442676,1738442717,1738442717.104086,-21600,,
com.google.Chrome,18,1738442658,1738442676,1738442676.962928,-21600,,
com.google.Chrome,300,1738442116,1738442416,1738442416.185566,-21600,,
com.leomehlig.today,7,1738442109,1738442116,1738442116.19805,-21600,,
com.google.Chrome,29,1738442080,1738442109,1738442109.12444,-21600,,
com.google.Chrome,458,1738441591,1738442049,1738442049.494084,-21600,,
com.google.Chrome,313,1738441060,1738441373,1738441373.623425,-21600,,
com.leomehlig.today,59,1738441001,1738441060,1738441060.750238,-21600,,
com.google.Chrome,149,1738440852,1738441001,1738441001.5694962,-21600,,
com.leomehlig.today,22,1738440830,1738440852,1738440853.102366,-21600,,
com.google.Chrome,1361,1738439469,1738440830,1738440830.810648,-21600,,
com.leomehlig.today,12,1738439457,1738439469,1738439469.511601,-21600,,
com.google.Chrome,252,1738439205,1738439457,1738439457.887196,-21600,,
com.tinyspeck.chatlyio,68,1738438380,1738438448,1738438448.9299989,-21600,EB445137-D7F5-57EC-87DA-1DB460D64046,"iPhone13,2"
com.apple.MobileSMS,1,1738438378,1738438379,1738438379.7885509,-21600,EB445137-D7F5-57EC-87DA-1DB460D64046,"iPhone13,2"
com.apple.MobileSMS,2,1738438048,1738438050,1738438050.756225,-21600,EB445137-D7F5-57EC-87DA-1DB460D64046,"iPhone13,2"
com.apple.MobileSMS,10,1738437795,1738437805,1738437805.347423,-21600,EB445137-D7F5-57EC-87DA-1DB460D64046,"iPhone13,2"
com.google.Chrome,474,1738437778,1738438252,1738438252.138241,-21600,,
com.apple.MobileSMS,6,1738437732,1738437738,1738437738.8528972,-21600,EB445137-D7F5-57EC-87DA-1DB460D64046,"iPhone13,2"
com.apple.mobileslideshow,2,1738437730,1738437732,1738437732.1300259,-21600,EB445137-D7F5-57EC-87DA-1DB460D64046,"iPhone13,2"
com.apple.MobileSMS,15,1738437715,1738437730,1738437730.689879,-21600,EB445137-D7F5-57EC-87DA-1DB460D64046,"iPhone13,2"
com.apple.mobileslideshow,8,1738437707,1738437715,1738437716.127907,-21600,EB445137-D7F5-57EC-87DA-1DB460D64046,"iPhone13,2"
com.apple.MobileSMS,19,1738437672,1738437691,1738437691.3413792,-21600,EB445137-D7F5-57EC-87DA-1DB460D64046,"iPhone13,2"
com.intsig.CamScannerLite,1,1738437671,1738437672,1738437672.686256,-21600,EB445137-D7F5-57EC-87DA-1DB460D64046,"iPhone13,2"
com.leomehlig.today,117,1738437661,1738437778,1738437778.287984,-21600,,
com.google.Chrome,1,1738437660,1738437661,1738437661.652988,-21600,,
com.google.Chrome,991,1738436611,1738437602,1738437602.629025,-21600,,
com.google.Chrome,731,1738435737,1738436468,1738436468.082014,-21600,,
com.leomehlig.today,2,1738435735,1738435737,1738435737.617697,-21600,,
com.google.Chrome,105,1738435630,1738435735,1738435735.536895,-21600,,
com.apple.finder,5,1738435625,1738435630,1738435630.826023,-21600,,
com.apple.iCal,45,1738435580,1738435625,1738435625.541144,-21600,,
com.apple.finder,170,1738435410,1738435580,1738435580.9620628,-21600,,
com.apple.iCal,156,1738435254,1738435410,1738435410.721089,-21600,,
com.intsig.CamScannerLite,281,1738435184,1738435465,1738435466.026,-21600,EB445137-D7F5-57EC-87DA-1DB460D64046,"iPhone13,2"
com.google.Chrome,78,1738435176,1738435254,1738435254.812844,-21600,,
com.intsig.CamScannerLite,178,1738434897,1738435075,1738435075.393313,-21600,EB445137-D7F5-57EC-87DA-1DB460D64046,"iPhone13,2"
com.truebill.truebillnative,138,1738434756,1738434894,1738434894.326375,-21600,EB445137-D7F5-57EC-87DA-1DB460D64046,"iPhone13,2"
com.apple.MobileSMS,5,1738434751,1738434756,1738434756.643495,-21600,EB445137-D7F5-57EC-87DA-1DB460D64046,"iPhone13,2"
com.apple.CoreAuthUI,2,1738434716,1738434718,1738434718.6943789,-21600,EB445137-D7F5-57EC-87DA-1DB460D64046,"iPhone13,2"
com.truebill.truebillnative,38,1738434713,1738434751,1738434751.8538132,-21600,EB445137-D7F5-57EC-87DA-1DB460D64046,"iPhone13,2"
com.intsig.CamScannerLite,3,1738434690,1738434693,1738434693.8333092,-21600,EB445137-D7F5-57EC-87DA-1DB460D64046,"iPhone13,2"
com.intsig.CamScannerLite,10,1738434648,1738434658,1738434658.670261,-21600,EB445137-D7F5-57EC-87DA-1DB460D64046,"iPhone13,2"
com.apple.Music,2,1738434643,1738434645,1738434646.000592,-21600,EB445137-D7F5-57EC-87DA-1DB460D64046,"iPhone13,2"
com.google.Chrome,300,1738434551,1738434851,1738434851.661094,-21600,,
com.apple.finder,80,1738434471,1738434551,1738434551.684515,-21600,,
com.google.Chrome,3,1738434468,1738434471,1738434471.158207,-21600,,
com.apple.finder,2,1738434466,1738434468,1738434468.43874,-21600,,
com.apple.Preview,1,1738434465,1738434466,1738434466.198166,-21600,,
com.apple.finder,2,1738434463,1738434465,1738434465.085981,-21600,,
com.google.Chrome,1,1738434462,1738434463,1738434463.390215,-21600,,
com.apple.finder,8,1738434454,1738434462,1738434462.2796478,-21600,,
com.google.Chrome,376,1738434078,1738434454,1738434454.3887029,-21600,,
com.apple.finder,7,1738434054,1738434061,1738434061.412703,-21600,,
com.leomehlig.today,22,1738434032,1738434054,1738434055.029715,-21600,,
com.apple.Music,27,1738433273,1738433300,1738433300.781314,-21600,EB445137-D7F5-57EC-87DA-1DB460D64046,"iPhone13,2"
com.apple.Music,13,1738432546,1738432559,1738432559.1109939,-21600,EB445137-D7F5-57EC-87DA-1DB460D64046,"iPhone13,2"
com.apple.weather,2,1738432544,1738432546,1738432547.002664,-21600,EB445137-D7F5-57EC-87DA-1DB460D64046,"iPhone13,2"
com.apple.weather,5,1738432422,1738432427,1738432428.118314,-21600,EB445137-D7F5-57EC-87DA-1DB460D64046,"iPhone13,2"
com.google.ios.youtube,582,1738431807,1738432389,1738432389.713937,-21600,EB445137-D7F5-57EC-87DA-1DB460D64046,"iPhone13,2"
com.google.ios.youtube,220,1738431488,1738431708,1738431708.523047,-21600,EB445137-D7F5-57EC-87DA-1DB460D64046,"iPhone13,2"
com.apple.weather,3,1738431423,1738431426,1738431426.504716,-21600,EB445137-D7F5-57EC-87DA-1DB460D64046,"iPhone13,2"
com.apple.weather,11,1738431382,1738431393,1738431393.726081,-21600,EB445137-D7F5-57EC-87DA-1DB460D64046,"iPhone13,2"
com.truebill.truebillnative,1,1738431380,1738431381,1738431382.1799068,-21600,EB445137-D7F5-57EC-87DA-1DB460D64046,"iPhone13,2"
com.apple.news,85,1738431146,1738431231,1738431231.223771,-21600,EB445137-D7F5-57EC-87DA-1DB460D64046,"iPhone13,2"
com.apple.news,2,1738431143,1738431145,1738431145.868805,-21600,EB445137-D7F5-57EC-87DA-1DB460D64046,"iPhone13,2"
com.leomehlig.today,38,1738431022,1738431060,1738431060.984436,-21600,,
com.google.Chrome,26,1738430996,1738431022,1738431022.434881,-21600,,
com.leomehlig.today,17,1738430979,1738430996,1738430997.861805,-21600,,
com.apple.news,452,1738430025,1738430477,1738430478.280679,-21600,EB445137-D7F5-57EC-87DA-1DB460D64046,"iPhone13,2"
com.myfitnesspal.mfp,8,1738430013,1738430021,1738430021.569766,-21600,EB445137-D7F5-57EC-87DA-1DB460D64046,"iPhone13,2"
com.myfitnesspal.mfp,63,1738429929,1738429992,1738429993.475694,-21600,EB445137-D7F5-57EC-87DA-1DB460D64046,"iPhone13,2"
com.tinyspeck.chatlyio,38,1738429723,1738429761,1738429762.044826,-21600,EB445137-D7F5-57EC-87DA-1DB460D64046,"iPhone13,2"
com.apple.MobileSMS,2,1738429718,1738429720,1738429720.570462,-21600,EB445137-D7F5-57EC-87DA-1DB460D64046,"iPhone13,2"
com.apple.MobileSMS,1,1738429558,1738429559,1738429560.24402,-21600,EB445137-D7F5-57EC-87DA-1DB460D64046,"iPhone13,2"
com.apple.MobileSMS,8,1738429391,1738429399,1738429399.711479,-21600,EB445137-D7F5-57EC-87DA-1DB460D64046,"iPhone13,2"
com.duosecurity.DuoMobile,0,1738429391,1738429391,1738429391.830048,-21600,EB445137-D7F5-57EC-87DA-1DB460D64046,"iPhone13,2"
com.leomehlig.today,6,1738429376,1738429382,1738429382.957866,-21600,,
com.cisco.secureclient.gui,6,1738429370,1738429376,1738429376.4996119,-21600,,
com.leomehlig.today,1,1738429369,1738429370,1738429370.972048,-21600,,
com.apple.Terminal,3,1738429366,1738429369,1738429369.395364,-21600,,
com.leomehlig.today,4,1738429362,1738429366,1738429366.4499478,-21600,,
com.electron.carta,1,1738429361,1738429362,1738429362.877809,-21600,,
com.microsoft.VSCode,7,1738429354,1738429361,1738429361.9530911,-21600,,
com.google.Chrome,150,1738429204,1738429354,1738429354.340101,-21600,,
com.leomehlig.today,23,1738429181,1738429204,1738429204.120854,-21600,,
com.google.Chrome,38,1738429143,1738429181,1738429181.5291939,-21600,,
com.microsoft.VSCode,53,1738429090,1738429143,1738429143.270883,-21600,,
com.google.Chrome,8,1738429082,1738429090,1738429090.204135,-21600,,
com.microsoft.VSCode,202,1738428880,1738429082,1738429082.131834,-21600,,
com.google.Chrome,1,1738428879,1738428880,1738428880.729978,-21600,,
com.microsoft.VSCode,2,1738428877,1738428879,1738428879.4409819,-21600,,
com.google.Chrome,3,1738428874,1738428877,1738428877.800167,-21600,,
com.microsoft.VSCode,3,1738428871,1738428874,1738428874.850508,-21600,,
com.google.Chrome,15,1738428856,1738428871,1738428871.1261458,-21600,,
com.microsoft.VSCode,1,1738428855,1738428856,1738428856.9007568,-21600,,
com.google.Chrome,4,1738428851,1738428855,1738428855.503162,-21600,,
com.microsoft.VSCode,61,1738428790,1738428851,1738428851.871578,-21600,,
com.google.Chrome,4,1738428786,1738428790,1738428790.461118,-21600,,
com.electron.carta,0,1738428786,1738428786,1738428786.9658499,-21600,,
com.google.Chrome,19,1738428767,1738428786,1738428786.149331,-21600,,
com.electron.carta,2,1738428765,1738428767,1738428767.4831362,-21600,,
com.google.Chrome,2,1738428763,1738428765,1738428765.81686,-21600,,
com.electron.carta,3,1738428760,1738428763,1738428763.775786,-21600,,
com.google.Chrome,7,1738428753,1738428760,1738428760.521222,-21600,,
com.electron.carta,20,1738428733,1738428753,1738428753.428067,-21600,,
com.google.Chrome,11,1738428722,1738428733,1738428733.117769,-21600,,
com.microsoft.VSCode,2,1738428720,1738428722,1738428722.188765,-21600,,
com.electron.carta,2,1738428718,1738428720,1738428720.8455439,-21600,,
com.microsoft.VSCode,1,1738428717,1738428718,1738428718.978544,-21600,,
com.google.Chrome,5,1738428712,1738428717,1738428717.127339,-21600,,
com.microsoft.VSCode,43,1738428669,1738428712,1738428712.8914928,-21600,,
com.electron.carta,66,1738428603,1738428669,1738428669.531393,-21600,,
com.microsoft.VSCode,33,1738428570,1738428603,1738428603.146638,-21600,,
com.apple.Preview,1,1738428569,1738428570,1738428570.580853,-21600,,
com.google.Chrome,15,1738428554,1738428569,1738428569.1553311,-21600,,
com.apple.Preview,4,1738428550,1738428554,1738428554.1871629,-21600,,
com.microsoft.VSCode,10,1738428540,1738428550,1738428550.6564178,-21600,,
com.apple.Preview,1,1738428539,1738428540,1738428540.31292,-21600,,
com.google.Chrome,18,1738428521,1738428539,1738428539.467778,-21600,,
com.apple.Preview,19,1738428502,1738428521,1738428521.566776,-21600,,
com.microsoft.VSCode,3,1738428499,1738428502,1738428502.916682,-21600,,
com.apple.Preview,2,1738428497,1738428499,1738428499.591834,-21600,,
com.microsoft.VSCode,231,1738428266,1738428497,1738428498.0246649,-21600,,
com.google.Chrome,20,1738428246,1738428266,1738428266.404832,-21600,,
com.microsoft.VSCode,19,1738428227,1738428246,1738428246.973034,-21600,,
com.google.Chrome,26,1738428201,1738428227,1738428227.09016,-21600,,
com.microsoft.VSCode,55,1738428146,1738428201,1738428201.345742,-21600,,
com.google.Chrome,3,1738428143,1738428146,1738428146.313449,-21600,,
com.apple.Preview,10,1738428133,1738428143,1738428143.592085,-21600,,
com.google.Chrome,1,1738428132,1738428133,1738428133.576912,-21600,,
com.microsoft.VSCode,24,1738428108,1738428132,1738428132.103901,-21600,,
com.google.Chrome,2,1738428106,1738428108,1738428108.439645,-21600,,
com.electron.carta,1,1738428105,1738428106,1738428106.892529,-21600,,
com.apple.Preview,8,1738428097,1738428105,1738428105.194798,-21600,,
com.electron.carta,1,1738428096,1738428097,1738428097.884803,-21600,,
com.microsoft.VSCode,13,1738428083,1738428096,1738428096.8603,-21600,,
com.electron.carta,10,1738428073,1738428083,1738428084.0201402,-21600,,
com.apple.Preview,49,1738428024,1738428073,1738428073.301879,-21600,,
com.electron.carta,14,1738428010,1738428024,1738428024.912609,-21600,,
com.microsoft.VSCode,2,1738428008,1738428010,1738428010.988122,-21600,,
com.electron.carta,20,1738427988,1738428008,1738428008.847158,-21600,,
com.microsoft.VSCode,91,1738427897,1738427988,1738427988.566914,-21600,,
com.google.Chrome,2,1738427895,1738427897,1738427897.127719,-21600,,
com.microsoft.VSCode,342,1738427553,1738427895,1738427895.885308,-21600,,
com.google.Chrome,20,1738427533,1738427553,1738427553.85267,-21600,,
com.microsoft.VSCode,182,1738427351,1738427533,1738427533.174611,-21600,,
com.apple.finder,67,1738427284,1738427351,1738427351.3803492,-21600,,
com.microsoft.VSCode,828,1738426456,1738427284,1738427284.214384,-21600,,
com.google.Chrome,11,1738426445,1738426456,1738426456.224639,-21600,,
com.microsoft.VSCode,42,1738426403,1738426445,1738426445.3142629,-21600,,
com.google.Chrome,69,1738426334,1738426403,1738426404.003602,-21600,,
com.microsoft.VSCode,268,1738426066,1738426334,1738426334.8147678,-21600,,
com.google.Chrome,1,1738426065,1738426066,1738426066.201318,-21600,,
com.microsoft.VSCode,14,1738426051,1738426065,1738426065.5794,-21600,,
com.google.Chrome,7,1738426044,1738426051,1738426051.184124,-21600,,
com.microsoft.VSCode,65,1738425979,1738426044,1738426044.13413,-21600,,
com.google.Chrome,34,1738425945,1738425979,1738425979.676896,-21600,,
com.microsoft.VSCode,828,1738425117,1738425945,1738425945.1830812,-21600,,
com.apple.Terminal,129,1738424988,1738425117,1738425117.8284159,-21600,,
com.microsoft.VSCode,51,1738424937,1738424988,1738424988.561088,-21600,,
com.apple.Terminal,82,1738424855,1738424937,1738424937.111453,-21600,,
com.microsoft.VSCode,14,1738424841,1738424855,1738424855.840529,-21600,,
com.apple.Terminal,53,1738424788,1738424841,1738424841.402935,-21600,,
com.microsoft.VSCode,4,1738424784,1738424788,1738424788.248794,-21600,,
com.apple.Terminal,72,1738424712,1738424784,1738424784.0759969,-21600,,
com.duosecurity.DuoMobile,3,1738424704,1738424707,1738424708.318983,-21600,EB445137-D7F5-57EC-87DA-1DB460D64046,"iPhone13,2"
com.truebill.truebillnative,1,1738424703,1738424704,1738424704.79446,-21600,EB445137-D7F5-57EC-87DA-1DB460D64046,"iPhone13,2"
com.cisco.secureclient.gui,51,1738424661,1738424712,1738424712.228198,-21600,,
com.apple.Terminal,5,1738424656,1738424661,1738424662.0022159,-21600,,
com.apple.Preview,23,1738424633,1738424656,1738424656.472863,-21600,,
com.microsoft.VSCode,244,1738424389,1738424633,1738424633.509845,-21600,,
com.google.Chrome,55,1738424334,1738424389,1738424389.572602,-21600,,
com.microsoft.VSCode,13,1738424321,1738424334,1738424334.49044,-21600,,
com.google.Chrome,8,1738424313,1738424321,1738424321.313524,-21600,,
com.microsoft.VSCode,42,1738424271,1738424313,1738424313.161169,-21600,,
com.google.Chrome,32,1738424239,1738424271,1738424271.836246,-21600,,
com.microsoft.VSCode,25,1738424214,1738424239,1738424239.8186002,-21600,,
com.google.Chrome,6,1738424208,1738424214,1738424214.342272,-21600,,
com.leomehlig.today,6,1738424202,1738424208,1738424208.5081491,-21600,,
com.google.Chrome,606,1738423596,1738424202,1738424202.7845469,-21600,,
com.apple.CoreAuthUI,2,1738423415,1738423417,1738423417.635693,-21600,EB445137-D7F5-57EC-87DA-1DB460D64046,"iPhone13,2"
com.truebill.truebillnative,27,1738423413,1738423440,1738423441.318159,-21600,EB445137-D7F5-57EC-87DA-1DB460D64046,"iPhone13,2"
com.apple.MobileSMS,3,1738423403,1738423406,1738423406.775271,-21600,EB445137-D7F5-57EC-87DA-1DB460D64046,"iPhone13,2"
com.clairmail.fth.client,3,1738423400,1738423403,1738423403.998903,-21600,EB445137-D7F5-57EC-87DA-1DB460D64046,"iPhone13,2"
com.clairmail.fth.client,0,1738423398,1738423398,1738423398.9247231,-21600,EB445137-D7F5-57EC-87DA-1DB460D64046,"iPhone13,2"
com.apple.CoreAuthUI,2,1738423361,1738423363,1738423363.688977,-21600,EB445137-D7F5-57EC-87DA-1DB460D64046,"iPhone13,2"
com.clairmail.fth.client,37,1738423357,1738423394,1738423394.847681,-21600,EB445137-D7F5-57EC-87DA-1DB460D64046,"iPhone13,2"
com.apple.MobileSMS,14,1738423341,1738423355,1738423355.1740851,-21600,EB445137-D7F5-57EC-87DA-1DB460D64046,"iPhone13,2"
com.leomehlig.today,4,1738423309,1738423313,1738423314.031505,-21600,,
com.google.Chrome,3,1738423306,1738423309,1738423309.594007,-21600,,
com.apple.MobileSMS,45,1738423223,1738423268,1738423269.044156,-21600,EB445137-D7F5-57EC-87DA-1DB460D64046,"iPhone13,2"
com.apple.calculator,8,1738423215,1738423223,1738423223.093111,-21600,EB445137-D7F5-57EC-87DA-1DB460D64046,"iPhone13,2"
com.apple.MobileSMS,2,1738423213,1738423215,1738423216.0400882,-21600,EB445137-D7F5-57EC-87DA-1DB460D64046,"iPhone13,2"
com.apple.MobileSMS,103,1738423102,1738423205,1738423205.691222,-21600,EB445137-D7F5-57EC-87DA-1DB460D64046,"iPhone13,2"
com.apple.calculator,88,1738423014,1738423102,1738423102.4013271,-21600,EB445137-D7F5-57EC-87DA-1DB460D64046,"iPhone13,2"
com.apple.MobileSMS,12,1738423002,1738423014,1738423015.039536,-21600,EB445137-D7F5-57EC-87DA-1DB460D64046,"iPhone13,2"
com.apple.calculator,1,1738423001,1738423002,1738423002.871073,-21600,EB445137-D7F5-57EC-87DA-1DB460D64046,"iPhone13,2"
com.apple.MobileSMS,7,1738422994,1738423001,1738423001.26271,-21600,EB445137-D7F5-57EC-87DA-1DB460D64046,"iPhone13,2"
com.apple.calculator,19,1738422975,1738422994,1738422994.7202358,-21600,EB445137-D7F5-57EC-87DA-1DB460D64046,"iPhone13,2"
com.renpho.health,3,1738422971,1738422974,1738422974.058317,-21600,EB445137-D7F5-57EC-87DA-1DB460D64046,"iPhone13,2"
com.renpho.health,61,1738420902,1738420963,1738420963.4904299,-21600,EB445137-D7F5-57EC-87DA-1DB460D64046,"iPhone13,2"
com.apple.news,142,1738419777,1738419919,1738419919.872714,-21600,EB445137-D7F5-57EC-87DA-1DB460D64046,"iPhone13,2"
com.apple.mobilecal,2,1738419743,1738419745,1738419745.3400621,-21600,EB445137-D7F5-57EC-87DA-1DB460D64046,"iPhone13,2"
com.apple.Health,46,1738419696,1738419742,1738419742.912837,-21600,EB445137-D7F5-57EC-87DA-1DB460D64046,"iPhone13,2"
com.apple.Music,102,1738390862,1738390964,1738390964.782881,-21600,EB445137-D7F5-57EC-87DA-1DB460D64046,"iPhone13,2"
com.apple.Music,43,1738390691,1738390734,1738390735.258775,-21600,EB445137-D7F5-57EC-87DA-1DB460D64046,"iPhone13,2"
com.google.chrome.ios,3,1738390685,1738390688,1738390689.0762181,-21600,EB445137-D7F5-57EC-87DA-1DB460D64046,"iPhone13,2"
com.google.chrome.ios,41,1738388683,1738388724,1738388724.574829,-21600,EB445137-D7F5-57EC-87DA-1DB460D64046,"iPhone13,2"
com.google.chrome.ios,88,1738385765,1738385853,1738385853.546114,-21600,EB445137-D7F5-57EC-87DA-1DB460D64046,"iPhone13,2"
com.apple.Health,2,1738385763,1738385765,1738385765.643291,-21600,EB445137-D7F5-57EC-87DA-1DB460D64046,"iPhone13,2"
com.apple.Health,35,1738382335,1738382370,1738382371.053841,-21600,EB445137-D7F5-57EC-87DA-1DB460D64046,"iPhone13,2"
com.myfitnesspal.mfp,95,1738382239,1738382334,1738382335.1057448,-21600,EB445137-D7F5-57EC-87DA-1DB460D64046,"iPhone13,2"
com.myfitnesspal.mfp,149,1738376875,1738377024,1738377024.3688722,-21600,EB445137-D7F5-57EC-87DA-1DB460D64046,"iPhone13,2"
com.google.chrome.ios,4,1738376871,1738376875,1738376876.117391,-21600,EB445137-D7F5-57EC-87DA-1DB460D64046,"iPhone13,2"
com.myfitnesspal.mfp,60,1738376811,1738376871,1738376871.6824331,-21600,EB445137-D7F5-57EC-87DA-1DB460D64046,"iPhone13,2"
com.google.chrome.ios,3,1738376808,1738376811,1738376812.146422,-21600,EB445137-D7F5-57EC-87DA-1DB460D64046,"iPhone13,2"
com.myfitnesspal.mfp,23,1738376785,1738376808,1738376808.6515532,-21600,EB445137-D7F5-57EC-87DA-1DB460D64046,"iPhone13,2"
com.google.chrome.ios,3,1738376782,1738376785,1738376785.495926,-21600,EB445137-D7F5-57EC-87DA-1DB460D64046,"iPhone13,2"
com.myfitnesspal.mfp,122,1738376660,1738376782,1738376782.948242,-21600,EB445137-D7F5-57EC-87DA-1DB460D64046,"iPhone13,2"
com.google.chrome.ios,4,1738376656,1738376660,1738376660.869471,-21600,EB445137-D7F5-57EC-87DA-1DB460D64046,"iPhone13,2"
com.myfitnesspal.mfp,71,1738376585,1738376656,1738376656.378824,-21600,EB445137-D7F5-57EC-87DA-1DB460D64046,"iPhone13,2"
com.google.chrome.ios,7,1738376578,1738376585,1738376586.2050328,-21600,EB445137-D7F5-57EC-87DA-1DB460D64046,"iPhone13,2"
com.myfitnesspal.mfp,24,1738376554,1738376578,1738376578.955224,-21600,EB445137-D7F5-57EC-87DA-1DB460D64046,"iPhone13,2"
com.google.chrome.ios,5,1738376549,1738376554,1738376554.645071,-21600,EB445137-D7F5-57EC-87DA-1DB460D64046,"iPhone13,2"
com.myfitnesspal.mfp,43,1738376506,1738376549,1738376549.549056,-21600,EB445137-D7F5-57EC-87DA-1DB460D64046,"iPhone13,2"
com.google.chrome.ios,35,1738376471,1738376506,1738376507.195743,-21600,EB445137-D7F5-57EC-87DA-1DB460D64046,"iPhone13,2"
com.myfitnesspal.mfp,8,1738376463,1738376471,1738376471.153823,-21600,EB445137-D7F5-57EC-87DA-1DB460D64046,"iPhone13,2"
com.google.chrome.ios,130,1738376333,1738376463,1738376463.3283339,-21600,EB445137-D7F5-57EC-87DA-1DB460D64046,"iPhone13,2"
com.myfitnesspal.mfp,50,1738376283,1738376333,1738376333.157047,-21600,EB445137-D7F5-57EC-87DA-1DB460D64046,"iPhone13,2"
com.google.chrome.ios,5,1738376278,1738376283,1738376283.853476,-21600,EB445137-D7F5-57EC-87DA-1DB460D64046,"iPhone13,2"
com.myfitnesspal.mfp,386,1738375892,1738376278,1738376278.33489,-21600,EB445137-D7F5-57EC-87DA-1DB460D64046,"iPhone13,2"
com.microsoft.Office.Outlook,1,1738375890,1738375891,1738375891.945795,-21600,EB445137-D7F5-57EC-87DA-1DB460D64046,"iPhone13,2"
com.microsoft.Office.Outlook,1,1738372786,1738372787,1738372787.561876,-21600,EB445137-D7F5-57EC-87DA-1DB460D64046,"iPhone13,2"
com.apple.mobiletimer,1,1738372785,1738372786,1738372786.400168,-21600,EB445137-D7F5-57EC-87DA-1DB460D64046,"iPhone13,2"
com.apple.mobiletimer,9,1738372343,1738372352,1738372352.396178,-21600,EB445137-D7F5-57EC-87DA-1DB460D64046,"iPhone13,2"
com.google.chrome.ios,7,1738372336,1738372343,1738372344.076052,-21600,EB445137-D7F5-57EC-87DA-1DB460D64046,"iPhone13,2"
com.google.chrome.ios,8,1738372306,1738372314,1738372315.076805,-21600,EB445137-D7F5-57EC-87DA-1DB460D64046,"iPhone13,2"
com.google.chrome.ios,5,1738372260,1738372265,1738372265.466642,-21600,EB445137-D7F5-57EC-87DA-1DB460D64046,"iPhone13,2"
com.google.chrome.ios,4,1738372194,1738372198,1738372199.017021,-21600,EB445137-D7F5-57EC-87DA-1DB460D64046,"iPhone13,2"
com.google.chrome.ios,36,1738371789,1738371825,1738371825.36219,-21600,EB445137-D7F5-57EC-87DA-1DB460D64046,"iPhone13,2"
com.google.chrome.ios,6,1738371470,1738371476,1738371477.0853481,-21600,EB445137-D7F5-57EC-87DA-1DB460D64046,"iPhone13,2"
com.google.chrome.ios,61,1738371316,1738371377,1738371377.913835,-21600,EB445137-D7F5-57EC-87DA-1DB460D64046,"iPhone13,2"
com.google.chrome.ios,62,1738371250,1738371312,1738371313.207075,-21600,EB445137-D7F5-57EC-87DA-1DB460D64046,"iPhone13,2"
com.google.chrome.ios,65,1738371174,1738371239,1738371240.345,-21600,EB445137-D7F5-57EC-87DA-1DB460D64046,"iPhone13,2"
com.google.chrome.ios,69,1738371066,1738371135,1738371135.313168,-21600,EB445137-D7F5-57EC-87DA-1DB460D64046,"iPhone13,2"
com.google.chrome.ios,227,1738370817,1738371044,1738371044.614325,-21600,EB445137-D7F5-57EC-87DA-1DB460D64046,"iPhone13,2"
com.google.chrome.ios,18,1738370724,1738370742,1738370742.450347,-21600,EB445137-D7F5-57EC-87DA-1DB460D64046,"iPhone13,2"
com.google.chrome.ios,14,1738370690,1738370704,1738370705.8791761,-21600,EB445137-D7F5-57EC-87DA-1DB460D64046,"iPhone13,2"
com.google.chrome.ios,31,1738369580,1738369611,1738369612.135323,-21600,EB445137-D7F5-57EC-87DA-1DB460D64046,"iPhone13,2"
com.google.chrome.ios,80,1738369086,1738369166,1738369166.74893,-21600,EB445137-D7F5-57EC-87DA-1DB460D64046,"iPhone13,2"
com.apple.mobilenotes,2,1738369084,1738369086,1738369086.709494,-21600,EB445137-D7F5-57EC-87DA-1DB460D64046,"iPhone13,2"
com.apple.mobilenotes,39,1738368689,1738368728,1738368728.6569,-21600,EB445137-D7F5-57EC-87DA-1DB460D64046,"iPhone13,2"
com.apple.mobilenotes,8,1738368608,1738368616,1738368616.519598,-21600,EB445137-D7F5-57EC-87DA-1DB460D64046,"iPhone13,2"
com.apple.Music,2,1738368606,1738368608,1738368608.186779,-21600,EB445137-D7F5-57EC-87DA-1DB460D64046,"iPhone13,2"
com.apple.Music,13,1738366976,1738366989,1738366989.664387,-21600,EB445137-D7F5-57EC-87DA-1DB460D64046,"iPhone13,2"
com.meijer.mobile.Meijer,0,1738366976,1738366976,1738366977.2478929,-21600,EB445137-D7F5-57EC-87DA-1DB460D64046,"iPhone13,2"
com.meijer.mobile.Meijer,42,1738366483,1738366525,1738366526.079893,-21600,EB445137-D7F5-57EC-87DA-1DB460D64046,"iPhone13,2"
com.apple.mobilenotes,3,1738366479,1738366482,1738366482.462185,-21600,EB445137-D7F5-57EC-87DA-1DB460D64046,"iPhone13,2"
com.apple.mobilenotes,5,1738366423,1738366428,1738366428.680725,-21600,EB445137-D7F5-57EC-87DA-1DB460D64046,"iPhone13,2"
com.apple.mobilenotes,3,1738366223,1738366226,1738366226.4343991,-21600,EB445137-D7F5-57EC-87DA-1DB460D64046,"iPhone13,2"
com.apple.mobilenotes,1,1738366115,1738366116,1738366117.059797,-21600,EB445137-D7F5-57EC-87DA-1DB460D64046,"iPhone13,2"
com.apple.mobilenotes,9,1738365946,1738365955,1738365955.3421059,-21600,EB445137-D7F5-57EC-87DA-1DB460D64046,"iPhone13,2"
com.apple.mobilenotes,8,1738365916,1738365924,1738365924.898948,-21600,EB445137-D7F5-57EC-87DA-1DB460D64046,"iPhone13,2"
com.apple.mobilenotes,7,1738365824,1738365831,1738365831.391056,-21600,EB445137-D7F5-57EC-87DA-1DB460D64046,"iPhone13,2"
com.google.chrome.ios,4,1738365820,1738365824,1738365824.589957,-21600,EB445137-D7F5-57EC-87DA-1DB460D64046,"iPhone13,2"
com.google.chrome.ios,9,1738364787,1738364796,1738364796.899771,-21600,EB445137-D7F5-57EC-87DA-1DB460D64046,"iPhone13,2"
com.google.chrome.ios,12,1738364765,1738364777,1738364777.207034,-21600,EB445137-D7F5-57EC-87DA-1DB460D64046,"iPhone13,2"
com.apple.mobilenotes,11,1738364754,1738364765,1738364765.270185,-21600,EB445137-D7F5-57EC-87DA-1DB460D64046,"iPhone13,2"
com.apple.mobilenotes,3,1738364722,1738364725,1738364725.494214,-21600,EB445137-D7F5-57EC-87DA-1DB460D64046,"iPhone13,2"
com.apple.mobilenotes,15,1738364614,1738364629,1738364629.9336948,-21600,EB445137-D7F5-57EC-87DA-1DB460D64046,"iPhone13,2"
com.google.chrome.ios,3,1738364611,1738364614,1738364614.066483,-21600,EB445137-D7F5-57EC-87DA-1DB460D64046,"iPhone13,2"
com.google.chrome.ios,3,1738364606,1738364609,1738364610.3978891,-21600,EB445137-D7F5-57EC-87DA-1DB460D64046,"iPhone13,2"
com.google.chrome.ios,9,1738364540,1738364549,1738364549.323808,-21600,EB445137-D7F5-57EC-87DA-1DB460D64046,"iPhone13,2"
com.google.chrome.ios,57,1738364408,1738364465,1738364466.088893,-21600,EB445137-D7F5-57EC-87DA-1DB460D64046,"iPhone13,2"
com.google.chrome.ios,7,1738364350,1738364357,1738364358.161385,-21600,EB445137-D7F5-57EC-87DA-1DB460D64046,"iPhone13,2"
com.google.chrome.ios,121,1738364154,1738364275,1738364276.2597399,-21600,EB445137-D7F5-57EC-87DA-1DB460D64046,"iPhone13,2"
com.apple.mobilenotes,2,1738364152,1738364154,1738364154.373505,-21600,EB445137-D7F5-57EC-87DA-1DB460D64046,"iPhone13,2"
com.apple.mobilenotes,15,1738364096,1738364111,1738364111.322534,-21600,EB445137-D7F5-57EC-87DA-1DB460D64046,"iPhone13,2"
com.apple.mobilenotes,15,1738364070,1738364085,1738364085.996618,-21600,EB445137-D7F5-57EC-87DA-1DB460D64046,"iPhone13,2"
com.apple.weather,2,1738364065,1738364067,1738364067.672223,-21600,EB445137-D7F5-57EC-87DA-1DB460D64046,"iPhone13,2"
com.apple.weather,11,1738361553,1738361564,1738361565.158175,-21600,EB445137-D7F5-57EC-87DA-1DB460D64046,"iPhone13,2"
com.apple.weather,1,1738361552,1738361553,1738361553.602525,-21600,EB445137-D7F5-57EC-87DA-1DB460D64046,"iPhone13,2"
com.apple.weather,4,1738361547,1738361551,1738361551.566427,-21600,EB445137-D7F5-57EC-87DA-1DB460D64046,"iPhone13,2"
com.google.Chrome,59,1738361418,1738361477,1738361478.2641149,-21600,,
com.microsoft.VSCode,729,1738360689,1738361418,1738361418.2055879,-21600,,
com.google.Chrome,66,1738360623,1738360689,1738360689.500338,-21600,,
com.microsoft.VSCode,63,1738360560,1738360623,1738360623.947751,-21600,,
com.google.Chrome,1,1738360559,1738360560,1738360560.31303,-21600,,
com.microsoft.VSCode,6,1738360553,1738360559,1738360559.496541,-21600,,
com.google.Chrome,18,1738360535,1738360553,1738360553.7105021,-21600,,
com.microsoft.VSCode,60,1738360475,1738360535,1738360535.047978,-21600,,
com.google.Chrome,2,1738360473,1738360475,1738360475.087642,-21600,,
com.microsoft.VSCode,2,1738360471,1738360473,1738360473.64108,-21600,,
com.google.Chrome,2,1738360469,1738360471,1738360471.7342482,-21600,,
com.microsoft.VSCode,8,1738360461,1738360469,1738360469.187664,-21600,,
com.google.Chrome,4,1738360457,1738360461,1738360461.4642758,-21600,,
com.microsoft.VSCode,8,1738360449,1738360457,1738360457.3197808,-21600,,
com.google.Chrome,54,1738360395,1738360449,1738360449.134592,-21600,,
com.microsoft.VSCode,21,1738360374,1738360395,1738360395.472019,-21600,,
com.apple.Preview,1,1738360373,1738360374,1738360374.337564,-21600,,
com.google.Chrome,9,1738360364,1738360373,1738360373.208585,-21600,,
com.apple.Preview,2,1738360362,1738360364,1738360364.147667,-21600,,
com.microsoft.VSCode,349,1738360013,1738360362,1738360362.977004,-21600,,
com.apple.Preview,1,1738360012,1738360013,1738360013.038072,-21600,,
com.microsoft.VSCode,23,1738359989,1738360012,1738360012.430551,-21600,,
com.apple.Preview,2,1738359987,1738359989,1738359989.188596,-21600,,
com.microsoft.VSCode,43,1738359944,1738359987,1738359988.01652,-21600,,
com.apple.Preview,1,1738359943,1738359944,1738359944.58253,-21600,,
com.microsoft.VSCode,19,1738359924,1738359943,1738359943.764317,-21600,,
com.apple.Preview,1,1738359923,1738359924,1738359924.8257852,-21600,,
com.google.Chrome,4,1738359919,1738359923,1738359924.047083,-21600,,
com.apple.Preview,1,1738359918,1738359919,1738359919.792121,-21600,,
com.microsoft.VSCode,47,1738359871,1738359918,1738359918.4386759,-21600,,
com.apple.Preview,1,1738359870,1738359871,1738359871.367903,-21600,,
com.google.Chrome,12,1738359858,1738359870,1738359870.259533,-21600,,
com.apple.Preview,1,1738359857,1738359858,1738359858.985666,-21600,,
com.microsoft.VSCode,534,1738359323,1738359857,1738359857.860743,-21600,,
com.apple.Preview,1,1738359322,1738359323,1738359323.0828938,-21600,,
com.microsoft.VSCode,69,1738359253,1738359322,1738359322.0632548,-21600,,
com.apple.Preview,1,1738359252,1738359253,1738359253.662257,-21600,,
com.google.Chrome,3,1738359249,1738359252,1738359252.61535,-21600,,
com.apple.Preview,2,1738359247,1738359249,1738359250.0366611,-21600,,
com.microsoft.VSCode,99,1738359148,1738359247,1738359247.427434,-21600,,
com.apple.Preview,22,1738359126,1738359148,1738359149.032374,-21600,,
com.microsoft.VSCode,5,1738359121,1738359126,1738359126.3276958,-21600,,
com.google.Chrome,35,1738359086,1738359121,1738359121.5396461,-21600,,
com.microsoft.VSCode,112,1738358974,1738359086,1738359086.861897,-21600,,
com.electron.carta,16,1738358958,1738358974,1738358974.838019,-21600,,
com.microsoft.VSCode,12,1738358946,1738358958,1738358958.12332,-21600,,
com.apple.Preview,2,1738358944,1738358946,1738358946.8279119,-21600,,
com.microsoft.VSCode,7,1738358937,1738358944,1738358944.539897,-21600,,
com.apple.Preview,2,1738358935,1738358937,1738358937.680942,-21600,,
com.microsoft.VSCode,1,1738358934,1738358935,1738358935.653469,-21600,,
com.apple.Preview,1,1738358933,1738358934,1738358934.91136,-21600,,
com.apple.finder,1,1738358932,1738358933,1738358934.013832,-21600,,
com.microsoft.VSCode,7,1738358925,1738358932,1738358932.534319,-21600,,
com.apple.finder,1,1738358924,1738358925,1738358925.093916,-21600,,
com.apple.Preview,5,1738358919,1738358924,1738358924.217735,-21600,,
com.apple.finder,4,1738358915,1738358919,1738358919.136033,-21600,,
com.microsoft.VSCode,30,1738358885,1738358915,1738358915.221819,-21600,,
com.leomehlig.today,7,1738358878,1738358885,1738358885.40377,-21600,,
com.apple.iCal,12,1738358866,1738358878,1738358879.2466822,-21600,,
com.leomehlig.today,8,1738358858,1738358866,1738358866.745174,-21600,,
com.microsoft.VSCode,30,1738358828,1738358858,1738358858.657515,-21600,,
com.apple.news,43,1738358620,1738358663,1738358663.352954,-21600,EB445137-D7F5-57EC-87DA-1DB460D64046,"iPhone13,2"
com.apple.news,3,1738357804,1738357807,1738357807.7223501,-21600,EB445137-D7F5-57EC-87DA-1DB460D64046,"iPhone13,2"
com.apple.news,48,1738353573,1738353621,1738353621.415936,-21600,EB445137-D7F5-57EC-87DA-1DB460D64046,"iPhone13,2"
com.apple.MobileSMS,33,1738353511,1738353544,1738353544.5993009,-21600,EB445137-D7F5-57EC-87DA-1DB460D64046,"iPhone13,2"
com.apple.MobileSMS,3,1738353397,1738353400,1738353400.7626681,-21600,EB445137-D7F5-57EC-87DA-1DB460D64046,"iPhone13,2"
com.apple.MobileSMS,17,1738353370,1738353387,1738353387.957672,-21600,EB445137-D7F5-57EC-87DA-1DB460D64046,"iPhone13,2"
com.apple.MobileSMS,42,1738353306,1738353348,1738353348.927419,-21600,EB445137-D7F5-57EC-87DA-1DB460D64046,"iPhone13,2"
com.instructure.icanvas,0,1738353306,1738353306,1738353307.8975592,-21600,EB445137-D7F5-57EC-87DA-1DB460D64046,"iPhone13,2"
com.instructure.icanvas,10,1738353250,1738353260,1738353260.515569,-21600,EB445137-D7F5-57EC-87DA-1DB460D64046,"iPhone13,2"
com.apple.MobileSMS,0,1738353250,1738353250,1738353251.1968532,-21600,EB445137-D7F5-57EC-87DA-1DB460D64046,"iPhone13,2"
com.apple.MobileSMS,2,1738353226,1738353228,1738353229.004638,-21600,EB445137-D7F5-57EC-87DA-1DB460D64046,"iPhone13,2"
com.apple.MobileSMS,47,1738353178,1738353225,1738353226.5412312,-21600,EB445137-D7F5-57EC-87DA-1DB460D64046,"iPhone13,2"
com.microsoft.Office.Outlook,59,1738351536,1738351595,1738351596.0641341,-21600,EB445137-D7F5-57EC-87DA-1DB460D64046,"iPhone13,2"
com.microsoft.VSCode,3,1738350045,1738350048,1738350048.446661,-21600,,
com.leomehlig.today,39,1738350006,1738350045,1738350045.868612,-21600,,
com.microsoft.VSCode,745,1738349261,1738350006,1738350006.878614,-21600,,
com.google.Chrome,2,1738349259,1738349261,1738349261.411588,-21600,,
com.leomehlig.today,39,1738349220,1738349259,1738349259.267895,-21600,,
com.google.Chrome,16,1738349204,1738349220,1738349220.452231,-21600,,
com.myfitnesspal.mfp,133,1738348466,1738348599,1738348599.8505049,-21600,EB445137-D7F5-57EC-87DA-1DB460D64046,"iPhone13,2"
com.toyopagroup.picaboo,10,1738348418,1738348428,1738348429.047349,-21600,EB445137-D7F5-57EC-87DA-1DB460D64046,"iPhone13,2"
com.leomehlig.today,0,1738348418,1738348418,1738348419.110048,-21600,EB445137-D7F5-57EC-87DA-1DB460D64046,"iPhone13,2"
com.leomehlig.today,22,1738342960,1738342982,1738342982.985859,-21600,EB445137-D7F5-57EC-87DA-1DB460D64046,"iPhone13,2"
com.apple.news,1,1738342957,1738342958,1738342958.46087,-21600,EB445137-D7F5-57EC-87DA-1DB460D64046,"iPhone13,2"
com.apple.news,123,1738342695,1738342818,1738342818.935341,-21600,EB445137-D7F5-57EC-87DA-1DB460D64046,"iPhone13,2"
com.microsoft.Office.Outlook,8,1738342668,1738342676,1738342676.8845,-21600,EB445137-D7F5-57EC-87DA-1DB460D64046,"iPhone13,2"
com.hammerandchisel.discord,46,1738342617,1738342663,1738342663.551598,-21600,EB445137-D7F5-57EC-87DA-1DB460D64046,"iPhone13,2"
com.toyopagroup.picaboo,27,1738342586,1738342613,1738342613.515324,-21600,EB445137-D7F5-57EC-87DA-1DB460D64046,"iPhone13,2"
com.toyopagroup.picaboo,11,1738342573,1738342584,1738342585.1050692,-21600,EB445137-D7F5-57EC-87DA-1DB460D64046,"iPhone13,2"
com.tinyspeck.chatlyio,40,1738342531,1738342571,1738342571.2085829,-21600,EB445137-D7F5-57EC-87DA-1DB460D64046,"iPhone13,2"
com.microsoft.Office.Outlook,1,1738342530,1738342531,1738342533.490761,-21600,EB445137-D7F5-57EC-87DA-1DB460D64046,"iPhone13,2"
com.microsoft.Office.Outlook,72,1738342385,1738342457,1738342457.6254148,-21600,EB445137-D7F5-57EC-87DA-1DB460D64046,"iPhone13,2"
com.toyopagroup.picaboo,6,1738342372,1738342378,1738342379.124433,-21600,EB445137-D7F5-57EC-87DA-1DB460D64046,"iPhone13,2"
com.toyopagroup.picaboo,19,1738342231,1738342250,1738342250.622459,-21600,EB445137-D7F5-57EC-87DA-1DB460D64046,"iPhone13,2"
com.toyopagroup.picaboo,22,1738342205,1738342227,1738342228.09354,-21600,EB445137-D7F5-57EC-87DA-1DB460D64046,"iPhone13,2"
com.myfitnesspal.mfp,0,1738342205,1738342205,1738342206.901921,-21600,EB445137-D7F5-57EC-87DA-1DB460D64046,"iPhone13,2"
com.google.Chrome,7,1738342052,1738342059,1738342059.187052,-21600,,
com.leomehlig.today,19,1738342033,1738342052,1738342052.781281,-21600,,
com.microsoft.VSCode,13,1738342020,1738342033,1738342033.859458,-21600,,
com.google.Chrome,55,1738341965,1738342020,1738342020.892376,-21600,,
com.microsoft.VSCode,740,1738341225,1738341965,1738341965.213511,-21600,,
com.microsoft.VSCode,547,1738340592,1738341139,1738341139.6983361,-21600,,
com.google.Chrome,5,1738340587,1738340592,1738340592.421668,-21600,,
com.microsoft.VSCode,142,1738340445,1738340587,1738340587.107368,-21600,,
com.google.Chrome,4,1738340441,1738340445,1738340445.21145,-21600,,
com.microsoft.VSCode,3,1738340438,1738340441,1738340441.891958,-21600,,
com.google.Chrome,3,1738340435,1738340438,1738340438.703599,-21600,,
com.microsoft.VSCode,4,1738340431,1738340435,1738340435.388238,-21600,,
com.google.Chrome,4,1738340427,1738340431,1738340431.911278,-21600,,
com.microsoft.VSCode,51,1738340376,1738340427,1738340427.403862,-21600,,
com.google.Chrome,1092,1738339284,1738340376,1738340376.9877892,-21600,,
com.google.Chrome,278,1738337421,1738337699,1738337699.891683,-21600,,
com.apple.finder,2,1738337419,1738337421,1738337421.19597,-21600,,
com.apple.Notes,0,1738337419,1738337419,1738337419.933887,-21600,,
com.apple.finder,4,1738337415,1738337419,1738337419.311595,-21600,,
com.leomehlig.today,2,1738337413,1738337415,1738337415.515276,-21600,,
com.apple.Notes,4,1738337409,1738337413,1738337413.982644,-21600,,
com.myfitnesspal.mfp,28,1738336101,1738336129,1738336130.0257158,-21600,EB445137-D7F5-57EC-87DA-1DB460D64046,"iPhone13,2"
com.apple.Notes,907,1738335499,1738336406,1738336406.533712,-21600,,
com.leomehlig.today,5,1738335494,1738335499,1738335499.2311091,-21600,,
com.apple.weather,27,1738334359,1738334386,1738334386.677896,-21600,EB445137-D7F5-57EC-87DA-1DB460D64046,"iPhone13,2"
com.renpho.health,1,1738334358,1738334359,1738334359.9896631,-21600,EB445137-D7F5-57EC-87DA-1DB460D64046,"iPhone13,2"
com.renpho.health,32,1738334311,1738334343,1738334343.268602,-21600,EB445137-D7F5-57EC-87DA-1DB460D64046,"iPhone13,2"
com.apple.Health,55,1738333297,1738333352,1738333352.700604,-21600,EB445137-D7F5-57EC-87DA-1DB460D64046,"iPhone13,2"
com.thestorygraph.thestorygraph,30,1738301393,1738301423,1738301423.081923,-21600,EB445137-D7F5-57EC-87DA-1DB460D64046,"iPhone13,2"
com.goodreads.Goodreads,40,1738301353,1738301393,1738301393.656578,-21600,EB445137-D7F5-57EC-87DA-1DB460D64046,"iPhone13,2"
com.thestorygraph.thestorygraph,40,1738301313,1738301353,1738301353.5164208,-21600,EB445137-D7F5-57EC-87DA-1DB460D64046,"iPhone13,2"
com.apple.Health,19,1738299503,1738299522,1738299522.36138,-21600,EB445137-D7F5-57EC-87DA-1DB460D64046,"iPhone13,2"
com.leomehlig.today,5,1738299274,1738299279,1738299279.856964,-21600,,
com.leomehlig.today,61,1738299213,1738299274,1738299274.993163,-21600,,
com.google.Chrome,394,1738298819,1738299213,1738299213.865073,-21600,,
com.google.Chrome,301,1738298486,1738298787,1738298787.103848,-21600,,
com.google.Chrome,308,1738297871,1738298179,1738298179.338412,-21600,,
com.apple.Health,74,1738297781,1738297855,1738297855.1537008,-21600,EB445137-D7F5-57EC-87DA-1DB460D64046,"iPhone13,2"
com.letterboxd.LetterboxdApp,50,1738297690,1738297740,1738297740.196395,-21600,EB445137-D7F5-57EC-87DA-1DB460D64046,"iPhone13,2"
com.apple.Music,215,1738297656,1738297871,1738297871.75604,-21600,,
com.google.Chrome,168,1738297488,1738297656,1738297656.168919,-21600,,
com.apple.Music,13,1738297475,1738297488,1738297488.4515681,-21600,,
com.google.Chrome,0,1738297475,1738297475,1738297475.929055,-21600,,
com.apple.Music,2,1738297473,1738297475,1738297475.314429,-21600,,
com.google.Chrome,0,1738297473,1738297473,1738297473.883323,-21600,,
com.apple.Music,2,1738297471,1738297473,1738297473.3971329,-21600,,
com.google.Chrome,113,1738297358,1738297471,1738297471.331565,-21600,,
com.apple.Health,49,1738296465,1738296514,1738296514.8656712,-21600,EB445137-D7F5-57EC-87DA-1DB460D64046,"iPhone13,2"
com.myfitnesspal.mfp,17,1738296448,1738296465,1738296466.070677,-21600,EB445137-D7F5-57EC-87DA-1DB460D64046,"iPhone13,2"
com.apple.Health,9,1738296439,1738296448,1738296448.301577,-21600,EB445137-D7F5-57EC-87DA-1DB460D64046,"iPhone13,2"
com.myfitnesspal.mfp,27,1738296412,1738296439,1738296439.3834171,-21600,EB445137-D7F5-57EC-87DA-1DB460D64046,"iPhone13,2"
com.apple.Health,54,1738296358,1738296412,1738296412.427765,-21600,EB445137-D7F5-57EC-87DA-1DB460D64046,"iPhone13,2"
com.myfitnesspal.mfp,23,1738296335,1738296358,1738296358.400626,-21600,EB445137-D7F5-57EC-87DA-1DB460D64046,"iPhone13,2"
com.apple.Health,248,1738296085,1738296333,1738296333.94482,-21600,EB445137-D7F5-57EC-87DA-1DB460D64046,"iPhone13,2"
com.google.Chrome,894,1738296063,1738296957,1738296957.702708,-21600,,
com.google.Chrome,760,1738294968,1738295728,1738295728.794567,-21600,,
com.apple.Preview,1,1738294967,1738294968,1738294968.729433,-21600,,
com.google.Chrome,1,1738294966,1738294967,1738294967.720098,-21600,,
com.microsoft.VSCode,2,1738294964,1738294966,1738294967.1487541,-21600,,
com.google.Chrome,99,1738294865,1738294964,1738294964.165071,-21600,,
com.microsoft.VSCode,6,1738294859,1738294865,1738294865.1734,-21600,,
com.google.Chrome,42,1738294817,1738294859,1738294859.447966,-21600,,
com.leomehlig.today,36,1738294781,1738294817,1738294817.433663,-21600,,
com.apple.MobileSMS,16,1738292683,1738292699,1738292699.397193,-21600,EB445137-D7F5-57EC-87DA-1DB460D64046,"iPhone13,2"
com.apple.MobileSMS,11,1738292655,1738292666,1738292666.183986,-21600,EB445137-D7F5-57EC-87DA-1DB460D64046,"iPhone13,2"
com.apple.weather,1,1738292654,1738292655,1738292655.686009,-21600,EB445137-D7F5-57EC-87DA-1DB460D64046,"iPhone13,2"
com.apple.weather,7,1738291635,1738291642,1738291642.7628431,-21600,EB445137-D7F5-57EC-87DA-1DB460D64046,"iPhone13,2"
com.apple.Music,1,1738291634,1738291635,1738291635.7498078,-21600,EB445137-D7F5-57EC-87DA-1DB460D64046,"iPhone13,2"
com.apple.Music,8,1738291596,1738291604,1738291605.3814092,-21600,EB445137-D7F5-57EC-87DA-1DB460D64046,"iPhone13,2"
com.intsig.CamScannerLite,6,1738291590,1738291596,1738291596.105129,-21600,EB445137-D7F5-57EC-87DA-1DB460D64046,"iPhone13,2"
com.intsig.CamScannerLite,2,1738291586,1738291588,1738291588.9435282,-21600,EB445137-D7F5-57EC-87DA-1DB460D64046,"iPhone13,2"
com.leomehlig.today,14,1738291396,1738291410,1738291410.994966,-21600,,
com.google.Chrome,4,1738291392,1738291396,1738291396.780456,-21600,,
com.leomehlig.today,10,1738291382,1738291392,1738291392.355674,-21600,,
com.google.Chrome,9,1738291373,1738291382,1738291382.967908,-21600,,
com.leomehlig.today,146,1738291227,1738291373,1738291373.7307448,-21600,,
com.google.Chrome,6,1738291221,1738291227,1738291227.497724,-21600,,
com.leomehlig.today,203,1738291018,1738291221,1738291221.336837,-21600,,
com.google.Chrome,32,1738290986,1738291018,1738291018.820399,-21600,,
com.leomehlig.today,6,1738290980,1738290986,1738290986.2978768,-21600,,
com.leomehlig.today,45,1738290787,1738290832,1738290832.8385801,-21600,,
com.intsig.CamScannerLite,26,1738290747,1738290773,1738290773.363124,-21600,EB445137-D7F5-57EC-87DA-1DB460D64046,"iPhone13,2"
com.google.Chrome,45,1738290742,1738290787,1738290787.370175,-21600,,
com.leomehlig.today,206,1738290536,1738290742,1738290742.655446,-21600,,
com.google.Chrome,147,1738290389,1738290536,1738290536.452467,-21600,,
com.leomehlig.today,19,1738290370,1738290389,1738290389.619633,-21600,,
com.microsoft.VSCode,2,1738290368,1738290370,1738290370.143004,-21600,,
com.leomehlig.today,2,1738290366,1738290368,1738290368.333253,-21600,,
com.intsig.CamScannerLite,220,1738290363,1738290583,1738290583.82754,-21600,EB445137-D7F5-57EC-87DA-1DB460D64046,"iPhone13,2"
com.hammerandchisel.discord,6,1738290349,1738290355,1738290355.5325642,-21600,EB445137-D7F5-57EC-87DA-1DB460D64046,"iPhone13,2"
com.google.Chrome,22,1738290344,1738290366,1738290366.821022,-21600,,
com.google.Chrome,337,1738289694,1738290031,1738290031.034482,-21600,,
com.microsoft.VSCode,4,1738289690,1738289694,1738289694.820514,-21600,,
com.microsoft.VSCode,304,1738289315,1738289619,1738289619.781673,-21600,,
com.hammerandchisel.discord,155,1738289313,1738289468,1738289468.897485,-21600,EB445137-D7F5-57EC-87DA-1DB460D64046,"iPhone13,2"
com.google.Chrome,34,1738289281,1738289315,1738289315.91769,-21600,,
com.microsoft.VSCode,2,1738289279,1738289281,1738289281.478794,-21600,,
com.hammerandchisel.discord,191,1738289081,1738289272,1738289272.498876,-21600,EB445137-D7F5-57EC-87DA-1DB460D64046,"iPhone13,2"
com.microsoft.VSCode,300,1738288915,1738289215,1738289215.6688662,-21600,,
com.microsoft.VSCode,300,1738288447,1738288747,1738288747.123285,-21600,,
com.microsoft.VSCode,300,1738288020,1738288320,1738288320.9094272,-21600,,
com.apple.finder,103,1738287917,1738288020,1738288020.9336991,-21600,,
com.apple.Preview,6,1738287911,1738287917,1738287917.3252978,-21600,,
com.microsoft.VSCode,133,1738287778,1738287911,1738287911.690202,-21600,,
com.microsoft.VSCode,320,1738287330,1738287650,1738287650.86847,-21600,,
com.hammerandchisel.discord,12,1738287040,1738287052,1738287052.8531651,-21600,EB445137-D7F5-57EC-87DA-1DB460D64046,"iPhone13,2"
com.microsoft.VSCode,300,1738286956,1738287256,1738287256.8337379,-21600,,
com.google.Chrome,260,1738286696,1738286956,1738286956.417275,-21600,,
com.microsoft.VSCode,76,1738286620,1738286696,1738286696.727118,-21600,,
com.google.Chrome,23,1738286597,1738286620,1738286620.8526812,-21600,,
com.microsoft.VSCode,223,1738286374,1738286597,1738286597.8957639,-21600,,
com.hammerandchisel.discord,47,1738286292,1738286339,1738286339.557157,-21600,EB445137-D7F5-57EC-87DA-1DB460D64046,"iPhone13,2"
com.apple.finder,115,1738286259,1738286374,1738286374.3511028,-21600,,
com.microsoft.VSCode,111,1738286148,1738286259,1738286259.820065,-21600,,
com.google.Chrome,37,1738286111,1738286148,1738286148.870273,-21600,,
com.hammerandchisel.discord,109,1738285957,1738286066,1738286066.843101,-21600,EB445137-D7F5-57EC-87DA-1DB460D64046,"iPhone13,2"
com.discoverfinancial.mobile,1,1738285955,1738285956,1738285956.842129,-21600,EB445137-D7F5-57EC-87DA-1DB460D64046,"iPhone13,2"
com.microsoft.VSCode,171,1738285940,1738286111,1738286111.1718159,-21600,,
com.google.Chrome,38,1738285902,1738285940,1738285940.13629,-21600,,
com.microsoft.VSCode,2,1738285900,1738285902,1738285902.670854,-21600,,
com.microsoft.VSCode,306,1738285558,1738285864,1738285864.670677,-21600,,
com.apple.finder,4,1738285554,1738285558,1738285559.0096478,-21600,,
com.leomehlig.today,4,1738285550,1738285554,1738285554.550926,-21600,,
com.google.Chrome,5,1738285545,1738285550,1738285550.899273,-21600,,
com.leomehlig.today,39,1738285506,1738285545,1738285545.2563381,-21600,,
com.apple.Passbook,50,1738285390,1738285440,1738285441.013386,-21600,EB445137-D7F5-57EC-87DA-1DB460D64046,"iPhone13,2"
com.apple.MobileSMS,18,1738285372,1738285390,1738285390.987442,-21600,EB445137-D7F5-57EC-87DA-1DB460D64046,"iPhone13,2"
com.apple.Passbook,16,1738285356,1738285372,1738285372.3924608,-21600,EB445137-D7F5-57EC-87DA-1DB460D64046,"iPhone13,2"
com.apple.PassbookUIService,6,1738285348,1738285354,1738285354.343864,-21600,EB445137-D7F5-57EC-87DA-1DB460D64046,"iPhone13,2"
com.apple.MobileSMS,7,1738285339,1738285346,1738285346.218225,-21600,EB445137-D7F5-57EC-87DA-1DB460D64046,"iPhone13,2"
com.apple.Music,1,1738285338,1738285339,1738285339.65488,-21600,EB445137-D7F5-57EC-87DA-1DB460D64046,"iPhone13,2"
com.apple.Music,42,1738283750,1738283792,1738283793.29525,-21600,EB445137-D7F5-57EC-87DA-1DB460D64046,"iPhone13,2"
com.apple.podcasts,2,1738283748,1738283750,1738283751.041456,-21600,EB445137-D7F5-57EC-87DA-1DB460D64046,"iPhone13,2"
com.myfitnesspal.mfp,10,1738283578,1738283588,1738283588.215497,-21600,EB445137-D7F5-57EC-87DA-1DB460D64046,"iPhone13,2"
com.myfitnesspal.mfp,8,1738283138,1738283146,1738283146.6029701,-21600,EB445137-D7F5-57EC-87DA-1DB460D64046,"iPhone13,2"
com.myfitnesspal.mfp,4,1738282900,1738282904,1738282904.88618,-21600,EB445137-D7F5-57EC-87DA-1DB460D64046,"iPhone13,2"
com.apple.Health,26,1738282466,1738282492,1738282493.007698,-21600,EB445137-D7F5-57EC-87DA-1DB460D64046,"iPhone13,2"
com.microsoft.Office.Outlook,2,1738282460,1738282462,1738282462.2856688,-21600,EB445137-D7F5-57EC-87DA-1DB460D64046,"iPhone13,2"
com.microsoft.Office.Outlook,9,1738282419,1738282428,1738282428.7228131,-21600,EB445137-D7F5-57EC-87DA-1DB460D64046,"iPhone13,2"
com.myfitnesspal.mfp,92,1738282290,1738282382,1738282382.295341,-21600,EB445137-D7F5-57EC-87DA-1DB460D64046,"iPhone13,2"
com.google.chrome.ios,88,1738282202,1738282290,1738282290.610956,-21600,EB445137-D7F5-57EC-87DA-1DB460D64046,"iPhone13,2"
com.myfitnesspal.mfp,191,1738282010,1738282201,1738282202.047073,-21600,EB445137-D7F5-57EC-87DA-1DB460D64046,"iPhone13,2"
com.myfitnesspal.mfp,58,1738281517,1738281575,1738281575.2667398,-21600,EB445137-D7F5-57EC-87DA-1DB460D64046,"iPhone13,2"
com.myfitnesspal.mfp,155,1738281313,1738281468,1738281468.699064,-21600,EB445137-D7F5-57EC-87DA-1DB460D64046,"iPhone13,2"
com.apple.news,2,1738281311,1738281313,1738281314.320622,-21600,EB445137-D7F5-57EC-87DA-1DB460D64046,"iPhone13,2"
com.apple.news,76,1738280703,1738280779,1738280780.300877,-21600,EB445137-D7F5-57EC-87DA-1DB460D64046,"iPhone13,2"
com.myfitnesspal.mfp,5,1738280684,1738280689,1738280689.489218,-21600,EB445137-D7F5-57EC-87DA-1DB460D64046,"iPhone13,2"
com.myfitnesspal.mfp,32,1738280146,1738280178,1738280178.801945,-21600,EB445137-D7F5-57EC-87DA-1DB460D64046,"iPhone13,2"
com.google.chrome.ios,2,1738280144,1738280146,1738280146.755944,-21600,EB445137-D7F5-57EC-87DA-1DB460D64046,"iPhone13,2"
com.google.chrome.ios,18,1738279981,1738279999,1738279999.571064,-21600,EB445137-D7F5-57EC-87DA-1DB460D64046,"iPhone13,2"
com.google.chrome.ios,99,1738279587,1738279686,1738279686.571128,-21600,EB445137-D7F5-57EC-87DA-1DB460D64046,"iPhone13,2"
com.google.chrome.ios,173,1738279137,1738279310,1738279311.0986938,-21600,EB445137-D7F5-57EC-87DA-1DB460D64046,"iPhone13,2"
com.google.chrome.ios,95,1738279024,1738279119,1738279119.5477371,-21600,EB445137-D7F5-57EC-87DA-1DB460D64046,"iPhone13,2"
com.google.chrome.ios,61,1738278720,1738278781,1738278781.3652148,-21600,EB445137-D7F5-57EC-87DA-1DB460D64046,"iPhone13,2"
com.google.chrome.ios,141,1738278578,1738278719,1738278719.787158,-21600,EB445137-D7F5-57EC-87DA-1DB460D64046,"iPhone13,2"
com.google.chrome.ios,33,1738278161,1738278194,1738278194.516566,-21600,EB445137-D7F5-57EC-87DA-1DB460D64046,"iPhone13,2"
com.google.chrome.ios,2,1738278159,1738278161,1738278161.178427,-21600,EB445137-D7F5-57EC-87DA-1DB460D64046,"iPhone13,2"
com.leomehlig.today,29,1738278050,1738278079,1738278080.211873,-21600,,
com.apple.iCal,7,1738278043,1738278050,1738278050.7227058,-21600,,
com.leomehlig.today,3,1738278040,1738278043,1738278043.4352021,-21600,,
com.google.Chrome,8,1738278032,1738278040,1738278040.749758,-21600,,
com.google.chrome.ios,16,1738277889,1738277905,1738277905.33843,-21600,EB445137-D7F5-57EC-87DA-1DB460D64046,"iPhone13,2"
com.google.chrome.ios,3,1738277842,1738277845,1738277845.85098,-21600,EB445137-D7F5-57EC-87DA-1DB460D64046,"iPhone13,2"
com.google.chrome.ios,48,1738277780,1738277828,1738277828.507293,-21600,EB445137-D7F5-57EC-87DA-1DB460D64046,"iPhone13,2"
com.myfitnesspal.mfp,2,1738277778,1738277780,1738277780.848065,-21600,EB445137-D7F5-57EC-87DA-1DB460D64046,"iPhone13,2"
com.myfitnesspal.mfp,118,1738277649,1738277767,1738277767.4797812,-21600,EB445137-D7F5-57EC-87DA-1DB460D64046,"iPhone13,2"
com.apple.mobiletimer,3,1738277646,1738277649,1738277649.543549,-21600,EB445137-D7F5-57EC-87DA-1DB460D64046,"iPhone13,2"
com.apple.mobiletimer,3,1738277344,1738277347,1738277348.0401921,-21600,EB445137-D7F5-57EC-87DA-1DB460D64046,"iPhone13,2"
com.google.chrome.ios,78,1738276931,1738277009,1738277009.1492028,-21600,EB445137-D7F5-57EC-87DA-1DB460D64046,"iPhone13,2"
com.toyopagroup.picaboo,11,1738276433,1738276444,1738276445.075748,-21600,EB445137-D7F5-57EC-87DA-1DB460D64046,"iPhone13,2"
com.microsoft.Office.Outlook,2,1738275819,1738275821,1738275821.3550181,-21600,EB445137-D7F5-57EC-87DA-1DB460D64046,"iPhone13,2"
com.google.Chrome,3,1738275732,1738275735,1738275735.404601,-21600,,
com.google.Chrome,395,1738275337,1738275732,1738275732.24138,-21600,,
com.apple.Preview,2,1738275335,1738275337,1738275337.8534951,-21600,,
com.google.Chrome,687,1738274648,1738275335,1738275335.5685868,-21600,,
com.toyopagroup.picaboo,2,1738273823,1738273825,1738273826.143454,-21600,EB445137-D7F5-57EC-87DA-1DB460D64046,"iPhone13,2"
com.myfitnesspal.mfp,1,1738273822,1738273823,1738273823.53947,-21600,EB445137-D7F5-57EC-87DA-1DB460D64046,"iPhone13,2"
com.google.Chrome,13,1738273541,1738273554,1738273554.860087,-21600,,
com.myfitnesspal.mfp,133,1738273160,1738273293,1738273293.533462,-21600,EB445137-D7F5-57EC-87DA-1DB460D64046,"iPhone13,2"
com.google.Chrome,408,1738272872,1738273280,1738273280.733464,-21600,,
com.google.Chrome,607,1738270950,1738271557,1738271557.3973222,-21600,,
com.google.Chrome,588,1738270211,1738270799,1738270799.328452,-21600,,
com.leomehlig.today,45,1738270166,1738270211,1738270211.216875,-21600,,
com.google.Chrome,18,1738270148,1738270166,1738270166.557647,-21600,,
com.google.Chrome,1759,1738267793,1738269552,1738269552.354244,-21600,,
com.myfitnesspal.mfp,208,1738267558,1738267766,1738267767.003542,-21600,EB445137-D7F5-57EC-87DA-1DB460D64046,"iPhone13,2"
com.toyopagroup.picaboo,37,1738267516,1738267553,1738267553.173483,-21600,EB445137-D7F5-57EC-87DA-1DB460D64046,"iPhone13,2"
com.truebill.truebillnative,0,1738267516,1738267516,1738267516.782644,-21600,EB445137-D7F5-57EC-87DA-1DB460D64046,"iPhone13,2"
com.google.Chrome,427,1738267358,1738267785,1738267785.827421,-21600,,
com.microsoft.VSCode,4,1738267354,1738267358,1738267359.154295,-21600,,
com.google.Chrome,2,1738267352,1738267354,1738267354.303987,-21600,,
com.apple.Preview,3,1738267349,1738267352,1738267352.7954168,-21600,,
com.google.Chrome,3,1738267346,1738267349,1738267349.2387218,-21600,,
com.electron.carta,3,1738267343,1738267346,1738267346.611796,-21600,,
com.google.Chrome,5,1738267338,1738267343,1738267343.249467,-21600,,
com.leomehlig.today,47,1738267291,1738267338,1738267339.056109,-21600,,
com.google.Chrome,59,1738267232,1738267291,1738267291.060216,-21600,,
com.microsoft.VSCode,17,1738267215,1738267232,1738267232.893074,-21600,,
com.google.Chrome,1,1738267214,1738267215,1738267215.95079,-21600,,
com.microsoft.VSCode,15,1738267199,1738267214,1738267214.914329,-21600,,
com.google.Chrome,128,1738267071,1738267199,1738267200.029777,-21600,,
com.microsoft.VSCode,1,1738267070,1738267071,1738267071.670579,-21600,,
com.google.Chrome,32,1738267038,1738267070,1738267070.118559,-21600,,
com.microsoft.VSCode,55,1738266983,1738267038,1738267038.343157,-21600,,
com.google.Chrome,8,1738266975,1738266983,1738266983.392857,-21600,,
com.microsoft.VSCode,87,1738266888,1738266975,1738266975.106945,-21600,,
com.apple.finder,21,1738266867,1738266888,1738266888.18223,-21600,,
com.google.Chrome,21,1738266846,1738266867,1738266867.7504401,-21600,,
com.microsoft.VSCode,1,1738266845,1738266846,1738266846.548912,-21600,,
com.google.Chrome,28,1738266817,1738266845,1738266846.002589,-21600,,
com.microsoft.VSCode,16,1738266801,1738266817,1738266817.532349,-21600,,
com.google.Chrome,14,1738266787,1738266801,1738266801.970756,-21600,,
com.apple.CoreAuthUI,2,1738266522,1738266524,1738266524.2332711,-21600,EB445137-D7F5-57EC-87DA-1DB460D64046,"iPhone13,2"
com.truebill.truebillnative,104,1738266519,1738266623,1738266623.92436,-21600,EB445137-D7F5-57EC-87DA-1DB460D64046,"iPhone13,2"
com.apple.Health,55,1738266458,1738266513,1738266513.108607,-21600,EB445137-D7F5-57EC-87DA-1DB460D64046,"iPhone13,2"
com.myfitnesspal.mfp,0,1738266458,1738266458,1738266466.865619,-21600,EB445137-D7F5-57EC-87DA-1DB460D64046,"iPhone13,2"
com.myfitnesspal.mfp,25,1738266027,1738266052,1738266052.23882,-21600,EB445137-D7F5-57EC-87DA-1DB460D64046,"iPhone13,2"
com.apple.Music,2,1738266025,1738266027,1738266027.111707,-21600,EB445137-D7F5-57EC-87DA-1DB460D64046,"iPhone13,2"
com.apple.Music,10,1738265350,1738265360,1738265360.88801,-21600,EB445137-D7F5-57EC-87DA-1DB460D64046,"iPhone13,2"
com.apple.Music,16,1738264878,1738264894,1738264894.3803148,-21600,EB445137-D7F5-57EC-87DA-1DB460D64046,"iPhone13,2"
com.apple.Music,15,1738264406,1738264421,1738264421.6579928,-21600,EB445137-D7F5-57EC-87DA-1DB460D64046,"iPhone13,2"
com.myfitnesspal.mfp,3,1738264403,1738264406,1738264406.687983,-21600,EB445137-D7F5-57EC-87DA-1DB460D64046,"iPhone13,2"
com.myfitnesspal.mfp,39,1738264095,1738264134,1738264134.243056,-21600,EB445137-D7F5-57EC-87DA-1DB460D64046,"iPhone13,2"
com.google.chrome.ios,4,1738264091,1738264095,1738264095.416,-21600,EB445137-D7F5-57EC-87DA-1DB460D64046,"iPhone13,2"
com.myfitnesspal.mfp,3,1738264088,1738264091,1738264091.6139479,-21600,EB445137-D7F5-57EC-87DA-1DB460D64046,"iPhone13,2"
com.myfitnesspal.mfp,41,1738263934,1738263975,1738263975.729978,-21600,EB445137-D7F5-57EC-87DA-1DB460D64046,"iPhone13,2"
com.myfitnesspal.mfp,40,1738263892,1738263932,1738263933.206157,-21600,EB445137-D7F5-57EC-87DA-1DB460D64046,"iPhone13,2"
com.myfitnesspal.mfp,20,1738263810,1738263830,1738263830.325352,-21600,EB445137-D7F5-57EC-87DA-1DB460D64046,"iPhone13,2"
com.google.chrome.ios,6,1738263804,1738263810,1738263810.995541,-21600,EB445137-D7F5-57EC-87DA-1DB460D64046,"iPhone13,2"
com.myfitnesspal.mfp,26,1738263778,1738263804,1738263804.81946,-21600,EB445137-D7F5-57EC-87DA-1DB460D64046,"iPhone13,2"
com.google.chrome.ios,10,1738263768,1738263778,1738263778.861588,-21600,EB445137-D7F5-57EC-87DA-1DB460D64046,"iPhone13,2"
com.myfitnesspal.mfp,41,1738263727,1738263768,1738263768.363698,-21600,EB445137-D7F5-57EC-87DA-1DB460D64046,"iPhone13,2"
com.google.chrome.ios,34,1738263693,1738263727,1738263727.2328029,-21600,EB445137-D7F5-57EC-87DA-1DB460D64046,"iPhone13,2"
com.google.chrome.ios,103,1738263502,1738263605,1738263606.145788,-21600,EB445137-D7F5-57EC-87DA-1DB460D64046,"iPhone13,2"
com.apple.Music,1,1738263500,1738263501,1738263502.0797482,-21600,EB445137-D7F5-57EC-87DA-1DB460D64046,"iPhone13,2"
com.apple.Music,5,1738263238,1738263243,1738263244.444721,-21600,EB445137-D7F5-57EC-87DA-1DB460D64046,"iPhone13,2"
com.microsoft.Office.Outlook,85,1738263079,1738263164,1738263164.838725,-21600,EB445137-D7F5-57EC-87DA-1DB460D64046,"iPhone13,2"
com.apple.MobileSMS,0,1738263079,1738263079,1738263080.95366,-21600,EB445137-D7F5-57EC-87DA-1DB460D64046,"iPhone13,2"
com.apple.MobileSMS,44,1738262977,1738263021,1738263021.468536,-21600,EB445137-D7F5-57EC-87DA-1DB460D64046,"iPhone13,2"
com.apple.mobileslideshow,59,1738262918,1738262977,1738262977.9752479,-21600,EB445137-D7F5-57EC-87DA-1DB460D64046,"iPhone13,2"
com.apple.mobilephone,1,1738262917,1738262918,1738262918.882918,-21600,EB445137-D7F5-57EC-87DA-1DB460D64046,"iPhone13,2"
com.apple.MobileSMS,2,1738262911,1738262913,1738262913.532289,-21600,EB445137-D7F5-57EC-87DA-1DB460D64046,"iPhone13,2"
com.apple.Music,8,1738262903,1738262911,1738262911.6482558,-21600,EB445137-D7F5-57EC-87DA-1DB460D64046,"iPhone13,2"
com.apple.Music,19,1738262062,1738262081,1738262081.342181,-21600,EB445137-D7F5-57EC-87DA-1DB460D64046,"iPhone13,2"
com.apple.weather,2,1738262060,1738262062,1738262062.304935,-21600,EB445137-D7F5-57EC-87DA-1DB460D64046,"iPhone13,2"
com.apple.weather,8,1738261197,1738261205,1738261205.327157,-21600,EB445137-D7F5-57EC-87DA-1DB460D64046,"iPhone13,2"
com.apple.Music,1,1738261195,1738261196,1738261196.7236829,-21600,EB445137-D7F5-57EC-87DA-1DB460D64046,"iPhone13,2"
com.apple.Music,27,1738261139,1738261166,1738261166.444061,-21600,EB445137-D7F5-57EC-87DA-1DB460D64046,"iPhone13,2"
com.apple.news,5,1738261134,1738261139,1738261139.0599089,-21600,EB445137-D7F5-57EC-87DA-1DB460D64046,"iPhone13,2"
com.google.Chrome,55,1738260509,1738260564,1738260564.996067,-21600,,
com.apple.news,251,1738259925,1738260176,1738260177.0571918,-21600,EB445137-D7F5-57EC-87DA-1DB460D64046,"iPhone13,2"
com.google.chrome.ios,2,1738259910,1738259912,1738259912.800305,-21600,EB445137-D7F5-57EC-87DA-1DB460D64046,"iPhone13,2"
com.google.chrome.ios,9,1738259859,1738259868,1738259869.063565,-21600,EB445137-D7F5-57EC-87DA-1DB460D64046,"iPhone13,2"
com.microsoft.Office.Outlook,3,1738259856,1738259859,1738259859.675781,-21600,EB445137-D7F5-57EC-87DA-1DB460D64046,"iPhone13,2"
com.google.Chrome,567,1738259850,1738260417,1738260417.727086,-21600,,
com.microsoft.Office.Outlook,11,1738259844,1738259855,1738259856.060453,-21600,EB445137-D7F5-57EC-87DA-1DB460D64046,"iPhone13,2"
com.microsoft.Office.Outlook,25,1738259429,1738259454,1738259454.929133,-21600,EB445137-D7F5-57EC-87DA-1DB460D64046,"iPhone13,2"
com.myfitnesspal.mfp,1,1738259428,1738259429,1738259429.63293,-21600,EB445137-D7F5-57EC-87DA-1DB460D64046,"iPhone13,2"
com.myfitnesspal.mfp,47,1738259237,1738259284,1738259284.72605,-21600,EB445137-D7F5-57EC-87DA-1DB460D64046,"iPhone13,2"
com.myfitnesspal.mfp,38,1738259193,1738259231,1738259231.2469769,-21600,EB445137-D7F5-57EC-87DA-1DB460D64046,"iPhone13,2"
com.ryansponzilli.DeepSkyCatalog,2,1738259189,1738259191,1738259191.3837252,-21600,EB445137-D7F5-57EC-87DA-1DB460D64046,"iPhone13,2"
com.google.Chrome,507,1738259111,1738259618,1738259618.781341,-21600,,
com.google.Chrome,79,1738258593,1738258672,1738258672.116519,-21600,,
com.microsoft.VSCode,5,1738258572,1738258577,1738258577.57543,-21600,,
com.google.Chrome,1,1738258571,1738258572,1738258572.489235,-21600,,
com.microsoft.VSCode,8,1738258563,1738258571,1738258571.662751,-21600,,
com.google.Chrome,20,1738258543,1738258563,1738258563.789682,-21600,,
com.microsoft.VSCode,54,1738258489,1738258543,1738258543.102629,-21600,,
com.google.Chrome,7,1738258482,1738258489,1738258489.537926,-21600,,
com.microsoft.VSCode,11,1738258471,1738258482,1738258482.568778,-21600,,
com.google.Chrome,4,1738258467,1738258471,1738258472.0098472,-21600,,
com.microsoft.VSCode,33,1738258434,1738258467,1738258467.5452409,-21600,,
com.google.Chrome,5,1738258429,1738258434,1738258434.786852,-21600,,
com.microsoft.VSCode,25,1738258404,1738258429,1738258429.31495,-21600,,
com.google.Chrome,12,1738258392,1738258404,1738258404.778841,-21600,,
com.microsoft.VSCode,63,1738258329,1738258392,1738258392.205,-21600,,
com.google.Chrome,3,1738258326,1738258329,1738258329.912503,-21600,,
com.microsoft.VSCode,0,1738258326,1738258326,1738258326.91812,-21600,,
com.google.Chrome,5,1738258321,1738258326,1738258326.119849,-21600,,
com.microsoft.VSCode,118,1738258203,1738258321,1738258321.92634,-21600,,
com.google.Chrome,2,1738258201,1738258203,1738258203.392276,-21600,,
com.microsoft.VSCode,12,1738258189,1738258201,1738258201.599863,-21600,,
com.google.Chrome,2,1738258187,1738258189,1738258189.071172,-21600,,
com.microsoft.VSCode,19,1738258168,1738258187,1738258187.988995,-21600,,
com.google.Chrome,8,1738258160,1738258168,1738258169.0359,-21600,,
com.microsoft.VSCode,51,1738258109,1738258160,1738258160.992451,-21600,,
com.google.Chrome,23,1738258086,1738258109,1738258109.525972,-21600,,
com.microsoft.VSCode,5,1738258081,1738258086,1738258086.9006782,-21600,,
com.google.Chrome,3,1738258078,1738258081,1738258081.9019198,-21600,,
com.microsoft.VSCode,18,1738258060,1738258078,1738258079.040451,-21600,,
com.google.Chrome,26,1738258034,1738258060,1738258060.604299,-21600,,
com.microsoft.VSCode,7,1738258027,1738258034,1738258034.3003302,-21600,,
com.google.Chrome,4,1738258023,1738258027,1738258027.0982342,-21600,,
com.microsoft.VSCode,159,1738257864,1738258023,1738258023.32251,-21600,,
com.google.Chrome,9,1738257855,1738257864,1738257864.268134,-21600,,
com.microsoft.VSCode,9,1738257846,1738257855,1738257855.1137109,-21600,,
com.google.Chrome,3,1738257843,1738257846,1738257846.711256,-21600,,
com.microsoft.VSCode,8,1738257835,1738257843,1738257843.763506,-21600,,
com.google.Chrome,3,1738257832,1738257835,1738257835.385211,-21600,,
com.microsoft.VSCode,10,1738257822,1738257832,1738257833.0053282,-21600,,
com.google.Chrome,1,1738257821,1738257822,1738257822.420654,-21600,,
com.microsoft.VSCode,13,1738257808,1738257821,1738257821.268248,-21600,,
com.google.Chrome,7,1738257801,1738257808,1738257808.149613,-21600,,
com.microsoft.VSCode,7,1738257794,1738257801,1738257802.011142,-21600,,
com.google.Chrome,11,1738257783,1738257794,1738257794.127281,-21600,,
com.microsoft.VSCode,13,1738257770,1738257783,1738257783.3362188,-21600,,
com.google.Chrome,96,1738257674,1738257770,1738257770.767387,-21600,,
com.microsoft.VSCode,5,1738257669,1738257674,1738257674.875266,-21600,,
com.google.Chrome,1,1738257668,1738257669,1738257669.3623161,-21600,,
com.microsoft.VSCode,10,1738257658,1738257668,1738257668.4615989,-21600,,
com.google.Chrome,2,1738257656,1738257658,1738257658.944565,-21600,,
com.microsoft.VSCode,5,1738257651,1738257656,1738257656.347595,-21600,,
com.google.Chrome,5,1738257646,1738257651,1738257652.0367641,-21600,,
com.microsoft.VSCode,9,1738257637,1738257646,1738257646.644197,-21600,,
com.google.Chrome,1,1738257636,1738257637,1738257637.648759,-21600,,
com.microsoft.VSCode,11,1738257625,1738257636,1738257636.5498738,-21600,,
com.google.Chrome,5,1738257620,1738257625,1738257625.797746,-21600,,
com.microsoft.VSCode,1,1738257619,1738257620,1738257620.6650162,-21600,,
com.google.Chrome,11,1738257608,1738257619,1738257619.3440928,-21600,,
com.microsoft.VSCode,19,1738257589,1738257608,1738257608.161277,-21600,,
com.google.Chrome,8,1738257581,1738257589,1738257590.030208,-21600,,
com.microsoft.VSCode,10,1738257571,1738257581,1738257581.0878181,-21600,,
com.google.Chrome,2,1738257569,1738257571,1738257571.569687,-21600,,
com.microsoft.VSCode,8,1738257561,1738257569,1738257569.780163,-21600,,
com.google.Chrome,9,1738257552,1738257561,1738257561.948854,-21600,,
com.microsoft.VSCode,4,1738257548,1738257552,1738257552.387229,-21600,,
com.google.Chrome,6,1738257542,1738257548,1738257548.395307,-21600,,
com.microsoft.VSCode,25,1738257517,1738257542,1738257542.694968,-21600,,
com.google.Chrome,6,1738257511,1738257517,1738257517.271223,-21600,,
com.microsoft.VSCode,6,1738257505,1738257511,1738257512.00138,-21600,,
com.google.Chrome,1,1738257504,1738257505,1738257505.414565,-21600,,
com.microsoft.VSCode,14,1738257490,1738257504,1738257504.165051,-21600,,
com.google.Chrome,16,1738257474,1738257490,1738257491.045505,-21600,,
com.apple.finder,1,1738257473,1738257474,1738257474.9260721,-21600,,
com.microsoft.VSCode,94,1738257379,1738257473,1738257473.81499,-21600,,
com.apple.finder,3,1738257376,1738257379,1738257379.251069,-21600,,
com.google.Chrome,195,1738257181,1738257376,1738257376.7473621,-21600,,
com.apple.finder,12,1738257169,1738257181,1738257181.189189,-21600,,
com.google.Chrome,226,1738256943,1738257169,1738257169.931007,-21600,,
com.microsoft.VSCode,40,1738256903,1738256943,1738256943.246059,-21600,,
com.google.Chrome,134,1738256769,1738256903,1738256903.7453818,-21600,,
com.microsoft.VSCode,115,1738256654,1738256769,1738256770.018285,-21600,,
com.apple.Notes,21,1738256633,1738256654,1738256654.218122,-21600,,
com.microsoft.VSCode,127,1738256506,1738256633,1738256633.747775,-21600,,
com.google.Chrome,60,1738256446,1738256506,1738256506.117939,-21600,,
com.microsoft.VSCode,83,1738256363,1738256446,1738256446.9314752,-21600,,
com.google.Chrome,3,1738256360,1738256363,1738256363.159322,-21600,,
com.microsoft.VSCode,12,1738256348,1738256360,1738256360.3592548,-21600,,
com.google.Chrome,3,1738256345,1738256348,1738256348.574805,-21600,,
com.microsoft.VSCode,2,1738256343,1738256345,1738256346.021803,-21600,,
com.google.Chrome,0,1738256343,1738256343,1738256343.6097941,-21600,,
com.microsoft.VSCode,4,1738256339,1738256343,1738256343.146885,-21600,,
com.google.Chrome,7,1738256332,1738256339,1738256339.7598891,-21600,,
com.microsoft.VSCode,26,1738256306,1738256332,1738256332.476644,-21600,,
com.google.Chrome,1,1738256305,1738256306,1738256306.24548,-21600,,
com.microsoft.VSCode,6,1738256299,1738256305,1738256305.21979,-21600,,
com.google.Chrome,1,1738256298,1738256299,1738256299.196734,-21600,,
com.microsoft.VSCode,1,1738256297,1738256298,1738256298.4793801,-21600,,
com.google.Chrome,2,1738256295,1738256297,1738256297.2326741,-21600,,
com.microsoft.VSCode,1,1738256294,1738256295,1738256295.214912,-21600,,
com.google.Chrome,2,1738256292,1738256294,1738256294.268647,-21600,,
com.microsoft.VSCode,15,1738256277,1738256292,1738256292.2877622,-21600,,
com.google.Chrome,36,1738256241,1738256277,1738256277.598635,-21600,,
com.microsoft.VSCode,18,1738256223,1738256241,1738256241.07869,-21600,,
com.google.Chrome,69,1738256154,1738256223,1738256223.1841831,-21600,,
com.microsoft.VSCode,159,1738255995,1738256154,1738256154.494391,-21600,,
com.apple.finder,10,1738255985,1738255995,1738255995.16747,-21600,,
com.microsoft.VSCode,456,1738255529,1738255985,1738255985.664002,-21600,,
com.apple.Preview,1,1738255528,1738255529,1738255529.258473,-21600,,
com.google.Chrome,2,1738255526,1738255528,1738255528.307085,-21600,,
com.electron.carta,20,1738255506,1738255526,1738255526.8509421,-21600,,
com.google.Chrome,12,1738255494,1738255506,1738255506.9550428,-21600,,
com.apple.Preview,3,1738255491,1738255494,1738255494.637632,-21600,,
com.microsoft.VSCode,140,1738255351,1738255491,1738255491.155134,-21600,,
com.apple.finder,1,1738255350,1738255351,1738255351.142365,-21600,,
com.apple.Preview,41,1738255309,1738255350,1738255350.219872,-21600,,
com.apple.finder,0,1738255309,1738255309,1738255309.7658482,-21600,,
com.apple.Preview,0,1738255309,1738255309,1738255309.596225,-21600,,
com.apple.finder,7,1738255302,1738255309,1738255309.2858539,-21600,,
com.microsoft.VSCode,141,1738255161,1738255302,1738255302.285129,-21600,,
com.google.Chrome,30,1738255131,1738255161,1738255161.825615,-21600,,
com.microsoft.VSCode,4,1738255127,1738255131,1738255132.049498,-21600,,
com.google.Chrome,2,1738255125,1738255127,1738255127.2819118,-21600,,
com.microsoft.VSCode,713,1738254412,1738255125,1738255125.937377,-21600,,
com.google.Chrome,1,1738254411,1738254412,1738254412.2826018,-21600,,
com.microsoft.VSCode,109,1738254302,1738254411,1738254411.75276,-21600,,
com.google.Chrome,7,1738254295,1738254302,1738254302.2399201,-21600,,
com.microsoft.VSCode,11,1738254284,1738254295,1738254295.961553,-21600,,
com.google.Chrome,4,1738254280,1738254284,1738254284.3936238,-21600,,
com.microsoft.VSCode,20,1738254260,1738254280,1738254280.328665,-21600,,
com.google.Chrome,17,1738254243,1738254260,1738254260.355799,-21600,,
com.microsoft.VSCode,55,1738254188,1738254243,1738254243.3206758,-21600,,
com.apple.Notes,10,1738254178,1738254188,1738254188.0943809,-21600,,
com.leomehlig.today,16,1738254162,1738254178,1738254178.112029,-21600,,
com.google.android.studio,54,1738254108,1738254162,1738254162.813384,-21600,,
com.google.Chrome,10,1738254098,1738254108,1738254108.574902,-21600,,
com.google.android.studio,1,1738254097,1738254098,1738254098.7470388,-21600,,
com.google.Chrome,7,1738254090,1738254097,1738254097.754342,-21600,,
com.google.android.studio,2,1738254088,1738254090,1738254090.1426811,-21600,,
com.google.Chrome,27,1738254061,1738254088,1738254088.647685,-21600,,
com.google.android.studio,1,1738254060,1738254061,1738254061.9339628,-21600,,
com.google.Chrome,43,1738254017,1738254060,1738254060.5309072,-21600,,
com.google.android.studio,4,1738254013,1738254017,1738254017.1411529,-21600,,
com.google.Chrome,37,1738253976,1738254013,1738254013.520482,-21600,,
com.google.android.studio,2,1738253974,1738253976,1738253976.505033,-21600,,
com.google.Chrome,3,1738253971,1738253974,1738253974.780998,-21600,,
com.google.android.studio,1,1738253970,1738253971,1738253972.044836,-21600,,
com.google.Chrome,3,1738253967,1738253970,1738253970.3079329,-21600,,
com.google.android.studio,6,1738253961,1738253967,1738253967.4307342,-21600,,
com.google.Chrome,182,1738253779,1738253961,1738253961.6472101,-21600,,
com.google.android.studio,24,1738253755,1738253779,1738253779.675123,-21600,,
com.google.Chrome,12,1738253743,1738253755,1738253755.206528,-21600,,
com.google.android.studio,380,1738253363,1738253743,1738253744.173666,-21600,,
com.leomehlig.today,41,1738253322,1738253363,1738253363.120676,-21600,,
com.ryansponzilli.DeepSkyCatalog,68,1738253049,1738253117,1738253117.574472,-21600,EB445137-D7F5-57EC-87DA-1DB460D64046,"iPhone13,2"
com.google.android.studio,839,1738252483,1738253322,1738253323.069582,-21600,,
com.google.Chrome,2,1738252481,1738252483,1738252483.93359,-21600,,
com.google.android.studio,17,1738252464,1738252481,1738252481.7127151,-21600,,
com.google.Chrome,4,1738252460,1738252464,1738252464.872433,-21600,,
com.google.android.studio,730,1738251730,1738252460,1738252460.5331202,-21600,,
com.google.Chrome,3,1738251727,1738251730,1738251730.685286,-21600,,
com.google.android.studio,10,1738251717,1738251727,1738251727.237088,-21600,,
com.google.Chrome,4,1738251713,1738251717,1738251718.0335689,-21600,,
com.google.android.studio,3,1738251710,1738251713,1738251713.266821,-21600,,
com.google.Chrome,4,1738251706,1738251710,1738251710.879171,-21600,,
com.google.android.studio,6,1738251700,1738251706,1738251706.757491,-21600,,
com.google.Chrome,1,1738251699,1738251700,1738251700.60012,-21600,,
com.google.android.studio,7,1738251692,1738251699,1738251699.2155619,-21600,,
com.google.Chrome,3,1738251689,1738251692,1738251692.39993,-21600,,
com.google.android.studio,10,1738251679,1738251689,1738251689.8820539,-21600,,
com.google.Chrome,3,1738251676,1738251679,1738251679.749988,-21600,,
com.google.android.studio,13,1738251663,1738251676,1738251676.255729,-21600,,
com.google.Chrome,3,1738251660,1738251663,1738251663.178265,-21600,,
com.google.android.studio,3,1738251657,1738251660,1738251660.7344189,-21600,,
com.google.Chrome,2,1738251655,1738251657,1738251657.37165,-21600,,
com.google.android.studio,9,1738251646,1738251655,1738251655.480834,-21600,,
com.google.Chrome,3,1738251643,1738251646,1738251646.33308,-21600,,
com.google.android.studio,10,1738251633,1738251643,1738251643.419145,-21600,,
com.google.Chrome,16,1738251617,1738251633,1738251633.481987,-21600,,
com.google.android.studio,33,1738251584,1738251617,1738251617.515176,-21600,,
com.google.Chrome,118,1738251466,1738251584,1738251584.82789,-21600,,
com.google.android.studio,50,1738251416,1738251466,1738251466.671761,-21600,,
com.google.Chrome,17,1738251209,1738251226,1738251227.0982451,-21600,,
com.google.android.studio,26,1738251183,1738251209,1738251209.415376,-21600,,
com.google.Chrome,1,1738251182,1738251183,1738251184.026336,-21600,,
com.google.android.studio,11,1738251171,1738251182,1738251182.773252,-21600,,
com.google.Chrome,23,1738251148,1738251171,1738251171.841724,-21600,,
com.google.android.studio,1,1738251147,1738251148,1738251148.667484,-21600,,
com.google.Chrome,6,1738251141,1738251147,1738251147.982887,-21600,,
com.google.android.studio,2,1738251139,1738251141,1738251141.278854,-21600,,
com.google.Chrome,5,1738251134,1738251139,1738251139.808566,-21600,,
com.google.android.studio,2,1738251132,1738251134,1738251134.8778691,-21600,,
com.google.Chrome,2,1738251130,1738251132,1738251132.3637872,-21600,,
com.google.android.studio,2,1738251128,1738251130,1738251130.89593,-21600,,
com.google.Chrome,1,1738251127,1738251128,1738251128.842668,-21600,,
com.google.android.studio,3,1738251124,1738251127,1738251127.069139,-21600,,
com.google.Chrome,112,1738251012,1738251124,1738251124.0732431,-21600,,
com.google.android.studio,2,1738251010,1738251012,1738251012.148614,-21600,,
com.google.Chrome,12,1738250998,1738251010,1738251010.18292,-21600,,
com.google.android.studio,34,1738250964,1738250998,1738250998.45462,-21600,,
com.google.Chrome,99,1738250865,1738250964,1738250964.133626,-21600,,
com.leomehlig.today,1,1738250864,1738250865,1738250865.269762,-21600,,
com.thestorygraph.thestorygraph,81,1738250668,1738250749,1738250749.239178,-21600,EB445137-D7F5-57EC-87DA-1DB460D64046,"iPhone13,2"
com.renpho.health,2,1738250655,1738250657,1738250657.5188642,-21600,EB445137-D7F5-57EC-87DA-1DB460D64046,"iPhone13,2"
com.renpho.health,39,1738248088,1738248127,1738248127.837178,-21600,EB445137-D7F5-57EC-87DA-1DB460D64046,"iPhone13,2"
com.apple.weather,35,1738246943,1738246978,1738246978.837579,-21600,EB445137-D7F5-57EC-87DA-1DB460D64046,"iPhone13,2"
com.apple.Health,13,1738246916,1738246929,1738246929.137803,-21600,EB445137-D7F5-57EC-87DA-1DB460D64046,"iPhone13,2"
com.apple.mobiletimer,0,1738246882,1738246882,1738246884.283822,-21600,EB445137-D7F5-57EC-87DA-1DB460D64046,"iPhone13,2"
com.thestorygraph.thestorygraph,21,1738215969,1738215990,1738215990.7936192,-21600,EB445137-D7F5-57EC-87DA-1DB460D64046,"iPhone13,2"
com.apple.news,2,1738215967,1738215969,1738215969.3776212,-21600,EB445137-D7F5-57EC-87DA-1DB460D64046,"iPhone13,2"
com.leomehlig.today,23,1738212798,1738212821,1738212821.508852,-21600,,
com.apple.news,215,1738212245,1738212460,1738212461.795062,-21600,EB445137-D7F5-57EC-87DA-1DB460D64046,"iPhone13,2"
com.microsoft.Office.Outlook,1,1738212234,1738212235,1738212235.6861281,-21600,EB445137-D7F5-57EC-87DA-1DB460D64046,"iPhone13,2"
com.google.Chrome,581,1738212217,1738212798,1738212798.298347,-21600,,
com.google.Chrome,301,1738211879,1738212180,1738212180.3265328,-21600,,
com.microsoft.Office.Outlook,10,1738211297,1738211307,1738211307.515005,-21600,EB445137-D7F5-57EC-87DA-1DB460D64046,"iPhone13,2"
com.microsoft.Office.Outlook,29,1738211267,1738211296,1738211296.169503,-21600,EB445137-D7F5-57EC-87DA-1DB460D64046,"iPhone13,2"
com.google.Chrome,304,1738211252,1738211556,1738211556.5467138,-21600,,
com.google.Chrome,301,1738210466,1738210767,1738210767.448323,-21600,,
com.google.Chrome,501,1738209960,1738210461,1738210461.054679,-21600,,
com.microsoft.VSCode,65,1738209895,1738209960,1738209960.2171211,-21600,,
com.google.Chrome,0,1738209895,1738209895,1738209895.773134,-21600,,
com.microsoft.VSCode,4,1738209891,1738209895,1738209895.310186,-21600,,
com.google.Chrome,28,1738209863,1738209891,1738209891.450307,-21600,,
com.microsoft.VSCode,185,1738209678,1738209863,1738209863.161875,-21600,,
com.google.Chrome,25,1738209653,1738209678,1738209678.73659,-21600,,
com.microsoft.VSCode,3,1738209650,1738209653,1738209653.253923,-21600,,
com.google.Chrome,4,1738209646,1738209650,1738209650.6507158,-21600,,
com.microsoft.VSCode,2,1738209644,1738209646,1738209646.979249,-21600,,
com.google.Chrome,22,1738209622,1738209644,1738209644.9621248,-21600,,
com.microsoft.VSCode,4,1738209618,1738209622,1738209622.612669,-21600,,
com.google.Chrome,27,1738209591,1738209618,1738209618.732448,-21600,,
com.microsoft.VSCode,2,1738209589,1738209591,1738209591.5400891,-21600,,
com.google.Chrome,3,1738209586,1738209589,1738209589.732238,-21600,,
com.microsoft.VSCode,2,1738209584,1738209586,1738209586.2606921,-21600,,
com.google.Chrome,2,1738209582,1738209584,1738209584.7062988,-21600,,
com.microsoft.VSCode,4,1738209578,1738209582,1738209582.080398,-21600,,
com.google.Chrome,4,1738209574,1738209578,1738209578.436024,-21600,,
com.microsoft.VSCode,1,1738209573,1738209574,1738209574.7649589,-21600,,
com.google.Chrome,8,1738209565,1738209573,1738209573.8226461,-21600,,
com.microsoft.VSCode,2,1738209563,1738209565,1738209565.2076988,-21600,,
com.google.Chrome,4,1738209559,1738209563,1738209563.878014,-21600,,
com.microsoft.VSCode,2,1738209557,1738209559,1738209560.0131102,-21600,,
com.google.Chrome,30,1738209527,1738209557,1738209557.9995809,-21600,,
com.microsoft.VSCode,8,1738209519,1738209527,1738209527.084568,-21600,,
com.google.Chrome,3,1738209516,1738209519,1738209519.7859879,-21600,,
com.apple.finder,2,1738209514,1738209516,1738209516.4509768,-21600,,
com.microsoft.VSCode,5,1738209509,1738209514,1738209514.95198,-21600,,
com.apple.finder,2,1738209507,1738209509,1738209509.302305,-21600,,
com.google.Chrome,3,1738209504,1738209507,1738209507.4643068,-21600,,
com.apple.finder,0,1738209504,1738209504,1738209504.870662,-21600,,
com.microsoft.VSCode,1,1738209503,1738209504,1738209504.297725,-21600,,
com.apple.finder,2,1738209501,1738209503,1738209503.558408,-21600,,
com.microsoft.VSCode,32,1738209469,1738209501,1738209501.8550658,-21600,,
com.apple.finder,4,1738209465,1738209469,1738209469.7946591,-21600,,
com.google.Chrome,337,1738209128,1738209465,1738209465.545965,-21600,,
com.leomehlig.today,46,1738209082,1738209128,1738209128.864625,-21600,,
com.google.Chrome,29,1738209053,1738209082,1738209082.232858,-21600,,
com.microsoft.Office.Outlook,19,1738209012,1738209031,1738209031.363153,-21600,EB445137-D7F5-57EC-87DA-1DB460D64046,"iPhone13,2"
com.apple.Music,1,1738209011,1738209012,1738209012.54234,-21600,EB445137-D7F5-57EC-87DA-1DB460D64046,"iPhone13,2"
com.google.Chrome,795,1738208136,1738208931,1738208931.068687,-21600,,
com.apple.Music,21,1738207225,1738207246,1738207246.722351,-21600,EB445137-D7F5-57EC-87DA-1DB460D64046,"iPhone13,2"
com.truebill.truebillnative,1,1738207224,1738207225,1738207226.026731,-21600,EB445137-D7F5-57EC-87DA-1DB460D64046,"iPhone13,2"
com.apple.CoreAuthUI,2,1738205366,1738205368,1738205369.246035,-21600,EB445137-D7F5-57EC-87DA-1DB460D64046,"iPhone13,2"
com.truebill.truebillnative,38,1738205361,1738205399,1738205399.343982,-21600,EB445137-D7F5-57EC-87DA-1DB460D64046,"iPhone13,2"
com.apple.Music,1,1738205358,1738205359,1738205359.997672,-21600,EB445137-D7F5-57EC-87DA-1DB460D64046,"iPhone13,2"
com.apple.Music,15,1738205011,1738205026,1738205026.843563,-21600,EB445137-D7F5-57EC-87DA-1DB460D64046,"iPhone13,2"
com.toyopagroup.picaboo,12,1738204996,1738205008,1738205009.264145,-21600,EB445137-D7F5-57EC-87DA-1DB460D64046,"iPhone13,2"
com.apple.camera,1,1738204989,1738204990,1738204995.430682,-21600,EB445137-D7F5-57EC-87DA-1DB460D64046,"iPhone13,2"
com.google.Chrome,4,1738204798,1738204802,1738204802.900635,-21600,,
com.apple.finder,2,1738204796,1738204798,1738204798.418257,-21600,,
com.apple.Notes,7,1738204789,1738204796,1738204796.78608,-21600,,
com.leomehlig.today,43,1738204746,1738204789,1738204789.6421208,-21600,,
com.apple.Notes,38,1738204708,1738204746,1738204747.0767121,-21600,,
com.leomehlig.today,153,1738204555,1738204708,1738204708.217733,-21600,,
com.apple.Notes,122,1738204433,1738204555,1738204556.057118,-21600,,
com.apple.iCal,1,1738204432,1738204433,1738204433.831255,-21600,,
com.leomehlig.today,3,1738204429,1738204432,1738204432.5204449,-21600,,
com.apple.iCal,0,1738204429,1738204429,1738204429.876431,-21600,,
com.apple.Notes,8,1738204421,1738204429,1738204429.104002,-21600,,
com.apple.iCal,5,1738204416,1738204421,1738204421.4350262,-21600,,
com.apple.Notes,19,1738204397,1738204416,1738204416.89999,-21600,,
com.leomehlig.today,8,1738204389,1738204397,1738204397.028574,-21600,,
com.google.Chrome,4,1738204385,1738204389,1738204389.32974,-21600,,
com.leomehlig.today,26,1738204359,1738204385,1738204385.630433,-21600,,
com.apple.finder,6,1738204353,1738204359,1738204359.732224,-21600,,
com.leomehlig.today,2,1738204351,1738204353,1738204353.593107,-21600,,
com.apple.Preview,0,1738204351,1738204351,1738204352.034535,-21600,,
com.leomehlig.today,26,1738204325,1738204351,1738204351.099897,-21600,,
com.microsoft.VSCode,44,1738204281,1738204325,1738204325.7267551,-21600,,
com.leomehlig.today,21,1738204260,1738204281,1738204281.955158,-21600,,
com.microsoft.VSCode,147,1738204113,1738204260,1738204260.388701,-21600,,
com.apple.Preview,1,1738204112,1738204113,1738204113.959907,-21600,,
com.google.Chrome,131,1738203981,1738204112,1738204112.294736,-21600,,
com.apple.Preview,8,1738203973,1738203981,1738203981.472008,-21600,,
com.apple.finder,192,1738203781,1738203973,1738203973.492583,-21600,,
com.apple.Preview,2,1738203779,1738203781,1738203781.560711,-21600,,
com.google.Chrome,117,1738203662,1738203779,1738203779.5807838,-21600,,
com.microsoft.VSCode,0,1738203662,1738203662,1738203663.008297,-21600,,
com.google.Chrome,47,1738203615,1738203662,1738203662.0859509,-21600,,
com.microsoft.VSCode,1,1738203614,1738203615,1738203615.740197,-21600,,
com.apple.finder,51,1738203563,1738203614,1738203614.5250359,-21600,,
com.apple.Preview,2,1738203561,1738203563,1738203563.144394,-21600,,
com.apple.finder,7,1738203554,1738203561,1738203561.8881412,-21600,,
com.apple.Preview,91,1738203463,1738203554,1738203554.471686,-21600,,
com.microsoft.VSCode,57,1738203406,1738203463,1738203463.6447139,-21600,,
com.apple.Preview,2,1738203404,1738203406,1738203406.925503,-21600,,
com.hnc.Discord,74,1738203330,1738203404,1738203404.652762,-21600,,
com.google.Chrome,115,1738203215,1738203330,1738203330.1747,-21600,,
com.hnc.Discord,140,1738203075,1738203215,1738203215.9020329,-21600,,
com.microsoft.VSCode,59,1738203016,1738203075,1738203075.57053,-21600,,
com.hnc.Discord,86,1738202930,1738203016,1738203016.306336,-21600,,
com.microsoft.VSCode,48,1738202882,1738202930,1738202930.325114,-21600,,
com.hnc.Discord,8,1738202874,1738202882,1738202882.9010901,-21600,,
com.microsoft.VSCode,13,1738202861,1738202874,1738202875.033242,-21600,,
com.hnc.Discord,7,1738202854,1738202861,1738202861.846,-21600,,
com.microsoft.VSCode,209,1738202645,1738202854,1738202854.290859,-21600,,
com.hnc.Discord,157,1738202488,1738202645,1738202645.471458,-21600,,
com.microsoft.VSCode,17,1738202471,1738202488,1738202488.31608,-21600,,
com.hnc.Discord,6,1738202465,1738202471,1738202471.882165,-21600,,
com.microsoft.VSCode,157,1738202308,1738202465,1738202466.061593,-21600,,
com.apple.Preview,76,1738202232,1738202308,1738202308.670105,-21600,,
com.microsoft.VSCode,50,1738202182,1738202232,1738202232.036045,-21600,,
com.google.Chrome,2,1738202180,1738202182,1738202183.046012,-21600,,
com.apple.Preview,47,1738202133,1738202180,1738202180.721087,-21600,,
com.google.Chrome,2,1738202131,1738202133,1738202133.11743,-21600,,
com.apple.Preview,1,1738202130,1738202131,1738202131.777607,-21600,,
com.google.Chrome,9,1738202121,1738202130,1738202130.629256,-21600,,
com.apple.Preview,11,1738202110,1738202121,1738202121.786847,-21600,,
com.apple.finder,4,1738202106,1738202110,1738202110.853549,-21600,,
com.microsoft.VSCode,76,1738202030,1738202106,1738202106.873925,-21600,,
com.google.chrome.ios,162,1738201788,1738201950,1738201950.7586741,-21600,EB445137-D7F5-57EC-87DA-1DB460D64046,"iPhone13,2"
com.leomehlig.today,135,1738201653,1738201788,1738201788.365045,-21600,EB445137-D7F5-57EC-87DA-1DB460D64046,"iPhone13,2"
com.letterboxd.LetterboxdApp,29,1738201605,1738201634,1738201634.725971,-21600,EB445137-D7F5-57EC-87DA-1DB460D64046,"iPhone13,2"
com.microsoft.VSCode,300,1738201402,1738201702,1738201702.265471,-21600,,
com.microsoft.VSCode,336,1738201022,1738201358,1738201358.090073,-21600,,
com.google.Chrome,33,1738200989,1738201022,1738201022.3052092,-21600,,
com.microsoft.VSCode,36,1738200953,1738200989,1738200989.2461162,-21600,,
com.google.Chrome,22,1738200931,1738200953,1738200953.876637,-21600,,
com.microsoft.VSCode,19,1738200912,1738200931,1738200931.539088,-21600,,
com.apple.calculator,107,1738200805,1738200912,1738200912.2507339,-21600,,
com.google.Chrome,75,1738200730,1738200805,1738200805.696507,-21600,,
com.microsoft.Office.Outlook,59,1738200548,1738200607,1738200607.821158,-21600,EB445137-D7F5-57EC-87DA-1DB460D64046,"iPhone13,2"
com.apple.Health,2,1738200546,1738200548,1738200548.5931392,-21600,EB445137-D7F5-57EC-87DA-1DB460D64046,"iPhone13,2"
com.microsoft.VSCode,1054,1738199676,1738200730,1738200731.063653,-21600,,
com.google.Chrome,13,1738199663,1738199676,1738199676.5582619,-21600,,
com.microsoft.VSCode,2,1738199621,1738199623,1738199623.692029,-21600,,
com.apple.Notes,0,1738199621,1738199621,1738199621.889833,-21600,,
com.microsoft.VSCode,1,1738199620,1738199621,1738199621.223983,-21600,,
com.apple.Terminal,1,1738199619,1738199620,1738199620.223424,-21600,,
com.microsoft.VSCode,101,1738199518,1738199619,1738199619.56141,-21600,,
com.google.Chrome,2,1738199516,1738199518,1738199518.796814,-21600,,
com.microsoft.VSCode,4,1738199512,1738199516,1738199516.500731,-21600,,
com.google.Chrome,3,1738199509,1738199512,1738199512.620132,-21600,,
com.microsoft.VSCode,2,1738199507,1738199509,1738199509.921122,-21600,,
com.google.Chrome,2,1738199505,1738199507,1738199507.424034,-21600,,
com.microsoft.VSCode,3,1738199502,1738199505,1738199505.158865,-21600,,
com.google.Chrome,2,1738199500,1738199502,1738199502.629426,-21600,,
com.microsoft.VSCode,3,1738199497,1738199500,1738199500.134455,-21600,,
com.google.Chrome,2,1738199495,1738199497,1738199497.3694,-21600,,
com.microsoft.VSCode,5,1738199490,1738199495,1738199495.052753,-21600,,
com.google.Chrome,2,1738199488,1738199490,1738199491.0363278,-21600,,
com.microsoft.VSCode,2,1738199486,1738199488,1738199488.827581,-21600,,
com.google.Chrome,4,1738199482,1738199486,1738199486.135953,-21600,,
com.microsoft.VSCode,13,1738199469,1738199482,1738199483.034316,-21600,,
com.google.Chrome,8,1738199461,1738199469,1738199469.465869,-21600,,
com.microsoft.VSCode,2,1738199459,1738199461,1738199461.937882,-21600,,
com.google.Chrome,1,1738199458,1738199459,1738199459.190804,-21600,,
com.microsoft.VSCode,2,1738199456,1738199458,1738199458.529059,-21600,,
com.google.Chrome,1,1738199455,1738199456,1738199456.6976418,-21600,,
com.microsoft.VSCode,6,1738199449,1738199455,1738199455.816083,-21600,,
com.google.Chrome,21,1738199428,1738199449,1738199449.513155,-21600,,
com.microsoft.VSCode,3,1738199425,1738199428,1738199428.528129,-21600,,
com.apple.finder,133,1738199292,1738199425,1738199425.338685,-21600,,
com.apple.Preview,28,1738199264,1738199292,1738199292.553952,-21600,,
com.apple.finder,2,1738199262,1738199264,1738199264.555289,-21600,,
com.apple.Preview,22,1738199240,1738199262,1738199262.731101,-21600,,
com.microsoft.VSCode,262,1738198978,1738199240,1738199240.318708,-21600,,
com.apple.Preview,1,1738198977,1738198978,1738198978.367607,-21600,,
com.microsoft.VSCode,12,1738198965,1738198977,1738198977.6667309,-21600,,
com.apple.Preview,2,1738198963,1738198965,1738198965.729828,-21600,,
com.microsoft.VSCode,4,1738198959,1738198963,1738198963.187704,-21600,,
com.apple.Preview,5,1738198954,1738198959,1738198959.4691591,-21600,,
com.microsoft.VSCode,10,1738198944,1738198954,1738198954.673305,-21600,,
com.apple.Preview,10,1738198934,1738198944,1738198944.167731,-21600,,
com.microsoft.VSCode,5,1738198929,1738198934,1738198934.3708138,-21600,,
com.apple.Preview,2,1738198927,1738198929,1738198929.281509,-21600,,
com.microsoft.VSCode,5,1738198922,1738198927,1738198927.0554252,-21600,,
com.apple.Preview,2,1738198920,1738198922,1738198922.747634,-21600,,
com.microsoft.VSCode,4,1738198916,1738198920,1738198920.224222,-21600,,
com.apple.Preview,2,1738198914,1738198916,1738198916.274364,-21600,,
com.microsoft.VSCode,6,1738198908,1738198914,1738198914.836803,-21600,,
com.apple.Preview,2,1738198906,1738198908,1738198908.6332579,-21600,,
com.microsoft.VSCode,5,1738198901,1738198906,1738198906.205347,-21600,,
com.apple.Preview,3,1738198898,1738198901,1738198901.14135,-21600,,
com.microsoft.VSCode,9,1738198889,1738198898,1738198898.301591,-21600,,
com.apple.Preview,3,1738198886,1738198889,1738198889.651247,-21600,,
com.microsoft.VSCode,7,1738198879,1738198886,1738198886.392075,-21600,,
com.apple.Preview,12,1738198867,1738198879,1738198879.723724,-21600,,
com.microsoft.VSCode,2,1738198865,1738198867,1738198868.010174,-21600,,
com.apple.Preview,24,1738198841,1738198865,1738198865.491862,-21600,,
com.microsoft.VSCode,3,1738198838,1738198841,1738198841.6530871,-21600,,
com.apple.Preview,3,1738198835,1738198838,1738198838.275601,-21600,,
com.microsoft.VSCode,2,1738198833,1738198835,1738198836.022974,-21600,,
com.apple.Preview,1,1738198832,1738198833,1738198833.0731158,-21600,,
com.microsoft.VSCode,2,1738198830,1738198832,1738198832.371117,-21600,,
com.apple.Preview,11,1738198819,1738198830,1738198830.3367,-21600,,
com.microsoft.VSCode,3,1738198816,1738198819,1738198819.84886,-21600,,
com.apple.Preview,2,1738198814,1738198816,1738198816.239143,-21600,,
com.microsoft.VSCode,5,1738198809,1738198814,1738198814.259879,-21600,,
com.apple.Preview,4,1738198805,1738198809,1738198809.2331781,-21600,,
com.microsoft.VSCode,3,1738198802,1738198805,1738198805.965866,-21600,,
com.apple.Preview,3,1738198799,1738198802,1738198802.38678,-21600,,
com.microsoft.VSCode,6,1738198793,1738198799,1738198799.745068,-21600,,
com.apple.Preview,23,1738198770,1738198793,1738198793.431361,-21600,,
com.microsoft.VSCode,3,1738198767,1738198770,1738198770.737622,-21600,,
com.apple.Preview,20,1738198747,1738198767,1738198767.560982,-21600,,
com.microsoft.VSCode,3,1738198744,1738198747,1738198747.918266,-21600,,
com.apple.Preview,2,1738198742,1738198744,1738198744.206326,-21600,,
com.microsoft.VSCode,1,1738198741,1738198742,1738198742.8166242,-21600,,
com.apple.Preview,5,1738198736,1738198741,1738198741.588438,-21600,,
com.microsoft.VSCode,11,1738198725,1738198736,1738198736.6521602,-21600,,
com.apple.Preview,2,1738198723,1738198725,1738198725.339919,-21600,,
com.microsoft.VSCode,5,1738198718,1738198723,1738198723.770208,-21600,,
com.apple.Preview,0,1738198718,1738198718,1738198718.968693,-21600,,
com.microsoft.VSCode,7,1738198711,1738198718,1738198718.147266,-21600,,
com.apple.Preview,5,1738198706,1738198711,1738198711.488858,-21600,,
com.microsoft.VSCode,5,1738198701,1738198706,1738198706.633751,-21600,,
com.apple.Preview,4,1738198697,1738198701,1738198701.089391,-21600,,
com.microsoft.VSCode,3,1738198694,1738198697,1738198697.314735,-21600,,
com.apple.Preview,4,1738198690,1738198694,1738198694.096434,-21600,,
com.microsoft.VSCode,6,1738198684,1738198690,1738198690.307548,-21600,,
com.apple.Preview,1,1738198683,1738198684,1738198684.316381,-21600,,
com.microsoft.VSCode,1,1738198682,1738198683,1738198683.664895,-21600,,
com.google.Chrome,1,1738198681,1738198682,1738198682.9007611,-21600,,
com.apple.Preview,12,1738198669,1738198681,1738198681.575996,-21600,,
com.google.Chrome,1,1738198668,1738198669,1738198669.6252499,-21600,,
com.microsoft.VSCode,97,1738198571,1738198668,1738198668.40607,-21600,,
com.google.Chrome,1,1738198570,1738198571,1738198571.525593,-21600,,
com.apple.Preview,7,1738198563,1738198570,1738198570.115529,-21600,,
com.google.Chrome,1,1738198562,1738198563,1738198564.0213351,-21600,,
com.microsoft.VSCode,3,1738198559,1738198562,1738198562.089754,-21600,,
com.google.Chrome,4,1738198555,1738198559,1738198560.307324,-21600,,
com.apple.Preview,17,1738198538,1738198555,1738198555.7110481,-21600,,
com.apple.finder,27,1738198511,1738198538,1738198538.639847,-21600,,
com.apple.Preview,29,1738198482,1738198511,1738198511.046701,-21600,,
com.apple.finder,51,1738198431,1738198482,1738198482.849472,-21600,,
com.google.Chrome,6,1738198425,1738198431,1738198431.6182141,-21600,,
com.microsoft.VSCode,2,1738198423,1738198425,1738198425.082878,-21600,,
com.apple.finder,6,1738198417,1738198423,1738198423.68859,-21600,,
com.microsoft.VSCode,57,1738198360,1738198417,1738198417.779475,-21600,,
com.google.Chrome,2,1738198358,1738198360,1738198360.617707,-21600,,
com.microsoft.VSCode,294,1738198064,1738198358,1738198358.663981,-21600,,
com.google.Chrome,56,1738198008,1738198064,1738198064.7298222,-21600,,
com.microsoft.VSCode,144,1738197864,1738198008,1738198008.709861,-21600,,
com.google.Chrome,1,1738197863,1738197864,1738197864.7835898,-21600,,
com.microsoft.VSCode,21,1738197842,1738197863,1738197863.175134,-21600,,
com.google.Chrome,8,1738197834,1738197842,1738197842.401688,-21600,,
com.microsoft.VSCode,52,1738197782,1738197834,1738197834.545402,-21600,,
com.google.Chrome,10,1738197772,1738197782,1738197783.0339131,-21600,,
com.microsoft.VSCode,24,1738197748,1738197772,1738197772.775919,-21600,,
com.google.Chrome,6,1738197742,1738197748,1738197748.964694,-21600,,
com.microsoft.VSCode,31,1738197711,1738197742,1738197742.956108,-21600,,
com.google.Chrome,4,1738197707,1738197711,1738197711.868534,-21600,,
com.microsoft.VSCode,3,1738197704,1738197707,1738197707.38376,-21600,,
com.google.Chrome,14,1738197690,1738197704,1738197704.2689052,-21600,,
com.microsoft.VSCode,18,1738197672,1738197690,1738197690.328031,-21600,,
com.google.Chrome,36,1738197636,1738197672,1738197672.528228,-21600,,
com.microsoft.VSCode,7,1738197629,1738197636,1738197636.146534,-21600,,
com.google.Chrome,2,1738197627,1738197629,1738197629.142383,-21600,,
com.microsoft.VSCode,2,1738197625,1738197627,1738197627.529799,-21600,,
com.apple.Terminal,5,1738197620,1738197625,1738197625.591275,-21600,,
com.microsoft.VSCode,1,1738197619,1738197620,1738197620.6933541,-21600,,
com.apple.Terminal,19,1738197600,1738197619,1738197619.355246,-21600,,
com.microsoft.VSCode,3,1738197597,1738197600,1738197600.8614821,-21600,,
com.google.Chrome,2,1738197595,1738197597,1738197597.9639502,-21600,,
com.microsoft.VSCode,6,1738197589,1738197595,1738197595.634165,-21600,,
com.google.Chrome,2,1738197587,1738197589,1738197589.498289,-21600,,
com.microsoft.VSCode,7,1738197580,1738197587,1738197587.22064,-21600,,
com.google.Chrome,20,1738197560,1738197580,1738197580.504455,-21600,,
com.microsoft.VSCode,25,1738197535,1738197560,1738197560.15169,-21600,,
com.apple.Terminal,1,1738197534,1738197535,1738197535.490323,-21600,,
com.google.Chrome,7,1738197527,1738197534,1738197534.741212,-21600,,
com.apple.Terminal,6,1738197521,1738197527,1738197527.568502,-21600,,
com.google.Chrome,2,1738197519,1738197521,1738197521.849145,-21600,,
com.apple.Terminal,1,1738197518,1738197519,1738197519.834302,-21600,,
com.google.Chrome,0,1738197518,1738197518,1738197518.9118829,-21600,,
com.apple.Terminal,21,1738197497,1738197518,1738197518.579217,-21600,,
com.google.Chrome,19,1738197478,1738197497,1738197497.288698,-21600,,
com.microsoft.VSCode,59,1738197419,1738197478,1738197478.5412211,-21600,,
com.google.Chrome,9,1738197410,1738197419,1738197419.3115249,-21600,,
com.microsoft.VSCode,1,1738197409,1738197410,1738197410.870425,-21600,,
com.google.Chrome,36,1738197373,1738197409,1738197409.4117,-21600,,
com.microsoft.VSCode,261,1738197112,1738197373,1738197373.452654,-21600,,
com.apple.finder,17,1738197095,1738197112,1738197112.3618178,-21600,,
com.leomehlig.today,1,1738197094,1738197095,1738197095.739129,-21600,,
com.google.Chrome,46,1738197048,1738197094,1738197094.14996,-21600,,
com.apple.Health,360,1738196797,1738197157,1738197157.657432,-21600,EB445137-D7F5-57EC-87DA-1DB460D64046,"iPhone13,2"
com.myfitnesspal.mfp,1,1738196791,1738196792,1738196793.135231,-21600,EB445137-D7F5-57EC-87DA-1DB460D64046,"iPhone13,2"
com.myfitnesspal.mfp,39,1738195956,1738195995,1738195995.768125,-21600,EB445137-D7F5-57EC-87DA-1DB460D64046,"iPhone13,2"
com.apple.Music,1,1738195954,1738195955,1738195956.05196,-21600,EB445137-D7F5-57EC-87DA-1DB460D64046,"iPhone13,2"
com.apple.Music,15,1738195446,1738195461,1738195461.410578,-21600,EB445137-D7F5-57EC-87DA-1DB460D64046,"iPhone13,2"
com.apple.weather,2,1738195444,1738195446,1738195446.348196,-21600,EB445137-D7F5-57EC-87DA-1DB460D64046,"iPhone13,2"
com.apple.weather,13,1738195263,1738195276,1738195277.099771,-21600,EB445137-D7F5-57EC-87DA-1DB460D64046,"iPhone13,2"
com.apple.weather,1,1738195260,1738195261,1738195261.519669,-21600,EB445137-D7F5-57EC-87DA-1DB460D64046,"iPhone13,2"
com.myfitnesspal.mfp,17,1738194977,1738194994,1738194995.0378618,-21600,EB445137-D7F5-57EC-87DA-1DB460D64046,"iPhone13,2"
com.apple.mobilecal,192,1738194771,1738194963,1738194963.4736218,-21600,EB445137-D7F5-57EC-87DA-1DB460D64046,"iPhone13,2"
com.apple.news,64,1738194701,1738194765,1738194765.600741,-21600,EB445137-D7F5-57EC-87DA-1DB460D64046,"iPhone13,2"
com.leomehlig.today,79,1738194611,1738194690,1738194690.408949,-21600,EB445137-D7F5-57EC-87DA-1DB460D64046,"iPhone13,2"
com.myfitnesspal.mfp,17,1738193032,1738193049,1738193049.7870522,-21600,EB445137-D7F5-57EC-87DA-1DB460D64046,"iPhone13,2"
com.myfitnesspal.mfp,47,1738192647,1738192694,1738192694.423276,-21600,EB445137-D7F5-57EC-87DA-1DB460D64046,"iPhone13,2"
com.apple.MobileSMS,2,1738192644,1738192646,1738192646.305582,-21600,EB445137-D7F5-57EC-87DA-1DB460D64046,"iPhone13,2"
com.apple.MobileSMS,8,1738191793,1738191801,1738191801.835125,-21600,EB445137-D7F5-57EC-87DA-1DB460D64046,"iPhone13,2"
com.google.Chrome,92,1738191471,1738191563,1738191563.2200341,-21600,,
com.apple.findmy,6,1738191413,1738191419,1738191420.140892,-21600,EB445137-D7F5-57EC-87DA-1DB460D64046,"iPhone13,2"
com.myfitnesspal.mfp,36,1738190291,1738190327,1738190327.8124251,-21600,EB445137-D7F5-57EC-87DA-1DB460D64046,"iPhone13,2"
com.google.Chrome,796,1738190007,1738190803,1738190803.243874,-21600,,
com.apple.Notes,53,1738189954,1738190007,1738190007.431735,-21600,,
com.myfitnesspal.mfp,434,1738189658,1738190092,1738190092.429593,-21600,EB445137-D7F5-57EC-87DA-1DB460D64046,"iPhone13,2"
com.google.Chrome,927,1738189027,1738189954,1738189954.972392,-21600,,
com.leomehlig.today,63,1738188964,1738189027,1738189028.674633,-21600,,
com.instructure.icanvas,14,1738188583,1738188597,1738188597.0760732,-21600,EB445137-D7F5-57EC-87DA-1DB460D64046,"iPhone13,2"
com.microsoft.Office.Outlook,2,1738188568,1738188570,1738188571.005394,-21600,EB445137-D7F5-57EC-87DA-1DB460D64046,"iPhone13,2"
com.microsoft.Office.Outlook,7,1738188560,1738188567,1738188567.695764,-21600,EB445137-D7F5-57EC-87DA-1DB460D64046,"iPhone13,2"
com.tinyspeck.chatlyio,7,1738188553,1738188560,1738188560.06878,-21600,EB445137-D7F5-57EC-87DA-1DB460D64046,"iPhone13,2"
com.tinyspeck.chatlyio,26,1738188510,1738188536,1738188536.434118,-21600,EB445137-D7F5-57EC-87DA-1DB460D64046,"iPhone13,2"
com.apple.Health,11,1738188498,1738188509,1738188509.44263,-21600,EB445137-D7F5-57EC-87DA-1DB460D64046,"iPhone13,2"
com.leomehlig.today,310,1738188433,1738188743,1738188743.1474981,-21600,,
com.apple.iCal,25,1738188408,1738188433,1738188433.754878,-21600,,
com.leomehlig.today,56,1738188352,1738188408,1738188408.56335,-21600,,
com.google.Chrome,70,1738188282,1738188352,1738188352.806237,-21600,,
com.apple.finder,4,1738188265,1738188269,1738188269.0780048,-21600,,
com.electron.carta,1,1738188264,1738188265,1738188265.8394299,-21600,,
com.apple.Notes,378,1738187886,1738188264,1738188264.987049,-21600,,
com.apple.finder,1,1738187885,1738187886,1738187886.116572,-21600,,
com.electron.carta,4,1738187881,1738187885,1738187885.1347752,-21600,,
com.apple.Health,15,1738187577,1738187592,1738187593.153038,-21600,EB445137-D7F5-57EC-87DA-1DB460D64046,"iPhone13,2"
com.apple.mobilenotes,2,1738187573,1738187575,1738187575.540777,-21600,EB445137-D7F5-57EC-87DA-1DB460D64046,"iPhone13,2"
com.apple.mobilenotes,35,1738186817,1738186852,1738186852.727005,-21600,EB445137-D7F5-57EC-87DA-1DB460D64046,"iPhone13,2"
com.google.Gmail,6,1738186807,1738186813,1738186814.035661,-21600,EB445137-D7F5-57EC-87DA-1DB460D64046,"iPhone13,2"
com.apple.camera,2,1738186807,1738186809,1738186812.848886,-21600,EB445137-D7F5-57EC-87DA-1DB460D64046,"iPhone13,2"
com.electron.carta,273,1738186463,1738186736,1738186736.110106,-21600,,
com.apple.Preview,604,1738185859,1738186463,1738186463.595541,-21600,,
com.apple.finder,5,1738185854,1738185859,1738185859.372048,-21600,,
com.electron.carta,513,1738185341,1738185854,1738185854.766296,-21600,,
com.electron.carta,2,1738185280,1738185282,1738185282.213252,-21600,,
com.apple.Notes,16,1738185264,1738185280,1738185280.809258,-21600,,
com.electron.carta,4,1738185260,1738185264,1738185264.657367,-21600,,
com.google.Chrome,1,1738185259,1738185260,1738185260.968885,-21600,,
com.electron.carta,45,1738185214,1738185259,1738185259.7795238,-21600,,
com.google.Chrome,1,1738185213,1738185214,1738185214.753789,-21600,,
com.electron.carta,98,1738185115,1738185213,1738185213.3474221,-21600,,
com.apple.Notes,18,1738185097,1738185115,1738185115.856495,-21600,,
com.electron.carta,3,1738185094,1738185097,1738185097.282174,-21600,,
com.apple.Notes,2,1738185092,1738185094,1738185094.7064772,-21600,,
com.electron.carta,2,1738185090,1738185092,1738185092.7531161,-21600,,
com.google.Chrome,9,1738185081,1738185090,1738185090.3267379,-21600,,
com.electron.carta,205,1738184876,1738185081,1738185081.373684,-21600,,
com.apple.Notes,20,1738184856,1738184876,1738184876.768776,-21600,,
com.google.Chrome,3,1738184853,1738184856,1738184856.184317,-21600,,
com.google.Gmail,13,1738184597,1738184610,1738184610.760926,-21600,EB445137-D7F5-57EC-87DA-1DB460D64046,"iPhone13,2"
com.tinyspeck.chatlyio,14,1738184158,1738184172,1738184172.57514,-21600,EB445137-D7F5-57EC-87DA-1DB460D64046,"iPhone13,2"
com.instructure.icanvas,0,1738184158,1738184158,1738184159.831191,-21600,EB445137-D7F5-57EC-87DA-1DB460D64046,"iPhone13,2"
com.instructure.icanvas,27,1738180317,1738180344,1738180344.725584,-21600,EB445137-D7F5-57EC-87DA-1DB460D64046,"iPhone13,2"
com.apple.news,0,1738180317,1738180317,1738180318.7132158,-21600,EB445137-D7F5-57EC-87DA-1DB460D64046,"iPhone13,2"
com.apple.news,342,1738176701,1738177043,1738177043.358622,-21600,EB445137-D7F5-57EC-87DA-1DB460D64046,"iPhone13,2"
com.apple.MobileSMS,7,1738176687,1738176694,1738176694.6093469,-21600,EB445137-D7F5-57EC-87DA-1DB460D64046,"iPhone13,2"
com.google.Gmail,0,1738176687,1738176687,1738176687.9099,-21600,EB445137-D7F5-57EC-87DA-1DB460D64046,"iPhone13,2"
com.google.Gmail,4,1738176653,1738176657,1738176657.44417,-21600,EB445137-D7F5-57EC-87DA-1DB460D64046,"iPhone13,2"
com.apple.MobileSMS,19,1738176612,1738176631,1738176631.741467,-21600,EB445137-D7F5-57EC-87DA-1DB460D64046,"iPhone13,2"
com.myfitnesspal.mfp,0,1738176612,1738176612,1738176612.730902,-21600,EB445137-D7F5-57EC-87DA-1DB460D64046,"iPhone13,2"
com.myfitnesspal.mfp,148,1738175563,1738175711,1738175711.805342,-21600,EB445137-D7F5-57EC-87DA-1DB460D64046,"iPhone13,2"
com.google.Chrome,865,1738174902,1738175767,1738175767.5564508,-21600,,
com.apple.Notes,8,1738174894,1738174902,1738174902.091321,-21600,,
com.google.Chrome,90,1738174804,1738174894,1738174894.551214,-21600,,
com.google.Chrome,329,1738174283,1738174612,1738174612.6483932,-21600,,
com.google.chrome.ios,162,1738170026,1738170188,1738170189.0169,-21600,EB445137-D7F5-57EC-87DA-1DB460D64046,"iPhone13,2"
com.apple.MobileSMS,2,1738170024,1738170026,1738170026.686986,-21600,EB445137-D7F5-57EC-87DA-1DB460D64046,"iPhone13,2"
com.apple.mobilenotes,116,1738169908,1738170024,1738170024.319988,-21600,EB445137-D7F5-57EC-87DA-1DB460D64046,"iPhone13,2"
com.leomehlig.today,58,1738169850,1738169908,1738169908.80649,-21600,EB445137-D7F5-57EC-87DA-1DB460D64046,"iPhone13,2"
com.apple.mobilecal,16,1738169817,1738169833,1738169833.318232,-21600,EB445137-D7F5-57EC-87DA-1DB460D64046,"iPhone13,2"
com.apple.weather,38,1738169728,1738169766,1738169766.028889,-21600,EB445137-D7F5-57EC-87DA-1DB460D64046,"iPhone13,2"
com.google.Chrome,54,1738169643,1738169697,1738169697.676513,-21600,,
com.apple.finder,2,1738169641,1738169643,1738169643.5049329,-21600,,
com.apple.weather,8,1738169543,1738169551,1738169552.1150742,-21600,EB445137-D7F5-57EC-87DA-1DB460D64046,"iPhone13,2"
com.apple.MobileSMS,2,1738169527,1738169529,1738169529.2830992,-21600,EB445137-D7F5-57EC-87DA-1DB460D64046,"iPhone13,2"
com.apple.MobileSMS,28,1738169311,1738169339,1738169340.204464,-21600,EB445137-D7F5-57EC-87DA-1DB460D64046,"iPhone13,2"
com.microsoft.Office.Outlook,10,1738168250,1738168260,1738168260.252228,-21600,EB445137-D7F5-57EC-87DA-1DB460D64046,"iPhone13,2"
com.apple.CoreAuthUI,8,1738164861,1738164869,1738164869.037397,-21600,EB445137-D7F5-57EC-87DA-1DB460D64046,"iPhone13,2"
com.truebill.truebillnative,246,1738164859,1738165105,1738165105.758521,-21600,EB445137-D7F5-57EC-87DA-1DB460D64046,"iPhone13,2"
com.microsoft.Office.Outlook,2,1738164855,1738164857,1738164858.0776238,-21600,EB445137-D7F5-57EC-87DA-1DB460D64046,"iPhone13,2"
com.microsoft.Office.Outlook,5,1738164850,1738164855,1738164855.361961,-21600,EB445137-D7F5-57EC-87DA-1DB460D64046,"iPhone13,2"
com.apple.CoreAuthUI,2,1738164775,1738164777,1738164777.977484,-21600,EB445137-D7F5-57EC-87DA-1DB460D64046,"iPhone13,2"
com.robinhood.release.Robinhood,67,1738164772,1738164839,1738164839.7903152,-21600,EB445137-D7F5-57EC-87DA-1DB460D64046,"iPhone13,2"
com.apple.news,94,1738164676,1738164770,1738164770.7483149,-21600,EB445137-D7F5-57EC-87DA-1DB460D64046,"iPhone13,2"
com.apple.finder,6,1738163525,1738163531,1738163531.3314462,-21600,,
com.electron.carta,245,1738163280,1738163525,1738163525.329372,-21600,,
com.apple.finder,29,1738163251,1738163280,1738163280.134426,-21600,,
com.electron.carta,146,1738163105,1738163251,1738163251.726663,-21600,,
com.apple.finder,119,1738162986,1738163105,1738163106.0283852,-21600,,
com.electron.carta,11,1738162975,1738162986,1738162986.646781,-21600,,
com.apple.finder,12,1738162963,1738162975,1738162975.393369,-21600,,
com.electron.carta,31,1738162932,1738162963,1738162963.861876,-21600,,
com.leomehlig.today,7,1738162925,1738162932,1738162932.365975,-21600,,
com.renpho.health,167,1738161507,1738161674,1738161674.492907,-21600,EB445137-D7F5-57EC-87DA-1DB460D64046,"iPhone13,2"
com.apple.weather,2,1738161505,1738161507,1738161507.319143,-21600,EB445137-D7F5-57EC-87DA-1DB460D64046,"iPhone13,2"
com.apple.weather,15,1738161486,1738161501,1738161501.373568,-21600,EB445137-D7F5-57EC-87DA-1DB460D64046,"iPhone13,2"
com.apple.Health,52,1738160453,1738160505,1738160506.021974,-21600,EB445137-D7F5-57EC-87DA-1DB460D64046,"iPhone13,2"
com.thestorygraph.thestorygraph,27,1738128141,1738128168,1738128168.5527182,-21600,EB445137-D7F5-57EC-87DA-1DB460D64046,"iPhone13,2"
com.apple.CoreAuthUI,1,1738125370,1738125371,1738125372.011883,-21600,EB445137-D7F5-57EC-87DA-1DB460D64046,"iPhone13,2"
com.apple.journal,1150,1738125368,1738126518,1738126518.087648,-21600,EB445137-D7F5-57EC-87DA-1DB460D64046,"iPhone13,2"
com.apple.Health,53,1738125314,1738125367,1738125367.868775,-21600,EB445137-D7F5-57EC-87DA-1DB460D64046,"iPhone13,2"
com.leomehlig.today,86,1738124847,1738124933,1738124933.310488,-21600,,
com.apple.finder,4,1738124843,1738124847,1738124847.430177,-21600,,
com.apple.Notes,112,1738124731,1738124843,1738124843.313216,-21600,,
com.google.Chrome,18,1738124713,1738124731,1738124731.5005522,-21600,,
com.apple.iCal,90,1738124623,1738124713,1738124713.4523091,-21600,,
com.google.Chrome,80,1738124543,1738124623,1738124623.3523278,-21600,,
com.google.Chrome,300,1738123925,1738124225,1738124225.5637589,-21600,,
com.google.Chrome,324,1738123323,1738123647,1738123647.082049,-21600,,
com.apple.Health,269,1738122167,1738122436,1738122436.7652612,-21600,EB445137-D7F5-57EC-87DA-1DB460D64046,"iPhone13,2"
com.google.Chrome,325,1738122029,1738122354,1738122355.013499,-21600,,
com.leomehlig.today,31,1738121998,1738122029,1738122029.7062979,-21600,,
com.apple.news,296,1738121173,1738121469,1738121469.6132932,-21600,EB445137-D7F5-57EC-87DA-1DB460D64046,"iPhone13,2"
com.microsoft.Office.Outlook,36,1738121129,1738121165,1738121166.056788,-21600,EB445137-D7F5-57EC-87DA-1DB460D64046,"iPhone13,2"
com.apple.Music,75,1738119599,1738119674,1738119674.8011599,-21600,EB445137-D7F5-57EC-87DA-1DB460D64046,"iPhone13,2"
com.leomehlig.today,4,1738119390,1738119394,1738119394.661267,-21600,,
com.google.Chrome,3,1738119387,1738119390,1738119390.679964,-21600,,
com.apple.finder,6,1738119381,1738119387,1738119387.562275,-21600,,
com.apple.Notes,1020,1738118361,1738119381,1738119381.2217278,-21600,,
com.apple.iCal,1,1738118360,1738118361,1738118361.77055,-21600,,
com.apple.finder,1,1738118359,1738118360,1738118360.680299,-21600,,
com.apple.Preview,18,1738118341,1738118359,1738118359.57378,-21600,,
com.apple.finder,6,1738118335,1738118341,1738118341.234435,-21600,,
com.apple.Notes,44,1738118291,1738118335,1738118335.523988,-21600,,
com.google.Chrome,44,1738118247,1738118291,1738118291.691601,-21600,,
com.apple.Notes,16,1738118231,1738118247,1738118247.35492,-21600,,
com.leomehlig.today,6,1738118225,1738118231,1738118231.9511352,-21600,,
com.google.Chrome,3,1738118222,1738118225,1738118225.21791,-21600,,
com.leomehlig.today,101,1738118121,1738118222,1738118222.7560549,-21600,,
com.leomehlig.today,333,1738116662,1738116995,1738116995.779886,-21600,,
com.apple.finder,1,1738116661,1738116662,1738116662.4378219,-21600,,
com.apple.Preview,138,1738116523,1738116661,1738116661.246529,-21600,,
com.apple.finder,7,1738116516,1738116523,1738116523.9660978,-21600,,
com.google.Chrome,21,1738116495,1738116516,1738116516.101409,-21600,,
com.apple.Health,196,1738115633,1738115829,1738115829.715771,-21600,EB445137-D7F5-57EC-87DA-1DB460D64046,"iPhone13,2"
com.apple.Music,2,1738115625,1738115627,1738115627.63523,-21600,EB445137-D7F5-57EC-87DA-1DB460D64046,"iPhone13,2"
com.google.Chrome,398,1738113254,1738113652,1738113652.803965,-21600,,
com.leomehlig.today,32,1738113222,1738113254,1738113254.446707,-21600,,
com.google.Chrome,134,1738113088,1738113222,1738113222.898237,-21600,,
com.leomehlig.today,1,1738113087,1738113088,1738113088.3771238,-21600,,
com.apple.Notes,2,1738113085,1738113087,1738113087.0958772,-21600,,
com.leomehlig.today,45,1738113040,1738113085,1738113086.028654,-21600,,
com.apple.Notes,97,1738112943,1738113040,1738113040.444463,-21600,,
com.google.Chrome,100,1738112843,1738112943,1738112943.557226,-21600,,
com.leomehlig.today,19,1738112824,1738112843,1738112843.845748,-21600,,
com.google.Chrome,22,1738112802,1738112824,1738112824.35114,-21600,,
com.google.Chrome,2069,1738110271,1738112340,1738112340.6763659,-21600,,
com.apple.Music,6,1738110004,1738110010,1738110011.150326,-21600,EB445137-D7F5-57EC-87DA-1DB460D64046,"iPhone13,2"
com.leomehlig.today,21,1738109990,1738110011,1738110013.978625,-21600,,
com.apple.Music,72,1738108418,1738108490,1738108491.2272549,-21600,EB445137-D7F5-57EC-87DA-1DB460D64046,"iPhone13,2"
com.discoverfinancial.mobile,34,1738108135,1738108169,1738108170.1933331,-21600,EB445137-D7F5-57EC-87DA-1DB460D64046,"iPhone13,2"
com.discoverfinancial.mobile,13,1738108121,1738108134,1738108134.999094,-21600,EB445137-D7F5-57EC-87DA-1DB460D64046,"iPhone13,2"
com.truebill.truebillnative,79,1738108032,1738108111,1738108111.10217,-21600,EB445137-D7F5-57EC-87DA-1DB460D64046,"iPhone13,2"
com.apple.CoreAuthUI,2,1738107981,1738107983,1738107983.7829142,-21600,EB445137-D7F5-57EC-87DA-1DB460D64046,"iPhone13,2"
com.discoverfinancial.mobile,56,1738107976,1738108032,1738108032.3145828,-21600,EB445137-D7F5-57EC-87DA-1DB460D64046,"iPhone13,2"
com.apple.CoreAuthUI,6,1738107849,1738107855,1738107855.3513079,-21600,EB445137-D7F5-57EC-87DA-1DB460D64046,"iPhone13,2"
com.truebill.truebillnative,129,1738107845,1738107974,1738107974.8951921,-21600,EB445137-D7F5-57EC-87DA-1DB460D64046,"iPhone13,2"
com.apple.news,214,1738107623,1738107837,1738107837.912118,-21600,EB445137-D7F5-57EC-87DA-1DB460D64046,"iPhone13,2"
com.microsoft.Office.Outlook,28,1738107582,1738107610,1738107610.260738,-21600,EB445137-D7F5-57EC-87DA-1DB460D64046,"iPhone13,2"
com.myfitnesspal.mfp,1,1738107581,1738107582,1738107582.246547,-21600,EB445137-D7F5-57EC-87DA-1DB460D64046,"iPhone13,2"
com.leomehlig.today,68,1738107454,1738107522,1738107522.655122,-21600,,
com.leomehlig.today,320,1738106573,1738106893,1738106893.325944,-21600,,
com.apple.finder,2,1738106571,1738106573,1738106573.20331,-21600,,
com.myfitnesspal.mfp,31,1738106321,1738106352,1738106352.2822099,-21600,EB445137-D7F5-57EC-87DA-1DB460D64046,"iPhone13,2"
com.hammerandchisel.discord,20,1738106227,1738106247,1738106247.395385,-21600,EB445137-D7F5-57EC-87DA-1DB460D64046,"iPhone13,2"
com.meijer.mobile.Meijer,1,1738106226,1738106227,1738106227.3059502,-21600,EB445137-D7F5-57EC-87DA-1DB460D64046,"iPhone13,2"
com.meijer.mobile.Meijer,72,1738106087,1738106159,1738106159.972615,-21600,EB445137-D7F5-57EC-87DA-1DB460D64046,"iPhone13,2"
com.apple.calculator,34,1738106053,1738106087,1738106087.3274078,-21600,EB445137-D7F5-57EC-87DA-1DB460D64046,"iPhone13,2"
com.meijer.mobile.Meijer,40,1738106013,1738106053,1738106053.6800551,-21600,EB445137-D7F5-57EC-87DA-1DB460D64046,"iPhone13,2"
com.apple.calculator,4,1738106009,1738106013,1738106013.98837,-21600,EB445137-D7F5-57EC-87DA-1DB460D64046,"iPhone13,2"
com.meijer.mobile.Meijer,53,1738105956,1738106009,1738106009.356038,-21600,EB445137-D7F5-57EC-87DA-1DB460D64046,"iPhone13,2"
com.apple.finder,360,1738099995,1738100355,1738100355.887045,-21600,,
com.leomehlig.today,68,1738099927,1738099995,1738099995.9262428,-21600,,
com.apple.iCal,15,1738099912,1738099927,1738099927.9006162,-21600,,
com.google.Chrome,307,1738099605,1738099912,1738099912.127852,-21600,,
com.apple.MobileSMS,4,1738099601,1738099605,1738099605.286125,-21600,,
com.google.Chrome,22,1738099579,1738099601,1738099601.163711,-21600,,
com.google.Chrome,2,1738098521,1738098523,1738098523.842547,-21600,,
com.apple.finder,77,1738098444,1738098521,1738098521.618384,-21600,,
com.intsig.CamScannerLite,116,1738098227,1738098343,1738098343.223229,-21600,EB445137-D7F5-57EC-87DA-1DB460D64046,"iPhone13,2"
com.google.Chrome,2938,1738095506,1738098444,1738098444.885741,-21600,,
com.google.chrome.ios,56,1738094264,1738094320,1738094320.422042,-21600,EB445137-D7F5-57EC-87DA-1DB460D64046,"iPhone13,2"
com.microsoft.Office.Outlook,62,1738093230,1738093292,1738093293.076457,-21600,EB445137-D7F5-57EC-87DA-1DB460D64046,"iPhone13,2"
com.apple.MobileSMS,30,1738093199,1738093229,1738093229.6119041,-21600,EB445137-D7F5-57EC-87DA-1DB460D64046,"iPhone13,2"
com.google.chrome.ios,37,1738093161,1738093198,1738093198.5469089,-21600,EB445137-D7F5-57EC-87DA-1DB460D64046,"iPhone13,2"
com.apple.MobileSMS,4,1738093157,1738093161,1738093161.383419,-21600,EB445137-D7F5-57EC-87DA-1DB460D64046,"iPhone13,2"
com.google.Chrome,5,1738093067,1738093072,1738093072.536802,-21600,,
com.leomehlig.today,155,1738092898,1738093053,1738093053.1828442,-21600,,
com.google.Chrome,134,1738092764,1738092898,1738092898.572057,-21600,,
com.leomehlig.today,47,1738092700,1738092747,1738092747.503376,-21600,,
com.hammerandchisel.discord,30,1738092697,1738092727,1738092727.9064841,-21600,EB445137-D7F5-57EC-87DA-1DB460D64046,"iPhone13,2"
com.amazon.Amazon,16,1738092390,1738092406,1738092406.743881,-21600,EB445137-D7F5-57EC-87DA-1DB460D64046,"iPhone13,2"
com.leomehlig.today,4,1738087238,1738087242,1738087242.607203,-21600,,
com.google.Chrome,514,1738086724,1738087238,1738087238.151804,-21600,,
com.google.Chrome,355,1738085906,1738086261,1738086261.6152349,-21600,,
com.myfitnesspal.mfp,130,1738085540,1738085670,1738085671.301722,-21600,EB445137-D7F5-57EC-87DA-1DB460D64046,"iPhone13,2"
com.instructure.icanvas,2,1738085536,1738085538,1738085538.8934479,-21600,EB445137-D7F5-57EC-87DA-1DB460D64046,"iPhone13,2"
com.google.Chrome,77,1738085244,1738085321,1738085321.874362,-21600,,
com.apple.finder,64,1738085165,1738085229,1738085229.615964,-21600,,
com.leomehlig.today,45,1738085120,1738085165,1738085165.2757668,-21600,,
com.apple.finder,2,1738085118,1738085120,1738085120.470655,-21600,,
com.leomehlig.today,3,1738085115,1738085118,1738085118.9805079,-21600,,
com.apple.Terminal,1,1738085114,1738085115,1738085115.828737,-21600,,
com.leomehlig.today,1,1738085113,1738085114,1738085114.947208,-21600,,
com.cisco.secureclient.gui,6,1738085107,1738085113,1738085113.424172,-21600,,
com.apple.Terminal,3,1738085104,1738085107,1738085107.249589,-21600,,
com.google.Chrome,65,1738085039,1738085104,1738085104.966182,-21600,,
com.apple.Terminal,4,1738085035,1738085039,1738085039.65592,-21600,,
com.leomehlig.today,21,1738085014,1738085035,1738085035.770163,-21600,,
com.cisco.secureclient.gui,2,1738085012,1738085014,1738085014.377201,-21600,,
com.apple.finder,0,1738085012,1738085012,1738085012.834671,-21600,,
com.apple.Notes,7,1738085005,1738085012,1738085012.262978,-21600,,
com.electron.carta,16,1738084989,1738085005,1738085005.776345,-21600,,
com.apple.Notes,68,1738084921,1738084989,1738084989.879777,-21600,,
com.electron.carta,30,1738084891,1738084921,1738084921.836138,-21600,,
com.apple.Terminal,5,1738084886,1738084891,1738084891.659061,-21600,,
com.electron.carta,788,1738084098,1738084886,1738084886.313225,-21600,,
com.google.Chrome,21,1738084077,1738084098,1738084098.092282,-21600,,
com.apple.iCal,15,1738084062,1738084077,1738084077.153429,-21600,,
com.google.Chrome,8,1738084054,1738084062,1738084062.303746,-21600,,
com.apple.iCal,3,1738084051,1738084054,1738084054.350634,-21600,,
com.google.Chrome,35,1738084016,1738084051,1738084051.2546039,-21600,,
com.apple.iCal,6,1738084010,1738084016,1738084016.989505,-21600,,
com.google.Chrome,13,1738083997,1738084010,1738084010.144345,-21600,,
com.apple.iCal,6,1738083991,1738083997,1738083997.895735,-21600,,
com.google.Chrome,5,1738083986,1738083991,1738083991.228771,-21600,,
com.apple.iCal,2,1738083984,1738083986,1738083986.8828058,-21600,,
com.google.Chrome,14,1738083970,1738083984,1738083984.283659,-21600,,
com.apple.iCal,16,1738083954,1738083970,1738083970.9076781,-21600,,
com.google.Chrome,39,1738083915,1738083954,1738083954.60247,-21600,,
com.instructure.icanvas,62,1738083883,1738083945,1738083945.262042,-21600,EB445137-D7F5-57EC-87DA-1DB460D64046,"iPhone13,2"
com.ryansponzilli.DeepSkyCatalog,0,1738083883,1738083883,1738083884.112097,-21600,EB445137-D7F5-57EC-87DA-1DB460D64046,"iPhone13,2"
com.apple.Terminal,53,1738083847,1738083900,1738083902.727881,-21600,,
com.electron.carta,181,1738083666,1738083847,1738083847.873461,-21600,,
com.apple.finder,30,1738083636,1738083666,1738083666.859621,-21600,,
com.electron.carta,71,1738083565,1738083636,1738083636.3317552,-21600,,
com.apple.finder,45,1738083492,1738083537,1738083537.5410209,-21600,,
com.apple.Terminal,11,1738083481,1738083492,1738083492.347709,-21600,,
com.apple.finder,37,1738083444,1738083481,1738083482.0324159,-21600,,
com.google.Chrome,22,1738083422,1738083444,1738083444.166645,-21600,,
com.apple.Preview,50,1738083372,1738083422,1738083422.3752642,-21600,,
com.google.Chrome,49,1738083323,1738083372,1738083372.198403,-21600,,
com.apple.Preview,75,1738083248,1738083323,1738083323.897818,-21600,,
com.apple.Terminal,2,1738083246,1738083248,1738083248.354459,-21600,,
com.apple.Preview,22,1738083224,1738083246,1738083246.56417,-21600,,
com.google.Chrome,8,1738083216,1738083224,1738083224.663653,-21600,,
com.apple.finder,13,1738083203,1738083216,1738083216.9376512,-21600,,
com.google.Chrome,1,1738083202,1738083203,1738083203.786257,-21600,,
com.apple.Preview,1,1738083201,1738083202,1738083202.967999,-21600,,
com.google.Chrome,23,1738083178,1738083201,1738083201.719839,-21600,,
com.apple.Preview,2,1738083176,1738083178,1738083178.551918,-21600,,
com.google.Chrome,2,1738083174,1738083176,1738083176.837222,-21600,,
com.apple.Preview,5,1738083169,1738083174,1738083174.41158,-21600,,
com.google.Chrome,104,1738083065,1738083169,1738083169.811861,-21600,,
com.apple.Preview,46,1738083019,1738083065,1738083065.503489,-21600,,
com.google.Chrome,42,1738082977,1738083019,1738083019.875636,-21600,,
com.apple.Preview,11,1738082966,1738082977,1738082977.817101,-21600,,
com.google.Chrome,1,1738082965,1738082966,1738082967.000732,-21600,,
com.apple.Preview,10,1738082955,1738082965,1738082965.772656,-21600,,
com.apple.finder,3,1738082952,1738082955,1738082955.086983,-21600,,
com.google.Chrome,125,1738082827,1738082952,1738082952.734504,-21600,,
com.apple.Terminal,9,1738082818,1738082827,1738082827.279632,-21600,,
com.google.Chrome,413,1738082405,1738082818,1738082818.25458,-21600,,
com.apple.Preview,135,1738082270,1738082405,1738082405.452795,-21600,,
com.apple.finder,19,1738082251,1738082270,1738082270.476262,-21600,,
com.apple.Terminal,172,1738082079,1738082251,1738082251.716135,-21600,,
com.apple.finder,10,1738082069,1738082079,1738082079.190279,-21600,,
com.apple.Terminal,27,1738082042,1738082069,1738082069.44543,-21600,,
com.google.Chrome,15,1738082027,1738082042,1738082042.318969,-21600,,
com.apple.Terminal,4,1738082023,1738082027,1738082027.320928,-21600,,
com.google.Chrome,5,1738082018,1738082023,1738082023.440314,-21600,,
com.apple.Terminal,10,1738082008,1738082018,1738082018.675874,-21600,,
com.google.Chrome,20,1738081988,1738082008,1738082008.864147,-21600,,
com.apple.Terminal,22,1738081966,1738081988,1738081988.69255,-21600,,
com.google.Chrome,21,1738081945,1738081966,1738081966.896854,-21600,,
com.apple.Terminal,27,1738081918,1738081945,1738081945.480499,-21600,,
com.apple.finder,6,1738081912,1738081918,1738081918.070928,-21600,,
com.apple.Terminal,38,1738081874,1738081912,1738081912.936726,-21600,,
com.apple.finder,2,1738081872,1738081874,1738081874.809463,-21600,,
com.apple.Terminal,8,1738081864,1738081872,1738081872.81021,-21600,,
com.apple.finder,8,1738081856,1738081864,1738081864.439548,-21600,,
com.apple.Terminal,39,1738081817,1738081856,1738081856.4427009,-21600,,
com.google.Chrome,19,1738081798,1738081817,1738081818.007474,-21600,,
com.apple.Terminal,60,1738081738,1738081798,1738081798.6426868,-21600,,
com.google.Chrome,78,1738081660,1738081738,1738081738.0582252,-21600,,
com.apple.Terminal,43,1738081617,1738081660,1738081660.9210649,-21600,,
com.apple.finder,6,1738081611,1738081617,1738081617.4409509,-21600,,
com.apple.Terminal,8,1738081603,1738081611,1738081611.089217,-21600,,
com.apple.finder,1,1738081602,1738081603,1738081603.374177,-21600,,
com.apple.Terminal,4,1738081598,1738081602,1738081602.235651,-21600,,
com.apple.finder,2,1738081596,1738081598,1738081598.5844789,-21600,,
com.google.Chrome,6,1738081590,1738081596,1738081596.859507,-21600,,
com.apple.finder,17,1738081573,1738081590,1738081590.9856339,-21600,,
com.apple.Terminal,61,1738081512,1738081573,1738081573.244258,-21600,,
com.apple.finder,11,1738081501,1738081512,1738081512.077709,-21600,,
com.apple.Terminal,11,1738081490,1738081501,1738081501.83608,-21600,,
com.apple.finder,46,1738081444,1738081490,1738081490.4895802,-21600,,
com.apple.Terminal,1,1738081443,1738081444,1738081444.794821,-21600,,
com.leomehlig.today,3,1738081440,1738081443,1738081443.584579,-21600,,
com.apple.Terminal,5,1738081435,1738081440,1738081440.783704,-21600,,
com.apple.finder,15,1738081420,1738081435,1738081435.556539,-21600,,
com.apple.systempreferences,3,1738081417,1738081420,1738081420.308576,-21600,,
com.apple.finder,42,1738081375,1738081417,1738081417.169678,-21600,,
com.apple.systempreferences,15,1738081360,1738081375,1738081375.995889,-21600,,
com.apple.finder,105,1738081255,1738081360,1738081360.587723,-21600,,
com.apple.FinalCut,5,1738081250,1738081255,1738081255.5219622,-21600,,
com.apple.finder,14,1738081214,1738081228,1738081228.0522819,-21600,,
com.apple.FinalCut,13,1738081201,1738081214,1738081215.018302,-21600,,
com.apple.finder,13,1738081188,1738081201,1738081201.278842,-21600,,
com.apple.FinalCut,7,1738081181,1738081188,1738081188.6115599,-21600,,
com.apple.finder,9,1738081172,1738081181,1738081181.918868,-21600,,
com.apple.systempreferences,37,1738081135,1738081172,1738081172.20908,-21600,,
com.apple.finder,5,1738081130,1738081135,1738081135.346123,-21600,,
com.apple.systempreferences,4,1738081126,1738081130,1738081130.134922,-21600,,
com.apple.finder,85,1738081041,1738081126,1738081126.218666,-21600,,
com.apple.FinalCut,33,1738081008,1738081041,1738081041.305523,-21600,,
com.apple.finder,100,1738080908,1738081008,1738081008.941772,-21600,,
com.apple.FinalCut,117,1738080791,1738080908,1738080908.754338,-21600,,
com.apple.finder,14,1738080777,1738080791,1738080791.8298988,-21600,,
com.apple.FinalCut,19,1738080758,1738080777,1738080777.421194,-21600,,
com.apple.finder,55,1738080703,1738080758,1738080758.290124,-21600,,
com.apple.Terminal,75,1738080628,1738080703,1738080703.093597,-21600,,
com.apple.finder,24,1738080604,1738080628,1738080628.5145159,-21600,,
com.apple.QuickTimePlayerX,15,1738080589,1738080604,1738080604.600395,-21600,,
com.apple.finder,24,1738080565,1738080589,1738080589.263766,-21600,,
com.apple.systempreferences,73,1738080492,1738080565,1738080565.9861112,-21600,,
com.apple.finder,9,1738080429,1738080438,1738080438.47406,-21600,,
com.apple.systempreferences,12,1738080417,1738080429,1738080429.938725,-21600,,
com.apple.finder,47,1738080370,1738080417,1738080417.358351,-21600,,
com.cisco.secureclient.gui,29,1738080341,1738080370,1738080370.125822,-21600,,
com.apple.finder,1,1738080340,1738080341,1738080341.2112741,-21600,,
com.cisco.secureclient.gui,2,1738080338,1738080340,1738080340.028595,-21600,,
com.leomehlig.today,4,1738080334,1738080338,1738080338.348089,-21600,,
com.ryansponzilli.DeepSkyCatalog,67,1738080247,1738080314,1738080315.083354,-21600,EB445137-D7F5-57EC-87DA-1DB460D64046,"iPhone13,2"
Astrospheric.Astrospheric,54,1738080193,1738080247,1738080247.8192348,-21600,EB445137-D7F5-57EC-87DA-1DB460D64046,"iPhone13,2"
com.truebill.truebillnative,2,1738080190,1738080192,1738080192.465694,-21600,EB445137-D7F5-57EC-87DA-1DB460D64046,"iPhone13,2"
com.google.Chrome,155,1738080179,1738080334,1738080334.313036,-21600,,
com.google.Chrome,55,1738079540,1738079595,1738079595.74056,-21600,,
com.apple.CoreAuthUI,2,1738078390,1738078392,1738078392.197505,-21600,EB445137-D7F5-57EC-87DA-1DB460D64046,"iPhone13,2"
com.truebill.truebillnative,34,1738078389,1738078423,1738078423.794893,-21600,EB445137-D7F5-57EC-87DA-1DB460D64046,"iPhone13,2"
com.apple.news,2,1738078377,1738078379,1738078379.6149101,-21600,EB445137-D7F5-57EC-87DA-1DB460D64046,"iPhone13,2"
com.google.Chrome,696,1738078250,1738078946,1738078946.0268779,-21600,,
com.apple.news,101,1738078099,1738078200,1738078201.034772,-21600,EB445137-D7F5-57EC-87DA-1DB460D64046,"iPhone13,2"
com.microsoft.Office.Outlook,16,1738078072,1738078088,1738078088.832556,-21600,EB445137-D7F5-57EC-87DA-1DB460D64046,"iPhone13,2"
com.apple.CoreAuthUI,2,1738076934,1738076936,1738076936.190068,-21600,EB445137-D7F5-57EC-87DA-1DB460D64046,"iPhone13,2"
com.truebill.truebillnative,102,1738076932,1738077034,1738077034.864989,-21600,EB445137-D7F5-57EC-87DA-1DB460D64046,"iPhone13,2"
com.microsoft.Office.Outlook,31,1738076896,1738076927,1738076927.670646,-21600,EB445137-D7F5-57EC-87DA-1DB460D64046,"iPhone13,2"
com.apple.weather,1,1738076895,1738076896,1738076896.592863,-21600,EB445137-D7F5-57EC-87DA-1DB460D64046,"iPhone13,2"
com.google.Chrome,330,1738076812,1738077142,1738077142.332402,-21600,,
com.leomehlig.today,17,1738076795,1738076812,1738076812.82017,-21600,,
com.google.Chrome,12,1738076783,1738076795,1738076795.562446,-21600,,
com.google.Chrome,345,1738076372,1738076717,1738076717.2879891,-21600,,
com.apple.Passwords,52,1738076320,1738076372,1738076372.472408,-21600,,
com.google.Chrome,139,1738076181,1738076320,1738076320.700016,-21600,,
com.apple.weather,15,1738075748,1738075763,1738075763.477396,-21600,EB445137-D7F5-57EC-87DA-1DB460D64046,"iPhone13,2"
com.apple.Health,1,1738075747,1738075748,1738075748.7603989,-21600,EB445137-D7F5-57EC-87DA-1DB460D64046,"iPhone13,2"
com.apple.Health,6,1738075708,1738075714,1738075714.446897,-21600,EB445137-D7F5-57EC-87DA-1DB460D64046,"iPhone13,2"
com.apple.Health,10,1738075697,1738075707,1738075707.359312,-21600,EB445137-D7F5-57EC-87DA-1DB460D64046,"iPhone13,2"
com.renpho.health,75,1738075619,1738075694,1738075694.018221,-21600,EB445137-D7F5-57EC-87DA-1DB460D64046,"iPhone13,2"
com.apple.news,53,1738074387,1738074440,1738074440.4659529,-21600,EB445137-D7F5-57EC-87DA-1DB460D64046,"iPhone13,2"
com.apple.news,2,1738074384,1738074386,1738074388.192511,-21600,EB445137-D7F5-57EC-87DA-1DB460D64046,"iPhone13,2"
com.apple.mobiletimer,8,1738074309,1738074317,1738074317.2105842,-21600,EB445137-D7F5-57EC-87DA-1DB460D64046,"iPhone13,2"
com.apple.Health,106,1738042036,1738042142,1738042142.8840342,-21600,EB445137-D7F5-57EC-87DA-1DB460D64046,"iPhone13,2"
com.thestorygraph.thestorygraph,18,1738042013,1738042031,1738042031.993576,-21600,EB445137-D7F5-57EC-87DA-1DB460D64046,"iPhone13,2"
com.google.Chrome,56,1738039810,1738039866,1738039866.43069,-21600,,
com.google.Chrome,728,1738038412,1738039140,1738039140.5175362,-21600,,
com.google.Chrome,1553,1738036794,1738038347,1738038347.553131,-21600,,
com.apple.finder,2,1738036792,1738036794,1738036794.865981,-21600,,
com.apple.Music,50,1738033426,1738033476,1738033476.5994592,-21600,EB445137-D7F5-57EC-87DA-1DB460D64046,"iPhone13,2"
com.apple.finder,34,1738033089,1738033123,1738033123.6531649,-21600,,
com.apple.Notes,4,1738033085,1738033089,1738033089.414569,-21600,,
com.apple.finder,2,1738033083,1738033085,1738033085.330946,-21600,,
com.microsoft.Excel,42,1738033041,1738033083,1738033084.082673,-21600,,
com.apple.finder,5,1738033036,1738033041,1738033041.405662,-21600,,
com.microsoft.Excel,32,1738033004,1738033036,1738033036.745772,-21600,,
com.apple.finder,13,1738032991,1738033004,1738033004.298604,-21600,,
com.microsoft.Excel,15,1738032976,1738032991,1738032991.7433028,-21600,,
com.apple.finder,6,1738032970,1738032976,1738032976.21918,-21600,,
com.apple.Preview,8,1738032962,1738032970,1738032970.662376,-21600,,
com.apple.finder,4,1738032958,1738032962,1738032962.044807,-21600,,
com.hammerandchisel.discord,29,1738032684,1738032713,1738032713.878603,-21600,EB445137-D7F5-57EC-87DA-1DB460D64046,"iPhone13,2"
com.apple.Music,0,1738032684,1738032684,1738032684.912461,-21600,EB445137-D7F5-57EC-87DA-1DB460D64046,"iPhone13,2"
com.microsoft.Excel,397,1738032561,1738032958,1738032958.773675,-21600,,
com.leomehlig.today,1,1738032560,1738032561,1738032561.520215,-21600,,
com.apple.Notes,154,1738032406,1738032560,1738032560.603057,-21600,,
com.leomehlig.today,3,1738032403,1738032406,1738032406.8989902,-21600,,
com.microsoft.Excel,198,1738032205,1738032403,1738032404.0463428,-21600,,
com.leomehlig.today,3,1738032202,1738032205,1738032205.103056,-21600,,
com.apple.finder,7,1738032195,1738032202,1738032202.250475,-21600,,
com.leomehlig.today,1,1738032194,1738032195,1738032195.915551,-21600,,
com.apple.finder,2,1738032192,1738032194,1738032194.343914,-21600,,
com.leomehlig.today,1,1738032191,1738032192,1738032192.356607,-21600,,
com.google.Chrome,1,1738032190,1738032191,1738032191.577822,-21600,,
com.leomehlig.today,112,1738032078,1738032190,1738032190.295961,-21600,,
com.apple.Notes,58,1738032020,1738032078,1738032078.4266062,-21600,,
com.leomehlig.today,8,1738032012,1738032020,1738032020.850585,-21600,,
com.google.Chrome,20,1738031992,1738032012,1738032012.3181028,-21600,,
com.leomehlig.today,15,1738031977,1738031992,1738031993.950615,-21600,,
com.apple.Preview,19,1738031958,1738031977,1738031977.047236,-21600,,
com.apple.finder,90,1738031868,1738031958,1738031958.2535791,-21600,,
com.leomehlig.today,18,1738031850,1738031868,1738031868.474726,-21600,,
com.apple.finder,4,1738031846,1738031850,1738031850.40991,-21600,,
com.leomehlig.today,5,1738031841,1738031846,1738031847.0312428,-21600,,
com.apple.finder,3,1738031838,1738031841,1738031841.285305,-21600,,
com.leomehlig.today,9,1738031829,1738031838,1738031838.576591,-21600,,
com.apple.finder,49,1738031780,1738031829,1738031829.43461,-21600,,
com.leomehlig.today,46,1738031734,1738031780,1738031780.061212,-21600,,
com.google.Chrome,92,1738031642,1738031734,1738031734.154228,-21600,,
com.apple.finder,5,1738031623,1738031628,1738031629.010306,-21600,,
com.leomehlig.today,9,1738031614,1738031623,1738031623.704862,-21600,,
com.apple.finder,4,1738031610,1738031614,1738031614.207759,-21600,,
com.apple.Notes,68,1738031542,1738031610,1738031610.8046489,-21600,,
com.electron.carta,18,1738031524,1738031542,1738031542.283413,-21600,,
com.google.Chrome,128,1738031396,1738031524,1738031524.206358,-21600,,
com.electron.carta,281,1738030592,1738030873,1738030873.976888,-21600,,
com.google.Chrome,2,1738030590,1738030592,1738030592.5028539,-21600,,
com.electron.carta,17,1738030573,1738030590,1738030590.79339,-21600,,
com.google.Chrome,1,1738030572,1738030573,1738030573.937002,-21600,,
com.electron.carta,1,1738030571,1738030572,1738030572.6952991,-21600,,
com.google.Chrome,76,1738030495,1738030571,1738030571.853195,-21600,,
com.electron.carta,127,1738030368,1738030495,1738030495.511673,-21600,,
com.google.Chrome,65,1738030303,1738030368,1738030368.191355,-21600,,
com.electron.carta,137,1738030166,1738030303,1738030303.7157478,-21600,,
com.google.Chrome,26,1738030140,1738030166,1738030166.938036,-21600,,
com.electron.carta,5,1738030135,1738030140,1738030140.285129,-21600,,
com.apple.Notes,2,1738030133,1738030135,1738030135.458395,-21600,,
com.electron.carta,7,1738030126,1738030133,1738030133.96364,-21600,,
com.apple.Notes,2,1738030124,1738030126,1738030126.318989,-21600,,
com.electron.carta,80,1738030044,1738030124,1738030124.381991,-21600,,
com.apple.Notes,4,1738030040,1738030044,1738030044.657699,-21600,,
com.electron.carta,7,1738030033,1738030040,1738030040.6675282,-21600,,
com.apple.Notes,7,1738030026,1738030033,1738030033.741543,-21600,,
com.electron.carta,726,1738029300,1738030026,1738030026.191791,-21600,,
com.google.Chrome,57,1738029243,1738029300,1738029300.9680328,-21600,,
com.electron.carta,314,1738028929,1738029243,1738029243.999835,-21600,,
com.google.Chrome,635,1738028294,1738028929,1738028929.18369,-21600,,
com.apple.Preview,53,1738028241,1738028294,1738028294.3958678,-21600,,
com.apple.finder,5,1738028236,1738028241,1738028241.795401,-21600,,
com.apple.Preview,5,1738028231,1738028236,1738028236.764431,-21600,,
com.apple.finder,11,1738028220,1738028231,1738028231.599294,-21600,,
com.apple.Preview,16,1738028204,1738028220,1738028220.681003,-21600,,
com.apple.finder,16,1738028188,1738028204,1738028204.344917,-21600,,
com.google.Chrome,35,1738028153,1738028188,1738028188.489712,-21600,,
com.apple.Notes,7,1738028146,1738028153,1738028153.267397,-21600,,
com.google.Chrome,2,1738028144,1738028146,1738028146.205233,-21600,,
com.apple.Notes,69,1738028075,1738028144,1738028144.902679,-21600,,
com.google.Chrome,2,1738028073,1738028075,1738028075.66135,-21600,,
com.apple.Preview,2,1738028071,1738028073,1738028073.025059,-21600,,
com.apple.finder,1,1738028070,1738028071,1738028071.4083838,-21600,,
com.apple.Notes,2,1738028068,1738028070,1738028070.702564,-21600,,
com.apple.finder,1,1738028067,1738028068,1738028068.153166,-21600,,
com.apple.Preview,1,1738028066,1738028067,1738028067.214213,-21600,,
com.google.Chrome,14,1738028052,1738028066,1738028066.291717,-21600,,
com.apple.Preview,1,1738028051,1738028052,1738028052.181126,-21600,,
com.apple.Notes,3,1738028048,1738028051,1738028051.3121161,-21600,,
com.apple.Preview,2,1738028046,1738028048,1738028048.126498,-21600,,
com.google.Chrome,3,1738028043,1738028046,1738028046.7536879,-21600,,
com.apple.Preview,1,1738028042,1738028043,1738028043.910012,-21600,,
com.apple.Notes,14,1738028028,1738028042,1738028042.947363,-21600,,
com.apple.Preview,1,1738028027,1738028028,1738028028.261015,-21600,,
com.google.Chrome,88,1738027939,1738028027,1738028027.2473922,-21600,,
com.apple.Preview,14,1738027925,1738027939,1738027939.6190639,-21600,,
com.apple.Notes,3,1738027922,1738027925,1738027925.419631,-21600,,
com.apple.Preview,588,1738027334,1738027922,1738027922.4145489,-21600,,
com.google.Chrome,220,1738027114,1738027334,1738027334.1377568,-21600,,
com.apple.finder,79,1738027035,1738027114,1738027114.542774,-21600,,
com.apple.Preview,187,1738026848,1738027035,1738027035.09954,-21600,,
com.google.Chrome,438,1738026410,1738026848,1738026848.818728,-21600,,
com.apple.finder,42,1738026368,1738026410,1738026410.835034,-21600,,
com.apple.Preview,2,1738026366,1738026368,1738026368.0868912,-21600,,
com.apple.finder,4,1738026362,1738026366,1738026366.313218,-21600,,
com.apple.Notes,10,1738026352,1738026362,1738026362.070053,-21600,,
com.google.Chrome,75,1738026277,1738026352,1738026352.784628,-21600,,
com.leomehlig.today,177,1738026100,1738026277,1738026277.779028,-21600,,
com.apple.finder,2,1738026098,1738026100,1738026105.615916,-21600,,
com.apple.Notes,0,1738026098,1738026098,1738026105.003135,-21600,,
com.google.Chrome,12,1738026086,1738026098,1738026099.5172381,-21600,,
com.apple.Music,5,1738025299,1738025304,1738025304.76425,-21600,EB445137-D7F5-57EC-87DA-1DB460D64046,"iPhone13,2"
com.apple.Music,8,1738021985,1738021993,1738021994.057272,-21600,EB445137-D7F5-57EC-87DA-1DB460D64046,"iPhone13,2"
com.myfitnesspal.mfp,0,1738021985,1738021985,1738021986.611969,-21600,EB445137-D7F5-57EC-87DA-1DB460D64046,"iPhone13,2"
com.myfitnesspal.mfp,28,1738021814,1738021842,1738021843.113411,-21600,EB445137-D7F5-57EC-87DA-1DB460D64046,"iPhone13,2"
com.myfitnesspal.mfp,406,1738020772,1738021178,1738021178.946103,-21600,EB445137-D7F5-57EC-87DA-1DB460D64046,"iPhone13,2"
com.google.Chrome,302,1738020720,1738021022,1738021022.016119,-21600,,
com.google.Chrome,300,1738020132,1738020432,1738020432.9418612,-21600,,
com.google.Chrome,310,1738019808,1738020118,1738020118.732614,-21600,,
com.google.Chrome,451,1738019344,1738019795,1738019795.1335201,-21600,,
com.google.Chrome,301,1738019040,1738019341,1738019341.8012052,-21600,,
com.google.Chrome,345,1738018452,1738018797,1738018797.1291242,-21600,,
com.google.Chrome,325,1738018011,1738018336,1738018336.250848,-21600,,
com.google.Chrome,396,1738017589,1738017985,1738017985.842428,-21600,,
com.google.Chrome,730,1738015768,1738016498,1738016498.236143,-21600,,
com.google.Chrome,1433,1738013382,1738014815,1738014815.3549109,-21600,,
com.apple.Notes,5,1738013377,1738013382,1738013382.8912911,-21600,,
com.google.Chrome,112,1738013265,1738013377,1738013377.20709,-21600,,
com.apple.mobilephone,2,1738013189,1738013191,1738013191.6513429,-21600,EB445137-D7F5-57EC-87DA-1DB460D64046,"iPhone13,2"
com.apple.InCallService,1,1738013188,1738013189,1738013189.729548,-21600,EB445137-D7F5-57EC-87DA-1DB460D64046,"iPhone13,2"
com.apple.InCallService,21,1738013160,1738013181,1738013181.1054869,-21600,EB445137-D7F5-57EC-87DA-1DB460D64046,"iPhone13,2"
com.apple.InCallService,41,1738013072,1738013113,1738013113.196604,-21600,EB445137-D7F5-57EC-87DA-1DB460D64046,"iPhone13,2"
com.apple.InCallService,8,1738013052,1738013060,1738013060.298914,-21600,EB445137-D7F5-57EC-87DA-1DB460D64046,"iPhone13,2"
com.apple.InCallService,10,1738012611,1738012621,1738012621.74733,-21600,EB445137-D7F5-57EC-87DA-1DB460D64046,"iPhone13,2"
com.apple.InCallService,2,1738012507,1738012509,1738012509.427445,-21600,EB445137-D7F5-57EC-87DA-1DB460D64046,"iPhone13,2"
com.apple.InCallService,0,1738011837,1738011837,1738011838.642266,-21600,EB445137-D7F5-57EC-87DA-1DB460D64046,"iPhone13,2"
com.apple.InCallService,2,1738011739,1738011741,1738011741.12678,-21600,EB445137-D7F5-57EC-87DA-1DB460D64046,"iPhone13,2"
com.apple.mobilephone,7,1738011732,1738011739,1738011740.092427,-21600,EB445137-D7F5-57EC-87DA-1DB460D64046,"iPhone13,2"
com.apple.findmy,5,1738011727,1738011732,1738011732.658288,-21600,EB445137-D7F5-57EC-87DA-1DB460D64046,"iPhone13,2"
com.apple.news,2,1738011708,1738011710,1738011711.0488548,-21600,EB445137-D7F5-57EC-87DA-1DB460D64046,"iPhone13,2"
com.apple.news,40,1738007914,1738007954,1738007954.6635342,-21600,EB445137-D7F5-57EC-87DA-1DB460D64046,"iPhone13,2"
com.apple.camera,5,1738007892,1738007897,1738007898.542063,-21600,EB445137-D7F5-57EC-87DA-1DB460D64046,"iPhone13,2"
com.microsoft.Office.Outlook,58,1738007832,1738007890,1738007890.762371,-21600,EB445137-D7F5-57EC-87DA-1DB460D64046,"iPhone13,2"
com.myfitnesspal.mfp,0,1738007832,1738007832,1738007833.791759,-21600,EB445137-D7F5-57EC-87DA-1DB460D64046,"iPhone13,2"
com.myfitnesspal.mfp,75,1738003455,1738003530,1738003530.4301639,-21600,EB445137-D7F5-57EC-87DA-1DB460D64046,"iPhone13,2"
com.microsoft.Office.Outlook,2,1738003097,1738003099,1738003099.63925,-21600,EB445137-D7F5-57EC-87DA-1DB460D64046,"iPhone13,2"
com.microsoft.Office.Outlook,16,1737997275,1737997291,1737997291.774434,-21600,EB445137-D7F5-57EC-87DA-1DB460D64046,"iPhone13,2"
com.apple.news,1,1737997272,1737997273,1737997273.7721171,-21600,EB445137-D7F5-57EC-87DA-1DB460D64046,"iPhone13,2"
com.apple.news,257,1737996972,1737997229,1737997229.3574119,-21600,EB445137-D7F5-57EC-87DA-1DB460D64046,"iPhone13,2"
com.robinhood.release.Robinhood,3,1737996969,1737996972,1737996972.999677,-21600,EB445137-D7F5-57EC-87DA-1DB460D64046,"iPhone13,2"
com.apple.news,107,1737996860,1737996967,1737996967.189688,-21600,EB445137-D7F5-57EC-87DA-1DB460D64046,"iPhone13,2"
com.google.chrome.ios,62,1737996630,1737996692,1737996692.640933,-21600,EB445137-D7F5-57EC-87DA-1DB460D64046,"iPhone13,2"
com.toyopagroup.picaboo,30,1737996082,1737996112,1737996112.79158,-21600,EB445137-D7F5-57EC-87DA-1DB460D64046,"iPhone13,2"
com.google.Chrome,36,1737994047,1737994083,1737994084.139168,-21600,,
com.apple.finder,51,1737993996,1737994047,1737994047.4220018,-21600,,
com.google.Chrome,44,1737993952,1737993996,1737993996.686339,-21600,,
com.apple.finder,40,1737993912,1737993952,1737993952.78658,-21600,,
com.google.Chrome,22,1737993890,1737993912,1737993912.045772,-21600,,
com.leomehlig.today,26,1737993837,1737993863,1737993863.347347,-21600,,
com.google.Chrome,244,1737993593,1737993837,1737993837.204239,-21600,,
com.google.chrome.ios,14,1737993402,1737993416,1737993416.32761,-21600,EB445137-D7F5-57EC-87DA-1DB460D64046,"iPhone13,2"
com.google.Gmail,19,1737993383,1737993402,1737993402.96693,-21600,EB445137-D7F5-57EC-87DA-1DB460D64046,"iPhone13,2"
com.amazon.Amazon,30,1737993351,1737993381,1737993381.403853,-21600,EB445137-D7F5-57EC-87DA-1DB460D64046,"iPhone13,2"
com.google.Gmail,8,1737993338,1737993346,1737993346.175939,-21600,EB445137-D7F5-57EC-87DA-1DB460D64046,"iPhone13,2"
com.google.Gmail,32,1737992233,1737992265,1737992265.128355,-21600,EB445137-D7F5-57EC-87DA-1DB460D64046,"iPhone13,2"
com.truebill.truebillnative,3,1737992229,1737992232,1737992232.846909,-21600,EB445137-D7F5-57EC-87DA-1DB460D64046,"iPhone13,2"
com.google.Chrome,444,1737992191,1737992635,1737992635.2588181,-21600,,
com.apple.CoreAuthUI,7,1737992108,1737992115,1737992115.64746,-21600,EB445137-D7F5-57EC-87DA-1DB460D64046,"iPhone13,2"
com.truebill.truebillnative,71,1737992105,1737992176,1737992176.588252,-21600,EB445137-D7F5-57EC-87DA-1DB460D64046,"iPhone13,2"
com.strava.stravaride,29,1737992070,1737992099,1737992099.544832,-21600,EB445137-D7F5-57EC-87DA-1DB460D64046,"iPhone13,2"
com.apple.iCal,35,1737991973,1737992008,1737992008.288484,-21600,,
com.google.Chrome,53,1737991920,1737991973,1737991973.745589,-21600,,
com.leomehlig.today,75,1737991845,1737991920,1737991920.783441,-21600,,
com.apple.Notes,6,1737991839,1737991845,1737991845.973184,-21600,,
com.leomehlig.today,1,1737991838,1737991839,1737991839.66025,-21600,,
com.apple.Notes,4,1737991834,1737991838,1737991838.854301,-21600,,
com.leomehlig.today,36,1737991798,1737991834,1737991834.445644,-21600,,
com.apple.Notes,112,1737991686,1737991798,1737991798.245898,-21600,,
com.google.Chrome,87,1737991599,1737991686,1737991686.5273519,-21600,,
com.google.Chrome,126,1737990499,1737990625,1737990625.85215,-21600,,
com.google.Chrome,78,1737990414,1737990492,1737990493.002404,-21600,,
com.apple.Notes,6,1737990408,1737990414,1737990414.972404,-21600,,
com.apple.Maps,42,1737989703,1737989745,1737989745.637871,-21600,EB445137-D7F5-57EC-87DA-1DB460D64046,"iPhone13,2"
com.google.Chrome,736,1737989672,1737990408,1737990408.7343469,-21600,,
com.apple.Health,18,1737989314,1737989332,1737989332.838661,-21600,EB445137-D7F5-57EC-87DA-1DB460D64046,"iPhone13,2"
com.apple.MobileSMS,6,1737989302,1737989308,1737989308.870174,-21600,EB445137-D7F5-57EC-87DA-1DB460D64046,"iPhone13,2"
com.renpho.health,0,1737989302,1737989302,1737989302.9871001,-21600,EB445137-D7F5-57EC-87DA-1DB460D64046,"iPhone13,2"
com.renpho.health,43,1737988620,1737988663,1737988663.7290401,-21600,EB445137-D7F5-57EC-87DA-1DB460D64046,"iPhone13,2"
com.apple.weather,39,1737956619,1737956658,1737956658.8335671,-21600,EB445137-D7F5-57EC-87DA-1DB460D64046,"iPhone13,2"
com.thestorygraph.thestorygraph,37,1737956543,1737956580,1737956580.6447701,-21600,EB445137-D7F5-57EC-87DA-1DB460D64046,"iPhone13,2"
com.myfitnesspal.mfp,77,1737955378,1737955455,1737955455.8552752,-21600,EB445137-D7F5-57EC-87DA-1DB460D64046,"iPhone13,2"
com.apple.Music,1,1737955372,1737955373,1737955373.7778149,-21600,EB445137-D7F5-57EC-87DA-1DB460D64046,"iPhone13,2"
com.google.Chrome,3,1737955225,1737955228,1737955229.1838322,-21600,,
com.google.Chrome,616,1737954264,1737954880,1737954880.877425,-21600,,
com.apple.Music,19,1737953320,1737953339,1737953339.7139049,-21600,EB445137-D7F5-57EC-87DA-1DB460D64046,"iPhone13,2"
com.apple.Health,40,1737953062,1737953102,1737953102.807847,-21600,EB445137-D7F5-57EC-87DA-1DB460D64046,"iPhone13,2"
com.apple.reminders,5,1737953048,1737953053,1737953053.318856,-21600,EB445137-D7F5-57EC-87DA-1DB460D64046,"iPhone13,2"
com.microsoft.Office.Outlook,45,1737952945,1737952990,1737952990.129681,-21600,EB445137-D7F5-57EC-87DA-1DB460D64046,"iPhone13,2"
com.apple.MobileSMS,1,1737952944,1737952945,1737952945.69387,-21600,EB445137-D7F5-57EC-87DA-1DB460D64046,"iPhone13,2"
com.google.Chrome,8,1737952772,1737952780,1737952781.0348701,-21600,,
com.apple.MobileSMS,6,1737947175,1737947181,1737947182.1336222,-21600,EB445137-D7F5-57EC-87DA-1DB460D64046,"iPhone13,2"
com.apple.MobileSMS,4,1737947171,1737947175,1737947175.913929,-21600,EB445137-D7F5-57EC-87DA-1DB460D64046,"iPhone13,2"
com.google.Chrome,311,1737946753,1737947064,1737947064.230885,-21600,,
com.google.Chrome,130,1737946618,1737946748,1737946748.68807,-21600,,
com.leomehlig.today,0,1737946611,1737946611,1737946612.1557689,-21600,,
com.apple.Notes,2,1737946609,1737946611,1737946611.3065372,-21600,,
com.apple.MobileSMS,2,1737946598,1737946600,1737946601.026338,-21600,EB445137-D7F5-57EC-87DA-1DB460D64046,"iPhone13,2"
com.apple.MobileSMS,3,1737946548,1737946551,1737946551.400478,-21600,EB445137-D7F5-57EC-87DA-1DB460D64046,"iPhone13,2"
com.apple.MobileSMS,61,1737946438,1737946499,1737946499.14382,-21600,EB445137-D7F5-57EC-87DA-1DB460D64046,"iPhone13,2"
com.apple.MobileSMS,51,1737946352,1737946403,1737946403.260542,-21600,EB445137-D7F5-57EC-87DA-1DB460D64046,"iPhone13,2"
com.apple.MobileSMS,56,1737946296,1737946352,1737946352.771095,-21600,EB445137-D7F5-57EC-87DA-1DB460D64046,"iPhone13,2"
com.amazon.Amazon,2,1737946294,1737946296,1737946296.652297,-21600,EB445137-D7F5-57EC-87DA-1DB460D64046,"iPhone13,2"
com.apple.Notes,5,1737946173,1737946178,1737946179.08023,-21600,,
com.google.Chrome,6,1737946167,1737946173,1737946173.663392,-21600,,
com.apple.Notes,1,1737946166,1737946167,1737946168.6300678,-21600,,
com.apple.Notes,304,1737945684,1737945988,1737945988.21824,-21600,,
com.amazon.Amazon,55,1737945592,1737945647,1737945647.855818,-21600,EB445137-D7F5-57EC-87DA-1DB460D64046,"iPhone13,2"
com.apple.mobilenotes,3,1737945588,1737945591,1737945591.315269,-21600,EB445137-D7F5-57EC-87DA-1DB460D64046,"iPhone13,2"
com.google.Chrome,226,1737945458,1737945684,1737945684.84025,-21600,,
com.apple.Notes,8,1737945425,1737945433,1737945433.641663,-21600,,
com.leomehlig.today,1,1737945424,1737945425,1737945425.539501,-21600,,
com.google.Chrome,44,1737945380,1737945424,1737945424.206569,-21600,,
com.apple.Notes,3,1737945377,1737945380,1737945380.137673,-21600,,
com.google.Chrome,4,1737945373,1737945377,1737945377.2585568,-21600,,
com.apple.Notes,6,1737945367,1737945373,1737945373.750591,-21600,,
com.google.Chrome,3,1737945364,1737945367,1737945367.081503,-21600,,
com.apple.Notes,1,1737945363,1737945364,1737945364.40852,-21600,,
com.google.Chrome,40,1737945323,1737945363,1737945363.362811,-21600,,
com.apple.Notes,176,1737945147,1737945323,1737945324.691289,-21600,,
com.leomehlig.today,493,1737944654,1737945147,1737945147.081588,-21600,,
com.apple.Notes,2,1737944652,1737944654,1737944654.093678,-21600,,
com.google.Chrome,85,1737944567,1737944652,1737944652.529684,-21600,,
com.leomehlig.today,40,1737944527,1737944567,1737944568.0584521,-21600,,
com.google.Chrome,56,1737944471,1737944527,1737944527.595334,-21600,,
com.apple.Notes,1,1737944470,1737944471,1737944471.624943,-21600,,
com.google.Chrome,2,1737944468,1737944470,1737944470.9648461,-21600,,
com.apple.Notes,8,1737944446,1737944454,1737944454.453511,-21600,,
com.apple.finder,2,1737944444,1737944446,1737944446.445185,-21600,,
com.apple.Preview,1021,1737943423,1737944444,1737944444.416346,-21600,,
com.google.Chrome,26,1737943397,1737943423,1737943423.8515692,-21600,,
com.apple.Preview,1,1737943396,1737943397,1737943397.720886,-21600,,
com.apple.mobilenotes,16,1737943325,1737943341,1737943341.8321528,-21600,EB445137-D7F5-57EC-87DA-1DB460D64046,"iPhone13,2"
com.myfitnesspal.mfp,180,1737943141,1737943321,1737943321.367807,-21600,EB445137-D7F5-57EC-87DA-1DB460D64046,"iPhone13,2"
com.google.chrome.ios,28,1737943107,1737943135,1737943135.839627,-21600,EB445137-D7F5-57EC-87DA-1DB460D64046,"iPhone13,2"
com.myfitnesspal.mfp,44,1737943063,1737943107,1737943107.825779,-21600,EB445137-D7F5-57EC-87DA-1DB460D64046,"iPhone13,2"
com.google.chrome.ios,3,1737943060,1737943063,1737943064.194087,-21600,EB445137-D7F5-57EC-87DA-1DB460D64046,"iPhone13,2"
com.apple.MobileSMS,3,1737943057,1737943060,1737943060.9211159,-21600,EB445137-D7F5-57EC-87DA-1DB460D64046,"iPhone13,2"
com.myfitnesspal.mfp,9,1737943048,1737943057,1737943057.669661,-21600,EB445137-D7F5-57EC-87DA-1DB460D64046,"iPhone13,2"
com.apple.Preview,300,1737943000,1737943300,1737943300.580069,-21600,,
com.apple.finder,7,1737942993,1737943000,1737943000.830522,-21600,,
com.google.Chrome,3,1737942990,1737942993,1737942993.2705321,-21600,,
com.apple.Notes,25,1737942965,1737942990,1737942990.088255,-21600,,
com.google.Chrome,2030,1737940935,1737942965,1737942965.852164,-21600,,
com.apple.Notes,2,1737940933,1737940935,1737940937.00777,-21600,,
com.leomehlig.today,10,1737940923,1737940933,1737940933.991657,-21600,,
com.google.Chrome,1,1737940922,1737940923,1737940924.029101,-21600,,
com.apple.Notes,2,1737940920,1737940922,1737940922.350271,-21600,,
com.apple.Notes,315,1737939232,1737939547,1737939547.502887,-21600,,
com.google.Chrome,16,1737939216,1737939232,1737939232.928196,-21600,,
com.google.chrome.ios,16,1737937731,1737937747,1737937748.264275,-21600,EB445137-D7F5-57EC-87DA-1DB460D64046,"iPhone13,2"
com.google.chrome.ios,7,1737937636,1737937643,1737937645.511596,-21600,EB445137-D7F5-57EC-87DA-1DB460D64046,"iPhone13,2"
com.google.chrome.ios,2,1737937633,1737937635,1737937636.080751,-21600,EB445137-D7F5-57EC-87DA-1DB460D64046,"iPhone13,2"
com.google.chrome.ios,14,1737937193,1737937207,1737937208.272637,-21600,EB445137-D7F5-57EC-87DA-1DB460D64046,"iPhone13,2"
com.myfitnesspal.mfp,5,1737937188,1737937193,1737937193.671313,-21600,EB445137-D7F5-57EC-87DA-1DB460D64046,"iPhone13,2"
com.google.Chrome,301,1737937179,1737937480,1737937480.2955,-21600,,
com.apple.Notes,4,1737937175,1737937179,1737937179.449839,-21600,,
com.leomehlig.today,35,1737937140,1737937175,1737937175.5144448,-21600,,
com.microsoft.VSCode,2,1737937138,1737937140,1737937140.5940619,-21600,,
com.google.Chrome,67,1737937071,1737937138,1737937138.07893,-21600,,
com.microsoft.VSCode,2,1737937069,1737937071,1737937071.556793,-21600,,
com.google.Chrome,1,1737937068,1737937069,1737937069.3699489,-21600,,
com.microsoft.VSCode,16,1737937052,1737937068,1737937068.512265,-21600,,
com.google.Chrome,9,1737937043,1737937052,1737937052.39816,-21600,,
com.microsoft.VSCode,1,1737937042,1737937043,1737937043.348792,-21600,,
com.google.Chrome,2,1737937040,1737937042,1737937042.1669378,-21600,,
com.microsoft.VSCode,28,1737937012,1737937040,1737937041.00016,-21600,,
com.google.Chrome,67,1737936945,1737937012,1737937012.846613,-21600,,
com.google.Chrome,665,1737936223,1737936888,1737936888.063933,-21600,,
com.leomehlig.today,39,1737936184,1737936223,1737936223.904737,-21600,,
com.apple.Notes,2,1737936182,1737936184,1737936184.336448,-21600,,
com.myfitnesspal.mfp,62,1737936112,1737936174,1737936176.408699,-21600,EB445137-D7F5-57EC-87DA-1DB460D64046,"iPhone13,2"
com.apple.mobileslideshow,1,1737936111,1737936112,1737936112.95578,-21600,EB445137-D7F5-57EC-87DA-1DB460D64046,"iPhone13,2"
com.myfitnesspal.mfp,17,1737936094,1737936111,1737936111.2256389,-21600,EB445137-D7F5-57EC-87DA-1DB460D64046,"iPhone13,2"
com.apple.mobileslideshow,6,1737936088,1737936094,1737936094.0783172,-21600,EB445137-D7F5-57EC-87DA-1DB460D64046,"iPhone13,2"
com.myfitnesspal.mfp,7,1737936081,1737936088,1737936088.8392448,-21600,EB445137-D7F5-57EC-87DA-1DB460D64046,"iPhone13,2"
com.apple.mobileslideshow,2,1737936079,1737936081,1737936081.910533,-21600,EB445137-D7F5-57EC-87DA-1DB460D64046,"iPhone13,2"
com.myfitnesspal.mfp,12,1737936067,1737936079,1737936080.0148969,-21600,EB445137-D7F5-57EC-87DA-1DB460D64046,"iPhone13,2"
com.apple.mobileslideshow,5,1737936062,1737936067,1737936067.883173,-21600,EB445137-D7F5-57EC-87DA-1DB460D64046,"iPhone13,2"
com.myfitnesspal.mfp,18,1737936044,1737936062,1737936063.152211,-21600,EB445137-D7F5-57EC-87DA-1DB460D64046,"iPhone13,2"
com.apple.mobileslideshow,2,1737936042,1737936044,1737936044.793515,-21600,EB445137-D7F5-57EC-87DA-1DB460D64046,"iPhone13,2"
com.myfitnesspal.mfp,8,1737936034,1737936042,1737936043.027175,-21600,EB445137-D7F5-57EC-87DA-1DB460D64046,"iPhone13,2"
com.apple.mobileslideshow,2,1737936032,1737936034,1737936034.973995,-21600,EB445137-D7F5-57EC-87DA-1DB460D64046,"iPhone13,2"
com.myfitnesspal.mfp,12,1737936020,1737936032,1737936032.287943,-21600,EB445137-D7F5-57EC-87DA-1DB460D64046,"iPhone13,2"
com.apple.mobileslideshow,11,1737936009,1737936020,1737936021.1270142,-21600,EB445137-D7F5-57EC-87DA-1DB460D64046,"iPhone13,2"
com.myfitnesspal.mfp,198,1737935811,1737936009,1737936009.364389,-21600,EB445137-D7F5-57EC-87DA-1DB460D64046,"iPhone13,2"
com.google.chrome.ios,12,1737935799,1737935811,1737935811.3490682,-21600,EB445137-D7F5-57EC-87DA-1DB460D64046,"iPhone13,2"
com.myfitnesspal.mfp,50,1737935749,1737935799,1737935799.969574,-21600,EB445137-D7F5-57EC-87DA-1DB460D64046,"iPhone13,2"
com.google.chrome.ios,7,1737935742,1737935749,1737935749.8012362,-21600,EB445137-D7F5-57EC-87DA-1DB460D64046,"iPhone13,2"
com.myfitnesspal.mfp,10,1737935732,1737935742,1737935742.701844,-21600,EB445137-D7F5-57EC-87DA-1DB460D64046,"iPhone13,2"
com.google.chrome.ios,1,1737935731,1737935732,1737935732.61695,-21600,EB445137-D7F5-57EC-87DA-1DB460D64046,"iPhone13,2"
com.myfitnesspal.mfp,15,1737935716,1737935731,1737935731.340379,-21600,EB445137-D7F5-57EC-87DA-1DB460D64046,"iPhone13,2"
com.google.chrome.ios,7,1737935709,1737935716,1737935716.545981,-21600,EB445137-D7F5-57EC-87DA-1DB460D64046,"iPhone13,2"
com.myfitnesspal.mfp,18,1737935691,1737935709,1737935709.836574,-21600,EB445137-D7F5-57EC-87DA-1DB460D64046,"iPhone13,2"
com.google.chrome.ios,3,1737935688,1737935691,1737935691.7780252,-21600,EB445137-D7F5-57EC-87DA-1DB460D64046,"iPhone13,2"
com.myfitnesspal.mfp,27,1737935661,1737935688,1737935688.8463202,-21600,EB445137-D7F5-57EC-87DA-1DB460D64046,"iPhone13,2"
com.google.chrome.ios,5,1737935656,1737935661,1737935662.074472,-21600,EB445137-D7F5-57EC-87DA-1DB460D64046,"iPhone13,2"
com.myfitnesspal.mfp,128,1737935528,1737935656,1737935656.208555,-21600,EB445137-D7F5-57EC-87DA-1DB460D64046,"iPhone13,2"
com.apple.CoreAuthUI,1,1737935495,1737935496,1737935496.969985,-21600,EB445137-D7F5-57EC-87DA-1DB460D64046,"iPhone13,2"
com.clairmail.fth.client,32,1737935491,1737935523,1737935523.764245,-21600,EB445137-D7F5-57EC-87DA-1DB460D64046,"iPhone13,2"
com.apple.mobiletimer,3,1737935482,1737935485,1737935485.090857,-21600,EB445137-D7F5-57EC-87DA-1DB460D64046,"iPhone13,2"
com.apple.mobiletimer,8,1737935213,1737935221,1737935221.2717252,-21600,EB445137-D7F5-57EC-87DA-1DB460D64046,"iPhone13,2"
com.google.chrome.ios,3,1737935207,1737935210,1737935210.41987,-21600,EB445137-D7F5-57EC-87DA-1DB460D64046,"iPhone13,2"
com.google.chrome.ios,7,1737935037,1737935044,1737935044.581105,-21600,EB445137-D7F5-57EC-87DA-1DB460D64046,"iPhone13,2"
com.google.chrome.ios,40,1737934997,1737935037,1737935037.8674688,-21600,EB445137-D7F5-57EC-87DA-1DB460D64046,"iPhone13,2"
com.google.chrome.ios,116,1737934548,1737934664,1737934665.8952641,-21600,EB445137-D7F5-57EC-87DA-1DB460D64046,"iPhone13,2"
com.google.chrome.ios,119,1737934356,1737934475,1737934477.299475,-21600,EB445137-D7F5-57EC-87DA-1DB460D64046,"iPhone13,2"
com.google.chrome.ios,126,1737934201,1737934327,1737934327.8914142,-21600,EB445137-D7F5-57EC-87DA-1DB460D64046,"iPhone13,2"
com.google.chrome.ios,425,1737933700,1737934125,1737934126.557481,-21600,EB445137-D7F5-57EC-87DA-1DB460D64046,"iPhone13,2"
com.google.chrome.ios,103,1737933117,1737933220,1737933223.747792,-21600,EB445137-D7F5-57EC-87DA-1DB460D64046,"iPhone13,2"
com.google.chrome.ios,65,1737933020,1737933085,1737933087.494827,-21600,EB445137-D7F5-57EC-87DA-1DB460D64046,"iPhone13,2"
com.google.chrome.ios,265,1737932754,1737933019,1737933021.707193,-21600,EB445137-D7F5-57EC-87DA-1DB460D64046,"iPhone13,2"
com.google.chrome.ios,64,1737932511,1737932575,1737932575.706452,-21600,EB445137-D7F5-57EC-87DA-1DB460D64046,"iPhone13,2"
com.google.chrome.ios,61,1737932383,1737932444,1737932444.836849,-21600,EB445137-D7F5-57EC-87DA-1DB460D64046,"iPhone13,2"
com.google.chrome.ios,489,1737931855,1737932344,1737932344.2849789,-21600,EB445137-D7F5-57EC-87DA-1DB460D64046,"iPhone13,2"
com.apple.news,1,1737931854,1737931855,1737931855.695719,-21600,EB445137-D7F5-57EC-87DA-1DB460D64046,"iPhone13,2"
com.apple.news,40,1737931373,1737931413,1737931414.564312,-21600,EB445137-D7F5-57EC-87DA-1DB460D64046,"iPhone13,2"
com.apple.Music,25,1737931348,1737931373,1737931373.425565,-21600,EB445137-D7F5-57EC-87DA-1DB460D64046,"iPhone13,2"
com.apple.news,357,1737930991,1737931348,1737931348.633282,-21600,EB445137-D7F5-57EC-87DA-1DB460D64046,"iPhone13,2"
com.apple.Music,2,1737930985,1737930987,1737930988.108793,-21600,EB445137-D7F5-57EC-87DA-1DB460D64046,"iPhone13,2"
com.apple.Music,4,1737930504,1737930508,1737930510.252016,-21600,EB445137-D7F5-57EC-87DA-1DB460D64046,"iPhone13,2"
com.google.chrome.ios,0,1737930504,1737930504,1737930505.390154,-21600,EB445137-D7F5-57EC-87DA-1DB460D64046,"iPhone13,2"
com.google.chrome.ios,14,1737930211,1737930225,1737930225.5429,-21600,EB445137-D7F5-57EC-87DA-1DB460D64046,"iPhone13,2"
com.apple.Music,1,1737930209,1737930210,1737930210.6004791,-21600,EB445137-D7F5-57EC-87DA-1DB460D64046,"iPhone13,2"
com.apple.Music,7,1737929817,1737929824,1737929824.170776,-21600,EB445137-D7F5-57EC-87DA-1DB460D64046,"iPhone13,2"
com.apple.news,2,1737929815,1737929817,1737929818.092413,-21600,EB445137-D7F5-57EC-87DA-1DB460D64046,"iPhone13,2"
com.apple.news,34,1737929702,1737929736,1737929737.180911,-21600,EB445137-D7F5-57EC-87DA-1DB460D64046,"iPhone13,2"
com.apple.Music,14,1737929688,1737929702,1737929703.122849,-21600,EB445137-D7F5-57EC-87DA-1DB460D64046,"iPhone13,2"
com.apple.news,84,1737929604,1737929688,1737929688.325362,-21600,EB445137-D7F5-57EC-87DA-1DB460D64046,"iPhone13,2"
com.apple.Music,38,1737929565,1737929603,1737929603.7982202,-21600,EB445137-D7F5-57EC-87DA-1DB460D64046,"iPhone13,2"
com.hammerandchisel.discord,3,1737929554,1737929557,1737929557.088005,-21600,EB445137-D7F5-57EC-87DA-1DB460D64046,"iPhone13,2"
com.hammerandchisel.discord,5,1737929084,1737929089,1737929089.5236359,-21600,EB445137-D7F5-57EC-87DA-1DB460D64046,"iPhone13,2"
com.discoverfinancial.mobile,4,1737929072,1737929076,1737929077.55448,-21600,EB445137-D7F5-57EC-87DA-1DB460D64046,"iPhone13,2"
com.apple.Notes,20,1737928809,1737928829,1737928829.461875,-21600,,
com.google.Chrome,589,1737928220,1737928809,1737928809.787108,-21600,,
com.google.Chrome,1071,1737927115,1737928186,1737928186.797299,-21600,,
com.google.Chrome,300,1737926760,1737927060,1737927060.365758,-21600,,
com.google.Chrome,1220,1737925519,1737926739,1737926739.3264089,-21600,,
com.apple.Notes,2,1737925517,1737925519,1737925520.290412,-21600,,
com.leomehlig.today,298,1737925219,1737925517,1737925517.51034,-21600,,
com.apple.Notes,5,1737925214,1737925219,1737925219.838583,-21600,,
com.leomehlig.today,11,1737925203,1737925214,1737925214.682308,-21600,,
com.apple.Notes,6,1737925197,1737925203,1737925203.334521,-21600,,
com.leomehlig.today,6,1737925191,1737925197,1737925197.674994,-21600,,
com.apple.Notes,29,1737925162,1737925191,1737925191.9260159,-21600,,
com.leomehlig.today,28,1737925134,1737925162,1737925162.332137,-21600,,
com.apple.Notes,16,1737925118,1737925134,1737925134.125338,-21600,,
com.apple.finder,10,1737925108,1737925118,1737925118.9404922,-21600,,
com.leomehlig.today,134,1737924974,1737925108,1737925108.965042,-21600,,
com.microsoft.Outlook,1,1737924973,1737924974,1737924974.5276031,-21600,,
com.leomehlig.today,4,1737924969,1737924973,1737924973.2252312,-21600,,
com.microsoft.VSCode,2,1737924967,1737924969,1737924969.2313929,-21600,,
com.leomehlig.today,1,1737924966,1737924967,1737924967.262697,-21600,,
com.apple.iCal,2,1737924964,1737924966,1737924966.041894,-21600,,
com.google.Chrome,18,1737924946,1737924964,1737924964.769882,-21600,,
com.leomehlig.today,6,1737924940,1737924946,1737924946.827971,-21600,,
com.google.Chrome,185,1737924755,1737924940,1737924940.9701881,-21600,,
com.apple.MobileSMS,3,1737924752,1737924755,1737924755.271906,-21600,,
com.google.Chrome,1,1737924751,1737924752,1737924752.400212,-21600,,
com.leomehlig.today,1,1737924750,1737924751,1737924751.441356,-21600,,
com.google.Chrome,11,1737924739,1737924750,1737924751.030721,-21600,,
com.apple.MobileSMS,60,1737924679,1737924739,1737924739.915296,-21600,,
com.google.Chrome,2,1737924677,1737924679,1737924679.3825622,-21600,,
com.apple.MobileSMS,19,1737924658,1737924677,1737924677.758512,-21600,,
com.google.Chrome,900,1737923758,1737924658,1737924658.451908,-21600,,
com.leomehlig.today,7,1737923751,1737923758,1737923759.0284529,-21600,,
com.google.Chrome,18,1737923733,1737923751,1737923751.7007399,-21600,,
com.leomehlig.today,35,1737923698,1737923733,1737923733.607373,-21600,,
com.google.Chrome,1,1737923697,1737923698,1737923698.66778,-21600,,
com.apple.iCal,7,1737923690,1737923697,1737923697.7062201,-21600,,
com.google.Chrome,11,1737923679,1737923690,1737923690.241146,-21600,,
com.leomehlig.today,21,1737923658,1737923679,1737923679.9489598,-21600,,
com.microsoft.VSCode,81,1737923577,1737923658,1737923658.6224089,-21600,,
com.google.Chrome,115,1737923462,1737923577,1737923577.339212,-21600,,
com.microsoft.VSCode,7,1737923455,1737923462,1737923462.5735211,-21600,,
com.google.Chrome,30,1737923425,1737923455,1737923455.47103,-21600,,
com.microsoft.VSCode,4,1737923421,1737923425,1737923425.726372,-21600,,
com.google.Chrome,2,1737923419,1737923421,1737923421.407971,-21600,,
com.microsoft.VSCode,3,1737923416,1737923419,1737923419.851965,-21600,,
com.google.Chrome,2,1737923414,1737923416,1737923416.976231,-21600,,
com.microsoft.VSCode,2,1737923412,1737923414,1737923414.8803282,-21600,,
com.google.Chrome,2,1737923410,1737923412,1737923412.2978292,-21600,,
com.microsoft.VSCode,1,1737923409,1737923410,1737923410.76299,-21600,,
com.google.Chrome,2,1737923407,1737923409,1737923409.3727999,-21600,,
com.microsoft.VSCode,2,1737923405,1737923407,1737923407.313923,-21600,,
com.google.Chrome,1,1737923404,1737923405,1737923406.0464292,-21600,,
com.microsoft.VSCode,19,1737923385,1737923404,1737923404.77192,-21600,,
com.google.Chrome,1,1737923384,1737923385,1737923385.73835,-21600,,
com.microsoft.VSCode,27,1737923357,1737923384,1737923384.592027,-21600,,
com.google.Chrome,2,1737923355,1737923357,1737923357.0693002,-21600,,
com.microsoft.VSCode,36,1737923319,1737923355,1737923355.57613,-21600,,
com.google.Chrome,13,1737923306,1737923319,1737923319.600913,-21600,,
com.microsoft.VSCode,3,1737923303,1737923306,1737923306.725719,-21600,,
com.apple.finder,1,1737923302,1737923303,1737923303.558083,-21600,,
com.google.Chrome,7,1737923295,1737923302,1737923302.79222,-21600,,
com.apple.finder,1,1737923294,1737923295,1737923295.907126,-21600,,
com.microsoft.VSCode,17,1737923277,1737923294,1737923294.2130442,-21600,,
com.apple.finder,1,1737923276,1737923277,1737923277.144115,-21600,,
com.microsoft.VSCode,13,1737923263,1737923276,1737923276.079369,-21600,,
com.apple.finder,10,1737923253,1737923263,1737923263.300672,-21600,,
com.microsoft.VSCode,6,1737923247,1737923253,1737923253.078368,-21600,,
com.google.Chrome,20,1737923227,1737923247,1737923247.6124449,-21600,,
com.microsoft.VSCode,22,1737923205,1737923227,1737923227.62346,-21600,,
com.google.Chrome,14,1737923191,1737923205,1737923205.483125,-21600,,
com.microsoft.VSCode,4,1737923187,1737923191,1737923191.24542,-21600,,
com.google.Chrome,3,1737923184,1737923187,1737923187.353619,-21600,,
com.microsoft.VSCode,1,1737923183,1737923184,1737923184.661089,-21600,,
com.google.Chrome,2,1737923181,1737923183,1737923183.893759,-21600,,
com.microsoft.VSCode,14,1737923167,1737923181,1737923181.9957619,-21600,,
com.google.Chrome,5,1737923162,1737923167,1737923167.534482,-21600,,
com.microsoft.VSCode,1,1737923161,1737923162,1737923163.039556,-21600,,
com.google.Chrome,23,1737923138,1737923161,1737923161.4207501,-21600,,
com.microsoft.VSCode,15,1737923123,1737923138,1737923138.797783,-21600,,
com.google.Chrome,5,1737923118,1737923123,1737923123.145697,-21600,,
com.microsoft.VSCode,21,1737923097,1737923118,1737923118.4615378,-21600,,
com.google.Chrome,5,1737923092,1737923097,1737923097.5299459,-21600,,
com.microsoft.VSCode,9,1737923083,1737923092,1737923092.880426,-21600,,
com.google.Chrome,1,1737923082,1737923083,1737923083.832237,-21600,,
com.microsoft.VSCode,25,1737923057,1737923082,1737923082.3134398,-21600,,
com.google.Chrome,1,1737923056,1737923057,1737923057.5184069,-21600,,
com.microsoft.VSCode,27,1737923029,1737923056,1737923056.418757,-21600,,
com.google.Chrome,723,1737922306,1737923029,1737923029.244668,-21600,,
com.leomehlig.today,19,1737922287,1737922306,1737922306.945218,-21600,,
com.google.Chrome,911,1737921376,1737922287,1737922287.12621,-21600,,
com.google.Chrome,329,1737920794,1737921123,1737921123.679091,-21600,,
com.leomehlig.today,10,1737920747,1737920757,1737920757.688239,-21600,,
com.google.Chrome,227,1737920520,1737920747,1737920747.393105,-21600,,
com.leomehlig.today,26,1737920494,1737920520,1737920520.377228,-21600,,
com.google.Chrome,462,1737920032,1737920494,1737920494.441823,-21600,,
com.microsoft.Outlook,5,1737920027,1737920032,1737920032.386579,-21600,,
com.google.Chrome,13,1737920014,1737920027,1737920027.710628,-21600,,
com.microsoft.Outlook,9,1737920005,1737920014,1737920014.864026,-21600,,
com.google.Chrome,116,1737919889,1737920005,1737920005.7465239,-21600,,
com.microsoft.Outlook,99,1737919768,1737919867,1737919867.086423,-21600,,
com.google.Chrome,4,1737919764,1737919768,1737919768.6169062,-21600,,
com.microsoft.Outlook,0,1737919764,1737919764,1737919764.755608,-21600,,
com.google.Chrome,6,1737919758,1737919764,1737919764.4627051,-21600,,
com.leomehlig.today,50,1737919708,1737919758,1737919759.028254,-21600,,
com.apple.finder,3,1737919705,1737919708,1737919708.411073,-21600,,
com.apple.iWork.Numbers,3,1737919702,1737919705,1737919705.118269,-21600,,
com.google.Chrome,4,1737919698,1737919702,1737919702.498962,-21600,,
com.apple.Music,1,1737918253,1737918254,1737918254.802969,-21600,EB445137-D7F5-57EC-87DA-1DB460D64046,"iPhone13,2"
com.apple.Music,18,1737915562,1737915580,1737915580.495918,-21600,EB445137-D7F5-57EC-87DA-1DB460D64046,"iPhone13,2"
com.google.Chrome,1,1737914206,1737914207,1737914207.5870461,-21600,,
com.google.chrome.ios,24,1737912898,1737912922,1737912923.356055,-21600,EB445137-D7F5-57EC-87DA-1DB460D64046,"iPhone13,2"
com.myfitnesspal.mfp,74,1737912824,1737912898,1737912898.3291268,-21600,EB445137-D7F5-57EC-87DA-1DB460D64046,"iPhone13,2"
com.apple.calculator,11,1737912813,1737912824,1737912824.680502,-21600,EB445137-D7F5-57EC-87DA-1DB460D64046,"iPhone13,2"
com.myfitnesspal.mfp,57,1737912756,1737912813,1737912813.5909061,-21600,EB445137-D7F5-57EC-87DA-1DB460D64046,"iPhone13,2"
com.myfitnesspal.mfp,0,1737912754,1737912754,1737912755.005147,-21600,EB445137-D7F5-57EC-87DA-1DB460D64046,"iPhone13,2"
com.google.Chrome,343,1737912319,1737912662,1737912662.463907,-21600,,
com.google.Chrome,197,1737911594,1737911791,1737911791.296932,-21600,,
com.myfitnesspal.mfp,372,1737911569,1737911941,1737911942.2405329,-21600,EB445137-D7F5-57EC-87DA-1DB460D64046,"iPhone13,2"
com.apple.mobiletimer,2,1737911567,1737911569,1737911569.755516,-21600,EB445137-D7F5-57EC-87DA-1DB460D64046,"iPhone13,2"
com.apple.iWork.Numbers,11,1737911215,1737911226,1737911226.598185,-21600,,
com.google.Chrome,13,1737911202,1737911215,1737911215.50698,-21600,,
com.apple.iWork.Numbers,16,1737911186,1737911202,1737911202.0960588,-21600,,
com.google.Chrome,2,1737911184,1737911186,1737911186.992756,-21600,,
com.apple.iWork.Numbers,2,1737911182,1737911184,1737911185.0119538,-21600,,
com.google.Chrome,25,1737911157,1737911182,1737911182.173483,-21600,,
com.apple.iWork.Numbers,22,1737911135,1737911157,1737911157.602086,-21600,,
com.google.Chrome,29,1737911106,1737911135,1737911135.4364161,-21600,,
com.apple.iWork.Numbers,19,1737911087,1737911106,1737911106.233053,-21600,,
com.google.Chrome,4,1737911083,1737911087,1737911087.911598,-21600,,
com.apple.finder,1,1737911082,1737911083,1737911083.330728,-21600,,
com.apple.iWork.Numbers,22,1737911060,1737911082,1737911082.4480991,-21600,,
com.apple.finder,27,1737911033,1737911060,1737911060.6994781,-21600,,
com.google.Chrome,70,1737910963,1737911033,1737911033.487284,-21600,,
com.apple.iWork.Numbers,50,1737910826,1737910876,1737910876.066025,-21600,,
com.google.Chrome,18,1737910808,1737910826,1737910826.115965,-21600,,
com.leomehlig.today,7,1737910801,1737910808,1737910808.670887,-21600,,
com.apple.mobiletimer,36,1737910251,1737910287,1737910287.8681269,-21600,EB445137-D7F5-57EC-87DA-1DB460D64046,"iPhone13,2"
com.myfitnesspal.mfp,527,1737908949,1737909476,1737909476.671424,-21600,EB445137-D7F5-57EC-87DA-1DB460D64046,"iPhone13,2"
com.apple.news,2,1737908947,1737908949,1737908949.316221,-21600,EB445137-D7F5-57EC-87DA-1DB460D64046,"iPhone13,2"
com.apple.news,132,1737908191,1737908323,1737908324.034334,-21600,EB445137-D7F5-57EC-87DA-1DB460D64046,"iPhone13,2"
com.apple.news,21,1737907221,1737907242,1737907242.7860641,-21600,EB445137-D7F5-57EC-87DA-1DB460D64046,"iPhone13,2"
com.google.chrome.ios,48,1737907167,1737907215,1737907215.489445,-21600,EB445137-D7F5-57EC-87DA-1DB460D64046,"iPhone13,2"
com.apple.Health,53,1737906725,1737906778,1737906778.06293,-21600,EB445137-D7F5-57EC-87DA-1DB460D64046,"iPhone13,2"
com.myfitnesspal.mfp,45,1737906669,1737906714,1737906715.0892959,-21600,EB445137-D7F5-57EC-87DA-1DB460D64046,"iPhone13,2"
com.apple.mobileslideshow,4,1737906611,1737906615,1737906616.480566,-21600,EB445137-D7F5-57EC-87DA-1DB460D64046,"iPhone13,2"
com.toyopagroup.picaboo,30,1737906446,1737906476,1737906476.620877,-21600,EB445137-D7F5-57EC-87DA-1DB460D64046,"iPhone13,2"
com.apple.weather,1,1737906445,1737906446,1737906446.886632,-21600,EB445137-D7F5-57EC-87DA-1DB460D64046,"iPhone13,2"
com.apple.weather,5,1737902809,1737902814,1737902814.3837209,-21600,EB445137-D7F5-57EC-87DA-1DB460D64046,"iPhone13,2"
com.renpho.health,1,1737902808,1737902809,1737902809.536223,-21600,EB445137-D7F5-57EC-87DA-1DB460D64046,"iPhone13,2"
com.renpho.health,46,1737902722,1737902768,1737902769.07847,-21600,EB445137-D7F5-57EC-87DA-1DB460D64046,"iPhone13,2"
com.apple.news,1,1737901777,1737901778,1737901779.058146,-21600,EB445137-D7F5-57EC-87DA-1DB460D64046,"iPhone13,2"
com.apple.news,275,1737901500,1737901775,1737901775.6442509,-21600,EB445137-D7F5-57EC-87DA-1DB460D64046,"iPhone13,2"
com.apple.Health,33,1737901467,1737901500,1737901500.906022,-21600,EB445137-D7F5-57EC-87DA-1DB460D64046,"iPhone13,2"
com.apple.news,112,1737901353,1737901465,1737901465.952235,-21600,EB445137-D7F5-57EC-87DA-1DB460D64046,"iPhone13,2"
com.apple.MobileSMS,3,1737861882,1737861885,1737861885.7422051,-21600,EB445137-D7F5-57EC-87DA-1DB460D64046,"iPhone13,2"
com.thestorygraph.thestorygraph,46,1737860539,1737860585,1737860585.652419,-21600,EB445137-D7F5-57EC-87DA-1DB460D64046,"iPhone13,2"
com.thestorygraph.thestorygraph,20,1737860303,1737860323,1737860323.385108,-21600,EB445137-D7F5-57EC-87DA-1DB460D64046,"iPhone13,2"
com.google.chrome.ios,501,1737859801,1737860302,1737860304.52559,-21600,EB445137-D7F5-57EC-87DA-1DB460D64046,"iPhone13,2"
com.letterboxd.LetterboxdApp,3,1737859798,1737859801,1737859801.609103,-21600,EB445137-D7F5-57EC-87DA-1DB460D64046,"iPhone13,2"
com.letterboxd.LetterboxdApp,45,1737858213,1737858258,1737858259.0642428,-21600,EB445137-D7F5-57EC-87DA-1DB460D64046,"iPhone13,2"
com.google.chrome.ios,2,1737858206,1737858208,1737858208.60481,-21600,EB445137-D7F5-57EC-87DA-1DB460D64046,"iPhone13,2"
com.google.chrome.ios,113,1737857492,1737857605,1737857606.22347,-21600,EB445137-D7F5-57EC-87DA-1DB460D64046,"iPhone13,2"
com.google.chrome.ios,153,1737857315,1737857468,1737857469.227614,-21600,EB445137-D7F5-57EC-87DA-1DB460D64046,"iPhone13,2"
com.apple.MobileSMS,26,1737857064,1737857090,1737857090.118585,-21600,EB445137-D7F5-57EC-87DA-1DB460D64046,"iPhone13,2"
com.google.chrome.ios,60,1737857004,1737857064,1737857065.250947,-21600,EB445137-D7F5-57EC-87DA-1DB460D64046,"iPhone13,2"
com.apple.MobileSMS,2,1737857002,1737857004,1737857004.423516,-21600,EB445137-D7F5-57EC-87DA-1DB460D64046,"iPhone13,2"
com.apple.Maps,2,1737857000,1737857002,1737857002.212686,-21600,EB445137-D7F5-57EC-87DA-1DB460D64046,"iPhone13,2"
com.apple.Maps,24,1737854623,1737854647,1737854647.306921,-21600,EB445137-D7F5-57EC-87DA-1DB460D64046,"iPhone13,2"
com.myfitnesspal.mfp,2,1737852814,1737852816,1737852816.60288,-21600,EB445137-D7F5-57EC-87DA-1DB460D64046,"iPhone13,2"
com.myfitnesspal.mfp,29,1737851747,1737851776,1737851776.53603,-21600,EB445137-D7F5-57EC-87DA-1DB460D64046,"iPhone13,2"
com.myfitnesspal.mfp,42,1737851126,1737851168,1737851168.5990438,-21600,EB445137-D7F5-57EC-87DA-1DB460D64046,"iPhone13,2"
com.myfitnesspal.mfp,38,1737851074,1737851112,1737851112.889289,-21600,EB445137-D7F5-57EC-87DA-1DB460D64046,"iPhone13,2"
com.apple.news,5,1737851069,1737851074,1737851074.346204,-21600,EB445137-D7F5-57EC-87DA-1DB460D64046,"iPhone13,2"
com.apple.news,84,1737848426,1737848510,1737848511.382821,-21600,EB445137-D7F5-57EC-87DA-1DB460D64046,"iPhone13,2"
com.hammerandchisel.discord,28,1737848282,1737848310,1737848310.76052,-21600,EB445137-D7F5-57EC-87DA-1DB460D64046,"iPhone13,2"
com.toyopagroup.picaboo,0,1737848282,1737848282,1737848282.644326,-21600,EB445137-D7F5-57EC-87DA-1DB460D64046,"iPhone13,2"
com.google.chrome.ios,1,1737847845,1737847846,1737847847.279077,-21600,EB445137-D7F5-57EC-87DA-1DB460D64046,"iPhone13,2"
com.google.chrome.ios,110,1737847323,1737847433,1737847433.309541,-21600,EB445137-D7F5-57EC-87DA-1DB460D64046,"iPhone13,2"
com.apple.MobileSMS,1,1737847322,1737847323,1737847323.623086,-21600,EB445137-D7F5-57EC-87DA-1DB460D64046,"iPhone13,2"
com.apple.mobileslideshow,1,1737847321,1737847322,1737847322.566778,-21600,EB445137-D7F5-57EC-87DA-1DB460D64046,"iPhone13,2"
com.apple.mobileslideshow,195,1737847034,1737847229,1737847229.149426,-21600,EB445137-D7F5-57EC-87DA-1DB460D64046,"iPhone13,2"
com.apple.mobileslideshow,269,1737846726,1737846995,1737846995.5427241,-21600,EB445137-D7F5-57EC-87DA-1DB460D64046,"iPhone13,2"
com.apple.mobileslideshow,198,1737846527,1737846725,1737846726.4287682,-21600,EB445137-D7F5-57EC-87DA-1DB460D64046,"iPhone13,2"
com.myfitnesspal.mfp,2,1737846525,1737846527,1737846527.52,-21600,EB445137-D7F5-57EC-87DA-1DB460D64046,"iPhone13,2"
com.myfitnesspal.mfp,33,1737846485,1737846518,1737846518.229815,-21600,EB445137-D7F5-57EC-87DA-1DB460D64046,"iPhone13,2"
com.apple.mobileslideshow,2,1737846482,1737846484,1737846484.6643028,-21600,EB445137-D7F5-57EC-87DA-1DB460D64046,"iPhone13,2"
com.apple.mobileslideshow,80,1737846394,1737846474,1737846474.263576,-21600,EB445137-D7F5-57EC-87DA-1DB460D64046,"iPhone13,2"
com.apple.Music,1,1737846392,1737846393,1737846394.033354,-21600,EB445137-D7F5-57EC-87DA-1DB460D64046,"iPhone13,2"
com.apple.Music,13,1737844435,1737844448,1737844450.015389,-21600,EB445137-D7F5-57EC-87DA-1DB460D64046,"iPhone13,2"
com.apple.MobileSMS,2,1737844433,1737844435,1737844435.19234,-21600,EB445137-D7F5-57EC-87DA-1DB460D64046,"iPhone13,2"
com.apple.MobileSMS,4,1737844262,1737844266,1737844266.880295,-21600,EB445137-D7F5-57EC-87DA-1DB460D64046,"iPhone13,2"
com.apple.MobileSMS,7,1737844233,1737844240,1737844240.774805,-21600,EB445137-D7F5-57EC-87DA-1DB460D64046,"iPhone13,2"
com.apple.mobileslideshow,2,1737844231,1737844233,1737844233.332617,-21600,EB445137-D7F5-57EC-87DA-1DB460D64046,"iPhone13,2"
com.leomehlig.today,2,1737844214,1737844216,1737844216.8398252,-21600,,
com.apple.mobileslideshow,93,1737844113,1737844206,1737844206.269256,-21600,EB445137-D7F5-57EC-87DA-1DB460D64046,"iPhone13,2"
com.google.Chrome,115,1737844099,1737844214,1737844214.980095,-21600,,
com.apple.Notes,1,1737844098,1737844099,1737844099.35998,-21600,,
com.google.Chrome,8,1737844090,1737844098,1737844098.432568,-21600,,
com.google.chrome.ios,7,1737844086,1737844093,1737844094.6724792,-21600,EB445137-D7F5-57EC-87DA-1DB460D64046,"iPhone13,2"
com.apple.MobileSMS,12,1737844074,1737844086,1737844086.396466,-21600,EB445137-D7F5-57EC-87DA-1DB460D64046,"iPhone13,2"
com.apple.MobileSMS,34,1737844056,1737844090,1737844090.227562,-21600,,
com.leomehlig.today,1,1737844055,1737844056,1737844056.632244,-21600,,
com.apple.MobileSMS,2,1737844053,1737844055,1737844055.026849,-21600,,
com.leomehlig.today,2,1737844051,1737844053,1737844053.565362,-21600,,
com.apple.Notes,0,1737844051,1737844051,1737844052.255649,-21600,,
com.apple.calculator,1,1737844050,1737844051,1737844051.309576,-21600,,
com.apple.CoreAuthUI,6,1737843976,1737843982,1737843982.1781502,-21600,EB445137-D7F5-57EC-87DA-1DB460D64046,"iPhone13,2"
com.clairmail.fth.client,64,1737843975,1737844039,1737844039.956262,-21600,EB445137-D7F5-57EC-87DA-1DB460D64046,"iPhone13,2"
com.truebill.truebillnative,36,1737843936,1737843972,1737843972.5842261,-21600,EB445137-D7F5-57EC-87DA-1DB460D64046,"iPhone13,2"
com.apple.calculator,28,1737843891,1737843919,1737843919.6808372,-21600,EB445137-D7F5-57EC-87DA-1DB460D64046,"iPhone13,2"
com.truebill.truebillnative,48,1737843843,1737843891,1737843891.938355,-21600,EB445137-D7F5-57EC-87DA-1DB460D64046,"iPhone13,2"
com.apple.iCal,259,1737843791,1737844050,1737844050.91801,-21600,,
com.apple.calculator,56,1737843787,1737843843,1737843843.360683,-21600,EB445137-D7F5-57EC-87DA-1DB460D64046,"iPhone13,2"
com.truebill.truebillnative,165,1737843622,1737843787,1737843787.6072822,-21600,EB445137-D7F5-57EC-87DA-1DB460D64046,"iPhone13,2"
com.apple.calculator,35,1737843587,1737843622,1737843622.514666,-21600,EB445137-D7F5-57EC-87DA-1DB460D64046,"iPhone13,2"
com.truebill.truebillnative,131,1737843456,1737843587,1737843587.6030102,-21600,EB445137-D7F5-57EC-87DA-1DB460D64046,"iPhone13,2"
com.apple.calculator,15,1737843441,1737843456,1737843456.3999639,-21600,EB445137-D7F5-57EC-87DA-1DB460D64046,"iPhone13,2"
com.apple.calculator,420,1737843371,1737843791,1737843791.1516,-21600,,
com.apple.CoreAuthUI,2,1737843351,1737843353,1737843353.115199,-21600,EB445137-D7F5-57EC-87DA-1DB460D64046,"iPhone13,2"
com.truebill.truebillnative,92,1737843349,1737843441,1737843441.3844972,-21600,EB445137-D7F5-57EC-87DA-1DB460D64046,"iPhone13,2"
com.google.ios.youtube,1,1737843344,1737843345,1737843346.924965,-21600,EB445137-D7F5-57EC-87DA-1DB460D64046,"iPhone13,2"
com.apple.weather,1,1737843343,1737843344,1737843344.659328,-21600,EB445137-D7F5-57EC-87DA-1DB460D64046,"iPhone13,2"
com.google.Chrome,42,1737843329,1737843371,1737843371.389313,-21600,,
com.apple.Notes,0,1737843329,1737843329,1737843329.7869492,-21600,,
com.apple.iCal,3,1737843326,1737843329,1737843329.055718,-21600,,
com.google.Chrome,1,1737843325,1737843326,1737843326.793791,-21600,,
com.apple.Notes,15,1737843310,1737843325,1737843325.467708,-21600,,
com.google.Chrome,22,1737843288,1737843310,1737843310.093374,-21600,,
com.apple.iCal,1,1737843287,1737843288,1737843288.654148,-21600,,
com.apple.Notes,35,1737843252,1737843287,1737843287.212111,-21600,,
com.apple.iCal,3,1737843249,1737843252,1737843252.614047,-21600,,
com.google.Chrome,0,1737843249,1737843249,1737843249.960853,-21600,,
com.apple.iCal,5,1737843244,1737843249,1737843249.241554,-21600,,
com.google.Chrome,21,1737843223,1737843244,1737843245.0121222,-21600,,
com.apple.Notes,27,1737843196,1737843223,1737843223.524432,-21600,,
com.google.Chrome,3,1737843193,1737843196,1737843196.3021631,-21600,,
com.leomehlig.today,1,1737843192,1737843193,1737843193.914943,-21600,,
com.apple.Notes,2,1737843190,1737843192,1737843192.420387,-21600,,
com.leomehlig.today,41,1737843149,1737843190,1737843190.39066,-21600,,
com.apple.Notes,2,1737843147,1737843149,1737843149.836837,-21600,,
com.google.Chrome,13,1737843134,1737843147,1737843147.2565808,-21600,,
com.apple.Notes,17,1737843117,1737843134,1737843134.274777,-21600,,
com.google.Chrome,29,1737843088,1737843117,1737843117.226654,-21600,,
com.apple.Notes,48,1737843040,1737843088,1737843088.718792,-21600,,
com.google.Chrome,10,1737843030,1737843040,1737843040.2116718,-21600,,
com.apple.weather,10,1737842878,1737842888,1737842889.222498,-21600,EB445137-D7F5-57EC-87DA-1DB460D64046,"iPhone13,2"
com.hammerandchisel.discord,15,1737842863,1737842878,1737842878.199197,-21600,EB445137-D7F5-57EC-87DA-1DB460D64046,"iPhone13,2"
com.truebill.truebillnative,1,1737842862,1737842863,1737842863.726996,-21600,EB445137-D7F5-57EC-87DA-1DB460D64046,"iPhone13,2"
com.leomehlig.today,273,1737842741,1737843014,1737843014.620479,-21600,,
com.google.Chrome,379,1737842362,1737842741,1737842741.448608,-21600,,
com.apple.Notes,4,1737842337,1737842341,1737842341.961833,-21600,,
com.apple.Terminal,2,1737842335,1737842337,1737842337.161612,-21600,,
com.apple.Notes,2,1737842333,1737842335,1737842335.79689,-21600,,
com.electron.carta,28,1737842305,1737842333,1737842333.5604172,-21600,,
com.apple.Notes,21,1737842284,1737842305,1737842305.892164,-21600,,
com.google.Chrome,3,1737842281,1737842284,1737842284.211207,-21600,,
com.apple.Notes,2,1737842279,1737842281,1737842281.7992969,-21600,,
com.google.Chrome,3,1737842276,1737842279,1737842279.553102,-21600,,
com.apple.Notes,2,1737842274,1737842276,1737842276.666873,-21600,,
com.google.Chrome,379,1737841895,1737842274,1737842274.0744529,-21600,,
com.apple.Notes,3,1737841892,1737841895,1737841895.774969,-21600,,
com.google.Chrome,296,1737841596,1737841892,1737841892.958939,-21600,,
com.apple.Notes,5,1737841591,1737841596,1737841596.436275,-21600,,
com.google.Chrome,127,1737841464,1737841591,1737841591.988648,-21600,,
com.apple.Notes,144,1737841320,1737841464,1737841464.6850781,-21600,,
com.google.Chrome,173,1737841147,1737841320,1737841320.223566,-21600,,
com.electron.carta,43,1737841104,1737841147,1737841147.457339,-21600,,
com.google.Chrome,6,1737841098,1737841104,1737841104.921984,-21600,,
com.electron.carta,1,1737841097,1737841098,1737841098.1607609,-21600,,
com.google.Chrome,3,1737841094,1737841097,1737841097.4561682,-21600,,
com.electron.carta,30,1737841064,1737841094,1737841094.21872,-21600,,
com.google.Chrome,2,1737841062,1737841064,1737841064.168449,-21600,,
com.electron.carta,7,1737841055,1737841062,1737841062.517539,-21600,,
com.google.Chrome,81,1737840974,1737841055,1737841055.1345282,-21600,,
com.electron.carta,128,1737840846,1737840974,1737840974.685509,-21600,,
com.google.Chrome,1,1737840845,1737840846,1737840846.342598,-21600,,
com.electron.carta,6,1737840839,1737840845,1737840845.196955,-21600,,
com.google.Chrome,427,1737840412,1737840839,1737840839.221294,-21600,,
com.electron.carta,77,1737840335,1737840412,1737840412.801149,-21600,,
com.google.Chrome,6,1737840329,1737840335,1737840335.046222,-21600,,
com.electron.carta,232,1737840097,1737840329,1737840329.713172,-21600,,
com.google.Chrome,114,1737839983,1737840097,1737840097.278586,-21600,,
com.electron.carta,33,1737839950,1737839983,1737839983.7493749,-21600,,
com.google.Chrome,154,1737839796,1737839950,1737839950.979309,-21600,,
com.electron.carta,11,1737839785,1737839796,1737839796.48168,-21600,,
com.google.Chrome,8,1737839777,1737839785,1737839785.3243341,-21600,,
com.electron.carta,130,1737839647,1737839777,1737839777.048765,-21600,,
com.google.Chrome,13,1737839634,1737839647,1737839647.754074,-21600,,
com.electron.carta,462,1737839172,1737839634,1737839634.83107,-21600,,
com.google.Chrome,188,1737838984,1737839172,1737839172.2778,-21600,,
com.cisco.secureclient.gui,3,1737838981,1737838984,1737838984.408722,-21600,,
com.google.Chrome,110,1737838871,1737838981,1737838981.5551372,-21600,,
com.apple.CoreAuthUI,2,1737838474,1737838476,1737838476.552895,-21600,EB445137-D7F5-57EC-87DA-1DB460D64046,"iPhone13,2"
com.truebill.truebillnative,247,1737838471,1737838718,1737838718.557983,-21600,EB445137-D7F5-57EC-87DA-1DB460D64046,"iPhone13,2"
com.google.Gmail,14,1737838435,1737838449,1737838449.883929,-21600,EB445137-D7F5-57EC-87DA-1DB460D64046,"iPhone13,2"
com.apple.Health,0,1737838435,1737838435,1737838436.392514,-21600,EB445137-D7F5-57EC-87DA-1DB460D64046,"iPhone13,2"
com.google.Chrome,85,1737838296,1737838381,1737838381.396621,-21600,,
com.apple.Terminal,26,1737838270,1737838296,1737838296.769477,-21600,,
com.google.Chrome,186,1737838084,1737838270,1737838270.1378698,-21600,,
com.apple.QuickTimePlayerX,10,1737838074,1737838084,1737838084.9138951,-21600,,
com.google.Chrome,3,1737838071,1737838074,1737838074.636654,-21600,,
com.electron.carta,476,1737837595,1737838071,1737838071.243407,-21600,,
com.apple.finder,4,1737837591,1737837595,1737837595.455168,-21600,,
com.apple.Preview,12,1737837579,1737837591,1737837591.887405,-21600,,
com.apple.finder,9,1737837570,1737837579,1737837579.610426,-21600,,
com.electron.carta,154,1737837416,1737837570,1737837570.600568,-21600,,
com.apple.finder,1,1737837415,1737837416,1737837416.893904,-21600,,
com.apple.Notes,1,1737837414,1737837415,1737837415.114613,-21600,,
com.apple.finder,1,1737837413,1737837414,1737837414.467246,-21600,,
com.microsoft.VSCode,1,1737837412,1737837413,1737837413.7291331,-21600,,
com.apple.finder,1,1737837411,1737837412,1737837412.573326,-21600,,
com.apple.Terminal,9,1737837402,1737837411,1737837411.827666,-21600,,
com.apple.finder,24,1737837378,1737837402,1737837402.662881,-21600,,
com.apple.Terminal,121,1737837257,1737837378,1737837378.7914162,-21600,,
com.apple.finder,6,1737837251,1737837257,1737837257.741963,-21600,,
com.apple.Terminal,26,1737837225,1737837251,1737837251.309071,-21600,,
com.google.Chrome,70,1737837155,1737837225,1737837225.5863252,-21600,,
com.apple.QuickTimePlayerX,291,1737836864,1737837155,1737837155.896702,-21600,,
com.apple.Terminal,11,1737836853,1737836864,1737836864.788238,-21600,,
com.google.Chrome,452,1737836401,1737836853,1737836853.544239,-21600,,
com.apple.Terminal,2,1737836399,1737836401,1737836401.450567,-21600,,
com.google.Chrome,41,1737836358,1737836399,1737836399.909521,-21600,,
com.apple.QuickTimePlayerX,5,1737836353,1737836358,1737836358.459931,-21600,,
com.apple.Terminal,72,1737836281,1737836353,1737836353.53703,-21600,,
com.google.Chrome,21,1737836260,1737836281,1737836281.895348,-21600,,
com.apple.Terminal,0,1737836260,1737836260,1737836260.583626,-21600,,
com.google.Chrome,2,1737836258,1737836260,1737836260.12113,-21600,,
com.apple.Terminal,15,1737836243,1737836258,1737836258.980259,-21600,,
com.google.Chrome,13,1737836230,1737836243,1737836243.8374019,-21600,,
com.apple.Terminal,16,1737836214,1737836230,1737836230.35468,-21600,,
com.google.Chrome,18,1737836196,1737836214,1737836214.609015,-21600,,
com.apple.Terminal,38,1737836158,1737836196,1737836196.847382,-21600,,
com.apple.finder,5,1737836153,1737836158,1737836158.5937328,-21600,,
com.apple.Terminal,82,1737836071,1737836153,1737836153.9995499,-21600,,
com.apple.finder,17,1737836054,1737836071,1737836071.5490131,-21600,,
com.apple.Terminal,143,1737835911,1737836054,1737836054.742342,-21600,,
com.google.Chrome,34,1737835877,1737835911,1737835911.7182899,-21600,,
com.apple.Terminal,175,1737835702,1737835877,1737835877.569718,-21600,,
com.apple.finder,62,1737835640,1737835702,1737835702.700346,-21600,,
com.microsoft.VSCode,41,1737835599,1737835640,1737835641.253432,-21600,,
com.apple.Terminal,4,1737835595,1737835599,1737835599.449105,-21600,,
com.apple.finder,1,1737835594,1737835595,1737835595.618661,-21600,,
com.microsoft.VSCode,17,1737835577,1737835594,1737835594.135498,-21600,,
com.apple.finder,3,1737835574,1737835577,1737835577.388365,-21600,,
com.apple.Terminal,60,1737835514,1737835574,1737835574.737412,-21600,,
com.apple.finder,61,1737835453,1737835514,1737835514.914258,-21600,,
com.apple.Terminal,57,1737835396,1737835453,1737835453.589493,-21600,,
com.google.Chrome,1,1737835395,1737835396,1737835396.947825,-21600,,
com.microsoft.rdc.macos,72,1737835323,1737835395,1737835395.125243,-21600,,
com.apple.Terminal,4,1737835319,1737835323,1737835323.542904,-21600,,
com.google.Chrome,4,1737835315,1737835319,1737835319.269734,-21600,,
com.cisco.secureclient.gui,37,1737835278,1737835315,1737835315.369564,-21600,,
com.google.Chrome,20,1737835258,1737835278,1737835278.5976439,-21600,,
com.electron.carta,39,1737835219,1737835258,1737835258.553735,-21600,,
com.google.Chrome,21,1737835198,1737835219,1737835219.513727,-21600,,
com.electron.carta,13,1737835185,1737835198,1737835198.8507562,-21600,,
com.google.Chrome,8,1737835177,1737835185,1737835185.350184,-21600,,
com.apple.QuickTimePlayerX,61,1737835116,1737835177,1737835177.9501839,-21600,,
com.apple.Health,55,1737834569,1737834624,1737834625.003241,-21600,EB445137-D7F5-57EC-87DA-1DB460D64046,"iPhone13,2"
com.apple.weather,2,1737834565,1737834567,1737834567.597369,-21600,EB445137-D7F5-57EC-87DA-1DB460D64046,"iPhone13,2"
com.apple.QuickTimePlayerX,914,1737834033,1737834947,1737834947.172651,-21600,,
com.apple.finder,2,1737834031,1737834033,1737834033.706791,-21600,,
com.apple.QuickTimePlayerX,2,1737834029,1737834031,1737834032.032689,-21600,,
com.apple.finder,8,1737834021,1737834029,1737834029.23526,-21600,,
com.google.Chrome,1168,1737832853,1737834021,1737834021.846123,-21600,,
com.google.Chrome,303,1737832062,1737832365,1737832365.0863929,-21600,,
com.google.Chrome,4077,1737827946,1737832023,1737832023.528504,-21600,,
com.leomehlig.today,21,1737827925,1737827946,1737827946.656197,-21600,,
com.apple.reminders,25,1737827900,1737827925,1737827925.153429,-21600,,
com.apple.Notes,32,1737827868,1737827900,1737827900.980371,-21600,,
com.leomehlig.today,14,1737827854,1737827868,1737827868.2869658,-21600,,
com.google.Chrome,5,1737827849,1737827854,1737827854.9074001,-21600,,
com.apple.weather,6,1737826375,1737826381,1737826381.814811,-21600,EB445137-D7F5-57EC-87DA-1DB460D64046,"iPhone13,2"
com.myfitnesspal.mfp,1,1737826374,1737826375,1737826375.840934,-21600,EB445137-D7F5-57EC-87DA-1DB460D64046,"iPhone13,2"
com.myfitnesspal.mfp,58,1737826312,1737826370,1737826370.955642,-21600,EB445137-D7F5-57EC-87DA-1DB460D64046,"iPhone13,2"
com.renpho.health,2,1737826308,1737826310,1737826310.515672,-21600,EB445137-D7F5-57EC-87DA-1DB460D64046,"iPhone13,2"
com.apple.MobileSMS,3,1737826305,1737826308,1737826308.137537,-21600,EB445137-D7F5-57EC-87DA-1DB460D64046,"iPhone13,2"
com.apple.MobileSMS,2,1737826302,1737826304,1737826304.7368588,-21600,EB445137-D7F5-57EC-87DA-1DB460D64046,"iPhone13,2"
com.apple.MobileSMS,3,1737826192,1737826195,1737826195.858862,-21600,EB445137-D7F5-57EC-87DA-1DB460D64046,"iPhone13,2"
com.apple.MobileSMS,110,1737825675,1737825785,1737825785.9243731,-21600,EB445137-D7F5-57EC-87DA-1DB460D64046,"iPhone13,2"
com.google.Chrome,59,1737825069,1737825128,1737825128.918723,-21600,,
com.google.Chrome,1215,1737823801,1737825016,1737825016.624675,-21600,,
com.apple.finder,14,1737823787,1737823801,1737823801.665999,-21600,,
com.apple.Notes,36,1737823751,1737823787,1737823787.891711,-21600,,
com.clairmail.fth.client,2,1737823633,1737823635,1737823635.6034331,-21600,EB445137-D7F5-57EC-87DA-1DB460D64046,"iPhone13,2"
com.apple.MobileSMS,30,1737823602,1737823632,1737823632.3835049,-21600,EB445137-D7F5-57EC-87DA-1DB460D64046,"iPhone13,2"
com.apple.CoreAuthUI,3,1737823558,1737823561,1737823561.750715,-21600,EB445137-D7F5-57EC-87DA-1DB460D64046,"iPhone13,2"
com.clairmail.fth.client,49,1737823553,1737823602,1737823602.3679519,-21600,EB445137-D7F5-57EC-87DA-1DB460D64046,"iPhone13,2"
com.apple.MobileSMS,2,1737823546,1737823548,1737823548.414154,-21600,EB445137-D7F5-57EC-87DA-1DB460D64046,"iPhone13,2"
com.google.Chrome,225,1737823526,1737823751,1737823751.610868,-21600,,
com.apple.MobileSMS,12,1737823494,1737823506,1737823506.654422,-21600,EB445137-D7F5-57EC-87DA-1DB460D64046,"iPhone13,2"
com.apple.MobileSMS,5,1737823330,1737823335,1737823335.879796,-21600,EB445137-D7F5-57EC-87DA-1DB460D64046,"iPhone13,2"
com.google.Chrome,576,1737822541,1737823117,1737823117.66472,-21600,,
com.apple.Notes,17,1737822524,1737822541,1737822542.0095758,-21600,,
com.google.Chrome,231,1737822293,1737822524,1737822524.7141309,-21600,,
com.leomehlig.today,1,1737822292,1737822293,1737822293.685234,-21600,,
com.google.Chrome,6,1737822286,1737822292,1737822292.961101,-21600,,
com.google.Chrome,426,1737821722,1737822148,1737822148.9126039,-21600,,
com.apple.Health,30,1737821656,1737821686,1737821686.220374,-21600,EB445137-D7F5-57EC-87DA-1DB460D64046,"iPhone13,2"
com.apple.PosterBoard,2,1737820711,1737820713,1737820713.224581,-21600,EB445137-D7F5-57EC-87DA-1DB460D64046,"iPhone13,2"
com.google.Chrome,979,1737820550,1737821529,1737821529.476614,-21600,,
com.amazon.Amazon,44,1737820063,1737820107,1737820107.950994,-21600,EB445137-D7F5-57EC-87DA-1DB460D64046,"iPhone13,2"
com.apple.Health,36,1737819598,1737819634,1737819634.875712,-21600,EB445137-D7F5-57EC-87DA-1DB460D64046,"iPhone13,2"
com.apple.mobilenotes,0,1737819598,1737819598,1737819599.244493,-21600,EB445137-D7F5-57EC-87DA-1DB460D64046,"iPhone13,2"
com.google.Chrome,605,1737819357,1737819962,1737819962.871773,-21600,,
com.leomehlig.today,17,1737819340,1737819357,1737819357.876864,-21600,,
com.apple.mobilenotes,19,1737817585,1737817604,1737817604.225553,-21600,EB445137-D7F5-57EC-87DA-1DB460D64046,"iPhone13,2"
com.apple.weather,1,1737817583,1737817584,1737817584.9776,-21600,EB445137-D7F5-57EC-87DA-1DB460D64046,"iPhone13,2"
com.apple.weather,61,1737816750,1737816811,1737816812.055903,-21600,EB445137-D7F5-57EC-87DA-1DB460D64046,"iPhone13,2"
com.renpho.health,1,1737816749,1737816750,1737816751.018337,-21600,EB445137-D7F5-57EC-87DA-1DB460D64046,"iPhone13,2"
com.renpho.health,38,1737816628,1737816666,1737816666.4176269,-21600,EB445137-D7F5-57EC-87DA-1DB460D64046,"iPhone13,2"
com.google.ios.youtube,472,1737815126,1737815598,1737815598.872647,-21600,EB445137-D7F5-57EC-87DA-1DB460D64046,"iPhone13,2"
com.leomehlig.today,183,1737784894,1737785077,1737785077.3635988,-21600,,
com.google.Chrome,3,1737784892,1737784895,1737784896.199337,-21600,,
com.google.chrome.ios,85,1737783029,1737783114,1737783114.250915,-21600,EB445137-D7F5-57EC-87DA-1DB460D64046,"iPhone13,2"
com.microsoft.Office.Outlook,13,1737782820,1737782833,1737782833.356004,-21600,EB445137-D7F5-57EC-87DA-1DB460D64046,"iPhone13,2"
com.myfitnesspal.mfp,8,1737782793,1737782801,1737782801.209453,-21600,EB445137-D7F5-57EC-87DA-1DB460D64046,"iPhone13,2"
com.myfitnesspal.mfp,651,1737776615,1737777266,1737777266.942553,-21600,EB445137-D7F5-57EC-87DA-1DB460D64046,"iPhone13,2"
com.toyopagroup.picaboo,8,1737776606,1737776614,1737776614.602234,-21600,EB445137-D7F5-57EC-87DA-1DB460D64046,"iPhone13,2"
com.toyopagroup.picaboo,19,1737771106,1737771125,1737771126.098424,-21600,EB445137-D7F5-57EC-87DA-1DB460D64046,"iPhone13,2"
com.apple.mobilenotes,2,1737771102,1737771104,1737771104.157512,-21600,EB445137-D7F5-57EC-87DA-1DB460D64046,"iPhone13,2"
com.apple.mobilenotes,44,1737770275,1737770319,1737770319.41503,-21600,EB445137-D7F5-57EC-87DA-1DB460D64046,"iPhone13,2"
com.myfitnesspal.mfp,1,1737770272,1737770273,1737770273.900011,-21600,EB445137-D7F5-57EC-87DA-1DB460D64046,"iPhone13,2"
com.myfitnesspal.mfp,26,1737767997,1737768023,1737768023.8389559,-21600,EB445137-D7F5-57EC-87DA-1DB460D64046,"iPhone13,2"
com.hammerandchisel.discord,393,1737766340,1737766733,1737766733.2921,-21600,EB445137-D7F5-57EC-87DA-1DB460D64046,"iPhone13,2"
com.instructure.icanvas,17,1737765346,1737765363,1737765363.565192,-21600,EB445137-D7F5-57EC-87DA-1DB460D64046,"iPhone13,2"
com.apple.MobileSMS,3,1737765331,1737765334,1737765334.972262,-21600,EB445137-D7F5-57EC-87DA-1DB460D64046,"iPhone13,2"
com.apple.mobilenotes,0,1737765331,1737765331,1737765331.8195438,-21600,EB445137-D7F5-57EC-87DA-1DB460D64046,"iPhone13,2"
com.apple.mobilenotes,4,1737761505,1737761509,1737761509.217541,-21600,EB445137-D7F5-57EC-87DA-1DB460D64046,"iPhone13,2"
com.apple.mobilenotes,3,1737761441,1737761444,1737761444.078332,-21600,EB445137-D7F5-57EC-87DA-1DB460D64046,"iPhone13,2"
com.apple.mobilenotes,10,1737761258,1737761268,1737761268.3175411,-21600,EB445137-D7F5-57EC-87DA-1DB460D64046,"iPhone13,2"
com.meijer.mobile.Meijer,2,1737761256,1737761258,1737761258.972363,-21600,EB445137-D7F5-57EC-87DA-1DB460D64046,"iPhone13,2"
com.meijer.mobile.Meijer,35,1737761198,1737761233,1737761233.475614,-21600,EB445137-D7F5-57EC-87DA-1DB460D64046,"iPhone13,2"
com.meijer.mobile.Meijer,71,1737760950,1737761021,1737761022.172978,-21600,EB445137-D7F5-57EC-87DA-1DB460D64046,"iPhone13,2"
com.apple.weather,1,1737760946,1737760947,1737760948.048602,-21600,EB445137-D7F5-57EC-87DA-1DB460D64046,"iPhone13,2"
com.apple.mobilenotes,1,1737760945,1737760946,1737760946.3546438,-21600,EB445137-D7F5-57EC-87DA-1DB460D64046,"iPhone13,2"
com.apple.mobilenotes,22,1737760855,1737760877,1737760877.4417381,-21600,EB445137-D7F5-57EC-87DA-1DB460D64046,"iPhone13,2"
com.apple.mobilenotes,38,1737760714,1737760752,1737760752.780565,-21600,EB445137-D7F5-57EC-87DA-1DB460D64046,"iPhone13,2"
com.amazon.Amazon,3,1737760711,1737760714,1737760714.955622,-21600,EB445137-D7F5-57EC-87DA-1DB460D64046,"iPhone13,2"
com.amazon.Amazon,3,1737760480,1737760483,1737760483.58132,-21600,EB445137-D7F5-57EC-87DA-1DB460D64046,"iPhone13,2"
com.apple.mobilenotes,2,1737760470,1737760472,1737760472.5434198,-21600,EB445137-D7F5-57EC-87DA-1DB460D64046,"iPhone13,2"
com.apple.mobilenotes,3,1737759775,1737759778,1737759778.685985,-21600,EB445137-D7F5-57EC-87DA-1DB460D64046,"iPhone13,2"
com.apple.mobilenotes,3,1737759560,1737759563,1737759563.643827,-21600,EB445137-D7F5-57EC-87DA-1DB460D64046,"iPhone13,2"
com.apple.mobilenotes,8,1737759532,1737759540,1737759540.9440432,-21600,EB445137-D7F5-57EC-87DA-1DB460D64046,"iPhone13,2"
com.apple.mobilenotes,33,1737759447,1737759480,1737759480.190292,-21600,EB445137-D7F5-57EC-87DA-1DB460D64046,"iPhone13,2"
com.apple.mobilenotes,10,1737759342,1737759352,1737759352.627884,-21600,EB445137-D7F5-57EC-87DA-1DB460D64046,"iPhone13,2"
com.apple.Maps,2,1737759339,1737759341,1737759341.9197888,-21600,EB445137-D7F5-57EC-87DA-1DB460D64046,"iPhone13,2"
com.apple.Maps,35,1737756695,1737756730,1737756730.912888,-21600,EB445137-D7F5-57EC-87DA-1DB460D64046,"iPhone13,2"
com.apple.news,32,1737756455,1737756487,1737756488.7049398,-21600,EB445137-D7F5-57EC-87DA-1DB460D64046,"iPhone13,2"
com.apple.MobileSMS,3,1737756447,1737756450,1737756450.0478501,-21600,EB445137-D7F5-57EC-87DA-1DB460D64046,"iPhone13,2"
com.apple.MobileSMS,8,1737756319,1737756327,1737756327.956654,-21600,EB445137-D7F5-57EC-87DA-1DB460D64046,"iPhone13,2"
com.google.Chrome,3,1737756228,1737756231,1737756231.3597589,-21600,,
com.leomehlig.today,3,1737756225,1737756228,1737756228.241455,-21600,,
com.apple.MobileSMS,10,1737756215,1737756225,1737756225.395704,-21600,,
com.leomehlig.today,14,1737756201,1737756215,1737756215.380066,-21600,,
com.google.Chrome,9,1737756192,1737756201,1737756201.478825,-21600,,
com.apple.Notes,145,1737756047,1737756192,1737756192.993363,-21600,,
com.google.Chrome,21,1737756026,1737756047,1737756047.15557,-21600,,
com.apple.Notes,101,1737755925,1737756026,1737756026.078247,-21600,,
com.google.Chrome,7,1737755918,1737755925,1737755925.152257,-21600,,
com.apple.Notes,8,1737755910,1737755918,1737755918.312469,-21600,,
com.google.Chrome,52,1737755858,1737755910,1737755910.807839,-21600,,
com.apple.Notes,6,1737755852,1737755858,1737755858.7484841,-21600,,
com.google.Chrome,12,1737755840,1737755852,1737755852.589573,-21600,,
com.apple.Notes,2,1737755838,1737755840,1737755840.854351,-21600,,
com.google.Chrome,3,1737755835,1737755838,1737755838.366066,-21600,,
com.apple.Notes,5,1737755830,1737755835,1737755835.997799,-21600,,
com.google.Chrome,11,1737755819,1737755830,1737755830.9853802,-21600,,
com.apple.Notes,3,1737755816,1737755819,1737755819.6297011,-21600,,
com.google.Chrome,6,1737755810,1737755816,1737755816.23428,-21600,,
com.apple.Notes,7,1737755803,1737755810,1737755810.9349198,-21600,,
com.google.Chrome,0,1737755803,1737755803,1737755803.78859,-21600,,
com.apple.Notes,1,1737755802,1737755803,1737755803.4367971,-21600,,
com.google.Chrome,1,1737755801,1737755802,1737755802.256578,-21600,,
com.apple.Notes,6,1737755795,1737755801,1737755801.186647,-21600,,
com.google.Chrome,29,1737755766,1737755795,1737755795.536505,-21600,,
com.apple.Notes,5,1737755761,1737755766,1737755766.763391,-21600,,
com.google.Chrome,1,1737755760,1737755761,1737755761.7721071,-21600,,
com.apple.Notes,63,1737755697,1737755760,1737755760.970715,-21600,,
com.google.Chrome,52,1737755645,1737755697,1737755697.484551,-21600,,
com.apple.Notes,117,1737755528,1737755645,1737755645.5725121,-21600,,
com.google.Chrome,22,1737755506,1737755528,1737755528.4832659,-21600,,
com.apple.Notes,10,1737755496,1737755506,1737755506.134383,-21600,,
com.google.Chrome,124,1737755372,1737755496,1737755496.4865398,-21600,,
com.apple.Notes,17,1737755355,1737755372,1737755373.072304,-21600,,
com.google.Chrome,2,1737755353,1737755355,1737755355.2283201,-21600,,
com.apple.Notes,11,1737755342,1737755353,1737755353.785533,-21600,,
com.google.Chrome,70,1737755272,1737755342,1737755342.099438,-21600,,
com.apple.Notes,4,1737755268,1737755272,1737755272.845666,-21600,,
com.google.Chrome,10,1737755258,1737755268,1737755268.660805,-21600,,
com.apple.Notes,6,1737755252,1737755258,1737755258.152379,-21600,,
com.google.Chrome,4,1737755248,1737755252,1737755252.231081,-21600,,
com.apple.Notes,4,1737755244,1737755248,1737755248.343276,-21600,,
com.google.Chrome,8,1737755236,1737755244,1737755244.5319061,-21600,,
com.apple.Notes,1,1737755235,1737755236,1737755236.773158,-21600,,
com.google.Chrome,8,1737755227,1737755235,1737755235.4333,-21600,,
com.apple.Notes,1,1737755226,1737755227,1737755227.111774,-21600,,
com.google.Chrome,5,1737755221,1737755226,1737755226.064419,-21600,,
com.apple.Notes,1,1737755220,1737755221,1737755221.83953,-21600,,
com.google.Chrome,5,1737755215,1737755220,1737755220.804527,-21600,,
com.apple.Notes,1,1737755214,1737755215,1737755215.396694,-21600,,
com.google.Chrome,3,1737755211,1737755214,1737755214.752877,-21600,,
com.apple.Notes,1,1737755210,1737755211,1737755211.854694,-21600,,
com.google.Chrome,2,1737755208,1737755210,1737755210.91475,-21600,,
com.apple.Notes,2,1737755206,1737755208,1737755208.506587,-21600,,
com.google.Chrome,20,1737755186,1737755206,1737755206.5203218,-21600,,
com.apple.Notes,1,1737755185,1737755186,1737755186.685948,-21600,,
com.google.Chrome,6,1737755179,1737755185,1737755185.417005,-21600,,
com.apple.Notes,22,1737755157,1737755179,1737755179.334178,-21600,,
com.leomehlig.today,7,1737755150,1737755157,1737755157.062945,-21600,,
com.apple.Notes,54,1737755096,1737755150,1737755150.80401,-21600,,
com.apple.CoreAuthUI,2,1737754755,1737754757,1737754757.968089,-21600,EB445137-D7F5-57EC-87DA-1DB460D64046,"iPhone13,2"
com.truebill.truebillnative,3,1737754754,1737754757,1737754757.95534,-21600,EB445137-D7F5-57EC-87DA-1DB460D64046,"iPhone13,2"
com.apple.Notes,391,1737754623,1737755014,1737755014.8524551,-21600,,
com.google.Chrome,2,1737754621,1737754623,1737754623.39578,-21600,,
com.apple.Notes,41,1737754580,1737754621,1737754621.558666,-21600,,
com.google.Chrome,4,1737754576,1737754580,1737754580.2414498,-21600,,
com.apple.Notes,2,1737754574,1737754576,1737754576.5903249,-21600,,
com.leomehlig.today,5,1737754569,1737754574,1737754574.594998,-21600,,
com.apple.CoreAuthUI,2,1737754498,1737754500,1737754500.4551249,-21600,EB445137-D7F5-57EC-87DA-1DB460D64046,"iPhone13,2"
com.truebill.truebillnative,59,1737754496,1737754555,1737754555.204947,-21600,EB445137-D7F5-57EC-87DA-1DB460D64046,"iPhone13,2"
com.apple.CoreAuthUI,2,1737754480,1737754482,1737754482.483873,-21600,EB445137-D7F5-57EC-87DA-1DB460D64046,"iPhone13,2"
com.discoverfinancial.mobile,22,1737754473,1737754495,1737754495.3022099,-21600,EB445137-D7F5-57EC-87DA-1DB460D64046,"iPhone13,2"
com.tinyspeck.chatlyio,35,1737754434,1737754469,1737754469.279587,-21600,EB445137-D7F5-57EC-87DA-1DB460D64046,"iPhone13,2"
com.microsoft.Office.Outlook,19,1737754413,1737754432,1737754432.1766748,-21600,EB445137-D7F5-57EC-87DA-1DB460D64046,"iPhone13,2"
com.apple.MobileSMS,36,1737754376,1737754412,1737754412.9333339,-21600,EB445137-D7F5-57EC-87DA-1DB460D64046,"iPhone13,2"
com.toyopagroup.picaboo,12,1737754346,1737754358,1737754358.996379,-21600,EB445137-D7F5-57EC-87DA-1DB460D64046,"iPhone13,2"
com.google.Chrome,1535,1737753034,1737754569,1737754570.085536,-21600,,
com.google.Chrome,241,1737749451,1737749692,1737749692.6685371,-21600,,
com.google.Chrome,391,1737749059,1737749450,1737749450.698454,-21600,,
com.hammerandchisel.discord,51,1737748582,1737748633,1737748633.544701,-21600,EB445137-D7F5-57EC-87DA-1DB460D64046,"iPhone13,2"
com.microsoft.Office.Outlook,10,1737748422,1737748432,1737748432.955271,-21600,EB445137-D7F5-57EC-87DA-1DB460D64046,"iPhone13,2"
com.toyopagroup.picaboo,5,1737748401,1737748406,1737748406.1125932,-21600,EB445137-D7F5-57EC-87DA-1DB460D64046,"iPhone13,2"
com.apple.MobileSMS,0,1737748401,1737748401,1737748403.016358,-21600,EB445137-D7F5-57EC-87DA-1DB460D64046,"iPhone13,2"
com.google.Chrome,60,1737745099,1737745159,1737745159.017621,-21600,,
com.leomehlig.today,2,1737745089,1737745091,1737745091.549553,-21600,,
com.apple.MobileSMS,2,1737744973,1737744975,1737744975.50526,-21600,EB445137-D7F5-57EC-87DA-1DB460D64046,"iPhone13,2"
com.apple.mobilenotes,0,1737744973,1737744973,1737744973.551959,-21600,EB445137-D7F5-57EC-87DA-1DB460D64046,"iPhone13,2"
com.apple.mobilenotes,17,1737744692,1737744709,1737744709.5140991,-21600,EB445137-D7F5-57EC-87DA-1DB460D64046,"iPhone13,2"
com.microsoft.Office.Outlook,2,1737744690,1737744692,1737744692.613426,-21600,EB445137-D7F5-57EC-87DA-1DB460D64046,"iPhone13,2"
com.microsoft.Office.Outlook,54,1737744581,1737744635,1737744636.265595,-21600,EB445137-D7F5-57EC-87DA-1DB460D64046,"iPhone13,2"
com.instructure.icanvas,46,1737743620,1737743666,1737743666.272008,-21600,EB445137-D7F5-57EC-87DA-1DB460D64046,"iPhone13,2"
com.apple.mobilenotes,2,1737743615,1737743617,1737743617.147502,-21600,EB445137-D7F5-57EC-87DA-1DB460D64046,"iPhone13,2"
com.apple.mobilenotes,77,1737743536,1737743613,1737743613.903862,-21600,EB445137-D7F5-57EC-87DA-1DB460D64046,"iPhone13,2"
com.toyopagroup.picaboo,9,1737743510,1737743519,1737743519.542027,-21600,EB445137-D7F5-57EC-87DA-1DB460D64046,"iPhone13,2"
com.myfitnesspal.mfp,0,1737743510,1737743510,1737743510.851589,-21600,EB445137-D7F5-57EC-87DA-1DB460D64046,"iPhone13,2"
com.leomehlig.today,346,1737743286,1737743632,1737743632.197363,-21600,,
com.myfitnesspal.mfp,23,1737742960,1737742983,1737742984.013523,-21600,EB445137-D7F5-57EC-87DA-1DB460D64046,"iPhone13,2"
com.hammerandchisel.discord,4,1737742951,1737742955,1737742955.805276,-21600,EB445137-D7F5-57EC-87DA-1DB460D64046,"iPhone13,2"
com.google.Chrome,1018,1737742268,1737743286,1737743286.12725,-21600,,
com.apple.MobileSMS,25,1737737984,1737738009,1737738010.2120218,-21600,EB445137-D7F5-57EC-87DA-1DB460D64046,"iPhone13,2"
com.apple.news,0,1737737984,1737737984,1737737985.288562,-21600,EB445137-D7F5-57EC-87DA-1DB460D64046,"iPhone13,2"
com.apple.news,63,1737737769,1737737832,1737737832.5693169,-21600,EB445137-D7F5-57EC-87DA-1DB460D64046,"iPhone13,2"
com.apple.MobileSMS,5,1737737744,1737737749,1737737749.04603,-21600,EB445137-D7F5-57EC-87DA-1DB460D64046,"iPhone13,2"
com.leomehlig.today,56,1737737685,1737737741,1737737742.0095801,-21600,EB445137-D7F5-57EC-87DA-1DB460D64046,"iPhone13,2"
com.instructure.icanvas,2,1737737682,1737737684,1737737684.242223,-21600,EB445137-D7F5-57EC-87DA-1DB460D64046,"iPhone13,2"
com.apple.MobileSMS,40,1737737639,1737737679,1737737679.287967,-21600,EB445137-D7F5-57EC-87DA-1DB460D64046,"iPhone13,2"
com.apple.CoreAuthUI,2,1737737320,1737737322,1737737322.333349,-21600,EB445137-D7F5-57EC-87DA-1DB460D64046,"iPhone13,2"
com.robinhood.release.Robinhood,104,1737737316,1737737420,1737737420.595477,-21600,EB445137-D7F5-57EC-87DA-1DB460D64046,"iPhone13,2"
com.apple.news,29,1737737284,1737737313,1737737313.0985398,-21600,EB445137-D7F5-57EC-87DA-1DB460D64046,"iPhone13,2"
com.apple.news,32,1737737249,1737737281,1737737281.8826652,-21600,EB445137-D7F5-57EC-87DA-1DB460D64046,"iPhone13,2"
com.microsoft.Office.Outlook,19,1737737221,1737737240,1737737240.332452,-21600,EB445137-D7F5-57EC-87DA-1DB460D64046,"iPhone13,2"
com.hammerandchisel.discord,32,1737737173,1737737205,1737737205.464834,-21600,EB445137-D7F5-57EC-87DA-1DB460D64046,"iPhone13,2"
com.apple.camera,1,1737737172,1737737173,1737737173.659205,-21600,EB445137-D7F5-57EC-87DA-1DB460D64046,"iPhone13,2"
com.google.Chrome,64,1737736831,1737736895,1737736895.509042,-21600,,
com.apple.finder,16,1737736815,1737736831,1737736831.081635,-21600,,
com.google.Chrome,4,1737736811,1737736815,1737736815.852673,-21600,,
com.microsoft.VSCode,4,1737736807,1737736811,1737736811.230322,-21600,,
com.apple.finder,260,1737736547,1737736807,1737736807.837641,-21600,,
com.microsoft.VSCode,98,1737736449,1737736547,1737736548.0372849,-21600,,
com.apple.finder,8,1737736441,1737736449,1737736449.4120069,-21600,,
com.google.Chrome,88,1737736316,1737736404,1737736405.038327,-21600,,
com.microsoft.VSCode,6,1737736310,1737736316,1737736316.9580898,-21600,,
com.google.Chrome,181,1737736129,1737736310,1737736310.1541429,-21600,,
com.microsoft.VSCode,47,1737736082,1737736129,1737736129.191121,-21600,,
com.google.Chrome,14,1737736068,1737736082,1737736082.818791,-21600,,
com.microsoft.VSCode,8,1737736060,1737736068,1737736068.296926,-21600,,
com.google.Chrome,4,1737736056,1737736060,1737736060.197836,-21600,,
com.microsoft.VSCode,5,1737736051,1737736056,1737736056.525025,-21600,,
com.google.Chrome,10,1737736041,1737736051,1737736051.825918,-21600,,
com.microsoft.VSCode,7,1737736034,1737736041,1737736041.323322,-21600,,
com.google.Chrome,12,1737736022,1737736034,1737736034.552678,-21600,,
com.microsoft.VSCode,67,1737735955,1737736022,1737736022.284402,-21600,,
com.google.Chrome,3,1737735952,1737735955,1737735955.129373,-21600,,
com.microsoft.VSCode,7,1737735945,1737735952,1737735952.638648,-21600,,
com.google.Chrome,2,1737735943,1737735945,1737735945.1457129,-21600,,
com.microsoft.VSCode,13,1737735930,1737735943,1737735943.9295092,-21600,,
com.google.Chrome,1,1737735929,1737735930,1737735930.354624,-21600,,
com.microsoft.VSCode,1,1737735928,1737735929,1737735929.797724,-21600,,
com.google.Chrome,2,1737735926,1737735928,1737735928.767774,-21600,,
com.microsoft.VSCode,31,1737735895,1737735926,1737735926.142761,-21600,,
com.google.Chrome,8,1737735887,1737735895,1737735895.169242,-21600,,
com.microsoft.VSCode,20,1737735867,1737735887,1737735887.903007,-21600,,
com.apple.Terminal,2,1737735865,1737735867,1737735867.171829,-21600,,
com.microsoft.VSCode,17,1737735848,1737735865,1737735866.169111,-21600,,
com.apple.Terminal,5,1737735843,1737735848,1737735848.267561,-21600,,
com.google.Chrome,2,1737735841,1737735843,1737735843.091586,-21600,,
com.apple.Terminal,2,1737735839,1737735841,1737735841.974978,-21600,,
com.google.Chrome,3,1737735836,1737735839,1737735839.199044,-21600,,
com.apple.Terminal,17,1737735819,1737735836,1737735836.5006108,-21600,,
com.google.Chrome,5,1737735814,1737735819,1737735819.8645902,-21600,,
com.apple.Terminal,4,1737735810,1737735814,1737735814.573646,-21600,,
com.google.Chrome,24,1737735786,1737735810,1737735811.017204,-21600,,
com.microsoft.VSCode,1,1737735785,1737735786,1737735786.887107,-21600,,
com.google.Chrome,1,1737735784,1737735785,1737735785.780416,-21600,,
com.microsoft.VSCode,0,1737735784,1737735784,1737735784.882554,-21600,,
com.google.Chrome,2,1737735782,1737735784,1737735784.099815,-21600,,
com.microsoft.VSCode,1,1737735781,1737735782,1737735782.575139,-21600,,
com.google.Chrome,2,1737735779,1737735781,1737735781.419948,-21600,,
com.microsoft.VSCode,1,1737735778,1737735779,1737735779.8288732,-21600,,
com.google.Chrome,1,1737735777,1737735778,1737735778.8374128,-21600,,
com.microsoft.VSCode,1,1737735776,1737735777,1737735777.422886,-21600,,
com.google.Chrome,2,1737735774,1737735776,1737735776.386046,-21600,,
com.microsoft.VSCode,1,1737735773,1737735774,1737735774.588472,-21600,,
com.google.Chrome,2,1737735771,1737735773,1737735773.576369,-21600,,
com.microsoft.VSCode,1,1737735770,1737735771,1737735771.048085,-21600,,
com.google.Chrome,5,1737735765,1737735770,1737735770.2497702,-21600,,
com.microsoft.VSCode,34,1737735731,1737735765,1737735765.210365,-21600,,
com.google.Chrome,2,1737735729,1737735731,1737735731.317853,-21600,,
com.apple.Terminal,2,1737735727,1737735729,1737735729.402094,-21600,,
com.google.Chrome,8,1737735719,1737735727,1737735727.267786,-21600,,
com.apple.Terminal,29,1737735690,1737735719,1737735719.377983,-21600,,
com.google.Chrome,12,1737735678,1737735690,1737735690.161582,-21600,,
com.apple.Terminal,22,1737735656,1737735678,1737735678.107877,-21600,,
com.microsoft.VSCode,19,1737735637,1737735656,1737735656.5426512,-21600,,
com.apple.Terminal,32,1737735605,1737735637,1737735637.2496948,-21600,,
com.google.Chrome,3,1737735602,1737735605,1737735605.1229749,-21600,,
com.apple.Terminal,0,1737735602,1737735602,1737735602.9222121,-21600,,
com.apple.finder,38,1737735564,1737735602,1737735602.264927,-21600,,
com.apple.Terminal,10,1737735554,1737735564,1737735564.062398,-21600,,
com.google.Chrome,9,1737735545,1737735554,1737735554.1410398,-21600,,
com.apple.Terminal,37,1737735508,1737735545,1737735545.0672941,-21600,,
com.microsoft.VSCode,2,1737735506,1737735508,1737735508.824599,-21600,,
com.apple.Terminal,16,1737735490,1737735506,1737735506.394522,-21600,,
com.google.Chrome,19,1737735471,1737735490,1737735490.703825,-21600,,
com.apple.Terminal,6,1737735465,1737735471,1737735472.1418371,-21600,,
com.google.Chrome,15,1737735450,1737735465,1737735465.3757849,-21600,,
com.apple.Terminal,3,1737735447,1737735450,1737735450.2062678,-21600,,
com.google.Chrome,11,1737735436,1737735447,1737735447.2193341,-21600,,
com.microsoft.VSCode,16,1737735420,1737735436,1737735436.211783,-21600,,
com.apple.Terminal,57,1737735363,1737735420,1737735420.304438,-21600,,
com.google.Chrome,31,1737735332,1737735363,1737735363.255033,-21600,,
com.microsoft.VSCode,1,1737735331,1737735332,1737735332.192534,-21600,,
com.google.Chrome,2,1737735329,1737735331,1737735331.27655,-21600,,
com.microsoft.VSCode,2,1737735327,1737735329,1737735329.389542,-21600,,
com.google.Chrome,2,1737735325,1737735327,1737735327.689612,-21600,,
com.microsoft.VSCode,1,1737735324,1737735325,1737735326.0178041,-21600,,
com.google.Chrome,3,1737735321,1737735324,1737735324.935132,-21600,,
com.microsoft.VSCode,1,1737735320,1737735321,1737735321.4604502,-21600,,
com.google.Chrome,2,1737735318,1737735320,1737735320.481367,-21600,,
com.microsoft.VSCode,4,1737735314,1737735318,1737735318.767884,-21600,,
com.google.Chrome,4,1737735310,1737735314,1737735314.396148,-21600,,
com.microsoft.VSCode,2,1737735308,1737735310,1737735310.149329,-21600,,
com.google.Chrome,2,1737735306,1737735308,1737735308.383412,-21600,,
com.microsoft.VSCode,1,1737735305,1737735306,1737735306.3971848,-21600,,
com.google.Chrome,5,1737735300,1737735305,1737735305.085372,-21600,,
com.microsoft.VSCode,1,1737735299,1737735300,1737735300.60082,-21600,,
com.google.Chrome,1,1737735298,1737735299,1737735299.7814798,-21600,,
com.microsoft.VSCode,1,1737735297,1737735298,1737735298.408091,-21600,,
com.google.Chrome,2,1737735295,1737735297,1737735297.392103,-21600,,
com.microsoft.VSCode,2,1737735293,1737735295,1737735295.428782,-21600,,
com.google.Chrome,11,1737735282,1737735293,1737735293.586576,-21600,,
com.microsoft.VSCode,24,1737735258,1737735282,1737735282.319371,-21600,,
com.apple.Terminal,28,1737735230,1737735258,1737735258.9599729,-21600,,
com.microsoft.VSCode,212,1737735018,1737735230,1737735230.809763,-21600,,
com.google.Chrome,5,1737735013,1737735018,1737735018.50477,-21600,,
com.microsoft.VSCode,164,1737734849,1737735013,1737735013.694292,-21600,,
com.google.Chrome,11,1737734838,1737734849,1737734850.063231,-21600,,
com.microsoft.VSCode,145,1737734693,1737734838,1737734838.868452,-21600,,
com.google.Chrome,7,1737734686,1737734693,1737734693.3915591,-21600,,
com.microsoft.VSCode,82,1737734604,1737734686,1737734686.879897,-21600,,
com.google.Chrome,5,1737734599,1737734604,1737734604.098824,-21600,,
com.microsoft.VSCode,36,1737734563,1737734599,1737734600.003179,-21600,,
com.apple.finder,2,1737734561,1737734563,1737734563.397287,-21600,,
com.apple.installer,58,1737734503,1737734561,1737734561.63433,-21600,,
com.apple.finder,5,1737734483,1737734488,1737734488.753161,-21600,,
com.google.Chrome,80,1737734403,1737734483,1737734484.054043,-21600,,
com.microsoft.VSCode,33,1737734370,1737734403,1737734403.999201,-21600,,
com.google.Chrome,10,1737734360,1737734370,1737734370.3271132,-21600,,
com.microsoft.VSCode,51,1737734309,1737734360,1737734360.390346,-21600,,
com.google.Chrome,10,1737734299,1737734309,1737734309.63659,-21600,,
com.microsoft.VSCode,233,1737734066,1737734299,1737734299.800712,-21600,,
com.google.Chrome,31,1737734035,1737734066,1737734067.0299459,-21600,,
com.microsoft.VSCode,27,1737734008,1737734035,1737734035.335287,-21600,,
com.google.Chrome,2,1737734006,1737734008,1737734008.800266,-21600,,
com.microsoft.VSCode,39,1737733967,1737734006,1737734006.453479,-21600,,
com.google.Chrome,35,1737733932,1737733967,1737733967.742728,-21600,,
com.microsoft.VSCode,28,1737733904,1737733932,1737733932.942531,-21600,,
com.google.Chrome,5,1737733899,1737733904,1737733904.365038,-21600,,
com.microsoft.VSCode,0,1737733899,1737733899,1737733899.9343371,-21600,,
com.google.Chrome,5,1737733894,1737733899,1737733899.469163,-21600,,
com.microsoft.VSCode,31,1737733863,1737733894,1737733894.555114,-21600,,
com.google.Chrome,28,1737733835,1737733863,1737733863.0730438,-21600,,
com.microsoft.VSCode,3,1737733832,1737733835,1737733835.437708,-21600,,
com.google.Chrome,16,1737733816,1737733832,1737733832.2499928,-21600,,
com.microsoft.VSCode,63,1737733753,1737733816,1737733816.244916,-21600,,
com.google.Chrome,4,1737733749,1737733753,1737733753.7380772,-21600,,
com.microsoft.VSCode,6,1737733743,1737733749,1737733749.7292671,-21600,,
com.google.Chrome,7,1737733736,1737733743,1737733743.5728621,-21600,,
com.apple.finder,8,1737733728,1737733736,1737733736.6078959,-21600,,
com.microsoft.VSCode,24,1737733704,1737733728,1737733728.128293,-21600,,
com.apple.finder,40,1737733664,1737733704,1737733704.397943,-21600,,
com.microsoft.VSCode,29,1737733635,1737733664,1737733664.745915,-21600,,
com.google.Chrome,61,1737733574,1737733635,1737733635.703186,-21600,,
com.microsoft.VSCode,39,1737733535,1737733574,1737733574.500736,-21600,,
com.google.Chrome,11,1737733524,1737733535,1737733535.229272,-21600,,
com.microsoft.VSCode,9,1737733515,1737733524,1737733524.7684379,-21600,,
com.google.Chrome,30,1737733485,1737733515,1737733515.3507938,-21600,,
com.microsoft.VSCode,7,1737733478,1737733485,1737733485.104397,-21600,,
com.apple.finder,2,1737733476,1737733478,1737733478.8016958,-21600,,
com.google.Chrome,19,1737733457,1737733476,1737733477.03882,-21600,,
com.apple.finder,0,1737733457,1737733457,1737733457.855084,-21600,,
com.microsoft.VSCode,309,1737733148,1737733457,1737733457.250876,-21600,,
com.apple.finder,58,1737733090,1737733148,1737733148.3857632,-21600,,
com.google.Chrome,108,1737732982,1737733090,1737733090.8883538,-21600,,
com.microsoft.VSCode,6,1737732976,1737732982,1737732982.4024138,-21600,,
com.google.Chrome,221,1737732755,1737732976,1737732976.852154,-21600,,
com.microsoft.VSCode,14,1737732741,1737732755,1737732755.747867,-21600,,
com.google.Chrome,39,1737732702,1737732741,1737732741.1829991,-21600,,
com.apple.finder,26,1737732676,1737732702,1737732702.592891,-21600,,
com.google.Chrome,60,1737732616,1737732676,1737732676.941494,-21600,,
com.apple.systempreferences,46,1737732570,1737732616,1737732616.076838,-21600,,
com.google.Chrome,122,1737732448,1737732570,1737732570.840639,-21600,,
com.leomehlig.today,9,1737732439,1737732448,1737732451.622601,-21600,,
com.apple.camera,7,1737732253,1737732260,1737732260.9037762,-21600,EB445137-D7F5-57EC-87DA-1DB460D64046,"iPhone13,2"
com.apple.weather,2,1737732248,1737732250,1737732250.7971148,-21600,EB445137-D7F5-57EC-87DA-1DB460D64046,"iPhone13,2"
com.apple.weather,25,1737731351,1737731376,1737731377.275463,-21600,EB445137-D7F5-57EC-87DA-1DB460D64046,"iPhone13,2"
com.renpho.health,1,1737731350,1737731351,1737731351.938518,-21600,EB445137-D7F5-57EC-87DA-1DB460D64046,"iPhone13,2"
com.renpho.health,37,1737729549,1737729586,1737729586.745712,-21600,EB445137-D7F5-57EC-87DA-1DB460D64046,"iPhone13,2"
com.apple.CoreAuthUI,6,1737696905,1737696911,1737696911.2415872,-21600,EB445137-D7F5-57EC-87DA-1DB460D64046,"iPhone13,2"
com.apple.journal,374,1737696904,1737697278,1737697278.549186,-21600,EB445137-D7F5-57EC-87DA-1DB460D64046,"iPhone13,2"
com.apple.Health,42,1737696860,1737696902,1737696902.350419,-21600,EB445137-D7F5-57EC-87DA-1DB460D64046,"iPhone13,2"
com.thestorygraph.thestorygraph,26,1737696832,1737696858,1737696858.790595,-21600,EB445137-D7F5-57EC-87DA-1DB460D64046,"iPhone13,2"
com.leomehlig.today,6,1737693972,1737693978,1737693978.373347,-21600,,
com.apple.Notes,4,1737693968,1737693972,1737693972.716924,-21600,,
com.google.Chrome,301,1737693667,1737693968,1737693968.2010288,-21600,,
com.google.Chrome,482,1737693022,1737693504,1737693504.829452,-21600,,
com.google.Chrome,1242,1737691702,1737692944,1737692944.059394,-21600,,
com.google.Chrome,1256,1737690404,1737691660,1737691660.5644112,-21600,,
com.google.Chrome,491,1737689740,1737690231,1737690231.1180592,-21600,,
com.apple.news,169,1737689700,1737689869,1737689869.983757,-21600,EB445137-D7F5-57EC-87DA-1DB460D64046,"iPhone13,2"
com.apple.news,7,1737689692,1737689699,1737689699.799377,-21600,EB445137-D7F5-57EC-87DA-1DB460D64046,"iPhone13,2"
com.google.Chrome,419,1737689132,1737689551,1737689551.317638,-21600,,
com.apple.Notes,1,1737689131,1737689132,1737689132.728163,-21600,,
com.hammerandchisel.discord,43,1737689101,1737689144,1737689144.788017,-21600,EB445137-D7F5-57EC-87DA-1DB460D64046,"iPhone13,2"
com.apple.Music,2,1737689097,1737689099,1737689099.904923,-21600,EB445137-D7F5-57EC-87DA-1DB460D64046,"iPhone13,2"
com.microsoft.Office.Outlook,3,1737689094,1737689097,1737689097.801647,-21600,EB445137-D7F5-57EC-87DA-1DB460D64046,"iPhone13,2"
com.leomehlig.today,40,1737689091,1737689131,1737689131.310473,-21600,,
com.apple.Notes,3,1737689088,1737689091,1737689091.563622,-21600,,
com.apple.iCal,90,1737688998,1737689088,1737689088.3503041,-21600,,
com.apple.Notes,2,1737688993,1737688995,1737688995.415287,-21600,,
com.microsoft.Office.Outlook,57,1737688980,1737689037,1737689037.8545508,-21600,EB445137-D7F5-57EC-87DA-1DB460D64046,"iPhone13,2"
com.apple.Music,0,1737688980,1737688980,1737688981.556263,-21600,EB445137-D7F5-57EC-87DA-1DB460D64046,"iPhone13,2"
com.apple.Music,27,1737688022,1737688049,1737688050.202259,-21600,EB445137-D7F5-57EC-87DA-1DB460D64046,"iPhone13,2"
com.apple.Notes,3,1737687790,1737687793,1737687794.03158,-21600,,
com.leomehlig.today,40,1737687750,1737687790,1737687790.445393,-21600,,
com.apple.Notes,2,1737687748,1737687750,1737687750.071095,-21600,,
com.apple.Notes,11,1737686716,1737686727,1737686727.3278918,-21600,,
com.google.Chrome,81,1737686635,1737686716,1737686716.429805,-21600,,
com.apple.QuickTimePlayerX,557,1737686078,1737686635,1737686635.255436,-21600,,
com.apple.QuickTimePlayerX,312,1737685759,1737686071,1737686071.599232,-21600,,
com.apple.QuickTimePlayerX,527,1737685109,1737685636,1737685636.1100569,-21600,,
com.apple.QuickTimePlayerX,756,1737684274,1737685030,1737685031.004643,-21600,,
com.apple.finder,2,1737684221,1737684223,1737684223.640517,-21600,,
com.google.Chrome,1371,1737682850,1737684221,1737684221.206445,-21600,,
com.google.Chrome,306,1737682405,1737682711,1737682711.8817601,-21600,,
com.google.Chrome,943,1737681444,1737682387,1737682387.072546,-21600,,
com.apple.QuickTimePlayerX,23,1737681421,1737681444,1737681444.383678,-21600,,
com.apple.QuickTimePlayerX,305,1737681059,1737681364,1737681364.279686,-21600,,
com.apple.QuickTimePlayerX,783,1737679687,1737680470,1737680470.16486,-21600,,
com.apple.finder,52,1737679635,1737679687,1737679688.019856,-21600,,
com.google.Chrome,13,1737679622,1737679635,1737679635.614112,-21600,,
com.apple.QuickTimePlayerX,224,1737679398,1737679622,1737679622.902216,-21600,,
com.apple.QuickTimePlayerX,288,1737678894,1737679182,1737679182.3202128,-21600,,
com.microsoft.Office.Outlook,7,1737678811,1737678818,1737678819.0565019,-21600,EB445137-D7F5-57EC-87DA-1DB460D64046,"iPhone13,2"
com.ebay.iphone,13,1737678796,1737678809,1737678809.846904,-21600,EB445137-D7F5-57EC-87DA-1DB460D64046,"iPhone13,2"
com.myfitnesspal.mfp,46,1737678748,1737678794,1737678794.200028,-21600,EB445137-D7F5-57EC-87DA-1DB460D64046,"iPhone13,2"
com.apple.Notes,448,1737678427,1737678875,1737678875.6703482,-21600,,
com.apple.QuickTimePlayerX,2,1737678425,1737678427,1737678427.268235,-21600,,
com.apple.Notes,72,1737678353,1737678425,1737678426.062634,-21600,,
com.apple.QuickTimePlayerX,128,1737678225,1737678353,1737678353.770834,-21600,,
com.leomehlig.today,52,1737678173,1737678225,1737678225.9300442,-21600,,
com.google.Chrome,5,1737678168,1737678173,1737678173.356618,-21600,,
com.apple.finder,1,1737678167,1737678168,1737678168.943348,-21600,,
com.google.android.studio,1,1737678166,1737678167,1737678167.281064,-21600,,
com.apple.finder,9,1737678157,1737678166,1737678166.647984,-21600,,
com.google.android.studio,9,1737678148,1737678157,1737678157.533241,-21600,,
com.myfitnesspal.mfp,86,1737677376,1737677462,1737677462.66833,-21600,EB445137-D7F5-57EC-87DA-1DB460D64046,"iPhone13,2"
com.google.Gmail,4,1737677372,1737677376,1737677376.2591128,-21600,EB445137-D7F5-57EC-87DA-1DB460D64046,"iPhone13,2"
com.google.android.studio,107,1737674690,1737674797,1737674797.524297,-21600,,
com.google.Chrome,76,1737674614,1737674690,1737674691.0241032,-21600,,
com.apple.finder,2,1737674612,1737674614,1737674614.4124088,-21600,,
com.apple.QuickTimePlayerX,1,1737674611,1737674612,1737674613.022538,-21600,,
com.google.Chrome,7,1737674604,1737674611,1737674611.178051,-21600,,
com.apple.QuickTimePlayerX,2,1737674602,1737674604,1737674605.03392,-21600,,
com.apple.finder,3,1737674599,1737674602,1737674602.187598,-21600,,
com.apple.dt.Xcode,2,1737674597,1737674599,1737674599.447307,-21600,,
com.apple.finder,9,1737674588,1737674597,1737674597.2084188,-21600,,
com.google.android.studio,1,1737674587,1737674588,1737674588.7005758,-21600,,
com.apple.finder,5,1737674582,1737674587,1737674587.523614,-21600,,
com.google.android.studio,48,1737674534,1737674582,1737674583.024588,-21600,,
com.google.Chrome,542,1737673992,1737674534,1737674535.046547,-21600,,
com.apple.finder,2,1737673990,1737673992,1737673992.8336868,-21600,,
com.google.Chrome,4,1737673986,1737673990,1737673990.9404979,-21600,,
com.apple.finder,2,1737673984,1737673986,1737673986.420829,-21600,,
com.google.android.studio,28,1737673956,1737673984,1737673984.7127109,-21600,,
com.apple.finder,2,1737673954,1737673956,1737673956.7300549,-21600,,
com.google.android.studio,96,1737673858,1737673954,1737673954.934057,-21600,,
com.google.Chrome,1,1737673857,1737673858,1737673858.489688,-21600,,
com.google.android.studio,29,1737673828,1737673857,1737673857.1404428,-21600,,
com.google.Chrome,4,1737673824,1737673828,1737673828.3988519,-21600,,
com.google.android.studio,3,1737673821,1737673824,1737673824.3995461,-21600,,
com.google.Chrome,4,1737673817,1737673821,1737673821.439713,-21600,,
com.google.android.studio,11,1737673806,1737673817,1737673817.466903,-21600,,
com.google.Chrome,5,1737673801,1737673806,1737673806.81488,-21600,,
com.google.android.studio,2,1737673799,1737673801,1737673801.269351,-21600,,
com.google.Chrome,19,1737673780,1737673799,1737673799.389446,-21600,,
com.google.android.studio,24,1737673756,1737673780,1737673780.601933,-21600,,
com.google.Chrome,1,1737673755,1737673756,1737673756.120683,-21600,,
com.google.android.studio,1,1737673754,1737673755,1737673755.134431,-21600,,
com.google.Chrome,5,1737673749,1737673754,1737673754.056004,-21600,,
com.google.android.studio,6,1737673743,1737673749,1737673750.000746,-21600,,
com.google.Chrome,6,1737673737,1737673743,1737673743.434164,-21600,,
com.google.android.studio,10,1737673727,1737673737,1737673737.822756,-21600,,
com.google.Chrome,23,1737673704,1737673727,1737673727.555849,-21600,,
com.google.android.studio,15,1737673689,1737673704,1737673704.430805,-21600,,
com.google.Chrome,12,1737673677,1737673689,1737673689.9275742,-21600,,
com.google.android.studio,16,1737673661,1737673677,1737673677.348713,-21600,,
com.google.Chrome,3,1737673658,1737673661,1737673661.465847,-21600,,
com.google.android.studio,4,1737673654,1737673658,1737673658.118711,-21600,,
com.google.Chrome,3,1737673651,1737673654,1737673654.6866632,-21600,,
com.google.android.studio,7,1737673644,1737673651,1737673651.0946069,-21600,,
com.google.Chrome,2,1737673642,1737673644,1737673644.765104,-21600,,
com.google.android.studio,16,1737673626,1737673642,1737673642.409357,-21600,,
com.google.Chrome,3,1737673623,1737673626,1737673626.521194,-21600,,
com.google.android.studio,5,1737673618,1737673623,1737673623.06687,-21600,,
com.google.Chrome,3,1737673615,1737673618,1737673618.444014,-21600,,
com.google.android.studio,5,1737673610,1737673615,1737673615.4190068,-21600,,
com.google.Chrome,4,1737673606,1737673610,1737673610.716658,-21600,,
com.google.android.studio,18,1737673588,1737673606,1737673606.850387,-21600,,
com.google.Chrome,69,1737673519,1737673588,1737673588.618112,-21600,,
com.google.android.studio,112,1737673407,1737673519,1737673519.858249,-21600,,
com.apple.finder,8,1737673333,1737673341,1737673341.329484,-21600,,
com.google.android.studio,9,1737673324,1737673333,1737673333.1542602,-21600,,
com.google.Chrome,3,1737673321,1737673324,1737673324.298774,-21600,,
com.google.android.studio,21,1737673300,1737673321,1737673321.643495,-21600,,
com.apple.dt.Xcode,39,1737673261,1737673300,1737673300.630003,-21600,,
com.google.android.studio,43,1737673218,1737673261,1737673261.570483,-21600,,
com.apple.finder,2,1737673216,1737673218,1737673218.85238,-21600,,
com.google.Chrome,89,1737673127,1737673216,1737673216.605535,-21600,,
com.apple.finder,1,1737673126,1737673127,1737673127.9856,-21600,,
com.google.Chrome,2,1737673124,1737673126,1737673126.119643,-21600,,
com.apple.finder,3,1737673121,1737673124,1737673124.814877,-21600,,
com.google.android.studio,2,1737673119,1737673121,1737673121.553134,-21600,,
com.apple.finder,3,1737673116,1737673119,1737673119.324679,-21600,,
com.google.android.studio,85,1737673031,1737673116,1737673116.525226,-21600,,
com.apple.finder,4,1737673027,1737673031,1737673031.975483,-21600,,
com.google.android.studio,57,1737672970,1737673027,1737673027.807581,-21600,,
com.apple.finder,5,1737672965,1737672970,1737672970.408278,-21600,,
com.google.Chrome,42,1737672923,1737672965,1737672965.786036,-21600,,
com.apple.finder,1,1737672922,1737672923,1737672924.013804,-21600,,
com.google.Chrome,2,1737672920,1737672922,1737672922.654793,-21600,,
com.apple.finder,2,1737672918,1737672920,1737672920.6204228,-21600,,
com.google.android.studio,4,1737672914,1737672918,1737672918.913789,-21600,,
com.apple.finder,4,1737672910,1737672914,1737672914.928917,-21600,,
com.google.android.studio,24,1737672886,1737672910,1737672910.430814,-21600,,
com.apple.finder,14,1737672872,1737672886,1737672886.444326,-21600,,
com.google.Chrome,37,1737672835,1737672872,1737672872.283708,-21600,,
com.apple.finder,2,1737672833,1737672835,1737672836.0005999,-21600,,
com.google.Chrome,3,1737672830,1737672833,1737672833.678063,-21600,,
com.apple.finder,28,1737672802,1737672830,1737672830.74932,-21600,,
com.google.android.studio,15,1737672787,1737672802,1737672802.861912,-21600,,
com.google.Chrome,4,1737672783,1737672787,1737672787.3382459,-21600,,
com.google.android.studio,13,1737672770,1737672783,1737672783.923753,-21600,,
com.google.Chrome,1,1737672769,1737672770,1737672770.087383,-21600,,
com.google.android.studio,3,1737672766,1737672769,1737672769.3528,-21600,,
com.google.Chrome,3,1737672763,1737672766,1737672766.187722,-21600,,
com.google.android.studio,2,1737672761,1737672763,1737672763.1608748,-21600,,
com.google.Chrome,2,1737672759,1737672761,1737672761.384084,-21600,,
com.google.android.studio,14,1737672745,1737672759,1737672759.444932,-21600,,
com.google.Chrome,5,1737672740,1737672745,1737672745.6685162,-21600,,
com.google.android.studio,3,1737672737,1737672740,1737672740.3079839,-21600,,
com.google.Chrome,6,1737672731,1737672737,1737672737.088409,-21600,,
com.google.android.studio,7,1737672724,1737672731,1737672731.6360068,-21600,,
com.google.Chrome,8,1737672716,1737672724,1737672724.4006839,-21600,,
com.google.android.studio,107,1737672609,1737672716,1737672716.081244,-21600,,
com.google.Chrome,2,1737672607,1737672609,1737672610.002424,-21600,,
com.google.android.studio,3,1737672604,1737672607,1737672607.197154,-21600,,
com.apple.Passwords,24,1737672580,1737672604,1737672604.962436,-21600,,
com.google.android.studio,28,1737672552,1737672580,1737672580.111927,-21600,,
com.google.Chrome,1,1737672551,1737672552,1737672552.9385018,-21600,,
com.google.android.studio,11,1737672540,1737672551,1737672551.764824,-21600,,
com.google.Chrome,23,1737672517,1737672540,1737672540.81874,-21600,,
com.google.android.studio,5,1737672512,1737672517,1737672517.855599,-21600,,
com.google.Chrome,58,1737672454,1737672512,1737672512.9306111,-21600,,
com.google.android.studio,126,1737672328,1737672454,1737672454.454256,-21600,,
com.google.Chrome,41,1737672287,1737672328,1737672328.8319411,-21600,,
com.apple.finder,3,1737672284,1737672287,1737672287.707089,-21600,,
com.google.Chrome,2,1737672282,1737672284,1737672284.78527,-21600,,
com.apple.finder,2,1737672280,1737672282,1737672282.8419518,-21600,,
com.google.android.studio,9,1737672271,1737672280,1737672280.662792,-21600,,
com.apple.finder,6,1737672265,1737672271,1737672271.478179,-21600,,
com.google.android.studio,39,1737672226,1737672265,1737672265.8519611,-21600,,
com.google.Chrome,1,1737672225,1737672226,1737672226.6437302,-21600,,
com.google.android.studio,23,1737672202,1737672225,1737672225.079152,-21600,,
com.google.Chrome,266,1737671936,1737672202,1737672202.97507,-21600,,
com.google.Chrome,300,1737671621,1737671921,1737671921.683702,-21600,,
com.google.Gmail,81,1737671557,1737671638,1737671638.331608,-21600,EB445137-D7F5-57EC-87DA-1DB460D64046,"iPhone13,2"
com.apple.news,1,1737671556,1737671557,1737671557.684015,-21600,EB445137-D7F5-57EC-87DA-1DB460D64046,"iPhone13,2"
com.apple.Passwords,109,1737671512,1737671621,1737671621.706647,-21600,,
com.google.Chrome,179,1737671333,1737671512,1737671512.0750241,-21600,,
com.apple.Photos,194,1737671139,1737671333,1737671333.328957,-21600,,
com.google.Chrome,3,1737671136,1737671139,1737671139.048784,-21600,,
com.apple.news,457,1737669144,1737669601,1737669601.985291,-21600,EB445137-D7F5-57EC-87DA-1DB460D64046,"iPhone13,2"
com.ebay.iphone,35,1737669086,1737669121,1737669121.999807,-21600,EB445137-D7F5-57EC-87DA-1DB460D64046,"iPhone13,2"
com.google.chrome.ios,1,1737669085,1737669086,1737669086.480135,-21600,EB445137-D7F5-57EC-87DA-1DB460D64046,"iPhone13,2"
com.google.chrome.ios,38,1737669023,1737669061,1737669061.7529821,-21600,EB445137-D7F5-57EC-87DA-1DB460D64046,"iPhone13,2"
com.apple.CoreAuthUI,2,1737668947,1737668949,1737668949.581578,-21600,EB445137-D7F5-57EC-87DA-1DB460D64046,"iPhone13,2"
com.google.chrome.ios,70,1737668923,1737668993,1737668993.706403,-21600,EB445137-D7F5-57EC-87DA-1DB460D64046,"iPhone13,2"
com.google.chrome.ios,2,1737668819,1737668821,1737668821.521593,-21600,EB445137-D7F5-57EC-87DA-1DB460D64046,"iPhone13,2"
com.google.Chrome,258,1737667810,1737668068,1737668068.280467,-21600,,
com.apple.QuickTimePlayerX,178,1737667632,1737667810,1737667810.405439,-21600,,
com.apple.QuickTimePlayerX,602,1737666888,1737667490,1737667490.648654,-21600,,
com.apple.QuickTimePlayerX,1187,1737665621,1737666808,1737666808.2206721,-21600,,
com.google.Chrome,1248,1737664373,1737665621,1737665621.362282,-21600,,
com.google.Chrome,309,1737663467,1737663776,1737663776.285218,-21600,,
com.leomehlig.today,66,1737663401,1737663467,1737663467.9102778,-21600,,
com.google.Chrome,27,1737663374,1737663401,1737663402.0041552,-21600,,
com.apple.CoreAuthUI,2,1737663194,1737663196,1737663196.397142,-21600,EB445137-D7F5-57EC-87DA-1DB460D64046,"iPhone13,2"
com.google.chrome.ios,29,1737663186,1737663215,1737663216.281914,-21600,EB445137-D7F5-57EC-87DA-1DB460D64046,"iPhone13,2"
com.apple.camera,3,1737663183,1737663186,1737663186.960092,-21600,EB445137-D7F5-57EC-87DA-1DB460D64046,"iPhone13,2"
edu.illinois.rokwire.ios,102,1737663076,1737663178,1737663178.173271,-21600,EB445137-D7F5-57EC-87DA-1DB460D64046,"iPhone13,2"
com.google.Chrome,345,1737662872,1737663217,1737663217.629072,-21600,,
com.leomehlig.today,5,1737662842,1737662847,1737662848.05084,-21600,,
com.tinyspeck.chatlyio,25,1737662784,1737662809,1737662809.903439,-21600,EB445137-D7F5-57EC-87DA-1DB460D64046,"iPhone13,2"
com.ebay.iphone,4,1737660024,1737660028,1737660029.096204,-21600,EB445137-D7F5-57EC-87DA-1DB460D64046,"iPhone13,2"
com.apple.Health,55,1737659108,1737659163,1737659163.4242802,-21600,EB445137-D7F5-57EC-87DA-1DB460D64046,"iPhone13,2"
com.ebay.iphone,21,1737659084,1737659105,1737659105.095448,-21600,EB445137-D7F5-57EC-87DA-1DB460D64046,"iPhone13,2"
com.tinyspeck.chatlyio,2,1737659082,1737659084,1737659084.2239451,-21600,EB445137-D7F5-57EC-87DA-1DB460D64046,"iPhone13,2"
com.myfitnesspal.mfp,2,1737659080,1737659082,1737659082.4963942,-21600,EB445137-D7F5-57EC-87DA-1DB460D64046,"iPhone13,2"
com.myfitnesspal.mfp,45,1737657967,1737658012,1737658012.336001,-21600,EB445137-D7F5-57EC-87DA-1DB460D64046,"iPhone13,2"
com.apple.Music,1,1737657962,1737657963,1737657964.0659099,-21600,EB445137-D7F5-57EC-87DA-1DB460D64046,"iPhone13,2"
com.apple.Music,25,1737657388,1737657413,1737657413.723625,-21600,EB445137-D7F5-57EC-87DA-1DB460D64046,"iPhone13,2"
com.apple.weather,3,1737657384,1737657387,1737657387.298456,-21600,EB445137-D7F5-57EC-87DA-1DB460D64046,"iPhone13,2"
com.apple.weather,4,1737656489,1737656493,1737656493.757402,-21600,EB445137-D7F5-57EC-87DA-1DB460D64046,"iPhone13,2"
com.leomehlig.today,161,1737656229,1737656390,1737656390.636195,-21600,,
com.google.ios.youtube,612,1737655145,1737655757,1737655757.4544759,-21600,EB445137-D7F5-57EC-87DA-1DB460D64046,"iPhone13,2"
com.tinyspeck.chatlyio,51,1737655092,1737655143,1737655144.265986,-21600,EB445137-D7F5-57EC-87DA-1DB460D64046,"iPhone13,2"
com.microsoft.Office.Outlook,98,1737654992,1737655090,1737655090.895509,-21600,EB445137-D7F5-57EC-87DA-1DB460D64046,"iPhone13,2"
com.apple.journal,1,1737654983,1737654984,1737654984.979254,-21600,EB445137-D7F5-57EC-87DA-1DB460D64046,"iPhone13,2"
com.apple.mobilenotes,0,1737654983,1737654983,1737654983.6514292,-21600,EB445137-D7F5-57EC-87DA-1DB460D64046,"iPhone13,2"
com.apple.mobilenotes,14,1737653912,1737653926,1737653926.702405,-21600,EB445137-D7F5-57EC-87DA-1DB460D64046,"iPhone13,2"
com.apple.mobileslideshow,2,1737653908,1737653910,1737653910.150525,-21600,EB445137-D7F5-57EC-87DA-1DB460D64046,"iPhone13,2"
com.leomehlig.today,22,1737652849,1737652871,1737652871.910687,-21600,,
com.apple.Preview,20,1737652829,1737652849,1737652849.7170238,-21600,,
com.apple.finder,25,1737652804,1737652829,1737652829.474325,-21600,,
com.apple.Preview,2351,1737650453,1737652804,1737652804.848445,-21600,,
com.apple.finder,112,1737650341,1737650453,1737650453.88593,-21600,,
com.google.Chrome,2,1737650339,1737650341,1737650341.922995,-21600,,
com.leomehlig.today,20,1737650319,1737650339,1737650339.4516659,-21600,,
com.google.Chrome,10,1737650309,1737650319,1737650319.7604098,-21600,,
com.leomehlig.today,49,1737650260,1737650309,1737650309.9497929,-21600,,
com.apple.mobileslideshow,75,1737649037,1737649112,1737649112.91928,-21600,EB445137-D7F5-57EC-87DA-1DB460D64046,"iPhone13,2"
com.apple.mobileslideshow,166,1737648728,1737648894,1737648894.622376,-21600,EB445137-D7F5-57EC-87DA-1DB460D64046,"iPhone13,2"
com.google.Chrome,1669,1737648591,1737650260,1737650260.680986,-21600,,
com.leomehlig.today,37,1737648554,1737648591,1737648591.919008,-21600,,
com.google.Chrome,322,1737648232,1737648554,1737648554.8221931,-21600,,
com.apple.mail,1,1737648231,1737648232,1737648232.750608,-21600,,
com.google.Chrome,1,1737648230,1737648231,1737648231.3640819,-21600,,
com.apple.mail,2,1737648228,1737648230,1737648230.543448,-21600,,
com.apple.mobileslideshow,686,1737647850,1737648536,1737648537.047977,-21600,EB445137-D7F5-57EC-87DA-1DB460D64046,"iPhone13,2"
com.apple.mobilephone,2,1737647848,1737647850,1737647850.189237,-21600,EB445137-D7F5-57EC-87DA-1DB460D64046,"iPhone13,2"
com.apple.weather,4,1737647842,1737647846,1737647846.547346,-21600,EB445137-D7F5-57EC-87DA-1DB460D64046,"iPhone13,2"
com.google.Chrome,1405,1737646823,1737648228,1737648229.019645,-21600,,
com.apple.mail,3,1737646820,1737646823,1737646823.426108,-21600,,
com.google.Chrome,1534,1737645286,1737646820,1737646821.005385,-21600,,
com.apple.Passwords,8,1737645278,1737645286,1737645286.8566818,-21600,,
com.google.Chrome,21,1737645257,1737645278,1737645278.9711552,-21600,,
com.leomehlig.today,9,1737645248,1737645257,1737645257.31433,-21600,,
com.apple.finder,12,1737645236,1737645248,1737645248.2075891,-21600,,
com.apple.weather,11,1737643543,1737643554,1737643554.369051,-21600,EB445137-D7F5-57EC-87DA-1DB460D64046,"iPhone13,2"
com.renpho.health,2,1737643541,1737643543,1737643543.188929,-21600,EB445137-D7F5-57EC-87DA-1DB460D64046,"iPhone13,2"
com.renpho.health,39,1737643128,1737643167,1737643167.46279,-21600,EB445137-D7F5-57EC-87DA-1DB460D64046,"iPhone13,2"
com.apple.Health,4,1737643124,1737643128,1737643128.140818,-21600,EB445137-D7F5-57EC-87DA-1DB460D64046,"iPhone13,2"
com.apple.Health,19,1737642143,1737642162,1737642162.270934,-21600,EB445137-D7F5-57EC-87DA-1DB460D64046,"iPhone13,2"
com.ebay.iphone,37,1737642085,1737642122,1737642122.366055,-21600,EB445137-D7F5-57EC-87DA-1DB460D64046,"iPhone13,2"
com.apple.CoreAuthUI,2,1737609852,1737609854,1737609854.950496,-21600,EB445137-D7F5-57EC-87DA-1DB460D64046,"iPhone13,2"
com.apple.journal,785,1737609850,1737610635,1737610635.591926,-21600,EB445137-D7F5-57EC-87DA-1DB460D64046,"iPhone13,2"
com.thestorygraph.thestorygraph,14,1737609826,1737609840,1737609840.613195,-21600,EB445137-D7F5-57EC-87DA-1DB460D64046,"iPhone13,2"
com.apple.finder,2,1737606695,1737606697,1737606697.619649,-21600,,
com.leomehlig.today,7,1737606688,1737606695,1737606695.094481,-21600,,
com.microsoft.Excel,151,1737606537,1737606688,1737606689.0005531,-21600,,
com.leomehlig.today,93,1737606444,1737606537,1737606537.49517,-21600,,
com.google.Chrome,553,1737605891,1737606444,1737606445.003892,-21600,,
com.apple.Health,105,1737605416,1737605521,1737605521.332924,-21600,EB445137-D7F5-57EC-87DA-1DB460D64046,"iPhone13,2"
com.google.Chrome,319,1737605113,1737605432,1737605432.303271,-21600,,
com.apple.Music,168,1737604945,1737605113,1737605113.029798,-21600,,
com.google.Chrome,50,1737604895,1737604945,1737604945.946145,-21600,,
com.apple.Music,15,1737604880,1737604895,1737604895.8422132,-21600,,
com.google.Chrome,3,1737604877,1737604880,1737604880.5327559,-21600,,
com.apple.news,41,1737603846,1737603887,1737603887.246793,-21600,EB445137-D7F5-57EC-87DA-1DB460D64046,"iPhone13,2"
com.apple.Music,2,1737603829,1737603831,1737603831.953178,-21600,EB445137-D7F5-57EC-87DA-1DB460D64046,"iPhone13,2"
com.google.Chrome,841,1737603530,1737604371,1737604371.581334,-21600,,
com.leomehlig.today,27,1737603503,1737603530,1737603530.0962281,-21600,,
com.microsoft.Excel,7,1737603496,1737603503,1737603503.118916,-21600,,
com.leomehlig.today,3,1737603493,1737603496,1737603496.7891579,-21600,,
com.microsoft.Excel,1,1737603492,1737603493,1737603493.832508,-21600,,
com.leomehlig.today,4,1737603488,1737603492,1737603492.786119,-21600,,
com.microsoft.Excel,6,1737603482,1737603488,1737603488.506094,-21600,,
com.leomehlig.today,11,1737603471,1737603482,1737603482.629435,-21600,,
com.microsoft.Excel,388,1737603083,1737603471,1737603471.950395,-21600,,
com.apple.finder,5,1737603078,1737603083,1737603083.30684,-21600,,
com.apple.Photos,23,1737603055,1737603078,1737603078.194797,-21600,,
com.google.Chrome,4,1737603051,1737603055,1737603055.6687279,-21600,,
com.google.Chrome,756,1737602180,1737602936,1737602936.204153,-21600,,
com.leomehlig.today,18,1737602162,1737602180,1737602180.565439,-21600,,
com.apple.finder,2,1737602160,1737602162,1737602162.405614,-21600,,
com.apple.Music,5,1737602155,1737602160,1737602160.7733722,-21600,,
com.apple.Music,54,1737600797,1737600851,1737600851.4109,-21600,EB445137-D7F5-57EC-87DA-1DB460D64046,"iPhone13,2"
com.apple.Music,30,1737600744,1737600774,1737600774.439777,-21600,,
com.google.Chrome,3,1737600741,1737600744,1737600744.300545,-21600,,
com.apple.MobileSMS,16,1737600584,1737600600,1737600600.9665952,-21600,EB445137-D7F5-57EC-87DA-1DB460D64046,"iPhone13,2"
com.hammerandchisel.discord,30,1737600554,1737600584,1737600584.962853,-21600,EB445137-D7F5-57EC-87DA-1DB460D64046,"iPhone13,2"
com.apple.MobileSMS,17,1737600511,1737600528,1737600528.531911,-21600,EB445137-D7F5-57EC-87DA-1DB460D64046,"iPhone13,2"
com.apple.AppStore,1,1737600507,1737600508,1737600509.0220861,-21600,EB445137-D7F5-57EC-87DA-1DB460D64046,"iPhone13,2"
com.google.Chrome,7,1737599736,1737599743,1737599743.366998,-21600,,
com.leomehlig.today,132,1737599604,1737599736,1737599736.871673,-21600,,
com.google.Chrome,2,1737599602,1737599604,1737599604.9381418,-21600,,
com.apple.finder,10,1737599592,1737599602,1737599602.071198,-21600,,
com.google.Chrome,2,1737599590,1737599592,1737599592.982493,-21600,,
com.apple.finder,1,1737599589,1737599590,1737599590.516386,-21600,,
com.google.Chrome,5,1737599584,1737599589,1737599589.083648,-21600,,
com.apple.finder,26,1737599558,1737599584,1737599585.014195,-21600,,
com.google.Chrome,52,1737599506,1737599558,1737599558.407892,-21600,,
com.apple.Notes,2,1737599466,1737599468,1737599468.981772,-21600,,
com.apple.Preview,1,1737599465,1737599466,1737599466.916428,-21600,,
com.apple.Notes,2,1737599463,1737599465,1737599465.743752,-21600,,
com.leomehlig.today,15,1737599448,1737599463,1737599463.468439,-21600,,
com.google.Chrome,202,1737599246,1737599448,1737599448.872047,-21600,,
com.cisco.secureclient.gui,4,1737598703,1737598707,1737598707.658181,-21600,,
com.google.Chrome,304,1737598170,1737598474,1737598474.02476,-21600,,
com.google.Chrome,141,1737597945,1737598086,1737598086.627109,-21600,,
com.google.Chrome,1485,1737596235,1737597720,1737597720.391192,-21600,,
com.apple.AppStore,32,1737595849,1737595881,1737595881.2560139,-21600,EB445137-D7F5-57EC-87DA-1DB460D64046,"iPhone13,2"
com.google.Chrome,496,1737595726,1737596222,1737596222.4139462,-21600,,
com.leomehlig.today,70,1737595656,1737595726,1737595726.6715832,-21600,,
com.myfitnesspal.mfp,8,1737595625,1737595633,1737595633.789248,-21600,EB445137-D7F5-57EC-87DA-1DB460D64046,"iPhone13,2"
com.myfitnesspal.mfp,2,1737595622,1737595624,1737595624.6465511,-21600,EB445137-D7F5-57EC-87DA-1DB460D64046,"iPhone13,2"
com.google.Chrome,113,1737595543,1737595656,1737595656.4335651,-21600,,
com.apple.Terminal,17,1737595526,1737595543,1737595543.728373,-21600,,
com.google.Chrome,1265,1737594261,1737595526,1737595526.735071,-21600,,
com.microsoft.rdc.macos,11,1737594250,1737594261,1737594261.097876,-21600,,
com.apple.Terminal,22,1737594228,1737594250,1737594250.8862429,-21600,,
com.cisco.secureclient.gui,2,1737594226,1737594228,1737594228.269134,-21600,,
com.apple.Terminal,11,1737594215,1737594226,1737594226.643427,-21600,,
com.google.Chrome,18,1737594197,1737594215,1737594216.0356688,-21600,,
com.apple.Terminal,38,1737594159,1737594197,1737594197.5221,-21600,,
com.google.Chrome,6,1737594153,1737594159,1737594159.622565,-21600,,
com.cisco.secureclient.gui,41,1737594112,1737594153,1737594153.79089,-21600,,
com.google.Chrome,19,1737594093,1737594112,1737594112.851275,-21600,,
com.google.Chrome,542,1737593484,1737594026,1737594026.591247,-21600,,
com.myfitnesspal.mfp,13,1737593310,1737593323,1737593324.075367,-21600,EB445137-D7F5-57EC-87DA-1DB460D64046,"iPhone13,2"
com.myfitnesspal.mfp,30,1737592717,1737592747,1737592747.817614,-21600,EB445137-D7F5-57EC-87DA-1DB460D64046,"iPhone13,2"
com.google.Chrome,867,1737592497,1737593364,1737593364.072751,-21600,,
com.leomehlig.today,16,1737592481,1737592497,1737592497.1364598,-21600,,
com.google.Chrome,772,1737591709,1737592481,1737592481.886497,-21600,,
com.google.Maps,72,1737590593,1737590665,1737590665.548955,-21600,EB445137-D7F5-57EC-87DA-1DB460D64046,"iPhone13,2"
com.apple.Maps,4,1737590585,1737590589,1737590589.673233,-21600,EB445137-D7F5-57EC-87DA-1DB460D64046,"iPhone13,2"
com.apple.news,71,1737590369,1737590440,1737590440.848658,-21600,EB445137-D7F5-57EC-87DA-1DB460D64046,"iPhone13,2"
com.apple.Music,22,1737590340,1737590362,1737590362.467437,-21600,EB445137-D7F5-57EC-87DA-1DB460D64046,"iPhone13,2"
com.truebill.truebillnative,2,1737590336,1737590338,1737590338.443722,-21600,EB445137-D7F5-57EC-87DA-1DB460D64046,"iPhone13,2"
com.apple.CoreAuthUI,2,1737590077,1737590079,1737590079.563088,-21600,EB445137-D7F5-57EC-87DA-1DB460D64046,"iPhone13,2"
com.truebill.truebillnative,68,1737590074,1737590142,1737590143.136138,-21600,EB445137-D7F5-57EC-87DA-1DB460D64046,"iPhone13,2"
com.apple.findmy,5,1737590067,1737590072,1737590073.111594,-21600,EB445137-D7F5-57EC-87DA-1DB460D64046,"iPhone13,2"
com.apple.MobileSMS,8,1737590057,1737590065,1737590065.691142,-21600,EB445137-D7F5-57EC-87DA-1DB460D64046,"iPhone13,2"
com.apple.findmy,10,1737590047,1737590057,1737590057.926928,-21600,EB445137-D7F5-57EC-87DA-1DB460D64046,"iPhone13,2"
com.apple.MobileSMS,2,1737590043,1737590045,1737590045.817466,-21600,EB445137-D7F5-57EC-87DA-1DB460D64046,"iPhone13,2"
com.apple.findmy,4,1737590039,1737590043,1737590044.0376148,-21600,EB445137-D7F5-57EC-87DA-1DB460D64046,"iPhone13,2"
com.apple.MobileSMS,2,1737590030,1737590032,1737590033.057976,-21600,EB445137-D7F5-57EC-87DA-1DB460D64046,"iPhone13,2"
com.apple.news,51,1737589909,1737589960,1737589960.9779139,-21600,EB445137-D7F5-57EC-87DA-1DB460D64046,"iPhone13,2"
com.ebay.iphone,15,1737589886,1737589901,1737589901.8724542,-21600,EB445137-D7F5-57EC-87DA-1DB460D64046,"iPhone13,2"
com.google.chrome.ios,33,1737589853,1737589886,1737589886.3368912,-21600,EB445137-D7F5-57EC-87DA-1DB460D64046,"iPhone13,2"
com.ebay.iphone,13,1737589840,1737589853,1737589853.3992748,-21600,EB445137-D7F5-57EC-87DA-1DB460D64046,"iPhone13,2"
com.microsoft.Office.Outlook,8,1737589831,1737589839,1737589839.859215,-21600,EB445137-D7F5-57EC-87DA-1DB460D64046,"iPhone13,2"
com.apple.MobileSMS,60,1737589771,1737589831,1737589831.134798,-21600,EB445137-D7F5-57EC-87DA-1DB460D64046,"iPhone13,2"
com.google.chrome.ios,0,1737589771,1737589771,1737589771.97598,-21600,EB445137-D7F5-57EC-87DA-1DB460D64046,"iPhone13,2"
com.google.chrome.ios,18,1737589301,1737589319,1737589319.35619,-21600,EB445137-D7F5-57EC-87DA-1DB460D64046,"iPhone13,2"
com.myfitnesspal.mfp,2,1737589299,1737589301,1737589301.220786,-21600,EB445137-D7F5-57EC-87DA-1DB460D64046,"iPhone13,2"
com.myfitnesspal.mfp,199,1737587867,1737588066,1737588067.2298598,-21600,EB445137-D7F5-57EC-87DA-1DB460D64046,"iPhone13,2"
com.myfitnesspal.mfp,10,1737587727,1737587737,1737587737.7109509,-21600,EB445137-D7F5-57EC-87DA-1DB460D64046,"iPhone13,2"
com.myfitnesspal.mfp,161,1737587383,1737587544,1737587544.9831429,-21600,EB445137-D7F5-57EC-87DA-1DB460D64046,"iPhone13,2"
com.google.Chrome,954,1737587065,1737588019,1737588019.0302901,-21600,,
com.leomehlig.today,9,1737587056,1737587065,1737587065.1471639,-21600,,
com.microsoft.Office.Outlook,5,1737586983,1737586988,1737586989.004647,-21600,EB445137-D7F5-57EC-87DA-1DB460D64046,"iPhone13,2"
com.toyopagroup.picaboo,3,1737586979,1737586982,1737586982.149129,-21600,EB445137-D7F5-57EC-87DA-1DB460D64046,"iPhone13,2"
com.ebay.iphone,0,1737586979,1737586979,1737586979.956339,-21600,EB445137-D7F5-57EC-87DA-1DB460D64046,"iPhone13,2"
com.leomehlig.today,26,1737586450,1737586476,1737586477.047446,-21600,,
com.google.Chrome,14,1737586436,1737586450,1737586450.385771,-21600,,
com.apple.finder,34,1737586402,1737586436,1737586436.3658319,-21600,,
com.apple.Preview,60,1737586342,1737586402,1737586402.349817,-21600,,
com.apple.finder,5,1737586288,1737586293,1737586293.6274362,-21600,,
com.google.Chrome,72,1737586216,1737586288,1737586288.599345,-21600,,
com.apple.Passwords,7,1737586209,1737586216,1737586216.247507,-21600,,
com.google.Chrome,2,1737586207,1737586209,1737586209.719064,-21600,,
com.apple.finder,18,1737586182,1737586200,1737586200.2467952,-21600,,
com.google.Chrome,37,1737586145,1737586182,1737586182.2336411,-21600,,
com.apple.finder,35,1737586110,1737586145,1737586145.503557,-21600,,
com.google.Chrome,11,1737586099,1737586110,1737586110.118007,-21600,,
com.apple.finder,16,1737586050,1737586066,1737586066.4993439,-21600,,
com.google.Chrome,86,1737585964,1737586050,1737586050.88944,-21600,,
com.apple.finder,55,1737585909,1737585964,1737585964.759908,-21600,,
com.apple.archiveutility,1,1737585908,1737585909,1737585909.526016,-21600,,
com.apple.finder,18,1737585890,1737585908,1737585908.879734,-21600,,
com.google.Chrome,32,1737585858,1737585890,1737585890.9753098,-21600,,
com.leomehlig.today,8,1737585850,1737585858,1737585858.623533,-21600,,
com.google.Chrome,393,1737585457,1737585850,1737585850.917426,-21600,,
com.apple.finder,55,1737585402,1737585457,1737585457.9460979,-21600,,
com.google.Chrome,10,1737585392,1737585402,1737585402.0764709,-21600,,
com.leomehlig.today,2,1737585390,1737585392,1737585393.054158,-21600,,
com.google.Chrome,27,1737585363,1737585390,1737585390.669378,-21600,,
com.apple.finder,3,1737585360,1737585363,1737585363.132032,-21600,,
com.leomehlig.today,26,1737585334,1737585360,1737585360.789909,-21600,,
com.apple.Notes,11,1737585323,1737585334,1737585334.701973,-21600,,
com.google.Chrome,12,1737585311,1737585323,1737585324.0194879,-21600,,
com.apple.systempreferences,19,1737585292,1737585311,1737585311.872911,-21600,,
com.google.Chrome,116,1737585176,1737585292,1737585292.290813,-21600,,
com.apple.finder,21,1737585155,1737585176,1737585176.6090732,-21600,,
com.apple.Preview,17,1737585138,1737585155,1737585155.741329,-21600,,
com.apple.finder,8,1737585130,1737585138,1737585138.158041,-21600,,
com.apple.archiveutility,3,1737585127,1737585130,1737585130.3931298,-21600,,
com.apple.finder,8,1737585119,1737585127,1737585127.926552,-21600,,
com.apple.archiveutility,3,1737585116,1737585119,1737585119.204808,-21600,,
com.google.Chrome,26,1737585090,1737585116,1737585116.379482,-21600,,
com.apple.archiveutility,6,1737585084,1737585090,1737585090.1015701,-21600,,
com.google.Chrome,38,1737585046,1737585084,1737585084.201702,-21600,,
com.apple.archiveutility,8,1737585038,1737585046,1737585046.772448,-21600,,
com.apple.finder,14,1737585024,1737585038,1737585038.441131,-21600,,
com.google.Chrome,31,1737584993,1737585024,1737585024.3487,-21600,,
com.apple.finder,2,1737584991,1737584993,1737584993.8688788,-21600,,
com.apple.archiveutility,3,1737584988,1737584991,1737584991.569679,-21600,,
com.apple.finder,2,1737584986,1737584988,1737584988.049895,-21600,,
com.apple.archiveutility,3,1737584983,1737584986,1737584986.552908,-21600,,
com.apple.finder,13,1737584970,1737584983,1737584983.942565,-21600,,
com.google.Chrome,372,1737584598,1737584970,1737584971.047888,-21600,,
com.apple.Notes,28,1737584570,1737584598,1737584598.189077,-21600,,
com.google.Chrome,245,1737584325,1737584570,1737584570.2716188,-21600,,
com.leomehlig.today,1,1737584195,1737584196,1737584196.532089,-21600,,
com.apple.Notes,39,1737584156,1737584195,1737584195.713249,-21600,,
com.leomehlig.today,7,1737584149,1737584156,1737584156.492116,-21600,,
com.google.Chrome,83,1737584066,1737584149,1737584149.390462,-21600,,
com.leomehlig.today,1,1737584065,1737584066,1737584066.918981,-21600,,
com.apple.Notes,19,1737584046,1737584065,1737584065.540983,-21600,,
com.leomehlig.today,19,1737584027,1737584046,1737584046.4388099,-21600,,
com.google.Chrome,104,1737583923,1737584027,1737584027.741219,-21600,,
com.leomehlig.today,24,1737583899,1737583923,1737583923.947898,-21600,,
com.apple.iCal,10,1737583889,1737583899,1737583899.7842069,-21600,,
com.google.Chrome,135,1737583754,1737583889,1737583889.123606,-21600,,
com.leomehlig.today,3,1737583751,1737583754,1737583755.053992,-21600,,
com.google.Chrome,76,1737583675,1737583751,1737583751.991499,-21600,,
com.leomehlig.today,7,1737583515,1737583522,1737583522.9713001,-21600,,
com.google.Chrome,18,1737583497,1737583515,1737583515.853395,-21600,,
com.leomehlig.today,22,1737583475,1737583497,1737583497.315813,-21600,,
com.google.Chrome,29,1737583446,1737583475,1737583475.092834,-21600,,
com.apple.finder,2,1737583444,1737583446,1737583446.639955,-21600,,
com.google.Chrome,5,1737583439,1737583444,1737583444.5062408,-21600,,
com.apple.finder,8,1737583431,1737583439,1737583439.2989411,-21600,,
com.google.Chrome,1,1737583430,1737583431,1737583431.128882,-21600,,
com.apple.finder,1,1737583429,1737583430,1737583430.14769,-21600,,
com.google.Chrome,5,1737583424,1737583429,1737583429.272912,-21600,,
com.apple.Notes,12,1737583412,1737583424,1737583424.467941,-21600,,
com.google.Chrome,4,1737583408,1737583412,1737583412.727561,-21600,,
com.apple.Notes,7,1737583401,1737583408,1737583408.992526,-21600,,
com.google.Chrome,35,1737583366,1737583401,1737583401.426398,-21600,,
com.apple.Notes,18,1737583348,1737583366,1737583366.6540298,-21600,,
com.google.Chrome,2,1737583346,1737583348,1737583348.927433,-21600,,
com.apple.iCal,0,1737583346,1737583346,1737583346.976993,-21600,,
com.apple.Notes,3,1737583343,1737583346,1737583346.3007588,-21600,,
com.apple.iCal,2,1737583341,1737583343,1737583343.463872,-21600,,
com.google.Chrome,1,1737583340,1737583341,1737583341.9591231,-21600,,
com.apple.iCal,9,1737583331,1737583340,1737583340.184068,-21600,,
com.google.Chrome,3,1737583328,1737583331,1737583332.021671,-21600,,
com.apple.MobileSMS,0,1737583328,1737583328,1737583328.9031382,-21600,,
com.google.Chrome,57,1737583271,1737583328,1737583328.2152128,-21600,,
com.apple.MobileSMS,1,1737583270,1737583271,1737583271.410056,-21600,,
com.apple.Notes,20,1737583250,1737583270,1737583270.060141,-21600,,
com.apple.MobileSMS,2,1737583248,1737583250,1737583250.790581,-21600,,
com.google.Chrome,195,1737583053,1737583248,1737583248.847077,-21600,,
com.apple.systempreferences,5,1737583048,1737583053,1737583053.613199,-21600,,
com.microsoft.VSCode,38,1737583010,1737583048,1737583048.254228,-21600,,
com.apple.systempreferences,93,1737582917,1737583010,1737583010.550462,-21600,,
com.google.Chrome,42,1737582867,1737582909,1737582909.241509,-21600,,
com.apple.Notes,117,1737582680,1737582797,1737582797.553143,-21600,,
com.google.Chrome,1,1737582679,1737582680,1737582680.636814,-21600,,
com.leomehlig.today,32,1737582647,1737582679,1737582679.241627,-21600,,
com.google.Chrome,107,1737582540,1737582647,1737582647.152957,-21600,,
com.apple.Notes,3,1737582537,1737582540,1737582540.842153,-21600,,
com.ebay.iphone,16,1737582155,1737582171,1737582171.200614,-21600,EB445137-D7F5-57EC-87DA-1DB460D64046,"iPhone13,2"
com.apple.mobilecal,16,1737581075,1737581091,1737581091.798352,-21600,EB445137-D7F5-57EC-87DA-1DB460D64046,"iPhone13,2"
com.apple.mobilenotes,3,1737581069,1737581072,1737581072.089476,-21600,EB445137-D7F5-57EC-87DA-1DB460D64046,"iPhone13,2"
com.apple.mobilenotes,13,1737579628,1737579641,1737579641.617449,-21600,EB445137-D7F5-57EC-87DA-1DB460D64046,"iPhone13,2"
com.apple.mobilenotes,2,1737579626,1737579628,1737579628.300568,-21600,EB445137-D7F5-57EC-87DA-1DB460D64046,"iPhone13,2"
com.apple.mobilenotes,14,1737579103,1737579117,1737579117.69908,-21600,EB445137-D7F5-57EC-87DA-1DB460D64046,"iPhone13,2"
com.apple.mobilecal,1,1737579101,1737579102,1737579102.960804,-21600,EB445137-D7F5-57EC-87DA-1DB460D64046,"iPhone13,2"
com.apple.mobilecal,5,1737575415,1737575420,1737575421.127345,-21600,EB445137-D7F5-57EC-87DA-1DB460D64046,"iPhone13,2"
com.apple.mobilecal,13,1737575399,1737575412,1737575413.717681,-21600,EB445137-D7F5-57EC-87DA-1DB460D64046,"iPhone13,2"
com.apple.weather,3,1737575393,1737575396,1737575400.658462,-21600,EB445137-D7F5-57EC-87DA-1DB460D64046,"iPhone13,2"
com.apple.Notes,109,1737571392,1737571501,1737571501.9910731,-21600,,
com.google.Chrome,41,1737571351,1737571392,1737571392.450941,-21600,,
com.apple.Notes,7,1737571344,1737571351,1737571351.427048,-21600,,
com.google.Chrome,1,1737571343,1737571344,1737571344.4622722,-21600,,
com.apple.Notes,17,1737571326,1737571343,1737571343.760314,-21600,,
com.google.Chrome,24,1737571302,1737571326,1737571326.210401,-21600,,
com.apple.Notes,36,1737571266,1737571302,1737571302.331037,-21600,,
com.google.Chrome,35,1737571231,1737571266,1737571266.996883,-21600,,
com.apple.Notes,5,1737571226,1737571231,1737571231.9679809,-21600,,
com.google.Chrome,10,1737571216,1737571226,1737571226.109632,-21600,,
com.apple.finder,3,1737571213,1737571216,1737571218.2416348,-21600,,
com.microsoft.Outlook,10,1737571203,1737571213,1737571213.8656201,-21600,,
com.google.Chrome,7,1737571196,1737571203,1737571205.350452,-21600,,
com.apple.weather,2,1737571193,1737571195,1737571195.517456,-21600,EB445137-D7F5-57EC-87DA-1DB460D64046,"iPhone13,2"
com.google.ios.youtube,1,1737571192,1737571193,1737571193.812192,-21600,EB445137-D7F5-57EC-87DA-1DB460D64046,"iPhone13,2"
com.google.ios.youtube,777,1737569945,1737570722,1737570722.471019,-21600,EB445137-D7F5-57EC-87DA-1DB460D64046,"iPhone13,2"
com.apple.mobilecal,29,1737569882,1737569911,1737569912.009447,-21600,EB445137-D7F5-57EC-87DA-1DB460D64046,"iPhone13,2"
com.ebay.iphone,10,1737569849,1737569859,1737569859.8266292,-21600,EB445137-D7F5-57EC-87DA-1DB460D64046,"iPhone13,2"
com.ebay.iphone,15,1737569821,1737569836,1737569836.370123,-21600,EB445137-D7F5-57EC-87DA-1DB460D64046,"iPhone13,2"
com.google.chrome.ios,5,1737569801,1737569806,1737569806.3553638,-21600,EB445137-D7F5-57EC-87DA-1DB460D64046,"iPhone13,2"
com.google.chrome.ios,48,1737569723,1737569771,1737569771.60692,-21600,EB445137-D7F5-57EC-87DA-1DB460D64046,"iPhone13,2"
com.google.chrome.ios,9,1737565293,1737565302,1737565302.954526,-21600,EB445137-D7F5-57EC-87DA-1DB460D64046,"iPhone13,2"
com.ebay.iphone,38,1737565000,1737565038,1737565038.8605251,-21600,EB445137-D7F5-57EC-87DA-1DB460D64046,"iPhone13,2"
com.microsoft.Office.Outlook,12,1737564937,1737564949,1737564949.243089,-21600,EB445137-D7F5-57EC-87DA-1DB460D64046,"iPhone13,2"
com.instructure.icanvas,19,1737564918,1737564937,1737564937.263716,-21600,EB445137-D7F5-57EC-87DA-1DB460D64046,"iPhone13,2"
com.apple.mobilecal,1,1737564917,1737564918,1737564918.181468,-21600,EB445137-D7F5-57EC-87DA-1DB460D64046,"iPhone13,2"
com.apple.mobilecal,2,1737564797,1737564799,1737564799.929378,-21600,EB445137-D7F5-57EC-87DA-1DB460D64046,"iPhone13,2"
com.apple.mobilecal,12,1737564625,1737564637,1737564637.5458832,-21600,EB445137-D7F5-57EC-87DA-1DB460D64046,"iPhone13,2"
com.google.Chrome,300,1737563344,1737563644,1737563644.8501658,-21600,,
com.google.Chrome,2812,1737560530,1737563342,1737563342.865512,-21600,,
com.apple.news,54,1737560039,1737560093,1737560093.566077,-21600,EB445137-D7F5-57EC-87DA-1DB460D64046,"iPhone13,2"
com.apple.news,55,1737559969,1737560024,1737560024.64066,-21600,EB445137-D7F5-57EC-87DA-1DB460D64046,"iPhone13,2"
com.google.Chrome,477,1737559769,1737560246,1737560246.62081,-21600,,
com.apple.Passwords,21,1737559748,1737559769,1737559769.825414,-21600,,
com.google.Chrome,4,1737559744,1737559748,1737559748.7105842,-21600,,
com.apple.Passwords,16,1737559728,1737559744,1737559744.5343208,-21600,,
com.google.Chrome,20,1737559708,1737559728,1737559729.018066,-21600,,
com.microsoft.Outlook,14,1737559694,1737559708,1737559708.640905,-21600,,
com.google.Chrome,33,1737559661,1737559694,1737559694.220108,-21600,,
com.microsoft.Outlook,15,1737559646,1737559661,1737559661.914647,-21600,,
com.ebay.iphone,53,1737559566,1737559619,1737559619.2436,-21600,EB445137-D7F5-57EC-87DA-1DB460D64046,"iPhone13,2"
com.apple.mobilecal,2,1737559557,1737559559,1737559559.291748,-21600,EB445137-D7F5-57EC-87DA-1DB460D64046,"iPhone13,2"
com.google.Chrome,108,1737559538,1737559646,1737559646.798229,-21600,,
com.microsoft.Outlook,40,1737559498,1737559538,1737559538.598918,-21600,,
com.google.Chrome,143,1737559355,1737559498,1737559498.8146029,-21600,,
com.leomehlig.today,10,1737559303,1737559313,1737559313.552761,-21600,,
com.apple.mobilecal,8,1737559212,1737559220,1737559220.649448,-21600,EB445137-D7F5-57EC-87DA-1DB460D64046,"iPhone13,2"
com.google.chrome.ios,10,1737559201,1737559211,1737559211.490443,-21600,EB445137-D7F5-57EC-87DA-1DB460D64046,"iPhone13,2"
com.apple.Maps,9,1737559187,1737559196,1737559196.21367,-21600,EB445137-D7F5-57EC-87DA-1DB460D64046,"iPhone13,2"
com.apple.Maps,28,1737558288,1737558316,1737558316.0910702,-21600,EB445137-D7F5-57EC-87DA-1DB460D64046,"iPhone13,2"
com.apple.Health,12,1737558081,1737558093,1737558093.621033,-21600,EB445137-D7F5-57EC-87DA-1DB460D64046,"iPhone13,2"
com.apple.Health,13,1737558068,1737558081,1737558081.279463,-21600,EB445137-D7F5-57EC-87DA-1DB460D64046,"iPhone13,2"
com.apple.AppStore,37,1737558001,1737558038,1737558038.6323562,-21600,EB445137-D7F5-57EC-87DA-1DB460D64046,"iPhone13,2"
com.google.Gmail,13,1737557985,1737557998,1737557998.195765,-21600,EB445137-D7F5-57EC-87DA-1DB460D64046,"iPhone13,2"
com.renpho.health,0,1737557985,1737557985,1737557986.003756,-21600,EB445137-D7F5-57EC-87DA-1DB460D64046,"iPhone13,2"
com.renpho.health,53,1737556807,1737556860,1737556860.503323,-21600,EB445137-D7F5-57EC-87DA-1DB460D64046,"iPhone13,2"
com.apple.mobiletimer,7,1737524063,1737524070,1737524070.2475,-21600,EB445137-D7F5-57EC-87DA-1DB460D64046,"iPhone13,2"
com.apple.journal,650,1737523389,1737524039,1737524039.302501,-21600,EB445137-D7F5-57EC-87DA-1DB460D64046,"iPhone13,2"
com.google.Gmail,9,1737523380,1737523389,1737523389.962205,-21600,EB445137-D7F5-57EC-87DA-1DB460D64046,"iPhone13,2"
com.apple.CoreAuthUI,4,1737523097,1737523101,1737523101.415831,-21600,EB445137-D7F5-57EC-87DA-1DB460D64046,"iPhone13,2"
com.apple.journal,281,1737523095,1737523376,1737523377.229669,-21600,EB445137-D7F5-57EC-87DA-1DB460D64046,"iPhone13,2"
com.apple.Health,27,1737523067,1737523094,1737523094.744823,-21600,EB445137-D7F5-57EC-87DA-1DB460D64046,"iPhone13,2"
com.thestorygraph.thestorygraph,11,1737522906,1737522917,1737522917.822571,-21600,EB445137-D7F5-57EC-87DA-1DB460D64046,"iPhone13,2"
com.apple.Maps,78,1737521783,1737521861,1737521861.8284822,-21600,EB445137-D7F5-57EC-87DA-1DB460D64046,"iPhone13,2"
com.microsoft.Office.Outlook,23,1737521748,1737521771,1737521771.07639,-21600,EB445137-D7F5-57EC-87DA-1DB460D64046,"iPhone13,2"
com.apple.Music,2,1737521746,1737521748,1737521748.8787642,-21600,EB445137-D7F5-57EC-87DA-1DB460D64046,"iPhone13,2"
com.leomehlig.today,10,1737521409,1737521419,1737521419.128811,-21600,,
com.google.Chrome,230,1737521179,1737521409,1737521409.568279,-21600,,
com.google.Chrome,902,1737519568,1737520470,1737520470.46763,-21600,,
com.google.Chrome,300,1737519038,1737519338,1737519338.370338,-21600,,
com.google.Chrome,362,1737518555,1737518917,1737518917.388136,-21600,,
com.google.Chrome,693,1737517330,1737518023,1737518023.041813,-21600,,
com.google.Chrome,752,1737516117,1737516869,1737516870.398344,-21600,,
com.apple.Music,2,1737516115,1737516117,1737516117.602705,-21600,,
com.apple.Music,23,1737515907,1737515930,1737515930.439859,-21600,EB445137-D7F5-57EC-87DA-1DB460D64046,"iPhone13,2"
com.apple.Music,108,1737514834,1737514942,1737514942.7706962,-21600,EB445137-D7F5-57EC-87DA-1DB460D64046,"iPhone13,2"
com.apple.Music,282,1737514185,1737514467,1737514468.232846,-21600,,
com.apple.Music,212,1737514030,1737514242,1737514242.99549,-21600,EB445137-D7F5-57EC-87DA-1DB460D64046,"iPhone13,2"
com.apple.MobileSMS,170,1737514015,1737514185,1737514185.889382,-21600,,
com.leomehlig.today,2,1737514013,1737514015,1737514015.9672132,-21600,,
com.apple.MobileSMS,66,1737513947,1737514013,1737514013.503642,-21600,,
com.leomehlig.today,154,1737513793,1737513947,1737513947.228101,-21600,,
com.apple.finder,8,1737513785,1737513793,1737513793.9445,-21600,,
com.microsoft.onenote.mac,6,1737513779,1737513785,1737513785.1276689,-21600,,
com.apple.MobileSMS,48,1737513731,1737513779,1737513779.080291,-21600,,
com.google.Chrome,9,1737513722,1737513731,1737513731.855229,-21600,,
com.apple.finder,55,1737513667,1737513722,1737513722.16115,-21600,,
com.google.Chrome,2,1737513665,1737513667,1737513667.6644201,-21600,,
com.apple.MobileSMS,5,1737513660,1737513665,1737513665.9533238,-21600,,
com.apple.finder,10,1737513650,1737513660,1737513660.693293,-21600,,
com.apple.MobileSMS,0,1737513650,1737513650,1737513650.3623672,-21600,,
com.apple.finder,9,1737513630,1737513639,1737513639.807147,-21600,,
com.google.Chrome,60,1737513570,1737513630,1737513630.997663,-21600,,
com.apple.finder,22,1737513548,1737513570,1737513570.8885798,-21600,,
com.google.Chrome,62,1737513486,1737513548,1737513548.1413999,-21600,,
com.apple.finder,14,1737513472,1737513486,1737513486.3445392,-21600,,
com.google.Chrome,39,1737513433,1737513472,1737513472.753221,-21600,,
com.apple.finder,11,1737513400,1737513411,1737513411.2302132,-21600,,
com.google.Chrome,6,1737513394,1737513400,1737513400.1365461,-21600,,
com.apple.finder,15,1737513379,1737513394,1737513394.4833112,-21600,,
com.google.Chrome,5,1737513374,1737513379,1737513379.819962,-21600,,
com.apple.finder,15,1737513359,1737513374,1737513374.3114948,-21600,,
com.google.Chrome,13,1737513346,1737513359,1737513359.369422,-21600,,
com.apple.finder,4,1737513342,1737513346,1737513346.997963,-21600,,
com.google.Chrome,43,1737513299,1737513342,1737513342.156848,-21600,,
com.apple.finder,22,1737513277,1737513299,1737513299.849582,-21600,,
com.thestorygraph.thestorygraph,3,1737513265,1737513268,1737513268.601941,-21600,EB445137-D7F5-57EC-87DA-1DB460D64046,"iPhone13,2"
com.google.Chrome,174,1737513103,1737513277,1737513277.644311,-21600,,
com.microsoft.onenote.mac,2,1737513101,1737513103,1737513104.452757,-21600,,
com.thestorygraph.thestorygraph,237,1737512999,1737513236,1737513236.219131,-21600,EB445137-D7F5-57EC-87DA-1DB460D64046,"iPhone13,2"
com.apple.mobilenotes,2,1737512997,1737512999,1737512999.4691901,-21600,EB445137-D7F5-57EC-87DA-1DB460D64046,"iPhone13,2"
com.microsoft.onenote.mac,93,1737512203,1737512296,1737512296.843114,-21600,,
com.apple.iCal,1,1737512202,1737512203,1737512204.009513,-21600,,
com.microsoft.onenote.mac,52,1737512150,1737512202,1737512202.054645,-21600,,
com.apple.iCal,6,1737512144,1737512150,1737512150.618499,-21600,,
com.microsoft.onenote.mac,23,1737512121,1737512144,1737512144.7293181,-21600,,
com.google.Chrome,4,1737512112,1737512116,1737512116.792821,-21600,,
com.apple.mobilenotes,54,1737512065,1737512119,1737512120.1695209,-21600,EB445137-D7F5-57EC-87DA-1DB460D64046,"iPhone13,2"
com.thestorygraph.thestorygraph,1,1737512064,1737512065,1737512065.678794,-21600,EB445137-D7F5-57EC-87DA-1DB460D64046,"iPhone13,2"
com.google.Chrome,46,1737510843,1737510889,1737510889.8175468,-21600,,
com.thestorygraph.thestorygraph,74,1737510181,1737510255,1737510255.7016401,-21600,EB445137-D7F5-57EC-87DA-1DB460D64046,"iPhone13,2"
com.google.ios.youtube,2,1737510156,1737510158,1737510158.677027,-21600,EB445137-D7F5-57EC-87DA-1DB460D64046,"iPhone13,2"
com.google.ios.youtube,296,1737505638,1737505934,1737505934.4925508,-21600,EB445137-D7F5-57EC-87DA-1DB460D64046,"iPhone13,2"
com.myfitnesspal.mfp,67,1737505501,1737505568,1737505568.807528,-21600,EB445137-D7F5-57EC-87DA-1DB460D64046,"iPhone13,2"
com.microsoft.Office.Outlook,2,1737505385,1737505387,1737505387.204134,-21600,EB445137-D7F5-57EC-87DA-1DB460D64046,"iPhone13,2"
com.microsoft.Office.Outlook,61,1737505177,1737505238,1737505239.087973,-21600,EB445137-D7F5-57EC-87DA-1DB460D64046,"iPhone13,2"
com.microsoft.Office.Outlook,32,1737504870,1737504902,1737504902.640955,-21600,EB445137-D7F5-57EC-87DA-1DB460D64046,"iPhone13,2"
com.apple.news,193,1737504197,1737504390,1737504390.826735,-21600,EB445137-D7F5-57EC-87DA-1DB460D64046,"iPhone13,2"
com.apple.news,32,1737504162,1737504194,1737504194.662034,-21600,EB445137-D7F5-57EC-87DA-1DB460D64046,"iPhone13,2"
com.apple.news,111,1737504000,1737504111,1737504111.886815,-21600,EB445137-D7F5-57EC-87DA-1DB460D64046,"iPhone13,2"
com.google.chrome.ios,122,1737503874,1737503996,1737503996.5367742,-21600,EB445137-D7F5-57EC-87DA-1DB460D64046,"iPhone13,2"
com.google.Chrome,185,1737503200,1737503385,1737503385.7920132,-21600,,
com.truebill.truebillnative,46,1737502607,1737502653,1737502653.472629,-21600,EB445137-D7F5-57EC-87DA-1DB460D64046,"iPhone13,2"
com.google.Chrome,927,1737502028,1737502955,1737502955.106398,-21600,,
com.google.Chrome,395,1737501473,1737501868,1737501868.511802,-21600,,
com.ebay.iphone,32,1737500579,1737500611,1737500612.000109,-21600,EB445137-D7F5-57EC-87DA-1DB460D64046,"iPhone13,2"
com.google.Chrome,600,1737500556,1737501156,1737501156.17619,-21600,,
com.tinyspeck.chatlyio,9,1737500530,1737500539,1737500539.137708,-21600,EB445137-D7F5-57EC-87DA-1DB460D64046,"iPhone13,2"
com.microsoft.Office.Outlook,31,1737500498,1737500529,1737500529.9336,-21600,EB445137-D7F5-57EC-87DA-1DB460D64046,"iPhone13,2"
com.google.Chrome,304,1737500197,1737500501,1737500501.24826,-21600,,
com.google.Chrome,383,1737499484,1737499867,1737499867.1055222,-21600,,
com.google.Chrome,313,1737498934,1737499247,1737499247.382391,-21600,,
com.google.Chrome,1461,1737497178,1737498639,1737498639.265459,-21600,,
com.google.Chrome,300,1737496777,1737497077,1737497077.390064,-21600,,
com.myfitnesspal.mfp,41,1737496393,1737496434,1737496434.035143,-21600,EB445137-D7F5-57EC-87DA-1DB460D64046,"iPhone13,2"
com.google.Chrome,532,1737496165,1737496697,1737496697.1971068,-21600,,
com.myfitnesspal.mfp,38,1737495613,1737495651,1737495651.819915,-21600,EB445137-D7F5-57EC-87DA-1DB460D64046,"iPhone13,2"
com.myfitnesspal.mfp,30,1737495258,1737495288,1737495288.689867,-21600,EB445137-D7F5-57EC-87DA-1DB460D64046,"iPhone13,2"
com.myfitnesspal.mfp,35,1737495000,1737495035,1737495035.938909,-21600,EB445137-D7F5-57EC-87DA-1DB460D64046,"iPhone13,2"
com.apple.weather,4,1737494989,1737494993,1737494993.757992,-21600,EB445137-D7F5-57EC-87DA-1DB460D64046,"iPhone13,2"
com.google.Chrome,1190,1737494941,1737496131,1737496131.140079,-21600,,
com.apple.weather,7,1737493258,1737493265,1737493265.337018,-21600,EB445137-D7F5-57EC-87DA-1DB460D64046,"iPhone13,2"
com.microsoft.Office.Outlook,1,1737493257,1737493258,1737493258.2984781,-21600,EB445137-D7F5-57EC-87DA-1DB460D64046,"iPhone13,2"
com.google.Chrome,418,1737492772,1737493190,1737493190.8680658,-21600,,
com.apple.finder,106,1737492666,1737492772,1737492773.462348,-21600,,
com.google.Chrome,1,1737492665,1737492666,1737492666.296031,-21600,,
com.microsoft.Office.Outlook,5,1737492501,1737492506,1737492506.8830671,-21600,EB445137-D7F5-57EC-87DA-1DB460D64046,"iPhone13,2"
com.ebay.iphone,2,1737492499,1737492501,1737492501.02172,-21600,EB445137-D7F5-57EC-87DA-1DB460D64046,"iPhone13,2"
com.leomehlig.today,198,1737492467,1737492665,1737492665.207677,-21600,,
com.apple.iCal,4,1737492463,1737492467,1737492467.7679949,-21600,,
com.ebay.iphone,91,1737492370,1737492461,1737492461.5989351,-21600,EB445137-D7F5-57EC-87DA-1DB460D64046,"iPhone13,2"
com.toyopagroup.picaboo,23,1737492301,1737492324,1737492324.684239,-21600,EB445137-D7F5-57EC-87DA-1DB460D64046,"iPhone13,2"
com.google.Chrome,993,1737491470,1737492463,1737492463.397564,-21600,,
com.apple.iCal,3,1737491467,1737491470,1737491470.213836,-21600,,
com.google.Chrome,268,1737491199,1737491467,1737491468.0114222,-21600,,
com.apple.iCal,2,1737491197,1737491199,1737491199.6643271,-21600,,
com.google.Chrome,73,1737491124,1737491197,1737491197.218591,-21600,,
com.apple.iCal,6,1737491118,1737491124,1737491124.1389709,-21600,,
com.google.Chrome,259,1737490859,1737491118,1737491118.300058,-21600,,
com.apple.Notes,2,1737490857,1737490859,1737490859.162428,-21600,,
com.google.Chrome,54,1737490803,1737490857,1737490857.574254,-21600,,
com.apple.Notes,28,1737490775,1737490803,1737490803.113533,-21600,,
com.google.Chrome,329,1737490446,1737490775,1737490775.1597881,-21600,,
com.microsoft.Outlook,6,1737490440,1737490446,1737490446.736573,-21600,,
com.google.Chrome,2,1737490438,1737490440,1737490440.636641,-21600,,
com.microsoft.Outlook,8,1737490430,1737490438,1737490438.552549,-21600,,
com.google.Chrome,2,1737490428,1737490430,1737490430.130343,-21600,,
com.microsoft.Outlook,4,1737490424,1737490428,1737490428.8508759,-21600,,
com.google.Chrome,218,1737490206,1737490424,1737490424.8992748,-21600,,
com.leomehlig.today,3,1737490155,1737490158,1737490160.187113,-21600,,
com.google.Chrome,27,1737490128,1737490155,1737490155.392952,-21600,,
com.microsoft.Office.Outlook,14,1737487810,1737487824,1737487824.47539,-21600,EB445137-D7F5-57EC-87DA-1DB460D64046,"iPhone13,2"
com.google.chrome.ios,0,1737487810,1737487810,1737487811.019969,-21600,EB445137-D7F5-57EC-87DA-1DB460D64046,"iPhone13,2"
com.google.chrome.ios,151,1737487356,1737487507,1737487507.84358,-21600,EB445137-D7F5-57EC-87DA-1DB460D64046,"iPhone13,2"
com.apple.weather,2,1737487354,1737487356,1737487356.875997,-21600,EB445137-D7F5-57EC-87DA-1DB460D64046,"iPhone13,2"
com.google.Chrome,446,1737486913,1737487359,1737487359.914703,-21600,,
com.leomehlig.today,1,1737486912,1737486913,1737486913.789085,-21600,,
com.apple.weather,3,1737486462,1737486465,1737486465.377908,-21600,EB445137-D7F5-57EC-87DA-1DB460D64046,"iPhone13,2"
com.leomehlig.today,310,1737486448,1737486758,1737486758.168849,-21600,,
com.google.Chrome,45,1737486403,1737486448,1737486448.390718,-21600,,
com.apple.MobileSMS,19,1737486263,1737486282,1737486282.881957,-21600,EB445137-D7F5-57EC-87DA-1DB460D64046,"iPhone13,2"
com.apple.news,0,1737486263,1737486263,1737486264.250763,-21600,EB445137-D7F5-57EC-87DA-1DB460D64046,"iPhone13,2"
com.apple.news,108,1737485459,1737485567,1737485567.629034,-21600,EB445137-D7F5-57EC-87DA-1DB460D64046,"iPhone13,2"
com.apple.news,1,1737485453,1737485454,1737485455.0609279,-21600,EB445137-D7F5-57EC-87DA-1DB460D64046,"iPhone13,2"
com.apple.news,57,1737484097,1737484154,1737484154.780995,-21600,EB445137-D7F5-57EC-87DA-1DB460D64046,"iPhone13,2"
com.apple.news,62,1737483594,1737483656,1737483656.818098,-21600,EB445137-D7F5-57EC-87DA-1DB460D64046,"iPhone13,2"
com.myfitnesspal.mfp,2,1737483584,1737483586,1737483586.102133,-21600,EB445137-D7F5-57EC-87DA-1DB460D64046,"iPhone13,2"
com.myfitnesspal.mfp,85,1737483128,1737483213,1737483213.9684849,-21600,EB445137-D7F5-57EC-87DA-1DB460D64046,"iPhone13,2"
com.google.Chrome,198,1737481432,1737481630,1737481630.830589,-21600,,
com.microsoft.onenote.mac,9,1737481423,1737481432,1737481432.50512,-21600,,
com.google.Chrome,1,1737481422,1737481423,1737481423.515184,-21600,,
com.cisco.secureclient.gui,6,1737481416,1737481422,1737481422.607713,-21600,,
com.apple.Terminal,9,1737481407,1737481416,1737481416.6006951,-21600,,
com.cisco.secureclient.gui,1,1737481406,1737481407,1737481407.921494,-21600,,
com.google.Chrome,120,1737481286,1737481406,1737481406.220505,-21600,,
com.apple.MobileSMS,11,1737481275,1737481286,1737481286.285193,-21600,,
com.google.Chrome,1649,1737479626,1737481275,1737481275.402834,-21600,,
com.apple.MobileSMS,2,1737479624,1737479626,1737479626.1513739,-21600,,
com.google.Chrome,25,1737479599,1737479624,1737479624.995717,-21600,,
com.apple.MobileSMS,43,1737479556,1737479599,1737479599.116714,-21600,,
com.google.Chrome,1763,1737477793,1737479556,1737479556.3897018,-21600,,
com.apple.Terminal,272,1737477521,1737477793,1737477793.571332,-21600,,
com.google.Chrome,2,1737477519,1737477521,1737477521.1011329,-21600,,
com.leomehlig.today,10,1737477509,1737477519,1737477519.42944,-21600,,
com.apple.Terminal,349,1737477160,1737477509,1737477509.867251,-21600,,
com.apple.weather,31,1737476940,1737476971,1737476971.886915,-21600,EB445137-D7F5-57EC-87DA-1DB460D64046,"iPhone13,2"
com.apple.Health,29,1737476900,1737476929,1737476929.590137,-21600,EB445137-D7F5-57EC-87DA-1DB460D64046,"iPhone13,2"
com.hammerandchisel.discord,270,1737476603,1737476873,1737476873.580182,-21600,EB445137-D7F5-57EC-87DA-1DB460D64046,"iPhone13,2"
com.hammerandchisel.discord,51,1737476507,1737476558,1737476559.082372,-21600,EB445137-D7F5-57EC-87DA-1DB460D64046,"iPhone13,2"
com.apple.Terminal,134,1737476476,1737476610,1737476610.226115,-21600,,
com.apple.CoreAuthUI,2,1737476366,1737476368,1737476368.41043,-21600,EB445137-D7F5-57EC-87DA-1DB460D64046,"iPhone13,2"
com.truebill.truebillnative,35,1737476362,1737476397,1737476398.026307,-21600,EB445137-D7F5-57EC-87DA-1DB460D64046,"iPhone13,2"
com.google.Chrome,1,1737476220,1737476221,1737476221.32128,-21600,,
com.apple.Terminal,15,1737476205,1737476220,1737476220.2720308,-21600,,
com.cisco.secureclient.gui,6,1737476199,1737476205,1737476205.6604419,-21600,,
com.google.Chrome,2,1737476197,1737476199,1737476199.572588,-21600,,
com.cisco.secureclient.gui,1,1737476196,1737476197,1737476197.998915,-21600,,
com.google.Chrome,26,1737476170,1737476196,1737476196.367094,-21600,,
com.tinyspeck.chatlyio,1,1737476159,1737476160,1737476160.9687982,-21600,EB445137-D7F5-57EC-87DA-1DB460D64046,"iPhone13,2"
com.apple.news,0,1737476159,1737476159,1737476159.9197369,-21600,EB445137-D7F5-57EC-87DA-1DB460D64046,"iPhone13,2"
com.cisco.secureclient.gui,38,1737476132,1737476170,1737476170.438842,-21600,,
com.google.Chrome,122,1737476010,1737476132,1737476132.707633,-21600,,
com.apple.news,34,1737474955,1737474989,1737474989.779852,-21600,EB445137-D7F5-57EC-87DA-1DB460D64046,"iPhone13,2"
com.google.Chrome,451,1737474667,1737475118,1737475118.2247849,-21600,,
com.ebay.iphone,46,1737474307,1737474353,1737474353.326346,-21600,EB445137-D7F5-57EC-87DA-1DB460D64046,"iPhone13,2"
com.google.Chrome,573,1737473994,1737474567,1737474567.96867,-21600,,
com.leomehlig.today,0,1737473994,1737473994,1737473994.905126,-21600,,
com.google.Chrome,24,1737473970,1737473994,1737473994.416569,-21600,,
com.leomehlig.today,3,1737473967,1737473970,1737473970.087648,-21600,,
com.google.Chrome,101,1737473866,1737473967,1737473968.0059528,-21600,,
com.apple.dt.Xcode,56,1737473810,1737473866,1737473866.776084,-21600,,
com.google.Chrome,92,1737473718,1737473810,1737473810.842427,-21600,,
com.ryansponzilli.DeepSkyCatalog,178,1737473537,1737473715,1737473715.140232,-21600,EB445137-D7F5-57EC-87DA-1DB460D64046,"iPhone13,2"
com.apple.TestFlight,43,1737473493,1737473536,1737473536.94504,-21600,EB445137-D7F5-57EC-87DA-1DB460D64046,"iPhone13,2"
com.ryansponzilli.DeepSkyCatalog,5,1737473486,1737473491,1737473491.3914142,-21600,EB445137-D7F5-57EC-87DA-1DB460D64046,"iPhone13,2"
com.microsoft.Office.Outlook,8,1737473440,1737473448,1737473448.900357,-21600,EB445137-D7F5-57EC-87DA-1DB460D64046,"iPhone13,2"
com.google.chrome.ios,52,1737473388,1737473440,1737473440.610996,-21600,EB445137-D7F5-57EC-87DA-1DB460D64046,"iPhone13,2"
com.microsoft.Office.Outlook,22,1737473366,1737473388,1737473388.066184,-21600,EB445137-D7F5-57EC-87DA-1DB460D64046,"iPhone13,2"
com.google.Chrome,336,1737473299,1737473635,1737473635.915648,-21600,,
com.leomehlig.today,1,1737473059,1737473060,1737473060.4064941,-21600,,
com.apple.Notes,1,1737473058,1737473059,1737473059.944096,-21600,,
com.leomehlig.today,4,1737473054,1737473058,1737473058.554801,-21600,,
com.apple.iphonesimulator,1,1737473053,1737473054,1737473054.6589808,-21600,,
com.apple.dt.Xcode,6,1737473047,1737473053,1737473053.559013,-21600,,
com.google.Chrome,29,1737473018,1737473047,1737473047.322157,-21600,,
com.apple.dt.Xcode,2,1737473016,1737473018,1737473018.9621649,-21600,,
com.google.Chrome,86,1737472930,1737473016,1737473016.304088,-21600,,
com.apple.dt.Xcode,75,1737472855,1737472930,1737472930.286605,-21600,,
com.ryansponzilli.DeepSkyCatalog,115,1737472581,1737472696,1737472696.592187,-21600,EB445137-D7F5-57EC-87DA-1DB460D64046,"iPhone13,2"
com.apple.iphonesimulator,182,1737472391,1737472573,1737472573.12578,-21600,,
com.apple.dt.Xcode,50,1737472341,1737472391,1737472391.84629,-21600,,
com.apple.iphonesimulator,23,1737472318,1737472341,1737472341.55189,-21600,,
com.apple.dt.Xcode,2,1737472314,1737472316,1737472316.613497,-21600,,
com.google.Chrome,73,1737472139,1737472212,1737472212.2662659,-21600,,
com.apple.iCal,17,1737472106,1737472123,1737472123.5168161,-21600,,
com.google.Chrome,3,1737472103,1737472106,1737472106.390363,-21600,,
com.leomehlig.today,24,1737472079,1737472103,1737472104.458951,-21600,,
com.apple.weather,19,1737471978,1737471997,1737471997.373635,-21600,EB445137-D7F5-57EC-87DA-1DB460D64046,"iPhone13,2"
com.apple.news,22,1737471955,1737471977,1737471977.3256578,-21600,EB445137-D7F5-57EC-87DA-1DB460D64046,"iPhone13,2"
com.apple.news,135,1737471818,1737471953,1737471953.613854,-21600,EB445137-D7F5-57EC-87DA-1DB460D64046,"iPhone13,2"
com.microsoft.Office.Outlook,24,1737471773,1737471797,1737471797.9407191,-21600,EB445137-D7F5-57EC-87DA-1DB460D64046,"iPhone13,2"
com.renpho.health,2,1737471771,1737471773,1737471773.3341799,-21600,EB445137-D7F5-57EC-87DA-1DB460D64046,"iPhone13,2"
com.renpho.health,44,1737470743,1737470787,1737470787.8304582,-21600,EB445137-D7F5-57EC-87DA-1DB460D64046,"iPhone13,2"
com.apple.weather,9,1737470722,1737470731,1737470731.159336,-21600,EB445137-D7F5-57EC-87DA-1DB460D64046,"iPhone13,2"
com.apple.mobiletimer,2,1737470718,1737470720,1737470720.619909,-21600,EB445137-D7F5-57EC-87DA-1DB460D64046,"iPhone13,2"
com.apple.mobiletimer,4,1737438428,1737438432,1737438432.998677,-21600,EB445137-D7F5-57EC-87DA-1DB460D64046,"iPhone13,2"
com.apple.CoreAuthUI,1,1737437417,1737437418,1737437418.343893,-21600,EB445137-D7F5-57EC-87DA-1DB460D64046,"iPhone13,2"
com.apple.journal,1002,1737437416,1737438418,1737438418.87363,-21600,EB445137-D7F5-57EC-87DA-1DB460D64046,"iPhone13,2"
com.apple.Health,22,1737437390,1737437412,1737437413.023252,-21600,EB445137-D7F5-57EC-87DA-1DB460D64046,"iPhone13,2"
com.apple.news,32,1737437350,1737437382,1737437382.7651892,-21600,EB445137-D7F5-57EC-87DA-1DB460D64046,"iPhone13,2"
com.apple.news,2,1737437328,1737437330,1737437330.670399,-21600,EB445137-D7F5-57EC-87DA-1DB460D64046,"iPhone13,2"
com.thestorygraph.thestorygraph,55,1737437271,1737437326,1737437326.6111732,-21600,EB445137-D7F5-57EC-87DA-1DB460D64046,"iPhone13,2"
com.google.chrome.ios,2,1737437269,1737437271,1737437271.566339,-21600,EB445137-D7F5-57EC-87DA-1DB460D64046,"iPhone13,2"
com.google.chrome.ios,38,1737436221,1737436259,1737436259.445259,-21600,EB445137-D7F5-57EC-87DA-1DB460D64046,"iPhone13,2"
com.apple.weather,5,1737435046,1737435051,1737435051.181056,-21600,EB445137-D7F5-57EC-87DA-1DB460D64046,"iPhone13,2"
com.leomehlig.today,50,1737432984,1737433034,1737433034.987844,-21600,,
com.google.Chrome,391,1737432593,1737432984,1737432984.330284,-21600,,
com.google.Chrome,387,1737431641,1737432028,1737432028.168531,-21600,,
com.google.Chrome,318,1737431113,1737431431,1737431431.14204,-21600,,
com.google.Chrome,819,1737430198,1737431017,1737431017.160141,-21600,,
com.google.Chrome,879,1737429238,1737430117,1737430117.778908,-21600,,
com.apple.CoreAuthUI,7,1737428858,1737428865,1737428865.291929,-21600,EB445137-D7F5-57EC-87DA-1DB460D64046,"iPhone13,2"
com.robinhood.release.Robinhood,36,1737428853,1737428889,1737428889.900835,-21600,EB445137-D7F5-57EC-87DA-1DB460D64046,"iPhone13,2"
com.google.Chrome,1055,1737427848,1737428903,1737428903.5271559,-21600,,
com.myfitnesspal.mfp,117,1737426745,1737426862,1737426862.468106,-21600,EB445137-D7F5-57EC-87DA-1DB460D64046,"iPhone13,2"
com.google.Chrome,880,1737426591,1737427471,1737427471.139141,-21600,,
com.apple.Notes,303,1737426288,1737426591,1737426591.952352,-21600,,
com.google.Chrome,11,1737426277,1737426288,1737426288.460194,-21600,,
com.myfitnesspal.mfp,215,1737425875,1737426090,1737426090.248894,-21600,EB445137-D7F5-57EC-87DA-1DB460D64046,"iPhone13,2"
com.apple.news,2,1737425787,1737425789,1737425789.4391952,-21600,EB445137-D7F5-57EC-87DA-1DB460D64046,"iPhone13,2"
com.google.Chrome,676,1737423046,1737423722,1737423722.62364,-21600,,
com.microsoft.onenote.mac,39,1737423007,1737423046,1737423046.125121,-21600,,
com.google.Chrome,111,1737422896,1737423007,1737423007.702977,-21600,,
com.apple.news,57,1737422780,1737422837,1737422839.5526981,-21600,EB445137-D7F5-57EC-87DA-1DB460D64046,"iPhone13,2"
com.apple.Preferences,2,1737422778,1737422780,1737422782.057016,-21600,EB445137-D7F5-57EC-87DA-1DB460D64046,"iPhone13,2"
com.apple.news,2,1737422776,1737422778,1737422778.885081,-21600,EB445137-D7F5-57EC-87DA-1DB460D64046,"iPhone13,2"
com.apple.weather,21,1737422752,1737422773,1737422773.426004,-21600,EB445137-D7F5-57EC-87DA-1DB460D64046,"iPhone13,2"
com.apple.weather,2,1737422750,1737422752,1737422752.91378,-21600,EB445137-D7F5-57EC-87DA-1DB460D64046,"iPhone13,2"
com.apple.news,4,1737422745,1737422749,1737422749.621379,-21600,EB445137-D7F5-57EC-87DA-1DB460D64046,"iPhone13,2"
com.apple.CoreAuthUI,2,1737422706,1737422708,1737422708.9749541,-21600,EB445137-D7F5-57EC-87DA-1DB460D64046,"iPhone13,2"
com.truebill.truebillnative,18,1737422701,1737422719,1737422719.219864,-21600,EB445137-D7F5-57EC-87DA-1DB460D64046,"iPhone13,2"
com.apple.mobiletimer,2,1737422678,1737422680,1737422680.360544,-21600,EB445137-D7F5-57EC-87DA-1DB460D64046,"iPhone13,2"
com.google.Chrome,304,1737422168,1737422472,1737422472.723174,-21600,,
com.apple.mobiletimer,33,1737422145,1737422178,1737422178.9777,-21600,EB445137-D7F5-57EC-87DA-1DB460D64046,"iPhone13,2"
com.google.chrome.ios,37,1737422108,1737422145,1737422145.307071,-21600,EB445137-D7F5-57EC-87DA-1DB460D64046,"iPhone13,2"
com.apple.mobiletimer,64,1737422044,1737422108,1737422108.90434,-21600,EB445137-D7F5-57EC-87DA-1DB460D64046,"iPhone13,2"
com.google.Chrome,1041,1737421109,1737422150,1737422150.229291,-21600,,
com.google.Chrome,300,1737420630,1737420930,1737420930.392026,-21600,,
com.google.Chrome,863,1737419720,1737420583,1737420583.235985,-21600,,
com.apple.mobiletimer,5,1737419375,1737419380,1737419380.7615628,-21600,EB445137-D7F5-57EC-87DA-1DB460D64046,"iPhone13,2"
com.apple.calculator,4,1737419369,1737419373,1737419373.3791618,-21600,EB445137-D7F5-57EC-87DA-1DB460D64046,"iPhone13,2"
com.apple.news,18,1737419329,1737419347,1737419347.7557259,-21600,EB445137-D7F5-57EC-87DA-1DB460D64046,"iPhone13,2"
com.tinyspeck.chatlyio,57,1737419264,1737419321,1737419321.8342838,-21600,EB445137-D7F5-57EC-87DA-1DB460D64046,"iPhone13,2"
com.apple.CoreAuthUI,2,1737419257,1737419259,1737419259.666599,-21600,EB445137-D7F5-57EC-87DA-1DB460D64046,"iPhone13,2"
com.apple.CoreAuthUI,2,1737419253,1737419255,1737419255.5344548,-21600,EB445137-D7F5-57EC-87DA-1DB460D64046,"iPhone13,2"
com.google.chrome.ios,28,1737419236,1737419264,1737419264.19256,-21600,EB445137-D7F5-57EC-87DA-1DB460D64046,"iPhone13,2"
com.tinyspeck.chatlyio,3,1737419233,1737419236,1737419236.818563,-21600,EB445137-D7F5-57EC-87DA-1DB460D64046,"iPhone13,2"
com.google.chrome.ios,110,1737419123,1737419233,1737419233.362931,-21600,EB445137-D7F5-57EC-87DA-1DB460D64046,"iPhone13,2"
com.google.chrome.ios,11,1737419042,1737419053,1737419053.9794412,-21600,EB445137-D7F5-57EC-87DA-1DB460D64046,"iPhone13,2"
com.tinyspeck.chatlyio,16,1737419026,1737419042,1737419042.101023,-21600,EB445137-D7F5-57EC-87DA-1DB460D64046,"iPhone13,2"
com.google.chrome.ios,0,1737419026,1737419026,1737419026.866216,-21600,EB445137-D7F5-57EC-87DA-1DB460D64046,"iPhone13,2"
com.google.chrome.ios,3,1737419022,1737419025,1737419025.542934,-21600,EB445137-D7F5-57EC-87DA-1DB460D64046,"iPhone13,2"
com.google.chrome.ios,10,1737419009,1737419019,1737419020.200851,-21600,EB445137-D7F5-57EC-87DA-1DB460D64046,"iPhone13,2"
com.google.chrome.ios,91,1737418519,1737418610,1737418610.533273,-21600,EB445137-D7F5-57EC-87DA-1DB460D64046,"iPhone13,2"
com.google.chrome.ios,166,1737418283,1737418449,1737418449.678434,-21600,EB445137-D7F5-57EC-87DA-1DB460D64046,"iPhone13,2"
com.google.ios.youtube,1,1737417828,1737417829,1737417829.400109,-21600,EB445137-D7F5-57EC-87DA-1DB460D64046,"iPhone13,2"
com.google.chrome.ios,221,1737417826,1737418047,1737418048.267081,-21600,EB445137-D7F5-57EC-87DA-1DB460D64046,"iPhone13,2"
com.google.ios.youtube,77,1737417749,1737417826,1737417826.629653,-21600,EB445137-D7F5-57EC-87DA-1DB460D64046,"iPhone13,2"
com.google.chrome.ios,140,1737417609,1737417749,1737417749.5399442,-21600,EB445137-D7F5-57EC-87DA-1DB460D64046,"iPhone13,2"
com.ryansponzilli.DeepSkyCatalog,2,1737417607,1737417609,1737417609.212739,-21600,EB445137-D7F5-57EC-87DA-1DB460D64046,"iPhone13,2"
com.google.Chrome,477,1737414216,1737414693,1737414693.133665,-21600,,
com.microsoft.onenote.mac,29,1737414187,1737414216,1737414216.250628,-21600,,
com.google.Chrome,2,1737414185,1737414187,1737414187.6152558,-21600,,
com.google.android.studio,19,1737414166,1737414185,1737414185.3641748,-21600,,
com.ryansponzilli.DeepSkyCatalog,17,1737414140,1737414157,1737414157.7216702,-21600,EB445137-D7F5-57EC-87DA-1DB460D64046,"iPhone13,2"
com.ryansponzilli.DeepSkyCatalog,4,1737414107,1737414111,1737414111.7912688,-21600,EB445137-D7F5-57EC-87DA-1DB460D64046,"iPhone13,2"
com.apple.ios.StoreKitUIService,4,1737414098,1737414102,1737414102.531292,-21600,EB445137-D7F5-57EC-87DA-1DB460D64046,"iPhone13,2"
com.ryansponzilli.DeepSkyCatalog,33,1737414055,1737414088,1737414088.797813,-21600,EB445137-D7F5-57EC-87DA-1DB460D64046,"iPhone13,2"
com.apple.dt.Xcode,113,1737414053,1737414166,1737414166.6988,-21600,,
com.google.Chrome,1,1737414052,1737414053,1737414053.843189,-21600,,
com.ryansponzilli.DeepSkyCatalog,73,1737413960,1737414033,1737414033.228729,-21600,EB445137-D7F5-57EC-87DA-1DB460D64046,"iPhone13,2"
com.apple.TestFlight,61,1737413899,1737413960,1737413960.863523,-21600,EB445137-D7F5-57EC-87DA-1DB460D64046,"iPhone13,2"
com.apple.TestFlight,8,1737413878,1737413886,1737413886.381686,-21600,EB445137-D7F5-57EC-87DA-1DB460D64046,"iPhone13,2"
com.apple.news,3,1737413862,1737413865,1737413865.411551,-21600,EB445137-D7F5-57EC-87DA-1DB460D64046,"iPhone13,2"
com.microsoft.onenote.mac,257,1737413795,1737414052,1737414052.422793,-21600,,
com.google.Chrome,158,1737413637,1737413795,1737413795.1834521,-21600,,
com.apple.dt.Xcode,112,1737413525,1737413637,1737413637.586786,-21600,,
com.google.Chrome,28,1737413419,1737413447,1737413447.315249,-21600,,
com.apple.dt.Xcode,457,1737412950,1737413407,1737413407.150955,-21600,,
com.apple.iphonesimulator,9,1737412941,1737412950,1737412951.090952,-21600,,
com.microsoft.onenote.mac,13,1737412928,1737412941,1737412941.509107,-21600,,
com.apple.iphonesimulator,125,1737412803,1737412928,1737412928.7921438,-21600,,
com.apple.dt.Xcode,82,1737412721,1737412803,1737412803.340205,-21600,,
com.apple.iphonesimulator,81,1737412640,1737412721,1737412721.44274,-21600,,
com.microsoft.onenote.mac,36,1737412604,1737412640,1737412640.5737839,-21600,,
com.apple.iphonesimulator,11,1737412593,1737412604,1737412604.302477,-21600,,
com.apple.dt.Xcode,14,1737412579,1737412593,1737412593.9519892,-21600,,
com.apple.iphonesimulator,41,1737412538,1737412579,1737412579.138414,-21600,,
com.apple.dt.Xcode,27,1737412511,1737412538,1737412538.706159,-21600,,
com.apple.iphonesimulator,21,1737412490,1737412511,1737412511.928385,-21600,,
com.apple.dt.Xcode,13,1737412477,1737412490,1737412490.639957,-21600,,
com.apple.iphonesimulator,12,1737412465,1737412477,1737412477.3365068,-21600,,
com.apple.dt.Xcode,189,1737412276,1737412465,1737412465.199017,-21600,,
com.apple.iphonesimulator,9,1737412267,1737412276,1737412276.6455379,-21600,,
com.microsoft.onenote.mac,9,1737412258,1737412267,1737412267.813291,-21600,,
com.apple.iphonesimulator,72,1737412186,1737412258,1737412259.185944,-21600,,
com.apple.dt.Xcode,8,1737412178,1737412186,1737412186.443846,-21600,,
com.apple.iphonesimulator,10,1737412168,1737412178,1737412178.452859,-21600,,
com.apple.dt.Xcode,23,1737412145,1737412168,1737412168.463852,-21600,,
com.apple.iphonesimulator,45,1737412100,1737412145,1737412145.1836529,-21600,,
com.apple.dt.Xcode,17,1737412083,1737412100,1737412100.917321,-21600,,
com.google.Chrome,70,1737412013,1737412083,1737412083.227202,-21600,,
com.apple.iphonesimulator,3,1737412010,1737412013,1737412015.075478,-21600,,
com.google.Chrome,2,1737412008,1737412010,1737412012.7886128,-21600,,
com.apple.news,80,1737411808,1737411888,1737411888.605598,-21600,EB445137-D7F5-57EC-87DA-1DB460D64046,"iPhone13,2"
com.apple.news,53,1737411162,1737411215,1737411215.472585,-21600,EB445137-D7F5-57EC-87DA-1DB460D64046,"iPhone13,2"
com.apple.MobileSMS,2,1737411153,1737411155,1737411155.852675,-21600,EB445137-D7F5-57EC-87DA-1DB460D64046,"iPhone13,2"
com.apple.MobileSMS,20,1737410488,1737410508,1737410509.153019,-21600,EB445137-D7F5-57EC-87DA-1DB460D64046,"iPhone13,2"
com.apple.news,0,1737410488,1737410488,1737410494.496974,-21600,EB445137-D7F5-57EC-87DA-1DB460D64046,"iPhone13,2"
com.apple.news,94,1737409988,1737410082,1737410082.8601131,-21600,EB445137-D7F5-57EC-87DA-1DB460D64046,"iPhone13,2"
com.ebay.iphone,135,1737408126,1737408261,1737408261.916096,-21600,EB445137-D7F5-57EC-87DA-1DB460D64046,"iPhone13,2"
com.apple.news,33,1737407463,1737407496,1737407496.721698,-21600,EB445137-D7F5-57EC-87DA-1DB460D64046,"iPhone13,2"
com.google.chrome.ios,10,1737407447,1737407457,1737407457.991221,-21600,EB445137-D7F5-57EC-87DA-1DB460D64046,"iPhone13,2"
com.google.chrome.ios,164,1737406848,1737407012,1737407013.1517138,-21600,EB445137-D7F5-57EC-87DA-1DB460D64046,"iPhone13,2"
com.google.chrome.ios,25,1737406176,1737406201,1737406201.607651,-21600,EB445137-D7F5-57EC-87DA-1DB460D64046,"iPhone13,2"
com.myfitnesspal.mfp,11,1737406163,1737406174,1737406174.926869,-21600,EB445137-D7F5-57EC-87DA-1DB460D64046,"iPhone13,2"
com.myfitnesspal.mfp,59,1737405950,1737406009,1737406009.9629378,-21600,EB445137-D7F5-57EC-87DA-1DB460D64046,"iPhone13,2"
com.myfitnesspal.mfp,24,1737405628,1737405652,1737405652.34864,-21600,EB445137-D7F5-57EC-87DA-1DB460D64046,"iPhone13,2"
com.google.Sheets,9,1737405619,1737405628,1737405628.666761,-21600,EB445137-D7F5-57EC-87DA-1DB460D64046,"iPhone13,2"
com.myfitnesspal.mfp,19,1737405600,1737405619,1737405619.4746032,-21600,EB445137-D7F5-57EC-87DA-1DB460D64046,"iPhone13,2"
com.google.Sheets,47,1737405553,1737405600,1737405600.58653,-21600,EB445137-D7F5-57EC-87DA-1DB460D64046,"iPhone13,2"
com.microsoft.onenote,19,1737405532,1737405551,1737405551.441817,-21600,EB445137-D7F5-57EC-87DA-1DB460D64046,"iPhone13,2"
com.myfitnesspal.mfp,92,1737405437,1737405529,1737405529.3763819,-21600,EB445137-D7F5-57EC-87DA-1DB460D64046,"iPhone13,2"
com.myfitnesspal.mfp,120,1737405315,1737405435,1737405435.3804479,-21600,EB445137-D7F5-57EC-87DA-1DB460D64046,"iPhone13,2"
com.apple.news,2,1737405298,1737405300,1737405300.175251,-21600,EB445137-D7F5-57EC-87DA-1DB460D64046,"iPhone13,2"
com.apple.news,79,1737405029,1737405108,1737405109.0628839,-21600,EB445137-D7F5-57EC-87DA-1DB460D64046,"iPhone13,2"
com.apple.news,194,1737404800,1737404994,1737404994.866534,-21600,EB445137-D7F5-57EC-87DA-1DB460D64046,"iPhone13,2"
com.apple.news,114,1737403935,1737404049,1737404049.93321,-21600,EB445137-D7F5-57EC-87DA-1DB460D64046,"iPhone13,2"
com.apple.mobilecal,2,1737403927,1737403929,1737403929.739911,-21600,EB445137-D7F5-57EC-87DA-1DB460D64046,"iPhone13,2"
com.apple.mobilecal,45,1737403416,1737403461,1737403461.6442652,-21600,EB445137-D7F5-57EC-87DA-1DB460D64046,"iPhone13,2"
com.google.chrome.ios,2,1737403409,1737403411,1737403411.575172,-21600,EB445137-D7F5-57EC-87DA-1DB460D64046,"iPhone13,2"
com.google.chrome.ios,12,1737399537,1737399549,1737399549.7481809,-21600,EB445137-D7F5-57EC-87DA-1DB460D64046,"iPhone13,2"
com.google.chrome.ios,35,1737399338,1737399373,1737399374.056851,-21600,EB445137-D7F5-57EC-87DA-1DB460D64046,"iPhone13,2"
com.apple.MobileSMS,6,1737399273,1737399279,1737399279.784639,-21600,EB445137-D7F5-57EC-87DA-1DB460D64046,"iPhone13,2"
com.apple.MobileSMS,20,1737399167,1737399187,1737399187.575664,-21600,EB445137-D7F5-57EC-87DA-1DB460D64046,"iPhone13,2"
com.apple.Maps,1,1737399166,1737399167,1737399167.713547,-21600,EB445137-D7F5-57EC-87DA-1DB460D64046,"iPhone13,2"
com.apple.Maps,0,1737396559,1737396559,1737396560.0542722,-21600,EB445137-D7F5-57EC-87DA-1DB460D64046,"iPhone13,2"
com.apple.Maps,2,1737396557,1737396559,1737396559.311037,-21600,EB445137-D7F5-57EC-87DA-1DB460D64046,"iPhone13,2"
com.apple.Maps,12,1737394344,1737394356,1737394356.551842,-21600,EB445137-D7F5-57EC-87DA-1DB460D64046,"iPhone13,2"
com.apple.news,1,1737394342,1737394343,1737394343.603312,-21600,EB445137-D7F5-57EC-87DA-1DB460D64046,"iPhone13,2"
com.google.Chrome,186,1737392987,1737393173,1737393173.624886,-21600,,
com.apple.iphonesimulator,12,1737392975,1737392987,1737392988.652869,-21600,,
com.apple.dt.Xcode,45,1737392930,1737392975,1737392975.934006,-21600,,
com.apple.iphonesimulator,37,1737392893,1737392930,1737392930.993774,-21600,,
com.apple.dt.Xcode,82,1737392811,1737392893,1737392893.365244,-21600,,
com.google.android.studio,5,1737392806,1737392811,1737392811.486546,-21600,,
com.apple.iphonesimulator,1,1737392805,1737392806,1737392806.494773,-21600,,
com.apple.news,13,1737392774,1737392787,1737392787.9364982,-21600,EB445137-D7F5-57EC-87DA-1DB460D64046,"iPhone13,2"
com.google.android.studio,73,1737392732,1737392805,1737392805.0433269,-21600,,
com.google.Chrome,254,1737392478,1737392732,1737392732.483701,-21600,,
com.google.android.studio,4,1737392474,1737392478,1737392479.116924,-21600,,
com.apple.news,2,1737392471,1737392473,1737392474.029965,-21600,EB445137-D7F5-57EC-87DA-1DB460D64046,"iPhone13,2"
com.apple.iphonesimulator,10,1737392464,1737392474,1737392474.4739962,-21600,,
com.apple.dt.Xcode,41,1737392423,1737392464,1737392464.98881,-21600,,
com.apple.iphonesimulator,28,1737392395,1737392423,1737392423.263112,-21600,,
com.apple.dt.Xcode,64,1737392331,1737392395,1737392395.804552,-21600,,
com.apple.iphonesimulator,16,1737392315,1737392331,1737392331.800422,-21600,,
com.apple.dt.Xcode,39,1737392276,1737392315,1737392315.544522,-21600,,
com.apple.iphonesimulator,45,1737392231,1737392276,1737392276.485348,-21600,,
com.apple.dt.Xcode,16,1737392215,1737392231,1737392231.44697,-21600,,
com.apple.iphonesimulator,11,1737392204,1737392215,1737392215.114964,-21600,,
com.apple.dt.Xcode,60,1737392144,1737392204,1737392204.285224,-21600,,
com.apple.iphonesimulator,57,1737392087,1737392144,1737392144.302634,-21600,,
com.apple.dt.Xcode,9,1737392078,1737392087,1737392087.864825,-21600,,
com.apple.iphonesimulator,18,1737392060,1737392078,1737392078.5469851,-21600,,
com.apple.dt.Xcode,40,1737392020,1737392060,1737392060.060385,-21600,,
com.apple.iphonesimulator,32,1737391988,1737392020,1737392020.3583388,-21600,,
com.apple.dt.Xcode,169,1737391819,1737391988,1737391988.964715,-21600,,
com.apple.iphonesimulator,20,1737391799,1737391819,1737391819.691061,-21600,,
com.apple.dt.Xcode,49,1737391750,1737391799,1737391799.7410312,-21600,,
com.apple.iphonesimulator,4,1737391746,1737391750,1737391751.0247989,-21600,,
com.apple.dt.Xcode,43,1737391703,1737391746,1737391746.290576,-21600,,
com.apple.iphonesimulator,26,1737391677,1737391703,1737391703.929342,-21600,,
com.apple.dt.Xcode,27,1737391650,1737391677,1737391677.630525,-21600,,
com.apple.iphonesimulator,47,1737391603,1737391650,1737391650.940635,-21600,,
com.apple.dt.Xcode,15,1737391588,1737391603,1737391603.54078,-21600,,
com.apple.iphonesimulator,40,1737391548,1737391588,1737391588.27147,-21600,,
com.apple.dt.Xcode,599,1737390949,1737391548,1737391549.017366,-21600,,
com.apple.iphonesimulator,8,1737390941,1737390949,1737390949.9575958,-21600,,
com.apple.dt.Xcode,3,1737390938,1737390941,1737390941.305726,-21600,,
com.apple.news,20,1737390907,1737390927,1737390927.5611691,-21600,EB445137-D7F5-57EC-87DA-1DB460D64046,"iPhone13,2"
com.apple.news,2,1737390905,1737390907,1737390907.462373,-21600,EB445137-D7F5-57EC-87DA-1DB460D64046,"iPhone13,2"
com.microsoft.Office.Outlook,51,1737390843,1737390894,1737390894.136148,-21600,EB445137-D7F5-57EC-87DA-1DB460D64046,"iPhone13,2"
com.apple.news,1,1737390842,1737390843,1737390843.784179,-21600,EB445137-D7F5-57EC-87DA-1DB460D64046,"iPhone13,2"
com.apple.iphonesimulator,326,1737390612,1737390938,1737390938.7355971,-21600,,
com.apple.dt.Xcode,34,1737390578,1737390612,1737390613.640399,-21600,,
com.apple.iphonesimulator,58,1737390520,1737390578,1737390578.2177749,-21600,,
com.apple.dt.Xcode,82,1737390424,1737390506,1737390506.832533,-21600,,
com.google.android.studio,0,1737390424,1737390424,1737390424.692205,-21600,,
com.apple.dt.Xcode,3,1737390421,1737390424,1737390424.055598,-21600,,
com.google.android.studio,1,1737390420,1737390421,1737390421.219445,-21600,,
com.apple.dt.Xcode,3,1737390417,1737390420,1737390420.3365688,-21600,,
com.google.android.studio,4,1737390413,1737390417,1737390417.643189,-21600,,
com.apple.dt.Xcode,56,1737390357,1737390413,1737390413.145021,-21600,,
com.google.android.studio,22,1737390335,1737390357,1737390357.691824,-21600,,
com.apple.dt.Xcode,134,1737390201,1737390335,1737390335.3880692,-21600,,
com.microsoft.onenote.mac,2,1737390199,1737390201,1737390201.8981051,-21600,,
com.google.android.studio,4,1737390195,1737390199,1737390199.9047608,-21600,,
com.microsoft.onenote.mac,14,1737390181,1737390195,1737390195.3240418,-21600,,
com.leomehlig.today,16,1737390165,1737390181,1737390181.515089,-21600,,
com.google.Chrome,76,1737390089,1737390165,1737390165.553621,-21600,,
com.apple.news,263,1737389356,1737389619,1737389619.932066,-21600,EB445137-D7F5-57EC-87DA-1DB460D64046,"iPhone13,2"
com.apple.Health,9,1737389338,1737389347,1737389347.863696,-21600,EB445137-D7F5-57EC-87DA-1DB460D64046,"iPhone13,2"
com.google.Chrome,868,1737389184,1737390052,1737390052.9960098,-21600,,
com.apple.MobileSMS,6,1737389178,1737389184,1737389184.87817,-21600,,
com.leomehlig.today,4,1737389174,1737389178,1737389178.319377,-21600,,
com.microsoft.onenote.mac,10,1737389164,1737389174,1737389174.662986,-21600,,
com.apple.Health,32,1737389118,1737389150,1737389150.3026729,-21600,EB445137-D7F5-57EC-87DA-1DB460D64046,"iPhone13,2"
com.apple.Health,24,1737389091,1737389115,1737389115.6205502,-21600,EB445137-D7F5-57EC-87DA-1DB460D64046,"iPhone13,2"
com.apple.Health,61,1737388980,1737389041,1737389042.040187,-21600,EB445137-D7F5-57EC-87DA-1DB460D64046,"iPhone13,2"
com.renpho.health,1,1737388979,1737388980,1737388980.650578,-21600,EB445137-D7F5-57EC-87DA-1DB460D64046,"iPhone13,2"
com.google.Chrome,195,1737388969,1737389164,1737389164.14923,-21600,,
com.apple.Passwords,2,1737388967,1737388969,1737388969.896477,-21600,,
com.renpho.health,26,1737388226,1737388252,1737388252.619967,-21600,EB445137-D7F5-57EC-87DA-1DB460D64046,"iPhone13,2"
com.apple.MobileSMS,6,1737383552,1737383558,1737383558.4947991,-21600,EB445137-D7F5-57EC-87DA-1DB460D64046,"iPhone13,2"
com.apple.MobileSMS,10,1737383421,1737383431,1737383431.5177798,-21600,EB445137-D7F5-57EC-87DA-1DB460D64046,"iPhone13,2"
com.apple.CoreAuthUI,10,1737353624,1737353634,1737353634.047447,-21600,EB445137-D7F5-57EC-87DA-1DB460D64046,"iPhone13,2"
com.apple.journal,1195,1737353622,1737354817,1737354817.274286,-21600,EB445137-D7F5-57EC-87DA-1DB460D64046,"iPhone13,2"
com.thestorygraph.thestorygraph,23,1737353394,1737353417,1737353417.333983,-21600,EB445137-D7F5-57EC-87DA-1DB460D64046,"iPhone13,2"
com.myfitnesspal.mfp,1,1737353392,1737353393,1737353393.533867,-21600,EB445137-D7F5-57EC-87DA-1DB460D64046,"iPhone13,2"
com.apple.Passwords,19,1737350865,1737350884,1737350884.275039,-21600,,
com.google.Chrome,55,1737350810,1737350865,1737350865.8624768,-21600,,
com.myfitnesspal.mfp,32,1737348736,1737348768,1737348768.287955,-21600,EB445137-D7F5-57EC-87DA-1DB460D64046,"iPhone13,2"
com.apple.mobilenotes,4,1737348729,1737348733,1737348733.357594,-21600,EB445137-D7F5-57EC-87DA-1DB460D64046,"iPhone13,2"
com.google.Chrome,1345,1737348701,1737350046,1737350046.9904962,-21600,,
com.google.Chrome,800,1737347695,1737348495,1737348495.1041021,-21600,,
com.google.Chrome,300,1737347327,1737347627,1737347627.847261,-21600,,
com.apple.mobilenotes,142,1737347292,1737347434,1737347434.3605518,-21600,EB445137-D7F5-57EC-87DA-1DB460D64046,"iPhone13,2"
com.google.Chrome,545,1737346716,1737347261,1737347261.154408,-21600,,
com.google.Chrome,976,1737345245,1737346221,1737346221.862987,-21600,,
com.google.Chrome,634,1737344422,1737345056,1737345056.902508,-21600,,
com.apple.weather,92,1737344319,1737344411,1737344411.360965,-21600,EB445137-D7F5-57EC-87DA-1DB460D64046,"iPhone13,2"
com.microsoft.Office.Outlook,25,1737344294,1737344319,1737344319.786944,-21600,EB445137-D7F5-57EC-87DA-1DB460D64046,"iPhone13,2"
com.google.Chrome,315,1737344004,1737344319,1737344319.0898318,-21600,,
com.google.Chrome,649,1737342959,1737343608,1737343608.636225,-21600,,
com.apple.MobileSMS,5,1737342541,1737342546,1737342546.4865708,-21600,EB445137-D7F5-57EC-87DA-1DB460D64046,"iPhone13,2"
com.google.Chrome,475,1737342438,1737342913,1737342913.528431,-21600,,
com.google.Chrome,616,1737341685,1737342301,1737342301.4289842,-21600,,
com.google.Chrome,388,1737341058,1737341446,1737341446.517251,-21600,,
com.google.Chrome,300,1737340744,1737341044,1737341044.993494,-21600,,
com.apple.weather,15,1737340682,1737340697,1737340697.201261,-21600,EB445137-D7F5-57EC-87DA-1DB460D64046,"iPhone13,2"
com.google.Chrome,395,1737340284,1737340679,1737340679.278105,-21600,,
com.clairmail.fth.client,139,1737339834,1737339973,1737339973.8329601,-21600,EB445137-D7F5-57EC-87DA-1DB460D64046,"iPhone13,2"
com.google.Chrome,468,1737339810,1737340278,1737340278.0263572,-21600,,
com.apple.Passwords,8,1737339802,1737339810,1737339810.129924,-21600,,
com.google.Chrome,8,1737339794,1737339802,1737339802.404808,-21600,,
com.apple.systempreferences,2,1737339792,1737339794,1737339794.7149549,-21600,,
com.google.Chrome,0,1737339792,1737339792,1737339792.916741,-21600,,
com.apple.CoreAuthUI,4,1737339718,1737339722,1737339722.9679089,-21600,EB445137-D7F5-57EC-87DA-1DB460D64046,"iPhone13,2"
com.clairmail.fth.client,83,1737339713,1737339796,1737339796.752132,-21600,EB445137-D7F5-57EC-87DA-1DB460D64046,"iPhone13,2"
com.apple.CoreAuthUI,3,1737339660,1737339663,1737339663.6505198,-21600,EB445137-D7F5-57EC-87DA-1DB460D64046,"iPhone13,2"
com.truebill.truebillnative,54,1737339656,1737339710,1737339710.1543021,-21600,EB445137-D7F5-57EC-87DA-1DB460D64046,"iPhone13,2"
com.myfitnesspal.mfp,3,1737339643,1737339646,1737339646.075213,-21600,EB445137-D7F5-57EC-87DA-1DB460D64046,"iPhone13,2"
com.google.Chrome,467,1737338669,1737339136,1737339136.992665,-21600,,
com.leomehlig.today,46,1737338623,1737338669,1737338669.418517,-21600,,
com.google.Chrome,1,1737338622,1737338623,1737338624.160141,-21600,,
com.apple.iphonesimulator,1,1737338621,1737338622,1737338623.466691,-21600,,
com.google.android.studio,6,1737338615,1737338621,1737338621.5403352,-21600,,
com.apple.dt.Xcode,301,1737338314,1737338615,1737338616.1508908,-21600,,
com.apple.iphonesimulator,2,1737338312,1737338314,1737338315.183248,-21600,,
com.apple.dt.Xcode,20,1737338292,1737338312,1737338312.450104,-21600,,
com.apple.iphonesimulator,62,1737338230,1737338292,1737338292.923799,-21600,,
com.apple.dt.Xcode,12,1737338218,1737338230,1737338230.450031,-21600,,
com.apple.iphonesimulator,117,1737338101,1737338218,1737338218.678551,-21600,,
com.apple.dt.Xcode,68,1737338033,1737338101,1737338101.3711262,-21600,,
com.apple.iphonesimulator,37,1737337996,1737338033,1737338033.710408,-21600,,
com.apple.dt.Xcode,20,1737337976,1737337996,1737337996.322516,-21600,,
com.apple.iphonesimulator,53,1737337923,1737337976,1737337976.594489,-21600,,
com.apple.dt.Xcode,16,1737337907,1737337923,1737337923.0870938,-21600,,
com.apple.iphonesimulator,9,1737337898,1737337907,1737337907.579663,-21600,,
com.apple.dt.Xcode,49,1737337849,1737337898,1737337898.8165479,-21600,,
com.apple.iphonesimulator,67,1737337782,1737337849,1737337849.568863,-21600,,
com.apple.dt.Xcode,77,1737337705,1737337782,1737337782.792243,-21600,,
com.google.android.studio,6,1737337699,1737337705,1737337705.35983,-21600,,
com.apple.iphonesimulator,90,1737337609,1737337699,1737337699.2586489,-21600,,
com.google.android.studio,219,1737337390,1737337609,1737337609.912225,-21600,,
com.apple.iphonesimulator,41,1737337349,1737337390,1737337390.377575,-21600,,
com.apple.dt.Xcode,2,1737337347,1737337349,1737337349.952019,-21600,,
com.apple.iphonesimulator,75,1737337272,1737337347,1737337347.682106,-21600,,
com.apple.dt.Xcode,20,1737337252,1737337272,1737337272.824112,-21600,,
com.apple.iphonesimulator,219,1737337033,1737337252,1737337252.359634,-21600,,
com.apple.dt.Xcode,12,1737337021,1737337033,1737337034.3837008,-21600,,
com.google.android.studio,2,1737337019,1737337021,1737337021.3338199,-21600,,
com.apple.dt.Xcode,17,1737337002,1737337019,1737337019.675261,-21600,,
com.google.android.studio,1,1737337001,1737337002,1737337002.107014,-21600,,
com.apple.dt.Xcode,4,1737336997,1737337001,1737337001.1711478,-21600,,
com.google.android.studio,1,1737336996,1737336997,1737336997.890688,-21600,,
com.apple.dt.Xcode,9,1737336987,1737336996,1737336996.810183,-21600,,
com.google.android.studio,4,1737336983,1737336987,1737336987.617543,-21600,,
com.apple.dt.Xcode,10,1737336973,1737336983,1737336983.894384,-21600,,
com.google.android.studio,2,1737336971,1737336973,1737336974.010262,-21600,,
com.apple.dt.Xcode,22,1737336949,1737336971,1737336971.4641829,-21600,,
com.google.android.studio,4,1737336945,1737336949,1737336949.415997,-21600,,
com.apple.dt.Xcode,4,1737336941,1737336945,1737336945.2851849,-21600,,
com.google.android.studio,3,1737336938,1737336941,1737336941.96716,-21600,,
com.apple.dt.Xcode,12,1737336926,1737336938,1737336938.52041,-21600,,
com.google.android.studio,9,1737336917,1737336926,1737336926.414603,-21600,,
com.apple.dt.Xcode,14,1737336903,1737336917,1737336918.0422668,-21600,,
com.google.android.studio,77,1737336826,1737336903,1737336903.639591,-21600,,
com.apple.iphonesimulator,11,1737336777,1737336788,1737336788.36905,-21600,,
com.apple.dt.Xcode,1,1737336776,1737336777,1737336777.23504,-21600,,
com.apple.iphonesimulator,1,1737336775,1737336776,1737336776.708976,-21600,,
com.apple.dt.Xcode,6,1737336769,1737336775,1737336775.9151812,-21600,,
com.apple.iphonesimulator,56,1737336713,1737336769,1737336769.909329,-21600,,
com.apple.dt.Xcode,3,1737336710,1737336713,1737336713.518132,-21600,,
com.google.android.studio,75,1737336635,1737336710,1737336710.634067,-21600,,
com.google.android.studio,356,1737336086,1737336442,1737336442.9015431,-21600,,
com.apple.iphonesimulator,49,1737336037,1737336086,1737336086.397085,-21600,,
com.apple.dt.Xcode,24,1737336013,1737336037,1737336037.589857,-21600,,
com.apple.iphonesimulator,0,1737336013,1737336013,1737336013.8863158,-21600,,
com.apple.dt.Xcode,69,1737335944,1737336013,1737336013.038671,-21600,,
com.apple.iphonesimulator,32,1737335912,1737335944,1737335944.175397,-21600,,
com.apple.dt.Xcode,16,1737335896,1737335912,1737335912.710678,-21600,,
com.apple.iphonesimulator,21,1737335875,1737335896,1737335896.283844,-21600,,
com.apple.dt.Xcode,58,1737335817,1737335875,1737335875.7388182,-21600,,
com.apple.iphonesimulator,11,1737335806,1737335817,1737335817.185601,-21600,,
com.apple.dt.Xcode,159,1737335647,1737335806,1737335806.610004,-21600,,
com.apple.iphonesimulator,18,1737335629,1737335647,1737335647.148417,-21600,,
com.apple.dt.Xcode,16,1737335613,1737335629,1737335629.403541,-21600,,
com.google.Chrome,376,1737335237,1737335613,1737335613.5355449,-21600,,
com.myfitnesspal.mfp,366,1737335231,1737335597,1737335597.8064141,-21600,EB445137-D7F5-57EC-87DA-1DB460D64046,"iPhone13,2"
com.google.chrome.ios,2,1737335226,1737335228,1737335228.578001,-21600,EB445137-D7F5-57EC-87DA-1DB460D64046,"iPhone13,2"
com.apple.dt.Xcode,21,1737335216,1737335237,1737335237.953095,-21600,,
com.google.chrome.ios,16,1737334912,1737334928,1737334928.491689,-21600,EB445137-D7F5-57EC-87DA-1DB460D64046,"iPhone13,2"
com.toyopagroup.picaboo,1,1737334911,1737334912,1737334912.429764,-21600,EB445137-D7F5-57EC-87DA-1DB460D64046,"iPhone13,2"
com.toyopagroup.picaboo,13,1737334202,1737334215,1737334215.954757,-21600,EB445137-D7F5-57EC-87DA-1DB460D64046,"iPhone13,2"
com.toyopagroup.picaboo,12,1737333925,1737333937,1737333940.921557,-21600,EB445137-D7F5-57EC-87DA-1DB460D64046,"iPhone13,2"
com.apple.dt.Xcode,300,1737333520,1737333820,1737333820.8384218,-21600,,
com.apple.iphonesimulator,21,1737333499,1737333520,1737333520.948309,-21600,,
com.apple.dt.Xcode,4,1737333495,1737333499,1737333499.059245,-21600,,
com.apple.iphonesimulator,37,1737333458,1737333495,1737333495.590627,-21600,,
com.apple.dt.Xcode,2,1737333456,1737333458,1737333458.04372,-21600,,
com.apple.iphonesimulator,20,1737333436,1737333456,1737333456.304718,-21600,,
com.apple.dt.Xcode,8,1737333428,1737333436,1737333437.015707,-21600,,
com.google.android.studio,1,1737333427,1737333428,1737333428.7664142,-21600,,
com.apple.dt.Xcode,5,1737333422,1737333427,1737333427.6571012,-21600,,
com.google.android.studio,5,1737333417,1737333422,1737333422.765368,-21600,,
com.apple.dt.Xcode,16,1737333401,1737333417,1737333417.235421,-21600,,
com.google.android.studio,3,1737333398,1737333401,1737333401.884098,-21600,,
com.apple.dt.Xcode,2,1737333396,1737333398,1737333398.890003,-21600,,
com.google.android.studio,2,1737333394,1737333396,1737333396.1849751,-21600,,
com.apple.dt.Xcode,3,1737333391,1737333394,1737333394.975687,-21600,,
com.google.android.studio,1,1737333390,1737333391,1737333391.6892262,-21600,,
com.apple.dt.Xcode,2,1737333388,1737333390,1737333390.338927,-21600,,
com.google.android.studio,1,1737333387,1737333388,1737333389.0377378,-21600,,
com.apple.dt.Xcode,2,1737333385,1737333387,1737333387.855873,-21600,,
com.google.android.studio,5,1737333380,1737333385,1737333385.568615,-21600,,
com.apple.dt.Xcode,4,1737333376,1737333380,1737333380.711762,-21600,,
com.google.android.studio,1,1737333375,1737333376,1737333376.45571,-21600,,
com.apple.dt.Xcode,1,1737333374,1737333375,1737333375.7211761,-21600,,
com.apple.iphonesimulator,5,1737333369,1737333374,1737333374.5369759,-21600,,
com.google.android.studio,13,1737333356,1737333369,1737333369.4491181,-21600,,
com.apple.iphonesimulator,179,1737333177,1737333356,1737333356.8641438,-21600,,
com.apple.dt.Xcode,2,1737333175,1737333177,1737333178.030202,-21600,,
com.apple.iphonesimulator,22,1737333153,1737333175,1737333175.08148,-21600,,
com.apple.dt.Xcode,18,1737333135,1737333153,1737333153.875871,-21600,,
com.apple.iphonesimulator,1,1737333134,1737333135,1737333135.230434,-21600,,
com.google.android.studio,12,1737333122,1737333134,1737333134.5398688,-21600,,
com.apple.iphonesimulator,1,1737333121,1737333122,1737333122.289731,-21600,,
com.apple.dt.Xcode,12,1737333109,1737333121,1737333121.388442,-21600,,
com.apple.iphonesimulator,0,1737333109,1737333109,1737333109.9527879,-21600,,
com.google.android.studio,18,1737333091,1737333109,1737333109.110475,-21600,,
com.apple.iphonesimulator,1,1737333090,1737333091,1737333091.490726,-21600,,
com.apple.dt.Xcode,15,1737333075,1737333090,1737333090.884626,-21600,,
com.apple.iphonesimulator,58,1737333017,1737333075,1737333075.130122,-21600,,
com.apple.dt.Xcode,57,1737332960,1737333017,1737333017.6879458,-21600,,
com.apple.iphonesimulator,2,1737332958,1737332960,1737332961.02069,-21600,,
com.apple.dt.Xcode,10,1737332948,1737332958,1737332958.544323,-21600,,
com.google.android.studio,1,1737332947,1737332948,1737332948.722375,-21600,,
com.apple.dt.Xcode,7,1737332940,1737332947,1737332947.364737,-21600,,
com.google.android.studio,16,1737332924,1737332940,1737332940.494487,-21600,,
com.apple.dt.Xcode,8,1737332916,1737332924,1737332924.38024,-21600,,
com.google.android.studio,10,1737332906,1737332916,1737332916.88173,-21600,,
com.apple.dt.Xcode,7,1737332899,1737332906,1737332907.029309,-21600,,
com.google.android.studio,3,1737332896,1737332899,1737332899.8069382,-21600,,
com.apple.dt.Xcode,3,1737332893,1737332896,1737332896.27815,-21600,,
com.google.android.studio,2,1737332891,1737332893,1737332893.759009,-21600,,
com.apple.dt.Xcode,3,1737332888,1737332891,1737332891.468257,-21600,,
com.google.android.studio,8,1737332880,1737332888,1737332888.6537251,-21600,,
com.apple.dt.Xcode,8,1737332872,1737332880,1737332880.3709579,-21600,,
com.google.android.studio,1,1737332871,1737332872,1737332872.932106,-21600,,
com.apple.dt.Xcode,2,1737332869,1737332871,1737332871.701076,-21600,,
com.google.android.studio,1,1737332868,1737332869,1737332869.836283,-21600,,
com.apple.dt.Xcode,4,1737332864,1737332868,1737332868.647049,-21600,,
com.google.android.studio,12,1737332852,1737332864,1737332864.2560902,-21600,,
com.apple.dt.Xcode,19,1737332833,1737332852,1737332852.3076081,-21600,,
com.google.android.studio,7,1737332826,1737332833,1737332833.742474,-21600,,
com.apple.dt.Xcode,2,1737332824,1737332826,1737332827.069802,-21600,,
com.google.android.studio,14,1737332810,1737332824,1737332824.0800161,-21600,,
com.apple.dt.Xcode,33,1737332777,1737332810,1737332810.329418,-21600,,
com.google.android.studio,0,1737332777,1737332777,1737332777.8369951,-21600,,
com.apple.dt.Xcode,1,1737332776,1737332777,1737332777.466394,-21600,,
com.apple.iphonesimulator,1,1737332775,1737332776,1737332776.738189,-21600,,
com.google.android.studio,25,1737332750,1737332775,1737332775.350054,-21600,,
com.apple.iphonesimulator,106,1737332644,1737332750,1737332750.704129,-21600,,
com.apple.dt.Xcode,93,1737332551,1737332644,1737332644.116609,-21600,,
com.apple.iphonesimulator,2,1737332549,1737332551,1737332551.810446,-21600,,
com.apple.dt.Xcode,24,1737332525,1737332549,1737332549.274897,-21600,,
com.apple.iphonesimulator,18,1737332507,1737332525,1737332525.32693,-21600,,
com.apple.dt.Xcode,112,1737332395,1737332507,1737332507.367084,-21600,,
com.apple.iphonesimulator,26,1737332369,1737332395,1737332395.2659888,-21600,,
com.google.chrome.ios,61,1737332219,1737332280,1737332280.2898269,-21600,EB445137-D7F5-57EC-87DA-1DB460D64046,"iPhone13,2"
com.apple.dt.Xcode,612,1737331757,1737332369,1737332369.279375,-21600,,
com.google.android.studio,1,1737331756,1737331757,1737331757.537696,-21600,,
com.apple.dt.Xcode,8,1737331748,1737331756,1737331757.0424628,-21600,,
com.google.android.studio,4,1737331744,1737331748,1737331748.411957,-21600,,
com.apple.dt.Xcode,5,1737331739,1737331744,1737331744.506324,-21600,,
com.google.android.studio,74,1737331665,1737331739,1737331740.0805058,-21600,,
com.apple.dt.Xcode,383,1737331282,1737331665,1737331665.6250339,-21600,,
com.apple.iphonesimulator,1,1737331281,1737331282,1737331282.6025171,-21600,,
com.apple.dt.Xcode,2,1737331279,1737331281,1737331281.9406261,-21600,,
com.apple.iphonesimulator,4,1737331275,1737331279,1737331279.8223171,-21600,,
com.apple.dt.Xcode,4,1737331271,1737331275,1737331275.7335172,-21600,,
com.apple.iphonesimulator,119,1737331152,1737331271,1737331271.857692,-21600,,
com.apple.dt.Xcode,19,1737331133,1737331152,1737331152.845717,-21600,,
com.google.Chrome,42,1737331091,1737331133,1737331133.713335,-21600,,
com.apple.dt.Xcode,1,1737331090,1737331091,1737331091.656005,-21600,,
com.apple.iphonesimulator,12,1737331078,1737331090,1737331090.389436,-21600,,
com.apple.dt.Xcode,18,1737331060,1737331078,1737331078.9136848,-21600,,
com.google.Chrome,5,1737331055,1737331060,1737331060.301348,-21600,,
com.apple.iphonesimulator,51,1737331004,1737331055,1737331055.646418,-21600,,
com.apple.dt.Xcode,3,1737331001,1737331004,1737331004.157607,-21600,,
com.google.Chrome,20,1737330981,1737331001,1737331001.81148,-21600,,
com.apple.dt.Xcode,0,1737330981,1737330981,1737330981.8763762,-21600,,
com.apple.iphonesimulator,15,1737330966,1737330981,1737330981.144238,-21600,,
com.apple.dt.Xcode,22,1737330944,1737330966,1737330966.95078,-21600,,
com.google.Chrome,50,1737330894,1737330944,1737330944.178128,-21600,,
com.apple.dt.Xcode,11,1737330883,1737330894,1737330894.041844,-21600,,
com.apple.iphonesimulator,33,1737330850,1737330883,1737330883.902816,-21600,,
com.apple.dt.Xcode,28,1737330822,1737330850,1737330850.6411371,-21600,,
com.google.Chrome,0,1737330822,1737330822,1737330822.792903,-21600,,
com.apple.iphonesimulator,1,1737330821,1737330822,1737330822.2573051,-21600,,
com.google.Chrome,33,1737330788,1737330821,1737330821.449208,-21600,,
com.apple.iphonesimulator,1,1737330787,1737330788,1737330788.695137,-21600,,
com.apple.dt.Xcode,22,1737330765,1737330787,1737330787.8269858,-21600,,
com.apple.iphonesimulator,1,1737330764,1737330765,1737330765.667441,-21600,,
com.google.Chrome,40,1737330724,1737330764,1737330764.7102919,-21600,,
com.apple.iphonesimulator,25,1737330699,1737330724,1737330724.901489,-21600,,
com.apple.dt.Xcode,40,1737330644,1737330684,1737330685.307252,-21600,,
com.google.Chrome,3,1737330641,1737330644,1737330644.421479,-21600,,
com.apple.dt.Xcode,1,1737330640,1737330641,1737330641.902941,-21600,,
com.burbn.instagram,50,1737330452,1737330502,1737330502.649261,-21600,EB445137-D7F5-57EC-87DA-1DB460D64046,"iPhone13,2"
com.google.chrome.ios,22,1737330430,1737330452,1737330452.232568,-21600,EB445137-D7F5-57EC-87DA-1DB460D64046,"iPhone13,2"
com.facebook.Facebook,20,1737330410,1737330430,1737330430.403131,-21600,EB445137-D7F5-57EC-87DA-1DB460D64046,"iPhone13,2"
com.google.chrome.ios,33,1737330377,1737330410,1737330410.126966,-21600,EB445137-D7F5-57EC-87DA-1DB460D64046,"iPhone13,2"
com.apple.news,35,1737330332,1737330367,1737330367.9670591,-21600,EB445137-D7F5-57EC-87DA-1DB460D64046,"iPhone13,2"
com.apple.news,2,1737330330,1737330332,1737330332.2028189,-21600,EB445137-D7F5-57EC-87DA-1DB460D64046,"iPhone13,2"
com.google.Chrome,486,1737330154,1737330640,1737330640.519895,-21600,,
com.microsoft.onenote.mac,71,1737330083,1737330154,1737330154.6166701,-21600,,
com.google.Chrome,11,1737330072,1737330083,1737330083.9830232,-21600,,
com.leomehlig.today,12,1737330045,1737330057,1737330058.093802,-21600,,
com.google.Chrome,114,1737329931,1737330045,1737330046.001247,-21600,,
com.leomehlig.today,22,1737329894,1737329916,1737329916.454513,-21600,,
com.microsoft.Outlook,9,1737329885,1737329894,1737329894.3750858,-21600,,
com.google.Chrome,68,1737329817,1737329885,1737329885.592974,-21600,,
com.leomehlig.today,26,1737329791,1737329817,1737329817.8869061,-21600,,
com.google.Chrome,157,1737329634,1737329791,1737329791.592524,-21600,,
com.apple.MobileSMS,47,1737329548,1737329595,1737329595.783474,-21600,EB445137-D7F5-57EC-87DA-1DB460D64046,"iPhone13,2"
com.google.Chrome,20,1737329127,1737329147,1737329147.2659159,-21600,,
com.google.Chrome,1126,1737327037,1737328163,1737328163.839023,-21600,,
com.google.Chrome,932,1737326044,1737326976,1737326976.1730518,-21600,,
com.google.Chrome,735,1737325185,1737325920,1737325920.4311628,-21600,,
com.google.Chrome,302,1737324876,1737325178,1737325178.399987,-21600,,
com.google.Chrome,474,1737324271,1737324745,1737324745.173847,-21600,,
com.google.Chrome,169,1737323985,1737324154,1737324154.329413,-21600,,
com.google.Chrome,400,1737322895,1737323295,1737323295.537324,-21600,,
com.google.Chrome,347,1737322406,1737322753,1737322753.169872,-21600,,
com.apple.Health,46,1737322383,1737322429,1737322429.196228,-21600,EB445137-D7F5-57EC-87DA-1DB460D64046,"iPhone13,2"
com.facebook.Facebook,56,1737321890,1737321946,1737321946.139292,-21600,EB445137-D7F5-57EC-87DA-1DB460D64046,"iPhone13,2"
com.google.Chrome,1383,1737320595,1737321978,1737321978.99312,-21600,,
com.google.Chrome,510,1737319978,1737320488,1737320488.356338,-21600,,
com.google.Chrome,927,1737318820,1737319747,1737319747.935144,-21600,,
com.zhiliaoapp.musically,295,1737317768,1737318063,1737318063.147748,-21600,EB445137-D7F5-57EC-87DA-1DB460D64046,"iPhone13,2"
com.apple.weather,19,1737317735,1737317754,1737317754.0871248,-21600,EB445137-D7F5-57EC-87DA-1DB460D64046,"iPhone13,2"
com.google.Chrome,655,1737317712,1737318367,1737318367.285389,-21600,,
com.microsoft.Outlook,72,1737317640,1737317712,1737317712.505289,-21600,,
com.google.Chrome,35,1737317605,1737317640,1737317640.644617,-21600,,
com.google.Chrome,326,1737317176,1737317502,1737317502.1063662,-21600,,
com.google.Chrome,22,1737316916,1737316938,1737316938.322355,-21600,,
com.leomehlig.today,15,1737316901,1737316916,1737316916.520148,-21600,,
com.apple.dt.Xcode,10,1737316891,1737316901,1737316901.091885,-21600,,
com.microsoft.onenote.mac,3,1737316888,1737316891,1737316892.046939,-21600,,
com.google.android.studio,6,1737316882,1737316888,1737316888.400398,-21600,,
com.microsoft.onenote.mac,14,1737316868,1737316882,1737316883.107826,-21600,,
com.apple.iphonesimulator,4,1737316864,1737316868,1737316868.301837,-21600,,
com.google.Chrome,22,1737316842,1737316864,1737316864.081862,-21600,,
com.apple.iphonesimulator,30,1737316812,1737316842,1737316842.979382,-21600,,
com.apple.dt.Xcode,14,1737316798,1737316812,1737316812.1923552,-21600,,
com.apple.iphonesimulator,1,1737316797,1737316798,1737316798.298088,-21600,,
com.google.Chrome,50,1737316747,1737316797,1737316797.359041,-21600,,
com.apple.iphonesimulator,32,1737316715,1737316747,1737316747.213213,-21600,,
com.apple.dt.Xcode,22,1737316693,1737316715,1737316715.6770082,-21600,,
com.apple.iphonesimulator,2,1737316691,1737316693,1737316693.861741,-21600,,
com.google.Chrome,52,1737316639,1737316691,1737316691.8991141,-21600,,
com.apple.iphonesimulator,69,1737316570,1737316639,1737316639.326791,-21600,,
com.apple.dt.Xcode,9,1737316561,1737316570,1737316570.9981952,-21600,,
com.apple.iphonesimulator,5,1737316556,1737316561,1737316561.0950642,-21600,,
com.apple.dt.Xcode,7,1737316549,1737316556,1737316556.1949348,-21600,,
com.apple.iphonesimulator,7,1737316542,1737316549,1737316549.906752,-21600,,
com.apple.dt.Xcode,14,1737316528,1737316542,1737316542.7623181,-21600,,
com.apple.iphonesimulator,6,1737316522,1737316528,1737316528.656215,-21600,,
com.apple.dt.Xcode,6,1737316516,1737316522,1737316522.402049,-21600,,
com.apple.iphonesimulator,15,1737316501,1737316516,1737316516.66727,-21600,,
com.apple.dt.Xcode,19,1737316482,1737316501,1737316501.7015672,-21600,,
com.apple.iphonesimulator,61,1737316421,1737316482,1737316482.198329,-21600,,
com.apple.dt.Xcode,13,1737316408,1737316421,1737316421.426882,-21600,,
com.apple.iphonesimulator,6,1737316402,1737316408,1737316408.709486,-21600,,
com.apple.dt.Xcode,19,1737316383,1737316402,1737316402.418827,-21600,,
com.apple.iphonesimulator,14,1737316369,1737316383,1737316383.847003,-21600,,
com.apple.dt.Xcode,192,1737316177,1737316369,1737316369.4149752,-21600,,
com.apple.iphonesimulator,11,1737316166,1737316177,1737316177.716949,-21600,,
com.apple.dt.Xcode,68,1737316098,1737316166,1737316167.014662,-21600,,
com.apple.iphonesimulator,25,1737316073,1737316098,1737316098.666708,-21600,,
com.apple.dt.Xcode,87,1737315986,1737316073,1737316073.1933331,-21600,,
com.apple.iphonesimulator,54,1737315932,1737315986,1737315986.181116,-21600,,
com.apple.dt.Xcode,114,1737315818,1737315932,1737315933.4801378,-21600,,
com.apple.iphonesimulator,55,1737315763,1737315818,1737315818.742917,-21600,,
com.apple.dt.Xcode,11,1737315752,1737315763,1737315763.566824,-21600,,
com.apple.iphonesimulator,9,1737315743,1737315752,1737315752.845372,-21600,,
com.apple.dt.Xcode,4,1737315739,1737315743,1737315743.6776562,-21600,,
com.apple.iphonesimulator,20,1737315719,1737315739,1737315739.2665071,-21600,,
com.apple.dt.Xcode,26,1737315693,1737315719,1737315719.770485,-21600,,
com.apple.iphonesimulator,46,1737315647,1737315693,1737315693.868052,-21600,,
com.apple.dt.Xcode,82,1737315565,1737315647,1737315648.0353599,-21600,,
com.google.Chrome,25,1737315540,1737315565,1737315565.3749309,-21600,,
com.apple.dt.Xcode,8,1737315532,1737315540,1737315540.079643,-21600,,
com.google.Chrome,17,1737315515,1737315532,1737315532.841769,-21600,,
com.apple.dt.Xcode,1,1737315514,1737315515,1737315515.7109761,-21600,,
com.google.Chrome,1,1737315513,1737315514,1737315514.567377,-21600,,
com.apple.dt.Xcode,305,1737315208,1737315513,1737315514.173595,-21600,,
com.google.Chrome,28,1737315180,1737315208,1737315208.632307,-21600,,
com.apple.dt.Xcode,2,1737315178,1737315180,1737315180.8121672,-21600,,
com.apple.iphonesimulator,10,1737315168,1737315178,1737315178.5748801,-21600,,
com.apple.dt.Xcode,2,1737315166,1737315168,1737315168.846446,-21600,,
com.apple.iphonesimulator,5,1737315161,1737315166,1737315167.071801,-21600,,
com.apple.dt.Xcode,2,1737315159,1737315161,1737315161.260473,-21600,,
com.google.android.studio,206,1737314953,1737315159,1737315159.5127668,-21600,,
com.google.Chrome,30,1737314923,1737314953,1737314953.952416,-21600,,
com.leomehlig.today,1,1737314922,1737314923,1737314924.063318,-21600,,
com.google.android.studio,6,1737314916,1737314922,1737314922.529162,-21600,,
com.apple.dt.Xcode,1,1737314915,1737314916,1737314916.123499,-21600,,
com.apple.iphonesimulator,107,1737314808,1737314915,1737314915.5219932,-21600,,
com.apple.dt.Xcode,14,1737314794,1737314808,1737314809.504545,-21600,,
com.google.android.studio,2,1737314762,1737314764,1737314764.397789,-21600,,
com.apple.dt.Xcode,5,1737314757,1737314762,1737314762.6476731,-21600,,
com.google.android.studio,2,1737314755,1737314757,1737314757.3790278,-21600,,
com.apple.dt.Xcode,7,1737314748,1737314755,1737314755.826659,-21600,,
com.google.android.studio,1,1737314747,1737314748,1737314748.47611,-21600,,
com.apple.dt.Xcode,4,1737314743,1737314747,1737314747.879256,-21600,,
com.google.android.studio,2,1737314741,1737314743,1737314743.6609101,-21600,,
com.apple.dt.Xcode,15,1737314726,1737314741,1737314741.1288671,-21600,,
com.google.android.studio,2,1737314724,1737314726,1737314726.25211,-21600,,
com.apple.dt.Xcode,8,1737314716,1737314724,1737314725.032477,-21600,,
com.google.android.studio,2,1737314714,1737314716,1737314716.1033878,-21600,,
com.apple.dt.Xcode,2,1737314712,1737314714,1737314714.813861,-21600,,
com.apple.MobileSMS,38,1737314609,1737314647,1737314647.226547,-21600,EB445137-D7F5-57EC-87DA-1DB460D64046,"iPhone13,2"
com.google.android.studio,152,1737314560,1737314712,1737314712.048173,-21600,,
com.apple.dt.Xcode,10,1737314550,1737314560,1737314560.574995,-21600,,
com.microsoft.onenote.mac,4,1737314546,1737314550,1737314550.35799,-21600,,
com.apple.dt.Xcode,2,1737314544,1737314546,1737314546.518384,-21600,,
com.microsoft.onenote.mac,1,1737314543,1737314544,1737314544.816721,-21600,,
com.apple.dt.Xcode,12,1737314531,1737314543,1737314543.766035,-21600,,
com.microsoft.onenote.mac,19,1737314512,1737314531,1737314531.934428,-21600,,
com.apple.finder,10,1737314502,1737314512,1737314512.597824,-21600,,
com.apple.Notes,9,1737314493,1737314502,1737314502.8600779,-21600,,
com.leomehlig.today,10,1737314483,1737314493,1737314493.723773,-21600,,
com.google.Chrome,43,1737314440,1737314483,1737314483.334228,-21600,,
com.apple.MobileSMS,24,1737314394,1737314418,1737314418.725039,-21600,EB445137-D7F5-57EC-87DA-1DB460D64046,"iPhone13,2"
com.apple.MobileSMS,2,1737314391,1737314393,1737314394.007016,-21600,EB445137-D7F5-57EC-87DA-1DB460D64046,"iPhone13,2"
com.apple.MobileSMS,10,1737314292,1737314302,1737314303.011743,-21600,EB445137-D7F5-57EC-87DA-1DB460D64046,"iPhone13,2"
com.apple.CoreAuthUI,2,1737314027,1737314029,1737314029.2066941,-21600,EB445137-D7F5-57EC-87DA-1DB460D64046,"iPhone13,2"
com.apple.CoreAuthUI,2,1737314024,1737314026,1737314026.0522342,-21600,EB445137-D7F5-57EC-87DA-1DB460D64046,"iPhone13,2"
com.google.chrome.ios,86,1737313999,1737314085,1737314085.544018,-21600,EB445137-D7F5-57EC-87DA-1DB460D64046,"iPhone13,2"
com.apple.MobileSMS,3,1737313996,1737313999,1737313999.5362291,-21600,EB445137-D7F5-57EC-87DA-1DB460D64046,"iPhone13,2"
com.apple.MobileSMS,25,1737313970,1737313995,1737313995.5506182,-21600,EB445137-D7F5-57EC-87DA-1DB460D64046,"iPhone13,2"
com.apple.MobileSMS,5,1737313382,1737313387,1737313387.58744,-21600,EB445137-D7F5-57EC-87DA-1DB460D64046,"iPhone13,2"
com.apple.MobileSMS,15,1737313112,1737313127,1737313128.090131,-21600,EB445137-D7F5-57EC-87DA-1DB460D64046,"iPhone13,2"
com.toyopagroup.picaboo,2,1737313109,1737313111,1737313112.0658221,-21600,EB445137-D7F5-57EC-87DA-1DB460D64046,"iPhone13,2"
com.apple.Maps,2,1737313105,1737313107,1737313108.39072,-21600,EB445137-D7F5-57EC-87DA-1DB460D64046,"iPhone13,2"
com.google.Chrome,5,1737311903,1737311908,1737311909.056854,-21600,,
com.leomehlig.today,2,1737311901,1737311903,1737311903.181277,-21600,,
com.apple.Maps,4,1737310049,1737310053,1737310053.600467,-21600,EB445137-D7F5-57EC-87DA-1DB460D64046,"iPhone13,2"
com.apple.Maps,18,1737310031,1737310049,1737310049.46804,-21600,EB445137-D7F5-57EC-87DA-1DB460D64046,"iPhone13,2"
com.apple.Maps,12,1737310019,1737310031,1737310031.1113238,-21600,EB445137-D7F5-57EC-87DA-1DB460D64046,"iPhone13,2"
com.apple.news,2,1737310017,1737310019,1737310019.219061,-21600,EB445137-D7F5-57EC-87DA-1DB460D64046,"iPhone13,2"
com.leomehlig.today,160,1737310010,1737310170,1737310170.5597792,-21600,,
com.leomehlig.today,18,1737309955,1737309973,1737309973.747013,-21600,,
com.google.Chrome,2,1737309953,1737309955,1737309955.4088101,-21600,,
com.google.Chrome,8,1737309869,1737309877,1737309877.700963,-21600,,
com.apple.news,26,1737309800,1737309826,1737309826.91018,-21600,EB445137-D7F5-57EC-87DA-1DB460D64046,"iPhone13,2"
com.zhiliaoapp.musically,41,1737309752,1737309793,1737309793.848232,-21600,EB445137-D7F5-57EC-87DA-1DB460D64046,"iPhone13,2"
com.apple.news,104,1737309646,1737309750,1737309750.401967,-21600,EB445137-D7F5-57EC-87DA-1DB460D64046,"iPhone13,2"
com.toyopagroup.picaboo,52,1737309589,1737309641,1737309641.693697,-21600,EB445137-D7F5-57EC-87DA-1DB460D64046,"iPhone13,2"
com.apple.findmy,40,1737309533,1737309573,1737309573.338368,-21600,EB445137-D7F5-57EC-87DA-1DB460D64046,"iPhone13,2"
com.toyopagroup.picaboo,20,1737309512,1737309532,1737309532.1821089,-21600,EB445137-D7F5-57EC-87DA-1DB460D64046,"iPhone13,2"
com.apple.MobileSMS,1,1737309511,1737309512,1737309512.859517,-21600,EB445137-D7F5-57EC-87DA-1DB460D64046,"iPhone13,2"
com.apple.MobileSMS,168,1737309341,1737309509,1737309509.6027908,-21600,EB445137-D7F5-57EC-87DA-1DB460D64046,"iPhone13,2"
com.microsoft.Office.Outlook,0,1737309341,1737309341,1737309341.623174,-21600,EB445137-D7F5-57EC-87DA-1DB460D64046,"iPhone13,2"
com.microsoft.Office.Outlook,73,1737309231,1737309304,1737309304.059402,-21600,EB445137-D7F5-57EC-87DA-1DB460D64046,"iPhone13,2"
com.apple.MobileSMS,39,1737308989,1737309028,1737309028.363363,-21600,EB445137-D7F5-57EC-87DA-1DB460D64046,"iPhone13,2"
com.apple.Music,0,1737308989,1737308989,1737308989.9487839,-21600,EB445137-D7F5-57EC-87DA-1DB460D64046,"iPhone13,2"
com.google.Chrome,313,1737308457,1737308770,1737308770.018526,-21600,,
com.apple.Music,27,1737307667,1737307694,1737307694.883681,-21600,EB445137-D7F5-57EC-87DA-1DB460D64046,"iPhone13,2"
com.apple.mobilenotes,1,1737307666,1737307667,1737307667.352469,-21600,EB445137-D7F5-57EC-87DA-1DB460D64046,"iPhone13,2"
com.apple.mobilenotes,5,1737306990,1737306995,1737306995.790158,-21600,EB445137-D7F5-57EC-87DA-1DB460D64046,"iPhone13,2"
com.apple.mobilenotes,4,1737306889,1737306893,1737306893.473023,-21600,EB445137-D7F5-57EC-87DA-1DB460D64046,"iPhone13,2"
com.apple.mobilenotes,20,1737306866,1737306886,1737306886.8024511,-21600,EB445137-D7F5-57EC-87DA-1DB460D64046,"iPhone13,2"
com.apple.mobilenotes,12,1737306374,1737306386,1737306387.035192,-21600,EB445137-D7F5-57EC-87DA-1DB460D64046,"iPhone13,2"
com.apple.mobilenotes,39,1737306020,1737306059,1737306059.57099,-21600,EB445137-D7F5-57EC-87DA-1DB460D64046,"iPhone13,2"
com.meijer.mobile.Meijer,3,1737306017,1737306020,1737306020.714237,-21600,EB445137-D7F5-57EC-87DA-1DB460D64046,"iPhone13,2"
com.meijer.mobile.Meijer,35,1737305940,1737305975,1737305975.232857,-21600,EB445137-D7F5-57EC-87DA-1DB460D64046,"iPhone13,2"
com.meijer.mobile.Meijer,25,1737305841,1737305866,1737305866.675092,-21600,EB445137-D7F5-57EC-87DA-1DB460D64046,"iPhone13,2"
com.apple.mobilenotes,2,1737305839,1737305841,1737305841.43452,-21600,EB445137-D7F5-57EC-87DA-1DB460D64046,"iPhone13,2"
com.apple.mobilenotes,17,1737305695,1737305712,1737305712.535802,-21600,EB445137-D7F5-57EC-87DA-1DB460D64046,"iPhone13,2"
com.meijer.mobile.Meijer,5,1737305690,1737305695,1737305695.65204,-21600,EB445137-D7F5-57EC-87DA-1DB460D64046,"iPhone13,2"
com.meijer.mobile.Meijer,35,1737305475,1737305510,1737305510.788158,-21600,EB445137-D7F5-57EC-87DA-1DB460D64046,"iPhone13,2"
com.apple.mobilenotes,9,1737305463,1737305472,1737305472.788477,-21600,EB445137-D7F5-57EC-87DA-1DB460D64046,"iPhone13,2"
com.apple.mobilenotes,6,1737305214,1737305220,1737305220.959704,-21600,EB445137-D7F5-57EC-87DA-1DB460D64046,"iPhone13,2"
com.apple.mobilenotes,109,1737305045,1737305154,1737305154.465384,-21600,EB445137-D7F5-57EC-87DA-1DB460D64046,"iPhone13,2"
com.tinyspeck.chatlyio,7,1737303997,1737304004,1737304004.540556,-21600,EB445137-D7F5-57EC-87DA-1DB460D64046,"iPhone13,2"
com.apple.Music,1,1737303993,1737303994,1737303994.932159,-21600,EB445137-D7F5-57EC-87DA-1DB460D64046,"iPhone13,2"
com.apple.Music,18,1737303132,1737303150,1737303150.174978,-21600,EB445137-D7F5-57EC-87DA-1DB460D64046,"iPhone13,2"
com.apple.weather,2,1737303130,1737303132,1737303132.490546,-21600,EB445137-D7F5-57EC-87DA-1DB460D64046,"iPhone13,2"
com.google.Chrome,144,1737302780,1737302924,1737302924.563436,-21600,,
com.apple.Notes,4,1737302776,1737302780,1737302780.446636,-21600,,
com.google.Chrome,44,1737302732,1737302776,1737302776.914476,-21600,,
com.apple.Notes,197,1737302535,1737302732,1737302732.8864799,-21600,,
com.google.Chrome,2,1737302533,1737302535,1737302535.75753,-21600,,
com.apple.Notes,25,1737302508,1737302533,1737302533.641053,-21600,,
com.google.Chrome,4,1737302504,1737302508,1737302508.093929,-21600,,
com.apple.Notes,8,1737302496,1737302504,1737302504.384068,-21600,,
com.google.Chrome,3,1737302493,1737302496,1737302496.7847738,-21600,,
com.apple.Notes,3,1737302490,1737302493,1737302493.5162659,-21600,,
com.google.Chrome,3,1737302487,1737302490,1737302491.007627,-21600,,
com.apple.Notes,2,1737302485,1737302487,1737302487.454133,-21600,,
com.google.Chrome,10,1737302475,1737302485,1737302485.0400481,-21600,,
com.apple.Notes,3,1737302472,1737302475,1737302475.1892219,-21600,,
com.google.Chrome,2,1737302470,1737302472,1737302472.59839,-21600,,
com.apple.Notes,2,1737302468,1737302470,1737302470.5803351,-21600,,
com.google.Chrome,3,1737302465,1737302468,1737302468.126018,-21600,,
com.apple.Notes,7,1737302458,1737302465,1737302465.578257,-21600,,
com.google.Chrome,1,1737302457,1737302458,1737302458.826163,-21600,,
com.apple.Notes,5,1737302452,1737302457,1737302457.1086922,-21600,,
com.google.Chrome,5,1737302447,1737302452,1737302452.737989,-21600,,
com.apple.Notes,3,1737302444,1737302447,1737302447.959515,-21600,,
com.google.Chrome,1,1737302443,1737302444,1737302444.9096708,-21600,,
com.apple.Notes,3,1737302440,1737302443,1737302443.892041,-21600,,
com.google.Chrome,3,1737302437,1737302440,1737302440.267757,-21600,,
com.apple.Notes,2,1737302435,1737302437,1737302437.989182,-21600,,
com.google.Chrome,2,1737302433,1737302435,1737302435.393605,-21600,,
com.apple.Notes,6,1737302427,1737302433,1737302433.066136,-21600,,
com.google.Chrome,1,1737302426,1737302427,1737302427.872515,-21600,,
com.apple.Notes,1,1737302425,1737302426,1737302426.2758842,-21600,,
com.google.Chrome,3,1737302422,1737302425,1737302425.123853,-21600,,
com.apple.Notes,11,1737302411,1737302422,1737302422.420611,-21600,,
com.google.Chrome,55,1737302356,1737302411,1737302411.195216,-21600,,
com.apple.Notes,13,1737302343,1737302356,1737302356.758919,-21600,,
com.google.Chrome,4,1737302339,1737302343,1737302343.3088331,-21600,,
com.microsoft.onenote.mac,3,1737302336,1737302339,1737302339.955687,-21600,,
com.google.Chrome,9,1737302327,1737302336,1737302336.234911,-21600,,
com.google.Chrome,302,1737301906,1737302208,1737302208.689471,-21600,,
com.apple.weather,77,1737301027,1737301104,1737301104.82813,-21600,EB445137-D7F5-57EC-87DA-1DB460D64046,"iPhone13,2"
com.google.Chrome,593,1737300923,1737301516,1737301516.353531,-21600,,
com.apple.finder,10,1737300913,1737300923,1737300923.247958,-21600,,
com.apple.Preview,19,1737300894,1737300913,1737300913.693687,-21600,,
com.apple.finder,11,1737300883,1737300894,1737300894.7848449,-21600,,
com.google.Chrome,2,1737300881,1737300883,1737300883.7682,-21600,,
com.apple.finder,13,1737300868,1737300881,1737300881.34896,-21600,,
com.apple.Preview,13,1737300855,1737300868,1737300868.950901,-21600,,
com.apple.finder,2,1737300853,1737300855,1737300855.07303,-21600,,
com.google.Chrome,6,1737300847,1737300853,1737300853.278061,-21600,,
com.apple.finder,4,1737300843,1737300847,1737300847.963311,-21600,,
com.google.Chrome,164,1737300679,1737300843,1737300843.721733,-21600,,
com.apple.Preferences,79,1737269572,1737269651,1737269652.2421288,-21600,EB445137-D7F5-57EC-87DA-1DB460D64046,"iPhone13,2"
com.apple.news,181,1737269370,1737269551,1737269551.391218,-21600,EB445137-D7F5-57EC-87DA-1DB460D64046,"iPhone13,2"
com.hulu.plus,247,1737269099,1737269346,1737269346.695092,-21600,EB445137-D7F5-57EC-87DA-1DB460D64046,"iPhone13,2"
com.hulu.plus,337,1737268761,1737269098,1737269098.937615,-21600,EB445137-D7F5-57EC-87DA-1DB460D64046,"iPhone13,2"
com.hulu.plus,3,1737268758,1737268761,1737268761.327283,-21600,EB445137-D7F5-57EC-87DA-1DB460D64046,"iPhone13,2"
com.hulu.plus,645,1737268112,1737268757,1737268757.975344,-21600,EB445137-D7F5-57EC-87DA-1DB460D64046,"iPhone13,2"
com.hulu.plus,406,1737267705,1737268111,1737268111.311805,-21600,EB445137-D7F5-57EC-87DA-1DB460D64046,"iPhone13,2"
com.hulu.plus,960,1737266743,1737267703,1737267703.502032,-21600,EB445137-D7F5-57EC-87DA-1DB460D64046,"iPhone13,2"
com.hulu.plus,345,1737266397,1737266742,1737266742.660125,-21600,EB445137-D7F5-57EC-87DA-1DB460D64046,"iPhone13,2"
com.apple.CoreAuthUI,5,1737266234,1737266239,1737266240.2663689,-21600,EB445137-D7F5-57EC-87DA-1DB460D64046,"iPhone13,2"
com.apple.CoreAuthUI,2,1737266223,1737266225,1737266225.271419,-21600,EB445137-D7F5-57EC-87DA-1DB460D64046,"iPhone13,2"
com.hulu.plus,210,1737266185,1737266395,1737266395.901005,-21600,EB445137-D7F5-57EC-87DA-1DB460D64046,"iPhone13,2"
com.apple.weather,26,1737266111,1737266137,1737266137.179884,-21600,EB445137-D7F5-57EC-87DA-1DB460D64046,"iPhone13,2"
com.apple.mobilephone,11,1737266088,1737266099,1737266099.048069,-21600,EB445137-D7F5-57EC-87DA-1DB460D64046,"iPhone13,2"
com.apple.news,1,1737266035,1737266036,1737266036.974493,-21600,EB445137-D7F5-57EC-87DA-1DB460D64046,"iPhone13,2"
com.apple.news,21,1737264811,1737264832,1737264832.7749062,-21600,EB445137-D7F5-57EC-87DA-1DB460D64046,"iPhone13,2"
com.apple.Preferences,19,1737264780,1737264799,1737264799.712034,-21600,EB445137-D7F5-57EC-87DA-1DB460D64046,"iPhone13,2"
com.google.ios.ytcreator,123,1737262712,1737262835,1737262835.164689,-21600,EB445137-D7F5-57EC-87DA-1DB460D64046,"iPhone13,2"
com.apple.news,3,1737262705,1737262708,1737262708.792712,-21600,EB445137-D7F5-57EC-87DA-1DB460D64046,"iPhone13,2"
com.zhiliaoapp.musically,4,1737262701,1737262705,1737262705.919641,-21600,EB445137-D7F5-57EC-87DA-1DB460D64046,"iPhone13,2"
com.zhiliaoapp.musically,44,1737261973,1737262017,1737262017.155617,-21600,EB445137-D7F5-57EC-87DA-1DB460D64046,"iPhone13,2"
com.apple.news,1,1737261969,1737261970,1737261970.9243321,-21600,EB445137-D7F5-57EC-87DA-1DB460D64046,"iPhone13,2"
com.apple.news,104,1737261684,1737261788,1737261789.265702,-21600,EB445137-D7F5-57EC-87DA-1DB460D64046,"iPhone13,2"
com.apple.findmy,2,1737241537,1737241539,1737241539.9906878,-21600,EB445137-D7F5-57EC-87DA-1DB460D64046,"iPhone13,2"
com.apple.findmy,1,1737239937,1737239938,1737239939.718176,-21600,EB445137-D7F5-57EC-87DA-1DB460D64046,"iPhone13,2"
com.apple.InCallService,2,1737239935,1737239937,1737239937.391654,-21600,EB445137-D7F5-57EC-87DA-1DB460D64046,"iPhone13,2"
com.apple.findmy,100,1737239835,1737239935,1737239935.6926498,-21600,EB445137-D7F5-57EC-87DA-1DB460D64046,"iPhone13,2"
com.apple.InCallService,8,1737239827,1737239835,1737239835.937172,-21600,EB445137-D7F5-57EC-87DA-1DB460D64046,"iPhone13,2"
com.apple.mobilephone,3,1737239824,1737239827,1737239827.597445,-21600,EB445137-D7F5-57EC-87DA-1DB460D64046,"iPhone13,2"
com.google.Chrome,66,1737239753,1737239819,1737239819.827004,-21600,,
com.apple.finder,2,1737239725,1737239727,1737239727.105926,-21600,,
com.apple.findmy,136,1737239688,1737239824,1737239824.6710138,-21600,EB445137-D7F5-57EC-87DA-1DB460D64046,"iPhone13,2"
com.apple.MobileSMS,2,1737239683,1737239685,1737239685.664778,-21600,EB445137-D7F5-57EC-87DA-1DB460D64046,"iPhone13,2"
com.apple.MobileSMS,64,1737239563,1737239627,1737239627.630271,-21600,EB445137-D7F5-57EC-87DA-1DB460D64046,"iPhone13,2"
com.apple.findmy,10,1737239553,1737239563,1737239563.843379,-21600,EB445137-D7F5-57EC-87DA-1DB460D64046,"iPhone13,2"
com.apple.MobileSMS,4,1737239549,1737239553,1737239553.5818691,-21600,EB445137-D7F5-57EC-87DA-1DB460D64046,"iPhone13,2"
com.apple.findmy,0,1737239549,1737239549,1737239550.283314,-21600,EB445137-D7F5-57EC-87DA-1DB460D64046,"iPhone13,2"
com.apple.findmy,8,1737238428,1737238436,1737238436.459248,-21600,EB445137-D7F5-57EC-87DA-1DB460D64046,"iPhone13,2"
com.apple.Maps,4,1737235513,1737235517,1737235517.307376,-21600,EB445137-D7F5-57EC-87DA-1DB460D64046,"iPhone13,2"
com.apple.findmy,14,1737235499,1737235513,1737235513.387868,-21600,EB445137-D7F5-57EC-87DA-1DB460D64046,"iPhone13,2"
com.apple.MobileSMS,2,1737235497,1737235499,1737235499.607895,-21600,EB445137-D7F5-57EC-87DA-1DB460D64046,"iPhone13,2"
com.apple.MobileSMS,29,1737233192,1737233221,1737233221.656158,-21600,EB445137-D7F5-57EC-87DA-1DB460D64046,"iPhone13,2"
com.apple.Music,1,1737233191,1737233192,1737233193.300242,-21600,EB445137-D7F5-57EC-87DA-1DB460D64046,"iPhone13,2"
com.apple.Music,9,1737232824,1737232833,1737232833.1812701,-21600,EB445137-D7F5-57EC-87DA-1DB460D64046,"iPhone13,2"
com.apple.podcasts,2,1737232822,1737232824,1737232824.3790379,-21600,EB445137-D7F5-57EC-87DA-1DB460D64046,"iPhone13,2"
com.apple.podcasts,2,1737231684,1737231686,1737231686.790893,-21600,EB445137-D7F5-57EC-87DA-1DB460D64046,"iPhone13,2"
com.apple.podcasts,13,1737229635,1737229648,1737229649.128036,-21600,EB445137-D7F5-57EC-87DA-1DB460D64046,"iPhone13,2"
com.apple.Music,22,1737229102,1737229124,1737229124.894565,-21600,EB445137-D7F5-57EC-87DA-1DB460D64046,"iPhone13,2"
com.google.chrome.ios,3,1737229099,1737229102,1737229102.3553162,-21600,EB445137-D7F5-57EC-87DA-1DB460D64046,"iPhone13,2"
com.google.chrome.ios,15,1737228817,1737228832,1737228832.379743,-21600,EB445137-D7F5-57EC-87DA-1DB460D64046,"iPhone13,2"
com.apple.Music,1,1737228815,1737228816,1737228817.149061,-21600,EB445137-D7F5-57EC-87DA-1DB460D64046,"iPhone13,2"
com.apple.Music,20,1737228279,1737228299,1737228300.057733,-21600,EB445137-D7F5-57EC-87DA-1DB460D64046,"iPhone13,2"
com.apple.Music,4,1737228011,1737228015,1737228015.3902168,-21600,EB445137-D7F5-57EC-87DA-1DB460D64046,"iPhone13,2"
com.apple.Music,4,1737227632,1737227636,1737227637.460229,-21600,EB445137-D7F5-57EC-87DA-1DB460D64046,"iPhone13,2"
com.apple.Music,111,1737226692,1737226803,1737226803.511857,-21600,EB445137-D7F5-57EC-87DA-1DB460D64046,"iPhone13,2"
com.apple.Music,7,1737226254,1737226261,1737226261.696903,-21600,EB445137-D7F5-57EC-87DA-1DB460D64046,"iPhone13,2"
com.apple.Music,5,1737223827,1737223832,1737223832.330493,-21600,EB445137-D7F5-57EC-87DA-1DB460D64046,"iPhone13,2"
com.apple.podcasts,59,1737223765,1737223824,1737223824.247653,-21600,EB445137-D7F5-57EC-87DA-1DB460D64046,"iPhone13,2"
com.apple.Music,31,1737223732,1737223763,1737223763.832076,-21600,EB445137-D7F5-57EC-87DA-1DB460D64046,"iPhone13,2"
com.apple.Music,7,1737223722,1737223729,1737223729.861923,-21600,EB445137-D7F5-57EC-87DA-1DB460D64046,"iPhone13,2"
com.apple.MobileSMS,12,1737223700,1737223712,1737223712.354755,-21600,EB445137-D7F5-57EC-87DA-1DB460D64046,"iPhone13,2"
com.apple.Maps,9,1737223691,1737223700,1737223700.2739282,-21600,EB445137-D7F5-57EC-87DA-1DB460D64046,"iPhone13,2"
com.apple.MobileSMS,6,1737223685,1737223691,1737223691.239836,-21600,EB445137-D7F5-57EC-87DA-1DB460D64046,"iPhone13,2"
com.apple.Maps,15,1737223670,1737223685,1737223685.313918,-21600,EB445137-D7F5-57EC-87DA-1DB460D64046,"iPhone13,2"
com.apple.finder,10,1737223181,1737223191,1737223191.997536,-21600,,
com.apple.Music,65,1737223116,1737223181,1737223181.54042,-21600,,
com.google.Chrome,2,1737223114,1737223116,1737223116.861737,-21600,,
com.apple.news,49,1737222673,1737222722,1737222722.721994,-21600,EB445137-D7F5-57EC-87DA-1DB460D64046,"iPhone13,2"
com.burbn.instagram,12,1737216761,1737216773,1737216773.1840901,-21600,EB445137-D7F5-57EC-87DA-1DB460D64046,"iPhone13,2"
com.facebook.Facebook,62,1737216696,1737216758,1737216758.690407,-21600,EB445137-D7F5-57EC-87DA-1DB460D64046,"iPhone13,2"
com.apple.Health,15,1737212886,1737212901,1737212901.3698,-21600,EB445137-D7F5-57EC-87DA-1DB460D64046,"iPhone13,2"
com.google.chrome.ios,157,1737210737,1737210894,1737210894.775756,-21600,EB445137-D7F5-57EC-87DA-1DB460D64046,"iPhone13,2"
com.google.Gmail,68,1737210669,1737210737,1737210737.665417,-21600,EB445137-D7F5-57EC-87DA-1DB460D64046,"iPhone13,2"
com.apple.mobilenotes,106,1737181730,1737181836,1737181836.453123,-21600,EB445137-D7F5-57EC-87DA-1DB460D64046,"iPhone13,2"
com.apple.mobiletimer,4,1737181724,1737181728,1737181728.2201061,-21600,EB445137-D7F5-57EC-87DA-1DB460D64046,"iPhone13,2"
com.apple.mobiletimer,9,1737181039,1737181048,1737181048.09883,-21600,EB445137-D7F5-57EC-87DA-1DB460D64046,"iPhone13,2"
com.thestorygraph.thestorygraph,14,1737181007,1737181021,1737181021.896146,-21600,EB445137-D7F5-57EC-87DA-1DB460D64046,"iPhone13,2"
com.thestorygraph.thestorygraph,20,1737180986,1737181006,1737181006.378356,-21600,EB445137-D7F5-57EC-87DA-1DB460D64046,"iPhone13,2"
com.apple.CoreAuthUI,6,1737178125,1737178131,1737178131.022522,-21600,EB445137-D7F5-57EC-87DA-1DB460D64046,"iPhone13,2"
com.apple.journal,701,1737178124,1737178825,1737178825.0822968,-21600,EB445137-D7F5-57EC-87DA-1DB460D64046,"iPhone13,2"
com.apple.Health,56,1737178065,1737178121,1737178121.374222,-21600,EB445137-D7F5-57EC-87DA-1DB460D64046,"iPhone13,2"
com.microsoft.Office.Outlook,22,1737178035,1737178057,1737178057.700341,-21600,EB445137-D7F5-57EC-87DA-1DB460D64046,"iPhone13,2"
com.google.Chrome,789,1737177024,1737177813,1737177813.68328,-21600,,
com.google.Chrome,360,1737176160,1737176520,1737176520.035279,-21600,,
com.google.Chrome,326,1737175673,1737175999,1737175999.366397,-21600,,
com.letterboxd.LetterboxdApp,2,1737174818,1737174820,1737174820.337821,-21600,EB445137-D7F5-57EC-87DA-1DB460D64046,"iPhone13,2"
com.thestorygraph.thestorygraph,1,1737174817,1737174818,1737174818.915767,-21600,EB445137-D7F5-57EC-87DA-1DB460D64046,"iPhone13,2"
com.google.Chrome,1373,1737174002,1737175375,1737175375.779574,-21600,,
com.leomehlig.today,213,1737173789,1737174002,1737174002.748338,-21600,,
com.apple.iCal,16,1737173773,1737173789,1737173789.267921,-21600,,
com.thestorygraph.thestorygraph,43,1737173689,1737173732,1737173732.585762,-21600,EB445137-D7F5-57EC-87DA-1DB460D64046,"iPhone13,2"
com.apple.MobileSMS,39,1737173646,1737173685,1737173685.4872751,-21600,EB445137-D7F5-57EC-87DA-1DB460D64046,"iPhone13,2"
com.microsoft.Office.Outlook,27,1737173619,1737173646,1737173646.801615,-21600,EB445137-D7F5-57EC-87DA-1DB460D64046,"iPhone13,2"
com.apple.MobileSMS,35,1737173583,1737173618,1737173618.575361,-21600,EB445137-D7F5-57EC-87DA-1DB460D64046,"iPhone13,2"
com.truebill.truebillnative,1,1737173582,1737173583,1737173583.747865,-21600,EB445137-D7F5-57EC-87DA-1DB460D64046,"iPhone13,2"
com.leomehlig.today,329,1737173444,1737173773,1737173774.023397,-21600,,
com.apple.iCal,20,1737173424,1737173444,1737173444.635045,-21600,,
com.leomehlig.today,14,1737173410,1737173424,1737173424.657364,-21600,,
com.apple.iCal,13,1737173397,1737173410,1737173410.945051,-21600,,
com.leomehlig.today,45,1737173352,1737173397,1737173397.515019,-21600,,
com.apple.finder,39,1737173313,1737173352,1737173352.7566981,-21600,,
com.google.Chrome,4,1737173309,1737173313,1737173313.856498,-21600,,
com.apple.finder,4,1737173305,1737173309,1737173309.211718,-21600,,
com.apple.iphonesimulator,4,1737173301,1737173305,1737173305.604249,-21600,,
com.google.android.studio,4,1737173297,1737173301,1737173301.326025,-21600,,
com.apple.dt.Xcode,3,1737173294,1737173297,1737173297.978547,-21600,,
com.google.Chrome,105,1737173189,1737173294,1737173294.5236921,-21600,,
com.microsoft.onenote.mac,179,1737173010,1737173189,1737173189.59007,-21600,,
com.google.Chrome,0,1737173010,1737173010,1737173011.02275,-21600,,
com.truebill.truebillnative,121,1737172909,1737173030,1737173031.303807,-21600,EB445137-D7F5-57EC-87DA-1DB460D64046,"iPhone13,2"
com.apple.CoreAuthUI,4,1737172884,1737172888,1737172888.759078,-21600,EB445137-D7F5-57EC-87DA-1DB460D64046,"iPhone13,2"
com.clairmail.fth.client,29,1737172879,1737172908,1737172908.240016,-21600,EB445137-D7F5-57EC-87DA-1DB460D64046,"iPhone13,2"
com.apple.CoreAuthUI,3,1737172864,1737172867,1737172867.79511,-21600,EB445137-D7F5-57EC-87DA-1DB460D64046,"iPhone13,2"
com.truebill.truebillnative,14,1737172861,1737172875,1737172875.3369842,-21600,EB445137-D7F5-57EC-87DA-1DB460D64046,"iPhone13,2"
com.amazon.Amazon,1,1737172860,1737172861,1737172861.8297849,-21600,EB445137-D7F5-57EC-87DA-1DB460D64046,"iPhone13,2"
com.microsoft.onenote.mac,155,1737172855,1737173010,1737173010.502711,-21600,,
com.amazon.Amazon,4,1737172238,1737172242,1737172243.467587,-21600,EB445137-D7F5-57EC-87DA-1DB460D64046,"iPhone13,2"
com.amazon.Amazon,12,1737171453,1737171465,1737171465.884145,-21600,EB445137-D7F5-57EC-87DA-1DB460D64046,"iPhone13,2"
com.apple.CoreAuthUI,2,1737171369,1737171371,1737171371.253145,-21600,EB445137-D7F5-57EC-87DA-1DB460D64046,"iPhone13,2"
com.amazon.Amazon,35,1737171364,1737171399,1737171399.826836,-21600,EB445137-D7F5-57EC-87DA-1DB460D64046,"iPhone13,2"
com.apple.MobileSMS,3,1737171360,1737171363,1737171363.247462,-21600,EB445137-D7F5-57EC-87DA-1DB460D64046,"iPhone13,2"
com.apple.MobileSMS,5,1737171211,1737171216,1737171216.943052,-21600,EB445137-D7F5-57EC-87DA-1DB460D64046,"iPhone13,2"
com.apple.Maps,26,1737171185,1737171211,1737171211.476187,-21600,EB445137-D7F5-57EC-87DA-1DB460D64046,"iPhone13,2"
com.apple.MobileSMS,5,1737171179,1737171184,1737171184.861989,-21600,EB445137-D7F5-57EC-87DA-1DB460D64046,"iPhone13,2"
com.apple.reminders,5,1737171171,1737171176,1737171176.62165,-21600,EB445137-D7F5-57EC-87DA-1DB460D64046,"iPhone13,2"
com.apple.MobileSMS,2,1737171168,1737171170,1737171171.168323,-21600,EB445137-D7F5-57EC-87DA-1DB460D64046,"iPhone13,2"
com.apple.Maps,0,1737171168,1737171168,1737171168.865262,-21600,EB445137-D7F5-57EC-87DA-1DB460D64046,"iPhone13,2"
com.apple.Maps,79,1737171086,1737171165,1737171165.888233,-21600,EB445137-D7F5-57EC-87DA-1DB460D64046,"iPhone13,2"
com.apple.Music,1,1737171084,1737171085,1737171085.8308182,-21600,EB445137-D7F5-57EC-87DA-1DB460D64046,"iPhone13,2"
com.apple.Music,83,1737169849,1737169932,1737169932.8548641,-21600,EB445137-D7F5-57EC-87DA-1DB460D64046,"iPhone13,2"
com.apple.Music,2,1737169844,1737169846,1737169847.100923,-21600,EB445137-D7F5-57EC-87DA-1DB460D64046,"iPhone13,2"
com.apple.Music,82,1737169761,1737169843,1737169843.941675,-21600,EB445137-D7F5-57EC-87DA-1DB460D64046,"iPhone13,2"
com.apple.Music,95,1737169652,1737169747,1737169747.037813,-21600,EB445137-D7F5-57EC-87DA-1DB460D64046,"iPhone13,2"
com.apple.Music,8,1737169636,1737169644,1737169645.2827768,-21600,EB445137-D7F5-57EC-87DA-1DB460D64046,"iPhone13,2"
com.apple.weather,2,1737169633,1737169635,1737169635.763166,-21600,EB445137-D7F5-57EC-87DA-1DB460D64046,"iPhone13,2"
com.apple.weather,18,1737163512,1737163530,1737163531.0832582,-21600,EB445137-D7F5-57EC-87DA-1DB460D64046,"iPhone13,2"
com.apple.Maps,2,1737163510,1737163512,1737163512.514343,-21600,EB445137-D7F5-57EC-87DA-1DB460D64046,"iPhone13,2"
com.apple.Maps,11,1737163400,1737163411,1737163412.123519,-21600,EB445137-D7F5-57EC-87DA-1DB460D64046,"iPhone13,2"
com.apple.Maps,63,1737163333,1737163396,1737163396.816341,-21600,EB445137-D7F5-57EC-87DA-1DB460D64046,"iPhone13,2"
com.truebill.truebillnative,2,1737163331,1737163333,1737163333.180354,-21600,EB445137-D7F5-57EC-87DA-1DB460D64046,"iPhone13,2"
com.apple.CoreAuthUI,3,1737163109,1737163112,1737163112.858537,-21600,EB445137-D7F5-57EC-87DA-1DB460D64046,"iPhone13,2"
com.truebill.truebillnative,16,1737163105,1737163121,1737163121.6216211,-21600,EB445137-D7F5-57EC-87DA-1DB460D64046,"iPhone13,2"
com.microsoft.onenote.mac,102,1737163028,1737163130,1737163130.196315,-21600,,
com.apple.AppStore,86,1737162945,1737163031,1737163031.689327,-21600,EB445137-D7F5-57EC-87DA-1DB460D64046,"iPhone13,2"
com.google.Chrome,115,1737162913,1737163028,1737163028.222509,-21600,,
com.apple.iCal,4,1737162909,1737162913,1737162913.621427,-21600,,
com.google.Chrome,13,1737162896,1737162909,1737162909.383126,-21600,,
com.apple.findmy,56,1737162886,1737162942,1737162943.212004,-21600,EB445137-D7F5-57EC-87DA-1DB460D64046,"iPhone13,2"
com.apple.dt.Xcode,199,1737162665,1737162864,1737162866.132946,-21600,,
com.apple.iphonesimulator,35,1737162630,1737162665,1737162665.970648,-21600,,
com.apple.dt.Xcode,1,1737162624,1737162625,1737162625.81212,-21600,,
com.google.android.studio,25,1737162562,1737162587,1737162587.426357,-21600,,
com.apple.dt.Xcode,9,1737162553,1737162562,1737162562.5821362,-21600,,
com.apple.finder,7,1737162546,1737162553,1737162554.0453281,-21600,,
com.apple.dt.Xcode,5,1737162541,1737162546,1737162546.281694,-21600,,
com.apple.finder,10,1737162531,1737162541,1737162541.304508,-21600,,
com.apple.dt.Xcode,18,1737162513,1737162531,1737162531.145478,-21600,,
com.apple.finder,6,1737162507,1737162513,1737162513.121851,-21600,,
com.apple.dt.Xcode,12,1737162495,1737162507,1737162508.023591,-21600,,
com.apple.finder,11,1737162484,1737162495,1737162495.368589,-21600,,
com.apple.dt.Xcode,31,1737162453,1737162484,1737162484.57304,-21600,,
com.apple.finder,5,1737162448,1737162453,1737162453.32956,-21600,,
com.apple.findmy,10,1737162430,1737162440,1737162440.7907948,-21600,EB445137-D7F5-57EC-87DA-1DB460D64046,"iPhone13,2"
com.apple.mobileslideshow,2,1737162428,1737162430,1737162430.522548,-21600,EB445137-D7F5-57EC-87DA-1DB460D64046,"iPhone13,2"
com.google.Chrome,263,1737162185,1737162448,1737162448.310567,-21600,,
com.apple.finder,18,1737162154,1737162172,1737162172.163501,-21600,,
com.google.Chrome,2,1737162152,1737162154,1737162154.1838012,-21600,,
com.apple.finder,3,1737162149,1737162152,1737162152.284295,-21600,,
com.apple.Terminal,1,1737162148,1737162149,1737162150.01123,-21600,,
com.google.Chrome,24,1737162124,1737162148,1737162148.421679,-21600,,
com.apple.MobileSMS,7,1737162117,1737162124,1737162124.4005551,-21600,,
com.apple.news,63,1737162054,1737162117,1737162117.8187752,-21600,,
com.apple.MobileSMS,6,1737162048,1737162054,1737162054.4741058,-21600,,
com.apple.iCal,9,1737162039,1737162048,1737162048.796294,-21600,,
com.google.Chrome,124,1737161915,1737162039,1737162039.65662,-21600,,
com.microsoft.Excel,34,1737161881,1737161915,1737161915.44544,-21600,,
com.apple.finder,42,1737161839,1737161881,1737161882.023179,-21600,,
com.apple.iCal,27,1737161812,1737161839,1737161839.2981439,-21600,,
com.google.Chrome,23,1737161789,1737161812,1737161812.745919,-21600,,
com.google.Chrome,134,1737159011,1737159145,1737159146.062564,-21600,,
com.apple.Photos,20,1737158991,1737159011,1737159011.9756088,-21600,,
com.google.Chrome,1,1737158990,1737158991,1737158991.259732,-21600,,
com.apple.Photos,31,1737158959,1737158990,1737158990.668601,-21600,,
com.google.Chrome,12,1737158947,1737158959,1737158959.1565828,-21600,,
com.apple.finder,5,1737158942,1737158947,1737158947.443846,-21600,,
com.apple.mobileslideshow,173,1737158910,1737159083,1737159083.127009,-21600,EB445137-D7F5-57EC-87DA-1DB460D64046,"iPhone13,2"
com.apple.Photos,38,1737158904,1737158942,1737158942.754175,-21600,,
com.google.Chrome,10,1737158894,1737158904,1737158904.804719,-21600,,
com.apple.camera,9,1737158868,1737158877,1737158878.537467,-21600,EB445137-D7F5-57EC-87DA-1DB460D64046,"iPhone13,2"
com.apple.MobileSMS,2,1737158865,1737158867,1737158867.44541,-21600,EB445137-D7F5-57EC-87DA-1DB460D64046,"iPhone13,2"
com.apple.Photos,35,1737158859,1737158894,1737158894.042093,-21600,,
com.google.Chrome,3,1737158856,1737158859,1737158859.9540749,-21600,,
com.apple.Photos,62,1737158794,1737158856,1737158856.0507178,-21600,,
com.apple.MobileSMS,61,1737158676,1737158737,1737158737.944488,-21600,EB445137-D7F5-57EC-87DA-1DB460D64046,"iPhone13,2"
com.apple.mobiletimer,2,1737158674,1737158676,1737158676.500618,-21600,EB445137-D7F5-57EC-87DA-1DB460D64046,"iPhone13,2"
com.google.Chrome,414,1737158380,1737158794,1737158794.403125,-21600,,
com.apple.Music,2,1737158378,1737158380,1737158380.13784,-21600,,
com.apple.systempreferences,91,1737158269,1737158360,1737158360.402573,-21600,,
com.apple.Music,13,1737158256,1737158269,1737158269.681921,-21600,,
com.apple.systempreferences,3,1737158251,1737158254,1737158254.954359,-21600,,
com.apple.Terminal,47,1737158201,1737158248,1737158248.356444,-21600,,
com.apple.finder,3,1737158198,1737158201,1737158201.62847,-21600,,
com.apple.Terminal,5,1737158193,1737158198,1737158198.402812,-21600,,
com.apple.finder,1,1737158192,1737158193,1737158193.9941769,-21600,,
com.apple.Terminal,7,1737158185,1737158192,1737158192.4643521,-21600,,
com.apple.finder,9,1737158176,1737158185,1737158185.770504,-21600,,
com.google.Chrome,54,1737158122,1737158176,1737158176.778271,-21600,,
com.microsoft.onenote.mac,21,1737158101,1737158122,1737158122.717041,-21600,,
com.apple.Music,0,1737158101,1737158101,1737158101.6589189,-21600,,
com.google.android.studio,2,1737158099,1737158101,1737158101.1335402,-21600,,
com.apple.dt.Xcode,3,1737158096,1737158099,1737158100.067558,-21600,,
com.google.android.studio,5,1737158091,1737158096,1737158096.421377,-21600,,
com.apple.Music,14,1737158077,1737158091,1737158091.594599,-21600,,
com.google.android.studio,1,1737158076,1737158077,1737158077.153486,-21600,,
com.microsoft.onenote.mac,91,1737157985,1737158076,1737158076.45837,-21600,,
com.google.android.studio,155,1737157830,1737157985,1737157985.971828,-21600,,
com.apple.Music,5,1737157825,1737157830,1737157830.284511,-21600,,
com.google.android.studio,203,1737157622,1737157825,1737157825.891776,-21600,,
com.apple.Music,16,1737157606,1737157622,1737157622.107085,-21600,,
com.google.android.studio,115,1737157491,1737157606,1737157607.031477,-21600,,
com.google.Chrome,1,1737157490,1737157491,1737157491.194504,-21600,,
com.google.android.studio,2,1737157488,1737157490,1737157490.683594,-21600,,
com.google.Chrome,34,1737157454,1737157488,1737157488.275126,-21600,,
com.google.android.studio,3,1737157451,1737157454,1737157454.681909,-21600,,
com.google.Chrome,8,1737157443,1737157451,1737157451.881974,-21600,,
com.google.android.studio,8,1737157435,1737157443,1737157443.9155521,-21600,,
com.google.Chrome,3,1737157432,1737157435,1737157435.89041,-21600,,
com.google.android.studio,1,1737157431,1737157432,1737157432.493079,-21600,,
com.google.Chrome,47,1737157384,1737157431,1737157431.073215,-21600,,
com.google.android.studio,31,1737157353,1737157384,1737157384.7950249,-21600,,
com.google.Chrome,41,1737157312,1737157353,1737157353.426543,-21600,,
com.apple.mobiletimer,123,1737157174,1737157297,1737157297.689238,-21600,EB445137-D7F5-57EC-87DA-1DB460D64046,"iPhone13,2"
com.apple.mobiletimer,16,1737157116,1737157132,1737157132.255816,-21600,EB445137-D7F5-57EC-87DA-1DB460D64046,"iPhone13,2"
com.apple.calculator,15,1737157101,1737157116,1737157116.162307,-21600,EB445137-D7F5-57EC-87DA-1DB460D64046,"iPhone13,2"
com.apple.mobiletimer,83,1737157018,1737157101,1737157101.995346,-21600,EB445137-D7F5-57EC-87DA-1DB460D64046,"iPhone13,2"
com.google.android.studio,518,1737156794,1737157312,1737157312.4716392,-21600,,
com.apple.Music,7,1737156787,1737156794,1737156794.283556,-21600,,
com.google.android.studio,14,1737156773,1737156787,1737156787.8179111,-21600,,
com.apple.Music,5,1737156768,1737156773,1737156773.352292,-21600,,
com.google.android.studio,147,1737156621,1737156768,1737156768.931082,-21600,,
com.apple.Music,5,1737156616,1737156621,1737156621.345176,-21600,,
com.google.android.studio,68,1737156548,1737156616,1737156616.1480808,-21600,,
com.apple.Music,85,1737156463,1737156548,1737156548.351511,-21600,,
com.google.android.studio,7,1737156456,1737156463,1737156463.979296,-21600,,
com.apple.Music,9,1737156447,1737156456,1737156456.505439,-21600,,
com.google.android.studio,98,1737156349,1737156447,1737156447.598075,-21600,,
com.microsoft.onenote.mac,9,1737156340,1737156349,1737156349.742198,-21600,,
com.google.android.studio,223,1737156117,1737156340,1737156340.7087111,-21600,,
com.apple.Music,7,1737156110,1737156117,1737156117.9107761,-21600,,
com.google.android.studio,132,1737155978,1737156110,1737156110.64038,-21600,,
com.apple.Music,6,1737155972,1737155978,1737155978.160608,-21600,,
com.google.android.studio,235,1737155737,1737155972,1737155972.1301122,-21600,,
com.google.Chrome,7,1737155730,1737155737,1737155737.2816281,-21600,,
com.google.android.studio,256,1737155474,1737155730,1737155730.773519,-21600,,
com.apple.Music,6,1737155468,1737155474,1737155474.9680529,-21600,,
com.google.android.studio,80,1737155388,1737155468,1737155468.445657,-21600,,
com.apple.Music,8,1737155380,1737155388,1737155388.575681,-21600,,
com.google.android.studio,214,1737155166,1737155380,1737155380.0703468,-21600,,
com.apple.Music,2,1737155164,1737155166,1737155166.670548,-21600,,
com.google.android.studio,531,1737154633,1737155164,1737155164.230638,-21600,,
com.apple.Music,20,1737154613,1737154633,1737154633.980688,-21600,,
com.google.android.studio,140,1737154473,1737154613,1737154613.216075,-21600,,
com.apple.Music,10,1737154463,1737154473,1737154473.597725,-21600,,
com.google.android.studio,290,1737154173,1737154463,1737154463.6671681,-21600,,
com.google.Chrome,28,1737154145,1737154173,1737154173.701888,-21600,,
com.google.android.studio,5,1737154140,1737154145,1737154145.625649,-21600,,
com.google.Chrome,1,1737154139,1737154140,1737154140.755718,-21600,,
com.google.android.studio,172,1737153967,1737154139,1737154139.248167,-21600,,
com.google.Chrome,4,1737153963,1737153967,1737153967.7653651,-21600,,
com.google.android.studio,2,1737153961,1737153963,1737153963.5568109,-21600,,
com.google.Chrome,9,1737153952,1737153961,1737153962.027736,-21600,,
com.google.android.studio,63,1737153889,1737153952,1737153952.59346,-21600,,
com.apple.Music,1,1737153888,1737153889,1737153889.926005,-21600,,
com.google.Chrome,15,1737153873,1737153888,1737153888.910923,-21600,,
com.apple.Music,1,1737153872,1737153873,1737153873.33073,-21600,,
com.google.android.studio,6,1737153866,1737153872,1737153872.482656,-21600,,
com.apple.Music,1,1737153865,1737153866,1737153866.488079,-21600,,
com.google.Chrome,14,1737153851,1737153865,1737153865.615581,-21600,,
com.apple.Music,5,1737153846,1737153851,1737153851.571877,-21600,,
com.google.android.studio,1,1737153845,1737153846,1737153846.712327,-21600,,
com.google.Chrome,3,1737153842,1737153845,1737153845.822875,-21600,,
com.apple.Music,0,1737153842,1737153842,1737153842.977474,-21600,,
com.google.android.studio,7,1737153835,1737153842,1737153842.067693,-21600,,
com.apple.Music,0,1737153835,1737153835,1737153836.0393162,-21600,,
com.google.Chrome,2,1737153833,1737153835,1737153835.170084,-21600,,
com.apple.Music,1,1737153832,1737153833,1737153833.7373319,-21600,,
com.google.android.studio,36,1737153796,1737153832,1737153832.485248,-21600,,
com.apple.Music,1,1737153795,1737153796,1737153797.0075989,-21600,,
com.google.android.studio,12,1737153783,1737153795,1737153795.907088,-21600,,
com.apple.Music,5,1737153778,1737153783,1737153783.626419,-21600,,
com.google.android.studio,25,1737153753,1737153778,1737153778.3944569,-21600,,
com.google.Chrome,4,1737153749,1737153753,1737153753.794709,-21600,,
com.google.android.studio,24,1737153725,1737153749,1737153749.781838,-21600,,
com.google.Chrome,17,1737153708,1737153725,1737153725.4068918,-21600,,
com.google.android.studio,79,1737153629,1737153708,1737153708.441484,-21600,,
com.google.Chrome,19,1737153610,1737153629,1737153629.615265,-21600,,
com.google.android.studio,1,1737153609,1737153610,1737153610.150465,-21600,,
com.apple.Music,4,1737153605,1737153609,1737153609.043297,-21600,,
com.google.Chrome,5,1737153600,1737153605,1737153605.070185,-21600,,
com.google.android.studio,119,1737153481,1737153600,1737153600.667838,-21600,,
com.google.Chrome,107,1737153374,1737153481,1737153481.672627,-21600,,
com.apple.Music,2,1737153372,1737153374,1737153374.82777,-21600,,
com.google.Chrome,44,1737153328,1737153372,1737153372.839676,-21600,,
com.google.android.studio,228,1737153100,1737153328,1737153328.1904058,-21600,,
