app,usage,start_time,end_time,created_at,tz,device_id,device_model
com.apple.finder,13,1742053262,1742053275,1742053275.190628,-18000,,
com.google.Chrome,2,1742053260,1742053262,1742053262.906857,-18000,,
com.google.Chrome,4,1742053223,1742053227,1742053227.244296,-18000,,
com.apple.MobileSMS,1,1742053222,1742053223,1742053223.212072,-18000,,
com.google.Chrome,37,1742053185,1742053222,1742053222.267023,-18000,,
com.apple.MobileSMS,2,1742053183,1742053185,1742053185.973778,-18000,,
com.google.Chrome,34,1742053149,1742053183,1742053183.5523071,-18000,,
com.apple.MobileSMS,2,1742053147,1742053149,1742053149.0690799,-18000,,
com.google.Chrome,4,1742053143,1742053147,1742053147.946399,-18000,,
com.apple.MobileSMS,2,1742053141,1742053143,1742053143.062259,-18000,,
com.google.Chrome,4,1742053137,1742053141,1742053141.875197,-18000,,
com.apple.MobileSMS,2,1742053135,1742053137,1742053137.2542238,-18000,,
com.google.Chrome,9,1742053126,1742053135,1742053135.6081939,-18000,,
com.apple.MobileSMS,1,1742053125,1742053126,1742053126.053595,-18000,,
com.google.Chrome,1,1742053124,1742053125,1742053125.308291,-18000,,
com.apple.MobileSMS,1,1742053123,1742053124,1742053124.6095471,-18000,,
com.google.Chrome,7,1742053116,1742053123,1742053123.927726,-18000,,
com.apple.MobileSMS,4,1742053112,1742053116,1742053116.154039,-18000,,
com.google.Chrome,9,1742053103,1742053112,1742053112.834033,-18000,,
com.apple.MobileSMS,5,1742053098,1742053103,1742053103.230588,-18000,,
com.google.Chrome,20,1742053078,1742053098,1742053098.032578,-18000,,
com.apple.MobileSMS,3,1742053075,1742053078,1742053078.3694758,-18000,,
com.google.Chrome,5,1742053070,1742053075,1742053075.525279,-18000,,
com.apple.MobileSMS,3,1742053067,1742053070,1742053070.3784308,-18000,,
com.google.Chrome,19,1742053048,1742053067,1742053067.634198,-18000,,
com.apple.MobileSMS,1,1742053047,1742053048,1742053048.9035869,-18000,,
com.google.Chrome,9,1742053038,1742053047,1742053047.3429952,-18000,,
com.apple.MobileSMS,4,1742053034,1742053038,1742053038.267425,-18000,,
com.google.Chrome,59,1742052975,1742053034,1742053034.972282,-18000,,
com.apple.MobileSMS,1,1742052974,1742052975,1742052975.574918,-18000,,
com.google.Chrome,1,1742052973,1742052974,1742052974.366149,-18000,,
com.apple.MobileSMS,1,1742052972,1742052973,1742052973.677178,-18000,,
com.google.Chrome,27,1742052945,1742052972,1742052972.4253058,-18000,,
com.apple.MobileSMS,2,1742052943,1742052945,1742052945.130021,-18000,,
com.google.Chrome,65,1742052878,1742052943,1742052943.2590141,-18000,,
com.apple.MobileSMS,1,1742052877,1742052878,1742052878.839153,-18000,,
com.google.Chrome,39,1742052838,1742052877,1742052877.591865,-18000,,
com.apple.MobileSMS,0,1742052838,1742052838,1742052838.672842,-18000,,
com.google.Chrome,1,1742052837,1742052838,1742052838.1579819,-18000,,
com.apple.MobileSMS,1,1742052836,1742052837,1742052837.4791741,-18000,,
com.google.Chrome,3,1742052833,1742052836,1742052836.735664,-18000,,
com.apple.MobileSMS,2,1742052831,1742052833,1742052833.9459372,-18000,,
com.google.Chrome,2,1742052829,1742052831,1742052831.178354,-18000,,
com.apple.MobileSMS,2,1742052827,1742052829,1742052829.32202,-18000,,
com.google.Chrome,0,1742052827,1742052827,1742052828.029436,-18000,,
com.apple.MobileSMS,2,1742052825,1742052827,1742052827.036799,-18000,,
com.google.Chrome,1,1742052824,1742052825,1742052825.877898,-18000,,
com.apple.MobileSMS,1,1742052823,1742052824,1742052824.595443,-18000,,
com.google.Chrome,19,1742052804,1742052823,1742052823.7512789,-18000,,
com.apple.MobileSMS,29,1742052775,1742052804,1742052804.873927,-18000,,
com.google.Chrome,10,1742052765,1742052775,1742052775.668653,-18000,,
com.google.Chrome,24,1742009024,1742009048,1742009048.748582,-18000,,
com.apple.Notes,39,1742008985,1742009024,1742009024.718818,-18000,,
com.google.Chrome,28,1742008957,1742008985,1742008985.3684568,-18000,,
com.apple.Notes,2,1742008955,1742008957,1742008957.368581,-18000,,
com.google.Chrome,37,1742008918,1742008955,1742008955.5538878,-18000,,
com.apple.Notes,2,1742008916,1742008918,1742008918.233571,-18000,,
com.google.Chrome,59,1742008857,1742008916,1742008916.63961,-18000,,
com.apple.Notes,26,1742008831,1742008857,1742008857.6170669,-18000,,
com.google.Chrome,10,1742008821,1742008831,1742008831.769954,-18000,,
com.apple.tv,158,1742007796,1742007954,1742007954.075557,-18000,EB445137-D7F5-57EC-87DA-1DB460D64046,"iPhone13,2"
com.google.Chrome,581,1742007609,1742008190,1742008191.288169,-18000,,
com.apple.finder,32,1742007577,1742007609,1742007611.0155249,-18000,,
com.apple.weather,31,1742007234,1742007265,1742007265.40374,-18000,EB445137-D7F5-57EC-87DA-1DB460D64046,"iPhone13,2"
com.apple.weather,9,1742005542,1742005551,1742005551.8206182,-18000,EB445137-D7F5-57EC-87DA-1DB460D64046,"iPhone13,2"
com.apple.mobileslideshow,2,1742005540,1742005542,1742005542.456778,-18000,EB445137-D7F5-57EC-87DA-1DB460D64046,"iPhone13,2"
com.apple.mobileslideshow,35,1742004646,1742004681,1742004682.0691671,-18000,EB445137-D7F5-57EC-87DA-1DB460D64046,"iPhone13,2"
com.apple.weather,2,1742004644,1742004646,1742004646.211238,-18000,EB445137-D7F5-57EC-87DA-1DB460D64046,"iPhone13,2"
com.apple.weather,32,1742003341,1742003373,1742003373.800529,-18000,EB445137-D7F5-57EC-87DA-1DB460D64046,"iPhone13,2"
com.apple.weather,4,1741998642,1741998646,1741998647.051834,-18000,EB445137-D7F5-57EC-87DA-1DB460D64046,"iPhone13,2"
com.apple.weather,15,1741997010,1741997025,1741997026.3185601,-18000,EB445137-D7F5-57EC-87DA-1DB460D64046,"iPhone13,2"
com.apple.news,1,1741997009,1741997010,1741997011.0262241,-18000,EB445137-D7F5-57EC-87DA-1DB460D64046,"iPhone13,2"
com.apple.news,81,1741991103,1741991184,1741991184.5208302,-18000,EB445137-D7F5-57EC-87DA-1DB460D64046,"iPhone13,2"
com.groundspeak.GeocachingIntro,12,1741991055,1741991067,1741991067.760717,-18000,EB445137-D7F5-57EC-87DA-1DB460D64046,"iPhone13,2"
com.microsoft.Office.Outlook,5,1741991043,1741991048,1741991048.8776941,-18000,EB445137-D7F5-57EC-87DA-1DB460D64046,"iPhone13,2"
com.apple.MobileSMS,3,1741991037,1741991040,1741991040.406451,-18000,EB445137-D7F5-57EC-87DA-1DB460D64046,"iPhone13,2"
com.apple.MobileSMS,3,1741991003,1741991006,1741991006.321384,-18000,EB445137-D7F5-57EC-87DA-1DB460D64046,"iPhone13,2"
com.apple.MobileSMS,11,1741990989,1741991000,1741991001.148902,-18000,EB445137-D7F5-57EC-87DA-1DB460D64046,"iPhone13,2"
com.apple.MobileSMS,67,1741990914,1741990981,1741990982.0211859,-18000,EB445137-D7F5-57EC-87DA-1DB460D64046,"iPhone13,2"
com.apple.news,7,1741990907,1741990914,1741990914.084278,-18000,EB445137-D7F5-57EC-87DA-1DB460D64046,"iPhone13,2"
com.apple.news,80,1741985524,1741985604,1741985604.955271,-18000,EB445137-D7F5-57EC-87DA-1DB460D64046,"iPhone13,2"
com.apple.reminders,2,1741985451,1741985453,1741985453.18154,-18000,EB445137-D7F5-57EC-87DA-1DB460D64046,"iPhone13,2"
com.microsoft.Office.Outlook,1,1741984074,1741984075,1741984075.724294,-18000,EB445137-D7F5-57EC-87DA-1DB460D64046,"iPhone13,2"
com.microsoft.Office.Outlook,68,1741983879,1741983947,1741983947.152052,-18000,EB445137-D7F5-57EC-87DA-1DB460D64046,"iPhone13,2"
com.toyopagroup.picaboo,26,1741983161,1741983187,1741983187.4522681,-18000,EB445137-D7F5-57EC-87DA-1DB460D64046,"iPhone13,2"
com.microsoft.Office.Outlook,3,1741983118,1741983121,1741983121.403113,-18000,EB445137-D7F5-57EC-87DA-1DB460D64046,"iPhone13,2"
com.google.chrome.ios,36,1741983082,1741983118,1741983118.6425529,-18000,EB445137-D7F5-57EC-87DA-1DB460D64046,"iPhone13,2"
com.microsoft.Office.Outlook,4,1741983078,1741983082,1741983082.864934,-18000,EB445137-D7F5-57EC-87DA-1DB460D64046,"iPhone13,2"
com.apple.CoreAuthUI,2,1741983016,1741983018,1741983018.08108,-18000,EB445137-D7F5-57EC-87DA-1DB460D64046,"iPhone13,2"
com.google.chrome.ios,80,1741982998,1741983078,1741983078.368185,-18000,EB445137-D7F5-57EC-87DA-1DB460D64046,"iPhone13,2"
com.microsoft.Office.Outlook,5,1741982993,1741982998,1741982998.1883311,-18000,EB445137-D7F5-57EC-87DA-1DB460D64046,"iPhone13,2"
com.google.chrome.ios,1,1741982992,1741982993,1741982994.0176091,-18000,EB445137-D7F5-57EC-87DA-1DB460D64046,"iPhone13,2"
com.microsoft.Office.Outlook,150,1741982842,1741982992,1741982992.394133,-18000,EB445137-D7F5-57EC-87DA-1DB460D64046,"iPhone13,2"
com.apple.MobileSMS,2,1741982837,1741982839,1741982839.205412,-18000,EB445137-D7F5-57EC-87DA-1DB460D64046,"iPhone13,2"
com.apple.PeopleViewService,2,1741982835,1741982837,1741982837.613611,-18000,EB445137-D7F5-57EC-87DA-1DB460D64046,"iPhone13,2"
com.microsoft.Office.Outlook,2,1741982830,1741982832,1741982832.7353501,-18000,EB445137-D7F5-57EC-87DA-1DB460D64046,"iPhone13,2"
com.clairmail.fth.client,45,1741982784,1741982829,1741982829.663271,-18000,EB445137-D7F5-57EC-87DA-1DB460D64046,"iPhone13,2"
com.microsoft.Office.Outlook,9,1741982774,1741982783,1741982783.958739,-18000,EB445137-D7F5-57EC-87DA-1DB460D64046,"iPhone13,2"
com.clairmail.fth.client,0,1741982774,1741982774,1741982774.794557,-18000,EB445137-D7F5-57EC-87DA-1DB460D64046,"iPhone13,2"
com.apple.CoreAuthUI,2,1741982765,1741982767,1741982767.9060779,-18000,EB445137-D7F5-57EC-87DA-1DB460D64046,"iPhone13,2"
com.clairmail.fth.client,11,1741982761,1741982772,1741982772.381124,-18000,EB445137-D7F5-57EC-87DA-1DB460D64046,"iPhone13,2"
com.apple.weather,2,1741982755,1741982757,1741982757.373045,-18000,EB445137-D7F5-57EC-87DA-1DB460D64046,"iPhone13,2"
com.apple.finder,5,1741981993,1741981998,1741981998.7926168,-18000,,
com.leomehlig.today,54,1741981939,1741981993,1741981993.247744,-18000,,
com.google.Chrome,0,1741981939,1741981939,1741981939.917568,-18000,,
com.apple.weather,2,1741981937,1741981939,1741981939.1340752,-18000,,
com.microsoft.VSCode,1,1741981936,1741981937,1741981937.939199,-18000,,
com.google.Chrome,64,1741981872,1741981936,1741981936.2668982,-18000,,
com.microsoft.VSCode,49,1741981823,1741981872,1741981872.302998,-18000,,
com.google.Chrome,23,1741981800,1741981823,1741981823.114804,-18000,,
com.microsoft.VSCode,256,1741981544,1741981800,1741981800.9293652,-18000,,
com.google.Chrome,33,1741981511,1741981544,1741981544.291257,-18000,,
com.microsoft.VSCode,1,1741981510,1741981511,1741981511.5428128,-18000,,
com.apple.MobileSMS,4,1741981506,1741981510,1741981510.345542,-18000,,
com.microsoft.VSCode,556,1741980950,1741981506,1741981506.3119102,-18000,,
com.apple.MobileSMS,1,1741980949,1741980950,1741980950.171267,-18000,,
com.microsoft.VSCode,9,1741980940,1741980949,1741980949.299293,-18000,,
com.apple.MobileSMS,95,1741980845,1741980940,1741980940.704893,-18000,,
com.microsoft.VSCode,11,1741980834,1741980845,1741980845.237684,-18000,,
com.apple.MobileSMS,103,1741980731,1741980834,1741980834.974741,-18000,,
com.apple.weather,31,1741980480,1741980511,1741980512.044627,-18000,EB445137-D7F5-57EC-87DA-1DB460D64046,"iPhone13,2"
com.apple.MobileSMS,2,1741980478,1741980480,1741980480.255938,-18000,EB445137-D7F5-57EC-87DA-1DB460D64046,"iPhone13,2"
com.microsoft.VSCode,273,1741980458,1741980731,1741980731.377534,-18000,,
com.google.Chrome,6,1741980452,1741980458,1741980458.093377,-18000,,
com.apple.iCal,20,1741980432,1741980452,1741980452.92325,-18000,,
com.google.Chrome,8,1741980424,1741980432,1741980432.100177,-18000,,
com.apple.iCal,80,1741980344,1741980424,1741980424.812069,-18000,,
com.google.Chrome,2,1741980342,1741980344,1741980344.310245,-18000,,
com.apple.iCal,7,1741980335,1741980342,1741980342.354597,-18000,,
com.google.Chrome,40,1741980295,1741980335,1741980335.269279,-18000,,
com.microsoft.VSCode,425,1741979858,1741980283,1741980283.228823,-18000,,
com.google.Chrome,1,1741979857,1741979858,1741979858.146249,-18000,,
com.microsoft.VSCode,374,1741979483,1741979857,1741979857.480046,-18000,,
com.google.Chrome,7,1741979476,1741979483,1741979483.9994159,-18000,,
com.microsoft.VSCode,13,1741979463,1741979476,1741979476.794026,-18000,,
com.google.Chrome,1,1741979462,1741979463,1741979463.810021,-18000,,
com.microsoft.VSCode,35,1741979427,1741979462,1741979462.380165,-18000,,
com.google.Chrome,2,1741979425,1741979427,1741979427.970242,-18000,,
com.microsoft.VSCode,6,1741979419,1741979425,1741979425.206356,-18000,,
com.google.Chrome,2,1741979417,1741979419,1741979419.8045568,-18000,,
com.microsoft.VSCode,17,1741979400,1741979417,1741979417.388588,-18000,,
com.google.Chrome,2,1741979398,1741979400,1741979400.443592,-18000,,
com.microsoft.VSCode,4,1741979394,1741979398,1741979398.839679,-18000,,
com.google.Chrome,4,1741979390,1741979394,1741979395.024647,-18000,,
com.microsoft.VSCode,13,1741979377,1741979390,1741979390.285073,-18000,,
com.google.Chrome,4,1741979373,1741979377,1741979377.510538,-18000,,
com.microsoft.VSCode,5,1741979368,1741979373,1741979373.4362001,-18000,,
com.google.Chrome,2,1741979366,1741979368,1741979368.703464,-18000,,
com.microsoft.VSCode,13,1741979353,1741979366,1741979366.1797,-18000,,
com.google.Chrome,3,1741979350,1741979353,1741979353.906248,-18000,,
com.microsoft.VSCode,0,1741979350,1741979350,1741979350.7286959,-18000,,
com.google.Chrome,1,1741979349,1741979350,1741979350.261845,-18000,,
com.microsoft.VSCode,5,1741979344,1741979349,1741979349.786747,-18000,,
com.google.Chrome,15,1741979329,1741979344,1741979344.438514,-18000,,
com.microsoft.VSCode,45,1741979284,1741979329,1741979329.782413,-18000,,
com.apple.MobileSMS,1,1741979283,1741979284,1741979284.429196,-18000,,
com.microsoft.VSCode,39,1741979244,1741979283,1741979283.6638489,-18000,,
com.apple.MobileSMS,218,1741979026,1741979244,1741979244.221068,-18000,,
com.apple.weather,221,1741978805,1741979026,1741979026.8043609,-18000,,
com.google.Chrome,95,1741978710,1741978805,1741978805.1093159,-18000,,
com.microsoft.VSCode,23,1741978687,1741978710,1741978710.69668,-18000,,
com.apple.finder,9,1741978678,1741978687,1741978687.7121491,-18000,,
com.apple.MobileSMS,9,1741977819,1741977828,1741977828.896975,-18000,EB445137-D7F5-57EC-87DA-1DB460D64046,"iPhone13,2"
com.apple.MobileSMS,4,1741977783,1741977787,1741977787.965186,-18000,EB445137-D7F5-57EC-87DA-1DB460D64046,"iPhone13,2"
com.microsoft.Office.Outlook,50,1741976502,1741976552,1741976552.203055,-18000,EB445137-D7F5-57EC-87DA-1DB460D64046,"iPhone13,2"
com.microsoft.Office.Outlook,13,1741976488,1741976501,1741976501.277919,-18000,EB445137-D7F5-57EC-87DA-1DB460D64046,"iPhone13,2"
com.apple.weather,0,1741976488,1741976488,1741976488.476438,-18000,EB445137-D7F5-57EC-87DA-1DB460D64046,"iPhone13,2"
com.apple.finder,2,1741975428,1741975430,1741975430.317523,-18000,,
com.leomehlig.today,28,1741975400,1741975428,1741975428.108784,-18000,,
com.google.Chrome,41,1741975359,1741975400,1741975400.1654,-18000,,
com.microsoft.VSCode,32,1741975327,1741975359,1741975359.0875611,-18000,,
com.google.Chrome,133,1741975194,1741975327,1741975327.890693,-18000,,
com.microsoft.VSCode,33,1741975161,1741975194,1741975194.537241,-18000,,
com.google.Chrome,24,1741975137,1741975161,1741975161.074101,-18000,,
com.microsoft.VSCode,11,1741975126,1741975137,1741975137.6192641,-18000,,
com.leomehlig.today,17,1741975109,1741975126,1741975126.433572,-18000,,
com.apple.iCal,12,1741975097,1741975109,1741975109.2155008,-18000,,
com.leomehlig.today,20,1741975077,1741975097,1741975097.541137,-18000,,
com.microsoft.VSCode,1,1741975076,1741975077,1741975077.861895,-18000,,
com.leomehlig.today,9,1741975067,1741975076,1741975076.073694,-18000,,
com.apple.weather,12,1741975028,1741975040,1741975040.7384892,-18000,EB445137-D7F5-57EC-87DA-1DB460D64046,"iPhone13,2"
com.apple.news,2,1741975026,1741975028,1741975028.887944,-18000,EB445137-D7F5-57EC-87DA-1DB460D64046,"iPhone13,2"
com.apple.weather,17,1741975009,1741975026,1741975026.6476479,-18000,EB445137-D7F5-57EC-87DA-1DB460D64046,"iPhone13,2"
com.apple.news,1,1741975008,1741975009,1741975010.052813,-18000,EB445137-D7F5-57EC-87DA-1DB460D64046,"iPhone13,2"
com.apple.news,92,1741974762,1741974854,1741974854.418699,-18000,EB445137-D7F5-57EC-87DA-1DB460D64046,"iPhone13,2"
com.microsoft.Office.Outlook,9,1741974748,1741974757,1741974757.016286,-18000,EB445137-D7F5-57EC-87DA-1DB460D64046,"iPhone13,2"
com.microsoft.Office.Outlook,8,1741974740,1741974748,1741974748.3440762,-18000,EB445137-D7F5-57EC-87DA-1DB460D64046,"iPhone13,2"
com.hammerandchisel.discord,0,1741974740,1741974740,1741974740.455049,-18000,EB445137-D7F5-57EC-87DA-1DB460D64046,"iPhone13,2"
com.microsoft.VSCode,850,1741974217,1741975067,1741975067.45486,-18000,,
com.google.Chrome,19,1741974198,1741974217,1741974217.394871,-18000,,
com.microsoft.VSCode,87,1741974111,1741974198,1741974198.3782911,-18000,,
com.google.Chrome,0,1741974111,1741974111,1741974111.9323459,-18000,,
com.microsoft.VSCode,3,1741974108,1741974111,1741974111.320829,-18000,,
com.google.Chrome,3,1741974105,1741974108,1741974108.258356,-18000,,
com.microsoft.VSCode,8,1741974097,1741974105,1741974105.736969,-18000,,
com.google.Chrome,14,1741974083,1741974097,1741974097.766592,-18000,,
com.microsoft.VSCode,78,1741974005,1741974083,1741974083.228417,-18000,,
com.google.Chrome,13,1741973992,1741974005,1741974005.104222,-18000,,
com.microsoft.VSCode,50,1741973942,1741973992,1741973992.306271,-18000,,
com.hammerandchisel.discord,21,1741973685,1741973706,1741973706.562523,-18000,EB445137-D7F5-57EC-87DA-1DB460D64046,"iPhone13,2"
com.microsoft.VSCode,165,1741973477,1741973642,1741973642.583641,-18000,,
com.google.Chrome,7,1741973470,1741973477,1741973477.553691,-18000,,
com.microsoft.VSCode,28,1741973442,1741973470,1741973470.9950051,-18000,,
com.google.Chrome,2,1741973440,1741973442,1741973442.6508899,-18000,,
com.microsoft.VSCode,3,1741973437,1741973440,1741973440.57917,-18000,,
com.google.Chrome,4,1741973433,1741973437,1741973437.4035912,-18000,,
com.microsoft.VSCode,1,1741973432,1741973433,1741973433.821629,-18000,,
com.google.Chrome,4,1741973428,1741973432,1741973432.333951,-18000,,
com.microsoft.VSCode,61,1741973367,1741973428,1741973428.251563,-18000,,
com.google.Chrome,3,1741973364,1741973367,1741973367.534865,-18000,,
com.microsoft.VSCode,6,1741973358,1741973364,1741973364.580446,-18000,,
com.google.Chrome,8,1741973350,1741973358,1741973358.52274,-18000,,
com.microsoft.VSCode,2,1741973348,1741973350,1741973350.851372,-18000,,
com.google.Chrome,22,1741973326,1741973348,1741973348.156816,-18000,,
com.microsoft.VSCode,21,1741973305,1741973326,1741973326.238274,-18000,,
com.google.Chrome,14,1741973291,1741973305,1741973305.870809,-18000,,
com.microsoft.VSCode,11,1741973280,1741973291,1741973291.231472,-18000,,
com.google.Chrome,2,1741973278,1741973280,1741973280.563422,-18000,,
com.microsoft.VSCode,5,1741973273,1741973278,1741973278.351809,-18000,,
com.google.Chrome,1,1741973272,1741973273,1741973273.8347301,-18000,,
com.microsoft.VSCode,2,1741973270,1741973272,1741973272.510711,-18000,,
com.google.Chrome,1,1741973269,1741973270,1741973270.5922241,-18000,,
com.microsoft.VSCode,2,1741973267,1741973269,1741973269.6599898,-18000,,
com.google.Chrome,1,1741973266,1741973267,1741973267.646892,-18000,,
com.microsoft.VSCode,16,1741973250,1741973266,1741973266.349731,-18000,,
com.google.Chrome,9,1741973241,1741973250,1741973250.527602,-18000,,
com.microsoft.VSCode,8,1741973233,1741973241,1741973241.132996,-18000,,
com.google.Chrome,2,1741973231,1741973233,1741973233.660658,-18000,,
com.microsoft.VSCode,3,1741973228,1741973231,1741973231.530381,-18000,,
com.google.Chrome,4,1741973224,1741973228,1741973228.7447739,-18000,,
com.microsoft.VSCode,8,1741973216,1741973224,1741973224.605276,-18000,,
com.google.Chrome,4,1741973212,1741973216,1741973216.250478,-18000,,
com.microsoft.VSCode,12,1741973200,1741973212,1741973212.1825209,-18000,,
com.google.Chrome,6,1741973194,1741973200,1741973200.199709,-18000,,
com.microsoft.VSCode,11,1741973183,1741973194,1741973194.802932,-18000,,
com.google.Chrome,5,1741973178,1741973183,1741973183.472286,-18000,,
com.microsoft.VSCode,6,1741973172,1741973178,1741973178.2108278,-18000,,
com.google.Chrome,21,1741973151,1741973172,1741973172.853976,-18000,,
com.microsoft.VSCode,456,1741972695,1741973151,1741973151.863755,-18000,,
com.google.Chrome,18,1741972677,1741972695,1741972695.2684212,-18000,,
com.microsoft.VSCode,15,1741972662,1741972677,1741972677.446804,-18000,,
com.google.Chrome,32,1741972630,1741972662,1741972662.0807018,-18000,,
com.microsoft.VSCode,211,1741972419,1741972630,1741972630.300904,-18000,,
com.google.Chrome,8,1741972411,1741972419,1741972419.326579,-18000,,
com.microsoft.VSCode,2,1741972409,1741972411,1741972411.2086291,-18000,,
com.google.Chrome,1,1741972408,1741972409,1741972409.6560922,-18000,,
com.microsoft.VSCode,2,1741972406,1741972408,1741972408.518036,-18000,,
com.google.Chrome,1,1741972405,1741972406,1741972406.4349241,-18000,,
com.microsoft.VSCode,3,1741972402,1741972405,1741972405.2381291,-18000,,
com.google.Chrome,3,1741972399,1741972402,1741972402.323773,-18000,,
com.microsoft.VSCode,3,1741972396,1741972399,1741972399.969022,-18000,,
com.google.Chrome,1,1741972395,1741972396,1741972396.787914,-18000,,
com.microsoft.VSCode,1,1741972394,1741972395,1741972395.70051,-18000,,
com.google.Chrome,2,1741972392,1741972394,1741972394.125194,-18000,,
com.microsoft.VSCode,3,1741972389,1741972392,1741972392.353864,-18000,,
com.google.Chrome,2,1741972387,1741972389,1741972389.166512,-18000,,
com.microsoft.VSCode,2,1741972385,1741972387,1741972387.179009,-18000,,
com.google.Chrome,2,1741972383,1741972385,1741972385.200335,-18000,,
com.microsoft.VSCode,1,1741972382,1741972383,1741972384.045285,-18000,,
com.google.Chrome,1,1741972381,1741972382,1741972382.5806022,-18000,,
com.microsoft.VSCode,2,1741972379,1741972381,1741972381.4639978,-18000,,
com.google.Chrome,3,1741972376,1741972379,1741972379.6956968,-18000,,
com.microsoft.VSCode,1,1741972375,1741972376,1741972377.0543861,-18000,,
com.google.Chrome,2,1741972373,1741972375,1741972375.4652982,-18000,,
com.microsoft.VSCode,2,1741972371,1741972373,1741972373.98343,-18000,,
com.google.Chrome,2,1741972369,1741972371,1741972371.881501,-18000,,
com.microsoft.VSCode,41,1741972328,1741972369,1741972369.101389,-18000,,
com.google.Chrome,3,1741972325,1741972328,1741972328.260875,-18000,,
com.microsoft.VSCode,2,1741972323,1741972325,1741972325.2958832,-18000,,
com.google.Chrome,2,1741972321,1741972323,1741972323.164054,-18000,,
com.microsoft.VSCode,2,1741972319,1741972321,1741972321.743263,-18000,,
com.google.Chrome,3,1741972316,1741972319,1741972319.498211,-18000,,
com.microsoft.VSCode,0,1741972316,1741972316,1741972316.707447,-18000,,
com.google.Chrome,2,1741972314,1741972316,1741972316.1484342,-18000,,
com.microsoft.VSCode,2,1741972312,1741972314,1741972314.650151,-18000,,
com.google.Chrome,2,1741972310,1741972312,1741972312.987925,-18000,,
com.microsoft.VSCode,7,1741972303,1741972310,1741972310.340534,-18000,,
com.google.Chrome,3,1741972300,1741972303,1741972303.237194,-18000,,
com.microsoft.VSCode,156,1741972144,1741972300,1741972300.9409041,-18000,,
com.google.Chrome,4,1741972140,1741972144,1741972144.489966,-18000,,
com.microsoft.VSCode,54,1741972086,1741972140,1741972140.742474,-18000,,
com.google.Chrome,1,1741972085,1741972086,1741972086.385664,-18000,,
com.microsoft.VSCode,86,1741971999,1741972085,1741972085.998657,-18000,,
com.google.Chrome,1,1741971998,1741971999,1741971999.648076,-18000,,
com.microsoft.VSCode,18,1741971980,1741971998,1741971998.822379,-18000,,
com.google.Chrome,3,1741971977,1741971980,1741971980.982675,-18000,,
com.microsoft.VSCode,3,1741971974,1741971977,1741971977.303797,-18000,,
com.google.Chrome,1,1741971973,1741971974,1741971974.569975,-18000,,
com.microsoft.VSCode,8,1741971965,1741971973,1741971973.921534,-18000,,
com.google.Chrome,17,1741971948,1741971965,1741971965.06638,-18000,,
com.microsoft.VSCode,2,1741971946,1741971948,1741971948.383255,-18000,,
com.google.Chrome,1,1741971945,1741971946,1741971946.947751,-18000,,
com.microsoft.VSCode,2,1741971943,1741971945,1741971945.892998,-18000,,
com.google.Chrome,1,1741971942,1741971943,1741971943.695024,-18000,,
com.microsoft.VSCode,2,1741971940,1741971942,1741971942.502173,-18000,,
com.google.Chrome,1,1741971939,1741971940,1741971940.601831,-18000,,
com.microsoft.VSCode,2,1741971937,1741971939,1741971939.3710542,-18000,,
com.google.Chrome,1,1741971936,1741971937,1741971937.76293,-18000,,
com.microsoft.VSCode,85,1741971851,1741971936,1741971936.94015,-18000,,
com.google.Chrome,2,1741971849,1741971851,1741971851.064454,-18000,,
com.microsoft.VSCode,83,1741971766,1741971849,1741971849.43816,-18000,,
com.google.Chrome,2,1741971764,1741971766,1741971766.148524,-18000,,
com.microsoft.VSCode,3,1741971761,1741971764,1741971764.927977,-18000,,
com.google.Chrome,15,1741971746,1741971761,1741971761.337331,-18000,,
com.microsoft.VSCode,1,1741971745,1741971746,1741971746.8383741,-18000,,
com.google.Chrome,6,1741971739,1741971745,1741971745.2661572,-18000,,
com.microsoft.VSCode,32,1741971707,1741971739,1741971739.747112,-18000,,
com.google.Chrome,79,1741971628,1741971707,1741971707.794704,-18000,,
com.leomehlig.today,45,1741971583,1741971628,1741971628.524393,-18000,,
com.google.Chrome,11,1741971572,1741971583,1741971584.020557,-18000,,
com.leomehlig.today,6,1741971566,1741971572,1741971572.8601952,-18000,,
com.apple.news,39,1741970067,1741970106,1741970106.825453,-18000,EB445137-D7F5-57EC-87DA-1DB460D64046,"iPhone13,2"
com.microsoft.Office.Outlook,6,1741969908,1741969914,1741969914.8013902,-18000,EB445137-D7F5-57EC-87DA-1DB460D64046,"iPhone13,2"
com.microsoft.Office.Outlook,65,1741968852,1741968917,1741968917.328126,-18000,EB445137-D7F5-57EC-87DA-1DB460D64046,"iPhone13,2"
com.apple.mobilecal,0,1741968852,1741968852,1741968853.990483,-18000,EB445137-D7F5-57EC-87DA-1DB460D64046,"iPhone13,2"
com.apple.mobilecal,63,1741968124,1741968187,1741968187.342186,-18000,EB445137-D7F5-57EC-87DA-1DB460D64046,"iPhone13,2"
com.apple.MobileSMS,5,1741968111,1741968116,1741968116.960493,-18000,EB445137-D7F5-57EC-87DA-1DB460D64046,"iPhone13,2"
com.apple.MobileSMS,20,1741968029,1741968049,1741968049.3528352,-18000,EB445137-D7F5-57EC-87DA-1DB460D64046,"iPhone13,2"
com.microsoft.Office.Outlook,2,1741968014,1741968016,1741968016.965385,-18000,EB445137-D7F5-57EC-87DA-1DB460D64046,"iPhone13,2"
com.microsoft.Office.Outlook,5,1741968006,1741968011,1741968011.759934,-18000,EB445137-D7F5-57EC-87DA-1DB460D64046,"iPhone13,2"
com.apple.MobileSMS,13,1741967987,1741968000,1741968000.1269011,-18000,EB445137-D7F5-57EC-87DA-1DB460D64046,"iPhone13,2"
com.apple.news,25,1741967962,1741967987,1741967987.731729,-18000,EB445137-D7F5-57EC-87DA-1DB460D64046,"iPhone13,2"
com.apple.MobileSMS,150,1741967810,1741967960,1741967960.75698,-18000,EB445137-D7F5-57EC-87DA-1DB460D64046,"iPhone13,2"
com.apple.MobileSMS,3,1741967058,1741967061,1741967061.919801,-18000,EB445137-D7F5-57EC-87DA-1DB460D64046,"iPhone13,2"
com.apple.weather,2,1741967055,1741967057,1741967057.112417,-18000,EB445137-D7F5-57EC-87DA-1DB460D64046,"iPhone13,2"
com.apple.weather,14,1741967028,1741967042,1741967043.193639,-18000,EB445137-D7F5-57EC-87DA-1DB460D64046,"iPhone13,2"
com.apple.weather,10,1741965654,1741965664,1741965664.427462,-18000,EB445137-D7F5-57EC-87DA-1DB460D64046,"iPhone13,2"
com.renpho.health,1,1741965653,1741965654,1741965654.8431,-18000,EB445137-D7F5-57EC-87DA-1DB460D64046,"iPhone13,2"
com.renpho.health,23,1741965595,1741965618,1741965618.779804,-18000,EB445137-D7F5-57EC-87DA-1DB460D64046,"iPhone13,2"
com.google.ios.youtube,1458,1741963252,1741964710,1741964710.933011,-18000,EB445137-D7F5-57EC-87DA-1DB460D64046,"iPhone13,2"
com.google.chrome.ios,189,1741936065,1741936254,1741936254.291379,-18000,EB445137-D7F5-57EC-87DA-1DB460D64046,"iPhone13,2"
com.microsoft.onenote,2,1741936063,1741936065,1741936065.666154,-18000,EB445137-D7F5-57EC-87DA-1DB460D64046,"iPhone13,2"
com.microsoft.onenote,58,1741933658,1741933716,1741933717.505722,-18000,EB445137-D7F5-57EC-87DA-1DB460D64046,"iPhone13,2"
Astrospheric.Astrospheric,2,1741933652,1741933654,1741933654.4931931,-18000,EB445137-D7F5-57EC-87DA-1DB460D64046,"iPhone13,2"
Astrospheric.Astrospheric,8,1741933310,1741933318,1741933318.3577971,-18000,EB445137-D7F5-57EC-87DA-1DB460D64046,"iPhone13,2"
Astrospheric.Astrospheric,5,1741933265,1741933270,1741933270.4991732,-18000,EB445137-D7F5-57EC-87DA-1DB460D64046,"iPhone13,2"
com.google.chrome.ios,4,1741933261,1741933265,1741933265.345823,-18000,EB445137-D7F5-57EC-87DA-1DB460D64046,"iPhone13,2"
com.google.chrome.ios,61,1741933115,1741933176,1741933176.67801,-18000,EB445137-D7F5-57EC-87DA-1DB460D64046,"iPhone13,2"
com.groundspeak.GeocachingIntro,1,1741933114,1741933115,1741933115.739733,-18000,EB445137-D7F5-57EC-87DA-1DB460D64046,"iPhone13,2"
com.groundspeak.GeocachingIntro,147,1741932245,1741932392,1741932392.701498,-18000,EB445137-D7F5-57EC-87DA-1DB460D64046,"iPhone13,2"
com.google.chrome.ios,7,1741932238,1741932245,1741932245.415606,-18000,EB445137-D7F5-57EC-87DA-1DB460D64046,"iPhone13,2"
com.google.chrome.ios,26,1741932189,1741932215,1741932216.454073,-18000,EB445137-D7F5-57EC-87DA-1DB460D64046,"iPhone13,2"
com.groundspeak.GeocachingIntro,263,1741931926,1741932189,1741932189.799683,-18000,EB445137-D7F5-57EC-87DA-1DB460D64046,"iPhone13,2"
com.groundspeak.GeocachingIntro,33,1741931765,1741931798,1741931799.155561,-18000,EB445137-D7F5-57EC-87DA-1DB460D64046,"iPhone13,2"
com.groundspeak.GeocachingIntro,83,1741930929,1741931012,1741931013.003835,-18000,EB445137-D7F5-57EC-87DA-1DB460D64046,"iPhone13,2"
com.apple.AuthenticationServicesUI,4,1741930537,1741930541,1741930541.7307692,-18000,EB445137-D7F5-57EC-87DA-1DB460D64046,"iPhone13,2"
com.groundspeak.GeocachingIntro,122,1741930505,1741930627,1741930627.7882419,-18000,EB445137-D7F5-57EC-87DA-1DB460D64046,"iPhone13,2"
com.apple.AppStore,95,1741930410,1741930505,1741930505.708998,-18000,EB445137-D7F5-57EC-87DA-1DB460D64046,"iPhone13,2"
Astrospheric.Astrospheric,1,1741930406,1741930407,1741930407.66742,-18000,EB445137-D7F5-57EC-87DA-1DB460D64046,"iPhone13,2"
Astrospheric.Astrospheric,15,1741929859,1741929874,1741929874.375916,-18000,EB445137-D7F5-57EC-87DA-1DB460D64046,"iPhone13,2"
com.apple.weather,2,1741929857,1741929859,1741929859.46696,-18000,EB445137-D7F5-57EC-87DA-1DB460D64046,"iPhone13,2"
com.apple.weather,4,1741928689,1741928693,1741928694.5666409,-18000,EB445137-D7F5-57EC-87DA-1DB460D64046,"iPhone13,2"
com.apple.MobileSMS,3,1741927893,1741927896,1741927896.0777159,-18000,EB445137-D7F5-57EC-87DA-1DB460D64046,"iPhone13,2"
com.apple.news,2,1741927744,1741927746,1741927746.984271,-18000,EB445137-D7F5-57EC-87DA-1DB460D64046,"iPhone13,2"
com.apple.news,102,1741927522,1741927624,1741927624.121142,-18000,EB445137-D7F5-57EC-87DA-1DB460D64046,"iPhone13,2"
com.apple.MobileSMS,9,1741927513,1741927522,1741927522.7056131,-18000,EB445137-D7F5-57EC-87DA-1DB460D64046,"iPhone13,2"
com.apple.news,546,1741926966,1741927512,1741927512.527439,-18000,EB445137-D7F5-57EC-87DA-1DB460D64046,"iPhone13,2"
com.apple.MobileSMS,26,1741926940,1741926966,1741926967.185658,-18000,EB445137-D7F5-57EC-87DA-1DB460D64046,"iPhone13,2"
com.apple.news,228,1741926712,1741926940,1741926940.257828,-18000,EB445137-D7F5-57EC-87DA-1DB460D64046,"iPhone13,2"
Astrospheric.Astrospheric,2,1741926690,1741926692,1741926692.826221,-18000,EB445137-D7F5-57EC-87DA-1DB460D64046,"iPhone13,2"
Astrospheric.Astrospheric,20,1741925889,1741925909,1741925909.337994,-18000,EB445137-D7F5-57EC-87DA-1DB460D64046,"iPhone13,2"
com.apple.MobileSMS,106,1741925530,1741925636,1741925636.702426,-18000,EB445137-D7F5-57EC-87DA-1DB460D64046,"iPhone13,2"
com.apple.weather,6,1741925523,1741925529,1741925529.939948,-18000,EB445137-D7F5-57EC-87DA-1DB460D64046,"iPhone13,2"
com.apple.weather,7,1741925220,1741925227,1741925227.3034868,-18000,EB445137-D7F5-57EC-87DA-1DB460D64046,"iPhone13,2"
com.apple.weather,2,1741924706,1741924708,1741924708.814283,-18000,EB445137-D7F5-57EC-87DA-1DB460D64046,"iPhone13,2"
Astrospheric.Astrospheric,53,1741924653,1741924706,1741924706.31634,-18000,EB445137-D7F5-57EC-87DA-1DB460D64046,"iPhone13,2"
com.apple.news,80,1741924569,1741924649,1741924649.430256,-18000,EB445137-D7F5-57EC-87DA-1DB460D64046,"iPhone13,2"
com.hammerandchisel.discord,12,1741924136,1741924148,1741924148.970438,-18000,EB445137-D7F5-57EC-87DA-1DB460D64046,"iPhone13,2"
com.google.chrome.ios,18,1741923165,1741923183,1741923183.8325992,-18000,EB445137-D7F5-57EC-87DA-1DB460D64046,"iPhone13,2"
com.t11.celeste,2,1741923163,1741923165,1741923165.258492,-18000,EB445137-D7F5-57EC-87DA-1DB460D64046,"iPhone13,2"
com.t11.celeste,30,1741923120,1741923150,1741923150.961093,-18000,EB445137-D7F5-57EC-87DA-1DB460D64046,"iPhone13,2"
com.apple.weather,2,1741923072,1741923074,1741923074.191807,-18000,EB445137-D7F5-57EC-87DA-1DB460D64046,"iPhone13,2"
com.apple.weather,9,1741919657,1741919666,1741919666.8000011,-18000,EB445137-D7F5-57EC-87DA-1DB460D64046,"iPhone13,2"
com.hammerandchisel.discord,2,1741919655,1741919657,1741919657.607759,-18000,EB445137-D7F5-57EC-87DA-1DB460D64046,"iPhone13,2"
com.hammerandchisel.discord,38,1741919217,1741919255,1741919256.280874,-18000,EB445137-D7F5-57EC-87DA-1DB460D64046,"iPhone13,2"
com.apple.mobileslideshow,0,1741919217,1741919217,1741919218.5468888,-18000,EB445137-D7F5-57EC-87DA-1DB460D64046,"iPhone13,2"
com.apple.mobileslideshow,103,1741918354,1741918457,1741918458.213076,-18000,EB445137-D7F5-57EC-87DA-1DB460D64046,"iPhone13,2"
com.apple.MobileSMS,18,1741916106,1741916124,1741916124.127759,-18000,EB445137-D7F5-57EC-87DA-1DB460D64046,"iPhone13,2"
Astrospheric.Astrospheric,1,1741916105,1741916106,1741916106.5018,-18000,EB445137-D7F5-57EC-87DA-1DB460D64046,"iPhone13,2"
Astrospheric.Astrospheric,6,1741916060,1741916066,1741916066.34586,-18000,EB445137-D7F5-57EC-87DA-1DB460D64046,"iPhone13,2"
Astrospheric.Astrospheric,17,1741916031,1741916048,1741916048.8147058,-18000,EB445137-D7F5-57EC-87DA-1DB460D64046,"iPhone13,2"
com.microsoft.Office.Outlook,5,1741915965,1741915970,1741915970.173413,-18000,EB445137-D7F5-57EC-87DA-1DB460D64046,"iPhone13,2"
com.apple.MobileSMS,69,1741915861,1741915930,1741915930.53421,-18000,EB445137-D7F5-57EC-87DA-1DB460D64046,"iPhone13,2"
com.apple.MobileSMS,10,1741915813,1741915823,1741915823.433378,-18000,EB445137-D7F5-57EC-87DA-1DB460D64046,"iPhone13,2"
com.apple.MobileSMS,9,1741915772,1741915781,1741915781.700144,-18000,EB445137-D7F5-57EC-87DA-1DB460D64046,"iPhone13,2"
com.google.ios.youtube,0,1741915772,1741915772,1741915773.571127,-18000,EB445137-D7F5-57EC-87DA-1DB460D64046,"iPhone13,2"
com.google.ios.youtube,614,1741913629,1741914243,1741914243.364038,-18000,EB445137-D7F5-57EC-87DA-1DB460D64046,"iPhone13,2"
com.tinyspeck.chatlyio,14,1741913598,1741913612,1741913613.0195742,-18000,EB445137-D7F5-57EC-87DA-1DB460D64046,"iPhone13,2"
com.apple.news,2,1741913595,1741913597,1741913597.5367541,-18000,EB445137-D7F5-57EC-87DA-1DB460D64046,"iPhone13,2"
com.leomehlig.today,156,1741912422,1741912578,1741912578.103331,-18000,,
com.apple.finder,3,1741912419,1741912422,1741912422.9013228,-18000,,
com.hnc.Discord,20,1741912399,1741912419,1741912419.425286,-18000,,
com.google.Chrome,495,1741911904,1741912399,1741912399.06664,-18000,,
com.google.Chrome,2295,1741909515,1741911810,1741911810.47173,-18000,,
com.google.Chrome,306,1741909141,1741909447,1741909447.245462,-18000,,
com.hnc.Discord,2,1741909139,1741909141,1741909141.164524,-18000,,
com.google.Chrome,32,1741909107,1741909139,1741909139.506604,-18000,,
com.hnc.Discord,15,1741909092,1741909107,1741909107.707672,-18000,,
com.google.Chrome,7,1741909085,1741909092,1741909092.314664,-18000,,
com.hnc.Discord,1,1741909084,1741909085,1741909085.376795,-18000,,
com.google.Chrome,2,1741909082,1741909084,1741909084.279502,-18000,,
com.hnc.Discord,3,1741909079,1741909082,1741909082.5559978,-18000,,
com.google.Chrome,540,1741908539,1741909079,1741909079.095228,-18000,,
com.apple.finder,1,1741908538,1741908539,1741908539.684379,-18000,,
com.apple.findmy,4,1741908534,1741908538,1741908538.487045,-18000,,
com.apple.news,135,1741908263,1741908398,1741908399.501756,-18000,EB445137-D7F5-57EC-87DA-1DB460D64046,"iPhone13,2"
com.apple.news,32,1741907676,1741907708,1741907708.197991,-18000,EB445137-D7F5-57EC-87DA-1DB460D64046,"iPhone13,2"
com.apple.weather,3,1741907655,1741907658,1741907658.203485,-18000,EB445137-D7F5-57EC-87DA-1DB460D64046,"iPhone13,2"
com.apple.findmy,296,1741904808,1741905104,1741905105.010213,-18000,,
com.apple.finder,5,1741904803,1741904808,1741904808.957452,-18000,,
com.apple.weather,30,1741904683,1741904713,1741904714.210209,-18000,EB445137-D7F5-57EC-87DA-1DB460D64046,"iPhone13,2"
com.leomehlig.today,198,1741904605,1741904803,1741904803.495037,-18000,,
com.apple.MobileSMS,3,1741904602,1741904605,1741904605.839536,-18000,,
Astrospheric.Astrospheric,22,1741904173,1741904195,1741904195.567892,-18000,EB445137-D7F5-57EC-87DA-1DB460D64046,"iPhone13,2"
com.apple.MobileSMS,321,1741904135,1741904456,1741904456.410378,-18000,,
com.apple.FaceTime,3,1741904132,1741904135,1741904135.154772,-18000,,
com.apple.MobileSMS,9,1741904123,1741904132,1741904132.300689,-18000,,
com.leomehlig.today,3,1741904120,1741904123,1741904123.079216,-18000,,
com.google.Chrome,2,1741904118,1741904120,1741904121.031248,-18000,,
com.leomehlig.today,27,1741904091,1741904118,1741904118.318912,-18000,,
com.apple.iCal,6,1741904085,1741904091,1741904091.563808,-18000,,
com.leomehlig.today,24,1741904061,1741904085,1741904085.577386,-18000,,
com.google.Chrome,865,1741903196,1741904061,1741904061.831787,-18000,,
com.apple.finder,5,1741903191,1741903196,1741903196.383422,-18000,,
com.apple.findmy,11,1741903180,1741903191,1741903191.296197,-18000,,
com.apple.finder,4,1741903176,1741903180,1741903180.21165,-18000,,
com.microsoft.Office.Outlook,33,1741902569,1741902602,1741902602.16777,-18000,EB445137-D7F5-57EC-87DA-1DB460D64046,"iPhone13,2"
com.google.chrome.ios,9,1741902560,1741902569,1741902569.160336,-18000,EB445137-D7F5-57EC-87DA-1DB460D64046,"iPhone13,2"
com.microsoft.Office.Outlook,15,1741902545,1741902560,1741902560.101069,-18000,EB445137-D7F5-57EC-87DA-1DB460D64046,"iPhone13,2"
com.apple.weather,0,1741902545,1741902545,1741902546.054123,-18000,EB445137-D7F5-57EC-87DA-1DB460D64046,"iPhone13,2"
com.google.Chrome,2282,1741900894,1741903176,1741903176.118541,-18000,,
com.leomehlig.today,24,1741900374,1741900398,1741900398.946622,-18000,,
com.google.Chrome,576,1741899798,1741900374,1741900374.943794,-18000,,
com.leomehlig.today,12,1741899786,1741899798,1741899798.528435,-18000,,
com.google.Chrome,1,1741899785,1741899786,1741899786.7108111,-18000,,
com.apple.iCal,4,1741899781,1741899785,1741899785.742261,-18000,,
com.google.Chrome,18,1741899763,1741899781,1741899781.02195,-18000,,
com.apple.weather,13,1741898913,1741898926,1741898926.1387591,-18000,EB445137-D7F5-57EC-87DA-1DB460D64046,"iPhone13,2"
com.google.Gmail,3,1741896645,1741896648,1741896648.2714272,-18000,EB445137-D7F5-57EC-87DA-1DB460D64046,"iPhone13,2"
com.google.chrome.ios,65,1741896579,1741896644,1741896644.8401809,-18000,EB445137-D7F5-57EC-87DA-1DB460D64046,"iPhone13,2"
com.google.Chrome,161,1741896536,1741896697,1741896697.528609,-18000,,
com.google.Gmail,46,1741896533,1741896579,1741896579.9872332,-18000,EB445137-D7F5-57EC-87DA-1DB460D64046,"iPhone13,2"
com.apple.mobilecal,5,1741896525,1741896530,1741896531.048397,-18000,EB445137-D7F5-57EC-87DA-1DB460D64046,"iPhone13,2"
com.microsoft.Office.Outlook,40,1741896481,1741896521,1741896521.916995,-18000,EB445137-D7F5-57EC-87DA-1DB460D64046,"iPhone13,2"
com.toyopagroup.picaboo,13,1741896459,1741896472,1741896472.516995,-18000,EB445137-D7F5-57EC-87DA-1DB460D64046,"iPhone13,2"
com.apple.finder,86,1741896450,1741896536,1741896536.469902,-18000,,
com.intsig.CamScannerLite,52,1741896401,1741896453,1741896454.195208,-18000,EB445137-D7F5-57EC-87DA-1DB460D64046,"iPhone13,2"
com.google.Chrome,82,1741896368,1741896450,1741896450.341054,-18000,,
com.leomehlig.today,5,1741896363,1741896368,1741896368.274932,-18000,,
com.google.Chrome,0,1741896363,1741896363,1741896364.016464,-18000,,
com.apple.iCal,7,1741896356,1741896363,1741896363.139759,-18000,,
com.google.Chrome,2,1741896354,1741896356,1741896356.735395,-18000,,
com.leomehlig.today,9,1741896345,1741896354,1741896354.187959,-18000,,
com.google.Chrome,87,1741896258,1741896345,1741896345.934319,-18000,,
com.google.Chrome,454,1741895541,1741895995,1741895995.556944,-18000,,
com.google.Chrome,656,1741892382,1741893038,1741893038.269929,-18000,,
com.apple.Passwords,7,1741892375,1741892382,1741892382.9588509,-18000,,
com.google.Chrome,1,1741892374,1741892375,1741892376.0185208,-18000,,
com.google.Chrome,10,1741891232,1741891242,1741891242.417608,-18000,,
com.leomehlig.today,2,1741890897,1741890899,1741890899.311695,-18000,,
com.apple.weather,70,1741887227,1741887297,1741887297.402766,-18000,EB445137-D7F5-57EC-87DA-1DB460D64046,"iPhone13,2"
Astrospheric.Astrospheric,46,1741887181,1741887227,1741887228.116496,-18000,EB445137-D7F5-57EC-87DA-1DB460D64046,"iPhone13,2"
com.microsoft.Office.Outlook,2,1741887177,1741887179,1741887179.556975,-18000,EB445137-D7F5-57EC-87DA-1DB460D64046,"iPhone13,2"
com.microsoft.Office.Outlook,29,1741887111,1741887140,1741887140.728273,-18000,EB445137-D7F5-57EC-87DA-1DB460D64046,"iPhone13,2"
co.hinge.mobile.ios,64,1741887045,1741887109,1741887109.3546,-18000,EB445137-D7F5-57EC-87DA-1DB460D64046,"iPhone13,2"
co.hinge.mobile.ios,6,1741887037,1741887043,1741887043.0847878,-18000,EB445137-D7F5-57EC-87DA-1DB460D64046,"iPhone13,2"
co.hinge.mobile.ios,22,1741886940,1741886962,1741886962.330153,-18000,EB445137-D7F5-57EC-87DA-1DB460D64046,"iPhone13,2"
com.apple.Health,30,1741886906,1741886936,1741886936.731122,-18000,EB445137-D7F5-57EC-87DA-1DB460D64046,"iPhone13,2"
com.apple.Health,26,1741886877,1741886903,1741886904.0412831,-18000,EB445137-D7F5-57EC-87DA-1DB460D64046,"iPhone13,2"
com.apple.MobileSMS,2,1741886875,1741886877,1741886877.434634,-18000,EB445137-D7F5-57EC-87DA-1DB460D64046,"iPhone13,2"
com.intsig.CamScannerLite,0,1741886875,1741886875,1741886877.2448878,-18000,EB445137-D7F5-57EC-87DA-1DB460D64046,"iPhone13,2"
com.leomehlig.today,65,1741885319,1741885384,1741885384.984075,-18000,,
com.microsoft.VSCode,6,1741885313,1741885319,1741885319.979711,-18000,,
com.google.Chrome,62,1741885251,1741885313,1741885313.857219,-18000,,
com.microsoft.VSCode,2,1741885249,1741885251,1741885251.951199,-18000,,
com.google.Chrome,1,1741885248,1741885249,1741885249.899646,-18000,,
com.microsoft.VSCode,8,1741885240,1741885248,1741885248.079794,-18000,,
com.google.Chrome,10,1741885230,1741885240,1741885241.0751572,-18000,,
com.microsoft.VSCode,53,1741885177,1741885230,1741885230.397826,-18000,,
com.google.Chrome,32,1741885145,1741885177,1741885177.7888188,-18000,,
com.leomehlig.today,44,1741885101,1741885145,1741885145.089689,-18000,,
com.apple.finder,9,1741885092,1741885101,1741885101.6560721,-18000,,
com.google.Chrome,45,1741885047,1741885092,1741885092.285326,-18000,,
com.apple.finder,1,1741885030,1741885031,1741885032.0421739,-18000,,
com.microsoft.VSCode,4,1741885026,1741885030,1741885030.753481,-18000,,
com.apple.Preview,44,1741884982,1741885026,1741885026.743032,-18000,,
com.apple.finder,1,1741884981,1741884982,1741884982.400272,-18000,,
com.apple.Preview,1,1741884980,1741884981,1741884981.7192512,-18000,,
com.apple.finder,23,1741884957,1741884980,1741884980.499671,-18000,,
com.google.Chrome,36,1741884921,1741884957,1741884957.0321689,-18000,,
com.apple.finder,1,1741884920,1741884921,1741884921.205965,-18000,,
com.google.Chrome,1,1741884919,1741884920,1741884920.317029,-18000,,
com.intsig.CamScannerLite,115,1741884861,1741884976,1741884977.2052898,-18000,EB445137-D7F5-57EC-87DA-1DB460D64046,"iPhone13,2"
com.microsoft.VSCode,761,1741884158,1741884919,1741884919.815212,-18000,,
com.google.Chrome,5,1741884153,1741884158,1741884158.320757,-18000,,
com.microsoft.VSCode,158,1741883995,1741884153,1741884154.037637,-18000,,
com.google.Chrome,1675,1741882320,1741883995,1741883995.205493,-18000,,
com.instructure.icanvas,34,1741882203,1741882237,1741882237.91334,-18000,EB445137-D7F5-57EC-87DA-1DB460D64046,"iPhone13,2"
com.apple.MobileSMS,20,1741882177,1741882197,1741882197.5351691,-18000,EB445137-D7F5-57EC-87DA-1DB460D64046,"iPhone13,2"
com.leomehlig.today,227,1741882093,1741882320,1741882320.637095,-18000,,
com.google.Chrome,42,1741882051,1741882093,1741882093.698563,-18000,,
com.leomehlig.today,3,1741882038,1741882041,1741882041.191647,-18000,,
com.google.Chrome,1226,1741880812,1741882038,1741882038.740874,-18000,,
com.google.Chrome,1621,1741879070,1741880691,1741880691.233272,-18000,,
com.apple.finder,2,1741879068,1741879070,1741879071.612648,-18000,,
com.leomehlig.today,20,1741879048,1741879068,1741879068.9338799,-18000,,
com.google.Chrome,5,1741879043,1741879048,1741879048.088597,-18000,,
com.microsoft.Office.Outlook,25,1741877032,1741877057,1741877058.0901809,-18000,EB445137-D7F5-57EC-87DA-1DB460D64046,"iPhone13,2"
com.apple.weather,2,1741877030,1741877032,1741877032.227734,-18000,EB445137-D7F5-57EC-87DA-1DB460D64046,"iPhone13,2"
com.apple.weather,26,1741875219,1741875245,1741875246.008415,-18000,EB445137-D7F5-57EC-87DA-1DB460D64046,"iPhone13,2"
com.renpho.health,2,1741875217,1741875219,1741875219.298538,-18000,EB445137-D7F5-57EC-87DA-1DB460D64046,"iPhone13,2"
com.renpho.health,39,1741874790,1741874829,1741874829.199584,-18000,EB445137-D7F5-57EC-87DA-1DB460D64046,"iPhone13,2"
com.instructure.icanvas,52,1741843825,1741843877,1741843879.119598,-18000,EB445137-D7F5-57EC-87DA-1DB460D64046,"iPhone13,2"
com.thestorygraph.thestorygraph,14,1741842221,1741842235,1741842235.979928,-18000,EB445137-D7F5-57EC-87DA-1DB460D64046,"iPhone13,2"
com.apple.FTMInternal,29,1741840547,1741840576,1741840576.473232,-18000,EB445137-D7F5-57EC-87DA-1DB460D64046,"iPhone13,2"
com.apple.mobilephone,1,1741840546,1741840547,1741840547.8092198,-18000,EB445137-D7F5-57EC-87DA-1DB460D64046,"iPhone13,2"
com.apple.FTMInternal,13,1741840532,1741840545,1741840545.510577,-18000,EB445137-D7F5-57EC-87DA-1DB460D64046,"iPhone13,2"
com.apple.mobilephone,6,1741840526,1741840532,1741840532.083741,-18000,EB445137-D7F5-57EC-87DA-1DB460D64046,"iPhone13,2"
com.google.chrome.ios,18,1741840508,1741840526,1741840526.9148211,-18000,EB445137-D7F5-57EC-87DA-1DB460D64046,"iPhone13,2"
com.apple.CTNotifyUIService,2,1741840505,1741840507,1741840507.381499,-18000,EB445137-D7F5-57EC-87DA-1DB460D64046,"iPhone13,2"
com.apple.CTNotifyUIService,1,1741840496,1741840497,1741840497.747544,-18000,EB445137-D7F5-57EC-87DA-1DB460D64046,"iPhone13,2"
com.apple.CTNotifyUIService,5,1741840484,1741840489,1741840489.9377499,-18000,EB445137-D7F5-57EC-87DA-1DB460D64046,"iPhone13,2"
com.apple.mobilephone,35,1741840473,1741840508,1741840508.569298,-18000,EB445137-D7F5-57EC-87DA-1DB460D64046,"iPhone13,2"
com.google.chrome.ios,8,1741840465,1741840473,1741840473.944182,-18000,EB445137-D7F5-57EC-87DA-1DB460D64046,"iPhone13,2"
com.apple.CTNotifyUIService,5,1741840458,1741840463,1741840463.215039,-18000,EB445137-D7F5-57EC-87DA-1DB460D64046,"iPhone13,2"
com.apple.mobilephone,24,1741840441,1741840465,1741840465.221291,-18000,EB445137-D7F5-57EC-87DA-1DB460D64046,"iPhone13,2"
com.google.chrome.ios,33,1741840407,1741840440,1741840441.415098,-18000,EB445137-D7F5-57EC-87DA-1DB460D64046,"iPhone13,2"
com.apple.mobilephone,13,1741840394,1741840407,1741840408.278641,-18000,EB445137-D7F5-57EC-87DA-1DB460D64046,"iPhone13,2"
com.letterboxd.LetterboxdApp,82,1741839906,1741839988,1741839988.6751351,-18000,EB445137-D7F5-57EC-87DA-1DB460D64046,"iPhone13,2"
com.thestorygraph.thestorygraph,15,1741839890,1741839905,1741839906.331954,-18000,EB445137-D7F5-57EC-87DA-1DB460D64046,"iPhone13,2"
com.google.chrome.ios,3,1741839887,1741839890,1741839893.068952,-18000,EB445137-D7F5-57EC-87DA-1DB460D64046,"iPhone13,2"
com.google.Chrome,392,1741838404,1741838796,1741838796.877697,-18000,,
com.apple.finder,4,1741838400,1741838404,1741838404.953872,-18000,,
com.apple.finder,3,1741838193,1741838196,1741838196.425513,-18000,,
com.apple.news,175,1741838018,1741838193,1741838193.7756171,-18000,,
com.apple.finder,35,1741837983,1741838018,1741838018.985073,-18000,,
com.google.chrome.ios,110,1741831494,1741831604,1741831604.532174,-18000,EB445137-D7F5-57EC-87DA-1DB460D64046,"iPhone13,2"
com.apple.Music,6,1741831014,1741831020,1741831020.315784,-18000,EB445137-D7F5-57EC-87DA-1DB460D64046,"iPhone13,2"
com.apple.Music,17,1741829713,1741829730,1741829730.88486,-18000,EB445137-D7F5-57EC-87DA-1DB460D64046,"iPhone13,2"
com.apple.finder,1,1741829556,1741829557,1741829557.5826411,-18000,,
com.leomehlig.today,1,1741829555,1741829556,1741829556.519386,-18000,,
com.apple.iCal,21,1741829534,1741829555,1741829555.075758,-18000,,
com.leomehlig.today,106,1741829428,1741829534,1741829534.7183452,-18000,,
com.google.Chrome,1688,1741827740,1741829428,1741829428.5314178,-18000,,
com.leomehlig.today,12,1741827717,1741827729,1741827729.687199,-18000,,
com.google.Chrome,121,1741827596,1741827717,1741827717.163028,-18000,,
com.apple.finder,3,1741827593,1741827596,1741827596.255019,-18000,,
com.google.Chrome,2,1741827591,1741827593,1741827593.3848581,-18000,,
com.apple.finder,2,1741827589,1741827591,1741827591.824129,-18000,,
com.google.Chrome,5,1741827584,1741827589,1741827589.216186,-18000,,
com.apple.Preview,61,1741827523,1741827584,1741827584.6257582,-18000,,
com.apple.finder,8,1741827515,1741827523,1741827523.9716702,-18000,,
com.microsoft.Word,1,1741827514,1741827515,1741827515.693626,-18000,,
com.apple.finder,22,1741827492,1741827514,1741827514.207706,-18000,,
com.google.Chrome,23,1741827469,1741827492,1741827492.335432,-18000,,
com.microsoft.Word,89,1741827368,1741827457,1741827457.052853,-18000,,
com.apple.Preview,5,1741827363,1741827368,1741827368.954279,-18000,,
com.google.Chrome,3,1741827360,1741827363,1741827364.065432,-18000,,
com.microsoft.Word,10,1741827350,1741827360,1741827360.52759,-18000,,
com.google.Chrome,10,1741827340,1741827350,1741827351.024543,-18000,,
com.microsoft.Word,24,1741827316,1741827340,1741827340.4902658,-18000,,
com.google.Chrome,3,1741827313,1741827316,1741827316.1107678,-18000,,
com.microsoft.Word,0,1741827313,1741827313,1741827313.831952,-18000,,
com.google.Chrome,2,1741827311,1741827313,1741827313.35366,-18000,,
com.microsoft.Word,7,1741827304,1741827311,1741827311.144412,-18000,,
com.google.Chrome,2,1741827302,1741827304,1741827304.869145,-18000,,
com.microsoft.Word,6,1741827296,1741827302,1741827302.7915668,-18000,,
com.google.Chrome,19,1741827277,1741827296,1741827296.61467,-18000,,
com.microsoft.Word,1,1741827276,1741827277,1741827277.6593819,-18000,,
com.google.Chrome,4,1741827272,1741827276,1741827276.200323,-18000,,
com.microsoft.Word,58,1741827214,1741827272,1741827272.754921,-18000,,
com.google.Chrome,3,1741827211,1741827214,1741827214.986098,-18000,,
com.microsoft.Word,10,1741827201,1741827211,1741827211.362718,-18000,,
com.google.Chrome,12,1741827189,1741827201,1741827201.680196,-18000,,
com.microsoft.Word,9,1741827180,1741827189,1741827189.632932,-18000,,
com.google.Chrome,2,1741827178,1741827180,1741827180.991156,-18000,,
com.microsoft.Word,17,1741827161,1741827178,1741827178.151521,-18000,,
com.google.Chrome,4,1741827157,1741827161,1741827161.082936,-18000,,
com.microsoft.Word,10,1741827147,1741827157,1741827157.568233,-18000,,
com.google.Chrome,17,1741827130,1741827147,1741827147.7028189,-18000,,
com.microsoft.Word,4,1741827126,1741827130,1741827131.0296412,-18000,,
com.google.Chrome,2,1741827124,1741827126,1741827126.9588652,-18000,,
com.microsoft.Word,7,1741827117,1741827124,1741827124.1482592,-18000,,
com.google.Chrome,21,1741827096,1741827117,1741827117.951023,-18000,,
com.microsoft.Word,22,1741827074,1741827096,1741827096.4264479,-18000,,
com.google.Chrome,12,1741827062,1741827074,1741827074.270009,-18000,,
com.microsoft.Word,3,1741827059,1741827062,1741827062.6045098,-18000,,
com.google.Chrome,25,1741827034,1741827059,1741827059.613383,-18000,,
com.microsoft.Word,11,1741827023,1741827034,1741827034.092029,-18000,,
com.google.Chrome,40,1741826983,1741827023,1741827023.404245,-18000,,
com.microsoft.Word,3,1741826980,1741826983,1741826983.994184,-18000,,
com.google.Chrome,39,1741826941,1741826980,1741826980.878114,-18000,,
com.microsoft.Word,13,1741826928,1741826941,1741826941.744255,-18000,,
com.google.Chrome,4,1741826924,1741826928,1741826928.57201,-18000,,
com.microsoft.Word,48,1741826876,1741826924,1741826924.104457,-18000,,
com.google.Chrome,33,1741826843,1741826876,1741826876.686154,-18000,,
com.microsoft.Word,4,1741826839,1741826843,1741826843.631864,-18000,,
com.google.Chrome,53,1741826786,1741826839,1741826839.925674,-18000,,
com.microsoft.Word,3,1741826783,1741826786,1741826787.043435,-18000,,
com.google.Chrome,5,1741826778,1741826783,1741826783.6487699,-18000,,
com.microsoft.Word,9,1741826769,1741826778,1741826778.1314058,-18000,,
com.google.Chrome,5,1741826764,1741826769,1741826770.066049,-18000,,
com.microsoft.Word,9,1741826755,1741826764,1741826764.796183,-18000,,
com.google.Chrome,2,1741826753,1741826755,1741826755.727896,-18000,,
com.microsoft.Word,8,1741826745,1741826753,1741826753.702147,-18000,,
com.google.Chrome,3,1741826742,1741826745,1741826745.133704,-18000,,
com.microsoft.Word,10,1741826732,1741826742,1741826742.4578881,-18000,,
com.google.Chrome,4,1741826728,1741826732,1741826732.3068829,-18000,,
com.microsoft.Word,10,1741826718,1741826728,1741826728.411592,-18000,,
com.google.Chrome,1,1741826717,1741826718,1741826718.519641,-18000,,
com.microsoft.Word,4,1741826713,1741826717,1741826717.307201,-18000,,
com.google.Chrome,19,1741826694,1741826713,1741826713.3722072,-18000,,
com.microsoft.Word,12,1741826682,1741826694,1741826694.2074509,-18000,,
com.google.Chrome,9,1741826673,1741826682,1741826682.533389,-18000,,
com.microsoft.Word,3,1741826670,1741826673,1741826673.256767,-18000,,
com.google.Chrome,7,1741826663,1741826670,1741826670.559737,-18000,,
com.microsoft.Word,6,1741826657,1741826663,1741826663.8758888,-18000,,
com.google.Chrome,5,1741826652,1741826657,1741826657.120376,-18000,,
com.microsoft.Word,44,1741826608,1741826652,1741826652.1852078,-18000,,
com.google.Chrome,11,1741826597,1741826608,1741826608.3762178,-18000,,
com.microsoft.Word,2,1741826595,1741826597,1741826597.330457,-18000,,
com.google.Chrome,7,1741826588,1741826595,1741826595.4763541,-18000,,
com.microsoft.Word,66,1741826522,1741826588,1741826588.205682,-18000,,
com.google.Chrome,3,1741826519,1741826522,1741826522.229228,-18000,,
com.microsoft.Word,21,1741826498,1741826519,1741826519.908205,-18000,,
com.google.Chrome,4,1741826494,1741826498,1741826498.749837,-18000,,
com.microsoft.Word,11,1741826483,1741826494,1741826494.2101889,-18000,,
com.google.Chrome,26,1741826457,1741826483,1741826483.079401,-18000,,
com.microsoft.Word,3,1741826454,1741826457,1741826457.559239,-18000,,
com.google.Chrome,1,1741826453,1741826454,1741826454.051333,-18000,,
com.microsoft.Word,4,1741826449,1741826453,1741826453.065036,-18000,,
com.google.Chrome,52,1741826397,1741826449,1741826449.264806,-18000,,
com.microsoft.Word,14,1741826383,1741826397,1741826397.7685652,-18000,,
com.google.Chrome,19,1741826364,1741826383,1741826383.792253,-18000,,
com.microsoft.Word,65,1741826299,1741826364,1741826364.517465,-18000,,
com.google.Chrome,11,1741826288,1741826299,1741826299.171091,-18000,,
com.microsoft.Word,0,1741826288,1741826288,1741826288.509575,-18000,,
com.leomehlig.today,1,1741826287,1741826288,1741826288.256741,-18000,,
com.microsoft.Word,10,1741826277,1741826287,1741826287.7242332,-18000,,
com.google.Chrome,11,1741826266,1741826277,1741826277.9491239,-18000,,
com.microsoft.Word,3,1741826263,1741826266,1741826266.9889522,-18000,,
com.google.Chrome,17,1741826246,1741826263,1741826263.973186,-18000,,
com.microsoft.Word,5,1741826241,1741826246,1741826246.3374472,-18000,,
com.google.Chrome,4,1741826237,1741826241,1741826241.5518122,-18000,,
com.microsoft.Word,3,1741826234,1741826237,1741826237.6922278,-18000,,
com.google.Chrome,10,1741826224,1741826234,1741826234.585268,-18000,,
com.microsoft.Word,14,1741826210,1741826224,1741826224.513217,-18000,,
com.google.Chrome,33,1741826177,1741826210,1741826210.7224941,-18000,,
com.microsoft.Word,3,1741826174,1741826177,1741826177.182972,-18000,,
com.google.Chrome,108,1741826066,1741826174,1741826174.9319968,-18000,,
com.microsoft.Word,3,1741826063,1741826066,1741826066.50949,-18000,,
com.google.Chrome,4,1741826059,1741826063,1741826063.565105,-18000,,
com.microsoft.Word,44,1741826015,1741826059,1741826059.528337,-18000,,
com.google.Chrome,3,1741826012,1741826015,1741826015.575673,-18000,,
com.microsoft.Word,1,1741826011,1741826012,1741826012.387744,-18000,,
com.google.Chrome,2,1741826009,1741826011,1741826011.981713,-18000,,
com.leomehlig.today,0,1741826009,1741826009,1741826009.895626,-18000,,
com.microsoft.Word,7,1741826002,1741826009,1741826009.290477,-18000,,
com.leomehlig.today,1,1741826001,1741826002,1741826002.868411,-18000,,
com.google.Chrome,8,1741825993,1741826001,1741826001.5738192,-18000,,
com.leomehlig.today,28,1741825965,1741825993,1741825993.351583,-18000,,
com.google.Chrome,13,1741825952,1741825965,1741825965.355082,-18000,,
com.microsoft.Word,1,1741825951,1741825952,1741825952.984219,-18000,,
com.google.Chrome,3,1741825948,1741825951,1741825951.1791139,-18000,,
com.microsoft.Word,19,1741825929,1741825948,1741825948.985999,-18000,,
com.google.Chrome,5,1741825924,1741825929,1741825929.776398,-18000,,
com.microsoft.Word,36,1741825888,1741825924,1741825924.371986,-18000,,
com.google.Chrome,1,1741825887,1741825888,1741825888.807688,-18000,,
com.microsoft.Word,11,1741825876,1741825887,1741825887.976241,-18000,,
com.google.Chrome,0,1741825876,1741825876,1741825876.904186,-18000,,
com.microsoft.Word,1,1741825875,1741825876,1741825876.187213,-18000,,
com.google.Chrome,6,1741825869,1741825875,1741825875.292408,-18000,,
com.microsoft.Word,6,1741825863,1741825869,1741825869.923061,-18000,,
com.google.Chrome,5,1741825858,1741825863,1741825863.256943,-18000,,
com.microsoft.Word,14,1741825844,1741825858,1741825858.767952,-18000,,
com.google.Chrome,9,1741825835,1741825844,1741825844.7826328,-18000,,
com.microsoft.Word,1,1741825834,1741825835,1741825835.4760818,-18000,,
com.google.Chrome,4,1741825830,1741825834,1741825834.7240958,-18000,,
com.microsoft.Word,10,1741825820,1741825830,1741825830.3929749,-18000,,
com.google.Chrome,4,1741825816,1741825820,1741825820.8300061,-18000,,
com.microsoft.Word,7,1741825809,1741825816,1741825816.720896,-18000,,
com.google.Chrome,7,1741825802,1741825809,1741825809.4982371,-18000,,
com.microsoft.Word,1,1741825801,1741825802,1741825802.4148521,-18000,,
com.google.Chrome,5,1741825796,1741825801,1741825801.3555632,-18000,,
com.microsoft.Word,7,1741825789,1741825796,1741825796.180912,-18000,,
com.google.Chrome,4,1741825785,1741825789,1741825789.694353,-18000,,
com.microsoft.Word,3,1741825782,1741825785,1741825785.8468451,-18000,,
com.google.Chrome,10,1741825772,1741825782,1741825782.227184,-18000,,
com.microsoft.Word,31,1741825741,1741825772,1741825772.594718,-18000,,
com.google.Chrome,8,1741825733,1741825741,1741825741.929635,-18000,,
com.microsoft.Word,11,1741825722,1741825733,1741825733.4224281,-18000,,
com.google.Chrome,1,1741825721,1741825722,1741825722.366836,-18000,,
com.microsoft.Word,57,1741825664,1741825721,1741825721.594421,-18000,,
com.google.Chrome,2,1741825662,1741825664,1741825664.0760732,-18000,,
com.microsoft.Word,9,1741825653,1741825662,1741825663.0173922,-18000,,
com.google.Chrome,22,1741825631,1741825653,1741825653.518622,-18000,,
com.microsoft.Word,8,1741825623,1741825631,1741825631.332722,-18000,,
com.google.Chrome,7,1741825616,1741825623,1741825623.764303,-18000,,
com.microsoft.Word,2,1741825614,1741825616,1741825616.7552881,-18000,,
com.google.Chrome,7,1741825607,1741825614,1741825614.570341,-18000,,
com.microsoft.Word,17,1741825590,1741825607,1741825607.363069,-18000,,
com.google.Chrome,5,1741825585,1741825590,1741825590.200972,-18000,,
com.microsoft.Word,3,1741825582,1741825585,1741825585.886314,-18000,,
com.google.Chrome,47,1741825535,1741825582,1741825582.53693,-18000,,
com.microsoft.Word,5,1741825530,1741825535,1741825535.6684809,-18000,,
com.google.Chrome,59,1741825471,1741825530,1741825530.801385,-18000,,
com.microsoft.Word,3,1741825468,1741825471,1741825471.093038,-18000,,
com.google.Chrome,45,1741825423,1741825468,1741825468.417889,-18000,,
com.microsoft.Word,4,1741825419,1741825423,1741825423.814467,-18000,,
com.google.Chrome,54,1741825365,1741825419,1741825419.1670651,-18000,,
com.microsoft.Word,2,1741825363,1741825365,1741825365.64272,-18000,,
com.google.Chrome,8,1741825355,1741825363,1741825363.0895228,-18000,,
com.microsoft.Word,12,1741825343,1741825355,1741825355.764976,-18000,,
com.google.Chrome,2,1741825341,1741825343,1741825343.414394,-18000,,
com.microsoft.Word,7,1741825334,1741825341,1741825341.376194,-18000,,
com.google.Chrome,9,1741825325,1741825334,1741825334.693119,-18000,,
com.microsoft.Word,0,1741825325,1741825325,1741825325.525414,-18000,,
com.google.Chrome,27,1741825298,1741825325,1741825325.1422238,-18000,,
com.microsoft.Word,3,1741825295,1741825298,1741825298.483642,-18000,,
com.google.Chrome,37,1741825258,1741825295,1741825295.6160312,-18000,,
com.microsoft.Word,18,1741825240,1741825258,1741825258.544292,-18000,,
com.google.Chrome,115,1741825125,1741825240,1741825240.0897598,-18000,,
com.microsoft.Word,2,1741825123,1741825125,1741825125.589956,-18000,,
com.google.Chrome,2,1741825121,1741825123,1741825123.629737,-18000,,
com.toyopagroup.picaboo,8,1741825076,1741825084,1741825085.1026711,-18000,EB445137-D7F5-57EC-87DA-1DB460D64046,"iPhone13,2"
com.microsoft.Word,226,1741824895,1741825121,1741825121.21445,-18000,,
com.google.Chrome,26,1741824869,1741824895,1741824895.8882651,-18000,,
com.microsoft.Word,279,1741824590,1741824869,1741824869.853406,-18000,,
com.google.Chrome,67,1741824523,1741824590,1741824590.763279,-18000,,
com.microsoft.Word,8,1741824515,1741824523,1741824523.412189,-18000,,
com.apple.Preview,155,1741824360,1741824515,1741824515.711149,-18000,,
com.microsoft.Word,61,1741824299,1741824360,1741824360.0927548,-18000,,
com.apple.Preview,30,1741824269,1741824299,1741824299.289408,-18000,,
com.apple.finder,8,1741824261,1741824269,1741824269.570804,-18000,,
com.apple.Preview,34,1741824227,1741824261,1741824261.9497318,-18000,,
com.apple.finder,1,1741824226,1741824227,1741824227.455793,-18000,,
com.microsoft.Word,11,1741824215,1741824226,1741824226.4826388,-18000,,
com.apple.Preview,61,1741824154,1741824215,1741824215.930959,-18000,,
com.apple.finder,7,1741824147,1741824154,1741824154.214958,-18000,,
com.microsoft.Word,99,1741824048,1741824147,1741824147.579912,-18000,,
com.google.Chrome,81,1741823967,1741824048,1741824048.288241,-18000,,
com.microsoft.Word,187,1741823780,1741823967,1741823967.2632651,-18000,,
com.google.Chrome,3,1741823777,1741823780,1741823780.273055,-18000,,
com.microsoft.Word,3,1741823774,1741823777,1741823777.835576,-18000,,
com.google.Chrome,29,1741823745,1741823774,1741823774.7473779,-18000,,
com.microsoft.Word,150,1741823595,1741823745,1741823745.119411,-18000,,
com.google.Chrome,10,1741823585,1741823595,1741823595.0659242,-18000,,
com.microsoft.Word,66,1741823519,1741823585,1741823585.101129,-18000,,
com.google.Chrome,69,1741823450,1741823519,1741823519.130424,-18000,,
com.microsoft.Word,62,1741823388,1741823450,1741823450.344205,-18000,,
com.google.Chrome,3,1741823385,1741823388,1741823388.172203,-18000,,
com.microsoft.Word,4,1741823381,1741823385,1741823385.1034288,-18000,,
com.google.Chrome,18,1741823363,1741823381,1741823381.230287,-18000,,
com.microsoft.Word,2,1741823361,1741823363,1741823363.913698,-18000,,
com.google.Chrome,17,1741823344,1741823361,1741823361.6994948,-18000,,
com.microsoft.Word,13,1741823331,1741823344,1741823344.166394,-18000,,
com.google.Chrome,61,1741823270,1741823331,1741823331.913446,-18000,,
com.microsoft.Word,5,1741823265,1741823270,1741823270.76635,-18000,,
com.google.Chrome,1,1741823264,1741823265,1741823265.9614,-18000,,
com.microsoft.Word,3,1741823261,1741823264,1741823264.839329,-18000,,
com.google.Chrome,10,1741823251,1741823261,1741823261.6045818,-18000,,
com.microsoft.Word,3,1741823248,1741823251,1741823252.051186,-18000,,
com.google.Chrome,19,1741823229,1741823248,1741823248.928242,-18000,,
com.microsoft.Word,2,1741823227,1741823229,1741823229.937856,-18000,,
com.google.Chrome,4,1741823223,1741823227,1741823227.54888,-18000,,
com.microsoft.Word,3,1741823220,1741823223,1741823223.072877,-18000,,
com.google.Chrome,4,1741823216,1741823220,1741823220.7456012,-18000,,
com.microsoft.Word,3,1741823213,1741823216,1741823216.420267,-18000,,
com.google.Chrome,71,1741823142,1741823213,1741823213.941412,-18000,,
com.microsoft.Word,205,1741822937,1741823142,1741823142.525744,-18000,,
com.google.Chrome,18,1741822919,1741822937,1741822937.7261338,-18000,,
com.microsoft.Word,14,1741822905,1741822919,1741822919.087306,-18000,,
com.google.Chrome,23,1741822882,1741822905,1741822905.105849,-18000,,
com.microsoft.Word,8,1741822874,1741822882,1741822882.171341,-18000,,
com.google.Chrome,6,1741822868,1741822874,1741822874.610054,-18000,,
com.microsoft.Word,18,1741822850,1741822868,1741822868.39533,-18000,,
com.google.Chrome,19,1741822831,1741822850,1741822850.820128,-18000,,
com.microsoft.Word,4,1741822827,1741822831,1741822831.968742,-18000,,
com.google.Chrome,27,1741822800,1741822827,1741822827.533166,-18000,,
com.microsoft.Word,37,1741822763,1741822800,1741822800.2248611,-18000,,
com.google.Chrome,60,1741822703,1741822763,1741822763.9394689,-18000,,
com.microsoft.Word,0,1741822703,1741822703,1741822704.0305882,-18000,,
com.google.Chrome,1,1741822702,1741822703,1741822703.562042,-18000,,
com.microsoft.Word,1,1741822701,1741822702,1741822702.299838,-18000,,
com.google.Chrome,4,1741822697,1741822701,1741822701.78083,-18000,,
com.microsoft.Word,5,1741822692,1741822697,1741822697.672499,-18000,,
com.google.Chrome,3,1741822689,1741822692,1741822692.064261,-18000,,
com.microsoft.Word,6,1741822683,1741822689,1741822689.10165,-18000,,
com.google.Chrome,3,1741822680,1741822683,1741822684.026099,-18000,,
com.microsoft.Word,13,1741822667,1741822680,1741822680.2393332,-18000,,
com.google.Chrome,16,1741822651,1741822667,1741822667.764777,-18000,,
com.microsoft.Word,4,1741822647,1741822651,1741822651.6825871,-18000,,
com.google.Chrome,51,1741822596,1741822647,1741822647.571152,-18000,,
com.microsoft.Word,5,1741822591,1741822596,1741822597.04278,-18000,,
com.google.Chrome,5,1741822586,1741822591,1741822591.9614491,-18000,,
com.microsoft.Word,1,1741822585,1741822586,1741822586.138812,-18000,,
com.google.Chrome,2,1741822583,1741822585,1741822585.1064339,-18000,,
com.microsoft.Word,1,1741822582,1741822583,1741822583.640285,-18000,,
com.google.Chrome,3,1741822579,1741822582,1741822582.122634,-18000,,
com.microsoft.Word,5,1741822574,1741822579,1741822579.862433,-18000,,
com.google.Chrome,2,1741822572,1741822574,1741822574.1364021,-18000,,
com.microsoft.Word,2,1741822570,1741822572,1741822572.492303,-18000,,
com.google.Chrome,1,1741822569,1741822570,1741822570.053966,-18000,,
com.microsoft.Word,1,1741822568,1741822569,1741822569.2728949,-18000,,
com.google.Chrome,10,1741822558,1741822568,1741822568.288227,-18000,,
com.microsoft.Word,5,1741822553,1741822558,1741822558.209149,-18000,,
com.google.Chrome,15,1741822538,1741822553,1741822553.6804628,-18000,,
com.microsoft.Word,2,1741822536,1741822538,1741822538.712415,-18000,,
com.google.Chrome,3,1741822533,1741822536,1741822536.7529778,-18000,,
com.microsoft.Word,9,1741822524,1741822533,1741822533.4876552,-18000,,
com.google.Chrome,2,1741822522,1741822524,1741822524.577759,-18000,,
com.microsoft.Word,119,1741822403,1741822522,1741822523.272944,-18000,,
com.apple.finder,12,1741822391,1741822403,1741822403.717657,-18000,,
com.apple.Preview,4,1741822387,1741822391,1741822391.451583,-18000,,
com.google.Chrome,3,1741822384,1741822387,1741822388.01314,-18000,,
com.leomehlig.today,2,1741822382,1741822384,1741822384.783524,-18000,,
com.instructure.icanvas,55,1741822155,1741822210,1741822210.582969,-18000,EB445137-D7F5-57EC-87DA-1DB460D64046,"iPhone13,2"
com.groupme.iphone-app,9,1741822136,1741822145,1741822145.67852,-18000,EB445137-D7F5-57EC-87DA-1DB460D64046,"iPhone13,2"
com.toyopagroup.picaboo,0,1741822136,1741822136,1741822137.306658,-18000,EB445137-D7F5-57EC-87DA-1DB460D64046,"iPhone13,2"
com.leomehlig.today,308,1741822066,1741822374,1741822374.147938,-18000,,
com.google.Chrome,55,1741822011,1741822066,1741822066.393033,-18000,,
com.apple.Preview,10,1741822001,1741822011,1741822011.3543901,-18000,,
com.google.Chrome,8,1741821993,1741822001,1741822001.96644,-18000,,
com.apple.Preview,6,1741821987,1741821993,1741821993.7225208,-18000,,
com.google.Chrome,4,1741821983,1741821987,1741821987.622313,-18000,,
com.apple.Preview,6,1741821977,1741821983,1741821983.452509,-18000,,
com.google.Chrome,3,1741821974,1741821977,1741821977.648638,-18000,,
com.apple.Preview,17,1741821957,1741821974,1741821974.629214,-18000,,
com.google.Chrome,0,1741821957,1741821957,1741821957.410925,-18000,,
com.apple.Preview,1,1741821956,1741821957,1741821957.1141958,-18000,,
com.apple.finder,1,1741821955,1741821956,1741821956.5558681,-18000,,
com.google.Chrome,2,1741821953,1741821955,1741821955.4036431,-18000,,
com.apple.finder,1,1741821952,1741821953,1741821953.583665,-18000,,
com.apple.Preview,11,1741821941,1741821952,1741821952.870106,-18000,,
com.apple.finder,2,1741821939,1741821941,1741821941.410583,-18000,,
com.apple.Preview,3,1741821936,1741821939,1741821939.900985,-18000,,
com.google.Chrome,49,1741821887,1741821936,1741821936.875953,-18000,,
com.apple.Preview,2,1741821885,1741821887,1741821887.7699761,-18000,,
com.google.Chrome,20,1741821865,1741821885,1741821885.903281,-18000,,
com.apple.Preview,0,1741821865,1741821865,1741821865.944308,-18000,,
com.google.Chrome,92,1741821773,1741821865,1741821865.17099,-18000,,
com.apple.Preview,2,1741821771,1741821773,1741821773.927726,-18000,,
com.toyopagroup.picaboo,94,1741821430,1741821524,1741821524.798222,-18000,EB445137-D7F5-57EC-87DA-1DB460D64046,"iPhone13,2"
com.google.Chrome,466,1741821305,1741821771,1741821772.0097342,-18000,,
com.apple.Preview,5,1741821300,1741821305,1741821305.741281,-18000,,
com.google.Chrome,3,1741821297,1741821300,1741821300.15276,-18000,,
com.apple.Preview,5,1741821292,1741821297,1741821297.9250531,-18000,,
com.apple.finder,0,1741821292,1741821292,1741821292.991416,-18000,,
com.apple.Preview,19,1741821273,1741821292,1741821292.123189,-18000,,
com.apple.finder,1,1741821272,1741821273,1741821273.931124,-18000,,
com.apple.Preview,3,1741821269,1741821272,1741821272.26209,-18000,,
com.google.Chrome,77,1741821192,1741821269,1741821269.292778,-18000,,
com.apple.Preview,9,1741821183,1741821192,1741821192.3897,-18000,,
com.google.Chrome,76,1741821107,1741821183,1741821183.199072,-18000,,
com.apple.Preview,13,1741821094,1741821107,1741821107.0418491,-18000,,
com.google.Chrome,66,1741821028,1741821094,1741821094.774977,-18000,,
com.apple.Preview,4,1741821024,1741821028,1741821028.334309,-18000,,
com.google.Chrome,4,1741821020,1741821024,1741821024.849644,-18000,,
com.apple.Preview,6,1741821014,1741821020,1741821020.6521358,-18000,,
com.google.Chrome,2,1741821012,1741821014,1741821014.1463351,-18000,,
com.apple.Preview,6,1741821006,1741821012,1741821012.9186602,-18000,,
com.google.Chrome,1,1741821005,1741821006,1741821006.3844938,-18000,,
com.apple.Preview,1,1741821004,1741821005,1741821005.5601292,-18000,,
com.google.Chrome,7,1741820997,1741821004,1741821004.760579,-18000,,
com.apple.Preview,3,1741820994,1741820997,1741820997.6594229,-18000,,
com.google.Chrome,1,1741820993,1741820994,1741820994.680416,-18000,,
com.apple.Preview,4,1741820989,1741820993,1741820993.1241221,-18000,,
com.google.Chrome,2,1741820987,1741820989,1741820989.144506,-18000,,
com.apple.Preview,11,1741820976,1741820987,1741820987.9374862,-18000,,
com.google.Chrome,4,1741820972,1741820976,1741820976.757808,-18000,,
com.apple.Preview,10,1741820962,1741820972,1741820972.782652,-18000,,
com.google.Chrome,0,1741820962,1741820962,1741820962.416467,-18000,,
com.apple.Preview,11,1741820951,1741820962,1741820962.173788,-18000,,
com.google.Chrome,15,1741820936,1741820951,1741820951.483187,-18000,,
com.apple.Preview,30,1741820906,1741820936,1741820936.867521,-18000,,
com.google.Chrome,2,1741820904,1741820906,1741820906.832683,-18000,,
com.apple.Preview,9,1741820895,1741820904,1741820904.078501,-18000,,
com.google.Chrome,2,1741820893,1741820895,1741820895.813875,-18000,,
com.apple.Preview,15,1741820878,1741820893,1741820893.780088,-18000,,
com.google.Chrome,2,1741820876,1741820878,1741820878.8932118,-18000,,
com.apple.Preview,29,1741820847,1741820876,1741820876.9787931,-18000,,
com.apple.finder,8,1741820839,1741820847,1741820847.5746322,-18000,,
com.google.Chrome,249,1741820590,1741820839,1741820839.241558,-18000,,
com.apple.Preview,38,1741820552,1741820590,1741820590.577071,-18000,,
com.apple.finder,10,1741820542,1741820552,1741820552.477168,-18000,,
com.google.Chrome,100,1741820442,1741820542,1741820542.258141,-18000,,
com.groupme.iphone-app,11,1741820424,1741820435,1741820436.01035,-18000,EB445137-D7F5-57EC-87DA-1DB460D64046,"iPhone13,2"
com.apple.iCal,5,1741820338,1741820343,1741820343.807047,-18000,,
com.hulu.plus,46,1741819560,1741819606,1741819606.9411159,-18000,EB445137-D7F5-57EC-87DA-1DB460D64046,"iPhone13,2"
com.wbd.stream,14,1741819518,1741819532,1741819532.397496,-18000,EB445137-D7F5-57EC-87DA-1DB460D64046,"iPhone13,2"
com.google.chrome.ios,29,1741819489,1741819518,1741819518.787139,-18000,EB445137-D7F5-57EC-87DA-1DB460D64046,"iPhone13,2"
com.wbd.stream,214,1741819272,1741819486,1741819486.682509,-18000,EB445137-D7F5-57EC-87DA-1DB460D64046,"iPhone13,2"
com.apple.Maps,2,1741819263,1741819265,1741819265.93722,-18000,EB445137-D7F5-57EC-87DA-1DB460D64046,"iPhone13,2"
com.apple.Preferences,62,1741819201,1741819263,1741819263.6510081,-18000,EB445137-D7F5-57EC-87DA-1DB460D64046,"iPhone13,2"
com.apple.news,2,1741819183,1741819185,1741819185.757606,-18000,EB445137-D7F5-57EC-87DA-1DB460D64046,"iPhone13,2"
com.apple.iCal,22,1741819161,1741819183,1741819184.000983,-18000,,
com.google.Chrome,23,1741819138,1741819161,1741819161.1169472,-18000,,
com.leomehlig.today,21,1741819117,1741819138,1741819139.028051,-18000,,
com.microsoft.VSCode,4,1741819113,1741819117,1741819117.772946,-18000,,
com.leomehlig.today,145,1741818968,1741819113,1741819113.169735,-18000,,
com.microsoft.VSCode,1,1741818967,1741818968,1741818968.602254,-18000,,
com.google.Chrome,12,1741818955,1741818967,1741818967.170584,-18000,,
com.microsoft.VSCode,5,1741818950,1741818955,1741818955.9874911,-18000,,
com.google.Chrome,3,1741818947,1741818950,1741818950.1917171,-18000,,
com.microsoft.VSCode,8,1741818939,1741818947,1741818947.235596,-18000,,
com.google.Chrome,2,1741818937,1741818939,1741818939.921404,-18000,,
com.microsoft.VSCode,5,1741818932,1741818937,1741818937.975954,-18000,,
com.google.Chrome,2,1741818930,1741818932,1741818932.678082,-18000,,
com.microsoft.VSCode,32,1741818898,1741818930,1741818930.933281,-18000,,
com.google.Chrome,2,1741818896,1741818898,1741818898.9720058,-18000,,
com.microsoft.VSCode,6,1741818890,1741818896,1741818896.115683,-18000,,
com.google.Chrome,2,1741818888,1741818890,1741818890.240364,-18000,,
com.microsoft.VSCode,0,1741818888,1741818888,1741818888.9622278,-18000,,
com.google.Chrome,13,1741818875,1741818888,1741818888.371276,-18000,,
com.microsoft.VSCode,7,1741818868,1741818875,1741818875.365699,-18000,,
com.google.Chrome,1,1741818867,1741818868,1741818868.4564939,-18000,,
com.microsoft.VSCode,6,1741818861,1741818867,1741818867.396239,-18000,,
com.google.Chrome,2,1741818859,1741818861,1741818861.6752582,-18000,,
com.microsoft.VSCode,8,1741818851,1741818859,1741818860.018917,-18000,,
com.google.Chrome,2,1741818849,1741818851,1741818851.0884042,-18000,,
com.microsoft.VSCode,3,1741818846,1741818849,1741818849.4411268,-18000,,
com.google.Chrome,2,1741818844,1741818846,1741818846.0731091,-18000,,
com.microsoft.VSCode,2,1741818842,1741818844,1741818845.020276,-18000,,
com.google.Chrome,3,1741818839,1741818842,1741818842.179954,-18000,,
com.microsoft.VSCode,29,1741818810,1741818839,1741818839.839167,-18000,,
com.google.Chrome,606,1741818204,1741818810,1741818810.145545,-18000,,
com.apple.finder,3,1741818201,1741818204,1741818204.4004068,-18000,,
com.apple.news,3,1741817955,1741817958,1741817959.197338,-18000,EB445137-D7F5-57EC-87DA-1DB460D64046,"iPhone13,2"
com.apple.weather,2,1741817632,1741817634,1741817634.498347,-18000,EB445137-D7F5-57EC-87DA-1DB460D64046,"iPhone13,2"
com.apple.weather,61,1741817482,1741817543,1741817544.625412,-18000,EB445137-D7F5-57EC-87DA-1DB460D64046,"iPhone13,2"
com.apple.finder,5,1741817253,1741817258,1741817259.065829,-18000,,
com.leomehlig.today,1,1741817252,1741817253,1741817253.665433,-18000,,
com.apple.finder,2,1741817250,1741817252,1741817252.132201,-18000,,
com.microsoft.VSCode,8,1741817242,1741817250,1741817250.886228,-18000,,
com.apple.finder,4,1741817238,1741817242,1741817243.2509332,-18000,,
com.leomehlig.today,50,1741817188,1741817238,1741817238.43653,-18000,,
com.google.Chrome,46,1741817142,1741817188,1741817188.989725,-18000,,
com.leomehlig.today,4,1741817131,1741817135,1741817135.4537702,-18000,,
com.apple.iCal,9,1741817122,1741817131,1741817131.1784592,-18000,,
com.leomehlig.today,40,1741817082,1741817122,1741817122.277278,-18000,,
com.google.Chrome,19,1741817063,1741817082,1741817082.7178311,-18000,,
com.microsoft.VSCode,158,1741816905,1741817063,1741817063.528631,-18000,,
com.apple.finder,89,1741816816,1741816905,1741816905.789819,-18000,,
com.microsoft.VSCode,10,1741816806,1741816816,1741816816.4588041,-18000,,
com.apple.finder,6,1741816800,1741816806,1741816806.269175,-18000,,
com.microsoft.VSCode,107,1741816693,1741816800,1741816800.211024,-18000,,
com.apple.finder,81,1741816612,1741816693,1741816694.042217,-18000,,
com.microsoft.VSCode,5,1741816607,1741816612,1741816612.144483,-18000,,
com.apple.finder,3,1741816604,1741816607,1741816607.986567,-18000,,
com.microsoft.VSCode,7,1741816597,1741816604,1741816604.5139441,-18000,,
com.apple.finder,1,1741816596,1741816597,1741816597.303927,-18000,,
com.google.Chrome,22,1741816574,1741816596,1741816596.135625,-18000,,
com.apple.finder,1,1741816573,1741816574,1741816574.676919,-18000,,
com.microsoft.VSCode,63,1741816510,1741816573,1741816573.8525438,-18000,,
com.apple.finder,18,1741816492,1741816510,1741816510.250797,-18000,,
com.microsoft.VSCode,5,1741816487,1741816492,1741816492.655957,-18000,,
com.apple.finder,4,1741816483,1741816487,1741816487.479152,-18000,,
com.microsoft.VSCode,14,1741816469,1741816483,1741816483.80508,-18000,,
com.google.Chrome,27,1741816442,1741816469,1741816469.097245,-18000,,
com.microsoft.VSCode,18,1741816424,1741816442,1741816443.0349941,-18000,,
com.google.Chrome,3,1741816421,1741816424,1741816424.122076,-18000,,
com.microsoft.VSCode,8,1741816413,1741816421,1741816421.250311,-18000,,
com.google.Chrome,8,1741816405,1741816413,1741816413.45771,-18000,,
com.microsoft.VSCode,5,1741816400,1741816405,1741816405.436198,-18000,,
com.google.Chrome,3,1741816397,1741816400,1741816400.9737868,-18000,,
com.microsoft.VSCode,163,1741816234,1741816397,1741816397.577591,-18000,,
com.apple.finder,24,1741816210,1741816234,1741816234.624817,-18000,,
com.microsoft.VSCode,229,1741815981,1741816210,1741816210.253645,-18000,,
com.apple.finder,68,1741815151,1741815219,1741815220.071313,-18000,,
com.microsoft.VSCode,5,1741815146,1741815151,1741815151.18848,-18000,,
com.apple.finder,3,1741815143,1741815146,1741815146.745769,-18000,,
com.microsoft.VSCode,1118,1741814025,1741815143,1741815143.431179,-18000,,
com.apple.finder,19,1741814006,1741814025,1741814025.87759,-18000,,
com.microsoft.VSCode,35,1741813971,1741814006,1741814006.960182,-18000,,
com.apple.finder,13,1741813958,1741813971,1741813971.982748,-18000,,
com.microsoft.VSCode,1333,1741812625,1741813958,1741813958.512094,-18000,,
com.google.Chrome,8,1741812617,1741812625,1741812625.573557,-18000,,
co.hinge.mobile.ios,287,1741812271,1741812558,1741812558.5218592,-18000,EB445137-D7F5-57EC-87DA-1DB460D64046,"iPhone13,2"
co.hinge.mobile.ios,371,1741811853,1741812224,1741812224.980686,-18000,EB445137-D7F5-57EC-87DA-1DB460D64046,"iPhone13,2"
com.google.Chrome,413,1741811732,1741812145,1741812145.439861,-18000,,
co.hinge.mobile.ios,32,1741811717,1741811749,1741811749.7741299,-18000,EB445137-D7F5-57EC-87DA-1DB460D64046,"iPhone13,2"
com.microsoft.VSCode,26,1741811706,1741811732,1741811732.387755,-18000,,
com.toyopagroup.picaboo,5,1741811532,1741811537,1741811538.068249,-18000,EB445137-D7F5-57EC-87DA-1DB460D64046,"iPhone13,2"
com.toyopagroup.picaboo,6,1741811524,1741811530,1741811530.1723518,-18000,EB445137-D7F5-57EC-87DA-1DB460D64046,"iPhone13,2"
com.apple.weather,1,1741811523,1741811524,1741811524.691248,-18000,EB445137-D7F5-57EC-87DA-1DB460D64046,"iPhone13,2"
com.apple.weather,11,1741810922,1741810933,1741810934.751175,-18000,EB445137-D7F5-57EC-87DA-1DB460D64046,"iPhone13,2"
com.microsoft.VSCode,563,1741809599,1741810162,1741810162.854855,-18000,,
com.leomehlig.today,4,1741809595,1741809599,1741809600.03648,-18000,,
co.hinge.mobile.ios,146,1741808850,1741808996,1741808996.618204,-18000,EB445137-D7F5-57EC-87DA-1DB460D64046,"iPhone13,2"
co.hinge.mobile.ios,40,1741808795,1741808835,1741808835.3241901,-18000,EB445137-D7F5-57EC-87DA-1DB460D64046,"iPhone13,2"
com.toyopagroup.picaboo,12,1741808780,1741808792,1741808792.1656199,-18000,EB445137-D7F5-57EC-87DA-1DB460D64046,"iPhone13,2"
com.google.Gmail,41,1741808738,1741808779,1741808779.7989988,-18000,EB445137-D7F5-57EC-87DA-1DB460D64046,"iPhone13,2"
com.leomehlig.today,29,1741808615,1741808644,1741808644.597959,-18000,,
com.google.Chrome,290,1741808325,1741808615,1741808615.035394,-18000,,
com.leomehlig.today,2,1741808323,1741808325,1741808325.7176409,-18000,,
com.google.Chrome,1966,1741806357,1741808323,1741808323.7089028,-18000,,
com.leomehlig.today,11,1741806346,1741806357,1741806357.6682239,-18000,,
com.google.Chrome,327,1741806019,1741806346,1741806346.432704,-18000,,
com.leomehlig.today,43,1741805976,1741806019,1741806019.4127269,-18000,,
com.google.Chrome,9,1741805967,1741805976,1741805976.472756,-18000,,
com.google.chrome.ios,47,1741805346,1741805393,1741805393.947355,-18000,EB445137-D7F5-57EC-87DA-1DB460D64046,"iPhone13,2"
co.hinge.mobile.ios,83,1741805142,1741805225,1741805226.1429958,-18000,EB445137-D7F5-57EC-87DA-1DB460D64046,"iPhone13,2"
co.hinge.mobile.ios,26,1741805071,1741805097,1741805097.338869,-18000,EB445137-D7F5-57EC-87DA-1DB460D64046,"iPhone13,2"
com.toyopagroup.picaboo,11,1741805047,1741805058,1741805059.043521,-18000,EB445137-D7F5-57EC-87DA-1DB460D64046,"iPhone13,2"
com.google.chrome.ios,2,1741805045,1741805047,1741805048.0569592,-18000,EB445137-D7F5-57EC-87DA-1DB460D64046,"iPhone13,2"
com.google.chrome.ios,36,1741805000,1741805036,1741805037.635919,-18000,EB445137-D7F5-57EC-87DA-1DB460D64046,"iPhone13,2"
com.google.chrome.ios,68,1741804889,1741804957,1741804957.719981,-18000,EB445137-D7F5-57EC-87DA-1DB460D64046,"iPhone13,2"
com.apple.news,2,1741804887,1741804889,1741804889.359828,-18000,EB445137-D7F5-57EC-87DA-1DB460D64046,"iPhone13,2"
com.apple.news,97,1741804594,1741804691,1741804692.575745,-18000,EB445137-D7F5-57EC-87DA-1DB460D64046,"iPhone13,2"
com.github.stormbreaker.prod,138,1741804371,1741804509,1741804509.6494842,-18000,EB445137-D7F5-57EC-87DA-1DB460D64046,"iPhone13,2"
com.apple.news,598,1741803367,1741803965,1741803965.85881,-18000,EB445137-D7F5-57EC-87DA-1DB460D64046,"iPhone13,2"
com.truebill.truebillnative,4,1741803363,1741803367,1741803367.892931,-18000,EB445137-D7F5-57EC-87DA-1DB460D64046,"iPhone13,2"
com.truebill.truebillnative,57,1741802283,1741802340,1741802341.274924,-18000,EB445137-D7F5-57EC-87DA-1DB460D64046,"iPhone13,2"
com.apple.calculator,6,1741802277,1741802283,1741802283.971708,-18000,EB445137-D7F5-57EC-87DA-1DB460D64046,"iPhone13,2"
com.truebill.truebillnative,17,1741802260,1741802277,1741802277.37938,-18000,EB445137-D7F5-57EC-87DA-1DB460D64046,"iPhone13,2"
com.apple.mobilecal,9,1741802251,1741802260,1741802261.0526109,-18000,EB445137-D7F5-57EC-87DA-1DB460D64046,"iPhone13,2"
com.truebill.truebillnative,65,1741802182,1741802247,1741802247.597549,-18000,EB445137-D7F5-57EC-87DA-1DB460D64046,"iPhone13,2"
com.apple.CoreAuthUI,2,1741802161,1741802163,1741802163.887512,-18000,EB445137-D7F5-57EC-87DA-1DB460D64046,"iPhone13,2"
com.clairmail.fth.client,25,1741802157,1741802182,1741802182.794723,-18000,EB445137-D7F5-57EC-87DA-1DB460D64046,"iPhone13,2"
com.apple.CoreAuthUI,7,1741802024,1741802031,1741802031.3839989,-18000,EB445137-D7F5-57EC-87DA-1DB460D64046,"iPhone13,2"
com.truebill.truebillnative,136,1741802019,1741802155,1741802155.9243999,-18000,EB445137-D7F5-57EC-87DA-1DB460D64046,"iPhone13,2"
com.google.Chrome,74,1741801882,1741801956,1741801956.944042,-18000,,
com.apple.finder,2,1741801880,1741801882,1741801882.7237558,-18000,,
com.leomehlig.today,34,1741801846,1741801880,1741801880.365868,-18000,,
com.google.Chrome,4,1741801842,1741801846,1741801846.502742,-18000,,
com.toyopagroup.picaboo,16,1741801810,1741801826,1741801826.336318,-18000,EB445137-D7F5-57EC-87DA-1DB460D64046,"iPhone13,2"
com.google.Chrome,3,1741800839,1741800842,1741800842.089153,-18000,,
com.thestorygraph.thestorygraph,40,1741800559,1741800599,1741800599.091361,-18000,EB445137-D7F5-57EC-87DA-1DB460D64046,"iPhone13,2"
com.apple.news,2,1741800549,1741800551,1741800555.6802301,-18000,EB445137-D7F5-57EC-87DA-1DB460D64046,"iPhone13,2"
com.apple.camera,1,1741800549,1741800550,1741800553.78369,-18000,EB445137-D7F5-57EC-87DA-1DB460D64046,"iPhone13,2"
com.google.Chrome,652,1741800184,1741800836,1741800836.720336,-18000,,
com.apple.news,106,1741797800,1741797906,1741797906.802312,-18000,EB445137-D7F5-57EC-87DA-1DB460D64046,"iPhone13,2"
com.apple.CoreAuthUI,2,1741797786,1741797788,1741797789.239647,-18000,EB445137-D7F5-57EC-87DA-1DB460D64046,"iPhone13,2"
com.robinhood.release.Robinhood,17,1741797783,1741797800,1741797800.8064718,-18000,EB445137-D7F5-57EC-87DA-1DB460D64046,"iPhone13,2"
com.apple.news,35,1741797747,1741797782,1741797782.3370972,-18000,EB445137-D7F5-57EC-87DA-1DB460D64046,"iPhone13,2"
com.groupme.iphone-app,21,1741797014,1741797035,1741797035.6836429,-18000,EB445137-D7F5-57EC-87DA-1DB460D64046,"iPhone13,2"
com.apple.mobilecal,2,1741797012,1741797014,1741797014.089316,-18000,EB445137-D7F5-57EC-87DA-1DB460D64046,"iPhone13,2"
com.apple.mobilecal,11,1741795441,1741795452,1741795453.3794498,-18000,EB445137-D7F5-57EC-87DA-1DB460D64046,"iPhone13,2"
com.apple.news,2,1741795438,1741795440,1741795440.316505,-18000,EB445137-D7F5-57EC-87DA-1DB460D64046,"iPhone13,2"
com.apple.news,187,1741795036,1741795223,1741795225.8090348,-18000,EB445137-D7F5-57EC-87DA-1DB460D64046,"iPhone13,2"
com.apple.Health,20,1741795005,1741795025,1741795025.6681771,-18000,EB445137-D7F5-57EC-87DA-1DB460D64046,"iPhone13,2"
com.apple.Health,36,1741794965,1741795001,1741795001.304754,-18000,EB445137-D7F5-57EC-87DA-1DB460D64046,"iPhone13,2"
com.truebill.truebillnative,0,1741794965,1741794965,1741794966.316709,-18000,EB445137-D7F5-57EC-87DA-1DB460D64046,"iPhone13,2"
com.google.Chrome,284,1741794390,1741794674,1741794674.604217,-18000,,
com.google.Chrome,157,1741793475,1741793632,1741793632.764725,-18000,,
com.apple.CoreAuthUI,2,1741793435,1741793437,1741793437.853798,-18000,EB445137-D7F5-57EC-87DA-1DB460D64046,"iPhone13,2"
com.truebill.truebillnative,109,1741793433,1741793542,1741793543.2228432,-18000,EB445137-D7F5-57EC-87DA-1DB460D64046,"iPhone13,2"
com.apple.Health,31,1741793398,1741793429,1741793429.419976,-18000,EB445137-D7F5-57EC-87DA-1DB460D64046,"iPhone13,2"
com.google.Chrome,1256,1741792002,1741793258,1741793258.9435902,-18000,,
com.microsoft.Office.Outlook,10,1741790804,1741790814,1741790814.90177,-18000,EB445137-D7F5-57EC-87DA-1DB460D64046,"iPhone13,2"
com.apple.weather,2,1741790802,1741790804,1741790804.279965,-18000,EB445137-D7F5-57EC-87DA-1DB460D64046,"iPhone13,2"
com.apple.weather,2,1741790794,1741790796,1741790796.8040528,-18000,EB445137-D7F5-57EC-87DA-1DB460D64046,"iPhone13,2"
com.google.Chrome,687,1741789294,1741789981,1741789981.753127,-18000,,
com.apple.finder,1,1741789281,1741789282,1741789282.457347,-18000,,
com.leomehlig.today,1,1741789280,1741789281,1741789281.270101,-18000,,
com.google.Chrome,16,1741789264,1741789280,1741789280.467754,-18000,,
com.leomehlig.today,26,1741789238,1741789264,1741789264.586271,-18000,,
com.google.Chrome,8,1741789230,1741789238,1741789238.5276709,-18000,,
com.apple.weather,61,1741785912,1741785973,1741785974.0589828,-18000,EB445137-D7F5-57EC-87DA-1DB460D64046,"iPhone13,2"
com.apple.news,2,1741785910,1741785912,1741785912.6946192,-18000,EB445137-D7F5-57EC-87DA-1DB460D64046,"iPhone13,2"
com.apple.news,199,1741785404,1741785603,1741785603.954616,-18000,EB445137-D7F5-57EC-87DA-1DB460D64046,"iPhone13,2"
com.apple.journal,567,1741754380,1741754947,1741754947.6678128,-18000,EB445137-D7F5-57EC-87DA-1DB460D64046,"iPhone13,2"
com.leomehlig.today,23,1741754357,1741754380,1741754380.815521,-18000,EB445137-D7F5-57EC-87DA-1DB460D64046,"iPhone13,2"
com.apple.CoreAuthUI,5,1741753920,1741753925,1741753925.915903,-18000,EB445137-D7F5-57EC-87DA-1DB460D64046,"iPhone13,2"
com.apple.journal,435,1741753919,1741754354,1741754354.615017,-18000,EB445137-D7F5-57EC-87DA-1DB460D64046,"iPhone13,2"
com.apple.CoreAuthUI,1,1741753791,1741753792,1741753792.526032,-18000,EB445137-D7F5-57EC-87DA-1DB460D64046,"iPhone13,2"
com.apple.journal,4,1741753790,1741753794,1741753794.864922,-18000,EB445137-D7F5-57EC-87DA-1DB460D64046,"iPhone13,2"
com.thestorygraph.thestorygraph,1,1741753789,1741753790,1741753790.4866161,-18000,EB445137-D7F5-57EC-87DA-1DB460D64046,"iPhone13,2"
com.google.Chrome,235,1741753531,1741753766,1741753766.055575,-18000,,
com.thestorygraph.thestorygraph,23,1741753346,1741753369,1741753369.960156,-18000,EB445137-D7F5-57EC-87DA-1DB460D64046,"iPhone13,2"
com.groupme.iphone-app,27,1741749760,1741749787,1741749787.846044,-18000,EB445137-D7F5-57EC-87DA-1DB460D64046,"iPhone13,2"
com.groupme.iphone-app,6,1741748637,1741748643,1741748643.439445,-18000,EB445137-D7F5-57EC-87DA-1DB460D64046,"iPhone13,2"
com.apple.Music,0,1741748637,1741748637,1741748638.8516068,-18000,EB445137-D7F5-57EC-87DA-1DB460D64046,"iPhone13,2"
com.google.Chrome,511,1741748154,1741748665,1741748666.2628698,-18000,,
com.leomehlig.today,33,1741748121,1741748154,1741748154.354759,-18000,,
com.google.Chrome,21,1741748100,1741748121,1741748121.869584,-18000,,
com.apple.finder,5,1741748095,1741748100,1741748100.691858,-18000,,
com.leomehlig.today,11,1741748084,1741748095,1741748095.297607,-18000,,
com.apple.finder,24,1741748060,1741748084,1741748084.500901,-18000,,
com.apple.Music,77,1741747262,1741747339,1741747340.10422,-18000,EB445137-D7F5-57EC-87DA-1DB460D64046,"iPhone13,2"
com.apple.Health,30,1741747159,1741747189,1741747189.772616,-18000,EB445137-D7F5-57EC-87DA-1DB460D64046,"iPhone13,2"
com.apple.Music,2,1741747157,1741747159,1741747159.370373,-18000,EB445137-D7F5-57EC-87DA-1DB460D64046,"iPhone13,2"
com.apple.finder,111,1741747143,1741747254,1741747254.209703,-18000,,
com.apple.iCal,2,1741747141,1741747143,1741747143.166244,-18000,,
com.microsoft.onenote.mac,73,1741747068,1741747141,1741747141.21528,-18000,,
com.apple.iCal,3,1741747065,1741747068,1741747068.1556048,-18000,,
com.microsoft.onenote.mac,4,1741747061,1741747065,1741747065.471761,-18000,,
com.apple.finder,4,1741747053,1741747057,1741747057.460267,-18000,,
com.apple.Music,15,1741745231,1741745246,1741745252.0386171,-18000,EB445137-D7F5-57EC-87DA-1DB460D64046,"iPhone13,2"
com.groupme.iphone-app,13,1741745210,1741745223,1741745223.158547,-18000,EB445137-D7F5-57EC-87DA-1DB460D64046,"iPhone13,2"
com.apple.Maps,2,1741745208,1741745210,1741745210.437068,-18000,EB445137-D7F5-57EC-87DA-1DB460D64046,"iPhone13,2"
com.apple.finder,6,1741745040,1741745046,1741745046.771247,-18000,,
com.leomehlig.today,0,1741745040,1741745040,1741745040.818598,-18000,,
com.google.Chrome,14,1741745026,1741745040,1741745040.416616,-18000,,
com.apple.finder,164,1741744862,1741745026,1741745026.572958,-18000,,
com.google.Chrome,42,1741744820,1741744862,1741744862.907711,-18000,,
com.leomehlig.today,8,1741744812,1741744820,1741744820.663344,-18000,,
com.google.Chrome,7,1741744805,1741744812,1741744812.6856298,-18000,,
com.microsoft.VSCode,1,1741744793,1741744794,1741744794.619724,-18000,,
com.google.Chrome,4,1741744789,1741744793,1741744793.281291,-18000,,
com.apple.Terminal,48,1741744741,1741744789,1741744789.703599,-18000,,
com.apple.finder,16,1741744725,1741744741,1741744741.638088,-18000,,
com.apple.archiveutility,0,1741744725,1741744725,1741744725.7235122,-18000,,
com.apple.finder,6,1741744719,1741744725,1741744725.123795,-18000,,
com.apple.Terminal,139,1741744580,1741744719,1741744719.435213,-18000,,
com.google.Chrome,1,1741744579,1741744580,1741744580.2082791,-18000,,
com.apple.Terminal,35,1741744544,1741744579,1741744579.438519,-18000,,
com.google.Chrome,14,1741744530,1741744544,1741744544.403508,-18000,,
com.apple.Terminal,45,1741744485,1741744530,1741744530.671443,-18000,,
com.apple.finder,1,1741744484,1741744485,1741744485.080717,-18000,,
com.google.Chrome,2,1741744482,1741744484,1741744484.383779,-18000,,
com.apple.Terminal,0,1741744482,1741744482,1741744482.7104921,-18000,,
com.apple.Notes,1,1741744481,1741744482,1741744482.264456,-18000,,
com.apple.Terminal,4,1741744477,1741744481,1741744481.923658,-18000,,
com.microsoft.VSCode,333,1741744144,1741744477,1741744477.7321649,-18000,,
com.apple.Notes,16,1741744128,1741744144,1741744145.102828,-18000,,
com.microsoft.VSCode,303,1741743825,1741744128,1741744129.0472279,-18000,,
com.apple.finder,7,1741743818,1741743825,1741743825.781313,-18000,,
com.microsoft.VSCode,5,1741743813,1741743818,1741743818.8853421,-18000,,
com.apple.finder,4,1741743809,1741743813,1741743813.751868,-18000,,
com.microsoft.VSCode,70,1741743739,1741743809,1741743809.651219,-18000,,
com.apple.finder,8,1741743731,1741743739,1741743740.007927,-18000,,
com.microsoft.VSCode,8,1741743723,1741743731,1741743731.344298,-18000,,
com.apple.finder,4,1741743719,1741743723,1741743723.847794,-18000,,
com.microsoft.VSCode,22,1741743697,1741743719,1741743719.465992,-18000,,
com.apple.finder,14,1741743683,1741743697,1741743697.1415849,-18000,,
com.microsoft.VSCode,100,1741743583,1741743683,1741743683.245295,-18000,,
com.google.Chrome,1,1741743582,1741743583,1741743583.6741629,-18000,,
com.microsoft.VSCode,5,1741743577,1741743582,1741743582.101345,-18000,,
com.google.Chrome,1,1741743576,1741743577,1741743577.803186,-18000,,
com.microsoft.VSCode,1,1741743575,1741743576,1741743576.600535,-18000,,
com.google.Chrome,12,1741743563,1741743575,1741743575.459965,-18000,,
com.microsoft.VSCode,45,1741743518,1741743563,1741743564.017645,-18000,,
com.apple.finder,8,1741743510,1741743518,1741743518.666147,-18000,,
com.microsoft.VSCode,68,1741743442,1741743510,1741743510.9236212,-18000,,
com.apple.finder,6,1741743436,1741743442,1741743442.948295,-18000,,
com.microsoft.VSCode,3,1741743433,1741743436,1741743436.398474,-18000,,
com.apple.finder,2,1741743431,1741743433,1741743433.283856,-18000,,
com.microsoft.VSCode,1,1741743430,1741743431,1741743431.690177,-18000,,
com.apple.finder,1,1741743429,1741743430,1741743430.983666,-18000,,
com.microsoft.VSCode,61,1741743368,1741743429,1741743430.016148,-18000,,
com.apple.finder,6,1741743362,1741743368,1741743368.263977,-18000,,
com.microsoft.VSCode,45,1741743317,1741743362,1741743362.9348788,-18000,,
com.apple.finder,2,1741743315,1741743317,1741743317.134881,-18000,,
com.microsoft.VSCode,2,1741743313,1741743315,1741743315.331326,-18000,,
com.apple.finder,1,1741743312,1741743313,1741743313.8097591,-18000,,
com.microsoft.VSCode,5,1741743307,1741743312,1741743312.8400822,-18000,,
com.apple.finder,17,1741743290,1741743307,1741743307.592579,-18000,,
com.microsoft.VSCode,231,1741743059,1741743290,1741743290.5292602,-18000,,
com.google.Chrome,16,1741743043,1741743059,1741743059.726253,-18000,,
com.microsoft.VSCode,17,1741743026,1741743043,1741743043.678045,-18000,,
com.google.Chrome,3,1741743023,1741743026,1741743026.0998502,-18000,,
com.microsoft.VSCode,21,1741743002,1741743023,1741743023.335525,-18000,,
com.google.Chrome,1,1741743001,1741743002,1741743002.6639729,-18000,,
com.microsoft.VSCode,3,1741742998,1741743001,1741743001.162631,-18000,,
com.google.Chrome,2,1741742996,1741742998,1741742998.5560079,-18000,,
com.microsoft.VSCode,4,1741742992,1741742996,1741742996.831336,-18000,,
com.google.Chrome,4,1741742988,1741742992,1741742992.826798,-18000,,
com.microsoft.VSCode,104,1741742884,1741742988,1741742989.040481,-18000,,
com.google.Chrome,9,1741742875,1741742884,1741742884.17415,-18000,,
com.microsoft.VSCode,86,1741742789,1741742875,1741742875.731473,-18000,,
com.google.Chrome,2,1741742787,1741742789,1741742789.745074,-18000,,
com.microsoft.VSCode,1,1741742786,1741742787,1741742787.153795,-18000,,
com.google.Chrome,95,1741742691,1741742786,1741742786.537286,-18000,,
com.microsoft.VSCode,1,1741742690,1741742691,1741742691.705312,-18000,,
com.google.Chrome,114,1741742576,1741742690,1741742690.75822,-18000,,
com.microsoft.VSCode,12,1741742564,1741742576,1741742576.848573,-18000,,
com.google.Chrome,4,1741742560,1741742564,1741742564.6106958,-18000,,
com.microsoft.VSCode,20,1741742540,1741742560,1741742560.943501,-18000,,
com.apple.finder,1,1741742539,1741742540,1741742540.339346,-18000,,
com.google.Chrome,11,1741742528,1741742539,1741742539.135452,-18000,,
com.apple.finder,2,1741742526,1741742528,1741742528.495197,-18000,,
com.microsoft.VSCode,189,1741742337,1741742526,1741742526.8183331,-18000,,
com.apple.finder,2,1741742335,1741742337,1741742337.646916,-18000,,
com.google.Chrome,91,1741742244,1741742335,1741742335.33881,-18000,,
com.apple.finder,3,1741742241,1741742244,1741742244.143633,-18000,,
com.microsoft.VSCode,121,1741742120,1741742241,1741742241.906927,-18000,,
com.google.Chrome,9,1741742111,1741742120,1741742120.918295,-18000,,
com.leomehlig.today,100,1741742011,1741742111,1741742111.053975,-18000,,
com.apple.Notes,23,1741741988,1741742011,1741742011.273169,-18000,,
com.leomehlig.today,34,1741741954,1741741988,1741741988.7430701,-18000,,
com.google.Chrome,2,1741741952,1741741954,1741741954.1066298,-18000,,
com.leomehlig.today,4,1741741948,1741741952,1741741952.5727658,-18000,,
com.google.Chrome,20,1741741928,1741741948,1741741948.32251,-18000,,
com.leomehlig.today,32,1741741884,1741741916,1741741916.83047,-18000,,
com.apple.finder,1,1741741883,1741741884,1741741884.887617,-18000,,
com.google.Chrome,3,1741741880,1741741883,1741741883.6648011,-18000,,
com.leomehlig.today,3,1741741877,1741741880,1741741880.43098,-18000,,
com.hnc.Discord,1,1741741876,1741741877,1741741877.973769,-18000,,
com.leomehlig.today,34,1741741842,1741741876,1741741877.007225,-18000,,
com.hnc.Discord,125,1741741717,1741741842,1741741842.1536422,-18000,,
com.google.Chrome,17,1741741700,1741741717,1741741717.521147,-18000,,
com.hnc.Discord,6,1741741694,1741741700,1741741700.7382278,-18000,,
com.google.Chrome,369,1741741325,1741741694,1741741694.6061869,-18000,,
com.leomehlig.today,3,1741741322,1741741325,1741741325.782435,-18000,,
com.apple.finder,231,1741741091,1741741322,1741741322.459501,-18000,,
com.google.Chrome,457,1741740634,1741741091,1741741091.282753,-18000,,
com.apple.finder,3,1741740631,1741740634,1741740634.9165812,-18000,,
com.google.Chrome,982,1741739649,1741740631,1741740631.28413,-18000,,
com.apple.finder,45,1741739604,1741739649,1741739649.411803,-18000,,
com.google.Chrome,230,1741739374,1741739604,1741739604.8528252,-18000,,
com.apple.finder,28,1741739346,1741739374,1741739374.670487,-18000,,
com.apple.Preview,7,1741739339,1741739346,1741739346.718021,-18000,,
com.google.Chrome,1,1741739338,1741739339,1741739339.1926131,-18000,,
com.apple.Notes,1,1741739337,1741739338,1741739338.474482,-18000,,
com.google.Chrome,1,1741739336,1741739337,1741739337.575729,-18000,,
com.microsoft.Outlook,2,1741739334,1741739336,1741739336.499937,-18000,,
com.google.Chrome,3,1741739331,1741739334,1741739334.52266,-18000,,
com.microsoft.Word,11,1741739320,1741739331,1741739332.18673,-18000,,
com.google.Chrome,25,1741739295,1741739320,1741739320.902029,-18000,,
com.leomehlig.today,52,1741739243,1741739295,1741739295.878329,-18000,,
com.google.Chrome,8,1741739235,1741739243,1741739243.765966,-18000,,
com.leomehlig.today,9,1741739226,1741739235,1741739235.244128,-18000,,
com.google.Chrome,26,1741739200,1741739226,1741739227.033821,-18000,,
com.microsoft.Word,77,1741739098,1741739175,1741739175.7909842,-18000,,
com.google.Chrome,43,1741739055,1741739098,1741739098.7581758,-18000,,
com.microsoft.Word,35,1741739020,1741739055,1741739055.990309,-18000,,
com.google.Chrome,216,1741738804,1741739020,1741739020.78738,-18000,,
com.microsoft.Word,184,1741738620,1741738804,1741738804.584077,-18000,,
com.google.Chrome,62,1741738558,1741738620,1741738620.5468168,-18000,,
com.microsoft.Word,369,1741738189,1741738558,1741738558.712638,-18000,,
com.apple.Preview,31,1741738158,1741738189,1741738190.020383,-18000,,
com.microsoft.Word,54,1741738104,1741738158,1741738158.9123821,-18000,,
com.apple.Preview,87,1741738017,1741738104,1741738104.3402948,-18000,,
com.microsoft.Word,56,1741737961,1741738017,1741738017.515759,-18000,,
com.apple.Preview,10,1741737951,1741737961,1741737961.381392,-18000,,
com.microsoft.Word,925,1741737026,1741737951,1741737951.177788,-18000,,
com.leomehlig.today,2,1741737024,1741737026,1741737026.257623,-18000,,
com.google.Chrome,2,1741737022,1741737024,1741737024.767153,-18000,,
com.leomehlig.today,4,1741737018,1741737022,1741737022.668917,-18000,,
com.microsoft.Word,37,1741736981,1741737018,1741737018.1991239,-18000,,
com.google.Chrome,2,1741736979,1741736981,1741736982.002811,-18000,,
com.microsoft.Word,2,1741736977,1741736979,1741736979.66579,-18000,,
com.google.Chrome,2,1741736975,1741736977,1741736977.446103,-18000,,
com.microsoft.Word,16,1741736959,1741736975,1741736975.744347,-18000,,
com.google.Chrome,2,1741736957,1741736959,1741736959.954278,-18000,,
com.microsoft.Word,17,1741736940,1741736957,1741736957.573903,-18000,,
com.google.Chrome,2,1741736938,1741736940,1741736940.669932,-18000,,
com.microsoft.Word,17,1741736921,1741736938,1741736938.236253,-18000,,
com.google.Chrome,1,1741736920,1741736921,1741736921.415587,-18000,,
com.microsoft.Word,10,1741736910,1741736920,1741736920.05931,-18000,,
com.google.Chrome,2,1741736908,1741736910,1741736910.6288729,-18000,,
com.microsoft.Word,7,1741736901,1741736908,1741736909.041084,-18000,,
com.google.Chrome,2,1741736899,1741736901,1741736901.431452,-18000,,
com.microsoft.Word,3,1741736896,1741736899,1741736899.985764,-18000,,
com.google.Chrome,9,1741736887,1741736896,1741736896.7499251,-18000,,
com.microsoft.Word,10,1741736877,1741736887,1741736887.925396,-18000,,
com.google.Chrome,1,1741736876,1741736877,1741736877.7933722,-18000,,
com.microsoft.Word,7,1741736869,1741736876,1741736876.9648,-18000,,
com.google.Chrome,15,1741736854,1741736869,1741736869.907876,-18000,,
com.microsoft.Word,227,1741736627,1741736854,1741736854.324751,-18000,,
com.google.Chrome,6,1741736621,1741736627,1741736627.483696,-18000,,
com.microsoft.Word,7,1741736614,1741736621,1741736621.498045,-18000,,
com.google.Chrome,49,1741736565,1741736614,1741736614.9019132,-18000,,
com.microsoft.Word,636,1741735929,1741736565,1741736565.577746,-18000,,
com.google.Chrome,43,1741735886,1741735929,1741735929.524662,-18000,,
com.microsoft.Word,312,1741735574,1741735886,1741735886.52274,-18000,,
com.apple.Preview,13,1741735561,1741735574,1741735575.01993,-18000,,
com.microsoft.Word,249,1741735312,1741735561,1741735561.073828,-18000,,
com.apple.Preview,42,1741735270,1741735312,1741735312.72019,-18000,,
com.apple.finder,3,1741735267,1741735270,1741735270.70406,-18000,,
com.microsoft.Word,96,1741735171,1741735267,1741735267.164985,-18000,,
com.apple.finder,9,1741735162,1741735171,1741735171.720202,-18000,,
com.microsoft.Word,96,1741735066,1741735162,1741735162.897588,-18000,,
com.apple.finder,2,1741735064,1741735066,1741735066.088595,-18000,,
com.apple.Preview,3,1741735061,1741735064,1741735064.174687,-18000,,
com.apple.finder,1,1741735060,1741735061,1741735061.748028,-18000,,
com.apple.Preview,3,1741735057,1741735060,1741735060.577322,-18000,,
com.apple.finder,0,1741735057,1741735057,1741735057.996052,-18000,,
com.microsoft.Word,8,1741735049,1741735057,1741735057.1716309,-18000,,
com.apple.finder,19,1741735030,1741735049,1741735049.894925,-18000,,
com.leomehlig.today,8,1741735022,1741735030,1741735030.435838,-18000,,
com.apple.finder,4,1741735018,1741735022,1741735022.322876,-18000,,
com.leomehlig.today,6,1741735012,1741735018,1741735018.520019,-18000,,
com.cisco.secureclient.gui,3,1741735009,1741735012,1741735012.255238,-18000,,
com.leomehlig.today,6,1741735003,1741735009,1741735009.337893,-18000,,
com.apple.Maps,8,1741734223,1741734231,1741734231.552726,-18000,EB445137-D7F5-57EC-87DA-1DB460D64046,"iPhone13,2"
com.apple.Maps,112,1741733992,1741734104,1741734105.057681,-18000,EB445137-D7F5-57EC-87DA-1DB460D64046,"iPhone13,2"
com.apple.MobileSMS,80,1741733912,1741733992,1741733993.435102,-18000,EB445137-D7F5-57EC-87DA-1DB460D64046,"iPhone13,2"
com.apple.Maps,42,1741733870,1741733912,1741733912.372057,-18000,EB445137-D7F5-57EC-87DA-1DB460D64046,"iPhone13,2"
com.apple.Music,3,1741733858,1741733861,1741733861.661648,-18000,EB445137-D7F5-57EC-87DA-1DB460D64046,"iPhone13,2"
com.apple.Music,26,1741733693,1741733719,1741733720.072633,-18000,EB445137-D7F5-57EC-87DA-1DB460D64046,"iPhone13,2"
com.apple.MobileSMS,21,1741733662,1741733683,1741733683.108408,-18000,EB445137-D7F5-57EC-87DA-1DB460D64046,"iPhone13,2"
com.apple.MobileSMS,55,1741733538,1741733593,1741733593.608729,-18000,EB445137-D7F5-57EC-87DA-1DB460D64046,"iPhone13,2"
com.apple.findmy,4,1741733534,1741733538,1741733538.455894,-18000,EB445137-D7F5-57EC-87DA-1DB460D64046,"iPhone13,2"
com.apple.MobileSMS,2,1741733532,1741733534,1741733534.561224,-18000,EB445137-D7F5-57EC-87DA-1DB460D64046,"iPhone13,2"
com.apple.findmy,6,1741733526,1741733532,1741733532.5263228,-18000,EB445137-D7F5-57EC-87DA-1DB460D64046,"iPhone13,2"
com.apple.MobileSMS,32,1741733493,1741733525,1741733525.467722,-18000,EB445137-D7F5-57EC-87DA-1DB460D64046,"iPhone13,2"
com.apple.MobileSMS,11,1741733343,1741733354,1741733354.996739,-18000,EB445137-D7F5-57EC-87DA-1DB460D64046,"iPhone13,2"
com.apple.weather,1,1741733342,1741733343,1741733343.449276,-18000,EB445137-D7F5-57EC-87DA-1DB460D64046,"iPhone13,2"
com.apple.weather,14,1741733062,1741733076,1741733077.009588,-18000,EB445137-D7F5-57EC-87DA-1DB460D64046,"iPhone13,2"
com.leomehlig.today,34,1741731754,1741731788,1741731789.041589,-18000,,
com.google.Chrome,138,1741731616,1741731754,1741731754.9727411,-18000,,
com.google.Chrome,302,1741731145,1741731447,1741731447.629414,-18000,,
com.google.Chrome,329,1741730657,1741730986,1741730986.270258,-18000,,
com.leomehlig.today,34,1741730369,1741730403,1741730403.8350081,-18000,,
com.apple.Preview,3,1741730366,1741730369,1741730369.7846851,-18000,,
com.leomehlig.today,37,1741730329,1741730366,1741730366.357405,-18000,,
com.google.Chrome,22,1741730307,1741730329,1741730329.216985,-18000,,
com.leomehlig.today,89,1741730218,1741730307,1741730307.3184428,-18000,,
com.google.Chrome,4,1741730214,1741730218,1741730218.967905,-18000,,
com.google.Chrome,276,1741728583,1741728859,1741728859.394156,-18000,,
com.apple.Preview,17,1741728566,1741728583,1741728583.449631,-18000,,
com.apple.finder,2,1741728564,1741728566,1741728566.2915468,-18000,,
com.apple.Preview,3,1741728561,1741728564,1741728564.291194,-18000,,
com.apple.finder,2,1741728559,1741728561,1741728561.8353739,-18000,,
com.google.Chrome,459,1741728100,1741728559,1741728559.116047,-18000,,
com.apple.finder,40,1741728060,1741728100,1741728100.2460089,-18000,,
com.google.Chrome,2082,1741725978,1741728060,1741728060.827419,-18000,,
com.apple.Preview,1,1741725977,1741725978,1741725983.387782,-18000,,
com.apple.Preview,420,1741722007,1741722427,1741722427.506607,-18000,,
com.apple.finder,10,1741721997,1741722007,1741722007.512996,-18000,,
com.google.Chrome,9,1741721988,1741721997,1741721997.680225,-18000,,
com.google.Chrome,365,1741721023,1741721388,1741721388.13641,-18000,,
com.apple.MobileSMS,44,1741720839,1741720883,1741720883.729254,-18000,EB445137-D7F5-57EC-87DA-1DB460D64046,"iPhone13,2"
com.google.chrome.ios,68,1741720771,1741720839,1741720839.3862128,-18000,EB445137-D7F5-57EC-87DA-1DB460D64046,"iPhone13,2"
com.apple.MobileSMS,105,1741720666,1741720771,1741720771.214915,-18000,EB445137-D7F5-57EC-87DA-1DB460D64046,"iPhone13,2"
com.apple.MobileSMS,7,1741719502,1741719509,1741719509.8999162,-18000,EB445137-D7F5-57EC-87DA-1DB460D64046,"iPhone13,2"
com.apple.MobileSMS,86,1741719312,1741719398,1741719398.0794501,-18000,EB445137-D7F5-57EC-87DA-1DB460D64046,"iPhone13,2"
com.apple.MobileSMS,1,1741719307,1741719308,1741719308.345279,-18000,EB445137-D7F5-57EC-87DA-1DB460D64046,"iPhone13,2"
com.apple.MobileSMS,66,1741719226,1741719292,1741719292.259046,-18000,EB445137-D7F5-57EC-87DA-1DB460D64046,"iPhone13,2"
com.apple.MobileSMS,1,1741719160,1741719161,1741719162.023068,-18000,EB445137-D7F5-57EC-87DA-1DB460D64046,"iPhone13,2"
com.apple.MobileSMS,29,1741719097,1741719126,1741719126.307749,-18000,EB445137-D7F5-57EC-87DA-1DB460D64046,"iPhone13,2"
com.apple.Health,17,1741718329,1741718346,1741718346.585566,-18000,EB445137-D7F5-57EC-87DA-1DB460D64046,"iPhone13,2"
com.apple.MobileSMS,166,1741718161,1741718327,1741718327.2735229,-18000,EB445137-D7F5-57EC-87DA-1DB460D64046,"iPhone13,2"
com.google.chrome.ios,31,1741718130,1741718161,1741718161.475497,-18000,EB445137-D7F5-57EC-87DA-1DB460D64046,"iPhone13,2"
com.apple.MobileSMS,27,1741718103,1741718130,1741718130.285873,-18000,EB445137-D7F5-57EC-87DA-1DB460D64046,"iPhone13,2"
com.apple.MobileSMS,10,1741717911,1741717921,1741717921.4586182,-18000,EB445137-D7F5-57EC-87DA-1DB460D64046,"iPhone13,2"
com.microsoft.Office.Outlook,14,1741717884,1741717898,1741717898.356996,-18000,EB445137-D7F5-57EC-87DA-1DB460D64046,"iPhone13,2"
com.apple.MobileSMS,144,1741717739,1741717883,1741717883.204673,-18000,EB445137-D7F5-57EC-87DA-1DB460D64046,"iPhone13,2"
com.apple.MobileSMS,82,1741717648,1741717730,1741717730.477991,-18000,EB445137-D7F5-57EC-87DA-1DB460D64046,"iPhone13,2"
com.apple.MobileSMS,11,1741717613,1741717624,1741717624.701377,-18000,EB445137-D7F5-57EC-87DA-1DB460D64046,"iPhone13,2"
com.microsoft.Office.Outlook,35,1741717578,1741717613,1741717613.3026881,-18000,EB445137-D7F5-57EC-87DA-1DB460D64046,"iPhone13,2"
com.instructure.icanvas,7,1741717568,1741717575,1741717575.997837,-18000,EB445137-D7F5-57EC-87DA-1DB460D64046,"iPhone13,2"
com.apple.MobileSMS,375,1741717188,1741717563,1741717563.165159,-18000,EB445137-D7F5-57EC-87DA-1DB460D64046,"iPhone13,2"
com.google.Chrome,327,1741717116,1741717443,1741717443.269825,-18000,,
com.letterboxd.LetterboxdApp,164,1741717021,1741717185,1741717185.269784,-18000,EB445137-D7F5-57EC-87DA-1DB460D64046,"iPhone13,2"
com.duosecurity.DuoMobile,1,1741717017,1741717018,1741717018.731412,-18000,EB445137-D7F5-57EC-87DA-1DB460D64046,"iPhone13,2"
com.apple.finder,129,1741716987,1741717116,1741717117.0301008,-18000,,
com.microsoft.VSCode,107,1741716880,1741716987,1741716988.2392612,-18000,,
com.apple.finder,19,1741716861,1741716880,1741716880.494413,-18000,,
com.apple.Terminal,354,1741716507,1741716861,1741716861.093312,-18000,,
com.apple.finder,2,1741716505,1741716507,1741716507.174487,-18000,,
com.apple.Terminal,101,1741716404,1741716505,1741716505.070832,-18000,,
com.microsoft.VSCode,2,1741716402,1741716404,1741716404.71321,-18000,,
com.apple.Passwords,2,1741716400,1741716402,1741716402.466696,-18000,,
com.duosecurity.DuoMobile,61,1741716393,1741716454,1741716455.0624518,-18000,EB445137-D7F5-57EC-87DA-1DB460D64046,"iPhone13,2"
com.cisco.secureclient.gui,29,1741716371,1741716400,1741716400.475875,-18000,,
com.apple.Passwords,2,1741716369,1741716371,1741716371.113254,-18000,,
com.cisco.secureclient.gui,2,1741716367,1741716369,1741716369.203699,-18000,,
com.apple.Passwords,4,1741716363,1741716367,1741716367.419164,-18000,,
com.cisco.secureclient.gui,3,1741716360,1741716363,1741716363.967704,-18000,,
com.apple.Passwords,2,1741716358,1741716360,1741716360.7645211,-18000,,
com.cisco.secureclient.gui,7,1741716351,1741716358,1741716358.2367148,-18000,,
com.apple.Passwords,8,1741716343,1741716351,1741716351.78239,-18000,,
com.cisco.secureclient.gui,1,1741716342,1741716343,1741716343.514409,-18000,,
com.microsoft.VSCode,3,1741716318,1741716321,1741716322.008165,-18000,,
com.cisco.secureclient.gui,2,1741716316,1741716318,1741716318.15872,-18000,,
com.apple.finder,63,1741716253,1741716316,1741716316.370184,-18000,,
com.apple.finder,301,1741715339,1741715640,1741715640.934787,-18000,,
com.microsoft.VSCode,18,1741715321,1741715339,1741715339.072875,-18000,,
com.apple.finder,63,1741715258,1741715321,1741715321.346973,-18000,,
com.microsoft.VSCode,79,1741715179,1741715258,1741715258.7827148,-18000,,
com.leomehlig.today,27,1741715152,1741715179,1741715179.26903,-18000,,
com.google.Chrome,58,1741715094,1741715152,1741715152.5289068,-18000,,
com.leomehlig.today,36,1741715058,1741715094,1741715094.353719,-18000,,
com.google.Chrome,10,1741715048,1741715058,1741715058.573899,-18000,,
com.apple.finder,15,1741715016,1741715031,1741715031.806185,-18000,,
com.microsoft.VSCode,24,1741714992,1741715016,1741715016.332144,-18000,,
com.apple.finder,81,1741714911,1741714992,1741714992.934727,-18000,,
com.microsoft.VSCode,3,1741714908,1741714911,1741714911.818192,-18000,,
com.apple.finder,4,1741714904,1741714908,1741714908.760401,-18000,,
com.microsoft.VSCode,8,1741714896,1741714904,1741714904.581903,-18000,,
com.apple.finder,15,1741714881,1741714896,1741714896.97176,-18000,,
com.microsoft.VSCode,15,1741714866,1741714881,1741714882.00766,-18000,,
com.apple.finder,19,1741714847,1741714866,1741714866.701966,-18000,,
com.microsoft.VSCode,6,1741714841,1741714847,1741714847.214097,-18000,,
com.apple.finder,49,1741714792,1741714841,1741714841.464622,-18000,,
com.microsoft.VSCode,463,1741714329,1741714792,1741714792.812437,-18000,,
com.apple.finder,27,1741714302,1741714329,1741714329.308738,-18000,,
com.google.Chrome,2,1741714300,1741714302,1741714302.350775,-18000,,
com.microsoft.VSCode,162,1741714138,1741714300,1741714301.038638,-18000,,
com.google.Chrome,3,1741714135,1741714138,1741714138.7601829,-18000,,
com.microsoft.VSCode,31,1741714104,1741714135,1741714135.1667051,-18000,,
com.google.Chrome,17,1741714087,1741714104,1741714104.392778,-18000,,
com.microsoft.VSCode,2,1741714085,1741714087,1741714087.487366,-18000,,
com.apple.finder,3,1741714082,1741714085,1741714085.227058,-18000,,
com.microsoft.VSCode,7,1741714075,1741714082,1741714082.63024,-18000,,
com.apple.finder,30,1741714045,1741714075,1741714075.545574,-18000,,
com.microsoft.VSCode,48,1741713997,1741714045,1741714045.1804318,-18000,,
com.google.Chrome,19,1741713978,1741713997,1741713997.6777,-18000,,
com.microsoft.VSCode,17,1741713961,1741713978,1741713978.914309,-18000,,
com.google.Chrome,13,1741713948,1741713961,1741713961.421255,-18000,,
com.microsoft.VSCode,26,1741713922,1741713948,1741713949.080202,-18000,,
com.apple.finder,41,1741713881,1741713922,1741713922.937154,-18000,,
com.microsoft.VSCode,17,1741713864,1741713881,1741713881.824254,-18000,,
com.apple.finder,30,1741713834,1741713864,1741713864.3273082,-18000,,
com.apple.Preview,18,1741713816,1741713834,1741713834.4572291,-18000,,
com.apple.finder,5,1741713811,1741713816,1741713816.3762732,-18000,,
com.apple.Preview,1,1741713810,1741713811,1741713811.4643888,-18000,,
com.apple.finder,13,1741713797,1741713810,1741713810.519867,-18000,,
com.microsoft.VSCode,288,1741713509,1741713797,1741713797.902011,-18000,,
com.apple.finder,106,1741713403,1741713509,1741713509.246128,-18000,,
com.microsoft.VSCode,5,1741713398,1741713403,1741713403.5141191,-18000,,
com.apple.finder,4,1741713394,1741713398,1741713398.1018062,-18000,,
com.microsoft.VSCode,405,1741712989,1741713394,1741713394.435474,-18000,,
com.apple.finder,4,1741712985,1741712989,1741712989.307603,-18000,,
com.microsoft.VSCode,121,1741712864,1741712985,1741712985.2509918,-18000,,
com.apple.finder,30,1741712834,1741712864,1741712864.5578299,-18000,,
com.microsoft.VSCode,6,1741712828,1741712834,1741712835.004714,-18000,,
com.apple.finder,10,1741712818,1741712828,1741712829.0232692,-18000,,
com.microsoft.VSCode,48,1741712770,1741712818,1741712818.294126,-18000,,
com.google.Chrome,0,1741712770,1741712770,1741712770.83387,-18000,,
com.microsoft.VSCode,4,1741712766,1741712770,1741712770.078349,-18000,,
com.google.Chrome,2,1741712764,1741712766,1741712766.1137362,-18000,,
com.microsoft.VSCode,1,1741712763,1741712764,1741712764.7712932,-18000,,
com.google.Chrome,63,1741712700,1741712763,1741712763.315479,-18000,,
com.microsoft.VSCode,235,1741712465,1741712700,1741712700.314268,-18000,,
com.apple.finder,15,1741712450,1741712465,1741712465.851888,-18000,,
com.apple.Preview,15,1741712435,1741712450,1741712450.130069,-18000,,
com.apple.finder,1,1741712434,1741712435,1741712435.887691,-18000,,
com.apple.Preview,1,1741712433,1741712434,1741712434.098898,-18000,,
com.apple.finder,38,1741712395,1741712433,1741712433.139261,-18000,,
com.microsoft.VSCode,11,1741712384,1741712395,1741712395.1997452,-18000,,
com.apple.finder,5,1741712379,1741712384,1741712384.156101,-18000,,
com.microsoft.VSCode,84,1741712295,1741712379,1741712379.85928,-18000,,
com.apple.finder,17,1741712278,1741712295,1741712296.023041,-18000,,
com.microsoft.VSCode,4,1741712274,1741712278,1741712278.9987721,-18000,,
com.apple.finder,3,1741712271,1741712274,1741712274.578762,-18000,,
com.microsoft.VSCode,135,1741712136,1741712271,1741712271.517659,-18000,,
com.apple.finder,9,1741712127,1741712136,1741712136.467153,-18000,,
com.microsoft.VSCode,33,1741712094,1741712127,1741712127.589577,-18000,,
com.apple.finder,15,1741712079,1741712094,1741712094.229195,-18000,,
com.microsoft.VSCode,3,1741712076,1741712079,1741712080.003259,-18000,,
com.apple.finder,3,1741712073,1741712076,1741712076.898282,-18000,,
com.microsoft.VSCode,141,1741711932,1741712073,1741712073.292021,-18000,,
com.apple.finder,21,1741711911,1741711932,1741711932.874521,-18000,,
com.microsoft.VSCode,2,1741711909,1741711911,1741711911.757056,-18000,,
com.apple.finder,17,1741711892,1741711909,1741711909.9554172,-18000,,
com.microsoft.VSCode,36,1741711856,1741711892,1741711892.6230202,-18000,,
com.apple.finder,10,1741711846,1741711856,1741711856.920481,-18000,,
com.microsoft.VSCode,4,1741711842,1741711846,1741711846.068893,-18000,,
com.apple.finder,10,1741711832,1741711842,1741711842.83075,-18000,,
com.microsoft.VSCode,528,1741711304,1741711832,1741711832.786577,-18000,,
com.apple.finder,227,1741711077,1741711304,1741711304.705947,-18000,,
com.microsoft.VSCode,39,1741711038,1741711077,1741711077.451174,-18000,,
com.apple.finder,9,1741711029,1741711038,1741711038.891562,-18000,,
com.microsoft.VSCode,120,1741710909,1741711029,1741711029.876865,-18000,,
com.apple.Dictionary,2,1741710907,1741710909,1741710909.132842,-18000,,
com.microsoft.VSCode,382,1741710525,1741710907,1741710907.448677,-18000,,
com.google.Chrome,1538,1741708987,1741710525,1741710525.639466,-18000,,
com.leomehlig.today,2,1741708985,1741708987,1741708987.392747,-18000,,
com.leomehlig.today,325,1741708321,1741708646,1741708646.875469,-18000,,
com.microsoft.VSCode,222,1741708099,1741708321,1741708321.58815,-18000,,
com.google.ios.youtube,799,1741707271,1741708070,1741708070.572297,-18000,EB445137-D7F5-57EC-87DA-1DB460D64046,"iPhone13,2"
com.google.ios.youtube,7,1741707262,1741707269,1741707269.622261,-18000,EB445137-D7F5-57EC-87DA-1DB460D64046,"iPhone13,2"
com.microsoft.Office.Outlook,2,1741707255,1741707257,1741707257.3665938,-18000,EB445137-D7F5-57EC-87DA-1DB460D64046,"iPhone13,2"
com.microsoft.VSCode,443,1741707084,1741707527,1741707527.70696,-18000,,
com.google.Chrome,108,1741706976,1741707084,1741707084.232125,-18000,,
com.microsoft.VSCode,9,1741706967,1741706976,1741706976.724434,-18000,,
com.apple.finder,138,1741706829,1741706967,1741706967.660101,-18000,,
com.microsoft.VSCode,88,1741706741,1741706829,1741706829.8666692,-18000,,
com.apple.finder,13,1741706728,1741706741,1741706741.38815,-18000,,
com.microsoft.VSCode,19,1741706709,1741706728,1741706728.575228,-18000,,
com.apple.finder,29,1741706680,1741706709,1741706709.85046,-18000,,
com.microsoft.VSCode,8,1741706672,1741706680,1741706680.7460341,-18000,,
com.apple.finder,79,1741706593,1741706672,1741706672.27952,-18000,,
com.microsoft.VSCode,231,1741706362,1741706593,1741706593.380722,-18000,,
com.apple.finder,12,1741706350,1741706362,1741706362.616595,-18000,,
com.microsoft.VSCode,1,1741706349,1741706350,1741706350.990566,-18000,,
com.google.Chrome,1,1741706348,1741706349,1741706349.833375,-18000,,
com.microsoft.VSCode,22,1741706326,1741706348,1741706348.6728559,-18000,,
com.google.Chrome,41,1741706285,1741706326,1741706327.057908,-18000,,
com.microsoft.VSCode,29,1741706256,1741706285,1741706285.765717,-18000,,
com.apple.finder,5,1741706251,1741706256,1741706256.490367,-18000,,
com.microsoft.VSCode,159,1741706092,1741706251,1741706251.84655,-18000,,
com.apple.finder,67,1741706025,1741706092,1741706092.5849462,-18000,,
com.microsoft.VSCode,103,1741705922,1741706025,1741706025.0815659,-18000,,
com.google.Chrome,36,1741705886,1741705922,1741705922.851037,-18000,,
com.microsoft.VSCode,12,1741705874,1741705886,1741705886.26272,-18000,,
com.google.Chrome,29,1741705845,1741705874,1741705874.750608,-18000,,
com.microsoft.VSCode,5,1741705840,1741705845,1741705845.9421601,-18000,,
com.apple.finder,78,1741705762,1741705840,1741705840.930651,-18000,,
com.microsoft.VSCode,553,1741705209,1741705762,1741705762.0541139,-18000,,
com.apple.finder,31,1741705178,1741705209,1741705209.127668,-18000,,
com.google.Chrome,97,1741705081,1741705178,1741705178.438767,-18000,,
com.apple.Preview,12,1741705069,1741705081,1741705081.353459,-18000,,
com.apple.finder,2,1741705067,1741705069,1741705069.6823869,-18000,,
com.google.Chrome,10,1741705057,1741705067,1741705067.880708,-18000,,
com.apple.finder,1,1741705056,1741705057,1741705057.421332,-18000,,
com.apple.Preview,8,1741705048,1741705056,1741705056.3690119,-18000,,
com.apple.finder,2,1741705046,1741705048,1741705048.2251148,-18000,,
com.google.Chrome,243,1741704803,1741705046,1741705046.198825,-18000,,
com.apple.Preview,112,1741704676,1741704788,1741704788.833462,-18000,,
com.google.Chrome,33,1741704643,1741704676,1741704676.4416962,-18000,,
com.apple.Preview,12,1741704631,1741704643,1741704643.717472,-18000,,
com.google.Chrome,1,1741704630,1741704631,1741704631.044526,-18000,,
com.apple.Preview,8,1741704622,1741704630,1741704630.3696,-18000,,
com.google.Chrome,3,1741704619,1741704622,1741704622.547657,-18000,,
com.apple.Preview,6,1741704613,1741704619,1741704619.883689,-18000,,
com.google.Chrome,7,1741704606,1741704613,1741704613.617002,-18000,,
com.apple.Preview,12,1741704594,1741704606,1741704606.773489,-18000,,
com.google.Chrome,11,1741704583,1741704594,1741704594.7736301,-18000,,
com.apple.Preview,40,1741704543,1741704583,1741704584.080854,-18000,,
com.google.Chrome,28,1741704515,1741704543,1741704543.997014,-18000,,
com.apple.Preview,56,1741704459,1741704515,1741704515.2363338,-18000,,
com.google.Chrome,1,1741704458,1741704459,1741704459.586643,-18000,,
com.apple.Preview,1,1741704457,1741704458,1741704459.0512872,-18000,,
com.google.Chrome,20,1741704437,1741704457,1741704457.271319,-18000,,
com.apple.Preview,24,1741704413,1741704437,1741704437.6793299,-18000,,
com.google.Chrome,8,1741704405,1741704413,1741704413.559243,-18000,,
com.apple.Preview,52,1741704353,1741704405,1741704405.9025722,-18000,,
com.google.Chrome,8,1741704345,1741704353,1741704353.062038,-18000,,
com.apple.Preview,1,1741704344,1741704345,1741704345.589758,-18000,,
com.google.Chrome,16,1741704328,1741704344,1741704344.289772,-18000,,
com.apple.Preview,126,1741704202,1741704328,1741704328.207549,-18000,,
com.google.Chrome,5,1741704197,1741704202,1741704202.626916,-18000,,
com.apple.Preview,108,1741704089,1741704197,1741704197.7740068,-18000,,
com.google.Chrome,24,1741704065,1741704089,1741704089.895121,-18000,,
com.apple.Preview,2,1741704063,1741704065,1741704065.374201,-18000,,
com.google.Chrome,31,1741704032,1741704063,1741704063.155221,-18000,,
com.apple.Preview,59,1741703973,1741704032,1741704032.796719,-18000,,
com.apple.finder,3,1741703970,1741703973,1741703973.4058208,-18000,,
com.microsoft.Outlook,425,1741703545,1741703970,1741703970.209569,-18000,,
com.apple.finder,3,1741703542,1741703545,1741703546.044666,-18000,,
com.microsoft.Office.Outlook,16,1741702690,1741702706,1741702707.030344,-18000,EB445137-D7F5-57EC-87DA-1DB460D64046,"iPhone13,2"
com.renpho.health,36,1741700985,1741701021,1741701021.742117,-18000,EB445137-D7F5-57EC-87DA-1DB460D64046,"iPhone13,2"
com.apple.finder,4,1741670141,1741670145,1741670145.153346,-18000,,
com.google.Chrome,37,1741670104,1741670141,1741670142.015043,-18000,,
com.google.Chrome,300,1741669554,1741669854,1741669854.898869,-18000,,
com.google.Chrome,525,1741668949,1741669474,1741669474.953609,-18000,,
com.google.Chrome,388,1741668493,1741668881,1741668881.79454,-18000,,
com.google.Chrome,1651,1741666257,1741667908,1741667908.6265311,-18000,,
com.apple.Music,2,1741666204,1741666206,1741666206.2146668,-18000,EB445137-D7F5-57EC-87DA-1DB460D64046,"iPhone13,2"
com.google.Chrome,992,1741663661,1741664653,1741664653.4455662,-18000,,
com.apple.finder,9,1741663652,1741663661,1741663661.963358,-18000,,
com.apple.finder,300,1741663016,1741663316,1741663316.981473,-18000,,
com.apple.Music,25,1741661788,1741661813,1741661815.556436,-18000,EB445137-D7F5-57EC-87DA-1DB460D64046,"iPhone13,2"
com.apple.finder,34,1741661539,1741661573,1741661573.546524,-18000,,
com.leomehlig.today,70,1741661469,1741661539,1741661539.3428888,-18000,,
com.apple.Notes,20,1741661449,1741661469,1741661470.070121,-18000,,
com.leomehlig.today,60,1741661389,1741661449,1741661449.4426699,-18000,,
com.apple.finder,5,1741661384,1741661389,1741661389.690002,-18000,,
com.electron.carta,0,1741661384,1741661384,1741661384.993335,-18000,,
com.apple.finder,1,1741661383,1741661384,1741661384.563949,-18000,,
com.microsoft.Outlook,1,1741661382,1741661383,1741661383.296237,-18000,,
com.apple.finder,3,1741661379,1741661382,1741661382.664269,-18000,,
com.microsoft.VSCode,74,1741661305,1741661379,1741661379.7767658,-18000,,
com.google.Chrome,124,1741661181,1741661305,1741661305.15575,-18000,,
com.microsoft.VSCode,6,1741661160,1741661166,1741661166.272468,-18000,,
com.apple.finder,1,1741661159,1741661160,1741661160.285203,-18000,,
com.google.Chrome,54,1741661105,1741661159,1741661159.387772,-18000,,
com.apple.finder,5,1741661100,1741661105,1741661105.077118,-18000,,
com.google.Chrome,1,1741661099,1741661100,1741661100.252695,-18000,,
com.apple.finder,13,1741661086,1741661099,1741661099.141018,-18000,,
com.google.Chrome,21,1741661065,1741661086,1741661086.232419,-18000,,
com.apple.finder,2,1741661063,1741661065,1741661065.0901818,-18000,,
com.google.Chrome,17,1741661046,1741661063,1741661063.142662,-18000,,
com.apple.finder,6,1741661040,1741661046,1741661046.698201,-18000,,
com.google.Chrome,4,1741661036,1741661040,1741661040.1708322,-18000,,
com.apple.finder,23,1741661013,1741661036,1741661036.709523,-18000,,
com.google.Chrome,15,1741660998,1741661013,1741661013.37178,-18000,,
com.apple.finder,4,1741660994,1741660998,1741660998.5619268,-18000,,
com.google.Chrome,16,1741660978,1741660994,1741660994.748992,-18000,,
com.apple.finder,2,1741660976,1741660978,1741660978.130474,-18000,,
com.google.Chrome,1,1741660975,1741660976,1741660977.041889,-18000,,
com.apple.finder,2,1741660973,1741660975,1741660975.600933,-18000,,
com.google.Chrome,3,1741660970,1741660973,1741660973.546982,-18000,,
com.apple.finder,3,1741660967,1741660970,1741660970.486397,-18000,,
com.microsoft.VSCode,2,1741660965,1741660967,1741660967.7474651,-18000,,
com.apple.finder,12,1741660953,1741660965,1741660966.020018,-18000,,
com.microsoft.VSCode,1,1741660952,1741660953,1741660954.036407,-18000,,
com.google.Chrome,9,1741660943,1741660952,1741660952.760892,-18000,,
com.microsoft.VSCode,44,1741660899,1741660943,1741660943.377773,-18000,,
com.apple.finder,3,1741660896,1741660899,1741660899.51307,-18000,,
com.google.Chrome,113,1741660783,1741660896,1741660896.621437,-18000,,
com.apple.finder,8,1741660775,1741660783,1741660783.4749,-18000,,
com.google.Chrome,10,1741660765,1741660775,1741660775.924415,-18000,,
com.apple.finder,21,1741660744,1741660765,1741660765.087384,-18000,,
com.google.Chrome,16,1741660728,1741660744,1741660744.724308,-18000,,
com.apple.finder,18,1741660710,1741660728,1741660728.5210729,-18000,,
com.google.Chrome,3,1741660707,1741660710,1741660710.6835608,-18000,,
com.apple.finder,4,1741660703,1741660707,1741660707.1933079,-18000,,
com.google.Chrome,7,1741660696,1741660703,1741660703.105367,-18000,,
com.apple.finder,41,1741660655,1741660696,1741660696.13133,-18000,,
com.apple.Notes,4,1741660651,1741660655,1741660655.247721,-18000,,
com.microsoft.VSCode,0,1741660651,1741660651,1741660651.8702102,-18000,,
com.apple.Notes,47,1741660604,1741660651,1741660651.223835,-18000,,
com.microsoft.VSCode,14,1741660590,1741660604,1741660604.441399,-18000,,
com.apple.Notes,57,1741660533,1741660590,1741660590.940453,-18000,,
com.apple.finder,18,1741660515,1741660533,1741660533.249875,-18000,,
com.microsoft.VSCode,146,1741660369,1741660515,1741660515.326188,-18000,,
com.apple.Notes,27,1741660342,1741660369,1741660369.611799,-18000,,
com.microsoft.VSCode,5,1741660337,1741660342,1741660342.4197211,-18000,,
com.leomehlig.today,10,1741660327,1741660337,1741660337.239396,-18000,,
com.microsoft.VSCode,58,1741660269,1741660327,1741660327.550764,-18000,,
com.microsoft.Outlook,1,1741660268,1741660269,1741660269.778771,-18000,,
com.apple.finder,1,1741660267,1741660268,1741660268.708942,-18000,,
com.microsoft.VSCode,5,1741660262,1741660267,1741660267.4292521,-18000,,
com.apple.finder,14,1741660248,1741660262,1741660262.832584,-18000,,
com.microsoft.VSCode,26,1741660222,1741660248,1741660248.207943,-18000,,
com.apple.finder,2,1741660220,1741660222,1741660222.73708,-18000,,
com.microsoft.VSCode,52,1741660168,1741660220,1741660220.136842,-18000,,
com.apple.finder,8,1741660160,1741660168,1741660168.962335,-18000,,
com.microsoft.VSCode,11,1741660149,1741660160,1741660160.215063,-18000,,
com.apple.finder,3,1741660146,1741660149,1741660149.564415,-18000,,
com.microsoft.VSCode,2,1741660144,1741660146,1741660146.912893,-18000,,
com.apple.finder,65,1741660079,1741660144,1741660144.3024049,-18000,,
com.microsoft.VSCode,1,1741660078,1741660079,1741660079.762861,-18000,,
com.apple.finder,20,1741660058,1741660078,1741660078.490844,-18000,,
com.apple.Preview,20,1741660038,1741660058,1741660058.84041,-18000,,
com.apple.finder,3,1741660035,1741660038,1741660039.063165,-18000,,
com.microsoft.VSCode,14,1741660021,1741660035,1741660035.302135,-18000,,
com.apple.finder,6,1741660015,1741660021,1741660021.173108,-18000,,
com.microsoft.VSCode,268,1741659747,1741660015,1741660015.7716022,-18000,,
com.apple.finder,31,1741659716,1741659747,1741659747.392861,-18000,,
com.microsoft.VSCode,5,1741659711,1741659716,1741659716.242474,-18000,,
com.apple.finder,136,1741659575,1741659711,1741659711.777275,-18000,,
com.microsoft.VSCode,155,1741659420,1741659575,1741659576.0182781,-18000,,
com.apple.finder,2,1741659418,1741659420,1741659420.420892,-18000,,
com.microsoft.VSCode,22,1741659396,1741659418,1741659419.5507898,-18000,,
com.apple.finder,8,1741659388,1741659396,1741659396.699201,-18000,,
com.microsoft.VSCode,175,1741659213,1741659388,1741659388.7766519,-18000,,
com.apple.finder,3,1741659210,1741659213,1741659213.344199,-18000,,
com.microsoft.VSCode,543,1741658667,1741659210,1741659210.256837,-18000,,
com.google.Chrome,25,1741658642,1741658667,1741658668.035633,-18000,,
com.microsoft.VSCode,309,1741658333,1741658642,1741658642.887936,-18000,,
com.google.Chrome,4,1741658329,1741658333,1741658333.897048,-18000,,
com.microsoft.VSCode,2,1741658327,1741658329,1741658329.468174,-18000,,
com.google.Chrome,6,1741658321,1741658327,1741658327.8084369,-18000,,
com.microsoft.VSCode,854,1741657467,1741658321,1741658321.6452188,-18000,,
com.electron.carta,2,1741657465,1741657467,1741657467.93334,-18000,,
com.microsoft.VSCode,10,1741657455,1741657465,1741657465.6677198,-18000,,
com.electron.carta,4,1741657451,1741657455,1741657455.195589,-18000,,
com.microsoft.VSCode,2,1741657449,1741657451,1741657451.853601,-18000,,
com.electron.carta,7,1741657442,1741657449,1741657449.749016,-18000,,
com.microsoft.VSCode,13,1741657429,1741657442,1741657442.73437,-18000,,
com.electron.carta,18,1741657411,1741657429,1741657429.694594,-18000,,
com.microsoft.VSCode,3,1741657408,1741657411,1741657411.5778031,-18000,,
com.electron.carta,2,1741657406,1741657408,1741657408.899126,-18000,,
com.microsoft.VSCode,56,1741657350,1741657406,1741657406.7102451,-18000,,
com.electron.carta,49,1741657301,1741657350,1741657350.3644,-18000,,
com.microsoft.VSCode,7,1741657294,1741657301,1741657301.506954,-18000,,
com.electron.carta,1,1741657293,1741657294,1741657294.996975,-18000,,
com.microsoft.VSCode,290,1741657003,1741657293,1741657293.404478,-18000,,
com.electron.carta,42,1741656961,1741657003,1741657003.700454,-18000,,
com.microsoft.VSCode,12,1741656949,1741656961,1741656961.465626,-18000,,
com.google.Chrome,7,1741656942,1741656949,1741656949.313857,-18000,,
com.microsoft.VSCode,71,1741656871,1741656942,1741656943.340244,-18000,,
com.apple.MobileSMS,0,1741656871,1741656871,1741656871.9729052,-18000,,
com.microsoft.VSCode,0,1741656871,1741656871,1741656871.583977,-18000,,
com.apple.finder,2,1741656869,1741656871,1741656871.407798,-18000,,
com.microsoft.Word,1,1741656868,1741656869,1741656869.785337,-18000,,
com.apple.finder,6,1741656862,1741656868,1741656868.855339,-18000,,
com.leomehlig.today,2,1741656860,1741656862,1741656862.907703,-18000,,
com.google.Chrome,970,1741655890,1741656860,1741656860.4151092,-18000,,
com.apple.finder,9,1741655863,1741655872,1741655873.096302,-18000,,
com.google.Chrome,5,1741655858,1741655863,1741655863.285435,-18000,,
com.apple.iCal,18,1741655840,1741655858,1741655858.306511,-18000,,
com.google.Chrome,13,1741655827,1741655840,1741655840.0396519,-18000,,
com.apple.iCal,4,1741655823,1741655827,1741655827.762325,-18000,,
com.google.Chrome,2,1741655821,1741655823,1741655823.5793772,-18000,,
com.apple.iCal,2,1741655819,1741655821,1741655821.653198,-18000,,
com.google.Chrome,2,1741655817,1741655819,1741655819.60319,-18000,,
com.apple.iCal,27,1741655790,1741655817,1741655817.386146,-18000,,
com.google.Chrome,15,1741655775,1741655790,1741655790.109427,-18000,,
com.leomehlig.today,172,1741655603,1741655775,1741655776.5959802,-18000,,
com.apple.Preview,5,1741655598,1741655603,1741655603.44501,-18000,,
com.microsoft.Word,2,1741655596,1741655598,1741655598.922299,-18000,,
com.leomehlig.today,28,1741655568,1741655596,1741655596.28363,-18000,,
com.microsoft.Word,211,1741655357,1741655568,1741655568.2796202,-18000,,
com.apple.Preview,106,1741655251,1741655357,1741655357.137648,-18000,,
com.microsoft.Word,44,1741655207,1741655251,1741655251.9981961,-18000,,
com.apple.Preview,79,1741655128,1741655207,1741655207.703896,-18000,,
com.microsoft.Word,446,1741654682,1741655128,1741655128.832851,-18000,,
com.leomehlig.today,3,1741654679,1741654682,1741654682.854943,-18000,,
com.microsoft.Word,4,1741654675,1741654679,1741654679.768622,-18000,,
com.apple.Preview,1,1741654674,1741654675,1741654675.512567,-18000,,
com.leomehlig.today,2,1741654672,1741654674,1741654674.289187,-18000,,
com.microsoft.Word,354,1741654318,1741654672,1741654672.732472,-18000,,
com.apple.Preview,2,1741654316,1741654318,1741654318.118103,-18000,,
com.microsoft.Word,11,1741654305,1741654316,1741654316.9724212,-18000,,
com.apple.Preview,1,1741654304,1741654305,1741654305.4862962,-18000,,
com.microsoft.Word,75,1741654229,1741654304,1741654304.345068,-18000,,
com.apple.Preview,70,1741654159,1741654229,1741654229.626823,-18000,,
com.apple.finder,157,1741654002,1741654159,1741654159.7698421,-18000,,
com.apple.Preview,2,1741654000,1741654002,1741654002.4037108,-18000,,
com.apple.finder,3,1741653997,1741654000,1741654000.753468,-18000,,
com.microsoft.Word,73,1741653924,1741653997,1741653997.3014898,-18000,,
com.apple.Preview,44,1741653880,1741653924,1741653924.518642,-18000,,
com.apple.finder,2,1741653878,1741653880,1741653880.873094,-18000,,
com.apple.Preview,0,1741653878,1741653878,1741653878.9042501,-18000,,
com.apple.finder,5,1741653873,1741653878,1741653878.155007,-18000,,
com.microsoft.Word,7,1741653866,1741653873,1741653873.785583,-18000,,
com.apple.Preview,3,1741653863,1741653866,1741653866.939563,-18000,,
com.google.Chrome,362,1741653501,1741653863,1741653863.759532,-18000,,
com.intsig.CamScannerLite,3,1741653483,1741653486,1741653486.101605,-18000,EB445137-D7F5-57EC-87DA-1DB460D64046,"iPhone13,2"
com.microsoft.Word,35,1741653466,1741653501,1741653501.4397612,-18000,,
com.apple.Preview,2,1741653464,1741653466,1741653466.060835,-18000,,
com.leomehlig.today,3,1741653461,1741653464,1741653464.4348521,-18000,,
com.microsoft.Word,415,1741653046,1741653461,1741653461.840282,-18000,,
com.apple.Preview,6,1741653040,1741653046,1741653046.318129,-18000,,
com.microsoft.Word,11,1741653029,1741653040,1741653040.467973,-18000,,
com.apple.Preview,54,1741652975,1741653029,1741653029.098103,-18000,,
com.microsoft.Word,1,1741652974,1741652975,1741652975.214956,-18000,,
com.apple.Preview,13,1741652961,1741652974,1741652974.1461449,-18000,,
com.microsoft.Word,2,1741652959,1741652961,1741652961.370053,-18000,,
com.apple.news,244,1741652715,1741652959,1741652959.765448,-18000,,
com.microsoft.Word,2,1741652713,1741652715,1741652715.785676,-18000,,
com.apple.news,0,1741652713,1741652713,1741652714.175103,-18000,,
com.microsoft.Word,2,1741652711,1741652713,1741652713.728486,-18000,,
com.apple.MobileSMS,5,1741652706,1741652711,1741652711.56599,-18000,,
com.apple.Preview,24,1741652682,1741652706,1741652706.35094,-18000,,
com.apple.finder,5,1741652677,1741652682,1741652682.44526,-18000,,
com.apple.Preview,1,1741652676,1741652677,1741652677.72064,-18000,,
com.apple.finder,117,1741652559,1741652676,1741652676.607549,-18000,,
com.microsoft.Word,7,1741652552,1741652559,1741652559.489495,-18000,,
com.apple.Preview,25,1741652527,1741652552,1741652552.8412728,-18000,,
com.apple.finder,5,1741652522,1741652527,1741652527.503265,-18000,,
com.apple.Preview,3,1741652519,1741652522,1741652522.152697,-18000,,
com.apple.finder,2,1741652517,1741652519,1741652519.8137379,-18000,,
com.apple.Preview,1,1741652516,1741652517,1741652517.897987,-18000,,
com.apple.finder,10,1741652506,1741652516,1741652516.7700582,-18000,,
com.apple.MobileSMS,23,1741652483,1741652506,1741652506.1320848,-18000,,
com.apple.Preview,49,1741652434,1741652483,1741652483.440542,-18000,,
com.apple.finder,18,1741652416,1741652434,1741652434.947998,-18000,,
com.intsig.CamScannerLite,71,1741652363,1741652434,1741652434.943174,-18000,EB445137-D7F5-57EC-87DA-1DB460D64046,"iPhone13,2"
com.tinyspeck.chatlyio,9,1741652351,1741652360,1741652360.4271998,-18000,EB445137-D7F5-57EC-87DA-1DB460D64046,"iPhone13,2"
com.microsoft.Office.Outlook,27,1741652322,1741652349,1741652349.4800348,-18000,EB445137-D7F5-57EC-87DA-1DB460D64046,"iPhone13,2"
com.apple.Preview,127,1741652289,1741652416,1741652416.0789351,-18000,,
com.microsoft.Word,411,1741651878,1741652289,1741652289.5568829,-18000,,
com.google.Chrome,84,1741651794,1741651878,1741651878.923253,-18000,,
com.microsoft.Word,813,1741650981,1741651794,1741651794.733056,-18000,,
com.google.Chrome,41,1741650940,1741650981,1741650981.286093,-18000,,
com.microsoft.Word,520,1741650420,1741650940,1741650941.670707,-18000,,
com.apple.Preview,7,1741650413,1741650420,1741650420.819139,-18000,,
com.apple.finder,5,1741650408,1741650413,1741650414.067881,-18000,,
com.microsoft.Word,7,1741650401,1741650408,1741650408.755424,-18000,,
com.apple.finder,17,1741650384,1741650401,1741650401.323433,-18000,,
com.google.Chrome,3,1741650381,1741650384,1741650384.853166,-18000,,
com.apple.finder,5,1741650376,1741650381,1741650381.669467,-18000,,
com.leomehlig.today,35,1741650341,1741650376,1741650376.923204,-18000,,
com.google.Chrome,10,1741650331,1741650341,1741650341.808796,-18000,,
com.apple.MobileSMS,53,1741648926,1741648979,1741648979.266531,-18000,EB445137-D7F5-57EC-87DA-1DB460D64046,"iPhone13,2"
com.tinyspeck.chatlyio,6,1741648792,1741648798,1741648798.630251,-18000,EB445137-D7F5-57EC-87DA-1DB460D64046,"iPhone13,2"
com.apple.weather,48,1741648741,1741648789,1741648789.853239,-18000,EB445137-D7F5-57EC-87DA-1DB460D64046,"iPhone13,2"
com.microsoft.Office.Outlook,1,1741648740,1741648741,1741648741.588056,-18000,EB445137-D7F5-57EC-87DA-1DB460D64046,"iPhone13,2"
com.microsoft.Office.Outlook,67,1741648574,1741648641,1741648641.60589,-18000,EB445137-D7F5-57EC-87DA-1DB460D64046,"iPhone13,2"
com.google.Chrome,623,1741647829,1741648452,1741648452.231539,-18000,,
com.leomehlig.today,1,1741647828,1741647829,1741647829.506201,-18000,,
com.leomehlig.today,370,1741647034,1741647404,1741647404.0358381,-18000,,
com.google.Chrome,9,1741647016,1741647025,1741647025.9350019,-18000,,
com.microsoft.VSCode,4,1741647012,1741647016,1741647017.882571,-18000,,
com.google.Chrome,88,1741646924,1741647012,1741647012.560573,-18000,,
com.microsoft.VSCode,573,1741646351,1741646924,1741646924.293579,-18000,,
com.google.Chrome,70,1741646281,1741646351,1741646351.367701,-18000,,
com.microsoft.VSCode,2,1741646279,1741646281,1741646281.950197,-18000,,
com.google.Chrome,9,1741646270,1741646279,1741646279.639052,-18000,,
com.microsoft.VSCode,237,1741646033,1741646270,1741646270.3147879,-18000,,
com.microsoft.VSCode,605,1741645423,1741646028,1741646028.865339,-18000,,
com.apple.finder,11,1741645412,1741645423,1741645424.012518,-18000,,
com.microsoft.VSCode,11,1741645401,1741645412,1741645412.256168,-18000,,
com.google.Chrome,158,1741645243,1741645401,1741645401.055352,-18000,,
com.microsoft.VSCode,132,1741645111,1741645243,1741645243.89203,-18000,,
com.google.Chrome,125,1741644986,1741645111,1741645112.001867,-18000,,
com.microsoft.VSCode,5,1741644981,1741644986,1741644986.673404,-18000,,
com.google.Chrome,69,1741644912,1741644981,1741644981.393632,-18000,,
com.microsoft.VSCode,81,1741644831,1741644912,1741644912.625222,-18000,,
com.google.Chrome,350,1741644481,1741644831,1741644831.4778519,-18000,,
com.apple.Preview,84,1741644397,1741644481,1741644481.812345,-18000,,
com.google.Chrome,63,1741644334,1741644397,1741644397.3400168,-18000,,
com.leomehlig.today,1,1741644333,1741644334,1741644334.587523,-18000,,
com.google.Chrome,382,1741643951,1741644333,1741644333.903863,-18000,,
com.apple.finder,1,1741643835,1741643836,1741643836.669693,-18000,,
com.google.Chrome,83,1741643752,1741643835,1741643835.663835,-18000,,
com.leomehlig.today,2,1741643750,1741643752,1741643752.220032,-18000,,
com.microsoft.Office.Outlook,11,1741643737,1741643748,1741643749.314934,-18000,EB445137-D7F5-57EC-87DA-1DB460D64046,"iPhone13,2"
com.tinyspeck.chatlyio,376,1741643359,1741643735,1741643735.437624,-18000,EB445137-D7F5-57EC-87DA-1DB460D64046,"iPhone13,2"
com.myfitnesspal.mfp,374,1741642920,1741643294,1741643294.875488,-18000,EB445137-D7F5-57EC-87DA-1DB460D64046,"iPhone13,2"
com.apple.news,1,1741642916,1741642917,1741642917.630486,-18000,EB445137-D7F5-57EC-87DA-1DB460D64046,"iPhone13,2"
com.apple.news,47,1741642444,1741642491,1741642491.767798,-18000,EB445137-D7F5-57EC-87DA-1DB460D64046,"iPhone13,2"
com.instructure.icanvas,26,1741642413,1741642439,1741642439.314265,-18000,EB445137-D7F5-57EC-87DA-1DB460D64046,"iPhone13,2"
com.apple.news,0,1741642413,1741642413,1741642414.701673,-18000,EB445137-D7F5-57EC-87DA-1DB460D64046,"iPhone13,2"
com.leomehlig.today,343,1741642357,1741642700,1741642700.123697,-18000,,
com.microsoft.VSCode,60,1741642297,1741642357,1741642357.3832831,-18000,,
com.google.Chrome,297,1741642000,1741642297,1741642297.370769,-18000,,
com.microsoft.VSCode,412,1741641524,1741641936,1741641936.547797,-18000,,
com.apple.finder,3,1741641521,1741641524,1741641524.103241,-18000,,
com.apple.Preview,1,1741641520,1741641521,1741641521.508184,-18000,,
com.apple.Preview,324,1741640942,1741641266,1741641266.5809078,-18000,,
com.apple.finder,18,1741640924,1741640942,1741640943.027283,-18000,,
com.google.Chrome,167,1741640757,1741640924,1741640924.120841,-18000,,
com.leomehlig.today,1,1741640756,1741640757,1741640757.148489,-18000,,
com.apple.Preview,3,1741640753,1741640756,1741640756.0486221,-18000,,
com.google.Chrome,3,1741640750,1741640753,1741640753.47453,-18000,,
com.apple.finder,22,1741640728,1741640750,1741640750.339851,-18000,,
com.apple.Preview,3,1741640725,1741640728,1741640728.979519,-18000,,
com.apple.finder,11,1741640714,1741640725,1741640725.7960482,-18000,,
com.google.Chrome,22,1741640692,1741640714,1741640714.546504,-18000,,
com.leomehlig.today,26,1741640613,1741640639,1741640640.129154,-18000,,
com.google.Chrome,10,1741640603,1741640613,1741640613.473609,-18000,,
com.apple.iCal,1,1741640602,1741640603,1741640603.217054,-18000,,
com.apple.MobileSMS,3,1741640599,1741640602,1741640602.409378,-18000,,
com.apple.news,420,1741640092,1741640512,1741640512.523745,-18000,EB445137-D7F5-57EC-87DA-1DB460D64046,"iPhone13,2"
com.instructure.icanvas,10,1741640075,1741640085,1741640085.641807,-18000,EB445137-D7F5-57EC-87DA-1DB460D64046,"iPhone13,2"
com.apple.MobileSMS,311,1741640020,1741640331,1741640331.298009,-18000,,
com.apple.iCal,2,1741640018,1741640020,1741640020.6888351,-18000,,
com.apple.FaceTime,17,1741640001,1741640018,1741640018.524751,-18000,,
com.apple.iCal,825,1741639176,1741640001,1741640001.1603022,-18000,,
com.google.Chrome,98,1741639078,1741639176,1741639176.503839,-18000,,
com.apple.finder,52,1741639026,1741639078,1741639078.0690742,-18000,,
com.google.Chrome,183,1741638843,1741639026,1741639026.324827,-18000,,
com.leomehlig.today,109,1741638734,1741638843,1741638844.312866,-18000,,
com.apple.iCal,212,1741638522,1741638734,1741638735.0116239,-18000,,
com.leomehlig.today,38,1741638484,1741638522,1741638522.8508968,-18000,,
com.hammerandchisel.discord,33,1741638404,1741638437,1741638437.800422,-18000,EB445137-D7F5-57EC-87DA-1DB460D64046,"iPhone13,2"
com.instructure.icanvas,6,1741638397,1741638403,1741638403.407552,-18000,EB445137-D7F5-57EC-87DA-1DB460D64046,"iPhone13,2"
com.instructure.icanvas,13,1741638373,1741638386,1741638386.56152,-18000,EB445137-D7F5-57EC-87DA-1DB460D64046,"iPhone13,2"
com.apple.weather,24,1741638348,1741638372,1741638372.471699,-18000,EB445137-D7F5-57EC-87DA-1DB460D64046,"iPhone13,2"
com.microsoft.Office.Outlook,2,1741638346,1741638348,1741638348.739194,-18000,EB445137-D7F5-57EC-87DA-1DB460D64046,"iPhone13,2"
com.apple.Notes,324,1741638160,1741638484,1741638484.599609,-18000,,
com.leomehlig.today,187,1741637973,1741638160,1741638160.639207,-18000,,
com.apple.MobileSMS,4,1741637969,1741637973,1741637973.243952,-18000,,
com.apple.FaceTime,2,1741637967,1741637969,1741637969.119721,-18000,,
com.apple.MobileSMS,8,1741637959,1741637967,1741637967.9492888,-18000,,
com.apple.finder,2,1741637957,1741637959,1741637959.783812,-18000,,
com.apple.findmy,10,1741637947,1741637957,1741637957.522976,-18000,,
com.apple.finder,2,1741637945,1741637947,1741637947.895452,-18000,,
com.apple.MobileSMS,9,1741637936,1741637945,1741637945.638032,-18000,,
com.leomehlig.today,17,1741637919,1741637936,1741637936.17459,-18000,,
com.apple.finder,2,1741637917,1741637919,1741637919.595521,-18000,,
com.apple.Terminal,0,1741637917,1741637917,1741637917.868542,-18000,,
com.google.Chrome,70,1741637847,1741637917,1741637917.4040232,-18000,,
com.microsoft.Outlook,13,1741637834,1741637847,1741637847.299364,-18000,,
com.google.Chrome,6,1741637828,1741637834,1741637834.396329,-18000,,
com.microsoft.Office.Outlook,42,1741636768,1741636810,1741636811.0550919,-18000,EB445137-D7F5-57EC-87DA-1DB460D64046,"iPhone13,2"
com.apple.Health,0,1741636768,1741636768,1741636769.918567,-18000,EB445137-D7F5-57EC-87DA-1DB460D64046,"iPhone13,2"
com.apple.Health,22,1741633317,1741633339,1741633339.5305738,-18000,EB445137-D7F5-57EC-87DA-1DB460D64046,"iPhone13,2"
com.github.stormbreaker.prod,85,1741633228,1741633313,1741633313.844254,-18000,EB445137-D7F5-57EC-87DA-1DB460D64046,"iPhone13,2"
com.github.stormbreaker.prod,11,1741633196,1741633207,1741633208.20457,-18000,EB445137-D7F5-57EC-87DA-1DB460D64046,"iPhone13,2"
com.instructure.icanvas,51,1741633130,1741633181,1741633181.2839909,-18000,EB445137-D7F5-57EC-87DA-1DB460D64046,"iPhone13,2"
com.apple.CoreAuthUI,2,1741633088,1741633090,1741633090.417224,-18000,EB445137-D7F5-57EC-87DA-1DB460D64046,"iPhone13,2"
com.microsoft.Office.Outlook,72,1741633058,1741633130,1741633130.149747,-18000,EB445137-D7F5-57EC-87DA-1DB460D64046,"iPhone13,2"
com.apple.CoreAuthUI,2,1741633019,1741633021,1741633022.039479,-18000,EB445137-D7F5-57EC-87DA-1DB460D64046,"iPhone13,2"
com.microsoft.Office.Outlook,64,1741632993,1741633057,1741633057.9440908,-18000,EB445137-D7F5-57EC-87DA-1DB460D64046,"iPhone13,2"
com.google.Chrome,197,1741632398,1741632595,1741632595.7773051,-18000,,
com.microsoft.VSCode,456,1741631942,1741632398,1741632398.908179,-18000,,
com.google.Chrome,7,1741631935,1741631942,1741631942.171238,-18000,,
com.microsoft.VSCode,31,1741631904,1741631935,1741631935.9885159,-18000,,
com.apple.Terminal,8,1741631896,1741631904,1741631905.004709,-18000,,
com.google.Chrome,47,1741631849,1741631896,1741631896.527466,-18000,,
com.apple.Terminal,11,1741631838,1741631849,1741631849.501377,-18000,,
com.microsoft.VSCode,833,1741631005,1741631838,1741631838.393255,-18000,,
com.google.Chrome,1,1741631004,1741631005,1741631006.081698,-18000,,
com.microsoft.VSCode,2,1741631002,1741631004,1741631004.891391,-18000,,
com.google.Chrome,1,1741631001,1741631002,1741631002.2393851,-18000,,
com.microsoft.VSCode,4,1741630997,1741631001,1741631001.438682,-18000,,
com.google.Chrome,30,1741630967,1741630997,1741630997.768193,-18000,,
com.microsoft.VSCode,387,1741630580,1741630967,1741630967.80411,-18000,,
com.apple.Dictionary,1,1741630579,1741630580,1741630580.560677,-18000,,
com.microsoft.VSCode,485,1741630094,1741630579,1741630579.74791,-18000,,
com.microsoft.Outlook,8,1741630086,1741630094,1741630094.814958,-18000,,
com.microsoft.VSCode,492,1741629594,1741630086,1741630086.7666821,-18000,,
com.apple.finder,43,1741629551,1741629594,1741629594.0476189,-18000,,
com.microsoft.VSCode,128,1741629423,1741629551,1741629551.093254,-18000,,
com.apple.finder,11,1741629412,1741629423,1741629423.318564,-18000,,
com.microsoft.VSCode,330,1741629082,1741629412,1741629412.4767442,-18000,,
com.microsoft.Outlook,2,1741629080,1741629082,1741629082.302227,-18000,,
com.leomehlig.today,21,1741629059,1741629080,1741629080.0916262,-18000,,
com.google.Chrome,138,1741628921,1741629059,1741629059.807272,-18000,,
com.microsoft.Outlook,16,1741628905,1741628921,1741628921.059243,-18000,,
com.toyopagroup.picaboo,3,1741628717,1741628720,1741628720.960139,-18000,EB445137-D7F5-57EC-87DA-1DB460D64046,"iPhone13,2"
com.microsoft.Outlook,105,1741627915,1741628020,1741628020.980774,-18000,,
com.apple.MobileSMS,20,1741627632,1741627652,1741627652.5211492,-18000,EB445137-D7F5-57EC-87DA-1DB460D64046,"iPhone13,2"
com.toyopagroup.picaboo,0,1741627632,1741627632,1741627632.4127269,-18000,EB445137-D7F5-57EC-87DA-1DB460D64046,"iPhone13,2"
com.toyopagroup.picaboo,28,1741627602,1741627630,1741627631.137358,-18000,EB445137-D7F5-57EC-87DA-1DB460D64046,"iPhone13,2"
com.apple.MobileSMS,3,1741627599,1741627602,1741627602.498194,-18000,EB445137-D7F5-57EC-87DA-1DB460D64046,"iPhone13,2"
com.google.Chrome,357,1741627558,1741627915,1741627915.952605,-18000,,
com.microsoft.Outlook,2,1741627556,1741627558,1741627558.7417169,-18000,,
com.google.Chrome,2,1741627554,1741627556,1741627556.450659,-18000,,
com.microsoft.Outlook,27,1741627527,1741627554,1741627554.4167972,-18000,,
com.google.Chrome,2,1741627525,1741627527,1741627527.918134,-18000,,
com.microsoft.Outlook,66,1741627459,1741627525,1741627525.250383,-18000,,
com.google.Chrome,26,1741627433,1741627459,1741627459.26659,-18000,,
com.microsoft.Outlook,4,1741627429,1741627433,1741627433.886046,-18000,,
com.google.Chrome,159,1741627270,1741627429,1741627430.015691,-18000,,
com.apple.MobileSMS,9,1741622938,1741622947,1741622947.566911,-18000,EB445137-D7F5-57EC-87DA-1DB460D64046,"iPhone13,2"
com.google.Chrome,290,1741622207,1741622497,1741622497.424909,-18000,,
com.google.chrome.ios,39,1741621903,1741621942,1741621943.128869,-18000,EB445137-D7F5-57EC-87DA-1DB460D64046,"iPhone13,2"
com.apple.MobileSMS,25,1741621790,1741621815,1741621816.093893,-18000,EB445137-D7F5-57EC-87DA-1DB460D64046,"iPhone13,2"
com.apple.Health,33,1741621621,1741621654,1741621654.432712,-18000,EB445137-D7F5-57EC-87DA-1DB460D64046,"iPhone13,2"
com.groupme.iphone-app,3,1741621613,1741621616,1741621616.913923,-18000,EB445137-D7F5-57EC-87DA-1DB460D64046,"iPhone13,2"
com.apple.weather,1,1741621612,1741621613,1741621613.270845,-18000,EB445137-D7F5-57EC-87DA-1DB460D64046,"iPhone13,2"
com.google.Chrome,64,1741621524,1741621588,1741621588.2772121,-18000,,
com.apple.MobileSMS,56,1741621468,1741621524,1741621524.134519,-18000,,
com.google.Chrome,23,1741621445,1741621468,1741621468.156219,-18000,,
com.apple.MobileSMS,111,1741621334,1741621445,1741621445.072567,-18000,,
com.google.Chrome,19,1741621315,1741621334,1741621334.107702,-18000,,
com.apple.MobileSMS,61,1741621254,1741621315,1741621315.1719341,-18000,,
com.google.Chrome,49,1741621205,1741621254,1741621254.415945,-18000,,
com.apple.MobileSMS,105,1741621100,1741621205,1741621205.789659,-18000,,
com.google.Chrome,29,1741621071,1741621100,1741621100.770184,-18000,,
com.apple.MobileSMS,25,1741621046,1741621071,1741621071.885707,-18000,,
com.google.Chrome,668,1741620378,1741621046,1741621046.720469,-18000,,
com.apple.iCal,10,1741620368,1741620378,1741620378.846827,-18000,,
com.google.Chrome,330,1741620038,1741620368,1741620368.414678,-18000,,
com.apple.MobileSMS,48,1741619990,1741620038,1741620038.96599,-18000,,
com.google.Chrome,20,1741619970,1741619990,1741619990.052999,-18000,,
com.apple.MobileSMS,64,1741619906,1741619970,1741619971.028065,-18000,,
com.google.Chrome,1,1741619905,1741619906,1741619906.970778,-18000,,
com.microsoft.Outlook,1,1741619904,1741619905,1741619905.857895,-18000,,
com.google.Chrome,88,1741619816,1741619904,1741619904.564166,-18000,,
com.apple.MobileSMS,21,1741619795,1741619816,1741619816.49795,-18000,,
com.google.Chrome,18,1741619777,1741619795,1741619795.88432,-18000,,
com.apple.MobileSMS,149,1741619628,1741619777,1741619777.891135,-18000,,
com.google.Chrome,12,1741619616,1741619628,1741619628.861516,-18000,,
com.apple.MobileSMS,2,1741619614,1741619616,1741619616.3742309,-18000,,
com.google.Chrome,48,1741619566,1741619614,1741619614.4197521,-18000,,
com.apple.MobileSMS,178,1741619388,1741619566,1741619566.319211,-18000,,
com.google.Chrome,10,1741619378,1741619388,1741619388.903873,-18000,,
com.apple.MobileSMS,50,1741619328,1741619378,1741619378.2733269,-18000,,
com.google.Chrome,44,1741619284,1741619328,1741619328.9459062,-18000,,
com.microsoft.Outlook,23,1741619261,1741619284,1741619284.914273,-18000,,
com.google.Chrome,62,1741619199,1741619261,1741619261.7407598,-18000,,
com.microsoft.Outlook,30,1741619169,1741619199,1741619199.794399,-18000,,
com.apple.MobileSMS,120,1741619049,1741619169,1741619169.363824,-18000,,
com.google.Chrome,3,1741619046,1741619049,1741619049.270976,-18000,,
com.apple.MobileSMS,19,1741619027,1741619046,1741619046.252555,-18000,,
com.google.Chrome,15,1741619012,1741619027,1741619027.173407,-18000,,
com.apple.MobileSMS,21,1741618991,1741619012,1741619012.953676,-18000,,
com.google.Chrome,9,1741618982,1741618991,1741618991.950499,-18000,,
com.apple.MobileSMS,14,1741618968,1741618982,1741618983.058171,-18000,,
com.google.Chrome,1215,1741617753,1741618968,1741618968.064038,-18000,,
com.apple.Passwords,10,1741617731,1741617741,1741617741.874917,-18000,,
com.google.Chrome,3,1741617728,1741617731,1741617731.627933,-18000,,
com.apple.weather,5,1741616495,1741616500,1741616500.9279819,-18000,EB445137-D7F5-57EC-87DA-1DB460D64046,"iPhone13,2"
com.renpho.health,2,1741616493,1741616495,1741616495.206287,-18000,EB445137-D7F5-57EC-87DA-1DB460D64046,"iPhone13,2"
com.renpho.health,61,1741616388,1741616449,1741616449.5945191,-18000,EB445137-D7F5-57EC-87DA-1DB460D64046,"iPhone13,2"
com.apple.news,3,1741614754,1741614757,1741614757.811616,-18000,EB445137-D7F5-57EC-87DA-1DB460D64046,"iPhone13,2"
com.apple.news,157,1741613852,1741614009,1741614009.470468,-18000,EB445137-D7F5-57EC-87DA-1DB460D64046,"iPhone13,2"
com.google.Chrome,841,1741584162,1741585003,1741585003.967284,-18000,,
com.apple.finder,69,1741584093,1741584162,1741584162.7828,-18000,,
com.google.Chrome,319,1741583774,1741584093,1741584093.875976,-18000,,
com.google.Chrome,1471,1741581859,1741583330,1741583330.274153,-18000,,
com.google.Chrome,581,1741581011,1741581592,1741581592.262347,-18000,,
com.apple.Preview,0,1741581011,1741581011,1741581011.458188,-18000,,
com.google.Chrome,2,1741581009,1741581011,1741581011.234805,-18000,,
com.google.Chrome,498,1741579839,1741580337,1741580337.8577461,-18000,,
com.google.Chrome,530,1741579073,1741579603,1741579603.093965,-18000,,
com.google.Chrome,1002,1741577833,1741578835,1741578835.800284,-18000,,
com.google.Chrome,1967,1741575464,1741577431,1741577431.6840549,-18000,,
com.apple.finder,6,1741575416,1741575422,1741575422.770805,-18000,,
com.google.chrome.ios,6,1741563787,1741563793,1741563794.099523,-18000,EB445137-D7F5-57EC-87DA-1DB460D64046,"iPhone13,2"
com.google.chrome.ios,2,1741563785,1741563787,1741563787.62273,-18000,EB445137-D7F5-57EC-87DA-1DB460D64046,"iPhone13,2"
com.google.chrome.ios,3,1741563782,1741563785,1741563785.4103742,-18000,EB445137-D7F5-57EC-87DA-1DB460D64046,"iPhone13,2"
com.google.chrome.ios,67,1741563516,1741563583,1741563584.4595141,-18000,EB445137-D7F5-57EC-87DA-1DB460D64046,"iPhone13,2"
com.apple.news,3,1741563513,1741563516,1741563517.153127,-18000,EB445137-D7F5-57EC-87DA-1DB460D64046,"iPhone13,2"
com.apple.PosterBoard,1,1741563513,1741563514,1741563514.672375,-18000,EB445137-D7F5-57EC-87DA-1DB460D64046,"iPhone13,2"
com.apple.news,106,1741563081,1741563187,1741563188.228773,-18000,EB445137-D7F5-57EC-87DA-1DB460D64046,"iPhone13,2"
com.toyopagroup.picaboo,27,1741563046,1741563073,1741563073.254043,-18000,EB445137-D7F5-57EC-87DA-1DB460D64046,"iPhone13,2"
com.google.chrome.ios,1,1741563045,1741563046,1741563046.603856,-18000,EB445137-D7F5-57EC-87DA-1DB460D64046,"iPhone13,2"
com.google.chrome.ios,98,1741562860,1741562958,1741562959.085921,-18000,EB445137-D7F5-57EC-87DA-1DB460D64046,"iPhone13,2"
com.apple.Music,2,1741562858,1741562860,1741562860.190292,-18000,EB445137-D7F5-57EC-87DA-1DB460D64046,"iPhone13,2"
com.apple.Music,19,1741561224,1741561243,1741561243.716506,-18000,EB445137-D7F5-57EC-87DA-1DB460D64046,"iPhone13,2"
com.apple.Music,52,1741560941,1741560993,1741560993.448813,-18000,EB445137-D7F5-57EC-87DA-1DB460D64046,"iPhone13,2"
com.apple.finder,1,1741560821,1741560822,1741560822.955102,-18000,,
com.google.Chrome,4,1741560817,1741560821,1741560821.194242,-18000,,
com.apple.finder,2,1741560815,1741560817,1741560817.586184,-18000,,
com.microsoft.VSCode,152,1741560663,1741560815,1741560815.82036,-18000,,
com.apple.finder,24,1741560639,1741560663,1741560663.155826,-18000,,
com.microsoft.VSCode,5,1741560634,1741560639,1741560639.077104,-18000,,
com.microsoft.Word,1,1741560633,1741560634,1741560635.014112,-18000,,
com.microsoft.VSCode,1,1741560632,1741560633,1741560633.71944,-18000,,
com.apple.shortcuts,5,1741560627,1741560632,1741560632.6607618,-18000,,
com.microsoft.VSCode,7,1741560592,1741560599,1741560599.87393,-18000,,
com.apple.MobileSMS,4,1741560588,1741560592,1741560592.5200791,-18000,,
com.microsoft.VSCode,7,1741560581,1741560588,1741560588.966111,-18000,,
com.apple.MobileSMS,5,1741560576,1741560581,1741560581.339369,-18000,,
com.microsoft.VSCode,5,1741560571,1741560576,1741560576.566824,-18000,,
com.apple.finder,1,1741560570,1741560571,1741560571.931267,-18000,,
com.leomehlig.today,13,1741560557,1741560570,1741560570.6903,-18000,,
com.apple.MobileSMS,30,1741560527,1741560557,1741560557.734523,-18000,,
com.leomehlig.today,92,1741560435,1741560527,1741560527.9930248,-18000,,
com.apple.iCal,15,1741560420,1741560435,1741560435.851083,-18000,,
com.leomehlig.today,29,1741560391,1741560420,1741560420.771572,-18000,,
com.apple.Notes,42,1741560349,1741560391,1741560391.618034,-18000,,
com.leomehlig.today,77,1741560272,1741560349,1741560349.745205,-18000,,
com.microsoft.Word,176,1741560096,1741560272,1741560272.931169,-18000,,
com.apple.finder,1,1741560095,1741560096,1741560096.576936,-18000,,
com.microsoft.Word,20,1741560075,1741560095,1741560095.226965,-18000,,
com.apple.finder,18,1741560057,1741560075,1741560075.878268,-18000,,
com.microsoft.Word,855,1741559202,1741560057,1741560057.578438,-18000,,
com.apple.Preview,16,1741559186,1741559202,1741559202.197887,-18000,,
com.apple.finder,4,1741559182,1741559186,1741559186.5354009,-18000,,
com.microsoft.Word,107,1741559075,1741559182,1741559182.852438,-18000,,
com.apple.finder,26,1741559049,1741559075,1741559075.244442,-18000,,
com.microsoft.Word,153,1741558896,1741559049,1741559049.654729,-18000,,
com.apple.finder,9,1741558887,1741558896,1741558897.056409,-18000,,
com.microsoft.Word,298,1741558589,1741558887,1741558888.021198,-18000,,
com.apple.finder,1,1741558588,1741558589,1741558589.788199,-18000,,
com.microsoft.Word,4,1741558584,1741558588,1741558588.120947,-18000,,
com.apple.finder,34,1741558550,1741558584,1741558584.702735,-18000,,
com.microsoft.Word,95,1741558455,1741558550,1741558550.320051,-18000,,
com.leomehlig.today,17,1741558438,1741558455,1741558456.069151,-18000,,
com.microsoft.Word,298,1741558140,1741558438,1741558438.98283,-18000,,
com.apple.Preview,39,1741558101,1741558140,1741558140.035049,-18000,,
com.microsoft.Word,57,1741558044,1741558101,1741558101.2559729,-18000,,
com.apple.Preview,10,1741558034,1741558044,1741558044.192635,-18000,,
com.microsoft.Word,85,1741557949,1741558034,1741558034.457053,-18000,,
com.apple.finder,2,1741557947,1741557949,1741557949.568744,-18000,,
com.microsoft.Word,4,1741557943,1741557947,1741557947.7222939,-18000,,
com.apple.finder,29,1741557914,1741557943,1741557943.149307,-18000,,
com.apple.Preview,80,1741557834,1741557914,1741557914.727855,-18000,,
com.microsoft.Word,45,1741557789,1741557834,1741557834.984558,-18000,,
com.google.Chrome,73,1741557716,1741557789,1741557789.356272,-18000,,
com.microsoft.Word,3,1741557713,1741557716,1741557716.2604442,-18000,,
com.google.Chrome,13,1741557700,1741557713,1741557713.6381211,-18000,,
com.microsoft.Word,6,1741557694,1741557700,1741557700.3368301,-18000,,
com.google.Chrome,8,1741557686,1741557694,1741557694.76406,-18000,,
com.microsoft.Word,19,1741557667,1741557686,1741557686.4721851,-18000,,
com.apple.Preview,32,1741557635,1741557667,1741557667.134062,-18000,,
com.apple.finder,1,1741557634,1741557635,1741557635.289485,-18000,,
com.apple.Preview,5,1741557629,1741557634,1741557634.970941,-18000,,
com.microsoft.Word,50,1741557579,1741557629,1741557629.615107,-18000,,
com.google.Chrome,36,1741557543,1741557579,1741557580.050153,-18000,,
com.microsoft.Word,7,1741557536,1741557543,1741557543.668127,-18000,,
com.google.Chrome,1,1741557535,1741557536,1741557536.88278,-18000,,
com.microsoft.Word,9,1741557526,1741557535,1741557535.861815,-18000,,
com.google.Chrome,3,1741557523,1741557526,1741557526.977592,-18000,,
com.microsoft.Word,9,1741557514,1741557523,1741557523.3377008,-18000,,
com.google.Chrome,0,1741557514,1741557514,1741557514.6640239,-18000,,
com.microsoft.Word,7,1741557507,1741557514,1741557514.08214,-18000,,
com.google.Chrome,2,1741557505,1741557507,1741557507.183988,-18000,,
com.microsoft.Word,13,1741557492,1741557505,1741557505.311644,-18000,,
com.google.Chrome,1,1741557491,1741557492,1741557493.1175199,-18000,,
com.microsoft.Word,8,1741557483,1741557491,1741557491.561473,-18000,,
com.google.Chrome,0,1741557483,1741557483,1741557483.8377972,-18000,,
com.microsoft.Word,6,1741557477,1741557483,1741557483.464102,-18000,,
com.google.Chrome,44,1741557433,1741557477,1741557477.291304,-18000,,
com.microsoft.Word,1,1741557432,1741557433,1741557433.102779,-18000,,
com.apple.Preview,0,1741557432,1741557432,1741557432.408382,-18000,,
com.microsoft.Word,22,1741557410,1741557432,1741557432.110845,-18000,,
com.apple.finder,1,1741557409,1741557410,1741557410.943712,-18000,,
com.apple.Preview,1,1741557408,1741557409,1741557409.709103,-18000,,
com.google.Chrome,148,1741557260,1741557408,1741557408.900347,-18000,,
com.apple.Preview,100,1741557160,1741557260,1741557260.359525,-18000,,
com.apple.finder,6,1741557154,1741557160,1741557160.468027,-18000,,
com.google.Chrome,10,1741557144,1741557154,1741557154.626618,-18000,,
com.microsoft.Word,7,1741557137,1741557144,1741557144.608614,-18000,,
com.google.Chrome,56,1741557081,1741557137,1741557138.0354118,-18000,,
com.microsoft.Word,88,1741556993,1741557081,1741557081.1501,-18000,,
com.apple.Preview,10,1741556983,1741556993,1741556993.260407,-18000,,
com.apple.finder,3,1741556980,1741556983,1741556983.8596702,-18000,,
com.apple.Preview,3,1741556977,1741556980,1741556980.641557,-18000,,
com.apple.finder,2,1741556975,1741556977,1741556977.732051,-18000,,
com.microsoft.Word,7,1741556968,1741556975,1741556975.546788,-18000,,
com.apple.finder,8,1741556960,1741556968,1741556968.7303329,-18000,,
com.google.Chrome,199,1741556761,1741556960,1741556960.267462,-18000,,
com.leomehlig.today,41,1741556720,1741556761,1741556761.426643,-18000,,
com.google.Chrome,66,1741556654,1741556720,1741556720.184482,-18000,,
com.microsoft.VSCode,15,1741556639,1741556654,1741556654.838732,-18000,,
com.google.Chrome,67,1741556572,1741556639,1741556639.7134662,-18000,,
com.microsoft.VSCode,14,1741556558,1741556572,1741556572.353149,-18000,,
com.google.Chrome,243,1741556315,1741556558,1741556558.860795,-18000,,
com.microsoft.VSCode,4,1741556311,1741556315,1741556315.214267,-18000,,
com.google.Chrome,22,1741556289,1741556311,1741556311.549689,-18000,,
com.microsoft.VSCode,27,1741556262,1741556289,1741556289.0690532,-18000,,
com.google.Chrome,16,1741556246,1741556262,1741556262.883193,-18000,,
com.microsoft.VSCode,93,1741556153,1741556246,1741556246.36221,-18000,,
com.google.Chrome,29,1741556124,1741556153,1741556154.03847,-18000,,
com.microsoft.VSCode,173,1741555951,1741556124,1741556124.337954,-18000,,
com.google.Chrome,2,1741555949,1741555951,1741555951.860456,-18000,,
com.microsoft.VSCode,15,1741555934,1741555949,1741555949.33772,-18000,,
com.google.Chrome,4,1741555930,1741555934,1741555934.051179,-18000,,
com.microsoft.VSCode,16,1741555914,1741555930,1741555931.010003,-18000,,
com.google.Chrome,3,1741555911,1741555914,1741555914.8516412,-18000,,
com.microsoft.VSCode,29,1741555882,1741555911,1741555911.967129,-18000,,
com.google.Chrome,7,1741555875,1741555882,1741555882.408184,-18000,,
com.microsoft.VSCode,312,1741555563,1741555875,1741555875.692683,-18000,,
com.google.Chrome,9,1741555554,1741555563,1741555563.411147,-18000,,
com.microsoft.VSCode,5,1741555549,1741555554,1741555554.17585,-18000,,
com.google.Chrome,32,1741555517,1741555549,1741555549.1145859,-18000,,
com.microsoft.VSCode,7,1741555510,1741555517,1741555517.810827,-18000,,
com.google.Chrome,10,1741555500,1741555510,1741555510.791226,-18000,,
com.microsoft.VSCode,121,1741555379,1741555500,1741555500.123276,-18000,,
com.google.Chrome,1,1741555378,1741555379,1741555379.8226218,-18000,,
com.microsoft.VSCode,15,1741555363,1741555378,1741555378.287267,-18000,,
com.google.Chrome,21,1741555342,1741555363,1741555364.060096,-18000,,
com.microsoft.VSCode,76,1741555266,1741555342,1741555342.7513828,-18000,,
com.apple.finder,31,1741555235,1741555266,1741555266.9796572,-18000,,
com.microsoft.VSCode,163,1741555072,1741555235,1741555235.159243,-18000,,
com.google.Chrome,8,1741555064,1741555072,1741555072.203207,-18000,,
com.microsoft.VSCode,3,1741555061,1741555064,1741555065.039129,-18000,,
com.google.Chrome,56,1741555005,1741555061,1741555061.760463,-18000,,
com.microsoft.VSCode,26,1741554979,1741555005,1741555005.125,-18000,,
com.google.Chrome,287,1741554692,1741554979,1741554979.767218,-18000,,
com.apple.mail,2,1741554690,1741554692,1741554692.5224462,-18000,,
com.google.Chrome,20,1741554670,1741554690,1741554690.2401009,-18000,,
com.microsoft.VSCode,162,1741554508,1741554670,1741554670.5348349,-18000,,
com.apple.finder,40,1741554468,1741554508,1741554508.7979689,-18000,,
com.microsoft.VSCode,101,1741554367,1741554468,1741554468.88377,-18000,,
com.apple.finder,2,1741554365,1741554367,1741554367.499794,-18000,,
com.microsoft.VSCode,1,1741554364,1741554365,1741554365.8330312,-18000,,
com.apple.finder,3,1741554361,1741554364,1741554364.359484,-18000,,
com.microsoft.VSCode,2,1741554359,1741554361,1741554362.0166988,-18000,,
com.apple.finder,4,1741554355,1741554359,1741554359.7648711,-18000,,
com.microsoft.VSCode,1,1741554354,1741554355,1741554355.274212,-18000,,
com.apple.finder,2,1741554352,1741554354,1741554354.0826259,-18000,,
com.microsoft.VSCode,2,1741554350,1741554352,1741554352.9483929,-18000,,
com.apple.finder,228,1741554122,1741554350,1741554350.0876641,-18000,,
com.microsoft.VSCode,611,1741553511,1741554122,1741554122.828232,-18000,,
com.apple.finder,6,1741553505,1741553511,1741553511.828846,-18000,,
com.microsoft.Word,191,1741553314,1741553505,1741553505.787616,-18000,,
com.apple.finder,47,1741553267,1741553314,1741553314.7654219,-18000,,
com.apple.Preview,30,1741553237,1741553267,1741553267.607275,-18000,,
com.apple.finder,7,1741553230,1741553237,1741553237.665145,-18000,,
com.google.Chrome,57,1741553173,1741553230,1741553230.858578,-18000,,
com.apple.finder,3,1741553140,1741553143,1741553143.134131,-18000,,
com.apple.mobilephone,5,1741553117,1741553122,1741553122.268924,-18000,EB445137-D7F5-57EC-87DA-1DB460D64046,"iPhone13,2"
com.apple.mobilecal,1,1741553115,1741553116,1741553116.956152,-18000,EB445137-D7F5-57EC-87DA-1DB460D64046,"iPhone13,2"
com.leomehlig.today,48,1741553092,1741553140,1741553140.989809,-18000,,
com.apple.finder,1,1741553091,1741553092,1741553092.7203422,-18000,,
com.microsoft.VSCode,2,1741553089,1741553091,1741553091.900214,-18000,,
com.apple.finder,5,1741553084,1741553089,1741553090.029657,-18000,,
us.zoom.xos,9,1741553075,1741553084,1741553084.768629,-18000,,
com.apple.mobilecal,1,1741552878,1741552879,1741552879.875315,-18000,EB445137-D7F5-57EC-87DA-1DB460D64046,"iPhone13,2"
com.apple.InCallService,1,1741552877,1741552878,1741552878.171067,-18000,EB445137-D7F5-57EC-87DA-1DB460D64046,"iPhone13,2"
com.apple.InCallService,128,1741552179,1741552307,1741552307.399111,-18000,EB445137-D7F5-57EC-87DA-1DB460D64046,"iPhone13,2"
com.apple.mobilecal,16,1741552163,1741552179,1741552179.7494621,-18000,EB445137-D7F5-57EC-87DA-1DB460D64046,"iPhone13,2"
com.microsoft.onenote,56,1741550434,1741550490,1741550490.371695,-18000,EB445137-D7F5-57EC-87DA-1DB460D64046,"iPhone13,2"
com.apple.MobileSMS,3,1741550431,1741550434,1741550434.203026,-18000,EB445137-D7F5-57EC-87DA-1DB460D64046,"iPhone13,2"
us.zoom.xos,0,1741549987,1741549987,1741549987.909394,-18000,,
com.leomehlig.today,8,1741549979,1741549987,1741549987.050787,-18000,,
com.google.Chrome,2,1741549977,1741549979,1741549979.865216,-18000,,
us.zoom.xos,1,1741549976,1741549977,1741549977.322175,-18000,,
com.apple.MobileSMS,2,1741549974,1741549976,1741549976.262469,-18000,,
us.zoom.xos,5,1741549969,1741549974,1741549975.001945,-18000,,
com.apple.MobileSMS,156,1741549571,1741549727,1741549727.5210629,-18000,EB445137-D7F5-57EC-87DA-1DB460D64046,"iPhone13,2"
us.zoom.xos,332,1741549537,1741549869,1741549869.543929,-18000,,
com.apple.MobileSMS,11,1741549526,1741549537,1741549537.8592172,-18000,,
us.zoom.xos,20,1741549506,1741549526,1741549526.162342,-18000,,
com.apple.MobileSMS,2,1741549504,1741549506,1741549506.165087,-18000,,
us.zoom.xos,3,1741549501,1741549504,1741549504.866708,-18000,,
com.google.Chrome,2,1741549499,1741549501,1741549501.127419,-18000,,
us.zoom.xos,2,1741549497,1741549499,1741549499.907902,-18000,,
com.google.Chrome,1,1741549496,1741549497,1741549497.601386,-18000,,
com.apple.MobileSMS,3,1741549493,1741549496,1741549496.420634,-18000,,
us.zoom.xos,10,1741549483,1741549493,1741549493.258385,-18000,,
com.apple.MobileSMS,0,1741549483,1741549483,1741549483.6771588,-18000,,
us.zoom.xos,2,1741549481,1741549483,1741549483.135155,-18000,,
com.apple.MobileSMS,2,1741549479,1741549481,1741549481.668106,-18000,,
com.microsoft.onenote,122,1741549449,1741549571,1741549571.3399,-18000,EB445137-D7F5-57EC-87DA-1DB460D64046,"iPhone13,2"
com.toyopagroup.picaboo,3,1741549438,1741549441,1741549441.263739,-18000,EB445137-D7F5-57EC-87DA-1DB460D64046,"iPhone13,2"
com.apple.MobileSMS,0,1741549438,1741549438,1741549439.300458,-18000,EB445137-D7F5-57EC-87DA-1DB460D64046,"iPhone13,2"
us.zoom.xos,48,1741549431,1741549479,1741549480.026016,-18000,,
com.google.Chrome,2,1741549429,1741549431,1741549431.486635,-18000,,
us.zoom.xos,1,1741549428,1741549429,1741549429.280467,-18000,,
com.google.Chrome,2,1741549426,1741549428,1741549428.1830668,-18000,,
com.apple.MobileSMS,2,1741549424,1741549426,1741549426.611315,-18000,,
com.google.Chrome,1,1741549423,1741549424,1741549424.5651379,-18000,,
com.apple.FaceTime,6,1741549417,1741549423,1741549423.951923,-18000,,
com.google.Chrome,3,1741549414,1741549417,1741549419.710349,-18000,,
com.apple.FaceTime,7,1741549407,1741549414,1741549415.596937,-18000,,
com.apple.DeskCam,1,1741549406,1741549407,1741549407.5214791,-18000,,
com.apple.FaceTime,1,1741549405,1741549406,1741549406.434569,-18000,,
com.apple.DeskCam,8,1741549397,1741549405,1741549405.693159,-18000,,
com.apple.MobileSMS,8,1741549381,1741549389,1741549389.547419,-18000,EB445137-D7F5-57EC-87DA-1DB460D64046,"iPhone13,2"
com.apple.FaceTime,30,1741549367,1741549397,1741549397.9970589,-18000,,
com.leomehlig.today,6,1741549361,1741549367,1741549367.9950151,-18000,,
com.apple.InCallService,25,1741549356,1741549381,1741549381.8368402,-18000,EB445137-D7F5-57EC-87DA-1DB460D64046,"iPhone13,2"
com.apple.MobileSMS,4,1741549352,1741549356,1741549356.5675712,-18000,EB445137-D7F5-57EC-87DA-1DB460D64046,"iPhone13,2"
com.apple.MobileSMS,19,1741549286,1741549305,1741549305.331902,-18000,EB445137-D7F5-57EC-87DA-1DB460D64046,"iPhone13,2"
com.microsoft.onenote,41,1741549245,1741549286,1741549286.8041282,-18000,EB445137-D7F5-57EC-87DA-1DB460D64046,"iPhone13,2"
com.toyopagroup.picaboo,2,1741549238,1741549240,1741549240.5157862,-18000,EB445137-D7F5-57EC-87DA-1DB460D64046,"iPhone13,2"
com.leomehlig.today,5,1741549174,1741549179,1741549179.783828,-18000,,
com.google.Chrome,3,1741549135,1741549138,1741549138.877212,-18000,,
us.zoom.xos,28,1741549107,1741549135,1741549135.771555,-18000,,
us.zoom.xos,300,1741548610,1741548910,1741548910.0957608,-18000,,
com.google.Chrome,10,1741548600,1741548610,1741548610.116638,-18000,,
us.zoom.xos,4,1741548596,1741548600,1741548600.441074,-18000,,
com.google.Chrome,5,1741548591,1741548596,1741548596.273529,-18000,,
us.zoom.xos,6,1741548585,1741548591,1741548591.489942,-18000,,
com.apple.Notes,1,1741548584,1741548585,1741548585.794685,-18000,,
com.google.Chrome,18,1741548566,1741548584,1741548584.647896,-18000,,
com.apple.Notes,171,1741548395,1741548566,1741548566.355307,-18000,,
us.zoom.xos,7,1741548388,1741548395,1741548395.131291,-18000,,
com.apple.Notes,7,1741548381,1741548388,1741548388.59895,-18000,,
us.zoom.xos,0,1741548381,1741548381,1741548381.597147,-18000,,
com.apple.Notes,1,1741548380,1741548381,1741548381.1777,-18000,,
com.google.Chrome,1,1741548379,1741548380,1741548380.405798,-18000,,
us.zoom.xos,0,1741548379,1741548379,1741548379.6256971,-18000,,
com.google.Chrome,3,1741548376,1741548379,1741548379.312403,-18000,,
com.apple.Notes,0,1741548376,1741548376,1741548376.62367,-18000,,
com.google.Chrome,2,1741548374,1741548376,1741548376.253498,-18000,,
us.zoom.xos,45,1741548329,1741548374,1741548374.863796,-18000,,
com.google.Chrome,4,1741548325,1741548329,1741548329.2158198,-18000,,
com.apple.Notes,3,1741548322,1741548325,1741548325.541611,-18000,,
com.google.Chrome,1,1741548321,1741548322,1741548322.132858,-18000,,
com.apple.Notes,1,1741548320,1741548321,1741548321.806782,-18000,,
com.google.Chrome,2,1741548318,1741548320,1741548320.838712,-18000,,
com.apple.Notes,2,1741548316,1741548318,1741548319.028835,-18000,,
com.toyopagroup.picaboo,4,1741548115,1741548119,1741548119.565845,-18000,EB445137-D7F5-57EC-87DA-1DB460D64046,"iPhone13,2"
com.toyopagroup.picaboo,20,1741548094,1741548114,1741548114.250489,-18000,EB445137-D7F5-57EC-87DA-1DB460D64046,"iPhone13,2"
com.groupme.iphone-app,2,1741548092,1741548094,1741548094.217865,-18000,EB445137-D7F5-57EC-87DA-1DB460D64046,"iPhone13,2"
us.zoom.xos,277,1741548039,1741548316,1741548316.8630362,-18000,,
com.groupme.iphone-app,8,1741547170,1741547178,1741547178.515995,-18000,EB445137-D7F5-57EC-87DA-1DB460D64046,"iPhone13,2"
us.zoom.xos,353,1741547107,1741547460,1741547460.34848,-18000,,
com.apple.Notes,4,1741547103,1741547107,1741547107.303803,-18000,,
us.zoom.xos,66,1741547037,1741547103,1741547103.651721,-18000,,
com.apple.iCal,17,1741547020,1741547037,1741547037.379074,-18000,,
us.zoom.xos,170,1741546850,1741547020,1741547020.960312,-18000,,
com.google.Chrome,2,1741546848,1741546850,1741546850.042001,-18000,,
com.apple.MobileSMS,104,1741546744,1741546848,1741546848.3122292,-18000,,
com.apple.Notes,2,1741546742,1741546744,1741546744.561981,-18000,,
com.leomehlig.today,1,1741546741,1741546742,1741546742.487341,-18000,,
com.google.Chrome,5,1741546736,1741546741,1741546741.946546,-18000,,
com.leomehlig.today,23,1741546713,1741546736,1741546736.871018,-18000,,
com.google.Chrome,170,1741546543,1741546713,1741546713.763596,-18000,,
com.google.Chrome,425,1741545929,1741546354,1741546354.139221,-18000,,
com.myfitnesspal.mfp,86,1741545800,1741545886,1741545887.021319,-18000,EB445137-D7F5-57EC-87DA-1DB460D64046,"iPhone13,2"
com.google.chrome.ios,22,1741545778,1741545800,1741545801.081428,-18000,EB445137-D7F5-57EC-87DA-1DB460D64046,"iPhone13,2"
com.myfitnesspal.mfp,207,1741545571,1741545778,1741545778.21704,-18000,EB445137-D7F5-57EC-87DA-1DB460D64046,"iPhone13,2"
com.google.chrome.ios,2,1741545569,1741545571,1741545572.151516,-18000,EB445137-D7F5-57EC-87DA-1DB460D64046,"iPhone13,2"
com.google.Chrome,304,1741545499,1741545803,1741545803.927794,-18000,,
com.myfitnesspal.mfp,75,1741545494,1741545569,1741545569.885381,-18000,EB445137-D7F5-57EC-87DA-1DB460D64046,"iPhone13,2"
com.google.Chrome,350,1741545109,1741545459,1741545459.139618,-18000,,
com.apple.Notes,8,1741544907,1741544915,1741544915.815418,-18000,,
com.google.Chrome,120,1741544787,1741544907,1741544907.8223019,-18000,,
com.apple.Notes,10,1741544777,1741544787,1741544787.8442411,-18000,,
com.google.Chrome,2,1741544775,1741544777,1741544777.239249,-18000,,
com.apple.Notes,10,1741544765,1741544775,1741544775.275017,-18000,,
com.google.Chrome,150,1741544615,1741544765,1741544765.427326,-18000,,
com.apple.Notes,7,1741544608,1741544615,1741544615.1926131,-18000,,
com.google.Chrome,3,1741544605,1741544608,1741544608.208798,-18000,,
com.apple.Notes,2,1741544603,1741544605,1741544605.188101,-18000,,
com.google.Chrome,33,1741544570,1741544603,1741544603.964397,-18000,,
com.apple.Notes,22,1741544548,1741544570,1741544570.1884332,-18000,,
com.google.Chrome,0,1741544548,1741544548,1741544548.708222,-18000,,
com.apple.Notes,2,1741544546,1741544548,1741544548.195184,-18000,,
com.google.Chrome,321,1741544225,1741544546,1741544546.31357,-18000,,
com.apple.MobileSMS,7,1741544218,1741544225,1741544225.317354,-18000,,
com.google.Chrome,2,1741544216,1741544218,1741544218.5050468,-18000,,
com.apple.finder,12,1741544204,1741544216,1741544216.413341,-18000,,
com.apple.news,3,1741541942,1741541945,1741541945.934314,-18000,EB445137-D7F5-57EC-87DA-1DB460D64046,"iPhone13,2"
com.apple.news,127,1741541543,1741541670,1741541670.242245,-18000,EB445137-D7F5-57EC-87DA-1DB460D64046,"iPhone13,2"
com.apple.news,100,1741541404,1741541504,1741541504.9743152,-18000,EB445137-D7F5-57EC-87DA-1DB460D64046,"iPhone13,2"
com.apple.CoreAuthUI,2,1741541292,1741541294,1741541294.432611,-18000,EB445137-D7F5-57EC-87DA-1DB460D64046,"iPhone13,2"
com.discoverfinancial.mobile,63,1741541285,1741541348,1741541348.9087481,-18000,EB445137-D7F5-57EC-87DA-1DB460D64046,"iPhone13,2"
com.apple.CoreAuthUI,2,1741541260,1741541262,1741541262.419201,-18000,EB445137-D7F5-57EC-87DA-1DB460D64046,"iPhone13,2"
com.clairmail.fth.client,28,1741541255,1741541283,1741541283.70543,-18000,EB445137-D7F5-57EC-87DA-1DB460D64046,"iPhone13,2"
com.apple.calculator,5,1741541246,1741541251,1741541251.165234,-18000,EB445137-D7F5-57EC-87DA-1DB460D64046,"iPhone13,2"
com.truebill.truebillnative,2,1741541244,1741541246,1741541246.84031,-18000,EB445137-D7F5-57EC-87DA-1DB460D64046,"iPhone13,2"
com.apple.calculator,4,1741541240,1741541244,1741541244.9197001,-18000,EB445137-D7F5-57EC-87DA-1DB460D64046,"iPhone13,2"
com.truebill.truebillnative,2,1741541238,1741541240,1741541240.716745,-18000,EB445137-D7F5-57EC-87DA-1DB460D64046,"iPhone13,2"
com.apple.calculator,4,1741541234,1741541238,1741541238.1665092,-18000,EB445137-D7F5-57EC-87DA-1DB460D64046,"iPhone13,2"
com.truebill.truebillnative,37,1741541197,1741541234,1741541234.359806,-18000,EB445137-D7F5-57EC-87DA-1DB460D64046,"iPhone13,2"
com.apple.CoreAuthUI,2,1741541041,1741541043,1741541043.288825,-18000,EB445137-D7F5-57EC-87DA-1DB460D64046,"iPhone13,2"
com.truebill.truebillnative,10,1741541037,1741541047,1741541047.61133,-18000,EB445137-D7F5-57EC-87DA-1DB460D64046,"iPhone13,2"
com.apple.news,56,1741540957,1741541013,1741541013.829255,-18000,EB445137-D7F5-57EC-87DA-1DB460D64046,"iPhone13,2"
com.apple.news,4,1741540951,1741540955,1741540955.868493,-18000,EB445137-D7F5-57EC-87DA-1DB460D64046,"iPhone13,2"
com.groupme.iphone-app,3,1741540942,1741540945,1741540945.13597,-18000,EB445137-D7F5-57EC-87DA-1DB460D64046,"iPhone13,2"
com.apple.news,0,1741540942,1741540942,1741540943.351347,-18000,EB445137-D7F5-57EC-87DA-1DB460D64046,"iPhone13,2"
com.apple.news,15,1741540878,1741540893,1741540893.975482,-18000,EB445137-D7F5-57EC-87DA-1DB460D64046,"iPhone13,2"
com.groupme.iphone-app,6,1741540872,1741540878,1741540878.364548,-18000,EB445137-D7F5-57EC-87DA-1DB460D64046,"iPhone13,2"
com.apple.news,80,1741540792,1741540872,1741540872.425424,-18000,EB445137-D7F5-57EC-87DA-1DB460D64046,"iPhone13,2"
com.apple.news,62,1741540728,1741540790,1741540790.93087,-18000,EB445137-D7F5-57EC-87DA-1DB460D64046,"iPhone13,2"
com.groupme.iphone-app,11,1741540717,1741540728,1741540728.686016,-18000,EB445137-D7F5-57EC-87DA-1DB460D64046,"iPhone13,2"
com.apple.news,84,1741540633,1741540717,1741540717.816032,-18000,EB445137-D7F5-57EC-87DA-1DB460D64046,"iPhone13,2"
com.apple.weather,4,1741540604,1741540608,1741540608.3307838,-18000,EB445137-D7F5-57EC-87DA-1DB460D64046,"iPhone13,2"
com.apple.weather,75,1741539369,1741539444,1741539444.6502562,-18000,EB445137-D7F5-57EC-87DA-1DB460D64046,"iPhone13,2"
com.apple.MobileSMS,2,1741539367,1741539369,1741539369.362273,-18000,EB445137-D7F5-57EC-87DA-1DB460D64046,"iPhone13,2"
com.apple.MobileSMS,2,1741539317,1741539319,1741539319.283988,-18000,EB445137-D7F5-57EC-87DA-1DB460D64046,"iPhone13,2"
com.apple.finder,7,1741539301,1741539308,1741539308.563951,-18000,,
com.leomehlig.today,1,1741539300,1741539301,1741539301.12432,-18000,,
com.google.Chrome,45,1741539255,1741539300,1741539300.104014,-18000,,
com.leomehlig.today,34,1741539210,1741539244,1741539244.4833698,-18000,,
com.apple.Notes,6,1741539204,1741539210,1741539210.822822,-18000,,
com.leomehlig.today,39,1741539165,1741539204,1741539204.863955,-18000,,
com.microsoft.VSCode,108,1741539057,1741539165,1741539165.7037668,-18000,,
com.apple.finder,9,1741539048,1741539057,1741539057.381299,-18000,,
com.microsoft.VSCode,23,1741539025,1741539048,1741539048.913018,-18000,,
com.apple.finder,5,1741539020,1741539025,1741539025.825429,-18000,,
com.microsoft.VSCode,227,1741538793,1741539020,1741539020.549036,-18000,,
com.apple.finder,24,1741538769,1741538793,1741538793.807754,-18000,,
com.apple.MobileSMS,1,1741538768,1741538769,1741538769.9193501,-18000,,
com.apple.finder,1,1741538767,1741538768,1741538768.687403,-18000,,
com.apple.MobileSMS,10,1741538757,1741538767,1741538767.63534,-18000,,
com.apple.finder,26,1741538731,1741538757,1741538757.3669991,-18000,,
com.microsoft.VSCode,3,1741538728,1741538731,1741538731.44797,-18000,,
com.apple.finder,29,1741538699,1741538728,1741538728.5809321,-18000,,
com.microsoft.VSCode,1,1741538698,1741538699,1741538699.834752,-18000,,
com.leomehlig.today,109,1741538589,1741538698,1741538698.7877269,-18000,,
com.apple.MobileSMS,130,1741538559,1741538689,1741538689.659661,-18000,EB445137-D7F5-57EC-87DA-1DB460D64046,"iPhone13,2"
com.apple.finder,137,1741538452,1741538589,1741538589.3909888,-18000,,
com.microsoft.VSCode,31,1741538421,1741538452,1741538452.097224,-18000,,
com.apple.finder,51,1741538370,1741538421,1741538421.678474,-18000,,
com.microsoft.VSCode,2,1741538368,1741538370,1741538370.4564052,-18000,,
com.google.Chrome,22,1741538346,1741538368,1741538368.741926,-18000,,
com.microsoft.VSCode,1,1741538345,1741538346,1741538346.2053509,-18000,,
com.apple.finder,29,1741538316,1741538345,1741538345.483217,-18000,,
com.microsoft.VSCode,24,1741538292,1741538316,1741538316.079156,-18000,,
com.apple.finder,13,1741538279,1741538292,1741538293.0323138,-18000,,
com.google.Chrome,1,1741538278,1741538279,1741538279.495563,-18000,,
com.microsoft.VSCode,59,1741538219,1741538278,1741538278.521503,-18000,,
com.google.Chrome,2,1741538217,1741538219,1741538219.62,-18000,,
com.microsoft.VSCode,3,1741538214,1741538217,1741538217.927593,-18000,,
com.google.Chrome,21,1741538193,1741538214,1741538214.738692,-18000,,
com.microsoft.VSCode,9,1741538184,1741538193,1741538193.065361,-18000,,
com.google.Chrome,25,1741538159,1741538184,1741538184.081297,-18000,,
com.microsoft.VSCode,34,1741538125,1741538159,1741538159.436517,-18000,,
com.apple.finder,12,1741538113,1741538125,1741538125.4902291,-18000,,
com.google.ios.youtube,225,1741537846,1741538071,1741538071.9580212,-18000,EB445137-D7F5-57EC-87DA-1DB460D64046,"iPhone13,2"
com.google.ios.youtube,25,1741537820,1741537845,1741537845.667863,-18000,EB445137-D7F5-57EC-87DA-1DB460D64046,"iPhone13,2"
com.apple.news,2,1741537798,1741537800,1741537800.451257,-18000,EB445137-D7F5-57EC-87DA-1DB460D64046,"iPhone13,2"
com.apple.finder,327,1741536804,1741537131,1741537131.10635,-18000,,
com.microsoft.VSCode,44,1741536760,1741536804,1741536804.769145,-18000,,
com.apple.finder,1,1741536759,1741536760,1741536760.899603,-18000,,
com.microsoft.VSCode,103,1741536656,1741536759,1741536759.803664,-18000,,
com.apple.finder,26,1741536630,1741536656,1741536656.105865,-18000,,
com.microsoft.VSCode,14,1741536616,1741536630,1741536630.5402179,-18000,,
com.apple.finder,31,1741536585,1741536616,1741536616.394494,-18000,,
com.microsoft.VSCode,81,1741536504,1741536585,1741536585.242125,-18000,,
com.apple.finder,6,1741536498,1741536504,1741536504.9752378,-18000,,
com.microsoft.VSCode,105,1741536393,1741536498,1741536498.188546,-18000,,
com.apple.finder,17,1741536376,1741536393,1741536393.2079759,-18000,,
com.microsoft.VSCode,95,1741536281,1741536376,1741536376.274559,-18000,,
com.apple.finder,1,1741536280,1741536281,1741536281.768108,-18000,,
com.microsoft.VSCode,10,1741536270,1741536280,1741536280.495244,-18000,,
com.apple.finder,36,1741536234,1741536270,1741536270.4382272,-18000,,
com.microsoft.VSCode,580,1741535654,1741536234,1741536234.984487,-18000,,
com.apple.finder,14,1741535640,1741535654,1741535654.821887,-18000,,
com.microsoft.VSCode,6,1741535634,1741535640,1741535640.6922941,-18000,,
com.apple.finder,46,1741535588,1741535634,1741535634.9812698,-18000,,
com.microsoft.VSCode,34,1741535554,1741535588,1741535588.40786,-18000,,
com.apple.finder,4,1741535550,1741535554,1741535554.657,-18000,,
com.microsoft.VSCode,16,1741535534,1741535550,1741535550.991097,-18000,,
com.apple.finder,22,1741535512,1741535534,1741535534.1424809,-18000,,
com.microsoft.VSCode,754,1741534758,1741535512,1741535512.830885,-18000,,
com.google.Chrome,3,1741534755,1741534758,1741534758.2481132,-18000,,
com.microsoft.VSCode,29,1741534726,1741534755,1741534755.942584,-18000,,
com.google.Chrome,6,1741534720,1741534726,1741534726.36883,-18000,,
com.microsoft.VSCode,12,1741534708,1741534720,1741534720.863136,-18000,,
com.google.Chrome,15,1741534693,1741534708,1741534708.722466,-18000,,
com.microsoft.VSCode,15,1741534678,1741534693,1741534693.922569,-18000,,
com.google.Chrome,5,1741534673,1741534678,1741534678.5189528,-18000,,
com.microsoft.VSCode,3,1741534670,1741534673,1741534673.9242082,-18000,,
com.google.Chrome,19,1741534651,1741534670,1741534670.4661589,-18000,,
com.microsoft.VSCode,2,1741534649,1741534651,1741534651.968738,-18000,,
com.google.Chrome,2,1741534647,1741534649,1741534649.845969,-18000,,
com.microsoft.VSCode,26,1741534621,1741534647,1741534647.637502,-18000,,
com.google.Chrome,15,1741534606,1741534621,1741534621.278829,-18000,,
com.microsoft.VSCode,4,1741534602,1741534606,1741534606.580289,-18000,,
com.google.Chrome,6,1741534596,1741534602,1741534602.923516,-18000,,
com.microsoft.VSCode,7,1741534589,1741534596,1741534596.848153,-18000,,
com.google.Chrome,2,1741534587,1741534589,1741534589.0832958,-18000,,
com.microsoft.VSCode,2,1741534585,1741534587,1741534587.16953,-18000,,
com.google.Chrome,15,1741534570,1741534585,1741534585.291273,-18000,,
com.microsoft.VSCode,4,1741534566,1741534570,1741534570.112752,-18000,,
com.google.Chrome,6,1741534560,1741534566,1741534566.0903702,-18000,,
com.microsoft.VSCode,5,1741534555,1741534560,1741534560.875341,-18000,,
com.google.Chrome,3,1741534552,1741534555,1741534555.981707,-18000,,
com.microsoft.VSCode,5,1741534547,1741534552,1741534552.395652,-18000,,
com.google.Chrome,9,1741534538,1741534547,1741534547.207829,-18000,,
com.microsoft.VSCode,17,1741534521,1741534538,1741534538.965613,-18000,,
com.google.Chrome,20,1741534501,1741534521,1741534521.8948488,-18000,,
com.microsoft.VSCode,10,1741534491,1741534501,1741534501.123263,-18000,,
com.google.Chrome,0,1741534491,1741534491,1741534491.913686,-18000,,
com.microsoft.VSCode,3,1741534488,1741534491,1741534491.269466,-18000,,
com.google.Chrome,24,1741534464,1741534488,1741534488.852848,-18000,,
com.microsoft.VSCode,2,1741534462,1741534464,1741534464.920614,-18000,,
com.google.Chrome,3,1741534459,1741534462,1741534462.2893128,-18000,,
com.microsoft.VSCode,25,1741534434,1741534459,1741534459.709446,-18000,,
com.google.Chrome,10,1741534424,1741534434,1741534434.267675,-18000,,
com.microsoft.VSCode,106,1741534318,1741534424,1741534424.934345,-18000,,
com.google.Chrome,17,1741534301,1741534318,1741534318.35042,-18000,,
com.microsoft.VSCode,1,1741534300,1741534301,1741534313.058442,-18000,,
com.google.Chrome,3,1741534297,1741534300,1741534310.672739,-18000,,
com.microsoft.VSCode,15,1741534294,1741534309,1741534309.849701,-18000,,
com.microsoft.VSCode,14,1741534275,1741534289,1741534297.614812,-18000,,
com.apple.finder,0,1741534275,1741534275,1741534293.8448238,-18000,,
com.microsoft.VSCode,13,1741534262,1741534275,1741534292.888562,-18000,,
com.apple.news,76,1741534155,1741534231,1741534231.613641,-18000,EB445137-D7F5-57EC-87DA-1DB460D64046,"iPhone13,2"
com.apple.Health,9,1741534135,1741534144,1741534144.2753348,-18000,EB445137-D7F5-57EC-87DA-1DB460D64046,"iPhone13,2"
com.groupme.iphone-app,9,1741534123,1741534132,1741534132.390161,-18000,EB445137-D7F5-57EC-87DA-1DB460D64046,"iPhone13,2"
com.renpho.health,1,1741534122,1741534123,1741534123.778014,-18000,EB445137-D7F5-57EC-87DA-1DB460D64046,"iPhone13,2"
com.apple.finder,5,1741534114,1741534119,1741534120.580126,-18000,,
com.google.Chrome,0,1741534114,1741534114,1741534115.017887,-18000,,
com.microsoft.VSCode,23,1741534091,1741534114,1741534114.6894832,-18000,,
com.google.Chrome,2,1741534089,1741534091,1741534091.32571,-18000,,
com.microsoft.VSCode,33,1741534056,1741534089,1741534090.312583,-18000,,
com.google.Chrome,2,1741534054,1741534056,1741534056.7494211,-18000,,
com.microsoft.VSCode,1,1741534053,1741534054,1741534054.413989,-18000,,
com.google.Chrome,19,1741534034,1741534053,1741534053.453928,-18000,,
com.microsoft.VSCode,8,1741534026,1741534034,1741534034.863752,-18000,,
com.google.Chrome,78,1741533948,1741534026,1741534026.763801,-18000,,
com.microsoft.VSCode,21,1741533927,1741533948,1741533948.639869,-18000,,
com.apple.finder,2,1741533925,1741533927,1741533927.733684,-18000,,
com.microsoft.VSCode,54,1741533871,1741533925,1741533925.213527,-18000,,
com.google.Chrome,1,1741533870,1741533871,1741533871.078547,-18000,,
com.microsoft.VSCode,1,1741533869,1741533870,1741533870.312447,-18000,,
com.google.Chrome,38,1741533831,1741533869,1741533869.760052,-18000,,
com.microsoft.VSCode,755,1741533076,1741533831,1741533831.1722012,-18000,,
com.apple.finder,8,1741533068,1741533076,1741533076.3339171,-18000,,
com.renpho.health,93,1741531378,1741531471,1741531471.664573,-18000,EB445137-D7F5-57EC-87DA-1DB460D64046,"iPhone13,2"
com.google.ios.youtube,1521,1741528394,1741529915,1741529915.356611,-18000,EB445137-D7F5-57EC-87DA-1DB460D64046,"iPhone13,2"
com.apple.CoreAuthUI,2,1741504607,1741504609,1741504609.209717,-21600,EB445137-D7F5-57EC-87DA-1DB460D64046,"iPhone13,2"
com.robinhood.release.Robinhood,62,1741504594,1741504656,1741504656.35237,-21600,EB445137-D7F5-57EC-87DA-1DB460D64046,"iPhone13,2"
com.instructure.icanvas,6,1741504585,1741504591,1741504591.589929,-21600,EB445137-D7F5-57EC-87DA-1DB460D64046,"iPhone13,2"
com.google.ios.youtube,840,1741503744,1741504584,1741504584.982635,-21600,EB445137-D7F5-57EC-87DA-1DB460D64046,"iPhone13,2"
com.apple.finder,31,1741502654,1741502685,1741502685.954517,-21600,,
com.google.Chrome,4,1741502650,1741502654,1741502654.134443,-21600,,
com.apple.finder,3,1741502647,1741502650,1741502650.981618,-21600,,
com.apple.Music,35,1741502612,1741502647,1741502647.212531,-21600,,
com.microsoft.VSCode,284,1741502328,1741502612,1741502612.578407,-21600,,
com.apple.Music,2,1741502326,1741502328,1741502328.830586,-21600,,
com.leomehlig.today,51,1741502275,1741502326,1741502326.649251,-21600,,
com.apple.Music,115,1741502160,1741502275,1741502275.89916,-21600,,
com.apple.finder,2,1741502158,1741502160,1741502160.357764,-21600,,
com.apple.Music,2,1741502156,1741502158,1741502158.0780048,-21600,,
com.apple.Music,3,1741502137,1741502140,1741502141.172164,-21600,EB445137-D7F5-57EC-87DA-1DB460D64046,"iPhone13,2"
com.apple.finder,32,1741502124,1741502156,1741502156.72592,-21600,,
com.microsoft.VSCode,192,1741501932,1741502124,1741502125.740941,-21600,,
com.apple.finder,76,1741501856,1741501932,1741501932.686358,-21600,,
com.microsoft.VSCode,2,1741501854,1741501856,1741501856.225723,-21600,,
com.apple.finder,6,1741501848,1741501854,1741501854.5031161,-21600,,
com.microsoft.VSCode,8,1741501840,1741501848,1741501848.856992,-21600,,
com.apple.finder,17,1741501823,1741501840,1741501840.411216,-21600,,
com.microsoft.VSCode,89,1741501734,1741501823,1741501823.491293,-21600,,
com.apple.finder,199,1741501535,1741501734,1741501734.839931,-21600,,
com.microsoft.VSCode,14,1741501521,1741501535,1741501535.2472239,-21600,,
com.apple.finder,5,1741501516,1741501521,1741501521.511379,-21600,,
com.microsoft.VSCode,67,1741501449,1741501516,1741501516.491272,-21600,,
com.apple.finder,12,1741501437,1741501449,1741501449.0759401,-21600,,
com.microsoft.VSCode,3,1741501434,1741501437,1741501437.5682158,-21600,,
com.apple.finder,18,1741501416,1741501434,1741501434.631321,-21600,,
com.apple.Preview,4,1741501412,1741501416,1741501416.8647032,-21600,,
com.apple.finder,23,1741501389,1741501412,1741501412.831832,-21600,,
com.microsoft.VSCode,175,1741501214,1741501389,1741501389.043046,-21600,,
com.apple.finder,292,1741500922,1741501214,1741501214.9496632,-21600,,
com.microsoft.VSCode,2,1741500920,1741500922,1741500922.251791,-21600,,
com.apple.finder,36,1741500884,1741500920,1741500920.399436,-21600,,
com.microsoft.VSCode,7,1741500826,1741500833,1741500833.498555,-21600,,
com.apple.finder,2,1741500824,1741500826,1741500826.9142141,-21600,,
com.microsoft.VSCode,142,1741500682,1741500824,1741500824.046565,-21600,,
com.apple.finder,3,1741500679,1741500682,1741500682.475236,-21600,,
com.microsoft.VSCode,97,1741500582,1741500679,1741500679.411751,-21600,,
com.apple.finder,4,1741500578,1741500582,1741500582.187341,-21600,,
com.microsoft.VSCode,74,1741500504,1741500578,1741500578.808708,-21600,,
com.apple.finder,3,1741500501,1741500504,1741500505.013299,-21600,,
com.microsoft.VSCode,90,1741500411,1741500501,1741500501.958142,-21600,,
com.apple.finder,7,1741500404,1741500411,1741500411.439018,-21600,,
com.microsoft.VSCode,3,1741500401,1741500404,1741500404.31291,-21600,,
com.apple.finder,8,1741500393,1741500401,1741500401.834787,-21600,,
com.microsoft.VSCode,163,1741500230,1741500393,1741500393.861027,-21600,,
com.apple.Music,16,1741500214,1741500230,1741500231.042227,-21600,,
com.microsoft.VSCode,99,1741500115,1741500214,1741500214.758805,-21600,,
com.apple.finder,34,1741500081,1741500115,1741500115.6763349,-21600,,
com.microsoft.VSCode,32,1741500049,1741500081,1741500081.29302,-21600,,
com.apple.finder,11,1741500038,1741500049,1741500049.6398559,-21600,,
com.microsoft.VSCode,2,1741500036,1741500038,1741500038.8676171,-21600,,
com.apple.finder,13,1741500023,1741500036,1741500036.139552,-21600,,
com.microsoft.VSCode,11,1741500012,1741500023,1741500024.0236301,-21600,,
com.google.Chrome,1,1741500011,1741500012,1741500012.851675,-21600,,
com.microsoft.VSCode,1,1741500010,1741500011,1741500011.744101,-21600,,
com.google.Chrome,2,1741500008,1741500010,1741500010.48137,-21600,,
com.microsoft.VSCode,249,1741499759,1741500008,1741500008.3293672,-21600,,
com.google.Chrome,25,1741499734,1741499759,1741499759.6352801,-21600,,
com.microsoft.VSCode,61,1741499673,1741499734,1741499734.1408958,-21600,,
com.apple.Music,10,1741499663,1741499673,1741499673.783293,-21600,,
com.microsoft.VSCode,479,1741499184,1741499663,1741499663.767974,-21600,,
com.apple.finder,10,1741499174,1741499184,1741499184.1337729,-21600,,
com.microsoft.VSCode,2,1741499172,1741499174,1741499174.539562,-21600,,
com.apple.finder,6,1741499166,1741499172,1741499172.601831,-21600,,
com.microsoft.VSCode,17,1741499149,1741499166,1741499166.0565748,-21600,,
com.apple.finder,5,1741499144,1741499149,1741499149.301198,-21600,,
com.microsoft.VSCode,1,1741499143,1741499144,1741499144.522099,-21600,,
com.apple.finder,2,1741499141,1741499143,1741499143.4717488,-21600,,
com.microsoft.VSCode,6,1741499135,1741499141,1741499141.467403,-21600,,
com.google.Chrome,3,1741499132,1741499135,1741499136.008836,-21600,,
com.apple.Music,53,1741499079,1741499132,1741499132.445827,-21600,,
com.google.Chrome,10,1741499069,1741499079,1741499079.722209,-21600,,
com.apple.Music,15,1741499054,1741499069,1741499069.122871,-21600,,
com.google.Chrome,11,1741499043,1741499054,1741499054.084721,-21600,,
com.apple.Music,140,1741487993,1741488133,1741488133.6519651,-21600,EB445137-D7F5-57EC-87DA-1DB460D64046,"iPhone13,2"
com.google.chrome.ios,153,1741487836,1741487989,1741487989.53021,-21600,EB445137-D7F5-57EC-87DA-1DB460D64046,"iPhone13,2"
com.google.ios.youtube,4,1741487831,1741487835,1741487835.3477721,-21600,EB445137-D7F5-57EC-87DA-1DB460D64046,"iPhone13,2"
com.google.ios.youtube,215,1741487615,1741487830,1741487830.4810848,-21600,EB445137-D7F5-57EC-87DA-1DB460D64046,"iPhone13,2"
com.google.ios.youtube,1,1741487614,1741487615,1741487615.771593,-21600,EB445137-D7F5-57EC-87DA-1DB460D64046,"iPhone13,2"
com.google.ios.youtube,119,1741487476,1741487595,1741487595.2176208,-21600,EB445137-D7F5-57EC-87DA-1DB460D64046,"iPhone13,2"
com.google.chrome.ios,20,1741487454,1741487474,1741487474.168216,-21600,EB445137-D7F5-57EC-87DA-1DB460D64046,"iPhone13,2"
com.google.chrome.ios,3,1741487440,1741487443,1741487443.592185,-21600,EB445137-D7F5-57EC-87DA-1DB460D64046,"iPhone13,2"
com.google.chrome.ios,39,1741487391,1741487430,1741487430.917974,-21600,EB445137-D7F5-57EC-87DA-1DB460D64046,"iPhone13,2"
com.toyopagroup.picaboo,24,1741485712,1741485736,1741485736.74752,-21600,EB445137-D7F5-57EC-87DA-1DB460D64046,"iPhone13,2"
com.apple.MobileSMS,2,1741485707,1741485709,1741485709.65436,-21600,EB445137-D7F5-57EC-87DA-1DB460D64046,"iPhone13,2"
com.apple.findmy,13,1741485694,1741485707,1741485707.578027,-21600,EB445137-D7F5-57EC-87DA-1DB460D64046,"iPhone13,2"
com.toyopagroup.picaboo,38,1741484948,1741484986,1741484986.7188802,-21600,EB445137-D7F5-57EC-87DA-1DB460D64046,"iPhone13,2"
com.google.chrome.ios,56,1741484315,1741484371,1741484371.730853,-21600,EB445137-D7F5-57EC-87DA-1DB460D64046,"iPhone13,2"
com.google.Chrome,19,1741480791,1741480810,1741480810.7604399,-21600,,
com.apple.finder,2,1741480789,1741480791,1741480791.349822,-21600,,
com.apple.news,37,1741480259,1741480296,1741480296.725268,-21600,EB445137-D7F5-57EC-87DA-1DB460D64046,"iPhone13,2"
com.apple.MobileSMS,2,1741480252,1741480254,1741480254.083646,-21600,EB445137-D7F5-57EC-87DA-1DB460D64046,"iPhone13,2"
com.apple.mobileslideshow,0,1741480252,1741480252,1741480253.6366901,-21600,EB445137-D7F5-57EC-87DA-1DB460D64046,"iPhone13,2"
com.apple.mobileslideshow,120,1741478231,1741478351,1741478351.7369509,-21600,EB445137-D7F5-57EC-87DA-1DB460D64046,"iPhone13,2"
com.apple.mobileslideshow,68,1741478161,1741478229,1741478229.1373339,-21600,EB445137-D7F5-57EC-87DA-1DB460D64046,"iPhone13,2"
com.apple.MobileSMS,2,1741478130,1741478132,1741478133.058988,-21600,EB445137-D7F5-57EC-87DA-1DB460D64046,"iPhone13,2"
com.apple.MobileSMS,79,1741477866,1741477945,1741477945.384482,-21600,EB445137-D7F5-57EC-87DA-1DB460D64046,"iPhone13,2"
com.apple.Health,1,1741477865,1741477866,1741477867.126761,-21600,EB445137-D7F5-57EC-87DA-1DB460D64046,"iPhone13,2"
com.apple.Health,28,1741476271,1741476299,1741476300.087339,-21600,EB445137-D7F5-57EC-87DA-1DB460D64046,"iPhone13,2"
com.apple.Health,39,1741476221,1741476260,1741476260.194747,-21600,EB445137-D7F5-57EC-87DA-1DB460D64046,"iPhone13,2"
com.apple.MobileSMS,3,1741476217,1741476220,1741476220.499362,-21600,EB445137-D7F5-57EC-87DA-1DB460D64046,"iPhone13,2"
com.apple.MobileSMS,9,1741473058,1741473067,1741473067.265938,-21600,EB445137-D7F5-57EC-87DA-1DB460D64046,"iPhone13,2"
com.apple.MobileSMS,4,1741473040,1741473044,1741473044.513268,-21600,EB445137-D7F5-57EC-87DA-1DB460D64046,"iPhone13,2"
com.groupme.iphone-app,2,1741472512,1741472514,1741472514.940905,-21600,EB445137-D7F5-57EC-87DA-1DB460D64046,"iPhone13,2"
com.apple.finder,8,1741472367,1741472375,1741472375.2876859,-21600,,
com.apple.iCal,1,1741472366,1741472367,1741472368.001934,-21600,,
com.apple.finder,1,1741472365,1741472366,1741472366.8636022,-21600,,
com.apple.Preview,1,1741472364,1741472365,1741472365.176968,-21600,,
com.apple.finder,2,1741472362,1741472364,1741472364.636897,-21600,,
com.apple.Notes,1,1741472361,1741472362,1741472362.2845721,-21600,,
com.leomehlig.today,96,1741472265,1741472361,1741472361.185477,-21600,,
com.apple.Notes,15,1741472250,1741472265,1741472265.567383,-21600,,
com.leomehlig.today,111,1741472139,1741472250,1741472250.375112,-21600,,
com.apple.finder,4,1741472135,1741472139,1741472139.59986,-21600,,
com.apple.Preview,707,1741471428,1741472135,1741472135.829597,-21600,,
com.google.Chrome,2,1741471426,1741471428,1741471428.366122,-21600,,
com.apple.Preview,107,1741471319,1741471426,1741471426.7438731,-21600,,
com.google.Chrome,2,1741471317,1741471319,1741471319.962501,-21600,,
com.apple.Preview,64,1741471253,1741471317,1741471317.993633,-21600,,
com.google.Chrome,2,1741471251,1741471253,1741471253.3239222,-21600,,
com.apple.finder,1,1741471250,1741471251,1741471251.745339,-21600,,
com.apple.Preview,20,1741471230,1741471250,1741471250.947768,-21600,,
com.apple.finder,3,1741471227,1741471230,1741471230.426095,-21600,,
com.apple.Preview,227,1741471000,1741471227,1741471227.911865,-21600,,
com.apple.finder,0,1741471000,1741471000,1741471000.371152,-21600,,
com.google.Chrome,5,1741470995,1741471000,1741471000.123611,-21600,,
com.apple.finder,12,1741470983,1741470995,1741470996.0439,-21600,,
com.apple.CoreAuthUI,2,1741470699,1741470701,1741470701.2468529,-21600,EB445137-D7F5-57EC-87DA-1DB460D64046,"iPhone13,2"
com.apple.CoreAuthUI,2,1741470677,1741470679,1741470679.6591492,-21600,EB445137-D7F5-57EC-87DA-1DB460D64046,"iPhone13,2"
com.google.chrome.ios,142,1741470653,1741470795,1741470795.248856,-21600,EB445137-D7F5-57EC-87DA-1DB460D64046,"iPhone13,2"
com.intsig.CamScannerLite,2,1741470650,1741470652,1741470652.718914,-21600,EB445137-D7F5-57EC-87DA-1DB460D64046,"iPhone13,2"
com.apple.finder,310,1741470591,1741470901,1741470901.684555,-21600,,
com.google.Chrome,29,1741470562,1741470591,1741470591.043958,-21600,,
com.apple.finder,13,1741470549,1741470562,1741470562.724422,-21600,,
com.google.Chrome,175,1741470374,1741470549,1741470549.152361,-21600,,
com.apple.Preview,185,1741469486,1741469671,1741469671.6157131,-21600,,
com.apple.Preview,612,1741468836,1741469448,1741469448.817455,-21600,,
com.apple.finder,46,1741468790,1741468836,1741468836.498004,-21600,,
com.leomehlig.today,43,1741468747,1741468790,1741468790.510016,-21600,,
com.apple.finder,8,1741468739,1741468747,1741468747.5028749,-21600,,
com.apple.Preview,2,1741468737,1741468739,1741468739.618699,-21600,,
com.apple.finder,3,1741468734,1741468737,1741468737.386897,-21600,,
com.apple.Preview,1,1741468733,1741468734,1741468734.958014,-21600,,
com.leomehlig.today,1,1741468732,1741468733,1741468733.1023679,-21600,,
com.apple.Preview,7,1741468725,1741468732,1741468732.068181,-21600,,
com.google.Chrome,418,1741468307,1741468725,1741468725.523488,-21600,,
com.apple.iCal,201,1741468106,1741468307,1741468309.027004,-21600,,
com.leomehlig.today,25,1741468081,1741468106,1741468106.693912,-21600,,
com.google.Chrome,1247,1741466834,1741468081,1741468082.003278,-21600,,
com.apple.finder,2,1741466832,1741466834,1741466834.64826,-21600,,
com.google.Chrome,2,1741466830,1741466832,1741466832.847004,-21600,,
com.apple.finder,5,1741466825,1741466830,1741466830.378787,-21600,,
com.intsig.CamScannerLite,104,1741466743,1741466847,1741466847.430629,-21600,EB445137-D7F5-57EC-87DA-1DB460D64046,"iPhone13,2"
com.google.Chrome,152,1741466673,1741466825,1741466825.194271,-21600,,
com.leomehlig.today,359,1741466302,1741466661,1741466661.090128,-21600,,
com.apple.iCal,33,1741466269,1741466302,1741466302.442916,-21600,,
com.microsoft.Outlook,8,1741466261,1741466269,1741466269.247517,-21600,,
com.apple.iCal,5,1741466256,1741466261,1741466261.831825,-21600,,
com.microsoft.Outlook,2,1741466254,1741466256,1741466256.8843699,-21600,,
com.apple.iCal,13,1741466241,1741466254,1741466254.328253,-21600,,
com.microsoft.Outlook,87,1741466154,1741466241,1741466241.764666,-21600,,
com.google.Chrome,5,1741466149,1741466154,1741466155.0342011,-21600,,
com.microsoft.Outlook,114,1741466035,1741466149,1741466150.056843,-21600,,
com.google.Chrome,137,1741465898,1741466035,1741466035.8401132,-21600,,
com.leomehlig.today,3,1741465887,1741465890,1741465890.711626,-21600,,
com.google.Chrome,2,1741465885,1741465887,1741465887.343497,-21600,,
com.leomehlig.today,38,1741465847,1741465885,1741465885.3303242,-21600,,
com.google.Chrome,5,1741465842,1741465847,1741465847.796082,-21600,,
com.apple.Preview,2,1741465840,1741465842,1741465842.290247,-21600,,
com.leomehlig.today,2,1741465838,1741465840,1741465840.420862,-21600,,
com.apple.Preview,604,1741465234,1741465838,1741465838.8116221,-21600,,
com.leomehlig.today,63,1741465171,1741465234,1741465234.619519,-21600,,
com.apple.news,267,1741464933,1741465200,1741465200.05112,-21600,EB445137-D7F5-57EC-87DA-1DB460D64046,"iPhone13,2"
com.apple.Health,17,1741464908,1741464925,1741464925.0989342,-21600,EB445137-D7F5-57EC-87DA-1DB460D64046,"iPhone13,2"
com.leomehlig.today,303,1741464867,1741465170,1741465170.2343888,-21600,,
com.apple.weather,13,1741464092,1741464105,1741464105.6488218,-21600,EB445137-D7F5-57EC-87DA-1DB460D64046,"iPhone13,2"
com.apple.CoreAuthUI,2,1741464046,1741464048,1741464048.8406138,-21600,EB445137-D7F5-57EC-87DA-1DB460D64046,"iPhone13,2"
com.truebill.truebillnative,38,1741464042,1741464080,1741464080.092262,-21600,EB445137-D7F5-57EC-87DA-1DB460D64046,"iPhone13,2"
com.apple.findmy,15,1741464015,1741464030,1741464030.398948,-21600,EB445137-D7F5-57EC-87DA-1DB460D64046,"iPhone13,2"
com.myfitnesspal.mfp,32,1741463960,1741463992,1741463992.938628,-21600,EB445137-D7F5-57EC-87DA-1DB460D64046,"iPhone13,2"
com.intsig.CamScannerLite,2,1741463953,1741463955,1741463955.990656,-21600,EB445137-D7F5-57EC-87DA-1DB460D64046,"iPhone13,2"
com.apple.Preview,1582,1741463285,1741464867,1741464867.825825,-21600,,
com.apple.finder,1,1741463284,1741463285,1741463285.7490249,-21600,,
com.apple.Preview,180,1741463104,1741463284,1741463284.672755,-21600,,
com.apple.finder,1,1741463103,1741463104,1741463104.119447,-21600,,
com.apple.Preview,158,1741462945,1741463103,1741463103.792681,-21600,,
com.intsig.CamScannerLite,202,1741462779,1741462981,1741462981.272595,-21600,EB445137-D7F5-57EC-87DA-1DB460D64046,"iPhone13,2"
com.google.chrome.ios,3,1741462776,1741462779,1741462779.590791,-21600,EB445137-D7F5-57EC-87DA-1DB460D64046,"iPhone13,2"
com.apple.finder,183,1741462762,1741462945,1741462945.364896,-21600,,
com.intsig.CamScannerLite,154,1741462622,1741462776,1741462776.713328,-21600,EB445137-D7F5-57EC-87DA-1DB460D64046,"iPhone13,2"
com.leomehlig.today,180,1741462582,1741462762,1741462763.006917,-21600,,
com.leomehlig.today,59,1741461419,1741461478,1741461478.56481,-21600,,
com.google.Chrome,495,1741460924,1741461419,1741461419.738764,-21600,,
com.leomehlig.today,72,1741460852,1741460924,1741460925.01297,-21600,,
com.google.Chrome,1299,1741459553,1741460852,1741460853.035489,-21600,,
com.apple.finder,2,1741459551,1741459553,1741459553.644155,-21600,,
com.google.Chrome,964,1741458587,1741459551,1741459551.544301,-21600,,
com.apple.finder,1,1741458551,1741458552,1741458552.9944968,-21600,,
com.leomehlig.today,1,1741458550,1741458551,1741458551.892885,-21600,,
com.apple.finder,3,1741458547,1741458550,1741458550.467233,-21600,,
com.apple.Health,29,1741457464,1741457493,1741457493.27206,-21600,EB445137-D7F5-57EC-87DA-1DB460D64046,"iPhone13,2"
com.myfitnesspal.mfp,242,1741457222,1741457464,1741457464.81299,-21600,EB445137-D7F5-57EC-87DA-1DB460D64046,"iPhone13,2"
com.google.chrome.ios,16,1741457206,1741457222,1741457226.813395,-21600,EB445137-D7F5-57EC-87DA-1DB460D64046,"iPhone13,2"
com.myfitnesspal.mfp,94,1741457112,1741457206,1741457206.873941,-21600,EB445137-D7F5-57EC-87DA-1DB460D64046,"iPhone13,2"
com.instructure.icanvas,3,1741457107,1741457110,1741457110.330545,-21600,EB445137-D7F5-57EC-87DA-1DB460D64046,"iPhone13,2"
com.apple.news,33,1741457071,1741457104,1741457104.696352,-21600,EB445137-D7F5-57EC-87DA-1DB460D64046,"iPhone13,2"
com.apple.news,33,1741457036,1741457069,1741457070.051805,-21600,EB445137-D7F5-57EC-87DA-1DB460D64046,"iPhone13,2"
com.apple.news,2,1741456997,1741456999,1741457000.223525,-21600,EB445137-D7F5-57EC-87DA-1DB460D64046,"iPhone13,2"
com.apple.finder,301,1741456932,1741457233,1741457233.910465,-21600,,
com.leomehlig.today,51,1741456881,1741456932,1741456932.643939,-21600,,
com.apple.Notes,2,1741456879,1741456881,1741456881.652121,-21600,,
com.leomehlig.today,1,1741456878,1741456879,1741456879.186388,-21600,,
com.google.Chrome,32,1741456846,1741456878,1741456878.765572,-21600,,
com.apple.finder,0,1741456846,1741456846,1741456847.2944732,-21600,,
com.microsoft.VSCode,1364,1741455482,1741456846,1741456846.946216,-21600,,
com.apple.Notes,236,1741455246,1741455482,1741455482.1109471,-21600,,
com.microsoft.VSCode,21,1741455225,1741455246,1741455246.8112202,-21600,,
com.apple.finder,63,1741455162,1741455225,1741455225.800301,-21600,,
com.google.Chrome,478,1741454684,1741455162,1741455162.733317,-21600,,
com.google.Chrome,325,1741454082,1741454407,1741454407.63174,-21600,,
com.electron.carta,7,1741454075,1741454082,1741454082.641886,-21600,,
com.google.Chrome,83,1741453992,1741454075,1741454075.946626,-21600,,
com.electron.carta,7,1741453985,1741453992,1741453992.7450109,-21600,,
com.google.Chrome,22,1741453963,1741453985,1741453985.5475368,-21600,,
com.electron.carta,5,1741453958,1741453963,1741453964.067327,-21600,,
com.google.Chrome,16,1741453942,1741453958,1741453958.989561,-21600,,
com.electron.carta,45,1741453897,1741453942,1741453942.490007,-21600,,
com.google.Chrome,17,1741453880,1741453897,1741453897.235365,-21600,,
com.electron.carta,7,1741453873,1741453880,1741453880.861525,-21600,,
com.apple.finder,12,1741453861,1741453873,1741453873.47373,-21600,,
com.electron.carta,15,1741453846,1741453861,1741453861.4906611,-21600,,
com.google.Chrome,20,1741453826,1741453846,1741453846.595356,-21600,,
com.electron.carta,15,1741453811,1741453826,1741453826.662642,-21600,,
com.google.Chrome,5,1741453806,1741453811,1741453811.92164,-21600,,
com.electron.carta,9,1741453797,1741453806,1741453806.8249211,-21600,,
com.google.Chrome,5,1741453792,1741453797,1741453797.674048,-21600,,
com.electron.carta,8,1741453784,1741453792,1741453792.905964,-21600,,
com.google.Chrome,17,1741453767,1741453784,1741453784.657604,-21600,,
com.electron.carta,8,1741453759,1741453767,1741453767.774622,-21600,,
com.google.Chrome,27,1741453732,1741453759,1741453759.295535,-21600,,
com.electron.carta,4,1741453728,1741453732,1741453732.717341,-21600,,
com.google.Chrome,6,1741453722,1741453728,1741453728.637696,-21600,,
com.electron.carta,22,1741453700,1741453722,1741453722.370558,-21600,,
com.google.Chrome,10,1741453690,1741453700,1741453700.764971,-21600,,
com.electron.carta,19,1741453671,1741453690,1741453691.04779,-21600,,
com.apple.finder,9,1741453662,1741453671,1741453671.7324271,-21600,,
com.electron.carta,4,1741453658,1741453662,1741453662.842514,-21600,,
com.google.Chrome,9,1741453649,1741453658,1741453658.5333,-21600,,
com.electron.carta,12,1741453637,1741453649,1741453649.59603,-21600,,
com.google.Chrome,6,1741453631,1741453637,1741453637.690326,-21600,,
com.electron.carta,40,1741453591,1741453631,1741453631.926961,-21600,,
com.google.Chrome,5,1741453586,1741453591,1741453591.3018699,-21600,,
com.electron.carta,15,1741453571,1741453586,1741453586.397635,-21600,,
com.google.Chrome,11,1741453560,1741453571,1741453571.203579,-21600,,
com.electron.carta,3,1741453557,1741453560,1741453560.1659842,-21600,,
com.google.Chrome,2,1741453555,1741453557,1741453558.015627,-21600,,
com.electron.carta,13,1741453542,1741453555,1741453555.100208,-21600,,
com.google.Chrome,30,1741453512,1741453542,1741453542.521377,-21600,,
com.electron.carta,6,1741453506,1741453512,1741453512.504384,-21600,,
com.google.Chrome,11,1741453495,1741453506,1741453506.5857859,-21600,,
com.electron.carta,9,1741453486,1741453495,1741453495.120953,-21600,,
com.apple.finder,1,1741453485,1741453486,1741453486.3041801,-21600,,
com.electron.carta,17,1741453468,1741453485,1741453485.687392,-21600,,
com.apple.finder,2,1741453466,1741453468,1741453468.458743,-21600,,
com.electron.carta,10,1741453456,1741453466,1741453466.7884378,-21600,,
com.google.Chrome,15,1741453441,1741453456,1741453456.333395,-21600,,
com.electron.carta,26,1741453415,1741453441,1741453441.583438,-21600,,
com.apple.finder,1,1741453414,1741453415,1741453415.8726459,-21600,,
com.electron.carta,3,1741453411,1741453414,1741453414.751985,-21600,,
com.apple.finder,31,1741453380,1741453411,1741453411.6505961,-21600,,
com.electron.carta,31,1741453349,1741453380,1741453380.479549,-21600,,
com.google.Chrome,90,1741453259,1741453349,1741453349.533681,-21600,,
com.electron.carta,18,1741453241,1741453259,1741453259.227587,-21600,,
com.google.Chrome,10,1741453231,1741453241,1741453241.154626,-21600,,
com.electron.carta,11,1741453220,1741453231,1741453231.45746,-21600,,
com.google.Chrome,14,1741453206,1741453220,1741453220.765132,-21600,,
com.electron.carta,114,1741453092,1741453206,1741453206.1850162,-21600,,
com.apple.finder,14,1741453078,1741453092,1741453092.571216,-21600,,
com.electron.carta,15,1741453063,1741453078,1741453078.472062,-21600,,
com.google.Chrome,7,1741453056,1741453063,1741453063.413032,-21600,,
com.electron.carta,9,1741453047,1741453056,1741453056.235468,-21600,,
com.google.Chrome,5,1741453042,1741453047,1741453047.2698898,-21600,,
com.electron.carta,18,1741453024,1741453042,1741453042.542162,-21600,,
com.google.Chrome,13,1741453011,1741453024,1741453024.357631,-21600,,
com.electron.carta,9,1741453002,1741453011,1741453011.8505511,-21600,,
com.google.Chrome,4,1741452998,1741453002,1741453002.2840009,-21600,,
com.electron.carta,5,1741452993,1741452998,1741452998.991527,-21600,,
com.google.Chrome,4,1741452989,1741452993,1741452993.827548,-21600,,
com.electron.carta,5,1741452984,1741452989,1741452990.001445,-21600,,
com.google.Chrome,51,1741452933,1741452984,1741452984.8232431,-21600,,
com.electron.carta,25,1741452908,1741452933,1741452933.547505,-21600,,
com.google.Chrome,5,1741452903,1741452908,1741452909.002316,-21600,,
com.electron.carta,55,1741452848,1741452903,1741452903.533719,-21600,,
com.google.Chrome,56,1741452792,1741452848,1741452848.5937052,-21600,,
com.electron.carta,17,1741452775,1741452792,1741452792.990367,-21600,,
com.google.Chrome,22,1741452753,1741452775,1741452775.881429,-21600,,
com.electron.carta,15,1741452738,1741452753,1741452753.86518,-21600,,
com.google.Chrome,21,1741452717,1741452738,1741452738.287631,-21600,,
com.electron.carta,11,1741452706,1741452717,1741452717.70242,-21600,,
com.google.Chrome,6,1741452700,1741452706,1741452706.652555,-21600,,
com.electron.carta,54,1741452646,1741452700,1741452700.57522,-21600,,
com.google.Chrome,25,1741452621,1741452646,1741452646.6794991,-21600,,
com.electron.carta,27,1741452594,1741452621,1741452622.068475,-21600,,
com.google.Chrome,13,1741452581,1741452594,1741452594.167449,-21600,,
com.electron.carta,8,1741452573,1741452581,1741452582.093456,-21600,,
com.google.Chrome,7,1741452566,1741452573,1741452573.736208,-21600,,
com.electron.carta,9,1741452557,1741452566,1741452566.215317,-21600,,
com.google.Chrome,21,1741452536,1741452557,1741452557.784391,-21600,,
com.electron.carta,3,1741452533,1741452536,1741452536.625077,-21600,,
com.google.Chrome,8,1741452525,1741452533,1741452533.214313,-21600,,
com.electron.carta,59,1741452466,1741452525,1741452525.170158,-21600,,
com.google.Chrome,71,1741452395,1741452466,1741452466.240467,-21600,,
com.electron.carta,3,1741452392,1741452395,1741452395.3047009,-21600,,
com.google.Chrome,32,1741452360,1741452392,1741452392.974683,-21600,,
com.electron.carta,10,1741452350,1741452360,1741452360.886308,-21600,,
com.apple.finder,24,1741452326,1741452350,1741452350.853838,-21600,,
com.electron.carta,34,1741452292,1741452326,1741452326.929645,-21600,,
com.google.Chrome,90,1741452202,1741452292,1741452292.3967109,-21600,,
com.electron.carta,13,1741452189,1741452202,1741452202.348905,-21600,,
com.google.Chrome,5,1741452184,1741452189,1741452189.514185,-21600,,
com.electron.carta,12,1741452172,1741452184,1741452184.14958,-21600,,
com.google.Chrome,6,1741452166,1741452172,1741452172.869884,-21600,,
com.electron.carta,12,1741452154,1741452166,1741452167.059542,-21600,,
com.google.Chrome,14,1741452140,1741452154,1741452154.709187,-21600,,
com.electron.carta,6,1741452134,1741452140,1741452140.646668,-21600,,
com.google.Chrome,19,1741452115,1741452134,1741452134.739301,-21600,,
com.electron.carta,17,1741452098,1741452115,1741452115.5974069,-21600,,
com.google.Chrome,6,1741452092,1741452098,1741452098.4184098,-21600,,
com.apple.finder,7,1741452085,1741452092,1741452093.0431151,-21600,,
com.electron.carta,60,1741452025,1741452085,1741452085.924712,-21600,,
com.google.Chrome,17,1741452008,1741452025,1741452025.588595,-21600,,
com.electron.carta,8,1741452000,1741452008,1741452008.199617,-21600,,
com.apple.finder,9,1741451991,1741452000,1741452000.80724,-21600,,
com.electron.carta,22,1741451969,1741451991,1741451991.997271,-21600,,
com.google.Chrome,7,1741451962,1741451969,1741451969.255666,-21600,,
com.electron.carta,15,1741451947,1741451962,1741451962.27793,-21600,,
com.google.Chrome,9,1741451938,1741451947,1741451948.056872,-21600,,
com.apple.finder,4,1741451934,1741451938,1741451939.035244,-21600,,
com.google.Chrome,1,1741451933,1741451934,1741451934.740275,-21600,,
com.apple.finder,3,1741451930,1741451933,1741451934.0029778,-21600,,
com.google.Chrome,33,1741451897,1741451930,1741451930.2453651,-21600,,
com.electron.carta,53,1741451844,1741451897,1741451897.4911652,-21600,,
com.google.Chrome,5,1741451839,1741451844,1741451845.0604692,-21600,,
com.electron.carta,8,1741451831,1741451839,1741451839.521772,-21600,,
com.google.Chrome,10,1741451821,1741451831,1741451832.0425382,-21600,,
com.electron.carta,19,1741451802,1741451821,1741451822.10702,-21600,,
com.google.Chrome,29,1741451773,1741451802,1741451802.421691,-21600,,
com.electron.carta,19,1741451754,1741451773,1741451773.685745,-21600,,
com.google.Chrome,5,1741451749,1741451754,1741451754.627946,-21600,,
com.electron.carta,26,1741451723,1741451749,1741451749.5892591,-21600,,
com.google.Chrome,31,1741451692,1741451723,1741451723.547406,-21600,,
com.apple.finder,2,1741451690,1741451692,1741451692.783335,-21600,,
com.google.Chrome,20,1741451670,1741451690,1741451690.535421,-21600,,
com.electron.carta,14,1741451656,1741451670,1741451670.660425,-21600,,
com.apple.finder,14,1741451642,1741451656,1741451656.7034988,-21600,,
com.electron.carta,6,1741451636,1741451642,1741451642.472774,-21600,,
com.google.Chrome,7,1741451629,1741451636,1741451636.313473,-21600,,
com.leomehlig.today,1,1741451628,1741451629,1741451629.204721,-21600,,
com.apple.iCal,4,1741451624,1741451628,1741451628.1173391,-21600,,
com.leomehlig.today,26,1741451598,1741451624,1741451624.4121099,-21600,,
com.apple.iCal,50,1741451548,1741451598,1741451598.507401,-21600,,
com.google.Chrome,55,1741451493,1741451548,1741451548.867847,-21600,,
com.electron.carta,16,1741451465,1741451481,1741451481.282617,-21600,,
com.google.Chrome,14,1741451451,1741451465,1741451465.834831,-21600,,
com.electron.carta,12,1741451439,1741451451,1741451451.657497,-21600,,
com.google.Chrome,9,1741451430,1741451439,1741451439.154865,-21600,,
com.electron.carta,36,1741451394,1741451430,1741451430.976173,-21600,,
com.google.Chrome,6,1741451388,1741451394,1741451394.3662481,-21600,,
com.electron.carta,11,1741451377,1741451388,1741451388.8359408,-21600,,
com.google.Chrome,11,1741451366,1741451377,1741451377.581902,-21600,,
com.electron.carta,13,1741451353,1741451366,1741451366.996197,-21600,,
com.google.Chrome,33,1741451320,1741451353,1741451353.397207,-21600,,
com.electron.carta,14,1741451306,1741451320,1741451320.987965,-21600,,
com.google.Chrome,8,1741451298,1741451306,1741451306.521025,-21600,,
com.electron.carta,3,1741451295,1741451298,1741451298.66746,-21600,,
com.google.Chrome,15,1741451280,1741451295,1741451295.9120321,-21600,,
com.electron.carta,4,1741451276,1741451280,1741451280.097035,-21600,,
com.google.Chrome,3,1741451273,1741451276,1741451276.14797,-21600,,
com.electron.carta,33,1741451240,1741451273,1741451273.569315,-21600,,
com.apple.finder,7,1741451233,1741451240,1741451240.878817,-21600,,
com.electron.carta,13,1741451220,1741451233,1741451233.642941,-21600,,
com.google.Chrome,10,1741451210,1741451220,1741451220.277359,-21600,,
com.electron.carta,5,1741451205,1741451210,1741451210.9506578,-21600,,
com.google.Chrome,36,1741451169,1741451205,1741451205.0617929,-21600,,
com.electron.carta,6,1741451163,1741451169,1741451169.4903378,-21600,,
com.google.Chrome,19,1741451144,1741451163,1741451163.389354,-21600,,
com.electron.carta,11,1741451133,1741451144,1741451144.053668,-21600,,
com.google.Chrome,5,1741451128,1741451133,1741451133.443006,-21600,,
com.electron.carta,15,1741451113,1741451128,1741451129.036562,-21600,,
com.google.Chrome,48,1741451065,1741451113,1741451114.0200849,-21600,,
com.electron.carta,24,1741451041,1741451065,1741451066.088903,-21600,,
com.google.Chrome,29,1741451012,1741451041,1741451041.950563,-21600,,
com.apple.finder,3,1741451009,1741451012,1741451012.091893,-21600,,
com.google.Chrome,10,1741450999,1741451009,1741451009.547811,-21600,,
com.electron.carta,84,1741450915,1741450999,1741450999.3954902,-21600,,
com.google.Chrome,106,1741450809,1741450915,1741450916.045927,-21600,,
com.electron.carta,3,1741450806,1741450809,1741450809.3181849,-21600,,
com.google.Chrome,1,1741450805,1741450806,1741450806.431998,-21600,,
com.electron.carta,11,1741450794,1741450805,1741450805.258009,-21600,,
com.apple.finder,9,1741450785,1741450794,1741450794.153409,-21600,,
com.electron.carta,0,1741450785,1741450785,1741450785.76246,-21600,,
com.google.Chrome,2,1741450783,1741450785,1741450785.297446,-21600,,
com.electron.carta,1,1741450782,1741450783,1741450783.4240808,-21600,,
com.apple.finder,2,1741450780,1741450782,1741450782.7258,-21600,,
com.electron.carta,21,1741450759,1741450780,1741450780.859148,-21600,,
com.google.Chrome,126,1741450633,1741450759,1741450759.773598,-21600,,
com.electron.carta,11,1741450622,1741450633,1741450633.868717,-21600,,
com.google.Chrome,4,1741450618,1741450622,1741450622.250215,-21600,,
com.electron.carta,18,1741450600,1741450618,1741450618.525844,-21600,,
com.google.Chrome,18,1741450582,1741450600,1741450600.8202891,-21600,,
com.electron.carta,23,1741450559,1741450582,1741450582.96692,-21600,,
com.google.Chrome,28,1741450531,1741450559,1741450559.8636088,-21600,,
com.electron.carta,7,1741450524,1741450531,1741450531.761982,-21600,,
com.google.Chrome,35,1741450489,1741450524,1741450524.642555,-21600,,
com.electron.carta,23,1741450466,1741450489,1741450489.190527,-21600,,
com.google.Chrome,27,1741450439,1741450466,1741450466.290421,-21600,,
com.electron.carta,34,1741450405,1741450439,1741450439.753058,-21600,,
com.google.Chrome,7,1741450398,1741450405,1741450405.757244,-21600,,
com.electron.carta,17,1741450381,1741450398,1741450398.232223,-21600,,
com.apple.finder,6,1741450375,1741450381,1741450381.549613,-21600,,
com.electron.carta,1,1741450374,1741450375,1741450375.956264,-21600,,
com.apple.finder,1,1741450373,1741450374,1741450374.92974,-21600,,
com.electron.carta,18,1741450355,1741450373,1741450373.2432098,-21600,,
com.google.Chrome,52,1741450303,1741450355,1741450356.019824,-21600,,
com.electron.carta,10,1741450293,1741450303,1741450303.958081,-21600,,
com.google.Chrome,20,1741450273,1741450293,1741450293.533052,-21600,,
com.electron.carta,8,1741450265,1741450273,1741450273.115458,-21600,,
com.google.Chrome,8,1741450257,1741450265,1741450265.398412,-21600,,
com.electron.carta,21,1741450236,1741450257,1741450257.913832,-21600,,
com.google.Chrome,2,1741450234,1741450236,1741450236.760573,-21600,,
com.apple.finder,2,1741450232,1741450234,1741450234.322118,-21600,,
com.apple.news,153,1741450003,1741450156,1741450156.457172,-21600,EB445137-D7F5-57EC-87DA-1DB460D64046,"iPhone13,2"
com.apple.CoreAuthUI,2,1741449966,1741449968,1741449968.3187618,-21600,EB445137-D7F5-57EC-87DA-1DB460D64046,"iPhone13,2"
com.truebill.truebillnative,30,1741449963,1741449993,1741449994.060375,-21600,EB445137-D7F5-57EC-87DA-1DB460D64046,"iPhone13,2"
com.google.Chrome,311,1741449921,1741450232,1741450232.918836,-21600,,
com.electron.carta,10,1741449911,1741449921,1741449921.133095,-21600,,
com.google.Chrome,35,1741449876,1741449911,1741449911.1663852,-21600,,
com.electron.carta,16,1741449860,1741449876,1741449876.418391,-21600,,
com.google.Chrome,11,1741449849,1741449860,1741449860.072585,-21600,,
com.electron.carta,3,1741449846,1741449849,1741449850.009275,-21600,,
com.google.Chrome,3,1741449843,1741449846,1741449846.680835,-21600,,
com.electron.carta,22,1741449821,1741449843,1741449843.831757,-21600,,
com.apple.finder,13,1741449808,1741449821,1741449821.31584,-21600,,
com.electron.carta,20,1741449788,1741449808,1741449808.697919,-21600,,
com.google.Chrome,45,1741449743,1741449788,1741449788.409785,-21600,,
com.electron.carta,20,1741449723,1741449743,1741449743.3251991,-21600,,
com.google.Chrome,11,1741449712,1741449723,1741449723.851243,-21600,,
com.electron.carta,6,1741449706,1741449712,1741449712.1263142,-21600,,
com.google.Chrome,21,1741449685,1741449706,1741449706.54837,-21600,,
com.electron.carta,17,1741449668,1741449685,1741449686.034023,-21600,,
com.google.Chrome,14,1741449654,1741449668,1741449668.42443,-21600,,
com.electron.carta,26,1741449628,1741449654,1741449654.4323668,-21600,,
com.apple.finder,2,1741449626,1741449628,1741449628.937335,-21600,,
com.electron.carta,8,1741449618,1741449626,1741449626.4625158,-21600,,
com.google.Chrome,7,1741449611,1741449618,1741449619.0504122,-21600,,
com.apple.finder,1,1741449610,1741449611,1741449611.504488,-21600,,
com.electron.carta,1,1741449609,1741449610,1741449610.646096,-21600,,
com.apple.finder,7,1741449602,1741449609,1741449609.6983418,-21600,,
com.google.Chrome,2,1741449600,1741449602,1741449602.404628,-21600,,
com.electron.carta,3,1741449597,1741449600,1741449600.344471,-21600,,
com.apple.finder,1,1741449596,1741449597,1741449597.986372,-21600,,
com.electron.carta,14,1741449582,1741449596,1741449596.091471,-21600,,
com.google.Chrome,33,1741449549,1741449582,1741449582.287859,-21600,,
com.electron.carta,19,1741449530,1741449549,1741449549.904574,-21600,,
com.google.Chrome,19,1741449511,1741449530,1741449530.421163,-21600,,
com.electron.carta,42,1741449469,1741449511,1741449511.565166,-21600,,
com.google.Chrome,13,1741449456,1741449469,1741449469.260962,-21600,,
com.electron.carta,21,1741449435,1741449456,1741449456.464538,-21600,,
com.google.Chrome,51,1741449384,1741449435,1741449435.755719,-21600,,
com.electron.carta,21,1741449363,1741449384,1741449384.550911,-21600,,
com.google.Chrome,6,1741449357,1741449363,1741449363.628288,-21600,,
com.electron.carta,19,1741449338,1741449357,1741449357.3617039,-21600,,
com.google.Chrome,7,1741449331,1741449338,1741449338.405827,-21600,,
com.electron.carta,9,1741449322,1741449331,1741449331.577095,-21600,,
com.google.Chrome,37,1741449285,1741449322,1741449322.814403,-21600,,
com.electron.carta,33,1741449252,1741449285,1741449285.7153049,-21600,,
com.google.Chrome,8,1741449244,1741449252,1741449252.356668,-21600,,
com.electron.carta,18,1741449226,1741449244,1741449245.059799,-21600,,
com.google.Chrome,9,1741449217,1741449226,1741449226.2771668,-21600,,
com.electron.carta,1,1741449216,1741449217,1741449217.6179829,-21600,,
com.apple.finder,3,1741449213,1741449216,1741449216.711989,-21600,,
com.electron.carta,1,1741449212,1741449213,1741449213.7734752,-21600,,
com.google.Chrome,33,1741449179,1741449212,1741449212.839458,-21600,,
com.electron.carta,13,1741449166,1741449179,1741449179.3648028,-21600,,
com.apple.finder,7,1741449159,1741449166,1741449166.957333,-21600,,
com.google.Chrome,2,1741449157,1741449159,1741449159.786397,-21600,,
com.electron.carta,24,1741449133,1741449157,1741449157.4504619,-21600,,
com.google.Chrome,33,1741449100,1741449133,1741449133.7897382,-21600,,
com.electron.carta,11,1741449089,1741449100,1741449100.68191,-21600,,
com.google.Chrome,28,1741449061,1741449089,1741449089.359371,-21600,,
com.electron.carta,9,1741449052,1741449061,1741449061.855092,-21600,,
com.google.Chrome,19,1741449033,1741449052,1741449052.169193,-21600,,
com.electron.carta,1,1741449032,1741449033,1741449033.9476109,-21600,,
com.google.Chrome,53,1741448979,1741449032,1741449032.535935,-21600,,
com.electron.carta,1,1741448978,1741448979,1741448979.778493,-21600,,
com.google.Chrome,10,1741448968,1741448978,1741448978.0939279,-21600,,
com.electron.carta,16,1741448952,1741448968,1741448968.690195,-21600,,
com.google.Chrome,10,1741448942,1741448952,1741448952.5810971,-21600,,
com.electron.carta,63,1741448879,1741448942,1741448943.063056,-21600,,
com.google.Chrome,66,1741448813,1741448879,1741448879.390423,-21600,,
com.electron.carta,5,1741448808,1741448813,1741448813.555188,-21600,,
com.google.Chrome,3,1741448805,1741448808,1741448809.024051,-21600,,
com.electron.carta,40,1741448765,1741448805,1741448805.156343,-21600,,
com.apple.finder,7,1741448758,1741448765,1741448765.9384851,-21600,,
com.google.Chrome,1,1741448757,1741448758,1741448758.916582,-21600,,
com.apple.finder,4,1741448753,1741448757,1741448757.9830031,-21600,,
com.google.Chrome,1,1741448752,1741448753,1741448753.653479,-21600,,
com.electron.carta,7,1741448745,1741448752,1741448752.821085,-21600,,
com.google.Chrome,69,1741448676,1741448745,1741448745.9041018,-21600,,
com.electron.carta,16,1741448660,1741448676,1741448676.310474,-21600,,
com.google.Chrome,22,1741448638,1741448660,1741448660.33561,-21600,,
com.electron.carta,19,1741448619,1741448638,1741448638.663075,-21600,,
com.google.Chrome,7,1741448612,1741448619,1741448619.73721,-21600,,
com.electron.carta,6,1741448606,1741448612,1741448612.844081,-21600,,
com.google.Chrome,26,1741448580,1741448606,1741448606.924243,-21600,,
com.electron.carta,13,1741448567,1741448580,1741448580.202849,-21600,,
com.google.Chrome,13,1741448554,1741448567,1741448567.680084,-21600,,
com.electron.carta,13,1741448541,1741448554,1741448554.759807,-21600,,
com.google.Chrome,17,1741448524,1741448541,1741448541.684401,-21600,,
com.electron.carta,9,1741448515,1741448524,1741448524.667959,-21600,,
com.google.Chrome,35,1741448480,1741448515,1741448515.381664,-21600,,
com.electron.carta,21,1741448459,1741448480,1741448480.567699,-21600,,
com.google.Chrome,32,1741448427,1741448459,1741448459.907438,-21600,,
com.electron.carta,21,1741448406,1741448427,1741448427.426979,-21600,,
com.apple.finder,36,1741448370,1741448406,1741448406.19729,-21600,,
com.google.Chrome,23,1741448347,1741448370,1741448370.361759,-21600,,
com.electron.carta,66,1741448281,1741448347,1741448347.270811,-21600,,
com.google.Chrome,32,1741448249,1741448281,1741448281.981046,-21600,,
com.apple.finder,9,1741448082,1741448091,1741448091.389992,-21600,,
com.leomehlig.today,101,1741447975,1741448076,1741448076.4499369,-21600,,
com.google.Chrome,2,1741447973,1741447975,1741447975.87762,-21600,,
com.apple.CoreAuthUI,2,1741447914,1741447916,1741447916.2513509,-21600,EB445137-D7F5-57EC-87DA-1DB460D64046,"iPhone13,2"
com.discoverfinancial.mobile,43,1741447908,1741447951,1741447951.341985,-21600,EB445137-D7F5-57EC-87DA-1DB460D64046,"iPhone13,2"
com.apple.MobileSMS,2,1741447829,1741447831,1741447831.537375,-21600,EB445137-D7F5-57EC-87DA-1DB460D64046,"iPhone13,2"
com.apple.CoreAuthUI,2,1741447816,1741447818,1741447818.7677932,-21600,EB445137-D7F5-57EC-87DA-1DB460D64046,"iPhone13,2"
com.clairmail.fth.client,14,1741447814,1741447828,1741447828.705653,-21600,EB445137-D7F5-57EC-87DA-1DB460D64046,"iPhone13,2"
com.apple.Health,21,1741447792,1741447813,1741447813.34193,-21600,EB445137-D7F5-57EC-87DA-1DB460D64046,"iPhone13,2"
com.apple.MobileSMS,27,1741447759,1741447786,1741447786.187885,-21600,EB445137-D7F5-57EC-87DA-1DB460D64046,"iPhone13,2"
com.apple.calculator,29,1741447730,1741447759,1741447759.6199532,-21600,EB445137-D7F5-57EC-87DA-1DB460D64046,"iPhone13,2"
com.apple.MobileSMS,39,1741447691,1741447730,1741447730.2653542,-21600,EB445137-D7F5-57EC-87DA-1DB460D64046,"iPhone13,2"
com.apple.calculator,57,1741447634,1741447691,1741447691.231299,-21600,EB445137-D7F5-57EC-87DA-1DB460D64046,"iPhone13,2"
com.apple.MobileSMS,12,1741447622,1741447634,1741447634.971663,-21600,EB445137-D7F5-57EC-87DA-1DB460D64046,"iPhone13,2"
com.apple.calculator,43,1741447579,1741447622,1741447622.871141,-21600,EB445137-D7F5-57EC-87DA-1DB460D64046,"iPhone13,2"
com.renpho.health,3,1741447576,1741447579,1741447579.218834,-21600,EB445137-D7F5-57EC-87DA-1DB460D64046,"iPhone13,2"
com.renpho.health,76,1741446112,1741446188,1741446189.0122042,-21600,EB445137-D7F5-57EC-87DA-1DB460D64046,"iPhone13,2"
com.google.ios.youtube,3,1741445242,1741445245,1741445245.659447,-21600,EB445137-D7F5-57EC-87DA-1DB460D64046,"iPhone13,2"
com.google.ios.youtube,1298,1741443938,1741445236,1741445236.249309,-21600,EB445137-D7F5-57EC-87DA-1DB460D64046,"iPhone13,2"
com.google.Chrome,368,1741415269,1741415637,1741415637.201494,-21600,,
com.apple.finder,2,1741415267,1741415269,1741415269.849169,-21600,,
com.apple.Music,0,1741415267,1741415267,1741415268.210997,-21600,,
com.google.Chrome,11,1741415256,1741415267,1741415267.78565,-21600,,
com.supercell.soil,7,1741412022,1741412029,1741412029.6209311,-21600,EB445137-D7F5-57EC-87DA-1DB460D64046,"iPhone13,2"
com.apple.GameOverlayUI,7,1741410357,1741410364,1741410364.6552901,-21600,EB445137-D7F5-57EC-87DA-1DB460D64046,"iPhone13,2"
com.supercell.soil,178,1741410311,1741410489,1741410490.277175,-21600,EB445137-D7F5-57EC-87DA-1DB460D64046,"iPhone13,2"
com.apple.GameOverlayUI,8,1741410011,1741410019,1741410019.722609,-21600,EB445137-D7F5-57EC-87DA-1DB460D64046,"iPhone13,2"
com.supercell.magic,289,1741409996,1741410285,1741410286.0372381,-21600,EB445137-D7F5-57EC-87DA-1DB460D64046,"iPhone13,2"
com.google.Chrome,26,1741408907,1741408933,1741408933.585287,-21600,,
com.apple.Music,10,1741408897,1741408907,1741408907.201241,-21600,,
com.google.Chrome,1411,1741407486,1741408897,1741408897.151099,-21600,,
com.apple.Music,130,1741407356,1741407486,1741407486.454423,-21600,,
com.google.Chrome,174,1741407182,1741407356,1741407356.513484,-21600,,
com.apple.Music,45,1741407137,1741407182,1741407182.2037401,-21600,,
com.google.Chrome,115,1741407022,1741407137,1741407137.396997,-21600,,
com.apple.Music,83,1741406939,1741407022,1741407022.563812,-21600,,
com.leomehlig.today,2,1741406937,1741406939,1741406939.319253,-21600,,
com.apple.news,2,1741406543,1741406545,1741406546.10772,-21600,EB445137-D7F5-57EC-87DA-1DB460D64046,"iPhone13,2"
com.apple.news,93,1741406267,1741406360,1741406360.746983,-21600,EB445137-D7F5-57EC-87DA-1DB460D64046,"iPhone13,2"
com.apple.MobileSMS,5,1741406257,1741406262,1741406262.754027,-21600,EB445137-D7F5-57EC-87DA-1DB460D64046,"iPhone13,2"
com.google.chrome.ios,0,1741406257,1741406257,1741406260.1096082,-21600,EB445137-D7F5-57EC-87DA-1DB460D64046,"iPhone13,2"
com.google.chrome.ios,51,1741404013,1741404064,1741404064.556631,-21600,EB445137-D7F5-57EC-87DA-1DB460D64046,"iPhone13,2"
com.google.chrome.ios,40,1741403802,1741403842,1741403843.135751,-21600,EB445137-D7F5-57EC-87DA-1DB460D64046,"iPhone13,2"
com.google.chrome.ios,35,1741403617,1741403652,1741403652.792832,-21600,EB445137-D7F5-57EC-87DA-1DB460D64046,"iPhone13,2"
com.google.chrome.ios,40,1741403551,1741403591,1741403591.287126,-21600,EB445137-D7F5-57EC-87DA-1DB460D64046,"iPhone13,2"
com.google.chrome.ios,48,1741403482,1741403530,1741403531.102386,-21600,EB445137-D7F5-57EC-87DA-1DB460D64046,"iPhone13,2"
com.google.chrome.ios,71,1741403388,1741403459,1741403459.398687,-21600,EB445137-D7F5-57EC-87DA-1DB460D64046,"iPhone13,2"
com.google.chrome.ios,75,1741403297,1741403372,1741403374.855569,-21600,EB445137-D7F5-57EC-87DA-1DB460D64046,"iPhone13,2"
com.google.chrome.ios,120,1741403163,1741403283,1741403286.479186,-21600,EB445137-D7F5-57EC-87DA-1DB460D64046,"iPhone13,2"
com.google.chrome.ios,88,1741401467,1741401555,1741401555.0904698,-21600,EB445137-D7F5-57EC-87DA-1DB460D64046,"iPhone13,2"
com.google.chrome.ios,5,1741401190,1741401195,1741401196.91252,-21600,EB445137-D7F5-57EC-87DA-1DB460D64046,"iPhone13,2"
com.google.chrome.ios,52,1741401128,1741401180,1741401181.25301,-21600,EB445137-D7F5-57EC-87DA-1DB460D64046,"iPhone13,2"
com.google.chrome.ios,47,1741400025,1741400072,1741400073.9620209,-21600,EB445137-D7F5-57EC-87DA-1DB460D64046,"iPhone13,2"
com.google.chrome.ios,96,1741399906,1741400002,1741400002.496409,-21600,EB445137-D7F5-57EC-87DA-1DB460D64046,"iPhone13,2"
com.apple.Music,1,1741399905,1741399906,1741399906.733444,-21600,EB445137-D7F5-57EC-87DA-1DB460D64046,"iPhone13,2"
com.apple.Music,5,1741399823,1741399828,1741399829.16005,-21600,EB445137-D7F5-57EC-87DA-1DB460D64046,"iPhone13,2"
com.apple.Music,25,1741399233,1741399258,1741399258.464947,-21600,EB445137-D7F5-57EC-87DA-1DB460D64046,"iPhone13,2"
com.groupme.iphone-app,3,1741399230,1741399233,1741399233.08656,-21600,EB445137-D7F5-57EC-87DA-1DB460D64046,"iPhone13,2"
com.groupme.iphone-app,23,1741398841,1741398864,1741398864.446307,-21600,EB445137-D7F5-57EC-87DA-1DB460D64046,"iPhone13,2"
com.instructure.icanvas,12,1741398816,1741398828,1741398829.01071,-21600,EB445137-D7F5-57EC-87DA-1DB460D64046,"iPhone13,2"
com.apple.MobileSMS,2,1741398811,1741398813,1741398813.746572,-21600,EB445137-D7F5-57EC-87DA-1DB460D64046,"iPhone13,2"
com.apple.MobileSMS,5,1741394965,1741394970,1741394970.2880158,-21600,EB445137-D7F5-57EC-87DA-1DB460D64046,"iPhone13,2"
com.apple.MobileSMS,20,1741394861,1741394881,1741394881.925953,-21600,EB445137-D7F5-57EC-87DA-1DB460D64046,"iPhone13,2"
com.google.chrome.ios,2,1741394859,1741394861,1741394861.430655,-21600,EB445137-D7F5-57EC-87DA-1DB460D64046,"iPhone13,2"
com.google.chrome.ios,3,1741393921,1741393924,1741393924.90164,-21600,EB445137-D7F5-57EC-87DA-1DB460D64046,"iPhone13,2"
com.instructure.icanvas,3,1741393918,1741393921,1741393921.6798692,-21600,EB445137-D7F5-57EC-87DA-1DB460D64046,"iPhone13,2"
com.instructure.icanvas,10,1741393872,1741393882,1741393882.3564281,-21600,EB445137-D7F5-57EC-87DA-1DB460D64046,"iPhone13,2"
com.instructure.icanvas,12,1741393523,1741393535,1741393536.003127,-21600,EB445137-D7F5-57EC-87DA-1DB460D64046,"iPhone13,2"
com.google.chrome.ios,1,1741393522,1741393523,1741393524.044804,-21600,EB445137-D7F5-57EC-87DA-1DB460D64046,"iPhone13,2"
com.google.chrome.ios,102,1741393342,1741393444,1741393445.760153,-21600,EB445137-D7F5-57EC-87DA-1DB460D64046,"iPhone13,2"
com.google.chrome.ios,163,1741393147,1741393310,1741393311.936432,-21600,EB445137-D7F5-57EC-87DA-1DB460D64046,"iPhone13,2"
com.google.chrome.ios,592,1741392544,1741393136,1741393137.0656672,-21600,EB445137-D7F5-57EC-87DA-1DB460D64046,"iPhone13,2"
com.google.chrome.ios,56,1741392419,1741392475,1741392475.544918,-21600,EB445137-D7F5-57EC-87DA-1DB460D64046,"iPhone13,2"
com.toyopagroup.picaboo,3,1741392416,1741392419,1741392419.97793,-21600,EB445137-D7F5-57EC-87DA-1DB460D64046,"iPhone13,2"
com.toyopagroup.picaboo,20,1741390328,1741390348,1741390348.641736,-21600,EB445137-D7F5-57EC-87DA-1DB460D64046,"iPhone13,2"
com.apple.MobileSMS,4,1741390318,1741390322,1741390323.137692,-21600,EB445137-D7F5-57EC-87DA-1DB460D64046,"iPhone13,2"
com.meijer.mobile.Meijer,2,1741390315,1741390317,1741390317.432898,-21600,EB445137-D7F5-57EC-87DA-1DB460D64046,"iPhone13,2"
com.meijer.mobile.Meijer,27,1741390269,1741390296,1741390297.1965451,-21600,EB445137-D7F5-57EC-87DA-1DB460D64046,"iPhone13,2"
com.meijer.mobile.Meijer,37,1741390153,1741390190,1741390190.8168778,-21600,EB445137-D7F5-57EC-87DA-1DB460D64046,"iPhone13,2"
com.meijer.mobile.Meijer,2,1741390011,1741390013,1741390013.554863,-21600,EB445137-D7F5-57EC-87DA-1DB460D64046,"iPhone13,2"
com.meijer.mobile.Meijer,8,1741389928,1741389936,1741389937.112597,-21600,EB445137-D7F5-57EC-87DA-1DB460D64046,"iPhone13,2"
com.meijer.mobile.Meijer,28,1741389895,1741389923,1741389923.444313,-21600,EB445137-D7F5-57EC-87DA-1DB460D64046,"iPhone13,2"
com.google.chrome.ios,1,1741389894,1741389895,1741389896.324535,-21600,EB445137-D7F5-57EC-87DA-1DB460D64046,"iPhone13,2"
com.google.chrome.ios,4,1741389871,1741389875,1741389875.660438,-21600,EB445137-D7F5-57EC-87DA-1DB460D64046,"iPhone13,2"
com.google.chrome.ios,4,1741389856,1741389860,1741389860.3390222,-21600,EB445137-D7F5-57EC-87DA-1DB460D64046,"iPhone13,2"
com.google.chrome.ios,31,1741389752,1741389783,1741389783.564805,-21600,EB445137-D7F5-57EC-87DA-1DB460D64046,"iPhone13,2"
com.google.chrome.ios,46,1741389601,1741389647,1741389648.635268,-21600,EB445137-D7F5-57EC-87DA-1DB460D64046,"iPhone13,2"
com.google.chrome.ios,7,1741389585,1741389592,1741389593.295177,-21600,EB445137-D7F5-57EC-87DA-1DB460D64046,"iPhone13,2"
com.google.chrome.ios,15,1741389421,1741389436,1741389437.3890991,-21600,EB445137-D7F5-57EC-87DA-1DB460D64046,"iPhone13,2"
com.meijer.mobile.Meijer,10,1741389411,1741389421,1741389422.29831,-21600,EB445137-D7F5-57EC-87DA-1DB460D64046,"iPhone13,2"
com.meijer.mobile.Meijer,5,1741389358,1741389363,1741389364.185523,-21600,EB445137-D7F5-57EC-87DA-1DB460D64046,"iPhone13,2"
com.meijer.mobile.Meijer,73,1741389268,1741389341,1741389341.929645,-21600,EB445137-D7F5-57EC-87DA-1DB460D64046,"iPhone13,2"
com.google.chrome.ios,134,1741389130,1741389264,1741389264.446509,-21600,EB445137-D7F5-57EC-87DA-1DB460D64046,"iPhone13,2"
com.google.chrome.ios,112,1741388494,1741388606,1741388610.332614,-21600,EB445137-D7F5-57EC-87DA-1DB460D64046,"iPhone13,2"
com.apple.mobilenotes,4,1741388489,1741388493,1741388493.400419,-21600,EB445137-D7F5-57EC-87DA-1DB460D64046,"iPhone13,2"
com.apple.mobilenotes,33,1741388438,1741388471,1741388471.480684,-21600,EB445137-D7F5-57EC-87DA-1DB460D64046,"iPhone13,2"
com.google.chrome.ios,41,1741388397,1741388438,1741388438.668884,-21600,EB445137-D7F5-57EC-87DA-1DB460D64046,"iPhone13,2"
com.google.chrome.ios,146,1741388251,1741388397,1741388397.6686301,-21600,EB445137-D7F5-57EC-87DA-1DB460D64046,"iPhone13,2"
com.google.chrome.ios,2,1741388249,1741388251,1741388251.700163,-21600,EB445137-D7F5-57EC-87DA-1DB460D64046,"iPhone13,2"
com.google.chrome.ios,20,1741388179,1741388199,1741388199.893259,-21600,EB445137-D7F5-57EC-87DA-1DB460D64046,"iPhone13,2"
com.google.chrome.ios,6,1741388149,1741388155,1741388156.866003,-21600,EB445137-D7F5-57EC-87DA-1DB460D64046,"iPhone13,2"
com.apple.MobileSMS,21,1741386887,1741386908,1741386908.707704,-21600,EB445137-D7F5-57EC-87DA-1DB460D64046,"iPhone13,2"
com.apple.MobileSMS,17,1741386842,1741386859,1741386860.152402,-21600,EB445137-D7F5-57EC-87DA-1DB460D64046,"iPhone13,2"
com.apple.MobileSMS,1,1741386173,1741386174,1741386174.667283,-21600,EB445137-D7F5-57EC-87DA-1DB460D64046,"iPhone13,2"
com.apple.MobileSMS,22,1741385523,1741385545,1741385545.3487391,-21600,EB445137-D7F5-57EC-87DA-1DB460D64046,"iPhone13,2"
com.leomehlig.today,3,1741385337,1741385340,1741385340.4973888,-21600,,
com.apple.finder,0,1741385337,1741385337,1741385338.0074282,-21600,,
us.zoom.xos,9,1741385328,1741385337,1741385337.5480452,-21600,,
com.apple.finder,1,1741385327,1741385328,1741385328.998499,-21600,,
com.microsoft.VSCode,2,1741385325,1741385327,1741385328.146419,-21600,,
com.google.Chrome,32,1741385293,1741385325,1741385325.739759,-21600,,
com.apple.finder,9,1741385261,1741385270,1741385270.246361,-21600,,
com.microsoft.VSCode,1,1741385260,1741385261,1741385261.308708,-21600,,
com.apple.finder,2,1741385258,1741385260,1741385260.4660702,-21600,,
com.microsoft.VSCode,12,1741385246,1741385258,1741385258.147311,-21600,,
com.apple.finder,2,1741385244,1741385246,1741385246.0772572,-21600,,
com.microsoft.VSCode,20,1741385224,1741385244,1741385244.45994,-21600,,
com.apple.finder,15,1741385209,1741385224,1741385224.314877,-21600,,
com.microsoft.VSCode,7,1741385202,1741385209,1741385209.519753,-21600,,
com.google.Chrome,4,1741385198,1741385202,1741385202.412747,-21600,,
com.microsoft.VSCode,17,1741385181,1741385198,1741385199.06813,-21600,,
com.apple.finder,3,1741385178,1741385181,1741385181.4893851,-21600,,
com.microsoft.VSCode,269,1741384909,1741385178,1741385178.405764,-21600,,
com.apple.finder,29,1741384880,1741384909,1741384909.8898191,-21600,,
com.microsoft.VSCode,16,1741384864,1741384880,1741384880.638958,-21600,,
com.apple.finder,15,1741384849,1741384864,1741384865.062985,-21600,,
com.microsoft.VSCode,86,1741384763,1741384849,1741384849.1235762,-21600,,
com.apple.finder,63,1741384700,1741384763,1741384763.6285129,-21600,,
com.microsoft.VSCode,31,1741384669,1741384700,1741384700.897701,-21600,,
com.google.Chrome,3,1741384666,1741384669,1741384669.958057,-21600,,
com.microsoft.VSCode,1,1741384665,1741384666,1741384666.728967,-21600,,
com.google.Chrome,7,1741384658,1741384665,1741384665.39467,-21600,,
com.microsoft.VSCode,4,1741384654,1741384658,1741384658.311493,-21600,,
com.google.Chrome,10,1741384644,1741384654,1741384654.2320929,-21600,,
com.microsoft.VSCode,843,1741383801,1741384644,1741384645.352659,-21600,,
com.apple.finder,4,1741383797,1741383801,1741383801.04825,-21600,,
us.zoom.xos,13,1741383784,1741383797,1741383797.853162,-21600,,
com.apple.Notes,477,1741383307,1741383784,1741383784.9511418,-21600,,
com.apple.iCal,10,1741383297,1741383307,1741383307.151551,-21600,,
us.zoom.xos,10,1741383287,1741383297,1741383297.5491018,-21600,,
com.apple.finder,2,1741383285,1741383287,1741383287.382454,-21600,,
us.zoom.xos,51,1741383234,1741383285,1741383285.920223,-21600,,
com.apple.MobileSMS,3,1741383133,1741383136,1741383136.545124,-21600,EB445137-D7F5-57EC-87DA-1DB460D64046,"iPhone13,2"
com.google.Chrome,0,1741383090,1741383090,1741383090.661779,-21600,,
us.zoom.xos,2,1741383088,1741383090,1741383090.06302,-21600,,
com.google.Chrome,3,1741383085,1741383088,1741383088.043822,-21600,,
com.apple.iCal,3,1741383082,1741383085,1741383085.974448,-21600,,
com.google.Chrome,2,1741383080,1741383082,1741383083.133487,-21600,,
com.apple.Notes,909,1741382171,1741383080,1741383081.40867,-21600,,
com.google.Chrome,6,1741382165,1741382171,1741382171.581819,-21600,,
com.apple.finder,5,1741382160,1741382165,1741382166.9793549,-21600,,
com.jinzhenyu.ruler,1,1741382159,1741382160,1741382160.4507852,-21600,,
com.apple.finder,21,1741382138,1741382159,1741382159.8917751,-21600,,
com.apple.InCallService,1062,1741382071,1741383133,1741383133.272797,-21600,EB445137-D7F5-57EC-87DA-1DB460D64046,"iPhone13,2"
com.apple.InCallService,2,1741381652,1741381654,1741381654.252116,-21600,EB445137-D7F5-57EC-87DA-1DB460D64046,"iPhone13,2"
com.apple.MobileSMS,9,1741381643,1741381652,1741381652.5808148,-21600,EB445137-D7F5-57EC-87DA-1DB460D64046,"iPhone13,2"
com.apple.findmy,15,1741381624,1741381639,1741381640.208946,-21600,EB445137-D7F5-57EC-87DA-1DB460D64046,"iPhone13,2"
com.apple.weather,2,1741381622,1741381624,1741381625.009285,-21600,EB445137-D7F5-57EC-87DA-1DB460D64046,"iPhone13,2"
com.apple.weather,10,1741381264,1741381274,1741381274.392878,-21600,EB445137-D7F5-57EC-87DA-1DB460D64046,"iPhone13,2"
com.instructure.icanvas,66,1741380861,1741380927,1741380927.260652,-21600,EB445137-D7F5-57EC-87DA-1DB460D64046,"iPhone13,2"
com.instructure.icanvas,6,1741377675,1741377681,1741377681.867599,-21600,EB445137-D7F5-57EC-87DA-1DB460D64046,"iPhone13,2"
com.google.chrome.ios,22,1741377650,1741377672,1741377672.667039,-21600,EB445137-D7F5-57EC-87DA-1DB460D64046,"iPhone13,2"
com.apple.news,66,1741377583,1741377649,1741377649.2646341,-21600,EB445137-D7F5-57EC-87DA-1DB460D64046,"iPhone13,2"
com.google.chrome.ios,7,1741377572,1741377579,1741377579.502987,-21600,EB445137-D7F5-57EC-87DA-1DB460D64046,"iPhone13,2"
com.google.chrome.ios,22,1741376765,1741376787,1741376787.779752,-21600,EB445137-D7F5-57EC-87DA-1DB460D64046,"iPhone13,2"
com.tinyspeck.chatlyio,17,1741376581,1741376598,1741376598.689999,-21600,EB445137-D7F5-57EC-87DA-1DB460D64046,"iPhone13,2"
com.apple.finder,3,1741376565,1741376568,1741376568.679237,-21600,,
com.leomehlig.today,0,1741376565,1741376565,1741376566.22948,-21600,,
com.google.Chrome,76,1741376489,1741376565,1741376565.8704638,-21600,,
com.apple.finder,4,1741376462,1741376466,1741376466.4025068,-21600,,
com.google.Chrome,5,1741376457,1741376462,1741376462.270875,-21600,,
com.electron.carta,2,1741376455,1741376457,1741376457.86826,-21600,,
com.google.Chrome,1,1741376454,1741376455,1741376456.050318,-21600,,
com.microsoft.VSCode,26,1741376428,1741376454,1741376454.876868,-21600,,
com.apple.Notes,66,1741376362,1741376428,1741376428.947816,-21600,,
com.microsoft.VSCode,44,1741376318,1741376362,1741376362.657477,-21600,,
com.google.Chrome,1,1741376317,1741376318,1741376318.938075,-21600,,
com.microsoft.VSCode,4,1741376313,1741376317,1741376318.0235229,-21600,,
com.google.Chrome,6,1741376307,1741376313,1741376313.668989,-21600,,
com.microsoft.VSCode,30,1741376277,1741376307,1741376307.961525,-21600,,
com.google.Chrome,31,1741376246,1741376277,1741376277.289991,-21600,,
com.electron.carta,45,1741376201,1741376246,1741376246.7573838,-21600,,
com.google.Chrome,17,1741376184,1741376201,1741376201.272809,-21600,,
com.electron.carta,28,1741376156,1741376184,1741376184.726238,-21600,,
com.google.Chrome,20,1741376136,1741376156,1741376156.680194,-21600,,
com.electron.carta,54,1741376082,1741376136,1741376136.5446239,-21600,,
com.google.Chrome,43,1741376039,1741376082,1741376082.469472,-21600,,
com.electron.carta,13,1741376026,1741376039,1741376039.2846708,-21600,,
com.google.Chrome,2,1741376024,1741376026,1741376026.804799,-21600,,
com.electron.carta,8,1741376016,1741376024,1741376024.7190418,-21600,,
com.google.Chrome,46,1741375970,1741376016,1741376017.007012,-21600,,
com.electron.carta,71,1741375899,1741375970,1741375970.6194592,-21600,,
com.google.Chrome,81,1741375818,1741375899,1741375899.867745,-21600,,
com.electron.carta,27,1741375791,1741375818,1741375819.017447,-21600,,
com.google.Chrome,2,1741375789,1741375791,1741375791.217929,-21600,,
com.apple.finder,1,1741375788,1741375789,1741375789.74983,-21600,,
com.google.Chrome,1,1741375787,1741375788,1741375788.347011,-21600,,
com.electron.carta,5,1741375782,1741375787,1741375787.727119,-21600,,
com.google.Chrome,155,1741375627,1741375782,1741375782.7933722,-21600,,
com.electron.carta,14,1741375613,1741375627,1741375627.76339,-21600,,
com.google.Chrome,4,1741375609,1741375613,1741375613.09221,-21600,,
com.apple.finder,25,1741375584,1741375609,1741375609.6112099,-21600,,
com.google.Chrome,26,1741375558,1741375584,1741375585.035901,-21600,,
com.electron.carta,21,1741375537,1741375558,1741375559.064275,-21600,,
com.google.Chrome,6,1741375531,1741375537,1741375537.288841,-21600,,
com.electron.carta,13,1741375518,1741375531,1741375531.257427,-21600,,
com.google.Chrome,23,1741375495,1741375518,1741375518.993692,-21600,,
com.electron.carta,22,1741375473,1741375495,1741375495.412683,-21600,,
com.google.Chrome,10,1741375463,1741375473,1741375473.382956,-21600,,
com.electron.carta,8,1741375455,1741375463,1741375464.025282,-21600,,
com.google.Chrome,11,1741375444,1741375455,1741375455.859854,-21600,,
com.electron.carta,20,1741375424,1741375444,1741375444.452927,-21600,,
com.google.Chrome,99,1741375325,1741375424,1741375424.1747499,-21600,,
com.electron.carta,98,1741375227,1741375325,1741375325.158684,-21600,,
com.google.Chrome,123,1741375104,1741375227,1741375227.859885,-21600,,
com.electron.carta,10,1741375094,1741375104,1741375105.038436,-21600,,
com.google.Chrome,13,1741375081,1741375094,1741375094.391983,-21600,,
com.electron.carta,18,1741375063,1741375081,1741375081.2091122,-21600,,
com.google.Chrome,73,1741374990,1741375063,1741375063.916393,-21600,,
com.electron.carta,13,1741374977,1741374990,1741374990.3736959,-21600,,
com.google.Chrome,68,1741374909,1741374977,1741374977.193886,-21600,,
com.electron.carta,48,1741374861,1741374909,1741374909.719818,-21600,,
com.google.Chrome,8,1741374853,1741374861,1741374861.122188,-21600,,
com.electron.carta,74,1741374779,1741374853,1741374853.2283502,-21600,,
com.google.Chrome,42,1741374737,1741374779,1741374779.550815,-21600,,
com.electron.carta,63,1741374674,1741374737,1741374737.501916,-21600,,
com.apple.finder,10,1741374664,1741374674,1741374674.683655,-21600,,
com.instructure.icanvas,12,1741374620,1741374632,1741374632.7698488,-21600,EB445137-D7F5-57EC-87DA-1DB460D64046,"iPhone13,2"
com.apple.mobileslideshow,0,1741374620,1741374620,1741374620.938719,-21600,EB445137-D7F5-57EC-87DA-1DB460D64046,"iPhone13,2"
com.electron.carta,81,1741374583,1741374664,1741374664.635594,-21600,,
com.google.Chrome,49,1741374534,1741374583,1741374583.418239,-21600,,
com.electron.carta,42,1741374492,1741374534,1741374534.935766,-21600,,
com.jinzhenyu.ruler,2,1741374490,1741374492,1741374493.005673,-21600,,
com.google.Chrome,1,1741374489,1741374490,1741374490.570555,-21600,,
com.jinzhenyu.ruler,0,1741374489,1741374489,1741374489.895493,-21600,,
com.google.Chrome,76,1741374413,1741374489,1741374489.4433131,-21600,,
com.electron.carta,15,1741374398,1741374413,1741374413.75216,-21600,,
com.jinzhenyu.ruler,2,1741374396,1741374398,1741374398.826798,-21600,,
com.electron.carta,1,1741374395,1741374396,1741374396.841434,-21600,,
com.jinzhenyu.ruler,1,1741374394,1741374395,1741374395.778871,-21600,,
com.electron.carta,54,1741374340,1741374394,1741374394.897476,-21600,,
com.jinzhenyu.ruler,4,1741374336,1741374340,1741374340.822029,-21600,,
com.electron.carta,9,1741374327,1741374336,1741374336.125207,-21600,,
com.google.Chrome,25,1741374302,1741374327,1741374327.545229,-21600,,
com.electron.carta,18,1741374284,1741374302,1741374302.738256,-21600,,
com.google.Chrome,33,1741374251,1741374284,1741374284.873681,-21600,,
com.electron.carta,16,1741374235,1741374251,1741374251.4973478,-21600,,
com.google.Chrome,19,1741374216,1741374235,1741374235.792177,-21600,,
com.electron.carta,30,1741374186,1741374216,1741374216.402182,-21600,,
com.google.Chrome,29,1741374157,1741374186,1741374186.5911531,-21600,,
com.electron.carta,36,1741374121,1741374157,1741374157.5857658,-21600,,
com.google.Chrome,55,1741374066,1741374121,1741374121.657546,-21600,,
com.electron.carta,35,1741374031,1741374066,1741374066.8792791,-21600,,
com.jinzhenyu.ruler,2,1741374029,1741374031,1741374031.387254,-21600,,
com.google.Chrome,22,1741374007,1741374029,1741374029.999738,-21600,,
com.leomehlig.today,21,1741373986,1741374007,1741374007.226777,-21600,,
com.google.Chrome,339,1741373647,1741373986,1741373986.1558452,-21600,,
com.jinzhenyu.ruler,40,1741373607,1741373647,1741373647.242395,-21600,,
com.electron.carta,3,1741373604,1741373607,1741373607.083955,-21600,,
com.jinzhenyu.ruler,7,1741373597,1741373604,1741373604.995304,-21600,,
com.electron.carta,0,1741373597,1741373597,1741373597.682472,-21600,,
com.jinzhenyu.ruler,4,1741373593,1741373597,1741373597.204513,-21600,,
com.google.Chrome,7,1741373586,1741373593,1741373593.941729,-21600,,
com.electron.carta,8,1741373578,1741373586,1741373586.964178,-21600,,
com.google.Chrome,9,1741373569,1741373578,1741373578.45314,-21600,,
com.electron.carta,30,1741373539,1741373569,1741373569.837562,-21600,,
com.google.Chrome,27,1741373512,1741373539,1741373539.315551,-21600,,
com.electron.carta,69,1741373443,1741373512,1741373512.487097,-21600,,
com.google.Chrome,15,1741373428,1741373443,1741373443.803539,-21600,,
com.electron.carta,16,1741373412,1741373428,1741373428.6061459,-21600,,
com.google.Chrome,22,1741373390,1741373412,1741373412.442996,-21600,,
com.electron.carta,1,1741373389,1741373390,1741373390.775327,-21600,,
com.apple.finder,4,1741373385,1741373389,1741373389.450499,-21600,,
com.electron.carta,203,1741373182,1741373385,1741373385.415031,-21600,,
com.google.Chrome,9,1741373173,1741373182,1741373182.736958,-21600,,
com.electron.carta,53,1741373120,1741373173,1741373173.7965279,-21600,,
com.google.Chrome,23,1741373097,1741373120,1741373120.310647,-21600,,
com.electron.carta,66,1741373031,1741373097,1741373097.2111878,-21600,,
com.google.Chrome,44,1741372987,1741373031,1741373031.395772,-21600,,
com.electron.carta,21,1741372966,1741372987,1741372987.5365648,-21600,,
com.google.Chrome,67,1741372899,1741372966,1741372966.764822,-21600,,
com.electron.carta,2,1741372897,1741372899,1741372899.5163121,-21600,,
com.apple.mobileslideshow,3,1741372642,1741372645,1741372647.13394,-21600,EB445137-D7F5-57EC-87DA-1DB460D64046,"iPhone13,2"
com.myfitnesspal.mfp,24,1741372616,1741372640,1741372640.555336,-21600,EB445137-D7F5-57EC-87DA-1DB460D64046,"iPhone13,2"
com.electron.carta,353,1741372466,1741372819,1741372819.8745,-21600,,
com.apple.finder,14,1741372452,1741372466,1741372466.7826428,-21600,,
com.electron.carta,28,1741372424,1741372452,1741372452.0655332,-21600,,
com.google.Chrome,20,1741372404,1741372424,1741372424.300919,-21600,,
com.electron.carta,60,1741372344,1741372404,1741372404.1866179,-21600,,
com.google.Chrome,8,1741372336,1741372344,1741372344.821476,-21600,,
com.electron.carta,26,1741372310,1741372336,1741372336.301614,-21600,,
com.google.Chrome,44,1741372266,1741372310,1741372311.035798,-21600,,
com.electron.carta,22,1741372244,1741372266,1741372266.633772,-21600,,
com.google.Chrome,33,1741372211,1741372244,1741372244.2771158,-21600,,
com.electron.carta,89,1741372122,1741372211,1741372211.559451,-21600,,
com.google.Chrome,36,1741372086,1741372122,1741372122.4223099,-21600,,
com.electron.carta,17,1741372069,1741372086,1741372086.2548862,-21600,,
com.google.Chrome,84,1741371985,1741372069,1741372069.1888928,-21600,,
com.electron.carta,33,1741371952,1741371985,1741371985.260988,-21600,,
com.google.Chrome,80,1741371872,1741371952,1741371952.07122,-21600,,
com.electron.carta,39,1741371833,1741371872,1741371872.916712,-21600,,
com.google.Chrome,42,1741371791,1741371833,1741371833.996914,-21600,,
com.electron.carta,28,1741371763,1741371791,1741371791.467994,-21600,,
com.google.Chrome,84,1741371679,1741371763,1741371763.3483639,-21600,,
com.electron.carta,38,1741371641,1741371679,1741371679.472688,-21600,,
com.google.Chrome,18,1741371623,1741371641,1741371641.6696901,-21600,,
com.electron.carta,166,1741371457,1741371623,1741371623.495867,-21600,,
com.google.Chrome,10,1741371447,1741371457,1741371457.856182,-21600,,
com.apple.finder,3,1741371444,1741371447,1741371448.019301,-21600,,
com.google.Chrome,24,1741371420,1741371444,1741371444.687557,-21600,,
com.electron.carta,22,1741371398,1741371420,1741371420.500381,-21600,,
com.google.Chrome,14,1741371384,1741371398,1741371398.4438891,-21600,,
com.apple.finder,27,1741371357,1741371384,1741371384.145142,-21600,,
com.electron.carta,2,1741371355,1741371357,1741371357.4499102,-21600,,
com.apple.findmy,2,1741371353,1741371355,1741371355.154416,-21600,,
com.electron.carta,88,1741371265,1741371353,1741371353.5499802,-21600,,
com.google.Chrome,75,1741371190,1741371265,1741371265.080513,-21600,,
com.electron.carta,21,1741371169,1741371190,1741371190.216164,-21600,,
com.microsoft.VSCode,21,1741371148,1741371169,1741371169.369193,-21600,,
com.apple.finder,4,1741371054,1741371058,1741371058.394178,-21600,,
com.leomehlig.today,9,1741371045,1741371054,1741371054.642041,-21600,,
com.google.Chrome,47,1741370998,1741371045,1741371046.001723,-21600,,
com.apple.iCal,17,1741370981,1741370998,1741370998.50033,-21600,,
com.google.Chrome,56,1741370925,1741370981,1741370981.465883,-21600,,
com.leomehlig.today,28,1741370897,1741370925,1741370925.8436599,-21600,,
com.google.Chrome,1,1741370896,1741370897,1741370897.047779,-21600,,
com.apple.iCal,6,1741370890,1741370896,1741370896.0644221,-21600,,
com.google.Chrome,88,1741370802,1741370890,1741370890.390624,-21600,,
com.leomehlig.today,4,1741370693,1741370697,1741370697.116005,-21600,,
com.burbn.instagram,62,1741368436,1741368498,1741368498.665319,-21600,EB445137-D7F5-57EC-87DA-1DB460D64046,"iPhone13,2"
com.apple.MobileSMS,2,1741366707,1741366709,1741366710.500498,-21600,EB445137-D7F5-57EC-87DA-1DB460D64046,"iPhone13,2"
com.apple.news,0,1741366707,1741366707,1741366708.150012,-21600,EB445137-D7F5-57EC-87DA-1DB460D64046,"iPhone13,2"
com.leomehlig.today,2,1741366454,1741366456,1741366456.498342,-21600,,
com.apple.finder,2,1741366452,1741366454,1741366454.691554,-21600,,
com.apple.calculator,0,1741366452,1741366452,1741366453.184427,-21600,,
com.google.Chrome,2,1741366450,1741366452,1741366453.0214229,-21600,,
com.microsoft.VSCode,157,1741366293,1741366450,1741366450.764203,-21600,,
com.google.Chrome,1,1741366292,1741366293,1741366293.923716,-21600,,
com.apple.Notes,7,1741366285,1741366292,1741366292.4894,-21600,,
com.google.Chrome,73,1741366212,1741366285,1741366285.497781,-21600,,
com.leomehlig.today,101,1741366111,1741366212,1741366212.260462,-21600,,
com.google.Chrome,1,1741366110,1741366111,1741366111.492877,-21600,,
com.leomehlig.today,12,1741366098,1741366110,1741366110.917074,-21600,,
com.google.Chrome,5,1741366093,1741366098,1741366099.074782,-21600,,
com.apple.calculator,4,1741366089,1741366093,1741366093.8659148,-21600,,
com.google.Chrome,6,1741366083,1741366089,1741366089.7272902,-21600,,
com.apple.calculator,6,1741366077,1741366083,1741366083.263149,-21600,,
com.google.Chrome,3,1741366074,1741366077,1741366077.844759,-21600,,
com.apple.calculator,74,1741366000,1741366074,1741366074.8113961,-21600,,
com.google.Chrome,1,1741365999,1741366000,1741366000.752771,-21600,,
com.apple.calculator,12,1741365987,1741365999,1741365999.962466,-21600,,
com.google.Chrome,18,1741365969,1741365987,1741365988.017535,-21600,,
com.apple.calculator,15,1741365954,1741365969,1741365969.3091311,-21600,,
com.google.Chrome,1,1741365953,1741365954,1741365954.9431648,-21600,,
com.apple.calculator,26,1741365927,1741365953,1741365953.696542,-21600,,
com.google.Chrome,10,1741365917,1741365927,1741365927.3952088,-21600,,
com.apple.calculator,19,1741365898,1741365917,1741365917.203395,-21600,,
com.google.Chrome,5,1741365893,1741365898,1741365898.4455318,-21600,,
com.apple.calculator,1,1741365892,1741365893,1741365893.368112,-21600,,
com.google.Chrome,2,1741365890,1741365892,1741365892.306631,-21600,,
com.apple.calculator,15,1741365875,1741365890,1741365890.862091,-21600,,
com.google.Chrome,33,1741365842,1741365875,1741365875.342585,-21600,,
com.apple.calculator,3,1741365839,1741365842,1741365842.840601,-21600,,
com.google.Chrome,3,1741365836,1741365839,1741365839.385669,-21600,,
com.apple.calculator,24,1741365812,1741365836,1741365836.4095402,-21600,,
com.apple.Notes,5,1741365807,1741365812,1741365812.2376652,-21600,,
com.apple.calculator,24,1741365783,1741365807,1741365807.682512,-21600,,
com.google.Chrome,1,1741365782,1741365783,1741365783.945517,-21600,,
com.apple.calculator,26,1741365756,1741365782,1741365783.050799,-21600,,
com.google.Chrome,21,1741365735,1741365756,1741365756.440666,-21600,,
com.apple.calculator,12,1741365723,1741365735,1741365735.298091,-21600,,
com.google.Chrome,2,1741365721,1741365723,1741365723.3046598,-21600,,
com.apple.calculator,22,1741365699,1741365721,1741365722.052009,-21600,,
com.google.Chrome,14,1741365685,1741365699,1741365699.302902,-21600,,
com.apple.calculator,14,1741365671,1741365685,1741365685.743818,-21600,,
com.google.Chrome,1,1741365670,1741365671,1741365671.586217,-21600,,
com.apple.calculator,18,1741365652,1741365670,1741365670.9296,-21600,,
com.google.Chrome,3,1741365649,1741365652,1741365652.2744741,-21600,,
com.apple.calculator,15,1741365634,1741365649,1741365649.094318,-21600,,
com.google.Chrome,1,1741365633,1741365634,1741365634.43886,-21600,,
com.apple.calculator,21,1741365612,1741365633,1741365633.0617728,-21600,,
com.google.Chrome,389,1741365223,1741365612,1741365612.451058,-21600,,
com.apple.calculator,12,1741365211,1741365223,1741365223.600771,-21600,,
com.google.Chrome,12,1741365199,1741365211,1741365211.909586,-21600,,
com.apple.calculator,1,1741365198,1741365199,1741365199.92562,-21600,,
com.apple.finder,1,1741365197,1741365198,1741365198.9898639,-21600,,
com.apple.calculator,1,1741365196,1741365197,1741365197.756456,-21600,,
com.google.Chrome,56,1741365140,1741365196,1741365196.784661,-21600,,
com.apple.calculator,15,1741365125,1741365140,1741365140.44033,-21600,,
com.google.Chrome,34,1741365091,1741365125,1741365125.082008,-21600,,
com.apple.calculator,31,1741365060,1741365091,1741365092.01432,-21600,,
com.google.Chrome,13,1741365047,1741365060,1741365060.2737489,-21600,,
com.apple.calculator,13,1741365034,1741365047,1741365047.83987,-21600,,
com.google.Chrome,1,1741365033,1741365034,1741365034.858253,-21600,,
com.apple.calculator,41,1741364992,1741365033,1741365033.969145,-21600,,
com.google.Chrome,47,1741364945,1741364992,1741364992.1825361,-21600,,
com.apple.calculator,44,1741364901,1741364945,1741364945.883497,-21600,,
com.google.Chrome,4,1741364897,1741364901,1741364901.963175,-21600,,
com.apple.calculator,14,1741364883,1741364897,1741364897.5419378,-21600,,
com.google.Chrome,23,1741364860,1741364883,1741364883.209639,-21600,,
com.apple.calculator,86,1741364774,1741364860,1741364860.138579,-21600,,
com.google.Chrome,3,1741364771,1741364774,1741364774.835565,-21600,,
com.apple.calculator,11,1741364760,1741364771,1741364771.783493,-21600,,
com.google.Chrome,7,1741364753,1741364760,1741364760.360991,-21600,,
com.apple.calculator,2,1741364751,1741364753,1741364753.9159179,-21600,,
com.google.Chrome,2,1741364749,1741364751,1741364751.1749039,-21600,,
com.apple.calculator,22,1741364727,1741364749,1741364749.8960562,-21600,,
com.google.Chrome,2,1741364725,1741364727,1741364727.1613312,-21600,,
com.apple.calculator,31,1741364694,1741364725,1741364725.7186031,-21600,,
com.apple.news,53,1741364159,1741364212,1741364213.3377218,-21600,EB445137-D7F5-57EC-87DA-1DB460D64046,"iPhone13,2"
com.google.Chrome,707,1741363987,1741364694,1741364694.8290029,-21600,,
com.clairmail.fth.client,30,1741363744,1741363774,1741363774.582955,-21600,EB445137-D7F5-57EC-87DA-1DB460D64046,"iPhone13,2"
com.truebill.truebillnative,3,1741363741,1741363744,1741363745.1527128,-21600,EB445137-D7F5-57EC-87DA-1DB460D64046,"iPhone13,2"
com.apple.CoreAuthUI,2,1741363719,1741363721,1741363721.8214312,-21600,EB445137-D7F5-57EC-87DA-1DB460D64046,"iPhone13,2"
com.clairmail.fth.client,25,1741363716,1741363741,1741363741.969473,-21600,EB445137-D7F5-57EC-87DA-1DB460D64046,"iPhone13,2"
com.apple.CoreAuthUI,8,1741363583,1741363591,1741363591.7599258,-21600,EB445137-D7F5-57EC-87DA-1DB460D64046,"iPhone13,2"
com.truebill.truebillnative,133,1741363578,1741363711,1741363711.6944752,-21600,EB445137-D7F5-57EC-87DA-1DB460D64046,"iPhone13,2"
com.google.Chrome,302,1741363333,1741363635,1741363635.396947,-21600,,
com.apple.finder,46,1741363287,1741363333,1741363333.545333,-21600,,
com.apple.news,2,1741363155,1741363157,1741363159.6184912,-21600,EB445137-D7F5-57EC-87DA-1DB460D64046,"iPhone13,2"
com.apple.Health,2,1741363153,1741363155,1741363157.605994,-21600,EB445137-D7F5-57EC-87DA-1DB460D64046,"iPhone13,2"
com.google.Chrome,139,1741363148,1741363287,1741363287.236847,-21600,,
com.apple.finder,68,1741363080,1741363148,1741363148.782227,-21600,,
com.apple.Health,25,1741363023,1741363048,1741363049.252439,-21600,EB445137-D7F5-57EC-87DA-1DB460D64046,"iPhone13,2"
com.google.Chrome,223,1741362857,1741363080,1741363080.931318,-21600,,
com.microsoft.VSCode,10,1741362847,1741362857,1741362857.048527,-21600,,
com.google.Chrome,91,1741362756,1741362847,1741362847.9611979,-21600,,
com.leomehlig.today,86,1741362670,1741362756,1741362756.536273,-21600,,
com.google.Chrome,1,1741362669,1741362670,1741362671.0453382,-21600,,
com.microsoft.VSCode,33,1741362636,1741362669,1741362669.989172,-21600,,
com.google.Chrome,1,1741362635,1741362636,1741362637.086276,-21600,,
com.microsoft.VSCode,5,1741362630,1741362635,1741362635.68026,-21600,,
com.google.Chrome,3,1741362627,1741362630,1741362630.703218,-21600,,
com.microsoft.VSCode,9,1741362618,1741362627,1741362627.820657,-21600,,
com.google.Chrome,46,1741362572,1741362618,1741362618.586168,-21600,,
com.microsoft.VSCode,103,1741362469,1741362572,1741362572.0653481,-21600,,
com.google.Chrome,32,1741362437,1741362469,1741362469.992897,-21600,,
com.microsoft.VSCode,9,1741362428,1741362437,1741362437.186891,-21600,,
com.google.Chrome,48,1741362380,1741362428,1741362428.518734,-21600,,
com.microsoft.VSCode,8,1741362372,1741362380,1741362380.939227,-21600,,
com.google.Chrome,19,1741362353,1741362372,1741362373.031251,-21600,,
com.microsoft.VSCode,346,1741362007,1741362353,1741362353.2591019,-21600,,
com.google.Chrome,33,1741361974,1741362007,1741362007.454761,-21600,,
com.microsoft.VSCode,4,1741361970,1741361974,1741361974.770905,-21600,,
com.google.Chrome,24,1741361946,1741361970,1741361970.806624,-21600,,
com.microsoft.VSCode,276,1741361670,1741361946,1741361947.040783,-21600,,
com.google.Chrome,2,1741361668,1741361670,1741361670.600318,-21600,,
com.microsoft.VSCode,97,1741361571,1741361668,1741361668.7094831,-21600,,
com.google.Chrome,2,1741361569,1741361571,1741361571.495148,-21600,,
com.microsoft.VSCode,2,1741361567,1741361569,1741361570.013381,-21600,,
com.google.Chrome,1,1741361566,1741361567,1741361567.831977,-21600,,
com.microsoft.VSCode,14,1741361552,1741361566,1741361566.336401,-21600,,
com.google.Chrome,3,1741361549,1741361552,1741361552.6295772,-21600,,
com.microsoft.VSCode,16,1741361533,1741361549,1741361549.0696712,-21600,,
com.google.Chrome,2,1741361531,1741361533,1741361533.14612,-21600,,
com.microsoft.VSCode,10,1741361521,1741361531,1741361531.8991241,-21600,,
com.google.Chrome,4,1741361517,1741361521,1741361521.90431,-21600,,
com.microsoft.VSCode,4,1741361513,1741361517,1741361517.5807881,-21600,,
com.google.Chrome,1,1741361512,1741361513,1741361513.883419,-21600,,
com.microsoft.VSCode,79,1741361433,1741361512,1741361512.524777,-21600,,
com.google.Chrome,14,1741361419,1741361433,1741361433.5545979,-21600,,
com.microsoft.VSCode,116,1741361290,1741361406,1741361406.545384,-21600,,
com.google.Chrome,3,1741361287,1741361290,1741361290.561923,-21600,,
com.microsoft.VSCode,68,1741361219,1741361287,1741361287.3967829,-21600,,
com.google.Chrome,2,1741361217,1741361219,1741361219.635711,-21600,,
com.microsoft.VSCode,53,1741361164,1741361217,1741361217.9070082,-21600,,
com.google.Chrome,3,1741361161,1741361164,1741361165.0086288,-21600,,
com.microsoft.VSCode,69,1741361092,1741361161,1741361161.582809,-21600,,
com.google.Chrome,26,1741361066,1741361092,1741361092.977113,-21600,,
com.microsoft.VSCode,25,1741361041,1741361066,1741361066.6346679,-21600,,
com.google.Chrome,35,1741361006,1741361041,1741361041.2202392,-21600,,
com.microsoft.VSCode,551,1741360455,1741361006,1741361006.546472,-21600,,
com.google.Chrome,84,1741360371,1741360455,1741360455.197825,-21600,,
com.leomehlig.today,11,1741360360,1741360371,1741360371.53146,-21600,,
com.google.Chrome,16,1741360344,1741360360,1741360360.532638,-21600,,
com.microsoft.VSCode,8,1741360336,1741360344,1741360344.487062,-21600,,
com.google.Chrome,10,1741360326,1741360336,1741360336.68574,-21600,,
com.microsoft.VSCode,36,1741360290,1741360326,1741360326.8126101,-21600,,
com.google.Chrome,1,1741360289,1741360290,1741360290.105288,-21600,,
com.microsoft.VSCode,4,1741360285,1741360289,1741360289.090732,-21600,,
com.google.Chrome,1,1741360284,1741360285,1741360285.351337,-21600,,
com.microsoft.VSCode,287,1741359997,1741360284,1741360284.442883,-21600,,
com.google.Chrome,4,1741359993,1741359997,1741359997.1608438,-21600,,
com.microsoft.VSCode,4,1741359989,1741359993,1741359993.934207,-21600,,
com.google.Chrome,74,1741359915,1741359989,1741359989.06952,-21600,,
com.microsoft.VSCode,2,1741359913,1741359915,1741359915.098206,-21600,,
com.google.Chrome,2,1741359911,1741359913,1741359913.398687,-21600,,
com.microsoft.VSCode,2,1741359909,1741359911,1741359912.016556,-21600,,
com.google.Chrome,5,1741359904,1741359909,1741359909.852031,-21600,,
com.microsoft.VSCode,22,1741359882,1741359904,1741359904.9201179,-21600,,
com.apple.finder,6,1741359876,1741359882,1741359882.2891378,-21600,,
com.apple.Passwords,8,1741359868,1741359876,1741359876.46938,-21600,,
com.apple.finder,3,1741359832,1741359835,1741359835.04567,-21600,,
com.microsoft.Outlook,13,1741359819,1741359832,1741359832.970468,-21600,,
com.microsoft.Outlook,1,1741358726,1741358727,1741358727.640017,-21600,,
com.apple.Passwords,0,1741358726,1741358726,1741358726.655165,-21600,,
com.google.Chrome,55,1741358671,1741358726,1741358726.121467,-21600,,
com.duosecurity.DuoMobile,10,1741358558,1741358568,1741358568.794492,-21600,EB445137-D7F5-57EC-87DA-1DB460D64046,"iPhone13,2"
com.microsoft.Outlook,35,1741358539,1741358574,1741358574.196902,-21600,,
com.apple.Passwords,2,1741358537,1741358539,1741358539.241822,-21600,,
com.microsoft.Outlook,1,1741358536,1741358537,1741358538.001243,-21600,,
com.apple.Passwords,2,1741358534,1741358536,1741358536.5155869,-21600,,
com.microsoft.Outlook,4,1741358530,1741358534,1741358534.9979491,-21600,,
com.apple.Passwords,2,1741358528,1741358530,1741358530.4010081,-21600,,
com.microsoft.Outlook,4,1741358524,1741358528,1741358528.242638,-21600,,
com.apple.Passwords,9,1741358515,1741358524,1741358524.905927,-21600,,
com.microsoft.Outlook,8,1741358507,1741358515,1741358515.490483,-21600,,
com.google.Chrome,4,1741358503,1741358507,1741358507.388001,-21600,,
com.apple.MobileSMS,24,1741358479,1741358503,1741358503.4730039,-21600,,
com.google.Chrome,1,1741358478,1741358479,1741358483.558745,-21600,,
com.microsoft.Outlook,5,1741358473,1741358478,1741358482.3578482,-21600,,
com.apple.finder,4,1741358469,1741358473,1741358473.4985151,-21600,,
com.apple.MobileSMS,25,1741357963,1741357988,1741357989.130069,-21600,EB445137-D7F5-57EC-87DA-1DB460D64046,"iPhone13,2"
com.renpho.health,18,1741357940,1741357958,1741357958.960699,-21600,EB445137-D7F5-57EC-87DA-1DB460D64046,"iPhone13,2"
com.apple.CoreAuthUI,6,1741326182,1741326188,1741326188.1887631,-21600,EB445137-D7F5-57EC-87DA-1DB460D64046,"iPhone13,2"
com.apple.journal,408,1741326180,1741326588,1741326588.1272979,-21600,EB445137-D7F5-57EC-87DA-1DB460D64046,"iPhone13,2"
com.apple.reminders,5,1741326160,1741326165,1741326165.847178,-21600,EB445137-D7F5-57EC-87DA-1DB460D64046,"iPhone13,2"
com.apple.Health,99,1741326058,1741326157,1741326157.71159,-21600,EB445137-D7F5-57EC-87DA-1DB460D64046,"iPhone13,2"
com.thestorygraph.thestorygraph,37,1741326017,1741326054,1741326054.169085,-21600,EB445137-D7F5-57EC-87DA-1DB460D64046,"iPhone13,2"
com.thestorygraph.thestorygraph,2,1741326015,1741326017,1741326017.270129,-21600,EB445137-D7F5-57EC-87DA-1DB460D64046,"iPhone13,2"
com.thestorygraph.thestorygraph,214,1741324112,1741324326,1741324326.8658,-21600,EB445137-D7F5-57EC-87DA-1DB460D64046,"iPhone13,2"
com.apple.MobileSMS,12,1741324100,1741324112,1741324112.837975,-21600,EB445137-D7F5-57EC-87DA-1DB460D64046,"iPhone13,2"
com.apple.MobileSMS,6,1741324011,1741324017,1741324018.01756,-21600,EB445137-D7F5-57EC-87DA-1DB460D64046,"iPhone13,2"
com.google.chrome.ios,17,1741323984,1741324001,1741324001.928647,-21600,EB445137-D7F5-57EC-87DA-1DB460D64046,"iPhone13,2"
com.apple.finder,2,1741322568,1741322570,1741322570.836288,-21600,,
com.google.Chrome,1,1741322567,1741322568,1741322568.9928021,-21600,,
com.apple.finder,1,1741322566,1741322567,1741322567.624759,-21600,,
com.leomehlig.today,9,1741322557,1741322566,1741322566.590095,-21600,,
com.google.Chrome,2,1741322555,1741322557,1741322557.548949,-21600,,
com.apple.MobileSMS,3,1741322552,1741322555,1741322555.915927,-21600,,
com.google.Chrome,4,1741322548,1741322552,1741322552.245467,-21600,,
com.microsoft.VSCode,95,1741322453,1741322548,1741322549.043188,-21600,,
com.google.Chrome,1,1741322452,1741322453,1741322454.066036,-21600,,
com.microsoft.VSCode,1,1741322451,1741322452,1741322452.354388,-21600,,
com.google.Chrome,52,1741322399,1741322451,1741322451.255546,-21600,,
com.microsoft.VSCode,625,1741321774,1741322399,1741322399.343978,-21600,,
com.google.Chrome,16,1741321758,1741321774,1741321774.584377,-21600,,
com.microsoft.VSCode,70,1741321688,1741321758,1741321758.276445,-21600,,
com.google.Chrome,15,1741321673,1741321688,1741321688.412372,-21600,,
com.microsoft.VSCode,48,1741321625,1741321673,1741321673.989459,-21600,,
com.google.Chrome,8,1741321617,1741321625,1741321625.357115,-21600,,
com.microsoft.VSCode,53,1741321564,1741321617,1741321617.905105,-21600,,
com.google.Chrome,1,1741321563,1741321564,1741321564.889186,-21600,,
com.microsoft.VSCode,3,1741321560,1741321563,1741321563.8268151,-21600,,
com.google.Chrome,13,1741321547,1741321560,1741321560.9387689,-21600,,
com.microsoft.VSCode,95,1741321452,1741321547,1741321547.943454,-21600,,
com.google.Chrome,32,1741321420,1741321452,1741321452.789991,-21600,,
com.microsoft.VSCode,1096,1741320324,1741321420,1741321420.603045,-21600,,
com.google.Chrome,42,1741320282,1741320324,1741320324.8085442,-21600,,
com.microsoft.VSCode,101,1741320181,1741320282,1741320282.259218,-21600,,
com.google.Chrome,8,1741320173,1741320181,1741320181.630647,-21600,,
com.microsoft.VSCode,579,1741319594,1741320173,1741320173.1424232,-21600,,
com.microsoft.VSCode,1129,1741317839,1741318968,1741318968.63035,-21600,,
com.google.Chrome,81,1741317758,1741317839,1741317840.057842,-21600,,
com.microsoft.VSCode,992,1741316766,1741317758,1741317758.9675632,-21600,,
com.google.Chrome,4,1741316762,1741316766,1741316766.332046,-21600,,
com.microsoft.VSCode,25,1741316737,1741316762,1741316763.0525022,-21600,,
com.google.Chrome,6,1741316731,1741316737,1741316738.010901,-21600,,
com.microsoft.VSCode,4,1741316727,1741316731,1741316731.870784,-21600,,
com.google.Chrome,122,1741316605,1741316727,1741316727.5471659,-21600,,
com.microsoft.VSCode,11,1741316594,1741316605,1741316605.890477,-21600,,
com.google.Chrome,3,1741316591,1741316594,1741316594.293611,-21600,,
com.microsoft.VSCode,538,1741316053,1741316591,1741316591.433121,-21600,,
com.apple.finder,1,1741316052,1741316053,1741316054.4176788,-21600,,
com.leomehlig.today,1,1741316051,1741316052,1741316052.77383,-21600,,
com.microsoft.Outlook,9,1741316042,1741316051,1741316051.145306,-21600,,
com.microsoft.Outlook,16,1741315560,1741315576,1741315576.686538,-21600,,
com.apple.Passwords,9,1741315551,1741315560,1741315560.373508,-21600,,
com.google.Chrome,28,1741315523,1741315551,1741315551.812391,-21600,,
com.apple.Passwords,19,1741315504,1741315523,1741315523.611896,-21600,,
com.google.Chrome,3,1741315501,1741315504,1741315504.1869931,-21600,,
com.apple.Passwords,12,1741315489,1741315501,1741315501.92584,-21600,,
com.google.Chrome,27,1741315462,1741315489,1741315489.46517,-21600,,
com.microsoft.Outlook,117,1741315345,1741315462,1741315462.598834,-21600,,
com.google.Chrome,34,1741315311,1741315345,1741315345.207924,-21600,,
com.microsoft.Outlook,2,1741315309,1741315311,1741315311.087616,-21600,,
com.google.Chrome,9,1741315300,1741315309,1741315309.873364,-21600,,
com.leomehlig.today,46,1741315245,1741315291,1741315291.489768,-21600,,
com.google.Chrome,2,1741315243,1741315245,1741315245.324516,-21600,,
com.microsoft.VSCode,597,1741314646,1741315243,1741315244.267252,-21600,,
com.google.Chrome,34,1741314612,1741314646,1741314646.687844,-21600,,
com.microsoft.VSCode,296,1741314316,1741314612,1741314612.883075,-21600,,
com.apple.news,75,1741314092,1741314167,1741314167.331701,-21600,EB445137-D7F5-57EC-87DA-1DB460D64046,"iPhone13,2"
com.microsoft.VSCode,2730,1741311585,1741314315,1741314315.329018,-21600,,
com.leomehlig.today,9,1741311576,1741311585,1741311585.852223,-21600,,
com.microsoft.VSCode,604,1741310972,1741311576,1741311576.7777991,-21600,,
com.google.Chrome,103,1741310869,1741310972,1741310972.853883,-21600,,
com.apple.news,2,1741309640,1741309642,1741309643.040488,-21600,EB445137-D7F5-57EC-87DA-1DB460D64046,"iPhone13,2"
com.microsoft.VSCode,1411,1741309458,1741310869,1741310869.468719,-21600,,
com.microsoft.Outlook,3,1741309455,1741309458,1741309458.501213,-21600,,
com.google.Chrome,36,1741309419,1741309455,1741309455.242607,-21600,,
com.microsoft.Outlook,8,1741309411,1741309419,1741309419.721538,-21600,,
com.google.Chrome,5,1741309406,1741309411,1741309411.8058019,-21600,,
com.apple.Passwords,18,1741309388,1741309406,1741309406.318839,-21600,,
com.google.Chrome,31,1741309357,1741309388,1741309388.981756,-21600,,
com.microsoft.VSCode,1095,1741308262,1741309357,1741309357.097775,-21600,,
com.microsoft.Outlook,1,1741308261,1741308262,1741308262.74892,-21600,,
com.google.Chrome,142,1741308119,1741308261,1741308261.120656,-21600,,
com.microsoft.Outlook,22,1741308065,1741308087,1741308087.0732632,-21600,,
com.microsoft.VSCode,324,1741307741,1741308065,1741308065.580651,-21600,,
com.google.Chrome,11,1741307730,1741307741,1741307741.868353,-21600,,
com.microsoft.VSCode,14,1741307716,1741307730,1741307730.219934,-21600,,
com.apple.finder,2,1741307714,1741307716,1741307716.848044,-21600,,
com.apple.iCal,1,1741307713,1741307714,1741307714.41341,-21600,,
com.leomehlig.today,1,1741307712,1741307713,1741307713.586128,-21600,,
com.google.Chrome,5,1741307707,1741307712,1741307712.866185,-21600,,
com.google.Chrome,325,1741306901,1741307226,1741307226.713286,-21600,,
com.leomehlig.today,19,1741306882,1741306901,1741306901.78299,-21600,,
com.apple.news,41,1741306631,1741306672,1741306672.789832,-21600,EB445137-D7F5-57EC-87DA-1DB460D64046,"iPhone13,2"
com.toyopagroup.picaboo,12,1741306609,1741306621,1741306621.558217,-21600,EB445137-D7F5-57EC-87DA-1DB460D64046,"iPhone13,2"
com.google.Chrome,382,1741306500,1741306882,1741306882.485174,-21600,,
com.google.Chrome,302,1741306179,1741306481,1741306481.172748,-21600,,
com.google.Chrome,304,1741305851,1741306155,1741306155.925081,-21600,,
com.apple.MobileSMS,9,1741305842,1741305851,1741305851.153693,-21600,,
com.toyopagroup.picaboo,8,1741305410,1741305418,1741305418.259392,-21600,EB445137-D7F5-57EC-87DA-1DB460D64046,"iPhone13,2"
com.apple.MobileSMS,301,1741305399,1741305700,1741305700.51647,-21600,,
com.apple.FaceTime,10,1741305389,1741305399,1741305399.598402,-21600,,
com.apple.MobileSMS,7,1741305382,1741305389,1741305389.347965,-21600,,
com.apple.FaceTime,1,1741305381,1741305382,1741305382.453566,-21600,,
com.apple.MobileSMS,2,1741305379,1741305381,1741305381.168394,-21600,,
com.toyopagroup.picaboo,9,1741305352,1741305361,1741305361.684011,-21600,EB445137-D7F5-57EC-87DA-1DB460D64046,"iPhone13,2"
Astrospheric.Astrospheric,2,1741305345,1741305347,1741305347.698306,-21600,EB445137-D7F5-57EC-87DA-1DB460D64046,"iPhone13,2"
com.leomehlig.today,51,1741305328,1741305379,1741305380.035408,-21600,,
com.google.Chrome,55,1741305273,1741305328,1741305329.114248,-21600,,
com.apple.iCal,311,1741304962,1741305273,1741305273.361234,-21600,,
Astrospheric.Astrospheric,82,1741304939,1741305021,1741305021.958181,-21600,EB445137-D7F5-57EC-87DA-1DB460D64046,"iPhone13,2"
com.apple.weather,31,1741304907,1741304938,1741304938.072701,-21600,EB445137-D7F5-57EC-87DA-1DB460D64046,"iPhone13,2"
com.apple.news,1,1741304906,1741304907,1741304908.068479,-21600,EB445137-D7F5-57EC-87DA-1DB460D64046,"iPhone13,2"
com.leomehlig.today,89,1741304873,1741304962,1741304962.993465,-21600,,
com.apple.finder,391,1741304482,1741304873,1741304873.972447,-21600,,
com.apple.news,15,1741304462,1741304477,1741304477.762454,-21600,EB445137-D7F5-57EC-87DA-1DB460D64046,"iPhone13,2"
com.apple.FaceTime,90,1741304392,1741304482,1741304482.448647,-21600,,
com.google.Chrome,12,1741304380,1741304392,1741304392.778057,-21600,,
com.apple.FaceTime,32,1741304348,1741304380,1741304380.94138,-21600,,
com.google.Chrome,128,1741304220,1741304348,1741304348.395102,-21600,,
com.apple.FaceTime,13,1741304207,1741304220,1741304220.613696,-21600,,
com.google.Chrome,6,1741304201,1741304207,1741304207.7722301,-21600,,
com.apple.FaceTime,89,1741304112,1741304201,1741304201.62415,-21600,,
com.google.Chrome,9,1741304103,1741304112,1741304112.838875,-21600,,
com.apple.FaceTime,6,1741304097,1741304103,1741304103.681586,-21600,,
com.google.Chrome,34,1741304063,1741304097,1741304097.75394,-21600,,
com.apple.FaceTime,59,1741304004,1741304063,1741304063.381017,-21600,,
com.apple.MobileSMS,3,1741304001,1741304004,1741304004.905797,-21600,,
com.apple.FaceTime,303,1741303698,1741304001,1741304001.060629,-21600,,
com.apple.FaceTime,300,1741303164,1741303464,1741303464.027566,-21600,,
com.apple.news,137,1741302999,1741303136,1741303136.81489,-21600,EB445137-D7F5-57EC-87DA-1DB460D64046,"iPhone13,2"
com.toyopagroup.picaboo,24,1741302960,1741302984,1741302984.7720919,-21600,EB445137-D7F5-57EC-87DA-1DB460D64046,"iPhone13,2"
com.apple.news,0,1741302960,1741302960,1741302961.2395082,-21600,EB445137-D7F5-57EC-87DA-1DB460D64046,"iPhone13,2"
com.apple.MobileSMS,249,1741302915,1741303164,1741303164.184937,-21600,,
com.google.Chrome,36,1741302879,1741302915,1741302915.211694,-21600,,
com.leomehlig.today,21,1741302831,1741302852,1741302853.263191,-21600,,
com.apple.MobileSMS,21,1741302810,1741302831,1741302831.1351209,-21600,,
com.apple.FaceTime,26,1741302784,1741302810,1741302811.024588,-21600,,
com.apple.MobileSMS,102,1741302682,1741302784,1741302785.0283918,-21600,,
com.leomehlig.today,1,1741302681,1741302682,1741302683.013544,-21600,,
com.apple.MobileSMS,2,1741302679,1741302681,1741302681.114867,-21600,,
com.microsoft.Outlook,5,1741302674,1741302679,1741302679.937625,-21600,,
com.google.Chrome,16,1741302658,1741302674,1741302674.767962,-21600,,
com.apple.news,41,1741302437,1741302478,1741302479.1728601,-21600,EB445137-D7F5-57EC-87DA-1DB460D64046,"iPhone13,2"
com.apple.findmy,4,1741302431,1741302435,1741302435.474575,-21600,EB445137-D7F5-57EC-87DA-1DB460D64046,"iPhone13,2"
com.apple.findmy,12,1741302395,1741302407,1741302407.344029,-21600,EB445137-D7F5-57EC-87DA-1DB460D64046,"iPhone13,2"
com.toyopagroup.picaboo,6,1741302381,1741302387,1741302387.253415,-21600,EB445137-D7F5-57EC-87DA-1DB460D64046,"iPhone13,2"
com.google.Chrome,433,1741300615,1741301048,1741301048.5875669,-21600,,
com.microsoft.Outlook,19,1741300596,1741300615,1741300615.081365,-21600,,
com.google.Chrome,2,1741300594,1741300596,1741300596.854939,-21600,,
com.leomehlig.today,2,1741300592,1741300594,1741300594.6635718,-21600,,
com.google.Chrome,3,1741300589,1741300592,1741300592.3048759,-21600,,
com.microsoft.Outlook,17,1741300572,1741300589,1741300589.370342,-21600,,
com.google.Chrome,74,1741300498,1741300572,1741300572.084447,-21600,,
com.microsoft.Outlook,21,1741300477,1741300498,1741300498.21591,-21600,,
com.google.Chrome,64,1741300413,1741300477,1741300477.399636,-21600,,
com.microsoft.Outlook,8,1741300405,1741300413,1741300413.4540482,-21600,,
com.google.Chrome,29,1741300376,1741300405,1741300405.076374,-21600,,
com.microsoft.Outlook,41,1741300335,1741300376,1741300376.7030811,-21600,,
com.google.Chrome,14,1741300321,1741300335,1741300336.088718,-21600,,
com.microsoft.Outlook,0,1741300321,1741300321,1741300321.6722689,-21600,,
com.google.Chrome,30,1741300291,1741300321,1741300321.198206,-21600,,
com.leomehlig.today,6,1741300285,1741300291,1741300291.808495,-21600,,
com.google.Chrome,1375,1741298910,1741300285,1741300286.0929189,-21600,,
com.microsoft.Office.Outlook,8,1741298030,1741298038,1741298038.8200002,-21600,EB445137-D7F5-57EC-87DA-1DB460D64046,"iPhone13,2"
com.toyopagroup.picaboo,1,1741298029,1741298030,1741298030.6621861,-21600,EB445137-D7F5-57EC-87DA-1DB460D64046,"iPhone13,2"
com.toyopagroup.picaboo,6,1741297953,1741297959,1741297959.9146528,-21600,EB445137-D7F5-57EC-87DA-1DB460D64046,"iPhone13,2"
com.apple.mobileslideshow,0,1741297953,1741297953,1741297955.74435,-21600,EB445137-D7F5-57EC-87DA-1DB460D64046,"iPhone13,2"
com.google.Chrome,3,1741297865,1741297868,1741297868.945919,-21600,,
com.apple.finder,1,1741297864,1741297865,1741297865.1933541,-21600,,
com.leomehlig.today,1,1741297863,1741297864,1741297864.284842,-21600,,
com.apple.finder,5,1741297858,1741297863,1741297864.004191,-21600,,
com.google.Chrome,18,1741297840,1741297858,1741297858.871223,-21600,,
com.leomehlig.today,77,1741297763,1741297840,1741297840.894059,-21600,,
com.apple.iCal,10,1741297753,1741297763,1741297763.897681,-21600,,
com.google.Chrome,938,1741296815,1741297753,1741297753.114143,-21600,,
com.google.Chrome,469,1741295350,1741295819,1741295819.258453,-21600,,
com.apple.Photos,26,1741295324,1741295350,1741295351.100043,-21600,,
com.apple.mobileslideshow,9,1741295313,1741295322,1741295322.249331,-21600,EB445137-D7F5-57EC-87DA-1DB460D64046,"iPhone13,2"
com.google.Chrome,122,1741295202,1741295324,1741295324.489273,-21600,,
com.apple.calculator,151,1741295051,1741295202,1741295202.395237,-21600,,
com.google.Chrome,4,1741295047,1741295051,1741295051.817394,-21600,,
com.google.Chrome,318,1741291857,1741292175,1741292175.447952,-21600,,
com.google.Chrome,331,1741291279,1741291610,1741291610.272654,-21600,,
com.apple.finder,2,1741291266,1741291268,1741291269.522445,-21600,,
com.tinyspeck.chatlyio,14,1741291017,1741291031,1741291031.372272,-21600,EB445137-D7F5-57EC-87DA-1DB460D64046,"iPhone13,2"
com.toyopagroup.picaboo,2,1741291013,1741291015,1741291016.215903,-21600,EB445137-D7F5-57EC-87DA-1DB460D64046,"iPhone13,2"
com.toyopagroup.picaboo,6,1741290414,1741290420,1741290420.3636599,-21600,EB445137-D7F5-57EC-87DA-1DB460D64046,"iPhone13,2"
com.apple.finder,17,1741290267,1741290284,1741290284.7731972,-21600,,
com.microsoft.Outlook,2,1741290265,1741290267,1741290267.7030869,-21600,,
com.microsoft.VSCode,240,1741290025,1741290265,1741290266.964889,-21600,,
com.microsoft.Outlook,11,1741290014,1741290025,1741290025.083652,-21600,,
com.google.Chrome,161,1741289853,1741290014,1741290014.426275,-21600,,
com.apple.Notes,14,1741289839,1741289853,1741289854.170363,-21600,,
com.google.Chrome,53,1741289786,1741289839,1741289839.9160109,-21600,,
com.apple.finder,5,1741289781,1741289786,1741289786.704372,-21600,,
com.google.Chrome,99,1741289682,1741289781,1741289781.406547,-21600,,
com.apple.finder,7,1741289675,1741289682,1741289682.540379,-21600,,
com.google.Chrome,90,1741289585,1741289675,1741289675.902884,-21600,,
com.apple.finder,3,1741289582,1741289585,1741289585.5572891,-21600,,
com.google.Chrome,37,1741289545,1741289582,1741289582.854672,-21600,,
com.apple.finder,1,1741289544,1741289545,1741289545.452756,-21600,,
com.apple.Preview,7,1741289537,1741289544,1741289544.5901752,-21600,,
com.apple.finder,1,1741289536,1741289537,1741289537.638572,-21600,,
com.google.Chrome,7,1741289529,1741289536,1741289536.504665,-21600,,
com.apple.finder,1,1741289528,1741289529,1741289529.778318,-21600,,
com.apple.Preview,17,1741289511,1741289528,1741289528.43182,-21600,,
com.apple.finder,3,1741289508,1741289511,1741289511.513838,-21600,,
com.google.Chrome,12,1741289496,1741289508,1741289508.2225208,-21600,,
com.google.chrome.ios,31,1741288536,1741288567,1741288567.2903972,-21600,EB445137-D7F5-57EC-87DA-1DB460D64046,"iPhone13,2"
com.apple.calculator,2,1741288532,1741288534,1741288535.01141,-21600,EB445137-D7F5-57EC-87DA-1DB460D64046,"iPhone13,2"
com.apple.calculator,56,1741288049,1741288105,1741288105.5131369,-21600,EB445137-D7F5-57EC-87DA-1DB460D64046,"iPhone13,2"
com.apple.MobileSMS,4,1741288045,1741288049,1741288049.566224,-21600,EB445137-D7F5-57EC-87DA-1DB460D64046,"iPhone13,2"
com.apple.calculator,4,1741288039,1741288043,1741288043.783904,-21600,EB445137-D7F5-57EC-87DA-1DB460D64046,"iPhone13,2"
com.apple.calculator,4,1741288033,1741288037,1741288037.739962,-21600,EB445137-D7F5-57EC-87DA-1DB460D64046,"iPhone13,2"
com.truebill.truebillnative,14,1741288019,1741288033,1741288033.6828341,-21600,EB445137-D7F5-57EC-87DA-1DB460D64046,"iPhone13,2"
com.apple.mobilecal,19,1741287939,1741287958,1741287958.9876552,-21600,EB445137-D7F5-57EC-87DA-1DB460D64046,"iPhone13,2"
com.apple.CoreAuthUI,4,1741287917,1741287921,1741287921.89705,-21600,EB445137-D7F5-57EC-87DA-1DB460D64046,"iPhone13,2"
com.truebill.truebillnative,21,1741287915,1741287936,1741287936.755594,-21600,EB445137-D7F5-57EC-87DA-1DB460D64046,"iPhone13,2"
com.apple.news,68,1741287846,1741287914,1741287914.730904,-21600,EB445137-D7F5-57EC-87DA-1DB460D64046,"iPhone13,2"
com.apple.news,137,1741287371,1741287508,1741287508.2614489,-21600,EB445137-D7F5-57EC-87DA-1DB460D64046,"iPhone13,2"
com.apple.news,108,1741287207,1741287315,1741287316.016175,-21600,EB445137-D7F5-57EC-87DA-1DB460D64046,"iPhone13,2"
Astrospheric.Astrospheric,11,1741287112,1741287123,1741287123.3388581,-21600,EB445137-D7F5-57EC-87DA-1DB460D64046,"iPhone13,2"
com.google.Sheets,91,1741287020,1741287111,1741287111.9754071,-21600,EB445137-D7F5-57EC-87DA-1DB460D64046,"iPhone13,2"
com.google.Drive,7,1741287013,1741287020,1741287020.5920482,-21600,EB445137-D7F5-57EC-87DA-1DB460D64046,"iPhone13,2"
com.microsoft.Office.Outlook,3,1741287010,1741287013,1741287013.570489,-21600,EB445137-D7F5-57EC-87DA-1DB460D64046,"iPhone13,2"
com.google.chrome.ios,4,1741287006,1741287010,1741287011.30496,-21600,EB445137-D7F5-57EC-87DA-1DB460D64046,"iPhone13,2"
com.google.chrome.ios,86,1741286643,1741286729,1741286729.855355,-21600,EB445137-D7F5-57EC-87DA-1DB460D64046,"iPhone13,2"
com.google.chrome.ios,13,1741286627,1741286640,1741286641.05483,-21600,EB445137-D7F5-57EC-87DA-1DB460D64046,"iPhone13,2"
com.myfitnesspal.mfp,4,1741286622,1741286626,1741286626.897464,-21600,EB445137-D7F5-57EC-87DA-1DB460D64046,"iPhone13,2"
com.myfitnesspal.mfp,104,1741286455,1741286559,1741286559.656124,-21600,EB445137-D7F5-57EC-87DA-1DB460D64046,"iPhone13,2"
com.apple.Music,2,1741286450,1741286452,1741286452.50107,-21600,EB445137-D7F5-57EC-87DA-1DB460D64046,"iPhone13,2"
com.apple.Music,19,1741285403,1741285422,1741285422.401051,-21600,EB445137-D7F5-57EC-87DA-1DB460D64046,"iPhone13,2"
com.toyopagroup.picaboo,8,1741285394,1741285402,1741285402.328587,-21600,EB445137-D7F5-57EC-87DA-1DB460D64046,"iPhone13,2"
com.google.Chrome,515,1741284711,1741285226,1741285226.247051,-21600,,
com.microsoft.Outlook,4,1741284707,1741284711,1741284711.212597,-21600,,
com.google.Chrome,390,1741284317,1741284707,1741284707.802136,-21600,,
com.apple.finder,14,1741284265,1741284279,1741284279.981299,-21600,,
com.microsoft.VSCode,18,1741284247,1741284265,1741284265.748402,-21600,,
com.google.chrome.ios,78,1741283673,1741283751,1741283751.394958,-21600,EB445137-D7F5-57EC-87DA-1DB460D64046,"iPhone13,2"
com.microsoft.Office.Outlook,2,1741283671,1741283673,1741283673.1926708,-21600,EB445137-D7F5-57EC-87DA-1DB460D64046,"iPhone13,2"
Astrospheric.Astrospheric,63,1741283608,1741283671,1741283671.813715,-21600,EB445137-D7F5-57EC-87DA-1DB460D64046,"iPhone13,2"
com.google.chrome.ios,24,1741283583,1741283607,1741283607.871282,-21600,EB445137-D7F5-57EC-87DA-1DB460D64046,"iPhone13,2"
com.google.chrome.ios,24,1741283559,1741283583,1741283584.0965261,-21600,EB445137-D7F5-57EC-87DA-1DB460D64046,"iPhone13,2"
com.microsoft.Office.Outlook,39,1741283520,1741283559,1741283559.9404202,-21600,EB445137-D7F5-57EC-87DA-1DB460D64046,"iPhone13,2"
com.leomehlig.today,2,1741283518,1741283520,1741283520.10164,-21600,EB445137-D7F5-57EC-87DA-1DB460D64046,"iPhone13,2"
com.leomehlig.today,16,1741283077,1741283093,1741283094.405208,-21600,EB445137-D7F5-57EC-87DA-1DB460D64046,"iPhone13,2"
com.apple.weather,2,1741283074,1741283076,1741283076.206594,-21600,EB445137-D7F5-57EC-87DA-1DB460D64046,"iPhone13,2"
com.apple.weather,13,1741282941,1741282954,1741282955.191066,-21600,EB445137-D7F5-57EC-87DA-1DB460D64046,"iPhone13,2"
com.microsoft.VSCode,301,1741282827,1741283128,1741283128.873893,-21600,,
com.apple.finder,4,1741282823,1741282827,1741282827.607914,-21600,,
com.microsoft.VSCode,11,1741282812,1741282823,1741282823.217785,-21600,,
com.apple.finder,15,1741282797,1741282812,1741282812.974586,-21600,,
com.microsoft.VSCode,8,1741282789,1741282797,1741282798.034039,-21600,,
com.apple.finder,62,1741282727,1741282789,1741282789.1987062,-21600,,
com.microsoft.VSCode,15,1741282712,1741282727,1741282727.677161,-21600,,
com.apple.finder,2,1741282710,1741282712,1741282712.313565,-21600,,
com.microsoft.VSCode,26,1741282684,1741282710,1741282710.651288,-21600,,
com.apple.MobileSMS,6,1741282290,1741282296,1741282296.315989,-21600,EB445137-D7F5-57EC-87DA-1DB460D64046,"iPhone13,2"
com.hammerandchisel.discord,0,1741282290,1741282290,1741282291.3729959,-21600,EB445137-D7F5-57EC-87DA-1DB460D64046,"iPhone13,2"
com.apple.finder,420,1741282264,1741282684,1741282684.585201,-21600,,
com.microsoft.VSCode,2,1741282262,1741282264,1741282264.4261642,-21600,,
com.electron.carta,2,1741282260,1741282262,1741282262.825989,-21600,,
com.google.Chrome,73,1741282187,1741282260,1741282261.021824,-21600,,
com.microsoft.VSCode,24,1741282143,1741282167,1741282167.325038,-21600,,
com.apple.finder,4,1741282139,1741282143,1741282143.4865808,-21600,,
com.hammerandchisel.discord,16,1741281863,1741281879,1741281879.769527,-21600,EB445137-D7F5-57EC-87DA-1DB460D64046,"iPhone13,2"
com.microsoft.VSCode,318,1741281821,1741282139,1741282139.266224,-21600,,
com.apple.finder,19,1741281802,1741281821,1741281821.923831,-21600,,
com.microsoft.VSCode,8,1741281794,1741281802,1741281802.350109,-21600,,
com.apple.finder,7,1741281787,1741281794,1741281794.1289601,-21600,,
com.microsoft.VSCode,31,1741281756,1741281787,1741281787.757648,-21600,,
com.apple.finder,31,1741281725,1741281756,1741281756.22206,-21600,,
com.apple.Preview,38,1741281687,1741281725,1741281725.7743359,-21600,,
com.microsoft.VSCode,3,1741281684,1741281687,1741281687.069643,-21600,,
com.apple.Preview,13,1741281671,1741281684,1741281684.97748,-21600,,
com.apple.finder,1,1741281670,1741281671,1741281671.742476,-21600,,
com.microsoft.VSCode,14,1741281656,1741281670,1741281670.8511791,-21600,,
com.apple.finder,7,1741281649,1741281656,1741281656.7120461,-21600,,
com.microsoft.VSCode,8,1741281641,1741281649,1741281649.8210192,-21600,,
com.apple.Preview,11,1741281630,1741281641,1741281641.49474,-21600,,
com.microsoft.VSCode,8,1741281622,1741281630,1741281630.990797,-21600,,
com.apple.Preview,8,1741281614,1741281622,1741281622.6336188,-21600,,
com.microsoft.VSCode,2,1741281612,1741281614,1741281614.4526749,-21600,,
com.apple.Preview,2,1741281610,1741281612,1741281612.9185019,-21600,,
com.apple.finder,2,1741281608,1741281610,1741281610.136623,-21600,,
com.microsoft.VSCode,11,1741281597,1741281608,1741281608.648901,-21600,,
com.apple.finder,3,1741281594,1741281597,1741281597.259932,-21600,,
com.microsoft.VSCode,80,1741281514,1741281594,1741281594.677487,-21600,,
com.apple.Preview,26,1741281488,1741281514,1741281514.574949,-21600,,
com.microsoft.VSCode,5,1741281483,1741281488,1741281488.553652,-21600,,
com.apple.Preview,6,1741281477,1741281483,1741281483.418284,-21600,,
com.apple.finder,3,1741281474,1741281477,1741281477.071471,-21600,,
com.microsoft.VSCode,30,1741281444,1741281474,1741281474.144665,-21600,,
com.apple.finder,14,1741281430,1741281444,1741281444.794328,-21600,,
com.microsoft.VSCode,32,1741281398,1741281430,1741281430.118511,-21600,,
com.apple.finder,27,1741281371,1741281398,1741281398.49009,-21600,,
com.microsoft.VSCode,19,1741281352,1741281371,1741281371.966605,-21600,,
com.apple.finder,6,1741281346,1741281352,1741281352.144956,-21600,,
com.microsoft.VSCode,690,1741280656,1741281346,1741281346.327359,-21600,,
com.apple.finder,3,1741280653,1741280656,1741280657.016768,-21600,,
com.microsoft.VSCode,46,1741280607,1741280653,1741280653.5516791,-21600,,
com.apple.finder,5,1741280602,1741280607,1741280607.646471,-21600,,
com.microsoft.VSCode,72,1741280530,1741280602,1741280602.635941,-21600,,
com.apple.finder,5,1741280525,1741280530,1741280530.5556002,-21600,,
com.microsoft.VSCode,162,1741280363,1741280525,1741280525.3244119,-21600,,
com.apple.finder,3,1741280360,1741280363,1741280363.635347,-21600,,
com.microsoft.VSCode,15,1741280345,1741280360,1741280360.72367,-21600,,
com.apple.finder,3,1741280342,1741280345,1741280346.031874,-21600,,
com.microsoft.VSCode,9,1741280333,1741280342,1741280342.992855,-21600,,
com.apple.finder,14,1741280319,1741280333,1741280333.1254091,-21600,,
com.microsoft.VSCode,5,1741280314,1741280319,1741280319.546468,-21600,,
com.apple.finder,11,1741280303,1741280314,1741280314.0615659,-21600,,
com.microsoft.VSCode,15,1741280288,1741280303,1741280303.819405,-21600,,
com.apple.finder,3,1741280285,1741280288,1741280288.07758,-21600,,
com.microsoft.VSCode,24,1741280261,1741280285,1741280285.356188,-21600,,
com.apple.finder,3,1741280258,1741280261,1741280261.651435,-21600,,
com.microsoft.VSCode,35,1741280223,1741280258,1741280258.520134,-21600,,
com.apple.finder,1,1741280222,1741280223,1741280223.734659,-21600,,
com.apple.MobileSMS,4,1741280194,1741280198,1741280198.87706,-21600,EB445137-D7F5-57EC-87DA-1DB460D64046,"iPhone13,2"
com.apple.CoreAuthUI,3,1741280157,1741280160,1741280160.03123,-21600,EB445137-D7F5-57EC-87DA-1DB460D64046,"iPhone13,2"
com.clairmail.fth.client,39,1741280154,1741280193,1741280193.438812,-21600,EB445137-D7F5-57EC-87DA-1DB460D64046,"iPhone13,2"
com.microsoft.VSCode,208,1741280014,1741280222,1741280222.251401,-21600,,
com.apple.finder,5,1741280009,1741280014,1741280014.120399,-21600,,
com.microsoft.VSCode,44,1741279965,1741280009,1741280009.323598,-21600,,
com.apple.finder,7,1741279958,1741279965,1741279965.547472,-21600,,
com.microsoft.VSCode,45,1741279913,1741279958,1741279958.966857,-21600,,
com.apple.finder,9,1741279904,1741279913,1741279913.148035,-21600,,
com.groupme.iphone-app,8,1741279761,1741279769,1741279770.0612578,-21600,EB445137-D7F5-57EC-87DA-1DB460D64046,"iPhone13,2"
com.microsoft.VSCode,411,1741279493,1741279904,1741279904.098281,-21600,,
com.apple.finder,30,1741279463,1741279493,1741279493.8963618,-21600,,
com.microsoft.VSCode,40,1741279423,1741279463,1741279463.6439319,-21600,,
com.apple.finder,9,1741279414,1741279423,1741279423.0931811,-21600,,
com.microsoft.VSCode,17,1741279397,1741279414,1741279415.02313,-21600,,
com.apple.news,221,1741279084,1741279305,1741279305.63533,-21600,EB445137-D7F5-57EC-87DA-1DB460D64046,"iPhone13,2"
com.apple.Health,34,1741279030,1741279064,1741279064.7663178,-21600,EB445137-D7F5-57EC-87DA-1DB460D64046,"iPhone13,2"
com.renpho.health,3,1741279026,1741279029,1741279029.2960548,-21600,EB445137-D7F5-57EC-87DA-1DB460D64046,"iPhone13,2"
com.microsoft.VSCode,306,1741278986,1741279292,1741279292.3571448,-21600,,
com.apple.finder,8,1741278978,1741278986,1741278986.946208,-21600,,
com.microsoft.VSCode,5,1741278973,1741278978,1741278979.01897,-21600,,
com.apple.finder,12,1741278961,1741278973,1741278973.8884459,-21600,,
com.microsoft.VSCode,783,1741278178,1741278961,1741278961.963762,-21600,,
com.apple.finder,60,1741278118,1741278178,1741278178.1504412,-21600,,
com.microsoft.VSCode,365,1741277753,1741278118,1741278118.656806,-21600,,
com.electron.carta,2,1741277751,1741277753,1741277753.7001991,-21600,,
com.microsoft.VSCode,11,1741277740,1741277751,1741277751.767617,-21600,,
com.electron.carta,5,1741277735,1741277740,1741277740.294553,-21600,,
com.microsoft.VSCode,12,1741277723,1741277735,1741277735.078529,-21600,,
com.electron.carta,2,1741277721,1741277723,1741277724.019902,-21600,,
com.microsoft.VSCode,33,1741277688,1741277721,1741277721.887076,-21600,,
com.electron.carta,8,1741277680,1741277688,1741277688.728385,-21600,,
com.microsoft.VSCode,23,1741277657,1741277680,1741277680.881538,-21600,,
com.electron.carta,2,1741277655,1741277657,1741277657.92798,-21600,,
com.microsoft.VSCode,18,1741277637,1741277655,1741277655.6155782,-21600,,
com.electron.carta,4,1741277633,1741277637,1741277637.266006,-21600,,
com.microsoft.VSCode,20,1741277613,1741277633,1741277633.923775,-21600,,
com.electron.carta,7,1741277606,1741277613,1741277613.059998,-21600,,
com.microsoft.VSCode,9,1741277597,1741277606,1741277607.009227,-21600,,
com.electron.carta,7,1741277590,1741277597,1741277597.52183,-21600,,
com.microsoft.VSCode,4,1741277586,1741277590,1741277590.4531178,-21600,,
com.electron.carta,55,1741277531,1741277586,1741277586.4458652,-21600,,
com.microsoft.VSCode,20,1741277511,1741277531,1741277532.023789,-21600,,
com.electron.carta,55,1741277456,1741277511,1741277511.6833282,-21600,,
com.microsoft.VSCode,23,1741277433,1741277456,1741277457.000629,-21600,,
com.electron.carta,42,1741277391,1741277433,1741277433.3849912,-21600,,
com.microsoft.VSCode,6,1741277385,1741277391,1741277391.7202048,-21600,,
com.electron.carta,26,1741277359,1741277385,1741277385.098808,-21600,,
com.microsoft.VSCode,44,1741277315,1741277359,1741277359.771482,-21600,,
com.electron.carta,75,1741277240,1741277315,1741277315.547322,-21600,,
com.microsoft.VSCode,15,1741277225,1741277240,1741277240.906759,-21600,,
com.electron.carta,33,1741277192,1741277225,1741277225.585205,-21600,,
com.microsoft.VSCode,170,1741277022,1741277192,1741277192.1932511,-21600,,
com.google.Chrome,32,1741276990,1741277022,1741277022.670881,-21600,,
com.microsoft.VSCode,42,1741276948,1741276990,1741276990.3490171,-21600,,
com.electron.carta,8,1741276940,1741276948,1741276948.522656,-21600,,
com.microsoft.VSCode,23,1741276917,1741276940,1741276940.989863,-21600,,
com.electron.carta,64,1741276853,1741276917,1741276917.24339,-21600,,
com.microsoft.VSCode,45,1741276808,1741276853,1741276853.4348059,-21600,,
com.electron.carta,103,1741276705,1741276808,1741276808.236639,-21600,,
com.microsoft.VSCode,72,1741276633,1741276705,1741276705.156262,-21600,,
com.google.Chrome,12,1741276621,1741276633,1741276633.139972,-21600,,
com.microsoft.VSCode,149,1741276472,1741276621,1741276621.319062,-21600,,
com.google.Chrome,47,1741276425,1741276472,1741276472.60251,-21600,,
com.microsoft.VSCode,44,1741276381,1741276425,1741276425.998729,-21600,,
com.electron.carta,5,1741276376,1741276381,1741276382.026269,-21600,,
com.microsoft.VSCode,21,1741276355,1741276376,1741276376.344442,-21600,,
com.electron.carta,52,1741276303,1741276355,1741276355.766783,-21600,,
com.microsoft.VSCode,76,1741276227,1741276303,1741276303.885253,-21600,,
com.google.Chrome,36,1741276191,1741276227,1741276227.667941,-21600,,
com.electron.carta,6,1741276185,1741276191,1741276191.3920112,-21600,,
com.google.Chrome,18,1741276167,1741276185,1741276185.705563,-21600,,
com.electron.carta,25,1741276142,1741276167,1741276167.370606,-21600,,
com.google.Chrome,9,1741276133,1741276142,1741276142.7121758,-21600,,
com.electron.carta,18,1741276115,1741276133,1741276133.997764,-21600,,
com.google.Chrome,26,1741276089,1741276115,1741276115.433268,-21600,,
com.electron.carta,22,1741276067,1741276089,1741276089.417871,-21600,,
com.google.Chrome,8,1741276059,1741276067,1741276067.439427,-21600,,
com.electron.carta,37,1741276022,1741276059,1741276059.229879,-21600,,
com.google.Chrome,40,1741275982,1741276022,1741276022.8043342,-21600,,
com.electron.carta,37,1741275945,1741275982,1741275982.502499,-21600,,
com.google.Chrome,19,1741275926,1741275945,1741275945.0789618,-21600,,
com.electron.carta,6,1741275920,1741275926,1741275926.508395,-21600,,
com.google.Chrome,52,1741275868,1741275920,1741275920.1033359,-21600,,
com.electron.carta,27,1741275841,1741275868,1741275868.787813,-21600,,
com.apple.Preview,6,1741275835,1741275841,1741275841.2288551,-21600,,
com.electron.carta,20,1741275815,1741275835,1741275835.665079,-21600,,
com.google.Chrome,21,1741275794,1741275815,1741275816.018971,-21600,,
com.electron.carta,145,1741275649,1741275794,1741275794.56494,-21600,,
com.google.Chrome,6,1741275643,1741275649,1741275649.708929,-21600,,
com.microsoft.VSCode,3,1741275640,1741275643,1741275643.256592,-21600,,
com.apple.Preview,13,1741275627,1741275640,1741275640.173954,-21600,,
com.apple.finder,18,1741275609,1741275627,1741275627.4105349,-21600,,
com.google.Chrome,10,1741275599,1741275609,1741275609.939789,-21600,,
com.microsoft.VSCode,22,1741275577,1741275599,1741275599.491705,-21600,,
com.google.Chrome,45,1741275532,1741275577,1741275577.9688802,-21600,,
com.microsoft.VSCode,58,1741275474,1741275532,1741275532.996124,-21600,,
com.electron.carta,30,1741275444,1741275474,1741275474.216763,-21600,,
com.microsoft.VSCode,229,1741275215,1741275444,1741275445.0441132,-21600,,
com.google.Chrome,22,1741275193,1741275215,1741275215.9318461,-21600,,
com.microsoft.VSCode,106,1741275087,1741275193,1741275193.530663,-21600,,
com.electron.carta,70,1741275017,1741275087,1741275087.4499478,-21600,,
com.microsoft.VSCode,68,1741274949,1741275017,1741275017.613515,-21600,,
com.electron.carta,1,1741274948,1741274949,1741274949.26472,-21600,,
com.google.Chrome,5,1741274943,1741274948,1741274948.190048,-21600,,
com.electron.carta,1,1741274942,1741274943,1741274943.579846,-21600,,
com.microsoft.VSCode,33,1741274909,1741274942,1741274942.773144,-21600,,
com.electron.carta,0,1741274909,1741274909,1741274909.4570599,-21600,,
com.microsoft.VSCode,14,1741274895,1741274909,1741274909.092617,-21600,,
com.electron.carta,1,1741274894,1741274895,1741274895.693404,-21600,,
com.google.Chrome,62,1741274832,1741274894,1741274894.1427112,-21600,,
com.microsoft.VSCode,173,1741274659,1741274832,1741274832.8236442,-21600,,
com.google.Chrome,0,1741274659,1741274659,1741274660.005046,-21600,,
com.microsoft.VSCode,2,1741274657,1741274659,1741274659.1407251,-21600,,
com.google.Chrome,1,1741274656,1741274657,1741274657.442663,-21600,,
com.microsoft.VSCode,2,1741274654,1741274656,1741274656.605492,-21600,,
com.google.Chrome,2,1741274652,1741274654,1741274654.2903972,-21600,,
com.microsoft.VSCode,1,1741274651,1741274652,1741274652.93855,-21600,,
com.google.Chrome,2,1741274649,1741274651,1741274651.311212,-21600,,
com.microsoft.VSCode,7,1741274642,1741274649,1741274649.300317,-21600,,
com.google.Chrome,29,1741274613,1741274642,1741274642.229461,-21600,,
com.microsoft.VSCode,2,1741274611,1741274613,1741274613.4446511,-21600,,
com.google.Chrome,2,1741274609,1741274611,1741274611.5879622,-21600,,
com.microsoft.VSCode,37,1741274572,1741274609,1741274609.948456,-21600,,
com.google.Chrome,44,1741274528,1741274572,1741274572.296907,-21600,,
com.microsoft.VSCode,48,1741274480,1741274528,1741274528.144459,-21600,,
com.google.Chrome,17,1741274463,1741274480,1741274480.258255,-21600,,
com.electron.carta,38,1741274425,1741274463,1741274463.1990008,-21600,,
com.microsoft.VSCode,57,1741274368,1741274425,1741274425.117595,-21600,,
com.google.Chrome,97,1741274271,1741274368,1741274368.226306,-21600,,
com.microsoft.VSCode,118,1741274153,1741274271,1741274271.682843,-21600,,
com.apple.Dictionary,2,1741274151,1741274153,1741274154.002301,-21600,,
com.microsoft.VSCode,23,1741274128,1741274151,1741274151.902987,-21600,,
com.apple.finder,17,1741274111,1741274128,1741274128.299549,-21600,,
com.microsoft.VSCode,200,1741273911,1741274111,1741274111.63693,-21600,,
com.apple.Preview,13,1741273898,1741273911,1741273911.807427,-21600,,
com.apple.finder,42,1741273856,1741273898,1741273898.759489,-21600,,
com.google.Chrome,5,1741273851,1741273856,1741273856.94925,-21600,,
com.microsoft.VSCode,24,1741273827,1741273851,1741273851.423572,-21600,,
com.apple.MobileSMS,142,1741273541,1741273683,1741273683.978864,-21600,,
com.microsoft.VSCode,12,1741273529,1741273541,1741273541.278473,-21600,,
com.google.Chrome,33,1741273496,1741273529,1741273529.645973,-21600,,
com.leomehlig.today,12,1741273484,1741273496,1741273496.6037722,-21600,,
com.google.Chrome,3,1741273481,1741273484,1741273484.899967,-21600,,
com.renpho.health,17,1741272718,1741272735,1741272735.2806358,-21600,EB445137-D7F5-57EC-87DA-1DB460D64046,"iPhone13,2"
com.google.ios.youtube,782,1741271768,1741272550,1741272550.251441,-21600,EB445137-D7F5-57EC-87DA-1DB460D64046,"iPhone13,2"
com.apple.news,64,1741271656,1741271720,1741271720.322809,-21600,EB445137-D7F5-57EC-87DA-1DB460D64046,"iPhone13,2"
com.apple.mobiletimer,7,1741271601,1741271608,1741271609.553693,-21600,EB445137-D7F5-57EC-87DA-1DB460D64046,"iPhone13,2"
com.apple.CoreAuthUI,4,1741240594,1741240598,1741240598.896421,-21600,EB445137-D7F5-57EC-87DA-1DB460D64046,"iPhone13,2"
com.apple.journal,516,1741240593,1741241109,1741241109.416841,-21600,EB445137-D7F5-57EC-87DA-1DB460D64046,"iPhone13,2"
com.thestorygraph.thestorygraph,90,1741240319,1741240409,1741240409.786567,-21600,EB445137-D7F5-57EC-87DA-1DB460D64046,"iPhone13,2"
com.apple.Health,20,1741237308,1741237328,1741237329.064676,-21600,EB445137-D7F5-57EC-87DA-1DB460D64046,"iPhone13,2"
com.google.Chrome,660,1741234949,1741235609,1741235609.982274,-21600,,
com.apple.finder,2,1741234947,1741234949,1741234949.883628,-21600,,
com.myfitnesspal.mfp,70,1741234139,1741234209,1741234209.278007,-21600,EB445137-D7F5-57EC-87DA-1DB460D64046,"iPhone13,2"
com.instructure.icanvas,2,1741234137,1741234139,1741234139.816877,-21600,EB445137-D7F5-57EC-87DA-1DB460D64046,"iPhone13,2"
com.apple.finder,346,1741234049,1741234395,1741234395.4528751,-21600,,
com.apple.Notes,3,1741234046,1741234049,1741234049.157527,-21600,,
com.apple.finder,3,1741234043,1741234046,1741234046.9459372,-21600,,
com.google.Chrome,7,1741234036,1741234043,1741234043.7623072,-21600,,
com.jinzhenyu.ruler,20,1741234016,1741234036,1741234036.618484,-21600,,
com.electron.carta,3,1741234013,1741234016,1741234017.0116758,-21600,,
com.jinzhenyu.ruler,1,1741234012,1741234013,1741234013.831847,-21600,,
com.electron.carta,0,1741234012,1741234012,1741234012.770718,-21600,,
com.jinzhenyu.ruler,1,1741234011,1741234012,1741234012.286779,-21600,,
com.electron.carta,1,1741234010,1741234011,1741234011.71883,-21600,,
com.apple.Notes,70,1741233940,1741234010,1741234010.5876021,-21600,,
com.google.Chrome,2,1741233938,1741233940,1741233940.326229,-21600,,
com.apple.Notes,36,1741233902,1741233938,1741233938.535048,-21600,,
com.google.Chrome,283,1741233619,1741233902,1741233902.8601542,-21600,,
com.electron.carta,10,1741233609,1741233619,1741233619.527487,-21600,,
com.google.Chrome,38,1741233571,1741233609,1741233609.60142,-21600,,
com.electron.carta,8,1741233563,1741233571,1741233572.096875,-21600,,
com.google.Chrome,8,1741233555,1741233563,1741233563.6510038,-21600,,
com.electron.carta,10,1741233545,1741233555,1741233555.676371,-21600,,
com.google.Chrome,28,1741233517,1741233545,1741233545.106952,-21600,,
com.electron.carta,22,1741233495,1741233517,1741233517.9196382,-21600,,
com.google.Chrome,8,1741233487,1741233495,1741233495.265441,-21600,,
com.electron.carta,4,1741233483,1741233487,1741233487.417572,-21600,,
com.google.Chrome,36,1741233447,1741233483,1741233483.973763,-21600,,
com.electron.carta,5,1741233442,1741233447,1741233447.958482,-21600,,
com.google.Chrome,39,1741233403,1741233442,1741233442.070004,-21600,,
com.electron.carta,2,1741233401,1741233403,1741233403.6998758,-21600,,
com.apple.finder,4,1741233397,1741233401,1741233401.695142,-21600,,
com.electron.carta,1,1741233396,1741233397,1741233397.8731542,-21600,,
com.google.Chrome,79,1741233317,1741233396,1741233396.9570909,-21600,,
com.electron.carta,4,1741233313,1741233317,1741233317.2696052,-21600,,
com.apple.finder,3,1741233310,1741233313,1741233313.729553,-21600,,
com.electron.carta,1,1741233309,1741233310,1741233311.0066938,-21600,,
com.apple.finder,0,1741233309,1741233309,1741233309.945868,-21600,,
com.electron.carta,3,1741233306,1741233309,1741233309.0723848,-21600,,
com.apple.finder,0,1741233306,1741233306,1741233306.773089,-21600,,
com.electron.carta,2,1741233304,1741233306,1741233306.086625,-21600,,
com.apple.finder,2,1741233302,1741233304,1741233304.704607,-21600,,
com.electron.carta,1,1741233301,1741233302,1741233302.447819,-21600,,
com.apple.finder,2,1741233299,1741233301,1741233301.825382,-21600,,
com.electron.carta,98,1741233201,1741233299,1741233299.623209,-21600,,
com.apple.finder,4,1741233197,1741233201,1741233201.1501842,-21600,,
com.electron.carta,14,1741233183,1741233197,1741233197.600274,-21600,,
com.google.Chrome,101,1741233082,1741233183,1741233183.5394669,-21600,,
com.electron.carta,20,1741233051,1741233071,1741233071.7169409,-21600,,
com.instructure.icanvas,131,1741232751,1741232882,1741232882.741641,-21600,EB445137-D7F5-57EC-87DA-1DB460D64046,"iPhone13,2"
com.instructure.icanvas,64,1741232686,1741232750,1741232751.093189,-21600,EB445137-D7F5-57EC-87DA-1DB460D64046,"iPhone13,2"
com.microsoft.Office.Outlook,1,1741232685,1741232686,1741232686.488315,-21600,EB445137-D7F5-57EC-87DA-1DB460D64046,"iPhone13,2"
com.google.Chrome,377,1741232674,1741233051,1741233051.807163,-21600,,
com.apple.finder,61,1741232613,1741232674,1741232675.075479,-21600,,
com.google.Chrome,173,1741232440,1741232613,1741232613.5794148,-21600,,
com.electron.carta,35,1741232405,1741232440,1741232440.716556,-21600,,
com.google.Chrome,7,1741232398,1741232405,1741232406.039186,-21600,,
com.electron.carta,24,1741232374,1741232398,1741232398.438721,-21600,,
com.google.Chrome,44,1741232330,1741232374,1741232374.399344,-21600,,
com.electron.carta,17,1741232313,1741232330,1741232330.4754992,-21600,,
com.jinzhenyu.ruler,2,1741232311,1741232313,1741232313.509482,-21600,,
com.google.Chrome,88,1741232223,1741232311,1741232311.883143,-21600,,
com.jinzhenyu.ruler,16,1741232207,1741232223,1741232223.5998502,-21600,,
com.electron.carta,2,1741232205,1741232207,1741232207.580219,-21600,,
com.jinzhenyu.ruler,4,1741232201,1741232205,1741232205.2596169,-21600,,
com.electron.carta,15,1741232186,1741232201,1741232201.2029052,-21600,,
com.jinzhenyu.ruler,0,1741232186,1741232186,1741232186.860059,-21600,,
com.electron.carta,20,1741232166,1741232186,1741232186.433043,-21600,,
com.jinzhenyu.ruler,11,1741232155,1741232166,1741232166.864386,-21600,,
com.electron.carta,5,1741232150,1741232155,1741232155.271452,-21600,,
com.jinzhenyu.ruler,3,1741232147,1741232150,1741232150.2606668,-21600,,
com.electron.carta,8,1741232139,1741232147,1741232147.705792,-21600,,
com.jinzhenyu.ruler,13,1741232126,1741232139,1741232139.126072,-21600,,
com.google.Chrome,66,1741232060,1741232126,1741232126.390466,-21600,,
com.electron.carta,6,1741232054,1741232060,1741232061.041779,-21600,,
com.google.Chrome,52,1741232002,1741232054,1741232055.014173,-21600,,
com.electron.carta,21,1741231981,1741232002,1741232002.9667978,-21600,,
com.google.Chrome,30,1741231951,1741231981,1741231981.3812919,-21600,,
com.electron.carta,9,1741231942,1741231951,1741231951.6665459,-21600,,
com.google.Chrome,6,1741231936,1741231942,1741231942.57414,-21600,,
com.electron.carta,21,1741231915,1741231936,1741231936.675956,-21600,,
com.google.Chrome,25,1741231890,1741231915,1741231915.0774078,-21600,,
com.electron.carta,14,1741231876,1741231890,1741231891.0188398,-21600,,
com.google.Chrome,7,1741231869,1741231876,1741231876.601181,-21600,,
com.electron.carta,14,1741231855,1741231869,1741231869.3139138,-21600,,
com.google.Chrome,4,1741231851,1741231855,1741231855.9240599,-21600,,
com.electron.carta,21,1741231830,1741231851,1741231851.33183,-21600,,
com.google.Chrome,9,1741231821,1741231830,1741231830.669757,-21600,,
com.electron.carta,12,1741231809,1741231821,1741231821.2730699,-21600,,
com.google.Chrome,20,1741231789,1741231809,1741231810.028576,-21600,,
com.apple.Notes,3,1741231786,1741231789,1741231789.376874,-21600,,
com.google.Chrome,4,1741231782,1741231786,1741231786.970459,-21600,,
com.electron.carta,23,1741231759,1741231782,1741231782.239147,-21600,,
com.google.Chrome,5,1741231754,1741231759,1741231759.887113,-21600,,
com.electron.carta,9,1741231745,1741231754,1741231754.895082,-21600,,
com.google.Chrome,21,1741231724,1741231745,1741231745.129788,-21600,,
com.electron.carta,12,1741231712,1741231724,1741231724.461364,-21600,,
com.google.Chrome,40,1741231672,1741231712,1741231712.66499,-21600,,
com.electron.carta,34,1741231638,1741231672,1741231672.6903949,-21600,,
com.google.Chrome,40,1741231598,1741231638,1741231638.494108,-21600,,
com.apple.finder,11,1741231587,1741231598,1741231598.692693,-21600,,
com.google.Chrome,27,1741231560,1741231587,1741231588.004476,-21600,,
com.apple.finder,7,1741231553,1741231560,1741231560.998075,-21600,,
com.google.Chrome,6,1741231547,1741231553,1741231553.099833,-21600,,
com.electron.carta,18,1741231529,1741231547,1741231548.024281,-21600,,
com.apple.finder,20,1741231509,1741231529,1741231529.994508,-21600,,
com.electron.carta,29,1741231480,1741231509,1741231509.497651,-21600,,
com.microsoft.Office.Outlook,28,1741231255,1741231283,1741231283.415757,-21600,EB445137-D7F5-57EC-87DA-1DB460D64046,"iPhone13,2"
com.toyopagroup.picaboo,40,1741231206,1741231246,1741231246.8190289,-21600,EB445137-D7F5-57EC-87DA-1DB460D64046,"iPhone13,2"
com.intsig.CamScannerLite,1,1741231205,1741231206,1741231207.511719,-21600,EB445137-D7F5-57EC-87DA-1DB460D64046,"iPhone13,2"
com.google.Chrome,386,1741231094,1741231480,1741231480.3648582,-21600,,
com.electron.carta,17,1741231077,1741231094,1741231094.4873881,-21600,,
com.google.Chrome,31,1741231046,1741231077,1741231077.566484,-21600,,
com.electron.carta,28,1741231018,1741231046,1741231046.953086,-21600,,
com.google.Chrome,71,1741230947,1741231018,1741231018.604708,-21600,,
com.electron.carta,40,1741230907,1741230947,1741230947.616276,-21600,,
com.google.Chrome,97,1741230810,1741230907,1741230907.442195,-21600,,
com.electron.carta,6,1741230804,1741230810,1741230810.450382,-21600,,
com.google.Chrome,11,1741230793,1741230804,1741230804.478016,-21600,,
com.electron.carta,17,1741230776,1741230793,1741230793.37132,-21600,,
com.google.Chrome,9,1741230767,1741230776,1741230776.8113031,-21600,,
com.electron.carta,30,1741230737,1741230767,1741230767.152028,-21600,,
com.google.Chrome,49,1741230688,1741230737,1741230737.58961,-21600,,
com.electron.carta,94,1741230594,1741230688,1741230688.1965141,-21600,,
com.google.Chrome,5,1741230589,1741230594,1741230594.930674,-21600,,
com.electron.carta,58,1741230531,1741230589,1741230589.917366,-21600,,
com.google.Chrome,14,1741230517,1741230531,1741230531.6642509,-21600,,
com.electron.carta,46,1741230471,1741230517,1741230517.6472158,-21600,,
com.google.Chrome,166,1741230305,1741230471,1741230471.8490229,-21600,,
com.electron.carta,12,1741230293,1741230305,1741230305.267161,-21600,,
com.apple.finder,8,1741230285,1741230293,1741230293.895874,-21600,,
com.google.Chrome,65,1741230220,1741230285,1741230285.509284,-21600,,
com.apple.finder,17,1741230203,1741230220,1741230220.6613321,-21600,,
com.electron.carta,25,1741230178,1741230203,1741230203.1433048,-21600,,
com.google.Chrome,56,1741230122,1741230178,1741230178.722221,-21600,,
com.electron.carta,6,1741230116,1741230122,1741230122.886084,-21600,,
com.google.Chrome,8,1741230108,1741230116,1741230116.710236,-21600,,
com.electron.carta,19,1741230089,1741230108,1741230108.4783258,-21600,,
com.google.Chrome,50,1741230039,1741230089,1741230090.027911,-21600,,
com.electron.carta,79,1741229960,1741230039,1741230039.1052241,-21600,,
com.google.Chrome,36,1741229924,1741229960,1741229960.1160588,-21600,,
com.electron.carta,23,1741229901,1741229924,1741229924.27421,-21600,,
com.google.Chrome,234,1741229667,1741229901,1741229901.767098,-21600,,
com.electron.carta,39,1741229628,1741229667,1741229667.60855,-21600,,
com.google.Chrome,47,1741229581,1741229628,1741229628.2857928,-21600,,
com.electron.carta,21,1741229560,1741229581,1741229581.599235,-21600,,
com.google.Chrome,75,1741229485,1741229560,1741229560.57963,-21600,,
com.apple.Notes,1,1741229484,1741229485,1741229485.8193069,-21600,,
com.google.Chrome,1,1741229483,1741229484,1741229484.703918,-21600,,
com.apple.Notes,4,1741229479,1741229483,1741229483.767448,-21600,,
com.google.Chrome,5,1741229474,1741229479,1741229479.822743,-21600,,
com.electron.carta,43,1741229431,1741229474,1741229474.528858,-21600,,
com.apple.finder,8,1741229423,1741229431,1741229431.6034288,-21600,,
com.electron.carta,5,1741229418,1741229423,1741229423.475978,-21600,,
com.apple.finder,39,1741229379,1741229418,1741229418.0391989,-21600,,
com.electron.carta,32,1741229347,1741229379,1741229379.7138782,-21600,,
com.google.Chrome,6,1741229341,1741229347,1741229347.6045508,-21600,,
com.electron.carta,68,1741229273,1741229341,1741229341.420212,-21600,,
com.google.Chrome,750,1741228523,1741229273,1741229273.7132359,-21600,,
com.apple.Notes,0,1741228523,1741228523,1741228524.026449,-21600,,
com.google.Chrome,23,1741228500,1741228523,1741228523.520417,-21600,,
com.apple.Notes,2,1741228498,1741228500,1741228500.419732,-21600,,
com.google.Chrome,2,1741228496,1741228498,1741228498.930884,-21600,,
com.apple.Notes,1,1741228495,1741228496,1741228496.512984,-21600,,
com.google.Chrome,2,1741228493,1741228495,1741228496.000503,-21600,,
com.apple.Notes,14,1741228479,1741228493,1741228493.925173,-21600,,
com.google.Chrome,66,1741228413,1741228479,1741228479.840917,-21600,,
com.apple.Notes,81,1741228332,1741228413,1741228413.1258621,-21600,,
com.google.Chrome,216,1741228116,1741228332,1741228332.125681,-21600,,
com.leomehlig.today,162,1741227954,1741228116,1741228116.9349189,-21600,,
com.google.Chrome,13,1741227941,1741227954,1741227954.3428411,-21600,,
com.leomehlig.today,202,1741227739,1741227941,1741227941.900766,-21600,,
com.google.Chrome,13,1741227726,1741227739,1741227739.4673991,-21600,,
com.leomehlig.today,10,1741227716,1741227726,1741227727.736302,-21600,,
com.apple.Notes,2,1741227714,1741227716,1741227716.9001532,-21600,,
com.leomehlig.today,5,1741227709,1741227714,1741227714.815865,-21600,,
com.google.Chrome,98,1741227611,1741227709,1741227709.990021,-21600,,
com.leomehlig.today,10,1741227581,1741227591,1741227591.908218,-21600,,
com.apple.finder,2,1741227579,1741227581,1741227581.905266,-21600,,
com.microsoft.VSCode,6,1741227573,1741227579,1741227579.7730222,-21600,,
com.apple.finder,2,1741227571,1741227573,1741227573.682509,-21600,,
com.hnc.Discord,3,1741227568,1741227571,1741227572.6958199,-21600,,
com.apple.finder,10,1741227558,1741227568,1741227568.455802,-21600,,
com.apple.Preview,64,1741227494,1741227558,1741227558.146713,-21600,,
com.apple.finder,1,1741227493,1741227494,1741227494.92176,-21600,,
com.apple.Preview,4,1741227489,1741227493,1741227493.622178,-21600,,
com.apple.finder,0,1741227489,1741227489,1741227489.9650831,-21600,,
com.apple.Preview,16,1741227473,1741227489,1741227489.725453,-21600,,
com.apple.finder,20,1741227453,1741227473,1741227473.298707,-21600,,
com.google.Chrome,3,1741227450,1741227453,1741227454.144588,-21600,,
com.intsig.CamScannerLite,123,1741227388,1741227511,1741227511.343287,-21600,EB445137-D7F5-57EC-87DA-1DB460D64046,"iPhone13,2"
com.hammerandchisel.discord,31,1741227356,1741227387,1741227387.8377318,-21600,EB445137-D7F5-57EC-87DA-1DB460D64046,"iPhone13,2"
com.google.chrome.ios,0,1741227356,1741227356,1741227356.974705,-21600,EB445137-D7F5-57EC-87DA-1DB460D64046,"iPhone13,2"
com.google.Chrome,378,1741226139,1741226517,1741226517.169711,-21600,,
com.leomehlig.today,8,1741226131,1741226139,1741226139.596901,-21600,,
com.google.chrome.ios,14,1741225557,1741225571,1741225571.717712,-21600,EB445137-D7F5-57EC-87DA-1DB460D64046,"iPhone13,2"
com.leomehlig.today,384,1741224661,1741225045,1741225045.360111,-21600,,
com.google.Chrome,134,1741224527,1741224661,1741224661.6965451,-21600,,
com.hnc.Discord,162,1741224365,1741224527,1741224527.598356,-21600,,
com.google.Chrome,3,1741224362,1741224365,1741224365.346427,-21600,,
com.google.Chrome,310,1741224028,1741224338,1741224338.581722,-21600,,
com.apple.Preview,295,1741223733,1741224028,1741224028.249521,-21600,,
com.hnc.Discord,5,1741223728,1741223733,1741223733.2878342,-21600,,
com.google.Chrome,743,1741222985,1741223728,1741223728.324535,-21600,,
com.apple.Preview,137,1741222848,1741222985,1741222985.876048,-21600,,
com.hnc.Discord,38,1741222810,1741222848,1741222848.6165562,-21600,,
com.google.Chrome,610,1741222200,1741222810,1741222810.706377,-21600,,
com.apple.Preview,17,1741222183,1741222200,1741222200.0739908,-21600,,
com.hnc.Discord,138,1741222045,1741222183,1741222183.311777,-21600,,
com.apple.Preview,8,1741222037,1741222045,1741222045.764017,-21600,,
com.apple.finder,3,1741222034,1741222037,1741222037.5687342,-21600,,
com.apple.Preview,4,1741222030,1741222034,1741222035.197463,-21600,,
com.apple.finder,3,1741222027,1741222030,1741222031.019089,-21600,,
com.google.Chrome,10,1741222017,1741222027,1741222027.7385101,-21600,,
com.hnc.Discord,28,1741221989,1741222017,1741222017.970161,-21600,,
com.microsoft.VSCode,1,1741221988,1741221989,1741221989.735501,-21600,,
com.google.Chrome,29,1741221959,1741221988,1741221988.06418,-21600,,
com.microsoft.VSCode,17,1741221942,1741221959,1741221959.4243832,-21600,,
com.google.Chrome,203,1741221739,1741221942,1741221943.061294,-21600,,
com.apple.finder,35,1741221704,1741221739,1741221739.361846,-21600,,
com.google.Chrome,94,1741221610,1741221704,1741221704.1317868,-21600,,
com.apple.Preview,26,1741221584,1741221610,1741221610.5919662,-21600,,
com.apple.finder,10,1741221574,1741221584,1741221584.5796409,-21600,,
com.microsoft.VSCode,88,1741221486,1741221574,1741221574.6778889,-21600,,
com.apple.finder,2,1741221484,1741221486,1741221486.668483,-21600,,
com.google.Chrome,141,1741221343,1741221484,1741221484.334612,-21600,,
com.apple.finder,103,1741221240,1741221343,1741221343.708617,-21600,,
com.google.Chrome,186,1741221054,1741221240,1741221240.30954,-21600,,
com.apple.finder,1,1741221044,1741221045,1741221046.021884,-21600,,
com.leomehlig.today,1,1741221043,1741221044,1741221044.6475248,-21600,,
com.google.Chrome,8,1741221035,1741221043,1741221043.5888429,-21600,,
com.tinyspeck.chatlyio,5,1741221014,1741221019,1741221019.104361,-21600,EB445137-D7F5-57EC-87DA-1DB460D64046,"iPhone13,2"
com.google.Chrome,550,1741219835,1741220385,1741220385.99382,-21600,,
com.apple.Health,2,1741219831,1741219833,1741219834.033102,-21600,EB445137-D7F5-57EC-87DA-1DB460D64046,"iPhone13,2"
com.apple.finder,5,1741219830,1741219835,1741219835.122031,-21600,,
com.apple.finder,4,1741219222,1741219226,1741219226.968844,-21600,,
com.leomehlig.today,1,1741219221,1741219222,1741219222.786829,-21600,,
com.google.Chrome,314,1741218907,1741219221,1741219221.648052,-21600,,
com.leomehlig.today,93,1741218814,1741218907,1741218907.7103739,-21600,,
com.google.Chrome,2,1741218812,1741218814,1741218815.053098,-21600,,
com.jinzhenyu.ruler,1,1741218811,1741218812,1741218812.752098,-21600,,
com.google.Chrome,130,1741218681,1741218811,1741218812.0481238,-21600,,
com.apple.finder,30,1741218505,1741218535,1741218535.765723,-21600,,
com.electron.carta,4,1741218501,1741218505,1741218505.9933128,-21600,,
com.apple.Health,10,1741218452,1741218462,1741218462.9002728,-21600,EB445137-D7F5-57EC-87DA-1DB460D64046,"iPhone13,2"
com.apple.weather,1,1741218450,1741218451,1741218452.049633,-21600,EB445137-D7F5-57EC-87DA-1DB460D64046,"iPhone13,2"
com.apple.weather,8,1741218441,1741218449,1741218449.4411569,-21600,EB445137-D7F5-57EC-87DA-1DB460D64046,"iPhone13,2"
com.myfitnesspal.mfp,1,1741218440,1741218441,1741218444.024894,-21600,EB445137-D7F5-57EC-87DA-1DB460D64046,"iPhone13,2"
com.myfitnesspal.mfp,4,1741218412,1741218416,1741218416.3701282,-21600,EB445137-D7F5-57EC-87DA-1DB460D64046,"iPhone13,2"
com.myfitnesspal.mfp,47,1741218331,1741218378,1741218379.168054,-21600,EB445137-D7F5-57EC-87DA-1DB460D64046,"iPhone13,2"
com.myfitnesspal.mfp,86,1741218171,1741218257,1741218258.367072,-21600,EB445137-D7F5-57EC-87DA-1DB460D64046,"iPhone13,2"
com.apple.Health,26,1741218144,1741218170,1741218171.14767,-21600,EB445137-D7F5-57EC-87DA-1DB460D64046,"iPhone13,2"
com.apple.MobileSMS,18,1741218125,1741218143,1741218143.375002,-21600,EB445137-D7F5-57EC-87DA-1DB460D64046,"iPhone13,2"
com.tinyspeck.chatlyio,26,1741218091,1741218117,1741218117.9926739,-21600,EB445137-D7F5-57EC-87DA-1DB460D64046,"iPhone13,2"
com.microsoft.Office.Outlook,44,1741218047,1741218091,1741218092.351438,-21600,EB445137-D7F5-57EC-87DA-1DB460D64046,"iPhone13,2"
com.tinyspeck.chatlyio,8,1741218037,1741218045,1741218045.437446,-21600,EB445137-D7F5-57EC-87DA-1DB460D64046,"iPhone13,2"
com.toyopagroup.picaboo,8,1741218010,1741218018,1741218018.4927812,-21600,EB445137-D7F5-57EC-87DA-1DB460D64046,"iPhone13,2"
com.apple.mobiletimer,0,1741218010,1741218010,1741218010.995843,-21600,EB445137-D7F5-57EC-87DA-1DB460D64046,"iPhone13,2"
com.apple.mobiletimer,344,1741217642,1741217986,1741217986.593081,-21600,EB445137-D7F5-57EC-87DA-1DB460D64046,"iPhone13,2"
com.toyopagroup.picaboo,25,1741217246,1741217271,1741217271.7508202,-21600,EB445137-D7F5-57EC-87DA-1DB460D64046,"iPhone13,2"
com.toyopagroup.picaboo,39,1741217159,1741217198,1741217198.677947,-21600,EB445137-D7F5-57EC-87DA-1DB460D64046,"iPhone13,2"
com.myfitnesspal.mfp,0,1741217159,1741217159,1741217160.040962,-21600,EB445137-D7F5-57EC-87DA-1DB460D64046,"iPhone13,2"
com.myfitnesspal.mfp,146,1741216740,1741216886,1741216886.3609881,-21600,EB445137-D7F5-57EC-87DA-1DB460D64046,"iPhone13,2"
com.tinyspeck.chatlyio,2,1741216738,1741216740,1741216740.336259,-21600,EB445137-D7F5-57EC-87DA-1DB460D64046,"iPhone13,2"
com.tinyspeck.chatlyio,1,1741216737,1741216738,1741216738.751912,-21600,EB445137-D7F5-57EC-87DA-1DB460D64046,"iPhone13,2"
com.tinyspeck.chatlyio,6,1741216205,1741216211,1741216212.244666,-21600,EB445137-D7F5-57EC-87DA-1DB460D64046,"iPhone13,2"
com.apple.MobileSMS,3,1741216200,1741216203,1741216203.621159,-21600,EB445137-D7F5-57EC-87DA-1DB460D64046,"iPhone13,2"
com.apple.MobileSMS,74,1741215938,1741216012,1741216012.819212,-21600,EB445137-D7F5-57EC-87DA-1DB460D64046,"iPhone13,2"
com.apple.MobileSMS,28,1741215897,1741215925,1741215925.878164,-21600,EB445137-D7F5-57EC-87DA-1DB460D64046,"iPhone13,2"
com.apple.MobileSMS,29,1741215830,1741215859,1741215859.6361651,-21600,EB445137-D7F5-57EC-87DA-1DB460D64046,"iPhone13,2"
com.microsoft.Office.Outlook,3,1741215827,1741215830,1741215831.00135,-21600,EB445137-D7F5-57EC-87DA-1DB460D64046,"iPhone13,2"
com.apple.MobileSMS,105,1741215717,1741215822,1741215822.6034389,-21600,EB445137-D7F5-57EC-87DA-1DB460D64046,"iPhone13,2"
com.apple.mobilenotes,209,1741215469,1741215678,1741215678.53914,-21600,EB445137-D7F5-57EC-87DA-1DB460D64046,"iPhone13,2"
com.apple.MobileSMS,21,1741215448,1741215469,1741215469.7867808,-21600,EB445137-D7F5-57EC-87DA-1DB460D64046,"iPhone13,2"
com.apple.MobileSMS,29,1741215408,1741215437,1741215437.491262,-21600,EB445137-D7F5-57EC-87DA-1DB460D64046,"iPhone13,2"
com.apple.MobileSMS,21,1741215375,1741215396,1741215396.390524,-21600,EB445137-D7F5-57EC-87DA-1DB460D64046,"iPhone13,2"
com.toyopagroup.picaboo,6,1741215357,1741215363,1741215364.102114,-21600,EB445137-D7F5-57EC-87DA-1DB460D64046,"iPhone13,2"
com.apple.news,0,1741215357,1741215357,1741215357.951591,-21600,EB445137-D7F5-57EC-87DA-1DB460D64046,"iPhone13,2"
com.electron.carta,543,1741214381,1741214924,1741214924.2735,-21600,,
com.apple.finder,12,1741214369,1741214381,1741214381.141492,-21600,,
com.electron.carta,32,1741214337,1741214369,1741214369.034899,-21600,,
com.google.Chrome,13,1741214324,1741214337,1741214337.381629,-21600,,
com.electron.carta,125,1741214199,1741214324,1741214324.727796,-21600,,
com.apple.finder,13,1741214186,1741214199,1741214199.742848,-21600,,
com.google.Chrome,0,1741214186,1741214186,1741214186.977284,-21600,,
com.electron.carta,188,1741213998,1741214186,1741214186.21433,-21600,,
com.jinzhenyu.ruler,1,1741213997,1741213998,1741213998.275632,-21600,,
com.electron.carta,2,1741213995,1741213997,1741213997.2081718,-21600,,
com.google.Chrome,15,1741213980,1741213995,1741213995.4401379,-21600,,
com.electron.carta,2,1741213978,1741213980,1741213981.0276709,-21600,,
com.apple.finder,16,1741213962,1741213978,1741213978.2225718,-21600,,
com.electron.carta,524,1741213438,1741213962,1741213962.122149,-21600,,
com.apple.finder,3,1741213435,1741213438,1741213438.391199,-21600,,
com.electron.carta,39,1741213396,1741213435,1741213435.742753,-21600,,
com.apple.Preview,7,1741213389,1741213396,1741213396.413549,-21600,,
com.apple.finder,6,1741213383,1741213389,1741213389.490312,-21600,,
com.electron.carta,115,1741213268,1741213383,1741213383.188858,-21600,,
com.apple.finder,7,1741213261,1741213268,1741213268.167376,-21600,,
com.electron.carta,5,1741213256,1741213261,1741213262.026989,-21600,,
com.apple.finder,5,1741213251,1741213256,1741213256.274663,-21600,,
com.electron.carta,67,1741213184,1741213251,1741213251.482553,-21600,,
com.apple.finder,11,1741213173,1741213184,1741213184.353148,-21600,,
com.electron.carta,201,1741212972,1741213173,1741213173.970035,-21600,,
com.google.Chrome,2,1741212970,1741212972,1741212972.0736818,-21600,,
com.electron.carta,897,1741212073,1741212970,1741212970.678798,-21600,,
com.google.Chrome,13,1741212060,1741212073,1741212073.967705,-21600,,
com.electron.carta,338,1741211722,1741212060,1741212061.0616689,-21600,,
com.google.Chrome,29,1741211693,1741211722,1741211722.9578419,-21600,,
com.electron.carta,10,1741211683,1741211693,1741211693.8404388,-21600,,
com.google.Chrome,13,1741211670,1741211683,1741211683.037966,-21600,,
com.electron.carta,122,1741211548,1741211670,1741211670.922885,-21600,,
com.apple.finder,25,1741211523,1741211548,1741211548.668958,-21600,,
com.electron.carta,979,1741210544,1741211523,1741211523.343668,-21600,,
com.jinzhenyu.ruler,1,1741210543,1741210544,1741210544.619851,-21600,,
com.electron.carta,280,1741210263,1741210543,1741210543.737674,-21600,,
com.jinzhenyu.ruler,1,1741210262,1741210263,1741210263.7467098,-21600,,
com.electron.carta,165,1741210097,1741210262,1741210262.819203,-21600,,
com.jinzhenyu.ruler,3,1741210094,1741210097,1741210097.726721,-21600,,
com.electron.carta,109,1741209985,1741210094,1741210094.319079,-21600,,
com.jinzhenyu.ruler,57,1741209928,1741209985,1741209985.4237509,-21600,,
com.electron.carta,3,1741209925,1741209928,1741209928.2530909,-21600,,
com.jinzhenyu.ruler,3,1741209922,1741209925,1741209925.158547,-21600,,
com.electron.carta,12,1741209910,1741209922,1741209922.49256,-21600,,
com.jinzhenyu.ruler,4,1741209906,1741209910,1741209910.56248,-21600,,
com.electron.carta,227,1741209679,1741209906,1741209906.9235501,-21600,,
com.jinzhenyu.ruler,3,1741209676,1741209679,1741209679.422065,-21600,,
com.electron.carta,16,1741209660,1741209676,1741209676.142071,-21600,,
com.jinzhenyu.ruler,1,1741209659,1741209660,1741209660.498201,-21600,,
com.electron.carta,0,1741209659,1741209659,1741209659.945891,-21600,,
com.jinzhenyu.ruler,1,1741209658,1741209659,1741209659.6176128,-21600,,
com.electron.carta,67,1741209591,1741209658,1741209658.8151798,-21600,,
com.jinzhenyu.ruler,1,1741209590,1741209591,1741209591.3377352,-21600,,
com.electron.carta,49,1741209541,1741209590,1741209590.389032,-21600,,
com.jinzhenyu.ruler,4,1741209537,1741209541,1741209541.939001,-21600,,
com.electron.carta,1,1741209536,1741209537,1741209537.8882031,-21600,,
com.jinzhenyu.ruler,5,1741209531,1741209536,1741209536.155274,-21600,,
com.electron.carta,561,1741208970,1741209531,1741209532.0881991,-21600,,
com.apple.finder,4,1741208966,1741208970,1741208970.995528,-21600,,
com.electron.carta,19,1741208947,1741208966,1741208966.888624,-21600,,
com.apple.Notes,5,1741208942,1741208947,1741208948.139538,-21600,,
com.apple.news,28,1741208819,1741208847,1741208847.275193,-21600,EB445137-D7F5-57EC-87DA-1DB460D64046,"iPhone13,2"
com.tinyspeck.chatlyio,15,1741208796,1741208811,1741208811.38034,-21600,EB445137-D7F5-57EC-87DA-1DB460D64046,"iPhone13,2"
com.tinyspeck.chatlyio,4,1741208624,1741208628,1741208629.160054,-21600,EB445137-D7F5-57EC-87DA-1DB460D64046,"iPhone13,2"
com.ebay.iphone,0,1741208624,1741208624,1741208624.922015,-21600,EB445137-D7F5-57EC-87DA-1DB460D64046,"iPhone13,2"
com.ebay.iphone,11,1741208167,1741208178,1741208178.449868,-21600,EB445137-D7F5-57EC-87DA-1DB460D64046,"iPhone13,2"
com.apple.Health,38,1741204622,1741204660,1741204660.0297809,-21600,EB445137-D7F5-57EC-87DA-1DB460D64046,"iPhone13,2"
com.google.chrome.ios,2,1741204620,1741204622,1741204622.9017339,-21600,EB445137-D7F5-57EC-87DA-1DB460D64046,"iPhone13,2"
com.google.chrome.ios,151,1741204011,1741204162,1741204163.758596,-21600,EB445137-D7F5-57EC-87DA-1DB460D64046,"iPhone13,2"
com.apple.news,1,1741204010,1741204011,1741204011.896243,-21600,EB445137-D7F5-57EC-87DA-1DB460D64046,"iPhone13,2"
com.apple.news,233,1741203452,1741203685,1741203685.255774,-21600,EB445137-D7F5-57EC-87DA-1DB460D64046,"iPhone13,2"
com.instructure.icanvas,22,1741203419,1741203441,1741203441.100412,-21600,EB445137-D7F5-57EC-87DA-1DB460D64046,"iPhone13,2"
com.apple.Notes,6,1741201444,1741201450,1741201450.439316,-21600,,
com.google.Chrome,27,1741201417,1741201444,1741201444.833022,-21600,,
com.apple.Notes,40,1741201377,1741201417,1741201417.631429,-21600,,
com.google.Chrome,4,1741201373,1741201377,1741201377.8591828,-21600,,
com.apple.Notes,4,1741201369,1741201373,1741201373.866071,-21600,,
com.google.Chrome,2,1741201367,1741201369,1741201369.140341,-21600,,
com.apple.Notes,9,1741201358,1741201367,1741201367.4463549,-21600,,
com.google.Chrome,1,1741201357,1741201358,1741201358.226222,-21600,,
com.apple.Notes,3,1741201354,1741201357,1741201357.489242,-21600,,
com.google.Chrome,1,1741201353,1741201354,1741201354.075469,-21600,,
com.apple.Notes,5,1741201348,1741201353,1741201353.374819,-21600,,
com.google.Chrome,3,1741201345,1741201348,1741201348.127057,-21600,,
com.apple.Notes,5,1741201340,1741201345,1741201346.0614529,-21600,,
com.google.Chrome,31,1741201309,1741201340,1741201340.691657,-21600,,
com.apple.Notes,10,1741201299,1741201309,1741201309.414372,-21600,,
com.google.Chrome,80,1741201219,1741201299,1741201299.295032,-21600,,
com.apple.Notes,19,1741201200,1741201219,1741201219.7800589,-21600,,
com.google.Chrome,1,1741201199,1741201200,1741201200.677,-21600,,
com.apple.Notes,43,1741201156,1741201199,1741201199.5387468,-21600,,
com.google.Chrome,457,1741200699,1741201156,1741201156.3391972,-21600,,
com.apple.finder,1,1741200698,1741200699,1741200699.968301,-21600,,
com.leomehlig.today,12,1741200686,1741200698,1741200698.824743,-21600,,
com.apple.news,2,1741200660,1741200662,1741200662.1570392,-21600,EB445137-D7F5-57EC-87DA-1DB460D64046,"iPhone13,2"
com.apple.news,106,1741200553,1741200659,1741200659.361074,-21600,EB445137-D7F5-57EC-87DA-1DB460D64046,"iPhone13,2"
com.microsoft.Office.Outlook,2,1741200544,1741200546,1741200546.63546,-21600,EB445137-D7F5-57EC-87DA-1DB460D64046,"iPhone13,2"
com.microsoft.Office.Outlook,4,1741200540,1741200544,1741200544.476688,-21600,EB445137-D7F5-57EC-87DA-1DB460D64046,"iPhone13,2"
com.instructure.icanvas,20,1741200518,1741200538,1741200538.4976048,-21600,EB445137-D7F5-57EC-87DA-1DB460D64046,"iPhone13,2"
com.github.stormbreaker.prod,153,1741200360,1741200513,1741200513.6831288,-21600,EB445137-D7F5-57EC-87DA-1DB460D64046,"iPhone13,2"
com.apple.MobileSMS,3,1741200340,1741200343,1741200343.092721,-21600,EB445137-D7F5-57EC-87DA-1DB460D64046,"iPhone13,2"
com.leomehlig.today,6,1741199471,1741199477,1741199477.9992251,-21600,,
com.google.Chrome,614,1741198857,1741199471,1741199471.259367,-21600,,
com.google.Chrome,343,1741198392,1741198735,1741198735.597312,-21600,,
com.apple.finder,7,1741198385,1741198392,1741198392.915008,-21600,,
com.apple.MobileSMS,15,1741194038,1741194053,1741194054.0885348,-21600,EB445137-D7F5-57EC-87DA-1DB460D64046,"iPhone13,2"
com.apple.news,32,1741194006,1741194038,1741194038.435883,-21600,EB445137-D7F5-57EC-87DA-1DB460D64046,"iPhone13,2"
Astrospheric.Astrospheric,54,1741193948,1741194002,1741194002.1377292,-21600,EB445137-D7F5-57EC-87DA-1DB460D64046,"iPhone13,2"
com.tier9digital.sundial,21,1741193925,1741193946,1741193946.677659,-21600,EB445137-D7F5-57EC-87DA-1DB460D64046,"iPhone13,2"
Astrospheric.Astrospheric,17,1741193906,1741193923,1741193923.510113,-21600,EB445137-D7F5-57EC-87DA-1DB460D64046,"iPhone13,2"
com.apple.weather,24,1741193878,1741193902,1741193902.677681,-21600,EB445137-D7F5-57EC-87DA-1DB460D64046,"iPhone13,2"
com.truebill.truebillnative,46,1741193825,1741193871,1741193871.832967,-21600,EB445137-D7F5-57EC-87DA-1DB460D64046,"iPhone13,2"
com.discoverfinancial.mobile,3,1741193819,1741193822,1741193822.508391,-21600,EB445137-D7F5-57EC-87DA-1DB460D64046,"iPhone13,2"
com.apple.CoreAuthUI,2,1741193791,1741193793,1741193793.851489,-21600,EB445137-D7F5-57EC-87DA-1DB460D64046,"iPhone13,2"
com.discoverfinancial.mobile,32,1741193785,1741193817,1741193818.114067,-21600,EB445137-D7F5-57EC-87DA-1DB460D64046,"iPhone13,2"
com.apple.CoreAuthUI,2,1741193745,1741193747,1741193747.990921,-21600,EB445137-D7F5-57EC-87DA-1DB460D64046,"iPhone13,2"
com.truebill.truebillnative,39,1741193742,1741193781,1741193782.134842,-21600,EB445137-D7F5-57EC-87DA-1DB460D64046,"iPhone13,2"
com.google.chrome.ios,24,1741193714,1741193738,1741193738.81759,-21600,EB445137-D7F5-57EC-87DA-1DB460D64046,"iPhone13,2"
com.apple.news,1,1741193713,1741193714,1741193714.9126701,-21600,EB445137-D7F5-57EC-87DA-1DB460D64046,"iPhone13,2"
com.apple.news,254,1741193131,1741193385,1741193385.9881768,-21600,EB445137-D7F5-57EC-87DA-1DB460D64046,"iPhone13,2"
com.apple.finder,6,1741193109,1741193115,1741193115.7835011,-21600,,
com.apple.finder,98,1741192294,1741192392,1741192392.455914,-21600,,
com.leomehlig.today,2,1741192292,1741192294,1741192294.487464,-21600,,
com.apple.finder,9,1741192283,1741192292,1741192292.603777,-21600,,
com.leomehlig.today,2,1741192281,1741192283,1741192283.4346318,-21600,,
com.apple.iCal,11,1741192270,1741192281,1741192281.692831,-21600,,
com.google.Chrome,5,1741192265,1741192270,1741192270.96611,-21600,,
com.leomehlig.today,17,1741192248,1741192265,1741192265.760371,-21600,,
com.google.Chrome,1,1741192247,1741192248,1741192248.25694,-21600,,
com.leomehlig.today,7,1741192240,1741192247,1741192247.254302,-21600,,
com.google.Chrome,15,1741192225,1741192240,1741192240.9586182,-21600,,
com.apple.iCal,19,1741192206,1741192225,1741192225.501246,-21600,,
com.apple.finder,39,1741192167,1741192206,1741192206.662926,-21600,,
com.google.Chrome,5,1741192162,1741192167,1741192168.0017772,-21600,,
com.apple.iCal,28,1741192134,1741192162,1741192162.810162,-21600,,
com.google.Chrome,137,1741191997,1741192134,1741192134.73489,-21600,,
com.apple.finder,102,1741191895,1741191997,1741191997.7439408,-21600,,
com.google.Chrome,39,1741191856,1741191895,1741191895.680095,-21600,,
com.apple.iCal,29,1741191813,1741191842,1741191842.5339332,-21600,,
com.leomehlig.today,25,1741191788,1741191813,1741191813.206603,-21600,,
com.google.Chrome,57,1741191731,1741191788,1741191788.902087,-21600,,
com.leomehlig.today,19,1741191682,1741191701,1741191702.008168,-21600,,
com.google.Chrome,494,1741191188,1741191682,1741191682.7556,-21600,,
com.microsoft.Office.Outlook,22,1741190569,1741190591,1741190591.875231,-21600,EB445137-D7F5-57EC-87DA-1DB460D64046,"iPhone13,2"
com.apple.Health,34,1741190534,1741190568,1741190568.893444,-21600,EB445137-D7F5-57EC-87DA-1DB460D64046,"iPhone13,2"
com.renpho.health,4,1741190530,1741190534,1741190534.353456,-21600,EB445137-D7F5-57EC-87DA-1DB460D64046,"iPhone13,2"
com.google.Chrome,311,1741190177,1741190488,1741190488.3387852,-21600,,
com.google.Chrome,1046,1741188735,1741189781,1741189781.2817268,-21600,,
com.apple.Dictionary,2,1741188733,1741188735,1741188735.2762651,-21600,,
com.google.Chrome,564,1741188169,1741188733,1741188733.344164,-21600,,
com.leomehlig.today,52,1741188117,1741188169,1741188169.847733,-21600,,
com.google.Chrome,1224,1741186893,1741188117,1741188117.67178,-21600,,
com.renpho.health,57,1741185074,1741185131,1741185131.3951712,-21600,EB445137-D7F5-57EC-87DA-1DB460D64046,"iPhone13,2"
com.apple.news,67,1741184999,1741185066,1741185066.226074,-21600,EB445137-D7F5-57EC-87DA-1DB460D64046,"iPhone13,2"
com.thestorygraph.thestorygraph,42,1741154172,1741154214,1741154214.568295,-21600,EB445137-D7F5-57EC-87DA-1DB460D64046,"iPhone13,2"
com.apple.news,2,1741154170,1741154172,1741154173.815959,-21600,EB445137-D7F5-57EC-87DA-1DB460D64046,"iPhone13,2"
com.google.Chrome,110,1741152442,1741152552,1741152552.391056,-21600,,
com.google.Chrome,721,1741151552,1741152273,1741152273.888287,-21600,,
com.apple.finder,2,1741151550,1741151552,1741151552.3797588,-21600,,
com.leomehlig.today,8,1741151542,1741151550,1741151550.736177,-21600,,
com.google.Chrome,140,1741151402,1741151542,1741151542.6242151,-21600,,
com.apple.MobileSMS,4,1741151398,1741151402,1741151402.6626701,-21600,,
com.google.Chrome,393,1741151005,1741151398,1741151398.63316,-21600,,
com.google.Chrome,329,1741150667,1741150996,1741150996.6548982,-21600,,
com.google.Chrome,1559,1741148894,1741150453,1741150453.171949,-21600,,
com.google.Chrome,373,1741146926,1741147299,1741147299.6281528,-21600,,
com.apple.finder,1,1741146925,1741146926,1741146926.749,-21600,,
com.google.Chrome,5,1741146920,1741146925,1741146925.25311,-21600,,
com.apple.finder,4,1741146916,1741146920,1741146920.460258,-21600,,
com.apple.news,29,1741146229,1741146258,1741146258.972703,-21600,EB445137-D7F5-57EC-87DA-1DB460D64046,"iPhone13,2"
com.apple.Music,0,1741146229,1741146229,1741146230.18019,-21600,EB445137-D7F5-57EC-87DA-1DB460D64046,"iPhone13,2"
com.apple.Music,23,1741144673,1741144696,1741144697.114938,-21600,EB445137-D7F5-57EC-87DA-1DB460D64046,"iPhone13,2"
com.apple.MobileSMS,4,1741144492,1741144496,1741144497.108306,-21600,EB445137-D7F5-57EC-87DA-1DB460D64046,"iPhone13,2"
com.apple.finder,7,1741144394,1741144401,1741144401.85365,-21600,,
com.leomehlig.today,143,1741144251,1741144394,1741144394.746696,-21600,,
com.apple.finder,3,1741144248,1741144251,1741144251.379263,-21600,,
com.microsoft.VSCode,19,1741144229,1741144248,1741144249.130251,-21600,,
com.google.Chrome,20,1741144209,1741144229,1741144229.895442,-21600,,
com.microsoft.VSCode,18,1741144191,1741144209,1741144209.964119,-21600,,
com.google.Chrome,35,1741144156,1741144191,1741144191.741887,-21600,,
com.microsoft.VSCode,6,1741144150,1741144156,1741144156.877897,-21600,,
com.apple.Preview,77,1741144073,1741144150,1741144150.988822,-21600,,
com.microsoft.VSCode,31,1741144042,1741144073,1741144073.903551,-21600,,
com.apple.Preview,25,1741144017,1741144042,1741144042.572691,-21600,,
com.microsoft.VSCode,70,1741143947,1741144017,1741144017.288213,-21600,,
com.apple.Preview,26,1741143921,1741143947,1741143947.9012861,-21600,,
com.microsoft.VSCode,14,1741143907,1741143921,1741143921.18405,-21600,,
com.google.Chrome,2,1741143905,1741143907,1741143907.4682732,-21600,,
com.microsoft.VSCode,35,1741143870,1741143905,1741143905.4540339,-21600,,
com.google.Chrome,18,1741143852,1741143870,1741143870.706619,-21600,,
com.microsoft.VSCode,145,1741143707,1741143852,1741143852.607532,-21600,,
com.google.Chrome,4,1741143703,1741143707,1741143707.955441,-21600,,
com.microsoft.VSCode,15,1741143688,1741143703,1741143703.3117762,-21600,,
com.apple.Preview,5,1741143683,1741143688,1741143688.845303,-21600,,
com.microsoft.VSCode,5,1741143678,1741143683,1741143683.42854,-21600,,
com.apple.finder,1,1741143677,1741143678,1741143678.162097,-21600,,
com.microsoft.VSCode,9,1741143668,1741143677,1741143677.059103,-21600,,
com.apple.finder,2,1741143666,1741143668,1741143668.2330542,-21600,,
com.apple.Preview,1,1741143665,1741143666,1741143666.584655,-21600,,
com.google.Chrome,26,1741143639,1741143665,1741143665.608819,-21600,,
com.apple.Preview,1,1741143638,1741143639,1741143639.423812,-21600,,
com.google.Chrome,23,1741143615,1741143638,1741143638.637469,-21600,,
com.apple.Preview,1,1741143614,1741143615,1741143615.588474,-21600,,
com.google.Chrome,7,1741143607,1741143614,1741143614.1319718,-21600,,
com.apple.Preview,25,1741143582,1741143607,1741143607.2194471,-21600,,
com.microsoft.VSCode,48,1741143534,1741143582,1741143582.876581,-21600,,
com.apple.Preview,12,1741143522,1741143534,1741143534.733307,-21600,,
com.microsoft.VSCode,4,1741143518,1741143522,1741143522.7227201,-21600,,
com.apple.Preview,1,1741143517,1741143518,1741143518.837057,-21600,,
com.microsoft.VSCode,3,1741143514,1741143517,1741143517.851614,-21600,,
com.apple.Preview,6,1741143508,1741143514,1741143514.2958941,-21600,,
com.microsoft.VSCode,9,1741143499,1741143508,1741143508.938987,-21600,,
com.apple.Preview,46,1741143453,1741143499,1741143500.0114322,-21600,,
com.microsoft.VSCode,13,1741143440,1741143453,1741143453.935503,-21600,,
com.apple.Preview,5,1741143435,1741143440,1741143440.1585732,-21600,,
com.microsoft.VSCode,3,1741143432,1741143435,1741143435.83723,-21600,,
com.apple.Preview,2,1741143430,1741143432,1741143432.5661469,-21600,,
com.microsoft.VSCode,10,1741143420,1741143430,1741143430.8811898,-21600,,
com.apple.Preview,38,1741143382,1741143420,1741143420.82618,-21600,,
com.apple.finder,2,1741143380,1741143382,1741143382.170646,-21600,,
com.microsoft.VSCode,0,1741143380,1741143380,1741143380.899489,-21600,,
com.apple.finder,3,1741143377,1741143380,1741143380.546294,-21600,,
com.microsoft.VSCode,28,1741143349,1741143377,1741143377.8237681,-21600,,
com.apple.finder,1,1741143348,1741143349,1741143349.624007,-21600,,
com.apple.Preview,21,1741143327,1741143348,1741143348.7424111,-21600,,
com.apple.finder,2,1741143325,1741143327,1741143327.7879329,-21600,,
com.apple.Preview,2,1741143323,1741143325,1741143325.68711,-21600,,
com.apple.finder,1,1741143322,1741143323,1741143323.99108,-21600,,
com.apple.Preview,4,1741143318,1741143322,1741143322.209916,-21600,,
com.apple.finder,11,1741143307,1741143318,1741143318.670621,-21600,,
com.apple.Preview,6,1741143301,1741143307,1741143307.496437,-21600,,
com.microsoft.VSCode,51,1741143250,1741143301,1741143301.1624432,-21600,,
com.apple.Preview,4,1741143246,1741143250,1741143250.061748,-21600,,
com.microsoft.VSCode,89,1741143157,1741143246,1741143246.368778,-21600,,
com.apple.finder,9,1741143148,1741143157,1741143158.006871,-21600,,
com.apple.Preview,3,1741143145,1741143148,1741143148.937391,-21600,,
com.microsoft.VSCode,110,1741143035,1741143145,1741143145.940263,-21600,,
com.google.Chrome,1,1741143034,1741143035,1741143035.829527,-21600,,
com.apple.Preview,4,1741143030,1741143034,1741143034.836639,-21600,,
com.google.Chrome,1,1741143029,1741143030,1741143030.761767,-21600,,
com.microsoft.VSCode,173,1741142856,1741143029,1741143030.032512,-21600,,
com.apple.Preview,25,1741142831,1741142856,1741142856.662335,-21600,,
com.google.Chrome,2,1741142829,1741142831,1741142831.720614,-21600,,
com.apple.Preview,34,1741142795,1741142829,1741142829.284062,-21600,,
com.google.Chrome,18,1741142777,1741142795,1741142796.00314,-21600,,
com.apple.Preview,37,1741142740,1741142777,1741142777.958095,-21600,,
com.apple.finder,24,1741142716,1741142740,1741142740.784857,-21600,,
com.apple.Preview,4,1741142712,1741142716,1741142717.002532,-21600,,
com.apple.finder,89,1741142623,1741142712,1741142712.576253,-21600,,
com.apple.Preview,110,1741142513,1741142623,1741142623.937595,-21600,,
com.leomehlig.today,24,1741142489,1741142513,1741142513.578758,-21600,,
com.google.Chrome,33,1741142456,1741142489,1741142489.37657,-21600,,
com.apple.Preview,107,1741142349,1741142456,1741142456.953625,-21600,,
com.apple.finder,4,1741142345,1741142349,1741142349.992429,-21600,,
com.apple.Preview,151,1741142194,1741142345,1741142345.997932,-21600,,
com.apple.finder,11,1741142183,1741142194,1741142194.268673,-21600,,
com.leomehlig.today,5,1741142178,1741142183,1741142183.19002,-21600,,
com.google.Chrome,28,1741142150,1741142178,1741142178.589621,-21600,,
com.leomehlig.today,11,1741142139,1741142150,1741142150.98904,-21600,,
com.google.Chrome,18,1741142121,1741142139,1741142139.151266,-21600,,
com.myfitnesspal.mfp,20,1741141702,1741141722,1741141722.72163,-21600,EB445137-D7F5-57EC-87DA-1DB460D64046,"iPhone13,2"
com.apple.MobileSMS,2,1741141666,1741141668,1741141668.460894,-21600,EB445137-D7F5-57EC-87DA-1DB460D64046,"iPhone13,2"
com.apple.MobileSMS,2,1741141664,1741141666,1741141666.539156,-21600,EB445137-D7F5-57EC-87DA-1DB460D64046,"iPhone13,2"
com.apple.MobileSMS,35,1741141414,1741141449,1741141449.303948,-21600,EB445137-D7F5-57EC-87DA-1DB460D64046,"iPhone13,2"
com.apple.MobileSMS,74,1741141319,1741141393,1741141393.893038,-21600,EB445137-D7F5-57EC-87DA-1DB460D64046,"iPhone13,2"
com.facebook.Facebook,99,1741141220,1741141319,1741141319.830584,-21600,EB445137-D7F5-57EC-87DA-1DB460D64046,"iPhone13,2"
com.apple.MobileSMS,6,1741141214,1741141220,1741141222.824716,-21600,EB445137-D7F5-57EC-87DA-1DB460D64046,"iPhone13,2"
com.robinhood.release.Robinhood,0,1741141214,1741141214,1741141215.795103,-21600,EB445137-D7F5-57EC-87DA-1DB460D64046,"iPhone13,2"
com.google.Chrome,740,1741141058,1741141798,1741141798.659231,-21600,,
com.leomehlig.today,2,1741141056,1741141058,1741141058.871325,-21600,,
com.google.Chrome,98,1741140958,1741141056,1741141057.021266,-21600,,
com.apple.Preview,2,1741140633,1741140635,1741140635.206202,-21600,,
com.google.Chrome,1,1741140632,1741140633,1741140633.12362,-21600,,
com.leomehlig.today,101,1741140531,1741140632,1741140632.227653,-21600,,
com.google.Chrome,12,1741140519,1741140531,1741140531.533659,-21600,,
com.apple.Preview,28,1741140491,1741140519,1741140519.2748442,-21600,,
com.apple.finder,6,1741140485,1741140491,1741140491.770581,-21600,,
com.apple.Preview,5,1741140480,1741140485,1741140485.644387,-21600,,
com.google.Chrome,427,1741140053,1741140480,1741140480.6391501,-21600,,
com.leomehlig.today,1,1741140052,1741140053,1741140053.489246,-21600,,
com.google.Chrome,63,1741139989,1741140052,1741140052.389509,-21600,,
com.google.Chrome,300,1741139682,1741139982,1741139982.579599,-21600,,
com.apple.CoreAuthUI,2,1741139636,1741139638,1741139638.967937,-21600,EB445137-D7F5-57EC-87DA-1DB460D64046,"iPhone13,2"
com.robinhood.release.Robinhood,47,1741139633,1741139680,1741139682.003563,-21600,EB445137-D7F5-57EC-87DA-1DB460D64046,"iPhone13,2"
com.apple.news,138,1741139492,1741139630,1741139630.560482,-21600,EB445137-D7F5-57EC-87DA-1DB460D64046,"iPhone13,2"
com.microsoft.Office.Outlook,53,1741139431,1741139484,1741139484.6562061,-21600,EB445137-D7F5-57EC-87DA-1DB460D64046,"iPhone13,2"
com.google.Chrome,797,1741138873,1741139670,1741139670.0582771,-21600,,
com.google.Chrome,909,1741137952,1741138861,1741138861.660842,-21600,,
com.apple.Preview,79,1741137873,1741137952,1741137952.775677,-21600,,
com.apple.Preview,300,1741137444,1741137744,1741137744.925951,-21600,,
com.google.Chrome,1,1741137443,1741137444,1741137444.9526381,-21600,,
com.leomehlig.today,2,1741137441,1741137443,1741137443.977273,-21600,,
com.google.Chrome,428,1741137013,1741137441,1741137441.285225,-21600,,
com.google.Chrome,768,1741136220,1741136988,1741136988.682012,-21600,,
com.apple.Preview,2,1741136218,1741136220,1741136221.0408459,-21600,,
com.apple.Preview,310,1741135868,1741136178,1741136178.798123,-21600,,
com.google.Chrome,205,1741135663,1741135868,1741135868.723522,-21600,,
com.apple.Preview,9,1741135654,1741135663,1741135663.993154,-21600,,
com.apple.finder,2,1741135652,1741135654,1741135654.341663,-21600,,
com.apple.Preview,1,1741135651,1741135652,1741135652.2711248,-21600,,
com.apple.finder,7,1741135644,1741135651,1741135651.529033,-21600,,
com.google.Chrome,107,1741135537,1741135644,1741135644.436095,-21600,,
com.leomehlig.today,92,1741135445,1741135537,1741135538.7625241,-21600,,
com.tinyspeck.chatlyio,18,1741135332,1741135350,1741135350.2469869,-21600,EB445137-D7F5-57EC-87DA-1DB460D64046,"iPhone13,2"
com.apple.Music,1,1741135323,1741135324,1741135325.36216,-21600,EB445137-D7F5-57EC-87DA-1DB460D64046,"iPhone13,2"
com.leomehlig.today,7,1741134590,1741134597,1741134597.6170712,-21600,,
com.google.Chrome,93,1741134497,1741134590,1741134590.716044,-21600,,
com.apple.finder,17,1741134468,1741134485,1741134485.87574,-21600,,
com.apple.Preview,141,1741134327,1741134468,1741134468.621942,-21600,,
com.leomehlig.today,2,1741134325,1741134327,1741134327.081847,-21600,,
com.apple.Preview,1757,1741132568,1741134325,1741134325.6839042,-21600,,
com.google.Chrome,37,1741132531,1741132568,1741132568.528688,-21600,,
com.apple.Preview,127,1741132404,1741132531,1741132531.3958812,-21600,,
com.apple.Music,29,1741131775,1741131804,1741131804.242578,-21600,EB445137-D7F5-57EC-87DA-1DB460D64046,"iPhone13,2"
com.apple.mobileslideshow,3,1741131772,1741131775,1741131775.3377252,-21600,EB445137-D7F5-57EC-87DA-1DB460D64046,"iPhone13,2"
com.apple.finder,12,1741131720,1741131732,1741131732.792365,-21600,,
com.leomehlig.today,2,1741131718,1741131720,1741131720.267257,-21600,,
com.apple.mobileslideshow,18,1741131604,1741131622,1741131622.6032782,-21600,EB445137-D7F5-57EC-87DA-1DB460D64046,"iPhone13,2"
com.apple.mobileslideshow,2,1741131601,1741131603,1741131603.816557,-21600,EB445137-D7F5-57EC-87DA-1DB460D64046,"iPhone13,2"
com.apple.weather,2,1741131599,1741131601,1741131601.456032,-21600,EB445137-D7F5-57EC-87DA-1DB460D64046,"iPhone13,2"
com.leomehlig.today,15,1741130684,1741130699,1741130699.3123431,-21600,,
com.apple.news,0,1741130646,1741130646,1741130647.144973,-21600,EB445137-D7F5-57EC-87DA-1DB460D64046,"iPhone13,2"
com.apple.news,341,1741130168,1741130509,1741130509.8963041,-21600,EB445137-D7F5-57EC-87DA-1DB460D64046,"iPhone13,2"
com.leomehlig.today,346,1741130095,1741130441,1741130441.33879,-21600,,
com.google.Chrome,6,1741130089,1741130095,1741130095.051542,-21600,,
com.leomehlig.today,36,1741130053,1741130089,1741130090.027554,-21600,,
com.google.Chrome,2,1741130051,1741130053,1741130053.737632,-21600,,
com.leomehlig.today,26,1741130025,1741130051,1741130051.1696692,-21600,,
com.apple.iCal,11,1741130014,1741130025,1741130026.046802,-21600,,
com.google.Chrome,2,1741130012,1741130014,1741130014.1471639,-21600,,
com.leomehlig.today,12,1741130000,1741130012,1741130012.730608,-21600,,
com.google.Chrome,474,1741129526,1741130000,1741130000.33573,-21600,,
com.google.Chrome,544,1741128879,1741129423,1741129423.5502949,-21600,,
com.apple.Notes,0,1741128879,1741128879,1741128880.090096,-21600,,
com.google.Chrome,5,1741128874,1741128879,1741128879.162797,-21600,,
com.apple.Notes,2,1741128872,1741128874,1741128875.040087,-21600,,
com.leomehlig.today,7,1741128865,1741128872,1741128872.3900452,-21600,,
com.google.Chrome,111,1741128754,1741128865,1741128865.1429682,-21600,,
com.microsoft.Office.Outlook,5,1741127942,1741127947,1741127947.6304622,-21600,EB445137-D7F5-57EC-87DA-1DB460D64046,"iPhone13,2"
com.google.chrome.ios,100,1741127842,1741127942,1741127943.13557,-21600,EB445137-D7F5-57EC-87DA-1DB460D64046,"iPhone13,2"
com.google.chrome.ios,3,1741127839,1741127842,1741127847.313659,-21600,EB445137-D7F5-57EC-87DA-1DB460D64046,"iPhone13,2"
com.google.chrome.ios,13,1741127802,1741127815,1741127817.4583201,-21600,EB445137-D7F5-57EC-87DA-1DB460D64046,"iPhone13,2"
com.microsoft.Office.Outlook,26,1741127776,1741127802,1741127803.0572538,-21600,EB445137-D7F5-57EC-87DA-1DB460D64046,"iPhone13,2"
com.myfitnesspal.mfp,2,1741127774,1741127776,1741127776.0929189,-21600,EB445137-D7F5-57EC-87DA-1DB460D64046,"iPhone13,2"
com.myfitnesspal.mfp,46,1741117372,1741117418,1741117419.0186749,-21600,EB445137-D7F5-57EC-87DA-1DB460D64046,"iPhone13,2"
com.groupme.iphone-app,16,1741116684,1741116700,1741116700.3414888,-21600,EB445137-D7F5-57EC-87DA-1DB460D64046,"iPhone13,2"
com.instructure.icanvas,1,1741116683,1741116684,1741116684.481688,-21600,EB445137-D7F5-57EC-87DA-1DB460D64046,"iPhone13,2"
com.google.Chrome,1224,1741115877,1741117101,1741117101.959708,-21600,,
com.leomehlig.today,8,1741115869,1741115877,1741115877.67899,-21600,,
com.apple.Preview,85,1741115784,1741115869,1741115869.106427,-21600,,
com.apple.finder,32,1741115752,1741115784,1741115784.051338,-21600,,
com.leomehlig.today,9,1741115743,1741115752,1741115752.155315,-21600,,
com.google.Chrome,3,1741115740,1741115743,1741115743.242293,-21600,,
com.apple.iCal,46,1741115694,1741115740,1741115741.016084,-21600,,
com.google.Chrome,2,1741115692,1741115694,1741115694.584795,-21600,,
com.apple.iCal,22,1741115670,1741115692,1741115692.487617,-21600,,
com.google.Chrome,4,1741115666,1741115670,1741115670.2105799,-21600,,
com.apple.iCal,1,1741115665,1741115666,1741115666.700685,-21600,,
com.leomehlig.today,1,1741115664,1741115665,1741115665.681596,-21600,,
com.apple.calculator,1,1741115663,1741115664,1741115664.4912071,-21600,,
com.leomehlig.today,29,1741115634,1741115663,1741115663.2302961,-21600,,
com.google.Chrome,49,1741115585,1741115634,1741115634.494179,-21600,,
com.instructure.icanvas,41,1741115294,1741115335,1741115336.168418,-21600,EB445137-D7F5-57EC-87DA-1DB460D64046,"iPhone13,2"
com.google.Gmail,0,1741115294,1741115294,1741115295.101367,-21600,EB445137-D7F5-57EC-87DA-1DB460D64046,"iPhone13,2"
com.google.Gmail,26,1741115265,1741115291,1741115291.4713368,-21600,EB445137-D7F5-57EC-87DA-1DB460D64046,"iPhone13,2"
com.google.chrome.ios,13,1741114489,1741114502,1741114502.440295,-21600,EB445137-D7F5-57EC-87DA-1DB460D64046,"iPhone13,2"
com.microsoft.onenote,2,1741114487,1741114489,1741114489.104828,-21600,EB445137-D7F5-57EC-87DA-1DB460D64046,"iPhone13,2"
com.microsoft.onenote,50,1741114127,1741114177,1741114178.0307012,-21600,EB445137-D7F5-57EC-87DA-1DB460D64046,"iPhone13,2"
com.microsoft.onenote,70,1741114014,1741114084,1741114085.346345,-21600,EB445137-D7F5-57EC-87DA-1DB460D64046,"iPhone13,2"
com.myfitnesspal.mfp,4,1741114008,1741114012,1741114012.1860352,-21600,EB445137-D7F5-57EC-87DA-1DB460D64046,"iPhone13,2"
com.myfitnesspal.mfp,41,1741113966,1741114007,1741114007.994048,-21600,EB445137-D7F5-57EC-87DA-1DB460D64046,"iPhone13,2"
com.myfitnesspal.mfp,2,1741113964,1741113966,1741113966.369347,-21600,EB445137-D7F5-57EC-87DA-1DB460D64046,"iPhone13,2"
com.myfitnesspal.mfp,32,1741113485,1741113517,1741113518.39615,-21600,EB445137-D7F5-57EC-87DA-1DB460D64046,"iPhone13,2"
com.instructure.icanvas,4,1741113464,1741113468,1741113469.0159302,-21600,EB445137-D7F5-57EC-87DA-1DB460D64046,"iPhone13,2"
com.microsoft.Office.Outlook,68,1741113390,1741113458,1741113458.729486,-21600,EB445137-D7F5-57EC-87DA-1DB460D64046,"iPhone13,2"
com.apple.weather,1,1741113389,1741113390,1741113390.858666,-21600,EB445137-D7F5-57EC-87DA-1DB460D64046,"iPhone13,2"
com.apple.weather,22,1741111339,1741111361,1741111361.885521,-21600,EB445137-D7F5-57EC-87DA-1DB460D64046,"iPhone13,2"
com.google.Chrome,479,1741110646,1741111125,1741111126.518223,-21600,,
com.google.Chrome,367,1741110215,1741110582,1741110582.870492,-21600,,
com.apple.finder,2,1741110213,1741110215,1741110217.216021,-21600,,
com.apple.finder,304,1741109505,1741109809,1741109809.685298,-21600,,
com.leomehlig.today,5,1741109500,1741109505,1741109505.609455,-21600,,
com.apple.finder,2,1741109498,1741109500,1741109500.722841,-21600,,
com.electron.carta,3,1741109495,1741109498,1741109498.7059069,-21600,,
com.google.Chrome,79,1741109416,1741109495,1741109495.502057,-21600,,
com.electron.carta,36,1741109306,1741109342,1741109342.421705,-21600,,
com.google.Chrome,46,1741109260,1741109306,1741109306.392291,-21600,,
com.electron.carta,80,1741109180,1741109260,1741109260.306339,-21600,,
com.apple.finder,7,1741109173,1741109180,1741109181.031948,-21600,,
com.electron.carta,10,1741109163,1741109173,1741109174.017457,-21600,,
com.google.Chrome,14,1741109149,1741109163,1741109163.4664168,-21600,,
com.electron.carta,49,1741109100,1741109149,1741109149.316802,-21600,,
com.google.Chrome,73,1741109027,1741109100,1741109100.376493,-21600,,
com.electron.carta,24,1741109003,1741109027,1741109027.218823,-21600,,
com.google.Chrome,79,1741108924,1741109003,1741109003.918971,-21600,,
com.electron.carta,24,1741108900,1741108924,1741108924.538584,-21600,,
com.google.Chrome,29,1741108871,1741108900,1741108900.9812841,-21600,,
com.apple.finder,11,1741108860,1741108871,1741108872.07056,-21600,,
com.google.Chrome,20,1741108840,1741108860,1741108860.260909,-21600,,
com.electron.carta,96,1741108744,1741108840,1741108840.187789,-21600,,
com.google.Chrome,18,1741108726,1741108744,1741108744.4803228,-21600,,
com.apple.finder,24,1741108702,1741108726,1741108726.997476,-21600,,
com.google.Chrome,11,1741108691,1741108702,1741108702.375049,-21600,,
com.apple.finder,51,1741108640,1741108691,1741108691.8508859,-21600,,
com.electron.carta,19,1741108621,1741108640,1741108640.612385,-21600,,
com.apple.finder,17,1741108604,1741108621,1741108622.0259,-21600,,
com.leomehlig.today,1,1741108603,1741108604,1741108604.4954782,-21600,,
com.google.Chrome,13,1741108590,1741108603,1741108603.741562,-21600,,
com.apple.Notes,155,1741108198,1741108353,1741108354.4847112,-21600,,
com.google.Chrome,13,1741108185,1741108198,1741108198.513232,-21600,,
com.apple.Notes,5,1741108180,1741108185,1741108185.258841,-21600,,
com.google.Chrome,9,1741108171,1741108180,1741108180.723489,-21600,,
com.apple.Notes,12,1741108159,1741108171,1741108171.984967,-21600,,
com.google.Chrome,2459,1741105700,1741108159,1741108159.249123,-21600,,
com.leomehlig.today,28,1741105672,1741105700,1741105700.339735,-21600,,
com.apple.Preview,9,1741105663,1741105672,1741105672.069305,-21600,,
com.apple.Preview,333,1741105215,1741105548,1741105548.909411,-21600,,
com.apple.Notes,73,1741105142,1741105215,1741105215.89274,-21600,,
com.apple.Preview,253,1741104889,1741105142,1741105142.128471,-21600,,
com.apple.finder,2,1741104887,1741104889,1741104889.9169989,-21600,,
com.apple.Notes,21,1741104866,1741104887,1741104887.528889,-21600,,
com.apple.Preview,275,1741104591,1741104866,1741104866.10688,-21600,,
com.google.Chrome,10,1741104581,1741104591,1741104591.7480059,-21600,,
com.apple.weather,8,1741104155,1741104163,1741104163.8589401,-21600,EB445137-D7F5-57EC-87DA-1DB460D64046,"iPhone13,2"
com.apple.Preview,484,1741104097,1741104581,1741104581.92712,-21600,,
com.apple.Notes,11,1741104086,1741104097,1741104097.4844189,-21600,,
com.apple.Preview,5,1741104081,1741104086,1741104086.1004639,-21600,,
com.apple.finder,4,1741104077,1741104081,1741104081.7531009,-21600,,
com.apple.Notes,10,1741104067,1741104077,1741104077.1060739,-21600,,
co.hinge.mobile.ios,103,1741103959,1741104062,1741104062.8851008,-21600,EB445137-D7F5-57EC-87DA-1DB460D64046,"iPhone13,2"
com.apple.news,325,1741103559,1741103884,1741103884.915751,-21600,EB445137-D7F5-57EC-87DA-1DB460D64046,"iPhone13,2"
com.apple.news,288,1741103266,1741103554,1741103554.398488,-21600,EB445137-D7F5-57EC-87DA-1DB460D64046,"iPhone13,2"
com.apple.news,6,1741103260,1741103266,1741103266.301866,-21600,EB445137-D7F5-57EC-87DA-1DB460D64046,"iPhone13,2"
com.google.ios.youtube,7,1741103249,1741103256,1741103256.652189,-21600,EB445137-D7F5-57EC-87DA-1DB460D64046,"iPhone13,2"
com.apple.mobilecal,7,1741103242,1741103249,1741103250.023701,-21600,EB445137-D7F5-57EC-87DA-1DB460D64046,"iPhone13,2"
com.amazon.Amazon,35,1741103193,1741103228,1741103229.187779,-21600,EB445137-D7F5-57EC-87DA-1DB460D64046,"iPhone13,2"
com.google.ios.youtube,81,1741103158,1741103239,1741103239.153096,-21600,EB445137-D7F5-57EC-87DA-1DB460D64046,"iPhone13,2"
com.apple.Notes,311,1741103020,1741103331,1741103331.511142,-21600,,
com.apple.finder,144,1741102876,1741103020,1741103020.619741,-21600,,
com.google.Chrome,204,1741102672,1741102876,1741102876.741344,-21600,,
com.google.Chrome,312,1741102181,1741102493,1741102493.66986,-21600,,
com.google.Chrome,310,1741101866,1741102176,1741102176.3096929,-21600,,
com.google.Chrome,479,1741101104,1741101583,1741101583.59529,-21600,,
com.apple.finder,55,1741101049,1741101104,1741101104.476774,-21600,,
com.google.Chrome,49,1741101000,1741101049,1741101049.629358,-21600,,
com.google.Chrome,380,1741100599,1741100979,1741100979.7354689,-21600,,
com.apple.finder,12,1741100587,1741100599,1741100599.527413,-21600,,
com.apple.Notes,19,1741100568,1741100587,1741100587.376082,-21600,,
com.google.Chrome,2,1741100566,1741100568,1741100568.06479,-21600,,
com.leomehlig.today,5,1741100561,1741100566,1741100566.71699,-21600,,
com.google.Chrome,4,1741100557,1741100561,1741100561.552754,-21600,,
com.microsoft.Office.Outlook,74,1741100386,1741100460,1741100460.267123,-21600,EB445137-D7F5-57EC-87DA-1DB460D64046,"iPhone13,2"
com.google.ios.youtube,77,1741100308,1741100385,1741100385.696237,-21600,EB445137-D7F5-57EC-87DA-1DB460D64046,"iPhone13,2"
com.google.ios.youtube,212,1741100093,1741100305,1741100305.847749,-21600,EB445137-D7F5-57EC-87DA-1DB460D64046,"iPhone13,2"
com.thestorygraph.thestorygraph,64,1741100029,1741100093,1741100093.270072,-21600,EB445137-D7F5-57EC-87DA-1DB460D64046,"iPhone13,2"
com.thestorygraph.thestorygraph,32,1741099959,1741099991,1741099991.916974,-21600,EB445137-D7F5-57EC-87DA-1DB460D64046,"iPhone13,2"
com.google.ios.youtube,435,1741099594,1741100029,1741100029.404319,-21600,EB445137-D7F5-57EC-87DA-1DB460D64046,"iPhone13,2"
com.apple.weather,7,1741099581,1741099588,1741099588.8806648,-21600,EB445137-D7F5-57EC-87DA-1DB460D64046,"iPhone13,2"
com.apple.weather,94,1741099278,1741099372,1741099373.342929,-21600,EB445137-D7F5-57EC-87DA-1DB460D64046,"iPhone13,2"
com.renpho.health,1,1741099277,1741099278,1741099279.018023,-21600,EB445137-D7F5-57EC-87DA-1DB460D64046,"iPhone13,2"
com.renpho.health,34,1741099195,1741099229,1741099230.213351,-21600,EB445137-D7F5-57EC-87DA-1DB460D64046,"iPhone13,2"
com.apple.news,154,1741098459,1741098613,1741098613.781764,-21600,EB445137-D7F5-57EC-87DA-1DB460D64046,"iPhone13,2"
com.apple.news,2,1741098456,1741098458,1741098458.5641332,-21600,EB445137-D7F5-57EC-87DA-1DB460D64046,"iPhone13,2"
com.apple.news,28,1741098370,1741098398,1741098398.32295,-21600,EB445137-D7F5-57EC-87DA-1DB460D64046,"iPhone13,2"
com.apple.CoreAuthUI,5,1741066379,1741066384,1741066384.781701,-21600,EB445137-D7F5-57EC-87DA-1DB460D64046,"iPhone13,2"
com.apple.journal,1040,1741066378,1741067418,1741067418.413841,-21600,EB445137-D7F5-57EC-87DA-1DB460D64046,"iPhone13,2"
com.apple.Health,0,1741066378,1741066378,1741066378.7557921,-21600,EB445137-D7F5-57EC-87DA-1DB460D64046,"iPhone13,2"
com.apple.Health,69,1741066163,1741066232,1741066232.865419,-21600,EB445137-D7F5-57EC-87DA-1DB460D64046,"iPhone13,2"
com.instructure.icanvas,12,1741066145,1741066157,1741066157.1355581,-21600,EB445137-D7F5-57EC-87DA-1DB460D64046,"iPhone13,2"
com.instructure.icanvas,31,1741066108,1741066139,1741066139.976756,-21600,EB445137-D7F5-57EC-87DA-1DB460D64046,"iPhone13,2"
com.thestorygraph.thestorygraph,18,1741066086,1741066104,1741066104.79808,-21600,EB445137-D7F5-57EC-87DA-1DB460D64046,"iPhone13,2"
com.microsoft.Office.Outlook,2,1741066084,1741066086,1741066086.135857,-21600,EB445137-D7F5-57EC-87DA-1DB460D64046,"iPhone13,2"
com.microsoft.Office.Outlook,9,1741061825,1741061834,1741061834.1912289,-21600,EB445137-D7F5-57EC-87DA-1DB460D64046,"iPhone13,2"
com.myfitnesspal.mfp,50,1741061774,1741061824,1741061824.476454,-21600,EB445137-D7F5-57EC-87DA-1DB460D64046,"iPhone13,2"
com.apple.Music,2,1741061772,1741061774,1741061774.451725,-21600,EB445137-D7F5-57EC-87DA-1DB460D64046,"iPhone13,2"
com.google.Chrome,468,1741061274,1741061742,1741061742.886472,-21600,,
com.apple.Music,15,1741059211,1741059226,1741059226.590557,-21600,EB445137-D7F5-57EC-87DA-1DB460D64046,"iPhone13,2"
com.intsig.CamScannerLite,3,1741059200,1741059203,1741059203.841601,-21600,EB445137-D7F5-57EC-87DA-1DB460D64046,"iPhone13,2"
com.google.Chrome,31,1741058939,1741058970,1741058970.734377,-21600,,
com.leomehlig.today,55,1741058884,1741058939,1741058939.3174129,-21600,,
com.google.Chrome,2,1741058882,1741058884,1741058884.7517881,-21600,,
com.apple.iCal,6,1741058876,1741058882,1741058882.127928,-21600,,
com.google.Chrome,3,1741058873,1741058876,1741058876.8854032,-21600,,
com.apple.Notes,3,1741058870,1741058873,1741058873.7622051,-21600,,
com.google.Chrome,868,1741058002,1741058870,1741058871.082272,-21600,,
com.apple.Preview,508,1741057494,1741058002,1741058002.5630078,-21600,,
com.apple.finder,42,1741057452,1741057494,1741057494.934751,-21600,,
com.google.Chrome,229,1741057223,1741057452,1741057452.382213,-21600,,
com.apple.finder,33,1741057190,1741057223,1741057223.4063969,-21600,,
com.google.Chrome,186,1741057004,1741057190,1741057190.464314,-21600,,
com.apple.Notes,289,1741056715,1741057004,1741057004.52104,-21600,,
com.google.Chrome,545,1741056170,1741056715,1741056715.52805,-21600,,
com.leomehlig.today,7,1741056163,1741056170,1741056170.22982,-21600,,
com.google.Chrome,29,1741056134,1741056163,1741056163.0606089,-21600,,
com.leomehlig.today,144,1741055990,1741056134,1741056134.299092,-21600,,
com.google.Chrome,828,1741055162,1741055990,1741055990.687852,-21600,,
com.apple.finder,1,1741055161,1741055162,1741055162.91832,-21600,,
com.apple.MobileSMS,2,1741055159,1741055161,1741055161.98226,-21600,,
com.apple.finder,30,1741055129,1741055159,1741055159.140712,-21600,,
com.google.Chrome,932,1741054197,1741055129,1741055129.431984,-21600,,
com.apple.Preview,10,1741054187,1741054197,1741054198.0311952,-21600,,
com.apple.finder,8,1741054179,1741054187,1741054187.714565,-21600,,
com.google.Chrome,618,1741053561,1741054179,1741054179.890291,-21600,,
com.leomehlig.today,62,1741053499,1741053561,1741053561.626679,-21600,,
com.google.Chrome,87,1741053412,1741053499,1741053499.386365,-21600,,
com.google.Chrome,1267,1741052072,1741053339,1741053339.798583,-21600,,
com.leomehlig.today,2,1741052070,1741052072,1741052072.387238,-21600,,
com.google.Chrome,135,1741051935,1741052070,1741052070.060409,-21600,,
com.leomehlig.today,160,1741051775,1741051935,1741051935.367183,-21600,,
com.google.Chrome,1,1741051774,1741051775,1741051775.378686,-21600,,
com.apple.Preview,63,1741051711,1741051774,1741051774.099973,-21600,,
com.google.Chrome,30,1741051681,1741051711,1741051711.9296389,-21600,,
com.apple.Preview,39,1741051642,1741051681,1741051681.8616462,-21600,,
com.google.Chrome,20,1741051622,1741051642,1741051642.9223871,-21600,,
com.apple.Preview,453,1741051169,1741051622,1741051622.1126719,-21600,,
com.google.Chrome,31,1741051138,1741051169,1741051169.341011,-21600,,
com.apple.Preview,5,1741051133,1741051138,1741051138.47218,-21600,,
com.google.Chrome,13,1741051120,1741051133,1741051133.6663198,-21600,,
com.apple.Preview,5,1741051115,1741051120,1741051120.612265,-21600,,
com.google.Chrome,12,1741051103,1741051115,1741051115.6120338,-21600,,
com.apple.Preview,5,1741051098,1741051103,1741051103.189821,-21600,,
com.google.Chrome,7,1741051091,1741051098,1741051098.478949,-21600,,
com.apple.Preview,4,1741051087,1741051091,1741051091.923703,-21600,,
com.google.Chrome,4,1741051083,1741051087,1741051087.84861,-21600,,
com.apple.Preview,4,1741051079,1741051083,1741051083.526105,-21600,,
com.google.Chrome,7,1741051072,1741051079,1741051079.454771,-21600,,
com.apple.Preview,5,1741051067,1741051072,1741051072.6142411,-21600,,
com.google.Chrome,13,1741051054,1741051067,1741051067.321529,-21600,,
com.apple.Preview,10,1741051044,1741051054,1741051054.092938,-21600,,
com.google.Chrome,18,1741051026,1741051044,1741051044.9826179,-21600,,
com.apple.Preview,15,1741051011,1741051026,1741051026.19297,-21600,,
com.google.Chrome,10,1741051001,1741051011,1741051011.0572271,-21600,,
com.apple.Preview,5,1741050996,1741051001,1741051001.131758,-21600,,
com.google.Chrome,8,1741050988,1741050996,1741050996.758,-21600,,
com.apple.Preview,5,1741050983,1741050988,1741050988.419478,-21600,,
com.google.Chrome,10,1741050973,1741050983,1741050983.9930239,-21600,,
com.apple.Preview,6,1741050967,1741050973,1741050973.832932,-21600,,
com.google.Chrome,27,1741050940,1741050967,1741050967.408674,-21600,,
com.apple.Preview,6,1741050934,1741050940,1741050941.028528,-21600,,
com.google.Chrome,6,1741050928,1741050934,1741050934.911415,-21600,,
com.apple.Preview,4,1741050924,1741050928,1741050928.826756,-21600,,
com.google.Chrome,11,1741050913,1741050924,1741050924.4418979,-21600,,
com.apple.Preview,6,1741050907,1741050913,1741050913.539676,-21600,,
com.google.Chrome,39,1741050868,1741050907,1741050907.263264,-21600,,
com.apple.Preview,5,1741050863,1741050868,1741050868.4689121,-21600,,
com.google.Chrome,11,1741050852,1741050863,1741050863.982473,-21600,,
com.apple.Preview,4,1741050848,1741050852,1741050853.015829,-21600,,
com.google.Chrome,6,1741050842,1741050848,1741050848.82553,-21600,,
com.apple.Preview,6,1741050836,1741050842,1741050842.635452,-21600,,
com.google.Chrome,42,1741050794,1741050836,1741050836.333138,-21600,,
com.apple.Preview,4,1741050790,1741050794,1741050794.366296,-21600,,
com.google.Chrome,10,1741050780,1741050790,1741050790.265428,-21600,,
com.apple.Preview,5,1741050775,1741050780,1741050780.115124,-21600,,
com.google.Chrome,16,1741050759,1741050775,1741050775.138958,-21600,,
com.apple.Preview,4,1741050755,1741050759,1741050759.889209,-21600,,
com.google.Chrome,12,1741050743,1741050755,1741050755.598761,-21600,,
com.apple.Preview,9,1741050734,1741050743,1741050743.143167,-21600,,
com.google.Chrome,72,1741050662,1741050734,1741050734.081334,-21600,,
com.apple.Preview,1,1741050661,1741050662,1741050662.754106,-21600,,
com.google.Chrome,14,1741050647,1741050661,1741050661.526019,-21600,,
com.apple.Preview,416,1741050231,1741050647,1741050647.5574532,-21600,,
com.apple.finder,15,1741050216,1741050231,1741050231.7614331,-21600,,
com.intsig.CamScannerLite,68,1741050204,1741050272,1741050272.934864,-21600,EB445137-D7F5-57EC-87DA-1DB460D64046,"iPhone13,2"
com.apple.mobileslideshow,20,1741050183,1741050203,1741050203.102409,-21600,EB445137-D7F5-57EC-87DA-1DB460D64046,"iPhone13,2"
com.instructure.icanvas,2,1741050176,1741050178,1741050178.974997,-21600,EB445137-D7F5-57EC-87DA-1DB460D64046,"iPhone13,2"
com.apple.Preview,48,1741050168,1741050216,1741050216.5300741,-21600,,
com.apple.finder,5,1741050163,1741050168,1741050168.4525042,-21600,,
com.google.Chrome,14,1741050149,1741050163,1741050163.6422548,-21600,,
com.instructure.icanvas,75,1741049662,1741049737,1741049737.805191,-21600,EB445137-D7F5-57EC-87DA-1DB460D64046,"iPhone13,2"
com.instructure.icanvas,36,1741049452,1741049488,1741049488.044198,-21600,EB445137-D7F5-57EC-87DA-1DB460D64046,"iPhone13,2"
com.intsig.CamScannerLite,2,1741049450,1741049452,1741049452.63527,-21600,EB445137-D7F5-57EC-87DA-1DB460D64046,"iPhone13,2"
com.intsig.CamScannerLite,18,1741049429,1741049447,1741049447.138941,-21600,EB445137-D7F5-57EC-87DA-1DB460D64046,"iPhone13,2"
com.intsig.CamScannerLite,2,1741049423,1741049425,1741049425.457172,-21600,EB445137-D7F5-57EC-87DA-1DB460D64046,"iPhone13,2"
com.intsig.CamScannerLite,97,1741049294,1741049391,1741049391.5466518,-21600,EB445137-D7F5-57EC-87DA-1DB460D64046,"iPhone13,2"
com.microsoft.Office.Outlook,1,1741049290,1741049291,1741049291.892545,-21600,EB445137-D7F5-57EC-87DA-1DB460D64046,"iPhone13,2"
com.microsoft.Office.Outlook,42,1741048595,1741048637,1741048637.630468,-21600,EB445137-D7F5-57EC-87DA-1DB460D64046,"iPhone13,2"
com.instructure.icanvas,49,1741048540,1741048589,1741048589.844897,-21600,EB445137-D7F5-57EC-87DA-1DB460D64046,"iPhone13,2"
com.myfitnesspal.mfp,0,1741048540,1741048540,1741048540.7664351,-21600,EB445137-D7F5-57EC-87DA-1DB460D64046,"iPhone13,2"
com.myfitnesspal.mfp,29,1741047661,1741047690,1741047690.312043,-21600,EB445137-D7F5-57EC-87DA-1DB460D64046,"iPhone13,2"
com.google.Chrome,345,1741047436,1741047781,1741047782.04322,-21600,,
com.myfitnesspal.mfp,68,1741047415,1741047483,1741047483.566217,-21600,EB445137-D7F5-57EC-87DA-1DB460D64046,"iPhone13,2"
com.myfitnesspal.mfp,398,1741046995,1741047393,1741047393.5213041,-21600,EB445137-D7F5-57EC-87DA-1DB460D64046,"iPhone13,2"
com.google.Chrome,377,1741046949,1741047326,1741047326.798795,-21600,,
com.leomehlig.today,9,1741046940,1741046949,1741046949.259495,-21600,,
com.leomehlig.today,39,1741045323,1741045362,1741045362.955663,-21600,,
com.google.Chrome,553,1741044770,1741045323,1741045323.444428,-21600,,
com.apple.news,101,1741044416,1741044517,1741044518.278421,-21600,EB445137-D7F5-57EC-87DA-1DB460D64046,"iPhone13,2"
com.tinyspeck.chatlyio,51,1741044357,1741044408,1741044408.782953,-21600,EB445137-D7F5-57EC-87DA-1DB460D64046,"iPhone13,2"
com.apple.weather,47,1741044306,1741044353,1741044353.4342542,-21600,EB445137-D7F5-57EC-87DA-1DB460D64046,"iPhone13,2"
com.google.Chrome,2018,1741042551,1741044569,1741044569.201421,-21600,,
com.leomehlig.today,79,1741042472,1741042551,1741042551.138743,-21600,,
com.apple.Preview,126,1741042346,1741042472,1741042472.778588,-21600,,
com.apple.Notes,1,1741042345,1741042346,1741042346.793896,-21600,,
com.apple.Preview,5,1741042340,1741042345,1741042345.553664,-21600,,
com.apple.Notes,6,1741042334,1741042340,1741042341.035708,-21600,,
com.apple.Preview,55,1741042279,1741042334,1741042334.249603,-21600,,
com.google.Chrome,1,1741042278,1741042279,1741042279.3878021,-21600,,
com.apple.Preview,20,1741042258,1741042278,1741042278.2817168,-21600,,
com.google.Chrome,2,1741042256,1741042258,1741042258.73925,-21600,,
com.apple.Preview,22,1741042234,1741042256,1741042256.5991569,-21600,,
com.google.Chrome,6,1741042228,1741042234,1741042234.2051868,-21600,,
com.apple.Preview,3,1741042225,1741042228,1741042228.9897962,-21600,,
com.google.Chrome,18,1741042207,1741042225,1741042225.292282,-21600,,
com.apple.Preview,9,1741042198,1741042207,1741042208.0354152,-21600,,
com.google.Chrome,0,1741042198,1741042198,1741042198.98311,-21600,,
com.apple.Preview,0,1741042198,1741042198,1741042198.7739,-21600,,
com.google.Chrome,1,1741042197,1741042198,1741042198.408815,-21600,,
com.apple.Preview,113,1741042084,1741042197,1741042197.3158622,-21600,,
com.google.Chrome,23,1741042061,1741042084,1741042084.3041348,-21600,,
com.leomehlig.today,0,1741042061,1741042061,1741042061.543705,-21600,,
com.google.Chrome,90,1741041971,1741042061,1741042061.2632031,-21600,,
com.leomehlig.today,52,1741041919,1741041971,1741041971.6118321,-21600,,
com.google.Chrome,70,1741041849,1741041919,1741041919.1847858,-21600,,
com.apple.Preview,8,1741041841,1741041849,1741041849.868562,-21600,,
com.google.Chrome,52,1741041789,1741041841,1741041841.6928458,-21600,,
com.apple.Preview,5,1741041784,1741041789,1741041789.269178,-21600,,
com.google.Chrome,11,1741041773,1741041784,1741041784.124197,-21600,,
com.apple.Preview,65,1741041708,1741041773,1741041773.350031,-21600,,
com.google.Chrome,56,1741041652,1741041708,1741041708.558496,-21600,,
com.apple.Preview,3,1741041649,1741041652,1741041652.3739219,-21600,,
com.google.Chrome,7,1741041642,1741041649,1741041649.956417,-21600,,
com.apple.Preview,322,1741041320,1741041642,1741041642.67998,-21600,,
com.apple.finder,3,1741041317,1741041320,1741041320.12667,-21600,,
com.apple.Preview,157,1741041160,1741041317,1741041317.711818,-21600,,
co.hinge.mobile.ios,319,1741040831,1741041150,1741041150.8317719,-21600,EB445137-D7F5-57EC-87DA-1DB460D64046,"iPhone13,2"
com.apple.ContactsUI.LimitedAccessPromptView,13,1741040815,1741040828,1741040828.50591,-21600,EB445137-D7F5-57EC-87DA-1DB460D64046,"iPhone13,2"
com.apple.Preview,377,1741040783,1741041160,1741041160.384211,-21600,,
com.apple.finder,13,1741040770,1741040783,1741040783.052033,-21600,,
com.google.Chrome,23,1741040747,1741040770,1741040770.322685,-21600,,
com.apple.finder,7,1741040740,1741040747,1741040747.4875941,-21600,,
com.google.Chrome,15,1741040725,1741040740,1741040741.027081,-21600,,
com.apple.MobileSMS,1,1741040724,1741040725,1741040726.0953069,-21600,,
co.hinge.mobile.ios,140,1741040688,1741040828,1741040828.479764,-21600,EB445137-D7F5-57EC-87DA-1DB460D64046,"iPhone13,2"
co.hinge.mobile.ios,164,1741040262,1741040426,1741040427.246636,-21600,EB445137-D7F5-57EC-87DA-1DB460D64046,"iPhone13,2"
com.thestorygraph.thestorygraph,16,1741040246,1741040262,1741040262.966278,-21600,EB445137-D7F5-57EC-87DA-1DB460D64046,"iPhone13,2"
co.hinge.mobile.ios,23,1741040223,1741040246,1741040246.532848,-21600,EB445137-D7F5-57EC-87DA-1DB460D64046,"iPhone13,2"
com.thestorygraph.thestorygraph,35,1741040188,1741040223,1741040223.374346,-21600,EB445137-D7F5-57EC-87DA-1DB460D64046,"iPhone13,2"
co.hinge.mobile.ios,522,1741039660,1741040182,1741040182.499486,-21600,EB445137-D7F5-57EC-87DA-1DB460D64046,"iPhone13,2"
com.apple.mobileslideshow,33,1741039627,1741039660,1741039660.862809,-21600,EB445137-D7F5-57EC-87DA-1DB460D64046,"iPhone13,2"
co.hinge.mobile.ios,3,1741039624,1741039627,1741039627.9368382,-21600,EB445137-D7F5-57EC-87DA-1DB460D64046,"iPhone13,2"
com.apple.mobileslideshow,5,1741039619,1741039624,1741039624.820796,-21600,EB445137-D7F5-57EC-87DA-1DB460D64046,"iPhone13,2"
co.hinge.mobile.ios,62,1741039557,1741039619,1741039620.001227,-21600,EB445137-D7F5-57EC-87DA-1DB460D64046,"iPhone13,2"
com.apple.mobileslideshow,135,1741039421,1741039556,1741039556.500474,-21600,EB445137-D7F5-57EC-87DA-1DB460D64046,"iPhone13,2"
com.facebook.Facebook,249,1741039170,1741039419,1741039420.067791,-21600,EB445137-D7F5-57EC-87DA-1DB460D64046,"iPhone13,2"
com.apple.mobileslideshow,6,1741039157,1741039163,1741039163.778971,-21600,EB445137-D7F5-57EC-87DA-1DB460D64046,"iPhone13,2"
com.tinyspeck.chatlyio,62,1741039071,1741039133,1741039133.839169,-21600,EB445137-D7F5-57EC-87DA-1DB460D64046,"iPhone13,2"
com.apple.news,6,1741039063,1741039069,1741039069.919197,-21600,EB445137-D7F5-57EC-87DA-1DB460D64046,"iPhone13,2"
com.apple.MobileSMS,7,1741039024,1741039031,1741039031.534692,-21600,,
com.apple.news,16,1741038849,1741038865,1741038865.4939709,-21600,EB445137-D7F5-57EC-87DA-1DB460D64046,"iPhone13,2"
com.apple.MobileSMS,726,1741038264,1741038990,1741038990.451144,-21600,,
com.google.Chrome,17,1741038247,1741038264,1741038264.6235619,-21600,,
com.apple.MobileSMS,13,1741038234,1741038247,1741038247.055849,-21600,,
com.google.Chrome,199,1741038035,1741038234,1741038234.901435,-21600,,
com.apple.Notes,41,1741037994,1741038035,1741038035.932998,-21600,,
com.apple.iCal,304,1741037690,1741037994,1741037994.5162868,-21600,,
com.apple.Notes,88,1741037602,1741037690,1741037690.4616299,-21600,,
com.apple.MobileSMS,173,1741037429,1741037602,1741037602.342046,-21600,,
com.microsoft.Office.Outlook,4,1741037360,1741037364,1741037364.736018,-21600,EB445137-D7F5-57EC-87DA-1DB460D64046,"iPhone13,2"
com.apple.findmy,2,1741037062,1741037064,1741037064.961965,-21600,EB445137-D7F5-57EC-87DA-1DB460D64046,"iPhone13,2"
com.apple.findmy,17,1741037028,1741037045,1741037046.171453,-21600,EB445137-D7F5-57EC-87DA-1DB460D64046,"iPhone13,2"
com.apple.MobileSMS,300,1741037020,1741037320,1741037320.4655972,-21600,,
com.apple.FaceTime,5,1741037015,1741037020,1741037020.470241,-21600,,
com.apple.MobileSMS,6,1741037009,1741037015,1741037015.839129,-21600,,
com.apple.findmy,137,1741036872,1741037009,1741037009.590221,-21600,,
com.google.Chrome,5,1741036867,1741036872,1741036872.84629,-21600,,
com.apple.findmy,9,1741035380,1741035389,1741035390.034955,-21600,EB445137-D7F5-57EC-87DA-1DB460D64046,"iPhone13,2"
com.toyopagroup.picaboo,19,1741035092,1741035111,1741035111.8148289,-21600,EB445137-D7F5-57EC-87DA-1DB460D64046,"iPhone13,2"
com.apple.mobilecal,1,1741035091,1741035092,1741035092.3011389,-21600,EB445137-D7F5-57EC-87DA-1DB460D64046,"iPhone13,2"
com.apple.mobilecal,15,1741034961,1741034976,1741034978.0071049,-21600,EB445137-D7F5-57EC-87DA-1DB460D64046,"iPhone13,2"
com.google.Chrome,5,1741031788,1741031793,1741031793.794064,-21600,,
com.apple.Preview,4,1741031784,1741031788,1741031788.411569,-21600,,
com.google.Chrome,2,1741031782,1741031784,1741031784.3814611,-21600,,
com.apple.Preview,3,1741031779,1741031782,1741031782.941702,-21600,,
com.apple.finder,6,1741031773,1741031779,1741031779.394559,-21600,,
com.google.Chrome,30,1741031743,1741031773,1741031773.192095,-21600,,
com.apple.finder,12,1741031731,1741031743,1741031743.1149259,-21600,,
com.google.Chrome,28,1741031703,1741031731,1741031731.15873,-21600,,
com.apple.finder,40,1741031663,1741031703,1741031703.415834,-21600,,
com.hammerandchisel.discord,58,1741029895,1741029953,1741029953.213089,-21600,EB445137-D7F5-57EC-87DA-1DB460D64046,"iPhone13,2"
com.toyopagroup.picaboo,59,1741029757,1741029816,1741029816.295632,-21600,EB445137-D7F5-57EC-87DA-1DB460D64046,"iPhone13,2"
com.toyopagroup.picaboo,6,1741029519,1741029525,1741029525.173187,-21600,EB445137-D7F5-57EC-87DA-1DB460D64046,"iPhone13,2"
com.microsoft.Office.Outlook,13,1741029506,1741029519,1741029519.6359649,-21600,EB445137-D7F5-57EC-87DA-1DB460D64046,"iPhone13,2"
com.toyopagroup.picaboo,144,1741029354,1741029498,1741029498.9732351,-21600,EB445137-D7F5-57EC-87DA-1DB460D64046,"iPhone13,2"
com.apple.finder,26,1741028509,1741028535,1741028535.348782,-21600,,
com.apple.Preview,45,1741028464,1741028509,1741028509.26904,-21600,,
com.apple.finder,6,1741028458,1741028464,1741028464.193429,-21600,,
com.apple.Preview,7,1741028451,1741028458,1741028458.760948,-21600,,
com.apple.finder,3,1741028448,1741028451,1741028451.2353358,-21600,,
com.google.Chrome,651,1741027797,1741028448,1741028448.3331618,-21600,,
com.apple.Preview,8,1741027789,1741027797,1741027797.0802488,-21600,,
com.google.Chrome,72,1741027717,1741027789,1741027789.565052,-21600,,
com.apple.Preview,4,1741027713,1741027717,1741027717.335192,-21600,,
com.google.Chrome,22,1741027691,1741027713,1741027713.382402,-21600,,
com.apple.Preview,31,1741027660,1741027691,1741027691.8314471,-21600,,
com.apple.finder,12,1741027648,1741027660,1741027660.8111,-21600,,
com.google.Chrome,12,1741027636,1741027648,1741027648.222381,-21600,,
com.myfitnesspal.mfp,129,1741027485,1741027614,1741027614.541463,-21600,EB445137-D7F5-57EC-87DA-1DB460D64046,"iPhone13,2"
com.instructure.icanvas,1,1741027483,1741027484,1741027485.089689,-21600,EB445137-D7F5-57EC-87DA-1DB460D64046,"iPhone13,2"
com.google.Chrome,689,1741025974,1741026663,1741026663.498555,-21600,,
com.apple.finder,53,1741025921,1741025974,1741025974.829883,-21600,,
com.google.Chrome,41,1741025880,1741025921,1741025922.027349,-21600,,
com.apple.finder,0,1741025861,1741025861,1741025862.724636,-21600,,
com.google.Chrome,7,1741025854,1741025861,1741025862.5314898,-21600,,
com.instructure.icanvas,11,1741025836,1741025847,1741025847.6457372,-21600,EB445137-D7F5-57EC-87DA-1DB460D64046,"iPhone13,2"
com.apple.mobilenotes,0,1741025836,1741025836,1741025837.1688972,-21600,EB445137-D7F5-57EC-87DA-1DB460D64046,"iPhone13,2"
com.apple.mobilenotes,50,1741023804,1741023854,1741023855.334661,-21600,EB445137-D7F5-57EC-87DA-1DB460D64046,"iPhone13,2"
com.apple.news,2,1741023799,1741023801,1741023801.253068,-21600,EB445137-D7F5-57EC-87DA-1DB460D64046,"iPhone13,2"
com.apple.news,264,1741020977,1741021241,1741021242.325351,-21600,EB445137-D7F5-57EC-87DA-1DB460D64046,"iPhone13,2"
com.apple.CoreAuthUI,2,1741020900,1741020902,1741020902.850463,-21600,EB445137-D7F5-57EC-87DA-1DB460D64046,"iPhone13,2"
com.microsoft.onenote,51,1741020897,1741020948,1741020948.730581,-21600,EB445137-D7F5-57EC-87DA-1DB460D64046,"iPhone13,2"
com.google.Chrome,2,1741020520,1741020522,1741020522.435674,-21600,,
com.apple.finder,3,1741020517,1741020520,1741020520.28331,-21600,,
com.leomehlig.today,92,1741020425,1741020517,1741020517.241087,-21600,,
com.apple.finder,19,1741020406,1741020425,1741020425.263442,-21600,,
com.google.Chrome,40,1741020366,1741020406,1741020406.165133,-21600,,
com.apple.finder,91,1741020275,1741020366,1741020366.114769,-21600,,
com.leomehlig.today,10,1741020265,1741020275,1741020275.484923,-21600,,
com.myfitnesspal.mfp,98,1741018597,1741018695,1741018695.625556,-21600,EB445137-D7F5-57EC-87DA-1DB460D64046,"iPhone13,2"
com.apple.Health,2,1741018592,1741018594,1741018594.7875772,-21600,EB445137-D7F5-57EC-87DA-1DB460D64046,"iPhone13,2"
com.apple.Health,32,1741018229,1741018261,1741018261.843652,-21600,EB445137-D7F5-57EC-87DA-1DB460D64046,"iPhone13,2"
com.myfitnesspal.mfp,76,1741018153,1741018229,1741018229.5344238,-21600,EB445137-D7F5-57EC-87DA-1DB460D64046,"iPhone13,2"
com.apple.Health,27,1741018122,1741018149,1741018149.1507812,-21600,EB445137-D7F5-57EC-87DA-1DB460D64046,"iPhone13,2"
com.apple.Health,1,1741018121,1741018122,1741018122.490536,-21600,EB445137-D7F5-57EC-87DA-1DB460D64046,"iPhone13,2"
com.leomehlig.today,383,1741018034,1741018417,1741018417.517925,-21600,,
com.google.Chrome,3,1741018031,1741018034,1741018034.67128,-21600,,
com.apple.Health,103,1741018014,1741018117,1741018117.864667,-21600,EB445137-D7F5-57EC-87DA-1DB460D64046,"iPhone13,2"
com.apple.Health,106,1741017895,1741018001,1741018001.269577,-21600,EB445137-D7F5-57EC-87DA-1DB460D64046,"iPhone13,2"
com.microsoft.Office.Outlook,0,1741017895,1741017895,1741017896.2142081,-21600,EB445137-D7F5-57EC-87DA-1DB460D64046,"iPhone13,2"
com.google.Chrome,856,1741017046,1741017902,1741017902.3911781,-21600,,
com.leomehlig.today,21,1741017025,1741017046,1741017046.9016252,-21600,,
com.leomehlig.today,337,1741016363,1741016700,1741016700.963601,-21600,,
com.apple.iCal,170,1741016193,1741016363,1741016363.607418,-21600,,
com.leomehlig.today,4,1741016189,1741016193,1741016193.508861,-21600,,
com.google.Chrome,35,1741016154,1741016189,1741016189.8308291,-21600,,
com.apple.iCal,3,1741016151,1741016154,1741016154.2627,-21600,,
com.google.Chrome,108,1741016043,1741016151,1741016151.8116179,-21600,,
com.microsoft.Office.Outlook,17,1741016002,1741016019,1741016019.984863,-21600,EB445137-D7F5-57EC-87DA-1DB460D64046,"iPhone13,2"
com.apple.finder,2,1741015972,1741015974,1741015974.412996,-21600,,
com.leomehlig.today,1,1741015971,1741015972,1741015973.042173,-21600,,
com.apple.Notes,23,1741015948,1741015971,1741015971.944201,-21600,,
com.leomehlig.today,54,1741015894,1741015948,1741015949.0298991,-21600,,
com.apple.finder,12,1741015882,1741015894,1741015894.439272,-21600,,
com.apple.Preview,605,1741015277,1741015882,1741015882.406989,-21600,,
com.apple.finder,13,1741015264,1741015277,1741015277.393059,-21600,,
com.apple.Preview,284,1741014980,1741015264,1741015264.189635,-21600,,
com.apple.finder,0,1741014980,1741014980,1741014980.5589929,-21600,,
com.apple.Preview,560,1741014420,1741014980,1741014980.3017569,-21600,,
com.apple.finder,17,1741014403,1741014420,1741014420.498646,-21600,,
com.leomehlig.today,40,1741014363,1741014403,1741014403.893955,-21600,,
com.google.Chrome,3,1741014360,1741014363,1741014363.63557,-21600,,
com.apple.news,282,1741011940,1741012222,1741012222.947287,-21600,EB445137-D7F5-57EC-87DA-1DB460D64046,"iPhone13,2"
com.google.Chrome,177,1740980279,1740980456,1740980456.7497668,-21600,,
com.apple.finder,197,1740980082,1740980279,1740980279.359443,-21600,,
com.leomehlig.today,1,1740980081,1740980082,1740980082.300685,-21600,,
com.google.Chrome,49,1740980032,1740980081,1740980081.054945,-21600,,
com.google.Chrome,302,1740979636,1740979938,1740979938.2897692,-21600,,
com.google.Chrome,302,1740978000,1740978302,1740978302.712072,-21600,,
com.google.Chrome,300,1740976987,1740977287,1740977287.5490742,-21600,,
com.google.Chrome,1386,1740975360,1740976746,1740976746.0944052,-21600,,
com.leomehlig.today,3,1740975357,1740975360,1740975360.7651649,-21600,,
com.apple.news,505,1740974464,1740974969,1740974969.696011,-21600,EB445137-D7F5-57EC-87DA-1DB460D64046,"iPhone13,2"
com.instructure.icanvas,7,1740974406,1740974413,1740974414.005105,-21600,EB445137-D7F5-57EC-87DA-1DB460D64046,"iPhone13,2"
com.apple.news,46,1740974300,1740974346,1740974346.831348,-21600,EB445137-D7F5-57EC-87DA-1DB460D64046,"iPhone13,2"
com.apple.news,28,1740973482,1740973510,1740973511.3755631,-21600,EB445137-D7F5-57EC-87DA-1DB460D64046,"iPhone13,2"
com.apple.news,15,1740972400,1740972415,1740972416.1213531,-21600,EB445137-D7F5-57EC-87DA-1DB460D64046,"iPhone13,2"
com.apple.news,13,1740972025,1740972038,1740972039.019915,-21600,EB445137-D7F5-57EC-87DA-1DB460D64046,"iPhone13,2"
com.apple.news,47,1740971711,1740971758,1740971759.011527,-21600,EB445137-D7F5-57EC-87DA-1DB460D64046,"iPhone13,2"
com.apple.news,24,1740970550,1740970574,1740970574.6323628,-21600,EB445137-D7F5-57EC-87DA-1DB460D64046,"iPhone13,2"
com.apple.MobileSMS,8,1740970482,1740970490,1740970490.483031,-21600,EB445137-D7F5-57EC-87DA-1DB460D64046,"iPhone13,2"
com.apple.news,1,1740970481,1740970482,1740970482.856952,-21600,EB445137-D7F5-57EC-87DA-1DB460D64046,"iPhone13,2"
com.apple.news,77,1740970350,1740970427,1740970427.4890962,-21600,EB445137-D7F5-57EC-87DA-1DB460D64046,"iPhone13,2"
com.apple.MobileSMS,3,1740970345,1740970348,1740970348.2600532,-21600,EB445137-D7F5-57EC-87DA-1DB460D64046,"iPhone13,2"
com.apple.MobileSMS,5,1740970138,1740970143,1740970143.575577,-21600,EB445137-D7F5-57EC-87DA-1DB460D64046,"iPhone13,2"
com.apple.news,1,1740970136,1740970137,1740970137.888201,-21600,EB445137-D7F5-57EC-87DA-1DB460D64046,"iPhone13,2"
com.apple.news,42,1740970083,1740970125,1740970125.756105,-21600,EB445137-D7F5-57EC-87DA-1DB460D64046,"iPhone13,2"
com.apple.MobileSMS,2,1740970078,1740970080,1740970080.827911,-21600,EB445137-D7F5-57EC-87DA-1DB460D64046,"iPhone13,2"
com.apple.MobileSMS,19,1740969337,1740969356,1740969356.775375,-21600,EB445137-D7F5-57EC-87DA-1DB460D64046,"iPhone13,2"
com.google.chrome.ios,2,1740969335,1740969337,1740969337.657346,-21600,EB445137-D7F5-57EC-87DA-1DB460D64046,"iPhone13,2"
com.google.chrome.ios,39,1740969167,1740969206,1740969206.818685,-21600,EB445137-D7F5-57EC-87DA-1DB460D64046,"iPhone13,2"
com.google.chrome.ios,38,1740969098,1740969136,1740969136.6007109,-21600,EB445137-D7F5-57EC-87DA-1DB460D64046,"iPhone13,2"
com.google.chrome.ios,56,1740968761,1740968817,1740968817.4457521,-21600,EB445137-D7F5-57EC-87DA-1DB460D64046,"iPhone13,2"
com.apple.news,565,1740968005,1740968570,1740968570.9460359,-21600,EB445137-D7F5-57EC-87DA-1DB460D64046,"iPhone13,2"
com.google.chrome.ios,24,1740967981,1740968005,1740968005.946881,-21600,EB445137-D7F5-57EC-87DA-1DB460D64046,"iPhone13,2"
com.apple.news,74,1740967907,1740967981,1740967981.3874478,-21600,EB445137-D7F5-57EC-87DA-1DB460D64046,"iPhone13,2"
com.apple.news,300,1740967489,1740967789,1740967789.906279,-21600,EB445137-D7F5-57EC-87DA-1DB460D64046,"iPhone13,2"
com.google.chrome.ios,3,1740967482,1740967485,1740967485.2767138,-21600,EB445137-D7F5-57EC-87DA-1DB460D64046,"iPhone13,2"
com.google.chrome.ios,23,1740967170,1740967193,1740967193.8389149,-21600,EB445137-D7F5-57EC-87DA-1DB460D64046,"iPhone13,2"
com.google.chrome.ios,47,1740967111,1740967158,1740967158.7362351,-21600,EB445137-D7F5-57EC-87DA-1DB460D64046,"iPhone13,2"
com.google.chrome.ios,82,1740967004,1740967086,1740967087.116833,-21600,EB445137-D7F5-57EC-87DA-1DB460D64046,"iPhone13,2"
com.burbn.instagram,45,1740966798,1740966843,1740966843.879581,-21600,EB445137-D7F5-57EC-87DA-1DB460D64046,"iPhone13,2"
com.leomehlig.today,8,1740965941,1740965949,1740965949.919044,-21600,,
com.apple.finder,1,1740965940,1740965941,1740965941.710665,-21600,,
com.apple.shortcuts,0,1740965940,1740965940,1740965940.494313,-21600,,
com.apple.finder,3,1740965937,1740965940,1740965940.147804,-21600,,
com.microsoft.VSCode,231,1740965706,1740965937,1740965938.427695,-21600,,
com.apple.finder,33,1740965673,1740965706,1740965706.12602,-21600,,
com.apple.shortcuts,3,1740965670,1740965673,1740965673.786011,-21600,,
com.apple.finder,4,1740965630,1740965634,1740965635.0209951,-21600,,
com.leomehlig.today,1,1740965629,1740965630,1740965630.489603,-21600,,
com.apple.iCal,1,1740965628,1740965629,1740965629.2841759,-21600,,
com.leomehlig.today,1,1740965627,1740965628,1740965628.8617768,-21600,,
com.apple.Notes,1,1740965626,1740965627,1740965627.436204,-21600,,
com.leomehlig.today,90,1740965536,1740965626,1740965626.161951,-21600,,
com.apple.Notes,11,1740965525,1740965536,1740965536.676077,-21600,,
com.leomehlig.today,1,1740965524,1740965525,1740965525.979588,-21600,,
com.apple.Notes,13,1740965511,1740965524,1740965524.2090049,-21600,,
com.leomehlig.today,19,1740965492,1740965511,1740965511.453946,-21600,,
com.apple.Notes,37,1740965455,1740965492,1740965492.498427,-21600,,
com.leomehlig.today,4,1740965451,1740965455,1740965456.034737,-21600,,
com.apple.iCal,8,1740965443,1740965451,1740965451.689921,-21600,,
com.leomehlig.today,162,1740965281,1740965443,1740965443.952856,-21600,,
com.google.Chrome,2950,1740962331,1740965281,1740965281.231914,-21600,,
com.groupme.iphone-app,6,1740962071,1740962077,1740962077.492869,-21600,EB445137-D7F5-57EC-87DA-1DB460D64046,"iPhone13,2"
com.myfitnesspal.mfp,1,1740962070,1740962071,1740962071.687039,-21600,EB445137-D7F5-57EC-87DA-1DB460D64046,"iPhone13,2"
com.myfitnesspal.mfp,6,1740962055,1740962061,1740962061.380886,-21600,EB445137-D7F5-57EC-87DA-1DB460D64046,"iPhone13,2"
com.myfitnesspal.mfp,195,1740961832,1740962027,1740962027.2374492,-21600,EB445137-D7F5-57EC-87DA-1DB460D64046,"iPhone13,2"
com.intsig.CamScannerLite,2,1740961830,1740961832,1740961833.886286,-21600,EB445137-D7F5-57EC-87DA-1DB460D64046,"iPhone13,2"
com.google.Chrome,1703,1740958302,1740960005,1740960005.464246,-21600,,
com.apple.finder,1,1740958301,1740958302,1740958302.203733,-21600,,
com.leomehlig.today,3,1740958298,1740958301,1740958301.1267781,-21600,,
com.apple.finder,6,1740958292,1740958298,1740958298.2660441,-21600,,
com.apple.finder,1,1740958118,1740958119,1740958119.3168511,-21600,,
com.apple.calculator,2,1740958116,1740958118,1740958118.242091,-21600,,
com.leomehlig.today,28,1740958088,1740958116,1740958117.025518,-21600,,
com.google.Chrome,912,1740957176,1740958088,1740958088.929182,-21600,,
com.leomehlig.today,1,1740957175,1740957176,1740957176.379373,-21600,,
com.google.Chrome,1128,1740956047,1740957175,1740957175.2928848,-21600,,
com.apple.calculator,28,1740956019,1740956047,1740956047.092276,-21600,,
com.google.Chrome,3,1740956016,1740956019,1740956019.2166271,-21600,,
com.apple.calculator,18,1740955998,1740956016,1740956016.186249,-21600,,
com.google.Chrome,677,1740955321,1740955998,1740955998.095876,-21600,,
com.leomehlig.today,29,1740955292,1740955321,1740955321.091769,-21600,,
com.apple.Preview,2,1740955290,1740955292,1740955292.837698,-21600,,
com.apple.finder,13,1740955277,1740955290,1740955290.1596742,-21600,,
com.apple.Preview,25,1740955252,1740955277,1740955277.3966541,-21600,,
com.apple.finder,2,1740955250,1740955252,1740955252.2183661,-21600,,
com.apple.Preview,16,1740955234,1740955250,1740955250.9222488,-21600,,
com.apple.finder,4,1740955230,1740955234,1740955235.044983,-21600,,
com.google.Chrome,162,1740955068,1740955230,1740955230.145395,-21600,,
com.apple.Preview,41,1740955027,1740955068,1740955069.028757,-21600,,
com.apple.finder,3,1740955024,1740955027,1740955028.00248,-21600,,
com.leomehlig.today,0,1740955024,1740955024,1740955025.03054,-21600,,
com.intsig.CamScannerLite,153,1740954891,1740955044,1740955045.028753,-21600,EB445137-D7F5-57EC-87DA-1DB460D64046,"iPhone13,2"
com.apple.finder,248,1740954776,1740955024,1740955024.2059178,-21600,,
com.leomehlig.today,8,1740954768,1740954776,1740954776.991466,-21600,,
com.groupme.iphone-app,12,1740954633,1740954645,1740954645.236713,-21600,EB445137-D7F5-57EC-87DA-1DB460D64046,"iPhone13,2"
com.apple.Preferences,48,1740953647,1740953695,1740953695.654993,-21600,EB445137-D7F5-57EC-87DA-1DB460D64046,"iPhone13,2"
com.apple.Music,1,1740953646,1740953647,1740953647.557054,-21600,EB445137-D7F5-57EC-87DA-1DB460D64046,"iPhone13,2"
com.leomehlig.today,214,1740953493,1740953707,1740953707.0651798,-21600,,
com.apple.Preview,1,1740953492,1740953493,1740953493.593728,-21600,,
com.google.Chrome,322,1740953170,1740953492,1740953493.20366,-21600,,
com.leomehlig.today,45,1740953125,1740953170,1740953170.8042998,-21600,,
com.google.Chrome,135,1740952990,1740953125,1740953125.175712,-21600,,
com.apple.Preview,14,1740952976,1740952990,1740952990.2575521,-21600,,
com.google.Chrome,7,1740952969,1740952976,1740952976.8314838,-21600,,
com.apple.Preview,3,1740952966,1740952969,1740952969.341438,-21600,,
com.google.Chrome,5,1740952961,1740952966,1740952966.383785,-21600,,
com.apple.Preview,7,1740952954,1740952961,1740952961.368103,-21600,,
com.apple.finder,7,1740952947,1740952954,1740952954.641971,-21600,,
com.google.Chrome,1161,1740951786,1740952947,1740952947.5414882,-21600,,
com.apple.Music,22,1740951748,1740951770,1740951770.7157412,-21600,EB445137-D7F5-57EC-87DA-1DB460D64046,"iPhone13,2"
com.apple.mobileslideshow,15,1740951730,1740951745,1740951745.292043,-21600,EB445137-D7F5-57EC-87DA-1DB460D64046,"iPhone13,2"
com.leomehlig.today,102,1740951684,1740951786,1740951786.912016,-21600,,
com.google.Chrome,2,1740951682,1740951684,1740951684.252427,-21600,,
com.apple.mobileslideshow,38,1740951411,1740951449,1740951449.589447,-21600,EB445137-D7F5-57EC-87DA-1DB460D64046,"iPhone13,2"
Astrospheric.Astrospheric,17,1740951375,1740951392,1740951392.6418061,-21600,EB445137-D7F5-57EC-87DA-1DB460D64046,"iPhone13,2"
com.apple.Health,5,1740951328,1740951333,1740951333.1174998,-21600,EB445137-D7F5-57EC-87DA-1DB460D64046,"iPhone13,2"
com.google.Chrome,564,1740950983,1740951547,1740951547.0402431,-21600,,
com.apple.finder,17,1740950966,1740950983,1740950983.611792,-21600,,
com.google.Chrome,6,1740950960,1740950966,1740950966.435042,-21600,,
com.apple.finder,2,1740950958,1740950960,1740950960.612025,-21600,,
com.google.Chrome,1,1740950957,1740950958,1740950958.470285,-21600,,
com.apple.finder,1,1740950956,1740950957,1740950957.402735,-21600,,
com.google.Chrome,5,1740950951,1740950956,1740950956.841367,-21600,,
com.apple.finder,3,1740950948,1740950951,1740950951.738439,-21600,,
com.google.Chrome,3,1740950945,1740950948,1740950948.534141,-21600,,
com.apple.finder,2,1740950943,1740950945,1740950945.726249,-21600,,
com.google.Chrome,3,1740950940,1740950943,1740950944.018736,-21600,,
com.apple.finder,3,1740950937,1740950940,1740950940.696374,-21600,,
com.google.Chrome,2,1740950935,1740950937,1740950937.363277,-21600,,
com.apple.finder,4,1740950931,1740950935,1740950935.318028,-21600,,
com.google.Chrome,2,1740950929,1740950931,1740950931.6365662,-21600,,
com.apple.finder,21,1740950908,1740950929,1740950929.921793,-21600,,
com.leomehlig.today,2,1740950906,1740950908,1740950908.1693401,-21600,,
com.apple.finder,6,1740950900,1740950906,1740950906.650103,-21600,,
com.google.Chrome,804,1740950096,1740950900,1740950900.529588,-21600,,
com.google.Chrome,1499,1740948417,1740949916,1740949916.83705,-21600,,
com.leomehlig.today,18,1740948399,1740948417,1740948417.615798,-21600,,
com.google.Chrome,1119,1740947280,1740948399,1740948399.21169,-21600,,
com.apple.finder,16,1740947264,1740947280,1740947280.397221,-21600,,
com.google.Chrome,1758,1740945506,1740947264,1740947264.859435,-21600,,
com.google.Chrome,528,1740944805,1740945333,1740945333.252126,-21600,,
com.apple.Health,31,1740944530,1740944561,1740944561.089906,-21600,EB445137-D7F5-57EC-87DA-1DB460D64046,"iPhone13,2"
com.ally.MobileBanking,9,1740941494,1740941503,1740941503.4351501,-21600,EB445137-D7F5-57EC-87DA-1DB460D64046,"iPhone13,2"
com.apple.CoreAuthUI,1,1740941449,1740941450,1740941451.006717,-21600,EB445137-D7F5-57EC-87DA-1DB460D64046,"iPhone13,2"
com.ally.MobileBanking,52,1740941442,1740941494,1740941494.2697248,-21600,EB445137-D7F5-57EC-87DA-1DB460D64046,"iPhone13,2"
com.truebill.truebillnative,6,1740941425,1740941431,1740941431.303135,-21600,EB445137-D7F5-57EC-87DA-1DB460D64046,"iPhone13,2"
com.apple.CoreAuthUI,2,1740941385,1740941387,1740941387.776458,-21600,EB445137-D7F5-57EC-87DA-1DB460D64046,"iPhone13,2"
com.clairmail.fth.client,38,1740941382,1740941420,1740941421.040473,-21600,EB445137-D7F5-57EC-87DA-1DB460D64046,"iPhone13,2"
com.truebill.truebillnative,6,1740941313,1740941319,1740941319.4359698,-21600,EB445137-D7F5-57EC-87DA-1DB460D64046,"iPhone13,2"
com.apple.calculator,4,1740941309,1740941313,1740941313.378495,-21600,EB445137-D7F5-57EC-87DA-1DB460D64046,"iPhone13,2"
com.truebill.truebillnative,4,1740941305,1740941309,1740941309.918517,-21600,EB445137-D7F5-57EC-87DA-1DB460D64046,"iPhone13,2"
com.apple.calculator,7,1740941298,1740941305,1740941305.675198,-21600,EB445137-D7F5-57EC-87DA-1DB460D64046,"iPhone13,2"
com.truebill.truebillnative,3,1740941295,1740941298,1740941298.266419,-21600,EB445137-D7F5-57EC-87DA-1DB460D64046,"iPhone13,2"
com.apple.calculator,4,1740941291,1740941295,1740941295.766275,-21600,EB445137-D7F5-57EC-87DA-1DB460D64046,"iPhone13,2"
com.apple.CoreAuthUI,2,1740941162,1740941164,1740941164.839164,-21600,EB445137-D7F5-57EC-87DA-1DB460D64046,"iPhone13,2"
com.truebill.truebillnative,131,1740941160,1740941291,1740941292.028827,-21600,EB445137-D7F5-57EC-87DA-1DB460D64046,"iPhone13,2"
com.google.chrome.ios,48,1740940816,1740940864,1740940864.5159001,-21600,EB445137-D7F5-57EC-87DA-1DB460D64046,"iPhone13,2"
com.thestorygraph.thestorygraph,2,1740940814,1740940816,1740940816.7799559,-21600,EB445137-D7F5-57EC-87DA-1DB460D64046,"iPhone13,2"
com.google.chrome.ios,39,1740940775,1740940814,1740940815.002939,-21600,EB445137-D7F5-57EC-87DA-1DB460D64046,"iPhone13,2"
com.thestorygraph.thestorygraph,51,1740940724,1740940775,1740940775.649405,-21600,EB445137-D7F5-57EC-87DA-1DB460D64046,"iPhone13,2"
com.thestorygraph.thestorygraph,97,1740940591,1740940688,1740940689.20363,-21600,EB445137-D7F5-57EC-87DA-1DB460D64046,"iPhone13,2"
com.google.chrome.ios,61,1740940525,1740940586,1740940586.578298,-21600,EB445137-D7F5-57EC-87DA-1DB460D64046,"iPhone13,2"
com.microsoft.Office.Outlook,6,1740940437,1740940443,1740940443.922655,-21600,EB445137-D7F5-57EC-87DA-1DB460D64046,"iPhone13,2"
com.apple.news,107,1740940328,1740940435,1740940435.816671,-21600,EB445137-D7F5-57EC-87DA-1DB460D64046,"iPhone13,2"
com.google.chrome.ios,85,1740939563,1740939648,1740939649.086814,-21600,EB445137-D7F5-57EC-87DA-1DB460D64046,"iPhone13,2"
com.microsoft.Office.Outlook,5,1740939536,1740939541,1740939541.553669,-21600,EB445137-D7F5-57EC-87DA-1DB460D64046,"iPhone13,2"
com.microsoft.Office.Outlook,280,1740937755,1740938035,1740938036.631891,-21600,EB445137-D7F5-57EC-87DA-1DB460D64046,"iPhone13,2"
com.myfitnesspal.mfp,127,1740937627,1740937754,1740937754.3448548,-21600,EB445137-D7F5-57EC-87DA-1DB460D64046,"iPhone13,2"
com.apple.mobileslideshow,28,1740937599,1740937627,1740937627.947287,-21600,EB445137-D7F5-57EC-87DA-1DB460D64046,"iPhone13,2"
com.myfitnesspal.mfp,54,1740937544,1740937598,1740937598.909898,-21600,EB445137-D7F5-57EC-87DA-1DB460D64046,"iPhone13,2"
com.google.chrome.ios,23,1740937521,1740937544,1740937545.038095,-21600,EB445137-D7F5-57EC-87DA-1DB460D64046,"iPhone13,2"
com.myfitnesspal.mfp,32,1740937489,1740937521,1740937521.956203,-21600,EB445137-D7F5-57EC-87DA-1DB460D64046,"iPhone13,2"
com.google.chrome.ios,110,1740937379,1740937489,1740937490.291576,-21600,EB445137-D7F5-57EC-87DA-1DB460D64046,"iPhone13,2"
com.google.Chrome,352,1740936502,1740936854,1740936854.166199,-21600,,
com.google.Chrome,4,1740936274,1740936278,1740936278.4973922,-21600,,
com.leomehlig.today,64,1740936210,1740936274,1740936274.30388,-21600,,
com.google.Chrome,496,1740935714,1740936210,1740936210.905509,-21600,,
com.google.chrome.ios,43,1740935294,1740935337,1740935337.64825,-21600,EB445137-D7F5-57EC-87DA-1DB460D64046,"iPhone13,2"
com.google.Chrome,421,1740935176,1740935597,1740935597.953424,-21600,,
com.leomehlig.today,13,1740935163,1740935176,1740935176.736836,-21600,,
com.hammerandchisel.discord,3,1740935148,1740935151,1740935151.231117,-21600,EB445137-D7F5-57EC-87DA-1DB460D64046,"iPhone13,2"
com.google.Chrome,41,1740935122,1740935163,1740935163.742581,-21600,,
com.microsoft.Excel,34,1740935088,1740935122,1740935122.484508,-21600,,
com.google.Chrome,310,1740934778,1740935088,1740935088.958184,-21600,,
com.leomehlig.today,3,1740934635,1740934638,1740934638.2734509,-21600,,
com.google.Chrome,212,1740934423,1740934635,1740934635.2949948,-21600,,
com.google.Chrome,1120,1740933302,1740934422,1740934422.631971,-21600,,
com.leomehlig.today,12,1740933290,1740933302,1740933302.1805382,-21600,,
com.google.Chrome,392,1740932898,1740933290,1740933290.99339,-21600,,
com.microsoft.Excel,6,1740932892,1740932898,1740932898.191719,-21600,,
com.google.Chrome,722,1740932170,1740932892,1740932892.922848,-21600,,
com.microsoft.Excel,14,1740932156,1740932170,1740932170.367185,-21600,,
com.google.Chrome,11,1740932145,1740932156,1740932156.057219,-21600,,
com.microsoft.Excel,1,1740932144,1740932145,1740932145.4385839,-21600,,
com.google.Chrome,4,1740932140,1740932144,1740932144.028685,-21600,,
com.microsoft.Excel,9,1740932131,1740932140,1740932140.265706,-21600,,
com.google.Chrome,13,1740932118,1740932131,1740932131.78563,-21600,,
com.microsoft.Excel,2,1740932116,1740932118,1740932118.453487,-21600,,
com.google.Chrome,3,1740932113,1740932116,1740932117.010679,-21600,,
com.microsoft.Excel,5,1740932108,1740932113,1740932113.124301,-21600,,
com.google.Chrome,7,1740932101,1740932108,1740932108.821532,-21600,,
com.microsoft.Excel,7,1740932094,1740932101,1740932101.39018,-21600,,
com.hammerandchisel.discord,59,1740932026,1740932085,1740932085.620891,-21600,EB445137-D7F5-57EC-87DA-1DB460D64046,"iPhone13,2"
com.myfitnesspal.mfp,1,1740932025,1740932026,1740932026.787027,-21600,EB445137-D7F5-57EC-87DA-1DB460D64046,"iPhone13,2"
com.google.Chrome,106,1740931988,1740932094,1740932094.852769,-21600,,
com.microsoft.Excel,23,1740931965,1740931988,1740931988.1293359,-21600,,
com.google.Chrome,2,1740931963,1740931965,1740931965.3936582,-21600,,
com.microsoft.Excel,6,1740931957,1740931963,1740931963.3470368,-21600,,
com.google.Chrome,6,1740931951,1740931957,1740931957.511222,-21600,,
com.microsoft.Excel,7,1740931944,1740931951,1740931951.23569,-21600,,
com.google.Chrome,12,1740931932,1740931944,1740931944.186619,-21600,,
com.microsoft.Excel,29,1740931903,1740931932,1740931932.124679,-21600,,
com.google.Chrome,9,1740931894,1740931903,1740931903.4624782,-21600,,
com.leomehlig.today,1,1740931893,1740931894,1740931894.542814,-21600,,
com.microsoft.Excel,2,1740931891,1740931893,1740931893.219945,-21600,,
com.google.Chrome,13,1740931878,1740931891,1740931891.917104,-21600,,
com.microsoft.Excel,2,1740931876,1740931878,1740931878.154849,-21600,,
com.google.Chrome,1,1740931875,1740931876,1740931876.867436,-21600,,
com.microsoft.Excel,3,1740931872,1740931875,1740931875.5718951,-21600,,
com.google.Chrome,1,1740931871,1740931872,1740931872.183064,-21600,,
com.microsoft.Excel,5,1740931866,1740931871,1740931871.200639,-21600,,
com.google.Chrome,2,1740931864,1740931866,1740931866.0967278,-21600,,
com.microsoft.Excel,3,1740931861,1740931864,1740931865.0250878,-21600,,
com.google.Chrome,5,1740931856,1740931861,1740931861.133848,-21600,,
com.microsoft.Excel,6,1740931850,1740931856,1740931856.7216911,-21600,,
com.google.Chrome,4,1740931846,1740931850,1740931850.314363,-21600,,
com.microsoft.Excel,10,1740931836,1740931846,1740931846.499289,-21600,,
com.google.Chrome,1,1740931835,1740931836,1740931836.6536279,-21600,,
com.microsoft.Excel,1,1740931834,1740931835,1740931835.681807,-21600,,
com.google.Chrome,4,1740931830,1740931834,1740931834.642456,-21600,,
com.microsoft.Excel,9,1740931821,1740931830,1740931831.002376,-21600,,
com.google.Chrome,9,1740931812,1740931821,1740931821.8144221,-21600,,
com.microsoft.Excel,3,1740931809,1740931812,1740931812.081236,-21600,,
com.google.Chrome,1,1740931808,1740931809,1740931809.459835,-21600,,
com.microsoft.Excel,1,1740931807,1740931808,1740931808.820475,-21600,,
com.google.Chrome,8,1740931799,1740931807,1740931807.900447,-21600,,
com.microsoft.Excel,11,1740931788,1740931799,1740931799.646793,-21600,,
com.google.Chrome,3,1740931785,1740931788,1740931788.968944,-21600,,
com.microsoft.Excel,18,1740931767,1740931785,1740931785.78216,-21600,,
com.google.Chrome,27,1740931740,1740931767,1740931767.511098,-21600,,
com.microsoft.Excel,137,1740931603,1740931740,1740931740.846462,-21600,,
com.google.Chrome,50,1740931553,1740931603,1740931603.555584,-21600,,
com.leomehlig.today,58,1740931481,1740931539,1740931539.0560389,-21600,,
com.google.Chrome,8,1740931473,1740931481,1740931482.065703,-21600,,
com.myfitnesspal.mfp,181,1740929226,1740929407,1740929408.438723,-21600,EB445137-D7F5-57EC-87DA-1DB460D64046,"iPhone13,2"
com.meijer.mobile.Meijer,52,1740929174,1740929226,1740929227.2950048,-21600,EB445137-D7F5-57EC-87DA-1DB460D64046,"iPhone13,2"
com.myfitnesspal.mfp,127,1740929044,1740929171,1740929171.518008,-21600,EB445137-D7F5-57EC-87DA-1DB460D64046,"iPhone13,2"
com.apple.Health,2,1740929040,1740929042,1740929042.745826,-21600,EB445137-D7F5-57EC-87DA-1DB460D64046,"iPhone13,2"
com.apple.Health,33,1740928858,1740928891,1740928891.6758971,-21600,EB445137-D7F5-57EC-87DA-1DB460D64046,"iPhone13,2"
com.renpho.health,23,1740928826,1740928849,1740928849.109436,-21600,EB445137-D7F5-57EC-87DA-1DB460D64046,"iPhone13,2"
com.renpho.health,31,1740927999,1740928030,1740928030.992155,-21600,EB445137-D7F5-57EC-87DA-1DB460D64046,"iPhone13,2"
com.apple.news,643,1740926380,1740927023,1740927023.4278169,-21600,EB445137-D7F5-57EC-87DA-1DB460D64046,"iPhone13,2"
com.microsoft.Office.Outlook,5,1740926359,1740926364,1740926364.0567951,-21600,EB445137-D7F5-57EC-87DA-1DB460D64046,"iPhone13,2"
com.toyopagroup.picaboo,15,1740926338,1740926353,1740926354.392237,-21600,EB445137-D7F5-57EC-87DA-1DB460D64046,"iPhone13,2"
com.google.Chrome,1,1740895214,1740895215,1740895215.457475,-21600,,
com.google.Chrome,583,1740893873,1740894456,1740894456.529202,-21600,,
com.google.Chrome,1239,1740892592,1740893831,1740893831.646791,-21600,,
com.google.Chrome,479,1740892010,1740892489,1740892489.052168,-21600,,
com.apple.finder,8,1740892002,1740892010,1740892011.61923,-21600,,
com.apple.news,18,1740891799,1740891817,1740891817.925287,-21600,EB445137-D7F5-57EC-87DA-1DB460D64046,"iPhone13,2"
com.apple.news,25,1740885415,1740885440,1740885441.1142669,-21600,EB445137-D7F5-57EC-87DA-1DB460D64046,"iPhone13,2"
com.apple.MobileSMS,2,1740885403,1740885405,1740885405.562774,-21600,EB445137-D7F5-57EC-87DA-1DB460D64046,"iPhone13,2"
com.microsoft.Office.Outlook,9,1740883089,1740883098,1740883098.737947,-21600,EB445137-D7F5-57EC-87DA-1DB460D64046,"iPhone13,2"
com.apple.MobileSMS,38,1740882492,1740882530,1740882531.095031,-21600,EB445137-D7F5-57EC-87DA-1DB460D64046,"iPhone13,2"
com.google.chrome.ios,0,1740882492,1740882492,1740882493.735986,-21600,EB445137-D7F5-57EC-87DA-1DB460D64046,"iPhone13,2"
com.google.chrome.ios,12,1740878811,1740878823,1740878823.569587,-21600,EB445137-D7F5-57EC-87DA-1DB460D64046,"iPhone13,2"
com.apple.mobileslideshow,2,1740878809,1740878811,1740878811.771543,-21600,EB445137-D7F5-57EC-87DA-1DB460D64046,"iPhone13,2"
com.apple.mobileslideshow,62,1740876276,1740876338,1740876338.7904382,-21600,EB445137-D7F5-57EC-87DA-1DB460D64046,"iPhone13,2"
com.apple.mobileslideshow,63,1740876176,1740876239,1740876239.381799,-21600,EB445137-D7F5-57EC-87DA-1DB460D64046,"iPhone13,2"
com.apple.mobileslideshow,260,1740875834,1740876094,1740876094.4078789,-21600,EB445137-D7F5-57EC-87DA-1DB460D64046,"iPhone13,2"
com.apple.mobileslideshow,62,1740875474,1740875536,1740875536.578299,-21600,EB445137-D7F5-57EC-87DA-1DB460D64046,"iPhone13,2"
com.apple.mobileslideshow,62,1740875068,1740875130,1740875130.2082891,-21600,EB445137-D7F5-57EC-87DA-1DB460D64046,"iPhone13,2"
com.apple.mobileslideshow,1,1740875067,1740875068,1740875068.4954739,-21600,EB445137-D7F5-57EC-87DA-1DB460D64046,"iPhone13,2"
com.apple.mobileslideshow,85,1740874875,1740874960,1740874960.264355,-21600,EB445137-D7F5-57EC-87DA-1DB460D64046,"iPhone13,2"
com.google.chrome.ios,7,1740874866,1740874873,1740874873.12341,-21600,EB445137-D7F5-57EC-87DA-1DB460D64046,"iPhone13,2"
com.google.chrome.ios,63,1740874795,1740874858,1740874858.248728,-21600,EB445137-D7F5-57EC-87DA-1DB460D64046,"iPhone13,2"
com.apple.Health,3,1740874782,1740874785,1740874785.28195,-21600,EB445137-D7F5-57EC-87DA-1DB460D64046,"iPhone13,2"
com.apple.Health,20,1740873952,1740873972,1740873972.4091558,-21600,EB445137-D7F5-57EC-87DA-1DB460D64046,"iPhone13,2"
com.google.Sheets,99,1740870755,1740870854,1740870854.955803,-21600,EB445137-D7F5-57EC-87DA-1DB460D64046,"iPhone13,2"
com.google.Sheets,14,1740870720,1740870734,1740870734.651496,-21600,EB445137-D7F5-57EC-87DA-1DB460D64046,"iPhone13,2"
com.apple.mobilenotes,2,1740870717,1740870719,1740870719.743232,-21600,EB445137-D7F5-57EC-87DA-1DB460D64046,"iPhone13,2"
com.apple.mobilenotes,108,1740870176,1740870284,1740870284.897572,-21600,EB445137-D7F5-57EC-87DA-1DB460D64046,"iPhone13,2"
com.apple.finder,1,1740869490,1740869491,1740869492.055153,-21600,,
com.leomehlig.today,30,1740869460,1740869490,1740869490.23855,-21600,,
com.leomehlig.today,11,1740869443,1740869454,1740869454.319672,-21600,,
com.apple.finder,8,1740869435,1740869443,1740869443.960185,-21600,,
com.google.Chrome,37,1740869398,1740869435,1740869435.991681,-21600,,
com.apple.finder,2,1740869396,1740869398,1740869398.987925,-21600,,
com.leomehlig.today,9,1740869387,1740869396,1740869396.601291,-21600,,
com.apple.finder,2,1740869385,1740869387,1740869387.190693,-21600,,
com.google.Chrome,10,1740869375,1740869385,1740869385.720087,-21600,,
com.apple.finder,1,1740869362,1740869363,1740869363.572465,-21600,,
com.apple.Notes,1,1740869361,1740869362,1740869362.700742,-21600,,
com.leomehlig.today,100,1740869261,1740869361,1740869361.43371,-21600,,
com.apple.Notes,7,1740869254,1740869261,1740869261.576128,-21600,,
com.leomehlig.today,1,1740869253,1740869254,1740869254.2684178,-21600,,
com.apple.Notes,16,1740869237,1740869253,1740869253.386172,-21600,,
com.leomehlig.today,4,1740869233,1740869237,1740869237.179967,-21600,,
com.apple.Notes,8,1740869225,1740869233,1740869233.82422,-21600,,
com.leomehlig.today,131,1740869094,1740869225,1740869226.025316,-21600,,
com.apple.finder,1,1740869093,1740869094,1740869094.8444328,-21600,,
com.microsoft.VSCode,3,1740869090,1740869093,1740869093.460386,-21600,,
com.google.Chrome,108,1740868982,1740869090,1740869090.950914,-21600,,
com.microsoft.VSCode,1,1740868981,1740868982,1740868982.061315,-21600,,
com.google.Chrome,685,1740868296,1740868981,1740868981.326113,-21600,,
com.microsoft.VSCode,5,1740868291,1740868296,1740868296.691803,-21600,,
com.google.Chrome,339,1740867952,1740868291,1740868291.694333,-21600,,
com.microsoft.VSCode,3,1740867949,1740867952,1740867952.564919,-21600,,
com.google.Chrome,0,1740867949,1740867949,1740867949.7349381,-21600,,
com.microsoft.VSCode,1,1740867948,1740867949,1740867949.137435,-21600,,
com.google.Chrome,1,1740867947,1740867948,1740867948.691051,-21600,,
com.microsoft.VSCode,6,1740867941,1740867947,1740867947.993649,-21600,,
com.google.Chrome,7,1740867934,1740867941,1740867941.225686,-21600,,
com.microsoft.VSCode,1,1740867933,1740867934,1740867934.847657,-21600,,
com.google.Chrome,44,1740867889,1740867933,1740867933.4698129,-21600,,
com.microsoft.VSCode,3,1740867886,1740867889,1740867889.1962972,-21600,,
com.google.Chrome,11,1740867875,1740867886,1740867886.516142,-21600,,
com.microsoft.VSCode,2,1740867873,1740867875,1740867875.7800431,-21600,,
com.google.Chrome,115,1740867758,1740867873,1740867873.923141,-21600,,
com.microsoft.VSCode,8,1740867750,1740867758,1740867758.221287,-21600,,
com.google.Chrome,1,1740867749,1740867750,1740867750.940419,-21600,,
com.microsoft.VSCode,8,1740867741,1740867749,1740867749.092884,-21600,,
com.google.Chrome,38,1740867703,1740867741,1740867741.241864,-21600,,
com.microsoft.VSCode,7,1740867696,1740867703,1740867703.314574,-21600,,
com.google.Chrome,4,1740867692,1740867696,1740867696.9956288,-21600,,
com.microsoft.VSCode,2,1740867690,1740867692,1740867692.165882,-21600,,
com.google.Chrome,1,1740867689,1740867690,1740867690.9192638,-21600,,
com.microsoft.VSCode,1,1740867688,1740867689,1740867689.45263,-21600,,
com.google.Chrome,2,1740867686,1740867688,1740867688.2413878,-21600,,
com.microsoft.VSCode,3,1740867683,1740867686,1740867686.144443,-21600,,
com.google.Chrome,18,1740867665,1740867683,1740867683.817957,-21600,,
com.microsoft.VSCode,1,1740867664,1740867665,1740867665.505331,-21600,,
com.google.Chrome,3,1740867661,1740867664,1740867664.991271,-21600,,
com.microsoft.VSCode,4,1740867657,1740867661,1740867661.479743,-21600,,
com.google.Chrome,49,1740867608,1740867657,1740867657.568787,-21600,,
com.microsoft.VSCode,10,1740867598,1740867608,1740867608.14452,-21600,,
com.google.Chrome,17,1740867581,1740867598,1740867598.252623,-21600,,
com.microsoft.VSCode,0,1740867581,1740867581,1740867581.851311,-21600,,
com.google.Chrome,125,1740867456,1740867581,1740867581.491499,-21600,,
com.microsoft.VSCode,9,1740867447,1740867456,1740867456.0988212,-21600,,
com.google.Chrome,15,1740867432,1740867447,1740867447.599267,-21600,,
com.microsoft.VSCode,6,1740867426,1740867432,1740867432.424097,-21600,,
com.google.Chrome,5,1740867421,1740867426,1740867426.823787,-21600,,
com.microsoft.VSCode,2,1740867419,1740867421,1740867421.692021,-21600,,
com.google.Chrome,21,1740867398,1740867419,1740867419.47549,-21600,,
com.microsoft.VSCode,1,1740867397,1740867398,1740867398.189167,-21600,,
com.google.Chrome,0,1740867397,1740867397,1740867397.884029,-21600,,
com.microsoft.VSCode,2,1740867395,1740867397,1740867397.138686,-21600,,
com.google.Chrome,63,1740867332,1740867395,1740867395.842557,-21600,,
com.microsoft.VSCode,8,1740867324,1740867332,1740867332.725153,-21600,,
com.google.Chrome,3,1740867321,1740867324,1740867324.595923,-21600,,
com.microsoft.VSCode,3,1740867318,1740867321,1740867321.826859,-21600,,
com.google.Chrome,6,1740867312,1740867318,1740867318.755619,-21600,,
com.microsoft.VSCode,0,1740867312,1740867312,1740867312.859127,-21600,,
com.google.Chrome,2,1740867310,1740867312,1740867312.312478,-21600,,
com.microsoft.VSCode,1,1740867309,1740867310,1740867310.215146,-21600,,
com.google.Chrome,33,1740867276,1740867309,1740867309.163323,-21600,,
com.microsoft.VSCode,10,1740867266,1740867276,1740867276.244275,-21600,,
com.google.Chrome,57,1740867209,1740867266,1740867266.86757,-21600,,
com.microsoft.VSCode,1,1740867208,1740867209,1740867209.841457,-21600,,
com.google.Chrome,3,1740867205,1740867208,1740867208.371594,-21600,,
com.microsoft.VSCode,10,1740867195,1740867205,1740867205.322782,-21600,,
com.google.Chrome,31,1740867164,1740867195,1740867195.312105,-21600,,
com.microsoft.VSCode,2,1740867162,1740867164,1740867165.011153,-21600,,
com.google.Chrome,51,1740867111,1740867162,1740867162.2835379,-21600,,
com.microsoft.VSCode,1,1740867110,1740867111,1740867111.228553,-21600,,
com.google.Chrome,1,1740867109,1740867110,1740867110.873858,-21600,,
com.microsoft.VSCode,2,1740867107,1740867109,1740867109.057697,-21600,,
com.google.Chrome,82,1740867025,1740867107,1740867107.551004,-21600,,
com.microsoft.VSCode,2,1740867023,1740867025,1740867025.564585,-21600,,
com.google.Chrome,3,1740867020,1740867023,1740867023.1620278,-21600,,
com.microsoft.VSCode,1,1740867019,1740867020,1740867020.881112,-21600,,
com.google.Chrome,1,1740867018,1740867019,1740867019.717753,-21600,,
com.microsoft.VSCode,12,1740867006,1740867018,1740867018.432411,-21600,,
com.google.Chrome,391,1740866615,1740867006,1740867006.5450602,-21600,,
com.apple.Preview,14,1740866601,1740866615,1740866615.1267428,-21600,,
com.apple.finder,0,1740866601,1740866601,1740866601.674127,-21600,,
com.apple.Preview,16,1740866585,1740866601,1740866601.3948321,-21600,,
com.apple.finder,1,1740866584,1740866585,1740866585.983671,-21600,,
com.apple.Preview,294,1740866290,1740866584,1740866584.375277,-21600,,
com.apple.finder,9,1740866281,1740866290,1740866290.148294,-21600,,
com.google.Chrome,1147,1740865134,1740866281,1740866281.285797,-21600,,
com.leomehlig.today,27,1740865093,1740865120,1740865120.2825952,-21600,,
com.google.Chrome,8,1740865085,1740865093,1740865093.932821,-21600,,
com.leomehlig.today,11,1740865074,1740865085,1740865085.912857,-21600,,
com.apple.finder,5,1740865069,1740865074,1740865074.608046,-21600,,
com.hammerandchisel.discord,68,1740864883,1740864951,1740864951.7999148,-21600,EB445137-D7F5-57EC-87DA-1DB460D64046,"iPhone13,2"
Astrospheric.Astrospheric,20,1740864843,1740864863,1740864864.078497,-21600,EB445137-D7F5-57EC-87DA-1DB460D64046,"iPhone13,2"
com.microsoft.Office.Outlook,6,1740864816,1740864822,1740864822.970604,-21600,EB445137-D7F5-57EC-87DA-1DB460D64046,"iPhone13,2"
com.apple.Health,19,1740864791,1740864810,1740864810.2540479,-21600,EB445137-D7F5-57EC-87DA-1DB460D64046,"iPhone13,2"
com.apple.finder,1,1740864711,1740864712,1740864712.532131,-21600,,
com.leomehlig.today,7,1740864704,1740864711,1740864711.389024,-21600,,
com.google.Chrome,3,1740864701,1740864704,1740864704.906995,-21600,,
com.apple.news,3,1740863844,1740863847,1740863847.864452,-21600,EB445137-D7F5-57EC-87DA-1DB460D64046,"iPhone13,2"
com.apple.Preview,913,1740863788,1740864701,1740864701.324072,-21600,,
com.apple.Preview,1134,1740862596,1740863730,1740863730.42319,-21600,,
com.google.Chrome,42,1740862554,1740862596,1740862596.519075,-21600,,
com.apple.Preview,41,1740862513,1740862554,1740862555.015359,-21600,,
com.leomehlig.today,1,1740862512,1740862513,1740862513.490969,-21600,,
com.google.Chrome,305,1740862207,1740862512,1740862512.069034,-21600,,
com.leomehlig.today,25,1740862182,1740862207,1740862207.90888,-21600,,
com.google.Chrome,412,1740861770,1740862182,1740862182.378161,-21600,,
com.apple.Preview,432,1740861338,1740861770,1740861770.900762,-21600,,
com.google.Chrome,147,1740861191,1740861338,1740861338.6499429,-21600,,
com.apple.Preview,55,1740861136,1740861191,1740861191.957439,-21600,,
com.google.Chrome,115,1740861021,1740861136,1740861136.461296,-21600,,
com.apple.news,76,1740860279,1740860355,1740860355.875383,-21600,EB445137-D7F5-57EC-87DA-1DB460D64046,"iPhone13,2"
com.apple.MobileSMS,3,1740860269,1740860272,1740860272.07979,-21600,EB445137-D7F5-57EC-87DA-1DB460D64046,"iPhone13,2"
com.hammerandchisel.discord,10,1740860251,1740860261,1740860261.954593,-21600,EB445137-D7F5-57EC-87DA-1DB460D64046,"iPhone13,2"
com.apple.news,1,1740860250,1740860251,1740860251.759602,-21600,EB445137-D7F5-57EC-87DA-1DB460D64046,"iPhone13,2"
com.apple.Preview,807,1740860214,1740861021,1740861021.808902,-21600,,
com.leomehlig.today,2,1740860212,1740860214,1740860214.230081,-21600,,
com.apple.Preview,10,1740860202,1740860212,1740860212.18078,-21600,,
com.apple.Preview,813,1740859355,1740860168,1740860168.692831,-21600,,
com.apple.news,196,1740859188,1740859384,1740859384.713259,-21600,EB445137-D7F5-57EC-87DA-1DB460D64046,"iPhone13,2"
com.apple.MobileSMS,7,1740859181,1740859188,1740859188.82916,-21600,EB445137-D7F5-57EC-87DA-1DB460D64046,"iPhone13,2"
com.apple.news,44,1740859137,1740859181,1740859181.970541,-21600,EB445137-D7F5-57EC-87DA-1DB460D64046,"iPhone13,2"
com.apple.MobileSMS,8,1740859120,1740859128,1740859128.628577,-21600,EB445137-D7F5-57EC-87DA-1DB460D64046,"iPhone13,2"
com.apple.Preview,861,1740858493,1740859354,1740859354.277704,-21600,,
com.apple.finder,20,1740858473,1740858493,1740858493.596336,-21600,,
com.google.Chrome,164,1740858309,1740858473,1740858473.600782,-21600,,
com.apple.finder,4,1740858294,1740858298,1740858298.9691482,-21600,,
com.apple.Preview,60,1740858234,1740858294,1740858294.36571,-21600,,
com.apple.finder,1,1740858233,1740858234,1740858234.8103151,-21600,,
com.apple.Preview,252,1740857981,1740858233,1740858233.245065,-21600,,
com.apple.finder,1,1740857980,1740857981,1740857981.3085,-21600,,
com.apple.Preview,167,1740857813,1740857980,1740857981.0151439,-21600,,
com.intsig.CamScannerLite,4,1740857796,1740857800,1740857800.606933,-21600,EB445137-D7F5-57EC-87DA-1DB460D64046,"iPhone13,2"
com.apple.CoreAuthUI,2,1740857783,1740857785,1740857785.842488,-21600,EB445137-D7F5-57EC-87DA-1DB460D64046,"iPhone13,2"
com.clairmail.fth.client,14,1740857782,1740857796,1740857796.72469,-21600,EB445137-D7F5-57EC-87DA-1DB460D64046,"iPhone13,2"
com.intsig.CamScannerLite,4,1740857767,1740857771,1740857771.148364,-21600,EB445137-D7F5-57EC-87DA-1DB460D64046,"iPhone13,2"
com.intsig.CamScannerLite,186,1740857564,1740857750,1740857751.992507,-21600,EB445137-D7F5-57EC-87DA-1DB460D64046,"iPhone13,2"
com.myfitnesspal.mfp,2,1740857562,1740857564,1740857564.334677,-21600,EB445137-D7F5-57EC-87DA-1DB460D64046,"iPhone13,2"
com.apple.finder,301,1740857512,1740857813,1740857813.952369,-21600,,
com.leomehlig.today,6,1740857506,1740857512,1740857512.336837,-21600,,
com.google.Chrome,106,1740857400,1740857506,1740857506.275422,-21600,,
com.apple.iCal,105,1740857295,1740857400,1740857400.4540129,-21600,,
com.google.Chrome,62,1740857233,1740857295,1740857295.867649,-21600,,
com.apple.iCal,40,1740857140,1740857180,1740857180.219279,-21600,,
com.leomehlig.today,16,1740857124,1740857140,1740857140.5875359,-21600,,
com.myfitnesspal.mfp,74,1740857037,1740857111,1740857112.055304,-21600,EB445137-D7F5-57EC-87DA-1DB460D64046,"iPhone13,2"
com.apple.mobileslideshow,6,1740857031,1740857037,1740857037.845457,-21600,EB445137-D7F5-57EC-87DA-1DB460D64046,"iPhone13,2"
com.myfitnesspal.mfp,28,1740857003,1740857031,1740857032.178242,-21600,EB445137-D7F5-57EC-87DA-1DB460D64046,"iPhone13,2"
com.apple.mobileslideshow,7,1740856996,1740857003,1740857003.4825358,-21600,EB445137-D7F5-57EC-87DA-1DB460D64046,"iPhone13,2"
com.myfitnesspal.mfp,46,1740856950,1740856996,1740856996.992199,-21600,EB445137-D7F5-57EC-87DA-1DB460D64046,"iPhone13,2"
com.apple.mobileslideshow,2,1740856948,1740856950,1740856950.170356,-21600,EB445137-D7F5-57EC-87DA-1DB460D64046,"iPhone13,2"
com.myfitnesspal.mfp,20,1740856928,1740856948,1740856948.198241,-21600,EB445137-D7F5-57EC-87DA-1DB460D64046,"iPhone13,2"
com.apple.mobileslideshow,3,1740856925,1740856928,1740856928.65763,-21600,EB445137-D7F5-57EC-87DA-1DB460D64046,"iPhone13,2"
com.myfitnesspal.mfp,10,1740856915,1740856925,1740856926.170479,-21600,EB445137-D7F5-57EC-87DA-1DB460D64046,"iPhone13,2"
com.apple.mobileslideshow,13,1740856902,1740856915,1740856915.168446,-21600,EB445137-D7F5-57EC-87DA-1DB460D64046,"iPhone13,2"
com.myfitnesspal.mfp,8,1740856894,1740856902,1740856902.744827,-21600,EB445137-D7F5-57EC-87DA-1DB460D64046,"iPhone13,2"
com.apple.mobileslideshow,4,1740856890,1740856894,1740856894.965945,-21600,EB445137-D7F5-57EC-87DA-1DB460D64046,"iPhone13,2"
com.myfitnesspal.mfp,10,1740856880,1740856890,1740856890.93942,-21600,EB445137-D7F5-57EC-87DA-1DB460D64046,"iPhone13,2"
com.apple.mobileslideshow,12,1740856868,1740856880,1740856880.348476,-21600,EB445137-D7F5-57EC-87DA-1DB460D64046,"iPhone13,2"
com.myfitnesspal.mfp,32,1740856836,1740856868,1740856868.354288,-21600,EB445137-D7F5-57EC-87DA-1DB460D64046,"iPhone13,2"
com.apple.mobileslideshow,16,1740856820,1740856836,1740856836.990679,-21600,EB445137-D7F5-57EC-87DA-1DB460D64046,"iPhone13,2"
com.myfitnesspal.mfp,34,1740856785,1740856819,1740856819.60953,-21600,EB445137-D7F5-57EC-87DA-1DB460D64046,"iPhone13,2"
com.hammerandchisel.discord,7,1740856777,1740856784,1740856784.956743,-21600,EB445137-D7F5-57EC-87DA-1DB460D64046,"iPhone13,2"
com.hammerandchisel.discord,20,1740856756,1740856776,1740856777.001796,-21600,EB445137-D7F5-57EC-87DA-1DB460D64046,"iPhone13,2"
com.apple.MobileSMS,55,1740856701,1740856756,1740856756.186974,-21600,EB445137-D7F5-57EC-87DA-1DB460D64046,"iPhone13,2"
com.apple.CoreAuthUI,2,1740856698,1740856700,1740856700.558526,-21600,EB445137-D7F5-57EC-87DA-1DB460D64046,"iPhone13,2"
com.truebill.truebillnative,2,1740856698,1740856700,1740856700.372268,-21600,EB445137-D7F5-57EC-87DA-1DB460D64046,"iPhone13,2"
com.leomehlig.today,300,1740856691,1740856991,1740856991.6977348,-21600,,
com.microsoft.Word,2,1740856689,1740856691,1740856691.304579,-21600,,
com.leomehlig.today,2,1740856687,1740856689,1740856689.71329,-21600,,
com.apple.finder,7,1740856680,1740856687,1740856687.113035,-21600,,
com.apple.CoreAuthUI,2,1740855264,1740855266,1740855266.089328,-21600,EB445137-D7F5-57EC-87DA-1DB460D64046,"iPhone13,2"
com.truebill.truebillnative,37,1740855262,1740855299,1740855299.7933888,-21600,EB445137-D7F5-57EC-87DA-1DB460D64046,"iPhone13,2"
com.apple.MobileSMS,34,1740855183,1740855217,1740855217.374908,-21600,EB445137-D7F5-57EC-87DA-1DB460D64046,"iPhone13,2"
com.apple.calculator,10,1740855173,1740855183,1740855183.0947661,-21600,EB445137-D7F5-57EC-87DA-1DB460D64046,"iPhone13,2"
com.apple.CoreAuthUI,3,1740855140,1740855143,1740855143.7683702,-21600,EB445137-D7F5-57EC-87DA-1DB460D64046,"iPhone13,2"
com.clairmail.fth.client,34,1740855137,1740855171,1740855171.6789331,-21600,EB445137-D7F5-57EC-87DA-1DB460D64046,"iPhone13,2"
com.apple.MobileSMS,17,1740855103,1740855120,1740855120.264018,-21600,EB445137-D7F5-57EC-87DA-1DB460D64046,"iPhone13,2"
com.apple.calculator,47,1740855056,1740855103,1740855103.87952,-21600,EB445137-D7F5-57EC-87DA-1DB460D64046,"iPhone13,2"
com.apple.finder,2,1740854712,1740854714,1740854714.703315,-21600,,
com.leomehlig.today,3,1740854709,1740854712,1740854712.836989,-21600,,
com.google.Chrome,8,1740854701,1740854709,1740854709.389454,-21600,,
com.leomehlig.today,129,1740854572,1740854701,1740854701.815753,-21600,,
com.apple.weather,12,1740853886,1740853898,1740853898.074592,-21600,EB445137-D7F5-57EC-87DA-1DB460D64046,"iPhone13,2"
Astrospheric.Astrospheric,23,1740853863,1740853886,1740853886.692752,-21600,EB445137-D7F5-57EC-87DA-1DB460D64046,"iPhone13,2"
Astrospheric.Astrospheric,21,1740853839,1740853860,1740853860.361318,-21600,EB445137-D7F5-57EC-87DA-1DB460D64046,"iPhone13,2"
com.google.chrome.ios,2,1740853836,1740853838,1740853838.9769049,-21600,EB445137-D7F5-57EC-87DA-1DB460D64046,"iPhone13,2"
com.leomehlig.today,131,1740852126,1740852257,1740852257.835577,-21600,,
com.google.Chrome,13,1740852113,1740852126,1740852126.545761,-21600,,
com.leomehlig.today,25,1740852088,1740852113,1740852113.2211661,-21600,,
com.google.Chrome,1456,1740850632,1740852088,1740852088.842613,-21600,,
com.leomehlig.today,90,1740850352,1740850442,1740850442.3191671,-21600,EB445137-D7F5-57EC-87DA-1DB460D64046,"iPhone13,2"
com.leomehlig.today,6,1740850295,1740850301,1740850301.694171,-21600,EB445137-D7F5-57EC-87DA-1DB460D64046,"iPhone13,2"
com.google.Chrome,727,1740849831,1740850558,1740850558.242593,-21600,,
com.apple.Preview,5,1740849826,1740849831,1740849831.591137,-21600,,
com.google.Chrome,159,1740849667,1740849826,1740849826.223144,-21600,,
com.apple.Preview,2,1740849665,1740849667,1740849667.542424,-21600,,
com.google.Chrome,1891,1740847774,1740849665,1740849665.290978,-21600,,
com.apple.finder,1,1740847773,1740847774,1740847774.2852468,-21600,,
com.apple.Preview,5,1740847768,1740847773,1740847773.244193,-21600,,
com.apple.finder,6,1740847762,1740847768,1740847768.072681,-21600,,
com.google.Chrome,1016,1740846746,1740847762,1740847762.5571718,-21600,,
com.google.Chrome,453,1740846098,1740846551,1740846551.3227339,-21600,,
com.apple.Music,20,1740846078,1740846098,1740846098.29277,-21600,,
com.myfitnesspal.mfp,161,1740844753,1740844914,1740844914.730705,-21600,EB445137-D7F5-57EC-87DA-1DB460D64046,"iPhone13,2"
com.meijer.mobile.Meijer,11,1740844742,1740844753,1740844754.1420732,-21600,EB445137-D7F5-57EC-87DA-1DB460D64046,"iPhone13,2"
com.myfitnesspal.mfp,16,1740844726,1740844742,1740844742.2888842,-21600,EB445137-D7F5-57EC-87DA-1DB460D64046,"iPhone13,2"
com.meijer.mobile.Meijer,3,1740844723,1740844726,1740844727.044877,-21600,EB445137-D7F5-57EC-87DA-1DB460D64046,"iPhone13,2"
com.myfitnesspal.mfp,10,1740844713,1740844723,1740844724.049254,-21600,EB445137-D7F5-57EC-87DA-1DB460D64046,"iPhone13,2"
com.meijer.mobile.Meijer,15,1740844698,1740844713,1740844713.3553782,-21600,EB445137-D7F5-57EC-87DA-1DB460D64046,"iPhone13,2"
com.myfitnesspal.mfp,25,1740844671,1740844696,1740844696.4768991,-21600,EB445137-D7F5-57EC-87DA-1DB460D64046,"iPhone13,2"
com.renpho.health,2,1740844667,1740844669,1740844669.187341,-21600,EB445137-D7F5-57EC-87DA-1DB460D64046,"iPhone13,2"
com.renpho.health,28,1740843912,1740843940,1740843940.628685,-21600,EB445137-D7F5-57EC-87DA-1DB460D64046,"iPhone13,2"
com.apple.news,1268,1740841850,1740843118,1740843118.624568,-21600,EB445137-D7F5-57EC-87DA-1DB460D64046,"iPhone13,2"
com.microsoft.Office.Outlook,27,1740841735,1740841762,1740841762.7168999,-21600,EB445137-D7F5-57EC-87DA-1DB460D64046,"iPhone13,2"
com.apple.Music,636,1740811299,1740811935,1740811935.193387,-21600,,
com.google.Chrome,168,1740811131,1740811299,1740811299.793623,-21600,,
com.apple.Music,9,1740811122,1740811131,1740811131.6942248,-21600,,
com.google.Chrome,11,1740811111,1740811122,1740811122.8906631,-21600,,
com.apple.news,205,1740810734,1740810939,1740810939.9538488,-21600,EB445137-D7F5-57EC-87DA-1DB460D64046,"iPhone13,2"
com.apple.Music,429,1740810682,1740811111,1740811111.0372682,-21600,,
com.apple.finder,6,1740810676,1740810682,1740810683.039954,-21600,,
com.apple.news,227,1740806295,1740806522,1740806523.048143,-21600,EB445137-D7F5-57EC-87DA-1DB460D64046,"iPhone13,2"
com.burbn.instagram,3,1740805194,1740805197,1740805197.137854,-21600,EB445137-D7F5-57EC-87DA-1DB460D64046,"iPhone13,2"
com.burbn.instagram,213,1740802435,1740802648,1740802648.595683,-21600,EB445137-D7F5-57EC-87DA-1DB460D64046,"iPhone13,2"
com.apple.news,2,1740802428,1740802430,1740802430.1506119,-21600,EB445137-D7F5-57EC-87DA-1DB460D64046,"iPhone13,2"
com.apple.news,315,1740797090,1740797405,1740797405.2863889,-21600,EB445137-D7F5-57EC-87DA-1DB460D64046,"iPhone13,2"
com.apple.news,574,1740796469,1740797043,1740797043.723839,-21600,EB445137-D7F5-57EC-87DA-1DB460D64046,"iPhone13,2"
com.apple.mobilenotes,3,1740796449,1740796452,1740796452.442494,-21600,EB445137-D7F5-57EC-87DA-1DB460D64046,"iPhone13,2"
com.apple.mobilenotes,9,1740789307,1740789316,1740789317.37681,-21600,EB445137-D7F5-57EC-87DA-1DB460D64046,"iPhone13,2"
com.apple.MobileSMS,2,1740789298,1740789300,1740789300.564153,-21600,EB445137-D7F5-57EC-87DA-1DB460D64046,"iPhone13,2"
com.apple.MobileSMS,5,1740788018,1740788023,1740788023.829251,-21600,EB445137-D7F5-57EC-87DA-1DB460D64046,"iPhone13,2"
com.apple.MobileSMS,13,1740787809,1740787822,1740787822.816321,-21600,EB445137-D7F5-57EC-87DA-1DB460D64046,"iPhone13,2"
com.apple.mobilenotes,1,1740787808,1740787809,1740787809.892817,-21600,EB445137-D7F5-57EC-87DA-1DB460D64046,"iPhone13,2"
com.apple.mobilenotes,7,1740787127,1740787134,1740787134.4437919,-21600,EB445137-D7F5-57EC-87DA-1DB460D64046,"iPhone13,2"
com.apple.mobilenotes,10,1740787066,1740787076,1740787076.531992,-21600,EB445137-D7F5-57EC-87DA-1DB460D64046,"iPhone13,2"
com.apple.mobilenotes,2,1740787009,1740787011,1740787011.249646,-21600,EB445137-D7F5-57EC-87DA-1DB460D64046,"iPhone13,2"
com.apple.mobilenotes,1,1740787008,1740787009,1740787009.170735,-21600,EB445137-D7F5-57EC-87DA-1DB460D64046,"iPhone13,2"
com.apple.mobilenotes,4,1740786998,1740787002,1740787003.194985,-21600,EB445137-D7F5-57EC-87DA-1DB460D64046,"iPhone13,2"
com.apple.mobilenotes,7,1740786073,1740786080,1740786081.0878649,-21600,EB445137-D7F5-57EC-87DA-1DB460D64046,"iPhone13,2"
com.apple.mobilenotes,4,1740786066,1740786070,1740786070.533601,-21600,EB445137-D7F5-57EC-87DA-1DB460D64046,"iPhone13,2"
com.apple.mobilenotes,6,1740785787,1740785793,1740785793.658496,-21600,EB445137-D7F5-57EC-87DA-1DB460D64046,"iPhone13,2"
com.apple.mobilenotes,12,1740785608,1740785620,1740785620.487747,-21600,EB445137-D7F5-57EC-87DA-1DB460D64046,"iPhone13,2"
com.apple.AuthenticationServicesUI,5,1740783164,1740783169,1740783169.747064,-21600,EB445137-D7F5-57EC-87DA-1DB460D64046,"iPhone13,2"
com.apple.CoreAuthUI,2,1740783160,1740783162,1740783162.81114,-21600,EB445137-D7F5-57EC-87DA-1DB460D64046,"iPhone13,2"
com.github.stormbreaker.prod,78,1740783148,1740783226,1740783226.6649919,-21600,EB445137-D7F5-57EC-87DA-1DB460D64046,"iPhone13,2"
com.apple.AppStore,42,1740783106,1740783148,1740783148.6814752,-21600,EB445137-D7F5-57EC-87DA-1DB460D64046,"iPhone13,2"
com.myfitnesspal.mfp,20,1740783082,1740783102,1740783102.9819589,-21600,EB445137-D7F5-57EC-87DA-1DB460D64046,"iPhone13,2"
com.apple.MobileSMS,3,1740783066,1740783069,1740783069.9882069,-21600,EB445137-D7F5-57EC-87DA-1DB460D64046,"iPhone13,2"
com.apple.MobileSMS,68,1740782985,1740783053,1740783053.572396,-21600,EB445137-D7F5-57EC-87DA-1DB460D64046,"iPhone13,2"
com.apple.MobileSMS,15,1740782969,1740782984,1740782984.7202969,-21600,EB445137-D7F5-57EC-87DA-1DB460D64046,"iPhone13,2"
com.apple.MobileSMS,4,1740782954,1740782958,1740782959.902162,-21600,EB445137-D7F5-57EC-87DA-1DB460D64046,"iPhone13,2"
com.apple.finder,1,1740782948,1740782949,1740782949.108028,-21600,,
com.leomehlig.today,1,1740782947,1740782948,1740782948.274802,-21600,,
com.google.Chrome,706,1740782241,1740782947,1740782947.312107,-21600,,
com.apple.finder,2,1740782239,1740782241,1740782241.963715,-21600,,
com.leomehlig.today,9,1740782230,1740782239,1740782239.9389281,-21600,,
com.apple.MobileSMS,2,1740782209,1740782211,1740782211.985673,-21600,EB445137-D7F5-57EC-87DA-1DB460D64046,"iPhone13,2"
com.apple.MobileSMS,5,1740782093,1740782098,1740782098.62759,-21600,EB445137-D7F5-57EC-87DA-1DB460D64046,"iPhone13,2"
com.apple.mobilenotes,15,1740782076,1740782091,1740782092.110487,-21600,EB445137-D7F5-57EC-87DA-1DB460D64046,"iPhone13,2"
com.apple.MobileSMS,13,1740782063,1740782076,1740782076.6253471,-21600,EB445137-D7F5-57EC-87DA-1DB460D64046,"iPhone13,2"
com.apple.mobilecal,8,1740782055,1740782063,1740782063.509707,-21600,EB445137-D7F5-57EC-87DA-1DB460D64046,"iPhone13,2"
com.instructure.icanvas,2,1740782051,1740782053,1740782053.5492601,-21600,EB445137-D7F5-57EC-87DA-1DB460D64046,"iPhone13,2"
com.apple.mobilenotes,100,1740781948,1740782048,1740782048.92522,-21600,EB445137-D7F5-57EC-87DA-1DB460D64046,"iPhone13,2"
com.apple.findmy,2,1740781945,1740781947,1740781948.977715,-21600,EB445137-D7F5-57EC-87DA-1DB460D64046,"iPhone13,2"
com.apple.findmy,2,1740781845,1740781847,1740781848.551163,-21600,EB445137-D7F5-57EC-87DA-1DB460D64046,"iPhone13,2"
com.apple.PeopleViewService,6,1740781839,1740781845,1740781845.6443338,-21600,EB445137-D7F5-57EC-87DA-1DB460D64046,"iPhone13,2"
com.apple.mobilecal,24,1740781589,1740781613,1740781613.865227,-21600,EB445137-D7F5-57EC-87DA-1DB460D64046,"iPhone13,2"
com.microsoft.Office.Outlook,27,1740781559,1740781586,1740781586.556316,-21600,EB445137-D7F5-57EC-87DA-1DB460D64046,"iPhone13,2"
com.apple.CoreAuthUI,3,1740781531,1740781534,1740781535.246211,-21600,EB445137-D7F5-57EC-87DA-1DB460D64046,"iPhone13,2"
com.robinhood.release.Robinhood,31,1740781525,1740781556,1740781556.616932,-21600,EB445137-D7F5-57EC-87DA-1DB460D64046,"iPhone13,2"
com.apple.MobileSMS,53,1740781443,1740781496,1740781496.236281,-21600,EB445137-D7F5-57EC-87DA-1DB460D64046,"iPhone13,2"
com.microsoft.Office.Outlook,11,1740781432,1740781443,1740781443.743768,-21600,EB445137-D7F5-57EC-87DA-1DB460D64046,"iPhone13,2"
com.google.Gmail,39,1740781391,1740781430,1740781430.6191201,-21600,EB445137-D7F5-57EC-87DA-1DB460D64046,"iPhone13,2"
com.instructure.icanvas,0,1740781391,1740781391,1740781392.179997,-21600,EB445137-D7F5-57EC-87DA-1DB460D64046,"iPhone13,2"
com.instructure.icanvas,14,1740781372,1740781386,1740781386.314724,-21600,EB445137-D7F5-57EC-87DA-1DB460D64046,"iPhone13,2"
com.leomehlig.today,28,1740781282,1740781310,1740781310.464889,-21600,,
com.google.Chrome,684,1740780598,1740781282,1740781282.6310802,-21600,,
com.apple.finder,7,1740780340,1740780347,1740780347.857265,-21600,,
com.google.Chrome,14,1740780326,1740780340,1740780340.187498,-21600,,
com.apple.finder,6,1740780320,1740780326,1740780327.015229,-21600,,
com.google.Chrome,82,1740780238,1740780320,1740780320.453191,-21600,,
com.apple.finder,26,1740779930,1740779956,1740779956.095268,-21600,,
com.google.Chrome,20,1740779910,1740779930,1740779931.04373,-21600,,
com.microsoft.Word,19,1740779891,1740779910,1740779910.206625,-21600,,
com.apple.finder,8,1740779883,1740779891,1740779891.5364451,-21600,,
com.microsoft.Word,15,1740779868,1740779883,1740779883.229477,-21600,,
com.google.Chrome,3,1740779865,1740779868,1740779868.150028,-21600,,
com.microsoft.Word,4,1740779861,1740779865,1740779866.029285,-21600,,
com.google.Chrome,5,1740779856,1740779861,1740779861.71643,-21600,,
com.microsoft.Word,4,1740779852,1740779856,1740779856.887051,-21600,,
com.google.Chrome,9,1740779843,1740779852,1740779852.5535722,-21600,,
com.microsoft.Word,1,1740779842,1740779843,1740779843.77204,-21600,,
com.google.Chrome,1,1740779841,1740779842,1740779842.622538,-21600,,
com.microsoft.Word,27,1740779814,1740779841,1740779841.343976,-21600,,
com.google.Chrome,3,1740779811,1740779814,1740779814.398933,-21600,,
com.microsoft.Word,15,1740779796,1740779811,1740779811.3723202,-21600,,
com.apple.finder,42,1740779754,1740779796,1740779796.315026,-21600,,
com.google.Chrome,3,1740779751,1740779754,1740779754.439575,-21600,,
com.apple.finder,5,1740779746,1740779751,1740779751.166161,-21600,,
com.google.Chrome,12,1740779734,1740779746,1740779746.9856539,-21600,,
com.apple.finder,6,1740779728,1740779734,1740779734.6784658,-21600,,
com.google.Chrome,0,1740779728,1740779728,1740779728.6824841,-21600,,
com.apple.finder,2,1740779726,1740779728,1740779728.290841,-21600,,
com.google.Chrome,8,1740779718,1740779726,1740779726.1448479,-21600,,
com.apple.finder,6,1740779712,1740779718,1740779718.4762921,-21600,,
com.google.Chrome,16,1740779696,1740779712,1740779712.3626862,-21600,,
com.apple.finder,90,1740779606,1740779696,1740779696.741102,-21600,,
com.google.Chrome,187,1740779419,1740779606,1740779606.698082,-21600,,
com.leomehlig.today,7,1740779412,1740779419,1740779420.225188,-21600,,
com.google.Chrome,608,1740778804,1740779412,1740779412.648148,-21600,,
com.apple.finder,2,1740778802,1740778804,1740778804.471439,-21600,,
com.apple.Notes,4,1740778798,1740778802,1740778802.2055612,-21600,,
com.google.Chrome,179,1740778619,1740778798,1740778798.3773541,-21600,,
com.apple.finder,6,1740778613,1740778619,1740778619.543232,-21600,,
com.leomehlig.today,7,1740778606,1740778613,1740778613.212748,-21600,,
com.apple.finder,5,1740778601,1740778606,1740778606.2179298,-21600,,
com.myfitnesspal.mfp,29,1740776023,1740776052,1740776052.768461,-21600,EB445137-D7F5-57EC-87DA-1DB460D64046,"iPhone13,2"
com.instructure.icanvas,27,1740772284,1740772311,1740772312.072452,-21600,EB445137-D7F5-57EC-87DA-1DB460D64046,"iPhone13,2"
com.truebill.truebillnative,0,1740772284,1740772284,1740772286.028466,-21600,EB445137-D7F5-57EC-87DA-1DB460D64046,"iPhone13,2"
com.apple.CoreAuthUI,3,1740771395,1740771398,1740771398.1516051,-21600,EB445137-D7F5-57EC-87DA-1DB460D64046,"iPhone13,2"
com.truebill.truebillnative,73,1740771393,1740771466,1740771466.6528811,-21600,EB445137-D7F5-57EC-87DA-1DB460D64046,"iPhone13,2"
com.microsoft.Office.Outlook,11,1740771366,1740771377,1740771377.274984,-21600,EB445137-D7F5-57EC-87DA-1DB460D64046,"iPhone13,2"
com.instructure.icanvas,20,1740771344,1740771364,1740771364.951995,-21600,EB445137-D7F5-57EC-87DA-1DB460D64046,"iPhone13,2"
com.myfitnesspal.mfp,27,1740770407,1740770434,1740770434.712932,-21600,EB445137-D7F5-57EC-87DA-1DB460D64046,"iPhone13,2"
com.apple.weather,22,1740770383,1740770405,1740770405.194632,-21600,EB445137-D7F5-57EC-87DA-1DB460D64046,"iPhone13,2"
Astrospheric.Astrospheric,7,1740770376,1740770383,1740770383.338297,-21600,EB445137-D7F5-57EC-87DA-1DB460D64046,"iPhone13,2"
Astrospheric.Astrospheric,33,1740770333,1740770366,1740770367.154527,-21600,EB445137-D7F5-57EC-87DA-1DB460D64046,"iPhone13,2"
com.apple.weather,9,1740770323,1740770332,1740770332.8083239,-21600,EB445137-D7F5-57EC-87DA-1DB460D64046,"iPhone13,2"
com.apple.Health,36,1740770271,1740770307,1740770307.8207378,-21600,EB445137-D7F5-57EC-87DA-1DB460D64046,"iPhone13,2"
com.microsoft.Office.Outlook,0,1740770271,1740770271,1740770271.676914,-21600,EB445137-D7F5-57EC-87DA-1DB460D64046,"iPhone13,2"
com.microsoft.Office.Outlook,19,1740769604,1740769623,1740769623.3727632,-21600,EB445137-D7F5-57EC-87DA-1DB460D64046,"iPhone13,2"
com.apple.finder,2,1740769519,1740769521,1740769521.7403789,-21600,,
com.leomehlig.today,1,1740769518,1740769519,1740769519.7705579,-21600,,
com.google.Chrome,1,1740769517,1740769518,1740769518.701262,-21600,,
com.leomehlig.today,1,1740769516,1740769517,1740769517.226079,-21600,,
com.microsoft.VSCode,2,1740769514,1740769516,1740769516.333547,-21600,,
com.leomehlig.today,31,1740769483,1740769514,1740769514.205471,-21600,,
com.microsoft.VSCode,473,1740769010,1740769483,1740769483.7983851,-21600,,
com.google.Chrome,20,1740768990,1740769010,1740769010.719182,-21600,,
com.microsoft.VSCode,914,1740768076,1740768990,1740768990.334991,-21600,,
com.google.Chrome,61,1740768015,1740768076,1740768076.733782,-21600,,
com.leomehlig.today,27,1740767988,1740768015,1740768015.928602,-21600,,
com.apple.Notes,3,1740767985,1740767988,1740767988.648254,-21600,,
com.instructure.icanvas,10,1740767604,1740767614,1740767614.731674,-21600,EB445137-D7F5-57EC-87DA-1DB460D64046,"iPhone13,2"
com.microsoft.Office.Outlook,0,1740767604,1740767604,1740767605.612834,-21600,EB445137-D7F5-57EC-87DA-1DB460D64046,"iPhone13,2"
com.microsoft.Office.Outlook,17,1740767546,1740767563,1740767563.929545,-21600,EB445137-D7F5-57EC-87DA-1DB460D64046,"iPhone13,2"
com.apple.Notes,76,1740767108,1740767184,1740767184.2861052,-21600,,
com.google.Chrome,7,1740767101,1740767108,1740767108.354323,-21600,,
com.apple.Notes,2,1740767099,1740767101,1740767101.94972,-21600,,
com.leomehlig.today,59,1740767040,1740767099,1740767099.0649838,-21600,,
com.apple.Notes,3,1740767037,1740767040,1740767040.478591,-21600,,
com.leomehlig.today,36,1740767001,1740767037,1740767037.854316,-21600,,
com.apple.Notes,48,1740766953,1740767001,1740767001.371004,-21600,,
com.google.Chrome,59,1740766894,1740766953,1740766953.833832,-21600,,
com.apple.Notes,414,1740766480,1740766894,1740766894.889575,-21600,,
com.google.Chrome,1,1740766479,1740766480,1740766480.421959,-21600,,
com.apple.Notes,6,1740766473,1740766479,1740766479.8227,-21600,,
com.google.Chrome,3,1740766470,1740766473,1740766473.513906,-21600,,
com.apple.Notes,8,1740766462,1740766470,1740766471.0313458,-21600,,
com.google.Chrome,3,1740766459,1740766462,1740766462.8952599,-21600,,
com.apple.Notes,9,1740766450,1740766459,1740766459.246393,-21600,,
com.google.Chrome,1,1740766449,1740766450,1740766451.0182781,-21600,,
com.apple.Notes,5,1740766444,1740766449,1740766449.776485,-21600,,
com.google.Chrome,2,1740766442,1740766444,1740766444.109178,-21600,,
com.apple.Notes,1,1740766441,1740766442,1740766442.9505172,-21600,,
com.google.Chrome,1,1740766440,1740766441,1740766441.7672958,-21600,,
com.apple.Notes,0,1740766440,1740766440,1740766440.522145,-21600,,
com.google.Chrome,1,1740766439,1740766440,1740766440.16006,-21600,,
com.apple.Notes,4,1740766435,1740766439,1740766439.191124,-21600,,
com.google.Chrome,2,1740766433,1740766435,1740766435.145108,-21600,,
com.apple.Notes,5,1740766428,1740766433,1740766433.960733,-21600,,
com.google.Chrome,17,1740766411,1740766428,1740766428.493188,-21600,,
com.apple.Notes,105,1740766306,1740766411,1740766412.579173,-21600,,
com.leomehlig.today,10,1740766296,1740766306,1740766306.7850199,-21600,,
com.leomehlig.today,2,1740761563,1740761565,1740761565.798973,-21600,,
com.google.Chrome,6,1740761557,1740761563,1740761563.9546561,-21600,,
com.microsoft.VSCode,648,1740760909,1740761557,1740761557.23977,-21600,,
com.google.Chrome,6,1740760903,1740760909,1740760909.060432,-21600,,
com.microsoft.VSCode,4,1740760899,1740760903,1740760903.947211,-21600,,
com.google.Chrome,4,1740760895,1740760899,1740760899.8978,-21600,,
com.microsoft.VSCode,18,1740760877,1740760895,1740760895.587751,-21600,,
com.google.Chrome,1,1740760876,1740760877,1740760877.669384,-21600,,
com.microsoft.VSCode,2,1740760874,1740760876,1740760876.7081351,-21600,,
com.google.Chrome,3,1740760871,1740760874,1740760874.40172,-21600,,
com.microsoft.VSCode,3,1740760868,1740760871,1740760872.01422,-21600,,
com.google.Chrome,1,1740760867,1740760868,1740760868.516522,-21600,,
com.microsoft.VSCode,6,1740760861,1740760867,1740760867.549588,-21600,,
com.google.Chrome,12,1740760849,1740760861,1740760861.690501,-21600,,
com.microsoft.VSCode,4,1740760845,1740760849,1740760849.600091,-21600,,
com.google.Chrome,0,1740760845,1740760845,1740760846.010977,-21600,,
com.microsoft.VSCode,4,1740760841,1740760845,1740760845.199154,-21600,,
com.google.Chrome,1,1740760840,1740760841,1740760841.8201652,-21600,,
com.microsoft.VSCode,1,1740760839,1740760840,1740760840.248849,-21600,,
com.google.Chrome,6,1740760833,1740760839,1740760839.497069,-21600,,
com.microsoft.VSCode,4,1740760829,1740760833,1740760833.703329,-21600,,
com.google.Chrome,3,1740760826,1740760829,1740760829.950543,-21600,,
com.microsoft.VSCode,9,1740760817,1740760826,1740760826.81796,-21600,,
com.google.Chrome,42,1740760775,1740760817,1740760817.5300632,-21600,,
com.microsoft.VSCode,10,1740760765,1740760775,1740760776.03187,-21600,,
com.apple.news,405,1740760360,1740760765,1740760765.793252,-21600,,
com.microsoft.VSCode,95,1740760265,1740760360,1740760360.238733,-21600,,
com.google.Chrome,1,1740760264,1740760265,1740760265.654978,-21600,,
com.microsoft.VSCode,171,1740760093,1740760264,1740760264.295264,-21600,,
com.google.Chrome,14,1740760079,1740760093,1740760093.12584,-21600,,
com.microsoft.VSCode,200,1740759879,1740760079,1740760079.5464048,-21600,,
com.google.Chrome,23,1740759856,1740759879,1740759879.650526,-21600,,
com.microsoft.VSCode,30,1740759826,1740759856,1740759856.595272,-21600,,
com.google.Chrome,5,1740759821,1740759826,1740759826.7914891,-21600,,
com.microsoft.VSCode,7,1740759814,1740759821,1740759821.4389539,-21600,,
com.google.Chrome,5,1740759809,1740759814,1740759814.986242,-21600,,
com.microsoft.VSCode,45,1740759764,1740759809,1740759809.806108,-21600,,
com.google.Chrome,6,1740759758,1740759764,1740759764.705762,-21600,,
com.microsoft.VSCode,31,1740759727,1740759758,1740759758.299315,-21600,,
com.google.Chrome,2,1740759725,1740759727,1740759727.358029,-21600,,
com.google.Chrome,447,1740758749,1740759196,1740759196.193126,-21600,,
com.leomehlig.today,94,1740758655,1740758749,1740758749.8333921,-21600,,
com.google.Chrome,8,1740758647,1740758655,1740758655.414877,-21600,,
com.google.Chrome,411,1740758234,1740758645,1740758645.480135,-21600,,
com.microsoft.VSCode,33,1740758201,1740758234,1740758234.129798,-21600,,
com.apple.finder,2,1740758199,1740758201,1740758201.265348,-21600,,
com.google.Chrome,38,1740758161,1740758199,1740758199.610273,-21600,,
com.microsoft.VSCode,8,1740758153,1740758161,1740758162.240868,-21600,,
com.leomehlig.today,15,1740758138,1740758153,1740758153.728425,-21600,,
com.microsoft.VSCode,1,1740758137,1740758138,1740758139.036387,-21600,,
com.google.Chrome,55,1740758082,1740758137,1740758137.629704,-21600,,
com.apple.finder,46,1740758006,1740758052,1740758052.281065,-21600,,
com.google.Chrome,3,1740758003,1740758006,1740758006.677459,-21600,,
com.apple.finder,1,1740758002,1740758003,1740758003.181081,-21600,,
com.google.Chrome,17,1740757985,1740758002,1740758002.5578961,-21600,,
com.apple.finder,10,1740757975,1740757985,1740757985.3386168,-21600,,
com.google.Chrome,13,1740757962,1740757975,1740757975.270303,-21600,,
com.apple.finder,16,1740757946,1740757962,1740757962.907895,-21600,,
com.google.Chrome,12,1740757934,1740757946,1740757946.5445971,-21600,,
com.apple.finder,45,1740757889,1740757934,1740757934.48743,-21600,,
com.microsoft.VSCode,12,1740757877,1740757889,1740757889.961642,-21600,,
com.google.Chrome,21,1740757856,1740757877,1740757877.129844,-21600,,
com.microsoft.VSCode,68,1740757788,1740757856,1740757856.764185,-21600,,
com.apple.finder,47,1740757741,1740757788,1740757788.787589,-21600,,
com.microsoft.VSCode,22,1740757719,1740757741,1740757742.050959,-21600,,
com.google.Chrome,19,1740757700,1740757719,1740757720.034549,-21600,,
com.microsoft.VSCode,4,1740757696,1740757700,1740757700.177542,-21600,,
com.apple.finder,4,1740757692,1740757696,1740757696.512804,-21600,,
com.microsoft.VSCode,67,1740757625,1740757692,1740757692.0728002,-21600,,
com.apple.finder,20,1740757605,1740757625,1740757625.3022509,-21600,,
com.microsoft.VSCode,1,1740757604,1740757605,1740757605.0688949,-21600,,
com.google.Chrome,1,1740757603,1740757604,1740757604.170721,-21600,,
com.microsoft.VSCode,27,1740757576,1740757603,1740757603.107819,-21600,,
com.google.Chrome,111,1740757465,1740757576,1740757576.575368,-21600,,
com.microsoft.VSCode,41,1740757424,1740757465,1740757465.641896,-21600,,
com.leomehlig.today,25,1740757399,1740757424,1740757424.082397,-21600,,
com.microsoft.VSCode,4,1740757395,1740757399,1740757399.7333689,-21600,,
com.apple.finder,20,1740757375,1740757395,1740757395.869766,-21600,,
com.microsoft.VSCode,169,1740757206,1740757375,1740757375.156997,-21600,,
com.google.Chrome,54,1740757152,1740757206,1740757206.5698109,-21600,,
com.microsoft.VSCode,27,1740757125,1740757152,1740757153.031652,-21600,,
com.google.Chrome,47,1740757078,1740757125,1740757125.796945,-21600,,
com.microsoft.VSCode,33,1740757045,1740757078,1740757078.808896,-21600,,
com.google.Chrome,12,1740757033,1740757045,1740757045.537708,-21600,,
com.microsoft.VSCode,8,1740757025,1740757033,1740757033.5749478,-21600,,
com.google.Chrome,1,1740757024,1740757025,1740757025.7353082,-21600,,
com.microsoft.VSCode,2,1740757022,1740757024,1740757024.6990972,-21600,,
com.google.Chrome,1,1740757021,1740757022,1740757022.188633,-21600,,
com.microsoft.VSCode,3,1740757018,1740757021,1740757021.079977,-21600,,
com.google.Chrome,3,1740757015,1740757018,1740757018.4400458,-21600,,
com.microsoft.VSCode,7,1740757008,1740757015,1740757015.657748,-21600,,
com.google.Chrome,8,1740757000,1740757008,1740757008.110046,-21600,,
com.microsoft.VSCode,5,1740756995,1740757000,1740757000.9626951,-21600,,
com.google.Chrome,3,1740756992,1740756995,1740756995.38289,-21600,,
com.microsoft.VSCode,1,1740756991,1740756992,1740756992.399126,-21600,,
com.google.Chrome,40,1740756951,1740756991,1740756991.113171,-21600,,
com.microsoft.VSCode,15,1740756936,1740756951,1740756951.052033,-21600,,
com.google.Chrome,4,1740756932,1740756936,1740756937.040615,-21600,,
com.microsoft.VSCode,35,1740756897,1740756932,1740756932.598777,-21600,,
com.google.Chrome,4,1740756893,1740756897,1740756897.144686,-21600,,
com.microsoft.VSCode,504,1740756389,1740756893,1740756893.677453,-21600,,
com.google.Chrome,22,1740756367,1740756389,1740756389.5406651,-21600,,
com.microsoft.VSCode,95,1740756272,1740756367,1740756367.792029,-21600,,
com.google.Chrome,44,1740756228,1740756272,1740756272.420351,-21600,,
com.microsoft.VSCode,1,1740756227,1740756228,1740756228.6638079,-21600,,
com.google.Chrome,68,1740756159,1740756227,1740756227.912962,-21600,,
com.microsoft.VSCode,85,1740756074,1740756159,1740756159.448543,-21600,,
com.google.Chrome,5,1740756069,1740756074,1740756074.938107,-21600,,
com.microsoft.VSCode,12,1740756057,1740756069,1740756069.941261,-21600,,
com.google.Chrome,2,1740756055,1740756057,1740756057.2445168,-21600,,
com.microsoft.VSCode,14,1740756041,1740756055,1740756055.671593,-21600,,
com.google.Chrome,23,1740756018,1740756041,1740756041.296574,-21600,,
com.microsoft.VSCode,5,1740756013,1740756018,1740756018.2971249,-21600,,
com.google.Chrome,5,1740756008,1740756013,1740756013.525408,-21600,,
com.microsoft.VSCode,130,1740755878,1740756008,1740756008.8080149,-21600,,
com.google.Chrome,72,1740755806,1740755878,1740755878.364296,-21600,,
com.microsoft.VSCode,74,1740755732,1740755806,1740755806.728242,-21600,,
com.google.Chrome,3,1740755729,1740755732,1740755732.2041621,-21600,,
com.toyopagroup.picaboo,30,1740755681,1740755711,1740755711.1740022,-21600,EB445137-D7F5-57EC-87DA-1DB460D64046,"iPhone13,2"
com.apple.weather,2,1740755677,1740755679,1740755679.707127,-21600,EB445137-D7F5-57EC-87DA-1DB460D64046,"iPhone13,2"
com.apple.weather,6,1740754804,1740754810,1740754810.542598,-21600,EB445137-D7F5-57EC-87DA-1DB460D64046,"iPhone13,2"
com.apple.Health,10,1740754793,1740754803,1740754803.53898,-21600,EB445137-D7F5-57EC-87DA-1DB460D64046,"iPhone13,2"
com.renpho.health,7,1740754784,1740754791,1740754791.49255,-21600,EB445137-D7F5-57EC-87DA-1DB460D64046,"iPhone13,2"
com.renpho.health,32,1740753956,1740753988,1740753988.4491792,-21600,EB445137-D7F5-57EC-87DA-1DB460D64046,"iPhone13,2"
com.google.ios.youtube,1039,1740752873,1740753912,1740753913.002479,-21600,EB445137-D7F5-57EC-87DA-1DB460D64046,"iPhone13,2"
com.google.ios.youtube,63,1740752774,1740752837,1740752837.494853,-21600,EB445137-D7F5-57EC-87DA-1DB460D64046,"iPhone13,2"
com.microsoft.Office.Outlook,30,1740752346,1740752376,1740752376.9190679,-21600,EB445137-D7F5-57EC-87DA-1DB460D64046,"iPhone13,2"
com.google.Gmail,6,1740752191,1740752197,1740752197.607884,-21600,EB445137-D7F5-57EC-87DA-1DB460D64046,"iPhone13,2"
com.apple.news,27,1740720656,1740720683,1740720683.277087,-21600,EB445137-D7F5-57EC-87DA-1DB460D64046,"iPhone13,2"
com.thestorygraph.thestorygraph,121,1740720526,1740720647,1740720647.817083,-21600,EB445137-D7F5-57EC-87DA-1DB460D64046,"iPhone13,2"
com.thestorygraph.thestorygraph,25,1740720499,1740720524,1740720524.959743,-21600,EB445137-D7F5-57EC-87DA-1DB460D64046,"iPhone13,2"
com.apple.Health,115,1740717359,1740717474,1740717474.861415,-21600,EB445137-D7F5-57EC-87DA-1DB460D64046,"iPhone13,2"
com.google.Chrome,301,1740715429,1740715730,1740715730.930766,-21600,,
com.apple.finder,9,1740715420,1740715429,1740715430.003327,-21600,,
com.apple.podcasts,4,1740714302,1740714306,1740714309.486995,-21600,EB445137-D7F5-57EC-87DA-1DB460D64046,"iPhone13,2"
com.intsig.CamScannerLite,1,1740714301,1740714302,1740714308.662205,-21600,EB445137-D7F5-57EC-87DA-1DB460D64046,"iPhone13,2"
com.apple.finder,6,1740713485,1740713491,1740713491.39065,-21600,,
com.leomehlig.today,56,1740713429,1740713485,1740713485.9765081,-21600,,
com.apple.finder,1,1740713428,1740713429,1740713429.6363158,-21600,,
com.google.Chrome,9,1740713419,1740713428,1740713428.31546,-21600,,
com.apple.finder,33,1740713386,1740713419,1740713420.027818,-21600,,
com.intsig.CamScannerLite,90,1740713302,1740713392,1740713393.267261,-21600,EB445137-D7F5-57EC-87DA-1DB460D64046,"iPhone13,2"
com.google.Chrome,619,1740712767,1740713386,1740713386.175262,-21600,,
com.myfitnesspal.mfp,59,1740712446,1740712505,1740712505.522104,-21600,EB445137-D7F5-57EC-87DA-1DB460D64046,"iPhone13,2"
com.intsig.CamScannerLite,6,1740712438,1740712444,1740712444.064135,-21600,EB445137-D7F5-57EC-87DA-1DB460D64046,"iPhone13,2"
com.google.Chrome,303,1740712421,1740712724,1740712724.038279,-21600,,
com.leomehlig.today,30,1740712391,1740712421,1740712421.809328,-21600,,
com.google.Chrome,2,1740712389,1740712391,1740712391.302423,-21600,,
com.apple.iCal,4,1740712385,1740712389,1740712389.8732371,-21600,,
com.google.Chrome,28,1740712357,1740712385,1740712385.437135,-21600,,
com.leomehlig.today,19,1740712338,1740712357,1740712357.326803,-21600,,
com.google.Chrome,3,1740712335,1740712338,1740712338.640315,-21600,,
com.leomehlig.today,4,1740712331,1740712335,1740712335.714388,-21600,,
com.intsig.CamScannerLite,58,1740712289,1740712347,1740712347.925137,-21600,EB445137-D7F5-57EC-87DA-1DB460D64046,"iPhone13,2"
com.google.Chrome,50,1740712281,1740712331,1740712331.8067741,-21600,,
com.apple.Music,3,1740712278,1740712281,1740712281.985124,-21600,,
com.google.Chrome,1,1740712277,1740712278,1740712278.208564,-21600,,
com.apple.Music,1,1740712276,1740712277,1740712277.607281,-21600,,
com.google.Chrome,8,1740712268,1740712276,1740712276.23702,-21600,,
com.apple.Music,149,1740712106,1740712255,1740712255.180904,-21600,,
com.intsig.CamScannerLite,221,1740712062,1740712283,1740712283.400383,-21600,EB445137-D7F5-57EC-87DA-1DB460D64046,"iPhone13,2"
com.apple.Music,2,1740712057,1740712059,1740712059.545965,-21600,EB445137-D7F5-57EC-87DA-1DB460D64046,"iPhone13,2"
com.leomehlig.today,65,1740712041,1740712106,1740712106.5238628,-21600,,
com.apple.Music,472,1740711569,1740712041,1740712041.333957,-21600,,
com.google.Chrome,257,1740711312,1740711569,1740711569.9815722,-21600,,
com.apple.Music,260,1740711052,1740711312,1740711312.185957,-21600,,
com.apple.Music,354,1740710491,1740710845,1740710845.234124,-21600,,
com.apple.Music,31,1740710484,1740710515,1740710516.021431,-21600,EB445137-D7F5-57EC-87DA-1DB460D64046,"iPhone13,2"
com.hnc.Discord,180,1740710311,1740710491,1740710491.3435678,-21600,,
com.apple.Preview,4,1740710307,1740710311,1740710311.3931,-21600,,
com.hnc.Discord,38,1740710269,1740710307,1740710308.011866,-21600,,
com.apple.finder,1,1740710268,1740710269,1740710269.277978,-21600,,
com.hnc.Discord,214,1740710054,1740710268,1740710268.8742619,-21600,,
com.apple.Preview,11,1740710043,1740710054,1740710054.771649,-21600,,
com.apple.finder,18,1740710025,1740710043,1740710043.611043,-21600,,
com.hnc.Discord,4,1740710021,1740710025,1740710025.628442,-21600,,
com.apple.finder,15,1740710006,1740710021,1740710022.00114,-21600,,
com.leomehlig.today,1,1740710005,1740710006,1740710006.570074,-21600,,
com.google.Chrome,14,1740709991,1740710005,1740710005.863862,-21600,,
com.apple.Music,37,1740709954,1740709991,1740709991.1204128,-21600,,
com.google.Chrome,26,1740709928,1740709954,1740709954.940047,-21600,,
com.apple.Music,6,1740709773,1740709779,1740709780.358043,-21600,EB445137-D7F5-57EC-87DA-1DB460D64046,"iPhone13,2"
com.apple.Music,18,1740709007,1740709025,1740709026.3214931,-21600,EB445137-D7F5-57EC-87DA-1DB460D64046,"iPhone13,2"
com.leomehlig.today,10,1740708990,1740709000,1740709000.768873,-21600,EB445137-D7F5-57EC-87DA-1DB460D64046,"iPhone13,2"
com.leomehlig.today,44,1740708755,1740708799,1740708802.4329371,-21600,EB445137-D7F5-57EC-87DA-1DB460D64046,"iPhone13,2"
com.groupme.iphone-app,4,1740708732,1740708736,1740708736.956249,-21600,EB445137-D7F5-57EC-87DA-1DB460D64046,"iPhone13,2"
com.google.Chrome,352,1740705927,1740706279,1740706279.222729,-21600,,
com.groupme.iphone-app,23,1740704152,1740704175,1740704175.9179,-21600,EB445137-D7F5-57EC-87DA-1DB460D64046,"iPhone13,2"
Astrospheric.Astrospheric,0,1740704152,1740704152,1740704152.986264,-21600,EB445137-D7F5-57EC-87DA-1DB460D64046,"iPhone13,2"
com.google.Chrome,316,1740704082,1740704398,1740704398.01793,-21600,,
com.apple.MobileSMS,8,1740704074,1740704082,1740704082.2943668,-21600,,
com.google.Chrome,6,1740704068,1740704074,1740704074.416123,-21600,,
com.apple.MobileSMS,17,1740704051,1740704068,1740704068.0719008,-21600,,
com.google.Chrome,13,1740704038,1740704051,1740704051.741091,-21600,,
com.leomehlig.today,2,1740704036,1740704038,1740704039.350772,-21600,,
Astrospheric.Astrospheric,55,1740700270,1740700325,1740700325.527032,-21600,EB445137-D7F5-57EC-87DA-1DB460D64046,"iPhone13,2"
com.leomehlig.today,102,1740699829,1740699931,1740699931.599218,-21600,,
com.apple.weather,8,1740699817,1740699825,1740699825.726416,-21600,EB445137-D7F5-57EC-87DA-1DB460D64046,"iPhone13,2"
com.ryansponzilli.DeepSkyCatalog,8,1740699808,1740699816,1740699816.993623,-21600,EB445137-D7F5-57EC-87DA-1DB460D64046,"iPhone13,2"
Astrospheric.Astrospheric,23,1740699785,1740699808,1740699808.465942,-21600,EB445137-D7F5-57EC-87DA-1DB460D64046,"iPhone13,2"
com.tier9digital.sundial,19,1740699766,1740699785,1740699785.742947,-21600,EB445137-D7F5-57EC-87DA-1DB460D64046,"iPhone13,2"
com.ryansponzilli.DeepSkyCatalog,2,1740699764,1740699766,1740699766.267223,-21600,EB445137-D7F5-57EC-87DA-1DB460D64046,"iPhone13,2"
com.google.Chrome,80,1740699749,1740699829,1740699829.149538,-21600,,
com.leomehlig.today,5,1740699744,1740699749,1740699750.944509,-21600,,
com.apple.iCal,6,1740699738,1740699744,1740699744.445781,-21600,,
com.groupme.iphone-app,34,1740699699,1740699733,1740699733.921772,-21600,EB445137-D7F5-57EC-87DA-1DB460D64046,"iPhone13,2"
com.hammerandchisel.discord,10,1740699687,1740699697,1740699697.9208488,-21600,EB445137-D7F5-57EC-87DA-1DB460D64046,"iPhone13,2"
com.apple.weather,2,1740699678,1740699680,1740699680.668864,-21600,EB445137-D7F5-57EC-87DA-1DB460D64046,"iPhone13,2"
Astrospheric.Astrospheric,34,1740699644,1740699678,1740699679.004277,-21600,EB445137-D7F5-57EC-87DA-1DB460D64046,"iPhone13,2"
com.apple.mobileslideshow,3,1740699639,1740699642,1740699642.845103,-21600,EB445137-D7F5-57EC-87DA-1DB460D64046,"iPhone13,2"
com.leomehlig.today,119,1740699619,1740699738,1740699738.7905788,-21600,,
com.apple.finder,3,1740699616,1740699619,1740699619.721489,-21600,,
com.apple.mobileslideshow,38,1740699576,1740699614,1740699615.199709,-21600,EB445137-D7F5-57EC-87DA-1DB460D64046,"iPhone13,2"
com.apple.finder,3,1740698992,1740698995,1740698995.479045,-21600,,
com.apple.MobileSMS,19,1740698973,1740698992,1740698992.6914759,-21600,,
com.myfitnesspal.mfp,223,1740698737,1740698960,1740698960.7193809,-21600,EB445137-D7F5-57EC-87DA-1DB460D64046,"iPhone13,2"
com.leomehlig.today,2,1740698702,1740698704,1740698704.722859,-21600,EB445137-D7F5-57EC-87DA-1DB460D64046,"iPhone13,2"
com.apple.MobileSMS,525,1740697720,1740698245,1740698245.918571,-21600,,
com.apple.FaceTime,5,1740697715,1740697720,1740697721.0534039,-21600,,
com.apple.MobileSMS,25,1740697690,1740697715,1740697715.8544269,-21600,,
com.apple.findmy,1,1740697689,1740697690,1740697690.4060268,-21600,,
com.apple.MobileSMS,1,1740697688,1740697689,1740697689.896306,-21600,,
com.apple.findmy,6,1740697682,1740697688,1740697689.022111,-21600,,
com.apple.MobileSMS,6,1740697676,1740697682,1740697683.0158591,-21600,,
com.apple.Preview,18,1740697658,1740697676,1740697676.9214702,-21600,,
com.apple.Preview,305,1740696815,1740697120,1740697120.673692,-21600,,
com.apple.finder,10,1740696805,1740696815,1740696815.388437,-21600,,
com.leomehlig.today,71,1740696734,1740696805,1740696805.443399,-21600,,
com.apple.finder,30,1740696704,1740696734,1740696734.4696321,-21600,,
com.apple.iCal,42,1740696662,1740696704,1740696704.3661761,-21600,,
com.google.Chrome,45,1740696617,1740696662,1740696662.773212,-21600,,
com.apple.finder,33,1740696584,1740696617,1740696617.810985,-21600,,
com.google.Chrome,4,1740696580,1740696584,1740696584.263495,-21600,,
com.leomehlig.today,45,1740696535,1740696580,1740696580.497026,-21600,,
com.apple.finder,2,1740696533,1740696535,1740696535.264169,-21600,,
com.google.Chrome,21,1740696512,1740696533,1740696533.737623,-21600,,
com.apple.finder,3,1740696497,1740696500,1740696500.5154881,-21600,,
com.leomehlig.today,1,1740696496,1740696497,1740696497.996667,-21600,,
com.google.Chrome,41,1740696455,1740696496,1740696496.289113,-21600,,
com.leomehlig.today,11,1740696421,1740696432,1740696432.9113,-21600,EB445137-D7F5-57EC-87DA-1DB460D64046,"iPhone13,2"
com.leomehlig.today,78,1740696377,1740696455,1740696455.553407,-21600,,
com.microsoft.Outlook,2,1740696375,1740696377,1740696377.8877258,-21600,,
com.apple.iCal,64,1740696311,1740696375,1740696375.873176,-21600,,
com.microsoft.Outlook,4,1740696307,1740696311,1740696311.335866,-21600,,
com.apple.iCal,0,1740696307,1740696307,1740696307.987246,-21600,,
com.leomehlig.today,4,1740696303,1740696307,1740696307.156066,-21600,,
com.hammerandchisel.discord,66,1740696302,1740696368,1740696368.609808,-21600,EB445137-D7F5-57EC-87DA-1DB460D64046,"iPhone13,2"
Astrospheric.Astrospheric,46,1740696253,1740696299,1740696299.361912,-21600,EB445137-D7F5-57EC-87DA-1DB460D64046,"iPhone13,2"
com.apple.findmy,3,1740696241,1740696244,1740696246.404666,-21600,EB445137-D7F5-57EC-87DA-1DB460D64046,"iPhone13,2"
com.apple.findmy,15,1740696222,1740696237,1740696237.880619,-21600,EB445137-D7F5-57EC-87DA-1DB460D64046,"iPhone13,2"
com.tinyspeck.chatlyio,54,1740696162,1740696216,1740696216.765808,-21600,EB445137-D7F5-57EC-87DA-1DB460D64046,"iPhone13,2"
com.groupme.iphone-app,30,1740696116,1740696146,1740696146.212308,-21600,EB445137-D7F5-57EC-87DA-1DB460D64046,"iPhone13,2"
com.google.chrome.ios,1,1740696115,1740696116,1740696116.7165132,-21600,EB445137-D7F5-57EC-87DA-1DB460D64046,"iPhone13,2"
com.google.Chrome,211,1740696092,1740696303,1740696303.969656,-21600,,
com.google.chrome.ios,21,1740695612,1740695633,1740695633.92423,-21600,EB445137-D7F5-57EC-87DA-1DB460D64046,"iPhone13,2"
com.apple.CoreAuthUI,2,1740695076,1740695078,1740695078.8806539,-21600,EB445137-D7F5-57EC-87DA-1DB460D64046,"iPhone13,2"
com.clairmail.fth.client,19,1740695070,1740695089,1740695089.938809,-21600,EB445137-D7F5-57EC-87DA-1DB460D64046,"iPhone13,2"
com.intsig.CamScannerLite,2,1740695059,1740695061,1740695061.5724401,-21600,EB445137-D7F5-57EC-87DA-1DB460D64046,"iPhone13,2"
com.google.Chrome,321,1740694041,1740694362,1740694362.5805368,-21600,,
com.apple.findmy,40,1740694001,1740694041,1740694041.2520862,-21600,,
com.google.Chrome,5,1740693996,1740694001,1740694001.4840841,-21600,,
com.leomehlig.today,5,1740693991,1740693996,1740693996.52993,-21600,,
com.google.Chrome,457,1740693534,1740693991,1740693991.517921,-21600,,
com.apple.MobileSMS,2,1740693532,1740693534,1740693534.21248,-21600,,
com.google.Chrome,70,1740693462,1740693532,1740693533.057006,-21600,,
com.apple.MobileSMS,10,1740693452,1740693462,1740693462.634974,-21600,,
com.apple.finder,2,1740693450,1740693452,1740693452.4383922,-21600,,
com.leomehlig.today,20,1740693430,1740693450,1740693450.820262,-21600,,
com.google.Chrome,53,1740693377,1740693430,1740693430.589113,-21600,,
com.apple.finder,2,1740693375,1740693377,1740693377.468046,-21600,,
com.intsig.CamScannerLite,70,1740693334,1740693404,1740693405.146316,-21600,EB445137-D7F5-57EC-87DA-1DB460D64046,"iPhone13,2"
com.microsoft.Office.Outlook,2,1740693328,1740693330,1740693330.5481439,-21600,EB445137-D7F5-57EC-87DA-1DB460D64046,"iPhone13,2"
com.microsoft.Office.Outlook,17,1740693202,1740693219,1740693219.664043,-21600,EB445137-D7F5-57EC-87DA-1DB460D64046,"iPhone13,2"
Astrospheric.Astrospheric,51,1740693140,1740693191,1740693191.859599,-21600,EB445137-D7F5-57EC-87DA-1DB460D64046,"iPhone13,2"
Astrospheric.Astrospheric,6,1740693133,1740693139,1740693139.879085,-21600,EB445137-D7F5-57EC-87DA-1DB460D64046,"iPhone13,2"
com.google.Chrome,248,1740693127,1740693375,1740693375.630528,-21600,,
Astrospheric.Astrospheric,10,1740693006,1740693016,1740693016.634942,-21600,EB445137-D7F5-57EC-87DA-1DB460D64046,"iPhone13,2"
com.google.Chrome,9,1740692668,1740692677,1740692677.851356,-21600,,
com.google.Chrome,316,1740691061,1740691377,1740691377.0288548,-21600,,
com.apple.Passwords,5,1740691056,1740691061,1740691061.507998,-21600,,
com.apple.calculator,4,1740691052,1740691056,1740691056.169455,-21600,,
com.apple.calculator,337,1740687209,1740687546,1740687546.922962,-21600,,
com.google.Chrome,2,1740687207,1740687209,1740687209.105809,-21600,,
com.google.Chrome,339,1740686503,1740686842,1740686842.026056,-21600,,
com.apple.Passwords,7,1740686482,1740686489,1740686489.163055,-21600,,
com.google.Chrome,16,1740686466,1740686482,1740686482.428753,-21600,,
com.apple.finder,2,1740686464,1740686466,1740686467.8092132,-21600,,
com.leomehlig.today,1,1740686463,1740686464,1740686465.075983,-21600,,
com.apple.CoreAuthUI,1,1740686233,1740686234,1740686235.085741,-21600,EB445137-D7F5-57EC-87DA-1DB460D64046,"iPhone13,2"
com.apple.journal,2,1740686232,1740686234,1740686234.8133001,-21600,EB445137-D7F5-57EC-87DA-1DB460D64046,"iPhone13,2"
com.leomehlig.today,63,1740685055,1740685118,1740685118.4824228,-21600,,
com.apple.iCal,1,1740685054,1740685055,1740685055.846993,-21600,,
com.apple.journal,45,1740684765,1740684810,1740684810.966907,-21600,EB445137-D7F5-57EC-87DA-1DB460D64046,"iPhone13,2"
com.microsoft.onenote.mac,302,1740684752,1740685054,1740685054.6852279,-21600,,
com.apple.iCal,2,1740684750,1740684752,1740684752.642205,-21600,,
com.microsoft.onenote.mac,3,1740684747,1740684750,1740684750.962394,-21600,,
com.apple.iCal,14,1740684733,1740684747,1740684747.099835,-21600,,
com.microsoft.onenote.mac,0,1740684733,1740684733,1740684733.9969501,-21600,,
com.apple.iCal,4,1740684729,1740684733,1740684733.200931,-21600,,
com.microsoft.onenote.mac,3,1740684726,1740684729,1740684729.674022,-21600,,
com.apple.iCal,1,1740684725,1740684726,1740684726.5405211,-21600,,
com.microsoft.onenote.mac,12,1740684713,1740684725,1740684725.246043,-21600,,
com.apple.CoreAuthUI,4,1740684673,1740684677,1740684677.532362,-21600,EB445137-D7F5-57EC-87DA-1DB460D64046,"iPhone13,2"
com.apple.journal,67,1740684671,1740684738,1740684738.735375,-21600,EB445137-D7F5-57EC-87DA-1DB460D64046,"iPhone13,2"
Astrospheric.Astrospheric,2,1740684664,1740684666,1740684666.227892,-21600,EB445137-D7F5-57EC-87DA-1DB460D64046,"iPhone13,2"
com.apple.iCal,62,1740684651,1740684713,1740684713.6301398,-21600,,
com.microsoft.onenote.mac,5,1740684646,1740684651,1740684651.798723,-21600,,
com.apple.Notes,42,1740684599,1740684641,1740684641.4276562,-21600,,
com.leomehlig.today,27,1740684572,1740684599,1740684599.128962,-21600,,
Astrospheric.Astrospheric,79,1740684467,1740684546,1740684546.969182,-21600,EB445137-D7F5-57EC-87DA-1DB460D64046,"iPhone13,2"
com.google.chrome.ios,2,1740684463,1740684465,1740684465.464093,-21600,EB445137-D7F5-57EC-87DA-1DB460D64046,"iPhone13,2"
com.hnc.Discord,150,1740684422,1740684572,1740684572.337311,-21600,,
com.leomehlig.today,19,1740684403,1740684422,1740684422.9002628,-21600,,
com.google.Chrome,6,1740684397,1740684403,1740684403.754859,-21600,,
com.google.chrome.ios,177,1740682650,1740682827,1740682827.7248359,-21600,EB445137-D7F5-57EC-87DA-1DB460D64046,"iPhone13,2"
com.google.chrome.ios,160,1740682432,1740682592,1740682592.65463,-21600,EB445137-D7F5-57EC-87DA-1DB460D64046,"iPhone13,2"
com.apple.news,2,1740682430,1740682432,1740682436.833943,-21600,EB445137-D7F5-57EC-87DA-1DB460D64046,"iPhone13,2"
com.apple.news,136,1740681311,1740681447,1740681448.7573771,-21600,EB445137-D7F5-57EC-87DA-1DB460D64046,"iPhone13,2"
com.apple.CoreAuthUI,1,1740680670,1740680671,1740680671.993541,-21600,EB445137-D7F5-57EC-87DA-1DB460D64046,"iPhone13,2"
com.apple.journal,116,1740680668,1740680784,1740680784.7822351,-21600,EB445137-D7F5-57EC-87DA-1DB460D64046,"iPhone13,2"
com.apple.CoreAuthUI,2,1740680501,1740680503,1740680503.818727,-21600,EB445137-D7F5-57EC-87DA-1DB460D64046,"iPhone13,2"
com.apple.journal,100,1740680499,1740680599,1740680599.8070478,-21600,EB445137-D7F5-57EC-87DA-1DB460D64046,"iPhone13,2"
com.apple.Health,18,1740680475,1740680493,1740680493.087834,-21600,EB445137-D7F5-57EC-87DA-1DB460D64046,"iPhone13,2"
com.myfitnesspal.mfp,0,1740680475,1740680475,1740680476.420763,-21600,EB445137-D7F5-57EC-87DA-1DB460D64046,"iPhone13,2"
com.myfitnesspal.mfp,1,1740680473,1740680474,1740680474.5799499,-21600,EB445137-D7F5-57EC-87DA-1DB460D64046,"iPhone13,2"
com.myfitnesspal.mfp,101,1740680289,1740680390,1740680391.4505801,-21600,EB445137-D7F5-57EC-87DA-1DB460D64046,"iPhone13,2"
com.apple.mobilecal,10,1740680269,1740680279,1740680279.042602,-21600,EB445137-D7F5-57EC-87DA-1DB460D64046,"iPhone13,2"
com.microsoft.Office.Outlook,8,1740680257,1740680265,1740680265.579771,-21600,EB445137-D7F5-57EC-87DA-1DB460D64046,"iPhone13,2"
com.apple.weather,0,1740680257,1740680257,1740680257.799226,-21600,EB445137-D7F5-57EC-87DA-1DB460D64046,"iPhone13,2"
com.apple.weather,3,1740678976,1740678979,1740678979.531213,-21600,EB445137-D7F5-57EC-87DA-1DB460D64046,"iPhone13,2"
com.instructure.icanvas,2,1740678974,1740678976,1740678976.2320318,-21600,EB445137-D7F5-57EC-87DA-1DB460D64046,"iPhone13,2"
com.google.Chrome,96,1740678871,1740678967,1740678967.570338,-21600,,
com.leomehlig.today,2,1740678869,1740678871,1740678871.1342611,-21600,,
com.instructure.icanvas,24,1740678843,1740678867,1740678867.871293,-21600,EB445137-D7F5-57EC-87DA-1DB460D64046,"iPhone13,2"
com.ryansponzilli.DeepSkyCatalog,0,1740678843,1740678843,1740678843.628022,-21600,EB445137-D7F5-57EC-87DA-1DB460D64046,"iPhone13,2"
com.ryansponzilli.DeepSkyCatalog,2,1740678590,1740678592,1740678592.277792,-21600,EB445137-D7F5-57EC-87DA-1DB460D64046,"iPhone13,2"
com.leomehlig.today,61,1740678306,1740678367,1740678367.6090732,-21600,,
com.ryansponzilli.DeepSkyCatalog,22,1740676934,1740676956,1740676956.793508,-21600,EB445137-D7F5-57EC-87DA-1DB460D64046,"iPhone13,2"
com.hammerandchisel.discord,10,1740676922,1740676932,1740676932.619909,-21600,EB445137-D7F5-57EC-87DA-1DB460D64046,"iPhone13,2"
com.google.Chrome,1414,1740676892,1740678306,1740678307.0537071,-21600,,
com.hammerandchisel.discord,3,1740676387,1740676390,1740676390.7420192,-21600,EB445137-D7F5-57EC-87DA-1DB460D64046,"iPhone13,2"
com.google.Chrome,583,1740676235,1740676818,1740676818.7987251,-21600,,
com.google.Chrome,308,1740675691,1740675999,1740675999.5171251,-21600,,
com.leomehlig.today,15,1740675676,1740675691,1740675691.656479,-21600,,
com.google.Chrome,223,1740675453,1740675676,1740675676.111681,-21600,,
com.leomehlig.today,35,1740675418,1740675453,1740675454.256474,-21600,,
com.apple.finder,48,1740675370,1740675418,1740675418.221534,-21600,,
com.microsoft.VSCode,5,1740675365,1740675370,1740675370.6973739,-21600,,
com.google.Chrome,69,1740675296,1740675365,1740675365.575416,-21600,,
com.microsoft.VSCode,73,1740675198,1740675271,1740675271.813202,-21600,,
com.google.Chrome,43,1740675155,1740675198,1740675198.549995,-21600,,
com.microsoft.VSCode,44,1740675111,1740675155,1740675155.396636,-21600,,
com.apple.finder,11,1740675100,1740675111,1740675111.764786,-21600,,
com.microsoft.VSCode,28,1740675072,1740675100,1740675100.738548,-21600,,
com.google.Chrome,8,1740675064,1740675072,1740675072.6559849,-21600,,
com.microsoft.VSCode,167,1740674897,1740675064,1740675064.854447,-21600,,
com.google.Chrome,67,1740674830,1740674897,1740674897.776822,-21600,,
com.hammerandchisel.discord,11,1740673772,1740673783,1740673784.118921,-21600,EB445137-D7F5-57EC-87DA-1DB460D64046,"iPhone13,2"
Astrospheric.Astrospheric,23,1740673744,1740673767,1740673767.8848639,-21600,EB445137-D7F5-57EC-87DA-1DB460D64046,"iPhone13,2"
com.apple.weather,11,1740673726,1740673737,1740673738.031049,-21600,EB445137-D7F5-57EC-87DA-1DB460D64046,"iPhone13,2"
com.apple.Health,26,1740673688,1740673714,1740673714.662644,-21600,EB445137-D7F5-57EC-87DA-1DB460D64046,"iPhone13,2"
com.ebay.iphone,20,1740673653,1740673673,1740673673.484136,-21600,EB445137-D7F5-57EC-87DA-1DB460D64046,"iPhone13,2"
com.microsoft.Office.Outlook,2,1740673651,1740673653,1740673653.47821,-21600,EB445137-D7F5-57EC-87DA-1DB460D64046,"iPhone13,2"
com.microsoft.VSCode,1584,1740673246,1740674830,1740674831.038437,-21600,,
com.google.Chrome,6,1740673240,1740673246,1740673246.914229,-21600,,
com.microsoft.VSCode,2,1740673238,1740673240,1740673240.88924,-21600,,
com.google.Chrome,1,1740673237,1740673238,1740673238.180131,-21600,,
com.microsoft.VSCode,10,1740673227,1740673237,1740673237.748232,-21600,,
com.google.Chrome,5,1740673222,1740673227,1740673227.920383,-21600,,
com.microsoft.VSCode,15,1740673207,1740673222,1740673222.5050101,-21600,,
com.google.Chrome,4,1740673203,1740673207,1740673207.255395,-21600,,
com.microsoft.VSCode,0,1740673203,1740673203,1740673204.0544472,-21600,,
com.google.Chrome,5,1740673198,1740673203,1740673203.226665,-21600,,
com.microsoft.VSCode,8,1740673190,1740673198,1740673198.2927861,-21600,,
com.google.Chrome,3,1740673187,1740673190,1740673190.757073,-21600,,
com.microsoft.VSCode,2,1740673185,1740673187,1740673187.9979959,-21600,,
com.google.Chrome,2,1740673183,1740673185,1740673185.6472511,-21600,,
com.microsoft.VSCode,24,1740673159,1740673183,1740673183.658843,-21600,,
com.google.Chrome,1,1740673158,1740673159,1740673159.940829,-21600,,
com.microsoft.VSCode,6,1740673152,1740673158,1740673158.85409,-21600,,
com.google.Chrome,3,1740673149,1740673152,1740673152.706981,-21600,,
com.microsoft.VSCode,2,1740673147,1740673149,1740673149.7613192,-21600,,
com.google.Chrome,6,1740673141,1740673147,1740673147.8975449,-21600,,
com.microsoft.VSCode,113,1740673028,1740673141,1740673141.742025,-21600,,
com.google.Chrome,1,1740673027,1740673028,1740673028.676011,-21600,,
com.microsoft.VSCode,9,1740673018,1740673027,1740673027.811337,-21600,,
com.google.Chrome,5,1740673013,1740673018,1740673018.408041,-21600,,
com.microsoft.VSCode,39,1740672974,1740673013,1740673013.17328,-21600,,
com.google.Chrome,2,1740672972,1740672974,1740672974.680398,-21600,,
com.microsoft.VSCode,3,1740672969,1740672972,1740672972.287266,-21600,,
com.google.Chrome,7,1740672962,1740672969,1740672969.074592,-21600,,
com.microsoft.VSCode,74,1740672888,1740672962,1740672963.028775,-21600,,
com.google.Chrome,5,1740672883,1740672888,1740672889.003818,-21600,,
com.microsoft.VSCode,6,1740672877,1740672883,1740672883.8894892,-21600,,
com.google.Chrome,4,1740672873,1740672877,1740672877.870718,-21600,,
com.microsoft.Office.Outlook,13,1740672650,1740672663,1740672663.974076,-21600,EB445137-D7F5-57EC-87DA-1DB460D64046,"iPhone13,2"
com.renpho.health,1,1740672649,1740672650,1740672652.38557,-21600,EB445137-D7F5-57EC-87DA-1DB460D64046,"iPhone13,2"
com.microsoft.VSCode,396,1740672477,1740672873,1740672873.463917,-21600,,
com.google.Chrome,40,1740672437,1740672477,1740672478.070555,-21600,,
com.microsoft.VSCode,306,1740672131,1740672437,1740672437.654335,-21600,,
com.google.Chrome,2,1740672129,1740672131,1740672131.926975,-21600,,
com.microsoft.VSCode,2,1740672127,1740672129,1740672129.949655,-21600,,
com.google.Chrome,1,1740672126,1740672127,1740672127.8264298,-21600,,
com.microsoft.VSCode,4,1740672122,1740672126,1740672126.9509292,-21600,,
com.google.Chrome,1,1740672121,1740672122,1740672122.9653401,-21600,,
com.microsoft.VSCode,3,1740672118,1740672121,1740672122.0514,-21600,,
com.google.Chrome,2,1740672116,1740672118,1740672118.181071,-21600,,
com.microsoft.VSCode,1,1740672115,1740672116,1740672116.580996,-21600,,
com.google.Chrome,3,1740672112,1740672115,1740672115.387274,-21600,,
com.microsoft.VSCode,21,1740672091,1740672112,1740672112.6267,-21600,,
com.google.Chrome,4,1740672087,1740672091,1740672091.915586,-21600,,
com.microsoft.VSCode,1,1740672086,1740672087,1740672087.9041739,-21600,,
com.google.Chrome,49,1740672037,1740672086,1740672086.910114,-21600,,
com.microsoft.VSCode,2,1740672035,1740672037,1740672037.414813,-21600,,
com.google.Chrome,35,1740672000,1740672035,1740672035.346918,-21600,,
com.microsoft.VSCode,253,1740671747,1740672000,1740672000.8350348,-21600,,
com.google.Chrome,194,1740671553,1740671747,1740671747.323664,-21600,,
com.microsoft.VSCode,183,1740671370,1740671553,1740671553.862411,-21600,,
com.google.Chrome,17,1740671353,1740671370,1740671370.452752,-21600,,
com.microsoft.VSCode,8,1740671345,1740671353,1740671353.140849,-21600,,
com.google.Chrome,50,1740671295,1740671345,1740671345.917496,-21600,,
com.microsoft.VSCode,13,1740671282,1740671295,1740671295.8646579,-21600,,
com.google.Chrome,1,1740671281,1740671282,1740671282.769158,-21600,,
com.microsoft.VSCode,1,1740671280,1740671281,1740671281.739074,-21600,,
com.google.Chrome,9,1740671271,1740671280,1740671280.589594,-21600,,
com.microsoft.VSCode,21,1740671250,1740671271,1740671271.0982041,-21600,,
com.google.Chrome,2,1740671248,1740671250,1740671250.642274,-21600,,
com.microsoft.VSCode,3,1740671245,1740671248,1740671248.720835,-21600,,
com.google.Chrome,5,1740671240,1740671245,1740671245.6190429,-21600,,
com.microsoft.VSCode,29,1740671211,1740671240,1740671240.684029,-21600,,
com.google.Chrome,18,1740671193,1740671211,1740671211.7118878,-21600,,
com.microsoft.VSCode,69,1740671124,1740671193,1740671193.590534,-21600,,
com.google.Chrome,28,1740671096,1740671124,1740671124.1019979,-21600,,
com.microsoft.VSCode,1,1740671095,1740671096,1740671096.206636,-21600,,
com.google.Chrome,3,1740671092,1740671095,1740671095.299514,-21600,,
com.microsoft.VSCode,75,1740671017,1740671092,1740671092.3623009,-21600,,
com.google.Chrome,17,1740671000,1740671017,1740671017.922045,-21600,,
com.microsoft.VSCode,28,1740670972,1740671000,1740671000.0898361,-21600,,
com.google.Chrome,55,1740670917,1740670972,1740670972.866105,-21600,,
com.microsoft.VSCode,38,1740670879,1740670917,1740670917.052269,-21600,,
com.google.Chrome,13,1740670866,1740670879,1740670880.031466,-21600,,
com.microsoft.VSCode,5,1740670861,1740670866,1740670866.629942,-21600,,
com.google.Chrome,13,1740670848,1740670861,1740670861.1575022,-21600,,
com.microsoft.VSCode,9,1740670839,1740670848,1740670848.7357678,-21600,,
com.google.Chrome,41,1740670798,1740670839,1740670839.186977,-21600,,
com.microsoft.VSCode,7,1740670791,1740670798,1740670798.4236531,-21600,,
com.google.Chrome,386,1740670405,1740670791,1740670791.979002,-21600,,
com.microsoft.VSCode,37,1740670368,1740670405,1740670405.925891,-21600,,
com.google.Chrome,37,1740670331,1740670368,1740670368.864445,-21600,,
com.microsoft.VSCode,43,1740670288,1740670331,1740670331.825515,-21600,,
com.google.Chrome,52,1740670236,1740670288,1740670288.242508,-21600,,
com.microsoft.VSCode,10,1740670226,1740670236,1740670236.457066,-21600,,
com.google.Chrome,128,1740670098,1740670226,1740670226.185451,-21600,,
com.microsoft.VSCode,511,1740669587,1740670098,1740670098.493806,-21600,,
com.google.Chrome,157,1740669430,1740669587,1740669587.674807,-21600,,
com.microsoft.VSCode,60,1740669370,1740669430,1740669430.152801,-21600,,
com.google.Chrome,1,1740669369,1740669370,1740669370.514056,-21600,,
com.microsoft.VSCode,5,1740669364,1740669369,1740669369.481271,-21600,,
com.google.Chrome,109,1740669255,1740669364,1740669364.6917238,-21600,,
com.microsoft.VSCode,11,1740669244,1740669255,1740669255.2313719,-21600,,
com.google.Chrome,10,1740669234,1740669244,1740669244.8056679,-21600,,
com.microsoft.VSCode,1,1740669233,1740669234,1740669234.794407,-21600,,
com.google.Chrome,9,1740669224,1740669233,1740669233.541795,-21600,,
com.microsoft.VSCode,3,1740669221,1740669224,1740669224.3669028,-21600,,
com.google.Chrome,18,1740669203,1740669221,1740669221.8015652,-21600,,
com.microsoft.VSCode,2,1740669201,1740669203,1740669203.103795,-21600,,
com.google.Chrome,2,1740669199,1740669201,1740669201.75227,-21600,,
com.microsoft.VSCode,3,1740669196,1740669199,1740669199.681081,-21600,,
com.google.Chrome,4,1740669192,1740669196,1740669196.664726,-21600,,
com.microsoft.VSCode,35,1740669157,1740669192,1740669192.984839,-21600,,
com.google.Chrome,4,1740669153,1740669157,1740669157.4449759,-21600,,
com.microsoft.VSCode,2,1740669151,1740669153,1740669153.539202,-21600,,
com.google.Chrome,78,1740669073,1740669151,1740669151.728255,-21600,,
com.microsoft.VSCode,450,1740668623,1740669073,1740669073.639462,-21600,,
com.google.Chrome,105,1740668518,1740668623,1740668623.5019531,-21600,,
com.renpho.health,42,1740667052,1740667094,1740667094.624809,-21600,EB445137-D7F5-57EC-87DA-1DB460D64046,"iPhone13,2"
com.renpho.health,13,1740667038,1740667051,1740667051.931943,-21600,EB445137-D7F5-57EC-87DA-1DB460D64046,"iPhone13,2"
com.renpho.health,8,1740667029,1740667037,1740667037.505645,-21600,EB445137-D7F5-57EC-87DA-1DB460D64046,"iPhone13,2"
com.apple.mobiletimer,1,1740665844,1740665845,1740665845.5980392,-21600,EB445137-D7F5-57EC-87DA-1DB460D64046,"iPhone13,2"
Astrospheric.Astrospheric,16,1740635869,1740635885,1740635885.881135,-21600,EB445137-D7F5-57EC-87DA-1DB460D64046,"iPhone13,2"
com.thestorygraph.thestorygraph,24,1740635758,1740635782,1740635782.926021,-21600,EB445137-D7F5-57EC-87DA-1DB460D64046,"iPhone13,2"
com.apple.MobileSMS,14,1740635742,1740635756,1740635756.7822142,-21600,EB445137-D7F5-57EC-87DA-1DB460D64046,"iPhone13,2"
com.apple.Music,0,1740635742,1740635742,1740635743.370966,-21600,EB445137-D7F5-57EC-87DA-1DB460D64046,"iPhone13,2"
com.apple.Music,1,1740633657,1740633658,1740633658.074904,-21600,EB445137-D7F5-57EC-87DA-1DB460D64046,"iPhone13,2"
com.google.Chrome,703,1740632829,1740633532,1740633532.4510221,-21600,,
com.google.Chrome,500,1740632048,1740632548,1740632548.200437,-21600,,
com.apple.finder,1,1740632047,1740632048,1740632049.519283,-21600,,
com.leomehlig.today,49,1740631998,1740632047,1740632047.8623571,-21600,,
com.apple.Music,103,1740630557,1740630660,1740630661.1148229,-21600,EB445137-D7F5-57EC-87DA-1DB460D64046,"iPhone13,2"
com.apple.MobileSMS,2,1740630555,1740630557,1740630557.935493,-21600,EB445137-D7F5-57EC-87DA-1DB460D64046,"iPhone13,2"
com.apple.MobileSMS,11,1740629905,1740629916,1740629916.8817759,-21600,EB445137-D7F5-57EC-87DA-1DB460D64046,"iPhone13,2"
com.apple.MobileSMS,50,1740629846,1740629896,1740629896.55919,-21600,EB445137-D7F5-57EC-87DA-1DB460D64046,"iPhone13,2"
com.apple.MobileSMS,15,1740629457,1740629472,1740629472.8881469,-21600,EB445137-D7F5-57EC-87DA-1DB460D64046,"iPhone13,2"
com.apple.MobileSMS,10,1740629424,1740629434,1740629435.1409578,-21600,EB445137-D7F5-57EC-87DA-1DB460D64046,"iPhone13,2"
com.apple.MobileSMS,40,1740629375,1740629415,1740629415.287047,-21600,EB445137-D7F5-57EC-87DA-1DB460D64046,"iPhone13,2"
com.apple.Music,2,1740629373,1740629375,1740629375.356741,-21600,EB445137-D7F5-57EC-87DA-1DB460D64046,"iPhone13,2"
com.apple.Music,23,1740629323,1740629346,1740629348.80971,-21600,EB445137-D7F5-57EC-87DA-1DB460D64046,"iPhone13,2"
com.apple.MobileSMS,44,1740629278,1740629322,1740629322.496247,-21600,EB445137-D7F5-57EC-87DA-1DB460D64046,"iPhone13,2"
com.google.chrome.ios,144,1740629134,1740629278,1740629278.465392,-21600,EB445137-D7F5-57EC-87DA-1DB460D64046,"iPhone13,2"
com.apple.MobileSMS,5,1740629129,1740629134,1740629134.908036,-21600,EB445137-D7F5-57EC-87DA-1DB460D64046,"iPhone13,2"
com.apple.Health,0,1740629129,1740629129,1740629130.491313,-21600,EB445137-D7F5-57EC-87DA-1DB460D64046,"iPhone13,2"
com.leomehlig.today,87,1740628830,1740628917,1740628917.749629,-21600,,
com.google.Chrome,282,1740628548,1740628830,1740628830.235402,-21600,,
com.apple.finder,3,1740628545,1740628548,1740628548.381556,-21600,,
com.google.Chrome,805,1740627740,1740628545,1740628545.107878,-21600,,
com.apple.finder,3,1740627715,1740627718,1740627718.200735,-21600,,
com.apple.Preview,7,1740627708,1740627715,1740627715.475857,-21600,,
com.google.Chrome,78,1740627630,1740627708,1740627708.3512259,-21600,,
com.apple.Preview,4,1740627626,1740627630,1740627630.950953,-21600,,
com.apple.finder,1,1740627625,1740627626,1740627626.215963,-21600,,
com.apple.Preview,2,1740627623,1740627625,1740627625.937341,-21600,,
com.google.Chrome,162,1740627461,1740627623,1740627623.451428,-21600,,
com.apple.Preview,5,1740627456,1740627461,1740627461.427291,-21600,,
com.apple.finder,0,1740627456,1740627456,1740627456.8243442,-21600,,
com.apple.Preview,2,1740627454,1740627456,1740627456.566945,-21600,,
com.google.Chrome,118,1740627336,1740627454,1740627454.0801492,-21600,,
com.apple.Preview,2,1740627334,1740627336,1740627336.9434528,-21600,,
com.apple.finder,3,1740627331,1740627334,1740627334.154416,-21600,,
com.google.Chrome,198,1740627133,1740627331,1740627331.3079,-21600,,
com.apple.Preview,2,1740627131,1740627133,1740627133.7382789,-21600,,
com.apple.finder,1,1740627130,1740627131,1740627131.430368,-21600,,
com.apple.Preview,7,1740627123,1740627130,1740627130.170922,-21600,,
com.apple.finder,6,1740627117,1740627123,1740627123.348975,-21600,,
com.google.Chrome,2,1740627115,1740627117,1740627117.5078568,-21600,,
com.apple.Notes,3,1740627112,1740627115,1740627116.11452,-21600,,
com.apple.finder,7,1740627105,1740627112,1740627112.2747278,-21600,,
com.apple.Dictionary,2,1740627103,1740627105,1740627105.753137,-21600,,
com.apple.Health,61,1740626739,1740626800,1740626800.407909,-21600,EB445137-D7F5-57EC-87DA-1DB460D64046,"iPhone13,2"
com.microsoft.VSCode,1084,1740626019,1740627103,1740627104.1675072,-21600,,
com.apple.Dictionary,1,1740626018,1740626019,1740626019.261821,-21600,,
com.apple.Health,78,1740625946,1740626024,1740626024.360554,-21600,EB445137-D7F5-57EC-87DA-1DB460D64046,"iPhone13,2"
com.apple.Health,11,1740625907,1740625918,1740625919.181458,-21600,EB445137-D7F5-57EC-87DA-1DB460D64046,"iPhone13,2"
com.apple.mobilecal,4,1740625900,1740625904,1740625904.9145122,-21600,EB445137-D7F5-57EC-87DA-1DB460D64046,"iPhone13,2"
com.microsoft.VSCode,231,1740625787,1740626018,1740626018.8032432,-21600,,
com.apple.finder,2,1740625785,1740625787,1740625788.1040149,-21600,,
com.google.Chrome,2,1740625783,1740625785,1740625785.4111261,-21600,,
com.apple.finder,1,1740625782,1740625783,1740625783.81968,-21600,,
com.google.Chrome,101,1740625681,1740625782,1740625782.472641,-21600,,
com.apple.Notes,16,1740625665,1740625681,1740625681.7000198,-21600,,
com.microsoft.VSCode,2,1740625663,1740625665,1740625665.794693,-21600,,
com.apple.Notes,1,1740625662,1740625663,1740625663.597855,-21600,,
com.google.Chrome,133,1740625529,1740625662,1740625662.6682072,-21600,,
com.microsoft.VSCode,99,1740625430,1740625529,1740625529.852905,-21600,,
com.google.Chrome,6,1740625424,1740625430,1740625430.050397,-21600,,
com.microsoft.VSCode,15,1740625409,1740625424,1740625424.171118,-21600,,
com.apple.finder,1,1740625408,1740625409,1740625409.54895,-21600,,
com.google.Chrome,5,1740625403,1740625408,1740625408.723065,-21600,,
com.apple.finder,2,1740625401,1740625403,1740625403.329963,-21600,,
com.microsoft.VSCode,24,1740625377,1740625401,1740625401.689588,-21600,,
com.google.Chrome,14,1740625363,1740625377,1740625377.430402,-21600,,
com.microsoft.VSCode,87,1740625276,1740625363,1740625363.5160809,-21600,,
com.apple.finder,5,1740625271,1740625276,1740625276.3060942,-21600,,
com.microsoft.VSCode,47,1740625224,1740625271,1740625271.6610389,-21600,,
com.apple.finder,25,1740625199,1740625224,1740625224.919863,-21600,,
com.apple.archiveutility,3,1740625196,1740625199,1740625199.909363,-21600,,
com.apple.finder,6,1740625190,1740625196,1740625196.8441172,-21600,,
com.microsoft.VSCode,1,1740625189,1740625190,1740625190.122652,-21600,,
com.apple.finder,12,1740625177,1740625189,1740625189.598098,-21600,,
com.microsoft.VSCode,9,1740625168,1740625177,1740625177.254683,-21600,,
com.apple.finder,22,1740625146,1740625168,1740625168.929741,-21600,,
com.microsoft.VSCode,115,1740625031,1740625146,1740625146.5778131,-21600,,
com.apple.finder,304,1740624727,1740625031,1740625031.8379169,-21600,,
com.apple.findmy,1,1740624726,1740624727,1740624727.895105,-21600,,
com.apple.finder,2,1740624724,1740624726,1740624726.464565,-21600,,
com.leomehlig.today,1,1740624723,1740624724,1740624724.065166,-21600,,
com.google.Chrome,4,1740624719,1740624723,1740624723.603722,-21600,,
com.leomehlig.today,154,1740624565,1740624719,1740624719.851118,-21600,,
com.google.Chrome,18,1740624547,1740624565,1740624565.241404,-21600,,
com.leomehlig.today,57,1740624477,1740624534,1740624535.269874,-21600,,
com.microsoft.VSCode,1,1740624476,1740624477,1740624477.9778461,-21600,,
com.leomehlig.today,1,1740624475,1740624476,1740624476.639515,-21600,,
com.hnc.Discord,12,1740624463,1740624475,1740624475.415681,-21600,,
com.leomehlig.today,11,1740624452,1740624463,1740624463.477937,-21600,,
com.google.Chrome,1135,1740623317,1740624452,1740624453.0768719,-21600,,
com.apple.Health,510,1740622968,1740623478,1740623478.583468,-21600,EB445137-D7F5-57EC-87DA-1DB460D64046,"iPhone13,2"
com.google.Chrome,371,1740622882,1740623253,1740623253.506228,-21600,,
com.google.Chrome,341,1740622454,1740622795,1740622795.501579,-21600,,
com.google.Chrome,567,1740621775,1740622342,1740622342.363803,-21600,,
com.apple.Music,4,1740621771,1740621775,1740621775.796211,-21600,,
com.google.Chrome,2,1740621769,1740621771,1740621771.098517,-21600,,
com.leomehlig.today,6,1740621748,1740621754,1740621755.179615,-21600,,
com.myfitnesspal.mfp,33,1740621598,1740621631,1740621631.993641,-21600,EB445137-D7F5-57EC-87DA-1DB460D64046,"iPhone13,2"
com.microsoft.Office.Outlook,5,1740621591,1740621596,1740621596.1402922,-21600,EB445137-D7F5-57EC-87DA-1DB460D64046,"iPhone13,2"
com.tinyspeck.chatlyio,17,1740621573,1740621590,1740621590.138122,-21600,EB445137-D7F5-57EC-87DA-1DB460D64046,"iPhone13,2"
com.tinyspeck.chatlyio,9,1740621564,1740621573,1740621573.398559,-21600,EB445137-D7F5-57EC-87DA-1DB460D64046,"iPhone13,2"
com.burbn.instagram,54,1740621508,1740621562,1740621563.048273,-21600,EB445137-D7F5-57EC-87DA-1DB460D64046,"iPhone13,2"
com.leomehlig.today,40,1740621403,1740621443,1740621443.258117,-21600,,
com.google.Chrome,706,1740620697,1740621403,1740621403.965852,-21600,,
com.leomehlig.today,14,1740620683,1740620697,1740620697.2194061,-21600,,
com.google.Chrome,853,1740619830,1740620683,1740620683.1162171,-21600,,
com.leomehlig.today,2,1740619828,1740619830,1740619830.5049372,-21600,,
com.google.Chrome,1194,1740618634,1740619828,1740619828.337892,-21600,,
com.hnc.Discord,103,1740618531,1740618634,1740618634.396213,-21600,,
com.google.Chrome,5,1740618526,1740618531,1740618531.6525831,-21600,,
com.hnc.Discord,6,1740618520,1740618526,1740618526.613225,-21600,,
com.google.Chrome,4,1740618516,1740618520,1740618520.129126,-21600,,
com.hnc.Discord,56,1740618460,1740618516,1740618516.753974,-21600,,
com.google.Chrome,4,1740618456,1740618460,1740618460.284618,-21600,,
com.leomehlig.today,4,1740618452,1740618456,1740618456.356632,-21600,,
com.burbn.instagram,57,1740618097,1740618154,1740618155.085936,-21600,EB445137-D7F5-57EC-87DA-1DB460D64046,"iPhone13,2"
com.google.Chrome,399,1740618053,1740618452,1740618452.349684,-21600,,
com.hnc.Discord,29,1740618024,1740618053,1740618053.5039558,-21600,,
com.google.Chrome,39,1740617985,1740618024,1740618024.686033,-21600,,
com.microsoft.VSCode,146,1740617839,1740617985,1740617985.832179,-21600,,
com.google.Chrome,75,1740617764,1740617839,1740617839.628907,-21600,,
com.microsoft.VSCode,67,1740617697,1740617764,1740617764.580069,-21600,,
com.google.Chrome,5,1740617692,1740617697,1740617697.289116,-21600,,
com.microsoft.VSCode,70,1740617622,1740617692,1740617692.269943,-21600,,
com.google.Chrome,914,1740616708,1740617622,1740617622.2144508,-21600,,
com.hnc.Discord,268,1740616440,1740616708,1740616708.228462,-21600,,
com.google.Chrome,14,1740616426,1740616440,1740616440.186984,-21600,,
com.hnc.Discord,16,1740616410,1740616426,1740616426.275373,-21600,,
com.google.Chrome,842,1740615568,1740616410,1740616410.797358,-21600,,
com.apple.Preview,116,1740615452,1740615568,1740615568.897629,-21600,,
com.apple.finder,8,1740615444,1740615452,1740615452.79392,-21600,,
com.google.Chrome,319,1740615125,1740615444,1740615444.4482799,-21600,,
com.apple.finder,4,1740615096,1740615100,1740615100.266036,-21600,,
com.microsoft.VSCode,1,1740615095,1740615096,1740615097.199926,-21600,,
com.apple.finder,5,1740615090,1740615095,1740615095.095927,-21600,,
com.leomehlig.today,16,1740615074,1740615090,1740615090.655995,-21600,,
com.apple.finder,20,1740615054,1740615074,1740615074.902502,-21600,,
Astrospheric.Astrospheric,20,1740614637,1740614657,1740614657.933809,-21600,EB445137-D7F5-57EC-87DA-1DB460D64046,"iPhone13,2"
com.myfitnesspal.mfp,1,1740614633,1740614634,1740614634.596648,-21600,EB445137-D7F5-57EC-87DA-1DB460D64046,"iPhone13,2"
com.myfitnesspal.mfp,17,1740613169,1740613186,1740613186.7062669,-21600,EB445137-D7F5-57EC-87DA-1DB460D64046,"iPhone13,2"
com.apple.weather,1,1740613168,1740613169,1740613170.268853,-21600,EB445137-D7F5-57EC-87DA-1DB460D64046,"iPhone13,2"
com.apple.weather,7,1740613075,1740613082,1740613082.721243,-21600,EB445137-D7F5-57EC-87DA-1DB460D64046,"iPhone13,2"
com.myfitnesspal.mfp,52,1740612597,1740612649,1740612649.980466,-21600,EB445137-D7F5-57EC-87DA-1DB460D64046,"iPhone13,2"
com.apple.news,3,1740612594,1740612597,1740612597.5598521,-21600,EB445137-D7F5-57EC-87DA-1DB460D64046,"iPhone13,2"
com.apple.news,259,1740612320,1740612579,1740612579.4774709,-21600,EB445137-D7F5-57EC-87DA-1DB460D64046,"iPhone13,2"
com.microsoft.Office.Outlook,1,1740612314,1740612315,1740612317.244529,-21600,EB445137-D7F5-57EC-87DA-1DB460D64046,"iPhone13,2"
com.apple.finder,21,1740611384,1740611405,1740611405.60814,-21600,,
com.microsoft.Outlook,9,1740611375,1740611384,1740611384.793734,-21600,,
com.google.Chrome,32,1740611343,1740611375,1740611375.863686,-21600,,
com.microsoft.VSCode,317,1740611026,1740611343,1740611343.2061849,-21600,,
com.google.Chrome,22,1740611004,1740611026,1740611026.324532,-21600,,
com.microsoft.VSCode,44,1740610960,1740611004,1740611004.801569,-21600,,
com.google.Chrome,1,1740610959,1740610960,1740610960.49651,-21600,,
com.microsoft.VSCode,3,1740610956,1740610959,1740610959.6283689,-21600,,
com.google.Chrome,30,1740610926,1740610956,1740610956.721678,-21600,,
com.microsoft.VSCode,27,1740610899,1740610926,1740610926.4142652,-21600,,
com.google.Chrome,6,1740610893,1740610899,1740610900.0124002,-21600,,
com.microsoft.VSCode,2,1740610891,1740610893,1740610893.536525,-21600,,
com.google.Chrome,2,1740610889,1740610891,1740610891.0834708,-21600,,
com.microsoft.VSCode,7,1740610882,1740610889,1740610889.423135,-21600,,
com.google.Chrome,20,1740610862,1740610882,1740610882.384546,-21600,,
com.microsoft.VSCode,1,1740610861,1740610862,1740610862.6321511,-21600,,
com.google.Chrome,6,1740610855,1740610861,1740610861.224244,-21600,,
com.microsoft.VSCode,31,1740610824,1740610855,1740610855.722213,-21600,,
com.google.Chrome,0,1740610824,1740610824,1740610825.048353,-21600,,
com.microsoft.VSCode,3,1740610821,1740610824,1740610824.1414208,-21600,,
com.google.Chrome,62,1740610759,1740610821,1740610821.480986,-21600,,
com.microsoft.VSCode,20,1740610739,1740610759,1740610759.921348,-21600,,
com.google.Chrome,35,1740610704,1740610739,1740610739.850143,-21600,,
com.microsoft.VSCode,138,1740610566,1740610704,1740610704.387846,-21600,,
com.google.Chrome,2,1740610564,1740610566,1740610566.210165,-21600,,
com.microsoft.VSCode,3,1740610561,1740610564,1740610564.9319391,-21600,,
com.google.Chrome,29,1740610532,1740610561,1740610561.148477,-21600,,
com.microsoft.VSCode,27,1740610505,1740610532,1740610532.204516,-21600,,
com.google.Chrome,18,1740610487,1740610505,1740610505.496194,-21600,,
com.microsoft.VSCode,3,1740610484,1740610487,1740610487.465084,-21600,,
com.google.Chrome,14,1740610470,1740610484,1740610484.114694,-21600,,
com.microsoft.VSCode,5,1740610465,1740610470,1740610470.870995,-21600,,
com.google.Chrome,3,1740610462,1740610465,1740610465.311454,-21600,,
com.microsoft.VSCode,3,1740610459,1740610462,1740610462.9718661,-21600,,
com.google.Chrome,14,1740610445,1740610459,1740610459.4491649,-21600,,
com.microsoft.VSCode,39,1740610406,1740610445,1740610445.167702,-21600,,
com.google.Chrome,10,1740610396,1740610406,1740610406.9026852,-21600,,
com.microsoft.VSCode,13,1740610383,1740610396,1740610396.666192,-21600,,
com.google.Chrome,7,1740610376,1740610383,1740610383.146066,-21600,,
com.microsoft.VSCode,1,1740610375,1740610376,1740610376.2434602,-21600,,
com.google.Chrome,3,1740610372,1740610375,1740610375.448061,-21600,,
com.microsoft.VSCode,17,1740610355,1740610372,1740610372.80234,-21600,,
com.google.Chrome,17,1740610338,1740610355,1740610355.896601,-21600,,
com.microsoft.VSCode,18,1740610320,1740610338,1740610338.297948,-21600,,
com.google.Chrome,5,1740610315,1740610320,1740610320.542859,-21600,,
com.microsoft.VSCode,13,1740610302,1740610315,1740610315.178472,-21600,,
com.google.Chrome,11,1740610291,1740610302,1740610302.648135,-21600,,
com.microsoft.VSCode,4,1740610287,1740610291,1740610291.535973,-21600,,
com.google.Chrome,4,1740610283,1740610287,1740610287.5085511,-21600,,
com.microsoft.VSCode,185,1740610098,1740610283,1740610283.4293919,-21600,,
com.apple.finder,7,1740610091,1740610098,1740610098.286663,-21600,,
com.microsoft.VSCode,4,1740610087,1740610091,1740610091.2345119,-21600,,
com.google.Chrome,321,1740609766,1740610087,1740610087.5291948,-21600,,
com.apple.Passwords,16,1740609750,1740609766,1740609766.347945,-21600,,
com.google.Chrome,5,1740609745,1740609750,1740609750.477731,-21600,,
com.apple.Passwords,3,1740609742,1740609745,1740609746.0127149,-21600,,
com.google.Chrome,6,1740609736,1740609742,1740609742.8815122,-21600,,
com.apple.Passwords,4,1740609732,1740609736,1740609736.069695,-21600,,
com.google.Chrome,3,1740609729,1740609732,1740609732.28294,-21600,,
com.apple.Passwords,16,1740609713,1740609729,1740609729.419157,-21600,,
com.google.Chrome,13,1740609700,1740609713,1740609713.179871,-21600,,
com.apple.Passwords,7,1740609693,1740609700,1740609700.717454,-21600,,
com.google.Chrome,5,1740609688,1740609693,1740609693.2562551,-21600,,
com.apple.Passwords,3,1740609685,1740609688,1740609688.132684,-21600,,
com.google.Chrome,4,1740609681,1740609685,1740609685.0723271,-21600,,
com.apple.Passwords,1,1740609680,1740609681,1740609682.003145,-21600,,
com.google.Chrome,5,1740609675,1740609680,1740609680.264199,-21600,,
com.apple.Passwords,6,1740609669,1740609675,1740609675.408318,-21600,,
com.google.Chrome,3,1740609666,1740609669,1740609669.9334831,-21600,,
com.microsoft.Outlook,3,1740609663,1740609666,1740609667.064826,-21600,,
com.google.Chrome,49,1740609614,1740609663,1740609663.644351,-21600,,
com.apple.Passwords,1,1740609613,1740609614,1740609614.5778651,-21600,,
com.google.Chrome,6,1740609607,1740609613,1740609613.596497,-21600,,
com.apple.Passwords,3,1740609604,1740609607,1740609608.035454,-21600,,
com.google.Chrome,27,1740609577,1740609604,1740609604.1680799,-21600,,
com.microsoft.Outlook,9,1740609568,1740609577,1740609577.177757,-21600,,
com.microsoft.VSCode,4,1740609564,1740609568,1740609568.878762,-21600,,
com.microsoft.Office.Outlook,16,1740609547,1740609563,1740609563.718721,-21600,EB445137-D7F5-57EC-87DA-1DB460D64046,"iPhone13,2"
com.myfitnesspal.mfp,1,1740609546,1740609547,1740609547.548544,-21600,EB445137-D7F5-57EC-87DA-1DB460D64046,"iPhone13,2"
com.microsoft.VSCode,304,1740609246,1740609550,1740609550.011054,-21600,,
com.apple.finder,10,1740609236,1740609246,1740609246.308941,-21600,,
com.microsoft.VSCode,1,1740609235,1740609236,1740609236.044218,-21600,,
com.google.Chrome,2,1740609233,1740609235,1740609235.342719,-21600,,
com.apple.finder,1,1740609232,1740609233,1740609233.6032891,-21600,,
com.microsoft.VSCode,110,1740609122,1740609232,1740609232.34196,-21600,,
com.apple.finder,29,1740609093,1740609122,1740609122.5971909,-21600,,
com.microsoft.VSCode,17,1740609076,1740609093,1740609093.9089808,-21600,,
com.apple.systempreferences,1,1740609072,1740609073,1740609073.752742,-21600,,
com.microsoft.VSCode,18,1740609051,1740609069,1740609069.628825,-21600,,
com.microsoft.VSCode,304,1740608617,1740608921,1740608921.118644,-21600,,
com.google.Chrome,0,1740608617,1740608617,1740608617.9940782,-21600,,
com.apple.finder,22,1740608595,1740608617,1740608617.1534572,-21600,,
com.google.Chrome,1,1740608594,1740608595,1740608595.083325,-21600,,
com.microsoft.VSCode,141,1740608453,1740608594,1740608594.5726728,-21600,,
com.google.Chrome,28,1740608425,1740608453,1740608453.567494,-21600,,
com.microsoft.VSCode,1,1740608424,1740608425,1740608425.653243,-21600,,
com.apple.finder,2,1740608422,1740608424,1740608424.079885,-21600,,
com.google.Chrome,6,1740608416,1740608422,1740608422.269321,-21600,,
com.apple.finder,50,1740608366,1740608416,1740608416.39572,-21600,,
com.microsoft.VSCode,4,1740608362,1740608366,1740608366.469895,-21600,,
com.google.Chrome,66,1740608296,1740608362,1740608362.940949,-21600,,
com.microsoft.VSCode,2,1740608278,1740608280,1740608280.240765,-21600,,
com.leomehlig.today,50,1740608228,1740608278,1740608278.9652128,-21600,,
com.apple.finder,93,1740608135,1740608228,1740608228.488636,-21600,,
com.microsoft.VSCode,20,1740608115,1740608135,1740608135.435546,-21600,,
com.google.Chrome,16,1740608099,1740608115,1740608115.358201,-21600,,
com.leomehlig.today,102,1740607997,1740608099,1740608099.716912,-21600,,
com.google.Chrome,9,1740607988,1740607997,1740607998.056977,-21600,,
com.microsoft.VSCode,49,1740607939,1740607988,1740607988.7893271,-21600,,
com.apple.finder,17,1740607922,1740607939,1740607939.9923959,-21600,,
com.microsoft.VSCode,526,1740607396,1740607922,1740607922.951881,-21600,,
com.google.Chrome,2,1740607394,1740607396,1740607396.432921,-21600,,
com.microsoft.VSCode,7,1740607387,1740607394,1740607394.85181,-21600,,
com.google.Chrome,123,1740607264,1740607387,1740607387.8853579,-21600,,
com.microsoft.VSCode,101,1740607163,1740607264,1740607264.791172,-21600,,
com.google.Chrome,227,1740606936,1740607163,1740607163.7315722,-21600,,
com.microsoft.VSCode,14,1740606922,1740606936,1740606936.483786,-21600,,
com.google.Chrome,155,1740606767,1740606922,1740606922.68047,-21600,,
com.microsoft.VSCode,1,1740606766,1740606767,1740606767.2077398,-21600,,
com.google.Chrome,4,1740606762,1740606766,1740606766.284765,-21600,,
com.microsoft.VSCode,45,1740606717,1740606762,1740606762.77382,-21600,,
com.google.Chrome,9,1740606708,1740606717,1740606717.263822,-21600,,
com.leomehlig.today,24,1740606684,1740606708,1740606709.624022,-21600,,
com.apple.finder,3,1740606681,1740606684,1740606684.442682,-21600,,
com.myfitnesspal.mfp,133,1740606497,1740606630,1740606631.121779,-21600,EB445137-D7F5-57EC-87DA-1DB460D64046,"iPhone13,2"
com.google.chrome.ios,2,1740606495,1740606497,1740606497.4144158,-21600,EB445137-D7F5-57EC-87DA-1DB460D64046,"iPhone13,2"
com.google.chrome.ios,27,1740605256,1740605283,1740605283.7523289,-21600,EB445137-D7F5-57EC-87DA-1DB460D64046,"iPhone13,2"
com.apple.news,1,1740605255,1740605256,1740605257.1451302,-21600,EB445137-D7F5-57EC-87DA-1DB460D64046,"iPhone13,2"
com.apple.news,19,1740599896,1740599915,1740599915.8663359,-21600,EB445137-D7F5-57EC-87DA-1DB460D64046,"iPhone13,2"
com.apple.news,73,1740599823,1740599896,1740599896.719238,-21600,EB445137-D7F5-57EC-87DA-1DB460D64046,"iPhone13,2"
com.hammerandchisel.discord,12,1740599763,1740599775,1740599775.748413,-21600,EB445137-D7F5-57EC-87DA-1DB460D64046,"iPhone13,2"
com.apple.news,1,1740599762,1740599763,1740599763.636666,-21600,EB445137-D7F5-57EC-87DA-1DB460D64046,"iPhone13,2"
com.apple.news,97,1740597562,1740597659,1740597659.970125,-21600,EB445137-D7F5-57EC-87DA-1DB460D64046,"iPhone13,2"
com.apple.news,1,1740597560,1740597561,1740597563.324666,-21600,EB445137-D7F5-57EC-87DA-1DB460D64046,"iPhone13,2"
com.apple.news,84,1740597423,1740597507,1740597507.705881,-21600,EB445137-D7F5-57EC-87DA-1DB460D64046,"iPhone13,2"
com.apple.news,43,1740597375,1740597418,1740597418.269242,-21600,EB445137-D7F5-57EC-87DA-1DB460D64046,"iPhone13,2"
com.apple.news,104,1740596973,1740597077,1740597077.635717,-21600,EB445137-D7F5-57EC-87DA-1DB460D64046,"iPhone13,2"
Astrospheric.Astrospheric,3,1740596950,1740596953,1740596953.0448442,-21600,EB445137-D7F5-57EC-87DA-1DB460D64046,"iPhone13,2"
Astrospheric.Astrospheric,14,1740596297,1740596311,1740596311.6145802,-21600,EB445137-D7F5-57EC-87DA-1DB460D64046,"iPhone13,2"
Astrospheric.Astrospheric,41,1740596246,1740596287,1740596288.193952,-21600,EB445137-D7F5-57EC-87DA-1DB460D64046,"iPhone13,2"
com.myfitnesspal.mfp,3,1740596242,1740596245,1740596245.489697,-21600,EB445137-D7F5-57EC-87DA-1DB460D64046,"iPhone13,2"
com.myfitnesspal.mfp,139,1740596102,1740596241,1740596242.799539,-21600,EB445137-D7F5-57EC-87DA-1DB460D64046,"iPhone13,2"
com.apple.finder,4,1740596080,1740596084,1740596084.871966,-21600,,
com.hnc.Discord,7,1740596073,1740596080,1740596080.73416,-21600,,
com.google.Chrome,224,1740595849,1740596073,1740596073.4783401,-21600,,
com.apple.finder,1,1740595848,1740595849,1740595849.622709,-21600,,
com.leomehlig.today,79,1740595769,1740595848,1740595848.406184,-21600,,
com.google.Chrome,7,1740595762,1740595769,1740595769.965956,-21600,,
com.groupme.iphone-app,5,1740595746,1740595751,1740595751.1467319,-21600,EB445137-D7F5-57EC-87DA-1DB460D64046,"iPhone13,2"
com.google.Chrome,219,1740594642,1740594861,1740594861.6218991,-21600,,
com.google.Chrome,829,1740593700,1740594529,1740594529.837379,-21600,,
com.microsoft.Office.Outlook,15,1740592038,1740592053,1740592054.0512528,-21600,EB445137-D7F5-57EC-87DA-1DB460D64046,"iPhone13,2"
com.apple.weather,0,1740592038,1740592038,1740592039.170229,-21600,EB445137-D7F5-57EC-87DA-1DB460D64046,"iPhone13,2"
com.apple.weather,3,1740592013,1740592016,1740592016.926775,-21600,EB445137-D7F5-57EC-87DA-1DB460D64046,"iPhone13,2"
com.ally.MobileBanking,2,1740592011,1740592013,1740592013.710635,-21600,EB445137-D7F5-57EC-87DA-1DB460D64046,"iPhone13,2"
com.ally.MobileBanking,51,1740589200,1740589251,1740589252.110446,-21600,EB445137-D7F5-57EC-87DA-1DB460D64046,"iPhone13,2"
com.google.Sheets,2,1740589198,1740589200,1740589200.1274328,-21600,EB445137-D7F5-57EC-87DA-1DB460D64046,"iPhone13,2"
com.apple.CoreAuthUI,2,1740589183,1740589185,1740589185.8636189,-21600,EB445137-D7F5-57EC-87DA-1DB460D64046,"iPhone13,2"
com.ally.MobileBanking,25,1740589173,1740589198,1740589198.473168,-21600,EB445137-D7F5-57EC-87DA-1DB460D64046,"iPhone13,2"
com.google.Sheets,7,1740589161,1740589168,1740589168.9702148,-21600,EB445137-D7F5-57EC-87DA-1DB460D64046,"iPhone13,2"
com.apple.CoreAuthUI,3,1740589062,1740589065,1740589065.14154,-21600,EB445137-D7F5-57EC-87DA-1DB460D64046,"iPhone13,2"
com.robinhood.release.Robinhood,97,1740589061,1740589158,1740589158.514683,-21600,EB445137-D7F5-57EC-87DA-1DB460D64046,"iPhone13,2"
com.google.Sheets,14,1740589046,1740589060,1740589060.610755,-21600,EB445137-D7F5-57EC-87DA-1DB460D64046,"iPhone13,2"
com.apple.CoreAuthUI,8,1740588891,1740588899,1740588899.097225,-21600,EB445137-D7F5-57EC-87DA-1DB460D64046,"iPhone13,2"
com.truebill.truebillnative,138,1740588889,1740589027,1740589027.5162191,-21600,EB445137-D7F5-57EC-87DA-1DB460D64046,"iPhone13,2"
com.apple.Health,101,1740588757,1740588858,1740588858.047993,-21600,EB445137-D7F5-57EC-87DA-1DB460D64046,"iPhone13,2"
com.google.Chrome,35,1740588434,1740588469,1740588469.343276,-21600,,
com.apple.finder,2,1740588432,1740588434,1740588434.4799,-21600,,
com.apple.finder,2,1740588423,1740588425,1740588426.036756,-21600,,
com.leomehlig.today,2,1740588421,1740588423,1740588423.887762,-21600,,
com.google.Chrome,5,1740588416,1740588421,1740588421.5517511,-21600,,
com.apple.finder,9,1740588407,1740588416,1740588416.172172,-21600,,
com.google.Chrome,96,1740588311,1740588407,1740588407.916323,-21600,,
com.apple.finder,1,1740588267,1740588268,1740588268.7194262,-21600,,
com.google.Chrome,19,1740588248,1740588267,1740588267.810223,-21600,,
com.apple.finder,15,1740588233,1740588248,1740588248.8665829,-21600,,
com.google.Chrome,1,1740588232,1740588233,1740588233.600903,-21600,,
com.leomehlig.today,4,1740588228,1740588232,1740588232.130971,-21600,,
com.apple.Preview,1507,1740586721,1740588228,1740588228.5226731,-21600,,
com.apple.finder,4,1740586717,1740586721,1740586721.639505,-21600,,
com.leomehlig.today,18,1740586699,1740586717,1740586717.571828,-21600,,
com.apple.iCal,6,1740586693,1740586699,1740586699.4631681,-21600,,
com.leomehlig.today,2,1740586691,1740586693,1740586693.801234,-21600,,
com.apple.finder,2,1740586689,1740586691,1740586691.304617,-21600,,
com.google.Chrome,4,1740586685,1740586689,1740586689.7132711,-21600,,
com.apple.Health,15,1740585198,1740585213,1740585214.220607,-21600,EB445137-D7F5-57EC-87DA-1DB460D64046,"iPhone13,2"
com.tinyspeck.chatlyio,43,1740585151,1740585194,1740585194.318085,-21600,EB445137-D7F5-57EC-87DA-1DB460D64046,"iPhone13,2"
com.apple.mobilephone,6,1740585144,1740585150,1740585150.362411,-21600,EB445137-D7F5-57EC-87DA-1DB460D64046,"iPhone13,2"
com.apple.Health,43,1740585099,1740585142,1740585143.00883,-21600,EB445137-D7F5-57EC-87DA-1DB460D64046,"iPhone13,2"
com.microsoft.Office.Outlook,29,1740584730,1740584759,1740584759.7709808,-21600,EB445137-D7F5-57EC-87DA-1DB460D64046,"iPhone13,2"
com.renpho.health,1,1740584729,1740584730,1740584731.634153,-21600,EB445137-D7F5-57EC-87DA-1DB460D64046,"iPhone13,2"
com.google.Chrome,75,1740583883,1740583958,1740583958.919114,-21600,,
com.leomehlig.today,43,1740583840,1740583883,1740583884.533533,-21600,,
com.apple.Preview,1112,1740582728,1740583840,1740583840.308363,-21600,,
com.apple.finder,9,1740582719,1740582728,1740582728.569072,-21600,,
com.leomehlig.today,2,1740582717,1740582719,1740582719.173552,-21600,,
com.apple.Passwords,1,1740582716,1740582717,1740582717.893002,-21600,,
com.leomehlig.today,20,1740582696,1740582716,1740582716.2891998,-21600,,
com.apple.iCal,10,1740582686,1740582696,1740582696.5675821,-21600,,
com.google.Chrome,27,1740582659,1740582686,1740582686.146702,-21600,,
com.google.Chrome,561,1740581660,1740582221,1740582221.642284,-21600,,
com.apple.Passwords,1,1740581657,1740581658,1740581658.776957,-21600,,
com.google.Chrome,34,1740581623,1740581657,1740581657.306157,-21600,,
com.leomehlig.today,2,1740581621,1740581623,1740581623.671427,-21600,,
com.leomehlig.today,355,1740581161,1740581516,1740581516.929494,-21600,,
com.google.Chrome,37,1740581124,1740581161,1740581161.093639,-21600,,
com.renpho.health,35,1740580816,1740580851,1740580851.34769,-21600,EB445137-D7F5-57EC-87DA-1DB460D64046,"iPhone13,2"
com.myfitnesspal.mfp,58,1740549349,1740549407,1740549407.328512,-21600,EB445137-D7F5-57EC-87DA-1DB460D64046,"iPhone13,2"
com.thestorygraph.thestorygraph,125,1740549205,1740549330,1740549330.675556,-21600,EB445137-D7F5-57EC-87DA-1DB460D64046,"iPhone13,2"
com.apple.MobileSMS,2,1740549201,1740549203,1740549203.610373,-21600,EB445137-D7F5-57EC-87DA-1DB460D64046,"iPhone13,2"
com.google.Chrome,325,1740546192,1740546517,1740546517.544306,-21600,,
com.apple.finder,4,1740546188,1740546192,1740546192.140994,-21600,,
com.leomehlig.today,102,1740546086,1740546188,1740546188.562834,-21600,,
com.apple.iCal,6,1740546080,1740546086,1740546086.3862262,-21600,,
com.leomehlig.today,38,1740546042,1740546080,1740546080.186957,-21600,,
com.apple.Preview,1693,1740544349,1740546042,1740546042.2389069,-21600,,
com.leomehlig.today,53,1740544296,1740544349,1740544349.718916,-21600,,
com.apple.Preview,78,1740544218,1740544296,1740544296.3371549,-21600,,
com.apple.finder,7,1740544211,1740544218,1740544218.524219,-21600,,
com.google.Chrome,15,1740544196,1740544211,1740544211.062344,-21600,,
com.apple.MobileSMS,59,1740544115,1740544174,1740544174.109178,-21600,EB445137-D7F5-57EC-87DA-1DB460D64046,"iPhone13,2"
com.microsoft.Office.Outlook,1,1740544114,1740544115,1740544115.389978,-21600,EB445137-D7F5-57EC-87DA-1DB460D64046,"iPhone13,2"
com.google.Chrome,526,1740541880,1740542406,1740542406.54495,-21600,,
com.apple.finder,2,1740541878,1740541880,1740541881.117626,-21600,,
com.microsoft.Office.Outlook,27,1740541715,1740541742,1740541742.4395828,-21600,EB445137-D7F5-57EC-87DA-1DB460D64046,"iPhone13,2"
com.instructure.icanvas,40,1740541674,1740541714,1740541714.770724,-21600,EB445137-D7F5-57EC-87DA-1DB460D64046,"iPhone13,2"
com.apple.Music,0,1740541674,1740541674,1740541675.236312,-21600,EB445137-D7F5-57EC-87DA-1DB460D64046,"iPhone13,2"
com.apple.Music,41,1740540820,1740540861,1740540861.951884,-21600,EB445137-D7F5-57EC-87DA-1DB460D64046,"iPhone13,2"
com.groupme.iphone-app,1,1740540814,1740540815,1740540815.713825,-21600,EB445137-D7F5-57EC-87DA-1DB460D64046,"iPhone13,2"
com.apple.Music,0,1740540814,1740540814,1740540814.665262,-21600,EB445137-D7F5-57EC-87DA-1DB460D64046,"iPhone13,2"
com.apple.Music,11,1740539034,1740539045,1740539046.0175328,-21600,EB445137-D7F5-57EC-87DA-1DB460D64046,"iPhone13,2"
com.apple.MobileSMS,2,1740539029,1740539031,1740539032.186897,-21600,EB445137-D7F5-57EC-87DA-1DB460D64046,"iPhone13,2"
com.apple.MobileSMS,6,1740538959,1740538965,1740538965.466321,-21600,EB445137-D7F5-57EC-87DA-1DB460D64046,"iPhone13,2"
com.instructure.icanvas,5,1740538943,1740538948,1740538948.453751,-21600,EB445137-D7F5-57EC-87DA-1DB460D64046,"iPhone13,2"
com.instructure.icanvas,17,1740538921,1740538938,1740538939.120714,-21600,EB445137-D7F5-57EC-87DA-1DB460D64046,"iPhone13,2"
com.apple.finder,2,1740538787,1740538789,1740538789.881225,-21600,,
com.apple.MobileSMS,1,1740538786,1740538787,1740538787.441372,-21600,,
com.apple.MobileSMS,42,1740538741,1740538783,1740538783.948378,-21600,,
com.apple.finder,4,1740538737,1740538741,1740538741.165021,-21600,,
com.leomehlig.today,1,1740538736,1740538737,1740538738.009789,-21600,,
com.apple.finder,2,1740538734,1740538736,1740538736.9804192,-21600,,
com.apple.Notes,169,1740538565,1740538734,1740538734.234002,-21600,,
com.apple.Preview,1,1740538564,1740538565,1740538565.576398,-21600,,
com.apple.Notes,10,1740538554,1740538564,1740538564.421665,-21600,,
com.apple.finder,5,1740538549,1740538554,1740538554.5886521,-21600,,
com.apple.Notes,101,1740538448,1740538549,1740538549.772204,-21600,,
com.apple.Preview,5,1740538443,1740538448,1740538448.2780309,-21600,,
com.apple.Notes,5,1740538438,1740538443,1740538443.867125,-21600,,
com.apple.finder,1,1740538437,1740538438,1740538438.9668021,-21600,,
com.google.Chrome,2,1740538435,1740538437,1740538437.241523,-21600,,
com.apple.Notes,18,1740538417,1740538435,1740538435.9073892,-21600,,
com.google.Chrome,2,1740538415,1740538417,1740538417.2624788,-21600,,
com.apple.MobileSMS,253,1740538162,1740538415,1740538415.2463331,-21600,,
com.google.Chrome,14,1740538148,1740538162,1740538162.042233,-21600,,
com.apple.MobileSMS,35,1740538113,1740538148,1740538148.454743,-21600,,
com.apple.Notes,3,1740538110,1740538113,1740538114.054106,-21600,,
com.apple.MobileSMS,4,1740538106,1740538110,1740538110.293982,-21600,,
com.apple.Notes,18,1740538088,1740538106,1740538106.622725,-21600,,
com.apple.finder,55,1740538033,1740538088,1740538088.63585,-21600,,
com.apple.iCal,8,1740538025,1740538033,1740538033.657768,-21600,,
com.apple.finder,17,1740538008,1740538025,1740538025.214756,-21600,,
com.google.Chrome,91,1740537917,1740538008,1740538008.095045,-21600,,
com.apple.Preview,5,1740537900,1740537905,1740537905.0646749,-21600,,
com.apple.finder,9,1740537891,1740537900,1740537900.584784,-21600,,
com.leomehlig.today,14,1740537877,1740537891,1740537891.343673,-21600,,
com.apple.Notes,5,1740537872,1740537877,1740537878.053942,-21600,,
com.leomehlig.today,87,1740537785,1740537872,1740537872.466485,-21600,,
com.apple.Notes,160,1740537625,1740537785,1740537785.821056,-21600,,
com.google.Chrome,6,1740537619,1740537625,1740537625.791702,-21600,,
com.apple.Notes,26,1740537593,1740537619,1740537619.704423,-21600,,
com.google.Chrome,13,1740537580,1740537593,1740537593.62669,-21600,,
com.apple.Notes,25,1740537555,1740537580,1740537580.576243,-21600,,
com.google.Chrome,37,1740537518,1740537555,1740537555.938335,-21600,,
com.apple.Notes,8,1740537510,1740537518,1740537519.6338758,-21600,,
com.apple.finder,4,1740537506,1740537510,1740537510.196322,-21600,,
com.groupme.iphone-app,2,1740537376,1740537378,1740537378.9008942,-21600,EB445137-D7F5-57EC-87DA-1DB460D64046,"iPhone13,2"
com.apple.finder,3,1740537334,1740537337,1740537337.934953,-21600,,
com.apple.Notes,1,1740537333,1740537334,1740537334.730463,-21600,,
com.apple.finder,2,1740537331,1740537333,1740537333.882588,-21600,,
com.microsoft.VSCode,2,1740537329,1740537331,1740537332.00724,-21600,,
com.apple.Notes,6,1740537323,1740537329,1740537329.3847852,-21600,,
com.google.Chrome,472,1740536851,1740537323,1740537324.048833,-21600,,
com.apple.finder,9,1740536842,1740536851,1740536851.837949,-21600,,
com.google.Chrome,34,1740536808,1740536842,1740536842.829201,-21600,,
com.apple.finder,10,1740536798,1740536808,1740536808.3221679,-21600,,
com.google.Chrome,10,1740536788,1740536798,1740536798.343436,-21600,,
com.apple.Notes,1,1740536787,1740536788,1740536788.176723,-21600,,
com.apple.Preview,5,1740536782,1740536787,1740536787.3693562,-21600,,
com.apple.Notes,1,1740536781,1740536782,1740536782.6132941,-21600,,
com.google.Chrome,138,1740536643,1740536781,1740536781.2333689,-21600,,
com.apple.Notes,8,1740536635,1740536643,1740536643.916175,-21600,,
com.google.Chrome,40,1740536595,1740536635,1740536635.215396,-21600,,
com.apple.Preview,1,1740536594,1740536595,1740536595.386837,-21600,,
com.google.Chrome,4,1740536590,1740536594,1740536594.1995358,-21600,,
com.apple.Preview,9,1740536581,1740536590,1740536590.308648,-21600,,
com.google.Chrome,3,1740536578,1740536581,1740536581.0326371,-21600,,
com.apple.Preview,9,1740536569,1740536578,1740536578.274994,-21600,,
com.google.Chrome,102,1740536467,1740536569,1740536569.309298,-21600,,
com.apple.Preview,11,1740536456,1740536467,1740536467.22123,-21600,,
com.apple.finder,89,1740536367,1740536456,1740536456.789962,-21600,,
com.apple.Preview,133,1740536234,1740536367,1740536367.753139,-21600,,
com.apple.finder,8,1740536226,1740536234,1740536234.289957,-21600,,
com.google.Chrome,56,1740536170,1740536226,1740536226.037967,-21600,,
com.leomehlig.today,0,1740536170,1740536170,1740536170.733083,-21600,,
com.google.Chrome,3,1740536167,1740536170,1740536170.289963,-21600,,
com.apple.Preview,676,1740535491,1740536167,1740536167.984716,-21600,,
com.apple.finder,2,1740535489,1740535491,1740535491.4598231,-21600,,
com.leomehlig.today,10,1740535479,1740535489,1740535489.781713,-21600,,
com.google.Chrome,2,1740535477,1740535479,1740535479.596065,-21600,,
com.apple.Preview,690,1740534787,1740535477,1740535477.9686918,-21600,,
com.google.Chrome,332,1740534455,1740534787,1740534787.2631779,-21600,,
com.apple.Preview,372,1740534083,1740534455,1740534455.751837,-21600,,
com.apple.finder,1,1740534082,1740534083,1740534083.081781,-21600,,
com.apple.Preview,879,1740533203,1740534082,1740534082.329098,-21600,,
com.apple.finder,23,1740533180,1740533203,1740533203.73077,-21600,,
com.google.Chrome,125,1740533055,1740533180,1740533180.298832,-21600,,
com.groupme.iphone-app,5,1740533043,1740533048,1740533048.809184,-21600,EB445137-D7F5-57EC-87DA-1DB460D64046,"iPhone13,2"
Astrospheric.Astrospheric,1,1740533042,1740533043,1740533043.5240989,-21600,EB445137-D7F5-57EC-87DA-1DB460D64046,"iPhone13,2"
com.leomehlig.today,54,1740533001,1740533055,1740533056.115306,-21600,,
com.apple.iCal,56,1740532945,1740533001,1740533001.920315,-21600,,
com.leomehlig.today,1,1740532944,1740532945,1740532945.6045961,-21600,,
com.google.Chrome,1553,1740531391,1740532944,1740532944.666503,-21600,,
com.microsoft.VSCode,18,1740531373,1740531391,1740531391.330621,-21600,,
com.google.Chrome,460,1740530913,1740531373,1740531373.81048,-21600,,
com.leomehlig.today,11,1740530902,1740530913,1740530913.151939,-21600,,
com.google.Chrome,153,1740530749,1740530902,1740530902.7784219,-21600,,
com.google.Chrome,336,1740530403,1740530739,1740530739.355592,-21600,,
com.apple.Preview,3,1740530400,1740530403,1740530403.9273481,-21600,,
com.google.Chrome,12,1740530388,1740530400,1740530400.33082,-21600,,
com.apple.finder,26,1740530362,1740530388,1740530388.973216,-21600,,
com.google.Chrome,504,1740529858,1740530362,1740530362.597158,-21600,,
com.leomehlig.today,41,1740529817,1740529858,1740529858.413083,-21600,,
Astrospheric.Astrospheric,29,1740529528,1740529557,1740529557.7585912,-21600,EB445137-D7F5-57EC-87DA-1DB460D64046,"iPhone13,2"
com.apple.Music,2,1740529524,1740529526,1740529527.730819,-21600,EB445137-D7F5-57EC-87DA-1DB460D64046,"iPhone13,2"
com.apple.Music,10,1740528852,1740528862,1740528864.356553,-21600,EB445137-D7F5-57EC-87DA-1DB460D64046,"iPhone13,2"
com.apple.news,4,1740528848,1740528852,1740528852.5733,-21600,EB445137-D7F5-57EC-87DA-1DB460D64046,"iPhone13,2"
com.leomehlig.today,300,1740527450,1740527750,1740527750.587301,-21600,,
com.google.Chrome,4,1740527446,1740527450,1740527450.0321631,-21600,,
com.leomehlig.today,62,1740527384,1740527446,1740527446.497541,-21600,,
com.google.Chrome,1,1740527383,1740527384,1740527384.338132,-21600,,
com.google.Chrome,364,1740526916,1740527280,1740527280.081132,-21600,,
com.apple.finder,12,1740526904,1740526916,1740526916.195334,-21600,,
com.apple.news,35,1740526383,1740526418,1740526418.5199862,-21600,EB445137-D7F5-57EC-87DA-1DB460D64046,"iPhone13,2"
com.microsoft.Office.Outlook,9,1740526256,1740526265,1740526267.3748322,-21600,EB445137-D7F5-57EC-87DA-1DB460D64046,"iPhone13,2"
com.myfitnesspal.mfp,3,1740526253,1740526256,1740526256.065712,-21600,EB445137-D7F5-57EC-87DA-1DB460D64046,"iPhone13,2"
com.myfitnesspal.mfp,48,1740525993,1740526041,1740526041.539948,-21600,EB445137-D7F5-57EC-87DA-1DB460D64046,"iPhone13,2"
com.apple.news,62,1740525573,1740525635,1740525635.3096662,-21600,EB445137-D7F5-57EC-87DA-1DB460D64046,"iPhone13,2"
com.groupme.iphone-app,5,1740525561,1740525566,1740525566.12127,-21600,EB445137-D7F5-57EC-87DA-1DB460D64046,"iPhone13,2"
com.groupme.iphone-app,5,1740525278,1740525283,1740525283.831423,-21600,EB445137-D7F5-57EC-87DA-1DB460D64046,"iPhone13,2"
com.apple.Music,3,1740524045,1740524048,1740524049.4912949,-21600,EB445137-D7F5-57EC-87DA-1DB460D64046,"iPhone13,2"
com.apple.Music,24,1740524000,1740524024,1740524027.492189,-21600,EB445137-D7F5-57EC-87DA-1DB460D64046,"iPhone13,2"
com.microsoft.Office.Outlook,3,1740523992,1740523995,1740523998.061019,-21600,EB445137-D7F5-57EC-87DA-1DB460D64046,"iPhone13,2"
com.microsoft.Office.Outlook,14,1740523904,1740523918,1740523918.6131501,-21600,EB445137-D7F5-57EC-87DA-1DB460D64046,"iPhone13,2"
com.apple.finder,100,1740523735,1740523835,1740523835.817059,-21600,,
com.google.Chrome,9,1740523726,1740523735,1740523735.2301579,-21600,,
com.apple.finder,18,1740523708,1740523726,1740523726.712305,-21600,,
com.google.Chrome,53,1740523655,1740523708,1740523708.136972,-21600,,
com.apple.iCal,10,1740523645,1740523655,1740523655.848155,-21600,,
com.google.Chrome,20,1740523625,1740523645,1740523645.684257,-21600,,
com.apple.Preview,105,1740523520,1740523625,1740523625.725045,-21600,,
com.google.Chrome,5,1740523515,1740523520,1740523520.529772,-21600,,
com.apple.Preview,380,1740523135,1740523515,1740523515.336204,-21600,,
com.apple.Preview,300,1740522774,1740523074,1740523074.939807,-21600,,
com.google.Chrome,18,1740522756,1740522774,1740522774.9437618,-21600,,
com.apple.Preview,463,1740522293,1740522756,1740522756.473734,-21600,,
com.apple.finder,3,1740522290,1740522293,1740522293.373169,-21600,,
com.google.Chrome,448,1740521842,1740522290,1740522290.893002,-21600,,
com.google.chrome.ios,25,1740521621,1740521646,1740521646.758858,-21600,EB445137-D7F5-57EC-87DA-1DB460D64046,"iPhone13,2"
com.groupme.iphone-app,2,1740521617,1740521619,1740521619.7765,-21600,EB445137-D7F5-57EC-87DA-1DB460D64046,"iPhone13,2"
com.groupme.iphone-app,8,1740521443,1740521451,1740521451.648628,-21600,EB445137-D7F5-57EC-87DA-1DB460D64046,"iPhone13,2"
com.apple.news,2,1740521441,1740521443,1740521443.269583,-21600,EB445137-D7F5-57EC-87DA-1DB460D64046,"iPhone13,2"
com.google.Chrome,632,1740521024,1740521656,1740521657.006768,-21600,,
com.google.Chrome,1892,1740519083,1740520975,1740520975.922657,-21600,,
com.apple.Preview,1,1740519082,1740519083,1740519083.510507,-21600,,
com.apple.Preview,300,1740518695,1740518995,1740518995.381544,-21600,,
com.google.Chrome,9,1740518686,1740518695,1740518695.3946462,-21600,,
com.apple.Preview,45,1740518641,1740518686,1740518686.541276,-21600,,
com.google.Chrome,248,1740518393,1740518641,1740518641.42926,-21600,,
com.apple.Preview,173,1740518220,1740518393,1740518393.542311,-21600,,
com.apple.finder,6,1740518214,1740518220,1740518220.68596,-21600,,
com.google.Chrome,204,1740518010,1740518214,1740518214.316567,-21600,,
com.google.Chrome,526,1740517298,1740517824,1740517824.280644,-21600,,
com.apple.finder,132,1740517166,1740517298,1740517298.549965,-21600,,
com.google.Chrome,295,1740516871,1740517166,1740517167.0162559,-21600,,
com.apple.news,163,1740512502,1740512665,1740512666.207186,-21600,EB445137-D7F5-57EC-87DA-1DB460D64046,"iPhone13,2"
com.apple.Health,37,1740512454,1740512491,1740512491.4687629,-21600,EB445137-D7F5-57EC-87DA-1DB460D64046,"iPhone13,2"
Astrospheric.Astrospheric,15,1740510058,1740510073,1740510073.627737,-21600,EB445137-D7F5-57EC-87DA-1DB460D64046,"iPhone13,2"
com.apple.weather,31,1740510026,1740510057,1740510057.463834,-21600,EB445137-D7F5-57EC-87DA-1DB460D64046,"iPhone13,2"
com.google.chrome.ios,45,1740509264,1740509309,1740509309.647451,-21600,EB445137-D7F5-57EC-87DA-1DB460D64046,"iPhone13,2"
com.apple.mobilecal,44,1740509220,1740509264,1740509264.200499,-21600,EB445137-D7F5-57EC-87DA-1DB460D64046,"iPhone13,2"
Astrospheric.Astrospheric,8,1740509199,1740509207,1740509208.123467,-21600,EB445137-D7F5-57EC-87DA-1DB460D64046,"iPhone13,2"
Astrospheric.Astrospheric,30,1740507439,1740507469,1740507470.058222,-21600,EB445137-D7F5-57EC-87DA-1DB460D64046,"iPhone13,2"
com.apple.mobilecal,2,1740507436,1740507438,1740507438.333467,-21600,EB445137-D7F5-57EC-87DA-1DB460D64046,"iPhone13,2"
com.apple.mobilecal,6,1740506868,1740506874,1740506874.831699,-21600,EB445137-D7F5-57EC-87DA-1DB460D64046,"iPhone13,2"
com.apple.mobilecal,23,1740506838,1740506861,1740506861.901472,-21600,EB445137-D7F5-57EC-87DA-1DB460D64046,"iPhone13,2"
com.google.chrome.ios,21,1740506814,1740506835,1740506835.928457,-21600,EB445137-D7F5-57EC-87DA-1DB460D64046,"iPhone13,2"
com.tinyspeck.chatlyio,27,1740506483,1740506510,1740506511.019484,-21600,EB445137-D7F5-57EC-87DA-1DB460D64046,"iPhone13,2"
com.microsoft.Office.Outlook,82,1740506370,1740506452,1740506452.401112,-21600,EB445137-D7F5-57EC-87DA-1DB460D64046,"iPhone13,2"
com.google.Gmail,18,1740506342,1740506360,1740506360.695463,-21600,EB445137-D7F5-57EC-87DA-1DB460D64046,"iPhone13,2"
com.myfitnesspal.mfp,0,1740506342,1740506342,1740506343.690069,-21600,EB445137-D7F5-57EC-87DA-1DB460D64046,"iPhone13,2"
com.myfitnesspal.mfp,113,1740506221,1740506334,1740506334.726315,-21600,EB445137-D7F5-57EC-87DA-1DB460D64046,"iPhone13,2"
com.microsoft.Office.Outlook,3,1740506215,1740506218,1740506218.9377198,-21600,EB445137-D7F5-57EC-87DA-1DB460D64046,"iPhone13,2"
com.myfitnesspal.mfp,5,1740506207,1740506212,1740506212.4595752,-21600,EB445137-D7F5-57EC-87DA-1DB460D64046,"iPhone13,2"
com.google.Chrome,422,1740505977,1740506399,1740506399.3642712,-21600,,
com.google.Chrome,580,1740505347,1740505927,1740505927.163527,-21600,,
com.google.Chrome,355,1740504990,1740505345,1740505345.173685,-21600,,
com.microsoft.onenote.mac,11,1740504979,1740504990,1740504990.284443,-21600,,
com.myfitnesspal.mfp,156,1740504955,1740505111,1740505112.1098619,-21600,EB445137-D7F5-57EC-87DA-1DB460D64046,"iPhone13,2"
com.apple.calculator,7,1740504948,1740504955,1740504955.717105,-21600,EB445137-D7F5-57EC-87DA-1DB460D64046,"iPhone13,2"
com.myfitnesspal.mfp,23,1740504925,1740504948,1740504948.881006,-21600,EB445137-D7F5-57EC-87DA-1DB460D64046,"iPhone13,2"
com.myfitnesspal.mfp,196,1740504596,1740504792,1740504792.3764381,-21600,EB445137-D7F5-57EC-87DA-1DB460D64046,"iPhone13,2"
com.microsoft.Office.Outlook,51,1740504537,1740504588,1740504589.015368,-21600,EB445137-D7F5-57EC-87DA-1DB460D64046,"iPhone13,2"
com.renpho.health,1,1740504536,1740504537,1740504539.618912,-21600,EB445137-D7F5-57EC-87DA-1DB460D64046,"iPhone13,2"
com.google.Chrome,531,1740504448,1740504979,1740504979.2791538,-21600,,
com.leomehlig.today,4,1740504444,1740504448,1740504449.390882,-21600,,
com.leomehlig.today,323,1740503666,1740503989,1740503989.451689,-21600,,
com.apple.iCal,6,1740503660,1740503666,1740503666.8814368,-21600,,
com.leomehlig.today,87,1740503573,1740503660,1740503660.381907,-21600,,
com.hnc.Discord,2,1740503571,1740503573,1740503573.423661,-21600,,
com.microsoft.VSCode,2,1740503569,1740503571,1740503571.5679178,-21600,,
com.google.Chrome,54,1740503515,1740503569,1740503569.8891249,-21600,,
com.microsoft.VSCode,157,1740503358,1740503515,1740503515.694479,-21600,,
com.google.Chrome,4,1740503354,1740503358,1740503358.964854,-21600,,
com.microsoft.VSCode,20,1740503334,1740503354,1740503354.416939,-21600,,
com.google.Chrome,9,1740503325,1740503334,1740503334.408533,-21600,,
com.microsoft.VSCode,4,1740503321,1740503325,1740503325.251686,-21600,,
com.google.Chrome,15,1740503306,1740503321,1740503321.095086,-21600,,
com.microsoft.VSCode,53,1740503253,1740503306,1740503306.946776,-21600,,
com.google.Chrome,8,1740503245,1740503253,1740503253.111188,-21600,,
com.microsoft.VSCode,12,1740503233,1740503245,1740503245.581949,-21600,,
com.google.Chrome,9,1740503224,1740503233,1740503233.239709,-21600,,
com.microsoft.VSCode,76,1740503148,1740503224,1740503224.5983381,-21600,,
com.google.Chrome,336,1740502812,1740503148,1740503148.4456,-21600,,
com.microsoft.VSCode,45,1740502767,1740502812,1740502812.909744,-21600,,
com.google.Chrome,7,1740502760,1740502767,1740502767.223463,-21600,,
com.hnc.Discord,1,1740502759,1740502760,1740502760.037811,-21600,,
com.microsoft.VSCode,56,1740502703,1740502759,1740502759.3103209,-21600,,
com.hnc.Discord,1,1740502702,1740502703,1740502703.828,-21600,,
com.google.Chrome,227,1740502475,1740502702,1740502702.955718,-21600,,
com.leomehlig.today,15,1740502460,1740502475,1740502475.976654,-21600,,
com.google.Chrome,11,1740502449,1740502460,1740502460.322887,-21600,,
com.hnc.Discord,12,1740502437,1740502449,1740502449.898705,-21600,,
com.google.Chrome,8,1740502429,1740502437,1740502437.811325,-21600,,
com.microsoft.VSCode,209,1740502220,1740502429,1740502430.0475302,-21600,,
com.google.Chrome,56,1740502164,1740502220,1740502220.8554502,-21600,,
com.microsoft.VSCode,23,1740502141,1740502164,1740502164.788301,-21600,,
com.apple.Preview,1,1740502140,1740502141,1740502141.039335,-21600,,
com.google.Chrome,4,1740502136,1740502140,1740502140.376966,-21600,,
com.apple.Preview,1,1740502135,1740502136,1740502136.948839,-21600,,
com.microsoft.VSCode,341,1740501794,1740502135,1740502135.251241,-21600,,
com.google.Chrome,12,1740501782,1740501794,1740501794.557348,-21600,,
com.microsoft.VSCode,54,1740501728,1740501782,1740501782.730675,-21600,,
com.google.Chrome,2,1740501726,1740501728,1740501729.044996,-21600,,
com.microsoft.VSCode,11,1740501715,1740501726,1740501726.867384,-21600,,
com.google.Chrome,3,1740501712,1740501715,1740501715.394171,-21600,,
com.microsoft.VSCode,231,1740501481,1740501712,1740501712.5446172,-21600,,
com.google.Chrome,73,1740501408,1740501481,1740501481.950455,-21600,,
com.google.Chrome,698,1740500709,1740501407,1740501407.5377932,-21600,,
com.apple.Preview,1,1740500708,1740500709,1740500709.8080502,-21600,,
com.hnc.Discord,3,1740500705,1740500708,1740500708.603956,-21600,,
com.google.Chrome,5,1740500700,1740500705,1740500705.151044,-21600,,
com.hnc.Discord,52,1740500648,1740500700,1740500700.738385,-21600,,
com.apple.Preview,43,1740500605,1740500648,1740500648.5618482,-21600,,
com.apple.finder,8,1740500597,1740500605,1740500605.306514,-21600,,
com.google.Chrome,189,1740500408,1740500597,1740500597.756019,-21600,,
com.apple.Preview,20,1740500388,1740500408,1740500408.924769,-21600,,
com.apple.finder,5,1740500383,1740500388,1740500388.229223,-21600,,
com.google.Chrome,821,1740499562,1740500383,1740500383.2832398,-21600,,
com.hnc.Discord,81,1740499481,1740499562,1740499562.239708,-21600,,
com.google.Chrome,7,1740499474,1740499481,1740499482.006195,-21600,,
com.hnc.Discord,86,1740499388,1740499474,1740499474.3021998,-21600,,
com.google.Chrome,263,1740499125,1740499388,1740499388.110357,-21600,,
com.hnc.Discord,74,1740499051,1740499125,1740499125.177043,-21600,,
com.google.Chrome,4,1740499047,1740499051,1740499051.181971,-21600,,
com.hnc.Discord,24,1740499023,1740499047,1740499047.18244,-21600,,
com.google.Chrome,41,1740498982,1740499023,1740499023.211293,-21600,,
com.hnc.Discord,9,1740498973,1740498982,1740498982.87394,-21600,,
com.google.Chrome,71,1740498902,1740498973,1740498973.2136579,-21600,,
com.hnc.Discord,3,1740498899,1740498902,1740498903.000361,-21600,,
com.google.Chrome,100,1740498799,1740498899,1740498899.4839659,-21600,,
com.hnc.Discord,56,1740498743,1740498799,1740498799.923157,-21600,,
com.google.Chrome,17,1740498726,1740498743,1740498743.525014,-21600,,
com.hnc.Discord,22,1740498704,1740498726,1740498726.730886,-21600,,
com.google.Chrome,275,1740498429,1740498704,1740498704.430372,-21600,,
com.leomehlig.today,28,1740498401,1740498429,1740498429.330842,-21600,,
com.apple.finder,3,1740498398,1740498401,1740498401.552495,-21600,,
com.google.Chrome,2,1740498396,1740498398,1740498398.394125,-21600,,
com.google.Chrome,2,1740497290,1740497292,1740497292.957542,-21600,,
com.apple.Preview,505,1740496785,1740497290,1740497290.7485762,-21600,,
com.google.Chrome,29,1740496756,1740496785,1740496785.6547399,-21600,,
com.apple.Preview,199,1740496557,1740496756,1740496757.1274529,-21600,,
com.apple.Preview,1331,1740495217,1740496548,1740496548.108611,-21600,,
com.apple.finder,5,1740495212,1740495217,1740495217.445485,-21600,,
com.google.Chrome,2,1740495210,1740495212,1740495212.274435,-21600,,
com.renpho.health,38,1740493978,1740494016,1740494016.899807,-21600,EB445137-D7F5-57EC-87DA-1DB460D64046,"iPhone13,2"
com.apple.weather,41,1740493936,1740493977,1740493978.1892629,-21600,EB445137-D7F5-57EC-87DA-1DB460D64046,"iPhone13,2"
com.microsoft.Office.Outlook,29,1740493185,1740493214,1740493214.0970268,-21600,EB445137-D7F5-57EC-87DA-1DB460D64046,"iPhone13,2"
com.apple.MobileSMS,8,1740493047,1740493055,1740493055.409848,-21600,EB445137-D7F5-57EC-87DA-1DB460D64046,"iPhone13,2"
com.apple.MobileSMS,44,1740492999,1740493043,1740493043.375093,-21600,EB445137-D7F5-57EC-87DA-1DB460D64046,"iPhone13,2"
com.apple.Health,58,1740463010,1740463068,1740463068.4583879,-21600,EB445137-D7F5-57EC-87DA-1DB460D64046,"iPhone13,2"
com.apple.journal,349,1740462659,1740463008,1740463008.551619,-21600,EB445137-D7F5-57EC-87DA-1DB460D64046,"iPhone13,2"
com.apple.journal,99,1740462559,1740462658,1740462658.358526,-21600,EB445137-D7F5-57EC-87DA-1DB460D64046,"iPhone13,2"
com.google.chrome.ios,13,1740462546,1740462559,1740462559.3205462,-21600,EB445137-D7F5-57EC-87DA-1DB460D64046,"iPhone13,2"
com.apple.CoreAuthUI,2,1740462242,1740462244,1740462244.616706,-21600,EB445137-D7F5-57EC-87DA-1DB460D64046,"iPhone13,2"
com.apple.journal,305,1740462241,1740462546,1740462546.055941,-21600,EB445137-D7F5-57EC-87DA-1DB460D64046,"iPhone13,2"
com.google.Chrome,715,1740459306,1740460021,1740460021.881054,-21600,,
com.leomehlig.today,42,1740459264,1740459306,1740459306.059377,-21600,,
com.leomehlig.today,307,1740458839,1740459146,1740459146.8169289,-21600,,
com.apple.Notes,41,1740458798,1740458839,1740458839.965928,-21600,,
com.leomehlig.today,120,1740458678,1740458798,1740458798.909566,-21600,,
com.apple.finder,2,1740458676,1740458678,1740458678.483564,-21600,,
com.microsoft.Outlook,0,1740458676,1740458676,1740458676.768321,-21600,,
com.google.Chrome,60,1740458616,1740458676,1740458676.28689,-21600,,
com.apple.finder,17,1740458599,1740458616,1740458616.482482,-21600,,
com.apple.Preview,36,1740458563,1740458599,1740458599.2331362,-21600,,
com.apple.finder,2,1740458561,1740458563,1740458563.771143,-21600,,
com.apple.Preview,6,1740458555,1740458561,1740458561.375113,-21600,,
com.apple.finder,15,1740458540,1740458555,1740458555.201899,-21600,,
com.google.Chrome,5,1740458535,1740458540,1740458540.97241,-21600,,
com.apple.finder,31,1740458504,1740458535,1740458535.616916,-21600,,
com.google.chrome.ios,2,1740458399,1740458401,1740458401.814671,-21600,EB445137-D7F5-57EC-87DA-1DB460D64046,"iPhone13,2"
com.google.Chrome,463,1740458041,1740458504,1740458504.111477,-21600,,
com.apple.MobileSMS,23,1740458018,1740458041,1740458041.421483,-21600,,
com.google.chrome.ios,50,1740452022,1740452072,1740452073.289289,-21600,EB445137-D7F5-57EC-87DA-1DB460D64046,"iPhone13,2"
com.apple.MobileSMS,98,1740450603,1740450701,1740450701.47371,-21600,,
com.google.Chrome,493,1740450110,1740450603,1740450603.974576,-21600,,
com.apple.MobileSMS,15,1740450095,1740450110,1740450110.972567,-21600,,
com.google.Chrome,22,1740450073,1740450095,1740450095.660101,-21600,,
com.apple.Preview,1,1740450072,1740450073,1740450073.2621698,-21600,,
com.google.Chrome,1,1740450071,1740450072,1740450072.247065,-21600,,
com.apple.Preview,7,1740450064,1740450071,1740450071.7841039,-21600,,
com.google.Chrome,67,1740449997,1740450064,1740450064.460485,-21600,,
com.apple.MobileSMS,3,1740449994,1740449997,1740449997.13104,-21600,,
com.google.Chrome,42,1740449952,1740449994,1740449995.064093,-21600,,
com.apple.MobileSMS,2,1740449950,1740449952,1740449952.5745301,-21600,,
com.google.Chrome,62,1740449888,1740449950,1740449950.3138041,-21600,,
com.apple.MobileSMS,68,1740449820,1740449888,1740449888.9285688,-21600,,
com.google.Chrome,7,1740449813,1740449820,1740449820.802188,-21600,,
com.apple.MobileSMS,65,1740449748,1740449813,1740449813.8361921,-21600,,
com.google.Chrome,21,1740449727,1740449748,1740449748.815898,-21600,,
com.apple.Preview,2,1740449725,1740449727,1740449727.249763,-21600,,
com.google.Chrome,3,1740449722,1740449725,1740449725.0946531,-21600,,
com.apple.Preview,12,1740449710,1740449722,1740449722.4045901,-21600,,
com.apple.finder,5,1740449705,1740449710,1740449710.562955,-21600,,
com.apple.Preview,10,1740449695,1740449705,1740449705.174283,-21600,,
com.google.Chrome,30,1740449665,1740449695,1740449695.617615,-21600,,
com.apple.MobileSMS,3,1740448445,1740448448,1740448448.527405,-21600,EB445137-D7F5-57EC-87DA-1DB460D64046,"iPhone13,2"
com.apple.MobileSMS,13,1740448128,1740448141,1740448141.344565,-21600,EB445137-D7F5-57EC-87DA-1DB460D64046,"iPhone13,2"
com.apple.MobileSMS,6,1740448104,1740448110,1740448110.231205,-21600,EB445137-D7F5-57EC-87DA-1DB460D64046,"iPhone13,2"
com.apple.MobileSMS,17,1740448071,1740448088,1740448088.896831,-21600,EB445137-D7F5-57EC-87DA-1DB460D64046,"iPhone13,2"
com.apple.MobileSMS,12,1740447822,1740447834,1740447834.635782,-21600,EB445137-D7F5-57EC-87DA-1DB460D64046,"iPhone13,2"
com.apple.news,0,1740447822,1740447822,1740447823.288608,-21600,EB445137-D7F5-57EC-87DA-1DB460D64046,"iPhone13,2"
com.apple.news,44,1740445299,1740445343,1740445344.126298,-21600,EB445137-D7F5-57EC-87DA-1DB460D64046,"iPhone13,2"
com.apple.news,66,1740445192,1740445258,1740445258.601173,-21600,EB445137-D7F5-57EC-87DA-1DB460D64046,"iPhone13,2"
com.google.chrome.ios,160,1740444987,1740445147,1740445147.679385,-21600,EB445137-D7F5-57EC-87DA-1DB460D64046,"iPhone13,2"
com.hammerandchisel.discord,2,1740444985,1740444987,1740444987.203652,-21600,EB445137-D7F5-57EC-87DA-1DB460D64046,"iPhone13,2"
com.hammerandchisel.discord,11,1740444865,1740444876,1740444876.855741,-21600,EB445137-D7F5-57EC-87DA-1DB460D64046,"iPhone13,2"
com.google.ios.youtube,1,1740444864,1740444865,1740444865.721352,-21600,EB445137-D7F5-57EC-87DA-1DB460D64046,"iPhone13,2"
com.google.Chrome,38,1740444313,1740444351,1740444351.967917,-21600,,
com.google.ios.youtube,83,1740444229,1740444312,1740444313.1067939,-21600,EB445137-D7F5-57EC-87DA-1DB460D64046,"iPhone13,2"
com.leomehlig.today,138,1740444175,1740444313,1740444313.5426512,-21600,,
com.google.Chrome,561,1740443614,1740444175,1740444176.0803761,-21600,,
com.apple.Preview,137,1740443477,1740443614,1740443614.8860478,-21600,,
com.apple.finder,5,1740443472,1740443477,1740443477.2535372,-21600,,
co.hinge.mobile.ios,246,1740443180,1740443426,1740443426.407536,-21600,EB445137-D7F5-57EC-87DA-1DB460D64046,"iPhone13,2"
com.google.Chrome,343,1740443129,1740443472,1740443472.261633,-21600,,
com.intsig.CamScannerLite,128,1740443025,1740443153,1740443153.591984,-21600,EB445137-D7F5-57EC-87DA-1DB460D64046,"iPhone13,2"
com.apple.Preview,184,1740442945,1740443129,1740443130.0418491,-21600,,
com.apple.finder,1,1740442944,1740442945,1740442945.570914,-21600,,
com.google.Chrome,93,1740442851,1740442944,1740442944.039878,-21600,,
com.apple.Preview,277,1740442560,1740442837,1740442837.830985,-21600,,
com.apple.finder,9,1740442551,1740442560,1740442560.146842,-21600,,
com.google.Chrome,928,1740441623,1740442551,1740442551.8306851,-21600,,
com.microsoft.Outlook,2,1740441621,1740441623,1740441624.6539721,-21600,,
com.microsoft.Outlook,367,1740441136,1740441503,1740441503.240594,-21600,,
com.leomehlig.today,271,1740440865,1740441136,1740441136.809309,-21600,,
com.apple.MobileSMS,0,1740440865,1740440865,1740440865.764276,-21600,,
com.leomehlig.today,1,1740440864,1740440865,1740440865.5515208,-21600,,
com.apple.Notes,1,1740440863,1740440864,1740440864.258607,-21600,,
com.google.Chrome,20,1740440843,1740440863,1740440863.8917909,-21600,,
com.groupme.iphone-app,6,1740440807,1740440813,1740440813.45185,-21600,EB445137-D7F5-57EC-87DA-1DB460D64046,"iPhone13,2"
com.instructure.icanvas,1,1740440806,1740440807,1740440807.848164,-21600,EB445137-D7F5-57EC-87DA-1DB460D64046,"iPhone13,2"
com.instructure.icanvas,6,1740440308,1740440314,1740440315.5893521,-21600,EB445137-D7F5-57EC-87DA-1DB460D64046,"iPhone13,2"
com.myfitnesspal.mfp,30,1740439168,1740439198,1740439199.228197,-21600,EB445137-D7F5-57EC-87DA-1DB460D64046,"iPhone13,2"
com.google.Chrome,687,1740438403,1740439090,1740439090.765707,-21600,,
com.leomehlig.today,2,1740438401,1740438403,1740438403.1637769,-21600,,
com.netflix.Netflix,15,1740437916,1740437931,1740437931.669265,-21600,EB445137-D7F5-57EC-87DA-1DB460D64046,"iPhone13,2"
com.google.chrome.ios,15,1740437899,1740437914,1740437914.964799,-21600,EB445137-D7F5-57EC-87DA-1DB460D64046,"iPhone13,2"
com.google.chrome.ios,84,1740437680,1740437764,1740437764.5623531,-21600,EB445137-D7F5-57EC-87DA-1DB460D64046,"iPhone13,2"
com.microsoft.Office.Outlook,31,1740437649,1740437680,1740437680.628864,-21600,EB445137-D7F5-57EC-87DA-1DB460D64046,"iPhone13,2"
com.apple.mobilephone,0,1740437649,1740437649,1740437650.1313848,-21600,EB445137-D7F5-57EC-87DA-1DB460D64046,"iPhone13,2"
com.leomehlig.today,330,1740437572,1740437902,1740437902.255499,-21600,,
com.apple.Notes,1,1740437571,1740437572,1740437572.8755689,-21600,,
com.apple.mobilephone,1,1740437141,1740437142,1740437142.792444,-21600,EB445137-D7F5-57EC-87DA-1DB460D64046,"iPhone13,2"
com.apple.InCallService,114,1740437027,1740437141,1740437141.434771,-21600,EB445137-D7F5-57EC-87DA-1DB460D64046,"iPhone13,2"
com.apple.InCallService,2,1740437023,1740437025,1740437025.431538,-21600,EB445137-D7F5-57EC-87DA-1DB460D64046,"iPhone13,2"
com.apple.mobilephone,3,1740437020,1740437023,1740437023.55732,-21600,EB445137-D7F5-57EC-87DA-1DB460D64046,"iPhone13,2"
com.apple.weather,2,1740436940,1740436942,1740436942.4294791,-21600,EB445137-D7F5-57EC-87DA-1DB460D64046,"iPhone13,2"
com.microsoft.Office.Outlook,2,1740436937,1740436939,1740436939.8914719,-21600,EB445137-D7F5-57EC-87DA-1DB460D64046,"iPhone13,2"
com.microsoft.Office.Outlook,10,1740436927,1740436937,1740436937.5384479,-21600,EB445137-D7F5-57EC-87DA-1DB460D64046,"iPhone13,2"
com.leomehlig.today,53,1740436868,1740436921,1740436921.124174,-21600,EB445137-D7F5-57EC-87DA-1DB460D64046,"iPhone13,2"
com.apple.news,46,1740436808,1740436854,1740436854.942408,-21600,EB445137-D7F5-57EC-87DA-1DB460D64046,"iPhone13,2"
com.burbn.instagram,57,1740436748,1740436805,1740436805.3651881,-21600,EB445137-D7F5-57EC-87DA-1DB460D64046,"iPhone13,2"
com.google.Gmail,8,1740436736,1740436744,1740436744.208664,-21600,EB445137-D7F5-57EC-87DA-1DB460D64046,"iPhone13,2"
com.google.Gmail,23,1740436713,1740436736,1740436736.119897,-21600,EB445137-D7F5-57EC-87DA-1DB460D64046,"iPhone13,2"
com.google.Gmail,13,1740436687,1740436700,1740436700.8259568,-21600,EB445137-D7F5-57EC-87DA-1DB460D64046,"iPhone13,2"
com.apple.news,0,1740436687,1740436687,1740436688.395072,-21600,EB445137-D7F5-57EC-87DA-1DB460D64046,"iPhone13,2"
com.apple.Notes,300,1740436647,1740436947,1740436947.2570372,-21600,,
us.zoom.xos,15,1740436632,1740436647,1740436647.190074,-21600,,
com.apple.Notes,12,1740436620,1740436632,1740436632.4805079,-21600,,
us.zoom.xos,210,1740436410,1740436620,1740436620.714771,-21600,,
com.apple.Notes,150,1740436260,1740436410,1740436410.610805,-21600,,
us.zoom.xos,10,1740436250,1740436260,1740436260.847684,-21600,,
com.apple.Notes,15,1740436235,1740436250,1740436250.618146,-21600,,
us.zoom.xos,4,1740436231,1740436235,1740436235.96859,-21600,,
com.apple.Notes,232,1740435999,1740436231,1740436231.528153,-21600,,
us.zoom.xos,76,1740435923,1740435999,1740436000.022347,-21600,,
com.google.Chrome,43,1740435880,1740435923,1740435923.839107,-21600,,
us.zoom.xos,124,1740435756,1740435880,1740435880.80112,-21600,,
com.google.Chrome,7,1740435749,1740435756,1740435756.638681,-21600,,
us.zoom.xos,101,1740435648,1740435749,1740435749.293958,-21600,,
com.google.Chrome,45,1740435603,1740435648,1740435648.178668,-21600,,
com.apple.Notes,324,1740435279,1740435603,1740435603.329464,-21600,,
com.apple.iCal,5,1740435274,1740435279,1740435279.632261,-21600,,
us.zoom.xos,25,1740435249,1740435274,1740435274.985352,-21600,,
com.google.Chrome,65,1740435184,1740435249,1740435249.190539,-21600,,
com.apple.Notes,80,1740435104,1740435184,1740435184.8871632,-21600,,
com.google.Chrome,44,1740435060,1740435104,1740435105.0366678,-21600,,
com.apple.Notes,71,1740434989,1740435060,1740435060.324575,-21600,,
com.google.Chrome,38,1740434951,1740434989,1740434990.020036,-21600,,
us.zoom.xos,53,1740434898,1740434951,1740434951.825351,-21600,,
com.google.Chrome,104,1740434794,1740434898,1740434898.835065,-21600,,
com.apple.Notes,9,1740434785,1740434794,1740434794.224267,-21600,,
us.zoom.xos,51,1740434734,1740434785,1740434785.3870559,-21600,,
com.apple.Notes,68,1740434633,1740434701,1740434701.165842,-21600,,
com.google.Chrome,111,1740434522,1740434633,1740434633.4717112,-21600,,
com.apple.Notes,72,1740434450,1740434522,1740434522.487005,-21600,,
us.zoom.xos,83,1740434367,1740434450,1740434450.13766,-21600,,
com.google.Chrome,5,1740434362,1740434367,1740434367.570869,-21600,,
us.zoom.xos,1,1740434361,1740434362,1740434362.4071121,-21600,,
com.google.Chrome,2,1740434359,1740434361,1740434361.354796,-21600,,
us.zoom.xos,8,1740434351,1740434359,1740434359.730629,-21600,,
com.google.Chrome,2,1740434349,1740434351,1740434352.0770268,-21600,,
com.apple.MobileSMS,1,1740434348,1740434349,1740434349.859033,-21600,,
com.google.Chrome,130,1740434218,1740434348,1740434348.685567,-21600,,
com.apple.MobileSMS,3,1740434215,1740434218,1740434218.417609,-21600,,
com.google.Chrome,776,1740433439,1740434215,1740434215.6159601,-21600,,
com.apple.MobileSMS,1,1740433438,1740433439,1740433439.1980062,-21600,,
com.google.Chrome,1,1740433437,1740433438,1740433439.0530648,-21600,,
com.apple.MobileSMS,0,1740433437,1740433437,1740433437.5716028,-21600,,
com.google.Chrome,2,1740433435,1740433437,1740433437.303695,-21600,,
com.apple.MobileSMS,0,1740433435,1740433435,1740433435.574736,-21600,,
com.google.Chrome,7,1740433428,1740433435,1740433435.198749,-21600,,
com.apple.MobileSMS,17,1740433411,1740433428,1740433428.409513,-21600,,
com.apple.finder,41,1740433370,1740433411,1740433411.817662,-21600,,
com.google.Chrome,2,1740433368,1740433370,1740433370.6451821,-21600,,
com.apple.MobileSMS,7,1740433224,1740433231,1740433231.076089,-21600,,
com.google.Chrome,2,1740433222,1740433224,1740433224.912201,-21600,,
com.apple.news,205,1740433013,1740433218,1740433218.844849,-21600,EB445137-D7F5-57EC-87DA-1DB460D64046,"iPhone13,2"
com.myfitnesspal.mfp,51,1740432954,1740433005,1740433006.030652,-21600,EB445137-D7F5-57EC-87DA-1DB460D64046,"iPhone13,2"
com.apple.InCallService,19,1740432815,1740432834,1740432834.166504,-21600,EB445137-D7F5-57EC-87DA-1DB460D64046,"iPhone13,2"
com.apple.CoreAuthUI,7,1740432790,1740432797,1740432797.758542,-21600,EB445137-D7F5-57EC-87DA-1DB460D64046,"iPhone13,2"
com.truebill.truebillnative,23,1740432787,1740432810,1740432810.437912,-21600,EB445137-D7F5-57EC-87DA-1DB460D64046,"iPhone13,2"
com.apple.InCallService,3,1740432775,1740432778,1740432778.554774,-21600,EB445137-D7F5-57EC-87DA-1DB460D64046,"iPhone13,2"
com.apple.InCallService,6,1740432742,1740432748,1740432748.125074,-21600,EB445137-D7F5-57EC-87DA-1DB460D64046,"iPhone13,2"
com.apple.MobileSMS,34,1740432708,1740432742,1740432742.023983,-21600,EB445137-D7F5-57EC-87DA-1DB460D64046,"iPhone13,2"
com.apple.InCallService,20,1740432681,1740432701,1740432701.504904,-21600,EB445137-D7F5-57EC-87DA-1DB460D64046,"iPhone13,2"
com.google.chrome.ios,39,1740432642,1740432681,1740432681.626069,-21600,EB445137-D7F5-57EC-87DA-1DB460D64046,"iPhone13,2"
com.apple.InCallService,73,1740432569,1740432642,1740432642.455748,-21600,EB445137-D7F5-57EC-87DA-1DB460D64046,"iPhone13,2"
com.apple.mobileslideshow,28,1740432139,1740432167,1740432167.7190819,-21600,EB445137-D7F5-57EC-87DA-1DB460D64046,"iPhone13,2"
com.microsoft.Office.Outlook,27,1740431870,1740431897,1740431897.306078,-21600,EB445137-D7F5-57EC-87DA-1DB460D64046,"iPhone13,2"
com.apple.mobilecal,101,1740431768,1740431869,1740431869.76689,-21600,EB445137-D7F5-57EC-87DA-1DB460D64046,"iPhone13,2"
com.apple.Maps,2,1740431762,1740431764,1740431765.015187,-21600,EB445137-D7F5-57EC-87DA-1DB460D64046,"iPhone13,2"
com.apple.InCallService,192,1740431563,1740431755,1740431755.156478,-21600,EB445137-D7F5-57EC-87DA-1DB460D64046,"iPhone13,2"
com.apple.InCallService,2,1740431087,1740431089,1740431089.912158,-21600,EB445137-D7F5-57EC-87DA-1DB460D64046,"iPhone13,2"
com.apple.mobilephone,4,1740431083,1740431087,1740431088.6221318,-21600,EB445137-D7F5-57EC-87DA-1DB460D64046,"iPhone13,2"
com.apple.findmy,7,1740431076,1740431083,1740431084.168153,-21600,EB445137-D7F5-57EC-87DA-1DB460D64046,"iPhone13,2"
com.google.chrome.ios,39,1740430937,1740430976,1740430976.798137,-21600,EB445137-D7F5-57EC-87DA-1DB460D64046,"iPhone13,2"
com.google.chrome.ios,20,1740430872,1740430892,1740430893.1137981,-21600,EB445137-D7F5-57EC-87DA-1DB460D64046,"iPhone13,2"
com.apple.news,2,1740430870,1740430872,1740430872.198588,-21600,EB445137-D7F5-57EC-87DA-1DB460D64046,"iPhone13,2"
com.apple.news,178,1740427068,1740427246,1740427247.377578,-21600,EB445137-D7F5-57EC-87DA-1DB460D64046,"iPhone13,2"
com.apple.weather,23,1740425933,1740425956,1740425956.2790852,-21600,EB445137-D7F5-57EC-87DA-1DB460D64046,"iPhone13,2"
Astrospheric.Astrospheric,17,1740425912,1740425929,1740425929.186051,-21600,EB445137-D7F5-57EC-87DA-1DB460D64046,"iPhone13,2"
Astrospheric.Astrospheric,87,1740425675,1740425762,1740425762.515157,-21600,EB445137-D7F5-57EC-87DA-1DB460D64046,"iPhone13,2"
com.google.chrome.ios,20,1740425638,1740425658,1740425658.240016,-21600,EB445137-D7F5-57EC-87DA-1DB460D64046,"iPhone13,2"
com.microsoft.Office.Outlook,11,1740425627,1740425638,1740425638.153451,-21600,EB445137-D7F5-57EC-87DA-1DB460D64046,"iPhone13,2"
com.apple.news,43,1740423028,1740423071,1740423071.8796492,-21600,EB445137-D7F5-57EC-87DA-1DB460D64046,"iPhone13,2"
com.myfitnesspal.mfp,3,1740423019,1740423022,1740423022.1226501,-21600,EB445137-D7F5-57EC-87DA-1DB460D64046,"iPhone13,2"
com.myfitnesspal.mfp,135,1740422294,1740422429,1740422429.363371,-21600,EB445137-D7F5-57EC-87DA-1DB460D64046,"iPhone13,2"
com.toyopagroup.picaboo,16,1740422276,1740422292,1740422292.2997432,-21600,EB445137-D7F5-57EC-87DA-1DB460D64046,"iPhone13,2"
com.google.ios.youtube,1,1740422275,1740422276,1740422276.1244822,-21600,EB445137-D7F5-57EC-87DA-1DB460D64046,"iPhone13,2"
com.google.ios.youtube,639,1740421344,1740421983,1740421983.772692,-21600,EB445137-D7F5-57EC-87DA-1DB460D64046,"iPhone13,2"
com.apple.MobileSMS,6,1740419982,1740419988,1740419988.083024,-21600,EB445137-D7F5-57EC-87DA-1DB460D64046,"iPhone13,2"
com.microsoft.Office.Outlook,0,1740419982,1740419982,1740419982.441605,-21600,EB445137-D7F5-57EC-87DA-1DB460D64046,"iPhone13,2"
com.microsoft.Office.Outlook,13,1740419395,1740419408,1740419408.6623812,-21600,EB445137-D7F5-57EC-87DA-1DB460D64046,"iPhone13,2"
com.apple.MobileSMS,3,1740419387,1740419390,1740419390.333538,-21600,EB445137-D7F5-57EC-87DA-1DB460D64046,"iPhone13,2"
com.apple.MobileSMS,2,1740419109,1740419111,1740419112.116615,-21600,EB445137-D7F5-57EC-87DA-1DB460D64046,"iPhone13,2"
com.apple.MobileSMS,3,1740418820,1740418823,1740418823.389219,-21600,EB445137-D7F5-57EC-87DA-1DB460D64046,"iPhone13,2"
com.apple.MobileSMS,23,1740418796,1740418819,1740418819.899599,-21600,EB445137-D7F5-57EC-87DA-1DB460D64046,"iPhone13,2"
com.apple.news,0,1740418796,1740418796,1740418797.978541,-21600,EB445137-D7F5-57EC-87DA-1DB460D64046,"iPhone13,2"
com.apple.news,24,1740418016,1740418040,1740418040.619662,-21600,EB445137-D7F5-57EC-87DA-1DB460D64046,"iPhone13,2"
com.apple.news,263,1740416185,1740416448,1740416448.834151,-21600,EB445137-D7F5-57EC-87DA-1DB460D64046,"iPhone13,2"
com.microsoft.Office.Outlook,2,1740416140,1740416142,1740416142.293328,-21600,EB445137-D7F5-57EC-87DA-1DB460D64046,"iPhone13,2"
com.microsoft.Office.Outlook,6,1740416012,1740416018,1740416018.920353,-21600,EB445137-D7F5-57EC-87DA-1DB460D64046,"iPhone13,2"
com.google.Chrome,202,1740415524,1740415726,1740415726.38413,-21600,,
com.apple.Music,5,1740415519,1740415524,1740415524.171911,-21600,,
com.google.Chrome,10,1740415509,1740415519,1740415519.670721,-21600,,
com.apple.finder,3,1740415506,1740415509,1740415509.265765,-21600,,
com.leomehlig.today,70,1740415436,1740415506,1740415506.221791,-21600,,
com.google.Chrome,93,1740415343,1740415436,1740415436.917046,-21600,,
com.leomehlig.today,12,1740415331,1740415343,1740415343.9035258,-21600,,
com.microsoft.Office.Outlook,14,1740415023,1740415037,1740415037.9885921,-21600,EB445137-D7F5-57EC-87DA-1DB460D64046,"iPhone13,2"
com.google.Chrome,335,1740414996,1740415331,1740415331.268295,-21600,,
com.apple.news,54,1740414139,1740414193,1740414194.375653,-21600,EB445137-D7F5-57EC-87DA-1DB460D64046,"iPhone13,2"
Astrospheric.Astrospheric,1,1740414138,1740414139,1740414140.756822,-21600,EB445137-D7F5-57EC-87DA-1DB460D64046,"iPhone13,2"
Astrospheric.Astrospheric,13,1740413656,1740413669,1740413669.99101,-21600,EB445137-D7F5-57EC-87DA-1DB460D64046,"iPhone13,2"
com.hammerandchisel.discord,37,1740413616,1740413653,1740413653.503484,-21600,EB445137-D7F5-57EC-87DA-1DB460D64046,"iPhone13,2"
com.microsoft.Office.Outlook,1,1740413615,1740413616,1740413616.584553,-21600,EB445137-D7F5-57EC-87DA-1DB460D64046,"iPhone13,2"
com.google.Chrome,1129,1740413563,1740414692,1740414692.617039,-21600,,
com.apple.iCal,36,1740413527,1740413563,1740413563.6694999,-21600,,
com.microsoft.Office.Outlook,177,1740413438,1740413615,1740413615.453089,-21600,EB445137-D7F5-57EC-87DA-1DB460D64046,"iPhone13,2"
Astrospheric.Astrospheric,0,1740413438,1740413438,1740413439.351877,-21600,EB445137-D7F5-57EC-87DA-1DB460D64046,"iPhone13,2"
com.google.Chrome,120,1740413407,1740413527,1740413527.4001741,-21600,,
com.google.Chrome,501,1740412684,1740413185,1740413185.39365,-21600,,
com.leomehlig.today,37,1740412647,1740412684,1740412684.988107,-21600,,
com.apple.iCal,13,1740412634,1740412647,1740412647.752658,-21600,,
com.leomehlig.today,3,1740412631,1740412634,1740412634.652789,-21600,,
com.apple.Preview,607,1740412024,1740412631,1740412631.288307,-21600,,
Astrospheric.Astrospheric,98,1740411956,1740412054,1740412054.373596,-21600,EB445137-D7F5-57EC-87DA-1DB460D64046,"iPhone13,2"
com.apple.Preview,1086,1740410505,1740411591,1740411591.5992079,-21600,,
com.apple.finder,11,1740410494,1740410505,1740410505.095643,-21600,,
com.apple.weather,4,1740410227,1740410231,1740410231.416635,-21600,EB445137-D7F5-57EC-87DA-1DB460D64046,"iPhone13,2"
com.apple.weather,10,1740409272,1740409282,1740409282.374576,-21600,EB445137-D7F5-57EC-87DA-1DB460D64046,"iPhone13,2"
com.apple.finder,124,1740409121,1740409245,1740409245.7772222,-21600,,
com.google.Chrome,176,1740408945,1740409121,1740409121.911238,-21600,,
com.leomehlig.today,3,1740408928,1740408931,1740408931.970598,-21600,,
com.apple.finder,1,1740408927,1740408928,1740408928.551158,-21600,,
com.apple.systempreferences,0,1740408927,1740408927,1740408927.9564219,-21600,,
com.apple.Music,7,1740408914,1740408921,1740408921.323533,-21600,,
com.apple.weather,5,1740408148,1740408153,1740408153.8875132,-21600,EB445137-D7F5-57EC-87DA-1DB460D64046,"iPhone13,2"
com.apple.Health,1,1740408147,1740408148,1740408148.4055262,-21600,EB445137-D7F5-57EC-87DA-1DB460D64046,"iPhone13,2"
com.apple.Health,36,1740408049,1740408085,1740408085.996721,-21600,EB445137-D7F5-57EC-87DA-1DB460D64046,"iPhone13,2"
com.apple.Health,8,1740408038,1740408046,1740408046.707118,-21600,EB445137-D7F5-57EC-87DA-1DB460D64046,"iPhone13,2"
com.renpho.health,35,1740408000,1740408035,1740408035.283894,-21600,EB445137-D7F5-57EC-87DA-1DB460D64046,"iPhone13,2"
com.instructure.icanvas,1,1740407998,1740407999,1740408000.049333,-21600,EB445137-D7F5-57EC-87DA-1DB460D64046,"iPhone13,2"
com.instructure.icanvas,61,1740406566,1740406627,1740406627.639772,-21600,EB445137-D7F5-57EC-87DA-1DB460D64046,"iPhone13,2"
com.apple.CoreAuthUI,1,1740374387,1740374388,1740374389.043791,-21600,EB445137-D7F5-57EC-87DA-1DB460D64046,"iPhone13,2"
com.apple.journal,1186,1740374386,1740375572,1740375572.22864,-21600,EB445137-D7F5-57EC-87DA-1DB460D64046,"iPhone13,2"
com.apple.Health,15,1740374221,1740374236,1740374236.865971,-21600,EB445137-D7F5-57EC-87DA-1DB460D64046,"iPhone13,2"
com.thestorygraph.thestorygraph,27,1740374190,1740374217,1740374217.4326549,-21600,EB445137-D7F5-57EC-87DA-1DB460D64046,"iPhone13,2"
com.apple.Music,311,1740372154,1740372465,1740372465.3806028,-21600,,
com.google.Chrome,2,1740372152,1740372154,1740372155.032604,-21600,,
com.tinyspeck.chatlyio,24,1740370750,1740370774,1740370774.966147,-21600,EB445137-D7F5-57EC-87DA-1DB460D64046,"iPhone13,2"
com.microsoft.Office.Outlook,2,1740370709,1740370711,1740370711.7346349,-21600,EB445137-D7F5-57EC-87DA-1DB460D64046,"iPhone13,2"
com.google.Chrome,10,1740370697,1740370707,1740370707.342924,-21600,,
com.apple.iCal,39,1740370658,1740370697,1740370697.756377,-21600,,
com.google.Chrome,35,1740370623,1740370658,1740370658.9436011,-21600,,
com.microsoft.Outlook,5,1740370579,1740370584,1740370584.911288,-21600,,
com.google.Chrome,22,1740370557,1740370579,1740370579.477769,-21600,,
com.microsoft.Outlook,8,1740370549,1740370557,1740370557.4221392,-21600,,
com.apple.Terminal,1,1740370548,1740370549,1740370549.734307,-21600,,
com.microsoft.Outlook,4,1740370544,1740370548,1740370548.693513,-21600,,
com.microsoft.Office.Outlook,35,1740370511,1740370546,1740370546.498472,-21600,EB445137-D7F5-57EC-87DA-1DB460D64046,"iPhone13,2"
com.duosecurity.DuoMobile,0,1740370511,1740370511,1740370512.40136,-21600,EB445137-D7F5-57EC-87DA-1DB460D64046,"iPhone13,2"
com.apple.finder,39,1740370505,1740370544,1740370544.736857,-21600,,
com.cisco.secureclient.gui,4,1740370501,1740370505,1740370505.2942328,-21600,,
com.google.Chrome,69,1740370432,1740370501,1740370501.099083,-21600,,
com.cisco.secureclient.gui,4,1740370413,1740370417,1740370417.25488,-21600,,
com.google.Chrome,81,1740370332,1740370413,1740370413.044846,-21600,,
com.apple.finder,55,1740370277,1740370332,1740370332.212652,-21600,,
com.apple.Notes,1,1740370276,1740370277,1740370277.542068,-21600,,
com.google.Chrome,56,1740370220,1740370276,1740370276.309268,-21600,,
com.apple.Notes,17,1740370203,1740370220,1740370220.173698,-21600,,
com.google.Chrome,54,1740370149,1740370203,1740370203.664164,-21600,,
com.apple.finder,5,1740370144,1740370149,1740370149.276089,-21600,,
com.google.Chrome,20,1740370124,1740370144,1740370144.749854,-21600,,
com.apple.finder,5,1740370119,1740370124,1740370124.1857948,-21600,,
com.google.Chrome,3,1740370116,1740370119,1740370119.84405,-21600,,
com.apple.finder,12,1740370104,1740370116,1740370116.506907,-21600,,
com.google.Chrome,1,1740370103,1740370104,1740370104.7739658,-21600,,
com.apple.finder,7,1740370096,1740370103,1740370103.265049,-21600,,
com.apple.Terminal,1,1740370095,1740370096,1740370096.949034,-21600,,
com.google.Chrome,3,1740370092,1740370095,1740370095.714591,-21600,,
com.apple.Terminal,2,1740370090,1740370092,1740370092.269566,-21600,,
com.apple.finder,2,1740370088,1740370090,1740370090.590594,-21600,,
com.apple.Terminal,4,1740370084,1740370088,1740370088.507873,-21600,,
com.google.Chrome,285,1740369799,1740370084,1740370084.783498,-21600,,
com.apple.finder,1,1740369798,1740369799,1740369799.619992,-21600,,
com.google.Chrome,3,1740369795,1740369798,1740369798.134861,-21600,,
com.apple.finder,1,1740369794,1740369795,1740369795.283823,-21600,,
com.google.Chrome,79,1740369715,1740369794,1740369794.529777,-21600,,
com.apple.finder,4,1740369711,1740369715,1740369715.1259298,-21600,,
com.apple.Terminal,33,1740369678,1740369711,1740369711.7042642,-21600,,
com.apple.finder,1,1740369677,1740369678,1740369678.4863892,-21600,,
com.apple.Terminal,96,1740369581,1740369677,1740369677.304282,-21600,,
com.apple.finder,15,1740369566,1740369581,1740369581.850565,-21600,,
com.apple.Terminal,25,1740369541,1740369566,1740369566.7674031,-21600,,
com.duosecurity.DuoMobile,5,1740369534,1740369539,1740369539.797039,-21600,EB445137-D7F5-57EC-87DA-1DB460D64046,"iPhone13,2"
com.microsoft.Office.Outlook,0,1740369534,1740369534,1740369535.088536,-21600,EB445137-D7F5-57EC-87DA-1DB460D64046,"iPhone13,2"
com.cisco.secureclient.gui,29,1740369512,1740369541,1740369541.3074121,-21600,,
com.apple.Terminal,1,1740369511,1740369512,1740369512.986098,-21600,,
com.apple.finder,14,1740369497,1740369511,1740369511.4006639,-21600,,
com.google.Chrome,663,1740368834,1740369497,1740369497.410038,-21600,,
com.microsoft.VSCode,51,1740368783,1740368834,1740368835.100282,-21600,,
com.google.Chrome,387,1740368396,1740368783,1740368783.9868789,-21600,,
com.microsoft.Office.Outlook,18,1740368055,1740368073,1740368073.657141,-21600,EB445137-D7F5-57EC-87DA-1DB460D64046,"iPhone13,2"
com.apple.MobileSMS,0,1740368055,1740368055,1740368055.8927732,-21600,EB445137-D7F5-57EC-87DA-1DB460D64046,"iPhone13,2"
com.microsoft.VSCode,540,1740367856,1740368396,1740368396.407269,-21600,,
com.microsoft.Word,2,1740367854,1740367856,1740367856.304848,-21600,,
com.microsoft.VSCode,2,1740367852,1740367854,1740367854.824645,-21600,,
com.apple.finder,29,1740367823,1740367852,1740367852.262394,-21600,,
com.apple.shortcuts,12,1740367811,1740367823,1740367823.7528381,-21600,,
com.apple.finder,7,1740367767,1740367774,1740367774.82112,-21600,,
com.apple.Passwords,0,1740367767,1740367767,1740367767.986261,-21600,,
com.google.Chrome,9,1740367758,1740367767,1740367767.474432,-21600,,
com.leomehlig.today,127,1740367631,1740367758,1740367759.0158172,-21600,,
com.google.Chrome,44,1740367587,1740367631,1740367631.229797,-21600,,
com.apple.finder,1,1740367586,1740367587,1740367587.40168,-21600,,
com.apple.MobileSMS,4,1740367534,1740367538,1740367538.310223,-21600,EB445137-D7F5-57EC-87DA-1DB460D64046,"iPhone13,2"
com.google.Chrome,96,1740367490,1740367586,1740367586.419335,-21600,,
com.apple.MobileSMS,2,1740367486,1740367488,1740367488.924557,-21600,EB445137-D7F5-57EC-87DA-1DB460D64046,"iPhone13,2"
com.apple.MobileSMS,8,1740367460,1740367468,1740367468.745651,-21600,EB445137-D7F5-57EC-87DA-1DB460D64046,"iPhone13,2"
com.apple.MobileSMS,160,1740367272,1740367432,1740367432.7410722,-21600,EB445137-D7F5-57EC-87DA-1DB460D64046,"iPhone13,2"
com.apple.MobileSMS,52,1740367206,1740367258,1740367258.7108579,-21600,EB445137-D7F5-57EC-87DA-1DB460D64046,"iPhone13,2"
com.instructure.icanvas,1,1740367205,1740367206,1740367206.6892061,-21600,EB445137-D7F5-57EC-87DA-1DB460D64046,"iPhone13,2"
com.instructure.icanvas,21,1740366691,1740366712,1740366712.435303,-21600,EB445137-D7F5-57EC-87DA-1DB460D64046,"iPhone13,2"
com.instructure.icanvas,10,1740366238,1740366248,1740366251.653342,-21600,EB445137-D7F5-57EC-87DA-1DB460D64046,"iPhone13,2"
com.groupme.iphone-app,0,1740366238,1740366238,1740366239.640219,-21600,EB445137-D7F5-57EC-87DA-1DB460D64046,"iPhone13,2"
com.google.Chrome,401,1740365063,1740365464,1740365464.738209,-21600,,
com.google.Chrome,382,1740363796,1740364178,1740364178.025461,-21600,,
com.apple.finder,2,1740363794,1740363796,1740363796.301682,-21600,,
com.apple.finder,345,1740360061,1740360406,1740360406.991117,-21600,,
com.apple.finder,307,1740358821,1740359128,1740359128.220094,-21600,,
com.google.Chrome,2,1740358819,1740358821,1740358821.966872,-21600,,
com.google.Chrome,307,1740357806,1740358113,1740358113.6601791,-21600,,
com.apple.finder,216,1740357590,1740357806,1740357806.2977529,-21600,,
com.apple.finder,300,1740357053,1740357353,1740357353.602699,-21600,,
com.apple.calculator,6,1740357047,1740357053,1740357053.7964392,-21600,,
com.apple.finder,294,1740356753,1740357047,1740357047.959669,-21600,,
com.google.Chrome,1408,1740355345,1740356753,1740356753.085335,-21600,,
com.groupme.iphone-app,2,1740355059,1740355061,1740355062.072586,-21600,EB445137-D7F5-57EC-87DA-1DB460D64046,"iPhone13,2"
com.groupme.iphone-app,4,1740355041,1740355045,1740355045.600854,-21600,EB445137-D7F5-57EC-87DA-1DB460D64046,"iPhone13,2"
com.groupme.iphone-app,16,1740354867,1740354883,1740354883.37411,-21600,EB445137-D7F5-57EC-87DA-1DB460D64046,"iPhone13,2"
com.apple.mobileslideshow,1,1740354866,1740354867,1740354868.1911988,-21600,EB445137-D7F5-57EC-87DA-1DB460D64046,"iPhone13,2"
com.apple.mobileslideshow,13,1740354629,1740354642,1740354643.44852,-21600,EB445137-D7F5-57EC-87DA-1DB460D64046,"iPhone13,2"
com.groupme.iphone-app,8,1740354585,1740354593,1740354593.2732692,-21600,EB445137-D7F5-57EC-87DA-1DB460D64046,"iPhone13,2"
com.groupme.iphone-app,10,1740354224,1740354234,1740354234.5158,-21600,EB445137-D7F5-57EC-87DA-1DB460D64046,"iPhone13,2"
com.apple.MobileSMS,2,1740354222,1740354224,1740354224.345597,-21600,EB445137-D7F5-57EC-87DA-1DB460D64046,"iPhone13,2"
com.apple.MobileSMS,6,1740354214,1740354220,1740354220.999018,-21600,EB445137-D7F5-57EC-87DA-1DB460D64046,"iPhone13,2"
com.groupme.iphone-app,29,1740354184,1740354213,1740354213.985443,-21600,EB445137-D7F5-57EC-87DA-1DB460D64046,"iPhone13,2"
com.groupme.iphone-app,17,1740354077,1740354094,1740354094.5421062,-21600,EB445137-D7F5-57EC-87DA-1DB460D64046,"iPhone13,2"
com.apple.CoreAuthUI,1,1740354055,1740354056,1740354056.974077,-21600,EB445137-D7F5-57EC-87DA-1DB460D64046,"iPhone13,2"
com.truebill.truebillnative,25,1740354052,1740354077,1740354077.238953,-21600,EB445137-D7F5-57EC-87DA-1DB460D64046,"iPhone13,2"
Astrospheric.Astrospheric,6,1740354028,1740354034,1740354034.9451718,-21600,EB445137-D7F5-57EC-87DA-1DB460D64046,"iPhone13,2"
Astrospheric.Astrospheric,81,1740353794,1740353875,1740353875.171705,-21600,EB445137-D7F5-57EC-87DA-1DB460D64046,"iPhone13,2"
com.apple.weather,20,1740353773,1740353793,1740353793.0527558,-21600,EB445137-D7F5-57EC-87DA-1DB460D64046,"iPhone13,2"
com.myfitnesspal.mfp,64,1740353709,1740353773,1740353773.745985,-21600,EB445137-D7F5-57EC-87DA-1DB460D64046,"iPhone13,2"
com.google.Gmail,1,1740353707,1740353708,1740353708.834422,-21600,EB445137-D7F5-57EC-87DA-1DB460D64046,"iPhone13,2"
com.google.Gmail,84,1740353580,1740353664,1740353664.5330129,-21600,EB445137-D7F5-57EC-87DA-1DB460D64046,"iPhone13,2"
com.google.Gmail,24,1740353552,1740353576,1740353576.264097,-21600,EB445137-D7F5-57EC-87DA-1DB460D64046,"iPhone13,2"
com.apple.news,0,1740353552,1740353552,1740353553.089696,-21600,EB445137-D7F5-57EC-87DA-1DB460D64046,"iPhone13,2"
com.apple.news,83,1740353455,1740353538,1740353538.517414,-21600,EB445137-D7F5-57EC-87DA-1DB460D64046,"iPhone13,2"
com.google.Chrome,77,1740352233,1740352310,1740352311.233549,-21600,,
com.apple.finder,14,1740352219,1740352233,1740352233.532041,-21600,,
com.google.Chrome,319,1740351900,1740352219,1740352219.87014,-21600,,
com.microsoft.Word,0,1740351900,1740351900,1740351900.995878,-21600,,
com.google.Chrome,146,1740351754,1740351900,1740351900.284657,-21600,,
com.microsoft.Word,172,1740351582,1740351754,1740351754.588346,-21600,,
com.google.Chrome,13,1740351569,1740351582,1740351582.836183,-21600,,
com.microsoft.Word,3,1740351566,1740351569,1740351569.299572,-21600,,
com.google.Chrome,4,1740351562,1740351566,1740351566.3920841,-21600,,
com.apple.Passwords,0,1740351562,1740351562,1740351562.981543,-21600,,
com.google.Chrome,3,1740351559,1740351562,1740351562.6960158,-21600,,
com.apple.Passwords,16,1740351543,1740351559,1740351559.4081712,-21600,,
com.google.Chrome,6,1740351537,1740351543,1740351543.107981,-21600,,
com.apple.Passwords,8,1740351529,1740351537,1740351537.614269,-21600,,
com.google.Chrome,217,1740351312,1740351529,1740351529.602107,-21600,,
com.microsoft.Word,50,1740351262,1740351312,1740351312.5118442,-21600,,
com.google.Chrome,21,1740351241,1740351262,1740351263.036524,-21600,,
com.microsoft.Word,71,1740351170,1740351241,1740351241.130548,-21600,,
com.google.Chrome,28,1740351142,1740351170,1740351170.4928389,-21600,,
com.microsoft.Word,100,1740351042,1740351142,1740351143.035379,-21600,,
com.google.Chrome,57,1740350985,1740351042,1740351042.7508512,-21600,,
com.microsoft.Word,28,1740350957,1740350985,1740350985.3892112,-21600,,
com.google.Chrome,16,1740350941,1740350957,1740350958.012264,-21600,,
com.apple.news,4,1740350640,1740350644,1740350644.2932239,-21600,EB445137-D7F5-57EC-87DA-1DB460D64046,"iPhone13,2"
com.apple.news,153,1740349473,1740349626,1740349626.4932861,-21600,EB445137-D7F5-57EC-87DA-1DB460D64046,"iPhone13,2"
com.apple.CoreAuthUI,2,1740349424,1740349426,1740349426.903561,-21600,EB445137-D7F5-57EC-87DA-1DB460D64046,"iPhone13,2"
com.robinhood.release.Robinhood,47,1740349420,1740349467,1740349467.865668,-21600,EB445137-D7F5-57EC-87DA-1DB460D64046,"iPhone13,2"
com.apple.MobileSMS,3,1740349386,1740349389,1740349389.6966228,-21600,EB445137-D7F5-57EC-87DA-1DB460D64046,"iPhone13,2"
com.google.Chrome,6,1740349370,1740349376,1740349376.671646,-21600,,
com.apple.finder,1,1740349369,1740349370,1740349370.377567,-21600,,
com.leomehlig.today,33,1740349336,1740349369,1740349369.079859,-21600,,
com.google.Chrome,53,1740349283,1740349336,1740349336.702036,-21600,,
com.leomehlig.today,56,1740349227,1740349283,1740349283.2269511,-21600,,
com.apple.MobileSMS,24,1740349203,1740349227,1740349227.503722,-21600,,
com.leomehlig.today,35,1740349168,1740349203,1740349203.628922,-21600,,
com.apple.MobileSMS,24,1740349164,1740349188,1740349188.6131082,-21600,EB445137-D7F5-57EC-87DA-1DB460D64046,"iPhone13,2"
com.google.Chrome,12,1740349156,1740349168,1740349168.96101,-21600,,
com.apple.iCal,56,1740349100,1740349156,1740349156.0649328,-21600,,
com.apple.Notes,1,1740349099,1740349100,1740349100.314307,-21600,,
com.apple.MobileSMS,172,1740348977,1740349149,1740349149.374156,-21600,EB445137-D7F5-57EC-87DA-1DB460D64046,"iPhone13,2"
com.google.Chrome,125,1740348974,1740349099,1740349099.345564,-21600,,
com.apple.Notes,33,1740348941,1740348974,1740348974.167111,-21600,,
com.apple.iCal,16,1740348925,1740348941,1740348941.367038,-21600,,
com.apple.MobileSMS,65,1740348907,1740348972,1740348973.0492802,-21600,EB445137-D7F5-57EC-87DA-1DB460D64046,"iPhone13,2"
com.groupme.iphone-app,13,1740348885,1740348898,1740348898.9741201,-21600,EB445137-D7F5-57EC-87DA-1DB460D64046,"iPhone13,2"
com.toyopagroup.picaboo,39,1740348843,1740348882,1740348882.983646,-21600,EB445137-D7F5-57EC-87DA-1DB460D64046,"iPhone13,2"
com.apple.MobileSMS,1,1740348842,1740348843,1740348843.4121609,-21600,EB445137-D7F5-57EC-87DA-1DB460D64046,"iPhone13,2"
com.google.Chrome,88,1740348837,1740348925,1740348925.7377791,-21600,,
com.google.Chrome,303,1740348517,1740348820,1740348820.178825,-21600,,
com.apple.iCal,14,1740348503,1740348517,1740348517.115125,-21600,,
com.google.Chrome,258,1740348245,1740348503,1740348503.2915401,-21600,,
com.leomehlig.today,4,1740347803,1740347807,1740347807.822808,-21600,,
com.google.Chrome,522,1740347281,1740347803,1740347803.3348742,-21600,,
com.google.Chrome,1305,1740345495,1740346800,1740346800.95135,-21600,,
com.leomehlig.today,51,1740345444,1740345495,1740345495.749949,-21600,,
com.apple.MobileSMS,2,1740345438,1740345440,1740345440.892688,-21600,EB445137-D7F5-57EC-87DA-1DB460D64046,"iPhone13,2"
com.google.Chrome,1026,1740344418,1740345444,1740345444.628406,-21600,,
com.apple.MobileSMS,42,1740344082,1740344124,1740344124.9746199,-21600,EB445137-D7F5-57EC-87DA-1DB460D64046,"iPhone13,2"
com.ally.MobileBanking,110,1740343962,1740344072,1740344072.256788,-21600,EB445137-D7F5-57EC-87DA-1DB460D64046,"iPhone13,2"
com.truebill.truebillnative,2,1740343960,1740343962,1740343962.31334,-21600,EB445137-D7F5-57EC-87DA-1DB460D64046,"iPhone13,2"
com.apple.CoreAuthUI,2,1740343942,1740343944,1740343944.489502,-21600,EB445137-D7F5-57EC-87DA-1DB460D64046,"iPhone13,2"
com.ally.MobileBanking,26,1740343934,1740343960,1740343960.275342,-21600,EB445137-D7F5-57EC-87DA-1DB460D64046,"iPhone13,2"
com.apple.CoreAuthUI,2,1740343916,1740343918,1740343918.5672588,-21600,EB445137-D7F5-57EC-87DA-1DB460D64046,"iPhone13,2"
com.truebill.truebillnative,18,1740343914,1740343932,1740343932.965739,-21600,EB445137-D7F5-57EC-87DA-1DB460D64046,"iPhone13,2"
com.myfitnesspal.mfp,50,1740343856,1740343906,1740343906.167207,-21600,EB445137-D7F5-57EC-87DA-1DB460D64046,"iPhone13,2"
com.apple.Health,54,1740343799,1740343853,1740343853.09205,-21600,EB445137-D7F5-57EC-87DA-1DB460D64046,"iPhone13,2"
com.apple.Health,22,1740341896,1740341918,1740341918.9608588,-21600,EB445137-D7F5-57EC-87DA-1DB460D64046,"iPhone13,2"
com.apple.Music,1,1740341895,1740341896,1740341896.643637,-21600,EB445137-D7F5-57EC-87DA-1DB460D64046,"iPhone13,2"
com.apple.Music,6,1740339678,1740339684,1740339684.9913158,-21600,EB445137-D7F5-57EC-87DA-1DB460D64046,"iPhone13,2"
com.apple.Music,7,1740339191,1740339198,1740339198.960547,-21600,EB445137-D7F5-57EC-87DA-1DB460D64046,"iPhone13,2"
com.apple.Music,23,1740339090,1740339113,1740339113.391159,-21600,EB445137-D7F5-57EC-87DA-1DB460D64046,"iPhone13,2"
com.apple.Music,44,1740338794,1740338838,1740338838.25348,-21600,EB445137-D7F5-57EC-87DA-1DB460D64046,"iPhone13,2"
com.apple.Music,41,1740338102,1740338143,1740338143.423952,-21600,EB445137-D7F5-57EC-87DA-1DB460D64046,"iPhone13,2"
com.apple.Music,27,1740337833,1740337860,1740337861.36991,-21600,EB445137-D7F5-57EC-87DA-1DB460D64046,"iPhone13,2"
com.apple.mobilecal,2,1740337830,1740337832,1740337832.301426,-21600,EB445137-D7F5-57EC-87DA-1DB460D64046,"iPhone13,2"
com.apple.mobilecal,50,1740337309,1740337359,1740337359.311225,-21600,EB445137-D7F5-57EC-87DA-1DB460D64046,"iPhone13,2"
com.apple.weather,16,1740337291,1740337307,1740337307.6457958,-21600,EB445137-D7F5-57EC-87DA-1DB460D64046,"iPhone13,2"
com.apple.mobilecal,95,1740337194,1740337289,1740337289.223001,-21600,EB445137-D7F5-57EC-87DA-1DB460D64046,"iPhone13,2"
com.leomehlig.today,1,1740337189,1740337190,1740337191.847667,-21600,EB445137-D7F5-57EC-87DA-1DB460D64046,"iPhone13,2"
com.apple.weather,1,1740337187,1740337188,1740337189.263441,-21600,EB445137-D7F5-57EC-87DA-1DB460D64046,"iPhone13,2"
com.apple.weather,4,1740334554,1740334558,1740334559.162572,-21600,EB445137-D7F5-57EC-87DA-1DB460D64046,"iPhone13,2"
com.apple.news,1,1740334399,1740334400,1740334400.605386,-21600,EB445137-D7F5-57EC-87DA-1DB460D64046,"iPhone13,2"
com.google.Chrome,10,1740334195,1740334205,1740334205.8455338,-21600,,
com.apple.finder,2,1740334193,1740334195,1740334195.082077,-21600,,
com.apple.Notes,0,1740334193,1740334193,1740334193.885728,-21600,,
com.apple.finder,2,1740334191,1740334193,1740334193.143664,-21600,,
com.microsoft.VSCode,37,1740334154,1740334191,1740334191.1763868,-21600,,
com.apple.finder,14,1740334140,1740334154,1740334154.4499931,-21600,,
com.apple.Preview,27,1740334113,1740334140,1740334140.081586,-21600,,
com.apple.finder,1,1740334112,1740334113,1740334113.3634439,-21600,,
com.apple.Preview,2,1740334110,1740334112,1740334112.207879,-21600,,
com.apple.finder,2,1740334108,1740334110,1740334110.38374,-21600,,
com.apple.Preview,4,1740334104,1740334108,1740334108.917728,-21600,,
com.apple.finder,2,1740334102,1740334104,1740334104.5218039,-21600,,
com.apple.Preview,1,1740334101,1740334102,1740334102.637315,-21600,,
com.apple.finder,56,1740334045,1740334101,1740334101.5898209,-21600,,
com.microsoft.VSCode,263,1740333782,1740334045,1740334045.727505,-21600,,
com.apple.finder,3,1740333779,1740333782,1740333782.1725779,-21600,,
com.microsoft.VSCode,4,1740333775,1740333779,1740333779.58598,-21600,,
com.apple.finder,8,1740333767,1740333775,1740333775.926914,-21600,,
com.microsoft.VSCode,12,1740333755,1740333767,1740333767.576531,-21600,,
com.apple.finder,8,1740333747,1740333755,1740333755.119214,-21600,,
com.microsoft.VSCode,120,1740333627,1740333747,1740333747.5485191,-21600,,
com.google.Chrome,5,1740333622,1740333627,1740333628.060896,-21600,,
com.apple.finder,35,1740333587,1740333622,1740333622.949712,-21600,,
com.microsoft.VSCode,53,1740333534,1740333587,1740333587.167602,-21600,,
com.apple.news,217,1740333282,1740333499,1740333499.762012,-21600,EB445137-D7F5-57EC-87DA-1DB460D64046,"iPhone13,2"
com.apple.weather,2,1740333270,1740333272,1740333272.86649,-21600,EB445137-D7F5-57EC-87DA-1DB460D64046,"iPhone13,2"
com.apple.finder,274,1740333260,1740333534,1740333534.202131,-21600,,
com.google.Chrome,54,1740333206,1740333260,1740333260.259626,-21600,,
com.apple.finder,47,1740333143,1740333190,1740333190.246258,-21600,,
com.microsoft.VSCode,79,1740333064,1740333143,1740333143.757742,-21600,,
com.apple.finder,22,1740333042,1740333064,1740333064.418186,-21600,,
com.microsoft.VSCode,222,1740332820,1740333042,1740333042.572729,-21600,,
com.apple.finder,65,1740332755,1740332820,1740332820.4134579,-21600,,
com.apple.weather,61,1740332711,1740332772,1740332772.534445,-21600,EB445137-D7F5-57EC-87DA-1DB460D64046,"iPhone13,2"
com.apple.news,55,1740332655,1740332710,1740332710.492169,-21600,EB445137-D7F5-57EC-87DA-1DB460D64046,"iPhone13,2"
com.microsoft.Office.Outlook,7,1740332625,1740332632,1740332632.953119,-21600,EB445137-D7F5-57EC-87DA-1DB460D64046,"iPhone13,2"
com.microsoft.Office.Outlook,88,1740332510,1740332598,1740332598.946939,-21600,EB445137-D7F5-57EC-87DA-1DB460D64046,"iPhone13,2"
com.microsoft.VSCode,531,1740332224,1740332755,1740332755.9666219,-21600,,
com.apple.finder,12,1740332212,1740332224,1740332224.7153301,-21600,,
com.microsoft.VSCode,68,1740332144,1740332212,1740332212.655623,-21600,,
com.apple.finder,93,1740332051,1740332144,1740332144.718793,-21600,,
com.apple.finder,303,1740331684,1740331987,1740331987.673639,-21600,,
com.microsoft.VSCode,15,1740331669,1740331684,1740331684.978028,-21600,,
com.apple.finder,3,1740331666,1740331669,1740331669.747045,-21600,,
com.microsoft.VSCode,15,1740331651,1740331666,1740331666.680784,-21600,,
com.jinzhenyu.ruler,1,1740331650,1740331651,1740331651.315412,-21600,,
com.microsoft.VSCode,0,1740331650,1740331650,1740331650.917295,-21600,,
com.jinzhenyu.ruler,1,1740331649,1740331650,1740331650.212919,-21600,,
com.microsoft.VSCode,1,1740331648,1740331649,1740331649.069324,-21600,,
com.jinzhenyu.ruler,0,1740331648,1740331648,1740331648.704586,-21600,,
com.microsoft.VSCode,1,1740331647,1740331648,1740331648.204474,-21600,,
com.apple.finder,12,1740331571,1740331583,1740331583.958463,-21600,,
com.microsoft.VSCode,15,1740331556,1740331571,1740331571.7233849,-21600,,
com.apple.finder,6,1740331550,1740331556,1740331556.98595,-21600,,
com.microsoft.VSCode,26,1740331524,1740331550,1740331550.5472112,-21600,,
com.apple.finder,3,1740331521,1740331524,1740331524.570818,-21600,,
com.microsoft.VSCode,28,1740331493,1740331521,1740331522.00209,-21600,,
com.apple.finder,16,1740331477,1740331493,1740331493.459478,-21600,,
com.microsoft.VSCode,18,1740331459,1740331477,1740331477.7746649,-21600,,
com.apple.finder,5,1740331454,1740331459,1740331459.757351,-21600,,
com.microsoft.VSCode,16,1740331438,1740331454,1740331454.116696,-21600,,
com.apple.finder,2,1740331436,1740331438,1740331438.649451,-21600,,
com.microsoft.VSCode,78,1740331358,1740331436,1740331436.926149,-21600,,
com.apple.finder,7,1740331351,1740331358,1740331358.827723,-21600,,
com.microsoft.VSCode,1,1740331350,1740331351,1740331351.572042,-21600,,
com.apple.finder,5,1740331345,1740331350,1740331350.6203651,-21600,,
com.microsoft.VSCode,399,1740330946,1740331345,1740331345.623129,-21600,,
com.apple.finder,5,1740330941,1740330946,1740330946.4267669,-21600,,
com.microsoft.VSCode,46,1740330895,1740330941,1740330941.83166,-21600,,
com.apple.finder,114,1740330781,1740330895,1740330895.4735332,-21600,,
com.google.Chrome,34,1740330747,1740330781,1740330781.501656,-21600,,
com.apple.finder,11,1740330736,1740330747,1740330747.197826,-21600,,
com.microsoft.VSCode,32,1740330704,1740330736,1740330736.161411,-21600,,
com.microsoft.Office.Outlook,7,1740330676,1740330683,1740330683.962223,-21600,EB445137-D7F5-57EC-87DA-1DB460D64046,"iPhone13,2"
com.apple.MobileSMS,24,1740330649,1740330673,1740330673.357753,-21600,EB445137-D7F5-57EC-87DA-1DB460D64046,"iPhone13,2"
com.apple.Health,32,1740330613,1740330645,1740330645.210322,-21600,EB445137-D7F5-57EC-87DA-1DB460D64046,"iPhone13,2"
com.groupme.iphone-app,4,1740330603,1740330607,1740330607.665956,-21600,EB445137-D7F5-57EC-87DA-1DB460D64046,"iPhone13,2"
Astrospheric.Astrospheric,1,1740330602,1740330603,1740330603.237001,-21600,EB445137-D7F5-57EC-87DA-1DB460D64046,"iPhone13,2"
com.apple.finder,149,1740330555,1740330704,1740330704.789435,-21600,,
com.microsoft.VSCode,45,1740330510,1740330555,1740330555.880908,-21600,,
com.apple.finder,11,1740330499,1740330510,1740330510.803313,-21600,,
com.microsoft.VSCode,51,1740330448,1740330499,1740330499.998551,-21600,,
com.apple.finder,23,1740330425,1740330448,1740330448.252273,-21600,,
com.microsoft.VSCode,141,1740330284,1740330425,1740330425.4253001,-21600,,
com.apple.finder,5,1740330279,1740330284,1740330284.331553,-21600,,
com.microsoft.VSCode,196,1740330083,1740330279,1740330279.608485,-21600,,
com.apple.finder,2,1740330081,1740330083,1740330083.166451,-21600,,
com.microsoft.VSCode,405,1740329676,1740330081,1740330081.146675,-21600,,
com.apple.finder,3,1740329673,1740329676,1740329677.011992,-21600,,
com.microsoft.VSCode,1,1740329672,1740329673,1740329674.1647081,-21600,,
com.apple.news,1,1740329671,1740329672,1740329673.0572681,-21600,,
com.microsoft.VSCode,15,1740329656,1740329671,1740329671.8593302,-21600,,
com.apple.news,121,1740329535,1740329656,1740329656.764306,-21600,,
com.apple.finder,17,1740329518,1740329535,1740329535.346929,-21600,,
com.microsoft.VSCode,23,1740329495,1740329518,1740329518.702763,-21600,,
com.apple.finder,2,1740329493,1740329495,1740329495.85048,-21600,,
com.microsoft.VSCode,2,1740329491,1740329493,1740329493.587945,-21600,,
com.apple.finder,0,1740329491,1740329491,1740329491.818314,-21600,,
com.microsoft.VSCode,13,1740329478,1740329491,1740329491.080761,-21600,,
com.apple.finder,4,1740329474,1740329478,1740329478.393786,-21600,,
com.microsoft.VSCode,103,1740329371,1740329474,1740329474.0592651,-21600,,
com.apple.finder,6,1740329365,1740329371,1740329372.002609,-21600,,
com.microsoft.VSCode,1352,1740328013,1740329365,1740329365.477273,-21600,,
com.google.Chrome,61,1740327952,1740328013,1740328013.583376,-21600,,
com.microsoft.VSCode,666,1740327286,1740327952,1740327952.7218919,-21600,,
com.google.Chrome,11,1740327275,1740327286,1740327286.327513,-21600,,
com.microsoft.VSCode,333,1740326942,1740327275,1740327275.200953,-21600,,
com.apple.finder,17,1740326925,1740326942,1740326942.326452,-21600,,
com.microsoft.VSCode,25,1740326900,1740326925,1740326925.4721441,-21600,,
com.google.Chrome,4,1740326896,1740326900,1740326900.667214,-21600,,
com.apple.finder,2,1740326894,1740326896,1740326896.136776,-21600,,
com.electron.carta,0,1740326894,1740326894,1740326894.950799,-21600,,
com.apple.finder,5,1740326889,1740326894,1740326894.149462,-21600,,
com.apple.iWork.Numbers,25,1740326864,1740326889,1740326889.66787,-21600,,
com.google.Chrome,178,1740326686,1740326864,1740326864.2172852,-21600,,
com.electron.carta,18,1740326668,1740326686,1740326687.032086,-21600,,
com.jinzhenyu.ruler,2,1740326666,1740326668,1740326668.9696221,-21600,,
com.google.Chrome,18,1740326648,1740326666,1740326667.045329,-21600,,
com.jinzhenyu.ruler,28,1740326620,1740326648,1740326648.796097,-21600,,
com.google.Chrome,3,1740326617,1740326620,1740326620.163028,-21600,,
com.electron.carta,7,1740326610,1740326617,1740326617.953885,-21600,,
com.google.Chrome,11,1740326599,1740326610,1740326610.955723,-21600,,
com.apple.Preview,5,1740326594,1740326599,1740326599.365485,-21600,,
com.electron.carta,1,1740326593,1740326594,1740326594.55892,-21600,,
com.google.Chrome,3,1740326590,1740326593,1740326593.415206,-21600,,
com.electron.carta,48,1740326542,1740326590,1740326590.326404,-21600,,
com.apple.Preview,3,1740326539,1740326542,1740326542.2148762,-21600,,
com.electron.carta,24,1740326515,1740326539,1740326539.357414,-21600,,
com.google.Chrome,2,1740326513,1740326515,1740326516.052971,-21600,,
com.electron.carta,89,1740326424,1740326513,1740326513.741859,-21600,,
com.apple.Preview,5,1740326419,1740326424,1740326424.65674,-21600,,
com.apple.finder,2,1740326417,1740326419,1740326419.667814,-21600,,
com.google.Chrome,10,1740326407,1740326417,1740326417.131112,-21600,,
com.electron.carta,8,1740326399,1740326407,1740326407.94,-21600,,
com.google.Chrome,34,1740326365,1740326399,1740326399.986171,-21600,,
com.electron.carta,100,1740326265,1740326365,1740326365.8770251,-21600,,
com.google.Chrome,65,1740326200,1740326265,1740326265.1043081,-21600,,
com.electron.carta,23,1740326177,1740326200,1740326200.820034,-21600,,
com.google.Chrome,7,1740326170,1740326177,1740326177.313237,-21600,,
com.apple.Preview,6,1740326164,1740326170,1740326170.261862,-21600,,
com.apple.finder,5,1740326159,1740326164,1740326164.206811,-21600,,
com.apple.Preview,2,1740326157,1740326159,1740326159.3045058,-21600,,
com.google.Chrome,10,1740326147,1740326157,1740326157.7604961,-21600,,
com.apple.Preview,4,1740326143,1740326147,1740326148.0571861,-21600,,
com.google.Chrome,3,1740326140,1740326143,1740326143.369893,-21600,,
com.electron.carta,5,1740326135,1740326140,1740326140.378515,-21600,,
com.google.Chrome,32,1740326103,1740326135,1740326135.168519,-21600,,
com.electron.carta,52,1740326051,1740326103,1740326103.989348,-21600,,
com.apple.finder,7,1740326044,1740326051,1740326051.948035,-21600,,
com.electron.carta,194,1740325850,1740326044,1740326044.4863591,-21600,,
com.google.Chrome,4,1740325846,1740325850,1740325850.449243,-21600,,
com.electron.carta,7,1740325839,1740325846,1740325846.888708,-21600,,
com.google.Chrome,5,1740325834,1740325839,1740325839.689626,-21600,,
com.electron.carta,14,1740325820,1740325834,1740325834.908277,-21600,,
com.jinzhenyu.ruler,4,1740325816,1740325820,1740325820.153995,-21600,,
com.google.Chrome,23,1740325793,1740325816,1740325816.504904,-21600,,
com.jinzhenyu.ruler,24,1740325769,1740325793,1740325793.829462,-21600,,
com.google.Chrome,15,1740325754,1740325769,1740325769.922913,-21600,,
com.electron.carta,27,1740325727,1740325754,1740325754.7835798,-21600,,
com.google.Chrome,2,1740325725,1740325727,1740325727.221451,-21600,,
com.electron.carta,58,1740325667,1740325725,1740325725.4683561,-21600,,
com.google.Chrome,3,1740325664,1740325667,1740325667.124605,-21600,,
com.electron.carta,46,1740325618,1740325664,1740325664.809713,-21600,,
com.apple.Preview,10,1740325608,1740325618,1740325619.042848,-21600,,
com.apple.finder,7,1740325601,1740325608,1740325608.6398458,-21600,,
com.electron.carta,21,1740325580,1740325601,1740325601.849026,-21600,,
com.google.Chrome,15,1740325565,1740325580,1740325580.238964,-21600,,
com.apple.Preview,2,1740325563,1740325565,1740325565.3964372,-21600,,
com.google.Chrome,3,1740325560,1740325563,1740325563.8417501,-21600,,
com.apple.Preview,2,1740325558,1740325560,1740325560.2166,-21600,,
com.google.Chrome,5,1740325553,1740325558,1740325558.134142,-21600,,
com.apple.Preview,5,1740325548,1740325553,1740325553.595382,-21600,,
com.google.Chrome,83,1740325465,1740325548,1740325548.724724,-21600,,
Astrospheric.Astrospheric,19,1740325399,1740325418,1740325418.745327,-21600,EB445137-D7F5-57EC-87DA-1DB460D64046,"iPhone13,2"
com.apple.Health,10,1740325385,1740325395,1740325395.922268,-21600,EB445137-D7F5-57EC-87DA-1DB460D64046,"iPhone13,2"
com.electron.carta,135,1740325330,1740325465,1740325465.394988,-21600,,
com.jinzhenyu.ruler,14,1740325316,1740325330,1740325330.654731,-21600,,
com.google.Chrome,28,1740325288,1740325316,1740325316.566907,-21600,,
com.jinzhenyu.ruler,77,1740325211,1740325288,1740325288.820963,-21600,,
com.electron.carta,54,1740325157,1740325211,1740325211.493587,-21600,,
com.google.Chrome,3,1740325154,1740325157,1740325157.329978,-21600,,
com.electron.carta,44,1740325110,1740325154,1740325154.476645,-21600,,
com.google.Chrome,4,1740325106,1740325110,1740325110.73855,-21600,,
com.electron.carta,55,1740325051,1740325106,1740325106.4819531,-21600,,
com.apple.Preview,2,1740325049,1740325051,1740325051.386218,-21600,,
com.apple.finder,0,1740325049,1740325049,1740325049.795306,-21600,,
com.apple.Preview,61,1740324988,1740325049,1740325049.566,-21600,,
com.apple.finder,100,1740324888,1740324988,1740324988.582221,-21600,,
com.electron.carta,9,1740324879,1740324888,1740324888.196172,-21600,,
com.google.Chrome,7,1740324872,1740324879,1740324879.43821,-21600,,
com.electron.carta,35,1740324837,1740324872,1740324872.1409721,-21600,,
com.google.Chrome,34,1740324803,1740324837,1740324837.069417,-21600,,
com.google.Chrome,41,1740324678,1740324719,1740324719.51472,-21600,,
com.apple.Notes,4,1740324674,1740324678,1740324680.711319,-21600,,
com.apple.finder,7,1740324667,1740324674,1740324674.836751,-21600,,
com.apple.Music,5,1740324662,1740324667,1740324667.8588672,-21600,,
com.myfitnesspal.mfp,110,1740324206,1740324316,1740324316.870683,-21600,EB445137-D7F5-57EC-87DA-1DB460D64046,"iPhone13,2"
com.renpho.health,8,1740324198,1740324206,1740324206.549432,-21600,EB445137-D7F5-57EC-87DA-1DB460D64046,"iPhone13,2"
com.renpho.health,29,1740323364,1740323393,1740323393.2505422,-21600,EB445137-D7F5-57EC-87DA-1DB460D64046,"iPhone13,2"
com.apple.weather,6,1740323357,1740323363,1740323363.0485768,-21600,EB445137-D7F5-57EC-87DA-1DB460D64046,"iPhone13,2"
com.apple.news,604,1740321399,1740322003,1740322003.9553142,-21600,EB445137-D7F5-57EC-87DA-1DB460D64046,"iPhone13,2"
com.apple.Music,7,1740289973,1740289980,1740289980.818403,-21600,,
com.apple.MobileSMS,2,1740289933,1740289935,1740289935.370429,-21600,EB445137-D7F5-57EC-87DA-1DB460D64046,"iPhone13,2"
com.apple.news,751,1740289173,1740289924,1740289924.584818,-21600,EB445137-D7F5-57EC-87DA-1DB460D64046,"iPhone13,2"
com.apple.Music,356,1740289113,1740289469,1740289469.40091,-21600,,
com.apple.Preview,0,1740289113,1740289113,1740289113.922826,-21600,,
com.apple.news,270,1740288504,1740288774,1740288774.902686,-21600,EB445137-D7F5-57EC-87DA-1DB460D64046,"iPhone13,2"
com.google.Chrome,695,1740288418,1740289113,1740289113.7049088,-21600,,
com.apple.news,337,1740288058,1740288395,1740288395.793504,-21600,EB445137-D7F5-57EC-87DA-1DB460D64046,"iPhone13,2"
com.instructure.icanvas,2,1740288056,1740288058,1740288058.43673,-21600,EB445137-D7F5-57EC-87DA-1DB460D64046,"iPhone13,2"
com.apple.Music,533,1740287885,1740288418,1740288418.912967,-21600,,
com.google.Chrome,2,1740287883,1740287885,1740287885.0346298,-21600,,
com.instructure.icanvas,27,1740287756,1740287783,1740287784.0597072,-21600,EB445137-D7F5-57EC-87DA-1DB460D64046,"iPhone13,2"
com.apple.news,0,1740287756,1740287756,1740287757.019717,-21600,EB445137-D7F5-57EC-87DA-1DB460D64046,"iPhone13,2"
com.apple.finder,2,1740287184,1740287186,1740287186.131514,-21600,,
com.apple.news,4,1740285603,1740285607,1740285607.536395,-21600,EB445137-D7F5-57EC-87DA-1DB460D64046,"iPhone13,2"
com.apple.news,337,1740283817,1740284154,1740284154.265939,-21600,EB445137-D7F5-57EC-87DA-1DB460D64046,"iPhone13,2"
com.apple.news,1,1740281620,1740281621,1740281621.542955,-21600,EB445137-D7F5-57EC-87DA-1DB460D64046,"iPhone13,2"
com.apple.Music,3,1740281612,1740281615,1740281615.051526,-21600,EB445137-D7F5-57EC-87DA-1DB460D64046,"iPhone13,2"
com.apple.Music,35,1740278563,1740278598,1740278598.646747,-21600,EB445137-D7F5-57EC-87DA-1DB460D64046,"iPhone13,2"
com.google.chrome.ios,3,1740278499,1740278502,1740278502.768789,-21600,EB445137-D7F5-57EC-87DA-1DB460D64046,"iPhone13,2"
com.google.chrome.ios,121,1740278038,1740278159,1740278159.758693,-21600,EB445137-D7F5-57EC-87DA-1DB460D64046,"iPhone13,2"
com.google.chrome.ios,42,1740276246,1740276288,1740276288.221009,-21600,EB445137-D7F5-57EC-87DA-1DB460D64046,"iPhone13,2"
com.apple.MobileSMS,23,1740276017,1740276040,1740276040.894316,-21600,EB445137-D7F5-57EC-87DA-1DB460D64046,"iPhone13,2"
com.apple.news,0,1740276017,1740276017,1740276018.275151,-21600,EB445137-D7F5-57EC-87DA-1DB460D64046,"iPhone13,2"
com.apple.news,18,1740274617,1740274635,1740274636.063359,-21600,EB445137-D7F5-57EC-87DA-1DB460D64046,"iPhone13,2"
com.google.chrome.ios,2,1740274598,1740274600,1740274601.098837,-21600,EB445137-D7F5-57EC-87DA-1DB460D64046,"iPhone13,2"
com.google.chrome.ios,74,1740272174,1740272248,1740272249.245586,-21600,EB445137-D7F5-57EC-87DA-1DB460D64046,"iPhone13,2"
com.apple.news,2,1740272172,1740272174,1740272174.303437,-21600,EB445137-D7F5-57EC-87DA-1DB460D64046,"iPhone13,2"
com.apple.news,72,1740268479,1740268551,1740268551.344913,-21600,EB445137-D7F5-57EC-87DA-1DB460D64046,"iPhone13,2"
com.apple.Music,9,1740268462,1740268471,1740268471.4826941,-21600,EB445137-D7F5-57EC-87DA-1DB460D64046,"iPhone13,2"
com.apple.Music,18,1740266105,1740266123,1740266123.933578,-21600,EB445137-D7F5-57EC-87DA-1DB460D64046,"iPhone13,2"
com.hammerandchisel.discord,2,1740266099,1740266101,1740266101.671426,-21600,EB445137-D7F5-57EC-87DA-1DB460D64046,"iPhone13,2"
com.apple.finder,3,1740265852,1740265855,1740265856.105229,-21600,,
com.apple.Notes,2,1740265850,1740265852,1740265852.349465,-21600,,
com.google.Chrome,990,1740264860,1740265850,1740265850.661388,-21600,,
com.apple.finder,3,1740264857,1740264860,1740264860.642695,-21600,,
com.google.Chrome,102,1740264755,1740264857,1740264857.7581968,-21600,,
com.apple.Notes,31,1740264724,1740264755,1740264755.1063051,-21600,,
com.google.Chrome,71,1740264653,1740264724,1740264724.164507,-21600,,
com.apple.finder,17,1740264636,1740264653,1740264654.722612,-21600,,
com.microsoft.VSCode,1634,1740263002,1740264636,1740264637.367964,-21600,,
com.google.Chrome,2,1740263000,1740263002,1740263002.577694,-21600,,
com.leomehlig.today,40,1740262960,1740263000,1740263000.433068,-21600,,
com.google.Chrome,2,1740262958,1740262960,1740262961.0339599,-21600,,
com.apple.Preview,164,1740262794,1740262958,1740262959.0671458,-21600,,
com.apple.finder,1,1740262793,1740262794,1740262794.9945378,-21600,,
com.apple.Preview,20,1740262773,1740262793,1740262793.5614371,-21600,,
com.apple.finder,8,1740262765,1740262773,1740262773.956661,-21600,,
com.leomehlig.today,22,1740262743,1740262765,1740262765.974029,-21600,,
com.apple.Preview,9,1740262734,1740262743,1740262743.9656491,-21600,,
com.leomehlig.today,3,1740262731,1740262734,1740262734.7075071,-21600,,
com.apple.Preview,635,1740262096,1740262731,1740262731.922759,-21600,,
com.leomehlig.today,2,1740262094,1740262096,1740262096.429523,-21600,,
com.hammerandchisel.discord,9,1740261743,1740261752,1740261752.4718962,-21600,EB445137-D7F5-57EC-87DA-1DB460D64046,"iPhone13,2"
com.intsig.CamScannerLite,3,1740261740,1740261743,1740261743.6223311,-21600,EB445137-D7F5-57EC-87DA-1DB460D64046,"iPhone13,2"
com.apple.Preview,397,1740261697,1740262094,1740262094.1799831,-21600,,
com.google.Chrome,39,1740261658,1740261697,1740261697.122006,-21600,,
com.apple.Preview,1272,1740260386,1740261658,1740261658.551435,-21600,,
com.apple.finder,52,1740260334,1740260386,1740260386.343581,-21600,,
com.google.Chrome,26,1740260308,1740260334,1740260334.786572,-21600,,
com.apple.finder,134,1740260174,1740260308,1740260308.440858,-21600,,
com.google.Chrome,7,1740260167,1740260174,1740260174.7415829,-21600,,
com.apple.finder,4,1740260163,1740260167,1740260167.0675402,-21600,,
com.google.Chrome,12,1740260151,1740260163,1740260164.0117931,-21600,,
com.apple.finder,3,1740260148,1740260151,1740260151.0941129,-21600,,
com.apple.Preview,1,1740260147,1740260148,1740260148.400724,-21600,,
com.google.Chrome,4,1740260143,1740260147,1740260147.060631,-21600,,
com.apple.Preview,7,1740260136,1740260143,1740260143.9210138,-21600,,
com.apple.finder,17,1740260119,1740260136,1740260136.598153,-21600,,
com.intsig.CamScannerLite,90,1740260088,1740260178,1740260178.2059479,-21600,EB445137-D7F5-57EC-87DA-1DB460D64046,"iPhone13,2"
com.apple.Preview,78,1740260041,1740260119,1740260119.778975,-21600,,
com.apple.finder,5,1740260036,1740260041,1740260041.948446,-21600,,
com.google.Chrome,446,1740259590,1740260036,1740260036.3491712,-21600,,
com.leomehlig.today,167,1740259423,1740259590,1740259591.9865599,-21600,,
com.apple.Preview,326,1740259097,1740259423,1740259423.940485,-21600,,
com.apple.Preview,595,1740258484,1740259079,1740259079.965471,-21600,,
com.apple.Preview,696,1740257747,1740258443,1740258443.117274,-21600,,
com.google.Chrome,448,1740257299,1740257747,1740257747.116015,-21600,,
com.apple.Preview,169,1740257130,1740257299,1740257299.973678,-21600,,
com.apple.Preview,380,1740256723,1740257103,1740257103.3314152,-21600,,
com.apple.finder,3,1740256720,1740256723,1740256723.503845,-21600,,
com.apple.Preview,2,1740256718,1740256720,1740256720.2624269,-21600,,
com.apple.finder,7,1740256711,1740256718,1740256718.907003,-21600,,
com.leomehlig.today,9,1740256702,1740256711,1740256711.827547,-21600,,
com.apple.MobileSMS,70,1740256632,1740256702,1740256702.415084,-21600,,
com.leomehlig.today,109,1740256523,1740256632,1740256632.768367,-21600,,
com.apple.Notes,38,1740256485,1740256523,1740256523.0844622,-21600,,
com.leomehlig.today,28,1740256457,1740256485,1740256485.564223,-21600,,
com.apple.finder,70,1740256387,1740256457,1740256458.03725,-21600,,
com.microsoft.Outlook,3,1740256384,1740256387,1740256387.401279,-21600,,
com.apple.finder,152,1740256232,1740256384,1740256384.798634,-21600,,
com.leomehlig.today,1,1740256231,1740256232,1740256232.5165858,-21600,,
com.apple.finder,8,1740256223,1740256231,1740256231.955939,-21600,,
com.apple.news,379,1740255840,1740256219,1740256219.333366,-21600,EB445137-D7F5-57EC-87DA-1DB460D64046,"iPhone13,2"
com.apple.finder,316,1740255796,1740256112,1740256112.4927812,-21600,,
com.leomehlig.today,15,1740255781,1740255796,1740255796.302843,-21600,,
com.apple.Preview,530,1740255251,1740255781,1740255781.89685,-21600,,
com.leomehlig.today,2,1740255249,1740255251,1740255251.2840629,-21600,,
com.hammerandchisel.discord,24,1740255220,1740255244,1740255244.339042,-21600,EB445137-D7F5-57EC-87DA-1DB460D64046,"iPhone13,2"
com.hammerandchisel.discord,3,1740255202,1740255205,1740255205.69317,-21600,EB445137-D7F5-57EC-87DA-1DB460D64046,"iPhone13,2"
com.intsig.CamScannerLite,2,1740255199,1740255201,1740255201.100694,-21600,EB445137-D7F5-57EC-87DA-1DB460D64046,"iPhone13,2"
com.intsig.CamScannerLite,0,1740255198,1740255198,1740255199.478177,-21600,EB445137-D7F5-57EC-87DA-1DB460D64046,"iPhone13,2"
com.apple.Preview,1210,1740254039,1740255249,1740255250.0404692,-21600,,
com.apple.MobileSMS,6,1740254033,1740254039,1740254039.442391,-21600,,
com.apple.Preview,483,1740253550,1740254033,1740254033.932341,-21600,,
com.apple.finder,8,1740253542,1740253550,1740253550.661076,-21600,,
com.leomehlig.today,4,1740253538,1740253542,1740253542.1117249,-21600,,
com.apple.finder,1,1740253537,1740253538,1740253538.925484,-21600,,
com.apple.Preview,7,1740253530,1740253537,1740253537.982019,-21600,,
com.apple.finder,11,1740253519,1740253530,1740253530.204607,-21600,,
com.leomehlig.today,57,1740253462,1740253519,1740253519.936903,-21600,,
com.apple.Preview,150,1740253312,1740253462,1740253462.081554,-21600,,
com.apple.finder,180,1740253132,1740253312,1740253312.091298,-21600,,
com.apple.Preview,26,1740253106,1740253132,1740253132.668194,-21600,,
com.apple.finder,11,1740253095,1740253106,1740253106.13902,-21600,,
com.intsig.CamScannerLite,254,1740253092,1740253346,1740253346.803913,-21600,EB445137-D7F5-57EC-87DA-1DB460D64046,"iPhone13,2"
com.hammerandchisel.discord,104,1740252984,1740253088,1740253088.634253,-21600,EB445137-D7F5-57EC-87DA-1DB460D64046,"iPhone13,2"
com.google.chrome.ios,1,1740252983,1740252984,1740252984.556036,-21600,EB445137-D7F5-57EC-87DA-1DB460D64046,"iPhone13,2"
com.google.Chrome,182,1740252913,1740253095,1740253095.2700438,-21600,,
com.apple.finder,2,1740252911,1740252913,1740252914.155422,-21600,,
com.leomehlig.today,4,1740252907,1740252911,1740252911.583434,-21600,,
com.apple.finder,2,1740252905,1740252907,1740252907.734746,-21600,,
com.microsoft.VSCode,36,1740252869,1740252905,1740252906.1753411,-21600,,
com.google.Chrome,18,1740252851,1740252869,1740252870.041744,-21600,,
com.microsoft.VSCode,1,1740252850,1740252851,1740252851.573869,-21600,,
com.google.Chrome,33,1740252817,1740252850,1740252850.6838,-21600,,
com.apple.finder,3,1740252814,1740252817,1740252817.47159,-21600,,
com.microsoft.VSCode,647,1740252167,1740252814,1740252814.531333,-21600,,
com.google.Chrome,40,1740252127,1740252167,1740252167.600611,-21600,,
com.microsoft.VSCode,306,1740251821,1740252127,1740252127.9165092,-21600,,
com.google.Chrome,10,1740251811,1740251821,1740251821.140995,-21600,,
com.microsoft.VSCode,59,1740251752,1740251811,1740251812.030741,-21600,,
com.google.Chrome,16,1740251736,1740251752,1740251752.608974,-21600,,
com.apple.MobileSMS,26,1740251710,1740251736,1740251736.210562,-21600,,
com.google.Chrome,39,1740251671,1740251710,1740251710.622388,-21600,,
com.microsoft.VSCode,217,1740251454,1740251671,1740251671.95068,-21600,,
com.google.Chrome,1,1740251453,1740251454,1740251454.494405,-21600,,
com.microsoft.VSCode,7,1740251446,1740251453,1740251453.048995,-21600,,
com.google.Chrome,2,1740251444,1740251446,1740251446.5232959,-21600,,
com.microsoft.VSCode,70,1740251374,1740251444,1740251444.370785,-21600,,
com.google.Chrome,29,1740251345,1740251374,1740251374.190773,-21600,,
com.microsoft.VSCode,134,1740251211,1740251345,1740251345.185077,-21600,,
com.google.Chrome,30,1740251181,1740251211,1740251211.760431,-21600,,
com.microsoft.VSCode,31,1740251137,1740251168,1740251168.114708,-21600,,
com.google.Chrome,6,1740251131,1740251137,1740251137.628644,-21600,,
com.apple.finder,16,1740251115,1740251131,1740251131.977236,-21600,,
com.google.Chrome,37,1740251078,1740251115,1740251115.104416,-21600,,
com.leomehlig.today,9,1740251069,1740251078,1740251079.1331592,-21600,,
com.google.Chrome,4,1740251065,1740251069,1740251069.1653,-21600,,
com.google.chrome.ios,4,1740250942,1740250946,1740250946.3560472,-21600,EB445137-D7F5-57EC-87DA-1DB460D64046,"iPhone13,2"
com.apple.CoreAuthUI,2,1740250920,1740250922,1740250922.229933,-21600,EB445137-D7F5-57EC-87DA-1DB460D64046,"iPhone13,2"
com.google.chrome.ios,28,1740250911,1740250939,1740250939.5424662,-21600,EB445137-D7F5-57EC-87DA-1DB460D64046,"iPhone13,2"
com.duosecurity.DuoMobile,1,1740250910,1740250911,1740250911.897171,-21600,EB445137-D7F5-57EC-87DA-1DB460D64046,"iPhone13,2"
com.google.Chrome,19,1740249520,1740249539,1740249539.391381,-21600,,
com.apple.finder,1,1740249519,1740249520,1740249520.6959891,-21600,,
com.google.Chrome,14,1740249505,1740249519,1740249519.237205,-21600,,
com.apple.finder,25,1740249480,1740249505,1740249505.369659,-21600,,
com.google.Chrome,22,1740249458,1740249480,1740249480.5503511,-21600,,
com.apple.finder,3,1740249439,1740249442,1740249442.574256,-21600,,
com.apple.finder,62,1740249022,1740249084,1740249084.39404,-21600,,
com.leomehlig.today,2,1740249020,1740249022,1740249022.421107,-21600,,
com.google.Chrome,1,1740249019,1740249020,1740249020.867762,-21600,,
com.apple.finder,2,1740249017,1740249019,1740249019.124104,-21600,,
com.microsoft.VSCode,3,1740249014,1740249017,1740249017.1898909,-21600,,
com.apple.finder,8,1740249006,1740249014,1740249014.686763,-21600,,
com.google.Chrome,12,1740248994,1740249006,1740249006.288402,-21600,,
com.leomehlig.today,4,1740248990,1740248994,1740248994.365941,-21600,,
com.google.Chrome,69,1740248921,1740248990,1740248990.3236408,-21600,,
com.leomehlig.today,15,1740248906,1740248921,1740248921.582268,-21600,,
com.google.Chrome,0,1740248906,1740248906,1740248906.860385,-21600,,
com.leomehlig.today,1,1740248905,1740248906,1740248906.248208,-21600,,
com.google.Chrome,1,1740248904,1740248905,1740248905.455369,-21600,,
com.apple.Terminal,168,1740248720,1740248888,1740248888.6685472,-21600,,
com.duosecurity.DuoMobile,3,1740248714,1740248717,1740248717.5646849,-21600,EB445137-D7F5-57EC-87DA-1DB460D64046,"iPhone13,2"
com.cisco.secureclient.gui,31,1740248689,1740248720,1740248720.968442,-21600,,
com.apple.Terminal,4,1740248685,1740248689,1740248689.849304,-21600,,
com.apple.finder,25,1740248660,1740248685,1740248685.167963,-21600,,
com.google.Chrome,5,1740248655,1740248660,1740248660.6662378,-21600,,
com.apple.finder,24,1740248631,1740248655,1740248655.502574,-21600,,
com.google.Chrome,62,1740248569,1740248631,1740248631.9447532,-21600,,
com.microsoft.VSCode,41,1740248528,1740248569,1740248569.270931,-21600,,
com.apple.finder,313,1740248215,1740248528,1740248528.299341,-21600,,
com.microsoft.VSCode,32,1740248183,1740248215,1740248215.266675,-21600,,
com.apple.finder,3,1740248180,1740248183,1740248183.455719,-21600,,
com.microsoft.VSCode,64,1740248116,1740248180,1740248180.353451,-21600,,
com.apple.finder,3,1740248113,1740248116,1740248116.431608,-21600,,
com.microsoft.VSCode,36,1740248077,1740248113,1740248113.8097792,-21600,,
com.apple.finder,3,1740248074,1740248077,1740248077.437217,-21600,,
com.microsoft.VSCode,62,1740248012,1740248074,1740248074.89696,-21600,,
com.apple.finder,2,1740248010,1740248012,1740248012.644215,-21600,,
com.microsoft.VSCode,4,1740248006,1740248010,1740248010.345072,-21600,,
com.apple.finder,3,1740248003,1740248006,1740248006.092829,-21600,,
com.microsoft.VSCode,21,1740247982,1740248003,1740248003.046939,-21600,,
com.apple.finder,2,1740247980,1740247982,1740247982.608618,-21600,,
com.microsoft.VSCode,26,1740247954,1740247980,1740247980.185554,-21600,,
com.apple.finder,4,1740247950,1740247954,1740247954.370904,-21600,,
com.microsoft.VSCode,67,1740247883,1740247950,1740247950.859034,-21600,,
com.google.Chrome,121,1740247762,1740247883,1740247883.337296,-21600,,
com.microsoft.VSCode,61,1740247701,1740247762,1740247762.8090281,-21600,,
com.apple.finder,6,1740247695,1740247701,1740247701.733377,-21600,,
com.microsoft.VSCode,2,1740247693,1740247695,1740247695.840121,-21600,,
com.apple.finder,1,1740247692,1740247693,1740247693.938709,-21600,,
com.microsoft.VSCode,7,1740247685,1740247692,1740247692.03646,-21600,,
com.apple.finder,1,1740247684,1740247685,1740247685.80936,-21600,,
com.microsoft.VSCode,32,1740247652,1740247684,1740247684.352773,-21600,,
com.apple.finder,9,1740247643,1740247652,1740247652.277728,-21600,,
com.microsoft.VSCode,130,1740247513,1740247643,1740247643.2215981,-21600,,
com.microsoft.VSCode,323,1740247077,1740247400,1740247400.77066,-21600,,
com.apple.finder,8,1740247069,1740247077,1740247077.410083,-21600,,
com.microsoft.VSCode,160,1740246909,1740247069,1740247069.8580961,-21600,,
com.google.Chrome,8,1740246901,1740246909,1740246909.248673,-21600,,
com.microsoft.VSCode,119,1740246782,1740246901,1740246901.748801,-21600,,
com.google.Chrome,33,1740246749,1740246782,1740246782.722924,-21600,,
com.electron.carta,1,1740246748,1740246749,1740246749.818417,-21600,,
com.google.Chrome,143,1740246605,1740246748,1740246748.625859,-21600,,
com.electron.carta,52,1740246553,1740246605,1740246605.878658,-21600,,
com.google.Chrome,3,1740246550,1740246553,1740246553.57879,-21600,,
com.electron.carta,20,1740246530,1740246550,1740246550.211689,-21600,,
com.jinzhenyu.ruler,5,1740246525,1740246530,1740246530.885795,-21600,,
com.electron.carta,2,1740246523,1740246525,1740246525.597825,-21600,,
com.google.Chrome,7,1740246516,1740246523,1740246523.0544739,-21600,,
com.electron.carta,5,1740246511,1740246516,1740246516.679463,-21600,,
com.jinzhenyu.ruler,1,1740246510,1740246511,1740246511.796541,-21600,,
com.google.Chrome,6,1740246504,1740246510,1740246510.1577868,-21600,,
com.jinzhenyu.ruler,23,1740246481,1740246504,1740246504.4966888,-21600,,
com.electron.carta,33,1740246448,1740246481,1740246481.614214,-21600,,
com.google.Chrome,11,1740246437,1740246448,1740246448.616094,-21600,,
com.electron.carta,3,1740246434,1740246437,1740246437.7159681,-21600,,
com.google.Chrome,59,1740246375,1740246434,1740246434.139081,-21600,,
com.electron.carta,125,1740246250,1740246375,1740246376.019736,-21600,,
com.apple.Preview,11,1740246239,1740246250,1740246251.00987,-21600,,
com.apple.finder,1,1740246238,1740246239,1740246239.677639,-21600,,
com.electron.carta,27,1740246211,1740246238,1740246238.553242,-21600,,
com.google.Chrome,11,1740246200,1740246211,1740246211.2186131,-21600,,
com.electron.carta,11,1740246189,1740246200,1740246200.151541,-21600,,
com.google.Chrome,9,1740246180,1740246189,1740246189.730983,-21600,,
com.electron.carta,119,1740246061,1740246180,1740246180.230575,-21600,,
com.apple.Preview,6,1740246055,1740246061,1740246061.2004929,-21600,,
com.apple.finder,1,1740246054,1740246055,1740246055.3651562,-21600,,
com.google.Chrome,20,1740246034,1740246054,1740246054.418322,-21600,,
com.apple.finder,6,1740246028,1740246034,1740246034.8678179,-21600,,
com.microsoft.VSCode,19,1740246009,1740246028,1740246028.248517,-21600,,
com.apple.finder,21,1740245988,1740246009,1740246009.602525,-21600,,
com.microsoft.VSCode,366,1740245622,1740245988,1740245988.108749,-21600,,
com.google.Chrome,17,1740245605,1740245622,1740245622.446866,-21600,,
com.microsoft.VSCode,20,1740245585,1740245605,1740245605.516005,-21600,,
com.google.Chrome,20,1740245565,1740245585,1740245585.21202,-21600,,
com.microsoft.VSCode,507,1740245058,1740245565,1740245565.7651482,-21600,,
com.apple.Preview,9,1740245049,1740245058,1740245058.8110142,-21600,,
com.apple.finder,18,1740245031,1740245049,1740245049.8783488,-21600,,
com.microsoft.VSCode,229,1740244802,1740245031,1740245031.990387,-21600,,
com.apple.finder,18,1740244784,1740244802,1740244802.677336,-21600,,
com.microsoft.VSCode,101,1740244683,1740244784,1740244784.9827561,-21600,,
com.apple.finder,3,1740244680,1740244683,1740244683.075716,-21600,,
com.microsoft.VSCode,29,1740244651,1740244680,1740244680.812097,-21600,,
com.apple.finder,60,1740244591,1740244651,1740244651.6151,-21600,,
com.microsoft.VSCode,23,1740244568,1740244591,1740244591.677973,-21600,,
com.google.Chrome,3,1740244565,1740244568,1740244568.479969,-21600,,
com.microsoft.VSCode,2,1740244563,1740244565,1740244565.1267672,-21600,,
com.google.Chrome,127,1740244436,1740244563,1740244563.363803,-21600,,
com.electron.carta,40,1740244396,1740244436,1740244436.899189,-21600,,
com.google.Chrome,13,1740244383,1740244396,1740244396.105021,-21600,,
com.electron.carta,17,1740244366,1740244383,1740244383.2694821,-21600,,
com.google.Chrome,8,1740244358,1740244366,1740244366.154882,-21600,,
com.electron.carta,60,1740244298,1740244358,1740244358.990191,-21600,,
com.google.Chrome,8,1740244290,1740244298,1740244298.5315251,-21600,,
com.electron.carta,41,1740244249,1740244290,1740244290.29381,-21600,,
com.google.Chrome,10,1740244239,1740244249,1740244249.890351,-21600,,
com.electron.carta,51,1740244188,1740244239,1740244239.469321,-21600,,
com.google.Chrome,7,1740244181,1740244188,1740244188.1079578,-21600,,
com.electron.carta,59,1740244122,1740244181,1740244181.776964,-21600,,
com.google.Chrome,42,1740244080,1740244122,1740244122.9982162,-21600,,
com.electron.carta,36,1740244044,1740244080,1740244080.393828,-21600,,
com.google.Chrome,2,1740244042,1740244044,1740244044.9771109,-21600,,
com.electron.carta,22,1740244020,1740244042,1740244042.96838,-21600,,
com.google.Chrome,7,1740244013,1740244020,1740244020.63889,-21600,,
com.electron.carta,39,1740243974,1740244013,1740244013.851095,-21600,,
com.google.Chrome,31,1740243943,1740243974,1740243974.0853739,-21600,,
com.electron.carta,40,1740243903,1740243943,1740243943.4411988,-21600,,
com.google.Chrome,7,1740243896,1740243903,1740243903.195928,-21600,,
com.apple.finder,4,1740243892,1740243896,1740243896.38967,-21600,,
com.google.Chrome,4,1740243888,1740243892,1740243892.581291,-21600,,
com.leomehlig.today,105,1740243783,1740243888,1740243888.240038,-21600,,
com.electron.carta,3,1740243780,1740243783,1740243783.913007,-21600,,
Astrospheric.Astrospheric,31,1740243744,1740243775,1740243775.987911,-21600,EB445137-D7F5-57EC-87DA-1DB460D64046,"iPhone13,2"
com.myfitnesspal.mfp,57,1740243550,1740243607,1740243608.042409,-21600,EB445137-D7F5-57EC-87DA-1DB460D64046,"iPhone13,2"
com.apple.mobilenotes,7,1740243542,1740243549,1740243550.030103,-21600,EB445137-D7F5-57EC-87DA-1DB460D64046,"iPhone13,2"
com.microsoft.Office.Outlook,3,1740243527,1740243530,1740243530.724922,-21600,EB445137-D7F5-57EC-87DA-1DB460D64046,"iPhone13,2"
com.apple.reminders,44,1740243482,1740243526,1740243526.6294909,-21600,EB445137-D7F5-57EC-87DA-1DB460D64046,"iPhone13,2"
com.microsoft.Office.Outlook,8,1740243471,1740243479,1740243479.739121,-21600,EB445137-D7F5-57EC-87DA-1DB460D64046,"iPhone13,2"
com.electron.carta,303,1740243442,1740243745,1740243745.614547,-21600,,
com.google.Chrome,5,1740243437,1740243442,1740243442.2025409,-21600,,
com.apple.finder,7,1740243430,1740243437,1740243437.0947452,-21600,,
com.google.Chrome,36,1740243394,1740243430,1740243430.8006349,-21600,,
com.electron.carta,29,1740243365,1740243394,1740243394.261282,-21600,,
com.apple.finder,9,1740243356,1740243365,1740243365.546444,-21600,,
com.electron.carta,54,1740243302,1740243356,1740243357.024743,-21600,,
com.apple.finder,20,1740243282,1740243302,1740243302.910682,-21600,,
com.google.Chrome,7,1740243275,1740243282,1740243282.968864,-21600,,
com.electron.carta,1,1740243274,1740243275,1740243275.0600471,-21600,,
com.apple.finder,5,1740243269,1740243274,1740243274.080467,-21600,,
com.electron.carta,1,1740243268,1740243269,1740243269.320368,-21600,,
com.google.Chrome,2,1740243266,1740243268,1740243268.344609,-21600,,
com.electron.carta,1,1740243265,1740243266,1740243266.383188,-21600,,
com.apple.finder,4,1740243261,1740243265,1740243265.72266,-21600,,
com.apple.Preview,4,1740243257,1740243261,1740243261.495014,-21600,,
com.electron.carta,51,1740243206,1740243257,1740243257.133266,-21600,,
com.google.Chrome,2,1740243204,1740243206,1740243206.339061,-21600,,
com.electron.carta,6,1740243198,1740243204,1740243204.727726,-21600,,
com.google.Chrome,19,1740243179,1740243198,1740243198.464663,-21600,,
com.electron.carta,30,1740243149,1740243179,1740243179.6134372,-21600,,
com.apple.Preview,4,1740243145,1740243149,1740243149.5018458,-21600,,
com.apple.finder,2,1740243143,1740243145,1740243145.4960241,-21600,,
com.electron.carta,15,1740243128,1740243143,1740243143.663498,-21600,,
com.google.Chrome,7,1740243121,1740243128,1740243128.340677,-21600,,
com.electron.carta,5,1740243116,1740243121,1740243121.400157,-21600,,
com.google.Chrome,105,1740243011,1740243116,1740243116.6696339,-21600,,
com.apple.finder,2,1740243009,1740243011,1740243012.080183,-21600,,
com.google.Chrome,23,1740242986,1740243009,1740243009.4755158,-21600,,
com.apple.finder,5,1740242981,1740242986,1740242986.5260382,-21600,,
com.google.Chrome,2,1740242979,1740242981,1740242981.725006,-21600,,
com.apple.finder,33,1740242946,1740242979,1740242979.15764,-21600,,
com.electron.carta,61,1740242885,1740242946,1740242946.867935,-21600,,
com.apple.Preview,2,1740242883,1740242885,1740242885.30738,-21600,,
com.electron.carta,12,1740242871,1740242883,1740242883.2912688,-21600,,
com.apple.Preview,4,1740242867,1740242871,1740242871.8987222,-21600,,
com.apple.finder,1,1740242866,1740242867,1740242867.093054,-21600,,
com.electron.carta,20,1740242846,1740242866,1740242866.8731341,-21600,,
com.apple.finder,8,1740242838,1740242846,1740242846.438318,-21600,,
com.electron.carta,126,1740242712,1740242838,1740242838.929394,-21600,,
com.apple.Preview,11,1740242701,1740242712,1740242712.368953,-21600,,
com.apple.finder,15,1740242686,1740242701,1740242701.132247,-21600,,
com.electron.carta,13,1740242673,1740242686,1740242686.632021,-21600,,
com.google.Chrome,55,1740242618,1740242673,1740242673.716401,-21600,,
com.electron.carta,53,1740242565,1740242618,1740242618.752205,-21600,,
com.google.Chrome,5,1740242560,1740242565,1740242565.869556,-21600,,
com.electron.carta,12,1740242548,1740242560,1740242560.610713,-21600,,
com.jinzhenyu.ruler,2,1740242546,1740242548,1740242548.458775,-21600,,
com.google.Chrome,24,1740242522,1740242546,1740242546.2969198,-21600,,
com.jinzhenyu.ruler,8,1740242514,1740242522,1740242522.770959,-21600,,
com.electron.carta,48,1740242466,1740242514,1740242514.838495,-21600,,
com.jinzhenyu.ruler,3,1740242463,1740242466,1740242466.598202,-21600,,
com.google.Chrome,23,1740242440,1740242463,1740242463.948147,-21600,,
com.jinzhenyu.ruler,11,1740242429,1740242440,1740242440.1455941,-21600,,
com.electron.carta,156,1740242273,1740242429,1740242429.121303,-21600,,
com.apple.Preview,5,1740242268,1740242273,1740242273.768385,-21600,,
com.electron.carta,71,1740242197,1740242268,1740242268.756796,-21600,,
com.apple.Preview,8,1740242189,1740242197,1740242197.242605,-21600,,
com.apple.finder,4,1740242185,1740242189,1740242189.799842,-21600,,
com.electron.carta,14,1740242171,1740242185,1740242186.000825,-21600,,
com.google.Chrome,28,1740242143,1740242171,1740242171.106005,-21600,,
com.apple.finder,2,1740242141,1740242143,1740242143.287891,-21600,,
com.google.Chrome,27,1740242114,1740242141,1740242141.624573,-21600,,
com.apple.finder,6,1740242108,1740242114,1740242114.230016,-21600,,
com.electron.carta,22,1740242086,1740242108,1740242108.407265,-21600,,
com.apple.Preview,13,1740242073,1740242086,1740242086.629689,-21600,,
com.apple.finder,0,1740242073,1740242073,1740242073.814229,-21600,,
com.electron.carta,38,1740242035,1740242073,1740242073.594236,-21600,,
com.apple.finder,5,1740242030,1740242035,1740242035.2377539,-21600,,
com.electron.carta,10,1740242020,1740242030,1740242030.821717,-21600,,
com.apple.finder,41,1740241979,1740242020,1740242020.701371,-21600,,
com.electron.carta,2,1740241977,1740241979,1740241979.920938,-21600,,
com.google.Chrome,42,1740241935,1740241977,1740241977.143211,-21600,,
com.electron.carta,13,1740241922,1740241935,1740241935.8406072,-21600,,
com.jinzhenyu.ruler,2,1740241920,1740241922,1740241922.418188,-21600,,
com.google.Chrome,29,1740241891,1740241920,1740241920.859232,-21600,,
com.jinzhenyu.ruler,2,1740241889,1740241891,1740241891.434495,-21600,,
com.google.Chrome,10,1740241879,1740241889,1740241889.159981,-21600,,
com.jinzhenyu.ruler,18,1740241861,1740241879,1740241880.00299,-21600,,
com.electron.carta,44,1740241817,1740241861,1740241861.38116,-21600,,
com.google.Chrome,49,1740241768,1740241817,1740241817.7222161,-21600,,
com.electron.carta,13,1740241755,1740241768,1740241769.088152,-21600,,
com.jinzhenyu.ruler,3,1740241752,1740241755,1740241755.065129,-21600,,
com.electron.carta,3,1740241749,1740241752,1740241752.5266051,-21600,,
com.jinzhenyu.ruler,1,1740241748,1740241749,1740241749.4672341,-21600,,
com.electron.carta,0,1740241748,1740241748,1740241748.850278,-21600,,
com.google.Chrome,56,1740241692,1740241748,1740241748.363631,-21600,,
com.jinzhenyu.ruler,28,1740241664,1740241692,1740241692.7026858,-21600,,
com.electron.carta,129,1740241535,1740241664,1740241664.893461,-21600,,
com.apple.Preview,9,1740241526,1740241535,1740241535.143707,-21600,,
com.apple.finder,2,1740241524,1740241526,1740241526.757813,-21600,,
com.electron.carta,4,1740241520,1740241524,1740241524.3552651,-21600,,
com.apple.finder,5,1740241515,1740241520,1740241520.883414,-21600,,
com.electron.carta,21,1740241494,1740241515,1740241515.067307,-21600,,
com.google.Chrome,10,1740241484,1740241494,1740241494.3116589,-21600,,
com.apple.finder,14,1740241470,1740241484,1740241484.939872,-21600,,
com.electron.carta,71,1740241399,1740241470,1740241470.373395,-21600,,
com.apple.finder,8,1740241391,1740241399,1740241399.9004111,-21600,,
com.electron.carta,9,1740241382,1740241391,1740241391.986837,-21600,,
com.apple.finder,5,1740241377,1740241382,1740241383.00965,-21600,,
com.google.Chrome,2,1740241375,1740241377,1740241377.69273,-21600,,
com.electron.carta,12,1740241363,1740241375,1740241375.907195,-21600,,
com.google.Chrome,2,1740241361,1740241363,1740241363.661346,-21600,,
com.apple.finder,9,1740241352,1740241361,1740241361.43436,-21600,,
com.electron.carta,15,1740241337,1740241352,1740241352.2355862,-21600,,
com.google.Chrome,30,1740241307,1740241337,1740241338.024606,-21600,,
com.electron.carta,25,1740241282,1740241307,1740241307.574596,-21600,,
com.jinzhenyu.ruler,3,1740241279,1740241282,1740241282.89397,-21600,,
com.google.Chrome,27,1740241252,1740241279,1740241279.544915,-21600,,
com.jinzhenyu.ruler,2,1740241250,1740241252,1740241252.8921509,-21600,,
com.google.Chrome,9,1740241241,1740241250,1740241250.7410011,-21600,,
com.jinzhenyu.ruler,46,1740241195,1740241241,1740241241.47212,-21600,,
com.electron.carta,63,1740241132,1740241195,1740241195.884037,-21600,,
com.google.Chrome,30,1740241102,1740241132,1740241132.793093,-21600,,
com.electron.carta,24,1740241078,1740241102,1740241102.102992,-21600,,
com.jinzhenyu.ruler,7,1740241071,1740241078,1740241078.256648,-21600,,
com.google.Chrome,37,1740241034,1740241071,1740241071.8180199,-21600,,
com.apple.Preview,2,1740241032,1740241034,1740241034.8358002,-21600,,
com.electron.carta,1,1740241031,1740241032,1740241032.5033522,-21600,,
com.jinzhenyu.ruler,1,1740241030,1740241031,1740241031.818721,-21600,,
com.google.Chrome,9,1740241021,1740241030,1740241030.872973,-21600,,
com.jinzhenyu.ruler,30,1740240991,1740241021,1740241021.147269,-21600,,
com.electron.carta,77,1740240914,1740240991,1740240991.6415849,-21600,,
com.apple.Preview,7,1740240907,1740240914,1740240914.587641,-21600,,
com.electron.carta,71,1740240836,1740240907,1740240907.246688,-21600,,
com.apple.Preview,6,1740240830,1740240836,1740240836.381178,-21600,,
com.apple.finder,2,1740240828,1740240830,1740240830.104457,-21600,,
com.google.Chrome,2,1740240826,1740240828,1740240828.423219,-21600,,
com.apple.finder,11,1740240815,1740240826,1740240826.355686,-21600,,
com.google.Chrome,20,1740240795,1740240815,1740240815.696775,-21600,,
com.apple.finder,1,1740240794,1740240795,1740240796.0850902,-21600,,
com.electron.carta,67,1740240727,1740240794,1740240794.821011,-21600,,
com.apple.Preview,13,1740240714,1740240727,1740240727.6057382,-21600,,
com.apple.finder,21,1740240693,1740240714,1740240714.177974,-21600,,
com.electron.carta,17,1740240676,1740240693,1740240693.904111,-21600,,
com.google.Chrome,27,1740240649,1740240676,1740240676.751709,-21600,,
com.apple.finder,0,1740240649,1740240649,1740240649.466292,-21600,,
com.electron.carta,106,1740240543,1740240649,1740240649.137971,-21600,,
com.apple.Preview,4,1740240539,1740240543,1740240543.427973,-21600,,
com.electron.carta,41,1740240498,1740240539,1740240539.904745,-21600,,
com.apple.Preview,17,1740240481,1740240498,1740240498.840564,-21600,,
com.apple.finder,6,1740240475,1740240481,1740240481.768299,-21600,,
com.electron.carta,7,1740240468,1740240475,1740240475.516015,-21600,,
com.google.Chrome,24,1740240444,1740240468,1740240468.809318,-21600,,
com.electron.carta,61,1740240383,1740240444,1740240444.999673,-21600,,
com.apple.finder,40,1740240343,1740240383,1740240383.1204581,-21600,,
com.google.Chrome,28,1740240315,1740240343,1740240343.28693,-21600,,
com.electron.carta,23,1740240292,1740240315,1740240316.033633,-21600,,
com.google.Chrome,55,1740240237,1740240292,1740240292.254771,-21600,,
com.apple.finder,3,1740240225,1740240228,1740240228.429995,-21600,,
com.leomehlig.today,98,1740240127,1740240225,1740240225.900913,-21600,,
com.google.Chrome,2,1740240125,1740240127,1740240127.094917,-21600,,
com.apple.MobileSMS,5,1740240120,1740240125,1740240125.527899,-21600,,
com.google.Chrome,20,1740240100,1740240120,1740240120.0672631,-21600,,
com.apple.MobileSMS,4,1740240096,1740240100,1740240100.150789,-21600,,
com.google.Chrome,121,1740239975,1740240096,1740240096.5599232,-21600,,
com.apple.MobileSMS,8,1740239967,1740239975,1740239975.353509,-21600,,
com.google.Chrome,183,1740239784,1740239967,1740239967.942978,-21600,,
com.apple.MobileSMS,6,1740239778,1740239784,1740239784.9123821,-21600,,
com.google.Chrome,3,1740239775,1740239778,1740239778.835493,-21600,,
com.apple.MobileSMS,3,1740239772,1740239775,1740239775.357572,-21600,,
com.google.Chrome,172,1740239600,1740239772,1740239772.298254,-21600,,
com.apple.MobileSMS,3,1740239597,1740239600,1740239600.457366,-21600,,
com.google.Chrome,3,1740239594,1740239597,1740239597.154182,-21600,,
com.apple.MobileSMS,3,1740239591,1740239594,1740239594.235928,-21600,,
com.google.Chrome,14,1740239577,1740239591,1740239591.186658,-21600,,
com.apple.MobileSMS,10,1740239567,1740239577,1740239577.6960878,-21600,,
com.apple.finder,2,1740239565,1740239567,1740239567.24084,-21600,,
com.apple.Music,1,1740239564,1740239565,1740239565.613212,-21600,,
com.apple.MobileSMS,1,1740239563,1740239564,1740239564.667866,-21600,,
com.apple.Music,25,1740239538,1740239563,1740239563.992389,-21600,,
com.apple.weather,4,1740239530,1740239534,1740239534.5061212,-21600,EB445137-D7F5-57EC-87DA-1DB460D64046,"iPhone13,2"
com.apple.Health,11,1740238008,1740238019,1740238019.797089,-21600,EB445137-D7F5-57EC-87DA-1DB460D64046,"iPhone13,2"
com.myfitnesspal.mfp,54,1740237952,1740238006,1740238006.436605,-21600,EB445137-D7F5-57EC-87DA-1DB460D64046,"iPhone13,2"
com.apple.calculator,13,1740237938,1740237951,1740237951.796052,-21600,EB445137-D7F5-57EC-87DA-1DB460D64046,"iPhone13,2"
com.renpho.health,2,1740237827,1740237829,1740237829.677917,-21600,EB445137-D7F5-57EC-87DA-1DB460D64046,"iPhone13,2"
com.renpho.health,24,1740236674,1740236698,1740236698.439313,-21600,EB445137-D7F5-57EC-87DA-1DB460D64046,"iPhone13,2"
com.apple.news,4,1740235502,1740235506,1740235506.8275518,-21600,EB445137-D7F5-57EC-87DA-1DB460D64046,"iPhone13,2"
com.apple.news,2,1740235496,1740235498,1740235498.8886461,-21600,EB445137-D7F5-57EC-87DA-1DB460D64046,"iPhone13,2"
com.apple.news,4,1740235485,1740235489,1740235489.0205588,-21600,EB445137-D7F5-57EC-87DA-1DB460D64046,"iPhone13,2"
com.apple.Music,15,1740202752,1740202767,1740202767.770989,-21600,,
com.apple.finder,6,1740202746,1740202752,1740202752.102515,-21600,,
com.apple.Music,3,1740202743,1740202746,1740202746.759767,-21600,,
com.apple.finder,1,1740202742,1740202743,1740202743.5305948,-21600,,
com.microsoft.VSCode,2,1740202740,1740202742,1740202742.094677,-21600,,
com.google.Chrome,82,1740202658,1740202740,1740202740.629256,-21600,,
com.microsoft.VSCode,25,1740202618,1740202643,1740202643.522954,-21600,,
com.apple.finder,16,1740202602,1740202618,1740202618.269958,-21600,,
com.microsoft.VSCode,104,1740202498,1740202602,1740202602.903452,-21600,,
com.google.Chrome,2,1740202496,1740202498,1740202498.3082309,-21600,,
com.microsoft.VSCode,0,1740202496,1740202496,1740202496.915025,-21600,,
com.google.Chrome,3,1740202493,1740202496,1740202496.117363,-21600,,
com.microsoft.VSCode,2,1740202491,1740202493,1740202494.026279,-21600,,
com.google.Chrome,1,1740202490,1740202491,1740202491.896661,-21600,,
com.microsoft.VSCode,2,1740202488,1740202490,1740202490.3807678,-21600,,
com.google.Chrome,4,1740202484,1740202488,1740202488.2156858,-21600,,
com.microsoft.VSCode,4,1740202480,1740202484,1740202484.581431,-21600,,
com.google.Chrome,2,1740202478,1740202480,1740202480.174341,-21600,,
com.microsoft.VSCode,0,1740202478,1740202478,1740202478.9497418,-21600,,
com.google.Chrome,2,1740202476,1740202478,1740202478.043952,-21600,,
com.microsoft.VSCode,3,1740202473,1740202476,1740202476.573834,-21600,,
com.google.Chrome,6,1740202467,1740202473,1740202473.21388,-21600,,
com.microsoft.VSCode,4,1740202463,1740202467,1740202467.921929,-21600,,
com.google.Chrome,1,1740202462,1740202463,1740202463.404272,-21600,,
com.microsoft.VSCode,3,1740202459,1740202462,1740202462.337181,-21600,,
com.google.Chrome,2,1740202457,1740202459,1740202459.081946,-21600,,
com.microsoft.VSCode,5,1740202452,1740202457,1740202457.934432,-21600,,
com.google.Chrome,1,1740202451,1740202452,1740202452.899713,-21600,,
com.microsoft.VSCode,4,1740202447,1740202451,1740202451.6069121,-21600,,
com.google.Chrome,2,1740202445,1740202447,1740202447.290385,-21600,,
com.microsoft.VSCode,1,1740202444,1740202445,1740202445.460618,-21600,,
com.google.Chrome,2,1740202442,1740202444,1740202444.6098661,-21600,,
com.microsoft.VSCode,39,1740202403,1740202442,1740202442.507502,-21600,,
com.google.Chrome,2,1740202401,1740202403,1740202403.595312,-21600,,
com.microsoft.VSCode,6,1740202395,1740202401,1740202401.261193,-21600,,
com.google.Chrome,0,1740202395,1740202395,1740202395.365388,-21600,,
com.microsoft.VSCode,5,1740202390,1740202395,1740202395.087626,-21600,,
com.google.Chrome,2,1740202388,1740202390,1740202390.233134,-21600,,
com.microsoft.VSCode,2,1740202386,1740202388,1740202389.011499,-21600,,
com.google.Chrome,2,1740202384,1740202386,1740202386.3186069,-21600,,
com.microsoft.VSCode,1,1740202383,1740202384,1740202384.837731,-21600,,
com.google.Chrome,1,1740202382,1740202383,1740202383.787479,-21600,,
com.microsoft.VSCode,4,1740202378,1740202382,1740202382.27428,-21600,,
com.google.Chrome,43,1740202335,1740202378,1740202378.098192,-21600,,
com.apple.finder,10,1740202325,1740202335,1740202335.089375,-21600,,
com.electron.carta,4,1740202321,1740202325,1740202326.085779,-21600,,
com.apple.finder,23,1740202298,1740202321,1740202321.544012,-21600,,
com.google.Chrome,9,1740202289,1740202298,1740202298.083345,-21600,,
com.electron.carta,14,1740202275,1740202289,1740202289.177336,-21600,,
com.google.Chrome,16,1740202259,1740202275,1740202275.507009,-21600,,
com.electron.carta,9,1740202250,1740202259,1740202259.437001,-21600,,
com.jinzhenyu.ruler,4,1740202246,1740202250,1740202250.268169,-21600,,
com.electron.carta,2,1740202244,1740202246,1740202246.6812658,-21600,,
com.google.Chrome,11,1740202233,1740202244,1740202244.906299,-21600,,
com.jinzhenyu.ruler,11,1740202222,1740202233,1740202233.048617,-21600,,
com.electron.carta,2,1740202220,1740202222,1740202222.133739,-21600,,
com.jinzhenyu.ruler,3,1740202217,1740202220,1740202220.8026571,-21600,,
com.electron.carta,3,1740202214,1740202217,1740202217.574312,-21600,,
com.google.Chrome,4,1740202210,1740202214,1740202214.823931,-21600,,
com.electron.carta,4,1740202206,1740202210,1740202210.964256,-21600,,
com.google.Chrome,5,1740202201,1740202206,1740202206.757666,-21600,,
com.jinzhenyu.ruler,21,1740202180,1740202201,1740202201.7565908,-21600,,
com.electron.carta,52,1740202128,1740202180,1740202180.6538792,-21600,,
com.google.Chrome,3,1740202125,1740202128,1740202128.928615,-21600,,
com.jinzhenyu.ruler,2,1740202123,1740202125,1740202125.517112,-21600,,
com.electron.carta,21,1740202102,1740202123,1740202123.361331,-21600,,
com.jinzhenyu.ruler,2,1740202100,1740202102,1740202102.8480558,-21600,,
com.google.Chrome,12,1740202088,1740202100,1740202100.664688,-21600,,
com.electron.carta,3,1740202085,1740202088,1740202088.394625,-21600,,
com.google.Chrome,27,1740202058,1740202085,1740202085.450768,-21600,,
com.electron.carta,13,1740202045,1740202058,1740202058.873652,-21600,,
com.jinzhenyu.ruler,12,1740202033,1740202045,1740202045.921935,-21600,,
com.electron.carta,148,1740201885,1740202033,1740202033.7992702,-21600,,
com.jinzhenyu.ruler,4,1740201881,1740201885,1740201885.751645,-21600,,
com.electron.carta,2,1740201879,1740201881,1740201881.574985,-21600,,
com.apple.finder,6,1740201873,1740201879,1740201879.705813,-21600,,
com.electron.carta,11,1740201862,1740201873,1740201873.970697,-21600,,
com.jinzhenyu.ruler,1,1740201861,1740201862,1740201862.168114,-21600,,
com.electron.carta,6,1740201855,1740201861,1740201861.536279,-21600,,
com.apple.finder,3,1740201852,1740201855,1740201855.8805718,-21600,,
com.jinzhenyu.ruler,1,1740201851,1740201852,1740201852.7740731,-21600,,
com.electron.carta,5,1740201846,1740201851,1740201851.800171,-21600,,
com.jinzhenyu.ruler,1,1740201845,1740201846,1740201846.471823,-21600,,
com.electron.carta,0,1740201845,1740201845,1740201845.725356,-21600,,
com.jinzhenyu.ruler,1,1740201844,1740201845,1740201845.464042,-21600,,
com.electron.carta,1,1740201843,1740201844,1740201844.931068,-21600,,
com.apple.finder,31,1740201812,1740201843,1740201843.754963,-21600,,
com.electron.carta,2,1740201810,1740201812,1740201812.510849,-21600,,
com.google.Chrome,96,1740201714,1740201810,1740201810.403551,-21600,,
com.jinzhenyu.ruler,3,1740201711,1740201714,1740201714.509647,-21600,,
com.google.Chrome,2,1740201709,1740201711,1740201711.6261292,-21600,,
com.electron.carta,2,1740201707,1740201709,1740201709.674288,-21600,,
com.jinzhenyu.ruler,1,1740201706,1740201707,1740201707.1424232,-21600,,
com.electron.carta,2,1740201704,1740201706,1740201706.154041,-21600,,
com.google.Chrome,0,1740201704,1740201704,1740201704.429031,-21600,,
com.jinzhenyu.ruler,1,1740201703,1740201704,1740201704.126418,-21600,,
com.google.Chrome,7,1740201696,1740201703,1740201703.321307,-21600,,
com.jinzhenyu.ruler,24,1740201672,1740201696,1740201696.293226,-21600,,
com.electron.carta,69,1740201603,1740201672,1740201672.022316,-21600,,
com.jinzhenyu.ruler,3,1740201600,1740201603,1740201603.1141062,-21600,,
com.electron.carta,0,1740201600,1740201600,1740201600.618404,-21600,,
com.google.Chrome,30,1740201570,1740201600,1740201600.140627,-21600,,
com.electron.carta,2,1740201568,1740201570,1740201570.932366,-21600,,
com.jinzhenyu.ruler,10,1740201558,1740201568,1740201568.387477,-21600,,
com.electron.carta,42,1740201516,1740201558,1740201558.055359,-21600,,
com.google.Chrome,4,1740201512,1740201516,1740201516.8683472,-21600,,
com.electron.carta,13,1740201499,1740201512,1740201512.847577,-21600,,
com.jinzhenyu.ruler,3,1740201496,1740201499,1740201499.7780619,-21600,,
com.electron.carta,13,1740201483,1740201496,1740201496.92662,-21600,,
com.google.Chrome,15,1740201468,1740201483,1740201483.429024,-21600,,
com.apple.finder,1,1740201467,1740201468,1740201468.871064,-21600,,
com.google.Chrome,15,1740201452,1740201467,1740201467.5757651,-21600,,
com.jinzhenyu.ruler,24,1740201428,1740201452,1740201452.0527802,-21600,,
com.electron.carta,96,1740201332,1740201428,1740201428.685172,-21600,,
com.apple.finder,19,1740201313,1740201332,1740201333.007585,-21600,,
com.electron.carta,6,1740201307,1740201313,1740201313.4559078,-21600,,
com.apple.finder,17,1740201290,1740201307,1740201307.94382,-21600,,
com.electron.carta,123,1740201167,1740201290,1740201290.570756,-21600,,
com.apple.finder,4,1740201163,1740201167,1740201167.284558,-21600,,
com.electron.carta,12,1740201151,1740201163,1740201163.608511,-21600,,
com.apple.finder,19,1740201132,1740201151,1740201151.09408,-21600,,
com.apple.Music,35,1740201097,1740201132,1740201132.524564,-21600,,
com.electron.carta,14,1740201083,1740201097,1740201097.774868,-21600,,
com.apple.finder,19,1740201064,1740201083,1740201083.1984901,-21600,,
com.google.Chrome,6,1740201058,1740201064,1740201064.868946,-21600,,
com.apple.finder,8,1740201050,1740201058,1740201058.645817,-21600,,
com.google.Chrome,42,1740201008,1740201050,1740201050.62257,-21600,,
com.electron.carta,97,1740200911,1740201008,1740201008.479176,-21600,,
com.apple.finder,4,1740200907,1740200911,1740200912.00981,-21600,,
com.electron.carta,9,1740200898,1740200907,1740200907.4150782,-21600,,
com.apple.finder,11,1740200887,1740200898,1740200898.730412,-21600,,
com.electron.carta,21,1740200866,1740200887,1740200887.336287,-21600,,
com.apple.finder,27,1740200839,1740200866,1740200866.441235,-21600,,
com.electron.carta,60,1740200779,1740200839,1740200839.979523,-21600,,
com.google.Chrome,41,1740200738,1740200779,1740200779.8860888,-21600,,
com.electron.carta,76,1740200662,1740200738,1740200738.435121,-21600,,
com.apple.finder,4,1740200658,1740200662,1740200662.6185021,-21600,,
com.electron.carta,17,1740200641,1740200658,1740200658.826758,-21600,,
com.apple.finder,55,1740200586,1740200641,1740200641.9593701,-21600,,
com.electron.carta,75,1740200511,1740200586,1740200586.364821,-21600,,
com.apple.finder,1,1740200510,1740200511,1740200511.902885,-21600,,
com.electron.carta,35,1740200475,1740200510,1740200510.376888,-21600,,
com.apple.finder,9,1740200466,1740200475,1740200475.782903,-21600,,
com.electron.carta,7,1740200459,1740200466,1740200466.217675,-21600,,
com.apple.finder,14,1740200445,1740200459,1740200459.5123491,-21600,,
com.electron.carta,6,1740200439,1740200445,1740200445.3882952,-21600,,
com.jinzhenyu.ruler,4,1740200435,1740200439,1740200439.498407,-21600,,
com.electron.carta,8,1740200427,1740200435,1740200435.83897,-21600,,
com.apple.finder,1,1740200426,1740200427,1740200427.484941,-21600,,
com.electron.carta,23,1740200403,1740200426,1740200426.50695,-21600,,
com.apple.finder,8,1740200395,1740200403,1740200403.249327,-21600,,
com.google.Chrome,22,1740200373,1740200395,1740200395.860807,-21600,,
com.electron.carta,1,1740200372,1740200373,1740200373.7445679,-21600,,
com.jinzhenyu.ruler,1,1740200371,1740200372,1740200372.655885,-21600,,
com.google.Chrome,12,1740200359,1740200371,1740200371.777997,-21600,,
com.jinzhenyu.ruler,7,1740200352,1740200359,1740200359.972955,-21600,,
com.electron.carta,1,1740200351,1740200352,1740200352.222517,-21600,,
com.google.Chrome,12,1740200339,1740200351,1740200351.572414,-21600,,
com.electron.carta,3,1740200336,1740200339,1740200340.049909,-21600,,
com.jinzhenyu.ruler,13,1740200323,1740200336,1740200336.9437919,-21600,,
com.electron.carta,68,1740200255,1740200323,1740200323.283238,-21600,,
com.jinzhenyu.ruler,4,1740200251,1740200255,1740200255.601062,-21600,,
com.electron.carta,5,1740200246,1740200251,1740200251.6979709,-21600,,
com.google.Chrome,10,1740200236,1740200246,1740200246.8830051,-21600,,
com.electron.carta,2,1740200234,1740200236,1740200236.487722,-21600,,
com.google.Chrome,11,1740200223,1740200234,1740200234.177012,-21600,,
com.electron.carta,7,1740200216,1740200223,1740200223.79005,-21600,,
com.jinzhenyu.ruler,3,1740200213,1740200216,1740200216.391561,-21600,,
com.electron.carta,1,1740200212,1740200213,1740200213.200376,-21600,,
com.jinzhenyu.ruler,3,1740200209,1740200212,1740200212.208571,-21600,,
com.electron.carta,57,1740200152,1740200209,1740200209.118266,-21600,,
com.google.Chrome,32,1740200120,1740200152,1740200152.582193,-21600,,
com.apple.finder,4,1740200116,1740200120,1740200120.5418758,-21600,,
com.google.Chrome,11,1740200105,1740200116,1740200116.619534,-21600,,
com.electron.carta,22,1740200083,1740200105,1740200105.246264,-21600,,
com.apple.finder,15,1740200068,1740200083,1740200083.593982,-21600,,
com.electron.carta,75,1740199993,1740200068,1740200068.4146051,-21600,,
com.apple.finder,71,1740199922,1740199993,1740199993.37638,-21600,,
com.jinzhenyu.ruler,4,1740199918,1740199922,1740199922.168994,-21600,,
com.apple.finder,3,1740199915,1740199918,1740199918.7350001,-21600,,
com.electron.carta,10,1740199905,1740199915,1740199915.335928,-21600,,
com.google.Chrome,74,1740199831,1740199905,1740199905.108869,-21600,,
com.jinzhenyu.ruler,20,1740199811,1740199831,1740199831.378865,-21600,,
com.google.Chrome,14,1740199797,1740199811,1740199811.2651858,-21600,,
com.jinzhenyu.ruler,33,1740199764,1740199797,1740199797.286333,-21600,,
com.electron.carta,72,1740199692,1740199764,1740199764.3623462,-21600,,
com.jinzhenyu.ruler,2,1740199690,1740199692,1740199692.871057,-21600,,
com.google.Chrome,27,1740199663,1740199690,1740199690.668019,-21600,,
com.jinzhenyu.ruler,22,1740199641,1740199663,1740199663.603487,-21600,,
com.google.Chrome,6,1740199635,1740199641,1740199641.5619678,-21600,,
com.jinzhenyu.ruler,11,1740199624,1740199635,1740199635.640352,-21600,,
com.electron.carta,5,1740199619,1740199624,1740199624.9626231,-21600,,
com.jinzhenyu.ruler,27,1740199592,1740199619,1740199619.169108,-21600,,
com.electron.carta,80,1740199512,1740199592,1740199592.98437,-21600,,
com.google.Chrome,21,1740199491,1740199512,1740199513.066622,-21600,,
com.electron.carta,32,1740199459,1740199491,1740199491.4604611,-21600,,
com.google.Chrome,6,1740199453,1740199459,1740199459.507973,-21600,,
com.electron.carta,24,1740199429,1740199453,1740199453.1879768,-21600,,
com.google.Chrome,6,1740199423,1740199429,1740199429.6445389,-21600,,
com.apple.finder,4,1740199419,1740199423,1740199423.590351,-21600,,
com.google.Chrome,7,1740199412,1740199419,1740199419.0740929,-21600,,
com.electron.carta,6,1740199406,1740199412,1740199412.879298,-21600,,
com.google.Chrome,5,1740199401,1740199406,1740199406.8153272,-21600,,
com.apple.finder,31,1740199370,1740199401,1740199401.54387,-21600,,
com.electron.carta,99,1740199271,1740199370,1740199370.024684,-21600,,
com.apple.finder,1,1740199270,1740199271,1740199271.644211,-21600,,
com.electron.carta,12,1740199258,1740199270,1740199270.033221,-21600,,
com.apple.finder,1,1740199257,1740199258,1740199258.169388,-21600,,
com.electron.carta,12,1740199245,1740199257,1740199257.106872,-21600,,
com.apple.finder,44,1740199201,1740199245,1740199245.5422149,-21600,,
com.electron.carta,29,1740199172,1740199201,1740199201.853714,-21600,,
com.google.Chrome,1,1740199171,1740199172,1740199172.141109,-21600,,
com.electron.carta,3,1740199168,1740199171,1740199171.1451359,-21600,,
com.google.Chrome,17,1740199151,1740199168,1740199168.978003,-21600,,
com.apple.Music,87,1740199064,1740199151,1740199151.927765,-21600,,
com.apple.Music,676,1740197319,1740197995,1740197995.165024,-21600,,
com.apple.news,125,1740197140,1740197265,1740197266.134033,-21600,EB445137-D7F5-57EC-87DA-1DB460D64046,"iPhone13,2"
com.apple.news,2,1740196411,1740196413,1740196413.7267241,-21600,EB445137-D7F5-57EC-87DA-1DB460D64046,"iPhone13,2"
com.apple.news,131,1740195068,1740195199,1740195199.853942,-21600,EB445137-D7F5-57EC-87DA-1DB460D64046,"iPhone13,2"
com.apple.news,3,1740195022,1740195025,1740195025.152777,-21600,EB445137-D7F5-57EC-87DA-1DB460D64046,"iPhone13,2"
com.apple.Music,417,1740194555,1740194972,1740194972.282429,-21600,,
com.google.Chrome,176,1740194379,1740194555,1740194555.939845,-21600,,
com.apple.Music,190,1740194189,1740194379,1740194379.277481,-21600,,
com.apple.systempreferences,8,1740194181,1740194189,1740194189.915556,-21600,,
com.apple.Music,152,1740194023,1740194175,1740194175.155458,-21600,,
com.google.Chrome,6,1740194017,1740194023,1740194023.821733,-21600,,
com.apple.news,397,1740193447,1740193844,1740193845.117756,-21600,EB445137-D7F5-57EC-87DA-1DB460D64046,"iPhone13,2"
com.instructure.icanvas,3,1740193427,1740193430,1740193430.8440151,-21600,EB445137-D7F5-57EC-87DA-1DB460D64046,"iPhone13,2"
com.instructure.icanvas,3,1740193420,1740193423,1740193423.6053162,-21600,EB445137-D7F5-57EC-87DA-1DB460D64046,"iPhone13,2"
com.instructure.icanvas,82,1740193332,1740193414,1740193414.187705,-21600,EB445137-D7F5-57EC-87DA-1DB460D64046,"iPhone13,2"
com.instructure.icanvas,1,1740190026,1740190027,1740190028.203496,-21600,EB445137-D7F5-57EC-87DA-1DB460D64046,"iPhone13,2"
com.instructure.icanvas,15,1740189855,1740189870,1740189873.041877,-21600,EB445137-D7F5-57EC-87DA-1DB460D64046,"iPhone13,2"
com.microsoft.Office.Outlook,0,1740189855,1740189855,1740189856.364563,-21600,EB445137-D7F5-57EC-87DA-1DB460D64046,"iPhone13,2"
com.microsoft.Office.Outlook,60,1740189786,1740189846,1740189846.8141952,-21600,EB445137-D7F5-57EC-87DA-1DB460D64046,"iPhone13,2"
com.apple.calculator,3,1740189782,1740189785,1740189785.2190819,-21600,EB445137-D7F5-57EC-87DA-1DB460D64046,"iPhone13,2"
com.apple.calculator,9,1740189653,1740189662,1740189663.0245209,-21600,EB445137-D7F5-57EC-87DA-1DB460D64046,"iPhone13,2"
com.myfitnesspal.mfp,140,1740188762,1740188902,1740188902.816269,-21600,EB445137-D7F5-57EC-87DA-1DB460D64046,"iPhone13,2"
com.myfitnesspal.mfp,3,1740184506,1740184509,1740184510.179877,-21600,EB445137-D7F5-57EC-87DA-1DB460D64046,"iPhone13,2"
com.myfitnesspal.mfp,16,1740183598,1740183614,1740183614.128543,-21600,EB445137-D7F5-57EC-87DA-1DB460D64046,"iPhone13,2"
com.myfitnesspal.mfp,37,1740183527,1740183564,1740183565.0175018,-21600,EB445137-D7F5-57EC-87DA-1DB460D64046,"iPhone13,2"
com.myfitnesspal.mfp,14,1740183274,1740183288,1740183288.530326,-21600,EB445137-D7F5-57EC-87DA-1DB460D64046,"iPhone13,2"
com.google.chrome.ios,5,1740183269,1740183274,1740183274.2100239,-21600,EB445137-D7F5-57EC-87DA-1DB460D64046,"iPhone13,2"
com.google.chrome.ios,149,1740183032,1740183181,1740183181.498692,-21600,EB445137-D7F5-57EC-87DA-1DB460D64046,"iPhone13,2"
com.myfitnesspal.mfp,35,1740182997,1740183032,1740183032.6604838,-21600,EB445137-D7F5-57EC-87DA-1DB460D64046,"iPhone13,2"
com.apple.MobileSMS,2,1740182995,1740182997,1740182997.402762,-21600,EB445137-D7F5-57EC-87DA-1DB460D64046,"iPhone13,2"
com.apple.MobileSMS,26,1740180806,1740180832,1740180832.7627,-21600,EB445137-D7F5-57EC-87DA-1DB460D64046,"iPhone13,2"
com.google.Maps,43,1740180763,1740180806,1740180806.89872,-21600,EB445137-D7F5-57EC-87DA-1DB460D64046,"iPhone13,2"
com.apple.MobileSMS,13,1740180750,1740180763,1740180763.734379,-21600,EB445137-D7F5-57EC-87DA-1DB460D64046,"iPhone13,2"
com.google.chrome.ios,0,1740180750,1740180750,1740180751.1607652,-21600,EB445137-D7F5-57EC-87DA-1DB460D64046,"iPhone13,2"
com.google.chrome.ios,44,1740179220,1740179264,1740179265.0360851,-21600,EB445137-D7F5-57EC-87DA-1DB460D64046,"iPhone13,2"
com.apple.mobilenotes,2,1740179218,1740179220,1740179220.3421931,-21600,EB445137-D7F5-57EC-87DA-1DB460D64046,"iPhone13,2"
com.apple.mobilenotes,7,1740178971,1740178978,1740178978.96166,-21600,EB445137-D7F5-57EC-87DA-1DB460D64046,"iPhone13,2"
com.instructure.icanvas,3,1740178888,1740178891,1740178891.769205,-21600,EB445137-D7F5-57EC-87DA-1DB460D64046,"iPhone13,2"
com.instructure.icanvas,31,1740178347,1740178378,1740178379.088739,-21600,EB445137-D7F5-57EC-87DA-1DB460D64046,"iPhone13,2"
com.apple.mobilenotes,1,1740178346,1740178347,1740178347.398425,-21600,EB445137-D7F5-57EC-87DA-1DB460D64046,"iPhone13,2"
com.apple.mobilenotes,15,1740177972,1740177987,1740177987.535945,-21600,EB445137-D7F5-57EC-87DA-1DB460D64046,"iPhone13,2"
com.apple.mobilenotes,18,1740177882,1740177900,1740177900.826786,-21600,EB445137-D7F5-57EC-87DA-1DB460D64046,"iPhone13,2"
com.microsoft.Office.Outlook,0,1740177882,1740177882,1740177882.861064,-21600,EB445137-D7F5-57EC-87DA-1DB460D64046,"iPhone13,2"
com.microsoft.Office.Outlook,1,1740177880,1740177881,1740177881.8138351,-21600,EB445137-D7F5-57EC-87DA-1DB460D64046,"iPhone13,2"
com.microsoft.Office.Outlook,8,1740177852,1740177860,1740177860.8725328,-21600,EB445137-D7F5-57EC-87DA-1DB460D64046,"iPhone13,2"
com.groupme.iphone-app,4,1740177840,1740177844,1740177844.362102,-21600,EB445137-D7F5-57EC-87DA-1DB460D64046,"iPhone13,2"
com.amazon.Amazon,0,1740177840,1740177840,1740177841.425297,-21600,EB445137-D7F5-57EC-87DA-1DB460D64046,"iPhone13,2"
com.amazon.Amazon,35,1740176487,1740176522,1740176522.755907,-21600,EB445137-D7F5-57EC-87DA-1DB460D64046,"iPhone13,2"
com.amazon.Amazon,3,1740176480,1740176483,1740176483.206917,-21600,EB445137-D7F5-57EC-87DA-1DB460D64046,"iPhone13,2"
com.amazon.Amazon,31,1740176352,1740176383,1740176383.6681361,-21600,EB445137-D7F5-57EC-87DA-1DB460D64046,"iPhone13,2"
Astrospheric.Astrospheric,17,1740171904,1740171921,1740171921.595391,-21600,EB445137-D7F5-57EC-87DA-1DB460D64046,"iPhone13,2"
com.apple.weather,12,1740171892,1740171904,1740171904.1547232,-21600,EB445137-D7F5-57EC-87DA-1DB460D64046,"iPhone13,2"
com.apple.weather,3,1740171880,1740171883,1740171883.412705,-21600,EB445137-D7F5-57EC-87DA-1DB460D64046,"iPhone13,2"
com.apple.weather,10,1740171616,1740171626,1740171626.179652,-21600,EB445137-D7F5-57EC-87DA-1DB460D64046,"iPhone13,2"
com.apple.MobileSMS,4,1740171533,1740171537,1740171537.3980021,-21600,EB445137-D7F5-57EC-87DA-1DB460D64046,"iPhone13,2"
com.apple.MobileSMS,8,1740171465,1740171473,1740171473.8157349,-21600,EB445137-D7F5-57EC-87DA-1DB460D64046,"iPhone13,2"
com.groupme.iphone-app,0,1740171465,1740171465,1740171465.925003,-21600,EB445137-D7F5-57EC-87DA-1DB460D64046,"iPhone13,2"
com.groupme.iphone-app,24,1740171440,1740171464,1740171464.908191,-21600,EB445137-D7F5-57EC-87DA-1DB460D64046,"iPhone13,2"
com.groupme.iphone-app,10,1740171414,1740171424,1740171425.025488,-21600,EB445137-D7F5-57EC-87DA-1DB460D64046,"iPhone13,2"
com.apple.MobileSMS,1,1740171413,1740171414,1740171414.749515,-21600,EB445137-D7F5-57EC-87DA-1DB460D64046,"iPhone13,2"
com.apple.MobileSMS,8,1740169399,1740169407,1740169407.816683,-21600,EB445137-D7F5-57EC-87DA-1DB460D64046,"iPhone13,2"
com.microsoft.Office.Outlook,0,1740169399,1740169399,1740169399.729064,-21600,EB445137-D7F5-57EC-87DA-1DB460D64046,"iPhone13,2"
com.microsoft.Office.Outlook,14,1740167881,1740167895,1740167895.788783,-21600,EB445137-D7F5-57EC-87DA-1DB460D64046,"iPhone13,2"
com.amazon.Amazon,2,1740167866,1740167868,1740167868.312406,-21600,EB445137-D7F5-57EC-87DA-1DB460D64046,"iPhone13,2"
com.google.Chrome,884,1740165226,1740166110,1740166110.645792,-21600,,
com.apple.iCal,1,1740165225,1740165226,1740165226.6032782,-21600,,
com.apple.MobileSMS,52,1740165173,1740165225,1740165225.060925,-21600,,
com.apple.iCal,3,1740165170,1740165173,1740165173.741153,-21600,,
com.apple.MobileSMS,1,1740165169,1740165170,1740165170.041744,-21600,,
com.apple.iCal,5,1740165164,1740165169,1740165169.590043,-21600,,
com.apple.MobileSMS,110,1740165054,1740165164,1740165164.811991,-21600,,
com.amazon.Amazon,7,1740164996,1740165003,1740165003.784204,-21600,EB445137-D7F5-57EC-87DA-1DB460D64046,"iPhone13,2"
com.apple.measure,1,1740164969,1740164970,1740164971.280083,-21600,EB445137-D7F5-57EC-87DA-1DB460D64046,"iPhone13,2"
com.google.Chrome,483,1740164571,1740165054,1740165054.246042,-21600,,
com.apple.MobileSMS,30,1740164541,1740164571,1740164571.067071,-21600,,
com.google.Chrome,2,1740164539,1740164541,1740164541.556304,-21600,,
com.apple.MobileSMS,99,1740164440,1740164539,1740164539.347472,-21600,,
com.google.Chrome,197,1740164243,1740164440,1740164440.6464992,-21600,,
com.apple.Maps,1,1740164242,1740164243,1740164243.357555,-21600,,
com.google.Chrome,123,1740164119,1740164242,1740164242.9654999,-21600,,
com.apple.Maps,42,1740164077,1740164119,1740164119.537737,-21600,,
com.google.Chrome,82,1740163995,1740164077,1740164077.9073281,-21600,,
com.apple.Maps,49,1740163946,1740163995,1740163995.801686,-21600,,
com.google.Chrome,204,1740163742,1740163946,1740163946.6574678,-21600,,
com.apple.measure,54,1740163438,1740163492,1740163492.4887,-21600,EB445137-D7F5-57EC-87DA-1DB460D64046,"iPhone13,2"
com.apple.mobilephone,10,1740163427,1740163437,1740163437.7142758,-21600,EB445137-D7F5-57EC-87DA-1DB460D64046,"iPhone13,2"
com.google.Chrome,842,1740162329,1740163171,1740163171.134488,-21600,,
com.apple.Maps,2,1740162327,1740162329,1740162329.065582,-21600,,
com.google.Chrome,1,1740162326,1740162327,1740162327.244749,-21600,,
com.apple.Maps,1,1740162324,1740162325,1740162325.679295,-21600,,
com.apple.systempreferences,1,1740162323,1740162324,1740162324.772337,-21600,,
com.apple.Maps,2,1740162321,1740162323,1740162323.41078,-21600,,
com.apple.systempreferences,0,1740162320,1740162320,1740162320.841049,-21600,,
com.google.Chrome,427,1740161893,1740162320,1740162320.405188,-21600,,
com.apple.Maps,2,1740161891,1740161893,1740161893.547162,-21600,,
com.google.Chrome,53,1740161838,1740161891,1740161891.885083,-21600,,
com.apple.Maps,29,1740161809,1740161838,1740161838.146871,-21600,,
com.apple.finder,9,1740161800,1740161809,1740161813.726121,-21600,,
com.apple.mobilephone,6,1740161380,1740161386,1740161386.9656482,-21600,EB445137-D7F5-57EC-87DA-1DB460D64046,"iPhone13,2"
com.apple.InCallService,0,1740161380,1740161380,1740161380.873388,-21600,EB445137-D7F5-57EC-87DA-1DB460D64046,"iPhone13,2"
com.apple.InCallService,2,1740160331,1740160333,1740160333.830245,-21600,EB445137-D7F5-57EC-87DA-1DB460D64046,"iPhone13,2"
com.apple.mobilephone,12,1740160319,1740160331,1740160331.5684118,-21600,EB445137-D7F5-57EC-87DA-1DB460D64046,"iPhone13,2"
com.apple.findmy,13,1740160306,1740160319,1740160319.564147,-21600,EB445137-D7F5-57EC-87DA-1DB460D64046,"iPhone13,2"
com.apple.finder,1,1740155703,1740155704,1740155704.656389,-21600,,
com.apple.Notes,1,1740155702,1740155703,1740155703.456557,-21600,,
com.myfitnesspal.mfp,96,1740155499,1740155595,1740155595.5974069,-21600,EB445137-D7F5-57EC-87DA-1DB460D64046,"iPhone13,2"
com.apple.mobileslideshow,7,1740155492,1740155499,1740155499.484117,-21600,EB445137-D7F5-57EC-87DA-1DB460D64046,"iPhone13,2"
com.google.Chrome,246,1740155456,1740155702,1740155702.6554499,-21600,,
com.apple.Notes,65,1740155391,1740155456,1740155456.751864,-21600,,
com.apple.finder,0,1740155391,1740155391,1740155392.006318,-21600,,
com.apple.Notes,1,1740155390,1740155391,1740155391.202029,-21600,,
com.apple.finder,1,1740155389,1740155390,1740155390.889035,-21600,,
com.apple.mobileslideshow,65,1740155264,1740155329,1740155329.909003,-21600,EB445137-D7F5-57EC-87DA-1DB460D64046,"iPhone13,2"
com.apple.Notes,187,1740155202,1740155389,1740155389.189295,-21600,,
com.apple.finder,1,1740155201,1740155202,1740155202.808045,-21600,,
com.google.Chrome,4,1740155197,1740155201,1740155201.447614,-21600,,
com.apple.finder,6,1740155191,1740155197,1740155197.723124,-21600,,
com.apple.Health,27,1740155143,1740155170,1740155170.183615,-21600,EB445137-D7F5-57EC-87DA-1DB460D64046,"iPhone13,2"
com.microsoft.Office.Outlook,15,1740155125,1740155140,1740155140.79762,-21600,EB445137-D7F5-57EC-87DA-1DB460D64046,"iPhone13,2"
com.apple.finder,282,1740154890,1740155172,1740155172.855187,-21600,,
com.google.android.studio,5,1740154885,1740154890,1740154890.531194,-21600,,
com.google.Chrome,176,1740154709,1740154885,1740154885.383616,-21600,,
com.apple.AppStore,6,1740154703,1740154709,1740154709.177981,-21600,,
com.google.Chrome,27,1740154676,1740154703,1740154703.609459,-21600,,
com.apple.calculator,1,1740154622,1740154623,1740154623.7175531,-21600,,
com.microsoft.onenote.mac,20,1740154602,1740154622,1740154622.162399,-21600,,
com.apple.calculator,9,1740154593,1740154602,1740154602.4815931,-21600,,
com.microsoft.onenote.mac,2,1740154591,1740154593,1740154593.109103,-21600,,
com.google.Chrome,0,1740154591,1740154591,1740154591.880764,-21600,,
com.microsoft.onenote.mac,3,1740154588,1740154591,1740154591.3256679,-21600,,
com.apple.calculator,6,1740154582,1740154588,1740154588.7553701,-21600,,
com.microsoft.onenote.mac,2,1740154580,1740154582,1740154582.465077,-21600,,
com.google.Chrome,1,1740154579,1740154580,1740154580.337861,-21600,,
com.microsoft.onenote.mac,8,1740154571,1740154579,1740154579.912014,-21600,,
com.google.Chrome,0,1740154571,1740154571,1740154571.722518,-21600,,
com.microsoft.onenote.mac,19,1740154552,1740154571,1740154571.199224,-21600,,
com.google.Chrome,1,1740154551,1740154552,1740154552.496772,-21600,,
com.microsoft.onenote.mac,56,1740154495,1740154551,1740154551.4553208,-21600,,
com.google.Chrome,66,1740154429,1740154495,1740154495.901352,-21600,,
com.microsoft.onenote.mac,5,1740154359,1740154364,1740154364.2841148,-21600,,
com.apple.calculator,9,1740154350,1740154359,1740154359.323009,-21600,,
com.microsoft.onenote.mac,10,1740154340,1740154350,1740154350.249308,-21600,,
com.apple.calculator,7,1740154333,1740154340,1740154340.275109,-21600,,
com.microsoft.onenote.mac,2,1740154331,1740154333,1740154333.679453,-21600,,
com.google.Chrome,3,1740154328,1740154331,1740154331.481967,-21600,,
com.microsoft.onenote.mac,2,1740154326,1740154328,1740154328.6062489,-21600,,
com.google.Chrome,3,1740154323,1740154326,1740154326.0524368,-21600,,
com.microsoft.onenote.mac,13,1740154310,1740154323,1740154323.232164,-21600,,
com.google.Chrome,1,1740154309,1740154310,1740154310.610767,-21600,,
com.microsoft.onenote.mac,5,1740154304,1740154309,1740154309.7284079,-21600,,
com.google.Chrome,2,1740154302,1740154304,1740154304.872213,-21600,,
com.microsoft.onenote.mac,1,1740154301,1740154302,1740154302.791723,-21600,,
com.google.Chrome,5,1740154296,1740154301,1740154302.060701,-21600,,
com.microsoft.onenote.mac,3,1740154293,1740154296,1740154296.109484,-21600,,
com.google.Chrome,19,1740154274,1740154293,1740154293.454375,-21600,,
com.microsoft.onenote.mac,81,1740154173,1740154254,1740154255.528964,-21600,,
com.ryansponzilli.DeepSkyCatalog,56,1740154118,1740154174,1740154174.8293,-21600,EB445137-D7F5-57EC-87DA-1DB460D64046,"iPhone13,2"
com.apple.weather,2,1740154116,1740154118,1740154118.401764,-21600,EB445137-D7F5-57EC-87DA-1DB460D64046,"iPhone13,2"
com.google.android.studio,118,1740154055,1740154173,1740154173.18511,-21600,,
com.google.Chrome,6,1740153991,1740153997,1740153997.2003322,-21600,,
com.apple.finder,115,1740153876,1740153991,1740153991.758357,-21600,,
com.leomehlig.today,43,1740153833,1740153876,1740153876.122565,-21600,,
com.google.Chrome,27,1740153806,1740153833,1740153834.0221992,-21600,,
com.leomehlig.today,26,1740153780,1740153806,1740153807.2172198,-21600,,
com.apple.weather,42,1740153651,1740153693,1740153693.967616,-21600,EB445137-D7F5-57EC-87DA-1DB460D64046,"iPhone13,2"
com.apple.news,189,1740153461,1740153650,1740153650.13702,-21600,EB445137-D7F5-57EC-87DA-1DB460D64046,"iPhone13,2"
com.myfitnesspal.mfp,34,1740153409,1740153443,1740153443.2835789,-21600,EB445137-D7F5-57EC-87DA-1DB460D64046,"iPhone13,2"
com.amazon.Amazon,19,1740153345,1740153364,1740153364.159925,-21600,EB445137-D7F5-57EC-87DA-1DB460D64046,"iPhone13,2"
com.apple.CoreAuthUI,2,1740153317,1740153319,1740153319.180365,-21600,EB445137-D7F5-57EC-87DA-1DB460D64046,"iPhone13,2"
com.truebill.truebillnative,30,1740153314,1740153344,1740153344.0973248,-21600,EB445137-D7F5-57EC-87DA-1DB460D64046,"iPhone13,2"
com.apple.Health,15,1740153280,1740153295,1740153295.974266,-21600,EB445137-D7F5-57EC-87DA-1DB460D64046,"iPhone13,2"
com.instructure.icanvas,1,1740153277,1740153278,1740153278.884688,-21600,EB445137-D7F5-57EC-87DA-1DB460D64046,"iPhone13,2"
com.leomehlig.today,310,1740153234,1740153544,1740153544.0256329,-21600,,
com.instructure.icanvas,18,1740153154,1740153172,1740153172.711296,-21600,EB445137-D7F5-57EC-87DA-1DB460D64046,"iPhone13,2"
com.apple.measure,1,1740153153,1740153154,1740153154.841105,-21600,EB445137-D7F5-57EC-87DA-1DB460D64046,"iPhone13,2"
com.google.Chrome,238,1740152996,1740153234,1740153234.488173,-21600,,
com.apple.Preview,754,1740152242,1740152996,1740152997.00604,-21600,,
com.google.Chrome,6,1740152236,1740152242,1740152242.659254,-21600,,
com.apple.Preview,4,1740152232,1740152236,1740152236.528473,-21600,,
com.google.Chrome,5,1740152227,1740152232,1740152232.91594,-21600,,
com.apple.Preview,1425,1740150802,1740152227,1740152227.972758,-21600,,
com.google.Chrome,16,1740150786,1740150802,1740150802.393975,-21600,,
com.apple.Preview,436,1740150350,1740150786,1740150786.530721,-21600,,
com.apple.finder,7,1740150343,1740150350,1740150350.49755,-21600,,
com.apple.Preview,5,1740150338,1740150343,1740150343.666544,-21600,,
com.apple.finder,11,1740150327,1740150338,1740150338.809527,-21600,,
com.google.Chrome,2,1740150325,1740150327,1740150327.9747381,-21600,,
com.leomehlig.today,0,1740150325,1740150325,1740150325.819128,-21600,,
com.google.Chrome,175,1740150150,1740150325,1740150325.4834461,-21600,,
com.leomehlig.today,8,1740150142,1740150150,1740150150.685834,-21600,,
com.microsoft.Word,7,1740150132,1740150139,1740150139.803199,-21600,,
com.leomehlig.today,1,1740150131,1740150132,1740150132.595292,-21600,,
com.google.Chrome,2,1740150129,1740150131,1740150131.367898,-21600,,
com.apple.measure,86,1740149952,1740150038,1740150038.9556751,-21600,EB445137-D7F5-57EC-87DA-1DB460D64046,"iPhone13,2"
com.apple.Health,2,1740149940,1740149942,1740149942.634651,-21600,EB445137-D7F5-57EC-87DA-1DB460D64046,"iPhone13,2"
com.apple.Health,23,1740148403,1740148426,1740148426.1246371,-21600,EB445137-D7F5-57EC-87DA-1DB460D64046,"iPhone13,2"
com.renpho.health,36,1740148367,1740148403,1740148403.6522,-21600,EB445137-D7F5-57EC-87DA-1DB460D64046,"iPhone13,2"
com.apple.mobiletimer,2,1740148363,1740148365,1740148365.0805259,-21600,EB445137-D7F5-57EC-87DA-1DB460D64046,"iPhone13,2"
com.apple.mobiletimer,11,1740147448,1740147459,1740147459.994429,-21600,EB445137-D7F5-57EC-87DA-1DB460D64046,"iPhone13,2"
com.google.Chrome,338,1740116913,1740117251,1740117252.582401,-21600,,
com.apple.finder,8,1740116905,1740116913,1740116913.927881,-21600,,
com.leomehlig.today,85,1740116820,1740116905,1740116905.949688,-21600,,
com.apple.finder,2,1740116818,1740116820,1740116820.223705,-21600,,
com.apple.Preview,0,1740116818,1740116818,1740116818.520505,-21600,,
com.apple.finder,1,1740116817,1740116818,1740116818.3531141,-21600,,
com.microsoft.Outlook,3,1740116814,1740116817,1740116817.284554,-21600,,
com.apple.finder,1,1740116813,1740116814,1740116814.798131,-21600,,
com.microsoft.Word,6,1740116807,1740116813,1740116813.121846,-21600,,
com.google.Chrome,25,1740116782,1740116807,1740116807.868954,-21600,,
com.google.Chrome,672,1740115600,1740116272,1740116272.98984,-21600,,
com.microsoft.Word,40,1740115560,1740115600,1740115600.126607,-21600,,
com.apple.finder,4,1740115556,1740115560,1740115560.2692962,-21600,,
com.google.Chrome,403,1740115153,1740115556,1740115556.5190182,-21600,,
com.apple.finder,88,1740115065,1740115153,1740115153.535609,-21600,,
com.apple.Preview,10,1740115055,1740115065,1740115065.129523,-21600,,
com.apple.finder,3,1740115052,1740115055,1740115055.687801,-21600,,
com.apple.Photos,3,1740115049,1740115052,1740115052.80029,-21600,,
com.apple.mobileslideshow,27,1740114973,1740115000,1740115001.2257938,-21600,EB445137-D7F5-57EC-87DA-1DB460D64046,"iPhone13,2"
com.google.Chrome,104,1740114945,1740115049,1740115049.518836,-21600,,
com.microsoft.Outlook,27,1740114918,1740114945,1740114945.8297172,-21600,,
com.apple.Photos,39,1740114879,1740114918,1740114918.698884,-21600,,
com.apple.mobileslideshow,72,1740114790,1740114862,1740114862.1414099,-21600,EB445137-D7F5-57EC-87DA-1DB460D64046,"iPhone13,2"
com.groupme.iphone-app,6,1740114771,1740114777,1740114777.652166,-21600,EB445137-D7F5-57EC-87DA-1DB460D64046,"iPhone13,2"
com.apple.MobileSMS,0,1740114771,1740114771,1740114772.169129,-21600,EB445137-D7F5-57EC-87DA-1DB460D64046,"iPhone13,2"
com.microsoft.Outlook,219,1740114660,1740114879,1740114879.403864,-21600,,
com.apple.finder,64,1740114596,1740114660,1740114660.124435,-21600,,
com.apple.Photos,76,1740114520,1740114596,1740114596.480905,-21600,,
com.apple.finder,477,1740114043,1740114520,1740114520.8081322,-21600,,
com.apple.Notes,26,1740114017,1740114043,1740114043.641077,-21600,,
com.apple.finder,15,1740114002,1740114017,1740114017.281361,-21600,,
com.apple.Notes,35,1740113967,1740114002,1740114002.318789,-21600,,
com.apple.finder,21,1740113946,1740113967,1740113967.15836,-21600,,
com.google.Chrome,98,1740113848,1740113946,1740113946.499424,-21600,,
com.apple.finder,35,1740113813,1740113848,1740113848.7441878,-21600,,
com.google.Chrome,10,1740113803,1740113813,1740113813.4669042,-21600,,
com.apple.finder,10,1740113793,1740113803,1740113803.2375178,-21600,,
com.google.Chrome,32,1740113761,1740113793,1740113793.4417582,-21600,,
com.apple.finder,537,1740113224,1740113761,1740113761.321714,-21600,,
com.leomehlig.today,1,1740113223,1740113224,1740113224.792138,-21600,,
com.apple.dt.Xcode,54,1740113169,1740113223,1740113223.1907,-21600,,
com.leomehlig.today,1,1740113168,1740113169,1740113169.538991,-21600,,
com.google.Chrome,1,1740113167,1740113168,1740113168.183145,-21600,,
com.apple.finder,2,1740113165,1740113167,1740113167.413769,-21600,,
com.apple.dt.Xcode,16,1740113149,1740113165,1740113165.952135,-21600,,
com.apple.finder,201,1740112948,1740113149,1740113149.3661618,-21600,,
com.google.Chrome,6,1740112942,1740112948,1740112948.834206,-21600,,
com.apple.MobileSMS,6,1740112328,1740112334,1740112334.738785,-21600,EB445137-D7F5-57EC-87DA-1DB460D64046,"iPhone13,2"
com.groupme.iphone-app,1,1740112327,1740112328,1740112328.356734,-21600,EB445137-D7F5-57EC-87DA-1DB460D64046,"iPhone13,2"
com.groupme.iphone-app,5,1740112233,1740112238,1740112239.1177468,-21600,EB445137-D7F5-57EC-87DA-1DB460D64046,"iPhone13,2"
com.google.Chrome,218,1740112009,1740112227,1740112227.37434,-21600,,
com.apple.finder,5,1740112004,1740112009,1740112009.163311,-21600,,
com.apple.finder,315,1740110921,1740111236,1740111236.361174,-21600,,
com.google.Chrome,92,1740110829,1740110921,1740110921.892705,-21600,,
com.apple.finder,58,1740110771,1740110829,1740110829.0685039,-21600,,
com.google.Chrome,107,1740110664,1740110771,1740110771.409278,-21600,,
com.microsoft.VSCode,39,1740110625,1740110664,1740110664.81669,-21600,,
com.google.Chrome,145,1740110480,1740110625,1740110625.3847709,-21600,,
com.microsoft.VSCode,33,1740110447,1740110480,1740110480.267142,-21600,,
com.google.Chrome,1,1740110446,1740110447,1740110447.06567,-21600,,
com.microsoft.VSCode,7,1740110439,1740110446,1740110446.0764608,-21600,,
com.google.Chrome,1,1740110438,1740110439,1740110440.0507832,-21600,,
com.microsoft.VSCode,0,1740110438,1740110438,1740110438.806364,-21600,,
com.google.Chrome,20,1740110418,1740110438,1740110438.215409,-21600,,
com.microsoft.VSCode,97,1740110321,1740110418,1740110418.952013,-21600,,
com.google.Chrome,7,1740110314,1740110321,1740110321.535499,-21600,,
com.microsoft.VSCode,7,1740110307,1740110314,1740110314.4188108,-21600,,
com.apple.finder,95,1740110212,1740110307,1740110307.2405128,-21600,,
com.google.Chrome,145,1740110067,1740110212,1740110212.2264152,-21600,,
com.leomehlig.today,0,1740110067,1740110067,1740110067.9631019,-21600,,
com.google.Chrome,2,1740110065,1740110067,1740110067.19382,-21600,,
com.leomehlig.today,1,1740110064,1740110065,1740110065.614819,-21600,,
com.google.Chrome,109,1740109955,1740110064,1740110064.640971,-21600,,
com.leomehlig.today,5,1740109950,1740109955,1740109955.250457,-21600,,
com.google.Chrome,13,1740109937,1740109950,1740109950.8463721,-21600,,
com.leomehlig.today,14,1740109923,1740109937,1740109937.512597,-21600,,
com.google.Chrome,77,1740109846,1740109923,1740109923.341292,-21600,,
com.ryansponzilli.DeepSkyCatalog,2,1740105733,1740105735,1740105735.31258,-21600,EB445137-D7F5-57EC-87DA-1DB460D64046,"iPhone13,2"
com.google.Chrome,6,1740105628,1740105634,1740105634.10435,-21600,,
com.leomehlig.today,6,1740105622,1740105628,1740105628.707593,-21600,,
com.google.Chrome,3,1740105619,1740105622,1740105622.099458,-21600,,
com.microsoft.onenote.mac,11,1740105608,1740105619,1740105619.837739,-21600,,
com.google.Chrome,238,1740105370,1740105608,1740105608.428293,-21600,,
com.ryansponzilli.DeepSkyCatalog,577,1740104482,1740105059,1740105059.3144069,-21600,EB445137-D7F5-57EC-87DA-1DB460D64046,"iPhone13,2"
com.ryansponzilli.DeepSkyCatalog,156,1740104312,1740104468,1740104468.392312,-21600,EB445137-D7F5-57EC-87DA-1DB460D64046,"iPhone13,2"
com.apple.AppStore,1,1740104309,1740104310,1740104311.0119948,-21600,EB445137-D7F5-57EC-87DA-1DB460D64046,"iPhone13,2"
com.microsoft.onenote.mac,1355,1740104015,1740105370,1740105370.6171389,-21600,,
com.google.Chrome,8,1740104007,1740104015,1740104015.3553472,-21600,,
com.microsoft.onenote.mac,517,1740103490,1740104007,1740104007.7377028,-21600,,
com.google.Chrome,13,1740103477,1740103490,1740103490.452425,-21600,,
com.microsoft.onenote.mac,7,1740103470,1740103477,1740103477.2078671,-21600,,
com.google.Chrome,26,1740103444,1740103470,1740103470.7926931,-21600,,
com.microsoft.onenote.mac,63,1740103381,1740103444,1740103444.737311,-21600,,
com.google.Chrome,286,1740103095,1740103381,1740103381.193729,-21600,,
com.apple.finder,13,1740103082,1740103095,1740103095.9042659,-21600,,
com.apple.Preview,1,1740103081,1740103082,1740103082.971199,-21600,,
com.apple.finder,2,1740103079,1740103081,1740103081.977699,-21600,,
com.apple.dt.Xcode,5,1740103074,1740103079,1740103079.911663,-21600,,
com.apple.finder,37,1740103037,1740103074,1740103074.472702,-21600,,
com.apple.dt.Xcode,97,1740102940,1740103037,1740103037.7143831,-21600,,
com.apple.AppStore,97,1740102225,1740102322,1740102322.5139952,-21600,EB445137-D7F5-57EC-87DA-1DB460D64046,"iPhone13,2"
com.google.Gmail,2,1740102220,1740102222,1740102222.78191,-21600,EB445137-D7F5-57EC-87DA-1DB460D64046,"iPhone13,2"
com.google.Chrome,2007,1740100933,1740102940,1740102940.182584,-21600,,
com.apple.AppStore,14,1740100829,1740100843,1740100843.4648042,-21600,,
com.google.Chrome,1,1740100828,1740100829,1740100829.8667111,-21600,,
com.apple.AppStore,2,1740100826,1740100828,1740100828.4838881,-21600,,
com.google.Chrome,208,1740100618,1740100826,1740100827.004507,-21600,,
com.google.Gmail,8,1740100547,1740100555,1740100556.335834,-21600,EB445137-D7F5-57EC-87DA-1DB460D64046,"iPhone13,2"
com.amazon.Amazon,0,1740100547,1740100547,1740100548.641959,-21600,EB445137-D7F5-57EC-87DA-1DB460D64046,"iPhone13,2"
com.amazon.Amazon,6,1740100437,1740100443,1740100443.9651031,-21600,EB445137-D7F5-57EC-87DA-1DB460D64046,"iPhone13,2"
com.amazon.Amazon,7,1740100052,1740100059,1740100059.176491,-21600,EB445137-D7F5-57EC-87DA-1DB460D64046,"iPhone13,2"
com.amazon.Amazon,6,1740099449,1740099455,1740099455.514144,-21600,EB445137-D7F5-57EC-87DA-1DB460D64046,"iPhone13,2"
com.amazon.Amazon,10,1740099013,1740099023,1740099023.30421,-21600,EB445137-D7F5-57EC-87DA-1DB460D64046,"iPhone13,2"
com.amazon.Amazon,22,1740096846,1740096868,1740096868.1953301,-21600,EB445137-D7F5-57EC-87DA-1DB460D64046,"iPhone13,2"
com.apple.CoreAuthUI,2,1740096836,1740096838,1740096838.049972,-21600,EB445137-D7F5-57EC-87DA-1DB460D64046,"iPhone13,2"
com.truebill.truebillnative,11,1740096833,1740096844,1740096844.392202,-21600,EB445137-D7F5-57EC-87DA-1DB460D64046,"iPhone13,2"
com.google.chrome.ios,54,1740096757,1740096811,1740096812.116372,-21600,EB445137-D7F5-57EC-87DA-1DB460D64046,"iPhone13,2"
com.groupme.iphone-app,5,1740096752,1740096757,1740096757.910759,-21600,EB445137-D7F5-57EC-87DA-1DB460D64046,"iPhone13,2"
com.apple.mobileslideshow,77,1740096666,1740096743,1740096743.818328,-21600,EB445137-D7F5-57EC-87DA-1DB460D64046,"iPhone13,2"
com.apple.news,91,1740096516,1740096607,1740096607.455085,-21600,EB445137-D7F5-57EC-87DA-1DB460D64046,"iPhone13,2"
com.apple.news,131,1740096360,1740096491,1740096492.0594258,-21600,EB445137-D7F5-57EC-87DA-1DB460D64046,"iPhone13,2"
com.apple.news,4,1740096350,1740096354,1740096355.62179,-21600,EB445137-D7F5-57EC-87DA-1DB460D64046,"iPhone13,2"
com.tinyspeck.chatlyio,14,1740096331,1740096345,1740096345.53714,-21600,EB445137-D7F5-57EC-87DA-1DB460D64046,"iPhone13,2"
com.myfitnesspal.mfp,1,1740096330,1740096331,1740096331.450928,-21600,EB445137-D7F5-57EC-87DA-1DB460D64046,"iPhone13,2"
com.google.Chrome,345,1740096177,1740096522,1740096522.103148,-21600,,
com.apple.AppStore,4,1740096173,1740096177,1740096177.550473,-21600,,
com.google.Chrome,753,1740095420,1740096173,1740096173.280565,-21600,,
com.leomehlig.today,34,1740095386,1740095420,1740095420.162033,-21600,,
com.google.Chrome,252,1740095134,1740095386,1740095386.494246,-21600,,
com.apple.Preview,2,1740095132,1740095134,1740095134.8857698,-21600,,
com.google.Chrome,60,1740095072,1740095132,1740095132.2451138,-21600,,
com.apple.Preview,281,1740094791,1740095072,1740095072.6944032,-21600,,
com.apple.finder,12,1740094779,1740094791,1740094791.1834369,-21600,,
com.google.Chrome,173,1740094606,1740094779,1740094779.6481519,-21600,,
com.leomehlig.today,2,1740094604,1740094606,1740094606.622661,-21600,,
com.google.Chrome,62,1740094542,1740094604,1740094604.238409,-21600,,
com.apple.finder,3,1740094539,1740094542,1740094542.286059,-21600,,
com.myfitnesspal.mfp,30,1740094496,1740094526,1740094526.2512112,-21600,EB445137-D7F5-57EC-87DA-1DB460D64046,"iPhone13,2"
com.myfitnesspal.mfp,19,1740094477,1740094496,1740094496.3291001,-21600,EB445137-D7F5-57EC-87DA-1DB460D64046,"iPhone13,2"
com.apple.mobilenotes,2,1740094475,1740094477,1740094477.6685228,-21600,EB445137-D7F5-57EC-87DA-1DB460D64046,"iPhone13,2"
com.apple.mobilenotes,84,1740094110,1740094194,1740094194.928918,-21600,EB445137-D7F5-57EC-87DA-1DB460D64046,"iPhone13,2"
com.myfitnesspal.mfp,25,1740094085,1740094110,1740094111.389916,-21600,EB445137-D7F5-57EC-87DA-1DB460D64046,"iPhone13,2"
com.myfitnesspal.mfp,24,1740094058,1740094082,1740094082.786885,-21600,EB445137-D7F5-57EC-87DA-1DB460D64046,"iPhone13,2"
com.amazon.Amazon,2,1740094053,1740094055,1740094055.42852,-21600,EB445137-D7F5-57EC-87DA-1DB460D64046,"iPhone13,2"
com.apple.finder,1,1740093979,1740093980,1740093980.5370998,-21600,,
com.leomehlig.today,2,1740093977,1740093979,1740093979.277567,-21600,,
com.apple.finder,5,1740093972,1740093977,1740093977.2484279,-21600,,
com.leomehlig.today,6,1740093966,1740093972,1740093972.076968,-21600,,
com.apple.finder,1,1740093965,1740093966,1740093966.662658,-21600,,
com.apple.FaceTime,6,1740093959,1740093965,1740093966.109442,-21600,,
com.amazon.Amazon,8,1740093888,1740093896,1740093896.8455691,-21600,EB445137-D7F5-57EC-87DA-1DB460D64046,"iPhone13,2"
com.myfitnesspal.mfp,1,1740093880,1740093881,1740093881.7787108,-21600,EB445137-D7F5-57EC-87DA-1DB460D64046,"iPhone13,2"
com.apple.finder,117,1740093842,1740093959,1740093959.525254,-21600,,
com.apple.FaceTime,2,1740093739,1740093741,1740093741.706053,-21600,,
com.leomehlig.today,2,1740093737,1740093739,1740093739.430141,-21600,,
com.apple.finder,2,1740093735,1740093737,1740093737.924331,-21600,,
com.leomehlig.today,15,1740093720,1740093735,1740093735.508935,-21600,,
com.apple.finder,4,1740093716,1740093720,1740093720.881846,-21600,,
com.leomehlig.today,89,1740093627,1740093716,1740093717.022044,-21600,,
com.google.Chrome,88,1740093539,1740093627,1740093627.2336369,-21600,,
com.apple.finder,2,1740093537,1740093539,1740093539.121183,-21600,,
com.apple.Passwords,2,1740093535,1740093537,1740093537.271968,-21600,,
com.apple.finder,173,1740093362,1740093535,1740093535.4450831,-21600,,
com.google.Chrome,160,1740093202,1740093362,1740093362.725535,-21600,,
com.apple.weather,106,1740093096,1740093202,1740093202.139606,-21600,,
com.google.Chrome,7,1740093089,1740093096,1740093096.903808,-21600,,
com.google.Chrome,370,1740092687,1740093057,1740093057.520835,-21600,,
com.apple.FaceTime,1,1740092669,1740092670,1740092671.346497,-21600,,
com.apple.FaceTime,308,1740092360,1740092668,1740092668.8672318,-21600,,
com.apple.MobileSMS,12,1740092348,1740092360,1740092360.5135531,-21600,,
com.google.Chrome,24,1740092324,1740092348,1740092348.251151,-21600,,
com.myfitnesspal.mfp,81,1740092156,1740092237,1740092237.53246,-21600,EB445137-D7F5-57EC-87DA-1DB460D64046,"iPhone13,2"
com.google.Chrome,24,1740091877,1740091901,1740091901.336319,-21600,,
com.microsoft.Office.Outlook,36,1740091765,1740091801,1740091801.05449,-21600,EB445137-D7F5-57EC-87DA-1DB460D64046,"iPhone13,2"
com.amazon.Amazon,9,1740091755,1740091764,1740091764.73141,-21600,EB445137-D7F5-57EC-87DA-1DB460D64046,"iPhone13,2"
com.apple.findmy,8,1740091725,1740091733,1740091733.718237,-21600,EB445137-D7F5-57EC-87DA-1DB460D64046,"iPhone13,2"
com.intsig.CamScannerLite,2,1740091722,1740091724,1740091724.823749,-21600,EB445137-D7F5-57EC-87DA-1DB460D64046,"iPhone13,2"
com.leomehlig.today,199,1740091678,1740091877,1740091877.5477,-21600,,
com.google.Chrome,2015,1740089663,1740091678,1740091678.897839,-21600,,
com.apple.finder,15,1740089648,1740089663,1740089663.3372068,-21600,,
com.intsig.CamScannerLite,95,1740089555,1740089650,1740089651.329349,-21600,EB445137-D7F5-57EC-87DA-1DB460D64046,"iPhone13,2"
com.apple.mobileslideshow,2,1740089552,1740089554,1740089555.067965,-21600,EB445137-D7F5-57EC-87DA-1DB460D64046,"iPhone13,2"
com.google.Chrome,286,1740089362,1740089648,1740089648.871817,-21600,,
com.apple.Passwords,1,1740089361,1740089362,1740089362.474644,-21600,,
com.apple.finder,1,1740089360,1740089361,1740089361.767345,-21600,,
com.apple.Photos,1,1740089359,1740089360,1740089360.931034,-21600,,
com.apple.finder,3,1740089356,1740089359,1740089359.720697,-21600,,
com.apple.Photos,6,1740089350,1740089356,1740089356.78646,-21600,,
com.apple.Passwords,2,1740089348,1740089350,1740089350.5849671,-21600,,
com.apple.mobileslideshow,14,1740089324,1740089338,1740089339.332128,-21600,EB445137-D7F5-57EC-87DA-1DB460D64046,"iPhone13,2"
com.hammerandchisel.discord,8,1740089305,1740089313,1740089313.9669971,-21600,EB445137-D7F5-57EC-87DA-1DB460D64046,"iPhone13,2"
com.toyopagroup.picaboo,36,1740089259,1740089295,1740089295.5408812,-21600,EB445137-D7F5-57EC-87DA-1DB460D64046,"iPhone13,2"
com.apple.Photos,106,1740089242,1740089348,1740089348.117202,-21600,,
com.google.Chrome,271,1740088971,1740089242,1740089242.994646,-21600,,
com.leomehlig.today,12,1740088959,1740088971,1740088971.5081248,-21600,,
com.google.Chrome,29,1740088930,1740088959,1740088959.709527,-21600,,
com.toyopagroup.picaboo,7,1740088748,1740088755,1740088755.5459929,-21600,EB445137-D7F5-57EC-87DA-1DB460D64046,"iPhone13,2"
com.toyopagroup.picaboo,25,1740088721,1740088746,1740088746.5380368,-21600,EB445137-D7F5-57EC-87DA-1DB460D64046,"iPhone13,2"
com.amazon.Amazon,2,1740088716,1740088718,1740088718.972423,-21600,EB445137-D7F5-57EC-87DA-1DB460D64046,"iPhone13,2"
com.amazon.Amazon,15,1740088602,1740088617,1740088617.19033,-21600,EB445137-D7F5-57EC-87DA-1DB460D64046,"iPhone13,2"
com.myfitnesspal.mfp,2,1740088600,1740088602,1740088603.171424,-21600,EB445137-D7F5-57EC-87DA-1DB460D64046,"iPhone13,2"
com.myfitnesspal.mfp,106,1740088019,1740088125,1740088125.9602141,-21600,EB445137-D7F5-57EC-87DA-1DB460D64046,"iPhone13,2"
com.myfitnesspal.mfp,2,1740088012,1740088014,1740088014.5107222,-21600,EB445137-D7F5-57EC-87DA-1DB460D64046,"iPhone13,2"
com.amazon.Amazon,14,1740087998,1740088012,1740088012.8926911,-21600,EB445137-D7F5-57EC-87DA-1DB460D64046,"iPhone13,2"
com.apple.mobileslideshow,2,1740087994,1740087996,1740087996.392504,-21600,EB445137-D7F5-57EC-87DA-1DB460D64046,"iPhone13,2"
com.google.Chrome,20,1740087778,1740087798,1740087799.2640781,-21600,,
com.apple.mobileslideshow,11,1740087174,1740087185,1740087185.42701,-21600,EB445137-D7F5-57EC-87DA-1DB460D64046,"iPhone13,2"
com.apple.mobileslideshow,1,1740087172,1740087173,1740087173.700048,-21600,EB445137-D7F5-57EC-87DA-1DB460D64046,"iPhone13,2"
com.google.Chrome,311,1740085450,1740085761,1740085761.492797,-21600,,
com.apple.Passwords,9,1740085427,1740085436,1740085436.8007011,-21600,,
com.google.Chrome,2,1740085425,1740085427,1740085427.216483,-21600,,
com.google.Chrome,300,1740085102,1740085402,1740085402.932396,-21600,,
com.apple.calculator,61,1740085041,1740085102,1740085102.328144,-21600,,
com.google.Chrome,1,1740085040,1740085041,1740085041.840564,-21600,,
com.google.Chrome,325,1740081705,1740082030,1740082030.09407,-21600,,
com.apple.Passwords,6,1740081699,1740081705,1740081705.814132,-21600,,
com.google.Chrome,3,1740081696,1740081699,1740081699.617985,-21600,,
com.microsoft.Office.Outlook,36,1740081439,1740081475,1740081475.2159839,-21600,EB445137-D7F5-57EC-87DA-1DB460D64046,"iPhone13,2"
com.amazon.Amazon,20,1740080452,1740080472,1740080472.5317922,-21600,EB445137-D7F5-57EC-87DA-1DB460D64046,"iPhone13,2"
com.apple.Health,3,1740080442,1740080445,1740080446.629469,-21600,EB445137-D7F5-57EC-87DA-1DB460D64046,"iPhone13,2"
com.google.Chrome,2,1740080005,1740080007,1740080007.810524,-21600,,
com.leomehlig.today,3,1740080002,1740080005,1740080005.6219969,-21600,,
com.google.Chrome,3,1740079999,1740080002,1740080002.8662992,-21600,,
com.apple.finder,4,1740079870,1740079874,1740079874.455009,-21600,,
com.google.Chrome,17,1740079853,1740079870,1740079870.2925029,-21600,,
com.apple.finder,6,1740079847,1740079853,1740079853.5556269,-21600,,
com.google.Chrome,61,1740079786,1740079847,1740079847.848454,-21600,,
com.apple.finder,248,1740079538,1740079786,1740079788.171599,-21600,,
com.apple.Passwords,0,1740079538,1740079538,1740079538.833496,-21600,,
com.apple.finder,3,1740079535,1740079538,1740079538.1367412,-21600,,
com.leomehlig.today,86,1740079449,1740079535,1740079535.825341,-21600,,
com.apple.finder,3,1740079446,1740079449,1740079449.44626,-21600,,
com.apple.Health,102,1740079345,1740079447,1740079448.375071,-21600,EB445137-D7F5-57EC-87DA-1DB460D64046,"iPhone13,2"
com.apple.CoreAuthUI,2,1740079339,1740079341,1740079341.4125838,-21600,EB445137-D7F5-57EC-87DA-1DB460D64046,"iPhone13,2"
com.truebill.truebillnative,6,1740079338,1740079344,1740079344.574338,-21600,EB445137-D7F5-57EC-87DA-1DB460D64046,"iPhone13,2"
com.truebill.truebillnative,33,1740077427,1740077460,1740077460.722172,-21600,EB445137-D7F5-57EC-87DA-1DB460D64046,"iPhone13,2"
com.apple.mobiletimer,2,1740077425,1740077427,1740077427.6247869,-21600,EB445137-D7F5-57EC-87DA-1DB460D64046,"iPhone13,2"
com.truebill.truebillnative,2,1740077423,1740077425,1740077425.456542,-21600,EB445137-D7F5-57EC-87DA-1DB460D64046,"iPhone13,2"
com.apple.CoreAuthUI,2,1740077306,1740077308,1740077308.727514,-21600,EB445137-D7F5-57EC-87DA-1DB460D64046,"iPhone13,2"
com.truebill.truebillnative,25,1740077303,1740077328,1740077328.207226,-21600,EB445137-D7F5-57EC-87DA-1DB460D64046,"iPhone13,2"
com.apple.mobiletimer,3,1740077274,1740077277,1740077277.314333,-21600,EB445137-D7F5-57EC-87DA-1DB460D64046,"iPhone13,2"
com.apple.mobiletimer,3,1740077214,1740077217,1740077217.324833,-21600,EB445137-D7F5-57EC-87DA-1DB460D64046,"iPhone13,2"
com.apple.news,163,1740077051,1740077214,1740077214.846116,-21600,EB445137-D7F5-57EC-87DA-1DB460D64046,"iPhone13,2"
com.apple.mobiletimer,4,1740077041,1740077045,1740077045.1351361,-21600,EB445137-D7F5-57EC-87DA-1DB460D64046,"iPhone13,2"
com.apple.findmy,7,1740076768,1740076775,1740076775.990854,-21600,EB445137-D7F5-57EC-87DA-1DB460D64046,"iPhone13,2"
com.apple.weather,1,1740076767,1740076768,1740076768.904828,-21600,EB445137-D7F5-57EC-87DA-1DB460D64046,"iPhone13,2"
com.apple.weather,37,1740076720,1740076757,1740076758.0847101,-21600,EB445137-D7F5-57EC-87DA-1DB460D64046,"iPhone13,2"
com.apple.Maps,16,1740076704,1740076720,1740076720.493248,-21600,EB445137-D7F5-57EC-87DA-1DB460D64046,"iPhone13,2"
com.apple.weather,40,1740076661,1740076701,1740076702.009342,-21600,EB445137-D7F5-57EC-87DA-1DB460D64046,"iPhone13,2"
com.apple.mobiletimer,5,1740076656,1740076661,1740076661.796383,-21600,EB445137-D7F5-57EC-87DA-1DB460D64046,"iPhone13,2"
com.apple.news,1,1740076655,1740076656,1740076656.573133,-21600,EB445137-D7F5-57EC-87DA-1DB460D64046,"iPhone13,2"
com.apple.news,44,1740076569,1740076613,1740076614.450704,-21600,EB445137-D7F5-57EC-87DA-1DB460D64046,"iPhone13,2"
com.apple.mobiletimer,3,1740076566,1740076569,1740076569.111022,-21600,EB445137-D7F5-57EC-87DA-1DB460D64046,"iPhone13,2"
com.apple.news,115,1740076451,1740076566,1740076566.691465,-21600,EB445137-D7F5-57EC-87DA-1DB460D64046,"iPhone13,2"
com.apple.mobiletimer,2,1740076442,1740076444,1740076444.561641,-21600,EB445137-D7F5-57EC-87DA-1DB460D64046,"iPhone13,2"
com.apple.mobiletimer,2,1740076344,1740076346,1740076346.947372,-21600,EB445137-D7F5-57EC-87DA-1DB460D64046,"iPhone13,2"
com.apple.mobiletimer,4,1740076134,1740076138,1740076138.2050772,-21600,EB445137-D7F5-57EC-87DA-1DB460D64046,"iPhone13,2"
com.apple.mobiletimer,3,1740076005,1740076008,1740076009.132838,-21600,EB445137-D7F5-57EC-87DA-1DB460D64046,"iPhone13,2"
com.apple.mobiletimer,2,1740075707,1740075709,1740075709.545646,-21600,EB445137-D7F5-57EC-87DA-1DB460D64046,"iPhone13,2"
com.apple.news,51,1740075656,1740075707,1740075707.5573769,-21600,EB445137-D7F5-57EC-87DA-1DB460D64046,"iPhone13,2"
com.apple.mobiletimer,1,1740075655,1740075656,1740075658.49192,-21600,EB445137-D7F5-57EC-87DA-1DB460D64046,"iPhone13,2"
com.apple.news,68,1740075587,1740075655,1740075655.472409,-21600,EB445137-D7F5-57EC-87DA-1DB460D64046,"iPhone13,2"
com.apple.mobiletimer,7,1740075580,1740075587,1740075587.702188,-21600,EB445137-D7F5-57EC-87DA-1DB460D64046,"iPhone13,2"
com.apple.mobiletimer,2,1740075522,1740075524,1740075525.072482,-21600,EB445137-D7F5-57EC-87DA-1DB460D64046,"iPhone13,2"
com.apple.news,107,1740075415,1740075522,1740075522.948329,-21600,EB445137-D7F5-57EC-87DA-1DB460D64046,"iPhone13,2"
com.apple.mobiletimer,1,1740075414,1740075415,1740075415.087776,-21600,EB445137-D7F5-57EC-87DA-1DB460D64046,"iPhone13,2"
com.apple.mobiletimer,3,1740075391,1740075394,1740075394.372933,-21600,EB445137-D7F5-57EC-87DA-1DB460D64046,"iPhone13,2"
com.apple.mobiletimer,60,1740075245,1740075305,1740075305.17466,-21600,EB445137-D7F5-57EC-87DA-1DB460D64046,"iPhone13,2"
com.apple.Music,5,1740075240,1740075245,1740075245.028411,-21600,EB445137-D7F5-57EC-87DA-1DB460D64046,"iPhone13,2"
com.apple.Music,16,1740075046,1740075062,1740075062.091721,-21600,EB445137-D7F5-57EC-87DA-1DB460D64046,"iPhone13,2"
com.apple.weather,2,1740075044,1740075046,1740075046.805253,-21600,EB445137-D7F5-57EC-87DA-1DB460D64046,"iPhone13,2"
com.apple.weather,10,1740073809,1740073819,1740073819.225315,-21600,EB445137-D7F5-57EC-87DA-1DB460D64046,"iPhone13,2"
com.apple.Health,121,1740073666,1740073787,1740073787.31178,-21600,EB445137-D7F5-57EC-87DA-1DB460D64046,"iPhone13,2"
com.amazon.Amazon,20,1740073637,1740073657,1740073657.861246,-21600,EB445137-D7F5-57EC-87DA-1DB460D64046,"iPhone13,2"
com.amazon.Amazon,13,1740073048,1740073061,1740073061.861483,-21600,EB445137-D7F5-57EC-87DA-1DB460D64046,"iPhone13,2"
com.intsig.CamScannerLite,2,1740073045,1740073047,1740073047.291665,-21600,EB445137-D7F5-57EC-87DA-1DB460D64046,"iPhone13,2"
com.intsig.CamScannerLite,10,1740072986,1740072996,1740072996.312026,-21600,EB445137-D7F5-57EC-87DA-1DB460D64046,"iPhone13,2"
com.apple.finder,97,1740072565,1740072662,1740072662.4211102,-21600,,
com.apple.archiveutility,0,1740072565,1740072565,1740072566.79667,-21600,,
com.apple.finder,57,1740072508,1740072565,1740072565.498911,-21600,,
com.apple.archiveutility,1,1740072507,1740072508,1740072509.694942,-21600,,
com.apple.finder,234,1740072273,1740072507,1740072507.971243,-21600,,
com.apple.archiveutility,1,1740072272,1740072273,1740072273.413873,-21600,,
com.intsig.CamScannerLite,369,1740072236,1740072605,1740072605.677618,-21600,EB445137-D7F5-57EC-87DA-1DB460D64046,"iPhone13,2"
com.apple.finder,89,1740072183,1740072272,1740072272.870356,-21600,,
com.apple.archiveutility,1,1740072182,1740072183,1740072184.664923,-21600,,
com.intsig.CamScannerLite,159,1740072073,1740072232,1740072232.223301,-21600,EB445137-D7F5-57EC-87DA-1DB460D64046,"iPhone13,2"
com.apple.finder,218,1740071964,1740072182,1740072182.6569471,-21600,,
com.google.Chrome,2,1740071962,1740071964,1740071964.243569,-21600,,
com.apple.MobileSMS,19,1740071943,1740071962,1740071962.505403,-21600,,
com.google.Chrome,85,1740071858,1740071943,1740071943.428537,-21600,,
com.apple.MobileSMS,5,1740071853,1740071858,1740071858.092,-21600,,
com.google.Chrome,3,1740071850,1740071853,1740071853.8547559,-21600,,
com.intsig.CamScannerLite,148,1740071722,1740071870,1740071870.471115,-21600,EB445137-D7F5-57EC-87DA-1DB460D64046,"iPhone13,2"
com.apple.MobileSMS,7,1740071645,1740071652,1740071652.0535588,-21600,EB445137-D7F5-57EC-87DA-1DB460D64046,"iPhone13,2"
com.apple.Health,6,1740071639,1740071645,1740071646.439919,-21600,EB445137-D7F5-57EC-87DA-1DB460D64046,"iPhone13,2"
com.apple.MobileSMS,24,1740071615,1740071639,1740071639.9069262,-21600,EB445137-D7F5-57EC-87DA-1DB460D64046,"iPhone13,2"
com.apple.finder,312,1740071517,1740071829,1740071829.796869,-21600,,
com.apple.Health,125,1740071489,1740071614,1740071615.1273708,-21600,EB445137-D7F5-57EC-87DA-1DB460D64046,"iPhone13,2"
com.google.Chrome,58,1740071459,1740071517,1740071517.64627,-21600,,
com.apple.Passwords,7,1740071452,1740071459,1740071459.3684,-21600,,
com.google.Chrome,4,1740071448,1740071452,1740071452.021158,-21600,,
com.apple.Passwords,8,1740071440,1740071448,1740071448.3052,-21600,,
com.google.Chrome,1,1740071439,1740071440,1740071440.9834208,-21600,,
com.apple.Passwords,2,1740071433,1740071435,1740071435.5292358,-21600,,
com.google.Chrome,1,1740071432,1740071433,1740071433.95548,-21600,,
com.apple.Passwords,8,1740071424,1740071432,1740071432.854933,-21600,,
com.google.Chrome,37,1740071387,1740071424,1740071424.210716,-21600,,
com.apple.finder,118,1740071269,1740071387,1740071388.2158089,-21600,,
com.apple.Preview,48,1740071221,1740071269,1740071269.476451,-21600,,
com.apple.finder,39,1740071182,1740071221,1740071222.034051,-21600,,
com.apple.Preview,94,1740071088,1740071182,1740071182.309804,-21600,,
com.apple.finder,4,1740071084,1740071088,1740071088.669434,-21600,,
com.apple.Health,360,1740071081,1740071441,1740071441.933453,-21600,EB445137-D7F5-57EC-87DA-1DB460D64046,"iPhone13,2"
com.leomehlig.today,55,1740071029,1740071084,1740071084.444231,-21600,,
com.apple.Notes,7,1740071022,1740071029,1740071030.015812,-21600,,
com.leomehlig.today,42,1740070980,1740071022,1740071022.129294,-21600,,
com.google.Chrome,58,1740070922,1740070980,1740070980.2042909,-21600,,
com.leomehlig.today,4,1740070918,1740070922,1740070922.965853,-21600,,
com.google.Chrome,362,1740070556,1740070918,1740070918.143925,-21600,,
com.leomehlig.today,8,1740070548,1740070556,1740070556.4682422,-21600,,
com.google.Chrome,859,1740069689,1740070548,1740070548.2306209,-21600,,
com.apple.Dictionary,2,1740069687,1740069689,1740069689.6738229,-21600,,
com.google.Chrome,953,1740068734,1740069687,1740069687.6472259,-21600,,
com.leomehlig.today,7,1740068727,1740068734,1740068734.41607,-21600,,
com.google.Chrome,196,1740068531,1740068727,1740068727.1034389,-21600,,
com.apple.iCal,8,1740068523,1740068531,1740068531.053627,-21600,,
com.leomehlig.today,148,1740068278,1740068426,1740068427.034013,-21600,EB445137-D7F5-57EC-87DA-1DB460D64046,"iPhone13,2"
com.apple.news,46,1740068220,1740068266,1740068266.1815748,-21600,EB445137-D7F5-57EC-87DA-1DB460D64046,"iPhone13,2"
com.apple.iCal,304,1740068172,1740068476,1740068476.784859,-21600,,
com.google.Chrome,8,1740068164,1740068172,1740068172.7893991,-21600,,
com.apple.Preview,39,1740068125,1740068164,1740068164.4286408,-21600,,
com.apple.finder,7,1740068118,1740068125,1740068125.544311,-21600,,
com.google.Chrome,4,1740068114,1740068118,1740068118.3471289,-21600,,
com.leomehlig.today,8,1740068106,1740068114,1740068114.949789,-21600,,
com.apple.finder,1,1740068105,1740068106,1740068106.929813,-21600,,
com.apple.shortcuts,6,1740067182,1740067188,1740067189.261177,-21600,EB445137-D7F5-57EC-87DA-1DB460D64046,"iPhone13,2"
com.apple.Health,1,1740067174,1740067175,1740067175.896747,-21600,EB445137-D7F5-57EC-87DA-1DB460D64046,"iPhone13,2"
com.apple.Health,6,1740067162,1740067168,1740067168.277237,-21600,EB445137-D7F5-57EC-87DA-1DB460D64046,"iPhone13,2"
com.google.Chrome,985,1740067120,1740068105,1740068105.494806,-21600,,
com.leomehlig.today,4,1740067116,1740067120,1740067120.9316149,-21600,,
com.google.Chrome,1121,1740065995,1740067116,1740067116.962778,-21600,,
com.leomehlig.today,3,1740065992,1740065995,1740065995.149965,-21600,,
com.google.Chrome,465,1740065527,1740065992,1740065992.503726,-21600,,
com.google.Chrome,1302,1740064215,1740065517,1740065517.553862,-21600,,
com.leomehlig.today,2,1740063732,1740063734,1740063735.6248899,-21600,,
com.apple.Health,168,1740063383,1740063551,1740063551.822623,-21600,EB445137-D7F5-57EC-87DA-1DB460D64046,"iPhone13,2"
com.renpho.health,3,1740063377,1740063380,1740063380.851979,-21600,EB445137-D7F5-57EC-87DA-1DB460D64046,"iPhone13,2"
com.leomehlig.today,316,1740063356,1740063672,1740063672.159792,-21600,,
com.apple.finder,2,1740063354,1740063356,1740063356.513053,-21600,,
com.microsoft.VSCode,16,1740063338,1740063354,1740063354.6994228,-21600,,
com.google.Chrome,198,1740063140,1740063338,1740063338.6171079,-21600,,
com.microsoft.VSCode,2,1740063138,1740063140,1740063140.989666,-21600,,
com.google.Chrome,118,1740063020,1740063138,1740063138.366548,-21600,,
com.microsoft.VSCode,4,1740063016,1740063020,1740063020.444378,-21600,,
com.google.Chrome,129,1740062887,1740063016,1740063017.0061169,-21600,,
com.microsoft.VSCode,87,1740062800,1740062887,1740062887.563139,-21600,,
com.google.Chrome,24,1740062776,1740062800,1740062800.305983,-21600,,
com.microsoft.VSCode,49,1740062727,1740062776,1740062776.758366,-21600,,
com.google.Chrome,7,1740062720,1740062727,1740062727.9899259,-21600,,
com.microsoft.VSCode,40,1740062680,1740062720,1740062720.3628879,-21600,,
com.google.Chrome,122,1740062558,1740062680,1740062680.293161,-21600,,
com.apple.finder,11,1740062547,1740062558,1740062558.985764,-21600,,
com.renpho.health,86,1740062024,1740062110,1740062110.352754,-21600,EB445137-D7F5-57EC-87DA-1DB460D64046,"iPhone13,2"
com.apple.weather,18,1740061161,1740061179,1740061179.366566,-21600,EB445137-D7F5-57EC-87DA-1DB460D64046,"iPhone13,2"
com.thestorygraph.thestorygraph,25,1740028916,1740028941,1740028941.283426,-21600,EB445137-D7F5-57EC-87DA-1DB460D64046,"iPhone13,2"
com.apple.Health,17,1740027759,1740027776,1740027777.078229,-21600,EB445137-D7F5-57EC-87DA-1DB460D64046,"iPhone13,2"
com.apple.CoreAuthUI,2,1740027634,1740027636,1740027636.926797,-21600,EB445137-D7F5-57EC-87DA-1DB460D64046,"iPhone13,2"
com.apple.mobileslideshow,59,1740027624,1740027683,1740027683.3802152,-21600,EB445137-D7F5-57EC-87DA-1DB460D64046,"iPhone13,2"
com.apple.news,8,1740027613,1740027621,1740027621.230455,-21600,EB445137-D7F5-57EC-87DA-1DB460D64046,"iPhone13,2"
com.apple.Health,2,1740027200,1740027202,1740027202.9831429,-21600,EB445137-D7F5-57EC-87DA-1DB460D64046,"iPhone13,2"
com.apple.Health,16,1740027180,1740027196,1740027197.198307,-21600,EB445137-D7F5-57EC-87DA-1DB460D64046,"iPhone13,2"
com.apple.Music,2,1740027177,1740027179,1740027181.154604,-21600,EB445137-D7F5-57EC-87DA-1DB460D64046,"iPhone13,2"
com.apple.Music,7,1740027126,1740027133,1740027133.4648561,-21600,EB445137-D7F5-57EC-87DA-1DB460D64046,"iPhone13,2"
com.apple.Music,9,1740025864,1740025873,1740025874.132042,-21600,EB445137-D7F5-57EC-87DA-1DB460D64046,"iPhone13,2"
com.apple.Music,11,1740025797,1740025808,1740025808.312306,-21600,EB445137-D7F5-57EC-87DA-1DB460D64046,"iPhone13,2"
com.apple.Music,11,1740025698,1740025709,1740025710.159231,-21600,EB445137-D7F5-57EC-87DA-1DB460D64046,"iPhone13,2"
com.hammerandchisel.discord,6,1740025689,1740025695,1740025695.296921,-21600,EB445137-D7F5-57EC-87DA-1DB460D64046,"iPhone13,2"
com.hammerandchisel.discord,2,1740025687,1740025689,1740025689.872272,-21600,EB445137-D7F5-57EC-87DA-1DB460D64046,"iPhone13,2"
com.hammerandchisel.discord,7,1740025467,1740025474,1740025475.187552,-21600,EB445137-D7F5-57EC-87DA-1DB460D64046,"iPhone13,2"
com.apple.finder,2,1740025443,1740025445,1740025445.179254,-21600,,
com.google.Chrome,6,1740025437,1740025443,1740025443.1791701,-21600,,
com.apple.finder,23,1740025414,1740025437,1740025437.881095,-21600,,
com.google.Chrome,26,1740025388,1740025414,1740025414.2406092,-21600,,
com.apple.finder,2,1740025386,1740025388,1740025388.836792,-21600,,
com.microsoft.VSCode,56,1740025330,1740025386,1740025386.787826,-21600,,
com.google.Chrome,9,1740025321,1740025330,1740025330.288327,-21600,,
com.microsoft.VSCode,87,1740025234,1740025321,1740025321.336257,-21600,,
com.google.Chrome,7,1740025227,1740025234,1740025234.154114,-21600,,
com.microsoft.VSCode,88,1740025139,1740025227,1740025227.983151,-21600,,
com.google.Chrome,1,1740025138,1740025139,1740025139.8262382,-21600,,
com.apple.finder,1,1740025137,1740025138,1740025138.569529,-21600,,
com.google.Chrome,1,1740025136,1740025137,1740025137.058799,-21600,,
com.microsoft.VSCode,21,1740025115,1740025136,1740025136.114719,-21600,,
com.google.Chrome,1,1740025114,1740025115,1740025115.190309,-21600,,
com.apple.finder,4,1740025110,1740025114,1740025114.292377,-21600,,
com.google.Chrome,1,1740025109,1740025110,1740025110.861057,-21600,,
com.microsoft.VSCode,72,1740025037,1740025109,1740025109.8634381,-21600,,
com.google.Chrome,1,1740025036,1740025037,1740025037.3735461,-21600,,
com.microsoft.VSCode,2,1740025034,1740025036,1740025036.737465,-21600,,
com.google.Chrome,0,1740025034,1740025034,1740025035.006681,-21600,,
com.microsoft.VSCode,2,1740025032,1740025034,1740025034.2194571,-21600,,
com.google.Chrome,0,1740025032,1740025032,1740025032.957718,-21600,,
com.microsoft.VSCode,6,1740025026,1740025032,1740025032.2293339,-21600,,
com.google.Chrome,17,1740025009,1740025026,1740025026.785606,-21600,,
com.microsoft.VSCode,8,1740025001,1740025009,1740025009.542861,-21600,,
com.google.Chrome,5,1740024996,1740025001,1740025001.7738361,-21600,,
com.microsoft.VSCode,43,1740024953,1740024996,1740024996.818997,-21600,,
com.apple.finder,15,1740024938,1740024953,1740024954.003502,-21600,,
com.microsoft.VSCode,30,1740024908,1740024938,1740024938.17315,-21600,,
com.apple.finder,10,1740024898,1740024908,1740024908.3889608,-21600,,
com.microsoft.VSCode,47,1740024851,1740024898,1740024898.086978,-21600,,
com.apple.finder,20,1740024831,1740024851,1740024851.9391599,-21600,,
com.microsoft.VSCode,115,1740024716,1740024831,1740024831.928304,-21600,,
com.apple.finder,30,1740024686,1740024716,1740024716.038362,-21600,,
com.microsoft.VSCode,1,1740024685,1740024686,1740024686.791122,-21600,,
com.apple.finder,0,1740024685,1740024685,1740024686.0392609,-21600,,
com.microsoft.VSCode,4,1740024681,1740024685,1740024685.271521,-21600,,
com.apple.finder,2,1740024679,1740024681,1740024681.721006,-21600,,
com.microsoft.VSCode,2,1740024677,1740024679,1740024679.420955,-21600,,
com.apple.finder,21,1740024656,1740024677,1740024677.9556952,-21600,,
com.microsoft.VSCode,37,1740024619,1740024656,1740024657.004976,-21600,,
com.apple.finder,33,1740024586,1740024619,1740024619.293651,-21600,,
com.microsoft.VSCode,9,1740024577,1740024586,1740024586.795594,-21600,,
com.google.Chrome,36,1740024541,1740024577,1740024577.761704,-21600,,
com.microsoft.VSCode,25,1740024516,1740024541,1740024541.101509,-21600,,
com.google.Chrome,9,1740024507,1740024516,1740024516.484993,-21600,,
com.microsoft.VSCode,22,1740024485,1740024507,1740024507.358798,-21600,,
com.apple.finder,11,1740024474,1740024485,1740024485.443787,-21600,,
com.microsoft.VSCode,1,1740024473,1740024474,1740024474.7894158,-21600,,
com.google.Chrome,13,1740024460,1740024473,1740024473.7510839,-21600,,
com.microsoft.VSCode,40,1740024420,1740024460,1740024460.148694,-21600,,
com.apple.finder,1,1740024419,1740024420,1740024420.592916,-21600,,
com.google.Chrome,28,1740024391,1740024419,1740024419.622124,-21600,,
com.apple.finder,9,1740024382,1740024391,1740024391.808306,-21600,,
com.microsoft.VSCode,119,1740024263,1740024382,1740024382.567827,-21600,,
com.apple.finder,13,1740024250,1740024263,1740024263.044702,-21600,,
com.microsoft.VSCode,104,1740024146,1740024250,1740024251.017861,-21600,,
com.apple.finder,0,1740024087,1740024087,1740024088.463964,-21600,,
com.google.Chrome,5,1740024082,1740024087,1740024087.370232,-21600,,
com.microsoft.VSCode,44,1740024038,1740024082,1740024083.237949,-21600,,
com.google.Chrome,1,1740024037,1740024038,1740024038.2418861,-21600,,
com.microsoft.VSCode,2,1740024035,1740024037,1740024037.5522919,-21600,,
com.google.Chrome,3,1740024032,1740024035,1740024035.947108,-21600,,
com.microsoft.VSCode,103,1740023929,1740024032,1740024032.965306,-21600,,
com.google.Chrome,2,1740023927,1740023929,1740023929.7032871,-21600,,
com.microsoft.VSCode,2,1740023925,1740023927,1740023927.870131,-21600,,
com.google.Chrome,2,1740023923,1740023925,1740023925.363597,-21600,,
com.microsoft.VSCode,1,1740023922,1740023923,1740023923.567922,-21600,,
com.google.Chrome,59,1740023863,1740023922,1740023922.901967,-21600,,
com.microsoft.VSCode,46,1740023817,1740023863,1740023863.257288,-21600,,
com.apple.finder,3,1740023814,1740023817,1740023817.155442,-21600,,
com.microsoft.VSCode,127,1740023687,1740023814,1740023815.63203,-21600,,
com.apple.finder,11,1740023676,1740023687,1740023687.452379,-21600,,
com.microsoft.VSCode,0,1740023676,1740023676,1740023676.816784,-21600,,
com.google.Chrome,1,1740023675,1740023676,1740023676.136818,-21600,,
com.microsoft.VSCode,49,1740023626,1740023675,1740023675.304152,-21600,,
com.google.Chrome,2,1740023624,1740023626,1740023626.876287,-21600,,
com.microsoft.VSCode,28,1740023596,1740023624,1740023624.436274,-21600,,
com.google.Chrome,12,1740023584,1740023596,1740023596.075037,-21600,,
com.microsoft.VSCode,57,1740023527,1740023584,1740023584.169699,-21600,,
com.google.Chrome,25,1740023502,1740023527,1740023527.109674,-21600,,
com.microsoft.VSCode,139,1740023363,1740023502,1740023503.021538,-21600,,
com.google.Chrome,135,1740023228,1740023363,1740023363.956526,-21600,,
com.apple.finder,15,1740023213,1740023228,1740023228.178541,-21600,,
com.leomehlig.today,136,1740023077,1740023213,1740023213.536385,-21600,,
com.google.Chrome,10,1740023067,1740023077,1740023077.4837341,-21600,,
com.leomehlig.today,24,1740023043,1740023067,1740023067.903133,-21600,,
com.google.Chrome,324,1740022719,1740023043,1740023043.3909779,-21600,,
com.leomehlig.today,4,1740022715,1740022719,1740022719.7282581,-21600,,
com.google.Chrome,1,1740022714,1740022715,1740022715.823287,-21600,,
com.leomehlig.today,16,1740022698,1740022714,1740022714.5730991,-21600,,
com.apple.Health,2,1740021713,1740021715,1740021715.715061,-21600,EB445137-D7F5-57EC-87DA-1DB460D64046,"iPhone13,2"
com.apple.Preferences,15,1740021669,1740021684,1740021684.838612,-21600,EB445137-D7F5-57EC-87DA-1DB460D64046,"iPhone13,2"
com.google.Chrome,1300,1740021398,1740022698,1740022698.425206,-21600,,
com.leomehlig.today,48,1740021350,1740021398,1740021398.973634,-21600,,
com.groupme.iphone-app,10,1740021217,1740021227,1740021228.003066,-21600,EB445137-D7F5-57EC-87DA-1DB460D64046,"iPhone13,2"
com.google.Chrome,195,1740021155,1740021350,1740021350.657167,-21600,,
com.leomehlig.today,27,1740021128,1740021155,1740021155.524476,-21600,,
com.google.Chrome,406,1740020722,1740021128,1740021128.379153,-21600,,
com.tinyspeck.chatlyio,24,1740020604,1740020628,1740020628.680351,-21600,EB445137-D7F5-57EC-87DA-1DB460D64046,"iPhone13,2"
com.apple.CoreAuthUI,2,1740020425,1740020427,1740020427.123485,-21600,EB445137-D7F5-57EC-87DA-1DB460D64046,"iPhone13,2"
com.truebill.truebillnative,179,1740020424,1740020603,1740020603.381136,-21600,EB445137-D7F5-57EC-87DA-1DB460D64046,"iPhone13,2"
com.ally.MobileBanking,2,1740020421,1740020423,1740020423.102068,-21600,EB445137-D7F5-57EC-87DA-1DB460D64046,"iPhone13,2"
com.google.Chrome,430,1740020247,1740020677,1740020677.107521,-21600,,
com.ally.MobileBanking,62,1740020186,1740020248,1740020248.744581,-21600,EB445137-D7F5-57EC-87DA-1DB460D64046,"iPhone13,2"
com.apple.calculator,7,1740020179,1740020186,1740020186.6306581,-21600,EB445137-D7F5-57EC-87DA-1DB460D64046,"iPhone13,2"
com.apple.CoreAuthUI,2,1740020088,1740020090,1740020090.041296,-21600,EB445137-D7F5-57EC-87DA-1DB460D64046,"iPhone13,2"
com.ally.MobileBanking,98,1740020081,1740020179,1740020179.744384,-21600,EB445137-D7F5-57EC-87DA-1DB460D64046,"iPhone13,2"
com.apple.CoreAuthUI,2,1740020000,1740020002,1740020002.527792,-21600,EB445137-D7F5-57EC-87DA-1DB460D64046,"iPhone13,2"
com.truebill.truebillnative,73,1740019998,1740020071,1740020071.2906551,-21600,EB445137-D7F5-57EC-87DA-1DB460D64046,"iPhone13,2"
com.google.Gmail,17,1740019947,1740019964,1740019964.142487,-21600,EB445137-D7F5-57EC-87DA-1DB460D64046,"iPhone13,2"
com.intsig.CamScannerLite,0,1740019947,1740019947,1740019948.598146,-21600,EB445137-D7F5-57EC-87DA-1DB460D64046,"iPhone13,2"
com.google.Chrome,315,1740019899,1740020214,1740020214.777144,-21600,,
com.leomehlig.today,7,1740019892,1740019899,1740019899.986236,-21600,,
com.google.Chrome,69,1740019823,1740019892,1740019892.736635,-21600,,
com.leomehlig.today,3,1740019340,1740019343,1740019343.9982219,-21600,,
com.apple.Notes,102,1740019238,1740019340,1740019340.988256,-21600,,
com.leomehlig.today,175,1740019063,1740019238,1740019238.9229789,-21600,,
com.apple.finder,33,1740019030,1740019063,1740019063.5525122,-21600,,
com.apple.Photos,16,1740019014,1740019030,1740019030.621659,-21600,,
com.apple.finder,16,1740018998,1740019014,1740019014.616199,-21600,,
com.intsig.CamScannerLite,295,1740018761,1740019056,1740019056.885347,-21600,EB445137-D7F5-57EC-87DA-1DB460D64046,"iPhone13,2"
com.hammerandchisel.discord,6,1740018749,1740018755,1740018755.471056,-21600,EB445137-D7F5-57EC-87DA-1DB460D64046,"iPhone13,2"
com.leomehlig.today,276,1740018722,1740018998,1740018998.652566,-21600,,
com.google.Chrome,1002,1740017720,1740018722,1740018722.532421,-21600,,
com.leomehlig.today,2,1740017718,1740017720,1740017721.005322,-21600,,
com.google.Chrome,2074,1740015644,1740017718,1740017718.312446,-21600,,
com.toyopagroup.picaboo,23,1740015377,1740015400,1740015400.383856,-21600,EB445137-D7F5-57EC-87DA-1DB460D64046,"iPhone13,2"
com.google.Chrome,587,1740015047,1740015634,1740015634.931179,-21600,,
com.apple.Preview,19,1740015028,1740015047,1740015047.8652868,-21600,,
com.google.Chrome,11,1740015017,1740015028,1740015028.2130852,-21600,,
com.apple.Preview,116,1740014901,1740015017,1740015017.3020802,-21600,,
com.apple.finder,1,1740014900,1740014901,1740014901.705967,-21600,,
com.google.Chrome,200,1740014700,1740014900,1740014900.109051,-21600,,
com.apple.Preview,18,1740014682,1740014700,1740014700.983319,-21600,,
com.google.Chrome,79,1740014603,1740014682,1740014682.966069,-21600,,
com.apple.Preview,78,1740014525,1740014603,1740014603.8632479,-21600,,
com.google.Chrome,292,1740014233,1740014525,1740014525.328094,-21600,,
com.apple.Preview,60,1740014173,1740014233,1740014233.436039,-21600,,
com.apple.finder,6,1740014167,1740014173,1740014173.895817,-21600,,
com.microsoft.Outlook,1,1740014166,1740014167,1740014167.156482,-21600,,
com.apple.finder,1,1740014165,1740014166,1740014166.384976,-21600,,
com.microsoft.Outlook,1,1740014164,1740014165,1740014165.163588,-21600,,
com.apple.news,56,1740014091,1740014147,1740014148.335494,-21600,EB445137-D7F5-57EC-87DA-1DB460D64046,"iPhone13,2"
com.apple.MobileSMS,4,1740014072,1740014076,1740014076.927006,-21600,EB445137-D7F5-57EC-87DA-1DB460D64046,"iPhone13,2"
com.amazon.Amazon,1,1740014071,1740014072,1740014073.677184,-21600,EB445137-D7F5-57EC-87DA-1DB460D64046,"iPhone13,2"
com.apple.Preview,99,1740014065,1740014164,1740014164.521778,-21600,,
com.apple.news,88,1740013977,1740014065,1740014065.884948,-21600,,
com.apple.Preview,66,1740013911,1740013977,1740013977.579829,-21600,,
com.apple.finder,9,1740013902,1740013911,1740013911.399121,-21600,,
com.apple.Preview,2,1740013900,1740013902,1740013902.7315512,-21600,,
com.apple.finder,9,1740013891,1740013900,1740013900.645334,-21600,,
com.google.Chrome,168,1740013723,1740013891,1740013891.867509,-21600,,
com.apple.Preview,134,1740013589,1740013723,1740013723.253107,-21600,,
com.google.Chrome,14,1740013575,1740013589,1740013589.456149,-21600,,
com.apple.Preview,647,1740012928,1740013575,1740013576.0541282,-21600,,
com.google.Chrome,230,1740012698,1740012928,1740012928.5918121,-21600,,
com.apple.Preview,127,1740012571,1740012698,1740012698.627279,-21600,,
com.google.Chrome,147,1740012424,1740012571,1740012571.8338408,-21600,,
com.apple.Preview,15,1740012409,1740012424,1740012424.063678,-21600,,
com.google.Chrome,3,1740012406,1740012409,1740012409.261368,-21600,,
com.apple.Preview,6,1740012400,1740012406,1740012406.090877,-21600,,
com.apple.finder,3,1740012397,1740012400,1740012400.0365071,-21600,,
com.apple.Preview,0,1740012397,1740012397,1740012397.970407,-21600,,
com.apple.finder,20,1740012377,1740012397,1740012397.123143,-21600,,
com.google.Chrome,5,1740012372,1740012377,1740012377.382848,-21600,,
com.apple.Preview,12,1740012360,1740012372,1740012372.378588,-21600,,
com.apple.finder,4,1740012356,1740012360,1740012360.282,-21600,,
com.apple.Preview,2,1740012354,1740012356,1740012356.196532,-21600,,
com.apple.finder,12,1740012342,1740012354,1740012354.6587238,-21600,,
com.google.Chrome,19,1740012323,1740012342,1740012342.678896,-21600,,
com.apple.finder,9,1740012314,1740012323,1740012323.0989199,-21600,,
com.leomehlig.today,9,1740012305,1740012314,1740012314.979169,-21600,,
com.google.Chrome,43,1740012262,1740012305,1740012305.2380428,-21600,,
com.apple.finder,71,1740012191,1740012262,1740012262.117104,-21600,,
com.google.Chrome,254,1740011937,1740012191,1740012191.7233691,-21600,,
com.leomehlig.today,15,1740011922,1740011937,1740011937.319336,-21600,,
com.microsoft.Outlook,1,1740011921,1740011922,1740011922.860456,-21600,,
com.google.Chrome,56,1740011865,1740011921,1740011921.958967,-21600,,
com.leomehlig.today,29,1740011836,1740011865,1740011865.5737638,-21600,,
com.amazon.Amazon,130,1740010197,1740010327,1740010327.462636,-21600,EB445137-D7F5-57EC-87DA-1DB460D64046,"iPhone13,2"
com.myfitnesspal.mfp,17,1740010170,1740010187,1740010187.8905802,-21600,EB445137-D7F5-57EC-87DA-1DB460D64046,"iPhone13,2"
com.apple.weather,2,1740010165,1740010167,1740010167.819608,-21600,EB445137-D7F5-57EC-87DA-1DB460D64046,"iPhone13,2"
com.apple.weather,11,1740010070,1740010081,1740010081.250953,-21600,EB445137-D7F5-57EC-87DA-1DB460D64046,"iPhone13,2"
com.tinyspeck.chatlyio,14,1740009102,1740009116,1740009116.818142,-21600,EB445137-D7F5-57EC-87DA-1DB460D64046,"iPhone13,2"
com.myfitnesspal.mfp,3,1740009080,1740009083,1740009083.107048,-21600,EB445137-D7F5-57EC-87DA-1DB460D64046,"iPhone13,2"
com.myfitnesspal.mfp,46,1740008980,1740009026,1740009026.9897308,-21600,EB445137-D7F5-57EC-87DA-1DB460D64046,"iPhone13,2"
com.myfitnesspal.mfp,20,1740008774,1740008794,1740008794.400756,-21600,EB445137-D7F5-57EC-87DA-1DB460D64046,"iPhone13,2"
com.apple.MobileSMS,3,1740008771,1740008774,1740008774.931112,-21600,EB445137-D7F5-57EC-87DA-1DB460D64046,"iPhone13,2"
com.apple.MobileSMS,2,1740008072,1740008074,1740008074.674622,-21600,EB445137-D7F5-57EC-87DA-1DB460D64046,"iPhone13,2"
com.apple.MobileSMS,42,1740008013,1740008055,1740008056.024066,-21600,EB445137-D7F5-57EC-87DA-1DB460D64046,"iPhone13,2"
com.apple.mobiletimer,2,1740008011,1740008013,1740008013.1881409,-21600,EB445137-D7F5-57EC-87DA-1DB460D64046,"iPhone13,2"
com.apple.mobiletimer,90,1740007071,1740007161,1740007161.28139,-21600,EB445137-D7F5-57EC-87DA-1DB460D64046,"iPhone13,2"
com.apple.news,182,1740005606,1740005788,1740005788.6938329,-21600,EB445137-D7F5-57EC-87DA-1DB460D64046,"iPhone13,2"
Astrospheric.Astrospheric,150,1740005395,1740005545,1740005546.3928719,-21600,EB445137-D7F5-57EC-87DA-1DB460D64046,"iPhone13,2"
com.apple.weather,5,1740005390,1740005395,1740005395.573972,-21600,EB445137-D7F5-57EC-87DA-1DB460D64046,"iPhone13,2"
Astrospheric.Astrospheric,3,1740005387,1740005390,1740005390.648277,-21600,EB445137-D7F5-57EC-87DA-1DB460D64046,"iPhone13,2"
com.apple.weather,45,1740005342,1740005387,1740005387.44087,-21600,EB445137-D7F5-57EC-87DA-1DB460D64046,"iPhone13,2"
com.apple.news,79,1740005252,1740005331,1740005331.861463,-21600,EB445137-D7F5-57EC-87DA-1DB460D64046,"iPhone13,2"
com.leomehlig.today,51,1740005186,1740005237,1740005237.071069,-21600,EB445137-D7F5-57EC-87DA-1DB460D64046,"iPhone13,2"
com.apple.news,111,1740005065,1740005176,1740005176.824199,-21600,EB445137-D7F5-57EC-87DA-1DB460D64046,"iPhone13,2"
com.apple.news,2,1740005055,1740005057,1740005058.146556,-21600,EB445137-D7F5-57EC-87DA-1DB460D64046,"iPhone13,2"
com.google.chrome.ios,18,1740005032,1740005050,1740005050.658576,-21600,EB445137-D7F5-57EC-87DA-1DB460D64046,"iPhone13,2"
com.microsoft.Office.Outlook,19,1740005008,1740005027,1740005027.242233,-21600,EB445137-D7F5-57EC-87DA-1DB460D64046,"iPhone13,2"
com.apple.MobileSMS,14,1740004981,1740004995,1740004995.4134269,-21600,EB445137-D7F5-57EC-87DA-1DB460D64046,"iPhone13,2"
com.google.chrome.ios,1,1740004980,1740004981,1740004981.734743,-21600,EB445137-D7F5-57EC-87DA-1DB460D64046,"iPhone13,2"
com.google.chrome.ios,4,1740004929,1740004933,1740004933.987629,-21600,EB445137-D7F5-57EC-87DA-1DB460D64046,"iPhone13,2"
com.google.chrome.ios,6,1740004415,1740004421,1740004421.9549952,-21600,EB445137-D7F5-57EC-87DA-1DB460D64046,"iPhone13,2"
com.myfitnesspal.mfp,163,1740004239,1740004402,1740004402.637402,-21600,EB445137-D7F5-57EC-87DA-1DB460D64046,"iPhone13,2"
com.google.chrome.ios,4,1740004231,1740004235,1740004235.9443989,-21600,EB445137-D7F5-57EC-87DA-1DB460D64046,"iPhone13,2"
com.leomehlig.today,207,1740004228,1740004435,1740004436.1344,-21600,,
com.apple.iCal,0,1740004228,1740004228,1740004228.8876529,-21600,,
com.leomehlig.today,63,1740004165,1740004228,1740004228.543764,-21600,,
com.apple.iCal,6,1740004159,1740004165,1740004165.213019,-21600,,
com.leomehlig.today,5,1740004154,1740004159,1740004159.275773,-21600,,
com.apple.iCal,6,1740004148,1740004154,1740004154.663125,-21600,,
com.leomehlig.today,22,1740004126,1740004148,1740004148.9881392,-21600,,
com.google.chrome.ios,61,1740004076,1740004137,1740004137.7541142,-21600,EB445137-D7F5-57EC-87DA-1DB460D64046,"iPhone13,2"
com.google.Chrome,180,1740003946,1740004126,1740004126.959754,-21600,,
com.apple.iCal,2,1740003944,1740003946,1740003946.83991,-21600,,
com.google.Chrome,2,1740003942,1740003944,1740003944.892014,-21600,,
com.apple.iCal,9,1740003933,1740003942,1740003942.564145,-21600,,
com.google.Chrome,1,1740003932,1740003933,1740003933.08208,-21600,,
com.apple.iCal,2,1740003930,1740003932,1740003932.1037478,-21600,,
com.google.Chrome,22,1740003908,1740003930,1740003930.460393,-21600,,
com.apple.iCal,16,1740003892,1740003908,1740003908.428597,-21600,,
com.microsoft.Outlook,2,1740003890,1740003892,1740003892.512051,-21600,,
com.google.Chrome,35,1740003855,1740003890,1740003890.1057792,-21600,,
com.microsoft.Outlook,35,1740003820,1740003855,1740003855.3888721,-21600,,
com.cisco.secureclient.gui,5,1740003815,1740003820,1740003820.97596,-21600,,
com.microsoft.Outlook,0,1740003815,1740003815,1740003815.971757,-21600,,
com.apple.finder,12,1740003803,1740003815,1740003815.2619572,-21600,,
com.google.chrome.ios,22,1740003777,1740003799,1740003799.991061,-21600,EB445137-D7F5-57EC-87DA-1DB460D64046,"iPhone13,2"
com.google.chrome.ios,2,1740003775,1740003777,1740003777.5991,-21600,EB445137-D7F5-57EC-87DA-1DB460D64046,"iPhone13,2"
com.google.chrome.ios,69,1740003611,1740003680,1740003680.409641,-21600,EB445137-D7F5-57EC-87DA-1DB460D64046,"iPhone13,2"
com.apple.MobileSMS,29,1740003493,1740003522,1740003522.487389,-21600,EB445137-D7F5-57EC-87DA-1DB460D64046,"iPhone13,2"
com.apple.mobilenotes,0,1740003493,1740003493,1740003494.64975,-21600,EB445137-D7F5-57EC-87DA-1DB460D64046,"iPhone13,2"
com.apple.finder,2,1740003448,1740003450,1740003450.322095,-21600,,
com.microsoft.VSCode,5,1740003443,1740003448,1740003448.311881,-21600,,
com.google.Chrome,60,1740003383,1740003443,1740003443.47122,-21600,,
com.apple.finder,2,1740003381,1740003383,1740003383.563581,-21600,,
com.apple.Terminal,39,1740003342,1740003381,1740003381.495878,-21600,,
com.apple.finder,1,1740003341,1740003342,1740003342.652089,-21600,,
com.apple.Terminal,19,1740003322,1740003341,1740003341.348083,-21600,,
com.apple.finder,15,1740003307,1740003322,1740003322.615996,-21600,,
com.apple.Terminal,214,1740003093,1740003307,1740003307.251188,-21600,,
com.google.Chrome,27,1740003066,1740003093,1740003093.568147,-21600,,
com.apple.Terminal,3,1740003063,1740003066,1740003066.448113,-21600,,
com.google.Chrome,2,1740003061,1740003063,1740003063.474702,-21600,,
com.apple.Terminal,8,1740003053,1740003061,1740003061.8704581,-21600,,
com.google.Chrome,35,1740003018,1740003053,1740003053.724012,-21600,,
com.apple.Terminal,89,1740002929,1740003018,1740003018.411221,-21600,,
com.cisco.secureclient.gui,28,1740002901,1740002929,1740002929.236161,-21600,,
com.apple.Terminal,42,1740002859,1740002901,1740002901.712018,-21600,,
com.apple.Preview,9,1740002850,1740002859,1740002859.528651,-21600,,
com.apple.finder,80,1740002770,1740002850,1740002850.572911,-21600,,
com.microsoft.VSCode,210,1740002560,1740002770,1740002770.5765948,-21600,,
com.apple.finder,50,1740002510,1740002560,1740002560.96191,-21600,,
com.apple.mobilenotes,93,1740000863,1740000956,1740000956.866015,-21600,EB445137-D7F5-57EC-87DA-1DB460D64046,"iPhone13,2"
com.apple.mobilecal,2,1740000861,1740000863,1740000863.319854,-21600,EB445137-D7F5-57EC-87DA-1DB460D64046,"iPhone13,2"
com.apple.mobilecal,11,1740000180,1740000191,1740000191.769652,-21600,EB445137-D7F5-57EC-87DA-1DB460D64046,"iPhone13,2"
com.microsoft.Office.Outlook,28,1740000037,1740000065,1740000065.695569,-21600,EB445137-D7F5-57EC-87DA-1DB460D64046,"iPhone13,2"
com.apple.finder,399,1739999588,1739999987,1739999987.480509,-21600,,
com.google.Chrome,66,1739999522,1739999588,1739999588.466555,-21600,,
com.apple.finder,159,1739999363,1739999522,1739999522.1210241,-21600,,
com.tinyspeck.chatlyio,3,1739999285,1739999288,1739999288.919129,-21600,EB445137-D7F5-57EC-87DA-1DB460D64046,"iPhone13,2"
com.tinyspeck.chatlyio,10,1739998680,1739998690,1739998690.945106,-21600,EB445137-D7F5-57EC-87DA-1DB460D64046,"iPhone13,2"
com.tinyspeck.chatlyio,6,1739998315,1739998321,1739998321.3413649,-21600,EB445137-D7F5-57EC-87DA-1DB460D64046,"iPhone13,2"
com.apple.news,11,1739995088,1739995099,1739995099.319439,-21600,EB445137-D7F5-57EC-87DA-1DB460D64046,"iPhone13,2"
com.apple.news,8,1739995047,1739995055,1739995056.0773768,-21600,EB445137-D7F5-57EC-87DA-1DB460D64046,"iPhone13,2"
com.apple.finder,174,1739994847,1739995021,1739995021.766821,-21600,,
com.microsoft.VSCode,2,1739994845,1739994847,1739994847.944696,-21600,,
com.apple.finder,38,1739994807,1739994845,1739994846.047593,-21600,,
com.microsoft.VSCode,7,1739994800,1739994807,1739994807.515184,-21600,,
com.google.Chrome,13,1739994787,1739994800,1739994800.215046,-21600,,
com.microsoft.VSCode,2,1739994785,1739994787,1739994787.8727942,-21600,,
com.google.Chrome,15,1739994770,1739994785,1739994785.871949,-21600,,
com.microsoft.VSCode,52,1739994718,1739994770,1739994770.2516,-21600,,
com.google.Chrome,0,1739994718,1739994718,1739994718.842658,-21600,,
com.microsoft.VSCode,4,1739994714,1739994718,1739994718.216594,-21600,,
com.google.Chrome,4,1739994710,1739994714,1739994714.543114,-21600,,
com.microsoft.VSCode,5,1739994705,1739994710,1739994710.0854511,-21600,,
com.apple.finder,213,1739994492,1739994705,1739994705.3962731,-21600,,
com.microsoft.VSCode,8,1739994484,1739994492,1739994492.6165419,-21600,,
com.google.Chrome,7,1739994477,1739994484,1739994484.935549,-21600,,
com.microsoft.VSCode,103,1739994374,1739994477,1739994477.590294,-21600,,
com.google.Chrome,3,1739994371,1739994374,1739994374.188363,-21600,,
com.microsoft.VSCode,16,1739994355,1739994371,1739994371.9185638,-21600,,
com.google.Chrome,2,1739994353,1739994355,1739994355.335105,-21600,,
com.apple.finder,1,1739994352,1739994353,1739994353.227394,-21600,,
com.microsoft.VSCode,1,1739994351,1739994352,1739994352.5476298,-21600,,
com.apple.finder,1,1739994350,1739994351,1739994351.735715,-21600,,
com.google.Chrome,15,1739994335,1739994350,1739994350.745967,-21600,,
com.apple.finder,1,1739994334,1739994335,1739994335.466646,-21600,,
com.apple.Photos,2,1739994332,1739994334,1739994334.522791,-21600,,
com.apple.finder,1,1739994331,1739994332,1739994332.681848,-21600,,
com.microsoft.VSCode,53,1739994278,1739994331,1739994331.8483748,-21600,,
com.apple.finder,6,1739994272,1739994278,1739994278.0714278,-21600,,
com.google.Chrome,41,1739994231,1739994272,1739994272.5056,-21600,,
com.apple.news,174,1739993339,1739993513,1739993514.0685248,-21600,EB445137-D7F5-57EC-87DA-1DB460D64046,"iPhone13,2"
com.hammerandchisel.discord,2,1739993323,1739993325,1739993325.8648171,-21600,EB445137-D7F5-57EC-87DA-1DB460D64046,"iPhone13,2"
com.hammerandchisel.discord,19,1739992506,1739992525,1739992525.395623,-21600,EB445137-D7F5-57EC-87DA-1DB460D64046,"iPhone13,2"
com.apple.mobilecal,45,1739992461,1739992506,1739992506.508212,-21600,EB445137-D7F5-57EC-87DA-1DB460D64046,"iPhone13,2"
com.hammerandchisel.discord,5,1739992456,1739992461,1739992461.196331,-21600,EB445137-D7F5-57EC-87DA-1DB460D64046,"iPhone13,2"
com.apple.mobilecal,27,1739992429,1739992456,1739992457.026716,-21600,EB445137-D7F5-57EC-87DA-1DB460D64046,"iPhone13,2"
com.hammerandchisel.discord,18,1739992411,1739992429,1739992429.0919971,-21600,EB445137-D7F5-57EC-87DA-1DB460D64046,"iPhone13,2"
com.apple.mobilecal,0,1739992411,1739992411,1739992412.423357,-21600,EB445137-D7F5-57EC-87DA-1DB460D64046,"iPhone13,2"
com.google.Chrome,187,1739991430,1739991617,1739991620.236737,-21600,,
com.microsoft.VSCode,6,1739991424,1739991430,1739991430.0605822,-21600,,
com.apple.finder,46,1739991378,1739991424,1739991424.0714211,-21600,,
com.microsoft.VSCode,2,1739991376,1739991378,1739991378.6776562,-21600,,
com.apple.finder,10,1739991366,1739991376,1739991376.375053,-21600,,
com.google.Chrome,50,1739991316,1739991366,1739991366.893567,-21600,,
com.microsoft.VSCode,80,1739991236,1739991316,1739991316.410537,-21600,,
com.google.Chrome,134,1739991102,1739991236,1739991237.043977,-21600,,
com.microsoft.VSCode,15,1739991087,1739991102,1739991102.814018,-21600,,
com.google.Chrome,37,1739991050,1739991087,1739991087.085685,-21600,,
com.microsoft.VSCode,8,1739991042,1739991050,1739991050.200708,-21600,,
com.google.Chrome,1,1739991041,1739991042,1739991042.28638,-21600,,
com.microsoft.VSCode,2,1739991039,1739991041,1739991041.214474,-21600,,
com.google.Chrome,1,1739991038,1739991039,1739991039.785291,-21600,,
com.microsoft.VSCode,67,1739990971,1739991038,1739991038.8705978,-21600,,
com.google.Chrome,3,1739990968,1739990971,1739990971.978138,-21600,,
com.microsoft.VSCode,11,1739990957,1739990968,1739990968.163768,-21600,,
com.google.Chrome,20,1739990937,1739990957,1739990957.482421,-21600,,
com.microsoft.VSCode,0,1739990937,1739990937,1739990937.903288,-21600,,
com.google.Chrome,9,1739990928,1739990937,1739990937.258493,-21600,,
com.microsoft.VSCode,19,1739990909,1739990928,1739990928.2530031,-21600,,
com.google.Chrome,3,1739990906,1739990909,1739990909.72172,-21600,,
com.microsoft.VSCode,25,1739990881,1739990906,1739990906.374068,-21600,,
com.google.Chrome,6,1739990875,1739990881,1739990881.453366,-21600,,
com.microsoft.VSCode,116,1739990759,1739990875,1739990875.513583,-21600,,
com.google.Chrome,137,1739990622,1739990759,1739990759.3097901,-21600,,
com.apple.finder,70,1739990552,1739990622,1739990622.6147451,-21600,,
com.google.Chrome,10,1739990542,1739990552,1739990552.668999,-21600,,
com.apple.mobilecal,12,1739985518,1739985530,1739985531.036789,-21600,EB445137-D7F5-57EC-87DA-1DB460D64046,"iPhone13,2"
com.microsoft.Office.Outlook,37,1739985476,1739985513,1739985513.511723,-21600,EB445137-D7F5-57EC-87DA-1DB460D64046,"iPhone13,2"
com.myfitnesspal.mfp,0,1739985476,1739985476,1739985477.0727549,-21600,EB445137-D7F5-57EC-87DA-1DB460D64046,"iPhone13,2"
com.myfitnesspal.mfp,42,1739984726,1739984768,1739984768.600941,-21600,EB445137-D7F5-57EC-87DA-1DB460D64046,"iPhone13,2"
com.apple.Health,56,1739984665,1739984721,1739984721.91922,-21600,EB445137-D7F5-57EC-87DA-1DB460D64046,"iPhone13,2"
com.apple.Health,55,1739984608,1739984663,1739984663.971702,-21600,EB445137-D7F5-57EC-87DA-1DB460D64046,"iPhone13,2"
com.apple.news,84,1739984289,1739984373,1739984373.35294,-21600,EB445137-D7F5-57EC-87DA-1DB460D64046,"iPhone13,2"
com.apple.Health,5,1739984276,1739984281,1739984281.186417,-21600,EB445137-D7F5-57EC-87DA-1DB460D64046,"iPhone13,2"
com.google.Sheets,75,1739984195,1739984270,1739984270.221566,-21600,EB445137-D7F5-57EC-87DA-1DB460D64046,"iPhone13,2"
com.tinyspeck.chatlyio,19,1739984176,1739984195,1739984195.929076,-21600,EB445137-D7F5-57EC-87DA-1DB460D64046,"iPhone13,2"
com.tinyspeck.chatlyio,37,1739983945,1739983982,1739983982.6868138,-21600,EB445137-D7F5-57EC-87DA-1DB460D64046,"iPhone13,2"
com.google.Chrome,13,1739983871,1739983884,1739983884.6242929,-21600,,
com.apple.finder,16,1739983855,1739983871,1739983871.075613,-21600,,
com.google.Chrome,114,1739983741,1739983855,1739983855.847914,-21600,,
com.microsoft.VSCode,20,1739983721,1739983741,1739983742.430169,-21600,,
com.google.Chrome,186,1739983535,1739983721,1739983721.551571,-21600,,
com.apple.finder,1,1739983508,1739983509,1739983509.709688,-21600,,
com.microsoft.VSCode,20,1739983488,1739983508,1739983508.86375,-21600,,
com.google.Chrome,14,1739983474,1739983488,1739983488.457052,-21600,,
com.microsoft.VSCode,7,1739983467,1739983474,1739983474.429932,-21600,,
com.google.Chrome,23,1739983444,1739983467,1739983467.558783,-21600,,
com.microsoft.VSCode,33,1739983411,1739983444,1739983444.407428,-21600,,
com.apple.finder,4,1739983407,1739983411,1739983411.39638,-21600,,
com.microsoft.VSCode,59,1739983348,1739983407,1739983407.537871,-21600,,
com.apple.finder,38,1739983310,1739983348,1739983348.334638,-21600,,
com.microsoft.VSCode,22,1739983288,1739983310,1739983310.529844,-21600,,
com.google.Chrome,5,1739983283,1739983288,1739983288.798706,-21600,,
com.microsoft.VSCode,6,1739983277,1739983283,1739983283.960733,-21600,,
com.google.Chrome,12,1739983265,1739983277,1739983277.2145529,-21600,,
com.microsoft.VSCode,7,1739983258,1739983265,1739983265.951798,-21600,,
com.apple.finder,23,1739983235,1739983258,1739983258.328232,-21600,,
com.microsoft.VSCode,1,1739983234,1739983235,1739983235.933294,-21600,,
com.apple.finder,2,1739983232,1739983234,1739983234.849468,-21600,,
com.microsoft.VSCode,22,1739983210,1739983232,1739983232.805097,-21600,,
com.apple.finder,43,1739983167,1739983210,1739983210.6353102,-21600,,
com.microsoft.VSCode,14,1739983153,1739983167,1739983167.198921,-21600,,
com.apple.finder,1,1739983152,1739983153,1739983153.3250499,-21600,,
com.google.Chrome,4,1739983148,1739983152,1739983152.396638,-21600,,
com.apple.finder,1,1739983147,1739983148,1739983148.943183,-21600,,
com.microsoft.VSCode,212,1739982935,1739983147,1739983147.4920301,-21600,,
com.google.Chrome,83,1739982852,1739982935,1739982935.562721,-21600,,
com.microsoft.VSCode,136,1739982716,1739982852,1739982852.893581,-21600,,
com.google.Chrome,54,1739982662,1739982716,1739982716.1915212,-21600,,
com.apple.CoreAuthUI,2,1739979994,1739979996,1739979996.3431559,-21600,EB445137-D7F5-57EC-87DA-1DB460D64046,"iPhone13,2"
com.ally.MobileBanking,230,1739979986,1739980216,1739980217.091066,-21600,EB445137-D7F5-57EC-87DA-1DB460D64046,"iPhone13,2"
com.apple.weather,8,1739979916,1739979924,1739979924.777094,-21600,EB445137-D7F5-57EC-87DA-1DB460D64046,"iPhone13,2"
com.ryansponzilli.DeepSkyCatalog,35,1739979877,1739979912,1739979912.232063,-21600,EB445137-D7F5-57EC-87DA-1DB460D64046,"iPhone13,2"
com.google.chrome.ios,7,1739979870,1739979877,1739979877.783216,-21600,EB445137-D7F5-57EC-87DA-1DB460D64046,"iPhone13,2"
com.ryansponzilli.DeepSkyCatalog,173,1739979697,1739979870,1739979871.0074968,-21600,EB445137-D7F5-57EC-87DA-1DB460D64046,"iPhone13,2"
com.tier9digital.sundial,26,1739979668,1739979694,1739979694.662317,-21600,EB445137-D7F5-57EC-87DA-1DB460D64046,"iPhone13,2"
Astrospheric.Astrospheric,23,1739979644,1739979667,1739979668.006382,-21600,EB445137-D7F5-57EC-87DA-1DB460D64046,"iPhone13,2"
com.apple.weather,58,1739979581,1739979639,1739979639.162786,-21600,EB445137-D7F5-57EC-87DA-1DB460D64046,"iPhone13,2"
com.hammerandchisel.discord,107,1739979380,1739979487,1739979487.95547,-21600,EB445137-D7F5-57EC-87DA-1DB460D64046,"iPhone13,2"
com.google.Chrome,9,1739979361,1739979370,1739979370.978242,-21600,,
com.leomehlig.today,70,1739979291,1739979361,1739979361.721181,-21600,,
com.google.Chrome,2,1739979289,1739979291,1739979291.565644,-21600,,
com.leomehlig.today,66,1739979223,1739979289,1739979289.576983,-21600,,
com.google.Chrome,8,1739979215,1739979223,1739979223.4484181,-21600,,
com.leomehlig.today,11,1739979204,1739979215,1739979215.623709,-21600,,
com.google.Chrome,115,1739979089,1739979204,1739979204.336112,-21600,,
com.leomehlig.today,54,1739979035,1739979089,1739979089.348339,-21600,,
com.apple.finder,3,1739979032,1739979035,1739979035.31312,-21600,,
com.google.Chrome,84,1739978948,1739979032,1739979032.570818,-21600,,
com.apple.Preview,371,1739978577,1739978948,1739978948.216351,-21600,,
com.google.Chrome,219,1739978358,1739978577,1739978577.241829,-21600,,
com.apple.Preview,46,1739978312,1739978358,1739978358.69585,-21600,,
com.google.Chrome,167,1739978145,1739978312,1739978312.4099898,-21600,,
com.google.Chrome,309,1739977833,1739978142,1739978142.09814,-21600,,
com.apple.Preview,9,1739977824,1739977833,1739977833.7749162,-21600,,
com.google.Chrome,23,1739977801,1739977824,1739977824.8296452,-21600,,
com.apple.Preview,0,1739977801,1739977801,1739977801.718471,-21600,,
com.google.Chrome,15,1739977786,1739977801,1739977801.081109,-21600,,
com.apple.Preview,169,1739977617,1739977786,1739977786.596352,-21600,,
com.apple.finder,11,1739977606,1739977617,1739977617.681889,-21600,,
com.apple.CoreAuthUI,2,1739977269,1739977271,1739977271.49951,-21600,EB445137-D7F5-57EC-87DA-1DB460D64046,"iPhone13,2"
com.truebill.truebillnative,81,1739977267,1739977348,1739977348.5524879,-21600,EB445137-D7F5-57EC-87DA-1DB460D64046,"iPhone13,2"
com.intsig.CamScannerLite,1,1739977264,1739977265,1739977266.10977,-21600,EB445137-D7F5-57EC-87DA-1DB460D64046,"iPhone13,2"
com.google.Chrome,373,1739977233,1739977606,1739977606.280556,-21600,,
com.apple.Preview,6,1739977227,1739977233,1739977233.283022,-21600,,
com.intsig.CamScannerLite,141,1739977080,1739977221,1739977221.5873241,-21600,EB445137-D7F5-57EC-87DA-1DB460D64046,"iPhone13,2"
com.apple.finder,171,1739977056,1739977227,1739977227.1418118,-21600,,
com.google.Chrome,47,1739977009,1739977056,1739977056.9627252,-21600,,
com.leomehlig.today,4,1739977005,1739977009,1739977010.064158,-21600,,
com.apple.mobileslideshow,27,1739976883,1739976910,1739976911.079289,-21600,EB445137-D7F5-57EC-87DA-1DB460D64046,"iPhone13,2"
com.renpho.health,1,1739976882,1739976883,1739976884.069294,-21600,EB445137-D7F5-57EC-87DA-1DB460D64046,"iPhone13,2"
com.renpho.health,85,1739975339,1739975424,1739975424.726389,-21600,EB445137-D7F5-57EC-87DA-1DB460D64046,"iPhone13,2"
com.tinyspeck.chatlyio,33,1739974757,1739974790,1739974790.924588,-21600,EB445137-D7F5-57EC-87DA-1DB460D64046,"iPhone13,2"
com.hammerandchisel.discord,4,1739974720,1739974724,1739974724.991063,-21600,EB445137-D7F5-57EC-87DA-1DB460D64046,"iPhone13,2"
com.hammerandchisel.discord,6,1739974712,1739974718,1739974718.6812282,-21600,EB445137-D7F5-57EC-87DA-1DB460D64046,"iPhone13,2"
com.apple.stocks,3,1739974705,1739974708,1739974708.440833,-21600,EB445137-D7F5-57EC-87DA-1DB460D64046,"iPhone13,2"
com.apple.Health,38,1739974647,1739974685,1739974685.9785318,-21600,EB445137-D7F5-57EC-87DA-1DB460D64046,"iPhone13,2"
com.hammerandchisel.discord,10,1739974597,1739974607,1739974607.571043,-21600,EB445137-D7F5-57EC-87DA-1DB460D64046,"iPhone13,2"
com.letterboxd.LetterboxdApp,2,1739974594,1739974596,1739974597.112154,-21600,EB445137-D7F5-57EC-87DA-1DB460D64046,"iPhone13,2"
com.apple.journal,615,1739942844,1739943459,1739943459.563858,-21600,EB445137-D7F5-57EC-87DA-1DB460D64046,"iPhone13,2"
com.apple.CoreAuthUI,4,1739942429,1739942433,1739942433.526871,-21600,EB445137-D7F5-57EC-87DA-1DB460D64046,"iPhone13,2"
com.apple.journal,415,1739942427,1739942842,1739942842.366156,-21600,EB445137-D7F5-57EC-87DA-1DB460D64046,"iPhone13,2"
com.apple.Health,13,1739942413,1739942426,1739942426.41417,-21600,EB445137-D7F5-57EC-87DA-1DB460D64046,"iPhone13,2"
com.tinyspeck.chatlyio,21,1739942203,1739942224,1739942224.200132,-21600,EB445137-D7F5-57EC-87DA-1DB460D64046,"iPhone13,2"
com.thestorygraph.thestorygraph,14,1739942185,1739942199,1739942199.150536,-21600,EB445137-D7F5-57EC-87DA-1DB460D64046,"iPhone13,2"
com.leomehlig.today,23,1739940014,1739940037,1739940037.586347,-21600,,
com.apple.finder,1,1739940013,1739940014,1739940014.936027,-21600,,
com.apple.finder,3,1739939868,1739939871,1739939871.770143,-21600,,
com.microsoft.VSCode,2,1739939866,1739939868,1739939868.80142,-21600,,
com.google.Chrome,184,1739939682,1739939866,1739939866.2766252,-21600,,
com.apple.finder,3,1739939679,1739939682,1739939682.538157,-21600,,
com.google.Chrome,81,1739939598,1739939679,1739939679.5100179,-21600,,
com.apple.finder,35,1739939545,1739939580,1739939580.692844,-21600,,
com.google.Chrome,122,1739939423,1739939545,1739939545.491087,-21600,,
com.apple.finder,7,1739939416,1739939423,1739939423.615755,-21600,,
com.google.Chrome,74,1739939342,1739939416,1739939416.6157951,-21600,,
com.apple.finder,20,1739939310,1739939330,1739939330.2862868,-21600,,
com.google.Chrome,63,1739939247,1739939310,1739939310.219767,-21600,,
com.apple.Notes,144,1739939077,1739939221,1739939221.947393,-21600,,
com.google.Chrome,38,1739939039,1739939077,1739939077.854178,-21600,,
com.apple.finder,104,1739938935,1739939039,1739939039.271292,-21600,,
com.google.Chrome,35,1739938900,1739938935,1739938935.581833,-21600,,
com.apple.finder,46,1739938854,1739938900,1739938900.250829,-21600,,
com.apple.Preview,2,1739938852,1739938854,1739938854.144747,-21600,,
com.apple.finder,33,1739938819,1739938852,1739938852.6796231,-21600,,
com.microsoft.VSCode,2,1739938817,1739938819,1739938819.8979058,-21600,,
com.google.Chrome,4,1739938813,1739938817,1739938817.747614,-21600,,
com.apple.finder,45,1739938768,1739938813,1739938813.810193,-21600,,
com.google.Chrome,5,1739938763,1739938768,1739938768.437571,-21600,,
com.apple.finder,21,1739938742,1739938763,1739938763.208551,-21600,,
com.microsoft.VSCode,4,1739938738,1739938742,1739938742.341855,-21600,,
com.apple.finder,2,1739938736,1739938738,1739938738.0931358,-21600,,
com.microsoft.VSCode,63,1739938673,1739938736,1739938736.5427089,-21600,,
com.apple.finder,9,1739938664,1739938673,1739938673.966846,-21600,,
com.microsoft.VSCode,26,1739938638,1739938664,1739938664.814224,-21600,,
com.apple.finder,8,1739938630,1739938638,1739938638.204541,-21600,,
com.microsoft.VSCode,31,1739938599,1739938630,1739938630.665053,-21600,,
com.apple.finder,2,1739938597,1739938599,1739938599.785715,-21600,,
com.microsoft.VSCode,5,1739938592,1739938597,1739938597.647728,-21600,,
com.apple.finder,4,1739938588,1739938592,1739938592.461242,-21600,,
com.microsoft.VSCode,20,1739938568,1739938588,1739938588.584933,-21600,,
com.google.Chrome,3,1739938565,1739938568,1739938568.259602,-21600,,
com.microsoft.VSCode,4,1739938561,1739938565,1739938565.964571,-21600,,
com.google.Chrome,2,1739938559,1739938561,1739938561.6987948,-21600,,
com.microsoft.VSCode,3,1739938556,1739938559,1739938559.6394858,-21600,,
com.google.Chrome,2,1739938554,1739938556,1739938556.737245,-21600,,
com.microsoft.VSCode,4,1739938550,1739938554,1739938554.710981,-21600,,
com.google.Chrome,2,1739938548,1739938550,1739938550.628576,-21600,,
com.microsoft.VSCode,4,1739938544,1739938548,1739938548.712461,-21600,,
com.google.Chrome,3,1739938541,1739938544,1739938544.694315,-21600,,
com.microsoft.VSCode,5,1739938536,1739938541,1739938542.112587,-21600,,
com.google.Chrome,21,1739938515,1739938536,1739938536.8697991,-21600,,
com.microsoft.VSCode,98,1739938417,1739938515,1739938515.938023,-21600,,
com.google.Chrome,9,1739938408,1739938417,1739938417.1820722,-21600,,
com.microsoft.VSCode,1,1739938407,1739938408,1739938408.827807,-21600,,
com.apple.finder,10,1739938397,1739938407,1739938407.266881,-21600,,
com.google.Chrome,68,1739938329,1739938397,1739938397.505165,-21600,,
com.apple.finder,16,1739938313,1739938329,1739938329.90703,-21600,,
com.google.Chrome,23,1739938290,1739938313,1739938313.741375,-21600,,
com.apple.finder,71,1739938219,1739938290,1739938290.6478791,-21600,,
com.google.Chrome,5,1739938214,1739938219,1739938220.035232,-21600,,
com.apple.finder,11,1739938203,1739938214,1739938214.774753,-21600,,
com.google.Chrome,15,1739938188,1739938203,1739938203.988996,-21600,,
com.apple.finder,2,1739938186,1739938188,1739938188.585887,-21600,,
com.google.Chrome,5,1739938181,1739938186,1739938186.301645,-21600,,
com.electron.carta,3,1739938178,1739938181,1739938181.713963,-21600,,
com.google.Chrome,4,1739938174,1739938178,1739938178.543952,-21600,,
com.apple.finder,1,1739938173,1739938174,1739938174.843145,-21600,,
com.google.Chrome,2,1739938171,1739938173,1739938173.697453,-21600,,
com.apple.finder,2,1739938169,1739938171,1739938171.9331,-21600,,
com.google.Chrome,13,1739938156,1739938169,1739938169.060401,-21600,,
com.apple.finder,212,1739937944,1739938156,1739938156.9028149,-21600,,
com.google.Chrome,60,1739937884,1739937944,1739937944.36369,-21600,,
com.apple.finder,23,1739937861,1739937884,1739937884.984764,-21600,,
com.google.Chrome,13,1739937848,1739937861,1739937861.037187,-21600,,
com.apple.finder,11,1739937837,1739937848,1739937848.449065,-21600,,
com.google.Chrome,16,1739937821,1739937837,1739937837.571154,-21600,,
com.electron.carta,2,1739937819,1739937821,1739937821.814537,-21600,,
com.google.Chrome,35,1739937784,1739937819,1739937819.322428,-21600,,
com.electron.carta,41,1739937743,1739937784,1739937784.318647,-21600,,
com.jinzhenyu.ruler,4,1739937739,1739937743,1739937743.269208,-21600,,
com.google.Chrome,19,1739937720,1739937739,1739937739.650608,-21600,,
com.jinzhenyu.ruler,2,1739937718,1739937720,1739937720.3156261,-21600,,
com.google.Chrome,18,1739937700,1739937718,1739937718.222962,-21600,,
com.jinzhenyu.ruler,14,1739937686,1739937700,1739937700.2652059,-21600,,
com.electron.carta,27,1739937659,1739937686,1739937687.0023742,-21600,,
com.google.Chrome,64,1739937595,1739937659,1739937659.8437529,-21600,,
com.electron.carta,29,1739937566,1739937595,1739937595.976447,-21600,,
com.google.Chrome,33,1739937533,1739937566,1739937566.841785,-21600,,
com.electron.carta,37,1739937496,1739937533,1739937533.892607,-21600,,
com.google.Chrome,27,1739937469,1739937496,1739937496.0731921,-21600,,
com.electron.carta,56,1739937413,1739937469,1739937469.515996,-21600,,
com.jinzhenyu.ruler,4,1739937409,1739937413,1739937413.1659179,-21600,,
com.google.Chrome,12,1739937397,1739937409,1739937409.350438,-21600,,
com.jinzhenyu.ruler,2,1739937395,1739937397,1739937397.725586,-21600,,
com.google.Chrome,9,1739937386,1739937395,1739937395.7851791,-21600,,
com.jinzhenyu.ruler,16,1739937370,1739937386,1739937387.062599,-21600,,
com.electron.carta,1,1739937369,1739937370,1739937370.367491,-21600,,
com.jinzhenyu.ruler,6,1739937363,1739937369,1739937369.5375319,-21600,,
com.electron.carta,2,1739937361,1739937363,1739937363.043079,-21600,,
com.jinzhenyu.ruler,1,1739937360,1739937361,1739937361.799288,-21600,,
com.electron.carta,0,1739937360,1739937360,1739937360.684303,-21600,,
com.jinzhenyu.ruler,4,1739937356,1739937360,1739937360.065693,-21600,,
com.electron.carta,43,1739937313,1739937356,1739937356.673456,-21600,,
com.google.Chrome,5,1739937308,1739937313,1739937313.198988,-21600,,
com.electron.carta,52,1739937256,1739937308,1739937309.0027928,-21600,,
com.jinzhenyu.ruler,8,1739937248,1739937256,1739937256.673172,-21600,,
com.electron.carta,21,1739937227,1739937248,1739937248.195878,-21600,,
com.apple.finder,7,1739937220,1739937227,1739937227.3472872,-21600,,
com.electron.carta,24,1739937196,1739937220,1739937220.754319,-21600,,
com.jinzhenyu.ruler,0,1739937196,1739937196,1739937196.7371368,-21600,,
com.electron.carta,10,1739937186,1739937196,1739937196.2732348,-21600,,
com.google.Chrome,55,1739937131,1739937186,1739937186.6461658,-21600,,
com.jinzhenyu.ruler,0,1739937131,1739937131,1739937131.996727,-21600,,
com.google.Chrome,2,1739937129,1739937131,1739937131.084758,-21600,,
com.electron.carta,4,1739937125,1739937129,1739937129.65926,-21600,,
com.google.Chrome,3,1739937122,1739937125,1739937125.2066278,-21600,,
com.electron.carta,9,1739937113,1739937122,1739937122.794168,-21600,,
com.jinzhenyu.ruler,1,1739937112,1739937113,1739937113.983419,-21600,,
com.electron.carta,2,1739937110,1739937112,1739937112.069272,-21600,,
com.jinzhenyu.ruler,12,1739937098,1739937110,1739937110.436435,-21600,,
com.electron.carta,3,1739937095,1739937098,1739937098.944946,-21600,,
com.jinzhenyu.ruler,2,1739937093,1739937095,1739937095.278491,-21600,,
com.electron.carta,59,1739937034,1739937093,1739937093.987082,-21600,,
com.google.Chrome,2,1739937032,1739937034,1739937034.721165,-21600,,
com.jinzhenyu.ruler,0,1739937032,1739937032,1739937032.600696,-21600,,
com.google.Chrome,15,1739937017,1739937032,1739937032.178062,-21600,,
com.jinzhenyu.ruler,3,1739937014,1739937017,1739937017.585742,-21600,,
com.google.Chrome,7,1739937007,1739937014,1739937014.627701,-21600,,
com.jinzhenyu.ruler,18,1739936989,1739937007,1739937007.803636,-21600,,
com.electron.carta,30,1739936959,1739936989,1739936989.573849,-21600,,
com.google.Chrome,3,1739936956,1739936959,1739936959.191042,-21600,,
com.electron.carta,18,1739936938,1739936956,1739936956.613318,-21600,,
com.google.Chrome,4,1739936934,1739936938,1739936938.3518329,-21600,,
com.electron.carta,76,1739936858,1739936934,1739936934.861494,-21600,,
com.apple.finder,10,1739936848,1739936858,1739936858.5795999,-21600,,
com.electron.carta,33,1739936815,1739936848,1739936848.078576,-21600,,
com.jinzhenyu.ruler,4,1739936811,1739936815,1739936815.131104,-21600,,
com.google.Chrome,24,1739936787,1739936811,1739936811.9777288,-21600,,
com.electron.carta,35,1739936752,1739936787,1739936787.67562,-21600,,
com.google.Chrome,1,1739936751,1739936752,1739936752.6600971,-21600,,
com.jinzhenyu.ruler,1,1739936750,1739936751,1739936751.347605,-21600,,
com.google.Chrome,22,1739936728,1739936750,1739936750.780102,-21600,,
com.jinzhenyu.ruler,2,1739936726,1739936728,1739936728.8260698,-21600,,
com.google.Chrome,11,1739936715,1739936726,1739936726.518166,-21600,,
com.jinzhenyu.ruler,13,1739936702,1739936715,1739936715.498208,-21600,,
com.electron.carta,71,1739936631,1739936702,1739936702.335007,-21600,,
com.jinzhenyu.ruler,2,1739936629,1739936631,1739936631.3197699,-21600,,
com.google.Chrome,66,1739936563,1739936629,1739936629.379138,-21600,,
com.jinzhenyu.ruler,3,1739936560,1739936563,1739936564.072674,-21600,,
com.google.Chrome,8,1739936552,1739936560,1739936560.847907,-21600,,
com.jinzhenyu.ruler,18,1739936534,1739936552,1739936552.3147821,-21600,,
com.electron.carta,23,1739936511,1739936534,1739936534.262505,-21600,,
com.jinzhenyu.ruler,1,1739936510,1739936511,1739936511.5470638,-21600,,
com.electron.carta,55,1739936455,1739936510,1739936510.426876,-21600,,
com.google.Chrome,2,1739936453,1739936455,1739936455.7421699,-21600,,
com.jinzhenyu.ruler,0,1739936453,1739936453,1739936454.0342941,-21600,,
com.google.Chrome,14,1739936439,1739936453,1739936453.32234,-21600,,
com.jinzhenyu.ruler,5,1739936434,1739936439,1739936439.682672,-21600,,
com.google.Chrome,0,1739936434,1739936434,1739936435.0106502,-21600,,
com.jinzhenyu.ruler,2,1739936432,1739936434,1739936434.7153568,-21600,,
com.google.Chrome,6,1739936426,1739936432,1739936432.971085,-21600,,
com.jinzhenyu.ruler,14,1739936412,1739936426,1739936426.596757,-21600,,
com.electron.carta,6,1739936406,1739936412,1739936412.087681,-21600,,
com.google.Chrome,25,1739936381,1739936406,1739936406.40422,-21600,,
com.electron.carta,33,1739936348,1739936381,1739936381.296907,-21600,,
com.google.Chrome,6,1739936342,1739936348,1739936348.764687,-21600,,
com.electron.carta,36,1739936306,1739936342,1739936343.082611,-21600,,
com.apple.finder,12,1739936294,1739936306,1739936306.370111,-21600,,
com.electron.carta,82,1739936212,1739936294,1739936295.048311,-21600,,
com.apple.finder,6,1739936206,1739936212,1739936212.927782,-21600,,
com.electron.carta,31,1739936175,1739936206,1739936206.992254,-21600,,
com.apple.finder,7,1739936168,1739936175,1739936175.3102489,-21600,,
com.electron.carta,3,1739936165,1739936168,1739936168.694385,-21600,,
com.jinzhenyu.ruler,1,1739936164,1739936165,1739936165.4824781,-21600,,
com.electron.carta,1,1739936163,1739936164,1739936164.299089,-21600,,
com.jinzhenyu.ruler,1,1739936162,1739936163,1739936163.44645,-21600,,
com.google.Chrome,35,1739936127,1739936162,1739936162.218163,-21600,,
com.jinzhenyu.ruler,3,1739936124,1739936127,1739936127.527211,-21600,,
com.google.Chrome,6,1739936118,1739936124,1739936125.047749,-21600,,
com.jinzhenyu.ruler,22,1739936096,1739936118,1739936118.165533,-21600,,
com.electron.carta,36,1739936060,1739936096,1739936096.4724622,-21600,,
com.google.Chrome,15,1739936045,1739936060,1739936060.321031,-21600,,
com.jinzhenyu.ruler,0,1739936045,1739936045,1739936045.883285,-21600,,
com.google.Chrome,3,1739936042,1739936045,1739936045.643804,-21600,,
com.electron.carta,142,1739935900,1739936042,1739936042.251989,-21600,,
com.jinzhenyu.ruler,3,1739935897,1739935900,1739935900.269222,-21600,,
com.google.Chrome,1,1739935896,1739935897,1739935897.355134,-21600,,
com.jinzhenyu.ruler,1,1739935895,1739935896,1739935896.683848,-21600,,
com.google.Chrome,21,1739935874,1739935895,1739935895.756744,-21600,,
com.jinzhenyu.ruler,2,1739935872,1739935874,1739935874.742979,-21600,,
com.google.Chrome,10,1739935862,1739935872,1739935872.542907,-21600,,
com.jinzhenyu.ruler,16,1739935846,1739935862,1739935862.811606,-21600,,
com.electron.carta,1,1739935845,1739935846,1739935846.456862,-21600,,
com.jinzhenyu.ruler,3,1739935842,1739935845,1739935845.674897,-21600,,
com.google.Chrome,33,1739935809,1739935842,1739935842.0973082,-21600,,
com.electron.carta,40,1739935769,1739935809,1739935809.2797608,-21600,,
com.google.Chrome,5,1739935764,1739935769,1739935769.250098,-21600,,
com.electron.carta,130,1739935634,1739935764,1739935764.528038,-21600,,
com.google.Chrome,9,1739935625,1739935634,1739935634.4615378,-21600,,
com.electron.carta,18,1739935607,1739935625,1739935625.326746,-21600,,
com.apple.finder,2,1739935605,1739935607,1739935607.817344,-21600,,
com.electron.carta,6,1739935599,1739935605,1739935605.748801,-21600,,
com.apple.finder,15,1739935584,1739935599,1739935599.499691,-21600,,
com.electron.carta,26,1739935558,1739935584,1739935584.4281158,-21600,,
com.jinzhenyu.ruler,3,1739935555,1739935558,1739935558.322427,-21600,,
com.google.Chrome,77,1739935478,1739935555,1739935555.9875069,-21600,,
com.jinzhenyu.ruler,3,1739935475,1739935478,1739935478.206558,-21600,,
com.google.Chrome,6,1739935469,1739935475,1739935475.11029,-21600,,
com.jinzhenyu.ruler,14,1739935455,1739935469,1739935469.273181,-21600,,
com.electron.carta,50,1739935405,1739935455,1739935455.940024,-21600,,
com.google.Chrome,116,1739935289,1739935405,1739935405.990421,-21600,,
com.electron.carta,41,1739935248,1739935289,1739935289.3437839,-21600,,
com.jinzhenyu.ruler,4,1739935244,1739935248,1739935248.6505609,-21600,,
com.electron.carta,2,1739935242,1739935244,1739935244.701418,-21600,,
com.apple.finder,2,1739935240,1739935242,1739935242.387085,-21600,,
com.google.Chrome,21,1739935219,1739935240,1739935240.374649,-21600,,
com.apple.finder,0,1739935219,1739935219,1739935220.041986,-21600,,
com.google.Chrome,8,1739935211,1739935219,1739935219.05411,-21600,,
com.apple.finder,9,1739935202,1739935211,1739935211.31313,-21600,,
com.google.Chrome,17,1739935185,1739935202,1739935202.716727,-21600,,
com.electron.carta,5,1739935180,1739935185,1739935185.822016,-21600,,
com.jinzhenyu.ruler,39,1739935141,1739935180,1739935180.877166,-21600,,
com.electron.carta,150,1739934991,1739935141,1739935141.973095,-21600,,
com.google.Chrome,8,1739934983,1739934991,1739934991.44257,-21600,,
com.electron.carta,115,1739934868,1739934983,1739934983.586956,-21600,,
com.apple.finder,13,1739934855,1739934868,1739934868.31772,-21600,,
com.google.Chrome,1,1739934854,1739934855,1739934855.174839,-21600,,
com.electron.carta,48,1739934806,1739934854,1739934854.390239,-21600,,
com.google.Chrome,6,1739934800,1739934806,1739934806.5433211,-21600,,
com.apple.finder,5,1739934795,1739934800,1739934800.090971,-21600,,
com.google.Chrome,1,1739934794,1739934795,1739934795.03123,-21600,,
com.apple.finder,66,1739934728,1739934794,1739934794.707799,-21600,,
com.electron.carta,18,1739934710,1739934728,1739934728.065161,-21600,,
com.google.Chrome,25,1739934685,1739934710,1739934711.013,-21600,,
com.apple.finder,55,1739934630,1739934685,1739934685.453844,-21600,,
com.apple.systempreferences,23,1739934607,1739934630,1739934631.014415,-21600,,
com.apple.finder,14,1739934593,1739934607,1739934607.998258,-21600,,
com.leomehlig.today,1,1739934585,1739934586,1739934586.5285978,-21600,,
com.apple.finder,2,1739934583,1739934585,1739934585.8991961,-21600,,
com.leomehlig.today,1,1739934582,1739934583,1739934583.129403,-21600,,
com.apple.finder,13,1739934569,1739934582,1739934582.683086,-21600,,
com.leomehlig.today,4,1739934565,1739934569,1739934569.3588228,-21600,,
com.google.Chrome,3,1739934562,1739934565,1739934565.610591,-21600,,
com.google.Chrome,369,1739932447,1739932816,1739932817.121612,-21600,,
com.google.Chrome,157,1739931976,1739932133,1739932133.665365,-21600,,
com.leomehlig.today,3,1739931973,1739931976,1739931976.179754,-21600,,
com.leomehlig.today,87,1739931520,1739931607,1739931607.2282372,-21600,,
com.apple.iCal,4,1739931516,1739931520,1739931520.650916,-21600,,
com.leomehlig.today,59,1739931457,1739931516,1739931516.676952,-21600,,
com.google.Chrome,186,1739931271,1739931457,1739931457.1391091,-21600,,
com.google.Chrome,484,1739930644,1739931128,1739931128.729792,-21600,,
com.leomehlig.today,15,1739930580,1739930595,1739930596.059314,-21600,,
com.google.Chrome,749,1739929831,1739930580,1739930580.423203,-21600,,
com.google.Chrome,308,1739929522,1739929830,1739929830.348721,-21600,,
com.apple.weather,21,1739929501,1739929522,1739929522.289604,-21600,,
com.google.Chrome,501,1739929000,1739929501,1739929501.81482,-21600,,
com.leomehlig.today,57,1739928943,1739929000,1739929000.9343019,-21600,,
com.google.chrome.ios,87,1739925790,1739925877,1739925878.34639,-21600,EB445137-D7F5-57EC-87DA-1DB460D64046,"iPhone13,2"
com.groupme.iphone-app,3,1739925769,1739925772,1739925772.6559339,-21600,EB445137-D7F5-57EC-87DA-1DB460D64046,"iPhone13,2"
com.myfitnesspal.mfp,558,1739925210,1739925768,1739925768.406903,-21600,EB445137-D7F5-57EC-87DA-1DB460D64046,"iPhone13,2"
com.myfitnesspal.mfp,35,1739925010,1739925045,1739925046.126934,-21600,EB445137-D7F5-57EC-87DA-1DB460D64046,"iPhone13,2"
com.apple.Health,93,1739923175,1739923268,1739923268.6661448,-21600,EB445137-D7F5-57EC-87DA-1DB460D64046,"iPhone13,2"
com.groupme.iphone-app,2,1739923170,1739923172,1739923172.776824,-21600,EB445137-D7F5-57EC-87DA-1DB460D64046,"iPhone13,2"
com.groupme.iphone-app,8,1739923024,1739923032,1739923032.576133,-21600,EB445137-D7F5-57EC-87DA-1DB460D64046,"iPhone13,2"
com.leomehlig.today,2,1739923022,1739923024,1739923024.195358,-21600,EB445137-D7F5-57EC-87DA-1DB460D64046,"iPhone13,2"
com.leomehlig.today,151,1739922784,1739922935,1739922935.617876,-21600,EB445137-D7F5-57EC-87DA-1DB460D64046,"iPhone13,2"
com.myfitnesspal.mfp,200,1739922576,1739922776,1739922776.573348,-21600,EB445137-D7F5-57EC-87DA-1DB460D64046,"iPhone13,2"
com.microsoft.Office.Outlook,26,1739922546,1739922572,1739922572.684579,-21600,EB445137-D7F5-57EC-87DA-1DB460D64046,"iPhone13,2"
com.google.Gmail,15,1739922530,1739922545,1739922545.628468,-21600,EB445137-D7F5-57EC-87DA-1DB460D64046,"iPhone13,2"
com.toyopagroup.picaboo,2,1739922523,1739922525,1739922525.770379,-21600,EB445137-D7F5-57EC-87DA-1DB460D64046,"iPhone13,2"
com.myfitnesspal.mfp,22,1739922336,1739922358,1739922358.306514,-21600,EB445137-D7F5-57EC-87DA-1DB460D64046,"iPhone13,2"
com.google.chrome.ios,2,1739922334,1739922336,1739922337.0505981,-21600,EB445137-D7F5-57EC-87DA-1DB460D64046,"iPhone13,2"
com.google.chrome.ios,223,1739918938,1739919161,1739919161.665746,-21600,EB445137-D7F5-57EC-87DA-1DB460D64046,"iPhone13,2"
com.google.chrome.ios,325,1739918518,1739918843,1739918843.235848,-21600,EB445137-D7F5-57EC-87DA-1DB460D64046,"iPhone13,2"
com.toyopagroup.picaboo,54,1739918463,1739918517,1739918517.8181381,-21600,EB445137-D7F5-57EC-87DA-1DB460D64046,"iPhone13,2"
com.myfitnesspal.mfp,9,1739915605,1739915614,1739915614.979819,-21600,EB445137-D7F5-57EC-87DA-1DB460D64046,"iPhone13,2"
com.myfitnesspal.mfp,30,1739915511,1739915541,1739915543.826947,-21600,EB445137-D7F5-57EC-87DA-1DB460D64046,"iPhone13,2"
com.apple.Health,1,1739915510,1739915511,1739915512.585382,-21600,EB445137-D7F5-57EC-87DA-1DB460D64046,"iPhone13,2"
com.myfitnesspal.mfp,0,1739915510,1739915510,1739915510.940315,-21600,EB445137-D7F5-57EC-87DA-1DB460D64046,"iPhone13,2"
com.myfitnesspal.mfp,15,1739915489,1739915504,1739915504.5592098,-21600,EB445137-D7F5-57EC-87DA-1DB460D64046,"iPhone13,2"
com.instructure.icanvas,16,1739915426,1739915442,1739915442.226768,-21600,EB445137-D7F5-57EC-87DA-1DB460D64046,"iPhone13,2"
com.google.chrome.ios,0,1739915426,1739915426,1739915426.950067,-21600,EB445137-D7F5-57EC-87DA-1DB460D64046,"iPhone13,2"
com.google.chrome.ios,75,1739913962,1739914037,1739914038.157162,-21600,EB445137-D7F5-57EC-87DA-1DB460D64046,"iPhone13,2"
com.netflix.Netflix,2,1739908773,1739908775,1739908775.057697,-21600,EB445137-D7F5-57EC-87DA-1DB460D64046,"iPhone13,2"
com.google.chrome.ios,69,1739908704,1739908773,1739908773.644796,-21600,EB445137-D7F5-57EC-87DA-1DB460D64046,"iPhone13,2"
com.microsoft.Office.Outlook,27,1739908677,1739908704,1739908705.048561,-21600,EB445137-D7F5-57EC-87DA-1DB460D64046,"iPhone13,2"
com.microsoft.Office.Outlook,49,1739908614,1739908663,1739908663.797759,-21600,EB445137-D7F5-57EC-87DA-1DB460D64046,"iPhone13,2"
com.leomehlig.today,32,1739907252,1739907284,1739907284.438819,-21600,,
com.google.Chrome,891,1739906361,1739907252,1739907252.8927112,-21600,,
com.apple.Preview,165,1739906196,1739906361,1739906361.7905889,-21600,,
com.apple.finder,5,1739906191,1739906196,1739906196.669709,-21600,,
com.google.Chrome,83,1739906108,1739906191,1739906191.1150541,-21600,,
com.apple.finder,4,1739906104,1739906108,1739906108.2346,-21600,,
com.leomehlig.today,94,1739906010,1739906104,1739906104.8944302,-21600,,
com.google.Chrome,8,1739906002,1739906010,1739906010.987706,-21600,,
com.microsoft.Outlook,2,1739906000,1739906002,1739906002.568099,-21600,,
com.google.Chrome,1,1739905999,1739906000,1739906000.505358,-21600,,
com.leomehlig.today,5,1739905994,1739905999,1739905999.22651,-21600,,
com.google.ios.youtube,344,1739901001,1739901345,1739901345.240561,-21600,EB445137-D7F5-57EC-87DA-1DB460D64046,"iPhone13,2"
com.apple.weather,7,1739900992,1739900999,1739900999.6263108,-21600,EB445137-D7F5-57EC-87DA-1DB460D64046,"iPhone13,2"
com.google.ios.youtube,816,1739900119,1739900935,1739900935.728891,-21600,EB445137-D7F5-57EC-87DA-1DB460D64046,"iPhone13,2"
com.myfitnesspal.mfp,90,1739900027,1739900117,1739900117.277866,-21600,EB445137-D7F5-57EC-87DA-1DB460D64046,"iPhone13,2"
com.microsoft.Office.Outlook,6,1739900010,1739900016,1739900017.087851,-21600,EB445137-D7F5-57EC-87DA-1DB460D64046,"iPhone13,2"
com.microsoft.Office.Outlook,57,1739899342,1739899399,1739899400.25579,-21600,EB445137-D7F5-57EC-87DA-1DB460D64046,"iPhone13,2"
com.apple.Health,58,1739899283,1739899341,1739899341.40729,-21600,EB445137-D7F5-57EC-87DA-1DB460D64046,"iPhone13,2"
com.instructure.icanvas,0,1739899283,1739899283,1739899283.67002,-21600,EB445137-D7F5-57EC-87DA-1DB460D64046,"iPhone13,2"
com.instructure.icanvas,12,1739899241,1739899253,1739899253.62844,-21600,EB445137-D7F5-57EC-87DA-1DB460D64046,"iPhone13,2"
com.instructure.icanvas,47,1739899193,1739899240,1739899240.4912481,-21600,EB445137-D7F5-57EC-87DA-1DB460D64046,"iPhone13,2"
com.apple.mobilenotes,0,1739899193,1739899193,1739899193.796153,-21600,EB445137-D7F5-57EC-87DA-1DB460D64046,"iPhone13,2"
com.apple.mobilenotes,13,1739898268,1739898281,1739898281.467341,-21600,EB445137-D7F5-57EC-87DA-1DB460D64046,"iPhone13,2"
com.leomehlig.today,33,1739897944,1739897977,1739897977.431131,-21600,,
com.apple.finder,2,1739897942,1739897944,1739897944.2698212,-21600,,
com.apple.Notes,6,1739897936,1739897942,1739897942.872748,-21600,,
com.apple.finder,4,1739897932,1739897936,1739897936.708942,-21600,,
com.apple.Music,4,1739897928,1739897932,1739897932.716803,-21600,,
com.apple.finder,2,1739897926,1739897928,1739897928.9243069,-21600,,
com.apple.Music,2,1739897924,1739897926,1739897926.254766,-21600,,
com.apple.Notes,2,1739897916,1739897918,1739897918.3647928,-21600,,
com.apple.Music,3,1739897913,1739897916,1739897916.10378,-21600,,
com.electron.carta,1,1739897912,1739897913,1739897913.94656,-21600,,
com.apple.Music,1,1739897911,1739897912,1739897912.947314,-21600,,
com.apple.finder,1,1739897910,1739897911,1739897911.2999,-21600,,
com.microsoft.VSCode,3,1739897907,1739897910,1739897910.516107,-21600,,
com.apple.finder,3,1739897904,1739897907,1739897907.4006739,-21600,,
com.google.Chrome,44,1739897860,1739897904,1739897904.586088,-21600,,
com.apple.finder,4,1739897718,1739897722,1739897722.602109,-21600,,
com.google.Chrome,4,1739897714,1739897718,1739897718.501086,-21600,,
com.apple.finder,8,1739897706,1739897714,1739897714.955673,-21600,,
com.google.Chrome,3,1739897703,1739897706,1739897706.835778,-21600,,
com.apple.finder,2,1739897701,1739897703,1739897703.518215,-21600,,
com.google.Chrome,1,1739897700,1739897701,1739897702.016223,-21600,,
com.apple.finder,3,1739897697,1739897700,1739897700.420404,-21600,,
com.google.Chrome,1,1739897696,1739897697,1739897697.75915,-21600,,
com.apple.finder,2,1739897694,1739897696,1739897697.0068731,-21600,,
com.google.Chrome,7,1739897687,1739897694,1739897694.857609,-21600,,
com.apple.finder,4,1739897683,1739897687,1739897687.071125,-21600,,
com.google.Chrome,2,1739897681,1739897683,1739897683.826593,-21600,,
com.apple.finder,14,1739897667,1739897681,1739897681.427433,-21600,,
com.google.Chrome,3,1739897664,1739897667,1739897667.59621,-21600,,
com.apple.finder,8,1739897656,1739897664,1739897664.8368092,-21600,,
com.google.Chrome,3,1739897653,1739897656,1739897656.635514,-21600,,
com.apple.finder,3,1739897650,1739897653,1739897653.8817,-21600,,
com.google.Chrome,3,1739897647,1739897650,1739897650.049372,-21600,,
com.apple.finder,6,1739897641,1739897647,1739897647.122261,-21600,,
com.google.Chrome,3,1739897638,1739897641,1739897641.095972,-21600,,
com.apple.finder,8,1739897630,1739897638,1739897638.7454228,-21600,,
com.google.Chrome,84,1739897546,1739897630,1739897630.022093,-21600,,
com.apple.finder,7,1739897539,1739897546,1739897546.23896,-21600,,
com.google.Chrome,28,1739897511,1739897539,1739897539.793096,-21600,,
com.apple.finder,3,1739897508,1739897511,1739897511.663974,-21600,,
com.google.Chrome,6,1739897502,1739897508,1739897508.665001,-21600,,
com.apple.finder,11,1739897491,1739897502,1739897502.360388,-21600,,
com.google.Chrome,73,1739897418,1739897491,1739897491.324901,-21600,,
com.apple.Dictionary,2,1739897416,1739897418,1739897418.439165,-21600,,
com.google.Chrome,28,1739897388,1739897416,1739897416.530129,-21600,,
com.apple.finder,5,1739897383,1739897388,1739897388.349271,-21600,,
com.google.Chrome,6,1739897377,1739897383,1739897383.5710258,-21600,,
com.apple.finder,3,1739897374,1739897377,1739897377.1887012,-21600,,
com.google.Chrome,6,1739897368,1739897374,1739897374.485879,-21600,,
com.apple.finder,2,1739897366,1739897368,1739897369.0550718,-21600,,
com.google.Chrome,1,1739897365,1739897366,1739897366.711035,-21600,,
com.apple.finder,1,1739897364,1739897365,1739897365.1531,-21600,,
com.google.Chrome,8,1739897356,1739897364,1739897364.613779,-21600,,
com.apple.finder,1,1739897355,1739897356,1739897356.8784351,-21600,,
com.google.Chrome,39,1739897316,1739897355,1739897355.2402291,-21600,,
com.apple.finder,2,1739897314,1739897316,1739897316.741634,-21600,,
com.google.Chrome,6,1739897308,1739897314,1739897314.2689428,-21600,,
com.apple.finder,6,1739897302,1739897308,1739897308.4055161,-21600,,
com.google.Chrome,5,1739897297,1739897302,1739897302.189949,-21600,,
com.apple.finder,1,1739897296,1739897297,1739897297.2737908,-21600,,
com.google.Chrome,4,1739897292,1739897296,1739897296.131779,-21600,,
com.apple.finder,7,1739897285,1739897292,1739897292.658468,-21600,,
com.google.Chrome,7,1739897278,1739897285,1739897285.793685,-21600,,
com.apple.finder,6,1739897272,1739897278,1739897278.9976292,-21600,,
com.google.Chrome,6,1739897266,1739897272,1739897272.275888,-21600,,
com.apple.finder,5,1739897261,1739897266,1739897266.313287,-21600,,
com.google.Chrome,15,1739897246,1739897261,1739897261.0747209,-21600,,
com.apple.finder,4,1739897242,1739897246,1739897247.017986,-21600,,
com.google.Chrome,6,1739897236,1739897242,1739897243.021492,-21600,,
com.apple.finder,5,1739897231,1739897236,1739897236.406979,-21600,,
com.google.Chrome,19,1739897212,1739897231,1739897231.154758,-21600,,
com.apple.finder,6,1739897206,1739897212,1739897212.295192,-21600,,
com.google.Chrome,42,1739897164,1739897206,1739897206.249583,-21600,,
com.apple.finder,2,1739897162,1739897164,1739897164.255825,-21600,,
com.google.Chrome,18,1739897144,1739897162,1739897162.0794039,-21600,,
com.apple.finder,11,1739897133,1739897144,1739897144.5231981,-21600,,
com.google.Chrome,4,1739897129,1739897133,1739897133.265442,-21600,,
com.apple.finder,6,1739897123,1739897129,1739897129.099956,-21600,,
com.google.Chrome,2,1739897121,1739897123,1739897123.994813,-21600,,
com.apple.finder,12,1739897109,1739897121,1739897121.6925712,-21600,,
com.google.Chrome,3,1739897106,1739897109,1739897109.310388,-21600,,
com.apple.finder,30,1739897076,1739897106,1739897106.409225,-21600,,
com.google.Chrome,3,1739897073,1739897076,1739897076.629448,-21600,,
com.apple.finder,16,1739897057,1739897073,1739897073.2720551,-21600,,
com.google.Chrome,2,1739897055,1739897057,1739897057.698803,-21600,,
com.microsoft.VSCode,0,1739897055,1739897055,1739897056.001872,-21600,,
com.apple.finder,19,1739897036,1739897055,1739897055.078512,-21600,,
com.electron.carta,31,1739897005,1739897036,1739897036.469497,-21600,,
com.apple.finder,36,1739896969,1739897005,1739897005.290432,-21600,,
com.electron.carta,31,1739896938,1739896969,1739896969.454927,-21600,,
com.apple.finder,12,1739896926,1739896938,1739896938.683593,-21600,,
com.electron.carta,4,1739896922,1739896926,1739896926.7262568,-21600,,
com.apple.finder,25,1739896897,1739896922,1739896922.623014,-21600,,
com.electron.carta,66,1739896831,1739896897,1739896897.835654,-21600,,
com.apple.finder,18,1739896813,1739896831,1739896831.038916,-21600,,
com.electron.carta,45,1739896768,1739896813,1739896813.9234319,-21600,,
com.apple.finder,20,1739896748,1739896768,1739896768.746364,-21600,,
com.electron.carta,46,1739896702,1739896748,1739896748.3478842,-21600,,
com.apple.finder,30,1739896672,1739896702,1739896702.298269,-21600,,
com.electron.carta,71,1739896601,1739896672,1739896672.9822478,-21600,,
com.apple.finder,26,1739896575,1739896601,1739896601.405261,-21600,,
com.electron.carta,20,1739896555,1739896575,1739896575.794703,-21600,,
com.apple.finder,95,1739896460,1739896555,1739896555.314503,-21600,,
com.electron.carta,68,1739896392,1739896460,1739896460.6097121,-21600,,
com.apple.finder,106,1739896286,1739896392,1739896392.725874,-21600,,
com.apple.Notes,8,1739896278,1739896286,1739896286.144618,-21600,,
com.microsoft.VSCode,146,1739896132,1739896278,1739896278.390263,-21600,,
com.apple.finder,16,1739896116,1739896132,1739896133.001143,-21600,,
com.microsoft.VSCode,19,1739896097,1739896116,1739896116.237616,-21600,,
com.apple.finder,10,1739896087,1739896097,1739896097.610444,-21600,,
com.microsoft.VSCode,10,1739896077,1739896087,1739896087.9314032,-21600,,
com.google.Chrome,85,1739895992,1739896077,1739896077.926321,-21600,,
com.electron.carta,1,1739895991,1739895992,1739895992.749836,-21600,,
com.jinzhenyu.ruler,7,1739895984,1739895991,1739895991.186507,-21600,,
com.electron.carta,5,1739895979,1739895984,1739895984.2661061,-21600,,
com.jinzhenyu.ruler,6,1739895973,1739895979,1739895979.34728,-21600,,
com.google.Chrome,23,1739895950,1739895973,1739895973.776904,-21600,,
com.electron.carta,35,1739895915,1739895950,1739895950.859561,-21600,,
com.jinzhenyu.ruler,5,1739895910,1739895915,1739895915.055908,-21600,,
com.electron.carta,1,1739895909,1739895910,1739895911.013946,-21600,,
com.jinzhenyu.ruler,3,1739895906,1739895909,1739895909.632502,-21600,,
com.electron.carta,2,1739895904,1739895906,1739895907.012061,-21600,,
com.jinzhenyu.ruler,14,1739895890,1739895904,1739895904.448379,-21600,,
com.electron.carta,87,1739895803,1739895890,1739895890.486985,-21600,,
com.google.Chrome,30,1739895773,1739895803,1739895803.1837568,-21600,,
com.apple.finder,90,1739895683,1739895773,1739895773.421143,-21600,,
com.electron.carta,50,1739895633,1739895683,1739895683.836629,-21600,,
com.apple.finder,6,1739895627,1739895633,1739895633.939879,-21600,,
com.electron.carta,42,1739895585,1739895627,1739895627.5993462,-21600,,
com.google.Chrome,32,1739895553,1739895585,1739895585.396169,-21600,,
com.apple.Notes,12,1739895518,1739895530,1739895530.43826,-21600,,
com.microsoft.VSCode,126,1739895392,1739895518,1739895518.5152001,-21600,,
com.apple.finder,181,1739895211,1739895392,1739895392.1097841,-21600,,
com.microsoft.VSCode,7,1739895204,1739895211,1739895211.7456899,-21600,,
com.apple.finder,5,1739895199,1739895204,1739895204.345652,-21600,,
com.microsoft.VSCode,164,1739895035,1739895199,1739895199.4903831,-21600,,
com.apple.finder,38,1739894997,1739895035,1739895035.446737,-21600,,
com.microsoft.VSCode,46,1739894951,1739894997,1739894997.435066,-21600,,
com.apple.finder,11,1739894940,1739894951,1739894951.9775229,-21600,,
com.microsoft.VSCode,26,1739894914,1739894940,1739894940.7084498,-21600,,
com.apple.finder,15,1739894899,1739894914,1739894914.901463,-21600,,
com.microsoft.VSCode,228,1739894671,1739894899,1739894899.10178,-21600,,
com.apple.Music,1,1739894670,1739894671,1739894671.6873431,-21600,,
com.google.Chrome,5,1739894665,1739894670,1739894670.48534,-21600,,
com.apple.Music,1,1739894664,1739894665,1739894665.5477772,-21600,,
com.microsoft.VSCode,34,1739894630,1739894664,1739894664.178913,-21600,,
com.apple.Music,16,1739894614,1739894630,1739894630.1575332,-21600,,
com.microsoft.VSCode,3,1739894611,1739894614,1739894614.0693588,-21600,,
com.google.Chrome,68,1739894543,1739894611,1739894611.393219,-21600,,
com.apple.Notes,7,1739894536,1739894543,1739894543.798068,-21600,,
com.apple.finder,4,1739894532,1739894536,1739894536.852438,-21600,,
com.leomehlig.today,1,1739894531,1739894532,1739894532.830291,-21600,,
com.google.Chrome,60,1739894471,1739894531,1739894531.612835,-21600,,
com.leomehlig.today,40,1739894062,1739894102,1739894103.4639869,-21600,,
com.apple.iCal,4,1739894058,1739894062,1739894062.0892339,-21600,,
com.leomehlig.today,7,1739894051,1739894058,1739894058.344283,-21600,,
com.apple.iCal,1,1739894050,1739894051,1739894051.263875,-21600,,
com.google.Chrome,12,1739894038,1739894050,1739894050.6307669,-21600,,
com.google.Chrome,1175,1739891305,1739892480,1739892480.791709,-21600,,
com.apple.Preview,1,1739891304,1739891305,1739891305.957845,-21600,,
com.google.Chrome,2,1739891302,1739891304,1739891304.5277228,-21600,,
com.apple.Preview,1,1739891301,1739891302,1739891302.482261,-21600,,
com.google.Chrome,3,1739891298,1739891301,1739891301.423883,-21600,,
com.apple.Preview,3,1739891295,1739891298,1739891298.5505571,-21600,,
com.google.Chrome,2,1739891293,1739891295,1739891295.600147,-21600,,
com.apple.Preview,2,1739891291,1739891293,1739891294.02021,-21600,,
com.google.Chrome,11,1739891280,1739891291,1739891291.105987,-21600,,
com.apple.Preview,1,1739891279,1739891280,1739891280.648427,-21600,,
com.google.Chrome,2,1739891277,1739891279,1739891279.583045,-21600,,
com.apple.Preview,1,1739891276,1739891277,1739891277.417478,-21600,,
com.google.Chrome,2,1739891274,1739891276,1739891276.4089398,-21600,,
com.apple.Preview,1,1739891273,1739891274,1739891274.794886,-21600,,
com.google.Chrome,1,1739891272,1739891273,1739891273.901713,-21600,,
com.apple.Preview,2,1739891270,1739891272,1739891272.09306,-21600,,
com.google.Chrome,2,1739891268,1739891270,1739891271.019144,-21600,,
com.apple.Preview,1,1739891267,1739891268,1739891269.069035,-21600,,
com.google.Chrome,0,1739891267,1739891267,1739891267.6216412,-21600,,
com.apple.Preview,1,1739891266,1739891267,1739891267.2757978,-21600,,
com.apple.finder,2,1739891264,1739891266,1739891266.3419251,-21600,,
com.google.Chrome,2,1739891262,1739891264,1739891264.8768811,-21600,,
com.apple.finder,1,1739891261,1739891262,1739891262.41367,-21600,,
com.google.Chrome,3,1739891258,1739891261,1739891261.850146,-21600,,
com.apple.finder,2,1739891256,1739891258,1739891258.941462,-21600,,
com.apple.Preview,2,1739891254,1739891256,1739891256.9174762,-21600,,
com.apple.finder,2,1739891252,1739891254,1739891254.82534,-21600,,
com.google.Chrome,6,1739891246,1739891252,1739891252.744056,-21600,,
com.apple.finder,1,1739891245,1739891246,1739891246.57234,-21600,,
com.apple.Preview,2,1739891243,1739891245,1739891245.529254,-21600,,
com.apple.finder,2,1739891241,1739891243,1739891243.7098,-21600,,
com.google.Chrome,62,1739891179,1739891241,1739891241.961642,-21600,,
com.apple.Preview,191,1739890988,1739891179,1739891179.849527,-21600,,
com.google.Chrome,42,1739890946,1739890988,1739890988.484091,-21600,,
com.apple.Preview,2,1739890944,1739890946,1739890946.358025,-21600,,
com.google.Chrome,25,1739890919,1739890944,1739890944.095269,-21600,,
com.apple.Preview,6,1739890913,1739890919,1739890919.194828,-21600,,
com.google.Chrome,24,1739890889,1739890913,1739890913.134552,-21600,,
com.apple.Preview,14,1739890875,1739890889,1739890889.073608,-21600,,
com.google.Chrome,70,1739890805,1739890875,1739890875.3239331,-21600,,
com.apple.Preview,4,1739890801,1739890805,1739890805.308123,-21600,,
com.google.Chrome,79,1739890722,1739890801,1739890801.531687,-21600,,
com.apple.Preview,26,1739890696,1739890722,1739890722.914912,-21600,,
com.google.Chrome,81,1739890615,1739890696,1739890696.704492,-21600,,
com.apple.Preview,1,1739890614,1739890615,1739890615.2200851,-21600,,
com.google.Chrome,1,1739890613,1739890614,1739890614.419616,-21600,,
com.apple.Preview,3,1739890610,1739890613,1739890613.926,-21600,,
com.google.Chrome,9,1739890601,1739890610,1739890610.876312,-21600,,
com.apple.Preview,7,1739890594,1739890601,1739890601.191278,-21600,,
com.google.Chrome,115,1739890479,1739890594,1739890594.8227692,-21600,,
com.apple.Preview,0,1739890479,1739890479,1739890479.762291,-21600,,
com.google.Chrome,12,1739890467,1739890479,1739890479.147033,-21600,,
com.apple.Preview,18,1739890449,1739890467,1739890467.4675422,-21600,,
com.google.Chrome,169,1739890280,1739890449,1739890449.0849261,-21600,,
com.apple.Preview,2,1739890278,1739890280,1739890280.896179,-21600,,
com.google.Chrome,7,1739890271,1739890278,1739890278.751508,-21600,,
com.apple.Preview,17,1739890254,1739890271,1739890271.924961,-21600,,
com.google.Chrome,58,1739890196,1739890254,1739890254.4384608,-21600,,
com.apple.Preview,16,1739890180,1739890196,1739890196.626902,-21600,,
com.google.Chrome,205,1739889975,1739890180,1739890180.611836,-21600,,
com.apple.Preview,3,1739889972,1739889975,1739889975.433385,-21600,,
com.apple.finder,8,1739889964,1739889972,1739889972.26629,-21600,,
com.google.Chrome,63,1739889901,1739889964,1739889964.338851,-21600,,
com.apple.Health,8,1739889659,1739889667,1739889667.411408,-21600,EB445137-D7F5-57EC-87DA-1DB460D64046,"iPhone13,2"
com.apple.mobileslideshow,9,1739889648,1739889657,1739889657.9576778,-21600,EB445137-D7F5-57EC-87DA-1DB460D64046,"iPhone13,2"
com.renpho.health,1,1739889647,1739889648,1739889649.1192489,-21600,EB445137-D7F5-57EC-87DA-1DB460D64046,"iPhone13,2"
com.renpho.health,73,1739888526,1739888599,1739888599.346719,-21600,EB445137-D7F5-57EC-87DA-1DB460D64046,"iPhone13,2"
com.apple.weather,34,1739888168,1739888202,1739888202.2210479,-21600,EB445137-D7F5-57EC-87DA-1DB460D64046,"iPhone13,2"
com.apple.weather,9,1739856828,1739856837,1739856837.789177,-21600,EB445137-D7F5-57EC-87DA-1DB460D64046,"iPhone13,2"
com.thestorygraph.thestorygraph,33,1739856748,1739856781,1739856781.436342,-21600,EB445137-D7F5-57EC-87DA-1DB460D64046,"iPhone13,2"
Astrospheric.Astrospheric,2,1739856746,1739856748,1739856748.2005959,-21600,EB445137-D7F5-57EC-87DA-1DB460D64046,"iPhone13,2"
Astrospheric.Astrospheric,19,1739855042,1739855061,1739855061.57307,-21600,EB445137-D7F5-57EC-87DA-1DB460D64046,"iPhone13,2"
com.google.Chrome,687,1739853814,1739854501,1739854501.7039418,-21600,,
com.apple.finder,2,1739853812,1739853814,1739853815.1740851,-21600,,
com.apple.Music,13,1739853477,1739853490,1739853490.946758,-21600,EB445137-D7F5-57EC-87DA-1DB460D64046,"iPhone13,2"
com.apple.finder,26,1739852441,1739852467,1739852468.0365338,-21600,,
com.leomehlig.today,4,1739852437,1739852441,1739852441.587156,-21600,,
com.google.Chrome,277,1739852160,1739852437,1739852437.819581,-21600,,
com.apple.finder,0,1739852160,1739852160,1739852161.368089,-21600,,
com.apple.Music,10,1739850653,1739850663,1739850664.1837149,-21600,EB445137-D7F5-57EC-87DA-1DB460D64046,"iPhone13,2"
com.apple.Music,60,1739850155,1739850215,1739850215.692786,-21600,EB445137-D7F5-57EC-87DA-1DB460D64046,"iPhone13,2"
com.apple.weather,4,1739850149,1739850153,1739850153.843861,-21600,EB445137-D7F5-57EC-87DA-1DB460D64046,"iPhone13,2"
com.leomehlig.today,1,1739850148,1739850149,1739850150.38216,-21600,EB445137-D7F5-57EC-87DA-1DB460D64046,"iPhone13,2"
com.apple.finder,54,1739849720,1739849774,1739849774.488909,-21600,,
com.leomehlig.today,21,1739849699,1739849720,1739849721.025629,-21600,,
com.apple.finder,7,1739849692,1739849699,1739849699.396311,-21600,,
com.leomehlig.today,3,1739849689,1739849692,1739849692.292849,-21600,,
com.apple.finder,2,1739849687,1739849689,1739849689.652796,-21600,,
com.leomehlig.today,1,1739849686,1739849687,1739849687.7725282,-21600,,
com.apple.Preview,1,1739849685,1739849686,1739849686.720437,-21600,,
com.google.Chrome,39,1739849646,1739849685,1739849685.3069348,-21600,,
com.microsoft.VSCode,4,1739849642,1739849646,1739849646.328933,-21600,,
com.google.Chrome,1,1739849641,1739849642,1739849642.4030561,-21600,,
com.leomehlig.today,0,1739849641,1739849641,1739849641.4373078,-21600,,
com.google.Chrome,1,1739849640,1739849641,1739849641.192128,-21600,,
com.apple.finder,3,1739849621,1739849624,1739849624.414353,-21600,,
com.google.Chrome,2,1739849619,1739849621,1739849621.3890119,-21600,,
com.leomehlig.today,30,1739849581,1739849611,1739849611.680454,-21600,,
com.google.Chrome,2,1739849579,1739849581,1739849581.240641,-21600,,
com.apple.finder,3,1739849576,1739849579,1739849579.694344,-21600,,
com.apple.Notes,53,1739849523,1739849576,1739849577.028157,-21600,,
com.apple.finder,3,1739849520,1739849523,1739849523.68134,-21600,,
com.apple.Notes,1,1739849519,1739849520,1739849520.748029,-21600,,
com.apple.finder,197,1739849322,1739849519,1739849519.126754,-21600,,
com.apple.Notes,7,1739849315,1739849322,1739849322.7773209,-21600,,
com.apple.finder,1,1739849314,1739849315,1739849315.897845,-21600,,
com.apple.Notes,10,1739849304,1739849314,1739849314.51082,-21600,,
com.apple.finder,4,1739849300,1739849304,1739849304.266103,-21600,,
com.apple.Notes,3,1739849297,1739849300,1739849300.549519,-21600,,
com.apple.finder,4,1739849293,1739849297,1739849297.260172,-21600,,
com.apple.Notes,10,1739849283,1739849293,1739849293.621988,-21600,,
com.apple.finder,4,1739849279,1739849283,1739849283.3665361,-21600,,
com.apple.Notes,9,1739849270,1739849279,1739849279.0968552,-21600,,
com.apple.finder,1,1739849269,1739849270,1739849270.2999349,-21600,,
com.apple.Notes,16,1739849253,1739849269,1739849269.069982,-21600,,
com.apple.finder,45,1739849208,1739849253,1739849253.699267,-21600,,
com.google.Chrome,60,1739849148,1739849208,1739849208.429452,-21600,,
com.microsoft.VSCode,20,1739849128,1739849148,1739849148.591553,-21600,,
com.apple.Preview,1,1739849127,1739849128,1739849128.192786,-21600,,
com.microsoft.VSCode,17,1739849110,1739849127,1739849127.372911,-21600,,
com.apple.Preview,1,1739849109,1739849110,1739849110.369979,-21600,,
com.microsoft.VSCode,4,1739849105,1739849109,1739849109.074743,-21600,,
com.apple.Preview,2,1739849103,1739849105,1739849105.147177,-21600,,
com.microsoft.VSCode,4,1739849099,1739849103,1739849103.8713531,-21600,,
com.apple.Preview,1,1739849098,1739849099,1739849099.891093,-21600,,
com.microsoft.VSCode,8,1739849090,1739849098,1739849098.859225,-21600,,
com.apple.Preview,1,1739849089,1739849090,1739849090.596401,-21600,,
com.microsoft.VSCode,9,1739849080,1739849089,1739849089.778998,-21600,,
com.apple.Preview,7,1739849073,1739849080,1739849080.5037332,-21600,,
com.microsoft.VSCode,3,1739849070,1739849073,1739849073.918006,-21600,,
com.apple.Preview,2,1739849068,1739849070,1739849070.518458,-21600,,
com.microsoft.VSCode,78,1739848990,1739849068,1739849068.116197,-21600,,
com.apple.Preview,1,1739848989,1739848990,1739848990.615574,-21600,,
com.microsoft.VSCode,9,1739848980,1739848989,1739848989.9891682,-21600,,
com.apple.Preview,2,1739848978,1739848980,1739848980.903048,-21600,,
com.microsoft.VSCode,13,1739848965,1739848978,1739848978.8881822,-21600,,
com.apple.Preview,1,1739848964,1739848965,1739848965.540427,-21600,,
com.microsoft.VSCode,2,1739848962,1739848964,1739848964.08816,-21600,,
com.apple.Preview,2,1739848960,1739848962,1739848962.769051,-21600,,
com.microsoft.VSCode,1,1739848959,1739848960,1739848960.475218,-21600,,
com.apple.Preview,1,1739848958,1739848959,1739848959.6975389,-21600,,
com.microsoft.VSCode,1,1739848957,1739848958,1739848958.49936,-21600,,
com.apple.Preview,1,1739848956,1739848957,1739848957.7801561,-21600,,
com.microsoft.VSCode,1,1739848955,1739848956,1739848956.721545,-21600,,
com.apple.Preview,2,1739848953,1739848955,1739848955.119632,-21600,,
com.microsoft.VSCode,3,1739848950,1739848953,1739848953.996038,-21600,,
com.apple.Preview,1,1739848949,1739848950,1739848950.5891829,-21600,,
com.microsoft.VSCode,21,1739848928,1739848949,1739848949.578364,-21600,,
com.apple.finder,3,1739848925,1739848928,1739848928.742466,-21600,,
com.microsoft.VSCode,2,1739848923,1739848925,1739848925.607448,-21600,,
com.apple.finder,1,1739848922,1739848923,1739848923.967799,-21600,,
com.microsoft.VSCode,2,1739848920,1739848922,1739848922.4621181,-21600,,
com.apple.finder,2,1739848918,1739848920,1739848920.45594,-21600,,
com.microsoft.VSCode,2,1739848916,1739848918,1739848918.760798,-21600,,
com.apple.finder,2,1739848914,1739848916,1739848916.712778,-21600,,
com.microsoft.VSCode,2,1739848912,1739848914,1739848914.8331552,-21600,,
com.apple.finder,4,1739848908,1739848912,1739848912.9486542,-21600,,
com.microsoft.VSCode,3,1739848905,1739848908,1739848908.057806,-21600,,
com.apple.finder,2,1739848903,1739848905,1739848905.598331,-21600,,
com.microsoft.VSCode,3,1739848900,1739848903,1739848903.3065748,-21600,,
com.apple.finder,1,1739848899,1739848900,1739848900.8334951,-21600,,
com.microsoft.VSCode,3,1739848896,1739848899,1739848899.355649,-21600,,
com.apple.finder,2,1739848894,1739848896,1739848896.813645,-21600,,
com.microsoft.VSCode,3,1739848891,1739848894,1739848894.287442,-21600,,
com.apple.finder,2,1739848889,1739848891,1739848891.8378038,-21600,,
com.microsoft.VSCode,4,1739848885,1739848889,1739848889.116519,-21600,,
com.apple.finder,13,1739848872,1739848885,1739848885.490861,-21600,,
com.microsoft.VSCode,22,1739848850,1739848872,1739848872.492876,-21600,,
com.apple.finder,12,1739848838,1739848850,1739848850.8656669,-21600,,
com.microsoft.VSCode,70,1739848768,1739848838,1739848838.7016048,-21600,,
com.apple.finder,2,1739848766,1739848768,1739848768.8573,-21600,,
com.apple.Preview,5,1739848761,1739848766,1739848766.790242,-21600,,
com.apple.finder,8,1739848753,1739848761,1739848761.4778671,-21600,,
com.microsoft.VSCode,2,1739848751,1739848753,1739848753.36607,-21600,,
com.apple.Preview,4,1739848747,1739848751,1739848751.8749251,-21600,,
com.microsoft.VSCode,1,1739848746,1739848747,1739848747.684231,-21600,,
com.apple.finder,43,1739848703,1739848746,1739848746.771949,-21600,,
com.microsoft.VSCode,3,1739848700,1739848703,1739848703.887423,-21600,,
com.apple.finder,7,1739848693,1739848700,1739848700.4735699,-21600,,
com.microsoft.VSCode,61,1739848632,1739848693,1739848693.6495938,-21600,,
com.apple.finder,2,1739848630,1739848632,1739848632.4563951,-21600,,
com.apple.Preview,4,1739848626,1739848630,1739848630.45616,-21600,,
com.apple.finder,14,1739848612,1739848626,1739848626.658249,-21600,,
com.microsoft.VSCode,234,1739848378,1739848612,1739848612.234321,-21600,,
com.leomehlig.today,36,1739848342,1739848378,1739848378.107518,-21600,,
com.microsoft.VSCode,111,1739848231,1739848342,1739848342.417814,-21600,,
com.apple.finder,157,1739848074,1739848231,1739848231.229652,-21600,,
com.microsoft.VSCode,2,1739848072,1739848074,1739848074.769956,-21600,,
com.apple.finder,3,1739848069,1739848072,1739848072.69682,-21600,,
com.microsoft.VSCode,13,1739848056,1739848069,1739848069.134877,-21600,,
com.apple.finder,11,1739848045,1739848056,1739848056.752819,-21600,,
com.microsoft.VSCode,7,1739848038,1739848045,1739848045.341494,-21600,,
com.apple.finder,9,1739848029,1739848038,1739848038.457525,-21600,,
com.microsoft.VSCode,899,1739847130,1739848029,1739848030.0409498,-21600,,
com.google.Chrome,2,1739847128,1739847130,1739847130.6430159,-21600,,
com.microsoft.VSCode,3,1739847125,1739847128,1739847128.877108,-21600,,
com.google.Chrome,1,1739847124,1739847125,1739847125.89992,-21600,,
com.microsoft.VSCode,3,1739847121,1739847124,1739847124.6578941,-21600,,
com.google.Chrome,1,1739847120,1739847121,1739847121.829853,-21600,,
com.microsoft.VSCode,6,1739847114,1739847120,1739847120.6150951,-21600,,
com.google.Chrome,2,1739847112,1739847114,1739847114.750788,-21600,,
com.microsoft.VSCode,3,1739847109,1739847112,1739847112.748158,-21600,,
com.google.Chrome,1,1739847108,1739847109,1739847109.2929459,-21600,,
com.microsoft.VSCode,3,1739847105,1739847108,1739847108.3131251,-21600,,
com.google.Chrome,1,1739847104,1739847105,1739847105.2579942,-21600,,
com.microsoft.VSCode,3,1739847101,1739847104,1739847104.1536798,-21600,,
com.google.Chrome,1,1739847100,1739847101,1739847101.633183,-21600,,
com.microsoft.VSCode,3,1739847097,1739847100,1739847100.256226,-21600,,
com.google.Chrome,2,1739847095,1739847097,1739847097.038585,-21600,,
com.microsoft.VSCode,14,1739847081,1739847095,1739847095.406598,-21600,,
com.google.Chrome,9,1739847072,1739847081,1739847081.957625,-21600,,
com.microsoft.VSCode,3,1739847069,1739847072,1739847073.049283,-21600,,
com.google.Chrome,1,1739847068,1739847069,1739847069.340415,-21600,,
com.microsoft.VSCode,3,1739847065,1739847068,1739847068.113071,-21600,,
com.google.Chrome,3,1739847062,1739847065,1739847065.174316,-21600,,
com.microsoft.VSCode,4,1739847058,1739847062,1739847062.628483,-21600,,
com.google.Chrome,1,1739847057,1739847058,1739847058.7983708,-21600,,
com.microsoft.VSCode,3,1739847054,1739847057,1739847057.0986261,-21600,,
com.google.Chrome,35,1739847019,1739847054,1739847054.1589031,-21600,,
com.microsoft.VSCode,98,1739846921,1739847019,1739847020.025251,-21600,,
com.apple.finder,4,1739846917,1739846921,1739846921.961926,-21600,,
com.microsoft.VSCode,1,1739846916,1739846917,1739846917.799923,-21600,,
com.apple.finder,13,1739846903,1739846916,1739846916.8547602,-21600,,
com.microsoft.VSCode,86,1739846817,1739846903,1739846903.355266,-21600,,
com.google.Chrome,7,1739846810,1739846817,1739846817.1554189,-21600,,
com.microsoft.VSCode,278,1739846532,1739846810,1739846810.455241,-21600,,
com.google.Chrome,2,1739846530,1739846532,1739846532.986295,-21600,,
com.microsoft.VSCode,4,1739846526,1739846530,1739846530.212605,-21600,,
com.google.Chrome,1,1739846525,1739846526,1739846526.863836,-21600,,
com.microsoft.VSCode,11,1739846514,1739846525,1739846525.183062,-21600,,
com.google.Chrome,7,1739846507,1739846514,1739846514.188858,-21600,,
com.microsoft.VSCode,102,1739846405,1739846507,1739846507.693078,-21600,,
com.google.Chrome,41,1739846364,1739846405,1739846405.394886,-21600,,
com.microsoft.VSCode,291,1739846073,1739846364,1739846364.448648,-21600,,
com.google.Chrome,2,1739846071,1739846073,1739846073.9393501,-21600,,
com.microsoft.VSCode,1,1739846070,1739846071,1739846071.698771,-21600,,
com.google.Chrome,6,1739846064,1739846070,1739846070.682239,-21600,,
com.microsoft.VSCode,2,1739846062,1739846064,1739846064.921907,-21600,,
com.google.Chrome,7,1739846055,1739846062,1739846062.688348,-21600,,
com.microsoft.VSCode,24,1739846031,1739846055,1739846055.86869,-21600,,
com.google.Chrome,3,1739846028,1739846031,1739846031.1345239,-21600,,
com.microsoft.VSCode,4,1739846024,1739846028,1739846028.953625,-21600,,
com.google.Chrome,44,1739845980,1739846024,1739846024.81511,-21600,,
com.microsoft.VSCode,401,1739845579,1739845980,1739845980.9061751,-21600,,
com.google.Chrome,39,1739845540,1739845579,1739845579.238155,-21600,,
com.microsoft.VSCode,243,1739845297,1739845540,1739845540.3153892,-21600,,
com.google.Chrome,3,1739845294,1739845297,1739845297.938602,-21600,,
com.microsoft.VSCode,44,1739845250,1739845294,1739845294.386524,-21600,,
com.google.Chrome,1,1739845249,1739845250,1739845251.054364,-21600,,
com.microsoft.VSCode,24,1739845225,1739845249,1739845249.718326,-21600,,
com.google.Chrome,13,1739845212,1739845225,1739845225.762744,-21600,,
com.microsoft.VSCode,4,1739845208,1739845212,1739845212.9699268,-21600,,
com.google.Chrome,18,1739845190,1739845208,1739845208.643285,-21600,,
com.microsoft.VSCode,9,1739845181,1739845190,1739845190.906712,-21600,,
com.google.Chrome,30,1739845151,1739845181,1739845181.936349,-21600,,
com.microsoft.VSCode,48,1739845103,1739845151,1739845151.825943,-21600,,
com.leomehlig.today,5,1739845098,1739845103,1739845103.600789,-21600,,
com.leomehlig.today,35,1739844938,1739844973,1739844973.6946511,-21600,,
com.google.Chrome,813,1739844125,1739844938,1739844938.590073,-21600,,
com.leomehlig.today,22,1739844103,1739844125,1739844125.234268,-21600,,
com.google.Chrome,285,1739843818,1739844103,1739844103.0903559,-21600,,
com.leomehlig.today,11,1739843807,1739843818,1739843818.184462,-21600,,
com.google.Chrome,537,1739843270,1739843807,1739843807.3872252,-21600,,
com.google.Chrome,315,1739842920,1739843235,1739843235.37221,-21600,,
com.leomehlig.today,75,1739842845,1739842920,1739842920.4404569,-21600,,
com.google.Chrome,12,1739842833,1739842845,1739842845.862354,-21600,,
com.leomehlig.today,84,1739842749,1739842833,1739842833.959279,-21600,,
com.apple.finder,2,1739842747,1739842749,1739842749.915526,-21600,,
com.leomehlig.today,67,1739842732,1739842799,1739842800.569061,-21600,EB445137-D7F5-57EC-87DA-1DB460D64046,"iPhone13,2"
com.leomehlig.today,25,1739842722,1739842747,1739842748.0120292,-21600,,
com.apple.finder,2,1739842720,1739842722,1739842722.543892,-21600,,
com.google.Chrome,2,1739842718,1739842720,1739842720.939012,-21600,,
com.leomehlig.today,8,1739842710,1739842718,1739842718.193717,-21600,,
com.google.Chrome,898,1739841812,1739842710,1739842710.624051,-21600,,
com.leomehlig.today,29,1739841783,1739841812,1739841812.575124,-21600,,
com.google.Chrome,1440,1739840343,1739841783,1739841783.686414,-21600,,
com.leomehlig.today,221,1739840039,1739840260,1739840260.481643,-21600,EB445137-D7F5-57EC-87DA-1DB460D64046,"iPhone13,2"
com.microsoft.Office.Outlook,11,1739840028,1739840039,1739840039.487371,-21600,EB445137-D7F5-57EC-87DA-1DB460D64046,"iPhone13,2"
com.apple.Health,42,1739839973,1739840015,1739840015.3929691,-21600,EB445137-D7F5-57EC-87DA-1DB460D64046,"iPhone13,2"
com.apple.Health,50,1739839922,1739839972,1739839972.857976,-21600,EB445137-D7F5-57EC-87DA-1DB460D64046,"iPhone13,2"
com.apple.news,17,1739838896,1739838913,1739838913.971416,-21600,EB445137-D7F5-57EC-87DA-1DB460D64046,"iPhone13,2"
com.google.Chrome,4719,1739835424,1739840143,1739840143.112924,-21600,,
com.apple.finder,1,1739835386,1739835387,1739835387.8071818,-21600,,
com.leomehlig.today,1,1739835385,1739835386,1739835386.282181,-21600,,
com.apple.finder,5,1739835380,1739835385,1739835385.61455,-21600,,
com.myfitnesspal.mfp,20,1739833984,1739834004,1739834005.341992,-21600,EB445137-D7F5-57EC-87DA-1DB460D64046,"iPhone13,2"
com.leomehlig.today,13,1739833318,1739833331,1739833331.0172482,-21600,,
com.apple.iCal,0,1739833318,1739833318,1739833319.0228338,-21600,,
com.leomehlig.today,1,1739833317,1739833318,1739833318.424577,-21600,,
com.hnc.Discord,2,1739833315,1739833317,1739833317.066207,-21600,,
com.google.Chrome,67,1739833248,1739833315,1739833315.0506868,-21600,,
com.google.Chrome,324,1739832696,1739833020,1739833020.685783,-21600,,
com.google.Chrome,317,1739832113,1739832430,1739832430.809941,-21600,,
com.leomehlig.today,18,1739832095,1739832113,1739832113.547349,-21600,,
com.apple.Preview,318,1739831777,1739832095,1739832095.296376,-21600,,
com.google.Chrome,115,1739831662,1739831777,1739831777.07134,-21600,,
com.apple.Preview,833,1739830829,1739831662,1739831662.643467,-21600,,
com.apple.finder,15,1739830814,1739830829,1739830829.58611,-21600,,
com.apple.finder,307,1739830365,1739830672,1739830672.5695329,-21600,,
com.google.Chrome,591,1739829774,1739830365,1739830365.232544,-21600,,
com.leomehlig.today,3,1739829771,1739829774,1739829774.9859629,-21600,,
com.apple.CoreAuthUI,2,1739829528,1739829530,1739829530.766581,-21600,EB445137-D7F5-57EC-87DA-1DB460D64046,"iPhone13,2"
com.robinhood.release.Robinhood,44,1739829527,1739829571,1739829571.839262,-21600,EB445137-D7F5-57EC-87DA-1DB460D64046,"iPhone13,2"
com.apple.CoreAuthUI,2,1739829507,1739829509,1739829509.270128,-21600,EB445137-D7F5-57EC-87DA-1DB460D64046,"iPhone13,2"
com.truebill.truebillnative,20,1739829505,1739829525,1739829526.12777,-21600,EB445137-D7F5-57EC-87DA-1DB460D64046,"iPhone13,2"
com.myfitnesspal.mfp,48,1739829453,1739829501,1739829501.395411,-21600,EB445137-D7F5-57EC-87DA-1DB460D64046,"iPhone13,2"
com.microsoft.Office.Outlook,8,1739829439,1739829447,1739829447.209583,-21600,EB445137-D7F5-57EC-87DA-1DB460D64046,"iPhone13,2"
com.tinyspeck.chatlyio,32,1739829406,1739829438,1739829438.287005,-21600,EB445137-D7F5-57EC-87DA-1DB460D64046,"iPhone13,2"
com.leomehlig.today,314,1739829358,1739829672,1739829672.494478,-21600,,
com.google.Chrome,39,1739829319,1739829358,1739829359.042965,-21600,,
com.hnc.Discord,3,1739829316,1739829319,1739829319.924487,-21600,,
com.apple.iCal,6,1739829310,1739829316,1739829316.367461,-21600,,
com.leomehlig.today,2,1739829308,1739829310,1739829310.501608,-21600,,
com.apple.FaceTime,12,1739829296,1739829308,1739829308.91693,-21600,,
com.leomehlig.today,4,1739829292,1739829296,1739829296.919127,-21600,,
com.leomehlig.today,308,1739828760,1739829068,1739829068.572846,-21600,,
com.goodreads.Goodreads,79,1739828255,1739828334,1739828334.3268518,-21600,EB445137-D7F5-57EC-87DA-1DB460D64046,"iPhone13,2"
com.apple.weather,7,1739828240,1739828247,1739828247.763413,-21600,EB445137-D7F5-57EC-87DA-1DB460D64046,"iPhone13,2"
com.leomehlig.today,556,1739828121,1739828677,1739828677.378837,-21600,,
com.apple.iCal,107,1739828014,1739828121,1739828121.6639562,-21600,,
com.hnc.Discord,54,1739827960,1739828014,1739828014.30567,-21600,,
com.leomehlig.today,4,1739827956,1739827960,1739827960.153911,-21600,,
com.hnc.Discord,4,1739827952,1739827956,1739827956.298317,-21600,,
com.apple.iCal,5,1739827947,1739827952,1739827952.173647,-21600,,
com.hnc.Discord,5,1739827942,1739827947,1739827947.397068,-21600,,
com.apple.iCal,242,1739827700,1739827942,1739827942.149673,-21600,,
com.leomehlig.today,55,1739827645,1739827700,1739827700.691928,-21600,,
com.apple.iCal,4,1739827641,1739827645,1739827645.2033129,-21600,,
com.google.Chrome,1,1739827640,1739827641,1739827641.893755,-21600,,
com.apple.iCal,7,1739827633,1739827640,1739827640.828745,-21600,,
com.google.Chrome,34,1739827599,1739827633,1739827634.028455,-21600,,
com.apple.FaceTime,5,1739827594,1739827599,1739827599.080879,-21600,,
com.google.Chrome,236,1739827358,1739827594,1739827594.602573,-21600,,
com.leomehlig.today,21,1739827325,1739827346,1739827347.4184299,-21600,,
com.apple.weather,109,1739827198,1739827307,1739827307.724259,-21600,EB445137-D7F5-57EC-87DA-1DB460D64046,"iPhone13,2"
com.apple.mobilephone,1,1739827197,1739827198,1739827198.6653728,-21600,EB445137-D7F5-57EC-87DA-1DB460D64046,"iPhone13,2"
com.apple.finder,155,1739827170,1739827325,1739827325.27549,-21600,,
com.leomehlig.today,34,1739827136,1739827170,1739827170.4749641,-21600,,
com.apple.finder,4,1739827132,1739827136,1739827137.027948,-21600,,
com.leomehlig.today,51,1739827081,1739827132,1739827132.41682,-21600,,
com.apple.finder,97,1739826984,1739827081,1739827081.331265,-21600,,
com.leomehlig.today,1,1739826983,1739826984,1739826984.833462,-21600,,
com.apple.FaceTime,3,1739826980,1739826983,1739826983.2618651,-21600,,
com.apple.MobileSMS,3,1739826977,1739826980,1739826980.334312,-21600,,
com.apple.FaceTime,2,1739826975,1739826977,1739826977.469222,-21600,,
com.apple.MobileSMS,243,1739826732,1739826975,1739826975.383672,-21600,,
com.apple.Terminal,1,1739826731,1739826732,1739826732.130756,-21600,,
com.apple.MobileSMS,1,1739826730,1739826731,1739826731.638647,-21600,,
com.google.Chrome,20,1739826710,1739826730,1739826730.926313,-21600,,
com.apple.mobilephone,15,1739825987,1739826002,1739826003.233665,-21600,EB445137-D7F5-57EC-87DA-1DB460D64046,"iPhone13,2"
com.apple.findmy,4,1739825967,1739825971,1739825972.11641,-21600,EB445137-D7F5-57EC-87DA-1DB460D64046,"iPhone13,2"
com.apple.findmy,3,1739825888,1739825891,1739825892.1164951,-21600,EB445137-D7F5-57EC-87DA-1DB460D64046,"iPhone13,2"
com.tinyspeck.chatlyio,18,1739825869,1739825887,1739825887.738514,-21600,EB445137-D7F5-57EC-87DA-1DB460D64046,"iPhone13,2"
com.apple.findmy,14,1739825855,1739825869,1739825869.77669,-21600,EB445137-D7F5-57EC-87DA-1DB460D64046,"iPhone13,2"
com.tinyspeck.chatlyio,2,1739825853,1739825855,1739825855.753416,-21600,EB445137-D7F5-57EC-87DA-1DB460D64046,"iPhone13,2"
com.apple.news,2,1739825793,1739825795,1739825796.696085,-21600,EB445137-D7F5-57EC-87DA-1DB460D64046,"iPhone13,2"
com.apple.news,14,1739822262,1739822276,1739822276.991829,-21600,EB445137-D7F5-57EC-87DA-1DB460D64046,"iPhone13,2"
com.apple.mobilecal,34,1739819345,1739819379,1739819379.796217,-21600,EB445137-D7F5-57EC-87DA-1DB460D64046,"iPhone13,2"
com.apple.MobileSMS,2,1739819343,1739819345,1739819345.205254,-21600,EB445137-D7F5-57EC-87DA-1DB460D64046,"iPhone13,2"
com.google.Chrome,62,1739819160,1739819222,1739819222.900298,-21600,,
com.apple.finder,1,1739819159,1739819160,1739819160.6957989,-21600,,
com.apple.iCal,18,1739819141,1739819159,1739819159.2756019,-21600,,
com.microsoft.VSCode,129,1739819012,1739819141,1739819142.0577211,-21600,,
com.apple.iCal,34,1739818978,1739819012,1739819012.952214,-21600,,
com.microsoft.VSCode,418,1739818560,1739818978,1739818978.6934528,-21600,,
com.apple.finder,47,1739818513,1739818560,1739818560.3635411,-21600,,
com.microsoft.VSCode,326,1739818187,1739818513,1739818513.588214,-21600,,
com.apple.Terminal,2,1739818185,1739818187,1739818187.363398,-21600,,
com.apple.finder,34,1739818151,1739818185,1739818185.434935,-21600,,
com.apple.Terminal,16,1739818135,1739818151,1739818152.014178,-21600,,
com.apple.finder,15,1739818120,1739818135,1739818135.176395,-21600,,
com.microsoft.VSCode,22,1739818098,1739818120,1739818120.980482,-21600,,
com.apple.Terminal,1,1739818097,1739818098,1739818098.19366,-21600,,
com.microsoft.VSCode,37,1739818060,1739818097,1739818097.373487,-21600,,
com.apple.Terminal,28,1739818032,1739818060,1739818060.073677,-21600,,
com.microsoft.VSCode,11,1739818021,1739818032,1739818032.5264401,-21600,,
com.apple.Terminal,109,1739817912,1739818021,1739818021.972134,-21600,,
com.microsoft.VSCode,26,1739817886,1739817912,1739817912.54875,-21600,,
com.google.Chrome,6,1739817880,1739817886,1739817886.632618,-21600,,
com.google.Chrome,2,1739817065,1739817067,1739817067.6084008,-21600,,
com.google.Chrome,1036,1739816016,1739817052,1739817052.993603,-21600,,
com.microsoft.VSCode,12,1739816004,1739816016,1739816017.1572142,-21600,,
com.apple.MobileSMS,9,1739815525,1739815534,1739815534.1509671,-21600,EB445137-D7F5-57EC-87DA-1DB460D64046,"iPhone13,2"
com.apple.weather,1,1739815524,1739815525,1739815525.817027,-21600,EB445137-D7F5-57EC-87DA-1DB460D64046,"iPhone13,2"
com.apple.weather,22,1739815358,1739815380,1739815380.384516,-21600,EB445137-D7F5-57EC-87DA-1DB460D64046,"iPhone13,2"
com.hammerandchisel.discord,2,1739815356,1739815358,1739815358.4668841,-21600,EB445137-D7F5-57EC-87DA-1DB460D64046,"iPhone13,2"
com.hammerandchisel.discord,39,1739813630,1739813669,1739813670.29979,-21600,EB445137-D7F5-57EC-87DA-1DB460D64046,"iPhone13,2"
com.apple.mobilenotes,0,1739813630,1739813630,1739813631.097148,-21600,EB445137-D7F5-57EC-87DA-1DB460D64046,"iPhone13,2"
com.apple.mobilenotes,6,1739811358,1739811364,1739811364.8142009,-21600,EB445137-D7F5-57EC-87DA-1DB460D64046,"iPhone13,2"
com.apple.mobilenotes,10,1739811343,1739811353,1739811353.242395,-21600,EB445137-D7F5-57EC-87DA-1DB460D64046,"iPhone13,2"
com.apple.mobilecal,12,1739811290,1739811302,1739811302.27663,-21600,EB445137-D7F5-57EC-87DA-1DB460D64046,"iPhone13,2"
com.myfitnesspal.mfp,20,1739811254,1739811274,1739811274.118413,-21600,EB445137-D7F5-57EC-87DA-1DB460D64046,"iPhone13,2"
com.myfitnesspal.mfp,3,1739811236,1739811239,1739811239.395313,-21600,EB445137-D7F5-57EC-87DA-1DB460D64046,"iPhone13,2"
com.myfitnesspal.mfp,41,1739810917,1739810958,1739810958.867476,-21600,EB445137-D7F5-57EC-87DA-1DB460D64046,"iPhone13,2"
com.myfitnesspal.mfp,2,1739810913,1739810915,1739810915.9002562,-21600,EB445137-D7F5-57EC-87DA-1DB460D64046,"iPhone13,2"
com.tier9digital.sundial,13,1739810874,1739810887,1739810887.258829,-21600,EB445137-D7F5-57EC-87DA-1DB460D64046,"iPhone13,2"
Astrospheric.Astrospheric,43,1739810829,1739810872,1739810872.1153688,-21600,EB445137-D7F5-57EC-87DA-1DB460D64046,"iPhone13,2"
com.apple.weather,6,1739810819,1739810825,1739810825.681001,-21600,EB445137-D7F5-57EC-87DA-1DB460D64046,"iPhone13,2"
com.toyopagroup.picaboo,54,1739810758,1739810812,1739810813.03511,-21600,EB445137-D7F5-57EC-87DA-1DB460D64046,"iPhone13,2"
com.microsoft.VSCode,283,1739810035,1739810318,1739810318.436112,-21600,,
com.google.Chrome,91,1739809944,1739810035,1739810035.799593,-21600,,
com.microsoft.VSCode,157,1739809787,1739809944,1739809944.906362,-21600,,
com.microsoft.VSCode,5,1739808123,1739808128,1739808128.590837,-21600,,
com.google.Chrome,27,1739808096,1739808123,1739808123.769116,-21600,,
com.microsoft.VSCode,46,1739808050,1739808096,1739808096.203576,-21600,,
com.google.Chrome,143,1739807907,1739808050,1739808050.486891,-21600,,
com.microsoft.VSCode,419,1739807488,1739807907,1739807907.284388,-21600,,
com.apple.Health,70,1739807210,1739807280,1739807280.3429441,-21600,EB445137-D7F5-57EC-87DA-1DB460D64046,"iPhone13,2"
com.google.Chrome,375,1739807113,1739807488,1739807488.223085,-21600,,
com.apple.news,130,1739807073,1739807203,1739807203.136129,-21600,EB445137-D7F5-57EC-87DA-1DB460D64046,"iPhone13,2"
com.google.Chrome,300,1739806808,1739807108,1739807108.770679,-21600,,
com.apple.Notes,60,1739806748,1739806808,1739806808.23166,-21600,,
com.leomehlig.today,64,1739806684,1739806748,1739806748.0674438,-21600,,
com.apple.Notes,12,1739806672,1739806684,1739806684.315846,-21600,,
com.google.Chrome,47,1739806625,1739806672,1739806672.7496939,-21600,,
com.leomehlig.today,126,1739806499,1739806625,1739806625.870055,-21600,,
com.google.Chrome,75,1739806424,1739806499,1739806499.990886,-21600,,
com.apple.iCal,29,1739806395,1739806424,1739806425.000243,-21600,,
com.google.Chrome,191,1739806204,1739806395,1739806396.026793,-21600,,
com.apple.CoreAuthUI,6,1739806201,1739806207,1739806207.562457,-21600,EB445137-D7F5-57EC-87DA-1DB460D64046,"iPhone13,2"
com.truebill.truebillnative,19,1739806198,1739806217,1739806217.1304069,-21600,EB445137-D7F5-57EC-87DA-1DB460D64046,"iPhone13,2"
com.groupme.iphone-app,2,1739806186,1739806188,1739806188.654903,-21600,EB445137-D7F5-57EC-87DA-1DB460D64046,"iPhone13,2"
com.microsoft.Office.Outlook,1,1739806185,1739806186,1739806186.33848,-21600,EB445137-D7F5-57EC-87DA-1DB460D64046,"iPhone13,2"
com.leomehlig.today,86,1739806118,1739806204,1739806204.304903,-21600,,
com.google.Chrome,33,1739806085,1739806118,1739806118.6707458,-21600,,
com.microsoft.Outlook,3,1739806082,1739806085,1739806085.546298,-21600,,
com.google.Chrome,14,1739806068,1739806082,1739806082.108191,-21600,,
com.microsoft.Outlook,33,1739806035,1739806068,1739806069.4439092,-21600,,
com.google.Chrome,122,1739805913,1739806035,1739806035.1899118,-21600,,
com.microsoft.Outlook,45,1739805868,1739805913,1739805913.8063002,-21600,,
com.google.Chrome,7,1739805861,1739805868,1739805868.477555,-21600,,
com.leomehlig.today,3,1739805858,1739805861,1739805861.3802838,-21600,,
com.microsoft.Office.Outlook,150,1739805755,1739805905,1739805905.881936,-21600,EB445137-D7F5-57EC-87DA-1DB460D64046,"iPhone13,2"
com.instructure.icanvas,4,1739805742,1739805746,1739805746.1108298,-21600,EB445137-D7F5-57EC-87DA-1DB460D64046,"iPhone13,2"
com.instructure.icanvas,54,1739805685,1739805739,1739805739.994709,-21600,EB445137-D7F5-57EC-87DA-1DB460D64046,"iPhone13,2"
com.intsig.CamScannerLite,0,1739805685,1739805685,1739805685.4172668,-21600,EB445137-D7F5-57EC-87DA-1DB460D64046,"iPhone13,2"
com.intsig.CamScannerLite,22,1739805506,1739805528,1739805529.117525,-21600,EB445137-D7F5-57EC-87DA-1DB460D64046,"iPhone13,2"
com.intsig.CamScannerLite,70,1739805363,1739805433,1739805433.73625,-21600,EB445137-D7F5-57EC-87DA-1DB460D64046,"iPhone13,2"
com.apple.mobileslideshow,2,1739805357,1739805359,1739805359.524529,-21600,EB445137-D7F5-57EC-87DA-1DB460D64046,"iPhone13,2"
com.leomehlig.today,95,1739805307,1739805402,1739805402.654931,-21600,,
com.google.Chrome,325,1739804982,1739805307,1739805307.390193,-21600,,
com.apple.finder,9,1739804963,1739804972,1739804972.904907,-21600,,
com.google.Chrome,1,1739804962,1739804963,1739804964.3683438,-21600,,
com.leomehlig.today,0,1739804962,1739804962,1739804963.69099,-21600,,
com.apple.Photos,2,1739804960,1739804962,1739804962.0729198,-21600,,
com.google.Chrome,1,1739804959,1739804960,1739804960.799968,-21600,,
com.apple.mobileslideshow,24,1739804470,1739804494,1739804495.174183,-21600,EB445137-D7F5-57EC-87DA-1DB460D64046,"iPhone13,2"
com.apple.Health,3,1739804465,1739804468,1739804469.183984,-21600,EB445137-D7F5-57EC-87DA-1DB460D64046,"iPhone13,2"
com.apple.Health,16,1739803791,1739803807,1739803807.770663,-21600,EB445137-D7F5-57EC-87DA-1DB460D64046,"iPhone13,2"
com.apple.MobileSMS,2,1739803786,1739803788,1739803788.605314,-21600,EB445137-D7F5-57EC-87DA-1DB460D64046,"iPhone13,2"
com.apple.MobileSMS,7,1739803613,1739803620,1739803621.130776,-21600,EB445137-D7F5-57EC-87DA-1DB460D64046,"iPhone13,2"
com.apple.weather,16,1739803597,1739803613,1739803613.868336,-21600,EB445137-D7F5-57EC-87DA-1DB460D64046,"iPhone13,2"
com.google.Chrome,22,1739803511,1739803533,1739803533.453419,-21600,,
com.leomehlig.today,2,1739803496,1739803498,1739803498.6882648,-21600,,
com.apple.weather,61,1739802679,1739802740,1739802740.683847,-21600,EB445137-D7F5-57EC-87DA-1DB460D64046,"iPhone13,2"
com.renpho.health,2,1739802677,1739802679,1739802679.1675138,-21600,EB445137-D7F5-57EC-87DA-1DB460D64046,"iPhone13,2"
com.renpho.health,37,1739802518,1739802555,1739802555.222755,-21600,EB445137-D7F5-57EC-87DA-1DB460D64046,"iPhone13,2"
com.groupme.iphone-app,52,1739801761,1739801813,1739801814.2211409,-21600,EB445137-D7F5-57EC-87DA-1DB460D64046,"iPhone13,2"
com.apple.Health,26,1739769375,1739769401,1739769401.412385,-21600,EB445137-D7F5-57EC-87DA-1DB460D64046,"iPhone13,2"
com.thestorygraph.thestorygraph,1,1739769374,1739769375,1739769375.492378,-21600,EB445137-D7F5-57EC-87DA-1DB460D64046,"iPhone13,2"
com.thestorygraph.thestorygraph,86,1739769266,1739769352,1739769352.994355,-21600,EB445137-D7F5-57EC-87DA-1DB460D64046,"iPhone13,2"
com.apple.mobilenotes,20,1739767055,1739767075,1739767075.6209989,-21600,EB445137-D7F5-57EC-87DA-1DB460D64046,"iPhone13,2"
com.apple.mobilenotes,11,1739767040,1739767051,1739767052.0127969,-21600,EB445137-D7F5-57EC-87DA-1DB460D64046,"iPhone13,2"
com.apple.news,21,1739767011,1739767032,1739767032.1858249,-21600,EB445137-D7F5-57EC-87DA-1DB460D64046,"iPhone13,2"
com.apple.news,8,1739761367,1739761375,1739761375.346174,-21600,EB445137-D7F5-57EC-87DA-1DB460D64046,"iPhone13,2"
com.apple.news,22,1739761244,1739761266,1739761267.404189,-21600,EB445137-D7F5-57EC-87DA-1DB460D64046,"iPhone13,2"
com.apple.CoreAuthUI,3,1739761228,1739761231,1739761231.245568,-21600,EB445137-D7F5-57EC-87DA-1DB460D64046,"iPhone13,2"
com.apple.CoreAuthUI,1,1739761227,1739761228,1739761228.144199,-21600,EB445137-D7F5-57EC-87DA-1DB460D64046,"iPhone13,2"
com.microsoft.onenote,11,1739761223,1739761234,1739761234.0813699,-21600,EB445137-D7F5-57EC-87DA-1DB460D64046,"iPhone13,2"
com.apple.CoreAuthUI,2,1739759066,1739759068,1739759068.76363,-21600,EB445137-D7F5-57EC-87DA-1DB460D64046,"iPhone13,2"
com.microsoft.onenote,69,1739759061,1739759130,1739759130.933186,-21600,EB445137-D7F5-57EC-87DA-1DB460D64046,"iPhone13,2"
com.apple.MobileSMS,2,1739759056,1739759058,1739759058.099131,-21600,EB445137-D7F5-57EC-87DA-1DB460D64046,"iPhone13,2"
com.apple.MobileSMS,1,1739757760,1739757761,1739757762.1481009,-21600,EB445137-D7F5-57EC-87DA-1DB460D64046,"iPhone13,2"
com.instructure.icanvas,0,1739757760,1739757760,1739757760.398478,-21600,EB445137-D7F5-57EC-87DA-1DB460D64046,"iPhone13,2"
com.instructure.icanvas,35,1739757723,1739757758,1739757758.6699572,-21600,EB445137-D7F5-57EC-87DA-1DB460D64046,"iPhone13,2"
com.letterboxd.LetterboxdApp,1,1739757722,1739757723,1739757723.7892962,-21600,EB445137-D7F5-57EC-87DA-1DB460D64046,"iPhone13,2"
com.leomehlig.today,13,1739757662,1739757675,1739757675.99053,-21600,,
com.google.Chrome,15,1739757647,1739757662,1739757662.988832,-21600,,
com.microsoft.VSCode,149,1739757498,1739757647,1739757647.7083879,-21600,,
com.apple.finder,6,1739757492,1739757498,1739757498.080783,-21600,,
com.apple.shortcuts,22,1739757470,1739757492,1739757492.926365,-21600,,
com.apple.finder,37,1739757433,1739757470,1739757470.269939,-21600,,
com.apple.shortcuts,3,1739757430,1739757433,1739757433.699414,-21600,,
com.microsoft.VSCode,87,1739757307,1739757394,1739757394.621546,-21600,,
com.leomehlig.today,17,1739757290,1739757307,1739757307.708713,-21600,,
com.microsoft.VSCode,92,1739757198,1739757290,1739757290.8197942,-21600,,
com.google.Chrome,50,1739757148,1739757198,1739757198.116658,-21600,,
com.leomehlig.today,33,1739757115,1739757148,1739757148.726825,-21600,,
com.google.Chrome,9,1739757106,1739757115,1739757115.529118,-21600,,
com.leomehlig.today,4,1739757102,1739757106,1739757106.0944262,-21600,,
com.google.Chrome,12,1739757090,1739757102,1739757103.0351372,-21600,,
com.microsoft.VSCode,65,1739757025,1739757090,1739757090.889913,-21600,,
com.google.Chrome,10,1739757015,1739757025,1739757025.567254,-21600,,
com.microsoft.VSCode,137,1739756878,1739757015,1739757015.414918,-21600,,
com.google.Chrome,6,1739756872,1739756878,1739756878.368695,-21600,,
com.microsoft.VSCode,6,1739756866,1739756872,1739756872.863327,-21600,,
com.google.Chrome,55,1739756811,1739756866,1739756866.457618,-21600,,
com.microsoft.VSCode,51,1739756760,1739756811,1739756811.9000149,-21600,,
com.google.Chrome,4,1739756756,1739756760,1739756760.5149488,-21600,,
com.microsoft.VSCode,4,1739756752,1739756756,1739756756.792943,-21600,,
com.google.Chrome,7,1739756745,1739756752,1739756752.096486,-21600,,
com.microsoft.VSCode,26,1739756719,1739756745,1739756745.406921,-21600,,
com.google.Chrome,1,1739756718,1739756719,1739756719.96925,-21600,,
com.microsoft.VSCode,32,1739756686,1739756718,1739756718.152557,-21600,,
com.google.Chrome,4,1739756682,1739756686,1739756686.273744,-21600,,
com.microsoft.VSCode,4,1739756678,1739756682,1739756682.455038,-21600,,
com.google.Chrome,3,1739756675,1739756678,1739756678.15483,-21600,,
com.microsoft.VSCode,11,1739756664,1739756675,1739756675.312299,-21600,,
com.google.Chrome,2,1739756662,1739756664,1739756664.3778691,-21600,,
com.microsoft.VSCode,8,1739756654,1739756662,1739756662.790045,-21600,,
com.google.Chrome,1,1739756653,1739756654,1739756654.23488,-21600,,
com.microsoft.VSCode,3,1739756650,1739756653,1739756653.176873,-21600,,
com.google.Chrome,2,1739756648,1739756650,1739756650.2391849,-21600,,
com.microsoft.VSCode,5,1739756643,1739756648,1739756648.2696118,-21600,,
com.google.Chrome,20,1739756623,1739756643,1739756643.292871,-21600,,
com.microsoft.VSCode,100,1739756523,1739756623,1739756623.342325,-21600,,
com.google.Chrome,6,1739756517,1739756523,1739756523.7299762,-21600,,
com.microsoft.VSCode,33,1739756484,1739756517,1739756517.991778,-21600,,
com.google.Chrome,24,1739756460,1739756484,1739756484.059468,-21600,,
com.microsoft.VSCode,19,1739756441,1739756460,1739756460.896995,-21600,,
com.google.Chrome,8,1739756433,1739756441,1739756441.893664,-21600,,
com.microsoft.VSCode,27,1739756406,1739756433,1739756433.1969662,-21600,,
com.google.Chrome,3,1739756403,1739756406,1739756406.895986,-21600,,
com.microsoft.VSCode,6,1739756397,1739756403,1739756403.981375,-21600,,
com.google.Chrome,14,1739756383,1739756397,1739756398.0274339,-21600,,
com.microsoft.VSCode,1,1739756382,1739756383,1739756383.833225,-21600,,
com.google.Chrome,5,1739756377,1739756382,1739756382.864717,-21600,,
com.microsoft.VSCode,33,1739756344,1739756377,1739756377.59707,-21600,,
com.google.Chrome,11,1739756333,1739756344,1739756344.7435222,-21600,,
com.microsoft.VSCode,72,1739756261,1739756333,1739756333.348172,-21600,,
com.google.Chrome,49,1739756212,1739756261,1739756261.62857,-21600,,
com.microsoft.VSCode,764,1739755448,1739756212,1739756212.788625,-21600,,
com.google.Chrome,18,1739755430,1739755448,1739755448.418792,-21600,,
com.microsoft.VSCode,57,1739755373,1739755430,1739755430.603897,-21600,,
com.google.Chrome,3,1739755370,1739755373,1739755373.252059,-21600,,
com.microsoft.VSCode,2,1739755368,1739755370,1739755370.325582,-21600,,
com.google.Chrome,19,1739755349,1739755368,1739755368.9698749,-21600,,
com.microsoft.VSCode,47,1739755302,1739755349,1739755349.794349,-21600,,
com.google.Chrome,8,1739755294,1739755302,1739755302.247624,-21600,,
com.microsoft.VSCode,22,1739755272,1739755294,1739755294.649709,-21600,,
com.google.Chrome,38,1739755234,1739755272,1739755272.994215,-21600,,
com.microsoft.VSCode,45,1739755189,1739755234,1739755234.154152,-21600,,
com.google.Chrome,3,1739755186,1739755189,1739755189.064815,-21600,,
com.microsoft.VSCode,270,1739754916,1739755186,1739755186.729724,-21600,,
com.google.Chrome,2,1739754914,1739754916,1739754916.503364,-21600,,
com.microsoft.VSCode,17,1739754897,1739754914,1739754914.12309,-21600,,
com.google.Chrome,6,1739754891,1739754897,1739754897.548054,-21600,,
com.microsoft.VSCode,1,1739754890,1739754891,1739754891.923574,-21600,,
com.google.Chrome,21,1739754869,1739754890,1739754890.70966,-21600,,
com.microsoft.VSCode,52,1739754817,1739754869,1739754869.402577,-21600,,
com.google.Chrome,61,1739754756,1739754817,1739754817.6186252,-21600,,
com.microsoft.VSCode,123,1739754633,1739754756,1739754756.682339,-21600,,
com.google.Chrome,18,1739754615,1739754633,1739754633.896416,-21600,,
com.microsoft.VSCode,84,1739754531,1739754615,1739754615.633205,-21600,,
com.google.Chrome,1,1739754530,1739754531,1739754531.484973,-21600,,
com.microsoft.VSCode,3,1739754527,1739754530,1739754530.354547,-21600,,
com.google.Chrome,1,1739754526,1739754527,1739754527.688441,-21600,,
com.microsoft.VSCode,13,1739754513,1739754526,1739754526.2396321,-21600,,
com.google.Chrome,1,1739754512,1739754513,1739754513.048236,-21600,,
com.microsoft.VSCode,3,1739754509,1739754512,1739754512.130529,-21600,,
com.google.Chrome,78,1739754431,1739754509,1739754509.176382,-21600,,
com.microsoft.VSCode,17,1739754414,1739754431,1739754431.137731,-21600,,
com.google.Chrome,17,1739754397,1739754414,1739754414.999219,-21600,,
com.microsoft.VSCode,4,1739754393,1739754397,1739754397.323666,-21600,,
com.google.Chrome,4,1739754389,1739754393,1739754393.134986,-21600,,
com.microsoft.VSCode,30,1739754359,1739754389,1739754390.030602,-21600,,
com.google.Chrome,3,1739754356,1739754359,1739754359.6477752,-21600,,
com.microsoft.VSCode,1,1739754355,1739754356,1739754356.957957,-21600,,
com.google.Chrome,2,1739754353,1739754355,1739754355.63524,-21600,,
com.microsoft.VSCode,2,1739754351,1739754353,1739754353.876863,-21600,,
com.google.Chrome,3,1739754348,1739754351,1739754351.819285,-21600,,
com.microsoft.VSCode,3,1739754345,1739754348,1739754348.834147,-21600,,
com.google.Chrome,1,1739754344,1739754345,1739754346.0085568,-21600,,
com.microsoft.VSCode,5,1739754339,1739754344,1739754344.302184,-21600,,
com.google.Chrome,4,1739754335,1739754339,1739754339.047535,-21600,,
com.microsoft.VSCode,2,1739754333,1739754335,1739754335.7381768,-21600,,
com.google.Chrome,1,1739754332,1739754333,1739754333.29056,-21600,,
com.microsoft.VSCode,2,1739754330,1739754332,1739754332.340303,-21600,,
com.google.Chrome,4,1739754326,1739754330,1739754330.9960232,-21600,,
com.microsoft.VSCode,8,1739754318,1739754326,1739754326.222426,-21600,,
com.google.Chrome,143,1739754175,1739754318,1739754318.279489,-21600,,
com.leomehlig.today,9,1739754166,1739754175,1739754175.6607041,-21600,,
com.google.Chrome,5,1739754161,1739754166,1739754166.6104178,-21600,,
com.microsoft.VSCode,120,1739754041,1739754161,1739754161.390913,-21600,,
com.google.Chrome,20,1739754021,1739754041,1739754041.245086,-21600,,
com.leomehlig.today,8,1739754013,1739754021,1739754021.240673,-21600,,
com.google.Chrome,3,1739754010,1739754013,1739754013.6909242,-21600,,
com.leomehlig.today,1,1739754009,1739754010,1739754010.8292,-21600,,
com.apple.Notes,4,1739754005,1739754009,1739754009.444003,-21600,,
com.leomehlig.today,257,1739753748,1739754005,1739754005.2546391,-21600,,
com.apple.Notes,34,1739753714,1739753748,1739753748.340946,-21600,,
com.leomehlig.today,22,1739753692,1739753714,1739753714.3222961,-21600,,
com.google.Chrome,12,1739753680,1739753692,1739753692.532341,-21600,,
com.leomehlig.today,27,1739753595,1739753622,1739753622.234023,-21600,,
com.google.Chrome,5,1739753590,1739753595,1739753595.4346042,-21600,,
com.myfitnesspal.mfp,98,1739751035,1739751133,1739751134.0588121,-21600,EB445137-D7F5-57EC-87DA-1DB460D64046,"iPhone13,2"
com.groupme.iphone-app,12,1739751021,1739751033,1739751033.6611562,-21600,EB445137-D7F5-57EC-87DA-1DB460D64046,"iPhone13,2"
com.apple.Music,1,1739751020,1739751021,1739751021.510057,-21600,EB445137-D7F5-57EC-87DA-1DB460D64046,"iPhone13,2"
com.apple.Music,316,1739748364,1739748680,1739748680.343144,-21600,EB445137-D7F5-57EC-87DA-1DB460D64046,"iPhone13,2"
com.apple.news,143,1739747654,1739747797,1739747797.253553,-21600,EB445137-D7F5-57EC-87DA-1DB460D64046,"iPhone13,2"
com.apple.Music,16,1739747603,1739747619,1739747619.586088,-21600,EB445137-D7F5-57EC-87DA-1DB460D64046,"iPhone13,2"
com.apple.MobileSMS,2,1739747601,1739747603,1739747603.5682511,-21600,EB445137-D7F5-57EC-87DA-1DB460D64046,"iPhone13,2"
com.apple.MobileSMS,1,1739747598,1739747599,1739747599.319786,-21600,EB445137-D7F5-57EC-87DA-1DB460D64046,"iPhone13,2"
com.apple.MobileSMS,4,1739747240,1739747244,1739747244.342883,-21600,EB445137-D7F5-57EC-87DA-1DB460D64046,"iPhone13,2"
com.groupme.iphone-app,1,1739747239,1739747240,1739747240.604887,-21600,EB445137-D7F5-57EC-87DA-1DB460D64046,"iPhone13,2"
com.google.Chrome,614,1739745702,1739746316,1739746316.069234,-21600,,
com.apple.finder,2,1739745700,1739745702,1739745702.331883,-21600,,
com.groupme.iphone-app,2,1739744876,1739744878,1739744878.949122,-21600,EB445137-D7F5-57EC-87DA-1DB460D64046,"iPhone13,2"
com.apple.finder,3,1739744757,1739744760,1739744760.834995,-21600,,
com.leomehlig.today,1,1739744756,1739744757,1739744757.50809,-21600,,
com.google.Chrome,2,1739744754,1739744756,1739744757.278682,-21600,,
com.leomehlig.today,48,1739744706,1739744754,1739744754.7269921,-21600,,
com.google.Chrome,27,1739744679,1739744706,1739744706.8538818,-21600,,
com.google.Chrome,845,1739743812,1739744657,1739744657.726665,-21600,,
com.leomehlig.today,7,1739743805,1739743812,1739743812.159175,-21600,,
com.groupme.iphone-app,15,1739743428,1739743443,1739743443.970286,-21600,EB445137-D7F5-57EC-87DA-1DB460D64046,"iPhone13,2"
com.myfitnesspal.mfp,1,1739743427,1739743428,1739743428.976089,-21600,EB445137-D7F5-57EC-87DA-1DB460D64046,"iPhone13,2"
com.google.Chrome,409,1739743396,1739743805,1739743805.621597,-21600,,
com.myfitnesspal.mfp,109,1739743103,1739743212,1739743213.164638,-21600,EB445137-D7F5-57EC-87DA-1DB460D64046,"iPhone13,2"
com.google.Chrome,429,1739742918,1739743347,1739743347.1680079,-21600,,
com.hammerandchisel.discord,7,1739742616,1739742623,1739742623.069139,-21600,EB445137-D7F5-57EC-87DA-1DB460D64046,"iPhone13,2"
com.hammerandchisel.discord,2,1739742612,1739742614,1739742615.181793,-21600,EB445137-D7F5-57EC-87DA-1DB460D64046,"iPhone13,2"
com.google.Chrome,444,1739742443,1739742887,1739742887.1302571,-21600,,
com.google.Chrome,451,1739741746,1739742197,1739742197.279438,-21600,,
com.leomehlig.today,9,1739741737,1739741746,1739741746.140341,-21600,,
com.google.Chrome,5,1739741732,1739741737,1739741737.579599,-21600,,
com.leomehlig.today,11,1739741705,1739741716,1739741717.081923,-21600,,
com.apple.finder,3,1739741702,1739741705,1739741705.10293,-21600,,
com.leomehlig.today,3,1739741699,1739741702,1739741702.99794,-21600,,
com.facebook.Facebook,190,1739741472,1739741662,1739741663.137037,-21600,EB445137-D7F5-57EC-87DA-1DB460D64046,"iPhone13,2"
com.apple.MobileSMS,2,1739741459,1739741461,1739741461.253959,-21600,EB445137-D7F5-57EC-87DA-1DB460D64046,"iPhone13,2"
com.apple.MobileSMS,30,1739741413,1739741443,1739741443.793426,-21600,EB445137-D7F5-57EC-87DA-1DB460D64046,"iPhone13,2"
com.apple.news,172,1739741239,1739741411,1739741411.29475,-21600,EB445137-D7F5-57EC-87DA-1DB460D64046,"iPhone13,2"
com.apple.MobileSMS,3,1739741231,1739741234,1739741234.173799,-21600,EB445137-D7F5-57EC-87DA-1DB460D64046,"iPhone13,2"
com.apple.MobileSMS,3,1739741220,1739741223,1739741224.027425,-21600,EB445137-D7F5-57EC-87DA-1DB460D64046,"iPhone13,2"
com.intsig.CamScannerLite,193,1739740893,1739741086,1739741086.9748368,-21600,EB445137-D7F5-57EC-87DA-1DB460D64046,"iPhone13,2"
com.truebill.truebillnative,2,1739740891,1739740893,1739740894.2391891,-21600,EB445137-D7F5-57EC-87DA-1DB460D64046,"iPhone13,2"
com.leomehlig.today,560,1739740841,1739741401,1739741401.821156,-21600,,
com.apple.Preview,2,1739740839,1739740841,1739740841.592519,-21600,,
com.apple.Preview,517,1739740117,1739740634,1739740634.613195,-21600,,
com.apple.finder,5,1739740112,1739740117,1739740117.7414231,-21600,,
com.google.Chrome,3,1739740109,1739740112,1739740112.796258,-21600,,
com.leomehlig.today,147,1739739962,1739740109,1739740110.392771,-21600,,
com.apple.finder,1,1739739961,1739739962,1739739963.6057029,-21600,,
com.apple.CoreAuthUI,2,1739739351,1739739353,1739739353.236309,-21600,EB445137-D7F5-57EC-87DA-1DB460D64046,"iPhone13,2"
com.truebill.truebillnative,48,1739739348,1739739396,1739739396.40992,-21600,EB445137-D7F5-57EC-87DA-1DB460D64046,"iPhone13,2"
com.groupme.iphone-app,12,1739738564,1739738576,1739738576.948627,-21600,EB445137-D7F5-57EC-87DA-1DB460D64046,"iPhone13,2"
com.apple.news,2,1739738562,1739738564,1739738564.7417722,-21600,EB445137-D7F5-57EC-87DA-1DB460D64046,"iPhone13,2"
com.apple.news,91,1739738043,1739738134,1739738134.816876,-21600,EB445137-D7F5-57EC-87DA-1DB460D64046,"iPhone13,2"
com.apple.finder,48,1739736124,1739736172,1739736172.9990458,-21600,,
com.leomehlig.today,0,1739736124,1739736124,1739736125.1496038,-21600,,
com.google.Chrome,643,1739735481,1739736124,1739736124.60644,-21600,,
com.leomehlig.today,44,1739735437,1739735481,1739735481.071906,-21600,,
com.google.Chrome,22,1739735415,1739735437,1739735437.763142,-21600,,
com.microsoft.Office.Outlook,56,1739733063,1739733119,1739733119.72769,-21600,EB445137-D7F5-57EC-87DA-1DB460D64046,"iPhone13,2"
com.google.chrome.ios,4,1739733059,1739733063,1739733064.378417,-21600,EB445137-D7F5-57EC-87DA-1DB460D64046,"iPhone13,2"
com.microsoft.Office.Outlook,20,1739733039,1739733059,1739733059.667128,-21600,EB445137-D7F5-57EC-87DA-1DB460D64046,"iPhone13,2"
com.microsoft.Office.Outlook,40,1739732999,1739733039,1739733039.288235,-21600,EB445137-D7F5-57EC-87DA-1DB460D64046,"iPhone13,2"
com.microsoft.Office.Outlook,19,1739732976,1739732995,1739732995.149256,-21600,EB445137-D7F5-57EC-87DA-1DB460D64046,"iPhone13,2"
com.apple.Music,2,1739732974,1739732976,1739732976.604237,-21600,EB445137-D7F5-57EC-87DA-1DB460D64046,"iPhone13,2"
com.apple.Music,19,1739731304,1739731323,1739731324.8402982,-21600,EB445137-D7F5-57EC-87DA-1DB460D64046,"iPhone13,2"
com.apple.weather,2,1739731300,1739731302,1739731302.38463,-21600,EB445137-D7F5-57EC-87DA-1DB460D64046,"iPhone13,2"
com.apple.weather,4,1739730184,1739730188,1739730189.1478171,-21600,EB445137-D7F5-57EC-87DA-1DB460D64046,"iPhone13,2"
