app,usage,start_time,end_time,created_at,tz,device_id,device_model
com.apple.finder,27,1734751714,1734751741,1734751741.4768791,-21600,,
com.google.Chrome,1098,1734750616,1734751714,1734751714.9021711,-21600,,
com.google.Chrome,5,1734562442,1734562447,1734562447.4329572,-21600,,
com.apple.finder,0,1734562442,1734562442,1734562442.993071,-21600,,
com.microsoft.onenote.mac,67,1734562375,1734562442,1734562442.649085,-21600,,
com.google.android.studio,228,1734562147,1734562375,1734562375.63619,-21600,,
com.apple.dt.Xcode,1,1734562146,1734562147,1734562148.0682712,-21600,,
com.google.Chrome,5,1734562141,1734562146,1734562146.1385388,-21600,,
com.apple.dt.Xcode,1,1734562140,1734562141,1734562141.0840611,-21600,,
com.google.android.studio,12,1734562128,1734562140,1734562140.06777,-21600,,
com.apple.dt.Xcode,1,1734562127,1734562128,1734562128.463254,-21600,,
com.google.android.studio,17,1734562110,1734562127,1734562127.4712749,-21600,,
com.apple.dt.Xcode,2,1734562108,1734562110,1734562110.601664,-21600,,
com.google.Chrome,66,1734562042,1734562108,1734562108.47018,-21600,,
com.apple.dt.Xcode,1,1734562041,1734562042,1734562042.563626,-21600,,
com.google.android.studio,53,1734561988,1734562041,1734562042.038663,-21600,,
com.apple.dt.Xcode,1,1734561987,1734561988,1734561988.747886,-21600,,
com.google.Chrome,87,1734561900,1734561987,1734561987.1247458,-21600,,
com.apple.dt.Xcode,1,1734561899,1734561900,1734561900.840266,-21600,,
com.google.Chrome,58,1734561841,1734561899,1734561899.565199,-21600,,
com.apple.dt.Xcode,1,1734561840,1734561841,1734561841.699584,-21600,,
com.google.android.studio,5,1734561835,1734561840,1734561840.515487,-21600,,
com.apple.dt.Xcode,3,1734561832,1734561835,1734561835.0449572,-21600,,
com.google.Chrome,3,1734561829,1734561832,1734561832.495851,-21600,,
com.apple.dt.Xcode,2,1734561827,1734561829,1734561829.8911371,-21600,,
com.google.android.studio,265,1734561562,1734561827,1734561828.042986,-21600,,
com.apple.dt.Xcode,8,1734561554,1734561562,1734561562.9574351,-21600,,
com.google.android.studio,71,1734561483,1734561554,1734561555.011798,-21600,,
com.google.Chrome,1,1734561482,1734561483,1734561483.345103,-21600,,
com.google.android.studio,7,1734561475,1734561482,1734561482.2101378,-21600,,
com.google.Chrome,43,1734561432,1734561475,1734561475.815608,-21600,,
com.google.android.studio,280,1734561152,1734561432,1734561432.1911669,-21600,,
com.apple.dt.Xcode,3,1734561149,1734561152,1734561152.263651,-21600,,
com.google.android.studio,45,1734561104,1734561149,1734561149.2536058,-21600,,
com.apple.dt.Xcode,1,1734561103,1734561104,1734561104.607094,-21600,,
com.google.android.studio,4,1734561099,1734561103,1734561103.3175201,-21600,,
com.apple.dt.Xcode,1,1734561098,1734561099,1734561099.365931,-21600,,
com.google.android.studio,51,1734561047,1734561098,1734561098.061903,-21600,,
com.apple.dt.Xcode,6,1734561041,1734561047,1734561047.5346909,-21600,,
com.google.android.studio,5,1734561036,1734561041,1734561041.901582,-21600,,
com.apple.dt.Xcode,5,1734561031,1734561036,1734561036.132082,-21600,,
com.google.android.studio,6,1734561025,1734561031,1734561031.967829,-21600,,
com.apple.dt.Xcode,2,1734561023,1734561025,1734561025.310498,-21600,,
com.google.android.studio,2,1734561021,1734561023,1734561023.1973882,-21600,,
com.apple.dt.Xcode,2,1734561019,1734561021,1734561022.03096,-21600,,
com.google.android.studio,108,1734560911,1734561019,1734561019.79283,-21600,,
com.apple.dt.Xcode,1,1734560910,1734560911,1734560911.85749,-21600,,
com.google.android.studio,1,1734560909,1734560910,1734560910.1335568,-21600,,
com.apple.dt.Xcode,1,1734560908,1734560909,1734560909.082782,-21600,,
com.google.android.studio,12,1734560896,1734560908,1734560908.0906239,-21600,,
com.apple.dt.Xcode,3,1734560893,1734560896,1734560896.6307812,-21600,,
com.google.android.studio,62,1734560831,1734560893,1734560893.986683,-21600,,
com.apple.dt.Xcode,1,1734560830,1734560831,1734560831.774518,-21600,,
com.google.android.studio,14,1734560816,1734560830,1734560830.54387,-21600,,
com.apple.dt.Xcode,1,1734560815,1734560816,1734560816.8103008,-21600,,
com.google.android.studio,52,1734560763,1734560815,1734560815.758606,-21600,,
com.apple.dt.Xcode,2,1734560761,1734560763,1734560763.560988,-21600,,
com.google.android.studio,3,1734560758,1734560761,1734560761.533818,-21600,,
com.apple.dt.Xcode,8,1734560750,1734560758,1734560758.815598,-21600,,
com.google.android.studio,15,1734560735,1734560750,1734560750.554383,-21600,,
com.apple.dt.Xcode,2,1734560733,1734560735,1734560735.769936,-21600,,
com.google.android.studio,6,1734560727,1734560733,1734560733.6580858,-21600,,
com.apple.dt.Xcode,1,1734560726,1734560727,1734560727.1105762,-21600,,
com.google.android.studio,4,1734560722,1734560726,1734560726.141793,-21600,,
com.apple.dt.Xcode,1,1734560721,1734560722,1734560722.565627,-21600,,
com.google.android.studio,14,1734560707,1734560721,1734560721.038158,-21600,,
com.apple.dt.Xcode,4,1734560703,1734560707,1734560707.230476,-21600,,
com.google.android.studio,3,1734560700,1734560703,1734560703.8967261,-21600,,
com.apple.dt.Xcode,1,1734560699,1734560700,1734560700.549221,-21600,,
com.google.android.studio,2,1734560697,1734560699,1734560699.347146,-21600,,
com.apple.dt.Xcode,83,1734560614,1734560697,1734560698.037191,-21600,,
com.google.android.studio,9,1734560605,1734560614,1734560614.519918,-21600,,
com.apple.dt.Xcode,2,1734560603,1734560605,1734560605.151832,-21600,,
com.google.android.studio,1,1734560602,1734560603,1734560603.1761851,-21600,,
com.google.Chrome,1,1734560601,1734560602,1734560602.312346,-21600,,
com.google.android.studio,199,1734560402,1734560601,1734560601.337677,-21600,,
com.google.Chrome,0,1734560402,1734560402,1734560402.700392,-21600,,
com.google.android.studio,2,1734560400,1734560402,1734560402.1705852,-21600,,
com.google.Chrome,36,1734560364,1734560400,1734560400.989633,-21600,,
com.google.android.studio,3,1734560361,1734560364,1734560364.870525,-21600,,
com.apple.dt.Xcode,12,1734560349,1734560361,1734560361.309412,-21600,,
com.google.android.studio,3,1734560346,1734560349,1734560349.748619,-21600,,
com.apple.dt.Xcode,11,1734560335,1734560346,1734560346.293034,-21600,,
com.google.android.studio,7,1734560328,1734560335,1734560336.052026,-21600,,
com.apple.dt.Xcode,11,1734560317,1734560328,1734560328.118939,-21600,,
com.google.android.studio,34,1734560283,1734560317,1734560317.8881788,-21600,,
com.apple.dt.Xcode,6,1734560277,1734560283,1734560283.400634,-21600,,
com.google.android.studio,216,1734560061,1734560277,1734560277.088923,-21600,,
com.apple.dt.Xcode,3,1734560058,1734560061,1734560061.727209,-21600,,
com.google.android.studio,307,1734559751,1734560058,1734560059.012629,-21600,,
com.apple.dt.Xcode,2,1734559749,1734559751,1734559751.2267818,-21600,,
com.google.android.studio,52,1734559697,1734559749,1734559749.739394,-21600,,
com.apple.dt.Xcode,10,1734559687,1734559697,1734559697.131748,-21600,,
com.google.android.studio,472,1734559215,1734559687,1734559687.406577,-21600,,
com.apple.dt.Xcode,132,1734559083,1734559215,1734559215.9347801,-21600,,
com.google.android.studio,235,1734558848,1734559083,1734559083.770787,-21600,,
com.google.Chrome,56,1734558792,1734558848,1734558848.9635139,-21600,,
com.google.android.studio,78,1734558714,1734558792,1734558792.812045,-21600,,
com.google.Chrome,39,1734558631,1734558670,1734558670.376554,-21600,,
com.google.Chrome,3,1734558234,1734558237,1734558237.5742722,-21600,,
com.apple.MobileSMS,3,1734558231,1734558234,1734558234.309737,-21600,,
com.google.Chrome,10,1734558221,1734558231,1734558231.5623121,-21600,,
com.google.Chrome,325,1734557795,1734558120,1734558120.0552511,-21600,,
com.google.Chrome,304,1734557152,1734557456,1734557456.9638839,-21600,,
com.google.Chrome,516,1734556362,1734556878,1734556878.4715729,-21600,,
com.google.Chrome,303,1734556053,1734556356,1734556357.018014,-21600,,
com.google.Chrome,1591,1734554306,1734555897,1734555897.585054,-21600,,
com.apple.news,142,1734554164,1734554306,1734554306.4931111,-21600,,
com.google.Chrome,67,1734554097,1734554164,1734554164.834552,-21600,,
com.google.Chrome,473,1734553563,1734554036,1734554036.079638,-21600,,
com.google.Chrome,375,1734553126,1734553501,1734553501.165858,-21600,,
com.google.Chrome,303,1734552510,1734552813,1734552813.808223,-21600,,
com.google.Chrome,310,1734551810,1734552120,1734552120.290005,-21600,,
com.google.Chrome,479,1734551015,1734551494,1734551494.7242398,-21600,,
com.apple.MobileSMS,10,1734551005,1734551015,1734551015.592922,-21600,,
com.google.Chrome,2,1734551003,1734551005,1734551005.312648,-21600,,
com.google.Chrome,339,1734550528,1734550867,1734550867.504715,-21600,,
com.google.Chrome,130,1734547652,1734547782,1734547783.092459,-21600,,
com.google.Chrome,320,1734546050,1734546370,1734546370.670486,-21600,,
com.google.Chrome,4,1734545024,1734545028,1734545028.9065251,-21600,,
com.apple.weather,16,1734508833,1734508849,1734508849.12971,-21600,EB445137-D7F5-57EC-87DA-1DB460D64046,"iPhone13,2"
com.apple.weather,13,1734503889,1734503902,1734503902.398627,-21600,EB445137-D7F5-57EC-87DA-1DB460D64046,"iPhone13,2"
com.apple.weather,2,1734503881,1734503883,1734503883.3619199,-21600,EB445137-D7F5-57EC-87DA-1DB460D64046,"iPhone13,2"
com.apple.weather,13,1734503149,1734503162,1734503162.540889,-21600,EB445137-D7F5-57EC-87DA-1DB460D64046,"iPhone13,2"
com.apple.weather,1,1734503121,1734503122,1734503122.6522288,-21600,EB445137-D7F5-57EC-87DA-1DB460D64046,"iPhone13,2"
com.apple.weather,44,1734503068,1734503112,1734503112.3190088,-21600,EB445137-D7F5-57EC-87DA-1DB460D64046,"iPhone13,2"
com.google.chrome.ios,2,1734503066,1734503068,1734503068.996342,-21600,EB445137-D7F5-57EC-87DA-1DB460D64046,"iPhone13,2"
com.google.chrome.ios,13,1734502316,1734502329,1734502329.43659,-21600,EB445137-D7F5-57EC-87DA-1DB460D64046,"iPhone13,2"
com.google.chrome.ios,60,1734502256,1734502316,1734502316.671287,-21600,EB445137-D7F5-57EC-87DA-1DB460D64046,"iPhone13,2"
com.google.chrome.ios,1,1734502040,1734502041,1734502041.688251,-21600,EB445137-D7F5-57EC-87DA-1DB460D64046,"iPhone13,2"
com.google.chrome.ios,1,1734502033,1734502034,1734502034.32135,-21600,EB445137-D7F5-57EC-87DA-1DB460D64046,"iPhone13,2"
com.google.chrome.ios,32,1734501503,1734501535,1734501535.567529,-21600,EB445137-D7F5-57EC-87DA-1DB460D64046,"iPhone13,2"
com.google.chrome.ios,19,1734499878,1734499897,1734499898.70979,-21600,EB445137-D7F5-57EC-87DA-1DB460D64046,"iPhone13,2"
com.google.chrome.ios,36,1734499257,1734499293,1734499293.441103,-21600,EB445137-D7F5-57EC-87DA-1DB460D64046,"iPhone13,2"
com.apple.Health,2,1734499255,1734499257,1734499257.992857,-21600,EB445137-D7F5-57EC-87DA-1DB460D64046,"iPhone13,2"
com.apple.Health,34,1734498567,1734498601,1734498601.774708,-21600,EB445137-D7F5-57EC-87DA-1DB460D64046,"iPhone13,2"
com.apple.MobileSMS,33,1734496428,1734496461,1734496461.493911,-21600,EB445137-D7F5-57EC-87DA-1DB460D64046,"iPhone13,2"
com.apple.MobileSMS,5,1734496206,1734496211,1734496211.936692,-21600,EB445137-D7F5-57EC-87DA-1DB460D64046,"iPhone13,2"
com.apple.MobileSMS,7,1734496176,1734496183,1734496183.341572,-21600,EB445137-D7F5-57EC-87DA-1DB460D64046,"iPhone13,2"
com.apple.MobileSMS,4,1734496121,1734496125,1734496125.135916,-21600,EB445137-D7F5-57EC-87DA-1DB460D64046,"iPhone13,2"
com.apple.MobileSMS,20,1734496098,1734496118,1734496118.60296,-21600,EB445137-D7F5-57EC-87DA-1DB460D64046,"iPhone13,2"
com.apple.MobileSMS,71,1734496023,1734496094,1734496094.5589051,-21600,EB445137-D7F5-57EC-87DA-1DB460D64046,"iPhone13,2"
com.apple.MobileSMS,76,1734495936,1734496012,1734496012.0611892,-21600,EB445137-D7F5-57EC-87DA-1DB460D64046,"iPhone13,2"
com.apple.MobileSMS,49,1734495846,1734495895,1734495895.934097,-21600,EB445137-D7F5-57EC-87DA-1DB460D64046,"iPhone13,2"
com.apple.MobileSMS,35,1734495803,1734495838,1734495838.410111,-21600,EB445137-D7F5-57EC-87DA-1DB460D64046,"iPhone13,2"
com.apple.MobileSMS,39,1734495742,1734495781,1734495782.4174562,-21600,EB445137-D7F5-57EC-87DA-1DB460D64046,"iPhone13,2"
com.apple.news,2,1734495740,1734495742,1734495743.185513,-21600,EB445137-D7F5-57EC-87DA-1DB460D64046,"iPhone13,2"
com.apple.news,6,1734495722,1734495728,1734495728.888283,-21600,EB445137-D7F5-57EC-87DA-1DB460D64046,"iPhone13,2"
com.apple.news,13,1734495698,1734495711,1734495711.782402,-21600,EB445137-D7F5-57EC-87DA-1DB460D64046,"iPhone13,2"
com.apple.news,31,1734495555,1734495586,1734495586.351064,-21600,EB445137-D7F5-57EC-87DA-1DB460D64046,"iPhone13,2"
com.apple.news,2,1734495545,1734495547,1734495547.853488,-21600,EB445137-D7F5-57EC-87DA-1DB460D64046,"iPhone13,2"
com.hammerandchisel.discord,44,1734494806,1734494850,1734494850.2489061,-21600,EB445137-D7F5-57EC-87DA-1DB460D64046,"iPhone13,2"
com.hammerandchisel.discord,5,1734494198,1734494203,1734494203.5740352,-21600,EB445137-D7F5-57EC-87DA-1DB460D64046,"iPhone13,2"
com.hammerandchisel.discord,15,1734494182,1734494197,1734494197.574842,-21600,EB445137-D7F5-57EC-87DA-1DB460D64046,"iPhone13,2"
com.hammerandchisel.discord,2,1734494180,1734494182,1734494182.0318708,-21600,EB445137-D7F5-57EC-87DA-1DB460D64046,"iPhone13,2"
com.truebill.truebillnative,34,1734494135,1734494169,1734494169.193135,-21600,EB445137-D7F5-57EC-87DA-1DB460D64046,"iPhone13,2"
com.discoverfinancial.mobile,3,1734494128,1734494131,1734494132.142161,-21600,EB445137-D7F5-57EC-87DA-1DB460D64046,"iPhone13,2"
com.apple.camera,0,1734494128,1734494128,1734494128.9781752,-21600,EB445137-D7F5-57EC-87DA-1DB460D64046,"iPhone13,2"
com.discoverfinancial.mobile,2,1734494119,1734494121,1734494121.490273,-21600,EB445137-D7F5-57EC-87DA-1DB460D64046,"iPhone13,2"
com.discoverfinancial.mobile,44,1734493514,1734493558,1734493558.7708778,-21600,EB445137-D7F5-57EC-87DA-1DB460D64046,"iPhone13,2"
com.apple.findmy,6,1734493111,1734493117,1734493118.578545,-21600,EB445137-D7F5-57EC-87DA-1DB460D64046,"iPhone13,2"
com.google.Chrome,445,1734492655,1734493100,1734493100.816523,-21600,,
com.google.Chrome,588,1734491813,1734492401,1734492401.3439178,-21600,,
com.google.Chrome,352,1734491454,1734491806,1734491806.4819589,-21600,,
com.apple.findmy,17,1734488766,1734488783,1734488783.219145,-21600,EB445137-D7F5-57EC-87DA-1DB460D64046,"iPhone13,2"
com.microsoft.Office.Outlook,5,1734488623,1734488628,1734488628.046123,-21600,EB445137-D7F5-57EC-87DA-1DB460D64046,"iPhone13,2"
com.apple.MobileSMS,4,1734488619,1734488623,1734488623.132966,-21600,EB445137-D7F5-57EC-87DA-1DB460D64046,"iPhone13,2"
com.apple.MobileSMS,7,1734488110,1734488117,1734488117.702036,-21600,EB445137-D7F5-57EC-87DA-1DB460D64046,"iPhone13,2"
com.apple.MobileSMS,3,1734487214,1734487217,1734487217.516963,-21600,EB445137-D7F5-57EC-87DA-1DB460D64046,"iPhone13,2"
com.google.Chrome,4100,1734487090,1734491190,1734491190.79792,-21600,,
com.apple.MobileSMS,30,1734486600,1734486630,1734486630.521929,-21600,EB445137-D7F5-57EC-87DA-1DB460D64046,"iPhone13,2"
com.microsoft.Office.Outlook,2,1734486598,1734486600,1734486600.2327862,-21600,EB445137-D7F5-57EC-87DA-1DB460D64046,"iPhone13,2"
com.apple.MobileSMS,129,1734486463,1734486592,1734486592.914384,-21600,EB445137-D7F5-57EC-87DA-1DB460D64046,"iPhone13,2"
com.google.Chrome,1184,1734485887,1734487071,1734487071.066226,-21600,,
com.apple.news,47,1734485717,1734485764,1734485764.730002,-21600,EB445137-D7F5-57EC-87DA-1DB460D64046,"iPhone13,2"
com.apple.news,133,1734485569,1734485702,1734485702.821535,-21600,EB445137-D7F5-57EC-87DA-1DB460D64046,"iPhone13,2"
com.apple.findmy,8,1734485548,1734485556,1734485556.5892,-21600,EB445137-D7F5-57EC-87DA-1DB460D64046,"iPhone13,2"
com.toyopagroup.picaboo,6,1734485542,1734485548,1734485548.6817389,-21600,EB445137-D7F5-57EC-87DA-1DB460D64046,"iPhone13,2"
com.toyopagroup.picaboo,2,1734485183,1734485185,1734485185.4073138,-21600,EB445137-D7F5-57EC-87DA-1DB460D64046,"iPhone13,2"
com.google.Chrome,623,1734485079,1734485702,1734485702.840864,-21600,,
com.google.Chrome,304,1734484556,1734484860,1734484861.009896,-21600,,
com.toyopagroup.picaboo,6,1734484197,1734484203,1734484203.841774,-21600,EB445137-D7F5-57EC-87DA-1DB460D64046,"iPhone13,2"
com.instructure.icanvas,3,1734484194,1734484197,1734484199.02085,-21600,EB445137-D7F5-57EC-87DA-1DB460D64046,"iPhone13,2"
com.google.Chrome,587,1734483916,1734484503,1734484503.817781,-21600,,
com.google.Chrome,306,1734483315,1734483621,1734483621.2611961,-21600,,
com.instructure.icanvas,3,1734482828,1734482831,1734482832.002294,-21600,EB445137-D7F5-57EC-87DA-1DB460D64046,"iPhone13,2"
com.instructure.icanvas,6,1734482821,1734482827,1734482827.587609,-21600,EB445137-D7F5-57EC-87DA-1DB460D64046,"iPhone13,2"
com.google.Chrome,638,1734482562,1734483200,1734483200.195833,-21600,,
com.instructure.icanvas,20,1734481807,1734481827,1734481827.637978,-21600,EB445137-D7F5-57EC-87DA-1DB460D64046,"iPhone13,2"
com.google.Chrome,739,1734481789,1734482528,1734482528.866191,-21600,,
com.google.Chrome,1114,1734478354,1734479468,1734479469.231264,-21600,,
com.apple.news,313,1734478024,1734478337,1734478337.607569,-21600,EB445137-D7F5-57EC-87DA-1DB460D64046,"iPhone13,2"
com.google.chrome.ios,65,1734477959,1734478024,1734478024.58745,-21600,EB445137-D7F5-57EC-87DA-1DB460D64046,"iPhone13,2"
com.apple.news,214,1734477744,1734477958,1734477958.79635,-21600,EB445137-D7F5-57EC-87DA-1DB460D64046,"iPhone13,2"
com.apple.news,9,1734477725,1734477734,1734477734.383542,-21600,EB445137-D7F5-57EC-87DA-1DB460D64046,"iPhone13,2"
com.apple.news,3,1734477722,1734477725,1734477725.416757,-21600,EB445137-D7F5-57EC-87DA-1DB460D64046,"iPhone13,2"
com.burbn.instagram,342,1734477374,1734477716,1734477716.8555732,-21600,EB445137-D7F5-57EC-87DA-1DB460D64046,"iPhone13,2"
com.google.Gmail,7,1734477367,1734477374,1734477374.428756,-21600,EB445137-D7F5-57EC-87DA-1DB460D64046,"iPhone13,2"
com.apple.findmy,3,1734477364,1734477367,1734477367.836976,-21600,EB445137-D7F5-57EC-87DA-1DB460D64046,"iPhone13,2"
com.google.Chrome,426,1734477228,1734477654,1734477654.011636,-21600,,
com.apple.findmy,10,1734477207,1734477217,1734477217.067069,-21600,EB445137-D7F5-57EC-87DA-1DB460D64046,"iPhone13,2"
com.burbn.instagram,328,1734476869,1734477197,1734477197.6671271,-21600,EB445137-D7F5-57EC-87DA-1DB460D64046,"iPhone13,2"
com.apple.news,683,1734476181,1734476864,1734476864.36909,-21600,EB445137-D7F5-57EC-87DA-1DB460D64046,"iPhone13,2"
com.google.Gmail,19,1734476153,1734476172,1734476172.06532,-21600,EB445137-D7F5-57EC-87DA-1DB460D64046,"iPhone13,2"
com.amazon.Amazon,127,1734476022,1734476149,1734476149.5545459,-21600,EB445137-D7F5-57EC-87DA-1DB460D64046,"iPhone13,2"
com.apple.MobileSMS,8,1734476014,1734476022,1734476022.875945,-21600,EB445137-D7F5-57EC-87DA-1DB460D64046,"iPhone13,2"
com.apple.findmy,7,1734476004,1734476011,1734476011.898541,-21600,EB445137-D7F5-57EC-87DA-1DB460D64046,"iPhone13,2"
com.apple.MobileSMS,30,1734475865,1734475895,1734475895.982868,-21600,EB445137-D7F5-57EC-87DA-1DB460D64046,"iPhone13,2"
com.apple.findmy,6,1734475859,1734475865,1734475865.7059112,-21600,EB445137-D7F5-57EC-87DA-1DB460D64046,"iPhone13,2"
com.apple.findmy,3,1734475655,1734475658,1734475658.30903,-21600,EB445137-D7F5-57EC-87DA-1DB460D64046,"iPhone13,2"
com.apple.findmy,13,1734474876,1734474889,1734474889.81879,-21600,EB445137-D7F5-57EC-87DA-1DB460D64046,"iPhone13,2"
com.apple.news,2,1734474874,1734474876,1734474876.303393,-21600,EB445137-D7F5-57EC-87DA-1DB460D64046,"iPhone13,2"
com.apple.news,23,1734474820,1734474843,1734474843.297818,-21600,EB445137-D7F5-57EC-87DA-1DB460D64046,"iPhone13,2"
com.apple.findmy,4,1734474809,1734474813,1734474813.489769,-21600,EB445137-D7F5-57EC-87DA-1DB460D64046,"iPhone13,2"
com.apple.findmy,10,1734474789,1734474799,1734474799.6370878,-21600,EB445137-D7F5-57EC-87DA-1DB460D64046,"iPhone13,2"
com.toyopagroup.picaboo,49,1734474485,1734474534,1734474534.958359,-21600,EB445137-D7F5-57EC-87DA-1DB460D64046,"iPhone13,2"
com.apple.findmy,9,1734471151,1734471160,1734471161.1376219,-21600,EB445137-D7F5-57EC-87DA-1DB460D64046,"iPhone13,2"
com.apple.findmy,10,1734471098,1734471108,1734471108.676908,-21600,EB445137-D7F5-57EC-87DA-1DB460D64046,"iPhone13,2"
com.apple.Music,2,1734471095,1734471097,1734471098.253187,-21600,EB445137-D7F5-57EC-87DA-1DB460D64046,"iPhone13,2"
com.apple.Music,12,1734470815,1734470827,1734470827.7305899,-21600,EB445137-D7F5-57EC-87DA-1DB460D64046,"iPhone13,2"
com.apple.Music,27,1734469659,1734469686,1734469686.878047,-21600,EB445137-D7F5-57EC-87DA-1DB460D64046,"iPhone13,2"
com.apple.Music,14,1734469625,1734469639,1734469639.2900329,-21600,EB445137-D7F5-57EC-87DA-1DB460D64046,"iPhone13,2"
com.apple.Music,6,1734467795,1734467801,1734467802.0028691,-21600,EB445137-D7F5-57EC-87DA-1DB460D64046,"iPhone13,2"
com.apple.Music,131,1734467425,1734467556,1734467556.400938,-21600,EB445137-D7F5-57EC-87DA-1DB460D64046,"iPhone13,2"
com.apple.podcasts,11,1734467414,1734467425,1734467425.416288,-21600,EB445137-D7F5-57EC-87DA-1DB460D64046,"iPhone13,2"
com.apple.podcasts,7,1734467107,1734467114,1734467114.850494,-21600,EB445137-D7F5-57EC-87DA-1DB460D64046,"iPhone13,2"
com.apple.podcasts,18,1734466768,1734466786,1734466786.97093,-21600,EB445137-D7F5-57EC-87DA-1DB460D64046,"iPhone13,2"
com.apple.podcasts,14,1734466007,1734466021,1734466021.8736758,-21600,EB445137-D7F5-57EC-87DA-1DB460D64046,"iPhone13,2"
com.apple.podcasts,7,1734465391,1734465398,1734465398.0876122,-21600,EB445137-D7F5-57EC-87DA-1DB460D64046,"iPhone13,2"
com.apple.podcasts,3,1734465357,1734465360,1734465360.475782,-21600,EB445137-D7F5-57EC-87DA-1DB460D64046,"iPhone13,2"
com.apple.podcasts,10,1734465346,1734465356,1734465356.192766,-21600,EB445137-D7F5-57EC-87DA-1DB460D64046,"iPhone13,2"
com.apple.podcasts,5,1734465267,1734465272,1734465272.507375,-21600,EB445137-D7F5-57EC-87DA-1DB460D64046,"iPhone13,2"
com.apple.podcasts,17,1734464498,1734464515,1734464515.788629,-21600,EB445137-D7F5-57EC-87DA-1DB460D64046,"iPhone13,2"
com.apple.podcasts,2,1734464449,1734464451,1734464451.681191,-21600,EB445137-D7F5-57EC-87DA-1DB460D64046,"iPhone13,2"
com.apple.podcasts,16,1734463647,1734463663,1734463663.242558,-21600,EB445137-D7F5-57EC-87DA-1DB460D64046,"iPhone13,2"
com.apple.podcasts,5,1734463612,1734463617,1734463617.524167,-21600,EB445137-D7F5-57EC-87DA-1DB460D64046,"iPhone13,2"
com.apple.podcasts,2,1734463138,1734463140,1734463140.841521,-21600,EB445137-D7F5-57EC-87DA-1DB460D64046,"iPhone13,2"
com.apple.podcasts,50,1734462642,1734462692,1734462692.581795,-21600,EB445137-D7F5-57EC-87DA-1DB460D64046,"iPhone13,2"
com.google.chrome.ios,6,1734462636,1734462642,1734462642.2918591,-21600,EB445137-D7F5-57EC-87DA-1DB460D64046,"iPhone13,2"
com.google.chrome.ios,20,1734462086,1734462106,1734462106.784192,-21600,EB445137-D7F5-57EC-87DA-1DB460D64046,"iPhone13,2"
com.apple.MobileSMS,9,1734461696,1734461705,1734461705.850344,-21600,EB445137-D7F5-57EC-87DA-1DB460D64046,"iPhone13,2"
com.apple.Music,4,1734461692,1734461696,1734461696.047951,-21600,EB445137-D7F5-57EC-87DA-1DB460D64046,"iPhone13,2"
com.apple.camera,0,1734461692,1734461692,1734461692.89288,-21600,EB445137-D7F5-57EC-87DA-1DB460D64046,"iPhone13,2"
com.apple.Music,5,1734461474,1734461479,1734461479.534868,-21600,EB445137-D7F5-57EC-87DA-1DB460D64046,"iPhone13,2"
com.apple.podcasts,38,1734461435,1734461473,1734461473.1953459,-21600,EB445137-D7F5-57EC-87DA-1DB460D64046,"iPhone13,2"
com.apple.MobileSMS,28,1734461393,1734461421,1734461421.4303951,-21600,EB445137-D7F5-57EC-87DA-1DB460D64046,"iPhone13,2"
com.apple.camera,2,1734461374,1734461376,1734461376.632639,-21600,EB445137-D7F5-57EC-87DA-1DB460D64046,"iPhone13,2"
com.apple.MobileSMS,110,1734461262,1734461372,1734461372.252964,-21600,EB445137-D7F5-57EC-87DA-1DB460D64046,"iPhone13,2"
com.truebill.truebillnative,3,1734461259,1734461262,1734461262.043261,-21600,EB445137-D7F5-57EC-87DA-1DB460D64046,"iPhone13,2"
com.truebill.truebillnative,44,1734460386,1734460430,1734460430.69411,-21600,EB445137-D7F5-57EC-87DA-1DB460D64046,"iPhone13,2"
com.clairmail.fth.client,41,1734460344,1734460385,1734460385.2142549,-21600,EB445137-D7F5-57EC-87DA-1DB460D64046,"iPhone13,2"
com.toyopagroup.picaboo,14,1734460216,1734460230,1734460230.675726,-21600,EB445137-D7F5-57EC-87DA-1DB460D64046,"iPhone13,2"
com.apple.camera,7,1734460208,1734460215,1734460215.132863,-21600,EB445137-D7F5-57EC-87DA-1DB460D64046,"iPhone13,2"
com.apple.MobileSMS,9,1734460207,1734460216,1734460217.003364,-21600,EB445137-D7F5-57EC-87DA-1DB460D64046,"iPhone13,2"
com.apple.MobileSMS,8,1734458714,1734458722,1734458722.6092172,-21600,EB445137-D7F5-57EC-87DA-1DB460D64046,"iPhone13,2"
com.apple.MobileSMS,25,1734458294,1734458319,1734458319.9580889,-21600,EB445137-D7F5-57EC-87DA-1DB460D64046,"iPhone13,2"
com.apple.MobileSMS,3,1734458291,1734458294,1734458294.4650831,-21600,EB445137-D7F5-57EC-87DA-1DB460D64046,"iPhone13,2"
com.apple.MobileSMS,17,1734457213,1734457230,1734457230.497308,-21600,EB445137-D7F5-57EC-87DA-1DB460D64046,"iPhone13,2"
com.apple.MobileSMS,8,1734457204,1734457212,1734457212.3898149,-21600,EB445137-D7F5-57EC-87DA-1DB460D64046,"iPhone13,2"
com.apple.MobileSMS,25,1734457160,1734457185,1734457185.066864,-21600,EB445137-D7F5-57EC-87DA-1DB460D64046,"iPhone13,2"
com.apple.news,4,1734457156,1734457160,1734457160.9803739,-21600,EB445137-D7F5-57EC-87DA-1DB460D64046,"iPhone13,2"
com.apple.news,3,1734456038,1734456041,1734456041.7042952,-21600,EB445137-D7F5-57EC-87DA-1DB460D64046,"iPhone13,2"
com.apple.news,124,1734455512,1734455636,1734455636.788491,-21600,EB445137-D7F5-57EC-87DA-1DB460D64046,"iPhone13,2"
com.google.chrome.ios,51,1734455453,1734455504,1734455504.3958511,-21600,EB445137-D7F5-57EC-87DA-1DB460D64046,"iPhone13,2"
com.apple.MobileSMS,29,1734455423,1734455452,1734455452.100702,-21600,EB445137-D7F5-57EC-87DA-1DB460D64046,"iPhone13,2"
com.apple.MobileSMS,6,1734455414,1734455420,1734455420.823195,-21600,EB445137-D7F5-57EC-87DA-1DB460D64046,"iPhone13,2"
com.apple.news,1,1734455410,1734455411,1734455411.715119,-21600,EB445137-D7F5-57EC-87DA-1DB460D64046,"iPhone13,2"
com.apple.MobileSMS,13,1734455396,1734455409,1734455409.041978,-21600,EB445137-D7F5-57EC-87DA-1DB460D64046,"iPhone13,2"
com.apple.findmy,16,1734455380,1734455396,1734455396.927264,-21600,EB445137-D7F5-57EC-87DA-1DB460D64046,"iPhone13,2"
com.apple.Music,32,1734455347,1734455379,1734455380.047872,-21600,EB445137-D7F5-57EC-87DA-1DB460D64046,"iPhone13,2"
com.microsoft.Office.Outlook,16,1734455311,1734455327,1734455327.082031,-21600,EB445137-D7F5-57EC-87DA-1DB460D64046,"iPhone13,2"
com.robinhood.release.Robinhood,17,1734452803,1734452820,1734452820.1198459,-21600,EB445137-D7F5-57EC-87DA-1DB460D64046,"iPhone13,2"
com.microsoft.Office.Outlook,3,1734452778,1734452781,1734452782.0085058,-21600,EB445137-D7F5-57EC-87DA-1DB460D64046,"iPhone13,2"
com.apple.Health,73,1734452705,1734452778,1734452778.1916928,-21600,EB445137-D7F5-57EC-87DA-1DB460D64046,"iPhone13,2"
com.renpho.health,15,1734452690,1734452705,1734452705.79161,-21600,EB445137-D7F5-57EC-87DA-1DB460D64046,"iPhone13,2"
com.google.Chrome,34,1734452132,1734452166,1734452166.406901,-21600,,
com.apple.finder,8,1734452085,1734452093,1734452093.8791862,-21600,,
com.renpho.health,29,1734448452,1734448481,1734448482.016118,-21600,EB445137-D7F5-57EC-87DA-1DB460D64046,"iPhone13,2"
com.google.ios.youtube,1250,1734446059,1734447309,1734447310.525796,-21600,EB445137-D7F5-57EC-87DA-1DB460D64046,"iPhone13,2"
com.clairmail.fth.client,1,1734446054,1734446055,1734446055.829764,-21600,EB445137-D7F5-57EC-87DA-1DB460D64046,"iPhone13,2"
com.apple.MobileSMS,40,1734445998,1734446038,1734446038.74317,-21600,EB445137-D7F5-57EC-87DA-1DB460D64046,"iPhone13,2"
com.apple.camera,1,1734445962,1734445963,1734445963.211849,-21600,EB445137-D7F5-57EC-87DA-1DB460D64046,"iPhone13,2"
com.apple.camera,0,1734445962,1734445962,1734445962.86079,-21600,EB445137-D7F5-57EC-87DA-1DB460D64046,"iPhone13,2"
com.apple.camera,1,1734445951,1734445952,1734445952.250969,-21600,EB445137-D7F5-57EC-87DA-1DB460D64046,"iPhone13,2"
com.apple.mobiletimer,0,1734445942,1734445942,1734445942.705114,-21600,EB445137-D7F5-57EC-87DA-1DB460D64046,"iPhone13,2"
com.apple.mobiletimer,26,1734445801,1734445827,1734445827.0785298,-21600,EB445137-D7F5-57EC-87DA-1DB460D64046,"iPhone13,2"
com.apple.mobiletimer,13,1734414825,1734414838,1734414838.376481,-21600,EB445137-D7F5-57EC-87DA-1DB460D64046,"iPhone13,2"
com.apple.mobiletimer,13,1734414810,1734414823,1734414823.4710112,-21600,EB445137-D7F5-57EC-87DA-1DB460D64046,"iPhone13,2"
com.apple.finder,8,1734414590,1734414598,1734414599.06372,-21600,,
com.burbn.instagram,510,1734414071,1734414581,1734414581.7606502,-21600,EB445137-D7F5-57EC-87DA-1DB460D64046,"iPhone13,2"
com.apple.MobileSMS,3,1734414060,1734414063,1734414063.200799,-21600,EB445137-D7F5-57EC-87DA-1DB460D64046,"iPhone13,2"
com.apple.Music,541,1734414049,1734414590,1734414590.726413,-21600,,
com.google.Chrome,9,1734414040,1734414049,1734414050.016471,-21600,,
com.google.Chrome,316,1734413707,1734414023,1734414023.9898062,-21600,,
com.apple.Photos,361,1734413346,1734413707,1734413707.860574,-21600,,
com.google.Chrome,2,1734413344,1734413346,1734413346.614949,-21600,,
com.google.Chrome,326,1734413017,1734413343,1734413343.6180491,-21600,,
com.apple.Photos,75,1734412942,1734413017,1734413017.480557,-21600,,
com.apple.Photos,611,1734412328,1734412939,1734412939.042978,-21600,,
com.apple.Music,144,1734412184,1734412328,1734412328.8593779,-21600,,
com.apple.Music,341,1734411840,1734412181,1734412181.9193459,-21600,,
com.apple.finder,3,1734411837,1734411840,1734411840.875704,-21600,,
com.apple.Photos,15,1734411822,1734411837,1734411837.9914231,-21600,,
com.google.Chrome,37,1734411785,1734411822,1734411822.188338,-21600,,
com.apple.MobileSMS,12,1734409801,1734409813,1734409813.471169,-21600,EB445137-D7F5-57EC-87DA-1DB460D64046,"iPhone13,2"
com.apple.MobileSMS,9,1734409614,1734409623,1734409623.349907,-21600,EB445137-D7F5-57EC-87DA-1DB460D64046,"iPhone13,2"
com.apple.MobileSMS,6,1734409228,1734409234,1734409234.144895,-21600,EB445137-D7F5-57EC-87DA-1DB460D64046,"iPhone13,2"
com.google.ios.youtube,1,1734409226,1734409227,1734409227.91054,-21600,EB445137-D7F5-57EC-87DA-1DB460D64046,"iPhone13,2"
com.google.ios.youtube,3,1734409063,1734409066,1734409066.957865,-21600,EB445137-D7F5-57EC-87DA-1DB460D64046,"iPhone13,2"
com.google.ios.youtube,6,1734409050,1734409056,1734409056.3168259,-21600,EB445137-D7F5-57EC-87DA-1DB460D64046,"iPhone13,2"
com.google.ios.youtube,3,1734408612,1734408615,1734408615.098717,-21600,EB445137-D7F5-57EC-87DA-1DB460D64046,"iPhone13,2"
com.google.ios.youtube,132,1734407862,1734407994,1734407994.5446482,-21600,EB445137-D7F5-57EC-87DA-1DB460D64046,"iPhone13,2"
com.google.chrome.ios,3,1734407858,1734407861,1734407861.802679,-21600,EB445137-D7F5-57EC-87DA-1DB460D64046,"iPhone13,2"
com.apple.news,2,1734407856,1734407858,1734407858.411028,-21600,EB445137-D7F5-57EC-87DA-1DB460D64046,"iPhone13,2"
com.apple.news,23,1734406369,1734406392,1734406392.4335032,-21600,EB445137-D7F5-57EC-87DA-1DB460D64046,"iPhone13,2"
com.google.chrome.ios,31,1734406338,1734406369,1734406369.357161,-21600,EB445137-D7F5-57EC-87DA-1DB460D64046,"iPhone13,2"
com.apple.news,64,1734406273,1734406337,1734406337.456538,-21600,EB445137-D7F5-57EC-87DA-1DB460D64046,"iPhone13,2"
com.google.Chrome,50,1734405885,1734405935,1734405935.691279,-21600,,
com.apple.news,6,1734405819,1734405825,1734405825.339263,-21600,EB445137-D7F5-57EC-87DA-1DB460D64046,"iPhone13,2"
com.apple.news,3,1734405657,1734405660,1734405661.0291672,-21600,EB445137-D7F5-57EC-87DA-1DB460D64046,"iPhone13,2"
com.apple.news,514,1734404984,1734405498,1734405498.915903,-21600,EB445137-D7F5-57EC-87DA-1DB460D64046,"iPhone13,2"
com.apple.news,343,1734403979,1734404322,1734404322.860599,-21600,EB445137-D7F5-57EC-87DA-1DB460D64046,"iPhone13,2"
com.apple.news,102,1734403803,1734403905,1734403905.118463,-21600,EB445137-D7F5-57EC-87DA-1DB460D64046,"iPhone13,2"
com.apple.weather,7,1734403785,1734403792,1734403792.471087,-21600,EB445137-D7F5-57EC-87DA-1DB460D64046,"iPhone13,2"
com.apple.weather,12,1734402679,1734402691,1734402691.690724,-21600,EB445137-D7F5-57EC-87DA-1DB460D64046,"iPhone13,2"
com.google.Chrome,4,1734402636,1734402640,1734402640.942157,-21600,,
com.apple.iCal,48,1734402588,1734402636,1734402636.8291368,-21600,,
com.google.Chrome,3,1734402585,1734402588,1734402588.4438782,-21600,,
com.apple.MobileSMS,10,1734402575,1734402585,1734402585.709216,-21600,,
com.google.Chrome,18,1734402557,1734402575,1734402575.277272,-21600,,
com.apple.MobileSMS,95,1734402462,1734402557,1734402557.714517,-21600,,
com.google.Chrome,33,1734402429,1734402462,1734402462.555989,-21600,,
com.apple.findmy,15,1734402301,1734402316,1734402317.294763,-21600,EB445137-D7F5-57EC-87DA-1DB460D64046,"iPhone13,2"
com.burbn.instagram,97,1734401072,1734401169,1734401169.4627419,-21600,EB445137-D7F5-57EC-87DA-1DB460D64046,"iPhone13,2"
com.toyopagroup.picaboo,37,1734401026,1734401063,1734401063.1158528,-21600,EB445137-D7F5-57EC-87DA-1DB460D64046,"iPhone13,2"
com.toyopagroup.picaboo,5,1734400777,1734400782,1734400782.8502378,-21600,EB445137-D7F5-57EC-87DA-1DB460D64046,"iPhone13,2"
com.toyopagroup.picaboo,24,1734400710,1734400734,1734400734.4380422,-21600,EB445137-D7F5-57EC-87DA-1DB460D64046,"iPhone13,2"
com.toyopagroup.picaboo,54,1734400432,1734400486,1734400486.9373279,-21600,EB445137-D7F5-57EC-87DA-1DB460D64046,"iPhone13,2"
com.toyopagroup.picaboo,33,1734395489,1734395522,1734395522.731542,-21600,EB445137-D7F5-57EC-87DA-1DB460D64046,"iPhone13,2"
com.apple.news,4,1734395485,1734395489,1734395489.615765,-21600,EB445137-D7F5-57EC-87DA-1DB460D64046,"iPhone13,2"
com.apple.news,3,1734394028,1734394031,1734394031.82838,-21600,EB445137-D7F5-57EC-87DA-1DB460D64046,"iPhone13,2"
com.apple.news,72,1734390849,1734390921,1734390921.671251,-21600,EB445137-D7F5-57EC-87DA-1DB460D64046,"iPhone13,2"
com.apple.news,3,1734390511,1734390514,1734390514.63242,-21600,EB445137-D7F5-57EC-87DA-1DB460D64046,"iPhone13,2"
com.apple.news,64,1734390255,1734390319,1734390319.7178469,-21600,EB445137-D7F5-57EC-87DA-1DB460D64046,"iPhone13,2"
com.google.Docs,11,1734389510,1734389521,1734389521.8474,-21600,EB445137-D7F5-57EC-87DA-1DB460D64046,"iPhone13,2"
com.google.Gmail,21,1734389489,1734389510,1734389510.487508,-21600,EB445137-D7F5-57EC-87DA-1DB460D64046,"iPhone13,2"
com.apple.Maps,4,1734389485,1734389489,1734389490.095859,-21600,EB445137-D7F5-57EC-87DA-1DB460D64046,"iPhone13,2"
com.apple.Maps,63,1734388967,1734389030,1734389030.45313,-21600,EB445137-D7F5-57EC-87DA-1DB460D64046,"iPhone13,2"
com.hammerandchisel.discord,3,1734388963,1734388966,1734388966.619791,-21600,EB445137-D7F5-57EC-87DA-1DB460D64046,"iPhone13,2"
com.hammerandchisel.discord,4,1734388959,1734388963,1734388963.4771872,-21600,EB445137-D7F5-57EC-87DA-1DB460D64046,"iPhone13,2"
com.hammerandchisel.discord,12,1734387891,1734387903,1734387903.1813831,-21600,EB445137-D7F5-57EC-87DA-1DB460D64046,"iPhone13,2"
com.apple.camera,7,1734385510,1734385517,1734385517.744194,-21600,EB445137-D7F5-57EC-87DA-1DB460D64046,"iPhone13,2"
com.google.Chrome,320,1734384235,1734384555,1734384555.245619,-21600,,
com.google.Chrome,416,1734383799,1734384215,1734384215.39676,-21600,,
com.google.Chrome,705,1734383084,1734383789,1734383789.772028,-21600,,
com.clairmail.fth.client,37,1734382649,1734382686,1734382686.7905579,-21600,EB445137-D7F5-57EC-87DA-1DB460D64046,"iPhone13,2"
com.apple.calculator,4,1734382645,1734382649,1734382649.374971,-21600,EB445137-D7F5-57EC-87DA-1DB460D64046,"iPhone13,2"
com.clairmail.fth.client,1,1734382644,1734382645,1734382645.695245,-21600,EB445137-D7F5-57EC-87DA-1DB460D64046,"iPhone13,2"
com.apple.calculator,2,1734382642,1734382644,1734382644.07485,-21600,EB445137-D7F5-57EC-87DA-1DB460D64046,"iPhone13,2"
com.clairmail.fth.client,15,1734382627,1734382642,1734382642.021037,-21600,EB445137-D7F5-57EC-87DA-1DB460D64046,"iPhone13,2"
com.apple.calculator,4,1734382623,1734382627,1734382627.6931062,-21600,EB445137-D7F5-57EC-87DA-1DB460D64046,"iPhone13,2"
com.clairmail.fth.client,122,1734382501,1734382623,1734382623.027873,-21600,EB445137-D7F5-57EC-87DA-1DB460D64046,"iPhone13,2"
com.hammerandchisel.discord,13,1734382482,1734382495,1734382495.829605,-21600,EB445137-D7F5-57EC-87DA-1DB460D64046,"iPhone13,2"
com.google.Chrome,526,1734382461,1734382987,1734382987.319849,-21600,,
com.hammerandchisel.discord,14,1734382454,1734382468,1734382468.8784518,-21600,EB445137-D7F5-57EC-87DA-1DB460D64046,"iPhone13,2"
com.google.Chrome,0,1734382451,1734382451,1734382451.338694,-21600,,
com.hammerandchisel.discord,6,1734381968,1734381974,1734381974.505063,-21600,EB445137-D7F5-57EC-87DA-1DB460D64046,"iPhone13,2"
com.apple.Music,3,1734381965,1734381968,1734381968.43381,-21600,EB445137-D7F5-57EC-87DA-1DB460D64046,"iPhone13,2"
com.apple.Music,4,1734381081,1734381085,1734381085.65622,-21600,EB445137-D7F5-57EC-87DA-1DB460D64046,"iPhone13,2"
com.apple.mobileslideshow,5,1734381076,1734381081,1734381081.533385,-21600,EB445137-D7F5-57EC-87DA-1DB460D64046,"iPhone13,2"
com.apple.mobileslideshow,14,1734381061,1734381075,1734381075.261619,-21600,EB445137-D7F5-57EC-87DA-1DB460D64046,"iPhone13,2"
com.apple.camera,21,1734381035,1734381056,1734381056.337648,-21600,EB445137-D7F5-57EC-87DA-1DB460D64046,"iPhone13,2"
com.apple.mobileslideshow,22,1734381034,1734381056,1734381056.2547688,-21600,EB445137-D7F5-57EC-87DA-1DB460D64046,"iPhone13,2"
com.apple.mobileslideshow,4,1734381015,1734381019,1734381019.4579391,-21600,EB445137-D7F5-57EC-87DA-1DB460D64046,"iPhone13,2"
com.apple.camera,8,1734380999,1734381007,1734381007.997412,-21600,EB445137-D7F5-57EC-87DA-1DB460D64046,"iPhone13,2"
com.apple.mobileslideshow,8,1734380999,1734381007,1734381007.926557,-21600,EB445137-D7F5-57EC-87DA-1DB460D64046,"iPhone13,2"
com.apple.camera,16,1734380498,1734380514,1734380514.391076,-21600,EB445137-D7F5-57EC-87DA-1DB460D64046,"iPhone13,2"
com.apple.mobileslideshow,17,1734380497,1734380514,1734380514.388726,-21600,EB445137-D7F5-57EC-87DA-1DB460D64046,"iPhone13,2"
com.apple.mobileslideshow,2,1734380465,1734380467,1734380467.856865,-21600,EB445137-D7F5-57EC-87DA-1DB460D64046,"iPhone13,2"
com.google.chrome.ios,6,1734380459,1734380465,1734380465.150356,-21600,EB445137-D7F5-57EC-87DA-1DB460D64046,"iPhone13,2"
com.apple.Maps,3,1734380456,1734380459,1734380459.090231,-21600,EB445137-D7F5-57EC-87DA-1DB460D64046,"iPhone13,2"
com.apple.Maps,16,1734379966,1734379982,1734379982.893392,-21600,EB445137-D7F5-57EC-87DA-1DB460D64046,"iPhone13,2"
com.apple.mobileslideshow,43,1734379911,1734379954,1734379954.749974,-21600,EB445137-D7F5-57EC-87DA-1DB460D64046,"iPhone13,2"
com.google.chrome.ios,24,1734379886,1734379910,1734379910.203068,-21600,EB445137-D7F5-57EC-87DA-1DB460D64046,"iPhone13,2"
com.google.chrome.ios,2,1734379837,1734379839,1734379839.293709,-21600,EB445137-D7F5-57EC-87DA-1DB460D64046,"iPhone13,2"
com.google.chrome.ios,108,1734379694,1734379802,1734379802.342186,-21600,EB445137-D7F5-57EC-87DA-1DB460D64046,"iPhone13,2"
com.microsoft.Office.Outlook,7,1734379685,1734379692,1734379692.348796,-21600,EB445137-D7F5-57EC-87DA-1DB460D64046,"iPhone13,2"
com.toyopagroup.picaboo,14,1734379665,1734379679,1734379679.376636,-21600,EB445137-D7F5-57EC-87DA-1DB460D64046,"iPhone13,2"
com.google.Chrome,558,1734378626,1734379184,1734379184.362118,-21600,,
com.google.Chrome,504,1734378032,1734378536,1734378536.348332,-21600,,
com.google.Chrome,315,1734377450,1734377765,1734377765.3968182,-21600,,
com.google.Chrome,529,1734376813,1734377342,1734377342.222158,-21600,,
com.google.Chrome,429,1734376367,1734376796,1734376796.95582,-21600,,
com.google.Chrome,441,1734375686,1734376127,1734376127.476375,-21600,,
com.google.Chrome,483,1734374957,1734375440,1734375440.9644198,-21600,,
com.google.Chrome,309,1734374562,1734374871,1734374871.079467,-21600,,
com.google.Chrome,311,1734374153,1734374464,1734374464.1368542,-21600,,
com.google.Chrome,787,1734373360,1734374147,1734374147.731436,-21600,,
com.apple.MobileSMS,36,1734373324,1734373360,1734373360.53483,-21600,,
com.google.Chrome,5,1734373319,1734373324,1734373324.727227,-21600,,
com.apple.MobileSMS,6,1734373313,1734373319,1734373319.6524072,-21600,,
com.google.Chrome,33,1734373280,1734373313,1734373313.8883371,-21600,,
com.apple.MobileSMS,53,1734373227,1734373280,1734373280.39425,-21600,,
com.google.Chrome,1,1734373226,1734373227,1734373227.696919,-21600,,
com.apple.MobileSMS,2,1734373224,1734373226,1734373226.05403,-21600,,
com.google.Chrome,6,1734373218,1734373224,1734373224.863477,-21600,,
com.apple.MobileSMS,1,1734373217,1734373218,1734373218.628973,-21600,,
com.google.Chrome,8,1734373209,1734373217,1734373217.535993,-21600,,
com.apple.MobileSMS,55,1734373154,1734373209,1734373209.364438,-21600,,
com.google.Chrome,13,1734373141,1734373154,1734373154.3971438,-21600,,
com.apple.MobileSMS,80,1734373061,1734373141,1734373141.2857661,-21600,,
com.google.Chrome,16,1734373045,1734373061,1734373061.382203,-21600,,
com.toyopagroup.picaboo,19,1734372544,1734372563,1734372563.6171489,-21600,EB445137-D7F5-57EC-87DA-1DB460D64046,"iPhone13,2"
com.apple.Music,8,1734372536,1734372544,1734372544.239386,-21600,EB445137-D7F5-57EC-87DA-1DB460D64046,"iPhone13,2"
com.apple.Music,6,1734371828,1734371834,1734371834.398546,-21600,EB445137-D7F5-57EC-87DA-1DB460D64046,"iPhone13,2"
com.google.chrome.ios,5,1734371822,1734371827,1734371827.654585,-21600,EB445137-D7F5-57EC-87DA-1DB460D64046,"iPhone13,2"
com.google.chrome.ios,3,1734370981,1734370984,1734370984.8204908,-21600,EB445137-D7F5-57EC-87DA-1DB460D64046,"iPhone13,2"
com.google.chrome.ios,6,1734370947,1734370953,1734370953.197612,-21600,EB445137-D7F5-57EC-87DA-1DB460D64046,"iPhone13,2"
com.google.chrome.ios,4,1734370941,1734370945,1734370946.015178,-21600,EB445137-D7F5-57EC-87DA-1DB460D64046,"iPhone13,2"
com.google.chrome.ios,376,1734370537,1734370913,1734370913.2795901,-21600,EB445137-D7F5-57EC-87DA-1DB460D64046,"iPhone13,2"
com.apple.Music,2,1734370535,1734370537,1734370537.812855,-21600,EB445137-D7F5-57EC-87DA-1DB460D64046,"iPhone13,2"
com.apple.Music,4,1734370450,1734370454,1734370454.656914,-21600,EB445137-D7F5-57EC-87DA-1DB460D64046,"iPhone13,2"
com.apple.Music,9,1734369973,1734369982,1734369982.8645701,-21600,EB445137-D7F5-57EC-87DA-1DB460D64046,"iPhone13,2"
com.apple.camera,1,1734369973,1734369974,1734369974.5594711,-21600,EB445137-D7F5-57EC-87DA-1DB460D64046,"iPhone13,2"
com.apple.Music,16,1734369272,1734369288,1734369288.654231,-21600,EB445137-D7F5-57EC-87DA-1DB460D64046,"iPhone13,2"
com.apple.weather,5,1734369267,1734369272,1734369272.984348,-21600,EB445137-D7F5-57EC-87DA-1DB460D64046,"iPhone13,2"
com.apple.weather,8,1734369235,1734369243,1734369243.4703321,-21600,EB445137-D7F5-57EC-87DA-1DB460D64046,"iPhone13,2"
com.apple.journal,873,1734368089,1734368962,1734368963.095879,-21600,EB445137-D7F5-57EC-87DA-1DB460D64046,"iPhone13,2"
com.google.Chrome,301,1734368076,1734368377,1734368377.108365,-21600,,
com.google.Chrome,327,1734367487,1734367814,1734367814.398166,-21600,,
com.apple.MobileSMS,34,1734367148,1734367182,1734367182.4538789,-21600,EB445137-D7F5-57EC-87DA-1DB460D64046,"iPhone13,2"
com.google.Chrome,3,1734367121,1734367124,1734367124.2848558,-21600,,
com.google.Chrome,432,1734366689,1734367121,1734367121.513881,-21600,,
com.google.Chrome,476,1734366163,1734366639,1734366639.2632709,-21600,,
com.apple.weather,46,1734365966,1734366012,1734366012.833005,-21600,EB445137-D7F5-57EC-87DA-1DB460D64046,"iPhone13,2"
com.google.ios.youtube,1812,1734363937,1734365749,1734365749.531839,-21600,EB445137-D7F5-57EC-87DA-1DB460D64046,"iPhone13,2"
com.google.Chrome,1914,1734362307,1734364221,1734364221.444985,-21600,,
com.apple.finder,10,1734362297,1734362307,1734362307.77753,-21600,,
com.apple.weather,28,1734362028,1734362056,1734362056.0542731,-21600,EB445137-D7F5-57EC-87DA-1DB460D64046,"iPhone13,2"
com.microsoft.Office.Outlook,37,1734361989,1734362026,1734362026.278779,-21600,EB445137-D7F5-57EC-87DA-1DB460D64046,"iPhone13,2"
com.google.ios.youtube,923,1734361066,1734361989,1734361990.141995,-21600,EB445137-D7F5-57EC-87DA-1DB460D64046,"iPhone13,2"
com.apple.news,53,1734361001,1734361054,1734361054.161876,-21600,EB445137-D7F5-57EC-87DA-1DB460D64046,"iPhone13,2"
com.apple.news,1,1734360923,1734360924,1734360925.3623161,-21600,EB445137-D7F5-57EC-87DA-1DB460D64046,"iPhone13,2"
com.apple.weather,4,1734360907,1734360911,1734360911.258743,-21600,EB445137-D7F5-57EC-87DA-1DB460D64046,"iPhone13,2"
com.apple.weather,31,1734359539,1734359570,1734359571.108403,-21600,EB445137-D7F5-57EC-87DA-1DB460D64046,"iPhone13,2"
com.apple.Health,28,1734359509,1734359537,1734359537.564549,-21600,EB445137-D7F5-57EC-87DA-1DB460D64046,"iPhone13,2"
com.apple.finder,2,1734359391,1734359393,1734359394.012227,-21600,,
com.apple.Health,43,1734359247,1734359290,1734359290.9308271,-21600,EB445137-D7F5-57EC-87DA-1DB460D64046,"iPhone13,2"
com.microsoft.Office.Outlook,13,1734359234,1734359247,1734359247.599061,-21600,EB445137-D7F5-57EC-87DA-1DB460D64046,"iPhone13,2"
com.renpho.health,6,1734359228,1734359234,1734359234.875668,-21600,EB445137-D7F5-57EC-87DA-1DB460D64046,"iPhone13,2"
com.renpho.health,25,1734358876,1734358901,1734358901.9407969,-21600,EB445137-D7F5-57EC-87DA-1DB460D64046,"iPhone13,2"
com.apple.mobiletimer,6,1734358866,1734358872,1734358872.428294,-21600,EB445137-D7F5-57EC-87DA-1DB460D64046,"iPhone13,2"
com.apple.mobiletimer,4,1734357989,1734357993,1734357993.6167421,-21600,EB445137-D7F5-57EC-87DA-1DB460D64046,"iPhone13,2"
com.apple.mobiletimer,25,1734357905,1734357930,1734357930.424916,-21600,EB445137-D7F5-57EC-87DA-1DB460D64046,"iPhone13,2"
com.apple.mobiletimer,9,1734357893,1734357902,1734357902.269328,-21600,EB445137-D7F5-57EC-87DA-1DB460D64046,"iPhone13,2"
com.apple.mobiletimer,13,1734327923,1734327936,1734327936.8194652,-21600,EB445137-D7F5-57EC-87DA-1DB460D64046,"iPhone13,2"
com.apple.mobiletimer,2,1734327919,1734327921,1734327921.173015,-21600,EB445137-D7F5-57EC-87DA-1DB460D64046,"iPhone13,2"
com.apple.mobiletimer,14,1734327905,1734327919,1734327919.8099751,-21600,EB445137-D7F5-57EC-87DA-1DB460D64046,"iPhone13,2"
com.thestorygraph.thestorygraph,4,1734327901,1734327905,1734327905.8066,-21600,EB445137-D7F5-57EC-87DA-1DB460D64046,"iPhone13,2"
com.thestorygraph.thestorygraph,21,1734327876,1734327897,1734327897.753389,-21600,EB445137-D7F5-57EC-87DA-1DB460D64046,"iPhone13,2"
com.hammerandchisel.discord,48,1734325817,1734325865,1734325866.0716062,-21600,EB445137-D7F5-57EC-87DA-1DB460D64046,"iPhone13,2"
com.apple.finder,0,1734325701,1734325701,1734325702.427754,-21600,,
com.google.Chrome,1069,1734324632,1734325701,1734325702.242605,-21600,,
com.google.Chrome,382,1734324079,1734324461,1734324461.768131,-21600,,
com.google.Chrome,301,1734323763,1734324064,1734324064.2970018,-21600,,
com.hammerandchisel.discord,9,1734323419,1734323428,1734323428.0921268,-21600,EB445137-D7F5-57EC-87DA-1DB460D64046,"iPhone13,2"
com.google.Chrome,344,1734323412,1734323756,1734323756.477313,-21600,,
com.google.Chrome,977,1734322152,1734323129,1734323129.437706,-21600,,
com.apple.finder,11,1734322141,1734322152,1734322152.127921,-21600,,
com.apple.iCal,188,1734321953,1734322141,1734322141.502931,-21600,,
com.apple.finder,133,1734321820,1734321953,1734321953.977488,-21600,,
com.google.Chrome,14,1734321806,1734321820,1734321820.910428,-21600,,
com.google.chrome.ios,161,1734321519,1734321680,1734321680.403932,-21600,EB445137-D7F5-57EC-87DA-1DB460D64046,"iPhone13,2"
com.strava.stravaride,14,1734321498,1734321512,1734321512.716861,-21600,EB445137-D7F5-57EC-87DA-1DB460D64046,"iPhone13,2"
com.truebill.truebillnative,16,1734321454,1734321470,1734321470.638783,-21600,EB445137-D7F5-57EC-87DA-1DB460D64046,"iPhone13,2"
com.apple.weather,74,1734321369,1734321443,1734321443.042574,-21600,EB445137-D7F5-57EC-87DA-1DB460D64046,"iPhone13,2"
com.apple.Maps,58,1734321311,1734321369,1734321369.397661,-21600,EB445137-D7F5-57EC-87DA-1DB460D64046,"iPhone13,2"
com.apple.weather,19,1734321288,1734321307,1734321307.019926,-21600,EB445137-D7F5-57EC-87DA-1DB460D64046,"iPhone13,2"
com.google.Chrome,460,1734319451,1734319911,1734319911.858854,-21600,,
com.google.Chrome,319,1734318931,1734319250,1734319250.608161,-21600,,
com.google.Chrome,702,1734318068,1734318770,1734318770.848114,-21600,,
com.google.Chrome,323,1734317583,1734317906,1734317906.112495,-21600,,
com.google.Chrome,960,1734316358,1734317318,1734317318.7386498,-21600,,
com.google.Chrome,715,1734315462,1734316177,1734316177.365793,-21600,,
com.google.Chrome,346,1734314090,1734314436,1734314436.61664,-21600,,
com.leomehlig.today,2,1734314088,1734314090,1734314090.428012,-21600,,
com.apple.MobileSMS,2,1734313942,1734313944,1734313944.09237,-21600,EB445137-D7F5-57EC-87DA-1DB460D64046,"iPhone13,2"
com.apple.MobileSMS,37,1734313840,1734313877,1734313877.327291,-21600,EB445137-D7F5-57EC-87DA-1DB460D64046,"iPhone13,2"
com.microsoft.Office.Outlook,6,1734313571,1734313577,1734313577.1958919,-21600,EB445137-D7F5-57EC-87DA-1DB460D64046,"iPhone13,2"
com.apple.MobileSMS,228,1734313337,1734313565,1734313565.078959,-21600,EB445137-D7F5-57EC-87DA-1DB460D64046,"iPhone13,2"
com.apple.MobileSMS,26,1734313258,1734313284,1734313284.729693,-21600,EB445137-D7F5-57EC-87DA-1DB460D64046,"iPhone13,2"
com.instructure.icanvas,8,1734313250,1734313258,1734313259.262012,-21600,EB445137-D7F5-57EC-87DA-1DB460D64046,"iPhone13,2"
com.leomehlig.today,283,1734313154,1734313437,1734313437.8913631,-21600,,
com.google.Chrome,5,1734313127,1734313132,1734313132.06335,-21600,,
com.microsoft.VSCode,320,1734312807,1734313127,1734313127.365724,-21600,,
com.microsoft.Excel,20,1734312787,1734312807,1734312807.808333,-21600,,
com.leomehlig.today,8,1734312779,1734312787,1734312787.168809,-21600,,
com.microsoft.Excel,8,1734312771,1734312779,1734312779.276411,-21600,,
com.leomehlig.today,9,1734312762,1734312771,1734312771.976342,-21600,,
com.microsoft.Excel,1,1734312761,1734312762,1734312762.124195,-21600,,
com.leomehlig.today,3,1734312758,1734312761,1734312761.2757502,-21600,,
com.microsoft.Excel,3,1734312755,1734312758,1734312758.816427,-21600,,
com.leomehlig.today,1,1734312754,1734312755,1734312755.8209128,-21600,,
com.microsoft.Excel,2,1734312752,1734312754,1734312754.329298,-21600,,
com.leomehlig.today,2,1734312750,1734312752,1734312752.845238,-21600,,
com.microsoft.Excel,3,1734312747,1734312750,1734312750.7213001,-21600,,
com.leomehlig.today,3,1734312744,1734312747,1734312747.8582911,-21600,,
com.microsoft.Excel,3,1734312741,1734312744,1734312744.598312,-21600,,
com.leomehlig.today,2,1734312739,1734312741,1734312741.377379,-21600,,
com.microsoft.Excel,3,1734312736,1734312739,1734312739.1968951,-21600,,
com.leomehlig.today,3,1734312733,1734312736,1734312736.234212,-21600,,
com.microsoft.Excel,4,1734312729,1734312733,1734312733.2637591,-21600,,
com.leomehlig.today,1,1734312728,1734312729,1734312730.010145,-21600,,
com.microsoft.Excel,1,1734312727,1734312728,1734312728.91966,-21600,,
com.leomehlig.today,3,1734312724,1734312727,1734312727.0624871,-21600,,
com.microsoft.Excel,1,1734312723,1734312724,1734312724.998769,-21600,,
com.leomehlig.today,2,1734312721,1734312723,1734312723.532069,-21600,,
com.microsoft.Excel,1,1734312720,1734312721,1734312721.834488,-21600,,
com.leomehlig.today,4,1734312716,1734312720,1734312720.2185268,-21600,,
com.microsoft.Excel,3,1734312713,1734312716,1734312716.54865,-21600,,
com.leomehlig.today,3,1734312710,1734312713,1734312713.524897,-21600,,
com.microsoft.Excel,3,1734312707,1734312710,1734312710.599514,-21600,,
com.leomehlig.today,2,1734312705,1734312707,1734312707.655509,-21600,,
com.microsoft.Excel,3,1734312702,1734312705,1734312705.591953,-21600,,
com.leomehlig.today,3,1734312699,1734312702,1734312702.427156,-21600,,
com.microsoft.Excel,2,1734312697,1734312699,1734312699.790859,-21600,,
com.leomehlig.today,3,1734312694,1734312697,1734312697.826253,-21600,,
com.microsoft.Excel,4,1734312690,1734312694,1734312694.374913,-21600,,
com.leomehlig.today,7,1734312683,1734312690,1734312690.743474,-21600,,
com.microsoft.Excel,2,1734312681,1734312683,1734312683.1205258,-21600,,
com.leomehlig.today,14,1734312667,1734312681,1734312681.1217542,-21600,,
com.microsoft.Excel,4,1734312663,1734312667,1734312667.354423,-21600,,
com.leomehlig.today,164,1734312499,1734312663,1734312663.9594169,-21600,,
com.apple.iCal,24,1734312475,1734312499,1734312499.856192,-21600,,
com.microsoft.Excel,173,1734312302,1734312475,1734312475.3980188,-21600,,
com.apple.finder,18,1734312284,1734312302,1734312302.4939709,-21600,,
com.microsoft.VSCode,20,1734312264,1734312284,1734312284.964727,-21600,,
com.google.Chrome,299,1734311965,1734312264,1734312264.9700441,-21600,,
com.instructure.icanvas,7,1734309151,1734309158,1734309158.360427,-21600,EB445137-D7F5-57EC-87DA-1DB460D64046,"iPhone13,2"
com.instructure.icanvas,3,1734307742,1734307745,1734307746.271672,-21600,EB445137-D7F5-57EC-87DA-1DB460D64046,"iPhone13,2"
com.apple.Passwords,7,1734299994,1734300001,1734300001.960027,-21600,EB445137-D7F5-57EC-87DA-1DB460D64046,"iPhone13,2"
com.apple.camera,0,1734299994,1734299994,1734299994.279602,-21600,EB445137-D7F5-57EC-87DA-1DB460D64046,"iPhone13,2"
com.apple.Passwords,4,1734299986,1734299990,1734299990.6638799,-21600,EB445137-D7F5-57EC-87DA-1DB460D64046,"iPhone13,2"
com.google.Chrome,4,1734299973,1734299977,1734299978.007477,-21600,,
com.apple.Passwords,25,1734299407,1734299432,1734299432.289686,-21600,EB445137-D7F5-57EC-87DA-1DB460D64046,"iPhone13,2"
com.google.Chrome,1756,1734297503,1734299259,1734299259.895658,-21600,,
com.leomehlig.today,1,1734297502,1734297503,1734297503.314363,-21600,,
com.google.Chrome,11,1734297491,1734297502,1734297502.459828,-21600,,
com.leomehlig.today,1,1734297490,1734297491,1734297491.436372,-21600,,
com.google.Chrome,10,1734297480,1734297490,1734297490.802746,-21600,,
com.leomehlig.today,5,1734297475,1734297480,1734297480.42513,-21600,,
com.google.Chrome,19,1734297456,1734297475,1734297475.572752,-21600,,
com.leomehlig.today,0,1734297456,1734297456,1734297456.86063,-21600,,
com.google.Chrome,189,1734297267,1734297456,1734297456.1725621,-21600,,
com.apple.calculator,7,1734297260,1734297267,1734297267.2195191,-21600,,
com.google.Chrome,1,1734297259,1734297260,1734297260.935245,-21600,,
com.apple.calculator,19,1734297240,1734297259,1734297259.706942,-21600,,
com.google.Chrome,1,1734297239,1734297240,1734297240.7707691,-21600,,
com.apple.calculator,2,1734297237,1734297239,1734297239.930371,-21600,,
com.google.Chrome,2,1734297235,1734297237,1734297237.175826,-21600,,
com.apple.calculator,45,1734297190,1734297235,1734297235.140116,-21600,,
com.google.Chrome,1,1734297189,1734297190,1734297190.247678,-21600,,
com.apple.calculator,1,1734297188,1734297189,1734297189.69033,-21600,,
com.google.Chrome,24,1734297164,1734297188,1734297188.749682,-21600,,
com.apple.calculator,5,1734297159,1734297164,1734297164.981612,-21600,,
com.google.Chrome,5,1734297154,1734297159,1734297159.305928,-21600,,
com.apple.calculator,14,1734297140,1734297154,1734297154.162811,-21600,,
com.google.Chrome,5,1734297135,1734297140,1734297140.183031,-21600,,
com.apple.calculator,5,1734297130,1734297135,1734297135.517833,-21600,,
com.google.Chrome,4,1734297126,1734297130,1734297130.876893,-21600,,
com.apple.calculator,9,1734297117,1734297126,1734297126.059418,-21600,,
com.google.Chrome,3,1734297114,1734297117,1734297117.4451451,-21600,,
com.apple.calculator,3,1734297111,1734297114,1734297114.144109,-21600,,
com.google.Chrome,5,1734297106,1734297111,1734297111.100456,-21600,,
com.apple.calculator,3,1734297103,1734297106,1734297106.9554791,-21600,,
com.google.Chrome,6,1734297097,1734297103,1734297103.869638,-21600,,
com.apple.calculator,2,1734297095,1734297097,1734297097.8064141,-21600,,
com.google.Chrome,73,1734297022,1734297095,1734297095.679707,-21600,,
com.apple.calculator,23,1734296999,1734297022,1734297022.653708,-21600,,
com.google.Chrome,7,1734296992,1734296999,1734296999.107899,-21600,,
com.apple.calculator,1,1734296991,1734296992,1734296992.573271,-21600,,
com.google.Chrome,10,1734296981,1734296991,1734296991.1841102,-21600,,
com.apple.calculator,1,1734296980,1734296981,1734296981.624446,-21600,,
com.google.Chrome,9,1734296971,1734296980,1734296980.109116,-21600,,
com.apple.calculator,10,1734296961,1734296971,1734296971.685713,-21600,,
com.google.Chrome,1,1734296960,1734296961,1734296961.9575071,-21600,,
com.leomehlig.today,0,1734296960,1734296960,1734296960.8865151,-21600,,
com.google.Chrome,90,1734296870,1734296960,1734296960.4631782,-21600,,
com.leomehlig.today,2,1734296854,1734296856,1734296856.3620582,-21600,,
com.google.chrome.ios,7,1734296740,1734296747,1734296747.1256251,-21600,EB445137-D7F5-57EC-87DA-1DB460D64046,"iPhone13,2"
com.google.chrome.ios,7,1734296687,1734296694,1734296694.955195,-21600,EB445137-D7F5-57EC-87DA-1DB460D64046,"iPhone13,2"
com.leomehlig.today,17,1734296668,1734296685,1734296685.586712,-21600,,
com.google.chrome.ios,30,1734296481,1734296511,1734296512.002995,-21600,EB445137-D7F5-57EC-87DA-1DB460D64046,"iPhone13,2"
com.google.chrome.ios,8,1734296466,1734296474,1734296474.433622,-21600,EB445137-D7F5-57EC-87DA-1DB460D64046,"iPhone13,2"
com.google.Chrome,221,1734296447,1734296668,1734296668.840156,-21600,,
com.apple.finder,12,1734296435,1734296447,1734296447.920165,-21600,,
com.google.Chrome,94,1734296341,1734296435,1734296435.355373,-21600,,
com.apple.finder,16,1734296325,1734296341,1734296341.8455482,-21600,,
com.google.chrome.ios,58,1734296263,1734296321,1734296321.767888,-21600,EB445137-D7F5-57EC-87DA-1DB460D64046,"iPhone13,2"
com.google.Chrome,150,1734296175,1734296325,1734296325.6825628,-21600,,
com.apple.finder,29,1734296146,1734296175,1734296175.788346,-21600,,
com.google.Chrome,24,1734296122,1734296146,1734296146.572431,-21600,,
com.apple.finder,10,1734296112,1734296122,1734296122.351584,-21600,,
com.google.chrome.ios,6,1734296098,1734296104,1734296104.94591,-21600,EB445137-D7F5-57EC-87DA-1DB460D64046,"iPhone13,2"
com.google.chrome.ios,50,1734296047,1734296097,1734296097.500942,-21600,EB445137-D7F5-57EC-87DA-1DB460D64046,"iPhone13,2"
com.google.Chrome,118,1734295994,1734296112,1734296112.297452,-21600,,
com.apple.finder,36,1734295958,1734295994,1734295994.982919,-21600,,
com.google.Chrome,6,1734295952,1734295958,1734295958.7929301,-21600,,
com.apple.finder,2,1734295950,1734295952,1734295952.587833,-21600,,
com.google.Chrome,3,1734295947,1734295950,1734295950.7978039,-21600,,
com.apple.finder,15,1734295932,1734295947,1734295947.977138,-21600,,
com.google.Chrome,6,1734295926,1734295932,1734295932.384661,-21600,,
com.apple.finder,10,1734295916,1734295926,1734295926.238267,-21600,,
com.google.Chrome,45,1734295871,1734295916,1734295916.438895,-21600,,
com.apple.finder,27,1734295844,1734295871,1734295871.310363,-21600,,
com.google.Chrome,79,1734295765,1734295844,1734295844.0557718,-21600,,
com.apple.finder,11,1734295754,1734295765,1734295765.501523,-21600,,
com.google.Chrome,103,1734295651,1734295754,1734295754.86626,-21600,,
com.apple.finder,39,1734295612,1734295651,1734295651.137912,-21600,,
com.google.chrome.ios,37,1734295574,1734295611,1734295611.7090611,-21600,EB445137-D7F5-57EC-87DA-1DB460D64046,"iPhone13,2"
com.google.Chrome,46,1734295566,1734295612,1734295612.138871,-21600,,
com.apple.finder,53,1734295513,1734295566,1734295566.369368,-21600,,
com.google.Chrome,105,1734295408,1734295513,1734295513.575369,-21600,,
com.apple.finder,31,1734295377,1734295408,1734295408.405647,-21600,,
com.google.Chrome,10,1734295367,1734295377,1734295377.39226,-21600,,
com.apple.finder,21,1734295346,1734295367,1734295367.9583879,-21600,,
com.google.Chrome,23,1734295323,1734295346,1734295346.822558,-21600,,
com.apple.finder,29,1734295294,1734295323,1734295323.891052,-21600,,
com.google.Chrome,13,1734295281,1734295294,1734295294.653842,-21600,,
com.apple.finder,1,1734295280,1734295281,1734295281.276664,-21600,,
com.google.Chrome,3,1734295277,1734295280,1734295280.2980762,-21600,,
com.apple.finder,19,1734295258,1734295277,1734295277.170872,-21600,,
com.google.Chrome,8,1734295250,1734295258,1734295258.8461308,-21600,,
com.apple.finder,27,1734295223,1734295250,1734295251.030566,-21600,,
com.google.Chrome,34,1734295189,1734295223,1734295223.79229,-21600,,
com.apple.finder,42,1734295147,1734295189,1734295189.945792,-21600,,
com.google.Chrome,1,1734295146,1734295147,1734295147.664805,-21600,,
com.apple.finder,2,1734295144,1734295146,1734295146.569047,-21600,,
com.google.chrome.ios,47,1734295080,1734295127,1734295127.549706,-21600,EB445137-D7F5-57EC-87DA-1DB460D64046,"iPhone13,2"
com.google.Chrome,70,1734295074,1734295144,1734295144.216241,-21600,,
com.apple.finder,65,1734295009,1734295074,1734295074.976386,-21600,,
com.google.Chrome,21,1734294988,1734295009,1734295009.3081641,-21600,,
com.google.chrome.ios,26,1734294961,1734294987,1734294987.7145882,-21600,EB445137-D7F5-57EC-87DA-1DB460D64046,"iPhone13,2"
com.apple.finder,44,1734294944,1734294988,1734294988.784764,-21600,,
com.google.Chrome,10,1734294934,1734294944,1734294944.358345,-21600,,
com.apple.finder,3,1734294931,1734294934,1734294934.273632,-21600,,
com.google.Chrome,2,1734294929,1734294931,1734294931.680687,-21600,,
com.apple.finder,60,1734294869,1734294929,1734294929.8448238,-21600,,
com.google.Chrome,15,1734294854,1734294869,1734294869.7299042,-21600,,
com.apple.finder,23,1734294831,1734294854,1734294854.10098,-21600,,
com.google.Chrome,35,1734294796,1734294831,1734294831.124394,-21600,,
com.apple.finder,102,1734294694,1734294796,1734294797.011294,-21600,,
com.google.Chrome,82,1734294612,1734294694,1734294694.04124,-21600,,
com.apple.finder,22,1734294590,1734294612,1734294612.40441,-21600,,
com.google.Chrome,50,1734294540,1734294590,1734294590.491463,-21600,,
com.apple.finder,22,1734294518,1734294540,1734294540.682909,-21600,,
com.google.chrome.ios,64,1734294490,1734294554,1734294554.953968,-21600,EB445137-D7F5-57EC-87DA-1DB460D64046,"iPhone13,2"
com.google.Chrome,49,1734294469,1734294518,1734294518.7311301,-21600,,
com.leomehlig.today,5,1734294464,1734294469,1734294469.434846,-21600,,
com.google.Chrome,143,1734294321,1734294464,1734294464.20542,-21600,,
com.leomehlig.today,26,1734294238,1734294264,1734294265.612639,-21600,,
com.apple.mobilephone,2,1734293538,1734293540,1734293540.127975,-21600,EB445137-D7F5-57EC-87DA-1DB460D64046,"iPhone13,2"
com.apple.InCallService,1,1734293537,1734293538,1734293538.274706,-21600,EB445137-D7F5-57EC-87DA-1DB460D64046,"iPhone13,2"
com.apple.InCallService,3,1734293083,1734293086,1734293086.144758,-21600,EB445137-D7F5-57EC-87DA-1DB460D64046,"iPhone13,2"
com.apple.mobilephone,29,1734293054,1734293083,1734293083.5304332,-21600,EB445137-D7F5-57EC-87DA-1DB460D64046,"iPhone13,2"
com.apple.findmy,7,1734293044,1734293051,1734293051.7774239,-21600,EB445137-D7F5-57EC-87DA-1DB460D64046,"iPhone13,2"
com.apple.findmy,6,1734293038,1734293044,1734293044.250537,-21600,EB445137-D7F5-57EC-87DA-1DB460D64046,"iPhone13,2"
com.apple.findmy,33,1734292888,1734292921,1734292921.785542,-21600,EB445137-D7F5-57EC-87DA-1DB460D64046,"iPhone13,2"
com.burbn.instagram,2,1734292885,1734292887,1734292887.98842,-21600,EB445137-D7F5-57EC-87DA-1DB460D64046,"iPhone13,2"
com.burbn.instagram,119,1734292719,1734292838,1734292838.1503139,-21600,EB445137-D7F5-57EC-87DA-1DB460D64046,"iPhone13,2"
com.burbn.instagram,2,1734292530,1734292532,1734292532.279066,-21600,EB445137-D7F5-57EC-87DA-1DB460D64046,"iPhone13,2"
com.burbn.instagram,82,1734292294,1734292376,1734292376.760411,-21600,EB445137-D7F5-57EC-87DA-1DB460D64046,"iPhone13,2"
com.amazon.Amazon,29,1734292247,1734292276,1734292276.652466,-21600,EB445137-D7F5-57EC-87DA-1DB460D64046,"iPhone13,2"
com.apple.MobileSMS,9,1734292238,1734292247,1734292247.657769,-21600,EB445137-D7F5-57EC-87DA-1DB460D64046,"iPhone13,2"
com.amazon.Amazon,1,1734292236,1734292237,1734292237.655113,-21600,EB445137-D7F5-57EC-87DA-1DB460D64046,"iPhone13,2"
com.apple.findmy,9,1734292225,1734292234,1734292234.834999,-21600,EB445137-D7F5-57EC-87DA-1DB460D64046,"iPhone13,2"
com.apple.findmy,9,1734292209,1734292218,1734292218.069984,-21600,EB445137-D7F5-57EC-87DA-1DB460D64046,"iPhone13,2"
com.apple.mobilecal,39,1734292169,1734292208,1734292208.419982,-21600,EB445137-D7F5-57EC-87DA-1DB460D64046,"iPhone13,2"
com.hammerandchisel.discord,68,1734292078,1734292146,1734292146.544157,-21600,EB445137-D7F5-57EC-87DA-1DB460D64046,"iPhone13,2"
com.apple.Maps,100,1734291943,1734292043,1734292043.391175,-21600,EB445137-D7F5-57EC-87DA-1DB460D64046,"iPhone13,2"
com.tinyspeck.chatlyio,28,1734291898,1734291926,1734291926.785151,-21600,EB445137-D7F5-57EC-87DA-1DB460D64046,"iPhone13,2"
com.apple.mobilenotes,12,1734291863,1734291875,1734291875.5161638,-21600,EB445137-D7F5-57EC-87DA-1DB460D64046,"iPhone13,2"
com.google.Sheets,229,1734291634,1734291863,1734291863.6609778,-21600,EB445137-D7F5-57EC-87DA-1DB460D64046,"iPhone13,2"
com.google.Drive,7,1734291627,1734291634,1734291635.0085669,-21600,EB445137-D7F5-57EC-87DA-1DB460D64046,"iPhone13,2"
com.apple.findmy,11,1734291607,1734291618,1734291618.443861,-21600,EB445137-D7F5-57EC-87DA-1DB460D64046,"iPhone13,2"
com.truebill.truebillnative,103,1734290910,1734291013,1734291013.40655,-21600,EB445137-D7F5-57EC-87DA-1DB460D64046,"iPhone13,2"
com.truebill.truebillnative,18,1734290884,1734290902,1734290902.1043692,-21600,EB445137-D7F5-57EC-87DA-1DB460D64046,"iPhone13,2"
com.apple.calculator,7,1734290877,1734290884,1734290884.089548,-21600,EB445137-D7F5-57EC-87DA-1DB460D64046,"iPhone13,2"
com.truebill.truebillnative,6,1734290871,1734290877,1734290877.718902,-21600,EB445137-D7F5-57EC-87DA-1DB460D64046,"iPhone13,2"
com.truebill.truebillnative,23,1734290845,1734290868,1734290869.1151118,-21600,EB445137-D7F5-57EC-87DA-1DB460D64046,"iPhone13,2"
com.apple.Maps,84,1734290760,1734290844,1734290844.558456,-21600,EB445137-D7F5-57EC-87DA-1DB460D64046,"iPhone13,2"
com.apple.findmy,15,1734290744,1734290759,1734290759.267561,-21600,EB445137-D7F5-57EC-87DA-1DB460D64046,"iPhone13,2"
com.leomehlig.today,54,1734289957,1734290011,1734290011.37599,-21600,,
com.google.Chrome,2,1734289955,1734289957,1734289959.684608,-21600,,
com.apple.MobileSMS,4,1734288944,1734288948,1734288949.277367,-21600,EB445137-D7F5-57EC-87DA-1DB460D64046,"iPhone13,2"
com.apple.MobileSMS,3,1734288839,1734288842,1734288842.4675431,-21600,EB445137-D7F5-57EC-87DA-1DB460D64046,"iPhone13,2"
com.google.chrome.ios,39,1734288463,1734288502,1734288502.983666,-21600,EB445137-D7F5-57EC-87DA-1DB460D64046,"iPhone13,2"
com.apple.MobileSMS,27,1734288430,1734288457,1734288457.521214,-21600,EB445137-D7F5-57EC-87DA-1DB460D64046,"iPhone13,2"
com.microsoft.Office.Outlook,10,1734288420,1734288430,1734288430.135823,-21600,EB445137-D7F5-57EC-87DA-1DB460D64046,"iPhone13,2"
com.apple.MobileSMS,136,1734288281,1734288417,1734288418.0181031,-21600,EB445137-D7F5-57EC-87DA-1DB460D64046,"iPhone13,2"
com.apple.MobileSMS,16,1734288232,1734288248,1734288248.5232291,-21600,EB445137-D7F5-57EC-87DA-1DB460D64046,"iPhone13,2"
com.apple.MobileSMS,149,1734288016,1734288165,1734288165.78896,-21600,EB445137-D7F5-57EC-87DA-1DB460D64046,"iPhone13,2"
com.apple.MobileSMS,95,1734287920,1734288015,1734288015.916851,-21600,EB445137-D7F5-57EC-87DA-1DB460D64046,"iPhone13,2"
com.apple.news,176,1734285359,1734285535,1734285536.035764,-21600,EB445137-D7F5-57EC-87DA-1DB460D64046,"iPhone13,2"
com.apple.Health,14,1734285333,1734285347,1734285347.614437,-21600,EB445137-D7F5-57EC-87DA-1DB460D64046,"iPhone13,2"
com.apple.Health,52,1734285279,1734285331,1734285331.469739,-21600,EB445137-D7F5-57EC-87DA-1DB460D64046,"iPhone13,2"
com.apple.weather,8,1734285271,1734285279,1734285280.548157,-21600,EB445137-D7F5-57EC-87DA-1DB460D64046,"iPhone13,2"
com.apple.weather,7,1734285215,1734285222,1734285222.642164,-21600,EB445137-D7F5-57EC-87DA-1DB460D64046,"iPhone13,2"
com.renpho.health,2,1734285213,1734285215,1734285215.727732,-21600,EB445137-D7F5-57EC-87DA-1DB460D64046,"iPhone13,2"
com.renpho.health,6,1734284965,1734284971,1734284971.493041,-21600,EB445137-D7F5-57EC-87DA-1DB460D64046,"iPhone13,2"
com.renpho.health,4,1734284960,1734284964,1734284964.967155,-21600,EB445137-D7F5-57EC-87DA-1DB460D64046,"iPhone13,2"
com.renpho.health,21,1734284197,1734284218,1734284218.647152,-21600,EB445137-D7F5-57EC-87DA-1DB460D64046,"iPhone13,2"
com.apple.camera,1,1734280788,1734280789,1734280789.1133928,-21600,EB445137-D7F5-57EC-87DA-1DB460D64046,"iPhone13,2"
com.apple.mobiletimer,0,1734279077,1734279077,1734279077.23159,-21600,EB445137-D7F5-57EC-87DA-1DB460D64046,"iPhone13,2"
com.apple.mobiletimer,27,1734278972,1734278999,1734278999.73205,-21600,EB445137-D7F5-57EC-87DA-1DB460D64046,"iPhone13,2"
com.apple.mobiletimer,25,1734278401,1734278426,1734278426.153233,-21600,EB445137-D7F5-57EC-87DA-1DB460D64046,"iPhone13,2"
com.apple.mobiletimer,13,1734248479,1734248492,1734248492.0925689,-21600,EB445137-D7F5-57EC-87DA-1DB460D64046,"iPhone13,2"
com.apple.mobiletimer,12,1734248451,1734248463,1734248464.604583,-21600,EB445137-D7F5-57EC-87DA-1DB460D64046,"iPhone13,2"
com.google.Chrome,10,1734246843,1734246853,1734246853.984617,-21600,,
com.google.Chrome,322,1734246431,1734246753,1734246753.579949,-21600,,
com.google.Chrome,586,1734245818,1734246404,1734246404.487467,-21600,,
com.google.Chrome,449,1734245229,1734245678,1734245678.353281,-21600,,
com.google.Chrome,309,1734244642,1734244951,1734244951.951163,-21600,,
com.google.Chrome,599,1734243926,1734244525,1734244525.152598,-21600,,
com.google.Chrome,1251,1734242670,1734243921,1734243921.541544,-21600,,
com.google.Chrome,567,1734242078,1734242645,1734242645.4557881,-21600,,
com.google.Chrome,364,1734241619,1734241983,1734241983.2006478,-21600,,
com.google.Chrome,587,1734240621,1734241208,1734241209.0799332,-21600,,
com.leomehlig.today,9,1734240612,1734240621,1734240621.712028,-21600,,
com.apple.iCal,3,1734240609,1734240612,1734240612.9012299,-21600,,
com.leomehlig.today,2,1734240607,1734240609,1734240609.9757519,-21600,,
com.apple.iCal,82,1734240525,1734240607,1734240607.741483,-21600,,
com.leomehlig.today,64,1734240461,1734240525,1734240525.719074,-21600,,
com.google.Chrome,123,1734240338,1734240461,1734240461.940877,-21600,,
com.apple.finder,20,1734240318,1734240338,1734240338.4597778,-21600,,
com.google.Chrome,45,1734240273,1734240318,1734240318.406048,-21600,,
com.google.chrome.ios,13,1734240247,1734240260,1734240260.388663,-21600,EB445137-D7F5-57EC-87DA-1DB460D64046,"iPhone13,2"
com.google.chrome.ios,15,1734236908,1734236923,1734236923.734404,-21600,EB445137-D7F5-57EC-87DA-1DB460D64046,"iPhone13,2"
com.google.chrome.ios,21,1734231151,1734231172,1734231172.87107,-21600,EB445137-D7F5-57EC-87DA-1DB460D64046,"iPhone13,2"
com.google.chrome.ios,59,1734229507,1734229566,1734229566.908296,-21600,EB445137-D7F5-57EC-87DA-1DB460D64046,"iPhone13,2"
com.google.chrome.ios,33,1734229254,1734229287,1734229287.848944,-21600,EB445137-D7F5-57EC-87DA-1DB460D64046,"iPhone13,2"
com.apple.camera,15,1734228485,1734228500,1734228500.482956,-21600,EB445137-D7F5-57EC-87DA-1DB460D64046,"iPhone13,2"
com.google.chrome.ios,2,1734228312,1734228314,1734228314.7701259,-21600,EB445137-D7F5-57EC-87DA-1DB460D64046,"iPhone13,2"
com.google.chrome.ios,2,1734227420,1734227422,1734227423.0036821,-21600,EB445137-D7F5-57EC-87DA-1DB460D64046,"iPhone13,2"
com.google.chrome.ios,80,1734227243,1734227323,1734227323.727485,-21600,EB445137-D7F5-57EC-87DA-1DB460D64046,"iPhone13,2"
com.google.chrome.ios,40,1734223932,1734223972,1734223972.8498812,-21600,EB445137-D7F5-57EC-87DA-1DB460D64046,"iPhone13,2"
com.google.chrome.ios,3,1734223929,1734223932,1734223932.437272,-21600,EB445137-D7F5-57EC-87DA-1DB460D64046,"iPhone13,2"
com.google.chrome.ios,14,1734222194,1734222208,1734222209.018958,-21600,EB445137-D7F5-57EC-87DA-1DB460D64046,"iPhone13,2"
com.google.chrome.ios,6,1734217786,1734217792,1734217792.202141,-21600,EB445137-D7F5-57EC-87DA-1DB460D64046,"iPhone13,2"
com.google.chrome.ios,6,1734217779,1734217785,1734217785.600472,-21600,EB445137-D7F5-57EC-87DA-1DB460D64046,"iPhone13,2"
com.google.chrome.ios,19,1734217757,1734217776,1734217777.062654,-21600,EB445137-D7F5-57EC-87DA-1DB460D64046,"iPhone13,2"
com.apple.camera,13,1734217743,1734217756,1734217757.888431,-21600,EB445137-D7F5-57EC-87DA-1DB460D64046,"iPhone13,2"
com.apple.news,15,1734217742,1734217757,1734217758.362279,-21600,EB445137-D7F5-57EC-87DA-1DB460D64046,"iPhone13,2"
com.apple.news,8,1734217635,1734217643,1734217643.8545442,-21600,EB445137-D7F5-57EC-87DA-1DB460D64046,"iPhone13,2"
com.apple.news,6,1734217626,1734217632,1734217632.778178,-21600,EB445137-D7F5-57EC-87DA-1DB460D64046,"iPhone13,2"
com.apple.news,49,1734216912,1734216961,1734216961.599328,-21600,EB445137-D7F5-57EC-87DA-1DB460D64046,"iPhone13,2"
com.apple.weather,24,1734216880,1734216904,1734216904.993641,-21600,EB445137-D7F5-57EC-87DA-1DB460D64046,"iPhone13,2"
com.google.Chrome,1825,1734214646,1734216471,1734216471.628955,-21600,,
com.google.Chrome,51,1734214421,1734214472,1734214472.63687,-21600,,
com.google.Chrome,351,1734214016,1734214367,1734214367.9129,-21600,,
com.google.Chrome,902,1734212762,1734213664,1734213664.0554929,-21600,,
com.google.Chrome,308,1734212177,1734212485,1734212485.992988,-21600,,
com.google.Chrome,948,1734210938,1734211886,1734211886.331094,-21600,,
com.leomehlig.today,5,1734210933,1734210938,1734210938.459515,-21600,,
com.leomehlig.today,14,1734210671,1734210685,1734210685.531188,-21600,,
com.google.Chrome,493,1734210178,1734210671,1734210671.276672,-21600,,
com.leomehlig.today,10,1734210168,1734210178,1734210178.991818,-21600,,
com.hammerandchisel.discord,22,1734208747,1734208769,1734208769.980052,-21600,EB445137-D7F5-57EC-87DA-1DB460D64046,"iPhone13,2"
com.google.Chrome,1496,1734208672,1734210168,1734210168.4335241,-21600,,
com.leomehlig.today,4,1734208668,1734208672,1734208672.126542,-21600,,
com.google.Chrome,1778,1734206890,1734208668,1734208668.214056,-21600,,
com.apple.finder,1,1734206889,1734206890,1734206890.606204,-21600,,
com.google.Chrome,75,1734206814,1734206889,1734206889.2694612,-21600,,
com.hammerandchisel.discord,210,1734206492,1734206702,1734206702.960737,-21600,EB445137-D7F5-57EC-87DA-1DB460D64046,"iPhone13,2"
com.apple.news,2,1734206487,1734206489,1734206489.521357,-21600,EB445137-D7F5-57EC-87DA-1DB460D64046,"iPhone13,2"
com.apple.findmy,4,1734206471,1734206475,1734206475.84193,-21600,EB445137-D7F5-57EC-87DA-1DB460D64046,"iPhone13,2"
com.apple.findmy,15,1734206455,1734206470,1734206470.6792688,-21600,EB445137-D7F5-57EC-87DA-1DB460D64046,"iPhone13,2"
com.google.Chrome,310,1734206416,1734206726,1734206726.760679,-21600,,
com.leomehlig.today,2,1734206414,1734206416,1734206416.422697,-21600,,
com.google.Chrome,2021,1734204393,1734206414,1734206414.751299,-21600,,
com.leomehlig.today,15,1734204349,1734204364,1734204366.020807,-21600,,
com.google.Chrome,22,1734204327,1734204349,1734204349.498853,-21600,,
com.apple.news,7,1734204120,1734204127,1734204127.236702,-21600,EB445137-D7F5-57EC-87DA-1DB460D64046,"iPhone13,2"
com.apple.news,6,1734203850,1734203856,1734203856.135108,-21600,EB445137-D7F5-57EC-87DA-1DB460D64046,"iPhone13,2"
com.apple.news,18,1734202970,1734202988,1734202988.8599548,-21600,EB445137-D7F5-57EC-87DA-1DB460D64046,"iPhone13,2"
com.apple.news,64,1734201406,1734201470,1734201471.760186,-21600,EB445137-D7F5-57EC-87DA-1DB460D64046,"iPhone13,2"
com.apple.MobileSMS,16,1734201384,1734201400,1734201400.851976,-21600,EB445137-D7F5-57EC-87DA-1DB460D64046,"iPhone13,2"
com.google.chrome.ios,20,1734200800,1734200820,1734200821.8633451,-21600,EB445137-D7F5-57EC-87DA-1DB460D64046,"iPhone13,2"
com.apple.news,109,1734200691,1734200800,1734200800.711802,-21600,EB445137-D7F5-57EC-87DA-1DB460D64046,"iPhone13,2"
com.apple.news,40,1734200509,1734200549,1734200549.859367,-21600,EB445137-D7F5-57EC-87DA-1DB460D64046,"iPhone13,2"
com.apple.MobileSMS,3,1734200502,1734200505,1734200505.308793,-21600,EB445137-D7F5-57EC-87DA-1DB460D64046,"iPhone13,2"
com.apple.MobileSMS,11,1734200491,1734200502,1734200502.218734,-21600,EB445137-D7F5-57EC-87DA-1DB460D64046,"iPhone13,2"
us.parkmobile.ParkMobile,5,1734200486,1734200491,1734200491.6696959,-21600,EB445137-D7F5-57EC-87DA-1DB460D64046,"iPhone13,2"
us.parkmobile.ParkMobile,20,1734200134,1734200154,1734200155.024091,-21600,EB445137-D7F5-57EC-87DA-1DB460D64046,"iPhone13,2"
com.apple.news,4,1734200120,1734200124,1734200124.776616,-21600,EB445137-D7F5-57EC-87DA-1DB460D64046,"iPhone13,2"
com.apple.news,5,1734199386,1734199391,1734199391.577882,-21600,EB445137-D7F5-57EC-87DA-1DB460D64046,"iPhone13,2"
com.google.Chrome,45,1734198264,1734198309,1734198309.0229778,-21600,,
com.apple.news,6,1734198152,1734198158,1734198158.1198568,-21600,EB445137-D7F5-57EC-87DA-1DB460D64046,"iPhone13,2"
com.google.Chrome,120,1734198038,1734198158,1734198158.250413,-21600,,
com.leomehlig.today,1,1734198037,1734198038,1734198038.864008,-21600,,
com.apple.news,2,1734198033,1734198035,1734198036.035799,-21600,EB445137-D7F5-57EC-87DA-1DB460D64046,"iPhone13,2"
com.apple.news,27,1734197914,1734197941,1734197941.706578,-21600,EB445137-D7F5-57EC-87DA-1DB460D64046,"iPhone13,2"
com.apple.news,344,1734197301,1734197645,1734197645.982974,-21600,EB445137-D7F5-57EC-87DA-1DB460D64046,"iPhone13,2"
com.apple.findmy,11,1734197284,1734197295,1734197295.7401118,-21600,EB445137-D7F5-57EC-87DA-1DB460D64046,"iPhone13,2"
com.apple.MobileSMS,7,1734197273,1734197280,1734197280.22247,-21600,EB445137-D7F5-57EC-87DA-1DB460D64046,"iPhone13,2"
com.apple.MobileSMS,4,1734197153,1734197157,1734197157.1399431,-21600,EB445137-D7F5-57EC-87DA-1DB460D64046,"iPhone13,2"
com.apple.MobileSMS,28,1734197075,1734197103,1734197104.387529,-21600,EB445137-D7F5-57EC-87DA-1DB460D64046,"iPhone13,2"
com.apple.weather,2,1734197073,1734197075,1734197075.449328,-21600,EB445137-D7F5-57EC-87DA-1DB460D64046,"iPhone13,2"
com.apple.weather,14,1734197059,1734197073,1734197073.2367911,-21600,EB445137-D7F5-57EC-87DA-1DB460D64046,"iPhone13,2"
com.apple.weather,1,1734196955,1734196956,1734196957.07019,-21600,EB445137-D7F5-57EC-87DA-1DB460D64046,"iPhone13,2"
com.apple.weather,9,1734196246,1734196255,1734196255.539966,-21600,EB445137-D7F5-57EC-87DA-1DB460D64046,"iPhone13,2"
com.toyopagroup.picaboo,14,1734196224,1734196238,1734196239.414984,-21600,EB445137-D7F5-57EC-87DA-1DB460D64046,"iPhone13,2"
com.apple.MobileSMS,18,1734196206,1734196224,1734196225.061308,-21600,EB445137-D7F5-57EC-87DA-1DB460D64046,"iPhone13,2"
com.renpho.health,5,1734196201,1734196206,1734196206.6509,-21600,EB445137-D7F5-57EC-87DA-1DB460D64046,"iPhone13,2"
com.leomehlig.today,37,1734196027,1734196064,1734196064.957121,-21600,,
com.apple.finder,2,1734196025,1734196027,1734196027.9361482,-21600,,
com.leomehlig.today,4,1734196021,1734196025,1734196025.764285,-21600,,
com.google.Chrome,10,1734196011,1734196021,1734196021.8335462,-21600,,
com.renpho.health,9,1734195504,1734195513,1734195513.389494,-21600,EB445137-D7F5-57EC-87DA-1DB460D64046,"iPhone13,2"
com.renpho.health,17,1734195439,1734195456,1734195457.113322,-21600,EB445137-D7F5-57EC-87DA-1DB460D64046,"iPhone13,2"
com.google.Chrome,9,1734157615,1734157624,1734157624.1740599,-21600,,
com.google.Chrome,300,1734157193,1734157493,1734157493.531859,-21600,,
com.google.Chrome,322,1734156701,1734157023,1734157023.5072699,-21600,,
com.google.Chrome,617,1734155785,1734156402,1734156402.939239,-21600,,
com.google.Chrome,589,1734155161,1734155750,1734155750.81417,-21600,,
com.google.Chrome,2361,1734152780,1734155141,1734155141.919991,-21600,,
com.google.ios.youtube,143,1734151991,1734152134,1734152135.320638,-21600,EB445137-D7F5-57EC-87DA-1DB460D64046,"iPhone13,2"
com.google.chrome.ios,74,1734151917,1734151991,1734151991.571837,-21600,EB445137-D7F5-57EC-87DA-1DB460D64046,"iPhone13,2"
com.google.ios.youtube,883,1734151034,1734151917,1734151917.281642,-21600,EB445137-D7F5-57EC-87DA-1DB460D64046,"iPhone13,2"
com.apple.weather,34,1734151000,1734151034,1734151034.604951,-21600,EB445137-D7F5-57EC-87DA-1DB460D64046,"iPhone13,2"
com.google.ios.youtube,1264,1734149736,1734151000,1734151001.213088,-21600,EB445137-D7F5-57EC-87DA-1DB460D64046,"iPhone13,2"
com.google.chrome.ios,107,1734149537,1734149644,1734149644.3926659,-21600,EB445137-D7F5-57EC-87DA-1DB460D64046,"iPhone13,2"
com.toyopagroup.picaboo,58,1734149259,1734149317,1734149317.397476,-21600,EB445137-D7F5-57EC-87DA-1DB460D64046,"iPhone13,2"
com.apple.Maps,4,1734149255,1734149259,1734149259.790313,-21600,EB445137-D7F5-57EC-87DA-1DB460D64046,"iPhone13,2"
com.apple.Maps,45,1734148957,1734149002,1734149002.2526798,-21600,EB445137-D7F5-57EC-87DA-1DB460D64046,"iPhone13,2"
com.apple.weather,3,1734148954,1734148957,1734148957.458259,-21600,EB445137-D7F5-57EC-87DA-1DB460D64046,"iPhone13,2"
com.apple.weather,8,1734148852,1734148860,1734148860.125819,-21600,EB445137-D7F5-57EC-87DA-1DB460D64046,"iPhone13,2"
com.apple.weather,18,1734148832,1734148850,1734148851.199671,-21600,EB445137-D7F5-57EC-87DA-1DB460D64046,"iPhone13,2"
com.apple.Passwords,39,1734148597,1734148636,1734148636.368598,-21600,EB445137-D7F5-57EC-87DA-1DB460D64046,"iPhone13,2"
com.hammerandchisel.discord,2,1734148592,1734148594,1734148594.890135,-21600,EB445137-D7F5-57EC-87DA-1DB460D64046,"iPhone13,2"
com.hammerandchisel.discord,4,1734148427,1734148431,1734148431.083106,-21600,EB445137-D7F5-57EC-87DA-1DB460D64046,"iPhone13,2"
com.hammerandchisel.discord,9,1734148418,1734148427,1734148427.2652311,-21600,EB445137-D7F5-57EC-87DA-1DB460D64046,"iPhone13,2"
com.hammerandchisel.discord,63,1734148355,1734148418,1734148418.282553,-21600,EB445137-D7F5-57EC-87DA-1DB460D64046,"iPhone13,2"
com.hammerandchisel.discord,13,1734148239,1734148252,1734148254.0276709,-21600,EB445137-D7F5-57EC-87DA-1DB460D64046,"iPhone13,2"
com.hammerandchisel.discord,15,1734146305,1734146320,1734146320.775968,-21600,EB445137-D7F5-57EC-87DA-1DB460D64046,"iPhone13,2"
com.apple.news,6,1734146299,1734146305,1734146305.941467,-21600,EB445137-D7F5-57EC-87DA-1DB460D64046,"iPhone13,2"
com.apple.news,155,1734141288,1734141443,1734141443.752296,-21600,EB445137-D7F5-57EC-87DA-1DB460D64046,"iPhone13,2"
com.apple.MobileSMS,4,1734141270,1734141274,1734141274.557059,-21600,EB445137-D7F5-57EC-87DA-1DB460D64046,"iPhone13,2"
com.google.chrome.ios,7,1734141263,1734141270,1734141271.071697,-21600,EB445137-D7F5-57EC-87DA-1DB460D64046,"iPhone13,2"
com.apple.camera,25,1734135756,1734135781,1734135782.2114801,-21600,EB445137-D7F5-57EC-87DA-1DB460D64046,"iPhone13,2"
com.google.chrome.ios,26,1734135755,1734135781,1734135782.25368,-21600,EB445137-D7F5-57EC-87DA-1DB460D64046,"iPhone13,2"
com.google.chrome.ios,9,1734134616,1734134625,1734134625.648847,-21600,EB445137-D7F5-57EC-87DA-1DB460D64046,"iPhone13,2"
com.google.chrome.ios,11,1734134605,1734134616,1734134616.55691,-21600,EB445137-D7F5-57EC-87DA-1DB460D64046,"iPhone13,2"
com.apple.mobiletimer,1,1734134604,1734134605,1734134605.6822472,-21600,EB445137-D7F5-57EC-87DA-1DB460D64046,"iPhone13,2"
com.google.chrome.ios,27,1734134577,1734134604,1734134604.6923208,-21600,EB445137-D7F5-57EC-87DA-1DB460D64046,"iPhone13,2"
com.google.chrome.ios,5,1734133978,1734133983,1734133983.834346,-21600,EB445137-D7F5-57EC-87DA-1DB460D64046,"iPhone13,2"
com.google.chrome.ios,22,1734133836,1734133858,1734133858.392648,-21600,EB445137-D7F5-57EC-87DA-1DB460D64046,"iPhone13,2"
com.apple.camera,1,1734133177,1734133178,1734133178.308886,-21600,EB445137-D7F5-57EC-87DA-1DB460D64046,"iPhone13,2"
com.google.Chrome,155,1734133132,1734133287,1734133287.502845,-21600,,
com.apple.MobileSMS,2,1734133021,1734133023,1734133023.832779,-21600,EB445137-D7F5-57EC-87DA-1DB460D64046,"iPhone13,2"
com.apple.mobiletimer,4,1734133017,1734133021,1734133021.8509421,-21600,EB445137-D7F5-57EC-87DA-1DB460D64046,"iPhone13,2"
com.google.android.studio,239,1734132893,1734133132,1734133132.9508061,-21600,,
com.apple.MobileSMS,6,1734132887,1734132893,1734132893.444658,-21600,,
com.apple.mobiletimer,149,1734132833,1734132982,1734132982.866066,-21600,EB445137-D7F5-57EC-87DA-1DB460D64046,"iPhone13,2"
com.apple.MobileSMS,19,1734132814,1734132833,1734132833.0410352,-21600,EB445137-D7F5-57EC-87DA-1DB460D64046,"iPhone13,2"
com.apple.mobiletimer,25,1734132789,1734132814,1734132814.41431,-21600,EB445137-D7F5-57EC-87DA-1DB460D64046,"iPhone13,2"
com.apple.Music,2,1734132781,1734132783,1734132783.945694,-21600,EB445137-D7F5-57EC-87DA-1DB460D64046,"iPhone13,2"
com.apple.Music,10,1734132695,1734132705,1734132705.480931,-21600,EB445137-D7F5-57EC-87DA-1DB460D64046,"iPhone13,2"
com.apple.Music,6,1734132447,1734132453,1734132453.434591,-21600,EB445137-D7F5-57EC-87DA-1DB460D64046,"iPhone13,2"
com.apple.Music,4,1734132151,1734132155,1734132155.482327,-21600,EB445137-D7F5-57EC-87DA-1DB460D64046,"iPhone13,2"
com.apple.MobileSMS,2,1734132144,1734132146,1734132146.615824,-21600,EB445137-D7F5-57EC-87DA-1DB460D64046,"iPhone13,2"
com.apple.Music,3,1734132141,1734132144,1734132145.458864,-21600,EB445137-D7F5-57EC-87DA-1DB460D64046,"iPhone13,2"
com.google.android.studio,906,1734131981,1734132887,1734132887.959317,-21600,,
com.google.Chrome,2,1734131979,1734131981,1734131981.855678,-21600,,
com.google.android.studio,3,1734131976,1734131979,1734131979.995142,-21600,,
com.google.Chrome,60,1734131916,1734131976,1734131977.0299768,-21600,,
com.google.android.studio,145,1734131771,1734131916,1734131916.406034,-21600,,
com.google.Chrome,21,1734131750,1734131771,1734131771.10727,-21600,,
com.google.android.studio,9,1734131741,1734131750,1734131750.345273,-21600,,
com.google.Chrome,27,1734131714,1734131741,1734131741.176921,-21600,,
com.google.android.studio,1,1734131713,1734131714,1734131715.028933,-21600,,
com.google.Chrome,40,1734131673,1734131713,1734131713.167366,-21600,,
com.google.android.studio,1,1734131672,1734131673,1734131673.631079,-21600,,
com.google.Chrome,5,1734131667,1734131672,1734131672.959014,-21600,,
com.google.android.studio,5,1734131662,1734131667,1734131667.294524,-21600,,
com.google.Chrome,3,1734131659,1734131662,1734131663.0509171,-21600,,
com.google.android.studio,5,1734131654,1734131659,1734131659.847093,-21600,,
com.google.Chrome,4,1734131650,1734131654,1734131654.627264,-21600,,
com.google.android.studio,2,1734131648,1734131650,1734131650.891252,-21600,,
com.google.Chrome,25,1734131623,1734131648,1734131648.961293,-21600,,
com.google.android.studio,39,1734131584,1734131623,1734131623.273213,-21600,,
com.google.Chrome,2,1734131582,1734131584,1734131584.279782,-21600,,
com.google.android.studio,2,1734131580,1734131582,1734131582.7574239,-21600,,
com.google.Chrome,1,1734131579,1734131580,1734131580.109983,-21600,,
com.google.android.studio,3,1734131576,1734131579,1734131579.476582,-21600,,
com.google.Chrome,2,1734131574,1734131576,1734131576.8858461,-21600,,
com.google.android.studio,3,1734131571,1734131574,1734131575.0226378,-21600,,
com.google.Chrome,1,1734131570,1734131571,1734131571.570991,-21600,,
com.google.android.studio,2,1734131568,1734131570,1734131570.575187,-21600,,
com.google.Chrome,2,1734131566,1734131568,1734131568.194663,-21600,,
com.google.android.studio,4,1734131562,1734131566,1734131566.463115,-21600,,
com.google.Chrome,2,1734131560,1734131562,1734131562.9920201,-21600,,
com.google.android.studio,3,1734131557,1734131560,1734131560.399582,-21600,,
com.google.Chrome,3,1734131554,1734131557,1734131557.087702,-21600,,
com.google.android.studio,3,1734131551,1734131554,1734131554.328998,-21600,,
com.google.Chrome,3,1734131548,1734131551,1734131551.737018,-21600,,
com.google.android.studio,2,1734131546,1734131548,1734131548.441035,-21600,,
com.google.Chrome,5,1734131541,1734131546,1734131546.9902248,-21600,,
com.google.android.studio,8,1734131533,1734131541,1734131541.625737,-21600,,
com.google.Chrome,4,1734131529,1734131533,1734131533.781283,-21600,,
com.google.android.studio,2,1734131527,1734131529,1734131529.925864,-21600,,
com.google.Chrome,2,1734131525,1734131527,1734131527.38361,-21600,,
com.google.android.studio,1,1734131524,1734131525,1734131525.729041,-21600,,
com.google.Chrome,1,1734131523,1734131524,1734131524.4906049,-21600,,
com.google.android.studio,5,1734131518,1734131523,1734131523.613394,-21600,,
com.google.Chrome,2,1734131516,1734131518,1734131518.379262,-21600,,
com.google.android.studio,22,1734131494,1734131516,1734131516.817605,-21600,,
com.google.Chrome,3,1734131491,1734131494,1734131494.34823,-21600,,
com.google.android.studio,7,1734131484,1734131491,1734131491.8062348,-21600,,
com.google.Chrome,2,1734131482,1734131484,1734131484.1418052,-21600,,
com.google.android.studio,4,1734131478,1734131482,1734131482.818273,-21600,,
com.google.Chrome,3,1734131475,1734131478,1734131478.574053,-21600,,
com.google.android.studio,3,1734131472,1734131475,1734131475.49294,-21600,,
com.google.Chrome,4,1734131468,1734131472,1734131472.484118,-21600,,
com.google.android.studio,4,1734131464,1734131468,1734131468.8050342,-21600,,
com.google.Chrome,6,1734131458,1734131464,1734131464.1559582,-21600,,
com.google.android.studio,9,1734131449,1734131458,1734131458.8732262,-21600,,
com.google.Chrome,7,1734131442,1734131449,1734131449.815779,-21600,,
com.google.android.studio,2,1734131440,1734131442,1734131442.179852,-21600,,
com.google.Chrome,1,1734131439,1734131440,1734131440.6114988,-21600,,
com.google.android.studio,1,1734131438,1734131439,1734131439.29217,-21600,,
com.google.Chrome,7,1734131431,1734131438,1734131438.464714,-21600,,
com.google.android.studio,21,1734131410,1734131431,1734131431.558528,-21600,,
com.google.Chrome,1,1734131409,1734131410,1734131410.470412,-21600,,
com.google.android.studio,3,1734131406,1734131409,1734131409.884198,-21600,,
com.google.Chrome,7,1734131399,1734131406,1734131406.7491388,-21600,,
com.google.android.studio,2,1734131397,1734131399,1734131399.163076,-21600,,
com.google.Chrome,16,1734131381,1734131397,1734131397.980134,-21600,,
com.google.android.studio,7,1734131374,1734131381,1734131381.909353,-21600,,
com.google.Chrome,7,1734131367,1734131374,1734131374.904808,-21600,,
com.google.android.studio,20,1734131347,1734131367,1734131367.197451,-21600,,
com.apple.Music,6,1734131281,1734131287,1734131287.274863,-21600,EB445137-D7F5-57EC-87DA-1DB460D64046,"iPhone13,2"
com.ryansponzilli.DeepSkyCatalog,4,1734131277,1734131281,1734131281.31825,-21600,EB445137-D7F5-57EC-87DA-1DB460D64046,"iPhone13,2"
com.ryansponzilli.DeepSkyCatalog,6,1734131270,1734131276,1734131276.043813,-21600,EB445137-D7F5-57EC-87DA-1DB460D64046,"iPhone13,2"
com.google.Chrome,96,1734131251,1734131347,1734131347.760333,-21600,,
com.google.android.studio,105,1734131146,1734131251,1734131251.094946,-21600,,
com.google.Chrome,1,1734131145,1734131146,1734131146.34566,-21600,,
com.google.android.studio,3,1734131142,1734131145,1734131145.412651,-21600,,
com.google.Chrome,0,1734131142,1734131142,1734131142.884575,-21600,,
com.google.android.studio,1,1734131141,1734131142,1734131142.2881742,-21600,,
com.google.Chrome,2,1734131139,1734131141,1734131141.315759,-21600,,
com.google.android.studio,2,1734131137,1734131139,1734131139.9028668,-21600,,
com.google.Chrome,1,1734131136,1734131137,1734131137.3439999,-21600,,
com.google.android.studio,4,1734131132,1734131136,1734131136.567721,-21600,,
com.google.Chrome,8,1734131124,1734131132,1734131132.3133988,-21600,,
com.google.android.studio,116,1734131008,1734131124,1734131124.353554,-21600,,
com.google.Chrome,62,1734130946,1734131008,1734131008.588745,-21600,,
com.ryansponzilli.DeepSkyCatalog,104,1734130886,1734130990,1734130990.227071,-21600,EB445137-D7F5-57EC-87DA-1DB460D64046,"iPhone13,2"
com.apple.Music,3,1734130881,1734130884,1734130884.147959,-21600,EB445137-D7F5-57EC-87DA-1DB460D64046,"iPhone13,2"
com.apple.Music,2,1734130566,1734130568,1734130568.313562,-21600,EB445137-D7F5-57EC-87DA-1DB460D64046,"iPhone13,2"
com.google.android.studio,704,1734130242,1734130946,1734130947.01246,-21600,,
com.google.Chrome,2,1734130240,1734130242,1734130242.420582,-21600,,
com.google.android.studio,7,1734130233,1734130240,1734130240.9701362,-21600,,
com.google.Chrome,16,1734130217,1734130233,1734130233.1667619,-21600,,
com.apple.Music,8,1734130205,1734130213,1734130213.319304,-21600,EB445137-D7F5-57EC-87DA-1DB460D64046,"iPhone13,2"
com.google.android.studio,189,1734130028,1734130217,1734130217.737304,-21600,,
com.apple.Music,2,1734129987,1734129989,1734129989.48253,-21600,EB445137-D7F5-57EC-87DA-1DB460D64046,"iPhone13,2"
com.google.Chrome,6,1734129984,1734129990,1734129990.7734408,-21600,,
com.apple.MobileSMS,156,1734129828,1734129984,1734129984.9876552,-21600,,
com.google.android.studio,215,1734129613,1734129828,1734129828.441679,-21600,,
com.google.Chrome,101,1734129512,1734129613,1734129613.756263,-21600,,
com.google.android.studio,35,1734129477,1734129512,1734129512.371407,-21600,,
com.apple.Music,3,1734129453,1734129456,1734129456.4098902,-21600,EB445137-D7F5-57EC-87DA-1DB460D64046,"iPhone13,2"
com.google.Chrome,30,1734129447,1734129477,1734129477.261712,-21600,,
com.apple.MobileSMS,10,1734129437,1734129447,1734129447.945503,-21600,,
com.google.Chrome,1,1734129436,1734129437,1734129437.4280639,-21600,,
com.google.android.studio,1,1734129435,1734129436,1734129436.3605142,-21600,,
com.google.Chrome,7,1734129428,1734129435,1734129435.423291,-21600,,
com.apple.MobileSMS,85,1734129343,1734129428,1734129428.326807,-21600,,
com.apple.Music,2,1734129159,1734129161,1734129161.3094459,-21600,EB445137-D7F5-57EC-87DA-1DB460D64046,"iPhone13,2"
com.google.Chrome,1412,1734127931,1734129343,1734129343.0758061,-21600,,
com.google.android.studio,4,1734127927,1734127931,1734127931.97787,-21600,,
com.apple.Music,16,1734127890,1734127906,1734127906.842036,-21600,EB445137-D7F5-57EC-87DA-1DB460D64046,"iPhone13,2"
com.apple.news,1,1734127887,1734127888,1734127888.169625,-21600,EB445137-D7F5-57EC-87DA-1DB460D64046,"iPhone13,2"
com.apple.news,49,1734127742,1734127791,1734127791.267452,-21600,EB445137-D7F5-57EC-87DA-1DB460D64046,"iPhone13,2"
com.apple.camera,0,1734127696,1734127696,1734127696.765658,-21600,EB445137-D7F5-57EC-87DA-1DB460D64046,"iPhone13,2"
com.leomehlig.today,281,1734127646,1734127927,1734127927.623506,-21600,,
com.google.Chrome,1122,1734126524,1734127646,1734127646.679735,-21600,,
com.leomehlig.today,1,1734126523,1734126524,1734126524.422744,-21600,,
com.google.Chrome,294,1734126229,1734126523,1734126523.685642,-21600,,
com.apple.MobileSMS,5,1734126224,1734126229,1734126229.1020908,-21600,,
com.google.Chrome,2427,1734123797,1734126224,1734126224.224955,-21600,,
com.leomehlig.today,9,1734123788,1734123797,1734123797.822937,-21600,,
com.google.ios.youtube,1313,1734122436,1734123749,1734123750.094864,-21600,EB445137-D7F5-57EC-87DA-1DB460D64046,"iPhone13,2"
com.leomehlig.today,317,1734122385,1734122702,1734122702.656177,-21600,,
com.google.Chrome,2392,1734119993,1734122385,1734122385.330737,-21600,,
com.apple.finder,8,1734119985,1734119993,1734119993.371897,-21600,,
com.google.Chrome,70,1734119915,1734119985,1734119985.0857558,-21600,,
com.leomehlig.today,74,1734119829,1734119903,1734119903.265826,-21600,,
com.google.Chrome,10,1734119819,1734119829,1734119829.0619721,-21600,,
com.apple.news,102,1734118694,1734118796,1734118797.0027819,-21600,EB445137-D7F5-57EC-87DA-1DB460D64046,"iPhone13,2"
com.apple.news,120,1734118522,1734118642,1734118642.957995,-21600,EB445137-D7F5-57EC-87DA-1DB460D64046,"iPhone13,2"
com.apple.news,136,1734118339,1734118475,1734118475.725589,-21600,EB445137-D7F5-57EC-87DA-1DB460D64046,"iPhone13,2"
com.apple.news,131,1734118141,1734118272,1734118272.680255,-21600,EB445137-D7F5-57EC-87DA-1DB460D64046,"iPhone13,2"
com.apple.camera,0,1734117631,1734117631,1734117631.5266562,-21600,EB445137-D7F5-57EC-87DA-1DB460D64046,"iPhone13,2"
com.instructure.icanvas,7,1734117618,1734117625,1734117625.276781,-21600,EB445137-D7F5-57EC-87DA-1DB460D64046,"iPhone13,2"
com.strava.stravaride,76,1734117533,1734117609,1734117609.3407269,-21600,EB445137-D7F5-57EC-87DA-1DB460D64046,"iPhone13,2"
com.strava.stravaride,28,1734117453,1734117481,1734117481.8034081,-21600,EB445137-D7F5-57EC-87DA-1DB460D64046,"iPhone13,2"
com.apple.news,2,1734117448,1734117450,1734117450.4201012,-21600,EB445137-D7F5-57EC-87DA-1DB460D64046,"iPhone13,2"
com.apple.news,37,1734117389,1734117426,1734117426.987335,-21600,EB445137-D7F5-57EC-87DA-1DB460D64046,"iPhone13,2"
com.microsoft.Office.Outlook,4,1734117370,1734117374,1734117374.555042,-21600,EB445137-D7F5-57EC-87DA-1DB460D64046,"iPhone13,2"
com.apple.MobileSMS,11,1734117358,1734117369,1734117369.966038,-21600,EB445137-D7F5-57EC-87DA-1DB460D64046,"iPhone13,2"
com.google.Chrome,31,1734115428,1734115459,1734115459.3858562,-21600,,
com.google.android.studio,3,1734115425,1734115428,1734115428.06692,-21600,,
com.google.Chrome,831,1734114594,1734115425,1734115425.32289,-21600,,
com.google.android.studio,379,1734114215,1734114594,1734114594.691704,-21600,,
com.apple.MobileSMS,8,1734113014,1734113022,1734113022.502917,-21600,EB445137-D7F5-57EC-87DA-1DB460D64046,"iPhone13,2"
com.google.android.studio,532,1734112766,1734113298,1734113298.33562,-21600,,
com.google.Chrome,2,1734112764,1734112766,1734112766.617114,-21600,,
com.google.android.studio,4,1734112760,1734112764,1734112764.463995,-21600,,
com.google.Chrome,1,1734112759,1734112760,1734112760.5660272,-21600,,
com.google.android.studio,11,1734112748,1734112759,1734112759.334326,-21600,,
com.google.Chrome,1,1734112747,1734112748,1734112748.937149,-21600,,
com.google.android.studio,1,1734112746,1734112747,1734112747.936444,-21600,,
com.google.Chrome,27,1734112719,1734112746,1734112746.6519032,-21600,,
com.google.android.studio,106,1734112613,1734112719,1734112719.720446,-21600,,
com.google.Chrome,32,1734112581,1734112613,1734112613.221883,-21600,,
com.google.android.studio,32,1734112549,1734112581,1734112581.561504,-21600,,
com.microsoft.onenote.mac,5,1734112544,1734112549,1734112549.241502,-21600,,
com.leomehlig.today,78,1734112466,1734112544,1734112544.043833,-21600,,
com.microsoft.onenote.mac,4,1734112462,1734112466,1734112466.2588692,-21600,,
com.google.Chrome,4,1734112458,1734112462,1734112462.779584,-21600,,
com.apple.Music,3,1734112455,1734112458,1734112458.525471,-21600,,
com.google.ios.youtube,261,1734110352,1734110613,1734110613.5631108,-21600,EB445137-D7F5-57EC-87DA-1DB460D64046,"iPhone13,2"
com.apple.weather,5,1734107418,1734107423,1734107423.317817,-21600,EB445137-D7F5-57EC-87DA-1DB460D64046,"iPhone13,2"
com.apple.Health,4,1734107408,1734107412,1734107412.504941,-21600,EB445137-D7F5-57EC-87DA-1DB460D64046,"iPhone13,2"
com.google.ios.youtube,34,1734107374,1734107408,1734107408.928869,-21600,EB445137-D7F5-57EC-87DA-1DB460D64046,"iPhone13,2"
com.apple.camera,362,1734106898,1734107260,1734107260.151506,-21600,EB445137-D7F5-57EC-87DA-1DB460D64046,"iPhone13,2"
com.google.ios.youtube,362,1734106898,1734107260,1734107260.148629,-21600,EB445137-D7F5-57EC-87DA-1DB460D64046,"iPhone13,2"
com.google.ios.youtube,10,1734106532,1734106542,1734106542.220214,-21600,EB445137-D7F5-57EC-87DA-1DB460D64046,"iPhone13,2"
com.google.ios.youtube,840,1734105142,1734105982,1734105983.0469651,-21600,EB445137-D7F5-57EC-87DA-1DB460D64046,"iPhone13,2"
com.google.ios.youtube,1256,1734103872,1734105128,1734105128.2322478,-21600,EB445137-D7F5-57EC-87DA-1DB460D64046,"iPhone13,2"
com.apple.Health,22,1734103815,1734103837,1734103837.4508471,-21600,EB445137-D7F5-57EC-87DA-1DB460D64046,"iPhone13,2"
com.toyopagroup.picaboo,18,1734103780,1734103798,1734103798.151542,-21600,EB445137-D7F5-57EC-87DA-1DB460D64046,"iPhone13,2"
com.renpho.health,17,1734103662,1734103679,1734103679.694158,-21600,EB445137-D7F5-57EC-87DA-1DB460D64046,"iPhone13,2"
com.apple.Music,575,1734070580,1734071155,1734071155.951401,-21600,,
com.apple.Photos,2872,1734067708,1734070580,1734070580.604735,-21600,,
com.apple.Music,35,1734067673,1734067708,1734067708.0398932,-21600,,
com.apple.Photos,32,1734067641,1734067673,1734067673.397408,-21600,,
com.apple.Music,3,1734067638,1734067641,1734067641.854848,-21600,,
com.google.Chrome,708,1734066930,1734067638,1734067638.57288,-21600,,
com.google.Chrome,552,1734066348,1734066900,1734066900.384671,-21600,,
com.google.android.studio,7,1734066127,1734066134,1734066134.6203961,-21600,,
com.google.Chrome,269,1734065858,1734066127,1734066127.834457,-21600,,
com.google.Chrome,305,1734065458,1734065763,1734065763.3452768,-21600,,
com.google.Chrome,310,1734064977,1734065287,1734065287.853269,-21600,,
com.google.android.studio,119,1734064858,1734064977,1734064977.4032068,-21600,,
com.leomehlig.today,3,1734064818,1734064821,1734064821.17275,-21600,,
com.google.android.studio,16,1734064802,1734064818,1734064818.387329,-21600,,
com.google.Chrome,112,1734064690,1734064802,1734064803.026186,-21600,,
com.apple.Passwords,9,1734064676,1734064685,1734064685.171581,-21600,,
com.google.Chrome,63,1734064613,1734064676,1734064677.103802,-21600,,
com.google.android.studio,25,1734064588,1734064613,1734064614.8002682,-21600,,
com.apple.Health,17,1734064513,1734064530,1734064530.177937,-21600,EB445137-D7F5-57EC-87DA-1DB460D64046,"iPhone13,2"
com.apple.Health,65,1734064439,1734064504,1734064504.847137,-21600,EB445137-D7F5-57EC-87DA-1DB460D64046,"iPhone13,2"
com.apple.news,3,1734064436,1734064439,1734064439.9887571,-21600,EB445137-D7F5-57EC-87DA-1DB460D64046,"iPhone13,2"
com.leomehlig.today,136,1734064426,1734064562,1734064563.073227,-21600,,
com.microsoft.onenote.mac,21,1734064405,1734064426,1734064426.45087,-21600,,
com.leomehlig.today,26,1734064366,1734064392,1734064392.1148949,-21600,,
com.google.Chrome,2,1734064364,1734064366,1734064366.984908,-21600,,
com.apple.news,2,1734063568,1734063570,1734063570.3527331,-21600,EB445137-D7F5-57EC-87DA-1DB460D64046,"iPhone13,2"
com.apple.news,3,1734063002,1734063005,1734063005.379146,-21600,EB445137-D7F5-57EC-87DA-1DB460D64046,"iPhone13,2"
com.apple.news,5,1734062792,1734062797,1734062797.797124,-21600,EB445137-D7F5-57EC-87DA-1DB460D64046,"iPhone13,2"
com.apple.news,61,1734062718,1734062779,1734062779.370281,-21600,EB445137-D7F5-57EC-87DA-1DB460D64046,"iPhone13,2"
com.instructure.icanvas,8,1734061283,1734061291,1734061291.187924,-21600,EB445137-D7F5-57EC-87DA-1DB460D64046,"iPhone13,2"
com.apple.MobileSMS,13,1734058484,1734058497,1734058497.433836,-21600,EB445137-D7F5-57EC-87DA-1DB460D64046,"iPhone13,2"
com.apple.MobileSMS,13,1734058434,1734058447,1734058447.812377,-21600,EB445137-D7F5-57EC-87DA-1DB460D64046,"iPhone13,2"
com.apple.MobileSMS,2,1734058396,1734058398,1734058398.859565,-21600,EB445137-D7F5-57EC-87DA-1DB460D64046,"iPhone13,2"
com.apple.MobileSMS,2,1734058384,1734058386,1734058386.624516,-21600,EB445137-D7F5-57EC-87DA-1DB460D64046,"iPhone13,2"
com.apple.MobileSMS,104,1734058243,1734058347,1734058347.8495421,-21600,EB445137-D7F5-57EC-87DA-1DB460D64046,"iPhone13,2"
com.apple.MobileSMS,11,1734058184,1734058195,1734058195.547586,-21600,EB445137-D7F5-57EC-87DA-1DB460D64046,"iPhone13,2"
com.apple.MobileSMS,194,1734057967,1734058161,1734058161.894567,-21600,EB445137-D7F5-57EC-87DA-1DB460D64046,"iPhone13,2"
com.apple.findmy,8,1734057959,1734057967,1734057967.4684439,-21600,EB445137-D7F5-57EC-87DA-1DB460D64046,"iPhone13,2"
com.microsoft.Office.Outlook,6,1734056350,1734056356,1734056357.063664,-21600,EB445137-D7F5-57EC-87DA-1DB460D64046,"iPhone13,2"
com.google.chrome.ios,33,1734056315,1734056348,1734056348.770386,-21600,EB445137-D7F5-57EC-87DA-1DB460D64046,"iPhone13,2"
com.google.chrome.ios,78,1734055798,1734055876,1734055876.215199,-21600,EB445137-D7F5-57EC-87DA-1DB460D64046,"iPhone13,2"
com.google.chrome.ios,12,1734052077,1734052089,1734052089.904465,-21600,EB445137-D7F5-57EC-87DA-1DB460D64046,"iPhone13,2"
com.google.chrome.ios,6,1734052023,1734052029,1734052029.8567271,-21600,EB445137-D7F5-57EC-87DA-1DB460D64046,"iPhone13,2"
com.google.chrome.ios,343,1734050291,1734050634,1734050635.3132172,-21600,EB445137-D7F5-57EC-87DA-1DB460D64046,"iPhone13,2"
com.google.chrome.ios,4,1734049781,1734049785,1734049785.0128388,-21600,EB445137-D7F5-57EC-87DA-1DB460D64046,"iPhone13,2"
com.google.chrome.ios,5,1734049513,1734049518,1734049518.660883,-21600,EB445137-D7F5-57EC-87DA-1DB460D64046,"iPhone13,2"
com.google.chrome.ios,8,1734049468,1734049476,1734049476.746566,-21600,EB445137-D7F5-57EC-87DA-1DB460D64046,"iPhone13,2"
com.apple.camera,1,1734049468,1734049469,1734049469.514365,-21600,EB445137-D7F5-57EC-87DA-1DB460D64046,"iPhone13,2"
com.google.chrome.ios,16,1734049392,1734049408,1734049408.3268309,-21600,EB445137-D7F5-57EC-87DA-1DB460D64046,"iPhone13,2"
com.google.chrome.ios,24,1734049077,1734049101,1734049101.707605,-21600,EB445137-D7F5-57EC-87DA-1DB460D64046,"iPhone13,2"
com.burbn.instagram,2,1734049075,1734049077,1734049077.905273,-21600,EB445137-D7F5-57EC-87DA-1DB460D64046,"iPhone13,2"
com.burbn.instagram,29,1734048265,1734048294,1734048294.972204,-21600,EB445137-D7F5-57EC-87DA-1DB460D64046,"iPhone13,2"
com.burbn.instagram,4,1734047738,1734047742,1734047742.102907,-21600,EB445137-D7F5-57EC-87DA-1DB460D64046,"iPhone13,2"
com.burbn.instagram,3,1734046839,1734046842,1734046842.072803,-21600,EB445137-D7F5-57EC-87DA-1DB460D64046,"iPhone13,2"
com.burbn.instagram,66,1734046216,1734046282,1734046282.4965482,-21600,EB445137-D7F5-57EC-87DA-1DB460D64046,"iPhone13,2"
com.apple.mobileslideshow,5,1734046209,1734046214,1734046214.6287441,-21600,EB445137-D7F5-57EC-87DA-1DB460D64046,"iPhone13,2"
com.apple.mobileslideshow,12,1734046166,1734046178,1734046178.793658,-21600,EB445137-D7F5-57EC-87DA-1DB460D64046,"iPhone13,2"
com.strava.stravaride,2,1734046164,1734046166,1734046166.1053991,-21600,EB445137-D7F5-57EC-87DA-1DB460D64046,"iPhone13,2"
com.strava.stravaride,6,1734045468,1734045474,1734045474.28932,-21600,EB445137-D7F5-57EC-87DA-1DB460D64046,"iPhone13,2"
com.strava.stravaride,62,1734045350,1734045412,1734045412.584209,-21600,EB445137-D7F5-57EC-87DA-1DB460D64046,"iPhone13,2"
com.apple.Maps,6,1734045344,1734045350,1734045350.37913,-21600,EB445137-D7F5-57EC-87DA-1DB460D64046,"iPhone13,2"
com.google.Chrome,34,1734044999,1734045033,1734045033.362832,-21600,,
com.leomehlig.today,1,1734044998,1734044999,1734045001.310396,-21600,,
com.leomehlig.today,20,1734044942,1734044962,1734044962.269981,-21600,,
com.apple.Maps,7,1734044935,1734044942,1734044942.358111,-21600,,
com.google.Chrome,321,1734044614,1734044935,1734044935.4276052,-21600,,
com.apple.Maps,185,1734044591,1734044776,1734044776.8815079,-21600,EB445137-D7F5-57EC-87DA-1DB460D64046,"iPhone13,2"
com.apple.MobileSMS,9,1734044579,1734044588,1734044588.227072,-21600,EB445137-D7F5-57EC-87DA-1DB460D64046,"iPhone13,2"
com.apple.Maps,137,1734044477,1734044614,1734044614.383476,-21600,,
com.google.Chrome,898,1734043579,1734044477,1734044477.972152,-21600,,
com.apple.MobileSMS,10,1734043010,1734043020,1734043020.7615728,-21600,,
com.leomehlig.today,2,1734043008,1734043010,1734043010.772418,-21600,,
com.apple.MobileSMS,10,1734042857,1734042867,1734042867.374732,-21600,EB445137-D7F5-57EC-87DA-1DB460D64046,"iPhone13,2"
com.apple.MobileSMS,48,1734042764,1734042812,1734042812.792142,-21600,EB445137-D7F5-57EC-87DA-1DB460D64046,"iPhone13,2"
com.google.Gmail,5,1734042177,1734042182,1734042183.107688,-21600,EB445137-D7F5-57EC-87DA-1DB460D64046,"iPhone13,2"
com.apple.MobileSMS,1,1734042176,1734042177,1734042178.026935,-21600,EB445137-D7F5-57EC-87DA-1DB460D64046,"iPhone13,2"
com.apple.camera,3,1734041967,1734041970,1734041971.193027,-21600,EB445137-D7F5-57EC-87DA-1DB460D64046,"iPhone13,2"
com.apple.MobileSMS,5,1734041965,1734041970,1734041971.105669,-21600,EB445137-D7F5-57EC-87DA-1DB460D64046,"iPhone13,2"
com.apple.MobileSMS,10,1734041417,1734041427,1734041427.934225,-21600,EB445137-D7F5-57EC-87DA-1DB460D64046,"iPhone13,2"
com.apple.MobileSMS,10,1734041295,1734041305,1734041305.606289,-21600,EB445137-D7F5-57EC-87DA-1DB460D64046,"iPhone13,2"
com.apple.MobileSMS,10,1734041173,1734041183,1734041183.52113,-21600,EB445137-D7F5-57EC-87DA-1DB460D64046,"iPhone13,2"
com.apple.MobileSMS,10,1734041149,1734041159,1734041159.940541,-21600,EB445137-D7F5-57EC-87DA-1DB460D64046,"iPhone13,2"
com.apple.MobileSMS,10,1734041041,1734041051,1734041051.041148,-21600,EB445137-D7F5-57EC-87DA-1DB460D64046,"iPhone13,2"
com.apple.MobileSMS,10,1734040947,1734040957,1734040957.430091,-21600,EB445137-D7F5-57EC-87DA-1DB460D64046,"iPhone13,2"
com.apple.MobileSMS,11,1734040912,1734040923,1734040923.024338,-21600,EB445137-D7F5-57EC-87DA-1DB460D64046,"iPhone13,2"
com.apple.MobileSMS,10,1734040875,1734040885,1734040885.95958,-21600,EB445137-D7F5-57EC-87DA-1DB460D64046,"iPhone13,2"
com.apple.MobileSMS,10,1734040833,1734040843,1734040843.691561,-21600,EB445137-D7F5-57EC-87DA-1DB460D64046,"iPhone13,2"
com.apple.MobileSMS,3,1734040681,1734040684,1734040684.552882,-21600,EB445137-D7F5-57EC-87DA-1DB460D64046,"iPhone13,2"
com.apple.MobileSMS,3,1734040678,1734040681,1734040681.557344,-21600,EB445137-D7F5-57EC-87DA-1DB460D64046,"iPhone13,2"
com.apple.MobileSMS,15,1734040440,1734040455,1734040455.759398,-21600,EB445137-D7F5-57EC-87DA-1DB460D64046,"iPhone13,2"
com.apple.MobileSMS,132,1734040289,1734040421,1734040422.040947,-21600,EB445137-D7F5-57EC-87DA-1DB460D64046,"iPhone13,2"
com.apple.camera,9,1734040279,1734040288,1734040289.7073588,-21600,EB445137-D7F5-57EC-87DA-1DB460D64046,"iPhone13,2"
com.apple.camera,5,1734040268,1734040273,1734040273.295939,-21600,EB445137-D7F5-57EC-87DA-1DB460D64046,"iPhone13,2"
com.ryansponzilli.DeepSkyCatalog,10,1734040267,1734040277,1734040277.926116,-21600,EB445137-D7F5-57EC-87DA-1DB460D64046,"iPhone13,2"
com.leomehlig.today,20,1734040238,1734040258,1734040258.272379,-21600,,
com.google.Chrome,4,1734040234,1734040238,1734040238.5684462,-21600,,
com.google.android.studio,117,1734040117,1734040234,1734040234.753055,-21600,,
com.google.Chrome,59,1734040058,1734040117,1734040117.11306,-21600,,
com.google.android.studio,22,1734040036,1734040058,1734040058.1010308,-21600,,
com.apple.dt.Xcode,1,1734040035,1734040036,1734040036.511438,-21600,,
com.google.android.studio,104,1734039931,1734040035,1734040035.993497,-21600,,
com.ryansponzilli.DeepSkyCatalog,2,1734039920,1734039922,1734039923.134882,-21600,EB445137-D7F5-57EC-87DA-1DB460D64046,"iPhone13,2"
com.apple.dt.Xcode,17,1734039914,1734039931,1734039931.2002149,-21600,,
com.ryansponzilli.DeepSkyCatalog,5,1734039730,1734039735,1734039735.6328049,-21600,EB445137-D7F5-57EC-87DA-1DB460D64046,"iPhone13,2"
com.ryansponzilli.DeepSkyCatalog,16,1734039595,1734039611,1734039611.552908,-21600,EB445137-D7F5-57EC-87DA-1DB460D64046,"iPhone13,2"
com.google.android.studio,371,1734039543,1734039914,1734039914.666961,-21600,,
com.apple.MobileSMS,17,1734039526,1734039543,1734039543.738079,-21600,,
com.apple.MobileSMS,22,1734039497,1734039519,1734039519.0773048,-21600,EB445137-D7F5-57EC-87DA-1DB460D64046,"iPhone13,2"
com.google.android.studio,113,1734039413,1734039526,1734039526.864036,-21600,,
com.apple.MobileSMS,29,1734039378,1734039407,1734039407.485691,-21600,EB445137-D7F5-57EC-87DA-1DB460D64046,"iPhone13,2"
com.ryansponzilli.DeepSkyCatalog,1,1734039377,1734039378,1734039378.820595,-21600,EB445137-D7F5-57EC-87DA-1DB460D64046,"iPhone13,2"
com.google.Chrome,64,1734039349,1734039413,1734039413.717229,-21600,,
com.ryansponzilli.DeepSkyCatalog,15,1734039341,1734039356,1734039356.926618,-21600,EB445137-D7F5-57EC-87DA-1DB460D64046,"iPhone13,2"
com.ryansponzilli.DeepSkyCatalog,10,1734039221,1734039231,1734039231.197088,-21600,EB445137-D7F5-57EC-87DA-1DB460D64046,"iPhone13,2"
com.ryansponzilli.DeepSkyCatalog,61,1734039123,1734039184,1734039184.7408829,-21600,EB445137-D7F5-57EC-87DA-1DB460D64046,"iPhone13,2"
com.apple.MobileSMS,4,1734039119,1734039123,1734039123.8040838,-21600,EB445137-D7F5-57EC-87DA-1DB460D64046,"iPhone13,2"
com.apple.MobileSMS,28,1734039028,1734039056,1734039056.520963,-21600,EB445137-D7F5-57EC-87DA-1DB460D64046,"iPhone13,2"
com.ryansponzilli.DeepSkyCatalog,47,1734038981,1734039028,1734039028.408716,-21600,EB445137-D7F5-57EC-87DA-1DB460D64046,"iPhone13,2"
com.ryansponzilli.DeepSkyCatalog,10,1734038930,1734038940,1734038940.899641,-21600,EB445137-D7F5-57EC-87DA-1DB460D64046,"iPhone13,2"
com.google.android.studio,471,1734038878,1734039349,1734039349.998927,-21600,,
com.apple.iCal,35,1734038843,1734038878,1734038878.762639,-21600,,
com.ryansponzilli.DeepSkyCatalog,12,1734038835,1734038847,1734038847.296505,-21600,EB445137-D7F5-57EC-87DA-1DB460D64046,"iPhone13,2"
com.ryansponzilli.DeepSkyCatalog,10,1734038810,1734038820,1734038820.8842158,-21600,EB445137-D7F5-57EC-87DA-1DB460D64046,"iPhone13,2"
com.ryansponzilli.DeepSkyCatalog,10,1734038786,1734038796,1734038796.6969352,-21600,EB445137-D7F5-57EC-87DA-1DB460D64046,"iPhone13,2"
com.ryansponzilli.DeepSkyCatalog,62,1734038275,1734038337,1734038337.400786,-21600,EB445137-D7F5-57EC-87DA-1DB460D64046,"iPhone13,2"
com.ryansponzilli.DeepSkyCatalog,83,1734038089,1734038172,1734038172.378547,-21600,EB445137-D7F5-57EC-87DA-1DB460D64046,"iPhone13,2"
com.google.android.studio,801,1734038042,1734038843,1734038843.270314,-21600,,
com.apple.dt.Xcode,2,1734038040,1734038042,1734038042.7149591,-21600,,
com.google.android.studio,12,1734038028,1734038040,1734038040.775393,-21600,,
com.apple.dt.Xcode,6,1734038022,1734038028,1734038028.488971,-21600,,
com.google.android.studio,33,1734037989,1734038022,1734038022.625838,-21600,,
com.apple.dt.Xcode,19,1734037970,1734037989,1734037989.644865,-21600,,
com.ryansponzilli.DeepSkyCatalog,68,1734037758,1734037826,1734037826.593008,-21600,EB445137-D7F5-57EC-87DA-1DB460D64046,"iPhone13,2"
com.ryansponzilli.DeepSkyCatalog,116,1734037630,1734037746,1734037746.727438,-21600,EB445137-D7F5-57EC-87DA-1DB460D64046,"iPhone13,2"
com.google.android.studio,368,1734037602,1734037970,1734037970.755344,-21600,,
com.apple.MobileSMS,1,1734037601,1734037602,1734037602.644589,-21600,,
com.google.android.studio,4,1734037597,1734037601,1734037602.001082,-21600,,
com.apple.MobileSMS,67,1734037530,1734037597,1734037597.635985,-21600,,
com.ryansponzilli.DeepSkyCatalog,11,1734037511,1734037522,1734037522.696478,-21600,EB445137-D7F5-57EC-87DA-1DB460D64046,"iPhone13,2"
com.google.android.studio,351,1734037179,1734037530,1734037531.027549,-21600,,
com.google.Chrome,4,1734037175,1734037179,1734037179.102889,-21600,,
com.google.android.studio,33,1734037142,1734037175,1734037175.753552,-21600,,
com.google.Chrome,2,1734037140,1734037142,1734037142.324259,-21600,,
com.google.android.studio,8,1734037132,1734037140,1734037141.0421839,-21600,,
com.google.Chrome,24,1734037108,1734037132,1734037132.812897,-21600,,
com.google.android.studio,86,1734037022,1734037108,1734037108.8088222,-21600,,
com.google.Chrome,3,1734037019,1734037022,1734037023.0389829,-21600,,
com.google.android.studio,2,1734037017,1734037019,1734037019.885185,-21600,,
com.google.Chrome,57,1734036960,1734037017,1734037017.1121259,-21600,,
com.google.android.studio,50,1734036910,1734036960,1734036960.084638,-21600,,
com.google.Chrome,27,1734036883,1734036910,1734036910.6306992,-21600,,
com.google.android.studio,240,1734036643,1734036883,1734036883.743829,-21600,,
com.google.Chrome,16,1734036627,1734036643,1734036643.900146,-21600,,
com.google.android.studio,19,1734036608,1734036627,1734036627.992734,-21600,,
com.ryansponzilli.DeepSkyCatalog,10,1734036597,1734036607,1734036607.363307,-21600,EB445137-D7F5-57EC-87DA-1DB460D64046,"iPhone13,2"
com.google.Chrome,18,1734036590,1734036608,1734036608.937134,-21600,,
com.ryansponzilli.DeepSkyCatalog,10,1734036546,1734036556,1734036556.419321,-21600,EB445137-D7F5-57EC-87DA-1DB460D64046,"iPhone13,2"
com.google.android.studio,50,1734036540,1734036590,1734036590.644195,-21600,,
com.google.Chrome,18,1734036522,1734036540,1734036540.873724,-21600,,
com.ryansponzilli.DeepSkyCatalog,10,1734036426,1734036436,1734036436.418867,-21600,EB445137-D7F5-57EC-87DA-1DB460D64046,"iPhone13,2"
com.ryansponzilli.DeepSkyCatalog,10,1734036306,1734036316,1734036316.403288,-21600,EB445137-D7F5-57EC-87DA-1DB460D64046,"iPhone13,2"
com.ryansponzilli.DeepSkyCatalog,61,1734036191,1734036252,1734036252.2852159,-21600,EB445137-D7F5-57EC-87DA-1DB460D64046,"iPhone13,2"
com.google.android.studio,390,1734036132,1734036522,1734036522.76478,-21600,,
com.google.Chrome,20,1734036112,1734036132,1734036132.64357,-21600,,
com.google.android.studio,7,1734036105,1734036112,1734036112.111254,-21600,,
com.google.Chrome,6,1734036099,1734036105,1734036105.9999151,-21600,,
com.google.android.studio,35,1734036064,1734036099,1734036099.577167,-21600,,
com.google.Chrome,75,1734035989,1734036064,1734036064.807524,-21600,,
com.ryansponzilli.DeepSkyCatalog,62,1734035952,1734036014,1734036014.2989612,-21600,EB445137-D7F5-57EC-87DA-1DB460D64046,"iPhone13,2"
com.ryansponzilli.DeepSkyCatalog,100,1734035700,1734035800,1734035800.965384,-21600,EB445137-D7F5-57EC-87DA-1DB460D64046,"iPhone13,2"
com.apple.findmy,2,1734035698,1734035700,1734035700.537956,-21600,EB445137-D7F5-57EC-87DA-1DB460D64046,"iPhone13,2"
com.google.android.studio,307,1734035682,1734035989,1734035989.353652,-21600,,
com.apple.findmy,46,1734035631,1734035677,1734035677.4946961,-21600,EB445137-D7F5-57EC-87DA-1DB460D64046,"iPhone13,2"
com.ryansponzilli.DeepSkyCatalog,4,1734035621,1734035625,1734035625.803483,-21600,EB445137-D7F5-57EC-87DA-1DB460D64046,"iPhone13,2"
com.apple.dt.Xcode,77,1734035605,1734035682,1734035682.106633,-21600,,
com.ryansponzilli.DeepSkyCatalog,61,1734035555,1734035616,1734035616.809032,-21600,EB445137-D7F5-57EC-87DA-1DB460D64046,"iPhone13,2"
com.google.android.studio,254,1734035351,1734035605,1734035606.10851,-21600,,
com.apple.dt.Xcode,1,1734035350,1734035351,1734035351.2191691,-21600,,
com.google.android.studio,6,1734035344,1734035350,1734035350.379766,-21600,,
com.apple.dt.Xcode,1,1734035343,1734035344,1734035344.296696,-21600,,
com.google.android.studio,31,1734035312,1734035343,1734035343.669518,-21600,,
com.apple.dt.Xcode,3,1734035309,1734035312,1734035312.157551,-21600,,
com.google.android.studio,54,1734035255,1734035309,1734035310.011318,-21600,,
com.apple.dt.Xcode,3,1734035252,1734035255,1734035255.982194,-21600,,
com.google.android.studio,1,1734035251,1734035252,1734035252.7893481,-21600,,
com.apple.dt.Xcode,2,1734035249,1734035251,1734035251.686091,-21600,,
com.google.android.studio,94,1734035155,1734035249,1734035249.933651,-21600,,
com.apple.dt.Xcode,2,1734035153,1734035155,1734035155.740655,-21600,,
com.ryansponzilli.DeepSkyCatalog,110,1734035013,1734035123,1734035123.359118,-21600,EB445137-D7F5-57EC-87DA-1DB460D64046,"iPhone13,2"
com.apple.news,7,1734035005,1734035012,1734035012.228862,-21600,EB445137-D7F5-57EC-87DA-1DB460D64046,"iPhone13,2"
com.google.android.studio,152,1734035001,1734035153,1734035153.992496,-21600,,
com.apple.dt.Xcode,6,1734034995,1734035001,1734035001.892144,-21600,,
com.google.android.studio,219,1734034776,1734034995,1734034995.628361,-21600,,
com.apple.dt.Xcode,23,1734034753,1734034776,1734034776.327424,-21600,,
com.google.android.studio,1,1734034752,1734034753,1734034753.392349,-21600,,
com.apple.dt.Xcode,38,1734034714,1734034752,1734034753.11025,-21600,,
com.google.android.studio,86,1734034618,1734034704,1734034704.986079,-21600,,
com.microsoft.onenote.mac,68,1734034400,1734034468,1734034468.678076,-21600,,
com.google.Chrome,18,1734034382,1734034400,1734034400.4554,-21600,,
com.leomehlig.today,149,1734034233,1734034382,1734034382.864994,-21600,,
com.google.Chrome,501,1734033732,1734034233,1734034233.391643,-21600,,
com.leomehlig.today,19,1734033713,1734033732,1734033732.208844,-21600,,
com.google.Chrome,28,1734033685,1734033713,1734033713.8777518,-21600,,
com.apple.news,45,1734033531,1734033576,1734033576.800431,-21600,EB445137-D7F5-57EC-87DA-1DB460D64046,"iPhone13,2"
com.apple.camera,10,1734033055,1734033065,1734033065.666785,-21600,EB445137-D7F5-57EC-87DA-1DB460D64046,"iPhone13,2"
com.instructure.icanvas,15,1734033052,1734033067,1734033067.4232678,-21600,EB445137-D7F5-57EC-87DA-1DB460D64046,"iPhone13,2"
com.google.Chrome,1419,1734032022,1734033441,1734033441.594758,-21600,,
com.leomehlig.today,6,1734032016,1734032022,1734032022.629152,-21600,,
com.google.Chrome,319,1734031697,1734032016,1734032016.7399879,-21600,,
com.instructure.icanvas,24,1734031164,1734031188,1734031189.008706,-21600,EB445137-D7F5-57EC-87DA-1DB460D64046,"iPhone13,2"
com.apple.news,86,1734031063,1734031149,1734031149.825426,-21600,EB445137-D7F5-57EC-87DA-1DB460D64046,"iPhone13,2"
com.apple.weather,24,1734031012,1734031036,1734031036.50073,-21600,EB445137-D7F5-57EC-87DA-1DB460D64046,"iPhone13,2"
com.apple.news,4,1734031008,1734031012,1734031012.348171,-21600,EB445137-D7F5-57EC-87DA-1DB460D64046,"iPhone13,2"
com.apple.news,13,1734030437,1734030450,1734030450.128039,-21600,EB445137-D7F5-57EC-87DA-1DB460D64046,"iPhone13,2"
com.apple.news,10,1734030317,1734030327,1734030327.681633,-21600,EB445137-D7F5-57EC-87DA-1DB460D64046,"iPhone13,2"
com.google.Chrome,777,1734030166,1734030943,1734030943.792449,-21600,,
com.google.Chrome,857,1734029309,1734030166,1734030166.237512,-21600,,
com.apple.news,86,1734028924,1734029010,1734029010.601944,-21600,EB445137-D7F5-57EC-87DA-1DB460D64046,"iPhone13,2"
com.apple.news,9,1734028908,1734028917,1734028917.844812,-21600,EB445137-D7F5-57EC-87DA-1DB460D64046,"iPhone13,2"
com.google.Chrome,728,1734028569,1734029297,1734029297.64797,-21600,,
com.leomehlig.today,14,1734028537,1734028551,1734028552.702423,-21600,,
com.google.Chrome,3,1734028534,1734028537,1734028537.883909,-21600,,
com.apple.camera,4,1734027283,1734027287,1734027287.590132,-21600,EB445137-D7F5-57EC-87DA-1DB460D64046,"iPhone13,2"
com.apple.news,5,1734027282,1734027287,1734027287.5699549,-21600,EB445137-D7F5-57EC-87DA-1DB460D64046,"iPhone13,2"
com.apple.news,3,1734027233,1734027236,1734027236.344674,-21600,EB445137-D7F5-57EC-87DA-1DB460D64046,"iPhone13,2"
com.apple.news,613,1734026528,1734027141,1734027141.889174,-21600,EB445137-D7F5-57EC-87DA-1DB460D64046,"iPhone13,2"
com.apple.camera,2,1734026269,1734026271,1734026271.627239,-21600,EB445137-D7F5-57EC-87DA-1DB460D64046,"iPhone13,2"
com.google.Chrome,81,1734025131,1734025212,1734025212.6491508,-21600,,
com.apple.news,42,1734025059,1734025101,1734025101.732837,-21600,EB445137-D7F5-57EC-87DA-1DB460D64046,"iPhone13,2"
com.apple.weather,31,1734025016,1734025047,1734025047.878231,-21600,EB445137-D7F5-57EC-87DA-1DB460D64046,"iPhone13,2"
com.tinyspeck.chatlyio,6,1734024987,1734024993,1734024993.719553,-21600,EB445137-D7F5-57EC-87DA-1DB460D64046,"iPhone13,2"
com.apple.weather,8,1734024963,1734024971,1734024972.005622,-21600,EB445137-D7F5-57EC-87DA-1DB460D64046,"iPhone13,2"
com.leomehlig.today,194,1734024937,1734025131,1734025132.394158,-21600,,
com.apple.news,232,1734024705,1734024937,1734024937.763986,-21600,,
com.leomehlig.today,48,1734024657,1734024705,1734024705.579193,-21600,,
com.google.Chrome,21,1734024636,1734024657,1734024657.281054,-21600,,
com.apple.iCal,24,1734024598,1734024622,1734024622.80529,-21600,,
com.google.Chrome,8,1734024590,1734024598,1734024598.740092,-21600,,
com.apple.weather,8,1734024064,1734024072,1734024072.783781,-21600,EB445137-D7F5-57EC-87DA-1DB460D64046,"iPhone13,2"
com.apple.MobileSMS,4,1734023940,1734023944,1734023944.084867,-21600,EB445137-D7F5-57EC-87DA-1DB460D64046,"iPhone13,2"
com.google.chrome.ios,2,1734023938,1734023940,1734023940.730811,-21600,EB445137-D7F5-57EC-87DA-1DB460D64046,"iPhone13,2"
com.apple.MobileSMS,21,1734023917,1734023938,1734023938.3846998,-21600,EB445137-D7F5-57EC-87DA-1DB460D64046,"iPhone13,2"
com.apple.weather,2,1734023915,1734023917,1734023918.3385859,-21600,EB445137-D7F5-57EC-87DA-1DB460D64046,"iPhone13,2"
com.apple.weather,3,1734023105,1734023108,1734023108.9937391,-21600,EB445137-D7F5-57EC-87DA-1DB460D64046,"iPhone13,2"
com.apple.Health,6,1734023099,1734023105,1734023105.848174,-21600,EB445137-D7F5-57EC-87DA-1DB460D64046,"iPhone13,2"
com.apple.Health,13,1734023078,1734023091,1734023091.190556,-21600,EB445137-D7F5-57EC-87DA-1DB460D64046,"iPhone13,2"
com.apple.Health,15,1734023060,1734023075,1734023075.218597,-21600,EB445137-D7F5-57EC-87DA-1DB460D64046,"iPhone13,2"
com.renpho.health,16,1734023041,1734023057,1734023057.6657228,-21600,EB445137-D7F5-57EC-87DA-1DB460D64046,"iPhone13,2"
com.apple.MobileSMS,13,1734023028,1734023041,1734023041.2341142,-21600,EB445137-D7F5-57EC-87DA-1DB460D64046,"iPhone13,2"
com.google.ios.youtube,1297,1734020860,1734022157,1734022158.126892,-21600,EB445137-D7F5-57EC-87DA-1DB460D64046,"iPhone13,2"
com.google.ios.youtube,261,1734020575,1734020836,1734020837.046042,-21600,EB445137-D7F5-57EC-87DA-1DB460D64046,"iPhone13,2"
com.apple.news,345,1734020222,1734020567,1734020567.3806748,-21600,EB445137-D7F5-57EC-87DA-1DB460D64046,"iPhone13,2"
com.google.chrome.ios,57,1734020156,1734020213,1734020213.372069,-21600,EB445137-D7F5-57EC-87DA-1DB460D64046,"iPhone13,2"
com.microsoft.Office.Outlook,64,1734020092,1734020156,1734020156.416398,-21600,EB445137-D7F5-57EC-87DA-1DB460D64046,"iPhone13,2"
com.apple.news,522,1734019561,1734020083,1734020083.9691439,-21600,EB445137-D7F5-57EC-87DA-1DB460D64046,"iPhone13,2"
com.apple.mobiletimer,13,1733982663,1733982676,1733982676.9040608,-21600,EB445137-D7F5-57EC-87DA-1DB460D64046,"iPhone13,2"
com.apple.mobiletimer,10,1733982606,1733982616,1733982616.344574,-21600,EB445137-D7F5-57EC-87DA-1DB460D64046,"iPhone13,2"
com.apple.mobiletimer,7,1733982597,1733982604,1733982605.807415,-21600,EB445137-D7F5-57EC-87DA-1DB460D64046,"iPhone13,2"
com.google.Chrome,459,1733982053,1733982512,1733982512.431244,-21600,,
com.apple.Music,328,1733981725,1733982053,1733982053.768934,-21600,,
com.google.Chrome,31,1733981694,1733981725,1733981725.030387,-21600,,
com.apple.Music,0,1733981694,1733981694,1733981694.709239,-21600,,
com.google.Chrome,20,1733981674,1733981694,1733981694.075449,-21600,,
com.apple.Music,599,1733981032,1733981631,1733981631.83467,-21600,,
com.google.Chrome,563,1733980469,1733981032,1733981032.525725,-21600,,
com.apple.Music,3,1733980466,1733980469,1733980469.3599072,-21600,,
com.google.Chrome,12,1733980454,1733980466,1733980466.4428492,-21600,,
com.apple.Music,3,1733980451,1733980454,1733980454.846191,-21600,,
com.google.Chrome,13,1733980438,1733980451,1733980451.52847,-21600,,
com.apple.Music,11,1733980427,1733980438,1733980438.218967,-21600,,
com.google.Chrome,11,1733980416,1733980427,1733980427.140761,-21600,,
com.apple.Music,82,1733980334,1733980416,1733980416.249405,-21600,,
com.google.Chrome,1047,1733979287,1733980334,1733980334.5984778,-21600,,
com.apple.finder,3,1733979284,1733979287,1733979288.287549,-21600,,
com.apple.Maps,5,1733979176,1733979181,1733979181.654619,-21600,EB445137-D7F5-57EC-87DA-1DB460D64046,"iPhone13,2"
com.apple.Maps,101,1733978921,1733979022,1733979023.446735,-21600,EB445137-D7F5-57EC-87DA-1DB460D64046,"iPhone13,2"
com.apple.camera,3,1733976182,1733976185,1733976185.396996,-21600,EB445137-D7F5-57EC-87DA-1DB460D64046,"iPhone13,2"
com.apple.MobileSMS,42,1733976089,1733976131,1733976131.191222,-21600,EB445137-D7F5-57EC-87DA-1DB460D64046,"iPhone13,2"
com.google.chrome.ios,17,1733976072,1733976089,1733976089.796256,-21600,EB445137-D7F5-57EC-87DA-1DB460D64046,"iPhone13,2"
com.google.ios.youtube,3,1733976069,1733976072,1733976072.354025,-21600,EB445137-D7F5-57EC-87DA-1DB460D64046,"iPhone13,2"
com.google.ios.youtube,9,1733974210,1733974219,1733974219.433584,-21600,EB445137-D7F5-57EC-87DA-1DB460D64046,"iPhone13,2"
com.google.ios.youtube,2,1733974043,1733974045,1733974045.974656,-21600,EB445137-D7F5-57EC-87DA-1DB460D64046,"iPhone13,2"
com.google.ios.youtube,1,1733973923,1733973924,1733973924.09406,-21600,EB445137-D7F5-57EC-87DA-1DB460D64046,"iPhone13,2"
com.google.ios.youtube,66,1733973823,1733973889,1733973890.304319,-21600,EB445137-D7F5-57EC-87DA-1DB460D64046,"iPhone13,2"
com.google.ios.youtube,13,1733973808,1733973821,1733973821.503679,-21600,EB445137-D7F5-57EC-87DA-1DB460D64046,"iPhone13,2"
com.google.ios.youtube,22,1733971460,1733971482,1733971483.898479,-21600,EB445137-D7F5-57EC-87DA-1DB460D64046,"iPhone13,2"
com.google.chrome.ios,36,1733971424,1733971460,1733971460.811473,-21600,EB445137-D7F5-57EC-87DA-1DB460D64046,"iPhone13,2"
com.apple.MobileSMS,10,1733969386,1733969396,1733969396.288393,-21600,EB445137-D7F5-57EC-87DA-1DB460D64046,"iPhone13,2"
com.hammerandchisel.discord,17,1733969165,1733969182,1733969182.92261,-21600,EB445137-D7F5-57EC-87DA-1DB460D64046,"iPhone13,2"
com.hammerandchisel.discord,30,1733966269,1733966299,1733966300.940827,-21600,EB445137-D7F5-57EC-87DA-1DB460D64046,"iPhone13,2"
com.google.chrome.ios,12,1733966257,1733966269,1733966270.489561,-21600,EB445137-D7F5-57EC-87DA-1DB460D64046,"iPhone13,2"
com.google.chrome.ios,3,1733960280,1733960283,1733960283.646974,-21600,EB445137-D7F5-57EC-87DA-1DB460D64046,"iPhone13,2"
com.google.chrome.ios,13,1733960178,1733960191,1733960191.949301,-21600,EB445137-D7F5-57EC-87DA-1DB460D64046,"iPhone13,2"
com.hammerandchisel.discord,4,1733959329,1733959333,1733959333.6268501,-21600,EB445137-D7F5-57EC-87DA-1DB460D64046,"iPhone13,2"
com.apple.Music,8,1733959308,1733959316,1733959316.248815,-21600,EB445137-D7F5-57EC-87DA-1DB460D64046,"iPhone13,2"
com.apple.finder,123,1733959229,1733959352,1733959352.678036,-21600,,
com.google.android.studio,58,1733959171,1733959229,1733959229.52583,-21600,,
com.apple.iCal,68,1733959043,1733959111,1733959111.578827,-21600,,
com.leomehlig.today,15,1733959028,1733959043,1733959043.45441,-21600,,
com.apple.Music,6,1733958544,1733958550,1733958550.041803,-21600,EB445137-D7F5-57EC-87DA-1DB460D64046,"iPhone13,2"
com.apple.Music,10,1733958531,1733958541,1733958542.0648499,-21600,EB445137-D7F5-57EC-87DA-1DB460D64046,"iPhone13,2"
com.apple.MobileSMS,9,1733958506,1733958515,1733958515.249973,-21600,EB445137-D7F5-57EC-87DA-1DB460D64046,"iPhone13,2"
com.apple.MobileSMS,71,1733958395,1733958466,1733958466.76123,-21600,EB445137-D7F5-57EC-87DA-1DB460D64046,"iPhone13,2"
com.apple.camera,0,1733958126,1733958126,1733958126.992974,-21600,EB445137-D7F5-57EC-87DA-1DB460D64046,"iPhone13,2"
com.toyopagroup.picaboo,63,1733957894,1733957957,1733957957.9443321,-21600,EB445137-D7F5-57EC-87DA-1DB460D64046,"iPhone13,2"
com.apple.Music,5,1733957889,1733957894,1733957894.819057,-21600,EB445137-D7F5-57EC-87DA-1DB460D64046,"iPhone13,2"
com.apple.Music,17,1733956898,1733956915,1733956915.297607,-21600,EB445137-D7F5-57EC-87DA-1DB460D64046,"iPhone13,2"
com.leomehlig.today,9,1733956608,1733956617,1733956617.099691,-21600,,
com.apple.finder,3,1733956605,1733956608,1733956608.703876,-21600,,
com.microsoft.Outlook,2,1733956603,1733956605,1733956605.305953,-21600,,
com.google.Chrome,13,1733956590,1733956603,1733956603.871825,-21600,,
us.zoom.xos,7,1733956583,1733956590,1733956590.517976,-21600,,
com.google.Chrome,170,1733956413,1733956583,1733956583.230751,-21600,,
com.microsoft.Outlook,3,1733956410,1733956413,1733956413.666887,-21600,,
com.google.Chrome,99,1733956311,1733956410,1733956410.7107959,-21600,,
com.apple.finder,4,1733956307,1733956311,1733956311.068911,-21600,,
com.google.Chrome,1,1733956306,1733956307,1733956307.499236,-21600,,
com.apple.finder,1,1733956305,1733956306,1733956306.905004,-21600,,
com.google.Chrome,26,1733956279,1733956305,1733956305.586574,-21600,,
com.apple.finder,1,1733956278,1733956279,1733956279.240025,-21600,,
com.google.Chrome,63,1733956215,1733956278,1733956278.295923,-21600,,
com.microsoft.Outlook,2,1733956213,1733956215,1733956215.993775,-21600,,
com.google.Chrome,30,1733956183,1733956213,1733956213.504037,-21600,,
us.zoom.xos,2,1733956181,1733956183,1733956183.972052,-21600,,
com.google.Chrome,54,1733956127,1733956181,1733956181.614101,-21600,,
com.apple.finder,25,1733956102,1733956127,1733956127.597249,-21600,,
com.google.Chrome,68,1733956034,1733956102,1733956102.370431,-21600,,
com.apple.Music,2,1733956032,1733956034,1733956034.1572309,-21600,,
com.apple.camera,24,1733955475,1733955499,1733955499.301522,-21600,EB445137-D7F5-57EC-87DA-1DB460D64046,"iPhone13,2"
com.apple.weather,35,1733955471,1733955506,1733955506.1082258,-21600,EB445137-D7F5-57EC-87DA-1DB460D64046,"iPhone13,2"
com.apple.weather,11,1733955457,1733955468,1733955468.0261831,-21600,EB445137-D7F5-57EC-87DA-1DB460D64046,"iPhone13,2"
com.apple.weather,1,1733955455,1733955456,1733955456.896044,-21600,EB445137-D7F5-57EC-87DA-1DB460D64046,"iPhone13,2"
com.apple.Music,339,1733955454,1733955793,1733955793.136369,-21600,,
us.zoom.xos,26,1733955428,1733955454,1733955454.8049579,-21600,,
com.google.Chrome,182,1733955246,1733955428,1733955428.1044312,-21600,,
com.apple.MobileSMS,17,1733955157,1733955174,1733955174.77672,-21600,EB445137-D7F5-57EC-87DA-1DB460D64046,"iPhone13,2"
com.hammerandchisel.discord,38,1733955117,1733955155,1733955155.9413471,-21600,EB445137-D7F5-57EC-87DA-1DB460D64046,"iPhone13,2"
com.apple.MobileSMS,61,1733955029,1733955090,1733955090.47439,-21600,EB445137-D7F5-57EC-87DA-1DB460D64046,"iPhone13,2"
us.zoom.xos,294,1733954923,1733955217,1733955217.9856958,-21600,,
com.google.Chrome,47,1733954876,1733954923,1733954923.2583442,-21600,,
com.leomehlig.today,82,1733954794,1733954876,1733954876.481323,-21600,,
us.zoom.xos,3,1733954791,1733954794,1733954794.907113,-21600,,
com.leomehlig.today,3,1733954788,1733954791,1733954791.3108912,-21600,,
com.apple.news,73,1733954528,1733954601,1733954601.977715,-21600,EB445137-D7F5-57EC-87DA-1DB460D64046,"iPhone13,2"
com.instructure.icanvas,2,1733954516,1733954518,1733954519.027678,-21600,EB445137-D7F5-57EC-87DA-1DB460D64046,"iPhone13,2"
us.zoom.xos,292,1733954496,1733954788,1733954788.923434,-21600,,
com.google.Chrome,19,1733954477,1733954496,1733954496.1924229,-21600,,
us.zoom.xos,13,1733954464,1733954477,1733954477.506071,-21600,,
com.google.Chrome,4,1733954460,1733954464,1733954464.381744,-21600,,
us.zoom.xos,5,1733954455,1733954460,1733954460.297441,-21600,,
com.google.Chrome,6,1733954449,1733954455,1733954455.163759,-21600,,
us.zoom.xos,4,1733954445,1733954449,1733954449.450101,-21600,,
com.google.Chrome,14,1733954431,1733954445,1733954445.6575289,-21600,,
us.zoom.xos,19,1733954412,1733954431,1733954431.372364,-21600,,
com.google.Chrome,5,1733954407,1733954412,1733954412.788171,-21600,,
us.zoom.xos,7,1733954400,1733954407,1733954407.588773,-21600,,
com.google.Chrome,18,1733954382,1733954400,1733954400.259489,-21600,,
com.apple.Photos,1,1733954358,1733954359,1733954359.080668,-21600,,
com.google.Chrome,2,1733954356,1733954358,1733954358.3922958,-21600,,
com.google.ios.youtube,1781,1733952452,1733954233,1733954233.471987,-21600,EB445137-D7F5-57EC-87DA-1DB460D64046,"iPhone13,2"
com.truebill.truebillnative,7,1733952439,1733952446,1733952446.787342,-21600,EB445137-D7F5-57EC-87DA-1DB460D64046,"iPhone13,2"
com.google.Chrome,400,1733952027,1733952427,1733952427.806258,-21600,,
com.google.Chrome,416,1733951467,1733951883,1733951883.1453772,-21600,,
com.google.Chrome,532,1733950621,1733951153,1733951153.0287971,-21600,,
com.google.Chrome,306,1733950163,1733950469,1733950469.2520962,-21600,,
com.google.Chrome,304,1733949568,1733949872,1733949872.981394,-21600,,
com.google.Chrome,1788,1733947419,1733949207,1733949207.149225,-21600,,
com.leomehlig.today,1,1733947418,1733947419,1733947419.578652,-21600,,
com.microsoft.VSCode,1,1733947417,1733947418,1733947418.98042,-21600,,
com.leomehlig.today,6,1733947411,1733947417,1733947417.542427,-21600,,
com.truebill.truebillnative,14,1733947223,1733947237,1733947237.5532498,-21600,EB445137-D7F5-57EC-87DA-1DB460D64046,"iPhone13,2"
com.apple.news,196,1733946999,1733947195,1733947195.087881,-21600,EB445137-D7F5-57EC-87DA-1DB460D64046,"iPhone13,2"
com.leomehlig.today,50,1733945990,1733946040,1733946041.147501,-21600,,
com.google.Chrome,51,1733945939,1733945990,1733945990.3144011,-21600,,
com.apple.finder,226,1733945702,1733945928,1733945928.081585,-21600,,
com.microsoft.VSCode,152,1733945550,1733945702,1733945702.2744641,-21600,,
com.google.Chrome,4,1733945546,1733945550,1733945551.47922,-21600,,
com.apple.finder,22,1733945524,1733945546,1733945546.086117,-21600,,
com.google.Chrome,81,1733945443,1733945524,1733945525.0361261,-21600,,
com.microsoft.VSCode,10,1733945433,1733945443,1733945443.449561,-21600,,
com.google.Chrome,2,1733945431,1733945433,1733945433.57037,-21600,,
com.microsoft.VSCode,6,1733945425,1733945431,1733945431.455511,-21600,,
com.google.Chrome,27,1733945398,1733945425,1733945425.30905,-21600,,
com.microsoft.VSCode,14,1733945384,1733945398,1733945398.8155031,-21600,,
com.google.Chrome,24,1733945360,1733945384,1733945384.5138988,-21600,,
com.microsoft.VSCode,6,1733945354,1733945360,1733945360.65027,-21600,,
com.apple.Terminal,20,1733945334,1733945354,1733945354.256723,-21600,,
com.microsoft.VSCode,72,1733945262,1733945334,1733945334.15303,-21600,,
com.apple.Terminal,13,1733945249,1733945262,1733945262.780438,-21600,,
com.google.Chrome,17,1733945232,1733945249,1733945249.560967,-21600,,
com.microsoft.VSCode,10,1733945222,1733945232,1733945232.359837,-21600,,
com.google.Chrome,35,1733945187,1733945222,1733945222.350991,-21600,,
com.microsoft.VSCode,129,1733945058,1733945187,1733945188.035129,-21600,,
com.google.Chrome,3,1733945055,1733945058,1733945058.257142,-21600,,
com.microsoft.VSCode,98,1733944957,1733945055,1733945056.425181,-21600,,
com.google.Chrome,111,1733944846,1733944957,1733944957.779043,-21600,,
com.microsoft.VSCode,1880,1733942935,1733944815,1733944815.212081,-21600,,
com.leomehlig.today,75,1733942860,1733942935,1733942936.056435,-21600,,
com.leomehlig.today,15,1733942039,1733942054,1733942057.4403172,-21600,,
com.apple.finder,1,1733941979,1733941980,1733941980.765075,-21600,,
com.google.Chrome,5,1733941974,1733941979,1733941979.68729,-21600,,
com.leomehlig.today,0,1733941974,1733941974,1733941974.8449268,-21600,,
com.microsoft.VSCode,5,1733941969,1733941974,1733941974.158009,-21600,,
com.leomehlig.today,19,1733941950,1733941969,1733941969.173495,-21600,,
com.google.Chrome,2,1733941948,1733941950,1733941950.8058581,-21600,,
com.leomehlig.today,1,1733941947,1733941948,1733941948.415679,-21600,,
com.google.Chrome,2,1733941945,1733941947,1733941947.85387,-21600,,
com.apple.MobileSMS,2,1733941943,1733941945,1733941945.5248852,-21600,,
com.apple.iCal,3,1733941940,1733941943,1733941943.895194,-21600,,
com.apple.FaceTime,0,1733941940,1733941940,1733941941.984729,-21600,,
com.ryansponzilli.DeepSkyCatalog,101,1733941786,1733941887,1733941887.146462,-21600,EB445137-D7F5-57EC-87DA-1DB460D64046,"iPhone13,2"
com.google.chrome.ios,4,1733941779,1733941783,1733941783.648071,-21600,EB445137-D7F5-57EC-87DA-1DB460D64046,"iPhone13,2"
com.leomehlig.today,3,1733941776,1733941779,1733941779.442179,-21600,EB445137-D7F5-57EC-87DA-1DB460D64046,"iPhone13,2"
com.leomehlig.today,3,1733941757,1733941760,1733941760.521302,-21600,EB445137-D7F5-57EC-87DA-1DB460D64046,"iPhone13,2"
com.apple.iCal,190,1733941750,1733941940,1733941940.716227,-21600,,
com.google.Chrome,13,1733941737,1733941750,1733941750.536015,-21600,,
com.apple.FaceTime,118,1733941619,1733941737,1733941737.5620751,-21600,,
com.apple.iCal,96,1733941523,1733941619,1733941619.055953,-21600,,
com.apple.FaceTime,3,1733941520,1733941523,1733941523.670763,-21600,,
com.apple.iCal,3,1733941517,1733941520,1733941520.7671208,-21600,,
com.apple.weather,25,1733941492,1733941517,1733941517.818606,-21600,,
com.apple.iCal,536,1733940956,1733941492,1733941492.895191,-21600,,
com.apple.MobileSMS,2,1733940954,1733940956,1733940956.202695,-21600,,
com.apple.MobileSMS,301,1733940535,1733940836,1733940836.2960548,-21600,,
com.apple.FaceTime,2,1733940533,1733940535,1733940535.6795921,-21600,,
com.apple.MobileSMS,13,1733940520,1733940533,1733940533.0986261,-21600,,
com.leomehlig.today,11,1733940509,1733940520,1733940520.590135,-21600,,
com.apple.MobileSMS,42,1733940467,1733940509,1733940509.1404161,-21600,,
com.leomehlig.today,57,1733940410,1733940467,1733940467.2673311,-21600,,
com.microsoft.VSCode,4,1733940406,1733940410,1733940410.367403,-21600,,
com.leomehlig.today,0,1733940406,1733940406,1733940406.38399,-21600,,
com.microsoft.VSCode,1,1733940405,1733940406,1733940406.30364,-21600,,
com.leomehlig.today,69,1733940397,1733940466,1733940467.3283849,-21600,EB445137-D7F5-57EC-87DA-1DB460D64046,"iPhone13,2"
com.leomehlig.today,14,1733940391,1733940405,1733940405.383764,-21600,,
com.microsoft.VSCode,1,1733940390,1733940391,1733940391.4869208,-21600,,
com.leomehlig.today,8,1733940382,1733940390,1733940390.220983,-21600,,
com.microsoft.VSCode,141,1733940241,1733940382,1733940382.349997,-21600,,
com.truebill.truebillnative,40,1733939969,1733940009,1733940009.256989,-21600,EB445137-D7F5-57EC-87DA-1DB460D64046,"iPhone13,2"
com.apple.findmy,13,1733939941,1733939954,1733939954.669539,-21600,EB445137-D7F5-57EC-87DA-1DB460D64046,"iPhone13,2"
com.apple.news,2,1733939939,1733939941,1733939941.376365,-21600,EB445137-D7F5-57EC-87DA-1DB460D64046,"iPhone13,2"
com.microsoft.VSCode,462,1733939759,1733940221,1733940221.960763,-21600,,
com.google.Chrome,5,1733939754,1733939759,1733939759.5615,-21600,,
com.microsoft.VSCode,1023,1733938731,1733939754,1733939754.156812,-21600,,
com.apple.news,34,1733938255,1733938289,1733938290.288317,-21600,EB445137-D7F5-57EC-87DA-1DB460D64046,"iPhone13,2"
com.apple.news,3,1733938246,1733938249,1733938249.8525848,-21600,EB445137-D7F5-57EC-87DA-1DB460D64046,"iPhone13,2"
com.google.Chrome,539,1733938192,1733938731,1733938731.116225,-21600,,
com.google.Chrome,352,1733937677,1733938029,1733938029.516533,-21600,,
com.microsoft.VSCode,75,1733937602,1733937677,1733937677.053169,-21600,,
com.leomehlig.today,14,1733937588,1733937602,1733937602.419519,-21600,,
com.google.Chrome,39,1733937549,1733937588,1733937588.219078,-21600,,
com.apple.news,38,1733937301,1733937339,1733937340.274477,-21600,EB445137-D7F5-57EC-87DA-1DB460D64046,"iPhone13,2"
com.tinyspeck.chatlyio,16,1733937273,1733937289,1733937289.502238,-21600,EB445137-D7F5-57EC-87DA-1DB460D64046,"iPhone13,2"
com.microsoft.Office.Outlook,12,1733937237,1733937249,1733937250.0782208,-21600,EB445137-D7F5-57EC-87DA-1DB460D64046,"iPhone13,2"
com.google.Gmail,12,1733937220,1733937232,1733937232.598376,-21600,EB445137-D7F5-57EC-87DA-1DB460D64046,"iPhone13,2"
com.apple.weather,6,1733937214,1733937220,1733937221.3259258,-21600,EB445137-D7F5-57EC-87DA-1DB460D64046,"iPhone13,2"
com.apple.weather,4,1733936821,1733936825,1733936825.482469,-21600,EB445137-D7F5-57EC-87DA-1DB460D64046,"iPhone13,2"
com.google.Chrome,57,1733932819,1733932876,1733932876.855211,-21600,,
com.apple.finder,3,1733932816,1733932819,1733932819.6621308,-21600,,
com.apple.camera,1,1733932735,1733932736,1733932737.050998,-21600,EB445137-D7F5-57EC-87DA-1DB460D64046,"iPhone13,2"
com.apple.weather,10,1733932729,1733932739,1733932739.844267,-21600,EB445137-D7F5-57EC-87DA-1DB460D64046,"iPhone13,2"
com.apple.weather,10,1733931426,1733931436,1733931436.122198,-21600,EB445137-D7F5-57EC-87DA-1DB460D64046,"iPhone13,2"
com.apple.weather,8,1733930786,1733930794,1733930794.95159,-21600,EB445137-D7F5-57EC-87DA-1DB460D64046,"iPhone13,2"
com.renpho.health,4,1733930781,1733930785,1733930786.0666971,-21600,EB445137-D7F5-57EC-87DA-1DB460D64046,"iPhone13,2"
com.renpho.health,18,1733930739,1733930757,1733930758.417025,-21600,EB445137-D7F5-57EC-87DA-1DB460D64046,"iPhone13,2"
com.google.chrome.ios,27,1733929732,1733929759,1733929760.118891,-21600,EB445137-D7F5-57EC-87DA-1DB460D64046,"iPhone13,2"
com.google.chrome.ios,15,1733929413,1733929428,1733929428.372138,-21600,EB445137-D7F5-57EC-87DA-1DB460D64046,"iPhone13,2"
com.google.chrome.ios,10,1733929111,1733929121,1733929121.362824,-21600,EB445137-D7F5-57EC-87DA-1DB460D64046,"iPhone13,2"
com.google.chrome.ios,19,1733928864,1733928883,1733928883.032117,-21600,EB445137-D7F5-57EC-87DA-1DB460D64046,"iPhone13,2"
com.google.chrome.ios,33,1733928301,1733928334,1733928334.24047,-21600,EB445137-D7F5-57EC-87DA-1DB460D64046,"iPhone13,2"
com.apple.finder,3,1733899843,1733899846,1733899847.098397,-21600,,
com.apple.Music,531,1733899312,1733899843,1733899843.780478,-21600,,
com.apple.Music,347,1733898951,1733899298,1733899298.025311,-21600,,
com.apple.Music,560,1733898335,1733898895,1733898895.030432,-21600,,
com.google.chrome.ios,10,1733897684,1733897694,1733897694.5679588,-21600,EB445137-D7F5-57EC-87DA-1DB460D64046,"iPhone13,2"
com.apple.Music,585,1733897637,1733898222,1733898222.148128,-21600,,
com.apple.Photos,226,1733897411,1733897637,1733897637.762238,-21600,,
com.apple.QuickTimePlayerX,484,1733896927,1733897411,1733897411.963665,-21600,,
com.apple.QuickTimePlayerX,321,1733896600,1733896921,1733896921.170877,-21600,,
com.apple.QuickTimePlayerX,503,1733896092,1733896595,1733896595.877224,-21600,,
com.apple.Music,377,1733895715,1733896092,1733896092.321219,-21600,,
com.apple.QuickTimePlayerX,11,1733895704,1733895715,1733895715.484867,-21600,,
com.apple.finder,6,1733895698,1733895704,1733895704.786233,-21600,,
com.apple.systempreferences,24,1733895674,1733895698,1733895698.302573,-21600,,
com.apple.finder,7,1733895660,1733895667,1733895667.080009,-21600,,
com.apple.QuickTimePlayerX,3,1733895657,1733895660,1733895660.924337,-21600,,
com.apple.finder,8,1733895649,1733895657,1733895657.285571,-21600,,
com.google.Chrome,18,1733895631,1733895649,1733895649.6913738,-21600,,
com.apple.finder,12,1733895619,1733895631,1733895631.7385569,-21600,,
com.apple.MobileSMS,4,1733895615,1733895619,1733895619.533098,-21600,,
com.apple.finder,5,1733895610,1733895615,1733895615.327084,-21600,,
com.leomehlig.today,45,1733895565,1733895610,1733895610.954471,-21600,,
com.microsoft.VSCode,0,1733895565,1733895565,1733895565.977721,-21600,,
com.google.Chrome,9,1733895556,1733895565,1733895565.775074,-21600,,
com.google.Chrome,442,1733894931,1733895373,1733895373.916175,-21600,,
com.google.chrome.ios,12,1733894805,1733894817,1733894817.52255,-21600,EB445137-D7F5-57EC-87DA-1DB460D64046,"iPhone13,2"
com.google.chrome.ios,7,1733894794,1733894801,1733894802.183541,-21600,EB445137-D7F5-57EC-87DA-1DB460D64046,"iPhone13,2"
com.google.chrome.ios,92,1733888848,1733888940,1733888941.268204,-21600,EB445137-D7F5-57EC-87DA-1DB460D64046,"iPhone13,2"
com.google.chrome.ios,54,1733888752,1733888806,1733888807.031568,-21600,EB445137-D7F5-57EC-87DA-1DB460D64046,"iPhone13,2"
com.google.chrome.ios,22,1733888695,1733888717,1733888718.1209412,-21600,EB445137-D7F5-57EC-87DA-1DB460D64046,"iPhone13,2"
com.tinyspeck.chatlyio,50,1733888254,1733888304,1733888304.711283,-21600,EB445137-D7F5-57EC-87DA-1DB460D64046,"iPhone13,2"
com.tinyspeck.chatlyio,1,1733888252,1733888253,1733888253.4170752,-21600,EB445137-D7F5-57EC-87DA-1DB460D64046,"iPhone13,2"
com.tinyspeck.chatlyio,45,1733888054,1733888099,1733888099.489052,-21600,EB445137-D7F5-57EC-87DA-1DB460D64046,"iPhone13,2"
com.toyopagroup.picaboo,3,1733887494,1733887497,1733887497.4722219,-21600,EB445137-D7F5-57EC-87DA-1DB460D64046,"iPhone13,2"
com.tinyspeck.chatlyio,134,1733887354,1733887488,1733887488.833363,-21600,EB445137-D7F5-57EC-87DA-1DB460D64046,"iPhone13,2"
com.apple.MobileSMS,39,1733886051,1733886090,1733886090.811812,-21600,EB445137-D7F5-57EC-87DA-1DB460D64046,"iPhone13,2"
com.instructure.icanvas,8,1733886043,1733886051,1733886051.243236,-21600,EB445137-D7F5-57EC-87DA-1DB460D64046,"iPhone13,2"
com.google.Chrome,681,1733883337,1733884018,1733884018.796843,-21600,,
com.apple.MobileSMS,42,1733883295,1733883337,1733883337.440949,-21600,,
com.apple.FaceTime,41,1733883254,1733883295,1733883295.638256,-21600,,
com.apple.FaceTime,404,1733882822,1733883226,1733883226.093745,-21600,,
com.apple.MobileSMS,8,1733882814,1733882822,1733882822.934406,-21600,,
com.google.Chrome,469,1733882345,1733882814,1733882814.815568,-21600,,
com.leomehlig.today,26,1733882319,1733882345,1733882345.627156,-21600,,
com.instructure.icanvas,6,1733881927,1733881933,1733881933.171863,-21600,EB445137-D7F5-57EC-87DA-1DB460D64046,"iPhone13,2"
com.instructure.icanvas,1,1733881156,1733881157,1733881157.8028169,-21600,EB445137-D7F5-57EC-87DA-1DB460D64046,"iPhone13,2"
com.instructure.icanvas,23,1733880753,1733880776,1733880777.071698,-21600,EB445137-D7F5-57EC-87DA-1DB460D64046,"iPhone13,2"
com.google.Gmail,15,1733879188,1733879203,1733879203.384686,-21600,EB445137-D7F5-57EC-87DA-1DB460D64046,"iPhone13,2"
com.instructure.icanvas,15,1733875346,1733875361,1733875361.216792,-21600,EB445137-D7F5-57EC-87DA-1DB460D64046,"iPhone13,2"
com.apple.MobileSMS,11,1733875333,1733875344,1733875344.157291,-21600,EB445137-D7F5-57EC-87DA-1DB460D64046,"iPhone13,2"
com.leomehlig.today,318,1733875272,1733875590,1733875590.841786,-21600,,
com.google.Chrome,3,1733875269,1733875272,1733875272.731989,-21600,,
com.microsoft.VSCode,168,1733875101,1733875269,1733875269.155833,-21600,,
com.google.Chrome,2,1733875099,1733875101,1733875101.8498979,-21600,,
com.microsoft.VSCode,81,1733875018,1733875099,1733875099.835847,-21600,,
com.google.Chrome,59,1733874959,1733875018,1733875018.269247,-21600,,
com.microsoft.VSCode,3,1733874956,1733874959,1733874959.5614839,-21600,,
com.google.Chrome,12,1733874944,1733874956,1733874957.007833,-21600,,
com.microsoft.VSCode,227,1733874717,1733874944,1733874944.6490312,-21600,,
com.google.Chrome,7,1733874710,1733874717,1733874717.957058,-21600,,
com.microsoft.VSCode,5,1733874705,1733874710,1733874710.463476,-21600,,
com.google.Chrome,8,1733874697,1733874705,1733874705.7605228,-21600,,
com.microsoft.VSCode,19,1733874678,1733874697,1733874697.923077,-21600,,
com.google.Chrome,2,1733874676,1733874678,1733874678.7656689,-21600,,
com.microsoft.VSCode,6,1733874670,1733874676,1733874676.273611,-21600,,
com.google.Chrome,3,1733874667,1733874670,1733874670.269916,-21600,,
com.microsoft.VSCode,12,1733874655,1733874667,1733874667.283575,-21600,,
com.google.Chrome,3,1733874652,1733874655,1733874655.477948,-21600,,
com.microsoft.VSCode,53,1733874599,1733874652,1733874653.034737,-21600,,
com.google.Chrome,2,1733874597,1733874599,1733874599.598001,-21600,,
com.microsoft.VSCode,18,1733874579,1733874597,1733874597.0773702,-21600,,
com.google.Chrome,44,1733874535,1733874579,1733874579.8847408,-21600,,
com.microsoft.VSCode,26,1733874509,1733874535,1733874536.036247,-21600,,
com.google.Chrome,14,1733874495,1733874509,1733874509.899807,-21600,,
com.microsoft.VSCode,3,1733874492,1733874495,1733874495.685888,-21600,,
com.google.Chrome,2,1733874490,1733874492,1733874493.027601,-21600,,
com.microsoft.VSCode,1133,1733873357,1733874490,1733874490.939882,-21600,,
com.google.Chrome,73,1733873284,1733873357,1733873357.374192,-21600,,
com.microsoft.VSCode,49,1733873235,1733873284,1733873284.750589,-21600,,
com.leomehlig.today,4,1733873231,1733873235,1733873235.1938848,-21600,,
com.microsoft.VSCode,159,1733873072,1733873231,1733873231.458202,-21600,,
com.google.Chrome,1,1733873071,1733873072,1733873072.396632,-21600,,
com.microsoft.VSCode,5,1733873066,1733873071,1733873071.09167,-21600,,
com.google.Chrome,2,1733873064,1733873066,1733873066.303001,-21600,,
com.microsoft.VSCode,3,1733873061,1733873064,1733873064.9364882,-21600,,
com.google.Chrome,1,1733873060,1733873061,1733873062.0107899,-21600,,
com.microsoft.VSCode,0,1733873060,1733873060,1733873060.995129,-21600,,
com.google.Chrome,1,1733873059,1733873060,1733873060.155087,-21600,,
com.microsoft.VSCode,2,1733873057,1733873059,1733873059.224803,-21600,,
com.google.Chrome,3,1733873054,1733873057,1733873057.4963589,-21600,,
com.microsoft.VSCode,8,1733873046,1733873054,1733873055.030098,-21600,,
com.google.Chrome,49,1733872997,1733873046,1733873046.485067,-21600,,
com.microsoft.VSCode,247,1733872750,1733872997,1733872997.1548781,-21600,,
com.google.Chrome,57,1733872693,1733872750,1733872750.12812,-21600,,
com.microsoft.VSCode,1928,1733870765,1733872693,1733872693.43718,-21600,,
com.google.Chrome,34,1733870731,1733870765,1733870765.596441,-21600,,
com.microsoft.VSCode,496,1733870235,1733870731,1733870731.313067,-21600,,
us.zoom.xos,11,1733870224,1733870235,1733870236.077527,-21600,,
com.tinyspeck.chatlyio,5,1733869940,1733869945,1733869945.531435,-21600,EB445137-D7F5-57EC-87DA-1DB460D64046,"iPhone13,2"
com.robinhood.release.Robinhood,43,1733869884,1733869927,1733869927.669697,-21600,EB445137-D7F5-57EC-87DA-1DB460D64046,"iPhone13,2"
com.apple.MobileAddressBook,135,1733869710,1733869845,1733869845.441091,-21600,EB445137-D7F5-57EC-87DA-1DB460D64046,"iPhone13,2"
com.apple.Preferences,1,1733869707,1733869708,1733869708.176021,-21600,EB445137-D7F5-57EC-87DA-1DB460D64046,"iPhone13,2"
com.apple.MobileSMS,151,1733869550,1733869701,1733869701.634383,-21600,EB445137-D7F5-57EC-87DA-1DB460D64046,"iPhone13,2"
com.instructure.icanvas,4,1733869539,1733869543,1733869543.190032,-21600,EB445137-D7F5-57EC-87DA-1DB460D64046,"iPhone13,2"
us.zoom.xos,302,1733869499,1733869801,1733869801.131953,-21600,,
com.leomehlig.today,20,1733869479,1733869499,1733869499.240299,-21600,,
com.apple.iCal,11,1733869468,1733869479,1733869479.959281,-21600,,
com.leomehlig.today,3,1733869465,1733869468,1733869468.5942678,-21600,,
us.zoom.xos,151,1733869314,1733869465,1733869465.3567882,-21600,,
com.apple.news,163,1733869151,1733869314,1733869314.51649,-21600,,
us.zoom.xos,4,1733869147,1733869151,1733869151.912909,-21600,,
com.apple.news,1211,1733867936,1733869147,1733869147.8742929,-21600,,
us.zoom.xos,42,1733867894,1733867936,1733867936.816824,-21600,,
com.google.Chrome,73,1733867821,1733867894,1733867894.1162891,-21600,,
us.zoom.xos,4,1733867817,1733867821,1733867821.573478,-21600,,
com.google.Chrome,10,1733867807,1733867817,1733867817.561089,-21600,,
us.zoom.xos,9,1733867798,1733867807,1733867807.936876,-21600,,
com.google.Chrome,14,1733867784,1733867798,1733867798.727608,-21600,,
us.zoom.xos,10,1733867774,1733867784,1733867784.233585,-21600,,
com.google.Chrome,19,1733867755,1733867774,1733867774.704064,-21600,,
us.zoom.xos,6,1733867749,1733867755,1733867755.067463,-21600,,
com.google.Chrome,11,1733867738,1733867749,1733867749.629751,-21600,,
us.zoom.xos,35,1733867703,1733867738,1733867738.719462,-21600,,
com.google.Chrome,21,1733867682,1733867703,1733867703.282892,-21600,,
us.zoom.xos,147,1733867535,1733867682,1733867682.388544,-21600,,
com.apple.news,434,1733867101,1733867535,1733867535.1058369,-21600,,
com.leomehlig.today,54,1733867047,1733867101,1733867101.440512,-21600,,
us.zoom.xos,26,1733867021,1733867047,1733867047.328082,-21600,,
com.apple.news,262,1733866759,1733867021,1733867021.16541,-21600,,
com.apple.MobileSMS,38,1733866510,1733866548,1733866548.110399,-21600,EB445137-D7F5-57EC-87DA-1DB460D64046,"iPhone13,2"
us.zoom.xos,265,1733866494,1733866759,1733866759.533031,-21600,,
com.google.Chrome,25,1733866469,1733866494,1733866494.8231292,-21600,,
us.zoom.xos,26,1733866443,1733866469,1733866469.561595,-21600,,
com.google.Chrome,62,1733866381,1733866443,1733866443.530418,-21600,,
com.microsoft.Outlook,12,1733866363,1733866375,1733866375.522913,-21600,,
com.google.Chrome,15,1733866348,1733866363,1733866364.1014528,-21600,,
us.zoom.xos,16,1733866332,1733866348,1733866348.785791,-21600,,
com.google.Chrome,5,1733866327,1733866332,1733866332.414157,-21600,,
us.zoom.xos,4,1733866323,1733866327,1733866327.8138828,-21600,,
com.google.Chrome,47,1733866276,1733866323,1733866323.713409,-21600,,
us.zoom.xos,1,1733866275,1733866276,1733866276.388764,-21600,,
com.google.Chrome,1,1733866274,1733866275,1733866275.3252711,-21600,,
us.zoom.xos,0,1733866274,1733866274,1733866274.498349,-21600,,
com.google.Chrome,5,1733866269,1733866274,1733866274.425479,-21600,,
us.zoom.xos,1,1733866268,1733866269,1733866269.9676142,-21600,,
com.google.Chrome,3,1733866265,1733866268,1733866268.91742,-21600,,
us.zoom.xos,21,1733866244,1733866265,1733866265.5789862,-21600,,
com.google.Chrome,13,1733866231,1733866244,1733866244.308622,-21600,,
com.apple.MobileSMS,15,1733864743,1733864758,1733864759.1216311,-21600,EB445137-D7F5-57EC-87DA-1DB460D64046,"iPhone13,2"
com.google.chrome.ios,17,1733864726,1733864743,1733864743.276273,-21600,EB445137-D7F5-57EC-87DA-1DB460D64046,"iPhone13,2"
com.apple.MobileSMS,24,1733864702,1733864726,1733864726.267178,-21600,EB445137-D7F5-57EC-87DA-1DB460D64046,"iPhone13,2"
com.instructure.icanvas,100,1733864573,1733864673,1733864673.987194,-21600,EB445137-D7F5-57EC-87DA-1DB460D64046,"iPhone13,2"
com.apple.MobileSMS,2,1733864272,1733864274,1733864274.7750769,-21600,EB445137-D7F5-57EC-87DA-1DB460D64046,"iPhone13,2"
com.apple.MobileSMS,13,1733864222,1733864235,1733864236.836114,-21600,EB445137-D7F5-57EC-87DA-1DB460D64046,"iPhone13,2"
com.apple.news,86,1733864136,1733864222,1733864222.6484408,-21600,EB445137-D7F5-57EC-87DA-1DB460D64046,"iPhone13,2"
com.apple.news,22,1733863543,1733863565,1733863565.805537,-21600,EB445137-D7F5-57EC-87DA-1DB460D64046,"iPhone13,2"
com.hammerandchisel.discord,24,1733863510,1733863534,1733863534.119279,-21600,EB445137-D7F5-57EC-87DA-1DB460D64046,"iPhone13,2"
com.google.chrome.ios,11,1733863496,1733863507,1733863507.5785232,-21600,EB445137-D7F5-57EC-87DA-1DB460D64046,"iPhone13,2"
com.google.chrome.ios,3,1733863228,1733863231,1733863231.989917,-21600,EB445137-D7F5-57EC-87DA-1DB460D64046,"iPhone13,2"
com.google.chrome.ios,29,1733862978,1733863007,1733863008.153938,-21600,EB445137-D7F5-57EC-87DA-1DB460D64046,"iPhone13,2"
com.apple.news,2,1733862976,1733862978,1733862978.8275461,-21600,EB445137-D7F5-57EC-87DA-1DB460D64046,"iPhone13,2"
com.apple.news,75,1733862743,1733862818,1733862818.823822,-21600,EB445137-D7F5-57EC-87DA-1DB460D64046,"iPhone13,2"
com.apple.news,55,1733862192,1733862247,1733862247.8215199,-21600,EB445137-D7F5-57EC-87DA-1DB460D64046,"iPhone13,2"
com.apple.news,41,1733861720,1733861761,1733861761.753598,-21600,EB445137-D7F5-57EC-87DA-1DB460D64046,"iPhone13,2"
com.google.Chrome,232,1733861114,1733861346,1733861346.067528,-21600,,
com.leomehlig.today,39,1733861075,1733861114,1733861114.660308,-21600,,
com.microsoft.VSCode,48,1733861027,1733861075,1733861075.628327,-21600,,
com.leomehlig.today,8,1733861019,1733861027,1733861028.0419521,-21600,,
com.apple.Passwords,2,1733861017,1733861019,1733861020.049954,-21600,,
com.leomehlig.today,14,1733861003,1733861017,1733861017.8718848,-21600,,
com.google.Chrome,1908,1733859095,1733861003,1733861004.0933108,-21600,,
com.apple.news,6,1733859028,1733859034,1733859034.845983,-21600,EB445137-D7F5-57EC-87DA-1DB460D64046,"iPhone13,2"
com.apple.news,2,1733859025,1733859027,1733859027.557023,-21600,EB445137-D7F5-57EC-87DA-1DB460D64046,"iPhone13,2"
com.leomehlig.today,68,1733859014,1733859082,1733859083.7949119,-21600,,
com.google.Chrome,75,1733858939,1733859014,1733859014.931912,-21600,,
com.leomehlig.today,14,1733858917,1733858931,1733858931.1967301,-21600,,
com.google.Chrome,721,1733858196,1733858917,1733858917.241806,-21600,,
com.leomehlig.today,23,1733858173,1733858196,1733858196.070874,-21600,,
com.google.Chrome,44,1733858129,1733858173,1733858173.0893888,-21600,,
com.apple.Passwords,7,1733858122,1733858129,1733858129.286092,-21600,,
com.google.Chrome,29,1733858093,1733858122,1733858122.8908172,-21600,,
com.leomehlig.today,91,1733858002,1733858093,1733858094.817596,-21600,,
com.apple.news,97,1733856945,1733857042,1733857043.035396,-21600,EB445137-D7F5-57EC-87DA-1DB460D64046,"iPhone13,2"
com.instructure.icanvas,4,1733856941,1733856945,1733856945.474761,-21600,EB445137-D7F5-57EC-87DA-1DB460D64046,"iPhone13,2"
com.apple.news,3,1733856938,1733856941,1733856941.913652,-21600,EB445137-D7F5-57EC-87DA-1DB460D64046,"iPhone13,2"
com.apple.news,162,1733856605,1733856767,1733856768.692821,-21600,EB445137-D7F5-57EC-87DA-1DB460D64046,"iPhone13,2"
com.apple.news,125,1733856428,1733856553,1733856553.751632,-21600,EB445137-D7F5-57EC-87DA-1DB460D64046,"iPhone13,2"
com.burbn.instagram,111,1733856053,1733856164,1733856164.4497209,-21600,EB445137-D7F5-57EC-87DA-1DB460D64046,"iPhone13,2"
com.microsoft.Office.Outlook,67,1733855890,1733855957,1733855957.041579,-21600,EB445137-D7F5-57EC-87DA-1DB460D64046,"iPhone13,2"
com.instructure.icanvas,102,1733855712,1733855814,1733855814.534296,-21600,EB445137-D7F5-57EC-87DA-1DB460D64046,"iPhone13,2"
com.apple.Health,1,1733855085,1733855086,1733855086.7174249,-21600,EB445137-D7F5-57EC-87DA-1DB460D64046,"iPhone13,2"
com.apple.Health,8,1733854858,1733854866,1733854866.961267,-21600,EB445137-D7F5-57EC-87DA-1DB460D64046,"iPhone13,2"
com.apple.Health,7,1733854723,1733854730,1733854731.343473,-21600,EB445137-D7F5-57EC-87DA-1DB460D64046,"iPhone13,2"
com.apple.Health,5,1733854717,1733854722,1733854722.482256,-21600,EB445137-D7F5-57EC-87DA-1DB460D64046,"iPhone13,2"
com.apple.Health,6,1733853009,1733853015,1733853015.205536,-21600,EB445137-D7F5-57EC-87DA-1DB460D64046,"iPhone13,2"
com.apple.Health,16,1733852992,1733853008,1733853010.020556,-21600,EB445137-D7F5-57EC-87DA-1DB460D64046,"iPhone13,2"
com.apple.MobileSMS,6,1733852986,1733852992,1733852993.313663,-21600,EB445137-D7F5-57EC-87DA-1DB460D64046,"iPhone13,2"
com.leomehlig.today,37,1733852947,1733852984,1733852984.404985,-21600,,
com.google.Chrome,3,1733852944,1733852947,1733852947.46141,-21600,,
com.leomehlig.today,1,1733852943,1733852944,1733852944.246151,-21600,,
com.google.Chrome,1,1733852942,1733852943,1733852943.112921,-21600,,
com.microsoft.VSCode,20,1733852922,1733852942,1733852942.173012,-21600,,
com.google.Chrome,25,1733852897,1733852922,1733852922.100013,-21600,,
com.microsoft.VSCode,733,1733852164,1733852897,1733852897.122359,-21600,,
com.google.Chrome,12,1733852152,1733852164,1733852164.755667,-21600,,
com.microsoft.VSCode,88,1733852064,1733852152,1733852153.014143,-21600,,
com.google.Chrome,11,1733852053,1733852064,1733852064.1620312,-21600,,
com.microsoft.VSCode,17,1733852036,1733852053,1733852053.4429832,-21600,,
com.google.Chrome,87,1733851949,1733852036,1733852036.1874409,-21600,,
com.microsoft.VSCode,29,1733851920,1733851949,1733851949.574188,-21600,,
com.google.Chrome,22,1733851898,1733851920,1733851920.239577,-21600,,
com.microsoft.VSCode,2,1733851896,1733851898,1733851898.525903,-21600,,
com.google.Chrome,2,1733851894,1733851896,1733851896.397078,-21600,,
com.microsoft.VSCode,1,1733851893,1733851894,1733851894.459878,-21600,,
com.apple.news,1,1733851892,1733851893,1733851893.422571,-21600,,
com.microsoft.VSCode,19,1733851873,1733851892,1733851892.1732311,-21600,,
com.apple.news,144,1733851729,1733851873,1733851873.2670379,-21600,,
com.microsoft.VSCode,63,1733851666,1733851729,1733851729.8361201,-21600,,
com.google.Chrome,101,1733851565,1733851666,1733851666.649199,-21600,,
com.microsoft.VSCode,96,1733851469,1733851565,1733851565.692909,-21600,,
com.google.Chrome,4,1733851465,1733851469,1733851469.402355,-21600,,
com.microsoft.VSCode,10,1733851455,1733851465,1733851465.172884,-21600,,
com.google.Chrome,61,1733851394,1733851455,1733851455.6330519,-21600,,
com.microsoft.VSCode,1052,1733850342,1733851394,1733851394.8818622,-21600,,
com.apple.finder,8,1733850334,1733850342,1733850342.5222921,-21600,,
com.apple.MobileSMS,2,1733850317,1733850319,1733850319.4795241,-21600,EB445137-D7F5-57EC-87DA-1DB460D64046,"iPhone13,2"
com.apple.findmy,14,1733850215,1733850229,1733850229.7405438,-21600,EB445137-D7F5-57EC-87DA-1DB460D64046,"iPhone13,2"
com.apple.MobileSMS,25,1733850189,1733850214,1733850215.068691,-21600,EB445137-D7F5-57EC-87DA-1DB460D64046,"iPhone13,2"
com.microsoft.Office.Outlook,2,1733850187,1733850189,1733850189.371101,-21600,EB445137-D7F5-57EC-87DA-1DB460D64046,"iPhone13,2"
com.microsoft.Office.Outlook,11,1733850176,1733850187,1733850187.682157,-21600,EB445137-D7F5-57EC-87DA-1DB460D64046,"iPhone13,2"
com.apple.weather,4,1733850171,1733850175,1733850175.5878701,-21600,EB445137-D7F5-57EC-87DA-1DB460D64046,"iPhone13,2"
com.apple.weather,10,1733850099,1733850109,1733850109.895314,-21600,EB445137-D7F5-57EC-87DA-1DB460D64046,"iPhone13,2"
com.apple.weather,2,1733850091,1733850093,1733850093.665145,-21600,EB445137-D7F5-57EC-87DA-1DB460D64046,"iPhone13,2"
com.apple.weather,5,1733849116,1733849121,1733849121.524441,-21600,EB445137-D7F5-57EC-87DA-1DB460D64046,"iPhone13,2"
com.apple.weather,11,1733848431,1733848442,1733848442.08601,-21600,EB445137-D7F5-57EC-87DA-1DB460D64046,"iPhone13,2"
com.apple.weather,17,1733848405,1733848422,1733848423.157302,-21600,EB445137-D7F5-57EC-87DA-1DB460D64046,"iPhone13,2"
com.renpho.health,4,1733848400,1733848404,1733848404.1846352,-21600,EB445137-D7F5-57EC-87DA-1DB460D64046,"iPhone13,2"
com.renpho.health,22,1733848357,1733848379,1733848379.855217,-21600,EB445137-D7F5-57EC-87DA-1DB460D64046,"iPhone13,2"
com.apple.Health,39,1733812278,1733812317,1733812317.276523,-21600,EB445137-D7F5-57EC-87DA-1DB460D64046,"iPhone13,2"
com.apple.journal,764,1733811510,1733812274,1733812274.918041,-21600,EB445137-D7F5-57EC-87DA-1DB460D64046,"iPhone13,2"
com.apple.calculator,3,1733811507,1733811510,1733811510.663344,-21600,EB445137-D7F5-57EC-87DA-1DB460D64046,"iPhone13,2"
com.apple.mobilecal,3,1733811504,1733811507,1733811507.622947,-21600,EB445137-D7F5-57EC-87DA-1DB460D64046,"iPhone13,2"
com.apple.calculator,1,1733811502,1733811503,1733811503.8880281,-21600,EB445137-D7F5-57EC-87DA-1DB460D64046,"iPhone13,2"
com.apple.journal,5,1733811493,1733811498,1733811498.8109322,-21600,EB445137-D7F5-57EC-87DA-1DB460D64046,"iPhone13,2"
com.microsoft.Office.Outlook,29,1733811464,1733811493,1733811493.462037,-21600,EB445137-D7F5-57EC-87DA-1DB460D64046,"iPhone13,2"
com.apple.journal,79,1733811381,1733811460,1733811460.878511,-21600,EB445137-D7F5-57EC-87DA-1DB460D64046,"iPhone13,2"
com.google.chrome.ios,12,1733811369,1733811381,1733811381.2618709,-21600,EB445137-D7F5-57EC-87DA-1DB460D64046,"iPhone13,2"
com.apple.camera,0,1733811338,1733811338,1733811338.390163,-21600,EB445137-D7F5-57EC-87DA-1DB460D64046,"iPhone13,2"
com.google.chrome.ios,14,1733811337,1733811351,1733811351.7838879,-21600,EB445137-D7F5-57EC-87DA-1DB460D64046,"iPhone13,2"
com.apple.finder,9,1733811151,1733811160,1733811160.3529649,-21600,,
com.microsoft.VSCode,1,1733811150,1733811151,1733811151.5964189,-21600,,
com.microsoft.Excel,0,1733811150,1733811150,1733811150.5868468,-21600,,
com.google.Chrome,432,1733810718,1733811150,1733811150.303977,-21600,,
com.google.Chrome,641,1733809810,1733810451,1733810451.634035,-21600,,
com.google.Chrome,516,1733809287,1733809803,1733809803.1976929,-21600,,
com.google.Chrome,305,1733808919,1733809224,1733809224.868964,-21600,,
com.google.Chrome,864,1733807642,1733808506,1733808506.29327,-21600,,
com.microsoft.VSCode,519,1733807123,1733807642,1733807642.813067,-21600,,
com.microsoft.Excel,20,1733807103,1733807123,1733807123.813283,-21600,,
com.leomehlig.today,6,1733807097,1733807103,1733807103.968863,-21600,,
com.microsoft.Excel,28,1733807069,1733807097,1733807097.729707,-21600,,
com.leomehlig.today,5,1733807064,1733807069,1733807069.19305,-21600,,
com.microsoft.Excel,6,1733807058,1733807064,1733807064.594368,-21600,,
com.leomehlig.today,5,1733807053,1733807058,1733807058.1718988,-21600,,
com.microsoft.Excel,16,1733807037,1733807053,1733807053.9556189,-21600,,
com.leomehlig.today,8,1733807029,1733807037,1733807037.654546,-21600,,
com.microsoft.Excel,7,1733807022,1733807029,1733807029.926563,-21600,,
com.apple.finder,63,1733806959,1733807022,1733807022.162646,-21600,,
com.leomehlig.today,1,1733806958,1733806959,1733806960.125397,-21600,,
com.google.Chrome,3,1733806955,1733806958,1733806958.334151,-21600,,
com.google.Chrome,482,1733806232,1733806714,1733806714.7145638,-21600,,
com.leomehlig.today,165,1733806067,1733806232,1733806234.4389992,-21600,,
com.apple.MobileSMS,5,1733806062,1733806067,1733806067.1278229,-21600,,
com.leomehlig.today,4,1733806058,1733806062,1733806062.9407759,-21600,,
com.google.chrome.ios,13,1733805375,1733805388,1733805388.308823,-21600,EB445137-D7F5-57EC-87DA-1DB460D64046,"iPhone13,2"
com.apple.camera,0,1733804041,1733804041,1733804041.76953,-21600,EB445137-D7F5-57EC-87DA-1DB460D64046,"iPhone13,2"
com.google.chrome.ios,4,1733804037,1733804041,1733804041.776723,-21600,EB445137-D7F5-57EC-87DA-1DB460D64046,"iPhone13,2"
com.google.chrome.ios,3,1733803742,1733803745,1733803745.269794,-21600,EB445137-D7F5-57EC-87DA-1DB460D64046,"iPhone13,2"
com.google.chrome.ios,5,1733802739,1733802744,1733802744.724866,-21600,EB445137-D7F5-57EC-87DA-1DB460D64046,"iPhone13,2"
com.google.chrome.ios,129,1733802600,1733802729,1733802729.9654732,-21600,EB445137-D7F5-57EC-87DA-1DB460D64046,"iPhone13,2"
com.apple.mobiletimer,3,1733799625,1733799628,1733799628.620315,-21600,EB445137-D7F5-57EC-87DA-1DB460D64046,"iPhone13,2"
com.apple.weather,33,1733799561,1733799594,1733799594.8430529,-21600,EB445137-D7F5-57EC-87DA-1DB460D64046,"iPhone13,2"
com.apple.mobiletimer,9,1733799552,1733799561,1733799561.7776499,-21600,EB445137-D7F5-57EC-87DA-1DB460D64046,"iPhone13,2"
com.apple.mobiletimer,8,1733799544,1733799552,1733799552.234194,-21600,EB445137-D7F5-57EC-87DA-1DB460D64046,"iPhone13,2"
com.apple.mobiletimer,6,1733799518,1733799524,1733799524.199734,-21600,EB445137-D7F5-57EC-87DA-1DB460D64046,"iPhone13,2"
com.apple.mobiletimer,8,1733799418,1733799426,1733799426.673593,-21600,EB445137-D7F5-57EC-87DA-1DB460D64046,"iPhone13,2"
com.apple.mobiletimer,3,1733799105,1733799108,1733799108.219234,-21600,EB445137-D7F5-57EC-87DA-1DB460D64046,"iPhone13,2"
com.apple.weather,3,1733799102,1733799105,1733799105.045048,-21600,EB445137-D7F5-57EC-87DA-1DB460D64046,"iPhone13,2"
com.apple.weather,6,1733799084,1733799090,1733799090.3489928,-21600,EB445137-D7F5-57EC-87DA-1DB460D64046,"iPhone13,2"
com.apple.weather,3,1733799076,1733799079,1733799079.169567,-21600,EB445137-D7F5-57EC-87DA-1DB460D64046,"iPhone13,2"
com.apple.weather,1,1733799074,1733799075,1733799075.896727,-21600,EB445137-D7F5-57EC-87DA-1DB460D64046,"iPhone13,2"
com.apple.weather,12,1733798666,1733798678,1733798679.231555,-21600,EB445137-D7F5-57EC-87DA-1DB460D64046,"iPhone13,2"
com.apple.mobiletimer,4,1733798662,1733798666,1733798666.1455731,-21600,EB445137-D7F5-57EC-87DA-1DB460D64046,"iPhone13,2"
com.apple.mobiletimer,0,1733798661,1733798661,1733798662.891077,-21600,EB445137-D7F5-57EC-87DA-1DB460D64046,"iPhone13,2"
com.apple.mobiletimer,6,1733798528,1733798534,1733798534.674325,-21600,EB445137-D7F5-57EC-87DA-1DB460D64046,"iPhone13,2"
com.tinyspeck.chatlyio,32,1733797241,1733797273,1733797273.039959,-21600,EB445137-D7F5-57EC-87DA-1DB460D64046,"iPhone13,2"
com.apple.Preferences,31,1733797209,1733797240,1733797240.90843,-21600,EB445137-D7F5-57EC-87DA-1DB460D64046,"iPhone13,2"
com.microsoft.Office.Outlook,6,1733797203,1733797209,1733797209.519269,-21600,EB445137-D7F5-57EC-87DA-1DB460D64046,"iPhone13,2"
com.apple.MobileSMS,5,1733795997,1733796002,1733796002.382979,-21600,EB445137-D7F5-57EC-87DA-1DB460D64046,"iPhone13,2"
com.apple.MobileSMS,2,1733795964,1733795966,1733795966.9885092,-21600,EB445137-D7F5-57EC-87DA-1DB460D64046,"iPhone13,2"
com.apple.MobileSMS,150,1733795694,1733795844,1733795844.167136,-21600,EB445137-D7F5-57EC-87DA-1DB460D64046,"iPhone13,2"
com.apple.MobileSMS,26,1733795635,1733795661,1733795661.8942652,-21600,EB445137-D7F5-57EC-87DA-1DB460D64046,"iPhone13,2"
com.google.chrome.ios,7,1733794688,1733794695,1733794695.076216,-21600,EB445137-D7F5-57EC-87DA-1DB460D64046,"iPhone13,2"
com.google.chrome.ios,25,1733794368,1733794393,1733794393.984649,-21600,EB445137-D7F5-57EC-87DA-1DB460D64046,"iPhone13,2"
com.google.chrome.ios,42,1733794137,1733794179,1733794179.7917628,-21600,EB445137-D7F5-57EC-87DA-1DB460D64046,"iPhone13,2"
com.apple.news,22,1733794115,1733794137,1733794137.877643,-21600,EB445137-D7F5-57EC-87DA-1DB460D64046,"iPhone13,2"
com.apple.news,49,1733793520,1733793569,1733793569.9153352,-21600,EB445137-D7F5-57EC-87DA-1DB460D64046,"iPhone13,2"
com.apple.news,21,1733793187,1733793208,1733793208.8974838,-21600,EB445137-D7F5-57EC-87DA-1DB460D64046,"iPhone13,2"
com.hammerandchisel.discord,19,1733793148,1733793167,1733793167.0757952,-21600,EB445137-D7F5-57EC-87DA-1DB460D64046,"iPhone13,2"
com.tinyspeck.chatlyio,27,1733792561,1733792588,1733792588.1333818,-21600,EB445137-D7F5-57EC-87DA-1DB460D64046,"iPhone13,2"
com.google.chrome.ios,11,1733792539,1733792550,1733792550.468976,-21600,EB445137-D7F5-57EC-87DA-1DB460D64046,"iPhone13,2"
com.google.chrome.ios,107,1733792244,1733792351,1733792352.1744661,-21600,EB445137-D7F5-57EC-87DA-1DB460D64046,"iPhone13,2"
com.apple.MobileSMS,1,1733792243,1733792244,1733792244.7394261,-21600,EB445137-D7F5-57EC-87DA-1DB460D64046,"iPhone13,2"
com.apple.MobileSMS,3,1733792240,1733792243,1733792243.382214,-21600,EB445137-D7F5-57EC-87DA-1DB460D64046,"iPhone13,2"
com.google.chrome.ios,1,1733792239,1733792240,1733792240.979106,-21600,EB445137-D7F5-57EC-87DA-1DB460D64046,"iPhone13,2"
com.apple.camera,1,1733792236,1733792237,1733792237.281273,-21600,EB445137-D7F5-57EC-87DA-1DB460D64046,"iPhone13,2"
com.apple.camera,0,1733789719,1733789719,1733789719.7172232,-21600,EB445137-D7F5-57EC-87DA-1DB460D64046,"iPhone13,2"
com.apple.camera,2,1733789606,1733789608,1733789608.049299,-21600,EB445137-D7F5-57EC-87DA-1DB460D64046,"iPhone13,2"
com.apple.camera,0,1733789604,1733789604,1733789604.564158,-21600,EB445137-D7F5-57EC-87DA-1DB460D64046,"iPhone13,2"
com.apple.camera,1,1733789601,1733789602,1733789602.9812531,-21600,EB445137-D7F5-57EC-87DA-1DB460D64046,"iPhone13,2"
com.apple.camera,1,1733789266,1733789267,1733789267.73623,-21600,EB445137-D7F5-57EC-87DA-1DB460D64046,"iPhone13,2"
com.instructure.icanvas,22,1733789252,1733789274,1733789274.0149221,-21600,EB445137-D7F5-57EC-87DA-1DB460D64046,"iPhone13,2"
com.apple.mobiletimer,9,1733789243,1733789252,1733789252.88173,-21600,EB445137-D7F5-57EC-87DA-1DB460D64046,"iPhone13,2"
com.apple.mobiletimer,4,1733789057,1733789061,1733789061.581516,-21600,EB445137-D7F5-57EC-87DA-1DB460D64046,"iPhone13,2"
com.google.chrome.ios,2,1733789028,1733789030,1733789030.760676,-21600,EB445137-D7F5-57EC-87DA-1DB460D64046,"iPhone13,2"
com.google.chrome.ios,74,1733788321,1733788395,1733788396.196677,-21600,EB445137-D7F5-57EC-87DA-1DB460D64046,"iPhone13,2"
com.apple.Music,1,1733788320,1733788321,1733788321.5887551,-21600,EB445137-D7F5-57EC-87DA-1DB460D64046,"iPhone13,2"
com.leomehlig.today,3,1733788248,1733788251,1733788251.830855,-21600,,
com.microsoft.VSCode,2,1733788246,1733788248,1733788248.16763,-21600,,
com.leomehlig.today,3,1733788243,1733788246,1733788246.93114,-21600,,
com.microsoft.Outlook,3,1733788232,1733788235,1733788235.398522,-21600,,
com.leomehlig.today,65,1733788167,1733788232,1733788232.847234,-21600,,
com.apple.Music,7,1733787611,1733787618,1733787618.926165,-21600,EB445137-D7F5-57EC-87DA-1DB460D64046,"iPhone13,2"
com.apple.Music,2,1733787603,1733787605,1733787606.021548,-21600,EB445137-D7F5-57EC-87DA-1DB460D64046,"iPhone13,2"
com.apple.Music,2,1733787599,1733787601,1733787601.175477,-21600,EB445137-D7F5-57EC-87DA-1DB460D64046,"iPhone13,2"
com.apple.Music,29,1733786596,1733786625,1733786625.706568,-21600,EB445137-D7F5-57EC-87DA-1DB460D64046,"iPhone13,2"
com.apple.news,37,1733786246,1733786283,1733786283.57624,-21600,EB445137-D7F5-57EC-87DA-1DB460D64046,"iPhone13,2"
com.microsoft.Office.Outlook,13,1733786230,1733786243,1733786244.029609,-21600,EB445137-D7F5-57EC-87DA-1DB460D64046,"iPhone13,2"
com.toyopagroup.picaboo,8,1733786220,1733786228,1733786228.869728,-21600,EB445137-D7F5-57EC-87DA-1DB460D64046,"iPhone13,2"
com.toyopagroup.picaboo,13,1733786024,1733786037,1733786037.109045,-21600,EB445137-D7F5-57EC-87DA-1DB460D64046,"iPhone13,2"
com.intsig.CamScannerLite,42,1733785981,1733786023,1733786023.167392,-21600,EB445137-D7F5-57EC-87DA-1DB460D64046,"iPhone13,2"
com.microsoft.Office.Outlook,8,1733785969,1733785977,1733785977.584594,-21600,EB445137-D7F5-57EC-87DA-1DB460D64046,"iPhone13,2"
com.leomehlig.today,55,1733785925,1733785980,1733785980.765907,-21600,,
com.google.Chrome,1172,1733784753,1733785925,1733785925.715397,-21600,,
com.leomehlig.today,1,1733784752,1733784753,1733784753.432656,-21600,,
com.google.Chrome,291,1733784461,1733784752,1733784752.736805,-21600,,
com.leomehlig.today,2,1733784449,1733784451,1733784451.3500519,-21600,,
com.tinyspeck.chatlyio,0,1733784294,1733784294,1733784294.428807,-21600,EB445137-D7F5-57EC-87DA-1DB460D64046,"iPhone13,2"
com.leomehlig.today,34,1733784246,1733784280,1733784280.100553,-21600,,
com.tinyspeck.chatlyio,13,1733784185,1733784198,1733784199.0536752,-21600,EB445137-D7F5-57EC-87DA-1DB460D64046,"iPhone13,2"
com.microsoft.Office.Outlook,6,1733784177,1733784183,1733784183.620044,-21600,EB445137-D7F5-57EC-87DA-1DB460D64046,"iPhone13,2"
com.toyopagroup.picaboo,8,1733784169,1733784177,1733784177.7462258,-21600,EB445137-D7F5-57EC-87DA-1DB460D64046,"iPhone13,2"
com.microsoft.VSCode,694,1733783552,1733784246,1733784246.594994,-21600,,
com.google.Chrome,16,1733783536,1733783552,1733783552.198168,-21600,,
com.microsoft.VSCode,393,1733783143,1733783536,1733783536.365045,-21600,,
com.google.Chrome,10,1733783133,1733783143,1733783143.080055,-21600,,
com.microsoft.VSCode,19,1733783114,1733783133,1733783133.360682,-21600,,
com.google.Chrome,62,1733783052,1733783114,1733783114.487879,-21600,,
com.microsoft.VSCode,32,1733783020,1733783052,1733783052.244215,-21600,,
com.google.Chrome,13,1733783007,1733783020,1733783020.202783,-21600,,
com.microsoft.VSCode,41,1733782966,1733783007,1733783007.139065,-21600,,
com.google.Chrome,93,1733782873,1733782966,1733782966.575414,-21600,,
com.microsoft.VSCode,1,1733782872,1733782873,1733782873.527318,-21600,,
com.google.Chrome,2,1733782870,1733782872,1733782872.131109,-21600,,
com.microsoft.VSCode,1,1733782869,1733782870,1733782870.535993,-21600,,
com.google.Chrome,11,1733782858,1733782869,1733782869.6667519,-21600,,
com.microsoft.VSCode,183,1733782675,1733782858,1733782858.5382252,-21600,,
com.google.Chrome,7,1733782668,1733782675,1733782675.4592772,-21600,,
com.microsoft.VSCode,12,1733782656,1733782668,1733782668.820277,-21600,,
com.google.Chrome,6,1733782650,1733782656,1733782656.196482,-21600,,
com.microsoft.VSCode,3,1733782647,1733782650,1733782650.206331,-21600,,
com.google.Chrome,14,1733782633,1733782647,1733782647.391355,-21600,,
com.microsoft.VSCode,3,1733782630,1733782633,1733782633.388898,-21600,,
com.google.Chrome,1,1733782629,1733782630,1733782630.147212,-21600,,
com.microsoft.VSCode,17,1733782612,1733782629,1733782629.102281,-21600,,
com.google.Chrome,12,1733782600,1733782612,1733782612.3575091,-21600,,
com.microsoft.VSCode,1,1733782599,1733782600,1733782600.1859798,-21600,,
com.google.Chrome,1,1733782598,1733782599,1733782599.836232,-21600,,
com.leomehlig.today,0,1733782598,1733782598,1733782598.8648582,-21600,,
com.microsoft.VSCode,1,1733782597,1733782598,1733782598.144813,-21600,,
com.leomehlig.today,1,1733782596,1733782597,1733782597.458959,-21600,,
com.microsoft.VSCode,11,1733782585,1733782596,1733782596.4489279,-21600,,
com.leomehlig.today,1,1733782584,1733782585,1733782585.3169498,-21600,,
com.google.Chrome,16,1733782568,1733782584,1733782584.548903,-21600,,
com.leomehlig.today,0,1733782568,1733782568,1733782569.024681,-21600,,
com.microsoft.VSCode,4,1733782564,1733782568,1733782568.028645,-21600,,
com.leomehlig.today,1,1733782563,1733782564,1733782564.7404861,-21600,,
com.google.Chrome,2,1733782561,1733782563,1733782563.932235,-21600,,
com.leomehlig.today,1,1733782560,1733782561,1733782561.618308,-21600,,
com.microsoft.VSCode,323,1733782237,1733782560,1733782560.947511,-21600,,
com.leomehlig.today,23,1733782214,1733782237,1733782237.363624,-21600,,
com.microsoft.VSCode,172,1733782042,1733782214,1733782214.349331,-21600,,
com.google.Chrome,1,1733782041,1733782042,1733782042.4096131,-21600,,
com.microsoft.VSCode,212,1733781829,1733782041,1733782041.5944052,-21600,,
com.google.Chrome,15,1733781814,1733781829,1733781829.460616,-21600,,
com.microsoft.VSCode,49,1733781765,1733781814,1733781814.679762,-21600,,
com.google.Chrome,10,1733781755,1733781765,1733781765.153137,-21600,,
com.microsoft.VSCode,309,1733781446,1733781755,1733781755.87797,-21600,,
com.google.Chrome,0,1733781446,1733781446,1733781446.992424,-21600,,
com.microsoft.VSCode,94,1733781352,1733781446,1733781446.611333,-21600,,
com.google.Chrome,2,1733781350,1733781352,1733781352.583253,-21600,,
com.microsoft.VSCode,6,1733781344,1733781350,1733781350.404366,-21600,,
com.google.Chrome,4,1733781340,1733781344,1733781344.473028,-21600,,
com.microsoft.VSCode,31,1733781309,1733781340,1733781340.116675,-21600,,
com.google.Chrome,3,1733781306,1733781309,1733781309.649133,-21600,,
com.microsoft.VSCode,8,1733781298,1733781306,1733781306.85658,-21600,,
com.google.Chrome,7,1733781291,1733781298,1733781298.8679729,-21600,,
com.microsoft.VSCode,12,1733781279,1733781291,1733781291.8054461,-21600,,
com.google.Chrome,6,1733781273,1733781279,1733781279.107013,-21600,,
com.microsoft.VSCode,1,1733781272,1733781273,1733781274.0106401,-21600,,
com.google.Chrome,3,1733781269,1733781272,1733781272.4063401,-21600,,
com.microsoft.VSCode,21,1733781248,1733781269,1733781269.5822,-21600,,
com.google.Chrome,1,1733781247,1733781248,1733781248.356614,-21600,,
com.microsoft.VSCode,61,1733781186,1733781247,1733781247.292901,-21600,,
com.google.Chrome,2,1733781184,1733781186,1733781186.3658252,-21600,,
com.microsoft.VSCode,4,1733781180,1733781184,1733781184.206355,-21600,,
com.google.Chrome,2,1733781178,1733781180,1733781180.646755,-21600,,
com.microsoft.VSCode,0,1733781178,1733781178,1733781178.9855242,-21600,,
com.google.Chrome,2,1733781176,1733781178,1733781178.091012,-21600,,
com.microsoft.VSCode,1,1733781175,1733781176,1733781176.853746,-21600,,
com.google.Chrome,4,1733781171,1733781175,1733781175.436238,-21600,,
com.microsoft.VSCode,3,1733781168,1733781171,1733781171.567513,-21600,,
com.google.Chrome,2,1733781166,1733781168,1733781168.846233,-21600,,
com.microsoft.VSCode,5,1733781161,1733781166,1733781166.7826672,-21600,,
com.google.Chrome,2,1733781159,1733781161,1733781161.678963,-21600,,
com.microsoft.VSCode,1,1733781158,1733781159,1733781159.368433,-21600,,
com.google.Chrome,3,1733781155,1733781158,1733781158.091778,-21600,,
com.microsoft.VSCode,1,1733781154,1733781155,1733781155.977151,-21600,,
com.google.Chrome,4,1733781150,1733781154,1733781154.237533,-21600,,
com.microsoft.VSCode,2,1733781148,1733781150,1733781150.6903028,-21600,,
com.google.Chrome,3,1733781145,1733781148,1733781148.6370292,-21600,,
com.microsoft.VSCode,1,1733781144,1733781145,1733781145.677431,-21600,,
com.google.Chrome,1,1733781143,1733781144,1733781144.497355,-21600,,
com.microsoft.VSCode,9,1733781134,1733781143,1733781143.756072,-21600,,
com.google.Chrome,9,1733781125,1733781134,1733781134.3030338,-21600,,
com.microsoft.VSCode,2,1733781123,1733781125,1733781125.076361,-21600,,
com.google.Chrome,1,1733781122,1733781123,1733781123.907624,-21600,,
com.microsoft.VSCode,4,1733781118,1733781122,1733781122.822192,-21600,,
com.google.Chrome,2,1733781116,1733781118,1733781118.581814,-21600,,
com.microsoft.VSCode,7,1733781109,1733781116,1733781116.215128,-21600,,
com.google.Chrome,1,1733781108,1733781109,1733781109.818922,-21600,,
com.microsoft.VSCode,14,1733781094,1733781108,1733781108.472399,-21600,,
com.google.Chrome,81,1733781013,1733781094,1733781094.353102,-21600,,
com.microsoft.VSCode,68,1733780934,1733781002,1733781002.331255,-21600,,
com.leomehlig.today,1,1733780933,1733780934,1733780934.1619592,-21600,,
com.microsoft.VSCode,11,1733780922,1733780933,1733780933.298149,-21600,,
com.leomehlig.today,1,1733780921,1733780922,1733780922.2667189,-21600,,
com.microsoft.VSCode,239,1733780682,1733780921,1733780921.471647,-21600,,
com.leomehlig.today,27,1733780655,1733780682,1733780682.583355,-21600,,
com.microsoft.VSCode,5,1733780650,1733780655,1733780655.899211,-21600,,
com.toyopagroup.picaboo,10,1733780633,1733780643,1733780643.8159552,-21600,EB445137-D7F5-57EC-87DA-1DB460D64046,"iPhone13,2"
com.toyopagroup.picaboo,14,1733780574,1733780588,1733780588.519378,-21600,EB445137-D7F5-57EC-87DA-1DB460D64046,"iPhone13,2"
com.google.Chrome,216,1733780434,1733780650,1733780651.057867,-21600,,
com.microsoft.VSCode,39,1733780395,1733780434,1733780434.939948,-21600,,
com.google.Chrome,1,1733780394,1733780395,1733780395.344998,-21600,,
com.toyopagroup.picaboo,6,1733780330,1733780336,1733780336.6507459,-21600,EB445137-D7F5-57EC-87DA-1DB460D64046,"iPhone13,2"
com.toyopagroup.picaboo,42,1733780246,1733780288,1733780288.8002648,-21600,EB445137-D7F5-57EC-87DA-1DB460D64046,"iPhone13,2"
com.microsoft.VSCode,192,1733780202,1733780394,1733780394.527611,-21600,,
com.google.Chrome,18,1733780184,1733780202,1733780202.6144152,-21600,,
com.microsoft.VSCode,27,1733780157,1733780184,1733780184.6038132,-21600,,
com.microsoft.Outlook,1,1733780156,1733780157,1733780157.5920892,-21600,,
com.google.Chrome,68,1733780088,1733780156,1733780156.288227,-21600,,
com.microsoft.Outlook,15,1733780073,1733780088,1733780088.70338,-21600,,
com.google.Chrome,156,1733779917,1733780073,1733780073.644144,-21600,,
com.toyopagroup.picaboo,280,1733779904,1733780184,1733780184.9705029,-21600,EB445137-D7F5-57EC-87DA-1DB460D64046,"iPhone13,2"
com.toyopagroup.picaboo,6,1733779876,1733779882,1733779882.48155,-21600,EB445137-D7F5-57EC-87DA-1DB460D64046,"iPhone13,2"
com.microsoft.VSCode,45,1733779872,1733779917,1733779918.0177011,-21600,,
com.google.Chrome,80,1733779792,1733779872,1733779872.4094071,-21600,,
com.microsoft.VSCode,239,1733779553,1733779792,1733779792.171056,-21600,,
com.google.Chrome,22,1733779531,1733779553,1733779553.600074,-21600,,
com.microsoft.VSCode,7,1733779524,1733779531,1733779531.565671,-21600,,
com.google.Chrome,15,1733779509,1733779524,1733779524.257767,-21600,,
com.microsoft.VSCode,28,1733779481,1733779509,1733779509.649718,-21600,,
com.toyopagroup.picaboo,122,1733779458,1733779580,1733779581.1711001,-21600,EB445137-D7F5-57EC-87DA-1DB460D64046,"iPhone13,2"
com.google.Chrome,34,1733779447,1733779481,1733779481.5234408,-21600,,
com.microsoft.VSCode,29,1733779418,1733779447,1733779447.395458,-21600,,
com.google.Chrome,10,1733779408,1733779418,1733779418.8294048,-21600,,
com.microsoft.VSCode,63,1733779345,1733779408,1733779408.9513578,-21600,,
com.google.Chrome,42,1733779303,1733779345,1733779345.0780869,-21600,,
com.microsoft.VSCode,2,1733779290,1733779292,1733779295.195435,-21600,,
com.google.Chrome,5,1733779285,1733779290,1733779292.442961,-21600,,
com.leomehlig.today,30,1733779255,1733779285,1733779287.588169,-21600,,
com.apple.InCallService,65,1733778789,1733778854,1733778854.606555,-21600,EB445137-D7F5-57EC-87DA-1DB460D64046,"iPhone13,2"
com.thestorygraph.thestorygraph,62,1733778727,1733778789,1733778790.069891,-21600,EB445137-D7F5-57EC-87DA-1DB460D64046,"iPhone13,2"
com.goodreads.Goodreads,7,1733778703,1733778710,1733778710.52351,-21600,EB445137-D7F5-57EC-87DA-1DB460D64046,"iPhone13,2"
com.microsoft.Office.Outlook,30,1733778673,1733778703,1733778703.938273,-21600,EB445137-D7F5-57EC-87DA-1DB460D64046,"iPhone13,2"
com.microsoft.Office.Outlook,3,1733778670,1733778673,1733778673.208877,-21600,EB445137-D7F5-57EC-87DA-1DB460D64046,"iPhone13,2"
com.goodreads.Goodreads,23,1733778643,1733778666,1733778666.6338649,-21600,EB445137-D7F5-57EC-87DA-1DB460D64046,"iPhone13,2"
com.apple.InCallService,32,1733778611,1733778643,1733778643.748402,-21600,EB445137-D7F5-57EC-87DA-1DB460D64046,"iPhone13,2"
com.goodreads.Goodreads,86,1733778525,1733778611,1733778611.907535,-21600,EB445137-D7F5-57EC-87DA-1DB460D64046,"iPhone13,2"
com.apple.MobileSMS,20,1733778502,1733778522,1733778522.632637,-21600,EB445137-D7F5-57EC-87DA-1DB460D64046,"iPhone13,2"
com.apple.mobileslideshow,7,1733778495,1733778502,1733778502.263864,-21600,EB445137-D7F5-57EC-87DA-1DB460D64046,"iPhone13,2"
com.apple.MobileSMS,55,1733778440,1733778495,1733778496.345118,-21600,EB445137-D7F5-57EC-87DA-1DB460D64046,"iPhone13,2"
com.apple.mobileslideshow,6,1733778434,1733778440,1733778440.1226258,-21600,EB445137-D7F5-57EC-87DA-1DB460D64046,"iPhone13,2"
com.apple.MobileSMS,26,1733778408,1733778434,1733778435.129225,-21600,EB445137-D7F5-57EC-87DA-1DB460D64046,"iPhone13,2"
com.apple.mobileslideshow,7,1733778401,1733778408,1733778409.118964,-21600,EB445137-D7F5-57EC-87DA-1DB460D64046,"iPhone13,2"
com.apple.MobileSMS,99,1733778302,1733778401,1733778401.6213732,-21600,EB445137-D7F5-57EC-87DA-1DB460D64046,"iPhone13,2"
com.apple.mobileslideshow,10,1733778292,1733778302,1733778302.890105,-21600,EB445137-D7F5-57EC-87DA-1DB460D64046,"iPhone13,2"
com.apple.MobileSMS,27,1733778265,1733778292,1733778292.525474,-21600,EB445137-D7F5-57EC-87DA-1DB460D64046,"iPhone13,2"
com.apple.mobileslideshow,27,1733778238,1733778265,1733778266.039351,-21600,EB445137-D7F5-57EC-87DA-1DB460D64046,"iPhone13,2"
com.apple.MobileSMS,15,1733778223,1733778238,1733778238.301077,-21600,EB445137-D7F5-57EC-87DA-1DB460D64046,"iPhone13,2"
com.apple.mobileslideshow,61,1733778162,1733778223,1733778223.605226,-21600,EB445137-D7F5-57EC-87DA-1DB460D64046,"iPhone13,2"
com.apple.InCallService,3,1733778158,1733778161,1733778161.047553,-21600,EB445137-D7F5-57EC-87DA-1DB460D64046,"iPhone13,2"
com.apple.InCallService,1,1733778045,1733778046,1733778046.102582,-21600,EB445137-D7F5-57EC-87DA-1DB460D64046,"iPhone13,2"
com.apple.InCallService,1,1733777993,1733777994,1733777994.784226,-21600,EB445137-D7F5-57EC-87DA-1DB460D64046,"iPhone13,2"
com.apple.InCallService,1,1733777957,1733777958,1733777958.306498,-21600,EB445137-D7F5-57EC-87DA-1DB460D64046,"iPhone13,2"
com.apple.InCallService,1,1733777900,1733777901,1733777901.7265182,-21600,EB445137-D7F5-57EC-87DA-1DB460D64046,"iPhone13,2"
com.apple.InCallService,1,1733777691,1733777692,1733777692.588362,-21600,EB445137-D7F5-57EC-87DA-1DB460D64046,"iPhone13,2"
com.apple.InCallService,1,1733777688,1733777689,1733777689.965685,-21600,EB445137-D7F5-57EC-87DA-1DB460D64046,"iPhone13,2"
com.apple.InCallService,2,1733777186,1733777188,1733777188.184527,-21600,EB445137-D7F5-57EC-87DA-1DB460D64046,"iPhone13,2"
com.apple.mobilephone,6,1733777180,1733777186,1733777187.391041,-21600,EB445137-D7F5-57EC-87DA-1DB460D64046,"iPhone13,2"
com.apple.findmy,9,1733777160,1733777169,1733777169.0894089,-21600,EB445137-D7F5-57EC-87DA-1DB460D64046,"iPhone13,2"
com.apple.findmy,14,1733777142,1733777156,1733777156.220448,-21600,EB445137-D7F5-57EC-87DA-1DB460D64046,"iPhone13,2"
com.toyopagroup.picaboo,4,1733777136,1733777140,1733777140.3282928,-21600,EB445137-D7F5-57EC-87DA-1DB460D64046,"iPhone13,2"
com.toyopagroup.picaboo,3,1733777112,1733777115,1733777116.70157,-21600,EB445137-D7F5-57EC-87DA-1DB460D64046,"iPhone13,2"
com.toyopagroup.picaboo,3,1733775220,1733775223,1733775224.721116,-21600,EB445137-D7F5-57EC-87DA-1DB460D64046,"iPhone13,2"
com.microsoft.Office.Outlook,4,1733775216,1733775220,1733775220.162591,-21600,EB445137-D7F5-57EC-87DA-1DB460D64046,"iPhone13,2"
com.microsoft.Office.Outlook,1,1733775122,1733775123,1733775123.9181051,-21600,EB445137-D7F5-57EC-87DA-1DB460D64046,"iPhone13,2"
com.microsoft.Office.Outlook,1,1733775115,1733775116,1733775116.550089,-21600,EB445137-D7F5-57EC-87DA-1DB460D64046,"iPhone13,2"
com.microsoft.Office.Outlook,8,1733775105,1733775113,1733775114.146514,-21600,EB445137-D7F5-57EC-87DA-1DB460D64046,"iPhone13,2"
com.google.Docs,2,1733775103,1733775105,1733775105.800469,-21600,EB445137-D7F5-57EC-87DA-1DB460D64046,"iPhone13,2"
com.apple.camera,10,1733775082,1733775092,1733775092.9232311,-21600,EB445137-D7F5-57EC-87DA-1DB460D64046,"iPhone13,2"
com.apple.camera,6,1733775074,1733775080,1733775080.43346,-21600,EB445137-D7F5-57EC-87DA-1DB460D64046,"iPhone13,2"
com.toyopagroup.picaboo,135,1733774894,1733775029,1733775030.015328,-21600,EB445137-D7F5-57EC-87DA-1DB460D64046,"iPhone13,2"
com.google.Docs,5,1733774889,1733774894,1733774895.061901,-21600,EB445137-D7F5-57EC-87DA-1DB460D64046,"iPhone13,2"
com.google.Docs,93,1733774776,1733774869,1733774869.855623,-21600,EB445137-D7F5-57EC-87DA-1DB460D64046,"iPhone13,2"
com.google.Drive,17,1733774759,1733774776,1733774776.806397,-21600,EB445137-D7F5-57EC-87DA-1DB460D64046,"iPhone13,2"
com.microsoft.Office.Outlook,59,1733774697,1733774756,1733774756.892918,-21600,EB445137-D7F5-57EC-87DA-1DB460D64046,"iPhone13,2"
com.toyopagroup.picaboo,142,1733774539,1733774681,1733774681.324976,-21600,EB445137-D7F5-57EC-87DA-1DB460D64046,"iPhone13,2"
com.apple.news,3,1733774536,1733774539,1733774541.026764,-21600,EB445137-D7F5-57EC-87DA-1DB460D64046,"iPhone13,2"
com.apple.news,1,1733773686,1733773687,1733773687.673388,-21600,EB445137-D7F5-57EC-87DA-1DB460D64046,"iPhone13,2"
com.apple.news,0,1733773464,1733773464,1733773464.962387,-21600,EB445137-D7F5-57EC-87DA-1DB460D64046,"iPhone13,2"
com.apple.news,1,1733773204,1733773205,1733773206.011872,-21600,EB445137-D7F5-57EC-87DA-1DB460D64046,"iPhone13,2"
com.apple.news,239,1733772960,1733773199,1733773199.9151511,-21600,EB445137-D7F5-57EC-87DA-1DB460D64046,"iPhone13,2"
com.google.chrome.ios,44,1733772913,1733772957,1733772957.674048,-21600,EB445137-D7F5-57EC-87DA-1DB460D64046,"iPhone13,2"
com.google.chrome.ios,1,1733772911,1733772912,1733772912.63661,-21600,EB445137-D7F5-57EC-87DA-1DB460D64046,"iPhone13,2"
com.google.chrome.ios,6,1733772874,1733772880,1733772880.210565,-21600,EB445137-D7F5-57EC-87DA-1DB460D64046,"iPhone13,2"
com.google.chrome.ios,22,1733772759,1733772781,1733772781.675735,-21600,EB445137-D7F5-57EC-87DA-1DB460D64046,"iPhone13,2"
com.google.chrome.ios,110,1733772510,1733772620,1733772620.647145,-21600,EB445137-D7F5-57EC-87DA-1DB460D64046,"iPhone13,2"
com.microsoft.Office.Outlook,18,1733772492,1733772510,1733772510.211446,-21600,EB445137-D7F5-57EC-87DA-1DB460D64046,"iPhone13,2"
com.toyopagroup.picaboo,11,1733772480,1733772491,1733772491.922008,-21600,EB445137-D7F5-57EC-87DA-1DB460D64046,"iPhone13,2"
com.apple.news,3,1733772477,1733772480,1733772480.78356,-21600,EB445137-D7F5-57EC-87DA-1DB460D64046,"iPhone13,2"
com.apple.news,48,1733772074,1733772122,1733772122.9832401,-21600,EB445137-D7F5-57EC-87DA-1DB460D64046,"iPhone13,2"
com.apple.news,186,1733771674,1733771860,1733771861.412671,-21600,EB445137-D7F5-57EC-87DA-1DB460D64046,"iPhone13,2"
com.apple.news,67,1733771535,1733771602,1733771603.025488,-21600,EB445137-D7F5-57EC-87DA-1DB460D64046,"iPhone13,2"
com.apple.news,113,1733771343,1733771456,1733771456.6737409,-21600,EB445137-D7F5-57EC-87DA-1DB460D64046,"iPhone13,2"
com.apple.news,21,1733771239,1733771260,1733771260.4791288,-21600,EB445137-D7F5-57EC-87DA-1DB460D64046,"iPhone13,2"
com.apple.news,412,1733770504,1733770916,1733770916.989231,-21600,EB445137-D7F5-57EC-87DA-1DB460D64046,"iPhone13,2"
com.apple.news,6,1733770477,1733770483,1733770483.564962,-21600,EB445137-D7F5-57EC-87DA-1DB460D64046,"iPhone13,2"
com.truebill.truebillnative,6,1733770433,1733770439,1733770439.697243,-21600,EB445137-D7F5-57EC-87DA-1DB460D64046,"iPhone13,2"
com.truebill.truebillnative,18,1733770414,1733770432,1733770432.373637,-21600,EB445137-D7F5-57EC-87DA-1DB460D64046,"iPhone13,2"
com.apple.MobileSMS,10,1733770366,1733770376,1733770376.164408,-21600,EB445137-D7F5-57EC-87DA-1DB460D64046,"iPhone13,2"
com.apple.weather,2,1733770364,1733770366,1733770366.96967,-21600,EB445137-D7F5-57EC-87DA-1DB460D64046,"iPhone13,2"
com.apple.weather,4,1733769524,1733769528,1733769528.601657,-21600,EB445137-D7F5-57EC-87DA-1DB460D64046,"iPhone13,2"
com.truebill.truebillnative,6,1733769285,1733769291,1733769291.636248,-21600,EB445137-D7F5-57EC-87DA-1DB460D64046,"iPhone13,2"
com.truebill.truebillnative,25,1733769170,1733769195,1733769196.746516,-21600,EB445137-D7F5-57EC-87DA-1DB460D64046,"iPhone13,2"
com.apple.MobileSMS,19,1733769151,1733769170,1733769170.752722,-21600,EB445137-D7F5-57EC-87DA-1DB460D64046,"iPhone13,2"
com.clairmail.fth.client,20,1733769131,1733769151,1733769151.9648929,-21600,EB445137-D7F5-57EC-87DA-1DB460D64046,"iPhone13,2"
com.truebill.truebillnative,36,1733769094,1733769130,1733769130.498012,-21600,EB445137-D7F5-57EC-87DA-1DB460D64046,"iPhone13,2"
com.apple.Health,32,1733769056,1733769088,1733769088.603527,-21600,EB445137-D7F5-57EC-87DA-1DB460D64046,"iPhone13,2"
com.apple.Health,55,1733768993,1733769048,1733769048.393466,-21600,EB445137-D7F5-57EC-87DA-1DB460D64046,"iPhone13,2"
com.microsoft.Office.Outlook,25,1733768947,1733768972,1733768972.846802,-21600,EB445137-D7F5-57EC-87DA-1DB460D64046,"iPhone13,2"
com.apple.MobileSMS,50,1733768897,1733768947,1733768947.967925,-21600,EB445137-D7F5-57EC-87DA-1DB460D64046,"iPhone13,2"
com.toyopagroup.picaboo,14,1733763272,1733763286,1733763287.364366,-21600,EB445137-D7F5-57EC-87DA-1DB460D64046,"iPhone13,2"
com.apple.weather,4,1733763268,1733763272,1733763272.945605,-21600,EB445137-D7F5-57EC-87DA-1DB460D64046,"iPhone13,2"
com.apple.weather,1,1733758341,1733758342,1733758342.3909922,-21600,EB445137-D7F5-57EC-87DA-1DB460D64046,"iPhone13,2"
com.apple.weather,2,1733758326,1733758328,1733758328.274863,-21600,EB445137-D7F5-57EC-87DA-1DB460D64046,"iPhone13,2"
com.apple.weather,5,1733758292,1733758297,1733758297.766533,-21600,EB445137-D7F5-57EC-87DA-1DB460D64046,"iPhone13,2"
com.renpho.health,2,1733758290,1733758292,1733758292.856739,-21600,EB445137-D7F5-57EC-87DA-1DB460D64046,"iPhone13,2"
com.renpho.health,89,1733758153,1733758242,1733758242.199364,-21600,EB445137-D7F5-57EC-87DA-1DB460D64046,"iPhone13,2"
com.renpho.health,61,1733758088,1733758149,1733758149.681488,-21600,EB445137-D7F5-57EC-87DA-1DB460D64046,"iPhone13,2"
com.apple.mobiletimer,9,1733758078,1733758087,1733758087.6390471,-21600,EB445137-D7F5-57EC-87DA-1DB460D64046,"iPhone13,2"
com.apple.mobiletimer,13,1733757455,1733757468,1733757468.8907409,-21600,EB445137-D7F5-57EC-87DA-1DB460D64046,"iPhone13,2"
com.apple.mobiletimer,4,1733757448,1733757452,1733757452.8354878,-21600,EB445137-D7F5-57EC-87DA-1DB460D64046,"iPhone13,2"
com.apple.mobiletimer,12,1733756981,1733756993,1733756993.999368,-21600,EB445137-D7F5-57EC-87DA-1DB460D64046,"iPhone13,2"
com.apple.mobiletimer,16,1733756607,1733756623,1733756623.86078,-21600,EB445137-D7F5-57EC-87DA-1DB460D64046,"iPhone13,2"
com.apple.mobiletimer,10,1733756444,1733756454,1733756454.112355,-21600,EB445137-D7F5-57EC-87DA-1DB460D64046,"iPhone13,2"
com.apple.mobiletimer,24,1733756053,1733756077,1733756077.08984,-21600,EB445137-D7F5-57EC-87DA-1DB460D64046,"iPhone13,2"
com.apple.mobiletimer,21,1733755501,1733755522,1733755522.9919848,-21600,EB445137-D7F5-57EC-87DA-1DB460D64046,"iPhone13,2"
com.apple.mobiletimer,13,1733723935,1733723948,1733723948.5548759,-21600,EB445137-D7F5-57EC-87DA-1DB460D64046,"iPhone13,2"
com.apple.mobiletimer,12,1733723921,1733723933,1733723933.266227,-21600,EB445137-D7F5-57EC-87DA-1DB460D64046,"iPhone13,2"
com.apple.weather,2,1733723919,1733723921,1733723921.8432322,-21600,EB445137-D7F5-57EC-87DA-1DB460D64046,"iPhone13,2"
com.apple.camera,0,1733723916,1733723916,1733723916.851657,-21600,EB445137-D7F5-57EC-87DA-1DB460D64046,"iPhone13,2"
com.apple.weather,2,1733723914,1733723916,1733723916.709029,-21600,EB445137-D7F5-57EC-87DA-1DB460D64046,"iPhone13,2"
com.leomehlig.today,26,1733723774,1733723800,1733723801.259602,-21600,,
com.google.Chrome,604,1733723170,1733723774,1733723774.201905,-21600,,
com.apple.weather,4,1733721618,1733721622,1733721622.408546,-21600,EB445137-D7F5-57EC-87DA-1DB460D64046,"iPhone13,2"
com.apple.weather,10,1733721552,1733721562,1733721562.814904,-21600,EB445137-D7F5-57EC-87DA-1DB460D64046,"iPhone13,2"
com.apple.news,0,1733721551,1733721551,1733721552.9286041,-21600,EB445137-D7F5-57EC-87DA-1DB460D64046,"iPhone13,2"
com.google.Chrome,676,1733721513,1733722189,1733722189.1467109,-21600,,
com.leomehlig.today,100,1733721413,1733721513,1733721513.84367,-21600,,
com.apple.news,13,1733720932,1733720945,1733720945.298952,-21600,EB445137-D7F5-57EC-87DA-1DB460D64046,"iPhone13,2"
com.apple.news,265,1733720515,1733720780,1733720781.221462,-21600,EB445137-D7F5-57EC-87DA-1DB460D64046,"iPhone13,2"
com.apple.news,2,1733720339,1733720341,1733720341.4709811,-21600,EB445137-D7F5-57EC-87DA-1DB460D64046,"iPhone13,2"
com.apple.news,83,1733720250,1733720333,1733720333.857199,-21600,EB445137-D7F5-57EC-87DA-1DB460D64046,"iPhone13,2"
com.apple.news,10,1733719843,1733719853,1733719854.011458,-21600,EB445137-D7F5-57EC-87DA-1DB460D64046,"iPhone13,2"
com.apple.news,94,1733719749,1733719843,1733719843.4340448,-21600,EB445137-D7F5-57EC-87DA-1DB460D64046,"iPhone13,2"
com.google.chrome.ios,74,1733719178,1733719252,1733719253.321334,-21600,EB445137-D7F5-57EC-87DA-1DB460D64046,"iPhone13,2"
com.apple.MobileSMS,6,1733719172,1733719178,1733719178.48933,-21600,EB445137-D7F5-57EC-87DA-1DB460D64046,"iPhone13,2"
com.apple.MobileSMS,5,1733713018,1733713023,1733713023.987194,-21600,EB445137-D7F5-57EC-87DA-1DB460D64046,"iPhone13,2"
com.apple.MobileSMS,23,1733712965,1733712988,1733712988.514193,-21600,EB445137-D7F5-57EC-87DA-1DB460D64046,"iPhone13,2"
com.google.chrome.ios,5,1733712960,1733712965,1733712965.4650521,-21600,EB445137-D7F5-57EC-87DA-1DB460D64046,"iPhone13,2"
com.google.chrome.ios,1,1733712606,1733712607,1733712608.0756512,-21600,EB445137-D7F5-57EC-87DA-1DB460D64046,"iPhone13,2"
com.apple.camera,1,1733712606,1733712607,1733712607.192801,-21600,EB445137-D7F5-57EC-87DA-1DB460D64046,"iPhone13,2"
com.google.chrome.ios,2,1733711978,1733711980,1733711980.190496,-21600,EB445137-D7F5-57EC-87DA-1DB460D64046,"iPhone13,2"
com.google.chrome.ios,69,1733711805,1733711874,1733711874.886363,-21600,EB445137-D7F5-57EC-87DA-1DB460D64046,"iPhone13,2"
com.toyopagroup.picaboo,13,1733711792,1733711805,1733711805.571817,-21600,EB445137-D7F5-57EC-87DA-1DB460D64046,"iPhone13,2"
com.toyopagroup.picaboo,10,1733711750,1733711760,1733711760.966442,-21600,EB445137-D7F5-57EC-87DA-1DB460D64046,"iPhone13,2"
com.toyopagroup.picaboo,38,1733709652,1733709690,1733709690.123829,-21600,EB445137-D7F5-57EC-87DA-1DB460D64046,"iPhone13,2"
com.toyopagroup.picaboo,29,1733708949,1733708978,1733708978.773793,-21600,EB445137-D7F5-57EC-87DA-1DB460D64046,"iPhone13,2"
com.apple.mobiletimer,10,1733708932,1733708942,1733708942.31149,-21600,EB445137-D7F5-57EC-87DA-1DB460D64046,"iPhone13,2"
com.apple.calculator,1,1733708928,1733708929,1733708929.197958,-21600,EB445137-D7F5-57EC-87DA-1DB460D64046,"iPhone13,2"
com.clairmail.fth.client,5,1733708923,1733708928,1733708928.174299,-21600,EB445137-D7F5-57EC-87DA-1DB460D64046,"iPhone13,2"
com.clairmail.fth.client,10,1733708733,1733708743,1733708743.223538,-21600,EB445137-D7F5-57EC-87DA-1DB460D64046,"iPhone13,2"
com.clairmail.fth.client,38,1733708694,1733708732,1733708732.810585,-21600,EB445137-D7F5-57EC-87DA-1DB460D64046,"iPhone13,2"
com.apple.MobileSMS,5,1733708686,1733708691,1733708691.955276,-21600,EB445137-D7F5-57EC-87DA-1DB460D64046,"iPhone13,2"
com.apple.MobileSMS,9,1733708662,1733708671,1733708671.6987119,-21600,EB445137-D7F5-57EC-87DA-1DB460D64046,"iPhone13,2"
com.apple.MobileSMS,142,1733708431,1733708573,1733708573.939507,-21600,EB445137-D7F5-57EC-87DA-1DB460D64046,"iPhone13,2"
com.t11.celeste,1,1733708430,1733708431,1733708431.85867,-21600,EB445137-D7F5-57EC-87DA-1DB460D64046,"iPhone13,2"
com.t11.celeste,9,1733705776,1733705785,1733705785.8589978,-21600,EB445137-D7F5-57EC-87DA-1DB460D64046,"iPhone13,2"
com.t11.celeste,5,1733702332,1733702337,1733702338.0830178,-21600,EB445137-D7F5-57EC-87DA-1DB460D64046,"iPhone13,2"
com.t11.celeste,12,1733702028,1733702040,1733702041.39305,-21600,EB445137-D7F5-57EC-87DA-1DB460D64046,"iPhone13,2"
com.apple.Maps,2,1733702004,1733702006,1733702006.3601809,-21600,EB445137-D7F5-57EC-87DA-1DB460D64046,"iPhone13,2"
com.apple.Maps,77,1733701768,1733701845,1733701845.938761,-21600,EB445137-D7F5-57EC-87DA-1DB460D64046,"iPhone13,2"
com.toyopagroup.picaboo,3,1733701765,1733701768,1733701769.2607841,-21600,EB445137-D7F5-57EC-87DA-1DB460D64046,"iPhone13,2"
com.toyopagroup.picaboo,9,1733700547,1733700556,1733700556.804487,-21600,EB445137-D7F5-57EC-87DA-1DB460D64046,"iPhone13,2"
com.toyopagroup.picaboo,6,1733700492,1733700498,1733700498.8469949,-21600,EB445137-D7F5-57EC-87DA-1DB460D64046,"iPhone13,2"
com.apple.MobileSMS,5,1733700485,1733700490,1733700490.776402,-21600,EB445137-D7F5-57EC-87DA-1DB460D64046,"iPhone13,2"
com.toyopagroup.picaboo,68,1733700417,1733700485,1733700485.262789,-21600,EB445137-D7F5-57EC-87DA-1DB460D64046,"iPhone13,2"
com.apple.MobileSMS,13,1733700397,1733700410,1733700411.0646482,-21600,EB445137-D7F5-57EC-87DA-1DB460D64046,"iPhone13,2"
com.toyopagroup.picaboo,7,1733700390,1733700397,1733700397.921492,-21600,EB445137-D7F5-57EC-87DA-1DB460D64046,"iPhone13,2"
com.apple.weather,4,1733700383,1733700387,1733700387.50595,-21600,EB445137-D7F5-57EC-87DA-1DB460D64046,"iPhone13,2"
com.apple.weather,4,1733700356,1733700360,1733700360.7492971,-21600,EB445137-D7F5-57EC-87DA-1DB460D64046,"iPhone13,2"
com.apple.weather,6,1733698759,1733698765,1733698765.5707932,-21600,EB445137-D7F5-57EC-87DA-1DB460D64046,"iPhone13,2"
com.google.ios.youtube,2,1733698757,1733698759,1733698759.4419432,-21600,EB445137-D7F5-57EC-87DA-1DB460D64046,"iPhone13,2"
com.google.ios.youtube,9,1733698539,1733698548,1733698548.912736,-21600,EB445137-D7F5-57EC-87DA-1DB460D64046,"iPhone13,2"
com.google.ios.youtube,489,1733698043,1733698532,1733698533.499898,-21600,EB445137-D7F5-57EC-87DA-1DB460D64046,"iPhone13,2"
com.leomehlig.today,23,1733697984,1733698007,1733698007.391553,-21600,,
com.apple.iCal,1,1733697983,1733697984,1733697984.761602,-21600,,
com.leomehlig.today,2,1733697981,1733697983,1733697983.645763,-21600,,
com.microsoft.VSCode,2,1733697979,1733697981,1733697981.7390308,-21600,,
com.leomehlig.today,11,1733697968,1733697979,1733697979.496214,-21600,,
com.apple.iCal,31,1733697937,1733697968,1733697968.415821,-21600,,
com.google.Chrome,121,1733697816,1733697937,1733697937.27823,-21600,,
com.apple.iCal,39,1733697777,1733697816,1733697816.248042,-21600,,
com.apple.finder,54,1733697723,1733697777,1733697777.732461,-21600,,
com.leomehlig.today,90,1733697633,1733697723,1733697724.028667,-21600,,
com.google.Chrome,82,1733697551,1733697633,1733697633.795568,-21600,,
com.microsoft.VSCode,50,1733697069,1733697119,1733697119.1595879,-21600,,
com.google.Chrome,7,1733697062,1733697069,1733697069.642846,-21600,,
com.microsoft.VSCode,61,1733697001,1733697062,1733697062.655624,-21600,,
com.google.Chrome,162,1733696839,1733697001,1733697001.544847,-21600,,
com.leomehlig.today,4,1733696835,1733696839,1733696840.545445,-21600,,
com.apple.news,768,1733695707,1733696475,1733696475.2652678,-21600,EB445137-D7F5-57EC-87DA-1DB460D64046,"iPhone13,2"
com.leomehlig.today,28,1733695467,1733695495,1733695495.6295462,-21600,,
com.google.Chrome,4,1733695463,1733695467,1733695467.907213,-21600,,
com.leomehlig.today,15,1733695448,1733695463,1733695463.2013788,-21600,,
com.toyopagroup.picaboo,54,1733695372,1733695426,1733695426.21637,-21600,EB445137-D7F5-57EC-87DA-1DB460D64046,"iPhone13,2"
com.microsoft.VSCode,95,1733695353,1733695448,1733695448.74902,-21600,,
com.leomehlig.today,53,1733695300,1733695353,1733695353.940096,-21600,,
com.microsoft.VSCode,924,1733694376,1733695300,1733695300.295877,-21600,,
com.google.Chrome,2,1733694374,1733694376,1733694376.73055,-21600,,
com.microsoft.VSCode,22,1733694352,1733694374,1733694374.3706079,-21600,,
com.google.Chrome,1,1733694351,1733694352,1733694352.1648412,-21600,,
com.microsoft.VSCode,4,1733694347,1733694351,1733694351.220366,-21600,,
com.google.Chrome,19,1733694328,1733694347,1733694347.423383,-21600,,
com.microsoft.VSCode,2,1733694326,1733694328,1733694328.108216,-21600,,
com.google.Chrome,5,1733694321,1733694326,1733694326.324263,-21600,,
com.microsoft.VSCode,51,1733694270,1733694321,1733694321.57309,-21600,,
com.google.Chrome,3,1733694267,1733694270,1733694270.786381,-21600,,
com.microsoft.VSCode,2,1733694265,1733694267,1733694267.8657231,-21600,,
com.google.Chrome,2,1733694263,1733694265,1733694265.097982,-21600,,
com.microsoft.VSCode,9,1733694254,1733694263,1733694263.769222,-21600,,
com.google.Chrome,9,1733694245,1733694254,1733694254.682461,-21600,,
com.microsoft.VSCode,16,1733694229,1733694245,1733694245.497198,-21600,,
com.google.Chrome,8,1733694221,1733694229,1733694229.778753,-21600,,
com.microsoft.VSCode,3,1733694218,1733694221,1733694221.3989959,-21600,,
com.apple.Photos,195,1733694023,1733694218,1733694218.580223,-21600,,
com.microsoft.VSCode,15,1733694008,1733694023,1733694023.092434,-21600,,
com.google.Chrome,3,1733694005,1733694008,1733694009.0031462,-21600,,
com.microsoft.VSCode,22,1733693983,1733694005,1733694005.776523,-21600,,
com.google.Chrome,2,1733693981,1733693983,1733693983.648871,-21600,,
com.microsoft.VSCode,3,1733693978,1733693981,1733693981.419934,-21600,,
com.google.Chrome,86,1733693892,1733693978,1733693978.2051392,-21600,,
com.microsoft.VSCode,3,1733693889,1733693892,1733693892.964305,-21600,,
com.google.Chrome,10,1733693879,1733693889,1733693889.9194798,-21600,,
com.microsoft.VSCode,1,1733693878,1733693879,1733693879.528349,-21600,,
com.google.Chrome,2,1733693876,1733693878,1733693878.847365,-21600,,
com.microsoft.VSCode,731,1733693145,1733693876,1733693876.632841,-21600,,
com.google.Chrome,3,1733693142,1733693145,1733693145.193449,-21600,,
com.microsoft.VSCode,3,1733693139,1733693142,1733693142.13009,-21600,,
com.google.Chrome,2,1733693137,1733693139,1733693139.128963,-21600,,
com.microsoft.VSCode,9,1733693128,1733693137,1733693137.1678529,-21600,,
com.google.Chrome,4,1733693124,1733693128,1733693128.8097749,-21600,,
com.microsoft.VSCode,4,1733693120,1733693124,1733693124.692514,-21600,,
com.google.Chrome,3,1733693117,1733693120,1733693120.5805311,-21600,,
com.microsoft.VSCode,7,1733693110,1733693117,1733693117.1342878,-21600,,
com.google.Chrome,2,1733693108,1733693110,1733693110.587733,-21600,,
com.microsoft.VSCode,5,1733693103,1733693108,1733693108.282641,-21600,,
com.google.Chrome,164,1733692939,1733693103,1733693103.578686,-21600,,
com.microsoft.VSCode,213,1733692709,1733692922,1733692922.770699,-21600,,
com.leomehlig.today,4,1733692705,1733692709,1733692709.866127,-21600,,
com.google.Chrome,105,1733692600,1733692705,1733692705.268815,-21600,,
com.apple.Health,100,1733692384,1733692484,1733692484.858101,-21600,EB445137-D7F5-57EC-87DA-1DB460D64046,"iPhone13,2"
com.apple.mobilephone,7,1733692377,1733692384,1733692384.826357,-21600,EB445137-D7F5-57EC-87DA-1DB460D64046,"iPhone13,2"
com.apple.Health,17,1733692359,1733692376,1733692376.993634,-21600,EB445137-D7F5-57EC-87DA-1DB460D64046,"iPhone13,2"
com.microsoft.Office.Outlook,25,1733692328,1733692353,1733692353.383699,-21600,EB445137-D7F5-57EC-87DA-1DB460D64046,"iPhone13,2"
com.microsoft.Office.Outlook,3,1733692261,1733692264,1733692264.591662,-21600,EB445137-D7F5-57EC-87DA-1DB460D64046,"iPhone13,2"
com.apple.news,300,1733691924,1733692224,1733692225.1215029,-21600,EB445137-D7F5-57EC-87DA-1DB460D64046,"iPhone13,2"
com.toyopagroup.picaboo,11,1733691900,1733691911,1733691911.697761,-21600,EB445137-D7F5-57EC-87DA-1DB460D64046,"iPhone13,2"
com.hammerandchisel.discord,21,1733691874,1733691895,1733691895.840199,-21600,EB445137-D7F5-57EC-87DA-1DB460D64046,"iPhone13,2"
com.toyopagroup.picaboo,42,1733691821,1733691863,1733691863.543429,-21600,EB445137-D7F5-57EC-87DA-1DB460D64046,"iPhone13,2"
com.apple.news,1,1733691817,1733691818,1733691818.483347,-21600,EB445137-D7F5-57EC-87DA-1DB460D64046,"iPhone13,2"
com.google.Chrome,693,1733690911,1733691604,1733691604.286721,-21600,,
com.google.Chrome,960,1733689667,1733690627,1733690627.483436,-21600,,
com.apple.news,31,1733689251,1733689282,1733689283.0872731,-21600,EB445137-D7F5-57EC-87DA-1DB460D64046,"iPhone13,2"
com.tinyspeck.chatlyio,6,1733689233,1733689239,1733689239.799635,-21600,EB445137-D7F5-57EC-87DA-1DB460D64046,"iPhone13,2"
com.toyopagroup.picaboo,6,1733689204,1733689210,1733689210.12189,-21600,EB445137-D7F5-57EC-87DA-1DB460D64046,"iPhone13,2"
com.google.Chrome,407,1733688910,1733689317,1733689317.425597,-21600,,
com.google.Chrome,963,1733687751,1733688714,1733688714.054582,-21600,,
com.apple.finder,255,1733687496,1733687751,1733687753.212743,-21600,,
com.microsoft.VSCode,98,1733687398,1733687496,1733687496.543882,-21600,,
com.leomehlig.today,5,1733687393,1733687398,1733687399.0159578,-21600,,
com.google.Chrome,1,1733687392,1733687393,1733687393.647915,-21600,,
com.leomehlig.today,20,1733687372,1733687392,1733687392.4429169,-21600,,
com.google.Chrome,38,1733687334,1733687372,1733687372.664092,-21600,,
com.intsig.CamScannerLite,79,1733687292,1733687371,1733687371.892671,-21600,EB445137-D7F5-57EC-87DA-1DB460D64046,"iPhone13,2"
com.apple.mobileslideshow,4,1733687281,1733687285,1733687285.258431,-21600,EB445137-D7F5-57EC-87DA-1DB460D64046,"iPhone13,2"
com.leomehlig.today,59,1733687263,1733687322,1733687323.552933,-21600,,
com.google.Chrome,70,1733687193,1733687263,1733687263.327049,-21600,,
com.apple.finder,0,1733687193,1733687193,1733687193.434994,-21600,,
com.apple.mobileslideshow,69,1733687179,1733687248,1733687249.012069,-21600,EB445137-D7F5-57EC-87DA-1DB460D64046,"iPhone13,2"
com.apple.camera,24,1733687155,1733687179,1733687180.967365,-21600,EB445137-D7F5-57EC-87DA-1DB460D64046,"iPhone13,2"
com.apple.news,15,1733687151,1733687166,1733687169.398159,-21600,EB445137-D7F5-57EC-87DA-1DB460D64046,"iPhone13,2"
com.google.Chrome,833,1733686360,1733687193,1733687193.087788,-21600,,
com.apple.news,2,1733686336,1733686338,1733686338.31657,-21600,EB445137-D7F5-57EC-87DA-1DB460D64046,"iPhone13,2"
com.leomehlig.today,7,1733684874,1733684881,1733684883.672478,-21600,,
com.google.Chrome,4,1733684870,1733684874,1733684874.673918,-21600,,
com.apple.news,6,1733684586,1733684592,1733684592.815274,-21600,EB445137-D7F5-57EC-87DA-1DB460D64046,"iPhone13,2"
com.apple.news,252,1733684333,1733684585,1733684585.9097018,-21600,EB445137-D7F5-57EC-87DA-1DB460D64046,"iPhone13,2"
com.toyopagroup.picaboo,25,1733684297,1733684322,1733684322.464917,-21600,EB445137-D7F5-57EC-87DA-1DB460D64046,"iPhone13,2"
com.truebill.truebillnative,41,1733683849,1733683890,1733683890.231554,-21600,EB445137-D7F5-57EC-87DA-1DB460D64046,"iPhone13,2"
com.clairmail.fth.client,37,1733683812,1733683849,1733683849.713365,-21600,EB445137-D7F5-57EC-87DA-1DB460D64046,"iPhone13,2"
com.truebill.truebillnative,56,1733683753,1733683809,1733683809.63756,-21600,EB445137-D7F5-57EC-87DA-1DB460D64046,"iPhone13,2"
com.google.Chrome,198,1733683719,1733683917,1733683917.520479,-21600,,
com.leomehlig.today,1,1733683718,1733683719,1733683719.3310251,-21600,,
com.microsoft.VSCode,194,1733683524,1733683718,1733683718.847662,-21600,,
com.google.Chrome,59,1733683465,1733683524,1733683524.488871,-21600,,
com.leomehlig.today,14,1733683435,1733683449,1733683450.2531738,-21600,,
com.microsoft.Office.Outlook,5,1733683429,1733683434,1733683434.9694219,-21600,EB445137-D7F5-57EC-87DA-1DB460D64046,"iPhone13,2"
com.leomehlig.today,80,1733683347,1733683427,1733683427.883034,-21600,EB445137-D7F5-57EC-87DA-1DB460D64046,"iPhone13,2"
com.apple.PosterBoard,0,1733683344,1733683344,1733683345.0198069,-21600,EB445137-D7F5-57EC-87DA-1DB460D64046,"iPhone13,2"
com.apple.weather,3,1733683343,1733683346,1733683346.700119,-21600,EB445137-D7F5-57EC-87DA-1DB460D64046,"iPhone13,2"
com.apple.finder,98,1733683337,1733683435,1733683435.7987251,-21600,,
com.apple.iCal,1,1733683336,1733683337,1733683337.5380878,-21600,,
com.google.Chrome,29,1733683307,1733683336,1733683336.702069,-21600,,
com.apple.finder,3,1733683304,1733683307,1733683308.002145,-21600,,
com.leomehlig.today,6,1733683298,1733683304,1733683304.715228,-21600,,
com.apple.finder,7,1733683291,1733683298,1733683298.09872,-21600,,
com.leomehlig.today,8,1733683283,1733683291,1733683291.25781,-21600,,
com.apple.finder,4,1733683279,1733683283,1733683283.519439,-21600,,
com.apple.QuickTimePlayerX,5,1733683274,1733683279,1733683279.410983,-21600,,
com.apple.weather,6,1733683244,1733683250,1733683250.145721,-21600,EB445137-D7F5-57EC-87DA-1DB460D64046,"iPhone13,2"
com.apple.weather,8,1733683027,1733683035,1733683035.125098,-21600,EB445137-D7F5-57EC-87DA-1DB460D64046,"iPhone13,2"
com.apple.weather,5,1733682450,1733682455,1733682455.8422651,-21600,EB445137-D7F5-57EC-87DA-1DB460D64046,"iPhone13,2"
com.google.ios.youtube,96,1733682350,1733682446,1733682447.807164,-21600,EB445137-D7F5-57EC-87DA-1DB460D64046,"iPhone13,2"
com.google.chrome.ios,3,1733682346,1733682349,1733682349.493905,-21600,EB445137-D7F5-57EC-87DA-1DB460D64046,"iPhone13,2"
com.letterboxd.LetterboxdApp,58,1733682287,1733682345,1733682345.235086,-21600,EB445137-D7F5-57EC-87DA-1DB460D64046,"iPhone13,2"
com.toyopagroup.picaboo,65,1733682209,1733682274,1733682274.851155,-21600,EB445137-D7F5-57EC-87DA-1DB460D64046,"iPhone13,2"
com.apple.mobilephone,22,1733682175,1733682197,1733682197.5512629,-21600,EB445137-D7F5-57EC-87DA-1DB460D64046,"iPhone13,2"
com.apple.MobileSMS,119,1733682056,1733682175,1733682175.899907,-21600,EB445137-D7F5-57EC-87DA-1DB460D64046,"iPhone13,2"
com.renpho.health,4,1733682052,1733682056,1733682056.387063,-21600,EB445137-D7F5-57EC-87DA-1DB460D64046,"iPhone13,2"
com.renpho.health,81,1733681239,1733681320,1733681320.338245,-21600,EB445137-D7F5-57EC-87DA-1DB460D64046,"iPhone13,2"
com.google.ios.youtube,9,1733681229,1733681238,1733681238.9866328,-21600,EB445137-D7F5-57EC-87DA-1DB460D64046,"iPhone13,2"
com.google.ios.youtube,9,1733680323,1733680332,1733680332.082578,-21600,EB445137-D7F5-57EC-87DA-1DB460D64046,"iPhone13,2"
com.google.ios.youtube,2212,1733678097,1733680309,1733680310.357157,-21600,EB445137-D7F5-57EC-87DA-1DB460D64046,"iPhone13,2"
com.gosund.smart,6,1733678061,1733678067,1733678067.9693,-21600,EB445137-D7F5-57EC-87DA-1DB460D64046,"iPhone13,2"
com.gosund.smart,18,1733678042,1733678060,1733678060.9775848,-21600,EB445137-D7F5-57EC-87DA-1DB460D64046,"iPhone13,2"
com.gosund.smart,10,1733670067,1733670077,1733670077.884439,-21600,EB445137-D7F5-57EC-87DA-1DB460D64046,"iPhone13,2"
com.apple.QuickTimePlayerX,458,1733648582,1733649040,1733649040.426965,-21600,,
com.microsoft.VSCode,2,1733648580,1733648582,1733648582.445191,-21600,,
com.apple.QuickTimePlayerX,3,1733648577,1733648580,1733648580.872603,-21600,,
com.apple.finder,4,1733648573,1733648577,1733648578.026464,-21600,,
com.apple.QuickTimePlayerX,1,1733648572,1733648573,1733648573.733177,-21600,,
com.apple.finder,2,1733648570,1733648572,1733648572.307714,-21600,,
com.apple.QuickTimePlayerX,4,1733648566,1733648570,1733648570.777278,-21600,,
com.apple.finder,4,1733648562,1733648566,1733648566.130218,-21600,,
com.microsoft.VSCode,33,1733648529,1733648562,1733648562.096395,-21600,,
com.apple.mobilephone,3,1733648494,1733648497,1733648497.165118,-21600,EB445137-D7F5-57EC-87DA-1DB460D64046,"iPhone13,2"
com.apple.InCallService,129,1733648365,1733648494,1733648494.758573,-21600,EB445137-D7F5-57EC-87DA-1DB460D64046,"iPhone13,2"
com.apple.mobilephone,13,1733648352,1733648365,1733648366.040601,-21600,EB445137-D7F5-57EC-87DA-1DB460D64046,"iPhone13,2"
com.google.chrome.ios,12,1733648340,1733648352,1733648352.645086,-21600,EB445137-D7F5-57EC-87DA-1DB460D64046,"iPhone13,2"
com.google.chrome.ios,13,1733648271,1733648284,1733648284.80834,-21600,EB445137-D7F5-57EC-87DA-1DB460D64046,"iPhone13,2"
com.google.chrome.ios,22,1733647272,1733647294,1733647294.461905,-21600,EB445137-D7F5-57EC-87DA-1DB460D64046,"iPhone13,2"
com.apple.mobileslideshow,3,1733647269,1733647272,1733647272.3362942,-21600,EB445137-D7F5-57EC-87DA-1DB460D64046,"iPhone13,2"
com.apple.mobileslideshow,2,1733645620,1733645622,1733645622.916194,-21600,EB445137-D7F5-57EC-87DA-1DB460D64046,"iPhone13,2"
com.apple.mobileslideshow,10,1733645037,1733645047,1733645047.805273,-21600,EB445137-D7F5-57EC-87DA-1DB460D64046,"iPhone13,2"
com.apple.mobileslideshow,2,1733645032,1733645034,1733645034.552141,-21600,EB445137-D7F5-57EC-87DA-1DB460D64046,"iPhone13,2"
com.apple.mobileslideshow,1,1733645029,1733645030,1733645030.598006,-21600,EB445137-D7F5-57EC-87DA-1DB460D64046,"iPhone13,2"
com.apple.mobileslideshow,2,1733645026,1733645028,1733645028.396778,-21600,EB445137-D7F5-57EC-87DA-1DB460D64046,"iPhone13,2"
com.apple.mobileslideshow,3,1733644332,1733644335,1733644335.3492808,-21600,EB445137-D7F5-57EC-87DA-1DB460D64046,"iPhone13,2"
com.apple.mobileslideshow,21,1733644113,1733644134,1733644134.476224,-21600,EB445137-D7F5-57EC-87DA-1DB460D64046,"iPhone13,2"
com.apple.camera,1,1733643396,1733643397,1733643397.04528,-21600,EB445137-D7F5-57EC-87DA-1DB460D64046,"iPhone13,2"
com.apple.mobileslideshow,2,1733643395,1733643397,1733643397.0438461,-21600,EB445137-D7F5-57EC-87DA-1DB460D64046,"iPhone13,2"
com.apple.mobileslideshow,6,1733643388,1733643394,1733643394.274703,-21600,EB445137-D7F5-57EC-87DA-1DB460D64046,"iPhone13,2"
com.apple.mobileslideshow,58,1733638880,1733638938,1733638939.143656,-21600,EB445137-D7F5-57EC-87DA-1DB460D64046,"iPhone13,2"
com.apple.camera,2,1733638872,1733638874,1733638875.000547,-21600,EB445137-D7F5-57EC-87DA-1DB460D64046,"iPhone13,2"
com.apple.camera,19,1733638376,1733638395,1733638395.640974,-21600,EB445137-D7F5-57EC-87DA-1DB460D64046,"iPhone13,2"
com.apple.camera,9,1733637998,1733638007,1733638007.134252,-21600,EB445137-D7F5-57EC-87DA-1DB460D64046,"iPhone13,2"
com.apple.camera,18,1733637883,1733637901,1733637902.0796452,-21600,EB445137-D7F5-57EC-87DA-1DB460D64046,"iPhone13,2"
com.apple.camera,28,1733637694,1733637722,1733637722.800239,-21600,EB445137-D7F5-57EC-87DA-1DB460D64046,"iPhone13,2"
com.apple.camera,27,1733637549,1733637576,1733637577.2668839,-21600,EB445137-D7F5-57EC-87DA-1DB460D64046,"iPhone13,2"
com.apple.camera,1,1733634656,1733634657,1733634657.309639,-21600,EB445137-D7F5-57EC-87DA-1DB460D64046,"iPhone13,2"
com.apple.camera,1,1733634652,1733634653,1733634653.3813381,-21600,EB445137-D7F5-57EC-87DA-1DB460D64046,"iPhone13,2"
com.apple.camera,1,1733634651,1733634652,1733634652.060513,-21600,EB445137-D7F5-57EC-87DA-1DB460D64046,"iPhone13,2"
com.apple.camera,0,1733634650,1733634650,1733634650.9131079,-21600,EB445137-D7F5-57EC-87DA-1DB460D64046,"iPhone13,2"
com.apple.camera,0,1733634643,1733634643,1733634643.607894,-21600,EB445137-D7F5-57EC-87DA-1DB460D64046,"iPhone13,2"
com.apple.camera,0,1733634642,1733634642,1733634642.769294,-21600,EB445137-D7F5-57EC-87DA-1DB460D64046,"iPhone13,2"
com.apple.camera,1,1733634640,1733634641,1733634641.0218391,-21600,EB445137-D7F5-57EC-87DA-1DB460D64046,"iPhone13,2"
com.apple.camera,0,1733634638,1733634638,1733634638.962604,-21600,EB445137-D7F5-57EC-87DA-1DB460D64046,"iPhone13,2"
com.google.chrome.ios,93,1733634511,1733634604,1733634604.783503,-21600,EB445137-D7F5-57EC-87DA-1DB460D64046,"iPhone13,2"
com.amazon.Amazon,126,1733630278,1733630404,1733630404.134129,-21600,EB445137-D7F5-57EC-87DA-1DB460D64046,"iPhone13,2"
com.apple.news,3,1733628555,1733628558,1733628558.8426828,-21600,EB445137-D7F5-57EC-87DA-1DB460D64046,"iPhone13,2"
com.apple.news,76,1733627626,1733627702,1733627702.795793,-21600,EB445137-D7F5-57EC-87DA-1DB460D64046,"iPhone13,2"
com.apple.calculator,7,1733627613,1733627620,1733627620.741712,-21600,EB445137-D7F5-57EC-87DA-1DB460D64046,"iPhone13,2"
com.apple.calculator,2,1733627590,1733627592,1733627593.0288749,-21600,EB445137-D7F5-57EC-87DA-1DB460D64046,"iPhone13,2"
com.apple.calculator,17,1733627454,1733627471,1733627471.265531,-21600,EB445137-D7F5-57EC-87DA-1DB460D64046,"iPhone13,2"
com.google.chrome.ios,4,1733627450,1733627454,1733627454.8057508,-21600,EB445137-D7F5-57EC-87DA-1DB460D64046,"iPhone13,2"
com.google.chrome.ios,7,1733627440,1733627447,1733627447.138881,-21600,EB445137-D7F5-57EC-87DA-1DB460D64046,"iPhone13,2"
com.google.chrome.ios,1,1733627260,1733627261,1733627261.8477669,-21600,EB445137-D7F5-57EC-87DA-1DB460D64046,"iPhone13,2"
com.google.chrome.ios,1,1733627253,1733627254,1733627254.662897,-21600,EB445137-D7F5-57EC-87DA-1DB460D64046,"iPhone13,2"
com.google.chrome.ios,17,1733627232,1733627249,1733627250.2580519,-21600,EB445137-D7F5-57EC-87DA-1DB460D64046,"iPhone13,2"
com.apple.camera,0,1733626765,1733626765,1733626765.3203812,-21600,EB445137-D7F5-57EC-87DA-1DB460D64046,"iPhone13,2"
com.apple.camera,1,1733626748,1733626749,1733626749.261716,-21600,EB445137-D7F5-57EC-87DA-1DB460D64046,"iPhone13,2"
com.tinyspeck.chatlyio,35,1733626691,1733626726,1733626726.664548,-21600,EB445137-D7F5-57EC-87DA-1DB460D64046,"iPhone13,2"
com.apple.news,2,1733626688,1733626690,1733626690.931247,-21600,EB445137-D7F5-57EC-87DA-1DB460D64046,"iPhone13,2"
com.apple.news,7,1733624814,1733624821,1733624822.21159,-21600,EB445137-D7F5-57EC-87DA-1DB460D64046,"iPhone13,2"
com.apple.news,3,1733620513,1733620516,1733620516.011697,-21600,EB445137-D7F5-57EC-87DA-1DB460D64046,"iPhone13,2"
com.apple.news,2,1733620425,1733620427,1733620427.808285,-21600,EB445137-D7F5-57EC-87DA-1DB460D64046,"iPhone13,2"
com.apple.news,4,1733620420,1733620424,1733620424.7845201,-21600,EB445137-D7F5-57EC-87DA-1DB460D64046,"iPhone13,2"
com.apple.news,71,1733620346,1733620417,1733620417.386682,-21600,EB445137-D7F5-57EC-87DA-1DB460D64046,"iPhone13,2"
com.apple.camera,3,1733619629,1733619632,1733619632.117145,-21600,EB445137-D7F5-57EC-87DA-1DB460D64046,"iPhone13,2"
com.apple.camera,2,1733619627,1733619629,1733619629.8176398,-21600,EB445137-D7F5-57EC-87DA-1DB460D64046,"iPhone13,2"
com.toyopagroup.picaboo,16,1733619620,1733619636,1733619636.9711971,-21600,EB445137-D7F5-57EC-87DA-1DB460D64046,"iPhone13,2"
com.toyopagroup.picaboo,22,1733617715,1733617737,1733617737.515899,-21600,EB445137-D7F5-57EC-87DA-1DB460D64046,"iPhone13,2"
com.tinyspeck.chatlyio,3,1733617712,1733617715,1733617715.52017,-21600,EB445137-D7F5-57EC-87DA-1DB460D64046,"iPhone13,2"
com.tinyspeck.chatlyio,25,1733617049,1733617074,1733617074.470237,-21600,EB445137-D7F5-57EC-87DA-1DB460D64046,"iPhone13,2"
com.tinyspeck.chatlyio,5,1733616635,1733616640,1733616640.718536,-21600,EB445137-D7F5-57EC-87DA-1DB460D64046,"iPhone13,2"
com.tinyspeck.chatlyio,6,1733616628,1733616634,1733616634.446537,-21600,EB445137-D7F5-57EC-87DA-1DB460D64046,"iPhone13,2"
com.tinyspeck.chatlyio,14,1733616523,1733616537,1733616537.831547,-21600,EB445137-D7F5-57EC-87DA-1DB460D64046,"iPhone13,2"
com.apple.MobileSMS,4,1733616519,1733616523,1733616523.3927011,-21600,EB445137-D7F5-57EC-87DA-1DB460D64046,"iPhone13,2"
com.apple.MobileSMS,2,1733616349,1733616351,1733616351.763414,-21600,EB445137-D7F5-57EC-87DA-1DB460D64046,"iPhone13,2"
com.apple.MobileSMS,14,1733616198,1733616212,1733616212.5912318,-21600,EB445137-D7F5-57EC-87DA-1DB460D64046,"iPhone13,2"
com.apple.MobileSMS,11,1733614100,1733614111,1733614111.127033,-21600,EB445137-D7F5-57EC-87DA-1DB460D64046,"iPhone13,2"
com.apple.calculator,8,1733614092,1733614100,1733614100.417305,-21600,EB445137-D7F5-57EC-87DA-1DB460D64046,"iPhone13,2"
com.apple.camera,4,1733613406,1733613410,1733613411.1795611,-21600,EB445137-D7F5-57EC-87DA-1DB460D64046,"iPhone13,2"
com.apple.camera,76,1733613324,1733613400,1733613400.9299111,-21600,EB445137-D7F5-57EC-87DA-1DB460D64046,"iPhone13,2"
com.tinyspeck.chatlyio,61,1733612079,1733612140,1733612140.346912,-21600,EB445137-D7F5-57EC-87DA-1DB460D64046,"iPhone13,2"
com.apple.MobileSMS,14,1733612063,1733612077,1733612077.079595,-21600,EB445137-D7F5-57EC-87DA-1DB460D64046,"iPhone13,2"
com.apple.MobileSMS,4,1733610838,1733610842,1733610842.3539848,-21600,EB445137-D7F5-57EC-87DA-1DB460D64046,"iPhone13,2"
com.apple.MobileSMS,3,1733610710,1733610713,1733610713.935161,-21600,EB445137-D7F5-57EC-87DA-1DB460D64046,"iPhone13,2"
com.toyopagroup.picaboo,4,1733610676,1733610680,1733610680.291072,-21600,EB445137-D7F5-57EC-87DA-1DB460D64046,"iPhone13,2"
com.apple.MobileSMS,34,1733610641,1733610675,1733610675.208791,-21600,EB445137-D7F5-57EC-87DA-1DB460D64046,"iPhone13,2"
com.apple.MobileSMS,32,1733610460,1733610492,1733610492.8230329,-21600,EB445137-D7F5-57EC-87DA-1DB460D64046,"iPhone13,2"
com.apple.MobileSMS,11,1733610447,1733610458,1733610458.261441,-21600,EB445137-D7F5-57EC-87DA-1DB460D64046,"iPhone13,2"
com.apple.MobileSMS,12,1733609632,1733609644,1733609644.1681871,-21600,EB445137-D7F5-57EC-87DA-1DB460D64046,"iPhone13,2"
com.toyopagroup.picaboo,2,1733609630,1733609632,1733609632.400563,-21600,EB445137-D7F5-57EC-87DA-1DB460D64046,"iPhone13,2"
com.toyopagroup.picaboo,18,1733609603,1733609621,1733609621.8697581,-21600,EB445137-D7F5-57EC-87DA-1DB460D64046,"iPhone13,2"
com.toyopagroup.picaboo,5,1733609592,1733609597,1733609597.536458,-21600,EB445137-D7F5-57EC-87DA-1DB460D64046,"iPhone13,2"
com.apple.MobileSMS,2,1733609590,1733609592,1733609592.7585921,-21600,EB445137-D7F5-57EC-87DA-1DB460D64046,"iPhone13,2"
com.apple.MobileSMS,12,1733609564,1733609576,1733609576.0963612,-21600,EB445137-D7F5-57EC-87DA-1DB460D64046,"iPhone13,2"
com.apple.MobileSMS,53,1733609497,1733609550,1733609551.000926,-21600,EB445137-D7F5-57EC-87DA-1DB460D64046,"iPhone13,2"
com.apple.MobileSMS,7,1733609486,1733609493,1733609494.0203319,-21600,EB445137-D7F5-57EC-87DA-1DB460D64046,"iPhone13,2"
com.tinyspeck.chatlyio,8,1733609478,1733609486,1733609486.127413,-21600,EB445137-D7F5-57EC-87DA-1DB460D64046,"iPhone13,2"
com.apple.Passwords,3,1733609475,1733609478,1733609478.8520908,-21600,EB445137-D7F5-57EC-87DA-1DB460D64046,"iPhone13,2"
com.apple.camera,1,1733609457,1733609458,1733609458.121912,-21600,EB445137-D7F5-57EC-87DA-1DB460D64046,"iPhone13,2"
com.apple.MobileSMS,12,1733609386,1733609398,1733609398.452184,-21600,EB445137-D7F5-57EC-87DA-1DB460D64046,"iPhone13,2"
com.apple.Passwords,42,1733609344,1733609386,1733609386.646862,-21600,EB445137-D7F5-57EC-87DA-1DB460D64046,"iPhone13,2"
com.apple.MobileSMS,4,1733609340,1733609344,1733609344.890594,-21600,EB445137-D7F5-57EC-87DA-1DB460D64046,"iPhone13,2"
com.apple.Passwords,22,1733609318,1733609340,1733609340.1329,-21600,EB445137-D7F5-57EC-87DA-1DB460D64046,"iPhone13,2"
com.apple.MobileSMS,8,1733609305,1733609313,1733609313.172291,-21600,EB445137-D7F5-57EC-87DA-1DB460D64046,"iPhone13,2"
com.apple.MobileSMS,2,1733609265,1733609267,1733609267.6360002,-21600,EB445137-D7F5-57EC-87DA-1DB460D64046,"iPhone13,2"
com.tinyspeck.chatlyio,10,1733609124,1733609134,1733609134.31359,-21600,EB445137-D7F5-57EC-87DA-1DB460D64046,"iPhone13,2"
com.tinyspeck.chatlyio,1,1733609122,1733609123,1733609123.588311,-21600,EB445137-D7F5-57EC-87DA-1DB460D64046,"iPhone13,2"
com.tinyspeck.chatlyio,2,1733609118,1733609120,1733609120.53133,-21600,EB445137-D7F5-57EC-87DA-1DB460D64046,"iPhone13,2"
com.apple.camera,0,1733609100,1733609100,1733609100.817224,-21600,EB445137-D7F5-57EC-87DA-1DB460D64046,"iPhone13,2"
com.apple.camera,1,1733609094,1733609095,1733609095.012938,-21600,EB445137-D7F5-57EC-87DA-1DB460D64046,"iPhone13,2"
com.tinyspeck.chatlyio,8,1733609093,1733609101,1733609101.7444391,-21600,EB445137-D7F5-57EC-87DA-1DB460D64046,"iPhone13,2"
com.apple.camera,1,1733609093,1733609094,1733609094.225299,-21600,EB445137-D7F5-57EC-87DA-1DB460D64046,"iPhone13,2"
com.tinyspeck.chatlyio,3,1733609087,1733609090,1733609090.192821,-21600,EB445137-D7F5-57EC-87DA-1DB460D64046,"iPhone13,2"
com.tinyspeck.chatlyio,7,1733609072,1733609079,1733609079.046056,-21600,EB445137-D7F5-57EC-87DA-1DB460D64046,"iPhone13,2"
com.apple.camera,0,1733609072,1733609072,1733609072.9340792,-21600,EB445137-D7F5-57EC-87DA-1DB460D64046,"iPhone13,2"
com.tinyspeck.chatlyio,11,1733609036,1733609047,1733609047.8028688,-21600,EB445137-D7F5-57EC-87DA-1DB460D64046,"iPhone13,2"
com.apple.camera,1,1733608832,1733608833,1733608833.957459,-21600,EB445137-D7F5-57EC-87DA-1DB460D64046,"iPhone13,2"
com.toyopagroup.picaboo,12,1733608807,1733608819,1733608819.615827,-21600,EB445137-D7F5-57EC-87DA-1DB460D64046,"iPhone13,2"
com.microsoft.VSCode,89,1733608551,1733608640,1733608640.7932339,-21600,,
com.leomehlig.today,30,1733608521,1733608551,1733608551.771591,-21600,,
com.microsoft.VSCode,220,1733608301,1733608521,1733608521.112794,-21600,,
com.google.Chrome,0,1733608301,1733608301,1733608301.651041,-21600,,
com.microsoft.VSCode,1,1733608300,1733608301,1733608301.071146,-21600,,
com.google.Chrome,4,1733608296,1733608300,1733608300.497711,-21600,,
com.microsoft.VSCode,523,1733607773,1733608296,1733608296.067503,-21600,,
com.google.Chrome,1,1733607772,1733607773,1733607773.438146,-21600,,
com.microsoft.VSCode,41,1733607731,1733607772,1733607773.0157099,-21600,,
com.google.Chrome,16,1733607715,1733607731,1733607731.7594628,-21600,,
com.microsoft.VSCode,7,1733607708,1733607715,1733607715.640295,-21600,,
com.google.Chrome,19,1733607689,1733607708,1733607708.2897692,-21600,,
com.microsoft.VSCode,1,1733607688,1733607689,1733607689.728127,-21600,,
com.google.Chrome,15,1733607673,1733607688,1733607688.851598,-21600,,
com.microsoft.VSCode,5,1733607668,1733607673,1733607673.487994,-21600,,
com.google.Chrome,11,1733607657,1733607668,1733607668.86637,-21600,,
com.microsoft.VSCode,737,1733606920,1733607657,1733607657.414979,-21600,,
com.google.Chrome,13,1733606907,1733606920,1733606920.837747,-21600,,
com.microsoft.VSCode,1040,1733605867,1733606907,1733606907.651925,-21600,,
com.google.Chrome,120,1733605747,1733605867,1733605867.7597032,-21600,,
com.microsoft.VSCode,344,1733605403,1733605747,1733605747.833488,-21600,,
com.google.Chrome,21,1733605382,1733605403,1733605403.856244,-21600,,
com.microsoft.VSCode,211,1733605160,1733605371,1733605371.639742,-21600,,
com.hnc.Discord,9,1733605151,1733605160,1733605160.722254,-21600,,
com.google.Chrome,55,1733605096,1733605151,1733605151.213839,-21600,,
com.apple.MobileSMS,0,1733605096,1733605096,1733605097.0333,-21600,,
com.google.Chrome,42,1733605054,1733605096,1733605096.66226,-21600,,
com.apple.MobileSMS,0,1733605054,1733605054,1733605054.9966378,-21600,,
com.hnc.Discord,53,1733605001,1733605054,1733605054.271251,-21600,,
com.microsoft.VSCode,39,1733604962,1733605001,1733605001.6794372,-21600,,
com.apple.MobileSMS,3,1733604959,1733604962,1733604962.961732,-21600,,
com.microsoft.VSCode,9,1733604950,1733604959,1733604959.242172,-21600,,
com.apple.MobileSMS,8,1733604942,1733604950,1733604950.707248,-21600,,
com.microsoft.VSCode,7,1733604935,1733604942,1733604942.775846,-21600,,
com.leomehlig.today,23,1733604912,1733604935,1733604935.155487,-21600,,
com.apple.iCal,36,1733604876,1733604912,1733604912.116503,-21600,,
com.apple.mobileslideshow,49,1733604532,1733604581,1733604581.819845,-21600,EB445137-D7F5-57EC-87DA-1DB460D64046,"iPhone13,2"
com.tinyspeck.chatlyio,57,1733604475,1733604532,1733604532.663882,-21600,EB445137-D7F5-57EC-87DA-1DB460D64046,"iPhone13,2"
com.google.Chrome,484,1733604392,1733604876,1733604876.4295058,-21600,,
com.google.Chrome,1901,1733601723,1733603624,1733603624.7414188,-21600,,
com.apple.MobileSMS,4,1733600360,1733600364,1733600364.2985048,-21600,EB445137-D7F5-57EC-87DA-1DB460D64046,"iPhone13,2"
com.tinyspeck.chatlyio,0,1733600360,1733600360,1733600361.01299,-21600,EB445137-D7F5-57EC-87DA-1DB460D64046,"iPhone13,2"
com.tinyspeck.chatlyio,7,1733600158,1733600165,1733600165.790616,-21600,EB445137-D7F5-57EC-87DA-1DB460D64046,"iPhone13,2"
com.apple.MobileSMS,22,1733600136,1733600158,1733600158.546298,-21600,EB445137-D7F5-57EC-87DA-1DB460D64046,"iPhone13,2"
com.tinyspeck.chatlyio,0,1733600102,1733600102,1733600102.976451,-21600,EB445137-D7F5-57EC-87DA-1DB460D64046,"iPhone13,2"
com.tinyspeck.chatlyio,5,1733600029,1733600034,1733600034.239742,-21600,EB445137-D7F5-57EC-87DA-1DB460D64046,"iPhone13,2"
com.google.Chrome,1569,1733599976,1733601545,1733601545.8143249,-21600,,
com.tinyspeck.chatlyio,84,1733599907,1733599991,1733599991.835722,-21600,EB445137-D7F5-57EC-87DA-1DB460D64046,"iPhone13,2"
com.tinyspeck.chatlyio,8,1733599687,1733599695,1733599695.199802,-21600,EB445137-D7F5-57EC-87DA-1DB460D64046,"iPhone13,2"
com.tinyspeck.chatlyio,7,1733599679,1733599686,1733599686.9462361,-21600,EB445137-D7F5-57EC-87DA-1DB460D64046,"iPhone13,2"
com.truebill.truebillnative,10,1733598736,1733598746,1733598746.040557,-21600,EB445137-D7F5-57EC-87DA-1DB460D64046,"iPhone13,2"
com.google.Sheets,20,1733598707,1733598727,1733598727.7976608,-21600,EB445137-D7F5-57EC-87DA-1DB460D64046,"iPhone13,2"
com.tinyspeck.chatlyio,8,1733598699,1733598707,1733598707.578723,-21600,EB445137-D7F5-57EC-87DA-1DB460D64046,"iPhone13,2"
com.microsoft.Office.Outlook,15,1733598684,1733598699,1733598699.627905,-21600,EB445137-D7F5-57EC-87DA-1DB460D64046,"iPhone13,2"
com.tinyspeck.chatlyio,5,1733598678,1733598683,1733598683.373487,-21600,EB445137-D7F5-57EC-87DA-1DB460D64046,"iPhone13,2"
com.apple.weather,10,1733598646,1733598656,1733598656.052953,-21600,EB445137-D7F5-57EC-87DA-1DB460D64046,"iPhone13,2"
com.apple.weather,5,1733598604,1733598609,1733598609.621894,-21600,EB445137-D7F5-57EC-87DA-1DB460D64046,"iPhone13,2"
com.apple.weather,6,1733598594,1733598600,1733598601.0240111,-21600,EB445137-D7F5-57EC-87DA-1DB460D64046,"iPhone13,2"
com.google.ios.youtube,473,1733597453,1733597926,1733597928.349391,-21600,EB445137-D7F5-57EC-87DA-1DB460D64046,"iPhone13,2"
com.apple.MobileSMS,5,1733597448,1733597453,1733597453.2237082,-21600,EB445137-D7F5-57EC-87DA-1DB460D64046,"iPhone13,2"
com.google.Chrome,44,1733597402,1733597446,1733597446.785534,-21600,,
com.apple.camera,0,1733597307,1733597307,1733597307.227649,-21600,EB445137-D7F5-57EC-87DA-1DB460D64046,"iPhone13,2"
com.apple.MobileSMS,7,1733597306,1733597313,1733597313.637358,-21600,EB445137-D7F5-57EC-87DA-1DB460D64046,"iPhone13,2"
com.apple.camera,0,1733597306,1733597306,1733597306.842058,-21600,EB445137-D7F5-57EC-87DA-1DB460D64046,"iPhone13,2"
com.apple.MobileSMS,3,1733597281,1733597284,1733597285.0967212,-21600,EB445137-D7F5-57EC-87DA-1DB460D64046,"iPhone13,2"
com.google.ios.youtube,160,1733597120,1733597280,1733597280.935391,-21600,EB445137-D7F5-57EC-87DA-1DB460D64046,"iPhone13,2"
com.tinyspeck.chatlyio,1,1733597119,1733597120,1733597121.021975,-21600,EB445137-D7F5-57EC-87DA-1DB460D64046,"iPhone13,2"
com.apple.MobileSMS,35,1733597084,1733597119,1733597119.583819,-21600,EB445137-D7F5-57EC-87DA-1DB460D64046,"iPhone13,2"
com.tinyspeck.chatlyio,5,1733597079,1733597084,1733597084.8059192,-21600,EB445137-D7F5-57EC-87DA-1DB460D64046,"iPhone13,2"
com.google.ios.youtube,972,1733596107,1733597079,1733597079.684118,-21600,EB445137-D7F5-57EC-87DA-1DB460D64046,"iPhone13,2"
com.truebill.truebillnative,29,1733596076,1733596105,1733596105.07052,-21600,EB445137-D7F5-57EC-87DA-1DB460D64046,"iPhone13,2"
com.toyopagroup.picaboo,55,1733596009,1733596064,1733596064.496438,-21600,EB445137-D7F5-57EC-87DA-1DB460D64046,"iPhone13,2"
com.tinyspeck.chatlyio,0,1733596002,1733596002,1733596002.237132,-21600,EB445137-D7F5-57EC-87DA-1DB460D64046,"iPhone13,2"
com.google.Chrome,308,1733595985,1733596293,1733596293.405725,-21600,,
com.leomehlig.today,23,1733595962,1733595985,1733595985.195812,-21600,,
com.google.Chrome,1,1733595961,1733595962,1733595962.595432,-21600,,
com.leomehlig.today,64,1733595897,1733595961,1733595961.123734,-21600,,
com.google.Chrome,5,1733595892,1733595897,1733595898.0256991,-21600,,
com.leomehlig.today,6,1733595886,1733595892,1733595892.4747381,-21600,,
com.google.Chrome,47,1733595839,1733595886,1733595886.915137,-21600,,
com.leomehlig.today,15,1733595824,1733595839,1733595839.266984,-21600,,
com.google.Chrome,116,1733595708,1733595824,1733595824.379128,-21600,,
com.leomehlig.today,9,1733595699,1733595708,1733595708.535512,-21600,,
com.google.Chrome,396,1733595303,1733595699,1733595700.0677872,-21600,,
com.leomehlig.today,70,1733595207,1733595277,1733595277.905548,-21600,,
com.google.Chrome,4,1733595203,1733595207,1733595207.068953,-21600,,
com.apple.MobileSMS,5,1733595198,1733595203,1733595203.742795,-21600,,
com.google.Chrome,54,1733595144,1733595198,1733595198.050318,-21600,,
com.tinyspeck.chatlyio,14,1733594532,1733594546,1733594546.840827,-21600,EB445137-D7F5-57EC-87DA-1DB460D64046,"iPhone13,2"
com.apple.camera,1,1733594377,1733594378,1733594378.8999271,-21600,EB445137-D7F5-57EC-87DA-1DB460D64046,"iPhone13,2"
com.apple.news,126,1733593686,1733593812,1733593812.988841,-21600,EB445137-D7F5-57EC-87DA-1DB460D64046,"iPhone13,2"
com.apple.news,113,1733593534,1733593647,1733593647.316567,-21600,EB445137-D7F5-57EC-87DA-1DB460D64046,"iPhone13,2"
com.apple.camera,0,1733593444,1733593444,1733593444.825616,-21600,EB445137-D7F5-57EC-87DA-1DB460D64046,"iPhone13,2"
com.apple.camera,0,1733593441,1733593441,1733593441.8679729,-21600,EB445137-D7F5-57EC-87DA-1DB460D64046,"iPhone13,2"
com.apple.camera,0,1733593389,1733593389,1733593389.6589851,-21600,EB445137-D7F5-57EC-87DA-1DB460D64046,"iPhone13,2"
com.apple.Health,37,1733593305,1733593342,1733593342.836465,-21600,EB445137-D7F5-57EC-87DA-1DB460D64046,"iPhone13,2"
com.apple.Health,17,1733593286,1733593303,1733593304.037226,-21600,EB445137-D7F5-57EC-87DA-1DB460D64046,"iPhone13,2"
com.apple.MobileSMS,8,1733593209,1733593217,1733593217.811557,-21600,EB445137-D7F5-57EC-87DA-1DB460D64046,"iPhone13,2"
com.apple.news,91,1733593118,1733593209,1733593209.5341458,-21600,EB445137-D7F5-57EC-87DA-1DB460D64046,"iPhone13,2"
com.apple.MobileSMS,2,1733593116,1733593118,1733593118.996928,-21600,EB445137-D7F5-57EC-87DA-1DB460D64046,"iPhone13,2"
com.toyopagroup.picaboo,7,1733593109,1733593116,1733593116.823598,-21600,EB445137-D7F5-57EC-87DA-1DB460D64046,"iPhone13,2"
com.toyopagroup.picaboo,1,1733593014,1733593015,1733593015.492683,-21600,EB445137-D7F5-57EC-87DA-1DB460D64046,"iPhone13,2"
com.toyopagroup.picaboo,0,1733592542,1733592542,1733592542.65757,-21600,EB445137-D7F5-57EC-87DA-1DB460D64046,"iPhone13,2"
com.toyopagroup.picaboo,24,1733591291,1733591315,1733591315.677465,-21600,EB445137-D7F5-57EC-87DA-1DB460D64046,"iPhone13,2"
com.renpho.health,8,1733591283,1733591291,1733591291.278225,-21600,EB445137-D7F5-57EC-87DA-1DB460D64046,"iPhone13,2"
com.google.Chrome,474,1733590991,1733591465,1733591465.1345758,-21600,,
com.google.Chrome,819,1733590102,1733590921,1733590921.084049,-21600,,
com.renpho.health,7,1733589955,1733589962,1733589962.848326,-21600,EB445137-D7F5-57EC-87DA-1DB460D64046,"iPhone13,2"
com.renpho.health,9,1733589943,1733589952,1733589952.8411388,-21600,EB445137-D7F5-57EC-87DA-1DB460D64046,"iPhone13,2"
com.renpho.health,19,1733589348,1733589367,1733589367.77477,-21600,EB445137-D7F5-57EC-87DA-1DB460D64046,"iPhone13,2"
com.tinyspeck.chatlyio,16,1733587753,1733587769,1733587769.339515,-21600,EB445137-D7F5-57EC-87DA-1DB460D64046,"iPhone13,2"
com.apple.news,2,1733585894,1733585896,1733585896.822287,-21600,EB445137-D7F5-57EC-87DA-1DB460D64046,"iPhone13,2"
com.apple.camera,0,1733585200,1733585200,1733585200.470469,-21600,EB445137-D7F5-57EC-87DA-1DB460D64046,"iPhone13,2"
com.apple.camera,0,1733583958,1733583958,1733583958.591672,-21600,EB445137-D7F5-57EC-87DA-1DB460D64046,"iPhone13,2"
com.apple.mobiletimer,12,1733551810,1733551822,1733551822.40098,-21600,EB445137-D7F5-57EC-87DA-1DB460D64046,"iPhone13,2"
com.apple.journal,227,1733551246,1733551473,1733551473.1735291,-21600,EB445137-D7F5-57EC-87DA-1DB460D64046,"iPhone13,2"
com.apple.journal,10,1733551226,1733551236,1733551236.188132,-21600,EB445137-D7F5-57EC-87DA-1DB460D64046,"iPhone13,2"
com.apple.journal,63,1733551151,1733551214,1733551214.335649,-21600,EB445137-D7F5-57EC-87DA-1DB460D64046,"iPhone13,2"
com.apple.journal,333,1733550812,1733551145,1733551146.085093,-21600,EB445137-D7F5-57EC-87DA-1DB460D64046,"iPhone13,2"
com.apple.journal,760,1733549830,1733550590,1733550590.6793308,-21600,EB445137-D7F5-57EC-87DA-1DB460D64046,"iPhone13,2"
com.apple.Music,0,1733549813,1733549813,1733549813.915838,-21600,EB445137-D7F5-57EC-87DA-1DB460D64046,"iPhone13,2"
com.apple.Music,13,1733549719,1733549732,1733549732.4873629,-21600,EB445137-D7F5-57EC-87DA-1DB460D64046,"iPhone13,2"
com.apple.Music,16,1733549250,1733549266,1733549267.1739268,-21600,EB445137-D7F5-57EC-87DA-1DB460D64046,"iPhone13,2"
com.google.Chrome,471,1733548764,1733549235,1733549236.004411,-21600,,
com.google.Chrome,1024,1733547597,1733548621,1733548621.5481749,-21600,,
com.google.Chrome,346,1733546932,1733547278,1733547278.46388,-21600,,
com.google.Chrome,985,1733545586,1733546571,1733546571.794013,-21600,,
com.apple.news,159,1733545195,1733545354,1733545354.544393,-21600,EB445137-D7F5-57EC-87DA-1DB460D64046,"iPhone13,2"
com.markhambly.APOD,23,1733545157,1733545180,1733545180.971756,-21600,EB445137-D7F5-57EC-87DA-1DB460D64046,"iPhone13,2"
com.truebill.truebillnative,4,1733545138,1733545142,1733545142.923517,-21600,EB445137-D7F5-57EC-87DA-1DB460D64046,"iPhone13,2"
com.ally.MobileBanking,102,1733545036,1733545138,1733545138.506036,-21600,EB445137-D7F5-57EC-87DA-1DB460D64046,"iPhone13,2"
com.truebill.truebillnative,43,1733544991,1733545034,1733545034.4327579,-21600,EB445137-D7F5-57EC-87DA-1DB460D64046,"iPhone13,2"
com.apple.news,124,1733544599,1733544723,1733544723.9228392,-21600,EB445137-D7F5-57EC-87DA-1DB460D64046,"iPhone13,2"
com.google.Chrome,11,1733544586,1733544597,1733544597.24719,-21600,,
com.apple.iCal,83,1733544503,1733544586,1733544586.7562761,-21600,,
com.apple.news,199,1733544290,1733544489,1733544490.387954,-21600,EB445137-D7F5-57EC-87DA-1DB460D64046,"iPhone13,2"
com.microsoft.Office.Outlook,31,1733544251,1733544282,1733544282.042951,-21600,EB445137-D7F5-57EC-87DA-1DB460D64046,"iPhone13,2"
com.toyopagroup.picaboo,40,1733544210,1733544250,1733544250.148659,-21600,EB445137-D7F5-57EC-87DA-1DB460D64046,"iPhone13,2"
com.google.Chrome,342,1733544161,1733544503,1733544503.5701962,-21600,,
com.leomehlig.today,134,1733544027,1733544161,1733544161.355155,-21600,,
com.google.Chrome,2,1733544025,1733544027,1733544027.397468,-21600,,
com.apple.iCal,17,1733544008,1733544025,1733544025.5897079,-21600,,
com.google.Chrome,72,1733543936,1733544008,1733544008.449501,-21600,,
com.toyopagroup.picaboo,2,1733543497,1733543499,1733543499.9419,-21600,EB445137-D7F5-57EC-87DA-1DB460D64046,"iPhone13,2"
com.t11.celeste,8,1733543489,1733543497,1733543497.3809838,-21600,EB445137-D7F5-57EC-87DA-1DB460D64046,"iPhone13,2"
com.t11.celeste,8,1733542710,1733542718,1733542718.718145,-21600,EB445137-D7F5-57EC-87DA-1DB460D64046,"iPhone13,2"
com.t11.celeste,2,1733542708,1733542710,1733542710.406042,-21600,EB445137-D7F5-57EC-87DA-1DB460D64046,"iPhone13,2"
com.t11.celeste,2,1733541742,1733541744,1733541744.8005772,-21600,EB445137-D7F5-57EC-87DA-1DB460D64046,"iPhone13,2"
com.t11.celeste,2389,1733539352,1733541741,1733541742.140582,-21600,EB445137-D7F5-57EC-87DA-1DB460D64046,"iPhone13,2"
com.noctuasoftware.stellarium-mobile-plus,3,1733539348,1733539351,1733539351.524148,-21600,EB445137-D7F5-57EC-87DA-1DB460D64046,"iPhone13,2"
com.apple.news,23,1733538214,1733538237,1733538237.503152,-21600,EB445137-D7F5-57EC-87DA-1DB460D64046,"iPhone13,2"
com.noctuasoftware.stellarium-mobile-plus,5,1733538201,1733538206,1733538206.086694,-21600,EB445137-D7F5-57EC-87DA-1DB460D64046,"iPhone13,2"
com.noctuasoftware.stellarium-mobile-plus,43,1733537968,1733538011,1733538011.433463,-21600,EB445137-D7F5-57EC-87DA-1DB460D64046,"iPhone13,2"
com.toyopagroup.picaboo,14,1733537923,1733537937,1733537937.5905309,-21600,EB445137-D7F5-57EC-87DA-1DB460D64046,"iPhone13,2"
com.noctuasoftware.stellarium-mobile-plus,3,1733537920,1733537923,1733537923.6318378,-21600,EB445137-D7F5-57EC-87DA-1DB460D64046,"iPhone13,2"
com.noctuasoftware.stellarium-mobile-plus,8,1733537559,1733537567,1733537567.229691,-21600,EB445137-D7F5-57EC-87DA-1DB460D64046,"iPhone13,2"
com.noctuasoftware.stellarium-mobile-plus,20,1733537538,1733537558,1733537558.276958,-21600,EB445137-D7F5-57EC-87DA-1DB460D64046,"iPhone13,2"
com.noctuasoftware.stellarium-mobile-plus,18,1733536795,1733536813,1733536813.9962711,-21600,EB445137-D7F5-57EC-87DA-1DB460D64046,"iPhone13,2"
com.google.chrome.ios,2,1733536788,1733536790,1733536790.567241,-21600,EB445137-D7F5-57EC-87DA-1DB460D64046,"iPhone13,2"
com.apple.camera,6,1733536305,1733536311,1733536312.284209,-21600,EB445137-D7F5-57EC-87DA-1DB460D64046,"iPhone13,2"
com.google.chrome.ios,9,1733536302,1733536311,1733536312.314557,-21600,EB445137-D7F5-57EC-87DA-1DB460D64046,"iPhone13,2"
com.google.chrome.ios,102,1733534470,1733534572,1733534573.287715,-21600,EB445137-D7F5-57EC-87DA-1DB460D64046,"iPhone13,2"
com.kechagias.polar-scope-align-free,1,1733534468,1733534469,1733534469.939295,-21600,EB445137-D7F5-57EC-87DA-1DB460D64046,"iPhone13,2"
com.kechagias.polar-scope-align-free,64,1733533101,1733533165,1733533165.818661,-21600,EB445137-D7F5-57EC-87DA-1DB460D64046,"iPhone13,2"
com.kechagias.polar-scope-align-free,88,1733532968,1733533056,1733533056.261559,-21600,EB445137-D7F5-57EC-87DA-1DB460D64046,"iPhone13,2"
com.apple.compass,2,1733532964,1733532966,1733532966.493448,-21600,EB445137-D7F5-57EC-87DA-1DB460D64046,"iPhone13,2"
com.apple.compass,27,1733532770,1733532797,1733532797.90505,-21600,EB445137-D7F5-57EC-87DA-1DB460D64046,"iPhone13,2"
com.apple.compass,21,1733532209,1733532230,1733532230.8644981,-21600,EB445137-D7F5-57EC-87DA-1DB460D64046,"iPhone13,2"
com.hammerandchisel.discord,3,1733532204,1733532207,1733532207.258806,-21600,EB445137-D7F5-57EC-87DA-1DB460D64046,"iPhone13,2"
com.apple.camera,6,1733531478,1733531484,1733531484.843577,-21600,EB445137-D7F5-57EC-87DA-1DB460D64046,"iPhone13,2"
com.hammerandchisel.discord,8,1733531476,1733531484,1733531484.840908,-21600,EB445137-D7F5-57EC-87DA-1DB460D64046,"iPhone13,2"
com.hammerandchisel.discord,5,1733530652,1733530657,1733530657.1428971,-21600,EB445137-D7F5-57EC-87DA-1DB460D64046,"iPhone13,2"
com.hammerandchisel.discord,0,1733530642,1733530642,1733530643.005064,-21600,EB445137-D7F5-57EC-87DA-1DB460D64046,"iPhone13,2"
com.hammerandchisel.discord,58,1733530380,1733530438,1733530439.0955,-21600,EB445137-D7F5-57EC-87DA-1DB460D64046,"iPhone13,2"
com.tinyspeck.chatlyio,15,1733530362,1733530377,1733530377.467175,-21600,EB445137-D7F5-57EC-87DA-1DB460D64046,"iPhone13,2"
com.tinyspeck.chatlyio,24,1733530248,1733530272,1733530272.8427892,-21600,EB445137-D7F5-57EC-87DA-1DB460D64046,"iPhone13,2"
com.google.chrome.ios,3,1733530245,1733530248,1733530248.49592,-21600,EB445137-D7F5-57EC-87DA-1DB460D64046,"iPhone13,2"
com.google.chrome.ios,0,1733530227,1733530227,1733530227.9325728,-21600,EB445137-D7F5-57EC-87DA-1DB460D64046,"iPhone13,2"
com.google.chrome.ios,7,1733530200,1733530207,1733530207.753821,-21600,EB445137-D7F5-57EC-87DA-1DB460D64046,"iPhone13,2"
com.google.chrome.ios,7,1733530192,1733530199,1733530199.472467,-21600,EB445137-D7F5-57EC-87DA-1DB460D64046,"iPhone13,2"
com.toyopagroup.picaboo,23,1733530169,1733530192,1733530192.165864,-21600,EB445137-D7F5-57EC-87DA-1DB460D64046,"iPhone13,2"
com.google.Sheets,42,1733530116,1733530158,1733530158.433434,-21600,EB445137-D7F5-57EC-87DA-1DB460D64046,"iPhone13,2"
com.tinyspeck.chatlyio,9,1733530107,1733530116,1733530116.417959,-21600,EB445137-D7F5-57EC-87DA-1DB460D64046,"iPhone13,2"
com.instructure.icanvas,78,1733530023,1733530101,1733530101.88992,-21600,EB445137-D7F5-57EC-87DA-1DB460D64046,"iPhone13,2"
com.apple.Music,3,1733528174,1733528177,1733528177.87015,-21600,EB445137-D7F5-57EC-87DA-1DB460D64046,"iPhone13,2"
com.apple.Music,6,1733527287,1733527293,1733527293.061348,-21600,EB445137-D7F5-57EC-87DA-1DB460D64046,"iPhone13,2"
com.apple.Music,6,1733527053,1733527059,1733527059.680355,-21600,EB445137-D7F5-57EC-87DA-1DB460D64046,"iPhone13,2"
com.apple.Music,40,1733526963,1733527003,1733527003.774904,-21600,EB445137-D7F5-57EC-87DA-1DB460D64046,"iPhone13,2"
com.toyopagroup.picaboo,38,1733525286,1733525324,1733525324.623882,-21600,EB445137-D7F5-57EC-87DA-1DB460D64046,"iPhone13,2"
com.toyopagroup.picaboo,1,1733524812,1733524813,1733524813.922831,-21600,EB445137-D7F5-57EC-87DA-1DB460D64046,"iPhone13,2"
com.toyopagroup.picaboo,10,1733523938,1733523948,1733523948.815738,-21600,EB445137-D7F5-57EC-87DA-1DB460D64046,"iPhone13,2"
com.toyopagroup.picaboo,9,1733523929,1733523938,1733523938.41651,-21600,EB445137-D7F5-57EC-87DA-1DB460D64046,"iPhone13,2"
com.toyopagroup.picaboo,2,1733522896,1733522898,1733522898.386801,-21600,EB445137-D7F5-57EC-87DA-1DB460D64046,"iPhone13,2"
com.toyopagroup.picaboo,48,1733522799,1733522847,1733522847.527349,-21600,EB445137-D7F5-57EC-87DA-1DB460D64046,"iPhone13,2"
com.apple.camera,43,1733522751,1733522794,1733522794.728473,-21600,EB445137-D7F5-57EC-87DA-1DB460D64046,"iPhone13,2"
com.apple.camera,11,1733522625,1733522636,1733522637.4158192,-21600,EB445137-D7F5-57EC-87DA-1DB460D64046,"iPhone13,2"
com.microsoft.Office.Outlook,17,1733522620,1733522637,1733522638.255278,-21600,EB445137-D7F5-57EC-87DA-1DB460D64046,"iPhone13,2"
com.microsoft.Office.Outlook,2,1733522586,1733522588,1733522588.387299,-21600,EB445137-D7F5-57EC-87DA-1DB460D64046,"iPhone13,2"
com.microsoft.Office.Outlook,2,1733522275,1733522277,1733522277.934484,-21600,EB445137-D7F5-57EC-87DA-1DB460D64046,"iPhone13,2"
com.microsoft.Office.Outlook,27,1733522241,1733522268,1733522268.8079891,-21600,EB445137-D7F5-57EC-87DA-1DB460D64046,"iPhone13,2"
com.microsoft.Office.Outlook,29,1733521882,1733521911,1733521911.8506231,-21600,EB445137-D7F5-57EC-87DA-1DB460D64046,"iPhone13,2"
com.toyopagroup.picaboo,49,1733521822,1733521871,1733521871.892678,-21600,EB445137-D7F5-57EC-87DA-1DB460D64046,"iPhone13,2"
com.apple.MobileSMS,3,1733521819,1733521822,1733521823.024024,-21600,EB445137-D7F5-57EC-87DA-1DB460D64046,"iPhone13,2"
com.apple.MobileSMS,64,1733521713,1733521777,1733521777.439117,-21600,EB445137-D7F5-57EC-87DA-1DB460D64046,"iPhone13,2"
com.google.Docs,2,1733521711,1733521713,1733521714.014523,-21600,EB445137-D7F5-57EC-87DA-1DB460D64046,"iPhone13,2"
com.google.Chrome,98,1733519490,1733519588,1733519588.8864589,-21600,,
com.leomehlig.today,34,1733519456,1733519490,1733519490.220284,-21600,,
com.google.Docs,64,1733519318,1733519382,1733519382.79569,-21600,EB445137-D7F5-57EC-87DA-1DB460D64046,"iPhone13,2"
com.google.Docs,33,1733519273,1733519306,1733519306.936864,-21600,EB445137-D7F5-57EC-87DA-1DB460D64046,"iPhone13,2"
com.google.Chrome,199,1733519257,1733519456,1733519456.2202659,-21600,,
com.apple.finder,2,1733519255,1733519257,1733519257.498355,-21600,,
com.apple.mobileslideshow,37,1733519235,1733519272,1733519272.6010718,-21600,EB445137-D7F5-57EC-87DA-1DB460D64046,"iPhone13,2"
com.apple.MobileSMS,8,1733519179,1733519187,1733519187.464088,-21600,EB445137-D7F5-57EC-87DA-1DB460D64046,"iPhone13,2"
com.apple.camera,24,1733519155,1733519179,1733519179.439746,-21600,EB445137-D7F5-57EC-87DA-1DB460D64046,"iPhone13,2"
com.hammerandchisel.discord,5,1733519143,1733519148,1733519148.781923,-21600,EB445137-D7F5-57EC-87DA-1DB460D64046,"iPhone13,2"
com.apple.MobileSMS,2,1733519141,1733519143,1733519143.447875,-21600,EB445137-D7F5-57EC-87DA-1DB460D64046,"iPhone13,2"
com.google.Chrome,893,1733518362,1733519255,1733519255.4429731,-21600,,
com.leomehlig.today,53,1733518296,1733518349,1733518350.724718,-21600,,
com.apple.MobileSMS,6,1733517594,1733517600,1733517600.528113,-21600,EB445137-D7F5-57EC-87DA-1DB460D64046,"iPhone13,2"
com.apple.MobileSMS,1,1733517249,1733517250,1733517250.605795,-21600,EB445137-D7F5-57EC-87DA-1DB460D64046,"iPhone13,2"
com.apple.MobileSMS,17,1733517014,1733517031,1733517032.082681,-21600,EB445137-D7F5-57EC-87DA-1DB460D64046,"iPhone13,2"
com.apple.MobileSMS,23,1733516968,1733516991,1733516991.61817,-21600,EB445137-D7F5-57EC-87DA-1DB460D64046,"iPhone13,2"
com.google.Gmail,8,1733516960,1733516968,1733516969.2445378,-21600,EB445137-D7F5-57EC-87DA-1DB460D64046,"iPhone13,2"
com.google.Gmail,10,1733515241,1733515251,1733515252.178016,-21600,EB445137-D7F5-57EC-87DA-1DB460D64046,"iPhone13,2"
com.letterboxd.LetterboxdApp,2,1733515239,1733515241,1733515241.3395529,-21600,EB445137-D7F5-57EC-87DA-1DB460D64046,"iPhone13,2"
com.google.chrome.ios,40,1733515199,1733515239,1733515239.510806,-21600,EB445137-D7F5-57EC-87DA-1DB460D64046,"iPhone13,2"
com.letterboxd.LetterboxdApp,2,1733515197,1733515199,1733515199.9370399,-21600,EB445137-D7F5-57EC-87DA-1DB460D64046,"iPhone13,2"
com.google.Gmail,54,1733515143,1733515197,1733515197.627431,-21600,EB445137-D7F5-57EC-87DA-1DB460D64046,"iPhone13,2"
com.google.Gmail,6,1733514762,1733514768,1733514768.4240432,-21600,EB445137-D7F5-57EC-87DA-1DB460D64046,"iPhone13,2"
com.amazon.Amazon,25,1733514737,1733514762,1733514762.4897718,-21600,EB445137-D7F5-57EC-87DA-1DB460D64046,"iPhone13,2"
com.apple.Preferences,0,1733514736,1733514736,1733514736.723709,-21600,EB445137-D7F5-57EC-87DA-1DB460D64046,"iPhone13,2"
com.amazon.Amazon,2,1733514734,1733514736,1733514736.696972,-21600,EB445137-D7F5-57EC-87DA-1DB460D64046,"iPhone13,2"
com.amazon.Amazon,32,1733514702,1733514734,1733514736.4128618,-21600,EB445137-D7F5-57EC-87DA-1DB460D64046,"iPhone13,2"
com.google.Gmail,13,1733514689,1733514702,1733514702.191412,-21600,EB445137-D7F5-57EC-87DA-1DB460D64046,"iPhone13,2"
com.amazon.Amazon,2,1733514686,1733514688,1733514689.181272,-21600,EB445137-D7F5-57EC-87DA-1DB460D64046,"iPhone13,2"
com.amazon.Amazon,36,1733514386,1733514422,1733514422.7953072,-21600,EB445137-D7F5-57EC-87DA-1DB460D64046,"iPhone13,2"
com.google.chrome.ios,47,1733514048,1733514095,1733514095.7390242,-21600,EB445137-D7F5-57EC-87DA-1DB460D64046,"iPhone13,2"
com.apple.news,2,1733514045,1733514047,1733514047.888307,-21600,EB445137-D7F5-57EC-87DA-1DB460D64046,"iPhone13,2"
com.apple.news,2,1733513879,1733513881,1733513881.162473,-21600,EB445137-D7F5-57EC-87DA-1DB460D64046,"iPhone13,2"
com.apple.news,37,1733513617,1733513654,1733513654.913908,-21600,EB445137-D7F5-57EC-87DA-1DB460D64046,"iPhone13,2"
com.apple.Music,5,1733513605,1733513610,1733513610.532254,-21600,EB445137-D7F5-57EC-87DA-1DB460D64046,"iPhone13,2"
com.apple.Music,4,1733513600,1733513604,1733513604.354795,-21600,EB445137-D7F5-57EC-87DA-1DB460D64046,"iPhone13,2"
com.apple.Music,10,1733512766,1733512776,1733512776.8942761,-21600,EB445137-D7F5-57EC-87DA-1DB460D64046,"iPhone13,2"
com.apple.Music,2,1733512737,1733512739,1733512739.499258,-21600,EB445137-D7F5-57EC-87DA-1DB460D64046,"iPhone13,2"
com.apple.Music,10,1733512657,1733512667,1733512667.623348,-21600,EB445137-D7F5-57EC-87DA-1DB460D64046,"iPhone13,2"
com.apple.Music,10,1733512467,1733512477,1733512477.177042,-21600,EB445137-D7F5-57EC-87DA-1DB460D64046,"iPhone13,2"
com.apple.Music,17,1733512266,1733512283,1733512283.957777,-21600,EB445137-D7F5-57EC-87DA-1DB460D64046,"iPhone13,2"
com.apple.Music,9,1733511966,1733511975,1733511975.218344,-21600,EB445137-D7F5-57EC-87DA-1DB460D64046,"iPhone13,2"
com.apple.Music,13,1733511952,1733511965,1733511965.593134,-21600,EB445137-D7F5-57EC-87DA-1DB460D64046,"iPhone13,2"
com.apple.Music,20,1733511335,1733511355,1733511355.4937282,-21600,EB445137-D7F5-57EC-87DA-1DB460D64046,"iPhone13,2"
com.google.ios.youtube,391,1733510289,1733510680,1733510680.669285,-21600,EB445137-D7F5-57EC-87DA-1DB460D64046,"iPhone13,2"
com.google.ios.youtube,177,1733510022,1733510199,1733510199.730566,-21600,EB445137-D7F5-57EC-87DA-1DB460D64046,"iPhone13,2"
com.google.ios.youtube,112,1733509571,1733509683,1733509684.121465,-21600,EB445137-D7F5-57EC-87DA-1DB460D64046,"iPhone13,2"
com.apple.mobiletimer,4,1733509567,1733509571,1733509571.3800821,-21600,EB445137-D7F5-57EC-87DA-1DB460D64046,"iPhone13,2"
com.apple.mobiletimer,61,1733509345,1733509406,1733509406.1761909,-21600,EB445137-D7F5-57EC-87DA-1DB460D64046,"iPhone13,2"
com.google.ios.youtube,184,1733509161,1733509345,1733509345.034028,-21600,EB445137-D7F5-57EC-87DA-1DB460D64046,"iPhone13,2"
com.apple.mobiletimer,35,1733509126,1733509161,1733509161.9495091,-21600,EB445137-D7F5-57EC-87DA-1DB460D64046,"iPhone13,2"
com.google.ios.youtube,477,1733508649,1733509126,1733509126.28836,-21600,EB445137-D7F5-57EC-87DA-1DB460D64046,"iPhone13,2"
com.google.ios.youtube,5,1733508643,1733508648,1733508648.941858,-21600,EB445137-D7F5-57EC-87DA-1DB460D64046,"iPhone13,2"
com.google.ios.youtube,203,1733508350,1733508553,1733508554.631608,-21600,EB445137-D7F5-57EC-87DA-1DB460D64046,"iPhone13,2"
com.apple.findmy,9,1733508336,1733508345,1733508346.167237,-21600,EB445137-D7F5-57EC-87DA-1DB460D64046,"iPhone13,2"
com.apple.MobileSMS,3,1733508321,1733508324,1733508324.288846,-21600,EB445137-D7F5-57EC-87DA-1DB460D64046,"iPhone13,2"
com.google.chrome.ios,41,1733507944,1733507985,1733507985.562573,-21600,EB445137-D7F5-57EC-87DA-1DB460D64046,"iPhone13,2"
com.apple.mobiletimer,2,1733507942,1733507944,1733507944.529059,-21600,EB445137-D7F5-57EC-87DA-1DB460D64046,"iPhone13,2"
com.apple.mobiletimer,7,1733507919,1733507926,1733507926.5325608,-21600,EB445137-D7F5-57EC-87DA-1DB460D64046,"iPhone13,2"
com.lafitness.lafitness,46,1733507599,1733507645,1733507645.084982,-21600,EB445137-D7F5-57EC-87DA-1DB460D64046,"iPhone13,2"
com.apple.Preferences,44,1733507553,1733507597,1733507598.168751,-21600,EB445137-D7F5-57EC-87DA-1DB460D64046,"iPhone13,2"
com.microsoft.Office.Outlook,19,1733507529,1733507548,1733507548.655134,-21600,EB445137-D7F5-57EC-87DA-1DB460D64046,"iPhone13,2"
com.apple.MobileSMS,10,1733507517,1733507527,1733507527.041673,-21600,EB445137-D7F5-57EC-87DA-1DB460D64046,"iPhone13,2"
com.apple.news,152,1733507365,1733507517,1733507517.950859,-21600,EB445137-D7F5-57EC-87DA-1DB460D64046,"iPhone13,2"
com.apple.MobileSMS,17,1733507348,1733507365,1733507365.3460078,-21600,EB445137-D7F5-57EC-87DA-1DB460D64046,"iPhone13,2"
com.apple.news,7,1733507335,1733507342,1733507342.153095,-21600,EB445137-D7F5-57EC-87DA-1DB460D64046,"iPhone13,2"
com.apple.news,61,1733507262,1733507323,1733507323.881205,-21600,EB445137-D7F5-57EC-87DA-1DB460D64046,"iPhone13,2"
com.apple.MobileSMS,4,1733507258,1733507262,1733507262.944919,-21600,EB445137-D7F5-57EC-87DA-1DB460D64046,"iPhone13,2"
com.apple.Passwords,6,1733507251,1733507257,1733507257.599946,-21600,EB445137-D7F5-57EC-87DA-1DB460D64046,"iPhone13,2"
com.apple.Passwords,16,1733507216,1733507232,1733507232.590629,-21600,EB445137-D7F5-57EC-87DA-1DB460D64046,"iPhone13,2"
com.leomehlig.today,17,1733507174,1733507191,1733507191.770292,-21600,,
com.google.Chrome,3,1733507171,1733507174,1733507174.843871,-21600,,
com.apple.Passwords,6,1733504162,1733504168,1733504168.950819,-21600,EB445137-D7F5-57EC-87DA-1DB460D64046,"iPhone13,2"
com.apple.Passwords,1,1733504123,1733504124,1733504124.4373012,-21600,EB445137-D7F5-57EC-87DA-1DB460D64046,"iPhone13,2"
com.apple.Passwords,22,1733504099,1733504121,1733504122.832903,-21600,EB445137-D7F5-57EC-87DA-1DB460D64046,"iPhone13,2"
com.apple.news,2,1733504092,1733504094,1733504095.0745192,-21600,EB445137-D7F5-57EC-87DA-1DB460D64046,"iPhone13,2"
com.apple.news,52,1733500958,1733501010,1733501011.2283158,-21600,EB445137-D7F5-57EC-87DA-1DB460D64046,"iPhone13,2"
com.microsoft.Office.Outlook,2,1733500932,1733500934,1733500934.157443,-21600,EB445137-D7F5-57EC-87DA-1DB460D64046,"iPhone13,2"
com.microsoft.Office.Outlook,30,1733500901,1733500931,1733500931.1981301,-21600,EB445137-D7F5-57EC-87DA-1DB460D64046,"iPhone13,2"
com.apple.MobileSMS,4,1733500896,1733500900,1733500900.193406,-21600,EB445137-D7F5-57EC-87DA-1DB460D64046,"iPhone13,2"
com.toyopagroup.picaboo,10,1733500885,1733500895,1733500895.639694,-21600,EB445137-D7F5-57EC-87DA-1DB460D64046,"iPhone13,2"
com.instructure.icanvas,21,1733500855,1733500876,1733500876.66733,-21600,EB445137-D7F5-57EC-87DA-1DB460D64046,"iPhone13,2"
com.microsoft.Office.Outlook,106,1733499799,1733499905,1733499905.115765,-21600,EB445137-D7F5-57EC-87DA-1DB460D64046,"iPhone13,2"
com.google.Gmail,26,1733499765,1733499791,1733499791.352427,-21600,EB445137-D7F5-57EC-87DA-1DB460D64046,"iPhone13,2"
com.renpho.health,9,1733499756,1733499765,1733499766.118733,-21600,EB445137-D7F5-57EC-87DA-1DB460D64046,"iPhone13,2"
com.renpho.health,77,1733498920,1733498997,1733498997.188733,-21600,EB445137-D7F5-57EC-87DA-1DB460D64046,"iPhone13,2"
com.apple.Health,54,1733464641,1733464695,1733464695.873654,-21600,EB445137-D7F5-57EC-87DA-1DB460D64046,"iPhone13,2"
com.google.chrome.ios,1,1733464640,1733464641,1733464642.005964,-21600,EB445137-D7F5-57EC-87DA-1DB460D64046,"iPhone13,2"
com.google.Chrome,189,1733464226,1733464415,1733464415.144903,-21600,,
com.leomehlig.today,98,1733464128,1733464226,1733464226.192389,-21600,,
com.google.Chrome,420,1733463708,1733464128,1733464128.5198379,-21600,,
com.google.Chrome,323,1733463120,1733463443,1733463443.183245,-21600,,
com.google.Chrome,1045,1733461778,1733462823,1733462823.988225,-21600,,
com.google.Chrome,316,1733461279,1733461595,1733461595.986085,-21600,,
com.google.Chrome,484,1733460620,1733461104,1733461104.404224,-21600,,
com.leomehlig.today,2,1733460618,1733460620,1733460620.531715,-21600,,
com.google.chrome.ios,12,1733460591,1733460603,1733460603.161233,-21600,EB445137-D7F5-57EC-87DA-1DB460D64046,"iPhone13,2"
com.google.chrome.ios,30,1733458961,1733458991,1733458991.791424,-21600,EB445137-D7F5-57EC-87DA-1DB460D64046,"iPhone13,2"
com.hammerandchisel.discord,5,1733458956,1733458961,1733458961.577434,-21600,EB445137-D7F5-57EC-87DA-1DB460D64046,"iPhone13,2"
com.hammerandchisel.discord,8,1733458741,1733458749,1733458749.304873,-21600,EB445137-D7F5-57EC-87DA-1DB460D64046,"iPhone13,2"
com.hammerandchisel.discord,84,1733458506,1733458590,1733458591.477426,-21600,EB445137-D7F5-57EC-87DA-1DB460D64046,"iPhone13,2"
com.apple.weather,11,1733458494,1733458505,1733458505.368321,-21600,EB445137-D7F5-57EC-87DA-1DB460D64046,"iPhone13,2"
com.apple.Health,70,1733458416,1733458486,1733458486.629058,-21600,EB445137-D7F5-57EC-87DA-1DB460D64046,"iPhone13,2"
com.apple.Music,85,1733458267,1733458352,1733458352.1128712,-21600,EB445137-D7F5-57EC-87DA-1DB460D64046,"iPhone13,2"
com.apple.Music,2,1733456779,1733456781,1733456781.691822,-21600,EB445137-D7F5-57EC-87DA-1DB460D64046,"iPhone13,2"
com.apple.Music,1,1733456138,1733456139,1733456139.514042,-21600,EB445137-D7F5-57EC-87DA-1DB460D64046,"iPhone13,2"
com.apple.Music,4,1733456116,1733456120,1733456120.107831,-21600,EB445137-D7F5-57EC-87DA-1DB460D64046,"iPhone13,2"
com.apple.Music,5,1733455425,1733455430,1733455430.731621,-21600,EB445137-D7F5-57EC-87DA-1DB460D64046,"iPhone13,2"
com.apple.Music,16,1733454986,1733455002,1733455003.151637,-21600,EB445137-D7F5-57EC-87DA-1DB460D64046,"iPhone13,2"
com.google.chrome.ios,10,1733454942,1733454952,1733454952.842085,-21600,EB445137-D7F5-57EC-87DA-1DB460D64046,"iPhone13,2"
com.apple.news,2,1733454939,1733454941,1733454941.988591,-21600,EB445137-D7F5-57EC-87DA-1DB460D64046,"iPhone13,2"
com.instructure.icanvas,6,1733454896,1733454902,1733454902.974313,-21600,EB445137-D7F5-57EC-87DA-1DB460D64046,"iPhone13,2"
com.instructure.icanvas,9,1733454339,1733454348,1733454348.899739,-21600,EB445137-D7F5-57EC-87DA-1DB460D64046,"iPhone13,2"
com.toyopagroup.picaboo,4,1733453442,1733453446,1733453446.64417,-21600,EB445137-D7F5-57EC-87DA-1DB460D64046,"iPhone13,2"
com.instructure.icanvas,3,1733453439,1733453442,1733453442.980279,-21600,EB445137-D7F5-57EC-87DA-1DB460D64046,"iPhone13,2"
com.leomehlig.today,20,1733453265,1733453285,1733453285.051101,-21600,,
com.apple.finder,1,1733453264,1733453265,1733453265.469075,-21600,,
com.microsoft.Excel,239,1733453025,1733453264,1733453264.494079,-21600,,
com.apple.calculator,87,1733452938,1733453025,1733453025.4767451,-21600,,
com.microsoft.Excel,112,1733452826,1733452938,1733452938.784953,-21600,,
com.apple.finder,7,1733452819,1733452826,1733452826.4954848,-21600,,
com.leomehlig.today,12,1733452807,1733452819,1733452819.218629,-21600,,
com.apple.finder,78,1733452729,1733452807,1733452807.579375,-21600,,
com.leomehlig.today,3,1733452726,1733452729,1733452729.755763,-21600,,
com.google.Chrome,117,1733452609,1733452726,1733452726.9372869,-21600,,
com.instructure.icanvas,16,1733452576,1733452592,1733452592.129024,-21600,EB445137-D7F5-57EC-87DA-1DB460D64046,"iPhone13,2"
com.apple.Photos,1,1733452438,1733452439,1733452439.276376,-21600,,
com.instructure.icanvas,73,1733452423,1733452496,1733452497.016736,-21600,EB445137-D7F5-57EC-87DA-1DB460D64046,"iPhone13,2"
com.toyopagroup.picaboo,36,1733452381,1733452417,1733452417.056113,-21600,EB445137-D7F5-57EC-87DA-1DB460D64046,"iPhone13,2"
com.leomehlig.today,60,1733452378,1733452438,1733452438.849049,-21600,,
com.google.Chrome,9,1733452369,1733452378,1733452378.626852,-21600,,
com.apple.finder,2,1733452367,1733452369,1733452369.065899,-21600,,
com.microsoft.VSCode,135,1733452232,1733452367,1733452367.874775,-21600,,
com.apple.finder,2,1733452230,1733452232,1733452232.41393,-21600,,
com.leomehlig.today,1,1733452229,1733452230,1733452230.510767,-21600,,
com.microsoft.VSCode,78,1733452151,1733452229,1733452229.08949,-21600,,
com.leomehlig.today,4,1733452147,1733452151,1733452151.364376,-21600,,
com.microsoft.Excel,28,1733452119,1733452147,1733452147.554018,-21600,,
com.leomehlig.today,10,1733452109,1733452119,1733452120.074079,-21600,,
com.microsoft.Excel,22,1733452087,1733452109,1733452109.716144,-21600,,
com.leomehlig.today,24,1733452063,1733452087,1733452087.10117,-21600,,
com.microsoft.Excel,0,1733452063,1733452063,1733452063.8599901,-21600,,
com.leomehlig.today,2,1733452061,1733452063,1733452063.3961759,-21600,,
com.microsoft.Excel,1,1733452060,1733452061,1733452061.271926,-21600,,
com.leomehlig.today,4,1733452056,1733452060,1733452060.665358,-21600,,
com.microsoft.Excel,2,1733452054,1733452056,1733452056.503187,-21600,,
com.leomehlig.today,1,1733452053,1733452054,1733452054.8841438,-21600,,
com.microsoft.Excel,2,1733452051,1733452053,1733452053.965591,-21600,,
com.leomehlig.today,5,1733452046,1733452051,1733452051.2216759,-21600,,
com.microsoft.Excel,3,1733452043,1733452046,1733452046.137152,-21600,,
com.leomehlig.today,5,1733452038,1733452043,1733452043.875958,-21600,,
com.microsoft.Excel,13,1733452025,1733452038,1733452038.9982948,-21600,,
com.apple.finder,24,1733452001,1733452025,1733452025.444755,-21600,,
com.leomehlig.today,27,1733451974,1733452001,1733452001.1600099,-21600,,
com.leomehlig.today,6,1733451933,1733451939,1733451939.835757,-21600,,
com.leomehlig.today,24,1733451644,1733451668,1733451669.027106,-21600,,
com.apple.MobileSMS,3,1733451641,1733451644,1733451644.086901,-21600,,
com.leomehlig.today,2,1733451639,1733451641,1733451641.5429049,-21600,,
com.microsoft.VSCode,7,1733451632,1733451639,1733451639.928266,-21600,,
com.google.Chrome,20,1733451612,1733451632,1733451633.255105,-21600,,
com.leomehlig.today,234,1733451378,1733451612,1733451612.413718,-21600,,
com.toyopagroup.picaboo,62,1733451257,1733451319,1733451319.6192122,-21600,EB445137-D7F5-57EC-87DA-1DB460D64046,"iPhone13,2"
com.apple.news,2,1733451255,1733451257,1733451258.202297,-21600,EB445137-D7F5-57EC-87DA-1DB460D64046,"iPhone13,2"
com.google.Chrome,162,1733451216,1733451378,1733451378.1251311,-21600,,
com.microsoft.VSCode,34,1733451182,1733451216,1733451216.380611,-21600,,
com.apple.MobileSMS,17,1733451165,1733451182,1733451182.110606,-21600,,
com.microsoft.VSCode,103,1733451062,1733451165,1733451165.1910539,-21600,,
com.google.Chrome,2,1733451060,1733451062,1733451062.051423,-21600,,
com.microsoft.VSCode,5,1733451055,1733451060,1733451060.484643,-21600,,
com.google.Chrome,4,1733451051,1733451055,1733451055.675644,-21600,,
com.microsoft.VSCode,55,1733450996,1733451051,1733451051.9482532,-21600,,
com.google.Chrome,1,1733450995,1733450996,1733450996.6800451,-21600,,
com.leomehlig.today,2,1733450993,1733450995,1733450995.4754062,-21600,,
com.google.Chrome,17,1733450976,1733450993,1733450993.988194,-21600,,
com.leomehlig.today,1,1733450975,1733450976,1733450976.69577,-21600,,
com.microsoft.VSCode,104,1733450871,1733450975,1733450975.8242512,-21600,,
com.google.Chrome,2,1733450869,1733450871,1733450871.644242,-21600,,
com.microsoft.VSCode,5,1733450864,1733450869,1733450869.747572,-21600,,
com.google.Chrome,6,1733450858,1733450864,1733450864.46272,-21600,,
com.microsoft.VSCode,30,1733450828,1733450858,1733450858.044715,-21600,,
com.google.Chrome,1,1733450827,1733450828,1733450828.206841,-21600,,
com.microsoft.VSCode,9,1733450818,1733450827,1733450827.6383781,-21600,,
com.google.Chrome,1,1733450817,1733450818,1733450818.397636,-21600,,
com.microsoft.VSCode,8,1733450809,1733450817,1733450817.202929,-21600,,
com.google.Chrome,7,1733450802,1733450809,1733450809.8555179,-21600,,
com.microsoft.VSCode,198,1733450604,1733450802,1733450802.422992,-21600,,
com.google.Chrome,5,1733450599,1733450604,1733450604.485975,-21600,,
com.microsoft.VSCode,190,1733450409,1733450599,1733450599.6834211,-21600,,
com.google.Chrome,18,1733450391,1733450409,1733450409.233694,-21600,,
com.microsoft.VSCode,114,1733450277,1733450391,1733450391.201367,-21600,,
com.google.Chrome,4,1733450273,1733450277,1733450277.162586,-21600,,
com.microsoft.VSCode,19,1733450254,1733450273,1733450273.904875,-21600,,
com.google.Chrome,8,1733450246,1733450254,1733450254.4185581,-21600,,
com.microsoft.VSCode,281,1733449965,1733450246,1733450246.441087,-21600,,
com.google.Chrome,6,1733449959,1733449965,1733449965.790261,-21600,,
com.microsoft.VSCode,1,1733449958,1733449959,1733449959.772427,-21600,,
com.google.Chrome,1,1733449957,1733449958,1733449959.00189,-21600,,
com.microsoft.VSCode,33,1733449924,1733449957,1733449957.918347,-21600,,
com.google.Chrome,14,1733449910,1733449924,1733449924.234192,-21600,,
com.microsoft.VSCode,27,1733449883,1733449910,1733449910.381726,-21600,,
com.google.Chrome,0,1733449883,1733449883,1733449883.9717731,-21600,,
com.microsoft.VSCode,10,1733449873,1733449883,1733449883.23687,-21600,,
com.google.Chrome,7,1733449866,1733449873,1733449873.524548,-21600,,
com.microsoft.VSCode,2,1733449864,1733449866,1733449866.904742,-21600,,
com.google.Chrome,5,1733449859,1733449864,1733449864.795486,-21600,,
com.microsoft.VSCode,10,1733449849,1733449859,1733449859.286375,-21600,,
com.google.Chrome,26,1733449823,1733449849,1733449849.75776,-21600,,
com.microsoft.VSCode,6,1733449817,1733449823,1733449823.101713,-21600,,
com.google.Chrome,3,1733449814,1733449817,1733449817.4851131,-21600,,
com.microsoft.VSCode,18,1733449796,1733449814,1733449814.942991,-21600,,
com.google.Chrome,1,1733449795,1733449796,1733449796.591998,-21600,,
com.microsoft.VSCode,5,1733449790,1733449795,1733449795.921918,-21600,,
com.google.Chrome,10,1733449780,1733449790,1733449790.256271,-21600,,
com.microsoft.VSCode,1,1733449779,1733449780,1733449780.169117,-21600,,
com.google.Chrome,0,1733449779,1733449779,1733449779.633831,-21600,,
com.microsoft.VSCode,9,1733449770,1733449779,1733449779.098538,-21600,,
com.google.Chrome,2,1733449768,1733449770,1733449770.39838,-21600,,
com.microsoft.VSCode,18,1733449750,1733449768,1733449768.269959,-21600,,
com.google.Chrome,3,1733449747,1733449750,1733449750.978002,-21600,,
com.microsoft.VSCode,2,1733449745,1733449747,1733449747.843353,-21600,,
com.google.Chrome,2,1733449743,1733449745,1733449746.06812,-21600,,
com.microsoft.VSCode,2,1733449741,1733449743,1733449743.8504791,-21600,,
com.google.Chrome,9,1733449732,1733449741,1733449741.430234,-21600,,
com.microsoft.VSCode,8,1733449724,1733449732,1733449732.4971728,-21600,,
com.google.Chrome,8,1733449716,1733449724,1733449724.43286,-21600,,
com.microsoft.VSCode,11,1733449705,1733449716,1733449716.974973,-21600,,
com.google.Chrome,2,1733449703,1733449705,1733449705.0719938,-21600,,
com.microsoft.VSCode,12,1733449691,1733449703,1733449703.642177,-21600,,
com.google.Chrome,1,1733449690,1733449691,1733449691.846437,-21600,,
com.microsoft.VSCode,2,1733449688,1733449690,1733449690.574791,-21600,,
com.google.Chrome,1,1733449687,1733449688,1733449688.813086,-21600,,
com.microsoft.VSCode,1,1733449686,1733449687,1733449687.938551,-21600,,
com.google.Chrome,4,1733449682,1733449686,1733449686.5851212,-21600,,
com.microsoft.VSCode,12,1733449670,1733449682,1733449682.404367,-21600,,
com.google.Chrome,1,1733449669,1733449670,1733449670.722359,-21600,,
com.microsoft.VSCode,8,1733449661,1733449669,1733449669.149183,-21600,,
com.google.Chrome,7,1733449654,1733449661,1733449661.53975,-21600,,
com.microsoft.VSCode,2,1733449652,1733449654,1733449654.712517,-21600,,
com.google.Chrome,2,1733449650,1733449652,1733449652.4947891,-21600,,
com.microsoft.VSCode,45,1733449605,1733449650,1733449650.473222,-21600,,
com.google.Chrome,2,1733449603,1733449605,1733449605.1795511,-21600,,
com.microsoft.VSCode,10,1733449593,1733449603,1733449603.980503,-21600,,
com.google.Chrome,3,1733449590,1733449593,1733449593.285747,-21600,,
com.microsoft.VSCode,2,1733449588,1733449590,1733449590.829752,-21600,,
com.google.Chrome,2,1733449586,1733449588,1733449588.184479,-21600,,
com.microsoft.VSCode,11,1733449575,1733449586,1733449586.9296432,-21600,,
com.google.Chrome,20,1733449555,1733449575,1733449575.9592571,-21600,,
com.microsoft.VSCode,56,1733449499,1733449555,1733449555.288406,-21600,,
com.google.Chrome,6,1733449493,1733449499,1733449499.689415,-21600,,
com.microsoft.VSCode,2,1733449491,1733449493,1733449493.0384479,-21600,,
com.google.Chrome,0,1733449491,1733449491,1733449491.721976,-21600,,
com.microsoft.VSCode,6,1733449485,1733449491,1733449491.177166,-21600,,
com.google.Chrome,2,1733449483,1733449485,1733449485.548582,-21600,,
com.microsoft.VSCode,6,1733449477,1733449483,1733449483.251668,-21600,,
com.google.Chrome,3,1733449474,1733449477,1733449477.111625,-21600,,
com.microsoft.VSCode,6,1733449468,1733449474,1733449474.3481212,-21600,,
com.google.Chrome,0,1733449468,1733449468,1733449469.039015,-21600,,
com.microsoft.VSCode,1,1733449467,1733449468,1733449468.400065,-21600,,
com.google.Chrome,2,1733449465,1733449467,1733449467.360882,-21600,,
com.microsoft.VSCode,21,1733449444,1733449465,1733449465.306201,-21600,,
com.google.Chrome,15,1733449429,1733449444,1733449444.7180781,-21600,,
com.microsoft.VSCode,3,1733449426,1733449429,1733449429.443266,-21600,,
com.google.Chrome,2,1733449424,1733449426,1733449426.196333,-21600,,
com.microsoft.VSCode,3,1733449421,1733449424,1733449424.4670281,-21600,,
com.google.Chrome,1,1733449420,1733449421,1733449422.0138922,-21600,,
com.microsoft.VSCode,4,1733449416,1733449420,1733449420.587685,-21600,,
com.google.Chrome,9,1733449407,1733449416,1733449416.6652842,-21600,,
com.microsoft.VSCode,5,1733449402,1733449407,1733449407.890594,-21600,,
com.google.Chrome,2,1733449400,1733449402,1733449402.129098,-21600,,
com.microsoft.VSCode,12,1733449388,1733449400,1733449400.1186671,-21600,,
com.google.Chrome,4,1733449384,1733449388,1733449388.158704,-21600,,
com.microsoft.VSCode,7,1733449377,1733449384,1733449384.127046,-21600,,
com.google.Chrome,3,1733449374,1733449377,1733449377.052012,-21600,,
com.microsoft.VSCode,2,1733449372,1733449374,1733449374.530148,-21600,,
com.google.Chrome,6,1733449366,1733449372,1733449372.991049,-21600,,
com.microsoft.VSCode,11,1733449355,1733449366,1733449366.041359,-21600,,
com.google.Chrome,3,1733449352,1733449355,1733449355.212234,-21600,,
com.microsoft.VSCode,8,1733449344,1733449352,1733449352.926354,-21600,,
com.google.Chrome,5,1733449339,1733449344,1733449344.5617871,-21600,,
com.microsoft.VSCode,38,1733449301,1733449339,1733449339.2059631,-21600,,
com.google.Chrome,13,1733449288,1733449301,1733449301.991867,-21600,,
com.microsoft.VSCode,16,1733449272,1733449288,1733449288.0371752,-21600,,
com.google.Chrome,1,1733449271,1733449272,1733449273.010446,-21600,,
com.microsoft.VSCode,13,1733449258,1733449271,1733449271.060101,-21600,,
com.google.Chrome,10,1733449248,1733449258,1733449258.1939769,-21600,,
com.microsoft.VSCode,6,1733449242,1733449248,1733449248.7515888,-21600,,
com.google.Chrome,1,1733449241,1733449242,1733449242.2532191,-21600,,
com.microsoft.VSCode,20,1733449221,1733449241,1733449241.613068,-21600,,
com.google.Chrome,52,1733449169,1733449221,1733449221.76845,-21600,,
com.apple.iCal,3,1733449166,1733449169,1733449169.754599,-21600,,
com.microsoft.Outlook,218,1733448948,1733449166,1733449166.736014,-21600,,
com.apple.iCal,4,1733448944,1733448948,1733448948.339577,-21600,,
com.microsoft.Outlook,4,1733448940,1733448944,1733448945.021649,-21600,,
com.apple.iCal,3,1733448937,1733448940,1733448940.610865,-21600,,
com.microsoft.Outlook,18,1733448919,1733448937,1733448937.864898,-21600,,
com.apple.iCal,0,1733448919,1733448919,1733448920.012751,-21600,,
com.microsoft.Outlook,14,1733448905,1733448919,1733448919.169495,-21600,,
com.apple.iCal,1,1733448904,1733448905,1733448906.07286,-21600,,
com.microsoft.Outlook,3,1733448901,1733448904,1733448904.5983748,-21600,,
com.apple.iCal,5,1733448896,1733448901,1733448901.66249,-21600,,
com.microsoft.Outlook,55,1733448841,1733448896,1733448896.7637792,-21600,,
com.apple.iCal,16,1733448825,1733448841,1733448841.231967,-21600,,
com.microsoft.Outlook,20,1733448805,1733448825,1733448825.837887,-21600,,
com.apple.iCal,3,1733448802,1733448805,1733448805.38475,-21600,,
com.microsoft.Outlook,2,1733448800,1733448802,1733448802.230667,-21600,,
com.apple.iCal,1,1733448799,1733448800,1733448800.659449,-21600,,
com.microsoft.Outlook,5,1733448794,1733448799,1733448799.427666,-21600,,
com.apple.iCal,5,1733448789,1733448794,1733448794.216484,-21600,,
com.microsoft.Outlook,49,1733448740,1733448789,1733448789.895226,-21600,,
com.apple.iCal,29,1733448711,1733448740,1733448740.881336,-21600,,
com.microsoft.Outlook,4,1733448707,1733448711,1733448711.122045,-21600,,
com.apple.iCal,8,1733448699,1733448707,1733448707.96296,-21600,,
com.microsoft.Outlook,27,1733448672,1733448699,1733448699.346796,-21600,,
com.google.Chrome,59,1733448613,1733448672,1733448672.5350409,-21600,,
com.microsoft.VSCode,1,1733448612,1733448613,1733448613.4795132,-21600,,
com.google.Chrome,10,1733448602,1733448612,1733448612.176831,-21600,,
com.microsoft.VSCode,82,1733448520,1733448602,1733448602.648621,-21600,,
com.leomehlig.today,24,1733448496,1733448520,1733448520.201565,-21600,,
com.google.Chrome,135,1733448361,1733448496,1733448496.699173,-21600,,
com.apple.Terminal,2,1733448359,1733448361,1733448361.612391,-21600,,
com.google.Chrome,292,1733448067,1733448359,1733448359.7334929,-21600,,
com.apple.news,6,1733446993,1733446999,1733446999.362486,-21600,EB445137-D7F5-57EC-87DA-1DB460D64046,"iPhone13,2"
com.apple.news,2,1733446969,1733446971,1733446971.0620341,-21600,EB445137-D7F5-57EC-87DA-1DB460D64046,"iPhone13,2"
com.apple.news,2,1733446966,1733446968,1733446968.510566,-21600,EB445137-D7F5-57EC-87DA-1DB460D64046,"iPhone13,2"
com.apple.news,15,1733446148,1733446163,1733446163.791877,-21600,EB445137-D7F5-57EC-87DA-1DB460D64046,"iPhone13,2"
com.apple.news,3,1733446141,1733446144,1733446144.399272,-21600,EB445137-D7F5-57EC-87DA-1DB460D64046,"iPhone13,2"
com.apple.news,12,1733446126,1733446138,1733446138.235118,-21600,EB445137-D7F5-57EC-87DA-1DB460D64046,"iPhone13,2"
com.apple.news,17,1733446108,1733446125,1733446125.688356,-21600,EB445137-D7F5-57EC-87DA-1DB460D64046,"iPhone13,2"
com.apple.news,5,1733445552,1733445557,1733445557.9946132,-21600,EB445137-D7F5-57EC-87DA-1DB460D64046,"iPhone13,2"
com.google.Chrome,2757,1733444657,1733447414,1733447414.272515,-21600,,
com.leomehlig.today,80,1733444577,1733444657,1733444658.057652,-21600,,
com.google.Chrome,380,1733444197,1733444577,1733444577.853828,-21600,,
com.leomehlig.today,83,1733444114,1733444197,1733444197.291112,-21600,,
com.google.Chrome,11,1733444103,1733444114,1733444114.448542,-21600,,
com.leomehlig.today,12,1733444091,1733444103,1733444103.758879,-21600,,
com.apple.news,52,1733443250,1733443302,1733443302.528276,-21600,EB445137-D7F5-57EC-87DA-1DB460D64046,"iPhone13,2"
com.apple.news,2,1733443247,1733443249,1733443249.37785,-21600,EB445137-D7F5-57EC-87DA-1DB460D64046,"iPhone13,2"
com.apple.news,144,1733443100,1733443244,1733443244.917748,-21600,EB445137-D7F5-57EC-87DA-1DB460D64046,"iPhone13,2"
com.toyopagroup.picaboo,31,1733443059,1733443090,1733443090.913237,-21600,EB445137-D7F5-57EC-87DA-1DB460D64046,"iPhone13,2"
com.google.Chrome,1200,1733442891,1733444091,1733444091.533844,-21600,,
com.google.Chrome,300,1733442506,1733442806,1733442806.91452,-21600,,
com.leomehlig.today,74,1733442432,1733442506,1733442506.926341,-21600,,
com.google.Chrome,119,1733442313,1733442432,1733442432.32262,-21600,,
com.leomehlig.today,222,1733442091,1733442313,1733442313.2347832,-21600,,
com.apple.finder,9,1733442082,1733442091,1733442091.891835,-21600,,
com.microsoft.Outlook,2,1733442080,1733442082,1733442082.1227012,-21600,,
com.google.Chrome,7,1733442073,1733442080,1733442080.97902,-21600,,
com.microsoft.VSCode,10,1733442063,1733442073,1733442073.977464,-21600,,
com.microsoft.VSCode,97,1733441095,1733441192,1733441193.024139,-21600,,
com.google.Chrome,22,1733441073,1733441095,1733441095.8455958,-21600,,
com.microsoft.VSCode,8,1733441065,1733441073,1733441073.463544,-21600,,
com.google.Chrome,3,1733441062,1733441065,1733441065.706671,-21600,,
com.microsoft.VSCode,17,1733441045,1733441062,1733441062.709753,-21600,,
com.google.Chrome,117,1733440928,1733441045,1733441045.1915889,-21600,,
com.microsoft.VSCode,36,1733440892,1733440928,1733440928.3325229,-21600,,
com.apple.MobileSMS,10,1733440882,1733440892,1733440892.344502,-21600,,
com.google.Chrome,403,1733440479,1733440882,1733440882.9270701,-21600,,
com.apple.finder,52,1733440427,1733440479,1733440479.2557511,-21600,,
com.google.Chrome,14,1733440413,1733440427,1733440427.113072,-21600,,
com.apple.finder,18,1733440395,1733440413,1733440413.665282,-21600,,
com.google.Chrome,358,1733440037,1733440395,1733440395.539442,-21600,,
com.microsoft.VSCode,61,1733439976,1733440037,1733440037.964854,-21600,,
com.google.Chrome,61,1733439915,1733439976,1733439976.383199,-21600,,
com.microsoft.VSCode,401,1733439514,1733439915,1733439915.1369061,-21600,,
com.google.Chrome,45,1733439469,1733439514,1733439514.358408,-21600,,
com.google.Chrome,46,1733439335,1733439381,1733439381.804905,-21600,,
com.microsoft.Outlook,13,1733439317,1733439330,1733439330.774022,-21600,,
com.google.Chrome,174,1733439143,1733439317,1733439317.549928,-21600,,
com.microsoft.VSCode,76,1733439067,1733439143,1733439143.454329,-21600,,
com.google.Chrome,1,1733439066,1733439067,1733439067.7581558,-21600,,
com.google.Chrome,316,1733438711,1733439027,1733439027.957034,-21600,,
com.google.Chrome,674,1733438035,1733438709,1733438709.888215,-21600,,
com.apple.MobileSMS,1,1733438034,1733438035,1733438035.95068,-21600,,
com.google.Chrome,1,1733438033,1733438034,1733438034.548428,-21600,,
com.apple.MobileSMS,2,1733438031,1733438033,1733438033.130076,-21600,,
com.google.Chrome,342,1733437689,1733438031,1733438031.243099,-21600,,
com.microsoft.VSCode,64,1733437625,1733437689,1733437689.644109,-21600,,
com.google.Chrome,75,1733437550,1733437625,1733437625.673946,-21600,,
com.apple.MobileSMS,11,1733437539,1733437550,1733437550.145279,-21600,,
com.google.Chrome,34,1733437505,1733437539,1733437539.290357,-21600,,
com.microsoft.VSCode,35,1733437470,1733437505,1733437505.979354,-21600,,
com.google.Chrome,44,1733437426,1733437470,1733437470.693752,-21600,,
com.microsoft.VSCode,18,1733437408,1733437426,1733437426.8858008,-21600,,
com.apple.finder,16,1733437392,1733437408,1733437408.681285,-21600,,
com.google.Chrome,9,1733437383,1733437392,1733437392.4480162,-21600,,
com.apple.finder,1,1733437382,1733437383,1733437383.606278,-21600,,
com.google.Chrome,5,1733437377,1733437382,1733437382.429285,-21600,,
com.microsoft.VSCode,2,1733437375,1733437377,1733437377.259726,-21600,,
com.google.Chrome,37,1733437338,1733437375,1733437375.975991,-21600,,
com.microsoft.VSCode,39,1733437299,1733437338,1733437338.195578,-21600,,
com.google.Chrome,17,1733437282,1733437299,1733437299.9574652,-21600,,
com.microsoft.VSCode,26,1733437256,1733437282,1733437283.0107388,-21600,,
com.apple.finder,15,1733437241,1733437256,1733437256.7644238,-21600,,
com.microsoft.VSCode,6,1733437235,1733437241,1733437241.6237512,-21600,,
com.google.Chrome,18,1733437217,1733437235,1733437235.904272,-21600,,
com.microsoft.VSCode,133,1733437084,1733437217,1733437217.551861,-21600,,
com.google.Chrome,20,1733437064,1733437084,1733437084.148065,-21600,,
com.microsoft.VSCode,28,1733437036,1733437064,1733437064.6631951,-21600,,
com.google.Chrome,49,1733436987,1733437036,1733437036.1519709,-21600,,
com.microsoft.VSCode,658,1733436329,1733436987,1733436987.615909,-21600,,
com.google.Chrome,10,1733436319,1733436329,1733436329.204752,-21600,,
com.microsoft.VSCode,6,1733436313,1733436319,1733436319.673482,-21600,,
com.google.Chrome,10,1733436303,1733436313,1733436313.096725,-21600,,
com.microsoft.VSCode,199,1733436104,1733436303,1733436303.441817,-21600,,
com.apple.Terminal,6,1733436098,1733436104,1733436104.780645,-21600,,
com.microsoft.VSCode,210,1733435888,1733436098,1733436098.262504,-21600,,
com.google.Chrome,171,1733435717,1733435888,1733435888.382211,-21600,,
com.microsoft.VSCode,112,1733435605,1733435717,1733435717.966299,-21600,,
com.google.Chrome,29,1733435576,1733435605,1733435605.2672,-21600,,
com.microsoft.VSCode,152,1733435424,1733435576,1733435576.5175982,-21600,,
com.google.Chrome,364,1733435060,1733435424,1733435424.218709,-21600,,
com.microsoft.VSCode,23,1733435037,1733435060,1733435060.640458,-21600,,
com.google.Chrome,191,1733434846,1733435037,1733435037.960346,-21600,,
com.microsoft.VSCode,362,1733434484,1733434846,1733434846.925437,-21600,,
com.apple.MobileSMS,1,1733434483,1733434484,1733434484.066574,-21600,,
com.google.Chrome,19,1733434464,1733434483,1733434483.4212918,-21600,,
com.apple.MobileSMS,2,1733434462,1733434464,1733434464.960732,-21600,,
com.google.Chrome,1,1733434461,1733434462,1733434463.0202,-21600,,
com.microsoft.VSCode,9,1733434452,1733434461,1733434461.431236,-21600,,
com.google.Chrome,4,1733434448,1733434452,1733434452.80462,-21600,,
com.microsoft.VSCode,4,1733434444,1733434448,1733434448.313843,-21600,,
com.google.Chrome,8,1733434436,1733434444,1733434444.574678,-21600,,
com.microsoft.VSCode,6,1733434430,1733434436,1733434436.75488,-21600,,
com.google.Chrome,7,1733434423,1733434430,1733434430.565291,-21600,,
com.microsoft.VSCode,13,1733434410,1733434423,1733434423.957989,-21600,,
com.google.Chrome,3,1733434407,1733434410,1733434410.56658,-21600,,
com.microsoft.VSCode,6,1733434401,1733434407,1733434407.889348,-21600,,
com.google.Chrome,6,1733434395,1733434401,1733434401.565628,-21600,,
com.microsoft.VSCode,5,1733434390,1733434395,1733434395.428427,-21600,,
com.google.Chrome,4,1733434386,1733434390,1733434390.516433,-21600,,
com.microsoft.VSCode,6,1733434380,1733434386,1733434386.642354,-21600,,
com.google.Chrome,5,1733434375,1733434380,1733434380.8138108,-21600,,
com.microsoft.VSCode,5,1733434370,1733434375,1733434375.914216,-21600,,
com.google.Chrome,3,1733434367,1733434370,1733434370.280508,-21600,,
com.microsoft.VSCode,1,1733434366,1733434367,1733434367.4083319,-21600,,
com.google.Chrome,0,1733434366,1733434366,1733434366.827046,-21600,,
com.apple.MobileSMS,2,1733434364,1733434366,1733434366.0738301,-21600,,
com.microsoft.VSCode,11,1733434353,1733434364,1733434364.375259,-21600,,
com.apple.MobileSMS,1,1733434352,1733434353,1733434353.991784,-21600,,
com.google.Chrome,27,1733434325,1733434352,1733434352.348151,-21600,,
com.apple.MobileSMS,11,1733434314,1733434325,1733434325.487947,-21600,,
com.toyopagroup.picaboo,2,1733434308,1733434310,1733434311.026365,-21600,EB445137-D7F5-57EC-87DA-1DB460D64046,"iPhone13,2"
com.microsoft.VSCode,240,1733434074,1733434314,1733434314.755518,-21600,,
com.google.Chrome,27,1733434047,1733434074,1733434074.3552961,-21600,,
com.microsoft.VSCode,17,1733434030,1733434047,1733434047.820475,-21600,,
com.google.Chrome,48,1733433982,1733434030,1733434030.911865,-21600,,
com.microsoft.VSCode,207,1733433775,1733433982,1733433982.784384,-21600,,
com.google.Chrome,50,1733433725,1733433775,1733433775.825162,-21600,,
com.apple.iCal,16,1733433709,1733433725,1733433725.939499,-21600,,
com.google.Chrome,18,1733433691,1733433709,1733433709.829776,-21600,,
com.microsoft.VSCode,143,1733433548,1733433691,1733433691.053978,-21600,,
com.google.Chrome,2,1733433546,1733433548,1733433548.107719,-21600,,
com.microsoft.VSCode,39,1733433507,1733433546,1733433546.50738,-21600,,
com.google.Chrome,12,1733433495,1733433507,1733433507.3284302,-21600,,
com.microsoft.VSCode,116,1733433379,1733433495,1733433495.262522,-21600,,
com.google.Chrome,13,1733433366,1733433379,1733433379.485169,-21600,,
com.microsoft.VSCode,7,1733433359,1733433366,1733433366.696208,-21600,,
com.google.Chrome,33,1733433326,1733433359,1733433359.3049932,-21600,,
com.microsoft.VSCode,0,1733433326,1733433326,1733433326.895447,-21600,,
com.google.Chrome,12,1733433314,1733433326,1733433326.2026029,-21600,,
com.microsoft.VSCode,51,1733433263,1733433314,1733433315.018985,-21600,,
com.google.Chrome,8,1733433255,1733433263,1733433263.729836,-21600,,
com.microsoft.VSCode,13,1733433242,1733433255,1733433255.116529,-21600,,
com.google.Chrome,3,1733433239,1733433242,1733433242.621121,-21600,,
com.microsoft.VSCode,8,1733433231,1733433239,1733433239.338634,-21600,,
com.google.Chrome,24,1733433207,1733433231,1733433231.408747,-21600,,
com.microsoft.VSCode,15,1733433192,1733433207,1733433207.226037,-21600,,
com.google.Chrome,140,1733433052,1733433192,1733433192.851393,-21600,,
com.toyopagroup.picaboo,14,1733433020,1733433034,1733433034.7270741,-21600,EB445137-D7F5-57EC-87DA-1DB460D64046,"iPhone13,2"
com.microsoft.VSCode,154,1733432898,1733433052,1733433052.088107,-21600,,
com.google.Chrome,2,1733432896,1733432898,1733432898.7861009,-21600,,
com.microsoft.VSCode,30,1733432866,1733432896,1733432896.0987039,-21600,,
com.apple.Terminal,31,1733432835,1733432866,1733432866.6297789,-21600,,
com.anaconda.io,34,1733432798,1733432832,1733432832.895774,-21600,,
com.microsoft.VSCode,109,1733432689,1733432798,1733432798.406657,-21600,,
com.google.Chrome,3,1733432686,1733432689,1733432689.467947,-21600,,
com.microsoft.VSCode,1,1733432685,1733432686,1733432686.671592,-21600,,
com.google.Chrome,4,1733432681,1733432685,1733432685.6638532,-21600,,
com.microsoft.VSCode,2,1733432679,1733432681,1733432681.375651,-21600,,
com.google.Chrome,5,1733432674,1733432679,1733432679.209574,-21600,,
com.microsoft.VSCode,6,1733432668,1733432674,1733432674.469073,-21600,,
com.google.Chrome,45,1733432623,1733432668,1733432668.653491,-21600,,
com.microsoft.VSCode,7,1733432616,1733432623,1733432623.925963,-21600,,
com.google.Chrome,20,1733432596,1733432616,1733432616.1436648,-21600,,
com.microsoft.VSCode,25,1733432571,1733432596,1733432596.491105,-21600,,
com.google.Chrome,2,1733432569,1733432571,1733432571.610448,-21600,,
com.microsoft.VSCode,2,1733432567,1733432569,1733432569.1275182,-21600,,
com.google.Chrome,1,1733432566,1733432567,1733432567.9560552,-21600,,
com.microsoft.VSCode,2,1733432564,1733432566,1733432566.999522,-21600,,
com.google.Chrome,1,1733432563,1733432564,1733432564.694716,-21600,,
com.microsoft.VSCode,5,1733432558,1733432563,1733432563.6193419,-21600,,
com.google.Chrome,56,1733432502,1733432558,1733432558.4938731,-21600,,
com.microsoft.VSCode,212,1733432290,1733432502,1733432502.23108,-21600,,
com.google.Chrome,7,1733432283,1733432290,1733432290.323522,-21600,,
com.intsig.CamScannerLite,115,1733431611,1733431726,1733431726.3093948,-21600,EB445137-D7F5-57EC-87DA-1DB460D64046,"iPhone13,2"
com.google.Chrome,279,1733431560,1733431839,1733431839.704598,-21600,,
com.apple.finder,2,1733431558,1733431560,1733431560.7625132,-21600,,
com.apple.mobileslideshow,105,1733431503,1733431608,1733431608.959289,-21600,EB445137-D7F5-57EC-87DA-1DB460D64046,"iPhone13,2"
com.apple.camera,46,1733431457,1733431503,1733431503.5283751,-21600,EB445137-D7F5-57EC-87DA-1DB460D64046,"iPhone13,2"
com.google.Chrome,239,1733431319,1733431558,1733431558.810792,-21600,,
com.apple.camera,73,1733431314,1733431387,1733431387.923956,-21600,EB445137-D7F5-57EC-87DA-1DB460D64046,"iPhone13,2"
com.apple.mobileslideshow,2,1733431311,1733431313,1733431313.732235,-21600,EB445137-D7F5-57EC-87DA-1DB460D64046,"iPhone13,2"
com.leomehlig.today,138,1733431181,1733431319,1733431319.936234,-21600,,
com.google.Chrome,93,1733431088,1733431181,1733431181.98425,-21600,,
com.microsoft.Outlook,78,1733431010,1733431088,1733431088.9973788,-21600,,
com.apple.mobileslideshow,2,1733430984,1733430986,1733430986.325306,-21600,EB445137-D7F5-57EC-87DA-1DB460D64046,"iPhone13,2"
com.apple.mobileslideshow,10,1733430806,1733430816,1733430816.21557,-21600,EB445137-D7F5-57EC-87DA-1DB460D64046,"iPhone13,2"
com.google.Chrome,1349,1733429661,1733431010,1733431010.762114,-21600,,
com.google.Chrome,547,1733428898,1733429445,1733429445.876468,-21600,,
com.google.Chrome,850,1733427997,1733428847,1733428847.341089,-21600,,
com.apple.mobileslideshow,11,1733426860,1733426871,1733426871.2195659,-21600,EB445137-D7F5-57EC-87DA-1DB460D64046,"iPhone13,2"
com.google.Chrome,1572,1733426055,1733427627,1733427627.112073,-21600,,
com.microsoft.Outlook,10,1733426045,1733426055,1733426055.1465812,-21600,,
com.apple.mobileslideshow,6,1733425940,1733425946,1733425946.275806,-21600,EB445137-D7F5-57EC-87DA-1DB460D64046,"iPhone13,2"
com.google.Chrome,133,1733425912,1733426045,1733426045.893753,-21600,,
com.microsoft.Outlook,11,1733425891,1733425902,1733425902.781224,-21600,,
com.google.Chrome,28,1733425863,1733425891,1733425891.97017,-21600,,
com.apple.mobileslideshow,209,1733425548,1733425757,1733425757.5823,-21600,EB445137-D7F5-57EC-87DA-1DB460D64046,"iPhone13,2"
com.apple.MobileSMS,9,1733425515,1733425524,1733425524.033699,-21600,EB445137-D7F5-57EC-87DA-1DB460D64046,"iPhone13,2"
com.apple.mobileslideshow,1,1733425514,1733425515,1733425516.37533,-21600,EB445137-D7F5-57EC-87DA-1DB460D64046,"iPhone13,2"
com.apple.mobileslideshow,144,1733425138,1733425282,1733425282.700012,-21600,EB445137-D7F5-57EC-87DA-1DB460D64046,"iPhone13,2"
com.apple.camera,1,1733425133,1733425134,1733425145.064857,-21600,EB445137-D7F5-57EC-87DA-1DB460D64046,"iPhone13,2"
com.apple.news,88,1733423725,1733423813,1733423813.79192,-21600,EB445137-D7F5-57EC-87DA-1DB460D64046,"iPhone13,2"
com.apple.MobileSMS,12,1733423700,1733423712,1733423712.812906,-21600,EB445137-D7F5-57EC-87DA-1DB460D64046,"iPhone13,2"
com.google.Chrome,300,1733423675,1733423975,1733423975.088461,-21600,,
com.apple.iCal,2,1733423673,1733423675,1733423675.094077,-21600,,
com.apple.MobileSMS,2,1733423671,1733423673,1733423673.325762,-21600,,
com.apple.iCal,13,1733423658,1733423671,1733423671.236011,-21600,,
com.apple.MobileSMS,5,1733423653,1733423658,1733423658.410702,-21600,,
com.apple.iCal,12,1733423641,1733423653,1733423653.613741,-21600,,
com.apple.MobileSMS,5,1733423636,1733423641,1733423641.806885,-21600,,
com.apple.iCal,2,1733423634,1733423636,1733423636.0947418,-21600,,
com.apple.MobileSMS,3,1733423631,1733423634,1733423634.5005279,-21600,,
com.apple.iCal,1,1733423630,1733423631,1733423631.2623029,-21600,,
com.apple.MobileSMS,10,1733423620,1733423630,1733423630.202719,-21600,,
com.apple.iCal,30,1733423590,1733423620,1733423620.1869211,-21600,,
com.google.Chrome,5,1733423585,1733423590,1733423590.137745,-21600,,
com.apple.MobileSMS,2,1733423578,1733423580,1733423580.1634321,-21600,EB445137-D7F5-57EC-87DA-1DB460D64046,"iPhone13,2"
com.apple.MobileSMS,4,1733423557,1733423561,1733423562.050768,-21600,EB445137-D7F5-57EC-87DA-1DB460D64046,"iPhone13,2"
com.thestorygraph.thestorygraph,22,1733423533,1733423555,1733423555.745326,-21600,EB445137-D7F5-57EC-87DA-1DB460D64046,"iPhone13,2"
com.instructure.icanvas,11,1733422224,1733422235,1733422235.931096,-21600,EB445137-D7F5-57EC-87DA-1DB460D64046,"iPhone13,2"
com.apple.Maps,57,1733421440,1733421497,1733421497.437275,-21600,EB445137-D7F5-57EC-87DA-1DB460D64046,"iPhone13,2"
com.microsoft.Office.Outlook,2,1733421433,1733421435,1733421435.849926,-21600,EB445137-D7F5-57EC-87DA-1DB460D64046,"iPhone13,2"
com.microsoft.Office.Outlook,4,1733420593,1733420597,1733420597.699122,-21600,EB445137-D7F5-57EC-87DA-1DB460D64046,"iPhone13,2"
com.google.Chrome,7,1733420586,1733420593,1733420594.2853332,-21600,,
com.leomehlig.today,52,1733420534,1733420586,1733420586.618784,-21600,,
com.microsoft.Office.Outlook,2,1733419636,1733419638,1733419638.138798,-21600,EB445137-D7F5-57EC-87DA-1DB460D64046,"iPhone13,2"
com.microsoft.Office.Outlook,3,1733419598,1733419601,1733419601.92619,-21600,EB445137-D7F5-57EC-87DA-1DB460D64046,"iPhone13,2"
com.microsoft.Office.Outlook,14,1733418371,1733418385,1733418385.059711,-21600,EB445137-D7F5-57EC-87DA-1DB460D64046,"iPhone13,2"
com.google.Chrome,2209,1733418325,1733420534,1733420534.348942,-21600,,
com.leomehlig.today,58,1733418267,1733418325,1733418325.321992,-21600,,
com.google.Chrome,655,1733417612,1733418267,1733418267.4640121,-21600,,
com.apple.MobileSMS,1,1733417611,1733417612,1733417612.620831,-21600,,
com.google.Chrome,56,1733417555,1733417611,1733417611.759666,-21600,,
com.apple.MobileSMS,1,1733417554,1733417555,1733417555.177836,-21600,,
com.google.Chrome,17,1733417537,1733417554,1733417554.244061,-21600,,
com.apple.MobileSMS,1,1733417536,1733417537,1733417537.8868198,-21600,,
com.microsoft.Office.Outlook,13,1733417526,1733417539,1733417539.87285,-21600,EB445137-D7F5-57EC-87DA-1DB460D64046,"iPhone13,2"
com.google.Chrome,18,1733417518,1733417536,1733417536.6638331,-21600,,
com.apple.MobileSMS,21,1733417497,1733417518,1733417518.182053,-21600,,
com.google.Chrome,156,1733417341,1733417497,1733417497.429126,-21600,,
com.leomehlig.today,29,1733417312,1733417341,1733417341.768186,-21600,,
com.google.Chrome,364,1733416948,1733417312,1733417312.631699,-21600,,
com.microsoft.Office.Outlook,15,1733416925,1733416940,1733416940.917182,-21600,EB445137-D7F5-57EC-87DA-1DB460D64046,"iPhone13,2"
com.ally.MobileBanking,3,1733416920,1733416923,1733416923.420568,-21600,EB445137-D7F5-57EC-87DA-1DB460D64046,"iPhone13,2"
com.leomehlig.today,7,1733416889,1733416896,1733416897.7206511,-21600,,
com.ally.MobileBanking,2,1733416738,1733416740,1733416740.148512,-21600,EB445137-D7F5-57EC-87DA-1DB460D64046,"iPhone13,2"
com.ally.MobileBanking,1,1733416470,1733416471,1733416471.1062,-21600,EB445137-D7F5-57EC-87DA-1DB460D64046,"iPhone13,2"
com.ally.MobileBanking,8,1733416417,1733416425,1733416425.199139,-21600,EB445137-D7F5-57EC-87DA-1DB460D64046,"iPhone13,2"
com.ally.MobileBanking,44,1733416162,1733416206,1733416206.964015,-21600,EB445137-D7F5-57EC-87DA-1DB460D64046,"iPhone13,2"
com.google.Gmail,8,1733416153,1733416161,1733416161.411736,-21600,EB445137-D7F5-57EC-87DA-1DB460D64046,"iPhone13,2"
com.amazon.Amazon,19,1733415564,1733415583,1733415583.55336,-21600,EB445137-D7F5-57EC-87DA-1DB460D64046,"iPhone13,2"
com.google.Gmail,13,1733415551,1733415564,1733415565.109816,-21600,EB445137-D7F5-57EC-87DA-1DB460D64046,"iPhone13,2"
com.truebill.truebillnative,49,1733415501,1733415550,1733415550.525027,-21600,EB445137-D7F5-57EC-87DA-1DB460D64046,"iPhone13,2"
com.apple.news,34,1733413951,1733413985,1733413985.399241,-21600,EB445137-D7F5-57EC-87DA-1DB460D64046,"iPhone13,2"
com.apple.news,25,1733413345,1733413370,1733413371.642507,-21600,EB445137-D7F5-57EC-87DA-1DB460D64046,"iPhone13,2"
com.apple.news,263,1733412848,1733413111,1733413111.823835,-21600,EB445137-D7F5-57EC-87DA-1DB460D64046,"iPhone13,2"
com.leomehlig.today,372,1733412753,1733413125,1733413125.315332,-21600,,
com.apple.weather,23,1733412708,1733412731,1733412731.806065,-21600,EB445137-D7F5-57EC-87DA-1DB460D64046,"iPhone13,2"
com.hammerandchisel.discord,201,1733412470,1733412671,1733412671.993336,-21600,EB445137-D7F5-57EC-87DA-1DB460D64046,"iPhone13,2"
com.apple.camera,3,1733412465,1733412468,1733412468.5024939,-21600,EB445137-D7F5-57EC-87DA-1DB460D64046,"iPhone13,2"
com.leomehlig.today,333,1733412416,1733412749,1733412749.963173,-21600,,
com.apple.iCal,41,1733412375,1733412416,1733412416.829887,-21600,,
com.leomehlig.today,6,1733412369,1733412375,1733412375.890033,-21600,,
com.toyopagroup.picaboo,51,1733412085,1733412136,1733412136.6211329,-21600,EB445137-D7F5-57EC-87DA-1DB460D64046,"iPhone13,2"
com.renpho.health,9,1733412076,1733412085,1733412085.811551,-21600,EB445137-D7F5-57EC-87DA-1DB460D64046,"iPhone13,2"
com.renpho.health,85,1733411411,1733411496,1733411497.0218,-21600,EB445137-D7F5-57EC-87DA-1DB460D64046,"iPhone13,2"
com.apple.weather,3,1733411404,1733411407,1733411408.107789,-21600,EB445137-D7F5-57EC-87DA-1DB460D64046,"iPhone13,2"
com.thestorygraph.thestorygraph,49,1733378541,1733378590,1733378590.279711,-21600,EB445137-D7F5-57EC-87DA-1DB460D64046,"iPhone13,2"
com.google.ios.youtube,6,1733378527,1733378533,1733378533.2718968,-21600,EB445137-D7F5-57EC-87DA-1DB460D64046,"iPhone13,2"
com.leomehlig.today,126,1733376821,1733376947,1733376947.9242768,-21600,,
com.google.Chrome,430,1733376391,1733376821,1733376821.839744,-21600,,
com.google.Chrome,310,1733375838,1733376148,1733376148.829679,-21600,,
com.google.Chrome,308,1733375248,1733375556,1733375556.613562,-21600,,
com.google.Chrome,579,1733374619,1733375198,1733375198.7917562,-21600,,
com.google.Chrome,1143,1733373145,1733374288,1733374288.3518538,-21600,,
com.google.ios.youtube,10,1733371802,1733371812,1733371812.668643,-21600,EB445137-D7F5-57EC-87DA-1DB460D64046,"iPhone13,2"
com.google.Chrome,1229,1733371790,1733373019,1733373019.839367,-21600,,
com.leomehlig.today,3,1733371787,1733371790,1733371791.3520808,-21600,,
com.google.ios.youtube,8,1733370987,1733370995,1733370995.6378899,-21600,EB445137-D7F5-57EC-87DA-1DB460D64046,"iPhone13,2"
com.leomehlig.today,304,1733370959,1733371263,1733371263.67948,-21600,,
com.apple.Photos,62,1733370897,1733370959,1733370959.611696,-21600,,
com.leomehlig.today,75,1733370822,1733370897,1733370897.3049378,-21600,,
com.google.Chrome,12,1733370810,1733370822,1733370822.217082,-21600,,
com.google.ios.youtube,82,1733370639,1733370721,1733370722.608261,-21600,EB445137-D7F5-57EC-87DA-1DB460D64046,"iPhone13,2"
com.google.chrome.ios,2,1733370635,1733370637,1733370637.881925,-21600,EB445137-D7F5-57EC-87DA-1DB460D64046,"iPhone13,2"
com.leomehlig.today,2,1733370633,1733370635,1733370635.143846,-21600,EB445137-D7F5-57EC-87DA-1DB460D64046,"iPhone13,2"
com.leomehlig.today,49,1733368543,1733368592,1733368593.074446,-21600,EB445137-D7F5-57EC-87DA-1DB460D64046,"iPhone13,2"
com.apple.mobilecal,4,1733368537,1733368541,1733368542.0015888,-21600,EB445137-D7F5-57EC-87DA-1DB460D64046,"iPhone13,2"
com.google.chrome.ios,13,1733368516,1733368529,1733368529.575673,-21600,EB445137-D7F5-57EC-87DA-1DB460D64046,"iPhone13,2"
com.google.chrome.ios,186,1733367124,1733367310,1733367310.910598,-21600,EB445137-D7F5-57EC-87DA-1DB460D64046,"iPhone13,2"
com.google.chrome.ios,32,1733367082,1733367114,1733367115.1824598,-21600,EB445137-D7F5-57EC-87DA-1DB460D64046,"iPhone13,2"
com.burbn.instagram,31,1733365733,1733365764,1733365765.007338,-21600,EB445137-D7F5-57EC-87DA-1DB460D64046,"iPhone13,2"
com.apple.news,34,1733365694,1733365728,1733365728.949897,-21600,EB445137-D7F5-57EC-87DA-1DB460D64046,"iPhone13,2"
com.apple.news,21,1733364054,1733364075,1733364075.4196,-21600,EB445137-D7F5-57EC-87DA-1DB460D64046,"iPhone13,2"
com.apple.news,46,1733363621,1733363667,1733363667.591463,-21600,EB445137-D7F5-57EC-87DA-1DB460D64046,"iPhone13,2"
com.apple.camera,0,1733363054,1733363054,1733363054.340339,-21600,EB445137-D7F5-57EC-87DA-1DB460D64046,"iPhone13,2"
com.apple.camera,0,1733363053,1733363053,1733363053.858814,-21600,EB445137-D7F5-57EC-87DA-1DB460D64046,"iPhone13,2"
com.tinyspeck.chatlyio,8,1733363033,1733363041,1733363041.3539438,-21600,EB445137-D7F5-57EC-87DA-1DB460D64046,"iPhone13,2"
com.burbn.instagram,63,1733362872,1733362935,1733362935.3702722,-21600,EB445137-D7F5-57EC-87DA-1DB460D64046,"iPhone13,2"
com.apple.camera,0,1733362869,1733362869,1733362869.2255611,-21600,EB445137-D7F5-57EC-87DA-1DB460D64046,"iPhone13,2"
com.apple.camera,0,1733362860,1733362860,1733362860.802742,-21600,EB445137-D7F5-57EC-87DA-1DB460D64046,"iPhone13,2"
com.burbn.instagram,10,1733362859,1733362869,1733362869.226089,-21600,EB445137-D7F5-57EC-87DA-1DB460D64046,"iPhone13,2"
com.burbn.instagram,47,1733362788,1733362835,1733362835.2775578,-21600,EB445137-D7F5-57EC-87DA-1DB460D64046,"iPhone13,2"
com.toyopagroup.picaboo,6,1733362778,1733362784,1733362784.584046,-21600,EB445137-D7F5-57EC-87DA-1DB460D64046,"iPhone13,2"
com.google.chrome.ios,2,1733362774,1733362776,1733362776.069851,-21600,EB445137-D7F5-57EC-87DA-1DB460D64046,"iPhone13,2"
com.google.chrome.ios,2,1733362040,1733362042,1733362043.181707,-21600,EB445137-D7F5-57EC-87DA-1DB460D64046,"iPhone13,2"
com.google.chrome.ios,24,1733361789,1733361813,1733361813.1878428,-21600,EB445137-D7F5-57EC-87DA-1DB460D64046,"iPhone13,2"
com.google.chrome.ios,28,1733361712,1733361740,1733361740.614153,-21600,EB445137-D7F5-57EC-87DA-1DB460D64046,"iPhone13,2"
com.truebill.truebillnative,9,1733361109,1733361118,1733361118.791214,-21600,EB445137-D7F5-57EC-87DA-1DB460D64046,"iPhone13,2"
com.toyopagroup.picaboo,7,1733360733,1733360740,1733360740.8832169,-21600,EB445137-D7F5-57EC-87DA-1DB460D64046,"iPhone13,2"
com.apple.MobileSMS,8,1733360664,1733360672,1733360672.57711,-21600,EB445137-D7F5-57EC-87DA-1DB460D64046,"iPhone13,2"
com.toyopagroup.picaboo,4,1733360660,1733360664,1733360664.610589,-21600,EB445137-D7F5-57EC-87DA-1DB460D64046,"iPhone13,2"
com.toyopagroup.picaboo,6,1733360593,1733360599,1733360599.07897,-21600,EB445137-D7F5-57EC-87DA-1DB460D64046,"iPhone13,2"
com.toyopagroup.picaboo,25,1733360487,1733360512,1733360512.4228148,-21600,EB445137-D7F5-57EC-87DA-1DB460D64046,"iPhone13,2"
com.toyopagroup.picaboo,5,1733360363,1733360368,1733360368.852971,-21600,EB445137-D7F5-57EC-87DA-1DB460D64046,"iPhone13,2"
com.toyopagroup.picaboo,97,1733360227,1733360324,1733360324.146922,-21600,EB445137-D7F5-57EC-87DA-1DB460D64046,"iPhone13,2"
com.toyopagroup.picaboo,6,1733360147,1733360153,1733360153.3288012,-21600,EB445137-D7F5-57EC-87DA-1DB460D64046,"iPhone13,2"
com.toyopagroup.picaboo,46,1733360062,1733360108,1733360108.29374,-21600,EB445137-D7F5-57EC-87DA-1DB460D64046,"iPhone13,2"
com.apple.MobileSMS,2,1733360057,1733360059,1733360059.580289,-21600,EB445137-D7F5-57EC-87DA-1DB460D64046,"iPhone13,2"
com.google.chrome.ios,26,1733360031,1733360057,1733360058.010984,-21600,EB445137-D7F5-57EC-87DA-1DB460D64046,"iPhone13,2"
com.toyopagroup.picaboo,2,1733360029,1733360031,1733360031.917355,-21600,EB445137-D7F5-57EC-87DA-1DB460D64046,"iPhone13,2"
com.toyopagroup.picaboo,9,1733359952,1733359961,1733359962.117566,-21600,EB445137-D7F5-57EC-87DA-1DB460D64046,"iPhone13,2"
com.toyopagroup.picaboo,28,1733359890,1733359918,1733359919.0163898,-21600,EB445137-D7F5-57EC-87DA-1DB460D64046,"iPhone13,2"
com.toyopagroup.picaboo,96,1733359778,1733359874,1733359874.294419,-21600,EB445137-D7F5-57EC-87DA-1DB460D64046,"iPhone13,2"
com.toyopagroup.picaboo,13,1733359316,1733359329,1733359329.4656348,-21600,EB445137-D7F5-57EC-87DA-1DB460D64046,"iPhone13,2"
com.toyopagroup.picaboo,14,1733359301,1733359315,1733359315.5670528,-21600,EB445137-D7F5-57EC-87DA-1DB460D64046,"iPhone13,2"
com.toyopagroup.picaboo,5,1733359028,1733359033,1733359033.707619,-21600,EB445137-D7F5-57EC-87DA-1DB460D64046,"iPhone13,2"
com.google.Chrome,457,1733358558,1733359015,1733359015.0380259,-21600,,
com.leomehlig.today,4,1733358554,1733358558,1733358560.237848,-21600,,
com.toyopagroup.picaboo,8,1733358541,1733358549,1733358549.119409,-21600,EB445137-D7F5-57EC-87DA-1DB460D64046,"iPhone13,2"
com.toyopagroup.picaboo,3,1733358536,1733358539,1733358540.202013,-21600,EB445137-D7F5-57EC-87DA-1DB460D64046,"iPhone13,2"
com.apple.MobileSMS,5,1733358530,1733358535,1733358535.68054,-21600,EB445137-D7F5-57EC-87DA-1DB460D64046,"iPhone13,2"
com.apple.MobileSMS,6,1733358514,1733358520,1733358520.909008,-21600,EB445137-D7F5-57EC-87DA-1DB460D64046,"iPhone13,2"
com.toyopagroup.picaboo,35,1733358464,1733358499,1733358499.790669,-21600,EB445137-D7F5-57EC-87DA-1DB460D64046,"iPhone13,2"
com.google.chrome.ios,6,1733358457,1733358463,1733358463.3606749,-21600,EB445137-D7F5-57EC-87DA-1DB460D64046,"iPhone13,2"
com.apple.camera,5,1733357873,1733357878,1733357879.3640962,-21600,EB445137-D7F5-57EC-87DA-1DB460D64046,"iPhone13,2"
com.google.chrome.ios,33,1733357872,1733357905,1733357906.456291,-21600,EB445137-D7F5-57EC-87DA-1DB460D64046,"iPhone13,2"
com.google.chrome.ios,108,1733357596,1733357704,1733357704.747838,-21600,EB445137-D7F5-57EC-87DA-1DB460D64046,"iPhone13,2"
com.google.Gmail,25,1733357571,1733357596,1733357596.63821,-21600,EB445137-D7F5-57EC-87DA-1DB460D64046,"iPhone13,2"
com.google.Gmail,66,1733357462,1733357528,1733357528.390955,-21600,EB445137-D7F5-57EC-87DA-1DB460D64046,"iPhone13,2"
com.apple.Passwords,122,1733357340,1733357462,1733357462.396196,-21600,EB445137-D7F5-57EC-87DA-1DB460D64046,"iPhone13,2"
com.google.chrome.ios,5,1733357332,1733357337,1733357337.957761,-21600,EB445137-D7F5-57EC-87DA-1DB460D64046,"iPhone13,2"
com.google.chrome.ios,111,1733357167,1733357278,1733357278.726097,-21600,EB445137-D7F5-57EC-87DA-1DB460D64046,"iPhone13,2"
com.apple.Music,2,1733357165,1733357167,1733357167.672604,-21600,EB445137-D7F5-57EC-87DA-1DB460D64046,"iPhone13,2"
com.apple.Music,5,1733355316,1733355321,1733355321.1069798,-21600,EB445137-D7F5-57EC-87DA-1DB460D64046,"iPhone13,2"
com.apple.Music,20,1733355296,1733355316,1733355317.3371491,-21600,EB445137-D7F5-57EC-87DA-1DB460D64046,"iPhone13,2"
com.apple.news,2,1733355294,1733355296,1733355298.712224,-21600,EB445137-D7F5-57EC-87DA-1DB460D64046,"iPhone13,2"
com.leomehlig.today,36,1733354992,1733355028,1733355029.109291,-21600,,
com.microsoft.VSCode,123,1733354869,1733354992,1733354992.353198,-21600,,
com.leomehlig.today,2,1733354867,1733354869,1733354869.4135761,-21600,,
com.microsoft.Excel,12,1733354855,1733354867,1733354867.0868192,-21600,,
com.leomehlig.today,1,1733354854,1733354855,1733354855.943737,-21600,,
com.microsoft.Excel,1,1733354853,1733354854,1733354854.676515,-21600,,
com.leomehlig.today,2,1733354851,1733354853,1733354853.507334,-21600,,
com.microsoft.Excel,3,1733354848,1733354851,1733354851.581462,-21600,,
com.leomehlig.today,6,1733354842,1733354848,1733354848.436156,-21600,,
com.microsoft.Excel,5,1733354837,1733354842,1733354842.341701,-21600,,
com.leomehlig.today,3,1733354834,1733354837,1733354837.937581,-21600,,
com.microsoft.Excel,1,1733354833,1733354834,1733354834.4615932,-21600,,
com.leomehlig.today,10,1733354823,1733354833,1733354833.089406,-21600,,
com.microsoft.Excel,2,1733354821,1733354823,1733354823.480472,-21600,,
com.leomehlig.today,7,1733354814,1733354821,1733354821.139495,-21600,,
com.microsoft.Excel,1,1733354813,1733354814,1733354814.7922292,-21600,,
com.leomehlig.today,9,1733354804,1733354813,1733354813.081187,-21600,,
com.microsoft.Excel,1,1733354803,1733354804,1733354804.300324,-21600,,
com.leomehlig.today,4,1733354799,1733354803,1733354803.2008681,-21600,,
com.microsoft.Excel,2,1733354797,1733354799,1733354799.506228,-21600,,
com.leomehlig.today,19,1733354778,1733354797,1733354797.343916,-21600,,
com.microsoft.Excel,1,1733354777,1733354778,1733354778.49689,-21600,,
com.leomehlig.today,1,1733354776,1733354777,1733354777.49822,-21600,,
com.microsoft.Excel,1,1733354775,1733354776,1733354776.071931,-21600,,
com.leomehlig.today,7,1733354768,1733354775,1733354775.3879929,-21600,,
com.microsoft.Excel,7,1733354761,1733354768,1733354768.260748,-21600,,
com.leomehlig.today,3,1733354758,1733354761,1733354761.6321769,-21600,,
com.microsoft.Excel,0,1733354758,1733354758,1733354758.2377748,-21600,,
com.apple.finder,12,1733354746,1733354758,1733354758.1176438,-21600,,
com.google.Chrome,6,1733354740,1733354746,1733354746.1381788,-21600,,
com.apple.news,6,1733354697,1733354703,1733354703.357327,-21600,EB445137-D7F5-57EC-87DA-1DB460D64046,"iPhone13,2"
com.leomehlig.today,74,1733354666,1733354740,1733354740.624381,-21600,,
com.google.Chrome,6,1733354660,1733354666,1733354666.882262,-21600,,
com.leomehlig.today,8,1733354652,1733354660,1733354660.1594071,-21600,,
com.apple.news,74,1733352210,1733352284,1733352285.153126,-21600,EB445137-D7F5-57EC-87DA-1DB460D64046,"iPhone13,2"
com.clairmail.fth.client,45,1733352155,1733352200,1733352200.519707,-21600,EB445137-D7F5-57EC-87DA-1DB460D64046,"iPhone13,2"
com.truebill.truebillnative,39,1733352112,1733352151,1733352151.028764,-21600,EB445137-D7F5-57EC-87DA-1DB460D64046,"iPhone13,2"
com.google.Chrome,2577,1733352075,1733354652,1733354652.744503,-21600,,
com.leomehlig.today,200,1733351875,1733352075,1733352075.495605,-21600,,
com.google.Chrome,1021,1733350854,1733351875,1733351875.278265,-21600,,
com.leomehlig.today,4,1733350832,1733350836,1733350836.774497,-21600,,
com.apple.news,168,1733350534,1733350702,1733350702.743456,-21600,EB445137-D7F5-57EC-87DA-1DB460D64046,"iPhone13,2"
com.leomehlig.today,20,1733350437,1733350457,1733350457.075556,-21600,,
com.google.Chrome,2499,1733347938,1733350437,1733350437.161041,-21600,,
com.apple.calculator,17,1733347869,1733347886,1733347887.007485,-21600,,
com.ally.MobileBanking,37,1733347852,1733347889,1733347889.853846,-21600,EB445137-D7F5-57EC-87DA-1DB460D64046,"iPhone13,2"
com.google.Chrome,83,1733347786,1733347869,1733347869.7369518,-21600,,
com.ally.MobileBanking,10,1733347746,1733347756,1733347756.960787,-21600,EB445137-D7F5-57EC-87DA-1DB460D64046,"iPhone13,2"
com.apple.weather,96,1733347514,1733347610,1733347610.473731,-21600,EB445137-D7F5-57EC-87DA-1DB460D64046,"iPhone13,2"
com.truebill.truebillnative,8,1733347499,1733347507,1733347507.219729,-21600,EB445137-D7F5-57EC-87DA-1DB460D64046,"iPhone13,2"
com.apple.mobileslideshow,6,1733347450,1733347456,1733347457.104638,-21600,EB445137-D7F5-57EC-87DA-1DB460D64046,"iPhone13,2"
com.leomehlig.today,23,1733347423,1733347446,1733347446.4855561,-21600,,
com.apple.iCal,22,1733347401,1733347423,1733347423.639368,-21600,,
com.leomehlig.today,2,1733347399,1733347401,1733347401.535584,-21600,,
com.google.Chrome,5,1733347394,1733347399,1733347399.3845901,-21600,,
com.apple.mobileslideshow,29,1733346768,1733346797,1733346798.102701,-21600,EB445137-D7F5-57EC-87DA-1DB460D64046,"iPhone13,2"
com.apple.camera,0,1733346728,1733346728,1733346728.580373,-21600,EB445137-D7F5-57EC-87DA-1DB460D64046,"iPhone13,2"
com.google.Chrome,21,1733346525,1733346546,1733346546.22176,-21600,,
com.leomehlig.today,38,1733346487,1733346525,1733346525.946269,-21600,,
com.google.Chrome,11,1733346476,1733346487,1733346487.420424,-21600,,
com.google.Chrome,310,1733346116,1733346426,1733346426.3932052,-21600,,
com.apple.Passwords,6,1733346110,1733346116,1733346116.425252,-21600,,
com.google.Chrome,6,1733346104,1733346110,1733346110.254641,-21600,,
com.apple.news,93,1733342206,1733342299,1733342299.6389232,-21600,EB445137-D7F5-57EC-87DA-1DB460D64046,"iPhone13,2"
com.apple.news,123,1733342061,1733342184,1733342185.8798242,-21600,EB445137-D7F5-57EC-87DA-1DB460D64046,"iPhone13,2"
com.apple.news,177,1733341432,1733341609,1733341609.460985,-21600,EB445137-D7F5-57EC-87DA-1DB460D64046,"iPhone13,2"
com.google.Chrome,6,1733341406,1733341412,1733341412.4684172,-21600,,
com.leomehlig.today,24,1733341382,1733341406,1733341406.3919601,-21600,,
com.google.Chrome,30,1733341352,1733341382,1733341382.819834,-21600,,
com.apple.Passwords,7,1733341345,1733341352,1733341353.050031,-21600,,
com.google.Chrome,5,1733341340,1733341345,1733341346.082405,-21600,,
com.leomehlig.today,12,1733340643,1733340655,1733340657.7254028,-21600,,
com.microsoft.Office.Outlook,29,1733340599,1733340628,1733340628.709447,-21600,EB445137-D7F5-57EC-87DA-1DB460D64046,"iPhone13,2"
com.apple.mobilecal,5,1733340593,1733340598,1733340598.523715,-21600,EB445137-D7F5-57EC-87DA-1DB460D64046,"iPhone13,2"
com.apple.mobilecal,1,1733340586,1733340587,1733340587.584019,-21600,EB445137-D7F5-57EC-87DA-1DB460D64046,"iPhone13,2"
com.apple.mobilecal,157,1733340428,1733340585,1733340585.991568,-21600,EB445137-D7F5-57EC-87DA-1DB460D64046,"iPhone13,2"
com.apple.news,5,1733340415,1733340420,1733340420.603498,-21600,EB445137-D7F5-57EC-87DA-1DB460D64046,"iPhone13,2"
com.apple.news,5,1733340390,1733340395,1733340395.9867911,-21600,EB445137-D7F5-57EC-87DA-1DB460D64046,"iPhone13,2"
com.apple.camera,1,1733340121,1733340122,1733340122.3250232,-21600,EB445137-D7F5-57EC-87DA-1DB460D64046,"iPhone13,2"
com.apple.news,23,1733340118,1733340141,1733340141.927984,-21600,EB445137-D7F5-57EC-87DA-1DB460D64046,"iPhone13,2"
com.apple.news,6,1733340111,1733340117,1733340117.834635,-21600,EB445137-D7F5-57EC-87DA-1DB460D64046,"iPhone13,2"
com.apple.camera,8,1733339571,1733339579,1733339579.302613,-21600,EB445137-D7F5-57EC-87DA-1DB460D64046,"iPhone13,2"
com.apple.camera,0,1733339569,1733339569,1733339569.331094,-21600,EB445137-D7F5-57EC-87DA-1DB460D64046,"iPhone13,2"
com.apple.camera,0,1733339569,1733339569,1733339569.8328772,-21600,EB445137-D7F5-57EC-87DA-1DB460D64046,"iPhone13,2"
com.apple.news,22,1733339563,1733339585,1733339585.682198,-21600,EB445137-D7F5-57EC-87DA-1DB460D64046,"iPhone13,2"
com.apple.camera,0,1733339548,1733339548,1733339548.5028,-21600,EB445137-D7F5-57EC-87DA-1DB460D64046,"iPhone13,2"
com.apple.camera,0,1733339545,1733339545,1733339545.75965,-21600,EB445137-D7F5-57EC-87DA-1DB460D64046,"iPhone13,2"
com.apple.camera,6,1733339539,1733339545,1733339545.041428,-21600,EB445137-D7F5-57EC-87DA-1DB460D64046,"iPhone13,2"
com.apple.camera,1,1733339538,1733339539,1733339539.756958,-21600,EB445137-D7F5-57EC-87DA-1DB460D64046,"iPhone13,2"
com.apple.news,18,1733339536,1733339554,1733339554.986366,-21600,EB445137-D7F5-57EC-87DA-1DB460D64046,"iPhone13,2"
com.apple.news,224,1733339296,1733339520,1733339521.511321,-21600,EB445137-D7F5-57EC-87DA-1DB460D64046,"iPhone13,2"
com.google.chrome.ios,51,1733339238,1733339289,1733339289.867485,-21600,EB445137-D7F5-57EC-87DA-1DB460D64046,"iPhone13,2"
com.toyopagroup.picaboo,7,1733339228,1733339235,1733339235.6264648,-21600,EB445137-D7F5-57EC-87DA-1DB460D64046,"iPhone13,2"
com.apple.news,4,1733339224,1733339228,1733339228.878591,-21600,EB445137-D7F5-57EC-87DA-1DB460D64046,"iPhone13,2"
com.apple.news,6,1733338898,1733338904,1733338904.495914,-21600,EB445137-D7F5-57EC-87DA-1DB460D64046,"iPhone13,2"
com.apple.news,239,1733338655,1733338894,1733338894.435215,-21600,EB445137-D7F5-57EC-87DA-1DB460D64046,"iPhone13,2"
com.tinyspeck.chatlyio,20,1733338626,1733338646,1733338646.955785,-21600,EB445137-D7F5-57EC-87DA-1DB460D64046,"iPhone13,2"
com.toyopagroup.picaboo,38,1733338549,1733338587,1733338587.031845,-21600,EB445137-D7F5-57EC-87DA-1DB460D64046,"iPhone13,2"
com.apple.weather,3,1733338546,1733338549,1733338549.584414,-21600,EB445137-D7F5-57EC-87DA-1DB460D64046,"iPhone13,2"
com.apple.weather,12,1733338296,1733338308,1733338308.613229,-21600,EB445137-D7F5-57EC-87DA-1DB460D64046,"iPhone13,2"
com.apple.weather,5,1733337289,1733337294,1733337295.042735,-21600,EB445137-D7F5-57EC-87DA-1DB460D64046,"iPhone13,2"
com.leomehlig.today,309,1733336954,1733337263,1733337263.4706569,-21600,,
com.google.Chrome,53,1733336901,1733336954,1733336954.453305,-21600,,
com.leomehlig.today,14,1733336887,1733336901,1733336901.632028,-21600,,
com.google.Chrome,50,1733336837,1733336887,1733336887.082838,-21600,,
com.leomehlig.today,86,1733336694,1733336780,1733336781.034728,-21600,,
com.apple.finder,52,1733336642,1733336694,1733336694.1893702,-21600,,
com.apple.camera,7,1733335236,1733335243,1733335243.450311,-21600,EB445137-D7F5-57EC-87DA-1DB460D64046,"iPhone13,2"
com.truebill.truebillnative,96,1733334537,1733334633,1733334633.532014,-21600,EB445137-D7F5-57EC-87DA-1DB460D64046,"iPhone13,2"
com.apple.finder,304,1733334463,1733334767,1733334767.05858,-21600,,
com.leomehlig.today,4,1733334459,1733334463,1733334463.68169,-21600,,
com.google.Chrome,605,1733333854,1733334459,1733334459.287262,-21600,,
com.leomehlig.today,32,1733333822,1733333854,1733333854.839778,-21600,,
com.google.Chrome,10,1733333812,1733333822,1733333822.923123,-21600,,
com.toyopagroup.picaboo,27,1733332258,1733332285,1733332285.937463,-21600,EB445137-D7F5-57EC-87DA-1DB460D64046,"iPhone13,2"
com.apple.MobileSMS,13,1733331142,1733331155,1733331156.265119,-21600,EB445137-D7F5-57EC-87DA-1DB460D64046,"iPhone13,2"
com.apple.Health,15,1733328294,1733328309,1733328309.732506,-21600,EB445137-D7F5-57EC-87DA-1DB460D64046,"iPhone13,2"
com.hammerandchisel.discord,27,1733328236,1733328263,1733328263.918844,-21600,EB445137-D7F5-57EC-87DA-1DB460D64046,"iPhone13,2"
com.microsoft.Office.Outlook,59,1733328177,1733328236,1733328236.1656399,-21600,EB445137-D7F5-57EC-87DA-1DB460D64046,"iPhone13,2"
com.apple.MobileSMS,2,1733328003,1733328005,1733328005.948862,-21600,EB445137-D7F5-57EC-87DA-1DB460D64046,"iPhone13,2"
com.apple.weather,16,1733327987,1733328003,1733328003.3689861,-21600,EB445137-D7F5-57EC-87DA-1DB460D64046,"iPhone13,2"
com.apple.weather,3,1733327263,1733327266,1733327266.360351,-21600,EB445137-D7F5-57EC-87DA-1DB460D64046,"iPhone13,2"
com.apple.weather,6,1733327070,1733327076,1733327077.0876799,-21600,EB445137-D7F5-57EC-87DA-1DB460D64046,"iPhone13,2"
com.renpho.health,2,1733327068,1733327070,1733327070.777592,-21600,EB445137-D7F5-57EC-87DA-1DB460D64046,"iPhone13,2"
com.renpho.health,5,1733327029,1733327034,1733327034.8161268,-21600,EB445137-D7F5-57EC-87DA-1DB460D64046,"iPhone13,2"
com.renpho.health,2,1733326435,1733326437,1733326437.938108,-21600,EB445137-D7F5-57EC-87DA-1DB460D64046,"iPhone13,2"
com.renpho.health,26,1733326353,1733326379,1733326379.488574,-21600,EB445137-D7F5-57EC-87DA-1DB460D64046,"iPhone13,2"
com.google.Chrome,383,1733291138,1733291521,1733291521.895948,-21600,,
com.google.Chrome,322,1733290403,1733290725,1733290725.580556,-21600,,
com.google.Chrome,309,1733289868,1733290177,1733290177.6622849,-21600,,
com.google.Chrome,310,1733289221,1733289531,1733289531.6877,-21600,,
com.google.Chrome,306,1733288582,1733288888,1733288888.23665,-21600,,
com.apple.camera,0,1733288202,1733288202,1733288202.40479,-21600,EB445137-D7F5-57EC-87DA-1DB460D64046,"iPhone13,2"
com.instructure.icanvas,0,1733288008,1733288008,1733288008.713028,-21600,EB445137-D7F5-57EC-87DA-1DB460D64046,"iPhone13,2"
com.google.Chrome,1241,1733287330,1733288571,1733288571.479779,-21600,,
com.leomehlig.today,2,1733287328,1733287330,1733287331.057056,-21600,,
com.google.Chrome,19,1733287309,1733287328,1733287328.791038,-21600,,
com.instructure.icanvas,13,1733287274,1733287287,1733287287.943392,-21600,EB445137-D7F5-57EC-87DA-1DB460D64046,"iPhone13,2"
com.instructure.icanvas,4,1733287268,1733287272,1733287272.317,-21600,EB445137-D7F5-57EC-87DA-1DB460D64046,"iPhone13,2"
com.instructure.icanvas,2,1733286735,1733286737,1733286737.103904,-21600,EB445137-D7F5-57EC-87DA-1DB460D64046,"iPhone13,2"
com.instructure.icanvas,5,1733286650,1733286655,1733286655.815793,-21600,EB445137-D7F5-57EC-87DA-1DB460D64046,"iPhone13,2"
com.google.Chrome,88,1733286647,1733286735,1733286735.4725409,-21600,,
com.leomehlig.today,3,1733286644,1733286647,1733286647.527596,-21600,,
com.google.Chrome,1,1733286643,1733286644,1733286644.0985541,-21600,,
com.apple.finder,3,1733286640,1733286643,1733286643.264227,-21600,,
com.leomehlig.today,1,1733286639,1733286640,1733286640.741136,-21600,,
com.microsoft.VSCode,9,1733286630,1733286639,1733286639.847203,-21600,,
com.leomehlig.today,70,1733286560,1733286630,1733286630.282259,-21600,,
com.apple.iCal,5,1733286555,1733286560,1733286560.42096,-21600,,
com.leomehlig.today,21,1733286534,1733286555,1733286555.614767,-21600,,
com.microsoft.Outlook,3,1733286531,1733286534,1733286535.1255121,-21600,,
com.google.Chrome,835,1733285696,1733286531,1733286531.444243,-21600,,
com.apple.MobileSMS,8,1733285643,1733285651,1733285652.024633,-21600,,
com.google.Chrome,46,1733285597,1733285643,1733285643.5112371,-21600,,
com.apple.iCal,3,1733285594,1733285597,1733285597.5415668,-21600,,
com.apple.MobileSMS,12,1733285582,1733285594,1733285594.117045,-21600,,
com.apple.iCal,2,1733285580,1733285582,1733285582.8955941,-21600,,
com.google.Chrome,9,1733285571,1733285580,1733285580.800324,-21600,,
com.apple.iCal,1,1733285570,1733285571,1733285571.6367521,-21600,,
com.apple.MobileSMS,1,1733285569,1733285570,1733285570.774465,-21600,,
com.microsoft.Outlook,1,1733285568,1733285569,1733285569.740632,-21600,,
com.apple.MobileSMS,29,1733285539,1733285568,1733285568.2191129,-21600,,
com.microsoft.Outlook,8,1733285531,1733285539,1733285539.0959659,-21600,,
com.google.Chrome,1,1733285530,1733285531,1733285531.762974,-21600,,
com.apple.MobileSMS,3,1733285527,1733285530,1733285530.513777,-21600,,
com.google.Chrome,73,1733285454,1733285527,1733285527.915975,-21600,,
com.microsoft.Outlook,18,1733285436,1733285454,1733285454.14356,-21600,,
com.instructure.icanvas,17,1733285436,1733285453,1733285454.287703,-21600,EB445137-D7F5-57EC-87DA-1DB460D64046,"iPhone13,2"
com.google.Chrome,293,1733285143,1733285436,1733285436.7734752,-21600,,
com.instructure.icanvas,10,1733285084,1733285094,1733285094.4666219,-21600,EB445137-D7F5-57EC-87DA-1DB460D64046,"iPhone13,2"
com.instructure.icanvas,10,1733284932,1733284942,1733284942.432101,-21600,EB445137-D7F5-57EC-87DA-1DB460D64046,"iPhone13,2"
com.instructure.icanvas,17,1733284373,1733284390,1733284390.7514,-21600,EB445137-D7F5-57EC-87DA-1DB460D64046,"iPhone13,2"
com.apple.MobileSMS,16,1733284337,1733284353,1733284353.912033,-21600,EB445137-D7F5-57EC-87DA-1DB460D64046,"iPhone13,2"
com.apple.mobiletimer,11,1733284326,1733284337,1733284338.317151,-21600,EB445137-D7F5-57EC-87DA-1DB460D64046,"iPhone13,2"
com.google.Chrome,934,1733284174,1733285108,1733285108.176323,-21600,,
com.apple.iCal,2,1733284172,1733284174,1733284174.9149408,-21600,,
com.google.Chrome,7,1733284165,1733284172,1733284172.036912,-21600,,
com.apple.iCal,4,1733284161,1733284165,1733284166.027535,-21600,,
com.google.Chrome,1,1733284160,1733284161,1733284161.824516,-21600,,
com.apple.iCal,4,1733284156,1733284160,1733284160.587285,-21600,,
com.google.Chrome,5,1733284151,1733284156,1733284157.012442,-21600,,
com.apple.iCal,5,1733284146,1733284151,1733284151.302573,-21600,,
com.google.Chrome,23,1733284123,1733284146,1733284146.530987,-21600,,
com.apple.iCal,26,1733284097,1733284123,1733284123.395584,-21600,,
com.google.Chrome,3,1733284094,1733284097,1733284097.1311011,-21600,,
com.apple.iCal,3,1733284091,1733284094,1733284095.027497,-21600,,
com.google.Chrome,1356,1733282735,1733284091,1733284091.561236,-21600,,
com.apple.mobiletimer,2,1733281947,1733281949,1733281949.5846019,-21600,EB445137-D7F5-57EC-87DA-1DB460D64046,"iPhone13,2"
com.apple.mobiletimer,8,1733281187,1733281195,1733281195.419909,-21600,EB445137-D7F5-57EC-87DA-1DB460D64046,"iPhone13,2"
com.apple.mobiletimer,2,1733281184,1733281186,1733281186.482419,-21600,EB445137-D7F5-57EC-87DA-1DB460D64046,"iPhone13,2"
com.apple.mobiletimer,691,1733278198,1733278889,1733278889.516841,-21600,EB445137-D7F5-57EC-87DA-1DB460D64046,"iPhone13,2"
com.apple.mobiletimer,372,1733277825,1733278197,1733278197.6199222,-21600,EB445137-D7F5-57EC-87DA-1DB460D64046,"iPhone13,2"
com.apple.mobiletimer,125,1733277523,1733277648,1733277648.622779,-21600,EB445137-D7F5-57EC-87DA-1DB460D64046,"iPhone13,2"
com.apple.mobiletimer,103,1733277388,1733277491,1733277491.226116,-21600,EB445137-D7F5-57EC-87DA-1DB460D64046,"iPhone13,2"
com.google.chrome.ios,2,1733277386,1733277388,1733277388.3985748,-21600,EB445137-D7F5-57EC-87DA-1DB460D64046,"iPhone13,2"
com.google.Chrome,2448,1733276451,1733278899,1733278899.6229901,-21600,,
com.apple.iCal,26,1733276425,1733276451,1733276451.321358,-21600,,
com.google.Chrome,2182,1733274243,1733276425,1733276425.809935,-21600,,
com.google.chrome.ios,10,1733273402,1733273412,1733273412.79945,-21600,EB445137-D7F5-57EC-87DA-1DB460D64046,"iPhone13,2"
com.google.chrome.ios,1,1733273360,1733273361,1733273361.6796231,-21600,EB445137-D7F5-57EC-87DA-1DB460D64046,"iPhone13,2"
com.google.chrome.ios,5,1733273230,1733273235,1733273236.102421,-21600,EB445137-D7F5-57EC-87DA-1DB460D64046,"iPhone13,2"
com.google.chrome.ios,83,1733272996,1733273079,1733273079.759742,-21600,EB445137-D7F5-57EC-87DA-1DB460D64046,"iPhone13,2"
com.google.chrome.ios,130,1733272569,1733272699,1733272699.883944,-21600,EB445137-D7F5-57EC-87DA-1DB460D64046,"iPhone13,2"
com.toyopagroup.picaboo,11,1733272425,1733272436,1733272436.653283,-21600,EB445137-D7F5-57EC-87DA-1DB460D64046,"iPhone13,2"
com.apple.mobileslideshow,6,1733272416,1733272422,1733272422.2691321,-21600,EB445137-D7F5-57EC-87DA-1DB460D64046,"iPhone13,2"
com.apple.weather,5,1733272387,1733272392,1733272392.437664,-21600,EB445137-D7F5-57EC-87DA-1DB460D64046,"iPhone13,2"
com.microsoft.Office.Outlook,7,1733272375,1733272382,1733272382.1393871,-21600,EB445137-D7F5-57EC-87DA-1DB460D64046,"iPhone13,2"
com.tinyspeck.chatlyio,25,1733272348,1733272373,1733272373.738616,-21600,EB445137-D7F5-57EC-87DA-1DB460D64046,"iPhone13,2"
com.apple.MobileSMS,3,1733272343,1733272346,1733272346.7637792,-21600,EB445137-D7F5-57EC-87DA-1DB460D64046,"iPhone13,2"
com.apple.news,315,1733269776,1733270091,1733270091.690675,-21600,EB445137-D7F5-57EC-87DA-1DB460D64046,"iPhone13,2"
com.instructure.icanvas,18,1733269722,1733269740,1733269740.2055578,-21600,EB445137-D7F5-57EC-87DA-1DB460D64046,"iPhone13,2"
com.apple.Music,7,1733269715,1733269722,1733269722.396181,-21600,EB445137-D7F5-57EC-87DA-1DB460D64046,"iPhone13,2"
com.apple.Music,21,1733268441,1733268462,1733268462.538903,-21600,EB445137-D7F5-57EC-87DA-1DB460D64046,"iPhone13,2"
com.toyopagroup.picaboo,4,1733268436,1733268440,1733268441.1296859,-21600,EB445137-D7F5-57EC-87DA-1DB460D64046,"iPhone13,2"
com.apple.camera,4,1733268427,1733268431,1733268431.3894129,-21600,EB445137-D7F5-57EC-87DA-1DB460D64046,"iPhone13,2"
com.google.Chrome,3,1733268080,1733268083,1733268083.990963,-21600,,
com.leomehlig.today,49,1733268031,1733268080,1733268080.557168,-21600,,
com.google.Chrome,356,1733267675,1733268031,1733268032.00124,-21600,,
com.apple.MobileSMS,3,1733267672,1733267675,1733267675.719009,-21600,,
com.google.Chrome,285,1733267387,1733267672,1733267672.964535,-21600,,
com.leomehlig.today,10,1733267377,1733267387,1733267387.86889,-21600,,
com.google.Chrome,1240,1733266137,1733267377,1733267377.48524,-21600,,
com.apple.MobileSMS,6,1733266131,1733266137,1733266137.182529,-21600,,
com.google.Chrome,15,1733266116,1733266131,1733266132.014771,-21600,,
com.google.Chrome,9,1733265983,1733265992,1733265992.9260468,-21600,,
us.zoom.xos,13,1733265970,1733265983,1733265983.801838,-21600,,
com.robinhood.release.Robinhood,51,1733265880,1733265931,1733265931.647726,-21600,EB445137-D7F5-57EC-87DA-1DB460D64046,"iPhone13,2"
com.truebill.truebillnative,103,1733265768,1733265871,1733265871.891149,-21600,EB445137-D7F5-57EC-87DA-1DB460D64046,"iPhone13,2"
com.google.chrome.ios,103,1733265662,1733265765,1733265765.7923388,-21600,EB445137-D7F5-57EC-87DA-1DB460D64046,"iPhone13,2"
com.toyopagroup.picaboo,34,1733265624,1733265658,1733265658.9804811,-21600,EB445137-D7F5-57EC-87DA-1DB460D64046,"iPhone13,2"
us.zoom.xos,300,1733265612,1733265912,1733265912.7204661,-21600,,
com.google.Chrome,26,1733265586,1733265612,1733265612.2120361,-21600,,
us.zoom.xos,12,1733265565,1733265577,1733265577.876824,-21600,,
com.google.Chrome,57,1733265508,1733265565,1733265565.1847749,-21600,,
com.microsoft.VSCode,1,1733265507,1733265508,1733265508.745318,-21600,,
us.zoom.xos,5,1733265502,1733265507,1733265507.452334,-21600,,
com.google.Chrome,1,1733265501,1733265502,1733265502.91805,-21600,,
com.apple.MobileSMS,24,1733265477,1733265501,1733265501.2365541,-21600,,
com.google.Chrome,34,1733265443,1733265477,1733265477.269456,-21600,,
com.apple.MobileSMS,23,1733265420,1733265443,1733265443.911968,-21600,,
com.google.Chrome,100,1733265320,1733265420,1733265420.956583,-21600,,
com.apple.MobileSMS,1,1733265319,1733265320,1733265320.4584599,-21600,,
us.zoom.xos,2,1733265317,1733265319,1733265319.322427,-21600,,
com.apple.MobileSMS,2,1733265315,1733265317,1733265317.533917,-21600,,
us.zoom.xos,1,1733265314,1733265315,1733265315.5716748,-21600,,
com.google.Chrome,112,1733265202,1733265314,1733265314.719898,-21600,,
com.microsoft.VSCode,5,1733265197,1733265202,1733265202.627818,-21600,,
com.google.Chrome,72,1733265125,1733265197,1733265197.251412,-21600,,
com.microsoft.VSCode,62,1733265063,1733265125,1733265125.738148,-21600,,
com.apple.MobileSMS,17,1733265046,1733265063,1733265063.9823508,-21600,,
com.google.Chrome,22,1733265024,1733265046,1733265046.8048968,-21600,,
com.apple.MobileSMS,3,1733265021,1733265024,1733265024.130433,-21600,,
com.google.Chrome,2,1733265019,1733265021,1733265021.188043,-21600,,
com.microsoft.VSCode,18,1733265001,1733265019,1733265019.543468,-21600,,
com.apple.MobileSMS,7,1733264994,1733265001,1733265001.267295,-21600,,
com.microsoft.VSCode,14,1733264980,1733264994,1733264994.4489288,-21600,,
com.google.Chrome,1,1733264979,1733264980,1733264980.466786,-21600,,
com.microsoft.VSCode,2,1733264977,1733264979,1733264979.365233,-21600,,
com.google.Chrome,1,1733264976,1733264977,1733264977.3176131,-21600,,
com.microsoft.VSCode,1,1733264975,1733264976,1733264977.0676332,-21600,,
com.google.Chrome,6,1733264969,1733264975,1733264975.373421,-21600,,
com.microsoft.VSCode,6,1733264963,1733264969,1733264969.770499,-21600,,
com.google.Chrome,1,1733264962,1733264963,1733264963.693398,-21600,,
com.microsoft.VSCode,48,1733264914,1733264962,1733264962.3799539,-21600,,
com.google.Chrome,1,1733264913,1733264914,1733264914.371531,-21600,,
com.microsoft.VSCode,11,1733264902,1733264913,1733264913.7990441,-21600,,
com.google.Chrome,86,1733264816,1733264902,1733264902.373205,-21600,,
us.zoom.xos,6,1733264810,1733264816,1733264816.273078,-21600,,
com.google.Chrome,6,1733264804,1733264810,1733264810.1681728,-21600,,
com.apple.MobileSMS,24,1733264780,1733264804,1733264804.322413,-21600,,
com.google.Chrome,144,1733264636,1733264780,1733264780.438653,-21600,,
us.zoom.xos,5,1733264631,1733264636,1733264636.279866,-21600,,
com.google.Chrome,15,1733264616,1733264631,1733264631.8808808,-21600,,
com.apple.MobileSMS,5,1733264611,1733264616,1733264616.214242,-21600,,
com.microsoft.VSCode,9,1733264602,1733264611,1733264611.3233051,-21600,,
com.google.Chrome,7,1733264595,1733264602,1733264602.9099898,-21600,,
com.microsoft.VSCode,5,1733264590,1733264595,1733264595.2252622,-21600,,
com.apple.MobileSMS,24,1733264566,1733264590,1733264590.972187,-21600,,
com.microsoft.VSCode,7,1733264559,1733264566,1733264566.2988992,-21600,,
us.zoom.xos,2,1733264557,1733264559,1733264559.512885,-21600,,
com.google.Chrome,80,1733264477,1733264557,1733264557.8212261,-21600,,
com.apple.Health,4,1733264469,1733264473,1733264473.8741698,-21600,EB445137-D7F5-57EC-87DA-1DB460D64046,"iPhone13,2"
com.apple.MobileSMS,3,1733264466,1733264469,1733264469.0972261,-21600,EB445137-D7F5-57EC-87DA-1DB460D64046,"iPhone13,2"
com.apple.Health,65,1733264401,1733264466,1733264467.02387,-21600,EB445137-D7F5-57EC-87DA-1DB460D64046,"iPhone13,2"
us.zoom.xos,93,1733264384,1733264477,1733264477.260575,-21600,,
com.google.Chrome,6,1733264378,1733264384,1733264384.4582648,-21600,,
com.apple.MobileSMS,13,1733264365,1733264378,1733264378.7546701,-21600,,
com.google.Chrome,118,1733264247,1733264365,1733264365.79046,-21600,,
com.microsoft.VSCode,44,1733264203,1733264247,1733264247.545979,-21600,,
com.google.Chrome,1,1733264202,1733264203,1733264203.7383099,-21600,,
com.apple.MobileSMS,2,1733264200,1733264202,1733264202.3346639,-21600,,
com.google.Chrome,17,1733264183,1733264200,1733264200.785816,-21600,,
com.apple.MobileSMS,3,1733264180,1733264183,1733264183.186624,-21600,,
com.microsoft.VSCode,3,1733264177,1733264180,1733264180.691876,-21600,,
us.zoom.xos,3,1733264174,1733264177,1733264177.7897968,-21600,,
com.microsoft.VSCode,0,1733264174,1733264174,1733264174.7796779,-21600,,
us.zoom.xos,5,1733264169,1733264174,1733264174.412372,-21600,,
com.google.Chrome,2,1733264167,1733264169,1733264169.363668,-21600,,
com.microsoft.VSCode,21,1733264146,1733264167,1733264167.9417372,-21600,,
com.apple.MobileSMS,1,1733264145,1733264146,1733264146.497828,-21600,,
com.google.Chrome,9,1733264136,1733264145,1733264145.097908,-21600,,
com.apple.MobileSMS,11,1733264125,1733264136,1733264136.1343389,-21600,,
com.google.Chrome,2,1733264123,1733264125,1733264125.121371,-21600,,
com.microsoft.VSCode,16,1733264107,1733264123,1733264123.7395148,-21600,,
com.google.Chrome,11,1733264096,1733264107,1733264107.500877,-21600,,
com.microsoft.VSCode,69,1733264027,1733264096,1733264096.427038,-21600,,
com.google.Chrome,8,1733264019,1733264027,1733264027.6443849,-21600,,
com.apple.MobileSMS,15,1733264004,1733264019,1733264019.566625,-21600,,
com.google.Chrome,11,1733263993,1733264004,1733264004.517406,-21600,,
com.apple.MobileSMS,11,1733263982,1733263993,1733263993.522686,-21600,,
com.google.Chrome,19,1733263963,1733263982,1733263982.573515,-21600,,
com.microsoft.VSCode,70,1733263893,1733263963,1733263963.135324,-21600,,
com.google.Chrome,8,1733263885,1733263893,1733263893.779834,-21600,,
com.microsoft.VSCode,16,1733263869,1733263885,1733263885.130733,-21600,,
com.google.Chrome,2,1733263867,1733263869,1733263869.6334162,-21600,,
com.microsoft.VSCode,2,1733263865,1733263867,1733263867.479943,-21600,,
com.google.Chrome,0,1733263865,1733263865,1733263866.040276,-21600,,
com.microsoft.VSCode,4,1733263861,1733263865,1733263865.173702,-21600,,
com.google.Chrome,4,1733263857,1733263861,1733263861.7934341,-21600,,
com.microsoft.VSCode,1,1733263856,1733263857,1733263857.636967,-21600,,
com.google.Chrome,2,1733263854,1733263856,1733263856.93005,-21600,,
com.microsoft.VSCode,13,1733263841,1733263854,1733263854.945571,-21600,,
com.google.Chrome,12,1733263829,1733263841,1733263841.495751,-21600,,
com.microsoft.VSCode,2,1733263827,1733263829,1733263829.524677,-21600,,
com.google.Chrome,4,1733263823,1733263827,1733263827.703316,-21600,,
com.microsoft.VSCode,0,1733263823,1733263823,1733263823.998168,-21600,,
com.google.Chrome,3,1733263820,1733263823,1733263823.290443,-21600,,
com.microsoft.VSCode,90,1733263730,1733263820,1733263820.645372,-21600,,
com.google.Chrome,8,1733263722,1733263730,1733263730.551556,-21600,,
com.microsoft.VSCode,121,1733263601,1733263722,1733263722.247108,-21600,,
us.zoom.xos,21,1733263580,1733263601,1733263601.475358,-21600,,
com.microsoft.VSCode,7,1733263573,1733263580,1733263580.445016,-21600,,
us.zoom.xos,3,1733263570,1733263573,1733263573.394052,-21600,,
com.microsoft.VSCode,1,1733263569,1733263570,1733263570.7084641,-21600,,
us.zoom.xos,2,1733263567,1733263569,1733263569.323756,-21600,,
com.microsoft.VSCode,84,1733263483,1733263567,1733263568.0060859,-21600,,
us.zoom.xos,4,1733263479,1733263483,1733263483.1456308,-21600,,
com.microsoft.VSCode,326,1733263153,1733263479,1733263479.628312,-21600,,
us.zoom.xos,2,1733263151,1733263153,1733263153.2869291,-21600,,
com.microsoft.VSCode,73,1733263078,1733263151,1733263152.028232,-21600,,
us.zoom.xos,7,1733263071,1733263078,1733263078.210034,-21600,,
com.microsoft.VSCode,110,1733262961,1733263071,1733263071.776898,-21600,,
com.google.Chrome,3,1733262958,1733262961,1733262961.421029,-21600,,
com.apple.calculator,1,1733262957,1733262958,1733262958.8664541,-21600,,
com.google.Chrome,20,1733262937,1733262957,1733262957.0553222,-21600,,
com.apple.calculator,4,1733262933,1733262937,1733262937.352768,-21600,,
com.google.Chrome,31,1733262902,1733262933,1733262933.197963,-21600,,
com.apple.calculator,19,1733262883,1733262902,1733262902.039538,-21600,,
com.microsoft.VSCode,74,1733262809,1733262883,1733262883.714462,-21600,,
us.zoom.xos,1,1733262808,1733262809,1733262810.024941,-21600,,
com.microsoft.VSCode,1,1733262807,1733262808,1733262808.2751498,-21600,,
us.zoom.xos,2,1733262805,1733262807,1733262807.238864,-21600,,
com.microsoft.VSCode,60,1733262745,1733262805,1733262805.564465,-21600,,
us.zoom.xos,9,1733262736,1733262745,1733262745.8197842,-21600,,
com.microsoft.VSCode,93,1733262643,1733262736,1733262736.384921,-21600,,
us.zoom.xos,7,1733262636,1733262643,1733262643.851482,-21600,,
com.microsoft.VSCode,143,1733262493,1733262636,1733262636.44255,-21600,,
us.zoom.xos,67,1733262426,1733262493,1733262493.681618,-21600,,
com.microsoft.VSCode,64,1733262362,1733262426,1733262426.049428,-21600,,
us.zoom.xos,59,1733262303,1733262362,1733262362.881239,-21600,,
com.microsoft.VSCode,286,1733262017,1733262303,1733262303.3086329,-21600,,
us.zoom.xos,3,1733262014,1733262017,1733262017.256953,-21600,,
com.microsoft.VSCode,0,1733262014,1733262014,1733262014.919483,-21600,,
us.zoom.xos,4,1733262010,1733262014,1733262014.640002,-21600,,
com.microsoft.VSCode,120,1733261890,1733262010,1733262010.355506,-21600,,
com.apple.MobileSMS,2,1733261888,1733261890,1733261890.950097,-21600,,
com.apple.MobileSMS,2,1733261877,1733261879,1733261879.7627702,-21600,EB445137-D7F5-57EC-87DA-1DB460D64046,"iPhone13,2"
us.zoom.xos,53,1733261835,1733261888,1733261888.207397,-21600,,
com.google.Chrome,3,1733261832,1733261835,1733261835.206569,-21600,,
com.toyopagroup.picaboo,55,1733261820,1733261875,1733261875.517024,-21600,EB445137-D7F5-57EC-87DA-1DB460D64046,"iPhone13,2"
com.apple.MobileSMS,3,1733261817,1733261820,1733261820.461026,-21600,EB445137-D7F5-57EC-87DA-1DB460D64046,"iPhone13,2"
com.microsoft.VSCode,20,1733261812,1733261832,1733261832.700615,-21600,,
com.apple.MobileSMS,47,1733261765,1733261812,1733261812.733482,-21600,,
com.toyopagroup.picaboo,65,1733261752,1733261817,1733261817.736346,-21600,EB445137-D7F5-57EC-87DA-1DB460D64046,"iPhone13,2"
us.zoom.xos,20,1733261745,1733261765,1733261766.0588121,-21600,,
com.apple.MobileSMS,4,1733261741,1733261745,1733261745.940609,-21600,,
us.zoom.xos,3,1733261738,1733261741,1733261741.4509602,-21600,,
com.apple.MobileSMS,9,1733261729,1733261738,1733261738.1015759,-21600,,
us.zoom.xos,9,1733261720,1733261729,1733261730.093229,-21600,,
com.google.Chrome,1,1733261719,1733261720,1733261720.167723,-21600,,
com.microsoft.VSCode,2,1733261717,1733261719,1733261719.186116,-21600,,
com.apple.MobileSMS,116,1733261601,1733261717,1733261717.941043,-21600,,
com.microsoft.VSCode,15,1733261586,1733261601,1733261601.0514,-21600,,
com.google.Chrome,5,1733261581,1733261586,1733261586.1274881,-21600,,
us.zoom.xos,12,1733261569,1733261581,1733261581.130439,-21600,,
com.google.Chrome,2,1733261567,1733261569,1733261569.164473,-21600,,
com.leomehlig.today,24,1733261543,1733261567,1733261567.147441,-21600,,
com.google.Chrome,1,1733261542,1733261543,1733261543.650858,-21600,,
com.leomehlig.today,4,1733261538,1733261542,1733261542.648468,-21600,,
com.google.Chrome,32,1733261506,1733261538,1733261538.910722,-21600,,
us.zoom.xos,3,1733261503,1733261506,1733261506.153348,-21600,,
com.google.Chrome,7,1733261496,1733261503,1733261503.5477982,-21600,,
us.zoom.xos,1,1733261495,1733261496,1733261496.446728,-21600,,
com.google.Chrome,2,1733261493,1733261495,1733261495.418107,-21600,,
com.microsoft.Office.Outlook,25,1733261456,1733261481,1733261482.048644,-21600,EB445137-D7F5-57EC-87DA-1DB460D64046,"iPhone13,2"
com.hammerandchisel.discord,9,1733261444,1733261453,1733261453.8964791,-21600,EB445137-D7F5-57EC-87DA-1DB460D64046,"iPhone13,2"
us.zoom.xos,109,1733261384,1733261493,1733261493.942117,-21600,,
com.google.Chrome,3,1733261381,1733261384,1733261384.289966,-21600,,
us.zoom.xos,1,1733261380,1733261381,1733261381.24037,-21600,,
com.google.Chrome,9,1733261371,1733261380,1733261380.212122,-21600,,
com.microsoft.VSCode,9,1733261362,1733261371,1733261371.772657,-21600,,
us.zoom.xos,2,1733261360,1733261362,1733261362.583571,-21600,,
com.apple.MobileSMS,6,1733261354,1733261360,1733261360.403348,-21600,,
us.zoom.xos,5,1733261349,1733261354,1733261354.487891,-21600,,
com.google.Chrome,1,1733261348,1733261349,1733261349.4010859,-21600,,
us.zoom.xos,4,1733261344,1733261348,1733261348.6360211,-21600,,
com.google.Chrome,8,1733261336,1733261344,1733261344.301464,-21600,,
com.leomehlig.today,52,1733261284,1733261336,1733261336.750743,-21600,,
com.google.Chrome,1378,1733259906,1733261284,1733261284.983859,-21600,,
com.leomehlig.today,1,1733259905,1733259906,1733259906.2457,-21600,,
com.google.Chrome,3,1733259902,1733259905,1733259905.077332,-21600,,
com.leomehlig.today,222,1733259680,1733259902,1733259902.964627,-21600,,
com.google.Gmail,5,1733257043,1733257048,1733257048.4434361,-21600,EB445137-D7F5-57EC-87DA-1DB460D64046,"iPhone13,2"
com.google.chrome.ios,155,1733256885,1733257040,1733257040.770925,-21600,EB445137-D7F5-57EC-87DA-1DB460D64046,"iPhone13,2"
com.toyopagroup.picaboo,49,1733255467,1733255516,1733255516.8876262,-21600,EB445137-D7F5-57EC-87DA-1DB460D64046,"iPhone13,2"
com.google.Chrome,4223,1733255457,1733259680,1733259680.258949,-21600,,
com.apple.Dictionary,0,1733255457,1733255457,1733255457.896436,-21600,,
com.google.Chrome,183,1733255274,1733255457,1733255457.162416,-21600,,
com.apple.finder,3,1733255271,1733255274,1733255274.29142,-21600,,
com.instructure.icanvas,8,1733254801,1733254809,1733254809.179976,-21600,EB445137-D7F5-57EC-87DA-1DB460D64046,"iPhone13,2"
com.google.Gmail,11,1733254790,1733254801,1733254802.0274491,-21600,EB445137-D7F5-57EC-87DA-1DB460D64046,"iPhone13,2"
com.google.Gmail,131,1733254588,1733254719,1733254720.156728,-21600,EB445137-D7F5-57EC-87DA-1DB460D64046,"iPhone13,2"
com.toyopagroup.picaboo,22,1733254165,1733254187,1733254187.5297031,-21600,EB445137-D7F5-57EC-87DA-1DB460D64046,"iPhone13,2"
com.google.Chrome,1107,1733254164,1733255271,1733255271.513369,-21600,,
com.leomehlig.today,62,1733254102,1733254164,1733254164.1641731,-21600,,
com.google.Chrome,4,1733254098,1733254102,1733254102.079105,-21600,,
com.apple.camera,6,1733253951,1733253957,1733253957.587624,-21600,EB445137-D7F5-57EC-87DA-1DB460D64046,"iPhone13,2"
com.toyopagroup.picaboo,7,1733253950,1733253957,1733253957.5263228,-21600,EB445137-D7F5-57EC-87DA-1DB460D64046,"iPhone13,2"
com.toyopagroup.picaboo,1,1733252731,1733252732,1733252732.567113,-21600,EB445137-D7F5-57EC-87DA-1DB460D64046,"iPhone13,2"
com.google.Chrome,53,1733252527,1733252580,1733252580.68368,-21600,,
com.toyopagroup.picaboo,21,1733252445,1733252466,1733252466.529916,-21600,EB445137-D7F5-57EC-87DA-1DB460D64046,"iPhone13,2"
com.toyopagroup.picaboo,64,1733251838,1733251902,1733251902.206543,-21600,EB445137-D7F5-57EC-87DA-1DB460D64046,"iPhone13,2"
com.apple.Preferences,12,1733251826,1733251838,1733251838.911254,-21600,EB445137-D7F5-57EC-87DA-1DB460D64046,"iPhone13,2"
com.toyopagroup.picaboo,15,1733251811,1733251826,1733251826.950358,-21600,EB445137-D7F5-57EC-87DA-1DB460D64046,"iPhone13,2"
com.apple.mobileslideshow,13,1733251795,1733251808,1733251809.0164251,-21600,EB445137-D7F5-57EC-87DA-1DB460D64046,"iPhone13,2"
com.google.chrome.ios,174,1733251620,1733251794,1733251794.882736,-21600,EB445137-D7F5-57EC-87DA-1DB460D64046,"iPhone13,2"
com.google.ios.youtube,438,1733251180,1733251618,1733251618.929152,-21600,EB445137-D7F5-57EC-87DA-1DB460D64046,"iPhone13,2"
com.apple.mobilecal,23,1733251154,1733251177,1733251177.756353,-21600,EB445137-D7F5-57EC-87DA-1DB460D64046,"iPhone13,2"
com.instructure.icanvas,19,1733251133,1733251152,1733251152.190462,-21600,EB445137-D7F5-57EC-87DA-1DB460D64046,"iPhone13,2"
com.instructure.icanvas,6,1733250958,1733250964,1733250964.311369,-21600,EB445137-D7F5-57EC-87DA-1DB460D64046,"iPhone13,2"
com.google.Chrome,1304,1733249439,1733250743,1733250743.8029618,-21600,,
com.leomehlig.today,8,1733249431,1733249439,1733249440.28365,-21600,,
com.leomehlig.today,52,1733247941,1733247993,1733247993.440784,-21600,,
com.google.Chrome,2293,1733245648,1733247941,1733247941.331228,-21600,,
com.apple.MobileSMS,73,1733245575,1733245648,1733245648.1009278,-21600,,
com.google.Chrome,69,1733245506,1733245575,1733245575.1926808,-21600,,
com.apple.MobileSMS,15,1733245491,1733245506,1733245506.761156,-21600,,
com.google.Chrome,16,1733245475,1733245491,1733245491.620376,-21600,,
com.apple.MobileSMS,3,1733245472,1733245475,1733245475.108366,-21600,,
com.google.Chrome,14,1733245458,1733245472,1733245472.489099,-21600,,
com.apple.MobileSMS,2,1733245456,1733245458,1733245458.764106,-21600,,
com.google.Chrome,11,1733245445,1733245456,1733245457.032208,-21600,,
com.apple.MobileSMS,11,1733245434,1733245445,1733245445.4148002,-21600,,
com.google.Chrome,5,1733245429,1733245434,1733245434.40486,-21600,,
com.apple.MobileSMS,30,1733245399,1733245429,1733245429.477944,-21600,,
com.instructure.icanvas,2,1733245335,1733245337,1733245337.516141,-21600,EB445137-D7F5-57EC-87DA-1DB460D64046,"iPhone13,2"
com.google.Chrome,82,1733245317,1733245399,1733245399.1556191,-21600,,
com.instructure.icanvas,19,1733245000,1733245019,1733245019.66088,-21600,EB445137-D7F5-57EC-87DA-1DB460D64046,"iPhone13,2"
com.google.Chrome,15,1733244448,1733244463,1733244464.219784,-21600,,
com.microsoft.VSCode,107,1733244341,1733244448,1733244448.235162,-21600,,
com.google.Chrome,6,1733244335,1733244341,1733244341.8415132,-21600,,
com.apple.finder,53,1733244282,1733244335,1733244335.441331,-21600,,
com.google.Chrome,17,1733244265,1733244282,1733244282.879016,-21600,,
com.microsoft.VSCode,6,1733244259,1733244265,1733244265.212981,-21600,,
com.google.Chrome,19,1733244240,1733244259,1733244259.45034,-21600,,
com.apple.Preview,49,1733244191,1733244240,1733244240.697536,-21600,,
com.microsoft.VSCode,49,1733244142,1733244191,1733244191.76953,-21600,,
com.google.Chrome,2,1733244140,1733244142,1733244142.665812,-21600,,
com.microsoft.VSCode,1,1733244139,1733244140,1733244140.934994,-21600,,
com.google.Chrome,1,1733244138,1733244139,1733244139.694298,-21600,,
com.microsoft.VSCode,4,1733244134,1733244138,1733244138.890521,-21600,,
com.google.Chrome,1,1733244133,1733244134,1733244134.620819,-21600,,
com.apple.news,106,1733244011,1733244117,1733244118.1160002,-21600,EB445137-D7F5-57EC-87DA-1DB460D64046,"iPhone13,2"
com.microsoft.Office.Outlook,2,1733244009,1733244011,1733244014.1404672,-21600,EB445137-D7F5-57EC-87DA-1DB460D64046,"iPhone13,2"
com.microsoft.VSCode,151,1733243982,1733244133,1733244133.449401,-21600,,
com.google.Chrome,1,1733243981,1733243982,1733243983.0133471,-21600,,
com.microsoft.VSCode,3,1733243978,1733243981,1733243981.179483,-21600,,
com.google.Chrome,1,1733243977,1733243978,1733243978.237448,-21600,,
com.microsoft.VSCode,2,1733243975,1733243977,1733243977.287191,-21600,,
com.google.Chrome,0,1733243975,1733243975,1733243975.96801,-21600,,
com.microsoft.VSCode,3,1733243972,1733243975,1733243975.509704,-21600,,
com.google.Chrome,1,1733243971,1733243972,1733243972.3308182,-21600,,
com.microsoft.VSCode,2,1733243969,1733243971,1733243971.583574,-21600,,
com.google.Chrome,0,1733243969,1733243969,1733243970.0077329,-21600,,
com.microsoft.VSCode,3,1733243966,1733243969,1733243969.179861,-21600,,
com.google.Chrome,0,1733243966,1733243966,1733243967.03252,-21600,,
com.microsoft.VSCode,5,1733243961,1733243966,1733243966.302639,-21600,,
com.google.Chrome,1,1733243960,1733243961,1733243961.917011,-21600,,
com.microsoft.VSCode,4,1733243956,1733243960,1733243960.7416592,-21600,,
com.google.Chrome,6,1733243950,1733243956,1733243956.29003,-21600,,
com.microsoft.VSCode,7,1733243943,1733243950,1733243950.6074328,-21600,,
com.google.Chrome,4,1733243939,1733243943,1733243943.295731,-21600,,
com.microsoft.VSCode,1,1733243938,1733243939,1733243939.647727,-21600,,
com.google.Chrome,1,1733243937,1733243938,1733243938.2172961,-21600,,
com.microsoft.VSCode,2,1733243935,1733243937,1733243937.171297,-21600,,
com.google.Chrome,1,1733243934,1733243935,1733243935.834856,-21600,,
com.microsoft.VSCode,2,1733243932,1733243934,1733243934.03632,-21600,,
com.google.Chrome,2,1733243930,1733243932,1733243933.023807,-21600,,
com.microsoft.VSCode,1,1733243929,1733243930,1733243930.499971,-21600,,
com.google.Chrome,1,1733243928,1733243929,1733243929.692227,-21600,,
com.microsoft.VSCode,0,1733243928,1733243928,1733243928.876981,-21600,,
com.google.Chrome,3,1733243925,1733243928,1733243928.076946,-21600,,
com.microsoft.VSCode,14,1733243911,1733243925,1733243925.927528,-21600,,
com.google.Chrome,8,1733243903,1733243911,1733243911.196072,-21600,,
com.microsoft.VSCode,5,1733243898,1733243903,1733243903.332209,-21600,,
com.google.Chrome,9,1733243889,1733243898,1733243898.389617,-21600,,
com.microsoft.VSCode,13,1733243876,1733243889,1733243889.4887152,-21600,,
com.google.Chrome,5,1733243871,1733243876,1733243876.545121,-21600,,
com.microsoft.VSCode,22,1733243849,1733243871,1733243871.175204,-21600,,
com.google.Chrome,12,1733243837,1733243849,1733243849.91579,-21600,,
com.microsoft.VSCode,1,1733243836,1733243837,1733243837.402844,-21600,,
com.google.Chrome,1,1733243835,1733243836,1733243836.279015,-21600,,
com.microsoft.VSCode,7,1733243828,1733243835,1733243835.4764419,-21600,,
com.google.Chrome,2,1733243826,1733243828,1733243828.31353,-21600,,
com.microsoft.VSCode,4,1733243822,1733243826,1733243826.273051,-21600,,
com.google.Chrome,5,1733243817,1733243822,1733243822.4620929,-21600,,
com.microsoft.VSCode,23,1733243794,1733243817,1733243817.073121,-21600,,
com.google.Chrome,0,1733243794,1733243794,1733243795.013661,-21600,,
com.microsoft.VSCode,13,1733243781,1733243794,1733243794.325035,-21600,,
com.google.Chrome,1,1733243780,1733243781,1733243781.8905969,-21600,,
com.microsoft.VSCode,37,1733243743,1733243780,1733243780.042787,-21600,,
com.google.Chrome,3,1733243740,1733243743,1733243743.0960898,-21600,,
com.microsoft.VSCode,9,1733243731,1733243740,1733243740.295018,-21600,,
com.google.Chrome,1,1733243730,1733243731,1733243731.375279,-21600,,
com.microsoft.VSCode,3,1733243727,1733243730,1733243730.531259,-21600,,
com.google.Chrome,2,1733243725,1733243727,1733243727.45227,-21600,,
com.microsoft.VSCode,8,1733243717,1733243725,1733243725.99362,-21600,,
com.google.Chrome,4,1733243713,1733243717,1733243718.0307589,-21600,,
com.microsoft.VSCode,15,1733243698,1733243713,1733243714.059338,-21600,,
com.google.Chrome,0,1733243698,1733243698,1733243698.775945,-21600,,
com.microsoft.VSCode,18,1733243680,1733243698,1733243698.086609,-21600,,
com.google.Chrome,19,1733243661,1733243680,1733243680.922165,-21600,,
com.microsoft.VSCode,0,1733243661,1733243661,1733243661.942185,-21600,,
com.google.Chrome,1,1733243660,1733243661,1733243661.0704541,-21600,,
com.microsoft.VSCode,21,1733243639,1733243660,1733243660.2516541,-21600,,
com.google.Chrome,13,1733243626,1733243639,1733243639.526699,-21600,,
com.microsoft.VSCode,8,1733243618,1733243626,1733243626.596668,-21600,,
com.google.Chrome,2,1733243616,1733243618,1733243618.30613,-21600,,
com.microsoft.VSCode,20,1733243596,1733243616,1733243617.0466971,-21600,,
com.google.Chrome,24,1733243572,1733243596,1733243596.4814029,-21600,,
com.microsoft.VSCode,4,1733243568,1733243572,1733243572.8659282,-21600,,
com.google.Chrome,8,1733243560,1733243568,1733243568.973392,-21600,,
com.microsoft.VSCode,52,1733243508,1733243560,1733243560.1537042,-21600,,
com.google.Chrome,11,1733243497,1733243508,1733243508.612753,-21600,,
com.microsoft.VSCode,1,1733243496,1733243497,1733243497.721724,-21600,,
com.google.Chrome,3,1733243493,1733243496,1733243496.501295,-21600,,
com.microsoft.VSCode,6,1733243487,1733243493,1733243493.772548,-21600,,
com.google.Chrome,3,1733243484,1733243487,1733243487.346466,-21600,,
com.microsoft.VSCode,7,1733243477,1733243484,1733243484.627888,-21600,,
com.google.Chrome,5,1733243472,1733243477,1733243477.5888991,-21600,,
com.microsoft.VSCode,4,1733243468,1733243472,1733243472.4395719,-21600,,
com.google.Chrome,1,1733243467,1733243468,1733243468.591978,-21600,,
com.microsoft.VSCode,3,1733243464,1733243467,1733243467.437424,-21600,,
com.google.Chrome,2,1733243462,1733243464,1733243464.617496,-21600,,
com.microsoft.VSCode,3,1733243459,1733243462,1733243462.733999,-21600,,
com.google.Chrome,4,1733243455,1733243459,1733243459.233275,-21600,,
com.microsoft.VSCode,3,1733243452,1733243455,1733243456.038591,-21600,,
com.google.Chrome,1,1733243451,1733243452,1733243452.8404279,-21600,,
com.microsoft.VSCode,10,1733243441,1733243451,1733243451.825243,-21600,,
com.google.Chrome,2,1733243439,1733243441,1733243441.731032,-21600,,
com.microsoft.VSCode,6,1733243433,1733243439,1733243439.3695068,-21600,,
com.google.Chrome,2,1733243431,1733243433,1733243433.474914,-21600,,
com.microsoft.VSCode,2,1733243429,1733243431,1733243432.012001,-21600,,
com.google.Chrome,6,1733243423,1733243429,1733243429.6521602,-21600,,
com.microsoft.VSCode,7,1733243416,1733243423,1733243423.3753839,-21600,,
com.google.Chrome,2,1733243414,1733243416,1733243416.9057832,-21600,,
com.microsoft.VSCode,5,1733243409,1733243414,1733243414.584797,-21600,,
com.google.Chrome,3,1733243406,1733243409,1733243409.738708,-21600,,
com.microsoft.VSCode,1,1733243405,1733243406,1733243406.848281,-21600,,
com.google.Chrome,6,1733243399,1733243405,1733243405.571207,-21600,,
com.microsoft.VSCode,3,1733243396,1733243399,1733243399.8543081,-21600,,
com.google.Chrome,2,1733243394,1733243396,1733243396.308301,-21600,,
com.microsoft.VSCode,3,1733243391,1733243394,1733243394.160252,-21600,,
com.google.Chrome,1,1733243390,1733243391,1733243392.096472,-21600,,
com.microsoft.VSCode,5,1733243385,1733243390,1733243390.9004111,-21600,,
com.google.Chrome,2,1733243383,1733243385,1733243385.205387,-21600,,
com.microsoft.VSCode,2,1733243381,1733243383,1733243383.858218,-21600,,
com.google.Chrome,2,1733243379,1733243381,1733243381.380604,-21600,,
com.microsoft.VSCode,1,1733243378,1733243379,1733243380.03741,-21600,,
com.google.Chrome,3,1733243375,1733243378,1733243378.8932729,-21600,,
com.microsoft.VSCode,8,1733243367,1733243375,1733243375.195774,-21600,,
com.google.Chrome,7,1733243360,1733243367,1733243367.540865,-21600,,
com.microsoft.VSCode,4,1733243356,1733243360,1733243361.046021,-21600,,
com.google.Chrome,9,1733243347,1733243356,1733243356.835466,-21600,,
com.microsoft.VSCode,63,1733243284,1733243347,1733243347.492917,-21600,,
com.google.Chrome,33,1733243251,1733243284,1733243284.4993792,-21600,,
com.microsoft.VSCode,29,1733243222,1733243251,1733243251.07451,-21600,,
com.google.Chrome,5,1733243217,1733243222,1733243222.487529,-21600,,
com.microsoft.VSCode,12,1733243205,1733243217,1733243218.037878,-21600,,
com.google.Chrome,1,1733243204,1733243205,1733243205.777894,-21600,,
com.microsoft.VSCode,3,1733243201,1733243204,1733243204.522974,-21600,,
com.google.Chrome,3,1733243198,1733243201,1733243201.427835,-21600,,
com.microsoft.VSCode,5,1733243193,1733243198,1733243198.972074,-21600,,
com.google.Chrome,23,1733243170,1733243193,1733243193.185738,-21600,,
com.microsoft.VSCode,6,1733243164,1733243170,1733243170.884801,-21600,,
com.google.Chrome,1,1733243163,1733243164,1733243164.8111901,-21600,,
com.microsoft.Office.Outlook,11,1733243118,1733243129,1733243130.648875,-21600,EB445137-D7F5-57EC-87DA-1DB460D64046,"iPhone13,2"
com.microsoft.VSCode,193,1733242970,1733243163,1733243163.402361,-21600,,
com.google.Chrome,19,1733242951,1733242970,1733242970.2110848,-21600,,
com.microsoft.VSCode,2,1733242949,1733242951,1733242951.53484,-21600,,
com.google.Chrome,17,1733242932,1733242949,1733242949.747679,-21600,,
com.microsoft.VSCode,69,1733242863,1733242932,1733242932.760386,-21600,,
com.google.Chrome,1,1733242862,1733242863,1733242863.650261,-21600,,
com.microsoft.VSCode,12,1733242850,1733242862,1733242862.939266,-21600,,
com.google.Chrome,13,1733242837,1733242850,1733242850.098592,-21600,,
com.microsoft.VSCode,2,1733242835,1733242837,1733242837.038568,-21600,,
com.google.Chrome,3,1733242832,1733242835,1733242835.39906,-21600,,
com.microsoft.VSCode,58,1733242774,1733242832,1733242832.574315,-21600,,
com.google.Chrome,5,1733242769,1733242774,1733242774.54627,-21600,,
com.microsoft.VSCode,21,1733242748,1733242769,1733242769.766968,-21600,,
com.google.Chrome,3,1733242745,1733242748,1733242748.8287768,-21600,,
com.microsoft.VSCode,40,1733242705,1733242745,1733242745.572916,-21600,,
com.google.Chrome,12,1733242693,1733242705,1733242705.647437,-21600,,
com.microsoft.VSCode,56,1733242637,1733242693,1733242693.297713,-21600,,
com.google.Chrome,4,1733242633,1733242637,1733242637.448525,-21600,,
com.microsoft.VSCode,38,1733242595,1733242633,1733242633.827281,-21600,,
com.google.Chrome,4,1733242591,1733242595,1733242595.709641,-21600,,
com.microsoft.VSCode,17,1733242574,1733242591,1733242591.79087,-21600,,
com.google.Chrome,12,1733242562,1733242574,1733242574.250331,-21600,,
com.microsoft.VSCode,1,1733242561,1733242562,1733242562.1444678,-21600,,
com.google.Chrome,2,1733242559,1733242561,1733242561.504518,-21600,,
com.microsoft.VSCode,10,1733242549,1733242559,1733242559.6794329,-21600,,
com.google.Chrome,2,1733242547,1733242549,1733242550.004867,-21600,,
com.microsoft.VSCode,16,1733242531,1733242547,1733242547.701963,-21600,,
com.google.Chrome,5,1733242526,1733242531,1733242531.316858,-21600,,
com.microsoft.VSCode,2,1733242524,1733242526,1733242526.736662,-21600,,
com.google.Chrome,1,1733242523,1733242524,1733242524.523207,-21600,,
com.microsoft.VSCode,42,1733242481,1733242523,1733242523.214704,-21600,,
com.google.Chrome,20,1733242461,1733242481,1733242481.901691,-21600,,
com.microsoft.VSCode,1,1733242460,1733242461,1733242461.788645,-21600,,
com.google.Chrome,2,1733242458,1733242460,1733242460.630322,-21600,,
com.microsoft.VSCode,30,1733242428,1733242458,1733242458.39284,-21600,,
com.google.Chrome,1,1733242427,1733242428,1733242428.326833,-21600,,
com.microsoft.VSCode,26,1733242401,1733242427,1733242427.544399,-21600,,
com.google.Chrome,2,1733242399,1733242401,1733242401.5525808,-21600,,
com.microsoft.VSCode,25,1733242374,1733242399,1733242399.612488,-21600,,
com.google.Chrome,11,1733242363,1733242374,1733242374.7806969,-21600,,
com.microsoft.VSCode,16,1733242347,1733242363,1733242364.0200381,-21600,,
com.google.Chrome,28,1733242319,1733242347,1733242347.918093,-21600,,
com.microsoft.VSCode,17,1733242302,1733242319,1733242319.8292708,-21600,,
com.google.Chrome,8,1733242294,1733242302,1733242302.134595,-21600,,
com.microsoft.VSCode,38,1733242256,1733242294,1733242294.473629,-21600,,
com.google.Chrome,2,1733242254,1733242256,1733242256.677423,-21600,,
com.microsoft.VSCode,7,1733242247,1733242254,1733242254.344387,-21600,,
com.google.Chrome,4,1733242243,1733242247,1733242247.411715,-21600,,
com.microsoft.VSCode,8,1733242235,1733242243,1733242243.880285,-21600,,
com.google.Chrome,40,1733242195,1733242235,1733242235.520927,-21600,,
com.microsoft.VSCode,5,1733242190,1733242195,1733242195.77178,-21600,,
com.google.Chrome,21,1733242169,1733242190,1733242190.729045,-21600,,
com.microsoft.VSCode,1,1733242168,1733242169,1733242169.429735,-21600,,
com.google.Chrome,2,1733242166,1733242168,1733242168.750582,-21600,,
com.microsoft.VSCode,2,1733242164,1733242166,1733242166.17295,-21600,,
com.google.Chrome,8,1733242156,1733242164,1733242164.321313,-21600,,
com.microsoft.VSCode,0,1733242156,1733242156,1733242156.544005,-21600,,
com.google.Chrome,4,1733242152,1733242156,1733242156.187698,-21600,,
com.microsoft.VSCode,11,1733242141,1733242152,1733242152.061753,-21600,,
com.google.Chrome,2,1733242139,1733242141,1733242141.2114391,-21600,,
com.microsoft.VSCode,3,1733242136,1733242139,1733242139.6365,-21600,,
com.google.Chrome,2,1733242134,1733242136,1733242136.772795,-21600,,
com.microsoft.VSCode,7,1733242127,1733242134,1733242134.748174,-21600,,
com.google.Chrome,10,1733242117,1733242127,1733242127.908845,-21600,,
com.microsoft.VSCode,16,1733242101,1733242117,1733242117.440305,-21600,,
com.google.Chrome,2,1733242099,1733242101,1733242101.153977,-21600,,
com.microsoft.VSCode,5,1733242094,1733242099,1733242099.853662,-21600,,
com.google.Chrome,2,1733242092,1733242094,1733242094.7253718,-21600,,
com.microsoft.VSCode,18,1733242074,1733242092,1733242092.5235271,-21600,,
com.google.Chrome,4,1733242070,1733242074,1733242074.262598,-21600,,
com.microsoft.VSCode,2,1733242068,1733242070,1733242070.8136868,-21600,,
com.google.Chrome,1,1733242067,1733242068,1733242069.0305781,-21600,,
com.microsoft.VSCode,1,1733242066,1733242067,1733242067.5235229,-21600,,
com.google.Chrome,11,1733242055,1733242066,1733242066.437355,-21600,,
com.microsoft.VSCode,39,1733242016,1733242055,1733242055.532202,-21600,,
com.google.Chrome,27,1733241989,1733242016,1733242016.348919,-21600,,
com.microsoft.VSCode,9,1733241980,1733241989,1733241989.6421309,-21600,,
com.google.Chrome,11,1733241969,1733241980,1733241980.389673,-21600,,
com.microsoft.VSCode,37,1733241932,1733241969,1733241969.2883968,-21600,,
com.google.Chrome,21,1733241911,1733241932,1733241932.3060231,-21600,,
com.microsoft.VSCode,2,1733241909,1733241911,1733241911.5756102,-21600,,
com.google.Chrome,12,1733241897,1733241909,1733241909.933,-21600,,
com.microsoft.VSCode,268,1733241629,1733241897,1733241897.67998,-21600,,
com.google.Chrome,7,1733241622,1733241629,1733241629.089961,-21600,,
com.microsoft.VSCode,7,1733241615,1733241622,1733241622.037712,-21600,,
com.google.Chrome,0,1733241615,1733241615,1733241615.974564,-21600,,
com.microsoft.VSCode,6,1733241609,1733241615,1733241615.1388369,-21600,,
com.google.Chrome,0,1733241609,1733241609,1733241609.869338,-21600,,
com.microsoft.VSCode,4,1733241605,1733241609,1733241609.097532,-21600,,
com.google.Chrome,0,1733241605,1733241605,1733241605.7597451,-21600,,
com.microsoft.VSCode,5,1733241600,1733241605,1733241605.084221,-21600,,
com.google.Chrome,10,1733241590,1733241600,1733241600.590188,-21600,,
com.microsoft.VSCode,61,1733241529,1733241590,1733241590.089895,-21600,,
com.google.Chrome,2,1733241527,1733241529,1733241529.530326,-21600,,
com.microsoft.VSCode,4,1733241523,1733241527,1733241527.860608,-21600,,
com.google.Chrome,3,1733241520,1733241523,1733241523.970617,-21600,,
com.microsoft.VSCode,23,1733241497,1733241520,1733241520.3013659,-21600,,
com.google.Chrome,6,1733241491,1733241497,1733241497.177719,-21600,,
com.microsoft.VSCode,1,1733241490,1733241491,1733241491.4542742,-21600,,
com.google.Chrome,2,1733241488,1733241490,1733241490.338192,-21600,,
com.microsoft.VSCode,20,1733241468,1733241488,1733241488.300838,-21600,,
com.google.Chrome,6,1733241462,1733241468,1733241468.465606,-21600,,
com.microsoft.VSCode,7,1733241455,1733241462,1733241462.70603,-21600,,
com.google.Chrome,4,1733241451,1733241455,1733241455.812933,-21600,,
com.microsoft.VSCode,7,1733241444,1733241451,1733241451.3492842,-21600,,
com.google.Chrome,11,1733241433,1733241444,1733241444.095388,-21600,,
com.microsoft.VSCode,45,1733241388,1733241433,1733241433.67185,-21600,,
com.google.Chrome,6,1733241382,1733241388,1733241388.269491,-21600,,
com.microsoft.VSCode,6,1733241376,1733241382,1733241382.071852,-21600,,
com.google.Chrome,17,1733241359,1733241376,1733241376.136539,-21600,,
com.microsoft.VSCode,13,1733241346,1733241359,1733241359.947818,-21600,,
com.google.Chrome,1,1733241345,1733241346,1733241346.560052,-21600,,
com.microsoft.VSCode,0,1733241345,1733241345,1733241345.897603,-21600,,
com.apple.finder,2,1733241343,1733241345,1733241345.0561671,-21600,,
com.google.Chrome,9,1733241334,1733241343,1733241343.548706,-21600,,
com.apple.finder,1,1733241333,1733241334,1733241334.103931,-21600,,
com.microsoft.VSCode,179,1733241154,1733241333,1733241333.115714,-21600,,
com.apple.finder,1,1733241153,1733241154,1733241154.5521998,-21600,,
com.google.Chrome,25,1733241128,1733241153,1733241153.47509,-21600,,
com.apple.finder,2,1733241126,1733241128,1733241128.553668,-21600,,
com.microsoft.VSCode,114,1733241012,1733241126,1733241127.0401568,-21600,,
com.google.chrome.ios,92,1733240919,1733241011,1733241011.7230911,-21600,EB445137-D7F5-57EC-87DA-1DB460D64046,"iPhone13,2"
com.apple.Music,6,1733240913,1733240919,1733240919.77619,-21600,EB445137-D7F5-57EC-87DA-1DB460D64046,"iPhone13,2"
com.hammerandchisel.discord,26,1733240885,1733240911,1733240911.77498,-21600,EB445137-D7F5-57EC-87DA-1DB460D64046,"iPhone13,2"
com.microsoft.Office.Outlook,5,1733240863,1733240868,1733240868.6042051,-21600,EB445137-D7F5-57EC-87DA-1DB460D64046,"iPhone13,2"
com.apple.camera,7,1733240107,1733240114,1733240115.06971,-21600,EB445137-D7F5-57EC-87DA-1DB460D64046,"iPhone13,2"
com.microsoft.VSCode,301,1733239998,1733240299,1733240299.3109,-21600,,
com.apple.finder,20,1733239978,1733239998,1733239998.074291,-21600,,
com.google.Chrome,28,1733239950,1733239978,1733239978.0402741,-21600,,
com.microsoft.VSCode,11,1733239895,1733239906,1733239906.127429,-21600,,
com.google.Chrome,3,1733239892,1733239895,1733239895.474595,-21600,,
com.apple.weather,83,1733238680,1733238763,1733238763.279691,-21600,EB445137-D7F5-57EC-87DA-1DB460D64046,"iPhone13,2"
com.apple.Health,32,1733238646,1733238678,1733238678.31107,-21600,EB445137-D7F5-57EC-87DA-1DB460D64046,"iPhone13,2"
com.microsoft.Office.Outlook,38,1733238604,1733238642,1733238642.420401,-21600,EB445137-D7F5-57EC-87DA-1DB460D64046,"iPhone13,2"
com.renpho.health,4,1733238600,1733238604,1733238604.744235,-21600,EB445137-D7F5-57EC-87DA-1DB460D64046,"iPhone13,2"
com.renpho.health,20,1733237836,1733237856,1733237857.214589,-21600,EB445137-D7F5-57EC-87DA-1DB460D64046,"iPhone13,2"
com.renpho.health,67,1733237768,1733237835,1733237835.615899,-21600,EB445137-D7F5-57EC-87DA-1DB460D64046,"iPhone13,2"
com.apple.mobiletimer,7,1733236678,1733236685,1733236685.776417,-21600,EB445137-D7F5-57EC-87DA-1DB460D64046,"iPhone13,2"
com.apple.camera,9,1733236517,1733236526,1733236526.818187,-21600,EB445137-D7F5-57EC-87DA-1DB460D64046,"iPhone13,2"
com.thestorygraph.thestorygraph,53,1733205547,1733205600,1733205600.45871,-21600,EB445137-D7F5-57EC-87DA-1DB460D64046,"iPhone13,2"
com.google.Chrome,45,1733203605,1733203650,1733203650.208046,-21600,,
com.google.Chrome,448,1733203139,1733203587,1733203587.9468641,-21600,,
com.google.Chrome,727,1733202309,1733203036,1733203036.143317,-21600,,
com.google.Chrome,314,1733201932,1733202246,1733202246.022656,-21600,,
com.google.Chrome,791,1733201036,1733201827,1733201827.504304,-21600,,
com.google.Chrome,305,1733200625,1733200930,1733200930.5714931,-21600,,
com.truebill.truebillnative,417,1733200240,1733200657,1733200657.334662,-21600,EB445137-D7F5-57EC-87DA-1DB460D64046,"iPhone13,2"
com.apple.Music,10,1733200224,1733200234,1733200234.6780648,-21600,EB445137-D7F5-57EC-87DA-1DB460D64046,"iPhone13,2"
com.apple.findmy,7,1733200216,1733200223,1733200223.465807,-21600,EB445137-D7F5-57EC-87DA-1DB460D64046,"iPhone13,2"
com.apple.findmy,12,1733200201,1733200213,1733200213.354776,-21600,EB445137-D7F5-57EC-87DA-1DB460D64046,"iPhone13,2"
com.google.Chrome,343,1733199941,1733200284,1733200284.498153,-21600,,
com.apple.iCal,60,1733199881,1733199941,1733199941.852981,-21600,,
com.apple.findmy,13,1733199802,1733199815,1733199815.2188401,-21600,EB445137-D7F5-57EC-87DA-1DB460D64046,"iPhone13,2"
com.google.Chrome,80,1733199801,1733199881,1733199881.285464,-21600,,
com.leomehlig.today,29,1733199772,1733199801,1733199802.028707,-21600,,
com.google.Chrome,3,1733199769,1733199772,1733199772.3181438,-21600,,
com.apple.findmy,9,1733199725,1733199734,1733199734.257458,-21600,EB445137-D7F5-57EC-87DA-1DB460D64046,"iPhone13,2"
com.apple.findmy,10,1733199003,1733199013,1733199013.720226,-21600,EB445137-D7F5-57EC-87DA-1DB460D64046,"iPhone13,2"
com.google.Chrome,837,1733198855,1733199692,1733199692.75443,-21600,,
com.google.Chrome,346,1733197281,1733197627,1733197627.491417,-21600,,
com.leomehlig.today,7,1733197274,1733197281,1733197281.133915,-21600,,
com.google.Chrome,9,1733197265,1733197274,1733197274.220696,-21600,,
com.leomehlig.today,3,1733197262,1733197265,1733197267.2283568,-21600,,
com.apple.findmy,3,1733196892,1733196895,1733196895.246005,-21600,EB445137-D7F5-57EC-87DA-1DB460D64046,"iPhone13,2"
com.leomehlig.today,114,1733196010,1733196124,1733196124.267746,-21600,,
com.apple.findmy,4,1733195515,1733195519,1733195519.04982,-21600,EB445137-D7F5-57EC-87DA-1DB460D64046,"iPhone13,2"
com.google.Chrome,2255,1733193755,1733196010,1733196010.629061,-21600,,
com.apple.MobileSMS,15,1733193740,1733193755,1733193755.91609,-21600,,
com.google.Chrome,26,1733193714,1733193740,1733193740.131091,-21600,,
com.apple.MobileSMS,16,1733193698,1733193714,1733193714.406524,-21600,,
com.google.Chrome,1,1733193697,1733193698,1733193698.309258,-21600,,
com.apple.MobileSMS,28,1733193669,1733193697,1733193697.704114,-21600,,
com.apple.findmy,9,1733193413,1733193422,1733193422.359412,-21600,EB445137-D7F5-57EC-87DA-1DB460D64046,"iPhone13,2"
com.apple.MobileSMS,3,1733193400,1733193403,1733193403.3629432,-21600,EB445137-D7F5-57EC-87DA-1DB460D64046,"iPhone13,2"
com.google.Chrome,439,1733193230,1733193669,1733193669.6014519,-21600,,
com.leomehlig.today,48,1733193182,1733193230,1733193230.356122,-21600,,
com.google.Chrome,303,1733192879,1733193182,1733193182.761335,-21600,,
com.leomehlig.today,12,1733192867,1733192879,1733192879.116055,-21600,,
com.google.Chrome,53,1733192814,1733192867,1733192867.474922,-21600,,
com.leomehlig.today,3,1733192800,1733192803,1733192803.7007608,-21600,,
com.microsoft.VSCode,9,1733192791,1733192800,1733192800.992136,-21600,,
com.leomehlig.today,1,1733192790,1733192791,1733192791.8625178,-21600,,
com.google.Chrome,64,1733192726,1733192790,1733192790.752187,-21600,,
com.leomehlig.today,26,1733192700,1733192726,1733192726.0531201,-21600,,
com.google.Chrome,99,1733192601,1733192700,1733192700.6819081,-21600,,
com.leomehlig.today,11,1733192590,1733192601,1733192601.9611468,-21600,,
com.google.Chrome,18,1733192572,1733192590,1733192590.674975,-21600,,
com.microsoft.VSCode,2,1733192570,1733192572,1733192572.0858722,-21600,,
com.hnc.Discord,4,1733192566,1733192570,1733192570.75768,-21600,,
com.microsoft.VSCode,1,1733192565,1733192566,1733192566.157938,-21600,,
com.apple.Preview,7,1733192558,1733192565,1733192565.275604,-21600,,
com.microsoft.VSCode,2,1733192556,1733192558,1733192558.061059,-21600,,
com.google.Chrome,18,1733192538,1733192556,1733192556.738868,-21600,,
com.microsoft.VSCode,59,1733192479,1733192538,1733192538.8605661,-21600,,
com.google.Chrome,34,1733192445,1733192479,1733192479.565566,-21600,,
com.microsoft.VSCode,239,1733192206,1733192445,1733192445.055317,-21600,,
com.hnc.Discord,16,1733192190,1733192206,1733192206.367008,-21600,,
com.google.Chrome,62,1733192128,1733192190,1733192190.5568929,-21600,,
com.hnc.Discord,10,1733192118,1733192128,1733192128.2648191,-21600,,
com.google.Chrome,5,1733192113,1733192118,1733192118.903374,-21600,,
com.microsoft.VSCode,31,1733192082,1733192113,1733192113.2991781,-21600,,
com.hnc.Discord,3,1733192079,1733192082,1733192082.3090138,-21600,,
com.microsoft.VSCode,41,1733192038,1733192079,1733192079.757656,-21600,,
com.hnc.Discord,1,1733192037,1733192038,1733192038.753047,-21600,,
com.microsoft.VSCode,54,1733191983,1733192037,1733192037.581836,-21600,,
com.hnc.Discord,5,1733191978,1733191983,1733191983.518723,-21600,,
com.microsoft.VSCode,2,1733191976,1733191978,1733191978.992896,-21600,,
com.apple.MobileSMS,31,1733191936,1733191967,1733191967.83519,-21600,EB445137-D7F5-57EC-87DA-1DB460D64046,"iPhone13,2"
com.hnc.Discord,62,1733191914,1733191976,1733191976.982881,-21600,,
com.microsoft.VSCode,3,1733191911,1733191914,1733191914.132633,-21600,,
com.hnc.Discord,61,1733191850,1733191911,1733191911.5343142,-21600,,
com.microsoft.VSCode,32,1733191818,1733191850,1733191850.2595081,-21600,,
com.leomehlig.today,1,1733191817,1733191818,1733191818.905562,-21600,,
com.google.Chrome,14,1733191803,1733191817,1733191817.905797,-21600,,
com.leomehlig.today,2,1733191801,1733191803,1733191803.837389,-21600,,
com.google.Chrome,20,1733191781,1733191801,1733191801.838842,-21600,,
com.microsoft.VSCode,3,1733191778,1733191781,1733191781.0474272,-21600,,
com.google.Chrome,0,1733191778,1733191778,1733191779.039038,-21600,,
com.microsoft.VSCode,4,1733191774,1733191778,1733191778.258079,-21600,,
com.google.Chrome,2,1733191772,1733191774,1733191774.335093,-21600,,
com.microsoft.VSCode,3,1733191769,1733191772,1733191772.6751719,-21600,,
com.google.Chrome,14,1733191755,1733191769,1733191769.6486669,-21600,,
com.microsoft.VSCode,32,1733191723,1733191755,1733191755.542674,-21600,,
com.google.Chrome,2,1733191721,1733191723,1733191723.5095859,-21600,,
com.microsoft.VSCode,2,1733191719,1733191721,1733191721.556428,-21600,,
com.google.Chrome,2,1733191717,1733191719,1733191719.6701121,-21600,,
com.microsoft.VSCode,2,1733191715,1733191717,1733191718.018276,-21600,,
com.google.Chrome,2,1733191713,1733191715,1733191715.173631,-21600,,
com.microsoft.VSCode,1,1733191712,1733191713,1733191714.023819,-21600,,
com.google.Chrome,1,1733191711,1733191712,1733191712.2150989,-21600,,
com.microsoft.VSCode,3,1733191708,1733191711,1733191711.323015,-21600,,
com.google.Chrome,2,1733191706,1733191708,1733191708.739925,-21600,,
com.microsoft.VSCode,4,1733191702,1733191706,1733191707.031455,-21600,,
com.google.Chrome,1,1733191701,1733191702,1733191702.893375,-21600,,
com.microsoft.VSCode,1,1733191700,1733191701,1733191702.0047069,-21600,,
com.google.Chrome,1,1733191699,1733191700,1733191700.961238,-21600,,
com.microsoft.VSCode,3,1733191696,1733191699,1733191699.904011,-21600,,
com.google.Chrome,0,1733191696,1733191696,1733191696.414326,-21600,,
com.microsoft.VSCode,2,1733191694,1733191696,1733191696.1052852,-21600,,
com.google.Chrome,17,1733191677,1733191694,1733191694.125752,-21600,,
com.microsoft.VSCode,46,1733191631,1733191677,1733191677.596602,-21600,,
com.google.Chrome,2,1733191629,1733191631,1733191631.4545488,-21600,,
com.microsoft.VSCode,6,1733191623,1733191629,1733191629.149271,-21600,,
com.google.Chrome,51,1733191572,1733191623,1733191623.1557279,-21600,,
com.microsoft.VSCode,67,1733191505,1733191572,1733191572.08517,-21600,,
com.google.Chrome,44,1733191461,1733191505,1733191505.534577,-21600,,
com.microsoft.VSCode,2,1733191459,1733191461,1733191461.3263521,-21600,,
com.google.Chrome,3,1733191456,1733191459,1733191459.830395,-21600,,
com.microsoft.VSCode,196,1733191260,1733191456,1733191456.098052,-21600,,
com.google.Chrome,14,1733191246,1733191260,1733191260.600473,-21600,,
com.microsoft.VSCode,66,1733191180,1733191246,1733191246.919446,-21600,,
com.google.Chrome,22,1733191158,1733191180,1733191180.388248,-21600,,
com.microsoft.VSCode,4,1733191154,1733191158,1733191159.029078,-21600,,
com.google.Chrome,5,1733191149,1733191154,1733191154.768935,-21600,,
com.microsoft.VSCode,9,1733191140,1733191149,1733191149.951664,-21600,,
com.google.Chrome,14,1733191126,1733191140,1733191140.8136091,-21600,,
com.microsoft.VSCode,2,1733191124,1733191126,1733191126.814456,-21600,,
com.google.Chrome,6,1733191118,1733191124,1733191124.369224,-21600,,
com.microsoft.VSCode,96,1733191022,1733191118,1733191118.662595,-21600,,
com.google.Chrome,15,1733189751,1733189766,1733189766.937213,-21600,,
com.apple.camera,2,1733189728,1733189730,1733189730.4465609,-21600,EB445137-D7F5-57EC-87DA-1DB460D64046,"iPhone13,2"
com.microsoft.VSCode,112,1733189639,1733189751,1733189751.340217,-21600,,
com.google.Chrome,13,1733189626,1733189639,1733189639.734894,-21600,,
com.microsoft.VSCode,14,1733189612,1733189626,1733189626.367804,-21600,,
com.google.Chrome,9,1733189603,1733189612,1733189613.002639,-21600,,
com.microsoft.VSCode,5,1733189598,1733189603,1733189603.883789,-21600,,
com.google.Chrome,4,1733189594,1733189598,1733189598.82163,-21600,,
com.microsoft.VSCode,2,1733189592,1733189594,1733189594.101894,-21600,,
com.google.Chrome,18,1733189574,1733189592,1733189592.329904,-21600,,
com.microsoft.VSCode,8,1733189566,1733189574,1733189574.0728831,-21600,,
com.google.Chrome,15,1733189551,1733189566,1733189566.401175,-21600,,
com.microsoft.VSCode,2,1733189549,1733189551,1733189551.303647,-21600,,
com.google.Chrome,1,1733189548,1733189549,1733189549.7434149,-21600,,
com.microsoft.VSCode,2,1733189546,1733189548,1733189548.659772,-21600,,
com.google.Chrome,19,1733189527,1733189546,1733189546.732203,-21600,,
com.microsoft.VSCode,2,1733189525,1733189527,1733189527.5782828,-21600,,
com.google.Chrome,1,1733189524,1733189525,1733189525.153518,-21600,,
com.microsoft.VSCode,9,1733189515,1733189524,1733189524.7447472,-21600,,
com.google.Chrome,4,1733189511,1733189515,1733189515.704739,-21600,,
com.microsoft.VSCode,38,1733189473,1733189511,1733189511.375605,-21600,,
com.google.Chrome,0,1733189473,1733189473,1733189473.673439,-21600,,
com.microsoft.VSCode,1,1733189472,1733189473,1733189473.071589,-21600,,
com.google.Chrome,6,1733189466,1733189472,1733189472.6792731,-21600,,
com.microsoft.VSCode,1,1733189465,1733189466,1733189466.194796,-21600,,
com.google.Chrome,51,1733189414,1733189465,1733189465.45288,-21600,,
com.microsoft.VSCode,9,1733189405,1733189414,1733189414.725183,-21600,,
com.google.Chrome,5,1733189400,1733189405,1733189405.920395,-21600,,
com.microsoft.VSCode,6,1733189394,1733189400,1733189400.633397,-21600,,
com.apple.camera,0,1733189322,1733189322,1733189322.281487,-21600,EB445137-D7F5-57EC-87DA-1DB460D64046,"iPhone13,2"
com.apple.camera,1,1733189318,1733189319,1733189319.925194,-21600,EB445137-D7F5-57EC-87DA-1DB460D64046,"iPhone13,2"
com.microsoft.VSCode,71,1733189242,1733189313,1733189313.816657,-21600,,
com.google.Chrome,19,1733189223,1733189242,1733189242.2393,-21600,,
com.microsoft.VSCode,19,1733189204,1733189223,1733189223.1270962,-21600,,
com.google.Chrome,10,1733189194,1733189204,1733189204.483475,-21600,,
com.microsoft.VSCode,119,1733189075,1733189194,1733189194.374465,-21600,,
com.google.Chrome,17,1733189058,1733189075,1733189075.638988,-21600,,
com.microsoft.VSCode,2,1733189056,1733189058,1733189058.563675,-21600,,
com.google.Chrome,44,1733189012,1733189056,1733189056.424428,-21600,,
com.microsoft.VSCode,43,1733188969,1733189012,1733189012.466086,-21600,,
com.google.Chrome,1,1733188968,1733188969,1733188969.898828,-21600,,
com.microsoft.VSCode,9,1733188959,1733188968,1733188968.452553,-21600,,
com.google.Chrome,1,1733188958,1733188959,1733188959.176248,-21600,,
com.microsoft.VSCode,3,1733188955,1733188958,1733188958.426256,-21600,,
com.google.Chrome,2,1733188953,1733188955,1733188955.989903,-21600,,
com.microsoft.VSCode,5,1733188948,1733188953,1733188953.7958841,-21600,,
com.google.Chrome,4,1733188944,1733188948,1733188949.019567,-21600,,
com.microsoft.VSCode,2,1733188942,1733188944,1733188944.064291,-21600,,
com.google.Chrome,1,1733188941,1733188942,1733188942.7591438,-21600,,
com.microsoft.VSCode,1,1733188940,1733188941,1733188941.185566,-21600,,
com.google.Chrome,60,1733188880,1733188940,1733188940.154505,-21600,,
com.microsoft.VSCode,16,1733188864,1733188880,1733188881.025504,-21600,,
com.google.Chrome,4,1733188860,1733188864,1733188864.1363258,-21600,,
com.microsoft.VSCode,1,1733188859,1733188860,1733188860.933532,-21600,,
com.google.Chrome,2,1733188857,1733188859,1733188859.958312,-21600,,
com.microsoft.VSCode,1,1733188856,1733188857,1733188857.6774778,-21600,,
com.google.Chrome,1,1733188855,1733188856,1733188856.9962049,-21600,,
com.microsoft.VSCode,8,1733188847,1733188855,1733188855.711499,-21600,,
com.google.Chrome,44,1733188803,1733188847,1733188847.751395,-21600,,
com.microsoft.VSCode,6,1733188797,1733188803,1733188803.501196,-21600,,
com.google.Chrome,225,1733188572,1733188797,1733188797.410253,-21600,,
com.microsoft.VSCode,20,1733188552,1733188572,1733188572.201367,-21600,,
com.apple.camera,2,1733188455,1733188457,1733188457.213719,-21600,EB445137-D7F5-57EC-87DA-1DB460D64046,"iPhone13,2"
com.google.Chrome,138,1733188414,1733188552,1733188552.477438,-21600,,
com.microsoft.VSCode,1,1733188413,1733188414,1733188414.984229,-21600,,
com.google.Chrome,50,1733188363,1733188413,1733188413.976692,-21600,,
com.microsoft.VSCode,33,1733188317,1733188350,1733188350.976953,-21600,,
com.leomehlig.today,86,1733188231,1733188317,1733188317.422701,-21600,,
com.instructure.icanvas,38,1733188020,1733188058,1733188058.89958,-21600,EB445137-D7F5-57EC-87DA-1DB460D64046,"iPhone13,2"
com.toyopagroup.picaboo,98,1733187890,1733187988,1733187988.3226209,-21600,EB445137-D7F5-57EC-87DA-1DB460D64046,"iPhone13,2"
com.apple.Music,4,1733187886,1733187890,1733187891.137363,-21600,EB445137-D7F5-57EC-87DA-1DB460D64046,"iPhone13,2"
com.apple.Music,6,1733185595,1733185601,1733185601.8605819,-21600,EB445137-D7F5-57EC-87DA-1DB460D64046,"iPhone13,2"
com.apple.Music,9,1733185584,1733185593,1733185593.6446,-21600,EB445137-D7F5-57EC-87DA-1DB460D64046,"iPhone13,2"
com.myfitnesspal.mfp,4,1733185580,1733185584,1733185584.9558702,-21600,EB445137-D7F5-57EC-87DA-1DB460D64046,"iPhone13,2"
com.myfitnesspal.mfp,40,1733185472,1733185512,1733185512.331917,-21600,EB445137-D7F5-57EC-87DA-1DB460D64046,"iPhone13,2"
com.myfitnesspal.mfp,280,1733185164,1733185444,1733185445.212512,-21600,EB445137-D7F5-57EC-87DA-1DB460D64046,"iPhone13,2"
com.myfitnesspal.mfp,61,1733184977,1733185038,1733185039.187183,-21600,EB445137-D7F5-57EC-87DA-1DB460D64046,"iPhone13,2"
com.apple.Music,38,1733184934,1733184972,1733184973.0240169,-21600,EB445137-D7F5-57EC-87DA-1DB460D64046,"iPhone13,2"
com.myfitnesspal.mfp,2,1733184931,1733184933,1733184933.183716,-21600,EB445137-D7F5-57EC-87DA-1DB460D64046,"iPhone13,2"
com.myfitnesspal.mfp,99,1733184817,1733184916,1733184916.991726,-21600,EB445137-D7F5-57EC-87DA-1DB460D64046,"iPhone13,2"
com.toyopagroup.picaboo,1,1733184815,1733184816,1733184818.402719,-21600,EB445137-D7F5-57EC-87DA-1DB460D64046,"iPhone13,2"
com.toyopagroup.picaboo,29,1733183361,1733183390,1733183390.542414,-21600,EB445137-D7F5-57EC-87DA-1DB460D64046,"iPhone13,2"
com.apple.camera,4,1733183342,1733183346,1733183347.0658488,-21600,EB445137-D7F5-57EC-87DA-1DB460D64046,"iPhone13,2"
com.google.chrome.ios,16,1733183341,1733183357,1733183357.2091532,-21600,EB445137-D7F5-57EC-87DA-1DB460D64046,"iPhone13,2"
com.apple.camera,5,1733183166,1733183171,1733183171.998832,-21600,EB445137-D7F5-57EC-87DA-1DB460D64046,"iPhone13,2"
com.google.chrome.ios,6,1733183165,1733183171,1733183172.013042,-21600,EB445137-D7F5-57EC-87DA-1DB460D64046,"iPhone13,2"
com.apple.camera,9,1733183151,1733183160,1733183160.963601,-21600,EB445137-D7F5-57EC-87DA-1DB460D64046,"iPhone13,2"
com.google.chrome.ios,11,1733183149,1733183160,1733183160.966027,-21600,EB445137-D7F5-57EC-87DA-1DB460D64046,"iPhone13,2"
com.apple.camera,9,1733183118,1733183127,1733183127.364892,-21600,EB445137-D7F5-57EC-87DA-1DB460D64046,"iPhone13,2"
com.google.chrome.ios,10,1733183117,1733183127,1733183127.3681989,-21600,EB445137-D7F5-57EC-87DA-1DB460D64046,"iPhone13,2"
com.apple.camera,2,1733183051,1733183053,1733183054.160116,-21600,EB445137-D7F5-57EC-87DA-1DB460D64046,"iPhone13,2"
com.google.chrome.ios,3,1733183050,1733183053,1733183054.2234778,-21600,EB445137-D7F5-57EC-87DA-1DB460D64046,"iPhone13,2"
com.apple.camera,34,1733182993,1733183027,1733183027.339287,-21600,EB445137-D7F5-57EC-87DA-1DB460D64046,"iPhone13,2"
com.google.chrome.ios,35,1733182992,1733183027,1733183027.346014,-21600,EB445137-D7F5-57EC-87DA-1DB460D64046,"iPhone13,2"
com.google.chrome.ios,23,1733182946,1733182969,1733182969.840774,-21600,EB445137-D7F5-57EC-87DA-1DB460D64046,"iPhone13,2"
com.toyopagroup.picaboo,62,1733182782,1733182844,1733182844.440382,-21600,EB445137-D7F5-57EC-87DA-1DB460D64046,"iPhone13,2"
com.hammerandchisel.discord,1,1733182779,1733182780,1733182780.277845,-21600,EB445137-D7F5-57EC-87DA-1DB460D64046,"iPhone13,2"
com.apple.mobilecal,4,1733182772,1733182776,1733182776.34934,-21600,EB445137-D7F5-57EC-87DA-1DB460D64046,"iPhone13,2"
com.hammerandchisel.discord,6,1733182764,1733182770,1733182770.237825,-21600,EB445137-D7F5-57EC-87DA-1DB460D64046,"iPhone13,2"
com.toyopagroup.picaboo,38,1733182726,1733182764,1733182764.3141909,-21600,EB445137-D7F5-57EC-87DA-1DB460D64046,"iPhone13,2"
com.intsig.CamScannerLite,2,1733182724,1733182726,1733182727.224473,-21600,EB445137-D7F5-57EC-87DA-1DB460D64046,"iPhone13,2"
com.leomehlig.today,234,1733182483,1733182717,1733182717.076129,-21600,,
com.google.Chrome,988,1733181495,1733182483,1733182483.485605,-21600,,
com.leomehlig.today,50,1733181445,1733181495,1733181495.786736,-21600,,
com.intsig.CamScannerLite,96,1733181333,1733181429,1733181429.715877,-21600,EB445137-D7F5-57EC-87DA-1DB460D64046,"iPhone13,2"
com.google.Chrome,953,1733180492,1733181445,1733181445.852024,-21600,,
com.leomehlig.today,37,1733180455,1733180492,1733180492.867464,-21600,,
com.google.Chrome,1540,1733178915,1733180455,1733180455.570487,-21600,,
com.leomehlig.today,7,1733178908,1733178915,1733178915.092157,-21600,,
com.apple.news,138,1733178663,1733178801,1733178802.627808,-21600,EB445137-D7F5-57EC-87DA-1DB460D64046,"iPhone13,2"
com.leomehlig.today,328,1733178558,1733178886,1733178886.07437,-21600,,
com.apple.weather,7,1733177647,1733177654,1733177654.647532,-21600,EB445137-D7F5-57EC-87DA-1DB460D64046,"iPhone13,2"
com.google.Chrome,2591,1733175967,1733178558,1733178558.299859,-21600,,
com.leomehlig.today,20,1733175947,1733175967,1733175967.751406,-21600,,
com.hammerandchisel.discord,60,1733174516,1733174576,1733174576.3359098,-21600,EB445137-D7F5-57EC-87DA-1DB460D64046,"iPhone13,2"
com.apple.Music,9,1733174504,1733174513,1733174513.1057081,-21600,EB445137-D7F5-57EC-87DA-1DB460D64046,"iPhone13,2"
com.google.chrome.ios,17,1733174486,1733174503,1733174503.9991121,-21600,EB445137-D7F5-57EC-87DA-1DB460D64046,"iPhone13,2"
com.google.chrome.ios,36,1733174443,1733174479,1733174479.896686,-21600,EB445137-D7F5-57EC-87DA-1DB460D64046,"iPhone13,2"
com.microsoft.Office.Outlook,34,1733174409,1733174443,1733174443.4892259,-21600,EB445137-D7F5-57EC-87DA-1DB460D64046,"iPhone13,2"
com.toyopagroup.picaboo,15,1733174394,1733174409,1733174410.02184,-21600,EB445137-D7F5-57EC-87DA-1DB460D64046,"iPhone13,2"
com.google.Chrome,1773,1733174174,1733175947,1733175947.692511,-21600,,
com.google.Chrome,510,1733173647,1733174157,1733174157.885001,-21600,,
com.apple.reminders,4,1733173643,1733173647,1733173647.930685,-21600,,
com.google.Chrome,410,1733173233,1733173643,1733173643.55509,-21600,,
com.leomehlig.today,27,1733173206,1733173233,1733173233.90527,-21600,,
com.toyopagroup.picaboo,6,1733172895,1733172901,1733172901.477063,-21600,EB445137-D7F5-57EC-87DA-1DB460D64046,"iPhone13,2"
com.toyopagroup.picaboo,50,1733172622,1733172672,1733172672.414846,-21600,EB445137-D7F5-57EC-87DA-1DB460D64046,"iPhone13,2"
com.apple.weather,12,1733171756,1733171768,1733171768.921061,-21600,EB445137-D7F5-57EC-87DA-1DB460D64046,"iPhone13,2"
com.google.Chrome,1492,1733171714,1733173206,1733173206.448292,-21600,,
com.truebill.truebillnative,69,1733171671,1733171740,1733171741.016588,-21600,EB445137-D7F5-57EC-87DA-1DB460D64046,"iPhone13,2"
com.clairmail.fth.client,58,1733171609,1733171667,1733171667.703421,-21600,EB445137-D7F5-57EC-87DA-1DB460D64046,"iPhone13,2"
com.toyopagroup.picaboo,124,1733171477,1733171601,1733171601.428684,-21600,EB445137-D7F5-57EC-87DA-1DB460D64046,"iPhone13,2"
com.instructure.icanvas,54,1733171423,1733171477,1733171478.1343908,-21600,EB445137-D7F5-57EC-87DA-1DB460D64046,"iPhone13,2"
com.apple.weather,7,1733171416,1733171423,1733171423.8000689,-21600,EB445137-D7F5-57EC-87DA-1DB460D64046,"iPhone13,2"
com.google.Chrome,581,1733171133,1733171714,1733171714.064326,-21600,,
com.apple.finder,45,1733171088,1733171133,1733171133.974642,-21600,,
com.google.Chrome,103,1733170985,1733171088,1733171088.6878061,-21600,,
com.leomehlig.today,8,1733170977,1733170985,1733170985.532676,-21600,,
com.google.Chrome,11,1733170966,1733170977,1733170977.530483,-21600,,
com.leomehlig.today,15,1733170951,1733170966,1733170966.547194,-21600,,
com.apple.weather,44,1733170224,1733170268,1733170268.331674,-21600,EB445137-D7F5-57EC-87DA-1DB460D64046,"iPhone13,2"
com.google.Chrome,1266,1733169685,1733170951,1733170951.810992,-21600,,
com.leomehlig.today,7,1733169658,1733169665,1733169665.499605,-21600,,
com.microsoft.VSCode,12,1733169646,1733169658,1733169658.705275,-21600,,
com.apple.camera,6,1733168939,1733168945,1733168945.731566,-21600,EB445137-D7F5-57EC-87DA-1DB460D64046,"iPhone13,2"
com.apple.camera,4,1733168908,1733168912,1733168913.0200071,-21600,EB445137-D7F5-57EC-87DA-1DB460D64046,"iPhone13,2"
com.clairmail.fth.client,6,1733168824,1733168830,1733168830.3037748,-21600,EB445137-D7F5-57EC-87DA-1DB460D64046,"iPhone13,2"
com.clairmail.fth.client,31,1733168793,1733168824,1733168824.186764,-21600,EB445137-D7F5-57EC-87DA-1DB460D64046,"iPhone13,2"
com.clairmail.fth.client,25,1733168767,1733168792,1733168792.9800181,-21600,EB445137-D7F5-57EC-87DA-1DB460D64046,"iPhone13,2"
com.apple.calculator,4,1733168758,1733168762,1733168762.5541291,-21600,EB445137-D7F5-57EC-87DA-1DB460D64046,"iPhone13,2"
com.apple.MobileSMS,2,1733168756,1733168758,1733168758.950604,-21600,EB445137-D7F5-57EC-87DA-1DB460D64046,"iPhone13,2"
com.apple.calculator,7,1733168749,1733168756,1733168756.1494699,-21600,EB445137-D7F5-57EC-87DA-1DB460D64046,"iPhone13,2"
com.apple.MobileSMS,16,1733168733,1733168749,1733168749.355478,-21600,EB445137-D7F5-57EC-87DA-1DB460D64046,"iPhone13,2"
com.toyopagroup.picaboo,8,1733168723,1733168731,1733168731.812436,-21600,EB445137-D7F5-57EC-87DA-1DB460D64046,"iPhone13,2"
com.microsoft.VSCode,260,1733168578,1733168838,1733168839.2754679,-21600,,
com.toyopagroup.picaboo,76,1733168565,1733168641,1733168642.254308,-21600,EB445137-D7F5-57EC-87DA-1DB460D64046,"iPhone13,2"
com.google.Chrome,57,1733168521,1733168578,1733168578.333403,-21600,,
com.microsoft.VSCode,1,1733168520,1733168521,1733168521.7956219,-21600,,
com.google.Chrome,2,1733168518,1733168520,1733168520.0535789,-21600,,
com.apple.finder,1,1733168517,1733168518,1733168518.950634,-21600,,
com.leomehlig.today,63,1733168454,1733168517,1733168517.887794,-21600,,
com.microsoft.VSCode,22,1733168432,1733168454,1733168454.297605,-21600,,
com.google.Chrome,73,1733168359,1733168432,1733168432.1602302,-21600,,
com.microsoft.VSCode,1,1733168358,1733168359,1733168359.995792,-21600,,
com.google.Chrome,6,1733168352,1733168358,1733168358.453323,-21600,,
com.microsoft.VSCode,2,1733168350,1733168352,1733168352.389835,-21600,,
com.google.Chrome,7,1733168343,1733168350,1733168350.592495,-21600,,
com.microsoft.VSCode,2,1733168341,1733168343,1733168343.781575,-21600,,
com.google.Chrome,3,1733168338,1733168341,1733168341.175336,-21600,,
com.microsoft.VSCode,2,1733168336,1733168338,1733168338.35526,-21600,,
com.google.Chrome,4,1733168332,1733168336,1733168336.1110768,-21600,,
com.microsoft.VSCode,1,1733168331,1733168332,1733168332.276101,-21600,,
com.google.Chrome,2,1733168329,1733168331,1733168331.089727,-21600,,
com.microsoft.VSCode,1,1733168328,1733168329,1733168329.219877,-21600,,
com.google.Chrome,8,1733168320,1733168328,1733168328.046375,-21600,,
com.microsoft.VSCode,2,1733168318,1733168320,1733168320.391824,-21600,,
com.google.Chrome,0,1733168318,1733168318,1733168318.968176,-21600,,
com.microsoft.VSCode,1,1733168317,1733168318,1733168318.635787,-21600,,
com.google.Chrome,99,1733168218,1733168317,1733168317.7688441,-21600,,
com.microsoft.VSCode,2,1733168216,1733168218,1733168218.4876661,-21600,,
com.google.Chrome,2,1733168214,1733168216,1733168216.973064,-21600,,
com.microsoft.VSCode,3,1733168211,1733168214,1733168214.2199569,-21600,,
com.google.Chrome,11,1733168200,1733168211,1733168211.425208,-21600,,
com.microsoft.VSCode,840,1733167360,1733168200,1733168200.309297,-21600,,
com.google.Chrome,9,1733167351,1733167360,1733167360.0640259,-21600,,
com.microsoft.VSCode,1,1733167350,1733167351,1733167351.768986,-21600,,
com.google.Chrome,14,1733167336,1733167350,1733167350.657512,-21600,,
com.microsoft.VSCode,37,1733167299,1733167336,1733167336.139379,-21600,,
com.apple.finder,198,1733167101,1733167299,1733167299.822329,-21600,,
com.google.Chrome,259,1733166842,1733167101,1733167101.9744039,-21600,,
com.microsoft.VSCode,3,1733166839,1733166842,1733166842.767785,-21600,,
com.google.Chrome,514,1733166325,1733166839,1733166839.911921,-21600,,
com.apple.iCal,28,1733166297,1733166325,1733166325.681075,-21600,,
com.google.Chrome,145,1733166152,1733166297,1733166297.8215032,-21600,,
com.microsoft.VSCode,25,1733166127,1733166152,1733166152.10472,-21600,,
com.google.Chrome,2,1733166125,1733166127,1733166127.2002568,-21600,,
com.microsoft.VSCode,33,1733166092,1733166125,1733166125.995068,-21600,,
com.google.Chrome,26,1733166066,1733166092,1733166092.9520268,-21600,,
com.microsoft.VSCode,199,1733165867,1733166066,1733166066.977755,-21600,,
com.google.Chrome,6,1733165861,1733165867,1733165867.4501538,-21600,,
com.microsoft.VSCode,4,1733165857,1733165861,1733165861.987077,-21600,,
com.google.Chrome,13,1733165844,1733165857,1733165857.315561,-21600,,
com.microsoft.VSCode,4,1733165840,1733165844,1733165844.807739,-21600,,
com.google.Chrome,3,1733165837,1733165840,1733165840.575395,-21600,,
com.microsoft.VSCode,4,1733165833,1733165837,1733165837.101959,-21600,,
com.google.Chrome,28,1733165805,1733165833,1733165834.012735,-21600,,
com.microsoft.VSCode,1,1733165804,1733165805,1733165805.652005,-21600,,
com.google.Chrome,4,1733165800,1733165804,1733165804.702143,-21600,,
com.microsoft.VSCode,271,1733165529,1733165800,1733165800.228644,-21600,,
com.google.Chrome,16,1733165513,1733165529,1733165529.7936401,-21600,,
com.microsoft.VSCode,13,1733165500,1733165513,1733165513.2354112,-21600,,
com.google.Chrome,2,1733165498,1733165500,1733165500.6592221,-21600,,
com.microsoft.VSCode,1,1733165497,1733165498,1733165498.190274,-21600,,
com.google.Chrome,17,1733165480,1733165497,1733165497.400076,-21600,,
com.google.Chrome,196,1733164435,1733164631,1733164631.829126,-21600,,
com.microsoft.VSCode,121,1733164314,1733164435,1733164435.344024,-21600,,
com.google.Chrome,1,1733164313,1733164314,1733164314.6637,-21600,,
com.microsoft.VSCode,0,1733164313,1733164313,1733164313.940855,-21600,,
com.google.Chrome,37,1733164276,1733164313,1733164313.194127,-21600,,
com.microsoft.VSCode,9,1733164267,1733164276,1733164276.4615169,-21600,,
com.google.Chrome,20,1733164247,1733164267,1733164267.247205,-21600,,
com.microsoft.VSCode,8,1733164239,1733164247,1733164247.777082,-21600,,
com.google.Chrome,4,1733164235,1733164239,1733164239.33254,-21600,,
com.microsoft.VSCode,47,1733164188,1733164235,1733164235.061197,-21600,,
com.google.Chrome,3,1733164185,1733164188,1733164188.764395,-21600,,
com.google.Chrome,321,1733163653,1733163974,1733163974.923986,-21600,,
com.microsoft.VSCode,106,1733163547,1733163653,1733163653.0234752,-21600,,
com.google.Chrome,616,1733162931,1733163547,1733163547.3942509,-21600,,
com.microsoft.VSCode,4,1733162927,1733162931,1733162933.8130388,-21600,,
com.apple.news,12,1733162427,1733162439,1733162440.0551162,-21600,EB445137-D7F5-57EC-87DA-1DB460D64046,"iPhone13,2"
com.microsoft.VSCode,474,1733162292,1733162766,1733162766.5057,-21600,,
com.google.Chrome,12,1733162280,1733162292,1733162295.249654,-21600,,
com.microsoft.VSCode,109,1733162171,1733162280,1733162280.877281,-21600,,
com.google.Chrome,630,1733161541,1733162171,1733162172.0136762,-21600,,
com.google.Chrome,1133,1733159516,1733160649,1733160649.152935,-21600,,
com.apple.iCal,80,1733159436,1733159516,1733159517.398137,-21600,,
com.leomehlig.today,19,1733159417,1733159436,1733159437.20541,-21600,,
com.apple.news,120,1733155127,1733155247,1733155247.7765179,-21600,EB445137-D7F5-57EC-87DA-1DB460D64046,"iPhone13,2"
com.apple.weather,3,1733155110,1733155113,1733155113.858506,-21600,EB445137-D7F5-57EC-87DA-1DB460D64046,"iPhone13,2"
com.apple.camera,5,1733154938,1733154943,1733154943.565232,-21600,EB445137-D7F5-57EC-87DA-1DB460D64046,"iPhone13,2"
com.apple.camera,2,1733154935,1733154937,1733154938.78057,-21600,EB445137-D7F5-57EC-87DA-1DB460D64046,"iPhone13,2"
com.apple.weather,12,1733154931,1733154943,1733154943.560749,-21600,EB445137-D7F5-57EC-87DA-1DB460D64046,"iPhone13,2"
com.apple.weather,3,1733154927,1733154930,1733154930.225501,-21600,EB445137-D7F5-57EC-87DA-1DB460D64046,"iPhone13,2"
com.apple.weather,16,1733154910,1733154926,1733154927.138983,-21600,EB445137-D7F5-57EC-87DA-1DB460D64046,"iPhone13,2"
com.apple.weather,1,1733154908,1733154909,1733154909.538008,-21600,EB445137-D7F5-57EC-87DA-1DB460D64046,"iPhone13,2"
com.apple.weather,5,1733154013,1733154018,1733154018.6879869,-21600,EB445137-D7F5-57EC-87DA-1DB460D64046,"iPhone13,2"
com.apple.weather,9,1733154003,1733154012,1733154013.408482,-21600,EB445137-D7F5-57EC-87DA-1DB460D64046,"iPhone13,2"
com.apple.MobileSMS,5,1733153996,1733154001,1733154001.795384,-21600,EB445137-D7F5-57EC-87DA-1DB460D64046,"iPhone13,2"
com.leomehlig.today,14,1733153873,1733153887,1733153887.387799,-21600,,
com.google.Chrome,3,1733153870,1733153873,1733153873.46625,-21600,,
com.microsoft.VSCode,207,1733153663,1733153870,1733153870.4245272,-21600,,
com.apple.finder,2,1733153661,1733153663,1733153663.666463,-21600,,
com.leomehlig.today,5,1733153656,1733153661,1733153661.4492788,-21600,,
com.apple.finder,2,1733153654,1733153656,1733153656.24246,-21600,,
com.leomehlig.today,5,1733153649,1733153654,1733153654.060775,-21600,,
com.microsoft.Excel,7,1733153642,1733153649,1733153650.0255408,-21600,,
com.leomehlig.today,3,1733153639,1733153642,1733153642.345484,-21600,,
com.microsoft.Excel,4,1733153635,1733153639,1733153639.743006,-21600,,
com.leomehlig.today,3,1733153632,1733153635,1733153635.11301,-21600,,
com.microsoft.Excel,21,1733153611,1733153632,1733153632.511785,-21600,,
com.leomehlig.today,6,1733153605,1733153611,1733153611.828722,-21600,,
com.microsoft.Excel,10,1733153595,1733153605,1733153605.387673,-21600,,
com.leomehlig.today,3,1733153592,1733153595,1733153595.742278,-21600,,
com.microsoft.Excel,8,1733153584,1733153592,1733153592.946053,-21600,,
com.leomehlig.today,5,1733153579,1733153584,1733153584.6652598,-21600,,
com.microsoft.Excel,11,1733153568,1733153579,1733153579.538871,-21600,,
com.leomehlig.today,5,1733153563,1733153568,1733153568.054387,-21600,,
com.microsoft.Excel,4,1733153559,1733153563,1733153563.058838,-21600,,
com.leomehlig.today,4,1733153555,1733153559,1733153559.535523,-21600,,
com.microsoft.Excel,3,1733153552,1733153555,1733153555.921767,-21600,,
com.leomehlig.today,5,1733153547,1733153552,1733153552.198907,-21600,,
com.microsoft.Excel,4,1733153543,1733153547,1733153547.213546,-21600,,
com.leomehlig.today,3,1733153540,1733153543,1733153543.731583,-21600,,
com.microsoft.Excel,6,1733153534,1733153540,1733153540.570281,-21600,,
com.leomehlig.today,4,1733153530,1733153534,1733153534.453768,-21600,,
com.microsoft.Excel,5,1733153525,1733153530,1733153530.966445,-21600,,
com.leomehlig.today,14,1733153511,1733153525,1733153525.805304,-21600,,
com.microsoft.Excel,22,1733153489,1733153511,1733153511.512364,-21600,,
com.apple.finder,18,1733153471,1733153489,1733153489.202341,-21600,,
com.leomehlig.today,4,1733153467,1733153471,1733153471.755604,-21600,,
com.apple.MobileSMS,9,1733153125,1733153134,1733153134.6359382,-21600,EB445137-D7F5-57EC-87DA-1DB460D64046,"iPhone13,2"
com.google.Chrome,369,1733153098,1733153467,1733153468.006415,-21600,,
com.leomehlig.today,51,1733153036,1733153087,1733153087.158434,-21600,,
com.apple.MobileSMS,2,1733152606,1733152608,1733152608.721045,-21600,EB445137-D7F5-57EC-87DA-1DB460D64046,"iPhone13,2"
com.apple.MobileSMS,25,1733152561,1733152586,1733152586.973844,-21600,EB445137-D7F5-57EC-87DA-1DB460D64046,"iPhone13,2"
com.apple.calculator,4,1733152557,1733152561,1733152561.209095,-21600,EB445137-D7F5-57EC-87DA-1DB460D64046,"iPhone13,2"
com.google.Chrome,541,1733152495,1733153036,1733153036.3573232,-21600,,
com.apple.calculator,66,1733152482,1733152548,1733152548.95611,-21600,EB445137-D7F5-57EC-87DA-1DB460D64046,"iPhone13,2"
com.microsoft.Office.Outlook,2,1733152480,1733152482,1733152483.025559,-21600,EB445137-D7F5-57EC-87DA-1DB460D64046,"iPhone13,2"
com.microsoft.Office.Outlook,10,1733152464,1733152474,1733152474.359051,-21600,EB445137-D7F5-57EC-87DA-1DB460D64046,"iPhone13,2"
com.apple.finder,4,1733152451,1733152455,1733152455.69859,-21600,,
com.leomehlig.today,10,1733152441,1733152451,1733152451.8193579,-21600,,
com.apple.finder,12,1733152429,1733152441,1733152441.5868769,-21600,,
com.microsoft.Outlook,1,1733152428,1733152429,1733152429.762652,-21600,,
com.apple.finder,1,1733152427,1733152428,1733152428.674388,-21600,,
com.microsoft.Outlook,1,1733152426,1733152427,1733152427.916369,-21600,,
com.apple.finder,1,1733152425,1733152426,1733152427.291391,-21600,,
com.microsoft.Office.Outlook,11,1733152411,1733152422,1733152422.375809,-21600,EB445137-D7F5-57EC-87DA-1DB460D64046,"iPhone13,2"
com.apple.MobileSMS,38,1733152364,1733152402,1733152402.608901,-21600,EB445137-D7F5-57EC-87DA-1DB460D64046,"iPhone13,2"
com.apple.calculator,15,1733152349,1733152364,1733152364.84744,-21600,EB445137-D7F5-57EC-87DA-1DB460D64046,"iPhone13,2"
com.apple.MobileSMS,18,1733152331,1733152349,1733152349.058971,-21600,EB445137-D7F5-57EC-87DA-1DB460D64046,"iPhone13,2"
com.apple.calculator,81,1733152250,1733152331,1733152331.4709811,-21600,EB445137-D7F5-57EC-87DA-1DB460D64046,"iPhone13,2"
com.apple.Health,65,1733152175,1733152240,1733152240.57101,-21600,EB445137-D7F5-57EC-87DA-1DB460D64046,"iPhone13,2"
com.leomehlig.today,287,1733152138,1733152425,1733152426.0127702,-21600,,
com.google.Chrome,4,1733152134,1733152138,1733152138.139059,-21600,,
com.instructure.icanvas,38,1733152125,1733152163,1733152163.549251,-21600,EB445137-D7F5-57EC-87DA-1DB460D64046,"iPhone13,2"
com.apple.weather,18,1733152107,1733152125,1733152125.683578,-21600,EB445137-D7F5-57EC-87DA-1DB460D64046,"iPhone13,2"
com.apple.weather,10,1733151929,1733151939,1733151939.374353,-21600,EB445137-D7F5-57EC-87DA-1DB460D64046,"iPhone13,2"
com.apple.weather,11,1733151855,1733151866,1733151866.814079,-21600,EB445137-D7F5-57EC-87DA-1DB460D64046,"iPhone13,2"
com.apple.weather,61,1733151308,1733151369,1733151369.527083,-21600,EB445137-D7F5-57EC-87DA-1DB460D64046,"iPhone13,2"
com.renpho.health,6,1733151302,1733151308,1733151308.074003,-21600,EB445137-D7F5-57EC-87DA-1DB460D64046,"iPhone13,2"
com.renpho.health,33,1733151240,1733151273,1733151273.320284,-21600,EB445137-D7F5-57EC-87DA-1DB460D64046,"iPhone13,2"
com.google.ios.youtube,6,1733151233,1733151239,1733151239.467905,-21600,EB445137-D7F5-57EC-87DA-1DB460D64046,"iPhone13,2"
com.google.ios.youtube,10,1733151221,1733151231,1733151231.328341,-21600,EB445137-D7F5-57EC-87DA-1DB460D64046,"iPhone13,2"
com.google.ios.youtube,710,1733149728,1733150438,1733150439.1674619,-21600,EB445137-D7F5-57EC-87DA-1DB460D64046,"iPhone13,2"
com.apple.news,53,1733149671,1733149724,1733149724.762066,-21600,EB445137-D7F5-57EC-87DA-1DB460D64046,"iPhone13,2"
com.apple.Music,10,1733149545,1733149555,1733149555.751436,-21600,EB445137-D7F5-57EC-87DA-1DB460D64046,"iPhone13,2"
com.google.chrome.ios,23,1733149519,1733149542,1733149542.6915731,-21600,EB445137-D7F5-57EC-87DA-1DB460D64046,"iPhone13,2"
com.apple.mobiletimer,5,1733149512,1733149517,1733149517.0748382,-21600,EB445137-D7F5-57EC-87DA-1DB460D64046,"iPhone13,2"
com.apple.mobiletimer,7,1733149488,1733149495,1733149495.377314,-21600,EB445137-D7F5-57EC-87DA-1DB460D64046,"iPhone13,2"
com.apple.mobiletimer,13,1733149465,1733149478,1733149479.485516,-21600,EB445137-D7F5-57EC-87DA-1DB460D64046,"iPhone13,2"
com.google.chrome.ios,43,1733122180,1733122223,1733122224.353732,-21600,EB445137-D7F5-57EC-87DA-1DB460D64046,"iPhone13,2"
com.facebook.Facebook,57,1733122078,1733122135,1733122135.6346269,-21600,EB445137-D7F5-57EC-87DA-1DB460D64046,"iPhone13,2"
com.apple.mobiletimer,9,1733122066,1733122075,1733122075.556536,-21600,EB445137-D7F5-57EC-87DA-1DB460D64046,"iPhone13,2"
com.apple.mobiletimer,13,1733121321,1733121334,1733121334.146007,-21600,EB445137-D7F5-57EC-87DA-1DB460D64046,"iPhone13,2"
com.apple.mobiletimer,14,1733121304,1733121318,1733121319.000049,-21600,EB445137-D7F5-57EC-87DA-1DB460D64046,"iPhone13,2"
com.thestorygraph.thestorygraph,13,1733121268,1733121281,1733121281.750726,-21600,EB445137-D7F5-57EC-87DA-1DB460D64046,"iPhone13,2"
com.apple.news,2,1733121264,1733121266,1733121267.2519379,-21600,EB445137-D7F5-57EC-87DA-1DB460D64046,"iPhone13,2"
com.apple.news,9,1733119926,1733119935,1733119935.8506799,-21600,EB445137-D7F5-57EC-87DA-1DB460D64046,"iPhone13,2"
com.apple.news,11,1733119523,1733119534,1733119534.877929,-21600,EB445137-D7F5-57EC-87DA-1DB460D64046,"iPhone13,2"
com.google.Chrome,613,1733118478,1733119091,1733119091.953836,-21600,,
com.leomehlig.today,78,1733118400,1733118478,1733118478.052033,-21600,,
com.apple.MobileSMS,6,1733118394,1733118400,1733118400.816638,-21600,,
com.leomehlig.today,137,1733118257,1733118394,1733118394.352742,-21600,,
com.apple.iCal,8,1733118249,1733118257,1733118257.975066,-21600,,
com.leomehlig.today,20,1733118229,1733118249,1733118249.607939,-21600,,
com.google.Chrome,22,1733118207,1733118229,1733118229.882863,-21600,,
com.apple.news,10,1733117653,1733117663,1733117663.030782,-21600,EB445137-D7F5-57EC-87DA-1DB460D64046,"iPhone13,2"
com.apple.news,10,1733116312,1733116322,1733116322.501318,-21600,EB445137-D7F5-57EC-87DA-1DB460D64046,"iPhone13,2"
com.apple.news,83,1733116214,1733116297,1733116297.5010839,-21600,EB445137-D7F5-57EC-87DA-1DB460D64046,"iPhone13,2"
com.apple.camera,1,1733116145,1733116146,1733116146.680824,-21600,EB445137-D7F5-57EC-87DA-1DB460D64046,"iPhone13,2"
com.apple.camera,0,1733116144,1733116144,1733116144.9938478,-21600,EB445137-D7F5-57EC-87DA-1DB460D64046,"iPhone13,2"
com.apple.camera,1,1733116141,1733116142,1733116142.24842,-21600,EB445137-D7F5-57EC-87DA-1DB460D64046,"iPhone13,2"
com.apple.camera,0,1733116098,1733116098,1733116098.402279,-21600,EB445137-D7F5-57EC-87DA-1DB460D64046,"iPhone13,2"
com.apple.news,79,1733116092,1733116171,1733116171.048429,-21600,EB445137-D7F5-57EC-87DA-1DB460D64046,"iPhone13,2"
com.apple.news,10,1733116030,1733116040,1733116040.588692,-21600,EB445137-D7F5-57EC-87DA-1DB460D64046,"iPhone13,2"
com.apple.news,2,1733116014,1733116016,1733116016.6169481,-21600,EB445137-D7F5-57EC-87DA-1DB460D64046,"iPhone13,2"
com.apple.news,3,1733116004,1733116007,1733116007.36306,-21600,EB445137-D7F5-57EC-87DA-1DB460D64046,"iPhone13,2"
com.apple.news,41,1733115624,1733115665,1733115665.229926,-21600,EB445137-D7F5-57EC-87DA-1DB460D64046,"iPhone13,2"
com.apple.news,26,1733115549,1733115575,1733115576.2371821,-21600,EB445137-D7F5-57EC-87DA-1DB460D64046,"iPhone13,2"
com.apple.news,69,1733115000,1733115069,1733115069.742744,-21600,EB445137-D7F5-57EC-87DA-1DB460D64046,"iPhone13,2"
com.apple.camera,0,1733114430,1733114430,1733114430.4593601,-21600,EB445137-D7F5-57EC-87DA-1DB460D64046,"iPhone13,2"
com.apple.news,50,1733114349,1733114399,1733114399.26635,-21600,EB445137-D7F5-57EC-87DA-1DB460D64046,"iPhone13,2"
com.apple.news,6,1733113200,1733113206,1733113206.258014,-21600,EB445137-D7F5-57EC-87DA-1DB460D64046,"iPhone13,2"
com.apple.news,43,1733112929,1733112972,1733112973.005155,-21600,EB445137-D7F5-57EC-87DA-1DB460D64046,"iPhone13,2"
com.apple.weather,15,1733112389,1733112404,1733112404.920388,-21600,EB445137-D7F5-57EC-87DA-1DB460D64046,"iPhone13,2"
com.google.chrome.ios,3,1733112386,1733112389,1733112389.324229,-21600,EB445137-D7F5-57EC-87DA-1DB460D64046,"iPhone13,2"
com.google.chrome.ios,11,1733111923,1733111934,1733111935.055824,-21600,EB445137-D7F5-57EC-87DA-1DB460D64046,"iPhone13,2"
com.apple.news,3,1733111920,1733111923,1733111923.2677999,-21600,EB445137-D7F5-57EC-87DA-1DB460D64046,"iPhone13,2"
com.apple.news,2,1733111403,1733111405,1733111405.402823,-21600,EB445137-D7F5-57EC-87DA-1DB460D64046,"iPhone13,2"
com.apple.news,35,1733111361,1733111396,1733111396.768918,-21600,EB445137-D7F5-57EC-87DA-1DB460D64046,"iPhone13,2"
com.apple.news,23,1733111172,1733111195,1733111195.8486152,-21600,EB445137-D7F5-57EC-87DA-1DB460D64046,"iPhone13,2"
com.apple.news,2,1733110658,1733110660,1733110660.144331,-21600,EB445137-D7F5-57EC-87DA-1DB460D64046,"iPhone13,2"
com.apple.news,37,1733110496,1733110533,1733110534.132571,-21600,EB445137-D7F5-57EC-87DA-1DB460D64046,"iPhone13,2"
com.apple.news,12,1733109241,1733109253,1733109254.371172,-21600,EB445137-D7F5-57EC-87DA-1DB460D64046,"iPhone13,2"
com.amazon.Amazon,7,1733109218,1733109225,1733109225.518189,-21600,EB445137-D7F5-57EC-87DA-1DB460D64046,"iPhone13,2"
com.amazon.Amazon,11,1733107829,1733107840,1733107840.4968271,-21600,EB445137-D7F5-57EC-87DA-1DB460D64046,"iPhone13,2"
com.amazon.Amazon,6,1733107772,1733107778,1733107778.952708,-21600,EB445137-D7F5-57EC-87DA-1DB460D64046,"iPhone13,2"
com.amazon.Amazon,107,1733107657,1733107764,1733107764.6502562,-21600,EB445137-D7F5-57EC-87DA-1DB460D64046,"iPhone13,2"
com.truebill.truebillnative,47,1733107610,1733107657,1733107657.126962,-21600,EB445137-D7F5-57EC-87DA-1DB460D64046,"iPhone13,2"
com.amazon.Amazon,149,1733107456,1733107605,1733107605.5441809,-21600,EB445137-D7F5-57EC-87DA-1DB460D64046,"iPhone13,2"
com.google.chrome.ios,3,1733107452,1733107455,1733107455.7995648,-21600,EB445137-D7F5-57EC-87DA-1DB460D64046,"iPhone13,2"
com.google.chrome.ios,15,1733106751,1733106766,1733106766.5312362,-21600,EB445137-D7F5-57EC-87DA-1DB460D64046,"iPhone13,2"
com.google.chrome.ios,10,1733105761,1733105771,1733105771.97721,-21600,EB445137-D7F5-57EC-87DA-1DB460D64046,"iPhone13,2"
com.apple.camera,0,1733105761,1733105761,1733105761.73798,-21600,EB445137-D7F5-57EC-87DA-1DB460D64046,"iPhone13,2"
com.google.chrome.ios,62,1733105696,1733105758,1733105758.8912659,-21600,EB445137-D7F5-57EC-87DA-1DB460D64046,"iPhone13,2"
com.apple.camera,6,1733105690,1733105696,1733105697.033467,-21600,EB445137-D7F5-57EC-87DA-1DB460D64046,"iPhone13,2"
com.google.chrome.ios,49,1733105641,1733105690,1733105691.478002,-21600,EB445137-D7F5-57EC-87DA-1DB460D64046,"iPhone13,2"
com.apple.camera,6,1733105634,1733105640,1733105641.7766109,-21600,EB445137-D7F5-57EC-87DA-1DB460D64046,"iPhone13,2"
com.google.Gmail,10,1733105631,1733105641,1733105642.371467,-21600,EB445137-D7F5-57EC-87DA-1DB460D64046,"iPhone13,2"
com.google.Gmail,58,1733105376,1733105434,1733105435.075424,-21600,EB445137-D7F5-57EC-87DA-1DB460D64046,"iPhone13,2"
com.apple.Passwords,81,1733105295,1733105376,1733105376.786941,-21600,EB445137-D7F5-57EC-87DA-1DB460D64046,"iPhone13,2"
com.apple.Preferences,43,1733104792,1733104835,1733104835.943578,-21600,EB445137-D7F5-57EC-87DA-1DB460D64046,"iPhone13,2"
com.apple.mobileslideshow,70,1733104721,1733104791,1733104791.559214,-21600,EB445137-D7F5-57EC-87DA-1DB460D64046,"iPhone13,2"
com.apple.mobiletimer,1,1733104719,1733104720,1733104720.965848,-21600,EB445137-D7F5-57EC-87DA-1DB460D64046,"iPhone13,2"
com.apple.mobiletimer,6,1733104391,1733104397,1733104397.585077,-21600,EB445137-D7F5-57EC-87DA-1DB460D64046,"iPhone13,2"
com.apple.mobiletimer,2,1733103909,1733103911,1733103911.960027,-21600,EB445137-D7F5-57EC-87DA-1DB460D64046,"iPhone13,2"
com.google.chrome.ios,2,1733103907,1733103909,1733103909.699595,-21600,EB445137-D7F5-57EC-87DA-1DB460D64046,"iPhone13,2"
com.google.chrome.ios,1,1733103861,1733103862,1733103863.039013,-21600,EB445137-D7F5-57EC-87DA-1DB460D64046,"iPhone13,2"
com.google.chrome.ios,15,1733103774,1733103789,1733103789.4025788,-21600,EB445137-D7F5-57EC-87DA-1DB460D64046,"iPhone13,2"
com.google.chrome.ios,36,1733103385,1733103421,1733103421.4360151,-21600,EB445137-D7F5-57EC-87DA-1DB460D64046,"iPhone13,2"
com.google.chrome.ios,60,1733103297,1733103357,1733103357.4018722,-21600,EB445137-D7F5-57EC-87DA-1DB460D64046,"iPhone13,2"
com.apple.mobiletimer,3,1733103291,1733103294,1733103294.720951,-21600,EB445137-D7F5-57EC-87DA-1DB460D64046,"iPhone13,2"
com.google.chrome.ios,4,1733103287,1733103291,1733103291.5770168,-21600,EB445137-D7F5-57EC-87DA-1DB460D64046,"iPhone13,2"
com.google.chrome.ios,76,1733103159,1733103235,1733103236.530782,-21600,EB445137-D7F5-57EC-87DA-1DB460D64046,"iPhone13,2"
com.google.chrome.ios,51,1733103027,1733103078,1733103079.250763,-21600,EB445137-D7F5-57EC-87DA-1DB460D64046,"iPhone13,2"
com.google.ios.youtube,7,1733103020,1733103027,1733103027.950595,-21600,EB445137-D7F5-57EC-87DA-1DB460D64046,"iPhone13,2"
com.google.ios.youtube,3,1733102779,1733102782,1733102782.146769,-21600,EB445137-D7F5-57EC-87DA-1DB460D64046,"iPhone13,2"
com.google.ios.youtube,29,1733102716,1733102745,1733102746.916343,-21600,EB445137-D7F5-57EC-87DA-1DB460D64046,"iPhone13,2"
com.google.chrome.ios,28,1733102688,1733102716,1733102716.428688,-21600,EB445137-D7F5-57EC-87DA-1DB460D64046,"iPhone13,2"
com.google.ios.youtube,31,1733102657,1733102688,1733102689.744662,-21600,EB445137-D7F5-57EC-87DA-1DB460D64046,"iPhone13,2"
com.google.chrome.ios,44,1733102613,1733102657,1733102657.9962668,-21600,EB445137-D7F5-57EC-87DA-1DB460D64046,"iPhone13,2"
com.apple.Music,2,1733102611,1733102613,1733102613.959053,-21600,EB445137-D7F5-57EC-87DA-1DB460D64046,"iPhone13,2"
com.apple.Music,7,1733101935,1733101942,1733101942.419437,-21600,EB445137-D7F5-57EC-87DA-1DB460D64046,"iPhone13,2"
com.apple.Music,6,1733101122,1733101128,1733101129.227775,-21600,EB445137-D7F5-57EC-87DA-1DB460D64046,"iPhone13,2"
com.apple.Music,11,1733100286,1733100297,1733100297.1103091,-21600,EB445137-D7F5-57EC-87DA-1DB460D64046,"iPhone13,2"
com.apple.Music,12,1733100192,1733100204,1733100204.2988791,-21600,EB445137-D7F5-57EC-87DA-1DB460D64046,"iPhone13,2"
com.apple.Music,13,1733099491,1733099504,1733099504.4186769,-21600,EB445137-D7F5-57EC-87DA-1DB460D64046,"iPhone13,2"
com.apple.mobilenotes,3,1733099487,1733099490,1733099490.0596042,-21600,EB445137-D7F5-57EC-87DA-1DB460D64046,"iPhone13,2"
com.apple.mobilenotes,5,1733098168,1733098173,1733098174.056325,-21600,EB445137-D7F5-57EC-87DA-1DB460D64046,"iPhone13,2"
com.apple.Music,3,1733098165,1733098168,1733098168.774425,-21600,EB445137-D7F5-57EC-87DA-1DB460D64046,"iPhone13,2"
com.apple.Music,86,1733097034,1733097120,1733097121.034339,-21600,EB445137-D7F5-57EC-87DA-1DB460D64046,"iPhone13,2"
com.apple.mobilenotes,7,1733097027,1733097034,1733097034.943069,-21600,EB445137-D7F5-57EC-87DA-1DB460D64046,"iPhone13,2"
com.apple.mobilenotes,74,1733096820,1733096894,1733096895.404459,-21600,EB445137-D7F5-57EC-87DA-1DB460D64046,"iPhone13,2"
com.apple.Music,18,1733096609,1733096627,1733096627.81759,-21600,EB445137-D7F5-57EC-87DA-1DB460D64046,"iPhone13,2"
com.apple.Music,12,1733095304,1733095316,1733095316.6847038,-21600,EB445137-D7F5-57EC-87DA-1DB460D64046,"iPhone13,2"
com.apple.Music,5,1733094140,1733094145,1733094145.093642,-21600,EB445137-D7F5-57EC-87DA-1DB460D64046,"iPhone13,2"
com.apple.Music,10,1733092480,1733092490,1733092490.76001,-21600,EB445137-D7F5-57EC-87DA-1DB460D64046,"iPhone13,2"
com.apple.Music,8,1733092253,1733092261,1733092261.402543,-21600,EB445137-D7F5-57EC-87DA-1DB460D64046,"iPhone13,2"
com.apple.Music,9,1733092223,1733092232,1733092233.003835,-21600,EB445137-D7F5-57EC-87DA-1DB460D64046,"iPhone13,2"
com.apple.Music,14,1733092181,1733092195,1733092196.0539842,-21600,EB445137-D7F5-57EC-87DA-1DB460D64046,"iPhone13,2"
com.apple.PosterBoard,1,1733092177,1733092178,1733092179.327127,-21600,EB445137-D7F5-57EC-87DA-1DB460D64046,"iPhone13,2"
com.apple.podcasts,3,1733092176,1733092179,1733092180.2268639,-21600,EB445137-D7F5-57EC-87DA-1DB460D64046,"iPhone13,2"
com.apple.podcasts,10,1733091407,1733091417,1733091417.757183,-21600,EB445137-D7F5-57EC-87DA-1DB460D64046,"iPhone13,2"
com.apple.podcasts,13,1733091392,1733091405,1733091405.9646559,-21600,EB445137-D7F5-57EC-87DA-1DB460D64046,"iPhone13,2"
com.apple.podcasts,9,1733091381,1733091390,1733091390.6958709,-21600,EB445137-D7F5-57EC-87DA-1DB460D64046,"iPhone13,2"
com.apple.Maps,8,1733091369,1733091377,1733091377.878862,-21600,EB445137-D7F5-57EC-87DA-1DB460D64046,"iPhone13,2"
com.apple.podcasts,5,1733091363,1733091368,1733091368.476568,-21600,EB445137-D7F5-57EC-87DA-1DB460D64046,"iPhone13,2"
com.apple.podcasts,12,1733089562,1733089574,1733089575.117106,-21600,EB445137-D7F5-57EC-87DA-1DB460D64046,"iPhone13,2"
com.apple.podcasts,23,1733089538,1733089561,1733089561.921321,-21600,EB445137-D7F5-57EC-87DA-1DB460D64046,"iPhone13,2"
com.apple.podcasts,10,1733088290,1733088300,1733088300.345278,-21600,EB445137-D7F5-57EC-87DA-1DB460D64046,"iPhone13,2"
com.apple.podcasts,14,1733088271,1733088285,1733088285.789391,-21600,EB445137-D7F5-57EC-87DA-1DB460D64046,"iPhone13,2"
com.apple.podcasts,154,1733088054,1733088208,1733088208.83573,-21600,EB445137-D7F5-57EC-87DA-1DB460D64046,"iPhone13,2"
com.toyopagroup.picaboo,7,1733088043,1733088050,1733088050.163255,-21600,EB445137-D7F5-57EC-87DA-1DB460D64046,"iPhone13,2"
com.toyopagroup.picaboo,18,1733085749,1733085767,1733085767.906167,-21600,EB445137-D7F5-57EC-87DA-1DB460D64046,"iPhone13,2"
com.toyopagroup.picaboo,6,1733084689,1733084695,1733084695.427034,-21600,EB445137-D7F5-57EC-87DA-1DB460D64046,"iPhone13,2"
com.toyopagroup.picaboo,8,1733084583,1733084591,1733084591.743197,-21600,EB445137-D7F5-57EC-87DA-1DB460D64046,"iPhone13,2"
com.toyopagroup.picaboo,6,1733084551,1733084557,1733084557.713073,-21600,EB445137-D7F5-57EC-87DA-1DB460D64046,"iPhone13,2"
com.toyopagroup.picaboo,6,1733084376,1733084382,1733084382.763098,-21600,EB445137-D7F5-57EC-87DA-1DB460D64046,"iPhone13,2"
com.apple.MobileSMS,7,1733084369,1733084376,1733084376.55451,-21600,EB445137-D7F5-57EC-87DA-1DB460D64046,"iPhone13,2"
com.apple.podcasts,81,1733084288,1733084369,1733084370.010096,-21600,EB445137-D7F5-57EC-87DA-1DB460D64046,"iPhone13,2"
com.apple.MobileSMS,4,1733084282,1733084286,1733084286.4803581,-21600,EB445137-D7F5-57EC-87DA-1DB460D64046,"iPhone13,2"
com.apple.MobileSMS,7,1733084233,1733084240,1733084240.359462,-21600,EB445137-D7F5-57EC-87DA-1DB460D64046,"iPhone13,2"
com.apple.MobileSMS,4,1733083988,1733083992,1733083993.0151029,-21600,EB445137-D7F5-57EC-87DA-1DB460D64046,"iPhone13,2"
com.apple.podcasts,6,1733083982,1733083988,1733083988.4664922,-21600,EB445137-D7F5-57EC-87DA-1DB460D64046,"iPhone13,2"
com.apple.podcasts,3,1733083919,1733083922,1733083923.108787,-21600,EB445137-D7F5-57EC-87DA-1DB460D64046,"iPhone13,2"
com.apple.Music,9,1733083908,1733083917,1733083917.830121,-21600,EB445137-D7F5-57EC-87DA-1DB460D64046,"iPhone13,2"
com.apple.MobileSMS,6,1733083382,1733083388,1733083388.517013,-21600,EB445137-D7F5-57EC-87DA-1DB460D64046,"iPhone13,2"
com.apple.MobileSMS,11,1733083321,1733083332,1733083332.6588879,-21600,EB445137-D7F5-57EC-87DA-1DB460D64046,"iPhone13,2"
com.apple.Music,11,1733083309,1733083320,1733083321.217618,-21600,EB445137-D7F5-57EC-87DA-1DB460D64046,"iPhone13,2"
com.apple.Music,31,1733082516,1733082547,1733082547.695298,-21600,EB445137-D7F5-57EC-87DA-1DB460D64046,"iPhone13,2"
com.apple.podcasts,63,1733082205,1733082268,1733082268.405082,-21600,EB445137-D7F5-57EC-87DA-1DB460D64046,"iPhone13,2"
com.apple.weather,7,1733082198,1733082205,1733082205.242218,-21600,EB445137-D7F5-57EC-87DA-1DB460D64046,"iPhone13,2"
com.apple.podcasts,22,1733082175,1733082197,1733082197.270319,-21600,EB445137-D7F5-57EC-87DA-1DB460D64046,"iPhone13,2"
com.apple.news,3,1733082170,1733082173,1733082173.962843,-21600,EB445137-D7F5-57EC-87DA-1DB460D64046,"iPhone13,2"
com.truebill.truebillnative,3,1733082161,1733082164,1733082164.935909,-21600,EB445137-D7F5-57EC-87DA-1DB460D64046,"iPhone13,2"
com.truebill.truebillnative,49,1733081779,1733081828,1733081828.52823,-21600,EB445137-D7F5-57EC-87DA-1DB460D64046,"iPhone13,2"
com.apple.news,36,1733081727,1733081763,1733081763.9501262,-21600,EB445137-D7F5-57EC-87DA-1DB460D64046,"iPhone13,2"
com.apple.weather,30,1733081688,1733081718,1733081718.421949,-21600,EB445137-D7F5-57EC-87DA-1DB460D64046,"iPhone13,2"
com.apple.MobileSMS,37,1733081641,1733081678,1733081678.738303,-21600,EB445137-D7F5-57EC-87DA-1DB460D64046,"iPhone13,2"
com.apple.MobileSMS,7,1733081479,1733081486,1733081486.6716928,-21600,EB445137-D7F5-57EC-87DA-1DB460D64046,"iPhone13,2"
com.apple.MobileSMS,60,1733080457,1733080517,1733080517.80789,-21600,EB445137-D7F5-57EC-87DA-1DB460D64046,"iPhone13,2"
com.discoverfinancial.mobile,2,1733080455,1733080457,1733080458.929655,-21600,EB445137-D7F5-57EC-87DA-1DB460D64046,"iPhone13,2"
com.discoverfinancial.mobile,1,1733080320,1733080321,1733080322.181011,-21600,EB445137-D7F5-57EC-87DA-1DB460D64046,"iPhone13,2"
com.discoverfinancial.mobile,34,1733079411,1733079445,1733079446.189637,-21600,EB445137-D7F5-57EC-87DA-1DB460D64046,"iPhone13,2"
com.google.chrome.ios,2,1733079409,1733079411,1733079411.357822,-21600,EB445137-D7F5-57EC-87DA-1DB460D64046,"iPhone13,2"
com.truebill.truebillnative,2,1733079407,1733079409,1733079409.4878159,-21600,EB445137-D7F5-57EC-87DA-1DB460D64046,"iPhone13,2"
com.truebill.truebillnative,25,1733079146,1733079171,1733079172.0109038,-21600,EB445137-D7F5-57EC-87DA-1DB460D64046,"iPhone13,2"
com.google.chrome.ios,3,1733079135,1733079138,1733079138.3313498,-21600,EB445137-D7F5-57EC-87DA-1DB460D64046,"iPhone13,2"
com.google.chrome.ios,46,1733078266,1733078312,1733078312.7592201,-21600,EB445137-D7F5-57EC-87DA-1DB460D64046,"iPhone13,2"
com.apple.MobileSMS,103,1733077571,1733077674,1733077674.800044,-21600,EB445137-D7F5-57EC-87DA-1DB460D64046,"iPhone13,2"
com.apple.mobileslideshow,44,1733077526,1733077570,1733077571.089957,-21600,EB445137-D7F5-57EC-87DA-1DB460D64046,"iPhone13,2"
com.apple.MobileSMS,14,1733077508,1733077522,1733077522.2952461,-21600,EB445137-D7F5-57EC-87DA-1DB460D64046,"iPhone13,2"
com.apple.camera,0,1733075135,1733075135,1733075135.5766969,-21600,EB445137-D7F5-57EC-87DA-1DB460D64046,"iPhone13,2"
com.apple.mobilecal,163,1733074819,1733074982,1733074982.1737618,-21600,EB445137-D7F5-57EC-87DA-1DB460D64046,"iPhone13,2"
com.amazon.Amazon,69,1733074747,1733074816,1733074817.038599,-21600,EB445137-D7F5-57EC-87DA-1DB460D64046,"iPhone13,2"
com.google.chrome.ios,84,1733074663,1733074747,1733074747.184791,-21600,EB445137-D7F5-57EC-87DA-1DB460D64046,"iPhone13,2"
com.amazon.Amazon,2,1733074661,1733074663,1733074663.566267,-21600,EB445137-D7F5-57EC-87DA-1DB460D64046,"iPhone13,2"
com.amazon.Amazon,223,1733074418,1733074641,1733074641.204757,-21600,EB445137-D7F5-57EC-87DA-1DB460D64046,"iPhone13,2"
com.microsoft.Office.Outlook,9,1733074325,1733074334,1733074334.6563702,-21600,EB445137-D7F5-57EC-87DA-1DB460D64046,"iPhone13,2"
com.google.chrome.ios,62,1733074171,1733074233,1733074233.820121,-21600,EB445137-D7F5-57EC-87DA-1DB460D64046,"iPhone13,2"
com.google.chrome.ios,211,1733073820,1733074031,1733074031.6553888,-21600,EB445137-D7F5-57EC-87DA-1DB460D64046,"iPhone13,2"
com.apple.Music,23,1733073797,1733073820,1733073821.0013208,-21600,EB445137-D7F5-57EC-87DA-1DB460D64046,"iPhone13,2"
com.amazon.Amazon,2,1733073793,1733073795,1733073795.649337,-21600,EB445137-D7F5-57EC-87DA-1DB460D64046,"iPhone13,2"
com.amazon.Amazon,23,1733073699,1733073722,1733073722.9152842,-21600,EB445137-D7F5-57EC-87DA-1DB460D64046,"iPhone13,2"
com.apple.news,2,1733073694,1733073696,1733073696.796396,-21600,EB445137-D7F5-57EC-87DA-1DB460D64046,"iPhone13,2"
com.apple.news,23,1733073612,1733073635,1733073635.876392,-21600,EB445137-D7F5-57EC-87DA-1DB460D64046,"iPhone13,2"
com.apple.findmy,14,1733073502,1733073516,1733073517.390452,-21600,EB445137-D7F5-57EC-87DA-1DB460D64046,"iPhone13,2"
com.apple.MobileSMS,3,1733072841,1733072844,1733072844.9674559,-21600,EB445137-D7F5-57EC-87DA-1DB460D64046,"iPhone13,2"
com.clairmail.fth.client,67,1733072774,1733072841,1733072841.586132,-21600,EB445137-D7F5-57EC-87DA-1DB460D64046,"iPhone13,2"
com.apple.findmy,4,1733072769,1733072773,1733072774.367249,-21600,EB445137-D7F5-57EC-87DA-1DB460D64046,"iPhone13,2"
com.apple.findmy,16,1733072740,1733072756,1733072756.654618,-21600,EB445137-D7F5-57EC-87DA-1DB460D64046,"iPhone13,2"
com.clairmail.fth.client,5,1733072735,1733072740,1733072741.015617,-21600,EB445137-D7F5-57EC-87DA-1DB460D64046,"iPhone13,2"
com.clairmail.fth.client,11,1733072092,1733072103,1733072104.02314,-21600,EB445137-D7F5-57EC-87DA-1DB460D64046,"iPhone13,2"
com.clairmail.fth.client,5,1733071543,1733071548,1733071548.298217,-21600,EB445137-D7F5-57EC-87DA-1DB460D64046,"iPhone13,2"
com.renpho.health,51,1733071489,1733071540,1733071540.600553,-21600,EB445137-D7F5-57EC-87DA-1DB460D64046,"iPhone13,2"
com.google.ios.youtube,188,1733070258,1733070446,1733070446.6789432,-21600,EB445137-D7F5-57EC-87DA-1DB460D64046,"iPhone13,2"
com.apple.findmy,17,1733070234,1733070251,1733070251.55308,-21600,EB445137-D7F5-57EC-87DA-1DB460D64046,"iPhone13,2"
com.apple.MobileSMS,74,1733070134,1733070208,1733070208.414604,-21600,EB445137-D7F5-57EC-87DA-1DB460D64046,"iPhone13,2"
com.apple.mobilecal,3,1733070124,1733070127,1733070127.4889479,-21600,EB445137-D7F5-57EC-87DA-1DB460D64046,"iPhone13,2"
com.apple.Health,8,1733070109,1733070117,1733070117.389186,-21600,EB445137-D7F5-57EC-87DA-1DB460D64046,"iPhone13,2"
com.apple.MobileSMS,3,1733070105,1733070108,1733070108.307276,-21600,EB445137-D7F5-57EC-87DA-1DB460D64046,"iPhone13,2"
com.google.ios.youtube,26,1733070079,1733070105,1733070106.344585,-21600,EB445137-D7F5-57EC-87DA-1DB460D64046,"iPhone13,2"
com.google.ios.youtube,98,1733069974,1733070072,1733070072.344945,-21600,EB445137-D7F5-57EC-87DA-1DB460D64046,"iPhone13,2"
com.apple.MobileSMS,30,1733069944,1733069974,1733069974.97731,-21600,EB445137-D7F5-57EC-87DA-1DB460D64046,"iPhone13,2"
com.google.ios.youtube,638,1733069306,1733069944,1733069944.356179,-21600,EB445137-D7F5-57EC-87DA-1DB460D64046,"iPhone13,2"
com.apple.findmy,23,1733069283,1733069306,1733069306.942545,-21600,EB445137-D7F5-57EC-87DA-1DB460D64046,"iPhone13,2"
com.google.ios.youtube,636,1733068645,1733069281,1733069281.45161,-21600,EB445137-D7F5-57EC-87DA-1DB460D64046,"iPhone13,2"
com.apple.MobileSMS,76,1733068564,1733068640,1733068640.2255502,-21600,EB445137-D7F5-57EC-87DA-1DB460D64046,"iPhone13,2"
com.apple.Music,2,1733068562,1733068564,1733068564.582155,-21600,EB445137-D7F5-57EC-87DA-1DB460D64046,"iPhone13,2"
com.apple.mobiletimer,3,1733068559,1733068562,1733068562.833935,-21600,EB445137-D7F5-57EC-87DA-1DB460D64046,"iPhone13,2"
com.apple.camera,0,1733068558,1733068558,1733068559.5216742,-21600,EB445137-D7F5-57EC-87DA-1DB460D64046,"iPhone13,2"
com.apple.Music,20,1733068530,1733068550,1733068550.4312282,-21600,EB445137-D7F5-57EC-87DA-1DB460D64046,"iPhone13,2"
com.apple.Music,15,1733068514,1733068529,1733068529.397921,-21600,EB445137-D7F5-57EC-87DA-1DB460D64046,"iPhone13,2"
com.apple.Music,23,1733067961,1733067984,1733067984.06018,-21600,EB445137-D7F5-57EC-87DA-1DB460D64046,"iPhone13,2"
com.apple.Music,23,1733067407,1733067430,1733067430.505676,-21600,EB445137-D7F5-57EC-87DA-1DB460D64046,"iPhone13,2"
com.apple.Music,17,1733066860,1733066877,1733066877.2323751,-21600,EB445137-D7F5-57EC-87DA-1DB460D64046,"iPhone13,2"
com.apple.Music,15,1733066309,1733066324,1733066324.6734018,-21600,EB445137-D7F5-57EC-87DA-1DB460D64046,"iPhone13,2"
com.apple.Music,23,1733065755,1733065778,1733065778.6662688,-21600,EB445137-D7F5-57EC-87DA-1DB460D64046,"iPhone13,2"
com.apple.Music,24,1733065201,1733065225,1733065225.7970328,-21600,EB445137-D7F5-57EC-87DA-1DB460D64046,"iPhone13,2"
com.apple.Music,14,1733033646,1733033660,1733033660.193852,-21600,EB445137-D7F5-57EC-87DA-1DB460D64046,"iPhone13,2"
com.apple.Music,2,1733033624,1733033626,1733033626.861001,-21600,EB445137-D7F5-57EC-87DA-1DB460D64046,"iPhone13,2"
com.apple.Music,20,1733033602,1733033622,1733033622.549326,-21600,EB445137-D7F5-57EC-87DA-1DB460D64046,"iPhone13,2"
com.apple.Music,83,1733033271,1733033354,1733033354.731886,-21600,EB445137-D7F5-57EC-87DA-1DB460D64046,"iPhone13,2"
com.apple.Music,12,1733033110,1733033122,1733033122.541539,-21600,EB445137-D7F5-57EC-87DA-1DB460D64046,"iPhone13,2"
com.apple.Music,10,1733033076,1733033086,1733033086.1972818,-21600,EB445137-D7F5-57EC-87DA-1DB460D64046,"iPhone13,2"
com.apple.Music,8,1733033063,1733033071,1733033071.958312,-21600,EB445137-D7F5-57EC-87DA-1DB460D64046,"iPhone13,2"
com.apple.Music,60,1733032996,1733033056,1733033056.3418221,-21600,EB445137-D7F5-57EC-87DA-1DB460D64046,"iPhone13,2"
com.apple.journal,4,1733032992,1733032996,1733032996.5260549,-21600,EB445137-D7F5-57EC-87DA-1DB460D64046,"iPhone13,2"
com.apple.Music,16,1733032976,1733032992,1733032992.722437,-21600,EB445137-D7F5-57EC-87DA-1DB460D64046,"iPhone13,2"
com.google.ios.youtube,10,1733032966,1733032976,1733032977.10786,-21600,EB445137-D7F5-57EC-87DA-1DB460D64046,"iPhone13,2"
com.google.Chrome,11,1733032439,1733032450,1733032450.801703,-21600,,
com.google.Chrome,300,1733031778,1733032078,1733032078.9459848,-21600,,
com.google.Chrome,367,1733031153,1733031520,1733031520.310642,-21600,,
com.leomehlig.today,10,1733031143,1733031153,1733031153.629167,-21600,,
com.google.Chrome,5,1733031138,1733031143,1733031143.622675,-21600,,
com.google.ios.youtube,13,1733031043,1733031056,1733031056.7349749,-21600,EB445137-D7F5-57EC-87DA-1DB460D64046,"iPhone13,2"
com.google.ios.youtube,96,1733030051,1733030147,1733030148.632863,-21600,EB445137-D7F5-57EC-87DA-1DB460D64046,"iPhone13,2"
com.google.ios.youtube,2,1733029978,1733029980,1733029980.528082,-21600,EB445137-D7F5-57EC-87DA-1DB460D64046,"iPhone13,2"
com.google.ios.youtube,73,1733029459,1733029532,1733029532.394064,-21600,EB445137-D7F5-57EC-87DA-1DB460D64046,"iPhone13,2"
com.google.ios.youtube,45,1733028618,1733028663,1733028663.768793,-21600,EB445137-D7F5-57EC-87DA-1DB460D64046,"iPhone13,2"
org.name.serializdmobile,9,1733028016,1733028025,1733028025.48814,-21600,EB445137-D7F5-57EC-87DA-1DB460D64046,"iPhone13,2"
org.name.serializdmobile,4,1733028010,1733028014,1733028014.382155,-21600,EB445137-D7F5-57EC-87DA-1DB460D64046,"iPhone13,2"
org.name.serializdmobile,13,1733027945,1733027958,1733027958.791817,-21600,EB445137-D7F5-57EC-87DA-1DB460D64046,"iPhone13,2"
org.name.serializdmobile,103,1733027692,1733027795,1733027795.30766,-21600,EB445137-D7F5-57EC-87DA-1DB460D64046,"iPhone13,2"
com.apple.MobileSMS,2,1733027687,1733027689,1733027689.2706861,-21600,EB445137-D7F5-57EC-87DA-1DB460D64046,"iPhone13,2"
com.apple.MobileSMS,40,1733027646,1733027686,1733027686.74492,-21600,EB445137-D7F5-57EC-87DA-1DB460D64046,"iPhone13,2"
com.google.chrome.ios,13,1733027633,1733027646,1733027646.5025501,-21600,EB445137-D7F5-57EC-87DA-1DB460D64046,"iPhone13,2"
com.google.chrome.ios,10,1733027319,1733027329,1733027329.524259,-21600,EB445137-D7F5-57EC-87DA-1DB460D64046,"iPhone13,2"
com.google.chrome.ios,3,1733027315,1733027318,1733027318.126889,-21600,EB445137-D7F5-57EC-87DA-1DB460D64046,"iPhone13,2"
com.google.chrome.ios,13,1733027243,1733027256,1733027256.561522,-21600,EB445137-D7F5-57EC-87DA-1DB460D64046,"iPhone13,2"
com.google.chrome.ios,860,1733024807,1733025667,1733025667.619722,-21600,EB445137-D7F5-57EC-87DA-1DB460D64046,"iPhone13,2"
com.google.chrome.ios,76,1733024654,1733024730,1733024730.372645,-21600,EB445137-D7F5-57EC-87DA-1DB460D64046,"iPhone13,2"
com.google.chrome.ios,898,1733023733,1733024631,1733024631.445809,-21600,EB445137-D7F5-57EC-87DA-1DB460D64046,"iPhone13,2"
com.google.chrome.ios,35,1733023670,1733023705,1733023705.978682,-21600,EB445137-D7F5-57EC-87DA-1DB460D64046,"iPhone13,2"
com.google.chrome.ios,2576,1733021092,1733023668,1733023668.935153,-21600,EB445137-D7F5-57EC-87DA-1DB460D64046,"iPhone13,2"
com.apple.MobileSMS,3,1733021089,1733021092,1733021092.4350061,-21600,EB445137-D7F5-57EC-87DA-1DB460D64046,"iPhone13,2"
com.apple.MobileSMS,14,1733020740,1733020754,1733020754.394196,-21600,EB445137-D7F5-57EC-87DA-1DB460D64046,"iPhone13,2"
com.apple.MobileSMS,8,1733020691,1733020699,1733020699.50618,-21600,EB445137-D7F5-57EC-87DA-1DB460D64046,"iPhone13,2"
com.instructure.icanvas,23,1733020430,1733020453,1733020453.073841,-21600,EB445137-D7F5-57EC-87DA-1DB460D64046,"iPhone13,2"
com.apple.MobileSMS,4,1733020426,1733020430,1733020430.8620958,-21600,EB445137-D7F5-57EC-87DA-1DB460D64046,"iPhone13,2"
com.apple.MobileSMS,6,1733019954,1733019960,1733019960.7920089,-21600,EB445137-D7F5-57EC-87DA-1DB460D64046,"iPhone13,2"
com.apple.MobileSMS,2,1733019557,1733019559,1733019559.8664641,-21600,EB445137-D7F5-57EC-87DA-1DB460D64046,"iPhone13,2"
com.apple.MobileSMS,2,1733019283,1733019285,1733019285.894141,-21600,EB445137-D7F5-57EC-87DA-1DB460D64046,"iPhone13,2"
com.apple.MobileSMS,7,1733018461,1733018468,1733018468.4132261,-21600,EB445137-D7F5-57EC-87DA-1DB460D64046,"iPhone13,2"
com.apple.MobileSMS,5,1733018356,1733018361,1733018361.841967,-21600,EB445137-D7F5-57EC-87DA-1DB460D64046,"iPhone13,2"
com.apple.MobileSMS,4,1733018317,1733018321,1733018321.187783,-21600,EB445137-D7F5-57EC-87DA-1DB460D64046,"iPhone13,2"
com.apple.MobileSMS,5,1733018311,1733018316,1733018316.168431,-21600,EB445137-D7F5-57EC-87DA-1DB460D64046,"iPhone13,2"
com.apple.MobileSMS,6,1733018301,1733018307,1733018307.390028,-21600,EB445137-D7F5-57EC-87DA-1DB460D64046,"iPhone13,2"
com.apple.camera,0,1733018277,1733018277,1733018277.671042,-21600,EB445137-D7F5-57EC-87DA-1DB460D64046,"iPhone13,2"
com.apple.camera,1,1733018273,1733018274,1733018274.3760939,-21600,EB445137-D7F5-57EC-87DA-1DB460D64046,"iPhone13,2"
com.apple.MobileSMS,11,1733018270,1733018281,1733018281.863307,-21600,EB445137-D7F5-57EC-87DA-1DB460D64046,"iPhone13,2"
com.apple.MobileSMS,3,1733018260,1733018263,1733018263.585989,-21600,EB445137-D7F5-57EC-87DA-1DB460D64046,"iPhone13,2"
com.apple.news,2,1733018258,1733018260,1733018260.7598739,-21600,EB445137-D7F5-57EC-87DA-1DB460D64046,"iPhone13,2"
com.apple.news,39,1733018171,1733018210,1733018211.217865,-21600,EB445137-D7F5-57EC-87DA-1DB460D64046,"iPhone13,2"
com.apple.MobileSMS,11,1733018155,1733018166,1733018166.150758,-21600,EB445137-D7F5-57EC-87DA-1DB460D64046,"iPhone13,2"
com.apple.MobileSMS,4,1733018118,1733018122,1733018122.745461,-21600,EB445137-D7F5-57EC-87DA-1DB460D64046,"iPhone13,2"
com.apple.findmy,7,1733018101,1733018108,1733018108.641139,-21600,EB445137-D7F5-57EC-87DA-1DB460D64046,"iPhone13,2"
com.apple.MobileSMS,4,1733018097,1733018101,1733018102.15222,-21600,EB445137-D7F5-57EC-87DA-1DB460D64046,"iPhone13,2"
com.apple.MobileSMS,6,1733018081,1733018087,1733018087.106328,-21600,EB445137-D7F5-57EC-87DA-1DB460D64046,"iPhone13,2"
com.apple.MobileSMS,6,1733017521,1733017527,1733017527.098702,-21600,EB445137-D7F5-57EC-87DA-1DB460D64046,"iPhone13,2"
com.apple.MobileSMS,2,1733017264,1733017266,1733017266.774914,-21600,EB445137-D7F5-57EC-87DA-1DB460D64046,"iPhone13,2"
com.apple.MobileSMS,3,1733017207,1733017210,1733017210.1921,-21600,EB445137-D7F5-57EC-87DA-1DB460D64046,"iPhone13,2"
com.apple.MobileSMS,3,1733017200,1733017203,1733017203.082687,-21600,EB445137-D7F5-57EC-87DA-1DB460D64046,"iPhone13,2"
com.apple.MobileSMS,15,1733017175,1733017190,1733017190.956114,-21600,EB445137-D7F5-57EC-87DA-1DB460D64046,"iPhone13,2"
com.apple.MobileSMS,6,1733017166,1733017172,1733017172.854418,-21600,EB445137-D7F5-57EC-87DA-1DB460D64046,"iPhone13,2"
com.apple.MobileSMS,8,1733017137,1733017145,1733017145.22192,-21600,EB445137-D7F5-57EC-87DA-1DB460D64046,"iPhone13,2"
com.apple.MobileSMS,2,1733017073,1733017075,1733017075.647634,-21600,EB445137-D7F5-57EC-87DA-1DB460D64046,"iPhone13,2"
com.apple.MobileSMS,6,1733017050,1733017056,1733017057.099176,-21600,EB445137-D7F5-57EC-87DA-1DB460D64046,"iPhone13,2"
com.apple.MobileSMS,9,1733017018,1733017027,1733017027.3170938,-21600,EB445137-D7F5-57EC-87DA-1DB460D64046,"iPhone13,2"
com.apple.MobileSMS,2,1733017001,1733017003,1733017003.373598,-21600,EB445137-D7F5-57EC-87DA-1DB460D64046,"iPhone13,2"
com.apple.MobileSMS,7,1733016962,1733016969,1733016969.320562,-21600,EB445137-D7F5-57EC-87DA-1DB460D64046,"iPhone13,2"
com.apple.MobileSMS,2,1733016959,1733016961,1733016961.51685,-21600,EB445137-D7F5-57EC-87DA-1DB460D64046,"iPhone13,2"
com.apple.MobileSMS,2,1733016853,1733016855,1733016855.376133,-21600,EB445137-D7F5-57EC-87DA-1DB460D64046,"iPhone13,2"
com.apple.MobileSMS,10,1733016836,1733016846,1733016846.425469,-21600,EB445137-D7F5-57EC-87DA-1DB460D64046,"iPhone13,2"
com.apple.MobileSMS,1,1733016775,1733016776,1733016776.523114,-21600,EB445137-D7F5-57EC-87DA-1DB460D64046,"iPhone13,2"
com.apple.MobileSMS,7,1733016765,1733016772,1733016772.2410002,-21600,EB445137-D7F5-57EC-87DA-1DB460D64046,"iPhone13,2"
com.apple.MobileSMS,18,1733016745,1733016763,1733016763.914046,-21600,EB445137-D7F5-57EC-87DA-1DB460D64046,"iPhone13,2"
com.apple.MobileSMS,34,1733016680,1733016714,1733016715.006597,-21600,EB445137-D7F5-57EC-87DA-1DB460D64046,"iPhone13,2"
com.apple.MobileSMS,22,1733016538,1733016560,1733016560.6060061,-21600,EB445137-D7F5-57EC-87DA-1DB460D64046,"iPhone13,2"
com.apple.MobileSMS,2,1733016535,1733016537,1733016537.685063,-21600,EB445137-D7F5-57EC-87DA-1DB460D64046,"iPhone13,2"
com.apple.MobileSMS,5,1733016527,1733016532,1733016532.426866,-21600,EB445137-D7F5-57EC-87DA-1DB460D64046,"iPhone13,2"
com.apple.MobileSMS,6,1733016309,1733016315,1733016315.598026,-21600,EB445137-D7F5-57EC-87DA-1DB460D64046,"iPhone13,2"
com.apple.MobileSMS,29,1733016192,1733016221,1733016222.2454128,-21600,EB445137-D7F5-57EC-87DA-1DB460D64046,"iPhone13,2"
com.apple.camera,0,1733011040,1733011040,1733011041.013063,-21600,EB445137-D7F5-57EC-87DA-1DB460D64046,"iPhone13,2"
com.apple.findmy,9,1733010999,1733011008,1733011008.712573,-21600,EB445137-D7F5-57EC-87DA-1DB460D64046,"iPhone13,2"
com.amazon.Amazon,365,1733010012,1733010377,1733010378.889987,-21600,EB445137-D7F5-57EC-87DA-1DB460D64046,"iPhone13,2"
com.apple.camera,0,1733009617,1733009617,1733009617.24311,-21600,EB445137-D7F5-57EC-87DA-1DB460D64046,"iPhone13,2"
com.apple.camera,1,1733009601,1733009602,1733009602.788018,-21600,EB445137-D7F5-57EC-87DA-1DB460D64046,"iPhone13,2"
com.microsoft.Office.Outlook,8,1733009405,1733009413,1733009413.503792,-21600,EB445137-D7F5-57EC-87DA-1DB460D64046,"iPhone13,2"
com.apple.weather,7,1733009389,1733009396,1733009396.170824,-21600,EB445137-D7F5-57EC-87DA-1DB460D64046,"iPhone13,2"
com.apple.news,21,1733009366,1733009387,1733009387.8111382,-21600,EB445137-D7F5-57EC-87DA-1DB460D64046,"iPhone13,2"
com.apple.MobileSMS,4,1733009337,1733009341,1733009341.9192429,-21600,EB445137-D7F5-57EC-87DA-1DB460D64046,"iPhone13,2"
com.apple.MobileSMS,1,1733008951,1733008952,1733008952.154066,-21600,EB445137-D7F5-57EC-87DA-1DB460D64046,"iPhone13,2"
com.apple.MobileSMS,8,1733008914,1733008922,1733008923.270698,-21600,EB445137-D7F5-57EC-87DA-1DB460D64046,"iPhone13,2"
com.apple.weather,30,1733005640,1733005670,1733005670.3685598,-21600,EB445137-D7F5-57EC-87DA-1DB460D64046,"iPhone13,2"
com.apple.MobileSMS,21,1733005616,1733005637,1733005637.444718,-21600,EB445137-D7F5-57EC-87DA-1DB460D64046,"iPhone13,2"
com.apple.MobileSMS,7,1733004909,1733004916,1733004916.1784039,-21600,EB445137-D7F5-57EC-87DA-1DB460D64046,"iPhone13,2"
com.apple.MobileSMS,46,1733004833,1733004879,1733004879.7861772,-21600,EB445137-D7F5-57EC-87DA-1DB460D64046,"iPhone13,2"
com.apple.MobileSMS,3,1733000469,1733000472,1733000472.763828,-21600,EB445137-D7F5-57EC-87DA-1DB460D64046,"iPhone13,2"
com.apple.MobileSMS,6,1733000328,1733000334,1733000334.4287848,-21600,EB445137-D7F5-57EC-87DA-1DB460D64046,"iPhone13,2"
com.apple.MobileSMS,32,1733000288,1733000320,1733000320.796949,-21600,EB445137-D7F5-57EC-87DA-1DB460D64046,"iPhone13,2"
com.apple.camera,0,1733000288,1733000288,1733000288.751789,-21600,EB445137-D7F5-57EC-87DA-1DB460D64046,"iPhone13,2"
com.apple.MobileSMS,19,1733000250,1733000269,1733000269.899059,-21600,EB445137-D7F5-57EC-87DA-1DB460D64046,"iPhone13,2"
com.apple.Maps,2,1733000248,1733000250,1733000250.450088,-21600,EB445137-D7F5-57EC-87DA-1DB460D64046,"iPhone13,2"
com.apple.Maps,2,1732999901,1732999903,1732999903.2624779,-21600,EB445137-D7F5-57EC-87DA-1DB460D64046,"iPhone13,2"
com.apple.Maps,17,1732999790,1732999807,1732999807.782045,-21600,EB445137-D7F5-57EC-87DA-1DB460D64046,"iPhone13,2"
com.apple.findmy,4,1732999782,1732999786,1732999786.3835192,-21600,EB445137-D7F5-57EC-87DA-1DB460D64046,"iPhone13,2"
com.google.chrome.ios,87,1732999539,1732999626,1732999627.079979,-21600,EB445137-D7F5-57EC-87DA-1DB460D64046,"iPhone13,2"
com.apple.news,5,1732999533,1732999538,1732999538.753858,-21600,EB445137-D7F5-57EC-87DA-1DB460D64046,"iPhone13,2"
com.apple.Music,48,1732999342,1732999390,1732999392.9177508,-21600,EB445137-D7F5-57EC-87DA-1DB460D64046,"iPhone13,2"
com.apple.musicrecognition,5,1732999337,1732999342,1732999342.9903002,-21600,EB445137-D7F5-57EC-87DA-1DB460D64046,"iPhone13,2"
com.apple.MobileSMS,12,1732999325,1732999337,1732999338.142788,-21600,EB445137-D7F5-57EC-87DA-1DB460D64046,"iPhone13,2"
com.apple.MobileSMS,2,1732999236,1732999238,1732999238.8909268,-21600,EB445137-D7F5-57EC-87DA-1DB460D64046,"iPhone13,2"
com.apple.MobileSMS,3,1732998672,1732998675,1732998675.272623,-21600,EB445137-D7F5-57EC-87DA-1DB460D64046,"iPhone13,2"
com.apple.MobileSMS,2,1732998556,1732998558,1732998558.839591,-21600,EB445137-D7F5-57EC-87DA-1DB460D64046,"iPhone13,2"
com.apple.MobileSMS,3,1732998426,1732998429,1732998429.847958,-21600,EB445137-D7F5-57EC-87DA-1DB460D64046,"iPhone13,2"
com.apple.MobileSMS,44,1732998358,1732998402,1732998402.444232,-21600,EB445137-D7F5-57EC-87DA-1DB460D64046,"iPhone13,2"
com.apple.MobileSMS,16,1732998336,1732998352,1732998352.9128919,-21600,EB445137-D7F5-57EC-87DA-1DB460D64046,"iPhone13,2"
com.apple.findmy,18,1732998291,1732998309,1732998309.224753,-21600,EB445137-D7F5-57EC-87DA-1DB460D64046,"iPhone13,2"
com.apple.MobileSMS,128,1732998140,1732998268,1732998268.71283,-21600,EB445137-D7F5-57EC-87DA-1DB460D64046,"iPhone13,2"
com.apple.MobileSMS,29,1732998087,1732998116,1732998116.240278,-21600,EB445137-D7F5-57EC-87DA-1DB460D64046,"iPhone13,2"
com.apple.MobileSMS,4,1732997892,1732997896,1732997896.6298862,-21600,EB445137-D7F5-57EC-87DA-1DB460D64046,"iPhone13,2"
com.apple.MobileSMS,10,1732997782,1732997792,1732997792.613585,-21600,EB445137-D7F5-57EC-87DA-1DB460D64046,"iPhone13,2"
com.apple.MobileSMS,10,1732997542,1732997552,1732997552.982778,-21600,EB445137-D7F5-57EC-87DA-1DB460D64046,"iPhone13,2"
com.apple.MobileSMS,11,1732997445,1732997456,1732997456.270781,-21600,EB445137-D7F5-57EC-87DA-1DB460D64046,"iPhone13,2"
com.apple.MobileSMS,11,1732997299,1732997310,1732997310.71001,-21600,EB445137-D7F5-57EC-87DA-1DB460D64046,"iPhone13,2"
com.apple.MobileSMS,13,1732997220,1732997233,1732997233.289034,-21600,EB445137-D7F5-57EC-87DA-1DB460D64046,"iPhone13,2"
com.apple.MobileSMS,54,1732997031,1732997085,1732997085.3720632,-21600,EB445137-D7F5-57EC-87DA-1DB460D64046,"iPhone13,2"
com.apple.MobileSMS,6,1732996985,1732996991,1732996991.162722,-21600,EB445137-D7F5-57EC-87DA-1DB460D64046,"iPhone13,2"
com.apple.MobileSMS,22,1732996842,1732996864,1732996864.606195,-21600,EB445137-D7F5-57EC-87DA-1DB460D64046,"iPhone13,2"
com.toyopagroup.picaboo,2,1732996840,1732996842,1732996843.018482,-21600,EB445137-D7F5-57EC-87DA-1DB460D64046,"iPhone13,2"
com.toyopagroup.picaboo,10,1732996729,1732996739,1732996739.9465652,-21600,EB445137-D7F5-57EC-87DA-1DB460D64046,"iPhone13,2"
com.toyopagroup.picaboo,6,1732996712,1732996718,1732996718.468771,-21600,EB445137-D7F5-57EC-87DA-1DB460D64046,"iPhone13,2"
com.apple.MobileSMS,68,1732996644,1732996712,1732996712.451295,-21600,EB445137-D7F5-57EC-87DA-1DB460D64046,"iPhone13,2"
com.apple.Music,5,1732996638,1732996643,1732996643.722162,-21600,EB445137-D7F5-57EC-87DA-1DB460D64046,"iPhone13,2"
com.apple.Music,11,1732996611,1732996622,1732996622.3074632,-21600,EB445137-D7F5-57EC-87DA-1DB460D64046,"iPhone13,2"
com.apple.Music,3,1732996568,1732996571,1732996571.631016,-21600,EB445137-D7F5-57EC-87DA-1DB460D64046,"iPhone13,2"
com.apple.Music,6,1732996536,1732996542,1732996543.044755,-21600,EB445137-D7F5-57EC-87DA-1DB460D64046,"iPhone13,2"
com.apple.MobileSMS,5,1732996524,1732996529,1732996530.023421,-21600,EB445137-D7F5-57EC-87DA-1DB460D64046,"iPhone13,2"
com.apple.MobileSMS,5,1732996518,1732996523,1732996523.5744,-21600,EB445137-D7F5-57EC-87DA-1DB460D64046,"iPhone13,2"
com.apple.MobileSMS,11,1732996313,1732996324,1732996324.978167,-21600,EB445137-D7F5-57EC-87DA-1DB460D64046,"iPhone13,2"
com.apple.MobileSMS,15,1732995415,1732995430,1732995430.052983,-21600,EB445137-D7F5-57EC-87DA-1DB460D64046,"iPhone13,2"
com.apple.MobileSMS,2,1732995377,1732995379,1732995379.818717,-21600,EB445137-D7F5-57EC-87DA-1DB460D64046,"iPhone13,2"
com.apple.MobileSMS,11,1732994854,1732994865,1732994865.2288,-21600,EB445137-D7F5-57EC-87DA-1DB460D64046,"iPhone13,2"
com.apple.MobileSMS,10,1732994686,1732994696,1732994696.927912,-21600,EB445137-D7F5-57EC-87DA-1DB460D64046,"iPhone13,2"
com.apple.MobileSMS,11,1732994468,1732994479,1732994479.626862,-21600,EB445137-D7F5-57EC-87DA-1DB460D64046,"iPhone13,2"
com.apple.MobileSMS,9,1732994382,1732994391,1732994391.164978,-21600,EB445137-D7F5-57EC-87DA-1DB460D64046,"iPhone13,2"
com.apple.MobileSMS,4,1732994346,1732994350,1732994350.8113508,-21600,EB445137-D7F5-57EC-87DA-1DB460D64046,"iPhone13,2"
com.apple.MobileSMS,3,1732994274,1732994277,1732994277.904282,-21600,EB445137-D7F5-57EC-87DA-1DB460D64046,"iPhone13,2"
com.apple.MobileSMS,12,1732994127,1732994139,1732994139.4317589,-21600,EB445137-D7F5-57EC-87DA-1DB460D64046,"iPhone13,2"
com.apple.camera,1,1732994127,1732994128,1732994128.648086,-21600,EB445137-D7F5-57EC-87DA-1DB460D64046,"iPhone13,2"
com.apple.MobileSMS,7,1732993995,1732994002,1732994002.540914,-21600,EB445137-D7F5-57EC-87DA-1DB460D64046,"iPhone13,2"
com.apple.MobileSMS,3,1732993518,1732993521,1732993521.878269,-21600,EB445137-D7F5-57EC-87DA-1DB460D64046,"iPhone13,2"
com.apple.MobileSMS,1,1732993106,1732993107,1732993108.017819,-21600,EB445137-D7F5-57EC-87DA-1DB460D64046,"iPhone13,2"
com.apple.MobileSMS,11,1732992967,1732992978,1732992978.888278,-21600,EB445137-D7F5-57EC-87DA-1DB460D64046,"iPhone13,2"
com.apple.MobileSMS,3,1732992928,1732992931,1732992931.984874,-21600,EB445137-D7F5-57EC-87DA-1DB460D64046,"iPhone13,2"
com.apple.MobileSMS,4,1732992653,1732992657,1732992657.605324,-21600,EB445137-D7F5-57EC-87DA-1DB460D64046,"iPhone13,2"
com.apple.MobileSMS,8,1732992541,1732992549,1732992549.459558,-21600,EB445137-D7F5-57EC-87DA-1DB460D64046,"iPhone13,2"
com.apple.MobileSMS,34,1732992222,1732992256,1732992256.308775,-21600,EB445137-D7F5-57EC-87DA-1DB460D64046,"iPhone13,2"
com.apple.findmy,3,1732992219,1732992222,1732992223.503316,-21600,EB445137-D7F5-57EC-87DA-1DB460D64046,"iPhone13,2"
com.apple.findmy,6,1732992117,1732992123,1732992123.301021,-21600,EB445137-D7F5-57EC-87DA-1DB460D64046,"iPhone13,2"
com.apple.MobileSMS,13,1732992104,1732992117,1732992118.0673509,-21600,EB445137-D7F5-57EC-87DA-1DB460D64046,"iPhone13,2"
com.apple.MobileSMS,6,1732991863,1732991869,1732991869.817878,-21600,EB445137-D7F5-57EC-87DA-1DB460D64046,"iPhone13,2"
com.apple.camera,0,1732991770,1732991770,1732991770.690055,-21600,EB445137-D7F5-57EC-87DA-1DB460D64046,"iPhone13,2"
com.apple.camera,1,1732991769,1732991770,1732991770.178319,-21600,EB445137-D7F5-57EC-87DA-1DB460D64046,"iPhone13,2"
com.apple.MobileSMS,26,1732991755,1732991781,1732991781.5154428,-21600,EB445137-D7F5-57EC-87DA-1DB460D64046,"iPhone13,2"
com.apple.camera,1,1732991755,1732991756,1732991756.268439,-21600,EB445137-D7F5-57EC-87DA-1DB460D64046,"iPhone13,2"
com.apple.camera,0,1732991696,1732991696,1732991696.884756,-21600,EB445137-D7F5-57EC-87DA-1DB460D64046,"iPhone13,2"
com.apple.MobileSMS,25,1732991691,1732991716,1732991716.219693,-21600,EB445137-D7F5-57EC-87DA-1DB460D64046,"iPhone13,2"
com.apple.camera,3,1732991691,1732991694,1732991694.992282,-21600,EB445137-D7F5-57EC-87DA-1DB460D64046,"iPhone13,2"
com.apple.camera,0,1732991683,1732991683,1732991683.448973,-21600,EB445137-D7F5-57EC-87DA-1DB460D64046,"iPhone13,2"
com.apple.MobileSMS,16,1732991673,1732991689,1732991689.706311,-21600,EB445137-D7F5-57EC-87DA-1DB460D64046,"iPhone13,2"
com.apple.MobileSMS,3,1732991632,1732991635,1732991635.7431622,-21600,EB445137-D7F5-57EC-87DA-1DB460D64046,"iPhone13,2"
com.apple.MobileSMS,4,1732991579,1732991583,1732991583.835177,-21600,EB445137-D7F5-57EC-87DA-1DB460D64046,"iPhone13,2"
com.apple.MobileSMS,9,1732991554,1732991563,1732991563.278213,-21600,EB445137-D7F5-57EC-87DA-1DB460D64046,"iPhone13,2"
com.apple.MobileSMS,6,1732991548,1732991554,1732991554.414648,-21600,EB445137-D7F5-57EC-87DA-1DB460D64046,"iPhone13,2"
com.apple.MobileSMS,2,1732991477,1732991479,1732991479.9201732,-21600,EB445137-D7F5-57EC-87DA-1DB460D64046,"iPhone13,2"
com.apple.MobileSMS,43,1732991424,1732991467,1732991467.851377,-21600,EB445137-D7F5-57EC-87DA-1DB460D64046,"iPhone13,2"
com.apple.MobileSMS,6,1732991404,1732991410,1732991410.397634,-21600,EB445137-D7F5-57EC-87DA-1DB460D64046,"iPhone13,2"
com.apple.MobileSMS,18,1732991382,1732991400,1732991400.334145,-21600,EB445137-D7F5-57EC-87DA-1DB460D64046,"iPhone13,2"
com.apple.MobileSMS,7,1732990776,1732990783,1732990783.5772681,-21600,EB445137-D7F5-57EC-87DA-1DB460D64046,"iPhone13,2"
com.apple.MobileSMS,6,1732988958,1732988964,1732988964.135608,-21600,EB445137-D7F5-57EC-87DA-1DB460D64046,"iPhone13,2"
com.apple.MobileSMS,23,1732988935,1732988958,1732988958.4627051,-21600,EB445137-D7F5-57EC-87DA-1DB460D64046,"iPhone13,2"
com.apple.MobileSMS,9,1732987874,1732987883,1732987883.1779099,-21600,EB445137-D7F5-57EC-87DA-1DB460D64046,"iPhone13,2"
com.apple.findmy,14,1732987860,1732987874,1732987874.2770162,-21600,EB445137-D7F5-57EC-87DA-1DB460D64046,"iPhone13,2"
com.apple.MobileSMS,2,1732987857,1732987859,1732987861.578055,-21600,EB445137-D7F5-57EC-87DA-1DB460D64046,"iPhone13,2"
com.apple.Music,6,1732987851,1732987857,1732987859.241455,-21600,EB445137-D7F5-57EC-87DA-1DB460D64046,"iPhone13,2"
com.apple.Music,10,1732987676,1732987686,1732987686.892465,-21600,EB445137-D7F5-57EC-87DA-1DB460D64046,"iPhone13,2"
com.apple.Music,13,1732987661,1732987674,1732987674.1903582,-21600,EB445137-D7F5-57EC-87DA-1DB460D64046,"iPhone13,2"
com.apple.Music,14,1732987506,1732987520,1732987521.6396499,-21600,EB445137-D7F5-57EC-87DA-1DB460D64046,"iPhone13,2"
com.apple.findmy,5,1732987501,1732987506,1732987507.141477,-21600,EB445137-D7F5-57EC-87DA-1DB460D64046,"iPhone13,2"
com.apple.findmy,10,1732987247,1732987257,1732987257.154733,-21600,EB445137-D7F5-57EC-87DA-1DB460D64046,"iPhone13,2"
com.apple.findmy,61,1732987155,1732987216,1732987216.82338,-21600,EB445137-D7F5-57EC-87DA-1DB460D64046,"iPhone13,2"
com.apple.MobileSMS,2,1732987153,1732987155,1732987155.45935,-21600,EB445137-D7F5-57EC-87DA-1DB460D64046,"iPhone13,2"
com.apple.MobileSMS,11,1732987066,1732987077,1732987077.842963,-21600,EB445137-D7F5-57EC-87DA-1DB460D64046,"iPhone13,2"
com.apple.MobileSMS,33,1732986984,1732987017,1732987017.555948,-21600,EB445137-D7F5-57EC-87DA-1DB460D64046,"iPhone13,2"
com.apple.findmy,8,1732986976,1732986984,1732986984.336679,-21600,EB445137-D7F5-57EC-87DA-1DB460D64046,"iPhone13,2"
com.apple.MobileSMS,2,1732986974,1732986976,1732986976.869721,-21600,EB445137-D7F5-57EC-87DA-1DB460D64046,"iPhone13,2"
com.apple.MobileSMS,0,1732986885,1732986885,1732986885.717216,-21600,EB445137-D7F5-57EC-87DA-1DB460D64046,"iPhone13,2"
com.apple.findmy,3,1732986882,1732986885,1732986885.665029,-21600,EB445137-D7F5-57EC-87DA-1DB460D64046,"iPhone13,2"
com.apple.findmy,5,1732985972,1732985977,1732985977.976551,-21600,EB445137-D7F5-57EC-87DA-1DB460D64046,"iPhone13,2"
com.apple.findmy,4,1732985950,1732985954,1732985954.833897,-21600,EB445137-D7F5-57EC-87DA-1DB460D64046,"iPhone13,2"
com.apple.MobileSMS,4,1732985945,1732985949,1732985949.710577,-21600,EB445137-D7F5-57EC-87DA-1DB460D64046,"iPhone13,2"
com.apple.MobileSMS,10,1732985468,1732985478,1732985478.2887058,-21600,EB445137-D7F5-57EC-87DA-1DB460D64046,"iPhone13,2"
com.apple.MobileSMS,12,1732985453,1732985465,1732985465.302458,-21600,EB445137-D7F5-57EC-87DA-1DB460D64046,"iPhone13,2"
com.apple.MobileSMS,10,1732985333,1732985343,1732985343.380589,-21600,EB445137-D7F5-57EC-87DA-1DB460D64046,"iPhone13,2"
com.apple.MobileSMS,13,1732985236,1732985249,1732985249.694675,-21600,EB445137-D7F5-57EC-87DA-1DB460D64046,"iPhone13,2"
com.apple.MobileSMS,16,1732985213,1732985229,1732985229.934369,-21600,EB445137-D7F5-57EC-87DA-1DB460D64046,"iPhone13,2"
com.apple.findmy,19,1732984245,1732984264,1732984264.580164,-21600,EB445137-D7F5-57EC-87DA-1DB460D64046,"iPhone13,2"
com.google.chrome.ios,27,1732984195,1732984222,1732984222.332572,-21600,EB445137-D7F5-57EC-87DA-1DB460D64046,"iPhone13,2"
com.apple.camera,2,1732984185,1732984187,1732984187.21472,-21600,EB445137-D7F5-57EC-87DA-1DB460D64046,"iPhone13,2"
com.apple.findmy,8,1732982746,1732982754,1732982754.7333999,-21600,EB445137-D7F5-57EC-87DA-1DB460D64046,"iPhone13,2"
com.apple.Music,21,1732982722,1732982743,1732982744.029996,-21600,EB445137-D7F5-57EC-87DA-1DB460D64046,"iPhone13,2"
com.apple.Music,22,1732982699,1732982721,1732982721.570156,-21600,EB445137-D7F5-57EC-87DA-1DB460D64046,"iPhone13,2"
com.apple.Music,22,1732982146,1732982168,1732982168.7806702,-21600,EB445137-D7F5-57EC-87DA-1DB460D64046,"iPhone13,2"
com.apple.Music,22,1732981594,1732981616,1732981616.778933,-21600,EB445137-D7F5-57EC-87DA-1DB460D64046,"iPhone13,2"
com.apple.Music,23,1732981041,1732981064,1732981064.9218988,-21600,EB445137-D7F5-57EC-87DA-1DB460D64046,"iPhone13,2"
com.apple.Music,20,1732980491,1732980511,1732980511.103406,-21600,EB445137-D7F5-57EC-87DA-1DB460D64046,"iPhone13,2"
com.apple.Music,23,1732979938,1732979961,1732979961.436596,-21600,EB445137-D7F5-57EC-87DA-1DB460D64046,"iPhone13,2"
com.apple.Music,25,1732979360,1732979385,1732979385.135567,-21600,EB445137-D7F5-57EC-87DA-1DB460D64046,"iPhone13,2"
com.apple.Music,28,1732978801,1732978829,1732978829.9922,-21600,EB445137-D7F5-57EC-87DA-1DB460D64046,"iPhone13,2"
com.apple.Music,13,1732948451,1732948464,1732948464.5842881,-21600,EB445137-D7F5-57EC-87DA-1DB460D64046,"iPhone13,2"
com.apple.Music,15,1732948431,1732948446,1732948446.68964,-21600,EB445137-D7F5-57EC-87DA-1DB460D64046,"iPhone13,2"
com.google.chrome.ios,18,1732948410,1732948428,1732948428.4385982,-21600,EB445137-D7F5-57EC-87DA-1DB460D64046,"iPhone13,2"
com.facebook.Facebook,203,1732947003,1732947206,1732947206.579838,-21600,EB445137-D7F5-57EC-87DA-1DB460D64046,"iPhone13,2"
com.apple.Health,33,1732945894,1732945927,1732945927.7976608,-21600,EB445137-D7F5-57EC-87DA-1DB460D64046,"iPhone13,2"
com.google.Chrome,449,1732944013,1732944462,1732944462.849409,-21600,,
com.google.ios.youtube,13,1732943792,1732943805,1732943805.795813,-21600,EB445137-D7F5-57EC-87DA-1DB460D64046,"iPhone13,2"
com.google.ios.youtube,61,1732943107,1732943168,1732943169.029572,-21600,EB445137-D7F5-57EC-87DA-1DB460D64046,"iPhone13,2"
com.google.chrome.ios,2,1732943103,1732943105,1732943105.712378,-21600,EB445137-D7F5-57EC-87DA-1DB460D64046,"iPhone13,2"
com.google.chrome.ios,6,1732943097,1732943103,1732943103.355904,-21600,EB445137-D7F5-57EC-87DA-1DB460D64046,"iPhone13,2"
com.apple.camera,5,1732943097,1732943102,1732943102.9387941,-21600,EB445137-D7F5-57EC-87DA-1DB460D64046,"iPhone13,2"
com.google.chrome.ios,181,1732942420,1732942601,1732942601.602967,-21600,EB445137-D7F5-57EC-87DA-1DB460D64046,"iPhone13,2"
com.toyopagroup.picaboo,13,1732942405,1732942418,1732942418.6223679,-21600,EB445137-D7F5-57EC-87DA-1DB460D64046,"iPhone13,2"
com.google.ios.youtube,4,1732942401,1732942405,1732942405.891694,-21600,EB445137-D7F5-57EC-87DA-1DB460D64046,"iPhone13,2"
com.google.ios.youtube,46,1732941731,1732941777,1732941777.867106,-21600,EB445137-D7F5-57EC-87DA-1DB460D64046,"iPhone13,2"
com.google.ios.youtube,93,1732941119,1732941212,1732941212.643499,-21600,EB445137-D7F5-57EC-87DA-1DB460D64046,"iPhone13,2"
com.google.ios.youtube,59,1732940405,1732940464,1732940464.750165,-21600,EB445137-D7F5-57EC-87DA-1DB460D64046,"iPhone13,2"
com.google.ios.youtube,1,1732940007,1732940008,1732940008.519609,-21600,EB445137-D7F5-57EC-87DA-1DB460D64046,"iPhone13,2"
com.google.ios.youtube,58,1732939770,1732939828,1732939828.603891,-21600,EB445137-D7F5-57EC-87DA-1DB460D64046,"iPhone13,2"
com.google.ios.youtube,152,1732939287,1732939439,1732939439.872991,-21600,EB445137-D7F5-57EC-87DA-1DB460D64046,"iPhone13,2"
com.google.ios.youtube,49,1732938675,1732938724,1732938725.05387,-21600,EB445137-D7F5-57EC-87DA-1DB460D64046,"iPhone13,2"
com.google.chrome.ios,33,1732937980,1732938013,1732938013.659189,-21600,EB445137-D7F5-57EC-87DA-1DB460D64046,"iPhone13,2"
com.google.chrome.ios,24,1732937952,1732937976,1732937976.896822,-21600,EB445137-D7F5-57EC-87DA-1DB460D64046,"iPhone13,2"
com.apple.weather,11,1732937923,1732937934,1732937934.917084,-21600,EB445137-D7F5-57EC-87DA-1DB460D64046,"iPhone13,2"
com.apple.weather,46,1732937217,1732937263,1732937263.745748,-21600,EB445137-D7F5-57EC-87DA-1DB460D64046,"iPhone13,2"
com.apple.news,327,1732935024,1732935351,1732935351.2636352,-21600,EB445137-D7F5-57EC-87DA-1DB460D64046,"iPhone13,2"
com.apple.news,52,1732934965,1732935017,1732935017.5500221,-21600,EB445137-D7F5-57EC-87DA-1DB460D64046,"iPhone13,2"
com.toyopagroup.picaboo,1,1732934958,1732934959,1732934959.2324948,-21600,EB445137-D7F5-57EC-87DA-1DB460D64046,"iPhone13,2"
com.google.Chrome,1686,1732933531,1732935217,1732935217.709643,-21600,,
com.apple.Music,42,1732933489,1732933531,1732933531.365552,-21600,,
com.google.Chrome,2,1732933487,1732933489,1732933489.180037,-21600,,
com.leomehlig.today,1,1732933486,1732933487,1732933487.278563,-21600,,
com.google.Chrome,1,1732933485,1732933486,1732933486.492003,-21600,,
com.apple.Music,2,1732933483,1732933485,1732933485.759303,-21600,,
com.google.Chrome,17,1732933466,1732933483,1732933483.622109,-21600,,
com.apple.Music,22,1732933444,1732933466,1732933466.518909,-21600,,
com.apple.findmy,6,1732932358,1732932364,1732932364.665318,-21600,EB445137-D7F5-57EC-87DA-1DB460D64046,"iPhone13,2"
com.apple.news,5,1732932351,1732932356,1732932356.4312181,-21600,EB445137-D7F5-57EC-87DA-1DB460D64046,"iPhone13,2"
com.apple.news,42,1732931146,1732931188,1732931188.283076,-21600,EB445137-D7F5-57EC-87DA-1DB460D64046,"iPhone13,2"
com.apple.news,9,1732931021,1732931030,1732931030.589217,-21600,EB445137-D7F5-57EC-87DA-1DB460D64046,"iPhone13,2"
com.google.Chrome,2439,1732931005,1732933444,1732933444.168086,-21600,,
com.apple.news,10,1732930469,1732930479,1732930479.2483401,-21600,EB445137-D7F5-57EC-87DA-1DB460D64046,"iPhone13,2"
com.google.Chrome,635,1732930132,1732930767,1732930767.361686,-21600,,
com.apple.camera,5,1732929766,1732929771,1732929772.337384,-21600,EB445137-D7F5-57EC-87DA-1DB460D64046,"iPhone13,2"
com.apple.news,7,1732929764,1732929771,1732929772.323676,-21600,EB445137-D7F5-57EC-87DA-1DB460D64046,"iPhone13,2"
com.apple.camera,11,1732929650,1732929661,1732929662.117041,-21600,EB445137-D7F5-57EC-87DA-1DB460D64046,"iPhone13,2"
com.apple.news,13,1732929648,1732929661,1732929662.076952,-21600,EB445137-D7F5-57EC-87DA-1DB460D64046,"iPhone13,2"
com.apple.camera,13,1732929528,1732929541,1732929544.644047,-21600,EB445137-D7F5-57EC-87DA-1DB460D64046,"iPhone13,2"
com.apple.news,17,1732929524,1732929541,1732929544.639869,-21600,EB445137-D7F5-57EC-87DA-1DB460D64046,"iPhone13,2"
com.google.Chrome,460,1732929286,1732929746,1732929746.747613,-21600,,
com.leomehlig.today,2,1732929284,1732929286,1732929286.413989,-21600,,
com.apple.MobileSMS,79,1732929205,1732929284,1732929285.0126328,-21600,,
com.leomehlig.today,31,1732929174,1732929205,1732929205.7060308,-21600,,
com.google.Chrome,42,1732929132,1732929174,1732929174.2292109,-21600,,
com.apple.news,3,1732929025,1732929028,1732929028.108799,-21600,EB445137-D7F5-57EC-87DA-1DB460D64046,"iPhone13,2"
com.apple.news,1,1732928980,1732928981,1732928981.914309,-21600,EB445137-D7F5-57EC-87DA-1DB460D64046,"iPhone13,2"
com.apple.news,63,1732928677,1732928740,1732928740.558682,-21600,EB445137-D7F5-57EC-87DA-1DB460D64046,"iPhone13,2"
com.toyopagroup.picaboo,4,1732928442,1732928446,1732928446.538392,-21600,EB445137-D7F5-57EC-87DA-1DB460D64046,"iPhone13,2"
com.apple.Music,9,1732928331,1732928340,1732928340.460243,-21600,EB445137-D7F5-57EC-87DA-1DB460D64046,"iPhone13,2"
com.apple.Music,9,1732928304,1732928313,1732928314.298697,-21600,EB445137-D7F5-57EC-87DA-1DB460D64046,"iPhone13,2"
com.apple.MobileSMS,6,1732927982,1732927988,1732927988.1531959,-21600,EB445137-D7F5-57EC-87DA-1DB460D64046,"iPhone13,2"
com.apple.Music,2,1732927980,1732927982,1732927982.4602551,-21600,EB445137-D7F5-57EC-87DA-1DB460D64046,"iPhone13,2"
com.apple.Music,6,1732927855,1732927861,1732927861.3860068,-21600,EB445137-D7F5-57EC-87DA-1DB460D64046,"iPhone13,2"
com.apple.Music,15,1732927741,1732927756,1732927756.828816,-21600,EB445137-D7F5-57EC-87DA-1DB460D64046,"iPhone13,2"
com.apple.Music,13,1732927726,1732927739,1732927739.910842,-21600,EB445137-D7F5-57EC-87DA-1DB460D64046,"iPhone13,2"
com.apple.Music,21,1732927311,1732927332,1732927332.383905,-21600,EB445137-D7F5-57EC-87DA-1DB460D64046,"iPhone13,2"
com.apple.Music,9,1732927270,1732927279,1732927279.987726,-21600,EB445137-D7F5-57EC-87DA-1DB460D64046,"iPhone13,2"
com.apple.Music,2,1732927266,1732927268,1732927268.4862309,-21600,EB445137-D7F5-57EC-87DA-1DB460D64046,"iPhone13,2"
com.apple.Music,2,1732926992,1732926994,1732926994.889446,-21600,EB445137-D7F5-57EC-87DA-1DB460D64046,"iPhone13,2"
com.apple.Music,5,1732926874,1732926879,1732926879.170196,-21600,EB445137-D7F5-57EC-87DA-1DB460D64046,"iPhone13,2"
com.apple.Music,1,1732926602,1732926603,1732926603.532331,-21600,EB445137-D7F5-57EC-87DA-1DB460D64046,"iPhone13,2"
com.apple.Music,10,1732926177,1732926187,1732926188.05331,-21600,EB445137-D7F5-57EC-87DA-1DB460D64046,"iPhone13,2"
com.apple.Music,13,1732926100,1732926113,1732926113.857229,-21600,EB445137-D7F5-57EC-87DA-1DB460D64046,"iPhone13,2"
com.apple.Preferences,77,1732926021,1732926098,1732926098.69682,-21600,EB445137-D7F5-57EC-87DA-1DB460D64046,"iPhone13,2"
com.apple.Music,32,1732925989,1732926021,1732926021.567056,-21600,EB445137-D7F5-57EC-87DA-1DB460D64046,"iPhone13,2"
com.apple.Music,36,1732925949,1732925985,1732925985.50794,-21600,EB445137-D7F5-57EC-87DA-1DB460D64046,"iPhone13,2"
com.apple.Music,42,1732925865,1732925907,1732925907.602673,-21600,EB445137-D7F5-57EC-87DA-1DB460D64046,"iPhone13,2"
com.apple.Music,11,1732925770,1732925781,1732925781.6126251,-21600,EB445137-D7F5-57EC-87DA-1DB460D64046,"iPhone13,2"
com.apple.Music,16,1732925748,1732925764,1732925764.588859,-21600,EB445137-D7F5-57EC-87DA-1DB460D64046,"iPhone13,2"
com.apple.Music,17,1732925708,1732925725,1732925725.185845,-21600,EB445137-D7F5-57EC-87DA-1DB460D64046,"iPhone13,2"
com.google.chrome.ios,18,1732925687,1732925705,1732925705.923413,-21600,EB445137-D7F5-57EC-87DA-1DB460D64046,"iPhone13,2"
com.google.chrome.ios,2,1732925683,1732925685,1732925685.444505,-21600,EB445137-D7F5-57EC-87DA-1DB460D64046,"iPhone13,2"
com.google.chrome.ios,10,1732923924,1732923934,1732923934.187271,-21600,EB445137-D7F5-57EC-87DA-1DB460D64046,"iPhone13,2"
com.google.chrome.ios,15,1732923570,1732923585,1732923586.191999,-21600,EB445137-D7F5-57EC-87DA-1DB460D64046,"iPhone13,2"
com.apple.news,2,1732923567,1732923569,1732923569.9863958,-21600,EB445137-D7F5-57EC-87DA-1DB460D64046,"iPhone13,2"
com.apple.news,113,1732923288,1732923401,1732923402.079255,-21600,EB445137-D7F5-57EC-87DA-1DB460D64046,"iPhone13,2"
com.apple.news,7,1732923280,1732923287,1732923287.707089,-21600,EB445137-D7F5-57EC-87DA-1DB460D64046,"iPhone13,2"
com.apple.news,302,1732922976,1732923278,1732923278.939681,-21600,EB445137-D7F5-57EC-87DA-1DB460D64046,"iPhone13,2"
com.apple.news,12,1732922458,1732922470,1732922470.079568,-21600,EB445137-D7F5-57EC-87DA-1DB460D64046,"iPhone13,2"
com.apple.news,10,1732922447,1732922457,1732922457.380979,-21600,EB445137-D7F5-57EC-87DA-1DB460D64046,"iPhone13,2"
com.apple.news,19,1732922425,1732922444,1732922444.123652,-21600,EB445137-D7F5-57EC-87DA-1DB460D64046,"iPhone13,2"
com.apple.news,333,1732922052,1732922385,1732922385.3294091,-21600,EB445137-D7F5-57EC-87DA-1DB460D64046,"iPhone13,2"
com.apple.findmy,10,1732922010,1732922020,1732922020.1760159,-21600,EB445137-D7F5-57EC-87DA-1DB460D64046,"iPhone13,2"
com.apple.findmy,10,1732921772,1732921782,1732921782.5568151,-21600,EB445137-D7F5-57EC-87DA-1DB460D64046,"iPhone13,2"
com.apple.findmy,5,1732921766,1732921771,1732921771.880892,-21600,EB445137-D7F5-57EC-87DA-1DB460D64046,"iPhone13,2"
com.google.Chrome,2,1732921673,1732921675,1732921675.635418,-21600,,
com.leomehlig.today,3,1732921670,1732921673,1732921673.33026,-21600,,
com.apple.MobileSMS,3,1732921667,1732921670,1732921670.569641,-21600,,
com.leomehlig.today,4,1732921663,1732921667,1732921667.334115,-21600,,
com.microsoft.VSCode,2,1732921661,1732921663,1732921663.714474,-21600,,
com.leomehlig.today,20,1732921641,1732921661,1732921661.0894141,-21600,,
com.apple.findmy,32,1732921010,1732921042,1732921042.872196,-21600,EB445137-D7F5-57EC-87DA-1DB460D64046,"iPhone13,2"
com.google.Chrome,653,1732920988,1732921641,1732921641.278863,-21600,,
com.microsoft.VSCode,12,1732920976,1732920988,1732920988.989413,-21600,,
com.google.Chrome,2,1732920974,1732920976,1732920976.855291,-21600,,
com.microsoft.VSCode,1,1732920973,1732920974,1732920974.8312268,-21600,,
com.google.Chrome,3,1732920970,1732920973,1732920973.075551,-21600,,
com.microsoft.VSCode,7,1732920963,1732920970,1732920970.568002,-21600,,
com.google.Chrome,1,1732920945,1732920946,1732920946.866805,-21600,,
com.microsoft.VSCode,1,1732920944,1732920945,1732920945.099792,-21600,,
com.google.Chrome,2,1732920942,1732920944,1732920944.244401,-21600,,
com.microsoft.VSCode,1,1732920941,1732920942,1732920942.839549,-21600,,
com.google.Chrome,1,1732920940,1732920941,1732920942.033053,-21600,,
com.microsoft.VSCode,1,1732920939,1732920940,1732920940.428797,-21600,,
com.google.Chrome,1,1732920938,1732920939,1732920939.406743,-21600,,
com.microsoft.VSCode,1,1732920937,1732920938,1732920938.325448,-21600,,
com.google.Chrome,1,1732920936,1732920937,1732920937.5425029,-21600,,
com.microsoft.VSCode,1,1732920935,1732920936,1732920936.3322039,-21600,,
com.google.Chrome,1,1732920934,1732920935,1732920935.463315,-21600,,
com.microsoft.VSCode,1,1732920933,1732920934,1732920934.454901,-21600,,
com.google.Chrome,3,1732920930,1732920933,1732920933.14578,-21600,,
com.microsoft.VSCode,1,1732920929,1732920930,1732920930.648655,-21600,,
com.google.Chrome,2,1732920927,1732920929,1732920929.626361,-21600,,
com.microsoft.VSCode,1,1732920926,1732920927,1732920927.35393,-21600,,
com.google.Chrome,2,1732920924,1732920926,1732920926.271031,-21600,,
com.microsoft.VSCode,1,1732920923,1732920924,1732920924.584317,-21600,,
com.google.Chrome,2,1732920921,1732920923,1732920923.479681,-21600,,
com.microsoft.VSCode,1,1732920920,1732920921,1732920921.808249,-21600,,
com.google.Chrome,1,1732920919,1732920920,1732920920.8716822,-21600,,
com.microsoft.VSCode,1,1732920918,1732920919,1732920919.6217499,-21600,,
com.google.Chrome,3,1732920915,1732920918,1732920918.438355,-21600,,
com.microsoft.VSCode,2,1732920913,1732920915,1732920915.913011,-21600,,
com.google.Chrome,2,1732920911,1732920913,1732920914.038856,-21600,,
com.microsoft.VSCode,1,1732920910,1732920911,1732920911.590693,-21600,,
com.google.Chrome,1,1732920909,1732920910,1732920910.551066,-21600,,
com.microsoft.VSCode,1,1732920908,1732920909,1732920909.187702,-21600,,
com.google.Chrome,1,1732920907,1732920908,1732920908.191514,-21600,,
com.microsoft.VSCode,24,1732920883,1732920907,1732920907.2642179,-21600,,
com.google.Chrome,4,1732920871,1732920875,1732920875.959281,-21600,,
com.microsoft.VSCode,1,1732920870,1732920871,1732920871.5989552,-21600,,
com.google.Chrome,3,1732920867,1732920870,1732920870.186475,-21600,,
com.microsoft.VSCode,0,1732920867,1732920867,1732920867.933708,-21600,,
com.google.Chrome,2,1732920865,1732920867,1732920867.050308,-21600,,
com.microsoft.VSCode,1,1732920864,1732920865,1732920865.98667,-21600,,
com.google.Chrome,1,1732920863,1732920864,1732920864.8539019,-21600,,
com.microsoft.VSCode,1,1732920862,1732920863,1732920863.6143131,-21600,,
com.google.Chrome,2,1732920860,1732920862,1732920862.064168,-21600,,
com.microsoft.VSCode,1,1732920859,1732920860,1732920860.950525,-21600,,
com.google.Chrome,2,1732920857,1732920859,1732920859.139731,-21600,,
com.microsoft.VSCode,2,1732920855,1732920857,1732920857.124363,-21600,,
com.google.Chrome,2,1732920853,1732920855,1732920855.999656,-21600,,
com.microsoft.VSCode,1,1732920852,1732920853,1732920853.54643,-21600,,
com.google.Chrome,2,1732920850,1732920852,1732920852.288422,-21600,,
com.microsoft.VSCode,3,1732920847,1732920850,1732920850.280682,-21600,,
com.google.Chrome,1,1732920846,1732920847,1732920847.8923159,-21600,,
com.microsoft.VSCode,1,1732920845,1732920846,1732920846.086546,-21600,,
com.google.Chrome,3,1732920842,1732920845,1732920845.111707,-21600,,
com.microsoft.VSCode,1,1732920841,1732920842,1732920842.631557,-21600,,
com.google.Chrome,2,1732920839,1732920841,1732920841.183508,-21600,,
com.microsoft.VSCode,1,1732920838,1732920839,1732920839.864764,-21600,,
com.google.Chrome,1,1732920837,1732920838,1732920838.916686,-21600,,
com.microsoft.VSCode,2,1732920835,1732920837,1732920837.229446,-21600,,
com.google.Chrome,1,1732920834,1732920835,1732920835.7064981,-21600,,
com.microsoft.VSCode,1,1732920833,1732920834,1732920834.929595,-21600,,
com.google.Chrome,1,1732920832,1732920833,1732920833.9331431,-21600,,
com.microsoft.VSCode,1,1732920831,1732920832,1732920832.616197,-21600,,
com.google.Chrome,3,1732920828,1732920831,1732920831.484025,-21600,,
com.microsoft.VSCode,1,1732920827,1732920828,1732920828.285017,-21600,,
com.google.Chrome,2,1732920825,1732920827,1732920827.077198,-21600,,
com.microsoft.VSCode,2,1732920823,1732920825,1732920825.155369,-21600,,
com.google.Chrome,4,1732920819,1732920823,1732920823.8789701,-21600,,
com.microsoft.VSCode,1,1732920818,1732920819,1732920819.526792,-21600,,
com.google.Chrome,1,1732920817,1732920818,1732920818.387656,-21600,,
com.microsoft.VSCode,2,1732920815,1732920817,1732920817.2102308,-21600,,
com.google.Chrome,2,1732920813,1732920815,1732920815.568509,-21600,,
com.microsoft.VSCode,2,1732920811,1732920813,1732920813.9404058,-21600,,
com.google.Chrome,2,1732920809,1732920811,1732920811.440384,-21600,,
com.microsoft.VSCode,1,1732920808,1732920809,1732920809.959145,-21600,,
com.google.Chrome,3,1732920805,1732920808,1732920808.4596,-21600,,
com.microsoft.VSCode,1,1732920804,1732920805,1732920805.907799,-21600,,
com.google.Chrome,4,1732920800,1732920804,1732920804.423918,-21600,,
com.microsoft.VSCode,1,1732920799,1732920800,1732920800.941206,-21600,,
com.google.Chrome,3,1732920796,1732920799,1732920799.3497782,-21600,,
com.microsoft.VSCode,1,1732920795,1732920796,1732920796.8565311,-21600,,
com.google.Chrome,2,1732920793,1732920795,1732920795.180898,-21600,,
com.microsoft.VSCode,1,1732920792,1732920793,1732920793.794118,-21600,,
com.google.Chrome,2,1732920790,1732920792,1732920792.7160292,-21600,,
com.microsoft.VSCode,1,1732920789,1732920790,1732920790.476305,-21600,,
com.google.Chrome,2,1732920787,1732920789,1732920789.33,-21600,,
com.microsoft.VSCode,1,1732920786,1732920787,1732920787.459494,-21600,,
com.google.Chrome,1,1732920785,1732920786,1732920786.8358688,-21600,,
com.microsoft.VSCode,1,1732920784,1732920785,1732920785.510833,-21600,,
com.google.Chrome,3,1732920781,1732920784,1732920784.34987,-21600,,
com.microsoft.VSCode,1,1732920780,1732920781,1732920781.45943,-21600,,
com.google.Chrome,4,1732920776,1732920780,1732920780.449162,-21600,,
com.microsoft.VSCode,1,1732920775,1732920776,1732920777.006316,-21600,,
com.google.Chrome,8,1732920767,1732920775,1732920775.260898,-21600,,
com.microsoft.VSCode,25,1732920742,1732920767,1732920767.528302,-21600,,
com.google.Chrome,3,1732920739,1732920742,1732920742.409195,-21600,,
com.microsoft.VSCode,5,1732920734,1732920739,1732920739.7429771,-21600,,
com.google.Chrome,10,1732920724,1732920734,1732920734.13937,-21600,,
com.microsoft.VSCode,15,1732920709,1732920724,1732920724.4246721,-21600,,
com.google.Chrome,1,1732920708,1732920709,1732920709.2415981,-21600,,
com.microsoft.VSCode,0,1732920708,1732920708,1732920709.025171,-21600,,
com.google.Chrome,1,1732920707,1732920708,1732920708.196151,-21600,,
com.microsoft.VSCode,2,1732920705,1732920707,1732920707.492208,-21600,,
com.google.Chrome,1,1732920704,1732920705,1732920705.334573,-21600,,
com.apple.findmy,61,1732920683,1732920744,1732920744.678056,-21600,EB445137-D7F5-57EC-87DA-1DB460D64046,"iPhone13,2"
com.microsoft.VSCode,53,1732920651,1732920704,1732920704.493349,-21600,,
com.google.Chrome,1,1732920650,1732920651,1732920651.440534,-21600,,
com.microsoft.VSCode,11,1732920639,1732920650,1732920650.7350569,-21600,,
com.google.Chrome,1,1732920638,1732920639,1732920640.000381,-21600,,
com.microsoft.VSCode,6,1732920632,1732920638,1732920638.74104,-21600,,
com.google.Chrome,1,1732920631,1732920632,1732920632.563299,-21600,,
com.microsoft.VSCode,4,1732920627,1732920631,1732920631.632755,-21600,,
com.google.Chrome,1,1732920626,1732920627,1732920627.175355,-21600,,
com.microsoft.VSCode,5,1732920621,1732920626,1732920626.078696,-21600,,
com.google.Chrome,1,1732920620,1732920621,1732920621.548914,-21600,,
com.microsoft.VSCode,9,1732920611,1732920620,1732920620.087081,-21600,,
com.google.Chrome,1,1732920610,1732920611,1732920612.027615,-21600,,
com.microsoft.VSCode,8,1732920602,1732920610,1732920610.6435242,-21600,,
com.google.Chrome,1,1732920601,1732920602,1732920602.871311,-21600,,
com.microsoft.VSCode,5,1732920596,1732920601,1732920601.7727199,-21600,,
com.google.Chrome,1,1732920595,1732920596,1732920596.3948941,-21600,,
com.microsoft.VSCode,41,1732920554,1732920595,1732920595.181066,-21600,,
com.google.Chrome,58,1732920496,1732920554,1732920554.824189,-21600,,
com.apple.iCal,36,1732920460,1732920496,1732920496.54163,-21600,,
com.google.Chrome,24,1732920436,1732920460,1732920460.614542,-21600,,
com.apple.findmy,17,1732920410,1732920427,1732920427.897563,-21600,EB445137-D7F5-57EC-87DA-1DB460D64046,"iPhone13,2"
com.robinhood.release.Robinhood,3,1732920406,1732920409,1732920409.4523191,-21600,EB445137-D7F5-57EC-87DA-1DB460D64046,"iPhone13,2"
com.robinhood.release.Robinhood,4,1732920394,1732920398,1732920398.132498,-21600,EB445137-D7F5-57EC-87DA-1DB460D64046,"iPhone13,2"
com.robinhood.release.Robinhood,68,1732920208,1732920276,1732920277.327079,-21600,EB445137-D7F5-57EC-87DA-1DB460D64046,"iPhone13,2"
com.apple.findmy,11,1732920152,1732920163,1732920163.292574,-21600,EB445137-D7F5-57EC-87DA-1DB460D64046,"iPhone13,2"
com.google.chrome.ios,46,1732920105,1732920151,1732920151.919951,-21600,EB445137-D7F5-57EC-87DA-1DB460D64046,"iPhone13,2"
com.microsoft.Office.Outlook,5,1732920094,1732920099,1732920099.799182,-21600,EB445137-D7F5-57EC-87DA-1DB460D64046,"iPhone13,2"
com.google.Chrome,305,1732920079,1732920384,1732920384.749793,-21600,,
com.apple.finder,2,1732920077,1732920079,1732920079.765105,-21600,,
us.zoom.xos,2,1732920075,1732920077,1732920077.42924,-21600,,
com.apple.finder,2,1732920073,1732920075,1732920075.106328,-21600,,
com.microsoft.Office.Outlook,8,1732920052,1732920060,1732920061.31617,-21600,EB445137-D7F5-57EC-87DA-1DB460D64046,"iPhone13,2"
com.apple.news,9,1732920041,1732920050,1732920050.8566751,-21600,EB445137-D7F5-57EC-87DA-1DB460D64046,"iPhone13,2"
us.zoom.xos,66,1732920007,1732920073,1732920073.4856138,-21600,,
com.google.Chrome,4,1732920003,1732920007,1732920007.934897,-21600,,
us.zoom.xos,58,1732919945,1732920003,1732920003.0598211,-21600,,
com.google.Chrome,26,1732919919,1732919945,1732919945.3526669,-21600,,
us.zoom.xos,6,1732919913,1732919919,1732919919.539772,-21600,,
com.google.Chrome,4,1732919909,1732919913,1732919913.37785,-21600,,
us.zoom.xos,3,1732919906,1732919909,1732919909.49579,-21600,,
com.google.Chrome,8,1732919898,1732919906,1732919906.7695131,-21600,,
us.zoom.xos,60,1732919838,1732919898,1732919898.8697991,-21600,,
com.google.Chrome,13,1732919825,1732919838,1732919838.967282,-21600,,
us.zoom.xos,93,1732919732,1732919825,1732919825.688966,-21600,,
com.google.Chrome,9,1732919723,1732919732,1732919732.3000832,-21600,,
us.zoom.xos,36,1732919687,1732919723,1732919723.0923371,-21600,,
com.google.Chrome,26,1732919661,1732919687,1732919687.8843799,-21600,,
us.zoom.xos,36,1732919625,1732919661,1732919661.658386,-21600,,
com.google.Chrome,9,1732919616,1732919625,1732919625.511466,-21600,,
us.zoom.xos,9,1732919607,1732919616,1732919616.2918649,-21600,,
com.google.Chrome,27,1732919580,1732919607,1732919607.100896,-21600,,
us.zoom.xos,66,1732919514,1732919580,1732919580.947674,-21600,,
com.google.Chrome,12,1732919502,1732919514,1732919514.519899,-21600,,
us.zoom.xos,54,1732919448,1732919502,1732919502.5114741,-21600,,
com.google.Chrome,6,1732919442,1732919448,1732919448.215798,-21600,,
us.zoom.xos,22,1732919420,1732919442,1732919442.799197,-21600,,
com.google.Chrome,5,1732919415,1732919420,1732919420.104642,-21600,,
us.zoom.xos,13,1732919402,1732919415,1732919415.747779,-21600,,
com.google.Chrome,27,1732919375,1732919402,1732919402.474138,-21600,,
com.apple.Photos,11,1732919364,1732919375,1732919375.3274798,-21600,,
com.google.Chrome,3,1732919361,1732919364,1732919364.472299,-21600,,
com.apple.Photos,10,1732919351,1732919361,1732919361.525969,-21600,,
com.google.Chrome,2,1732919349,1732919351,1732919351.464401,-21600,,
us.zoom.xos,346,1732919003,1732919349,1732919349.352785,-21600,,
com.google.Chrome,8,1732918995,1732919003,1732919003.041311,-21600,,
us.zoom.xos,12,1732918983,1732918995,1732918995.080019,-21600,,
com.google.Chrome,20,1732918963,1732918983,1732918983.433296,-21600,,
us.zoom.xos,19,1732918944,1732918963,1732918963.891504,-21600,,
com.google.Chrome,43,1732918901,1732918944,1732918944.733931,-21600,,
us.zoom.xos,65,1732918836,1732918901,1732918901.63978,-21600,,
com.google.Chrome,9,1732918827,1732918836,1732918836.04455,-21600,,
com.microsoft.VSCode,1,1732918826,1732918827,1732918827.5230699,-21600,,
com.apple.news,56,1732918570,1732918626,1732918626.508579,-21600,EB445137-D7F5-57EC-87DA-1DB460D64046,"iPhone13,2"
com.toyopagroup.picaboo,28,1732918540,1732918568,1732918568.475369,-21600,EB445137-D7F5-57EC-87DA-1DB460D64046,"iPhone13,2"
com.apple.findmy,7,1732918533,1732918540,1732918541.505259,-21600,EB445137-D7F5-57EC-87DA-1DB460D64046,"iPhone13,2"
us.zoom.xos,673,1732918153,1732918826,1732918826.362914,-21600,,
com.google.Chrome,4,1732918149,1732918153,1732918153.8380098,-21600,,
us.zoom.xos,105,1732918044,1732918149,1732918149.2458858,-21600,,
com.google.Chrome,52,1732917992,1732918044,1732918044.692953,-21600,,
com.microsoft.VSCode,1,1732917991,1732917992,1732917992.894963,-21600,,
us.zoom.xos,1,1732917990,1732917991,1732917991.728679,-21600,,
com.google.Chrome,189,1732917801,1732917990,1732917990.399251,-21600,,
com.microsoft.VSCode,1,1732917800,1732917801,1732917801.391777,-21600,,
us.zoom.xos,143,1732917657,1732917800,1732917800.423809,-21600,,
com.microsoft.VSCode,25,1732917632,1732917657,1732917657.431592,-21600,,
us.zoom.xos,2,1732917630,1732917632,1732917632.338139,-21600,,
com.apple.findmy,7,1732917526,1732917533,1732917534.2750711,-21600,EB445137-D7F5-57EC-87DA-1DB460D64046,"iPhone13,2"
com.apple.weather,26,1732917499,1732917525,1732917525.222655,-21600,EB445137-D7F5-57EC-87DA-1DB460D64046,"iPhone13,2"
com.toyopagroup.picaboo,17,1732917449,1732917466,1732917466.742899,-21600,EB445137-D7F5-57EC-87DA-1DB460D64046,"iPhone13,2"
com.toyopagroup.picaboo,81,1732917334,1732917415,1732917415.471802,-21600,EB445137-D7F5-57EC-87DA-1DB460D64046,"iPhone13,2"
com.apple.weather,4,1732917330,1732917334,1732917334.45539,-21600,EB445137-D7F5-57EC-87DA-1DB460D64046,"iPhone13,2"
com.apple.weather,6,1732917009,1732917015,1732917015.176435,-21600,EB445137-D7F5-57EC-87DA-1DB460D64046,"iPhone13,2"
us.zoom.xos,300,1732916900,1732917200,1732917200.716284,-21600,,
com.google.Chrome,2,1732916898,1732916900,1732916900.739471,-21600,,
us.zoom.xos,61,1732916837,1732916898,1732916898.704423,-21600,,
com.google.Chrome,34,1732916803,1732916837,1732916837.072102,-21600,,
us.zoom.xos,2,1732916801,1732916803,1732916803.477242,-21600,,
com.google.Chrome,2,1732916799,1732916801,1732916801.516842,-21600,,
com.microsoft.VSCode,1,1732916798,1732916799,1732916799.733957,-21600,,
com.google.Chrome,29,1732916769,1732916798,1732916798.724752,-21600,,
com.microsoft.VSCode,1,1732916768,1732916769,1732916769.579095,-21600,,
us.zoom.xos,1,1732916767,1732916768,1732916768.246015,-21600,,
com.apple.weather,2,1732916379,1732916381,1732916381.664376,-21600,EB445137-D7F5-57EC-87DA-1DB460D64046,"iPhone13,2"
com.apple.weather,0,1732916378,1732916378,1732916378.9320931,-21600,EB445137-D7F5-57EC-87DA-1DB460D64046,"iPhone13,2"
us.zoom.xos,557,1732916168,1732916725,1732916725.317202,-21600,,
com.microsoft.VSCode,18,1732916150,1732916168,1732916168.667906,-21600,,
us.zoom.xos,11,1732916139,1732916150,1732916150.98809,-21600,,
com.microsoft.VSCode,51,1732916088,1732916139,1732916140.02908,-21600,,
us.zoom.xos,21,1732916067,1732916088,1732916088.9938931,-21600,,
com.google.Chrome,11,1732916056,1732916067,1732916067.637747,-21600,,
us.zoom.xos,3,1732916053,1732916056,1732916056.795515,-21600,,
com.google.Chrome,12,1732916041,1732916053,1732916053.357527,-21600,,
com.microsoft.VSCode,101,1732915940,1732916041,1732916041.9275951,-21600,,
com.google.Chrome,2,1732915938,1732915940,1732915940.9580889,-21600,,
com.microsoft.VSCode,1,1732915937,1732915938,1732915938.897937,-21600,,
us.zoom.xos,2,1732915935,1732915937,1732915937.298197,-21600,,
com.google.Chrome,9,1732915926,1732915935,1732915935.474626,-21600,,
com.microsoft.VSCode,3,1732915923,1732915926,1732915926.696834,-21600,,
com.google.Chrome,1,1732915922,1732915923,1732915923.754809,-21600,,
com.microsoft.VSCode,18,1732915904,1732915922,1732915922.4764252,-21600,,
com.google.Chrome,1,1732915903,1732915904,1732915904.575811,-21600,,
us.zoom.xos,4,1732915899,1732915903,1732915903.6972132,-21600,,
com.google.Chrome,4,1732915895,1732915899,1732915899.235486,-21600,,
us.zoom.xos,6,1732915889,1732915895,1732915895.1619182,-21600,,
com.google.Chrome,10,1732915879,1732915889,1732915889.4124951,-21600,,
us.zoom.xos,1,1732915878,1732915879,1732915879.800982,-21600,,
com.microsoft.VSCode,6,1732915872,1732915878,1732915878.717149,-21600,,
us.zoom.xos,2,1732915870,1732915872,1732915872.456057,-21600,,
com.microsoft.VSCode,15,1732915855,1732915870,1732915870.980465,-21600,,
com.apple.weather,7,1732915741,1732915748,1732915748.784271,-21600,EB445137-D7F5-57EC-87DA-1DB460D64046,"iPhone13,2"
us.zoom.xos,313,1732915542,1732915855,1732915855.369749,-21600,,
com.google.Chrome,3,1732915539,1732915542,1732915542.9292831,-21600,,
us.zoom.xos,25,1732915514,1732915539,1732915539.9716702,-21600,,
com.google.Chrome,77,1732915437,1732915514,1732915514.467591,-21600,,
us.zoom.xos,14,1732915423,1732915437,1732915437.059873,-21600,,
com.google.Chrome,7,1732915416,1732915423,1732915423.3864,-21600,,
com.apple.weather,2,1732915144,1732915146,1732915146.641696,-21600,EB445137-D7F5-57EC-87DA-1DB460D64046,"iPhone13,2"
us.zoom.xos,539,1732914877,1732915416,1732915416.8869638,-21600,,
com.google.Chrome,6,1732914871,1732914877,1732914877.522378,-21600,,
us.zoom.xos,2,1732914869,1732914871,1732914871.882931,-21600,,
com.google.Chrome,5,1732914864,1732914869,1732914869.187644,-21600,,
us.zoom.xos,0,1732914864,1732914864,1732914864.7078772,-21600,,
com.google.Chrome,7,1732914857,1732914864,1732914864.066957,-21600,,
us.zoom.xos,31,1732914826,1732914857,1732914857.3359509,-21600,,
com.google.Chrome,8,1732914818,1732914826,1732914826.232574,-21600,,
us.zoom.xos,227,1732914591,1732914818,1732914818.889766,-21600,,
com.google.Chrome,8,1732914583,1732914591,1732914591.879929,-21600,,
us.zoom.xos,19,1732914564,1732914583,1732914583.3852038,-21600,,
com.google.Chrome,1,1732914563,1732914564,1732914564.257518,-21600,,
us.zoom.xos,7,1732914556,1732914563,1732914563.652314,-21600,,
com.google.Chrome,17,1732914539,1732914556,1732914556.6678061,-21600,,
us.zoom.xos,0,1732914539,1732914539,1732914539.562142,-21600,,
com.google.Chrome,7,1732914532,1732914539,1732914539.241846,-21600,,
us.zoom.xos,2,1732914530,1732914532,1732914532.285969,-21600,,
com.google.Chrome,5,1732914525,1732914530,1732914530.1110868,-21600,,
us.zoom.xos,1,1732914524,1732914525,1732914525.43259,-21600,,
com.google.Chrome,1,1732914523,1732914524,1732914524.569355,-21600,,
us.zoom.xos,3,1732914520,1732914523,1732914523.7504911,-21600,,
com.google.Chrome,8,1732914512,1732914520,1732914520.1759,-21600,,
us.zoom.xos,254,1732914258,1732914512,1732914512.1762009,-21600,,
com.google.Chrome,5,1732914253,1732914258,1732914258.773858,-21600,,
us.zoom.xos,3,1732914250,1732914253,1732914253.7538419,-21600,,
com.google.Chrome,15,1732914235,1732914250,1732914250.654206,-21600,,
com.apple.weather,49,1732914172,1732914221,1732914221.713035,-21600,EB445137-D7F5-57EC-87DA-1DB460D64046,"iPhone13,2"
us.zoom.xos,80,1732914155,1732914235,1732914235.396377,-21600,,
com.google.Chrome,26,1732914129,1732914155,1732914155.842064,-21600,,
com.apple.MobileSMS,83,1732914084,1732914167,1732914167.7699208,-21600,EB445137-D7F5-57EC-87DA-1DB460D64046,"iPhone13,2"
com.hammerandchisel.discord,5,1732914079,1732914084,1732914084.472513,-21600,EB445137-D7F5-57EC-87DA-1DB460D64046,"iPhone13,2"
us.zoom.xos,69,1732914060,1732914129,1732914129.827569,-21600,,
com.google.Chrome,5,1732914055,1732914060,1732914060.266432,-21600,,
us.zoom.xos,3,1732914052,1732914055,1732914055.314797,-21600,,
com.google.Chrome,3,1732914049,1732914052,1732914052.54494,-21600,,
us.zoom.xos,37,1732914012,1732914049,1732914049.139647,-21600,,
com.google.Chrome,3,1732914009,1732914012,1732914012.4603782,-21600,,
us.zoom.xos,69,1732913940,1732914009,1732914009.48033,-21600,,
com.google.Chrome,1,1732913939,1732913940,1732913940.894699,-21600,,
com.truebill.truebillnative,106,1732913873,1732913979,1732913979.748457,-21600,EB445137-D7F5-57EC-87DA-1DB460D64046,"iPhone13,2"
com.truebill.truebillnative,6,1732913865,1732913871,1732913871.174172,-21600,EB445137-D7F5-57EC-87DA-1DB460D64046,"iPhone13,2"
com.truebill.truebillnative,2,1732913862,1732913864,1732913864.461845,-21600,EB445137-D7F5-57EC-87DA-1DB460D64046,"iPhone13,2"
com.microsoft.Office.Outlook,4,1732913849,1732913853,1732913853.423162,-21600,EB445137-D7F5-57EC-87DA-1DB460D64046,"iPhone13,2"
us.zoom.xos,97,1732913842,1732913939,1732913939.125668,-21600,,
com.google.Chrome,3,1732913839,1732913842,1732913842.099015,-21600,,
us.zoom.xos,13,1732913826,1732913839,1732913839.34428,-21600,,
com.microsoft.Office.Outlook,21,1732913804,1732913825,1732913825.871817,-21600,EB445137-D7F5-57EC-87DA-1DB460D64046,"iPhone13,2"
com.google.ios.youtube,8,1732913792,1732913800,1732913800.357573,-21600,EB445137-D7F5-57EC-87DA-1DB460D64046,"iPhone13,2"
com.google.ios.youtube,19,1732913772,1732913791,1732913791.616991,-21600,EB445137-D7F5-57EC-87DA-1DB460D64046,"iPhone13,2"
com.google.Chrome,234,1732913592,1732913826,1732913826.888952,-21600,,
com.google.Chrome,300,1732913024,1732913324,1732913324.714604,-21600,,
com.google.Chrome,300,1732912721,1732913021,1732913021.8102589,-21600,,
com.google.Chrome,300,1732912418,1732912718,1732912718.807188,-21600,,
com.google.Chrome,300,1732912116,1732912416,1732912416.871554,-21600,,
com.google.ios.youtube,1711,1732911880,1732913591,1732913591.63137,-21600,EB445137-D7F5-57EC-87DA-1DB460D64046,"iPhone13,2"
com.hammerandchisel.discord,15,1732911863,1732911878,1732911878.205234,-21600,EB445137-D7F5-57EC-87DA-1DB460D64046,"iPhone13,2"
com.toyopagroup.picaboo,41,1732911820,1732911861,1732911861.761065,-21600,EB445137-D7F5-57EC-87DA-1DB460D64046,"iPhone13,2"
com.google.Chrome,300,1732911814,1732912114,1732912114.476352,-21600,,
com.leomehlig.today,14,1732911800,1732911814,1732911814.494504,-21600,,
com.google.Chrome,1124,1732910676,1732911800,1732911800.51197,-21600,,
com.toyopagroup.picaboo,15,1732910477,1732910492,1732910492.5985851,-21600,EB445137-D7F5-57EC-87DA-1DB460D64046,"iPhone13,2"
com.google.ios.youtube,3779,1732906692,1732910471,1732910471.665707,-21600,EB445137-D7F5-57EC-87DA-1DB460D64046,"iPhone13,2"
com.google.Chrome,50,1732906631,1732906681,1732906681.792653,-21600,,
us.zoom.xos,4,1732906627,1732906631,1732906631.763507,-21600,,
com.google.Chrome,4,1732906623,1732906627,1732906627.910223,-21600,,
us.zoom.xos,2,1732906621,1732906623,1732906623.874399,-21600,,
com.microsoft.Outlook,4,1732906617,1732906621,1732906621.6928082,-21600,,
us.zoom.xos,5,1732906612,1732906617,1732906617.479224,-21600,,
com.microsoft.Outlook,0,1732906612,1732906612,1732906612.820642,-21600,,
us.zoom.xos,65,1732906547,1732906612,1732906612.108639,-21600,,
com.google.Chrome,36,1732906511,1732906547,1732906547.349903,-21600,,
com.leomehlig.today,62,1732906449,1732906511,1732906512.0278912,-21600,,
com.google.Chrome,430,1732906019,1732906449,1732906449.1559,-21600,,
com.google.ios.youtube,665,1732905333,1732905998,1732905998.6778002,-21600,EB445137-D7F5-57EC-87DA-1DB460D64046,"iPhone13,2"
com.apple.weather,13,1732905314,1732905327,1732905327.659493,-21600,EB445137-D7F5-57EC-87DA-1DB460D64046,"iPhone13,2"
com.google.Chrome,931,1732904644,1732905575,1732905575.733525,-21600,,
com.google.Chrome,731,1732903901,1732904632,1732904632.5377479,-21600,,
com.google.Chrome,508,1732903376,1732903884,1732903884.180264,-21600,,
com.google.Gmail,18,1732901743,1732901761,1732901761.1637468,-21600,EB445137-D7F5-57EC-87DA-1DB460D64046,"iPhone13,2"
com.google.Gmail,25,1732901711,1732901736,1732901736.430145,-21600,EB445137-D7F5-57EC-87DA-1DB460D64046,"iPhone13,2"
com.apple.Health,94,1732901611,1732901705,1732901705.95171,-21600,EB445137-D7F5-57EC-87DA-1DB460D64046,"iPhone13,2"
com.apple.Health,7,1732901599,1732901606,1732901606.8779979,-21600,EB445137-D7F5-57EC-87DA-1DB460D64046,"iPhone13,2"
com.google.Chrome,323,1732901500,1732901823,1732901823.73177,-21600,,
com.leomehlig.today,13,1732901487,1732901500,1732901501.008621,-21600,,
com.google.Chrome,646,1732900841,1732901487,1732901487.790031,-21600,,
com.apple.finder,6,1732900835,1732900841,1732900841.733584,-21600,,
com.google.Chrome,2,1732900833,1732900835,1732900835.958601,-21600,,
com.leomehlig.today,25,1732900808,1732900833,1732900833.630059,-21600,,
com.apple.finder,25,1732900783,1732900808,1732900808.708112,-21600,,
com.google.Chrome,3,1732900780,1732900783,1732900783.8100471,-21600,,
com.google.Chrome,440,1732899953,1732900393,1732900393.932476,-21600,,
com.apple.iCal,1,1732899952,1732899953,1732899953.821717,-21600,,
com.apple.MobileSMS,88,1732899864,1732899952,1732899952.89507,-21600,,
com.apple.iCal,2,1732899862,1732899864,1732899865.005669,-21600,,
com.google.Chrome,122,1732899740,1732899862,1732899862.26913,-21600,,
com.apple.iCal,5,1732899735,1732899740,1732899740.0747628,-21600,,
com.leomehlig.today,1,1732899734,1732899735,1732899735.747154,-21600,,
com.apple.MobileSMS,130,1732899604,1732899734,1732899734.9301329,-21600,,
com.leomehlig.today,44,1732899560,1732899604,1732899604.430325,-21600,,
com.apple.MobileSMS,1,1732899559,1732899560,1732899560.500599,-21600,,
com.leomehlig.today,18,1732899541,1732899559,1732899559.498524,-21600,,
com.apple.MobileSMS,2,1732899539,1732899541,1732899541.4159431,-21600,,
com.apple.iCal,1,1732899538,1732899539,1732899539.8212771,-21600,,
com.leomehlig.today,5,1732899533,1732899538,1732899538.72784,-21600,,
com.apple.iCal,1,1732899532,1732899533,1732899533.116894,-21600,,
com.apple.MobileSMS,0,1732899532,1732899532,1732899532.698772,-21600,,
com.apple.iCal,1,1732899531,1732899532,1732899532.1765409,-21600,,
com.apple.MobileSMS,1,1732899530,1732899531,1732899531.4396338,-21600,,
com.apple.iCal,3,1732899527,1732899530,1732899530.3826098,-21600,,
com.apple.MobileSMS,12,1732899515,1732899527,1732899527.535571,-21600,,
com.apple.iCal,39,1732899476,1732899515,1732899515.961132,-21600,,
com.google.Chrome,407,1732899069,1732899476,1732899476.9820452,-21600,,
com.leomehlig.today,4,1732899051,1732899055,1732899055.047861,-21600,,
com.google.Chrome,19,1732899032,1732899051,1732899051.965589,-21600,,
com.apple.findmy,6,1732898992,1732898998,1732898999.2949061,-21600,EB445137-D7F5-57EC-87DA-1DB460D64046,"iPhone13,2"
com.apple.Health,4,1732898987,1732898991,1732898992.008428,-21600,EB445137-D7F5-57EC-87DA-1DB460D64046,"iPhone13,2"
com.apple.Health,58,1732898407,1732898465,1732898465.914762,-21600,EB445137-D7F5-57EC-87DA-1DB460D64046,"iPhone13,2"
com.renpho.health,77,1732898330,1732898407,1732898407.276562,-21600,EB445137-D7F5-57EC-87DA-1DB460D64046,"iPhone13,2"
com.google.chrome.ios,58,1732896759,1732896817,1732896817.971511,-21600,EB445137-D7F5-57EC-87DA-1DB460D64046,"iPhone13,2"
com.apple.weather,3,1732896756,1732896759,1732896759.5214992,-21600,EB445137-D7F5-57EC-87DA-1DB460D64046,"iPhone13,2"
com.apple.news,299,1732896457,1732896756,1732896757.3175,-21600,EB445137-D7F5-57EC-87DA-1DB460D64046,"iPhone13,2"
com.apple.Music,5,1732896413,1732896418,1732896418.7167969,-21600,EB445137-D7F5-57EC-87DA-1DB460D64046,"iPhone13,2"
com.apple.weather,6,1732896407,1732896413,1732896413.624207,-21600,EB445137-D7F5-57EC-87DA-1DB460D64046,"iPhone13,2"
com.apple.Music,45,1732896348,1732896393,1732896393.4102159,-21600,EB445137-D7F5-57EC-87DA-1DB460D64046,"iPhone13,2"
com.google.chrome.ios,13,1732896335,1732896348,1732896348.239521,-21600,EB445137-D7F5-57EC-87DA-1DB460D64046,"iPhone13,2"
com.apple.Music,19,1732896316,1732896335,1732896335.169169,-21600,EB445137-D7F5-57EC-87DA-1DB460D64046,"iPhone13,2"
com.google.chrome.ios,164,1732896152,1732896316,1732896317.11935,-21600,EB445137-D7F5-57EC-87DA-1DB460D64046,"iPhone13,2"
com.apple.Music,21,1732896130,1732896151,1732896151.212215,-21600,EB445137-D7F5-57EC-87DA-1DB460D64046,"iPhone13,2"
com.google.ios.youtube,21,1732896106,1732896127,1732896127.564313,-21600,EB445137-D7F5-57EC-87DA-1DB460D64046,"iPhone13,2"
com.google.ios.youtube,15,1732896021,1732896036,1732896036.110623,-21600,EB445137-D7F5-57EC-87DA-1DB460D64046,"iPhone13,2"
com.google.ios.youtube,604,1732894694,1732895298,1732895298.8925428,-21600,EB445137-D7F5-57EC-87DA-1DB460D64046,"iPhone13,2"
com.apple.journal,2052,1732857842,1732859894,1732859894.6104121,-21600,EB445137-D7F5-57EC-87DA-1DB460D64046,"iPhone13,2"
com.toyopagroup.picaboo,6,1732857834,1732857840,1732857840.2408118,-21600,EB445137-D7F5-57EC-87DA-1DB460D64046,"iPhone13,2"
com.toyopagroup.picaboo,12,1732857787,1732857799,1732857799.528347,-21600,EB445137-D7F5-57EC-87DA-1DB460D64046,"iPhone13,2"
com.apple.camera,0,1732857781,1732857781,1732857781.823969,-21600,EB445137-D7F5-57EC-87DA-1DB460D64046,"iPhone13,2"
com.apple.camera,1,1732857771,1732857772,1732857772.3137279,-21600,EB445137-D7F5-57EC-87DA-1DB460D64046,"iPhone13,2"
com.apple.weather,21,1732857766,1732857787,1732857787.2803931,-21600,EB445137-D7F5-57EC-87DA-1DB460D64046,"iPhone13,2"
com.apple.weather,13,1732856670,1732856683,1732856683.37935,-21600,EB445137-D7F5-57EC-87DA-1DB460D64046,"iPhone13,2"
com.apple.weather,3,1732856534,1732856537,1732856537.642692,-21600,EB445137-D7F5-57EC-87DA-1DB460D64046,"iPhone13,2"
com.apple.camera,0,1732856479,1732856479,1732856479.8447452,-21600,EB445137-D7F5-57EC-87DA-1DB460D64046,"iPhone13,2"
com.hammerandchisel.discord,21,1732856013,1732856034,1732856034.934902,-21600,EB445137-D7F5-57EC-87DA-1DB460D64046,"iPhone13,2"
com.toyopagroup.picaboo,40,1732855331,1732855371,1732855371.328288,-21600,EB445137-D7F5-57EC-87DA-1DB460D64046,"iPhone13,2"
com.toyopagroup.picaboo,4,1732854670,1732854674,1732854674.5815759,-21600,EB445137-D7F5-57EC-87DA-1DB460D64046,"iPhone13,2"
com.toyopagroup.picaboo,51,1732854608,1732854659,1732854659.895195,-21600,EB445137-D7F5-57EC-87DA-1DB460D64046,"iPhone13,2"
com.apple.weather,31,1732853937,1732853968,1732853968.544112,-21600,EB445137-D7F5-57EC-87DA-1DB460D64046,"iPhone13,2"
com.microsoft.Office.Outlook,9,1732853914,1732853923,1732853923.936013,-21600,EB445137-D7F5-57EC-87DA-1DB460D64046,"iPhone13,2"
com.hammerandchisel.discord,7,1732852486,1732852493,1732852493.836735,-21600,EB445137-D7F5-57EC-87DA-1DB460D64046,"iPhone13,2"
com.google.ios.youtube,2,1732852484,1732852486,1732852487.053786,-21600,EB445137-D7F5-57EC-87DA-1DB460D64046,"iPhone13,2"
com.google.ios.youtube,14,1732851741,1732851755,1732851756.026228,-21600,EB445137-D7F5-57EC-87DA-1DB460D64046,"iPhone13,2"
com.google.Chrome,354,1732851448,1732851802,1732851802.5867882,-21600,,
com.leomehlig.today,2,1732851446,1732851448,1732851448.683459,-21600,,
com.google.ios.youtube,3,1732851321,1732851324,1732851324.0341659,-21600,EB445137-D7F5-57EC-87DA-1DB460D64046,"iPhone13,2"
com.google.ios.youtube,2,1732851308,1732851310,1732851310.2815418,-21600,EB445137-D7F5-57EC-87DA-1DB460D64046,"iPhone13,2"
com.google.ios.youtube,1276,1732850030,1732851306,1732851307.2222018,-21600,EB445137-D7F5-57EC-87DA-1DB460D64046,"iPhone13,2"
com.apple.news,121,1732849901,1732850022,1732850022.984703,-21600,EB445137-D7F5-57EC-87DA-1DB460D64046,"iPhone13,2"
com.apple.news,97,1732849800,1732849897,1732849897.717527,-21600,EB445137-D7F5-57EC-87DA-1DB460D64046,"iPhone13,2"
com.google.chrome.ios,105,1732849680,1732849785,1732849785.9440231,-21600,EB445137-D7F5-57EC-87DA-1DB460D64046,"iPhone13,2"
com.leomehlig.today,8,1732849507,1732849515,1732849515.989183,-21600,,
com.apple.finder,15,1732849492,1732849507,1732849507.277184,-21600,,
com.leomehlig.today,3,1732849489,1732849492,1732849492.622429,-21600,,
com.google.Chrome,718,1732848771,1732849489,1732849489.468216,-21600,,
com.google.Chrome,408,1732848304,1732848712,1732848712.338932,-21600,,
com.google.Chrome,1138,1732846891,1732848029,1732848029.2296429,-21600,,
com.google.Chrome,304,1732846277,1732846581,1732846581.07442,-21600,,
com.apple.findmy,8,1732845662,1732845670,1732845671.014439,-21600,EB445137-D7F5-57EC-87DA-1DB460D64046,"iPhone13,2"
com.google.Chrome,1380,1732844881,1732846261,1732846261.355391,-21600,,
com.google.Chrome,304,1732844184,1732844488,1732844488.4281049,-21600,,
com.google.Chrome,300,1732843877,1732844177,1732844177.407305,-21600,,
com.google.Chrome,310,1732843481,1732843791,1732843791.7261338,-21600,,
com.google.Chrome,1046,1732842144,1732843190,1732843190.1926,-21600,,
com.apple.news,231,1732841822,1732842053,1732842053.4390678,-21600,EB445137-D7F5-57EC-87DA-1DB460D64046,"iPhone13,2"
com.leomehlig.today,8,1732841797,1732841805,1732841805.2760339,-21600,EB445137-D7F5-57EC-87DA-1DB460D64046,"iPhone13,2"
com.apple.news,9,1732841779,1732841788,1732841788.925099,-21600,EB445137-D7F5-57EC-87DA-1DB460D64046,"iPhone13,2"
com.google.Chrome,301,1732841769,1732842070,1732842070.6991792,-21600,,
com.apple.news,129,1732841640,1732841769,1732841769.072688,-21600,,
com.google.Chrome,11,1732841629,1732841640,1732841640.795356,-21600,,
com.leomehlig.today,99,1732841530,1732841629,1732841629.493182,-21600,,
com.apple.MobileSMS,13,1732841517,1732841530,1732841530.682499,-21600,,
com.google.Chrome,67,1732841450,1732841517,1732841517.780219,-21600,,
com.apple.news,13,1732841436,1732841449,1732841449.816136,-21600,EB445137-D7F5-57EC-87DA-1DB460D64046,"iPhone13,2"
com.apple.news,18,1732840115,1732840133,1732840133.5505729,-21600,EB445137-D7F5-57EC-87DA-1DB460D64046,"iPhone13,2"
com.apple.news,81,1732839630,1732839711,1732839711.878648,-21600,EB445137-D7F5-57EC-87DA-1DB460D64046,"iPhone13,2"
com.google.chrome.ios,26,1732839459,1732839485,1732839485.993027,-21600,EB445137-D7F5-57EC-87DA-1DB460D64046,"iPhone13,2"
com.robtop.geometryjump,5,1732836938,1732836943,1732836943.306001,-21600,EB445137-D7F5-57EC-87DA-1DB460D64046,"iPhone13,2"
com.robtop.geometryjump,30,1732836695,1732836725,1732836726.169746,-21600,EB445137-D7F5-57EC-87DA-1DB460D64046,"iPhone13,2"
com.robtop.geometryjump,10,1732836678,1732836688,1732836688.9953752,-21600,EB445137-D7F5-57EC-87DA-1DB460D64046,"iPhone13,2"
com.robtop.geometryjump,82,1732836595,1732836677,1732836677.644466,-21600,EB445137-D7F5-57EC-87DA-1DB460D64046,"iPhone13,2"
com.microsoft.Office.Outlook,11,1732826757,1732826768,1732826768.5084,-21600,EB445137-D7F5-57EC-87DA-1DB460D64046,"iPhone13,2"
com.hammerandchisel.discord,11,1732826735,1732826746,1732826746.242083,-21600,EB445137-D7F5-57EC-87DA-1DB460D64046,"iPhone13,2"
com.apple.mobilephone,4,1732826731,1732826735,1732826735.755441,-21600,EB445137-D7F5-57EC-87DA-1DB460D64046,"iPhone13,2"
com.apple.mobilephone,12,1732825587,1732825599,1732825599.675775,-21600,EB445137-D7F5-57EC-87DA-1DB460D64046,"iPhone13,2"
com.apple.mobilephone,6,1732825549,1732825555,1732825555.566846,-21600,EB445137-D7F5-57EC-87DA-1DB460D64046,"iPhone13,2"
com.apple.InCallService,66,1732825483,1732825549,1732825549.308515,-21600,EB445137-D7F5-57EC-87DA-1DB460D64046,"iPhone13,2"
com.apple.mobilephone,3,1732825480,1732825483,1732825484.210413,-21600,EB445137-D7F5-57EC-87DA-1DB460D64046,"iPhone13,2"
com.apple.MobileSMS,2,1732825478,1732825480,1732825480.187048,-21600,EB445137-D7F5-57EC-87DA-1DB460D64046,"iPhone13,2"
com.google.Chrome,1328,1732822014,1732823342,1732823342.8254051,-21600,,
com.leomehlig.today,62,1732821952,1732822014,1732822014.623859,-21600,,
com.google.Chrome,48,1732821904,1732821952,1732821952.6619148,-21600,,
com.leomehlig.today,99,1732821787,1732821886,1732821886.376987,-21600,,
com.apple.iCal,12,1732821775,1732821787,1732821787.314009,-21600,,
com.leomehlig.today,39,1732821736,1732821775,1732821775.404059,-21600,,
com.google.Chrome,2,1732821734,1732821736,1732821736.851766,-21600,,
com.apple.mobilecal,27,1732821365,1732821392,1732821392.797169,-21600,EB445137-D7F5-57EC-87DA-1DB460D64046,"iPhone13,2"
com.google.Chrome,2125,1732819374,1732821499,1732821499.999148,-21600,,
com.google.Chrome,301,1732819055,1732819356,1732819356.762681,-21600,,
com.apple.MobileSMS,67,1732818988,1732819055,1732819055.906443,-21600,,
com.google.Chrome,820,1732818168,1732818988,1732818988.472714,-21600,,
com.google.Chrome,581,1732817009,1732817590,1732817590.256164,-21600,,
com.google.Chrome,1217,1732815740,1732816957,1732816957.90521,-21600,,
com.google.Chrome,330,1732815020,1732815350,1732815350.47296,-21600,,
com.apple.MobileSMS,2,1732814436,1732814438,1732814438.6426911,-21600,EB445137-D7F5-57EC-87DA-1DB460D64046,"iPhone13,2"
com.google.Chrome,303,1732814328,1732814631,1732814631.934722,-21600,,
com.google.Chrome,3360,1732810641,1732814001,1732814001.194663,-21600,,
com.apple.news,59,1732810475,1732810534,1732810535.073604,-21600,EB445137-D7F5-57EC-87DA-1DB460D64046,"iPhone13,2"
com.apple.camera,1,1732810462,1732810463,1732810463.49528,-21600,EB445137-D7F5-57EC-87DA-1DB460D64046,"iPhone13,2"
com.apple.MobileSMS,3,1732810282,1732810285,1732810285.2356591,-21600,EB445137-D7F5-57EC-87DA-1DB460D64046,"iPhone13,2"
com.apple.MobileSMS,16,1732809766,1732809782,1732809782.304127,-21600,EB445137-D7F5-57EC-87DA-1DB460D64046,"iPhone13,2"
com.renpho.health,16,1732809225,1732809241,1732809241.030458,-21600,EB445137-D7F5-57EC-87DA-1DB460D64046,"iPhone13,2"
com.apple.MobileSMS,4,1732809220,1732809224,1732809224.081173,-21600,EB445137-D7F5-57EC-87DA-1DB460D64046,"iPhone13,2"
com.apple.MobileSMS,7,1732808172,1732808179,1732808180.0395331,-21600,EB445137-D7F5-57EC-87DA-1DB460D64046,"iPhone13,2"
com.apple.MobileSMS,7,1732808158,1732808165,1732808165.759355,-21600,EB445137-D7F5-57EC-87DA-1DB460D64046,"iPhone13,2"
com.apple.MobileSMS,6,1732807872,1732807878,1732807878.959618,-21600,EB445137-D7F5-57EC-87DA-1DB460D64046,"iPhone13,2"
com.apple.MobileSMS,6,1732807748,1732807754,1732807754.340837,-21600,EB445137-D7F5-57EC-87DA-1DB460D64046,"iPhone13,2"
com.apple.MobileSMS,6,1732807586,1732807592,1732807592.468581,-21600,EB445137-D7F5-57EC-87DA-1DB460D64046,"iPhone13,2"
com.apple.MobileSMS,19,1732807434,1732807453,1732807453.516343,-21600,EB445137-D7F5-57EC-87DA-1DB460D64046,"iPhone13,2"
com.apple.MobileSMS,69,1732807197,1732807266,1732807266.909278,-21600,EB445137-D7F5-57EC-87DA-1DB460D64046,"iPhone13,2"
com.apple.Music,10,1732778149,1732778159,1732778159.678549,-21600,EB445137-D7F5-57EC-87DA-1DB460D64046,"iPhone13,2"
com.google.chrome.ios,212,1732777937,1732778149,1732778149.631727,-21600,EB445137-D7F5-57EC-87DA-1DB460D64046,"iPhone13,2"
com.apple.Music,22,1732777915,1732777937,1732777937.436904,-21600,EB445137-D7F5-57EC-87DA-1DB460D64046,"iPhone13,2"
com.google.chrome.ios,27,1732777888,1732777915,1732777916.027951,-21600,EB445137-D7F5-57EC-87DA-1DB460D64046,"iPhone13,2"
com.apple.Music,52,1732777836,1732777888,1732777888.748486,-21600,EB445137-D7F5-57EC-87DA-1DB460D64046,"iPhone13,2"
com.apple.Music,28,1732777530,1732777558,1732777558.2691,-21600,EB445137-D7F5-57EC-87DA-1DB460D64046,"iPhone13,2"
com.apple.Music,58,1732777418,1732777476,1732777476.677271,-21600,EB445137-D7F5-57EC-87DA-1DB460D64046,"iPhone13,2"
com.apple.Music,58,1732777287,1732777345,1732777346.0382729,-21600,EB445137-D7F5-57EC-87DA-1DB460D64046,"iPhone13,2"
com.apple.Music,107,1732777014,1732777121,1732777121.8881068,-21600,EB445137-D7F5-57EC-87DA-1DB460D64046,"iPhone13,2"
com.apple.findmy,9,1732777005,1732777014,1732777014.782946,-21600,EB445137-D7F5-57EC-87DA-1DB460D64046,"iPhone13,2"
com.apple.Music,32,1732776967,1732776999,1732776999.9829159,-21600,EB445137-D7F5-57EC-87DA-1DB460D64046,"iPhone13,2"
com.google.chrome.ios,11,1732776956,1732776967,1732776967.3429298,-21600,EB445137-D7F5-57EC-87DA-1DB460D64046,"iPhone13,2"
com.apple.Music,12,1732776944,1732776956,1732776957.07318,-21600,EB445137-D7F5-57EC-87DA-1DB460D64046,"iPhone13,2"
com.google.chrome.ios,27,1732776917,1732776944,1732776944.702903,-21600,EB445137-D7F5-57EC-87DA-1DB460D64046,"iPhone13,2"
com.apple.Music,66,1732776851,1732776917,1732776917.169777,-21600,EB445137-D7F5-57EC-87DA-1DB460D64046,"iPhone13,2"
com.apple.Music,36,1732776612,1732776648,1732776649.131829,-21600,EB445137-D7F5-57EC-87DA-1DB460D64046,"iPhone13,2"
com.apple.Music,28,1732776394,1732776422,1732776422.451239,-21600,EB445137-D7F5-57EC-87DA-1DB460D64046,"iPhone13,2"
com.apple.PosterBoard,5,1732776261,1732776266,1732776266.777419,-21600,EB445137-D7F5-57EC-87DA-1DB460D64046,"iPhone13,2"
com.apple.MobileSMS,16,1732776256,1732776272,1732776272.233938,-21600,EB445137-D7F5-57EC-87DA-1DB460D64046,"iPhone13,2"
com.google.Chrome,650,1732775598,1732776248,1732776248.6443028,-21600,,
com.google.Chrome,303,1732774949,1732775252,1732775252.116761,-21600,,
com.google.Chrome,449,1732774260,1732774709,1732774709.7220268,-21600,,
com.apple.MobileSMS,70,1732774193,1732774263,1732774263.870254,-21600,EB445137-D7F5-57EC-87DA-1DB460D64046,"iPhone13,2"
com.apple.mobiletimer,3,1732774188,1732774191,1732774191.1616979,-21600,EB445137-D7F5-57EC-87DA-1DB460D64046,"iPhone13,2"
com.apple.mobiletimer,2,1732773371,1732773373,1732773373.529769,-21600,EB445137-D7F5-57EC-87DA-1DB460D64046,"iPhone13,2"
com.apple.mobiletimer,7,1732773361,1732773368,1732773369.214272,-21600,EB445137-D7F5-57EC-87DA-1DB460D64046,"iPhone13,2"
com.apple.mobiletimer,1,1732773359,1732773360,1732773360.816225,-21600,EB445137-D7F5-57EC-87DA-1DB460D64046,"iPhone13,2"
com.apple.calculator,9,1732773350,1732773359,1732773360.358597,-21600,EB445137-D7F5-57EC-87DA-1DB460D64046,"iPhone13,2"
com.apple.calculator,10,1732773313,1732773323,1732773323.626616,-21600,EB445137-D7F5-57EC-87DA-1DB460D64046,"iPhone13,2"
com.apple.calculator,17,1732773131,1732773148,1732773148.926817,-21600,EB445137-D7F5-57EC-87DA-1DB460D64046,"iPhone13,2"
com.apple.calculator,4,1732772675,1732772679,1732772679.51659,-21600,EB445137-D7F5-57EC-87DA-1DB460D64046,"iPhone13,2"
com.apple.calculator,8,1732772667,1732772675,1732772675.494766,-21600,EB445137-D7F5-57EC-87DA-1DB460D64046,"iPhone13,2"
com.apple.calculator,232,1732772341,1732772573,1732772573.926882,-21600,EB445137-D7F5-57EC-87DA-1DB460D64046,"iPhone13,2"
com.google.Sheets,49,1732772292,1732772341,1732772341.812903,-21600,EB445137-D7F5-57EC-87DA-1DB460D64046,"iPhone13,2"
com.apple.Health,2,1732772283,1732772285,1732772286.202159,-21600,EB445137-D7F5-57EC-87DA-1DB460D64046,"iPhone13,2"
com.apple.Health,33,1732771478,1732771511,1732771511.625335,-21600,EB445137-D7F5-57EC-87DA-1DB460D64046,"iPhone13,2"
com.apple.Music,2,1732771475,1732771477,1732771477.306803,-21600,EB445137-D7F5-57EC-87DA-1DB460D64046,"iPhone13,2"
com.apple.Music,3,1732771464,1732771467,1732771467.666946,-21600,EB445137-D7F5-57EC-87DA-1DB460D64046,"iPhone13,2"
com.apple.Music,10,1732771447,1732771457,1732771457.529793,-21600,EB445137-D7F5-57EC-87DA-1DB460D64046,"iPhone13,2"
com.apple.Music,17,1732771300,1732771317,1732771317.5646849,-21600,EB445137-D7F5-57EC-87DA-1DB460D64046,"iPhone13,2"
com.apple.Music,12,1732770992,1732771004,1732771004.37777,-21600,EB445137-D7F5-57EC-87DA-1DB460D64046,"iPhone13,2"
com.apple.camera,0,1732770974,1732770974,1732770974.307756,-21600,EB445137-D7F5-57EC-87DA-1DB460D64046,"iPhone13,2"
com.apple.Music,20,1732770971,1732770991,1732770991.406635,-21600,EB445137-D7F5-57EC-87DA-1DB460D64046,"iPhone13,2"
com.apple.Music,2,1732770696,1732770698,1732770698.2584128,-21600,EB445137-D7F5-57EC-87DA-1DB460D64046,"iPhone13,2"
com.apple.Music,10,1732770544,1732770554,1732770554.934176,-21600,EB445137-D7F5-57EC-87DA-1DB460D64046,"iPhone13,2"
com.apple.Music,4,1732770467,1732770471,1732770471.906177,-21600,EB445137-D7F5-57EC-87DA-1DB460D64046,"iPhone13,2"
com.apple.Music,14,1732770408,1732770422,1732770422.747922,-21600,EB445137-D7F5-57EC-87DA-1DB460D64046,"iPhone13,2"
com.apple.Music,30,1732770299,1732770329,1732770329.5993161,-21600,EB445137-D7F5-57EC-87DA-1DB460D64046,"iPhone13,2"
com.apple.Music,39,1732770081,1732770120,1732770120.74268,-21600,EB445137-D7F5-57EC-87DA-1DB460D64046,"iPhone13,2"
com.apple.camera,0,1732769847,1732769847,1732769847.707541,-21600,EB445137-D7F5-57EC-87DA-1DB460D64046,"iPhone13,2"
com.apple.Music,11,1732769846,1732769857,1732769857.9636478,-21600,EB445137-D7F5-57EC-87DA-1DB460D64046,"iPhone13,2"
com.apple.Music,9,1732769810,1732769819,1732769819.815829,-21600,EB445137-D7F5-57EC-87DA-1DB460D64046,"iPhone13,2"
com.clairmail.fth.client,4,1732769806,1732769810,1732769810.925673,-21600,EB445137-D7F5-57EC-87DA-1DB460D64046,"iPhone13,2"
com.clairmail.fth.client,51,1732769479,1732769530,1732769530.743569,-21600,EB445137-D7F5-57EC-87DA-1DB460D64046,"iPhone13,2"
com.apple.Music,14,1732769460,1732769474,1732769474.594468,-21600,EB445137-D7F5-57EC-87DA-1DB460D64046,"iPhone13,2"
com.apple.Music,36,1732769403,1732769439,1732769439.231161,-21600,EB445137-D7F5-57EC-87DA-1DB460D64046,"iPhone13,2"
com.apple.Music,22,1732769380,1732769402,1732769402.188025,-21600,EB445137-D7F5-57EC-87DA-1DB460D64046,"iPhone13,2"
com.apple.Music,18,1732769360,1732769378,1732769378.8165832,-21600,EB445137-D7F5-57EC-87DA-1DB460D64046,"iPhone13,2"
com.apple.camera,1,1732769320,1732769321,1732769321.252785,-21600,EB445137-D7F5-57EC-87DA-1DB460D64046,"iPhone13,2"
com.apple.camera,2,1732769315,1732769317,1732769317.408011,-21600,EB445137-D7F5-57EC-87DA-1DB460D64046,"iPhone13,2"
com.apple.camera,1,1732769312,1732769313,1732769313.287499,-21600,EB445137-D7F5-57EC-87DA-1DB460D64046,"iPhone13,2"
com.apple.Music,21,1732769310,1732769331,1732769331.5272222,-21600,EB445137-D7F5-57EC-87DA-1DB460D64046,"iPhone13,2"
com.apple.Music,1,1732769095,1732769096,1732769096.920088,-21600,EB445137-D7F5-57EC-87DA-1DB460D64046,"iPhone13,2"
com.apple.Music,2,1732769088,1732769090,1732769090.428813,-21600,EB445137-D7F5-57EC-87DA-1DB460D64046,"iPhone13,2"
com.apple.Music,85,1732769003,1732769088,1732769088.695564,-21600,EB445137-D7F5-57EC-87DA-1DB460D64046,"iPhone13,2"
com.apple.MobileSMS,6,1732768790,1732768796,1732768796.368788,-21600,EB445137-D7F5-57EC-87DA-1DB460D64046,"iPhone13,2"
com.apple.MobileSMS,7,1732768563,1732768570,1732768570.4833121,-21600,EB445137-D7F5-57EC-87DA-1DB460D64046,"iPhone13,2"
com.apple.MobileSMS,16,1732762211,1732762227,1732762227.390321,-21600,EB445137-D7F5-57EC-87DA-1DB460D64046,"iPhone13,2"
com.apple.news,3,1732762208,1732762211,1732762212.4214401,-21600,EB445137-D7F5-57EC-87DA-1DB460D64046,"iPhone13,2"
com.apple.news,3,1732762196,1732762199,1732762199.672851,-21600,EB445137-D7F5-57EC-87DA-1DB460D64046,"iPhone13,2"
com.apple.news,1,1732761987,1732761988,1732761988.1494942,-21600,EB445137-D7F5-57EC-87DA-1DB460D64046,"iPhone13,2"
com.apple.news,3,1732761949,1732761952,1732761952.366568,-21600,EB445137-D7F5-57EC-87DA-1DB460D64046,"iPhone13,2"
com.google.Chrome,219,1732761942,1732762161,1732762161.363466,-21600,,
com.apple.MobileSMS,33,1732761909,1732761942,1732761942.524221,-21600,,
com.google.Chrome,309,1732761600,1732761909,1732761909.69128,-21600,,
com.microsoft.VSCode,14,1732761586,1732761600,1732761600.282057,-21600,,
com.google.Chrome,1,1732761585,1732761586,1732761586.436805,-21600,,
com.microsoft.VSCode,13,1732761572,1732761585,1732761585.272965,-21600,,
com.apple.news,35,1732761410,1732761445,1732761446.26912,-21600,EB445137-D7F5-57EC-87DA-1DB460D64046,"iPhone13,2"
com.google.Chrome,184,1732761388,1732761572,1732761572.457581,-21600,,
com.google.Chrome,599,1732760656,1732761255,1732761255.5084639,-21600,,
com.leomehlig.today,6,1732760650,1732760656,1732760657.8611078,-21600,,
com.apple.news,204,1732760299,1732760503,1732760503.973218,-21600,EB445137-D7F5-57EC-87DA-1DB460D64046,"iPhone13,2"
com.apple.MobileSMS,53,1732760240,1732760293,1732760293.222427,-21600,EB445137-D7F5-57EC-87DA-1DB460D64046,"iPhone13,2"
com.apple.camera,1,1732759027,1732759028,1732759028.1231751,-21600,EB445137-D7F5-57EC-87DA-1DB460D64046,"iPhone13,2"
com.apple.MobileSMS,7,1732758988,1732758995,1732758995.384439,-21600,EB445137-D7F5-57EC-87DA-1DB460D64046,"iPhone13,2"
com.apple.findmy,7,1732758816,1732758823,1732758823.5624352,-21600,EB445137-D7F5-57EC-87DA-1DB460D64046,"iPhone13,2"
com.apple.Music,2,1732758814,1732758816,1732758816.854985,-21600,EB445137-D7F5-57EC-87DA-1DB460D64046,"iPhone13,2"
com.apple.Music,2,1732758808,1732758810,1732758810.062458,-21600,EB445137-D7F5-57EC-87DA-1DB460D64046,"iPhone13,2"
com.apple.Music,0,1732758803,1732758803,1732758803.9926062,-21600,EB445137-D7F5-57EC-87DA-1DB460D64046,"iPhone13,2"
com.apple.Music,12,1732758779,1732758791,1732758792.539339,-21600,EB445137-D7F5-57EC-87DA-1DB460D64046,"iPhone13,2"
com.apple.MobileSMS,3,1732758771,1732758774,1732758774.7412171,-21600,EB445137-D7F5-57EC-87DA-1DB460D64046,"iPhone13,2"
com.apple.MobileSMS,2,1732758304,1732758306,1732758306.502439,-21600,EB445137-D7F5-57EC-87DA-1DB460D64046,"iPhone13,2"
com.apple.MobileSMS,2,1732758248,1732758250,1732758250.532041,-21600,EB445137-D7F5-57EC-87DA-1DB460D64046,"iPhone13,2"
com.apple.MobileSMS,6,1732757769,1732757775,1732757775.701185,-21600,EB445137-D7F5-57EC-87DA-1DB460D64046,"iPhone13,2"
com.apple.MobileSMS,3,1732757620,1732757623,1732757623.600595,-21600,EB445137-D7F5-57EC-87DA-1DB460D64046,"iPhone13,2"
com.apple.camera,0,1732757606,1732757606,1732757606.271675,-21600,EB445137-D7F5-57EC-87DA-1DB460D64046,"iPhone13,2"
com.apple.MobileSMS,4,1732757605,1732757609,1732757609.451477,-21600,EB445137-D7F5-57EC-87DA-1DB460D64046,"iPhone13,2"
com.apple.MobileSMS,2,1732757094,1732757096,1732757096.603061,-21600,EB445137-D7F5-57EC-87DA-1DB460D64046,"iPhone13,2"
com.apple.MobileSMS,4,1732756823,1732756827,1732756827.592904,-21600,EB445137-D7F5-57EC-87DA-1DB460D64046,"iPhone13,2"
com.apple.MobileSMS,85,1732756554,1732756639,1732756639.2255502,-21600,EB445137-D7F5-57EC-87DA-1DB460D64046,"iPhone13,2"
com.apple.MobileSMS,11,1732756450,1732756461,1732756461.5005322,-21600,EB445137-D7F5-57EC-87DA-1DB460D64046,"iPhone13,2"
com.apple.MobileSMS,5,1732756139,1732756144,1732756145.168607,-21600,EB445137-D7F5-57EC-87DA-1DB460D64046,"iPhone13,2"
com.apple.MobileSMS,9,1732755996,1732756005,1732756005.3261309,-21600,EB445137-D7F5-57EC-87DA-1DB460D64046,"iPhone13,2"
com.apple.MobileSMS,17,1732755979,1732755996,1732755996.896253,-21600,EB445137-D7F5-57EC-87DA-1DB460D64046,"iPhone13,2"
com.apple.MobileSMS,27,1732755831,1732755858,1732755859.685923,-21600,EB445137-D7F5-57EC-87DA-1DB460D64046,"iPhone13,2"
com.apple.findmy,39,1732755037,1732755076,1732755076.051192,-21600,EB445137-D7F5-57EC-87DA-1DB460D64046,"iPhone13,2"
com.apple.MobileSMS,22,1732755010,1732755032,1732755032.902031,-21600,EB445137-D7F5-57EC-87DA-1DB460D64046,"iPhone13,2"
com.apple.Maps,2,1732755008,1732755010,1732755010.9243731,-21600,EB445137-D7F5-57EC-87DA-1DB460D64046,"iPhone13,2"
com.apple.Maps,4,1732754890,1732754894,1732754894.526901,-21600,EB445137-D7F5-57EC-87DA-1DB460D64046,"iPhone13,2"
com.apple.Maps,7,1732754709,1732754716,1732754717.0138888,-21600,EB445137-D7F5-57EC-87DA-1DB460D64046,"iPhone13,2"
com.apple.Maps,6,1732754349,1732754355,1732754355.092238,-21600,EB445137-D7F5-57EC-87DA-1DB460D64046,"iPhone13,2"
com.apple.Maps,4,1732754085,1732754089,1732754089.349753,-21600,EB445137-D7F5-57EC-87DA-1DB460D64046,"iPhone13,2"
com.apple.Maps,6,1732753849,1732753855,1732753855.3041182,-21600,EB445137-D7F5-57EC-87DA-1DB460D64046,"iPhone13,2"
com.apple.Maps,3,1732753129,1732753132,1732753132.72755,-21600,EB445137-D7F5-57EC-87DA-1DB460D64046,"iPhone13,2"
com.apple.Maps,3,1732753008,1732753011,1732753011.1559548,-21600,EB445137-D7F5-57EC-87DA-1DB460D64046,"iPhone13,2"
com.apple.Maps,6,1732752998,1732753004,1732753004.889595,-21600,EB445137-D7F5-57EC-87DA-1DB460D64046,"iPhone13,2"
com.apple.Maps,26,1732752440,1732752466,1732752467.129518,-21600,EB445137-D7F5-57EC-87DA-1DB460D64046,"iPhone13,2"
com.apple.Maps,25,1732751475,1732751500,1732751500.534879,-21600,EB445137-D7F5-57EC-87DA-1DB460D64046,"iPhone13,2"
com.apple.MobileSMS,3,1732751469,1732751472,1732751472.767593,-21600,EB445137-D7F5-57EC-87DA-1DB460D64046,"iPhone13,2"
com.apple.MobileSMS,6,1732750822,1732750828,1732750828.591882,-21600,EB445137-D7F5-57EC-87DA-1DB460D64046,"iPhone13,2"
com.apple.MobileSMS,8,1732745634,1732745642,1732745642.687423,-21600,EB445137-D7F5-57EC-87DA-1DB460D64046,"iPhone13,2"
com.apple.MobileSMS,3,1732745368,1732745371,1732745371.276202,-21600,EB445137-D7F5-57EC-87DA-1DB460D64046,"iPhone13,2"
com.apple.MobileSMS,15,1732745352,1732745367,1732745367.215167,-21600,EB445137-D7F5-57EC-87DA-1DB460D64046,"iPhone13,2"
com.apple.MobileSMS,5,1732745086,1732745091,1732745091.2916188,-21600,EB445137-D7F5-57EC-87DA-1DB460D64046,"iPhone13,2"
com.apple.MobileSMS,4,1732744772,1732744776,1732744776.731879,-21600,EB445137-D7F5-57EC-87DA-1DB460D64046,"iPhone13,2"
com.toyopagroup.picaboo,24,1732744745,1732744769,1732744769.6990871,-21600,EB445137-D7F5-57EC-87DA-1DB460D64046,"iPhone13,2"
com.apple.camera,10,1732744672,1732744682,1732744682.7530599,-21600,EB445137-D7F5-57EC-87DA-1DB460D64046,"iPhone13,2"
com.instructure.icanvas,9,1732744573,1732744582,1732744582.467664,-21600,EB445137-D7F5-57EC-87DA-1DB460D64046,"iPhone13,2"
com.apple.MobileSMS,5,1732744556,1732744561,1732744561.9897351,-21600,EB445137-D7F5-57EC-87DA-1DB460D64046,"iPhone13,2"
com.apple.MobileSMS,4,1732744514,1732744518,1732744519.727518,-21600,EB445137-D7F5-57EC-87DA-1DB460D64046,"iPhone13,2"
com.leomehlig.today,11,1732744494,1732744505,1732744505.690538,-21600,EB445137-D7F5-57EC-87DA-1DB460D64046,"iPhone13,2"
com.apple.MobileSMS,37,1732744454,1732744491,1732744491.4018888,-21600,EB445137-D7F5-57EC-87DA-1DB460D64046,"iPhone13,2"
com.apple.findmy,7,1732744447,1732744454,1732744454.6174479,-21600,EB445137-D7F5-57EC-87DA-1DB460D64046,"iPhone13,2"
com.apple.MobileSMS,5,1732744442,1732744447,1732744447.667704,-21600,EB445137-D7F5-57EC-87DA-1DB460D64046,"iPhone13,2"
com.apple.MobileSMS,47,1732744362,1732744409,1732744409.870636,-21600,EB445137-D7F5-57EC-87DA-1DB460D64046,"iPhone13,2"
com.toyopagroup.picaboo,9,1732744236,1732744245,1732744245.566407,-21600,EB445137-D7F5-57EC-87DA-1DB460D64046,"iPhone13,2"
com.apple.Maps,48,1732744100,1732744148,1732744148.3287082,-21600,EB445137-D7F5-57EC-87DA-1DB460D64046,"iPhone13,2"
com.apple.MobileSMS,8,1732736876,1732736884,1732736884.200292,-21600,EB445137-D7F5-57EC-87DA-1DB460D64046,"iPhone13,2"
com.apple.MobileSMS,10,1732736742,1732736752,1732736752.1818,-21600,EB445137-D7F5-57EC-87DA-1DB460D64046,"iPhone13,2"
com.apple.MobileSMS,14,1732736240,1732736254,1732736254.647666,-21600,EB445137-D7F5-57EC-87DA-1DB460D64046,"iPhone13,2"
com.apple.camera,7,1732735187,1732735194,1732735195.760427,-21600,EB445137-D7F5-57EC-87DA-1DB460D64046,"iPhone13,2"
com.apple.weather,6,1732735186,1732735192,1732735194.696525,-21600,EB445137-D7F5-57EC-87DA-1DB460D64046,"iPhone13,2"
com.apple.weather,70,1732731034,1732731104,1732731105.132012,-21600,EB445137-D7F5-57EC-87DA-1DB460D64046,"iPhone13,2"
com.apple.news,55,1732730979,1732731034,1732731034.3935251,-21600,EB445137-D7F5-57EC-87DA-1DB460D64046,"iPhone13,2"
com.apple.news,5,1732730911,1732730916,1732730916.86624,-21600,EB445137-D7F5-57EC-87DA-1DB460D64046,"iPhone13,2"
com.apple.news,78,1732730720,1732730798,1732730799.266459,-21600,EB445137-D7F5-57EC-87DA-1DB460D64046,"iPhone13,2"
com.apple.MobileSMS,5,1732730706,1732730711,1732730711.5901852,-21600,EB445137-D7F5-57EC-87DA-1DB460D64046,"iPhone13,2"
com.apple.MobileSMS,6,1732728918,1732728924,1732728924.0782971,-21600,EB445137-D7F5-57EC-87DA-1DB460D64046,"iPhone13,2"
com.apple.MobileSMS,15,1732727731,1732727746,1732727746.9816608,-21600,EB445137-D7F5-57EC-87DA-1DB460D64046,"iPhone13,2"
com.apple.Music,3,1732727728,1732727731,1732727731.5362,-21600,EB445137-D7F5-57EC-87DA-1DB460D64046,"iPhone13,2"
com.apple.Music,12,1732727704,1732727716,1732727716.764447,-21600,EB445137-D7F5-57EC-87DA-1DB460D64046,"iPhone13,2"
com.apple.Health,3,1732727699,1732727702,1732727703.320472,-21600,EB445137-D7F5-57EC-87DA-1DB460D64046,"iPhone13,2"
com.apple.Health,18,1732727587,1732727605,1732727606.231588,-21600,EB445137-D7F5-57EC-87DA-1DB460D64046,"iPhone13,2"
com.renpho.health,23,1732726451,1732726474,1732726474.5456219,-21600,EB445137-D7F5-57EC-87DA-1DB460D64046,"iPhone13,2"
com.google.ios.youtube,1486,1732723866,1732725352,1732725352.828587,-21600,EB445137-D7F5-57EC-87DA-1DB460D64046,"iPhone13,2"
com.apple.camera,1,1732723809,1732723810,1732723810.728199,-21600,EB445137-D7F5-57EC-87DA-1DB460D64046,"iPhone13,2"
com.leomehlig.today,37,1732687752,1732687789,1732687789.8716521,-21600,,
com.apple.iCal,85,1732687667,1732687752,1732687752.080327,-21600,,
com.leomehlig.today,37,1732687630,1732687667,1732687667.2417521,-21600,,
com.google.Chrome,6,1732687624,1732687630,1732687630.2610831,-21600,,
com.apple.news,6,1732686838,1732686844,1732686845.4903321,-21600,EB445137-D7F5-57EC-87DA-1DB460D64046,"iPhone13,2"
com.apple.news,275,1732686544,1732686819,1732686819.262389,-21600,EB445137-D7F5-57EC-87DA-1DB460D64046,"iPhone13,2"
com.apple.news,81,1732685701,1732685782,1732685783.129119,-21600,EB445137-D7F5-57EC-87DA-1DB460D64046,"iPhone13,2"
com.apple.news,80,1732684915,1732684995,1732684995.386363,-21600,EB445137-D7F5-57EC-87DA-1DB460D64046,"iPhone13,2"
com.apple.news,12,1732684264,1732684276,1732684276.6804628,-21600,EB445137-D7F5-57EC-87DA-1DB460D64046,"iPhone13,2"
com.apple.news,2,1732684261,1732684263,1732684263.694714,-21600,EB445137-D7F5-57EC-87DA-1DB460D64046,"iPhone13,2"
com.apple.news,11,1732684209,1732684220,1732684220.218123,-21600,EB445137-D7F5-57EC-87DA-1DB460D64046,"iPhone13,2"
com.apple.news,37,1732683462,1732683499,1732683499.9072828,-21600,EB445137-D7F5-57EC-87DA-1DB460D64046,"iPhone13,2"
com.apple.news,4,1732682916,1732682920,1732682920.270434,-21600,EB445137-D7F5-57EC-87DA-1DB460D64046,"iPhone13,2"
com.apple.news,37,1732682082,1732682119,1732682120.236137,-21600,EB445137-D7F5-57EC-87DA-1DB460D64046,"iPhone13,2"
com.google.chrome.ios,26,1732681493,1732681519,1732681520.058223,-21600,EB445137-D7F5-57EC-87DA-1DB460D64046,"iPhone13,2"
com.apple.news,3,1732681489,1732681492,1732681492.898462,-21600,EB445137-D7F5-57EC-87DA-1DB460D64046,"iPhone13,2"
com.apple.news,6,1732681403,1732681409,1732681409.150553,-21600,EB445137-D7F5-57EC-87DA-1DB460D64046,"iPhone13,2"
com.apple.news,60,1732681150,1732681210,1732681210.950787,-21600,EB445137-D7F5-57EC-87DA-1DB460D64046,"iPhone13,2"
com.google.chrome.ios,2,1732681146,1732681148,1732681148.839017,-21600,EB445137-D7F5-57EC-87DA-1DB460D64046,"iPhone13,2"
com.google.chrome.ios,3,1732680604,1732680607,1732680607.4687529,-21600,EB445137-D7F5-57EC-87DA-1DB460D64046,"iPhone13,2"
com.google.chrome.ios,30,1732680565,1732680595,1732680596.589186,-21600,EB445137-D7F5-57EC-87DA-1DB460D64046,"iPhone13,2"
com.apple.news,2,1732680563,1732680565,1732680565.9534469,-21600,EB445137-D7F5-57EC-87DA-1DB460D64046,"iPhone13,2"
com.apple.news,6,1732680552,1732680558,1732680558.261588,-21600,EB445137-D7F5-57EC-87DA-1DB460D64046,"iPhone13,2"
com.apple.news,99,1732680289,1732680388,1732680388.77206,-21600,EB445137-D7F5-57EC-87DA-1DB460D64046,"iPhone13,2"
com.apple.news,12,1732679655,1732679667,1732679667.706481,-21600,EB445137-D7F5-57EC-87DA-1DB460D64046,"iPhone13,2"
com.apple.news,62,1732679578,1732679640,1732679641.139241,-21600,EB445137-D7F5-57EC-87DA-1DB460D64046,"iPhone13,2"
com.google.chrome.ios,21,1732679367,1732679388,1732679389.245243,-21600,EB445137-D7F5-57EC-87DA-1DB460D64046,"iPhone13,2"
com.google.Gmail,26,1732678208,1732678234,1732678234.026999,-21600,EB445137-D7F5-57EC-87DA-1DB460D64046,"iPhone13,2"
com.google.Chrome,847,1732677341,1732678188,1732678188.8162599,-21600,,
com.google.Chrome,1231,1732675792,1732677023,1732677023.681329,-21600,,
com.google.Chrome,304,1732675396,1732675700,1732675700.659266,-21600,,
com.google.Chrome,638,1732674567,1732675205,1732675205.2059898,-21600,,
com.google.Chrome,702,1732673540,1732674242,1732674242.807191,-21600,,
com.apple.news,153,1732672852,1732673005,1732673005.180385,-21600,EB445137-D7F5-57EC-87DA-1DB460D64046,"iPhone13,2"
com.microsoft.Office.Outlook,4,1732672837,1732672841,1732672841.9918818,-21600,EB445137-D7F5-57EC-87DA-1DB460D64046,"iPhone13,2"
com.microsoft.Office.Outlook,9,1732672394,1732672403,1732672403.934455,-21600,EB445137-D7F5-57EC-87DA-1DB460D64046,"iPhone13,2"
com.apple.news,61,1732672331,1732672392,1732672392.781759,-21600,EB445137-D7F5-57EC-87DA-1DB460D64046,"iPhone13,2"
com.apple.news,3,1732672304,1732672307,1732672307.7478929,-21600,EB445137-D7F5-57EC-87DA-1DB460D64046,"iPhone13,2"
com.google.Chrome,1095,1732672040,1732673135,1732673135.1608372,-21600,,
com.apple.news,268,1732671771,1732672039,1732672040.4435902,-21600,EB445137-D7F5-57EC-87DA-1DB460D64046,"iPhone13,2"
com.apple.MobileSMS,31,1732671720,1732671751,1732671751.4272718,-21600,EB445137-D7F5-57EC-87DA-1DB460D64046,"iPhone13,2"
com.apple.news,32,1732671688,1732671720,1732671720.9969969,-21600,EB445137-D7F5-57EC-87DA-1DB460D64046,"iPhone13,2"
com.apple.news,2,1732671673,1732671675,1732671675.851105,-21600,EB445137-D7F5-57EC-87DA-1DB460D64046,"iPhone13,2"
com.google.Chrome,300,1732671671,1732671971,1732671971.278075,-21600,,
com.microsoft.VSCode,1,1732671670,1732671671,1732671671.206077,-21600,,
com.leomehlig.today,136,1732671534,1732671670,1732671670.486477,-21600,,
com.microsoft.VSCode,9,1732671525,1732671534,1732671534.611525,-21600,,
com.google.Chrome,35,1732671490,1732671525,1732671525.743528,-21600,,
com.apple.finder,1,1732671489,1732671490,1732671490.590732,-21600,,
com.microsoft.VSCode,63,1732671426,1732671489,1732671489.773484,-21600,,
com.apple.finder,2,1732671424,1732671426,1732671426.051919,-21600,,
com.apple.news,3,1732671396,1732671399,1732671399.239644,-21600,EB445137-D7F5-57EC-87DA-1DB460D64046,"iPhone13,2"
com.apple.news,2,1732671251,1732671253,1732671254.13394,-21600,EB445137-D7F5-57EC-87DA-1DB460D64046,"iPhone13,2"
com.apple.news,0,1732671250,1732671250,1732671250.919246,-21600,EB445137-D7F5-57EC-87DA-1DB460D64046,"iPhone13,2"
com.google.Chrome,178,1732671246,1732671424,1732671424.4952068,-21600,,
com.apple.finder,1,1732671245,1732671246,1732671246.841012,-21600,,
com.microsoft.VSCode,1,1732671244,1732671245,1732671245.681009,-21600,,
com.apple.MobileSMS,31,1732671213,1732671244,1732671244.404803,-21600,,
com.microsoft.VSCode,15,1732671198,1732671213,1732671213.7842531,-21600,,
com.apple.finder,5,1732671193,1732671198,1732671198.4099889,-21600,,
com.google.Chrome,34,1732671159,1732671193,1732671193.249408,-21600,,
com.apple.finder,1,1732671158,1732671159,1732671159.240732,-21600,,
com.microsoft.VSCode,25,1732671133,1732671158,1732671158.11806,-21600,,
com.apple.finder,0,1732671133,1732671133,1732671133.897953,-21600,,
com.google.Chrome,29,1732671104,1732671133,1732671133.130996,-21600,,
com.apple.finder,1,1732671103,1732671104,1732671104.740361,-21600,,
com.microsoft.VSCode,19,1732671084,1732671103,1732671103.190162,-21600,,
com.apple.MobileSMS,27,1732671057,1732671084,1732671084.837229,-21600,,
com.microsoft.VSCode,36,1732671021,1732671057,1732671057.412235,-21600,,
com.apple.MobileSMS,1,1732671020,1732671021,1732671021.42943,-21600,,
com.google.Chrome,1,1732671019,1732671020,1732671020.57586,-21600,,
com.apple.MobileSMS,0,1732671019,1732671019,1732671019.819232,-21600,,
com.microsoft.VSCode,3,1732671016,1732671019,1732671019.054348,-21600,,
com.apple.MobileSMS,26,1732670990,1732671016,1732671016.897846,-21600,,
com.apple.news,118,1732670925,1732671043,1732671043.728581,-21600,EB445137-D7F5-57EC-87DA-1DB460D64046,"iPhone13,2"
com.microsoft.VSCode,67,1732670923,1732670990,1732670990.676218,-21600,,
com.apple.MobileSMS,5,1732670918,1732670923,1732670923.143585,-21600,,
com.microsoft.VSCode,1,1732670917,1732670918,1732670918.854975,-21600,,
com.google.Chrome,19,1732670898,1732670917,1732670917.847486,-21600,,
com.microsoft.VSCode,1,1732670897,1732670898,1732670898.515654,-21600,,
com.apple.MobileSMS,82,1732670815,1732670897,1732670897.563568,-21600,,
com.microsoft.VSCode,118,1732670697,1732670815,1732670815.70048,-21600,,
com.apple.MobileSMS,10,1732670687,1732670697,1732670698.0228581,-21600,,
com.microsoft.VSCode,249,1732670438,1732670687,1732670688.001612,-21600,,
com.apple.MobileSMS,16,1732670422,1732670438,1732670438.748025,-21600,,
com.microsoft.VSCode,19,1732670403,1732670422,1732670422.858366,-21600,,
com.apple.MobileSMS,4,1732670399,1732670403,1732670403.6162329,-21600,,
com.microsoft.VSCode,9,1732670390,1732670399,1732670399.953649,-21600,,
com.apple.MobileSMS,65,1732670325,1732670390,1732670390.219764,-21600,,
com.microsoft.VSCode,7,1732670318,1732670325,1732670325.56082,-21600,,
com.apple.MobileSMS,2,1732670316,1732670318,1732670318.5267549,-21600,,
com.microsoft.VSCode,7,1732670309,1732670316,1732670316.6485271,-21600,,
com.apple.MobileSMS,34,1732670275,1732670309,1732670309.8042722,-21600,,
com.microsoft.VSCode,3,1732670272,1732670275,1732670275.879727,-21600,,
com.apple.MobileSMS,6,1732670266,1732670272,1732670272.186503,-21600,,
com.google.Chrome,18,1732670248,1732670266,1732670266.2792258,-21600,,
com.apple.MobileSMS,2,1732670246,1732670248,1732670248.402272,-21600,,
com.microsoft.VSCode,1,1732670245,1732670246,1732670246.497618,-21600,,
com.apple.MobileSMS,23,1732670222,1732670245,1732670245.467414,-21600,,
com.microsoft.VSCode,2,1732670220,1732670222,1732670222.381287,-21600,,
com.apple.MobileSMS,8,1732670212,1732670220,1732670220.806015,-21600,,
com.microsoft.VSCode,1,1732670211,1732670212,1732670212.1601171,-21600,,
com.apple.MobileSMS,10,1732670201,1732670211,1732670211.793201,-21600,,
com.microsoft.VSCode,3,1732670198,1732670201,1732670201.6380901,-21600,,
com.apple.MobileSMS,44,1732670154,1732670198,1732670198.769524,-21600,,
com.microsoft.VSCode,4,1732670150,1732670154,1732670154.641413,-21600,,
com.apple.MobileSMS,3,1732670147,1732670150,1732670151.02347,-21600,,
com.microsoft.VSCode,1,1732670146,1732670147,1732670147.746299,-21600,,
com.apple.MobileSMS,13,1732670133,1732670146,1732670146.72275,-21600,,
com.microsoft.VSCode,3,1732670130,1732670133,1732670133.136822,-21600,,
com.apple.MobileSMS,35,1732670095,1732670130,1732670130.395944,-21600,,
com.microsoft.VSCode,30,1732670065,1732670095,1732670095.676913,-21600,,
com.apple.MobileSMS,1,1732670064,1732670065,1732670065.183885,-21600,,
com.google.Chrome,17,1732670047,1732670064,1732670064.253217,-21600,,
com.apple.MobileSMS,31,1732670016,1732670047,1732670048.0010061,-21600,,
com.google.Chrome,4,1732670012,1732670016,1732670016.971655,-21600,,
com.apple.MobileSMS,1,1732670011,1732670012,1732670012.238799,-21600,,
com.google.Chrome,1,1732670010,1732670011,1732670011.309664,-21600,,
com.microsoft.VSCode,2,1732670008,1732670010,1732670010.109579,-21600,,
com.apple.MobileSMS,98,1732669910,1732670008,1732670008.576024,-21600,,
com.apple.news,10,1732669444,1732669454,1732669454.671562,-21600,EB445137-D7F5-57EC-87DA-1DB460D64046,"iPhone13,2"
com.microsoft.VSCode,474,1732669436,1732669910,1732669910.868722,-21600,,
com.google.Chrome,211,1732669225,1732669436,1732669437.007433,-21600,,
com.microsoft.VSCode,2,1732669223,1732669225,1732669226.276764,-21600,,
com.google.Chrome,241,1732668982,1732669223,1732669224.293666,-21600,,
com.apple.news,155,1732668883,1732669038,1732669039.050365,-21600,EB445137-D7F5-57EC-87DA-1DB460D64046,"iPhone13,2"
com.microsoft.VSCode,148,1732668834,1732668982,1732668983.198525,-21600,,
com.google.Chrome,12,1732668822,1732668834,1732668834.314569,-21600,,
com.apple.news,119,1732668682,1732668801,1732668801.4080071,-21600,EB445137-D7F5-57EC-87DA-1DB460D64046,"iPhone13,2"
com.microsoft.VSCode,453,1732668369,1732668822,1732668822.677476,-21600,,
com.google.Chrome,1,1732668368,1732668369,1732668369.818605,-21600,,
com.apple.iCal,2,1732668366,1732668368,1732668368.229883,-21600,,
com.apple.news,413,1732667937,1732668350,1732668351.1300879,-21600,EB445137-D7F5-57EC-87DA-1DB460D64046,"iPhone13,2"
com.apple.weather,56,1732667876,1732667932,1732667932.121728,-21600,EB445137-D7F5-57EC-87DA-1DB460D64046,"iPhone13,2"
com.apple.news,296,1732667579,1732667875,1732667875.475085,-21600,EB445137-D7F5-57EC-87DA-1DB460D64046,"iPhone13,2"
com.hammerandchisel.discord,9,1732667560,1732667569,1732667569.179466,-21600,EB445137-D7F5-57EC-87DA-1DB460D64046,"iPhone13,2"
com.microsoft.Office.Outlook,5,1732667531,1732667536,1732667536.790103,-21600,EB445137-D7F5-57EC-87DA-1DB460D64046,"iPhone13,2"
com.toyopagroup.picaboo,27,1732667453,1732667480,1732667480.6129498,-21600,EB445137-D7F5-57EC-87DA-1DB460D64046,"iPhone13,2"
com.apple.MobileSMS,4,1732667449,1732667453,1732667453.8834128,-21600,EB445137-D7F5-57EC-87DA-1DB460D64046,"iPhone13,2"
com.apple.MobileSMS,9,1732665396,1732665405,1732665406.003937,-21600,EB445137-D7F5-57EC-87DA-1DB460D64046,"iPhone13,2"
com.apple.MobileSMS,119,1732665014,1732665133,1732665133.700645,-21600,EB445137-D7F5-57EC-87DA-1DB460D64046,"iPhone13,2"
com.apple.mobileslideshow,2,1732665011,1732665013,1732665014.093123,-21600,EB445137-D7F5-57EC-87DA-1DB460D64046,"iPhone13,2"
com.apple.mobileslideshow,18,1732664980,1732664998,1732664998.748653,-21600,EB445137-D7F5-57EC-87DA-1DB460D64046,"iPhone13,2"
com.hammerandchisel.discord,2,1732664973,1732664975,1732664975.1404948,-21600,EB445137-D7F5-57EC-87DA-1DB460D64046,"iPhone13,2"
com.hammerandchisel.discord,6,1732663213,1732663219,1732663219.525455,-21600,EB445137-D7F5-57EC-87DA-1DB460D64046,"iPhone13,2"
com.toyopagroup.picaboo,9,1732663204,1732663213,1732663214.034092,-21600,EB445137-D7F5-57EC-87DA-1DB460D64046,"iPhone13,2"
com.apple.findmy,8,1732663196,1732663204,1732663205.5385242,-21600,EB445137-D7F5-57EC-87DA-1DB460D64046,"iPhone13,2"
com.apple.findmy,18,1732658641,1732658659,1732658660.437992,-21600,EB445137-D7F5-57EC-87DA-1DB460D64046,"iPhone13,2"
com.google.chrome.ios,3,1732658637,1732658640,1732658640.67784,-21600,EB445137-D7F5-57EC-87DA-1DB460D64046,"iPhone13,2"
com.google.chrome.ios,3,1732657999,1732658002,1732658002.9552078,-21600,EB445137-D7F5-57EC-87DA-1DB460D64046,"iPhone13,2"
com.google.chrome.ios,15,1732657776,1732657791,1732657791.881456,-21600,EB445137-D7F5-57EC-87DA-1DB460D64046,"iPhone13,2"
com.google.chrome.ios,2,1732657307,1732657309,1732657309.679109,-21600,EB445137-D7F5-57EC-87DA-1DB460D64046,"iPhone13,2"
com.google.chrome.ios,7,1732657292,1732657299,1732657299.298316,-21600,EB445137-D7F5-57EC-87DA-1DB460D64046,"iPhone13,2"
com.google.chrome.ios,3,1732657202,1732657205,1732657205.506266,-21600,EB445137-D7F5-57EC-87DA-1DB460D64046,"iPhone13,2"
com.google.chrome.ios,3,1732656968,1732656971,1732656971.808426,-21600,EB445137-D7F5-57EC-87DA-1DB460D64046,"iPhone13,2"
com.microsoft.onenote,34,1732656934,1732656968,1732656968.602398,-21600,EB445137-D7F5-57EC-87DA-1DB460D64046,"iPhone13,2"
com.google.chrome.ios,66,1732656866,1732656932,1732656932.2644,-21600,EB445137-D7F5-57EC-87DA-1DB460D64046,"iPhone13,2"
com.google.chrome.ios,57,1732656802,1732656859,1732656859.2925339,-21600,EB445137-D7F5-57EC-87DA-1DB460D64046,"iPhone13,2"
com.apple.MobileSMS,4,1732656798,1732656802,1732656802.223253,-21600,EB445137-D7F5-57EC-87DA-1DB460D64046,"iPhone13,2"
com.apple.MobileSMS,6,1732656731,1732656737,1732656738.05693,-21600,EB445137-D7F5-57EC-87DA-1DB460D64046,"iPhone13,2"
com.apple.MobileSMS,14,1732656526,1732656540,1732656540.360054,-21600,EB445137-D7F5-57EC-87DA-1DB460D64046,"iPhone13,2"
com.apple.MobileSMS,12,1732656255,1732656267,1732656267.975044,-21600,EB445137-D7F5-57EC-87DA-1DB460D64046,"iPhone13,2"
com.apple.MobileSMS,2,1732656077,1732656079,1732656080.22747,-21600,EB445137-D7F5-57EC-87DA-1DB460D64046,"iPhone13,2"
com.apple.MobileSMS,83,1732655376,1732655459,1732655459.7883081,-21600,EB445137-D7F5-57EC-87DA-1DB460D64046,"iPhone13,2"
com.apple.MobileSMS,15,1732655000,1732655015,1732655015.5223331,-21600,EB445137-D7F5-57EC-87DA-1DB460D64046,"iPhone13,2"
com.google.Gmail,12,1732654988,1732655000,1732655000.7344909,-21600,EB445137-D7F5-57EC-87DA-1DB460D64046,"iPhone13,2"
com.apple.MobileSMS,8,1732654980,1732654988,1732654988.153017,-21600,EB445137-D7F5-57EC-87DA-1DB460D64046,"iPhone13,2"
com.apple.MobileSMS,7,1732653787,1732653794,1732653794.681519,-21600,EB445137-D7F5-57EC-87DA-1DB460D64046,"iPhone13,2"
com.apple.MobileSMS,20,1732651721,1732651741,1732651741.5985188,-21600,EB445137-D7F5-57EC-87DA-1DB460D64046,"iPhone13,2"
com.apple.MobileSMS,26,1732651480,1732651506,1732651506.963676,-21600,EB445137-D7F5-57EC-87DA-1DB460D64046,"iPhone13,2"
com.apple.iCal,39,1732651431,1732651470,1732651470.451147,-21600,,
com.google.Chrome,15,1732651416,1732651431,1732651431.847351,-21600,,
com.microsoft.VSCode,161,1732651255,1732651416,1732651416.4075809,-21600,,
com.google.Chrome,242,1732651013,1732651255,1732651255.388674,-21600,,
com.leomehlig.today,16,1732650997,1732651013,1732651013.633384,-21600,,
com.apple.iCal,14,1732650983,1732650997,1732650997.1860971,-21600,,
com.leomehlig.today,74,1732650909,1732650983,1732650983.317254,-21600,,
com.microsoft.VSCode,148,1732650761,1732650909,1732650909.271569,-21600,,
com.google.Chrome,148,1732650613,1732650761,1732650761.7246861,-21600,,
com.microsoft.VSCode,4,1732650609,1732650613,1732650613.897682,-21600,,
com.google.Chrome,0,1732650609,1732650609,1732650609.545485,-21600,,
com.microsoft.VSCode,3,1732650606,1732650609,1732650609.214112,-21600,,
com.google.Chrome,10,1732650596,1732650606,1732650606.351169,-21600,,
com.microsoft.VSCode,475,1732650121,1732650596,1732650597.0211701,-21600,,
com.google.Chrome,26,1732650095,1732650121,1732650121.9930859,-21600,,
com.microsoft.VSCode,7,1732650088,1732650095,1732650095.670716,-21600,,
com.google.Chrome,3,1732650085,1732650088,1732650088.992269,-21600,,
com.microsoft.VSCode,3,1732650082,1732650085,1732650085.9965,-21600,,
com.google.Chrome,20,1732650062,1732650082,1732650082.126739,-21600,,
com.microsoft.VSCode,6,1732650056,1732650062,1732650062.0739279,-21600,,
com.google.Chrome,0,1732650056,1732650056,1732650056.888454,-21600,,
com.microsoft.VSCode,4,1732650052,1732650056,1732650056.168335,-21600,,
com.google.Chrome,10,1732650042,1732650052,1732650052.0623631,-21600,,
com.microsoft.VSCode,247,1732649795,1732650042,1732650042.207732,-21600,,
com.apple.MobileSMS,221,1732649753,1732649974,1732649974.145395,-21600,EB445137-D7F5-57EC-87DA-1DB460D64046,"iPhone13,2"
com.apple.camera,1,1732649455,1732649456,1732649456.343103,-21600,EB445137-D7F5-57EC-87DA-1DB460D64046,"iPhone13,2"
com.apple.camera,0,1732649455,1732649455,1732649455.361212,-21600,EB445137-D7F5-57EC-87DA-1DB460D64046,"iPhone13,2"
com.apple.camera,0,1732649454,1732649454,1732649454.8761802,-21600,EB445137-D7F5-57EC-87DA-1DB460D64046,"iPhone13,2"
com.google.chrome.ios,34,1732649356,1732649390,1732649390.667983,-21600,EB445137-D7F5-57EC-87DA-1DB460D64046,"iPhone13,2"
com.apple.mobilecal,3,1732649353,1732649356,1732649356.568709,-21600,EB445137-D7F5-57EC-87DA-1DB460D64046,"iPhone13,2"
com.apple.mobilecal,7,1732649303,1732649310,1732649310.27752,-21600,EB445137-D7F5-57EC-87DA-1DB460D64046,"iPhone13,2"
com.apple.camera,0,1732649299,1732649299,1732649300.6494498,-21600,EB445137-D7F5-57EC-87DA-1DB460D64046,"iPhone13,2"
com.apple.mobilecal,13,1732649286,1732649299,1732649300.824543,-21600,EB445137-D7F5-57EC-87DA-1DB460D64046,"iPhone13,2"
com.apple.mobilecal,29,1732649249,1732649278,1732649278.670404,-21600,EB445137-D7F5-57EC-87DA-1DB460D64046,"iPhone13,2"
com.apple.news,2,1732649239,1732649241,1732649241.8246322,-21600,EB445137-D7F5-57EC-87DA-1DB460D64046,"iPhone13,2"
com.apple.news,39,1732647486,1732647525,1732647525.744097,-21600,EB445137-D7F5-57EC-87DA-1DB460D64046,"iPhone13,2"
com.apple.Health,11,1732647447,1732647458,1732647458.933562,-21600,EB445137-D7F5-57EC-87DA-1DB460D64046,"iPhone13,2"
com.microsoft.VSCode,337,1732645770,1732646107,1732646107.653696,-21600,,
com.google.Chrome,1,1732645769,1732645770,1732645770.9603682,-21600,,
com.microsoft.VSCode,8,1732645761,1732645769,1732645769.2424622,-21600,,
com.google.Chrome,4,1732645757,1732645761,1732645761.305303,-21600,,
com.microsoft.VSCode,21,1732645736,1732645757,1732645757.734999,-21600,,
com.google.Chrome,2,1732645734,1732645736,1732645736.624073,-21600,,
com.microsoft.VSCode,3,1732645731,1732645734,1732645734.9546561,-21600,,
com.google.Chrome,61,1732645670,1732645731,1732645731.9520001,-21600,,
com.microsoft.VSCode,3,1732645667,1732645670,1732645670.497289,-21600,,
com.google.Chrome,8,1732645659,1732645667,1732645667.64096,-21600,,
com.microsoft.VSCode,4,1732645655,1732645659,1732645659.5124478,-21600,,
com.google.Chrome,9,1732645646,1732645655,1732645655.425655,-21600,,
com.microsoft.VSCode,59,1732645587,1732645646,1732645646.621809,-21600,,
com.google.Chrome,1,1732645586,1732645587,1732645587.623358,-21600,,
com.microsoft.VSCode,15,1732645571,1732645586,1732645586.68779,-21600,,
com.google.Chrome,5,1732645566,1732645571,1732645571.438105,-21600,,
com.microsoft.VSCode,7,1732645559,1732645566,1732645566.494087,-21600,,
com.google.Chrome,3,1732645556,1732645559,1732645559.667688,-21600,,
com.microsoft.VSCode,14,1732645542,1732645556,1732645557.038529,-21600,,
com.google.Chrome,18,1732645524,1732645542,1732645543.021275,-21600,,
com.microsoft.VSCode,3,1732645521,1732645524,1732645524.297339,-21600,,
com.google.Chrome,3,1732645518,1732645521,1732645521.438034,-21600,,
com.microsoft.VSCode,628,1732644890,1732645518,1732645518.188421,-21600,,
com.google.Chrome,5,1732644885,1732644890,1732644890.6660008,-21600,,
com.microsoft.VSCode,2,1732644883,1732644885,1732644885.8415031,-21600,,
com.google.Chrome,55,1732644828,1732644883,1732644883.2090259,-21600,,
com.microsoft.VSCode,8,1732644820,1732644828,1732644828.729276,-21600,,
com.google.Chrome,2,1732644818,1732644820,1732644820.755266,-21600,,
com.microsoft.VSCode,11,1732644807,1732644818,1732644818.143918,-21600,,
com.google.Chrome,18,1732644789,1732644807,1732644807.5154262,-21600,,
com.microsoft.VSCode,511,1732644278,1732644789,1732644789.680664,-21600,,
com.google.Chrome,21,1732644257,1732644278,1732644278.439765,-21600,,
com.microsoft.VSCode,22,1732644235,1732644257,1732644257.759819,-21600,,
com.google.Chrome,2,1732644233,1732644235,1732644235.391504,-21600,,
com.microsoft.VSCode,7,1732644226,1732644233,1732644234.010188,-21600,,
com.google.Chrome,2,1732644224,1732644226,1732644227.028494,-21600,,
com.microsoft.VSCode,2,1732644222,1732644224,1732644224.291881,-21600,,
com.google.Chrome,4,1732644218,1732644222,1732644222.443778,-21600,,
com.microsoft.VSCode,16,1732644202,1732644218,1732644218.359401,-21600,,
com.google.Chrome,5,1732644197,1732644202,1732644202.8938951,-21600,,
com.microsoft.VSCode,16,1732644181,1732644197,1732644197.8582668,-21600,,
com.google.Chrome,10,1732644171,1732644181,1732644181.099427,-21600,,
com.microsoft.VSCode,87,1732644084,1732644171,1732644171.150207,-21600,,
com.google.Chrome,1,1732644083,1732644084,1732644084.886527,-21600,,
com.apple.MobileSMS,4,1732644079,1732644083,1732644083.16379,-21600,,
com.google.Chrome,7,1732644072,1732644079,1732644079.594094,-21600,,
com.apple.findmy,13,1732643867,1732643880,1732643880.6540232,-21600,EB445137-D7F5-57EC-87DA-1DB460D64046,"iPhone13,2"
com.google.ios.youtube,1058,1732642809,1732643867,1732643868.144198,-21600,EB445137-D7F5-57EC-87DA-1DB460D64046,"iPhone13,2"
com.google.ios.youtube,3,1732642803,1732642806,1732642806.374329,-21600,EB445137-D7F5-57EC-87DA-1DB460D64046,"iPhone13,2"
com.apple.findmy,11,1732642782,1732642793,1732642799.296272,-21600,EB445137-D7F5-57EC-87DA-1DB460D64046,"iPhone13,2"
com.apple.findmy,37,1732642659,1732642696,1732642696.5826612,-21600,EB445137-D7F5-57EC-87DA-1DB460D64046,"iPhone13,2"
com.apple.findmy,15,1732642318,1732642333,1732642333.590619,-21600,EB445137-D7F5-57EC-87DA-1DB460D64046,"iPhone13,2"
com.apple.findmy,6,1732641713,1732641719,1732641719.536611,-21600,EB445137-D7F5-57EC-87DA-1DB460D64046,"iPhone13,2"
com.apple.findmy,12,1732641695,1732641707,1732641707.981612,-21600,EB445137-D7F5-57EC-87DA-1DB460D64046,"iPhone13,2"
com.renpho.health,3,1732641692,1732641695,1732641695.04455,-21600,EB445137-D7F5-57EC-87DA-1DB460D64046,"iPhone13,2"
com.renpho.health,30,1732641532,1732641562,1732641562.8638148,-21600,EB445137-D7F5-57EC-87DA-1DB460D64046,"iPhone13,2"
com.apple.findmy,16,1732640416,1732640432,1732640432.5046349,-21600,EB445137-D7F5-57EC-87DA-1DB460D64046,"iPhone13,2"
com.facebook.Facebook,379,1732640037,1732640416,1732640417.193935,-21600,EB445137-D7F5-57EC-87DA-1DB460D64046,"iPhone13,2"
com.apple.findmy,22,1732639961,1732639983,1732639983.8417292,-21600,EB445137-D7F5-57EC-87DA-1DB460D64046,"iPhone13,2"
com.apple.news,184,1732639773,1732639957,1732639957.406961,-21600,EB445137-D7F5-57EC-87DA-1DB460D64046,"iPhone13,2"
com.hammerandchisel.discord,42,1732639718,1732639760,1732639760.923922,-21600,EB445137-D7F5-57EC-87DA-1DB460D64046,"iPhone13,2"
com.apple.findmy,14,1732638750,1732638764,1732638764.950764,-21600,EB445137-D7F5-57EC-87DA-1DB460D64046,"iPhone13,2"
com.apple.findmy,21,1732636815,1732636836,1732636837.154705,-21600,EB445137-D7F5-57EC-87DA-1DB460D64046,"iPhone13,2"
com.apple.mobiletimer,10,1732635057,1732635067,1732635067.77826,-21600,EB445137-D7F5-57EC-87DA-1DB460D64046,"iPhone13,2"
com.apple.findmy,14,1732635035,1732635049,1732635050.117968,-21600,EB445137-D7F5-57EC-87DA-1DB460D64046,"iPhone13,2"
com.apple.mobiletimer,12,1732635022,1732635034,1732635034.2428842,-21600,EB445137-D7F5-57EC-87DA-1DB460D64046,"iPhone13,2"
com.apple.mobiletimer,20,1732635001,1732635021,1732635021.6333199,-21600,EB445137-D7F5-57EC-87DA-1DB460D64046,"iPhone13,2"
com.apple.mobiletimer,14,1732605282,1732605296,1732605296.2621288,-21600,EB445137-D7F5-57EC-87DA-1DB460D64046,"iPhone13,2"
com.apple.mobiletimer,11,1732605267,1732605278,1732605278.745219,-21600,EB445137-D7F5-57EC-87DA-1DB460D64046,"iPhone13,2"
com.google.Chrome,17,1732605191,1732605208,1732605208.4945378,-21600,,
com.google.Chrome,494,1732604347,1732604841,1732604841.179123,-21600,,
com.apple.camera,0,1732603931,1732603931,1732603931.4230452,-21600,EB445137-D7F5-57EC-87DA-1DB460D64046,"iPhone13,2"
com.google.Chrome,300,1732603778,1732604078,1732604078.449424,-21600,,
com.google.Chrome,574,1732603165,1732603739,1732603739.195427,-21600,,
com.apple.Preferences,3,1732603156,1732603159,1732603159.653944,-21600,EB445137-D7F5-57EC-87DA-1DB460D64046,"iPhone13,2"
com.apple.Preferences,13,1732603089,1732603102,1732603102.6890101,-21600,EB445137-D7F5-57EC-87DA-1DB460D64046,"iPhone13,2"
com.apple.Preferences,10,1732601249,1732601259,1732601259.55906,-21600,EB445137-D7F5-57EC-87DA-1DB460D64046,"iPhone13,2"
com.apple.Preferences,2,1732600526,1732600528,1732600528.157125,-21600,EB445137-D7F5-57EC-87DA-1DB460D64046,"iPhone13,2"
com.apple.Preferences,25,1732599784,1732599809,1732599810.603936,-21600,EB445137-D7F5-57EC-87DA-1DB460D64046,"iPhone13,2"
com.apple.Passwords,128,1732597729,1732597857,1732597857.287332,-21600,EB445137-D7F5-57EC-87DA-1DB460D64046,"iPhone13,2"
com.apple.camera,47,1732597676,1732597723,1732597723.8029032,-21600,EB445137-D7F5-57EC-87DA-1DB460D64046,"iPhone13,2"
com.apple.Maps,1344,1732594192,1732595536,1732595537.298061,-21600,EB445137-D7F5-57EC-87DA-1DB460D64046,"iPhone13,2"
com.apple.MobileSMS,3,1732594189,1732594192,1732594192.802304,-21600,EB445137-D7F5-57EC-87DA-1DB460D64046,"iPhone13,2"
com.apple.Maps,11,1732594178,1732594189,1732594189.64574,-21600,EB445137-D7F5-57EC-87DA-1DB460D64046,"iPhone13,2"
com.apple.MobileSMS,36,1732594142,1732594178,1732594178.0941648,-21600,EB445137-D7F5-57EC-87DA-1DB460D64046,"iPhone13,2"
com.apple.findmy,8,1732594134,1732594142,1732594142.302016,-21600,EB445137-D7F5-57EC-87DA-1DB460D64046,"iPhone13,2"
com.apple.MobileSMS,88,1732594046,1732594134,1732594134.54426,-21600,EB445137-D7F5-57EC-87DA-1DB460D64046,"iPhone13,2"
com.apple.findmy,5,1732594040,1732594045,1732594046.406074,-21600,EB445137-D7F5-57EC-87DA-1DB460D64046,"iPhone13,2"
com.hammerandchisel.discord,3,1732594036,1732594039,1732594039.349468,-21600,EB445137-D7F5-57EC-87DA-1DB460D64046,"iPhone13,2"
com.hammerandchisel.discord,5,1732592980,1732592985,1732592985.175781,-21600,EB445137-D7F5-57EC-87DA-1DB460D64046,"iPhone13,2"
com.apple.findmy,14,1732592128,1732592142,1732592142.912549,-21600,EB445137-D7F5-57EC-87DA-1DB460D64046,"iPhone13,2"
com.toyopagroup.picaboo,3,1732591988,1732591991,1732591991.568187,-21600,EB445137-D7F5-57EC-87DA-1DB460D64046,"iPhone13,2"
com.apple.MobileSMS,4,1732591984,1732591988,1732591989.071219,-21600,EB445137-D7F5-57EC-87DA-1DB460D64046,"iPhone13,2"
com.apple.MobileSMS,6,1732591974,1732591980,1732591980.208482,-21600,EB445137-D7F5-57EC-87DA-1DB460D64046,"iPhone13,2"
com.apple.MobileSMS,26,1732591945,1732591971,1732591971.4759722,-21600,EB445137-D7F5-57EC-87DA-1DB460D64046,"iPhone13,2"
com.hammerandchisel.discord,3,1732591942,1732591945,1732591945.860838,-21600,EB445137-D7F5-57EC-87DA-1DB460D64046,"iPhone13,2"
com.hammerandchisel.discord,2,1732591940,1732591942,1732591942.682838,-21600,EB445137-D7F5-57EC-87DA-1DB460D64046,"iPhone13,2"
com.apple.camera,0,1732589958,1732589958,1732589959.191653,-21600,EB445137-D7F5-57EC-87DA-1DB460D64046,"iPhone13,2"
com.hammerandchisel.discord,5,1732589953,1732589958,1732589959.188047,-21600,EB445137-D7F5-57EC-87DA-1DB460D64046,"iPhone13,2"
com.hammerandchisel.discord,3,1732589493,1732589496,1732589497.067573,-21600,EB445137-D7F5-57EC-87DA-1DB460D64046,"iPhone13,2"
com.toyopagroup.picaboo,7,1732589486,1732589493,1732589493.4227629,-21600,EB445137-D7F5-57EC-87DA-1DB460D64046,"iPhone13,2"
com.apple.Maps,1370,1732588113,1732589483,1732589483.111057,-21600,EB445137-D7F5-57EC-87DA-1DB460D64046,"iPhone13,2"
com.apple.MobileSMS,4,1732586779,1732586783,1732586783.783464,-21600,EB445137-D7F5-57EC-87DA-1DB460D64046,"iPhone13,2"
com.apple.MobileSMS,2,1732586706,1732586708,1732586710.052137,-21600,EB445137-D7F5-57EC-87DA-1DB460D64046,"iPhone13,2"
com.apple.MobileSMS,20,1732586679,1732586699,1732586699.840677,-21600,EB445137-D7F5-57EC-87DA-1DB460D64046,"iPhone13,2"
com.apple.MobileSMS,12,1732586656,1732586668,1732586669.259077,-21600,EB445137-D7F5-57EC-87DA-1DB460D64046,"iPhone13,2"
com.toyopagroup.picaboo,10,1732586640,1732586650,1732586650.44504,-21600,EB445137-D7F5-57EC-87DA-1DB460D64046,"iPhone13,2"
com.apple.MobileSMS,59,1732586557,1732586616,1732586616.5474539,-21600,EB445137-D7F5-57EC-87DA-1DB460D64046,"iPhone13,2"
com.google.ios.youtube,386,1732586171,1732586557,1732586558.0336819,-21600,EB445137-D7F5-57EC-87DA-1DB460D64046,"iPhone13,2"
com.apple.MobileSMS,4,1732586155,1732586159,1732586159.711391,-21600,EB445137-D7F5-57EC-87DA-1DB460D64046,"iPhone13,2"
com.apple.MobileSMS,143,1732585915,1732586058,1732586058.1989012,-21600,EB445137-D7F5-57EC-87DA-1DB460D64046,"iPhone13,2"
com.apple.Maps,2,1732585913,1732585915,1732585915.7265239,-21600,EB445137-D7F5-57EC-87DA-1DB460D64046,"iPhone13,2"
com.apple.MobileSMS,12,1732585901,1732585913,1732585913.164407,-21600,EB445137-D7F5-57EC-87DA-1DB460D64046,"iPhone13,2"
com.apple.Maps,5,1732585896,1732585901,1732585901.763649,-21600,EB445137-D7F5-57EC-87DA-1DB460D64046,"iPhone13,2"
com.apple.MobileSMS,20,1732585876,1732585896,1732585896.9787688,-21600,EB445137-D7F5-57EC-87DA-1DB460D64046,"iPhone13,2"
com.apple.Maps,6,1732585870,1732585876,1732585876.814064,-21600,EB445137-D7F5-57EC-87DA-1DB460D64046,"iPhone13,2"
com.apple.MobileSMS,20,1732585850,1732585870,1732585870.593965,-21600,EB445137-D7F5-57EC-87DA-1DB460D64046,"iPhone13,2"
com.apple.Maps,10,1732585840,1732585850,1732585850.587111,-21600,EB445137-D7F5-57EC-87DA-1DB460D64046,"iPhone13,2"
com.apple.MobileSMS,24,1732585816,1732585840,1732585840.873952,-21600,EB445137-D7F5-57EC-87DA-1DB460D64046,"iPhone13,2"
com.apple.Maps,10,1732585806,1732585816,1732585816.7184181,-21600,EB445137-D7F5-57EC-87DA-1DB460D64046,"iPhone13,2"
com.apple.MobileSMS,16,1732585790,1732585806,1732585806.5093389,-21600,EB445137-D7F5-57EC-87DA-1DB460D64046,"iPhone13,2"
com.apple.weather,12,1732585773,1732585785,1732585785.5745401,-21600,EB445137-D7F5-57EC-87DA-1DB460D64046,"iPhone13,2"
com.apple.MobileSMS,51,1732585711,1732585762,1732585762.3662028,-21600,EB445137-D7F5-57EC-87DA-1DB460D64046,"iPhone13,2"
com.apple.MobileSMS,61,1732585642,1732585703,1732585703.33325,-21600,EB445137-D7F5-57EC-87DA-1DB460D64046,"iPhone13,2"
com.apple.findmy,23,1732585619,1732585642,1732585642.7325249,-21600,EB445137-D7F5-57EC-87DA-1DB460D64046,"iPhone13,2"
com.apple.MobileSMS,59,1732585560,1732585619,1732585619.900693,-21600,EB445137-D7F5-57EC-87DA-1DB460D64046,"iPhone13,2"
com.hammerandchisel.discord,11,1732585549,1732585560,1732585560.688232,-21600,EB445137-D7F5-57EC-87DA-1DB460D64046,"iPhone13,2"
com.apple.MobileSMS,224,1732585323,1732585547,1732585547.613945,-21600,EB445137-D7F5-57EC-87DA-1DB460D64046,"iPhone13,2"
com.apple.MobileSMS,7,1732585304,1732585311,1732585311.95927,-21600,EB445137-D7F5-57EC-87DA-1DB460D64046,"iPhone13,2"
com.apple.findmy,7,1732585270,1732585277,1732585277.674364,-21600,EB445137-D7F5-57EC-87DA-1DB460D64046,"iPhone13,2"
com.apple.Maps,31,1732585237,1732585268,1732585268.9933538,-21600,EB445137-D7F5-57EC-87DA-1DB460D64046,"iPhone13,2"
com.google.chrome.ios,97,1732585140,1732585237,1732585237.510017,-21600,EB445137-D7F5-57EC-87DA-1DB460D64046,"iPhone13,2"
com.apple.MobileSMS,51,1732585089,1732585140,1732585140.811847,-21600,EB445137-D7F5-57EC-87DA-1DB460D64046,"iPhone13,2"
com.apple.findmy,11,1732585078,1732585089,1732585089.6891022,-21600,EB445137-D7F5-57EC-87DA-1DB460D64046,"iPhone13,2"
com.hammerandchisel.discord,30,1732585044,1732585074,1732585074.420779,-21600,EB445137-D7F5-57EC-87DA-1DB460D64046,"iPhone13,2"
com.apple.findmy,6,1732585038,1732585044,1732585044.85525,-21600,EB445137-D7F5-57EC-87DA-1DB460D64046,"iPhone13,2"
com.google.Chrome,426,1732584593,1732585019,1732585019.412531,-21600,,
com.google.Chrome,308,1732584278,1732584586,1732584586.751513,-21600,,
com.google.Chrome,310,1732583956,1732584266,1732584266.682452,-21600,,
com.google.Chrome,304,1732583598,1732583902,1732583902.228364,-21600,,
com.google.Chrome,324,1732582915,1732583239,1732583239.502332,-21600,,
com.google.Chrome,395,1732582189,1732582584,1732582584.771601,-21600,,
com.microsoft.Office.Outlook,12,1732581605,1732581617,1732581617.818139,-21600,EB445137-D7F5-57EC-87DA-1DB460D64046,"iPhone13,2"
com.apple.findmy,10,1732581572,1732581582,1732581583.191512,-21600,EB445137-D7F5-57EC-87DA-1DB460D64046,"iPhone13,2"
com.google.Chrome,1292,1732580666,1732581958,1732581958.2539248,-21600,,
com.google.ios.youtube,138,1732579448,1732579586,1732579586.409854,-21600,EB445137-D7F5-57EC-87DA-1DB460D64046,"iPhone13,2"
com.hammerandchisel.discord,16,1732579428,1732579444,1732579444.939559,-21600,EB445137-D7F5-57EC-87DA-1DB460D64046,"iPhone13,2"
com.apple.findmy,3,1732579425,1732579428,1732579428.537164,-21600,EB445137-D7F5-57EC-87DA-1DB460D64046,"iPhone13,2"
com.apple.findmy,10,1732579390,1732579400,1732579400.5000138,-21600,EB445137-D7F5-57EC-87DA-1DB460D64046,"iPhone13,2"
com.google.Chrome,2980,1732576505,1732579485,1732579485.807821,-21600,,
com.apple.MobileSMS,26,1732576479,1732576505,1732576505.941996,-21600,,
com.google.Chrome,1,1732576478,1732576479,1732576479.3933458,-21600,,
com.apple.MobileSMS,4,1732576474,1732576478,1732576478.575642,-21600,,
com.apple.AddressBook,7,1732576467,1732576474,1732576474.919942,-21600,,
com.apple.MobileSMS,5,1732576462,1732576467,1732576467.93322,-21600,,
com.google.Chrome,4,1732576458,1732576462,1732576462.9343019,-21600,,
com.apple.MobileSMS,15,1732576443,1732576458,1732576458.846713,-21600,,
com.google.Chrome,269,1732576174,1732576443,1732576443.695887,-21600,,
com.apple.findmy,67,1732575650,1732575717,1732575719.1096702,-21600,EB445137-D7F5-57EC-87DA-1DB460D64046,"iPhone13,2"
com.apple.findmy,18,1732575501,1732575519,1732575519.737619,-21600,EB445137-D7F5-57EC-87DA-1DB460D64046,"iPhone13,2"
com.hammerandchisel.discord,5,1732575491,1732575496,1732575496.3285189,-21600,EB445137-D7F5-57EC-87DA-1DB460D64046,"iPhone13,2"
com.apple.findmy,4,1732575487,1732575491,1732575491.588745,-21600,EB445137-D7F5-57EC-87DA-1DB460D64046,"iPhone13,2"
com.apple.findmy,64,1732575209,1732575273,1732575273.7428498,-21600,EB445137-D7F5-57EC-87DA-1DB460D64046,"iPhone13,2"
com.apple.findmy,39,1732574911,1732574950,1732574950.681754,-21600,EB445137-D7F5-57EC-87DA-1DB460D64046,"iPhone13,2"
com.google.Chrome,1129,1732574895,1732576024,1732576024.351773,-21600,,
com.apple.findmy,24,1732574652,1732574676,1732574677.202883,-21600,EB445137-D7F5-57EC-87DA-1DB460D64046,"iPhone13,2"
com.hammerandchisel.discord,6,1732574646,1732574652,1732574652.261279,-21600,EB445137-D7F5-57EC-87DA-1DB460D64046,"iPhone13,2"
com.hammerandchisel.discord,2,1732566737,1732566739,1732566739.514265,-21600,EB445137-D7F5-57EC-87DA-1DB460D64046,"iPhone13,2"
com.hammerandchisel.discord,5,1732566656,1732566661,1732566662.193342,-21600,EB445137-D7F5-57EC-87DA-1DB460D64046,"iPhone13,2"
com.apple.MobileSMS,4,1732566652,1732566656,1732566656.360637,-21600,EB445137-D7F5-57EC-87DA-1DB460D64046,"iPhone13,2"
com.apple.MobileSMS,6,1732565949,1732565955,1732565956.161933,-21600,EB445137-D7F5-57EC-87DA-1DB460D64046,"iPhone13,2"
com.apple.weather,5,1732565944,1732565949,1732565949.941859,-21600,EB445137-D7F5-57EC-87DA-1DB460D64046,"iPhone13,2"
com.apple.MobileSMS,5,1732565939,1732565944,1732565944.4863749,-21600,EB445137-D7F5-57EC-87DA-1DB460D64046,"iPhone13,2"
com.apple.MobileSMS,8,1732565915,1732565923,1732565923.1795712,-21600,EB445137-D7F5-57EC-87DA-1DB460D64046,"iPhone13,2"
com.apple.MobileSMS,5,1732565897,1732565902,1732565902.972116,-21600,EB445137-D7F5-57EC-87DA-1DB460D64046,"iPhone13,2"
com.apple.MobileSMS,5,1732565787,1732565792,1732565792.332241,-21600,EB445137-D7F5-57EC-87DA-1DB460D64046,"iPhone13,2"
com.apple.MobileSMS,3,1732565757,1732565760,1732565760.940371,-21600,EB445137-D7F5-57EC-87DA-1DB460D64046,"iPhone13,2"
com.hammerandchisel.discord,2,1732565755,1732565757,1732565757.99488,-21600,EB445137-D7F5-57EC-87DA-1DB460D64046,"iPhone13,2"
com.apple.MobileSMS,23,1732565732,1732565755,1732565756.258216,-21600,EB445137-D7F5-57EC-87DA-1DB460D64046,"iPhone13,2"
com.google.Chrome,246,1732565368,1732565614,1732565614.3192391,-21600,,
com.google.Chrome,608,1732564737,1732565345,1732565345.0883532,-21600,,
com.microsoft.Office.Outlook,4,1732564333,1732564337,1732564337.353482,-21600,EB445137-D7F5-57EC-87DA-1DB460D64046,"iPhone13,2"
com.hammerandchisel.discord,10,1732564320,1732564330,1732564330.855379,-21600,EB445137-D7F5-57EC-87DA-1DB460D64046,"iPhone13,2"
com.google.Chrome,303,1732564182,1732564485,1732564485.393279,-21600,,
com.hammerandchisel.discord,14,1732563628,1732563642,1732563642.593971,-21600,EB445137-D7F5-57EC-87DA-1DB460D64046,"iPhone13,2"
com.google.Chrome,313,1732562798,1732563111,1732563111.535676,-21600,,
com.google.Chrome,572,1732562102,1732562674,1732562675.001823,-21600,,
com.apple.findmy,8,1732562094,1732562102,1732562102.9513888,-21600,,
com.google.Chrome,2,1732562092,1732562094,1732562094.283592,-21600,,
com.google.ios.youtube,460,1732561534,1732561994,1732561994.379037,-21600,EB445137-D7F5-57EC-87DA-1DB460D64046,"iPhone13,2"
com.apple.news,502,1732561026,1732561528,1732561529.0167809,-21600,EB445137-D7F5-57EC-87DA-1DB460D64046,"iPhone13,2"
com.hammerandchisel.discord,31,1732560989,1732561020,1732561020.4770598,-21600,EB445137-D7F5-57EC-87DA-1DB460D64046,"iPhone13,2"
com.apple.weather,4,1732557336,1732557340,1732557340.378817,-21600,EB445137-D7F5-57EC-87DA-1DB460D64046,"iPhone13,2"
com.apple.weather,13,1732557230,1732557243,1732557244.706727,-21600,EB445137-D7F5-57EC-87DA-1DB460D64046,"iPhone13,2"
com.apple.findmy,2,1732557228,1732557230,1732557230.3685021,-21600,EB445137-D7F5-57EC-87DA-1DB460D64046,"iPhone13,2"
com.apple.findmy,5,1732556483,1732556488,1732556489.284243,-21600,EB445137-D7F5-57EC-87DA-1DB460D64046,"iPhone13,2"
com.apple.Health,54,1732556419,1732556473,1732556473.875568,-21600,EB445137-D7F5-57EC-87DA-1DB460D64046,"iPhone13,2"
com.apple.MobileSMS,4,1732556395,1732556399,1732556399.0485501,-21600,EB445137-D7F5-57EC-87DA-1DB460D64046,"iPhone13,2"
com.apple.Health,15,1732556380,1732556395,1732556395.2463121,-21600,EB445137-D7F5-57EC-87DA-1DB460D64046,"iPhone13,2"
com.renpho.health,7,1732556373,1732556380,1732556381.518279,-21600,EB445137-D7F5-57EC-87DA-1DB460D64046,"iPhone13,2"
com.google.Chrome,150,1732556243,1732556393,1732556394.405462,-21600,,
com.leomehlig.today,57,1732556186,1732556243,1732556243.126439,-21600,,
com.google.Chrome,150,1732556036,1732556186,1732556186.86039,-21600,,
com.leomehlig.today,27,1732555884,1732555911,1732555911.240148,-21600,,
com.google.Chrome,6,1732555878,1732555884,1732555884.788961,-21600,,
com.apple.MobileSMS,21,1732555857,1732555878,1732555878.4964662,-21600,,
com.renpho.health,10,1732555808,1732555818,1732555818.163935,-21600,EB445137-D7F5-57EC-87DA-1DB460D64046,"iPhone13,2"
com.google.Chrome,577,1732555280,1732555857,1732555857.576163,-21600,,
com.apple.finder,12,1732555268,1732555280,1732555280.449582,-21600,,
com.apple.camera,122,1732555215,1732555337,1732555337.615705,-21600,EB445137-D7F5-57EC-87DA-1DB460D64046,"iPhone13,2"
com.renpho.health,124,1732555213,1732555337,1732555337.599282,-21600,EB445137-D7F5-57EC-87DA-1DB460D64046,"iPhone13,2"
com.google.Chrome,1353,1732553915,1732555268,1732555268.285001,-21600,,
com.renpho.health,10,1732553335,1732553345,1732553345.1447191,-21600,EB445137-D7F5-57EC-87DA-1DB460D64046,"iPhone13,2"
com.renpho.health,4,1732553327,1732553331,1732553331.896126,-21600,EB445137-D7F5-57EC-87DA-1DB460D64046,"iPhone13,2"
com.renpho.health,38,1732553243,1732553281,1732553281.9262161,-21600,EB445137-D7F5-57EC-87DA-1DB460D64046,"iPhone13,2"
com.google.ios.youtube,158,1732551596,1732551754,1732551754.3423061,-21600,EB445137-D7F5-57EC-87DA-1DB460D64046,"iPhone13,2"
com.google.chrome.ios,2,1732551594,1732551596,1732551597.476795,-21600,EB445137-D7F5-57EC-87DA-1DB460D64046,"iPhone13,2"
com.google.ios.youtube,1480,1732550114,1732551594,1732551595.0962749,-21600,EB445137-D7F5-57EC-87DA-1DB460D64046,"iPhone13,2"
com.apple.findmy,14,1732550082,1732550096,1732550097.060838,-21600,EB445137-D7F5-57EC-87DA-1DB460D64046,"iPhone13,2"
com.apple.news,18,1732550064,1732550082,1732550082.792231,-21600,EB445137-D7F5-57EC-87DA-1DB460D64046,"iPhone13,2"
com.apple.news,12,1732547407,1732547419,1732547419.812952,-21600,EB445137-D7F5-57EC-87DA-1DB460D64046,"iPhone13,2"
com.apple.news,16,1732544701,1732544717,1732544718.018508,-21600,EB445137-D7F5-57EC-87DA-1DB460D64046,"iPhone13,2"
com.apple.news,13,1732514348,1732514361,1732514361.4477448,-21600,EB445137-D7F5-57EC-87DA-1DB460D64046,"iPhone13,2"
com.apple.news,6,1732514339,1732514345,1732514345.946093,-21600,EB445137-D7F5-57EC-87DA-1DB460D64046,"iPhone13,2"
com.apple.news,11,1732514283,1732514294,1732514294.607183,-21600,EB445137-D7F5-57EC-87DA-1DB460D64046,"iPhone13,2"
com.apple.camera,1,1732514283,1732514284,1732514284.315804,-21600,EB445137-D7F5-57EC-87DA-1DB460D64046,"iPhone13,2"
com.apple.news,91,1732513336,1732513427,1732513427.78011,-21600,EB445137-D7F5-57EC-87DA-1DB460D64046,"iPhone13,2"
com.apple.news,61,1732512659,1732512720,1732512720.947078,-21600,EB445137-D7F5-57EC-87DA-1DB460D64046,"iPhone13,2"
com.google.chrome.ios,3,1732512656,1732512659,1732512659.561355,-21600,EB445137-D7F5-57EC-87DA-1DB460D64046,"iPhone13,2"
com.apple.findmy,6,1732512276,1732512282,1732512283.5948958,-21600,EB445137-D7F5-57EC-87DA-1DB460D64046,"iPhone13,2"
com.apple.news,2,1732512269,1732512271,1732512271.6186461,-21600,EB445137-D7F5-57EC-87DA-1DB460D64046,"iPhone13,2"
com.apple.news,62,1732511858,1732511920,1732511920.4547129,-21600,EB445137-D7F5-57EC-87DA-1DB460D64046,"iPhone13,2"
com.apple.news,93,1732511176,1732511269,1732511269.781855,-21600,EB445137-D7F5-57EC-87DA-1DB460D64046,"iPhone13,2"
com.apple.news,4,1732510688,1732510692,1732510692.262315,-21600,EB445137-D7F5-57EC-87DA-1DB460D64046,"iPhone13,2"
com.apple.news,4,1732509900,1732509904,1732509904.055462,-21600,EB445137-D7F5-57EC-87DA-1DB460D64046,"iPhone13,2"
com.apple.news,74,1732509663,1732509737,1732509738.0154161,-21600,EB445137-D7F5-57EC-87DA-1DB460D64046,"iPhone13,2"
com.google.chrome.ios,14,1732509635,1732509649,1732509649.637742,-21600,EB445137-D7F5-57EC-87DA-1DB460D64046,"iPhone13,2"
com.apple.camera,1,1732509610,1732509611,1732509611.1725059,-21600,EB445137-D7F5-57EC-87DA-1DB460D64046,"iPhone13,2"
com.google.chrome.ios,36,1732509335,1732509371,1732509371.8804421,-21600,EB445137-D7F5-57EC-87DA-1DB460D64046,"iPhone13,2"
com.apple.news,3,1732509331,1732509334,1732509334.818615,-21600,EB445137-D7F5-57EC-87DA-1DB460D64046,"iPhone13,2"
com.apple.camera,0,1732509331,1732509331,1732509331.7159982,-21600,EB445137-D7F5-57EC-87DA-1DB460D64046,"iPhone13,2"
com.apple.news,59,1732508850,1732508909,1732508909.8561149,-21600,EB445137-D7F5-57EC-87DA-1DB460D64046,"iPhone13,2"
com.apple.news,74,1732508118,1732508192,1732508192.50049,-21600,EB445137-D7F5-57EC-87DA-1DB460D64046,"iPhone13,2"
com.apple.camera,1,1732508075,1732508076,1732508076.719126,-21600,EB445137-D7F5-57EC-87DA-1DB460D64046,"iPhone13,2"
com.apple.camera,1,1732508073,1732508074,1732508074.175188,-21600,EB445137-D7F5-57EC-87DA-1DB460D64046,"iPhone13,2"
com.apple.news,33,1732508059,1732508092,1732508092.903696,-21600,EB445137-D7F5-57EC-87DA-1DB460D64046,"iPhone13,2"
com.apple.news,5,1732507813,1732507818,1732507818.177702,-21600,EB445137-D7F5-57EC-87DA-1DB460D64046,"iPhone13,2"
com.apple.camera,6,1732507739,1732507745,1732507745.308902,-21600,EB445137-D7F5-57EC-87DA-1DB460D64046,"iPhone13,2"
com.apple.news,8,1732507738,1732507746,1732507746.5149112,-21600,EB445137-D7F5-57EC-87DA-1DB460D64046,"iPhone13,2"
com.apple.news,57,1732507421,1732507478,1732507478.974814,-21600,EB445137-D7F5-57EC-87DA-1DB460D64046,"iPhone13,2"
com.google.Chrome,649,1732505754,1732506403,1732506403.686621,-21600,,
com.apple.findmy,8,1732505638,1732505646,1732505646.160174,-21600,EB445137-D7F5-57EC-87DA-1DB460D64046,"iPhone13,2"
com.apple.news,4,1732505628,1732505632,1732505633.01,-21600,EB445137-D7F5-57EC-87DA-1DB460D64046,"iPhone13,2"
com.apple.news,451,1732505176,1732505627,1732505627.69438,-21600,EB445137-D7F5-57EC-87DA-1DB460D64046,"iPhone13,2"
com.robinhood.release.Robinhood,36,1732505036,1732505072,1732505072.163422,-21600,EB445137-D7F5-57EC-87DA-1DB460D64046,"iPhone13,2"
com.instructure.icanvas,7,1732505020,1732505027,1732505027.686132,-21600,EB445137-D7F5-57EC-87DA-1DB460D64046,"iPhone13,2"
com.google.chrome.ios,77,1732504924,1732505001,1732505001.258936,-21600,EB445137-D7F5-57EC-87DA-1DB460D64046,"iPhone13,2"
com.hammerandchisel.discord,26,1732504891,1732504917,1732504917.9234,-21600,EB445137-D7F5-57EC-87DA-1DB460D64046,"iPhone13,2"
com.thestorygraph.thestorygraph,4,1732504841,1732504845,1732504846.011606,-21600,EB445137-D7F5-57EC-87DA-1DB460D64046,"iPhone13,2"
com.hammerandchisel.discord,5,1732504822,1732504827,1732504827.207943,-21600,EB445137-D7F5-57EC-87DA-1DB460D64046,"iPhone13,2"
com.hammerandchisel.discord,12,1732504792,1732504804,1732504804.012969,-21600,EB445137-D7F5-57EC-87DA-1DB460D64046,"iPhone13,2"
com.renpho.health,3,1732504782,1732504785,1732504785.2394009,-21600,EB445137-D7F5-57EC-87DA-1DB460D64046,"iPhone13,2"
com.apple.findmy,4,1732504695,1732504699,1732504699.8940148,-21600,EB445137-D7F5-57EC-87DA-1DB460D64046,"iPhone13,2"
org.name.serializdmobile,251,1732503926,1732504177,1732504177.238714,-21600,EB445137-D7F5-57EC-87DA-1DB460D64046,"iPhone13,2"
com.google.Chrome,644,1732503574,1732504218,1732504218.5722651,-21600,,
com.hammerandchisel.discord,12,1732503371,1732503383,1732503383.336941,-21600,EB445137-D7F5-57EC-87DA-1DB460D64046,"iPhone13,2"
com.hammerandchisel.discord,13,1732502813,1732502826,1732502826.664906,-21600,EB445137-D7F5-57EC-87DA-1DB460D64046,"iPhone13,2"
com.microsoft.Office.Outlook,21,1732502568,1732502589,1732502589.224482,-21600,EB445137-D7F5-57EC-87DA-1DB460D64046,"iPhone13,2"
com.google.Chrome,313,1732502472,1732502785,1732502785.167583,-21600,,
com.hammerandchisel.discord,3,1732502359,1732502362,1732502362.298008,-21600,EB445137-D7F5-57EC-87DA-1DB460D64046,"iPhone13,2"
com.apple.findmy,6,1732502114,1732502120,1732502120.560868,-21600,EB445137-D7F5-57EC-87DA-1DB460D64046,"iPhone13,2"
com.hammerandchisel.discord,14,1732502093,1732502107,1732502107.506007,-21600,EB445137-D7F5-57EC-87DA-1DB460D64046,"iPhone13,2"
com.google.Chrome,612,1732501771,1732502383,1732502383.3484159,-21600,,
com.google.Chrome,349,1732500978,1732501327,1732501327.187906,-21600,,
com.apple.MobileSMS,6,1732500972,1732500978,1732500978.1122031,-21600,,
com.google.Chrome,436,1732500536,1732500972,1732500972.813816,-21600,,
com.apple.MobileSMS,5,1732500531,1732500536,1732500536.982841,-21600,,
com.google.Chrome,3,1732500528,1732500531,1732500531.66044,-21600,,
com.google.Chrome,310,1732500086,1732500396,1732500396.568297,-21600,,
com.google.Chrome,420,1732499504,1732499924,1732499924.705039,-21600,,
com.apple.news,118,1732499200,1732499318,1732499318.9953299,-21600,EB445137-D7F5-57EC-87DA-1DB460D64046,"iPhone13,2"
com.google.chrome.ios,57,1732499143,1732499200,1732499201.258998,-21600,EB445137-D7F5-57EC-87DA-1DB460D64046,"iPhone13,2"
com.hammerandchisel.discord,3,1732499140,1732499143,1732499144.290814,-21600,EB445137-D7F5-57EC-87DA-1DB460D64046,"iPhone13,2"
com.google.chrome.ios,2,1732499138,1732499140,1732499141.095053,-21600,EB445137-D7F5-57EC-87DA-1DB460D64046,"iPhone13,2"
com.apple.news,140,1732498997,1732499137,1732499137.8670568,-21600,EB445137-D7F5-57EC-87DA-1DB460D64046,"iPhone13,2"
com.hammerandchisel.discord,25,1732498965,1732498990,1732498990.740473,-21600,EB445137-D7F5-57EC-87DA-1DB460D64046,"iPhone13,2"
com.apple.MobileSMS,18,1732498941,1732498959,1732498959.6352658,-21600,EB445137-D7F5-57EC-87DA-1DB460D64046,"iPhone13,2"
com.clairmail.fth.client,8,1732498933,1732498941,1732498941.694155,-21600,EB445137-D7F5-57EC-87DA-1DB460D64046,"iPhone13,2"
com.clairmail.fth.client,36,1732498897,1732498933,1732498933.579496,-21600,EB445137-D7F5-57EC-87DA-1DB460D64046,"iPhone13,2"
com.apple.MobileSMS,6,1732498890,1732498896,1732498896.9324121,-21600,EB445137-D7F5-57EC-87DA-1DB460D64046,"iPhone13,2"
com.hammerandchisel.discord,8,1732498882,1732498890,1732498890.522234,-21600,EB445137-D7F5-57EC-87DA-1DB460D64046,"iPhone13,2"
com.apple.MobileSMS,10,1732498872,1732498882,1732498882.20688,-21600,EB445137-D7F5-57EC-87DA-1DB460D64046,"iPhone13,2"
com.hammerandchisel.discord,33,1732498837,1732498870,1732498870.7764502,-21600,EB445137-D7F5-57EC-87DA-1DB460D64046,"iPhone13,2"
com.burbn.instagram,42,1732498795,1732498837,1732498837.869288,-21600,EB445137-D7F5-57EC-87DA-1DB460D64046,"iPhone13,2"
com.hammerandchisel.discord,8,1732498785,1732498793,1732498793.7121449,-21600,EB445137-D7F5-57EC-87DA-1DB460D64046,"iPhone13,2"
com.apple.MobileSMS,2,1732498783,1732498785,1732498785.337702,-21600,EB445137-D7F5-57EC-87DA-1DB460D64046,"iPhone13,2"
com.hammerandchisel.discord,5,1732498778,1732498783,1732498784.0065799,-21600,EB445137-D7F5-57EC-87DA-1DB460D64046,"iPhone13,2"
com.apple.MobileSMS,8,1732498770,1732498778,1732498778.1339002,-21600,EB445137-D7F5-57EC-87DA-1DB460D64046,"iPhone13,2"
com.apple.MobileSMS,209,1732498561,1732498770,1732498770.4678168,-21600,EB445137-D7F5-57EC-87DA-1DB460D64046,"iPhone13,2"
com.apple.MobileSMS,129,1732498427,1732498556,1732498556.5582008,-21600,EB445137-D7F5-57EC-87DA-1DB460D64046,"iPhone13,2"
com.apple.findmy,17,1732498410,1732498427,1732498427.734631,-21600,EB445137-D7F5-57EC-87DA-1DB460D64046,"iPhone13,2"
com.apple.news,381,1732498027,1732498408,1732498408.3325171,-21600,EB445137-D7F5-57EC-87DA-1DB460D64046,"iPhone13,2"
com.apple.news,2,1732498024,1732498026,1732498026.663959,-21600,EB445137-D7F5-57EC-87DA-1DB460D64046,"iPhone13,2"
com.apple.findmy,13,1732497981,1732497994,1732497994.4362059,-21600,EB445137-D7F5-57EC-87DA-1DB460D64046,"iPhone13,2"
com.apple.MobileSMS,25,1732497875,1732497900,1732497901.050951,-21600,EB445137-D7F5-57EC-87DA-1DB460D64046,"iPhone13,2"
com.apple.findmy,3,1732497872,1732497875,1732497875.909754,-21600,EB445137-D7F5-57EC-87DA-1DB460D64046,"iPhone13,2"
com.apple.findmy,7,1732497794,1732497801,1732497801.3277779,-21600,EB445137-D7F5-57EC-87DA-1DB460D64046,"iPhone13,2"
com.google.Gmail,25,1732497769,1732497794,1732497795.012008,-21600,EB445137-D7F5-57EC-87DA-1DB460D64046,"iPhone13,2"
com.google.chrome.ios,4,1732497765,1732497769,1732497769.8479,-21600,EB445137-D7F5-57EC-87DA-1DB460D64046,"iPhone13,2"
com.google.chrome.ios,5,1732497739,1732497744,1732497744.819762,-21600,EB445137-D7F5-57EC-87DA-1DB460D64046,"iPhone13,2"
com.google.chrome.ios,151,1732497587,1732497738,1732497738.575077,-21600,EB445137-D7F5-57EC-87DA-1DB460D64046,"iPhone13,2"
com.google.chrome.ios,65,1732497518,1732497583,1732497584.444937,-21600,EB445137-D7F5-57EC-87DA-1DB460D64046,"iPhone13,2"
com.google.Gmail,5,1732497513,1732497518,1732497518.632257,-21600,EB445137-D7F5-57EC-87DA-1DB460D64046,"iPhone13,2"
com.google.chrome.ios,60,1732497449,1732497509,1732497509.510031,-21600,EB445137-D7F5-57EC-87DA-1DB460D64046,"iPhone13,2"
com.google.Gmail,17,1732497432,1732497449,1732497449.9958181,-21600,EB445137-D7F5-57EC-87DA-1DB460D64046,"iPhone13,2"
com.apple.findmy,2,1732497429,1732497431,1732497431.921907,-21600,EB445137-D7F5-57EC-87DA-1DB460D64046,"iPhone13,2"
com.apple.findmy,6,1732495807,1732495813,1732495813.358438,-21600,EB445137-D7F5-57EC-87DA-1DB460D64046,"iPhone13,2"
com.apple.findmy,2,1732495804,1732495806,1732495806.9429479,-21600,EB445137-D7F5-57EC-87DA-1DB460D64046,"iPhone13,2"
com.hammerandchisel.discord,6,1732495796,1732495802,1732495802.113857,-21600,EB445137-D7F5-57EC-87DA-1DB460D64046,"iPhone13,2"
com.google.chrome.ios,3,1732495793,1732495796,1732495796.884702,-21600,EB445137-D7F5-57EC-87DA-1DB460D64046,"iPhone13,2"
com.google.chrome.ios,4,1732495543,1732495547,1732495547.5923991,-21600,EB445137-D7F5-57EC-87DA-1DB460D64046,"iPhone13,2"
com.google.chrome.ios,12,1732494409,1732494421,1732494421.4349608,-21600,EB445137-D7F5-57EC-87DA-1DB460D64046,"iPhone13,2"
com.google.chrome.ios,39,1732494366,1732494405,1732494406.449812,-21600,EB445137-D7F5-57EC-87DA-1DB460D64046,"iPhone13,2"
com.apple.camera,1293,1732486168,1732487461,1732487462.066386,-21600,EB445137-D7F5-57EC-87DA-1DB460D64046,"iPhone13,2"
com.apple.findmy,23,1732485189,1732485212,1732485212.73483,-21600,EB445137-D7F5-57EC-87DA-1DB460D64046,"iPhone13,2"
com.google.Chrome,286,1732485167,1732485453,1732485453.3695378,-21600,,
com.google.Chrome,361,1732484794,1732485155,1732485155.585555,-21600,,
com.apple.Music,6,1732484449,1732484455,1732484455.39887,-21600,EB445137-D7F5-57EC-87DA-1DB460D64046,"iPhone13,2"
com.google.Chrome,309,1732484433,1732484742,1732484742.886709,-21600,,
com.google.Chrome,376,1732483974,1732484350,1732484350.807909,-21600,,
com.google.Chrome,569,1732483405,1732483974,1732483974.471626,-21600,,
com.google.Chrome,505,1732482663,1732483168,1732483168.868078,-21600,,
com.google.Chrome,306,1732482232,1732482538,1732482538.89412,-21600,,
com.google.Chrome,353,1732481532,1732481885,1732481886.001178,-21600,,
com.apple.Music,2,1732481216,1732481218,1732481218.864345,-21600,EB445137-D7F5-57EC-87DA-1DB460D64046,"iPhone13,2"
com.apple.Music,4,1732477888,1732477892,1732477892.696749,-21600,EB445137-D7F5-57EC-87DA-1DB460D64046,"iPhone13,2"
com.apple.Music,6,1732476018,1732476024,1732476024.4145222,-21600,EB445137-D7F5-57EC-87DA-1DB460D64046,"iPhone13,2"
com.apple.Music,6,1732473077,1732473083,1732473083.2116919,-21600,EB445137-D7F5-57EC-87DA-1DB460D64046,"iPhone13,2"
com.apple.Music,2,1732473066,1732473068,1732473068.4769158,-21600,EB445137-D7F5-57EC-87DA-1DB460D64046,"iPhone13,2"
com.apple.Music,8,1732471976,1732471984,1732471985.467945,-21600,EB445137-D7F5-57EC-87DA-1DB460D64046,"iPhone13,2"
com.apple.AppStore,2,1732471973,1732471975,1732471975.468972,-21600,EB445137-D7F5-57EC-87DA-1DB460D64046,"iPhone13,2"
com.apple.AppStore,53,1732471804,1732471857,1732471858.191248,-21600,EB445137-D7F5-57EC-87DA-1DB460D64046,"iPhone13,2"
com.google.chrome.ios,2,1732471786,1732471788,1732471788.401835,-21600,EB445137-D7F5-57EC-87DA-1DB460D64046,"iPhone13,2"
com.apple.MobileSMS,111,1732470640,1732470751,1732470751.935831,-21600,EB445137-D7F5-57EC-87DA-1DB460D64046,"iPhone13,2"
com.apple.news,67,1732469308,1732469375,1732469375.244677,-21600,EB445137-D7F5-57EC-87DA-1DB460D64046,"iPhone13,2"
com.apple.Health,9,1732469293,1732469302,1732469302.292601,-21600,EB445137-D7F5-57EC-87DA-1DB460D64046,"iPhone13,2"
com.apple.findmy,110,1732469045,1732469155,1732469155.0766191,-21600,EB445137-D7F5-57EC-87DA-1DB460D64046,"iPhone13,2"
com.apple.InCallService,407,1732468602,1732469009,1732469009.285512,-21600,EB445137-D7F5-57EC-87DA-1DB460D64046,"iPhone13,2"
com.burbn.instagram,122,1732468480,1732468602,1732468603.1289968,-21600,EB445137-D7F5-57EC-87DA-1DB460D64046,"iPhone13,2"
com.hammerandchisel.discord,3,1732468474,1732468477,1732468477.8208551,-21600,EB445137-D7F5-57EC-87DA-1DB460D64046,"iPhone13,2"
com.apple.reminders,6,1732468462,1732468468,1732468468.398565,-21600,EB445137-D7F5-57EC-87DA-1DB460D64046,"iPhone13,2"
com.apple.MobileSMS,74,1732468364,1732468438,1732468438.5379438,-21600,EB445137-D7F5-57EC-87DA-1DB460D64046,"iPhone13,2"
com.apple.weather,9,1732468355,1732468364,1732468365.143584,-21600,EB445137-D7F5-57EC-87DA-1DB460D64046,"iPhone13,2"
com.apple.weather,8,1732467054,1732467062,1732467062.36806,-21600,EB445137-D7F5-57EC-87DA-1DB460D64046,"iPhone13,2"
com.google.chrome.ios,61,1732466972,1732467033,1732467033.316457,-21600,EB445137-D7F5-57EC-87DA-1DB460D64046,"iPhone13,2"
com.renpho.health,3,1732466969,1732466972,1732466972.2022362,-21600,EB445137-D7F5-57EC-87DA-1DB460D64046,"iPhone13,2"
com.renpho.health,31,1732466925,1732466956,1732466956.151968,-21600,EB445137-D7F5-57EC-87DA-1DB460D64046,"iPhone13,2"
com.google.ios.youtube,1129,1732464716,1732465845,1732465845.6226501,-21600,EB445137-D7F5-57EC-87DA-1DB460D64046,"iPhone13,2"
com.apple.findmy,10,1732464703,1732464713,1732464713.8686519,-21600,EB445137-D7F5-57EC-87DA-1DB460D64046,"iPhone13,2"
com.apple.MobileSMS,12,1732464673,1732464685,1732464685.545199,-21600,EB445137-D7F5-57EC-87DA-1DB460D64046,"iPhone13,2"
com.google.ios.youtube,636,1732464035,1732464671,1732464671.80681,-21600,EB445137-D7F5-57EC-87DA-1DB460D64046,"iPhone13,2"
com.apple.mobiletimer,19,1732464001,1732464020,1732464020.7603211,-21600,EB445137-D7F5-57EC-87DA-1DB460D64046,"iPhone13,2"
com.apple.mobiletimer,9,1732462783,1732462792,1732462792.465939,-21600,EB445137-D7F5-57EC-87DA-1DB460D64046,"iPhone13,2"
com.apple.mobiletimer,29,1732462752,1732462781,1732462782.1573749,-21600,EB445137-D7F5-57EC-87DA-1DB460D64046,"iPhone13,2"
com.apple.mobiletimer,21,1732462201,1732462222,1732462222.328051,-21600,EB445137-D7F5-57EC-87DA-1DB460D64046,"iPhone13,2"
com.apple.mobiletimer,8,1732460792,1732460800,1732460800.709134,-21600,EB445137-D7F5-57EC-87DA-1DB460D64046,"iPhone13,2"
com.apple.mobiletimer,5,1732460784,1732460789,1732460789.747779,-21600,EB445137-D7F5-57EC-87DA-1DB460D64046,"iPhone13,2"
com.google.Chrome,28,1732431774,1732431802,1732431802.865581,-21600,,
com.google.Chrome,300,1732430868,1732431168,1732431168.338822,-21600,,
com.google.Chrome,1017,1732429757,1732430774,1732430774.7575831,-21600,,
com.google.Chrome,993,1732428476,1732429469,1732429469.765324,-21600,,
com.leomehlig.today,2,1732428434,1732428436,1732428436.133625,-21600,,
com.toyopagroup.picaboo,11,1732425452,1732425463,1732425463.55939,-21600,EB445137-D7F5-57EC-87DA-1DB460D64046,"iPhone13,2"
com.toyopagroup.picaboo,6,1732419207,1732419213,1732419213.032378,-21600,EB445137-D7F5-57EC-87DA-1DB460D64046,"iPhone13,2"
com.toyopagroup.picaboo,19,1732418313,1732418332,1732418332.9750152,-21600,EB445137-D7F5-57EC-87DA-1DB460D64046,"iPhone13,2"
com.toyopagroup.picaboo,4,1732416814,1732416818,1732416819.067844,-21600,EB445137-D7F5-57EC-87DA-1DB460D64046,"iPhone13,2"
com.toyopagroup.picaboo,18,1732415620,1732415638,1732415638.7091541,-21600,EB445137-D7F5-57EC-87DA-1DB460D64046,"iPhone13,2"
com.apple.camera,0,1732414683,1732414683,1732414683.735886,-21600,EB445137-D7F5-57EC-87DA-1DB460D64046,"iPhone13,2"
com.toyopagroup.picaboo,11,1732414650,1732414661,1732414661.101291,-21600,EB445137-D7F5-57EC-87DA-1DB460D64046,"iPhone13,2"
com.toyopagroup.picaboo,7,1732414632,1732414639,1732414639.376282,-21600,EB445137-D7F5-57EC-87DA-1DB460D64046,"iPhone13,2"
com.apple.camera,2,1732414600,1732414602,1732414602.916168,-21600,EB445137-D7F5-57EC-87DA-1DB460D64046,"iPhone13,2"
com.apple.Maps,39,1732414557,1732414596,1732414597.214034,-21600,EB445137-D7F5-57EC-87DA-1DB460D64046,"iPhone13,2"
com.apple.MobileSMS,3,1732414553,1732414556,1732414556.488899,-21600,EB445137-D7F5-57EC-87DA-1DB460D64046,"iPhone13,2"
com.apple.MobileSMS,3,1732414401,1732414404,1732414404.312002,-21600,EB445137-D7F5-57EC-87DA-1DB460D64046,"iPhone13,2"
com.hammerandchisel.discord,12,1732414386,1732414398,1732414398.169711,-21600,EB445137-D7F5-57EC-87DA-1DB460D64046,"iPhone13,2"
com.apple.findmy,5,1732414381,1732414386,1732414386.496155,-21600,EB445137-D7F5-57EC-87DA-1DB460D64046,"iPhone13,2"
com.apple.findmy,3,1732413937,1732413940,1732413940.767467,-21600,EB445137-D7F5-57EC-87DA-1DB460D64046,"iPhone13,2"
com.apple.findmy,62,1732413813,1732413875,1732413876.2928529,-21600,EB445137-D7F5-57EC-87DA-1DB460D64046,"iPhone13,2"
com.apple.findmy,6,1732413778,1732413784,1732413784.713989,-21600,EB445137-D7F5-57EC-87DA-1DB460D64046,"iPhone13,2"
com.apple.findmy,1,1732413774,1732413775,1732413775.430019,-21600,EB445137-D7F5-57EC-87DA-1DB460D64046,"iPhone13,2"
com.apple.findmy,84,1732413624,1732413708,1732413708.906406,-21600,EB445137-D7F5-57EC-87DA-1DB460D64046,"iPhone13,2"
com.apple.MobileSMS,8,1732413343,1732413351,1732413351.415794,-21600,EB445137-D7F5-57EC-87DA-1DB460D64046,"iPhone13,2"
com.apple.findmy,6,1732413337,1732413343,1732413344.156413,-21600,EB445137-D7F5-57EC-87DA-1DB460D64046,"iPhone13,2"
com.apple.findmy,6,1732413310,1732413316,1732413316.18681,-21600,EB445137-D7F5-57EC-87DA-1DB460D64046,"iPhone13,2"
com.apple.findmy,7,1732413256,1732413263,1732413264.240254,-21600,EB445137-D7F5-57EC-87DA-1DB460D64046,"iPhone13,2"
com.hammerandchisel.discord,43,1732413194,1732413237,1732413237.144592,-21600,EB445137-D7F5-57EC-87DA-1DB460D64046,"iPhone13,2"
com.toyopagroup.picaboo,3,1732413188,1732413191,1732413191.825818,-21600,EB445137-D7F5-57EC-87DA-1DB460D64046,"iPhone13,2"
com.apple.MobileSMS,5,1732413183,1732413188,1732413188.326055,-21600,EB445137-D7F5-57EC-87DA-1DB460D64046,"iPhone13,2"
com.apple.MobileSMS,1,1732413004,1732413005,1732413005.799199,-21600,EB445137-D7F5-57EC-87DA-1DB460D64046,"iPhone13,2"
com.apple.MobileSMS,3,1732412701,1732412704,1732412704.522922,-21600,EB445137-D7F5-57EC-87DA-1DB460D64046,"iPhone13,2"
com.apple.MobileSMS,37,1732412655,1732412692,1732412692.730554,-21600,EB445137-D7F5-57EC-87DA-1DB460D64046,"iPhone13,2"
com.toyopagroup.picaboo,2,1732412652,1732412654,1732412655.2105188,-21600,EB445137-D7F5-57EC-87DA-1DB460D64046,"iPhone13,2"
com.toyopagroup.picaboo,34,1732412615,1732412649,1732412649.403689,-21600,EB445137-D7F5-57EC-87DA-1DB460D64046,"iPhone13,2"
com.apple.MobileSMS,26,1732412589,1732412615,1732412615.984093,-21600,EB445137-D7F5-57EC-87DA-1DB460D64046,"iPhone13,2"
com.toyopagroup.picaboo,31,1732412558,1732412589,1732412589.944193,-21600,EB445137-D7F5-57EC-87DA-1DB460D64046,"iPhone13,2"
com.hammerandchisel.discord,15,1732412538,1732412553,1732412553.7465181,-21600,EB445137-D7F5-57EC-87DA-1DB460D64046,"iPhone13,2"
com.toyopagroup.picaboo,26,1732411598,1732411624,1732411624.405484,-21600,EB445137-D7F5-57EC-87DA-1DB460D64046,"iPhone13,2"
com.apple.findmy,6,1732410103,1732410109,1732410109.229218,-21600,EB445137-D7F5-57EC-87DA-1DB460D64046,"iPhone13,2"
com.apple.MobileSMS,9,1732410093,1732410102,1732410102.65245,-21600,EB445137-D7F5-57EC-87DA-1DB460D64046,"iPhone13,2"
com.apple.MobileSMS,4,1732409510,1732409514,1732409514.053108,-21600,EB445137-D7F5-57EC-87DA-1DB460D64046,"iPhone13,2"
com.apple.MobileSMS,2,1732408340,1732408342,1732408342.385375,-21600,EB445137-D7F5-57EC-87DA-1DB460D64046,"iPhone13,2"
com.apple.MobileSMS,8,1732407844,1732407852,1732407852.2112079,-21600,EB445137-D7F5-57EC-87DA-1DB460D64046,"iPhone13,2"
com.apple.MobileSMS,22,1732407636,1732407658,1732407658.677425,-21600,EB445137-D7F5-57EC-87DA-1DB460D64046,"iPhone13,2"
com.apple.MobileSMS,7,1732407557,1732407564,1732407564.942062,-21600,EB445137-D7F5-57EC-87DA-1DB460D64046,"iPhone13,2"
com.apple.MobileSMS,61,1732407094,1732407155,1732407155.558439,-21600,EB445137-D7F5-57EC-87DA-1DB460D64046,"iPhone13,2"
com.apple.MobileSMS,5,1732407085,1732407090,1732407090.4103432,-21600,EB445137-D7F5-57EC-87DA-1DB460D64046,"iPhone13,2"
com.apple.MobileSMS,3,1732406560,1732406563,1732406563.7101312,-21600,EB445137-D7F5-57EC-87DA-1DB460D64046,"iPhone13,2"
com.google.chrome.ios,105,1732406382,1732406487,1732406487.4589329,-21600,EB445137-D7F5-57EC-87DA-1DB460D64046,"iPhone13,2"
com.clairmail.fth.client,1,1732406133,1732406134,1732406134.747572,-21600,EB445137-D7F5-57EC-87DA-1DB460D64046,"iPhone13,2"
com.apple.MobileSMS,19,1732406083,1732406102,1732406102.462493,-21600,EB445137-D7F5-57EC-87DA-1DB460D64046,"iPhone13,2"
com.apple.mobilecal,2,1732406081,1732406083,1732406084.42871,-21600,EB445137-D7F5-57EC-87DA-1DB460D64046,"iPhone13,2"
com.apple.mobilecal,8,1732403432,1732403440,1732403440.964298,-21600,EB445137-D7F5-57EC-87DA-1DB460D64046,"iPhone13,2"
com.apple.MobileSMS,12,1732402964,1732402976,1732402976.526348,-21600,EB445137-D7F5-57EC-87DA-1DB460D64046,"iPhone13,2"
com.apple.MobileSMS,19,1732399294,1732399313,1732399313.883631,-21600,EB445137-D7F5-57EC-87DA-1DB460D64046,"iPhone13,2"
com.apple.MobileSMS,35,1732399245,1732399280,1732399280.19165,-21600,EB445137-D7F5-57EC-87DA-1DB460D64046,"iPhone13,2"
com.apple.MobileSMS,15,1732399228,1732399243,1732399243.174099,-21600,EB445137-D7F5-57EC-87DA-1DB460D64046,"iPhone13,2"
com.apple.MobileSMS,2,1732399220,1732399222,1732399222.646193,-21600,EB445137-D7F5-57EC-87DA-1DB460D64046,"iPhone13,2"
com.apple.MobileSMS,3,1732399205,1732399208,1732399208.494053,-21600,EB445137-D7F5-57EC-87DA-1DB460D64046,"iPhone13,2"
com.apple.MobileSMS,38,1732399166,1732399204,1732399204.506734,-21600,EB445137-D7F5-57EC-87DA-1DB460D64046,"iPhone13,2"
com.google.chrome.ios,1,1732399165,1732399166,1732399167.099244,-21600,EB445137-D7F5-57EC-87DA-1DB460D64046,"iPhone13,2"
com.google.chrome.ios,114,1732399007,1732399121,1732399121.7576199,-21600,EB445137-D7F5-57EC-87DA-1DB460D64046,"iPhone13,2"
com.google.chrome.ios,149,1732398825,1732398974,1732398974.9388452,-21600,EB445137-D7F5-57EC-87DA-1DB460D64046,"iPhone13,2"
com.amazon.Amazon,31,1732398794,1732398825,1732398825.368371,-21600,EB445137-D7F5-57EC-87DA-1DB460D64046,"iPhone13,2"
com.apple.MobileSMS,2,1732398790,1732398792,1732398792.730802,-21600,EB445137-D7F5-57EC-87DA-1DB460D64046,"iPhone13,2"
com.apple.MobileSMS,41,1732398724,1732398765,1732398765.490648,-21600,EB445137-D7F5-57EC-87DA-1DB460D64046,"iPhone13,2"
com.apple.MobileSMS,15,1732398675,1732398690,1732398691.0072951,-21600,EB445137-D7F5-57EC-87DA-1DB460D64046,"iPhone13,2"
com.apple.MobileSMS,33,1732398597,1732398630,1732398631.0045738,-21600,EB445137-D7F5-57EC-87DA-1DB460D64046,"iPhone13,2"
com.apple.MobileSMS,77,1732398507,1732398584,1732398584.138962,-21600,EB445137-D7F5-57EC-87DA-1DB460D64046,"iPhone13,2"
com.apple.news,2,1732398505,1732398507,1732398507.93709,-21600,EB445137-D7F5-57EC-87DA-1DB460D64046,"iPhone13,2"
com.apple.news,6,1732398271,1732398277,1732398277.965788,-21600,EB445137-D7F5-57EC-87DA-1DB460D64046,"iPhone13,2"
com.apple.news,156,1732398091,1732398247,1732398248.057451,-21600,EB445137-D7F5-57EC-87DA-1DB460D64046,"iPhone13,2"
com.hammerandchisel.discord,10,1732398061,1732398071,1732398071.068583,-21600,EB445137-D7F5-57EC-87DA-1DB460D64046,"iPhone13,2"
com.apple.MobileSMS,3,1732398051,1732398054,1732398054.265847,-21600,EB445137-D7F5-57EC-87DA-1DB460D64046,"iPhone13,2"
com.apple.mobileslideshow,1,1732398050,1732398051,1732398051.994955,-21600,EB445137-D7F5-57EC-87DA-1DB460D64046,"iPhone13,2"
com.apple.mobileslideshow,8,1732397036,1732397044,1732397045.163827,-21600,EB445137-D7F5-57EC-87DA-1DB460D64046,"iPhone13,2"
com.apple.MobileSMS,7,1732397018,1732397025,1732397025.3686938,-21600,EB445137-D7F5-57EC-87DA-1DB460D64046,"iPhone13,2"
com.apple.camera,0,1732395417,1732395417,1732395417.999106,-21600,EB445137-D7F5-57EC-87DA-1DB460D64046,"iPhone13,2"
com.apple.camera,1,1732395321,1732395322,1732395322.265952,-21600,EB445137-D7F5-57EC-87DA-1DB460D64046,"iPhone13,2"
com.google.chrome.ios,40,1732394988,1732395028,1732395029.6180701,-21600,EB445137-D7F5-57EC-87DA-1DB460D64046,"iPhone13,2"
com.hammerandchisel.discord,71,1732394105,1732394176,1732394177.360769,-21600,EB445137-D7F5-57EC-87DA-1DB460D64046,"iPhone13,2"
com.amazon.Amazon,24,1732394080,1732394104,1732394105.054202,-21600,EB445137-D7F5-57EC-87DA-1DB460D64046,"iPhone13,2"
com.apple.MobileSMS,2,1732394078,1732394080,1732394080.966546,-21600,EB445137-D7F5-57EC-87DA-1DB460D64046,"iPhone13,2"
com.apple.news,3,1732394075,1732394078,1732394079.757586,-21600,EB445137-D7F5-57EC-87DA-1DB460D64046,"iPhone13,2"
com.apple.news,5,1732391181,1732391186,1732391186.6530828,-21600,EB445137-D7F5-57EC-87DA-1DB460D64046,"iPhone13,2"
com.apple.news,13,1732391134,1732391147,1732391148.080271,-21600,EB445137-D7F5-57EC-87DA-1DB460D64046,"iPhone13,2"
com.google.chrome.ios,314,1732389088,1732389402,1732389402.5028272,-21600,EB445137-D7F5-57EC-87DA-1DB460D64046,"iPhone13,2"
com.apple.findmy,3,1732389085,1732389088,1732389088.814066,-21600,EB445137-D7F5-57EC-87DA-1DB460D64046,"iPhone13,2"
com.leomehlig.today,49,1732384283,1732384332,1732384332.330978,-21600,,
com.microsoft.VSCode,99,1732384184,1732384283,1732384283.8544068,-21600,,
com.google.Chrome,34,1732384150,1732384184,1732384184.951579,-21600,,
com.microsoft.VSCode,855,1732383295,1732384150,1732384150.497457,-21600,,
com.apple.finder,15,1732383280,1732383295,1732383295.351633,-21600,,
com.google.Chrome,23,1732383257,1732383280,1732383280.440306,-21600,,
com.apple.finder,10,1732383247,1732383257,1732383257.821706,-21600,,
com.google.Chrome,4,1732383243,1732383247,1732383247.9039931,-21600,,
com.leomehlig.today,29,1732383214,1732383243,1732383243.130784,-21600,,
com.google.Chrome,45,1732383169,1732383214,1732383214.707512,-21600,,
com.apple.findmy,12,1732383100,1732383112,1732383112.738851,-21600,EB445137-D7F5-57EC-87DA-1DB460D64046,"iPhone13,2"
com.apple.findmy,31,1732382848,1732382879,1732382880.285441,-21600,EB445137-D7F5-57EC-87DA-1DB460D64046,"iPhone13,2"
com.google.Chrome,261,1732382641,1732382902,1732382902.638797,-21600,,
com.leomehlig.today,28,1732382613,1732382641,1732382641.275241,-21600,,
com.google.Chrome,348,1732382265,1732382613,1732382613.109106,-21600,,
com.apple.finder,33,1732382232,1732382265,1732382265.2772431,-21600,,
com.google.Chrome,104,1732382128,1732382232,1732382232.578464,-21600,,
com.apple.Photos,149,1732381979,1732382128,1732382128.231744,-21600,,
com.google.Chrome,79,1732381900,1732381979,1732381979.902289,-21600,,
com.leomehlig.today,32,1732381816,1732381848,1732381848.4512029,-21600,,
com.apple.MobileSMS,10,1732381806,1732381816,1732381816.462833,-21600,,
com.leomehlig.today,10,1732381796,1732381806,1732381806.509408,-21600,,
com.apple.findmy,8,1732381644,1732381652,1732381653.005652,-21600,EB445137-D7F5-57EC-87DA-1DB460D64046,"iPhone13,2"
com.leomehlig.today,24,1732381608,1732381632,1732381632.433213,-21600,,
com.apple.finder,87,1732381521,1732381608,1732381608.465975,-21600,,
com.apple.Terminal,33,1732381488,1732381521,1732381522.0164351,-21600,,
com.apple.finder,19,1732381469,1732381488,1732381489.006818,-21600,,
com.apple.reminders,12,1732381457,1732381469,1732381469.78439,-21600,,
com.leomehlig.today,27,1732381424,1732381451,1732381451.7512221,-21600,EB445137-D7F5-57EC-87DA-1DB460D64046,"iPhone13,2"
com.leomehlig.today,47,1732381410,1732381457,1732381457.300003,-21600,,
com.apple.systempreferences,14,1732381396,1732381410,1732381410.6384192,-21600,,
com.google.Chrome,7,1732381383,1732381390,1732381390.0576339,-21600,,
com.leomehlig.today,37,1732381346,1732381383,1732381383.278331,-21600,,
com.apple.reminders,32,1732381314,1732381346,1732381346.2412639,-21600,,
com.leomehlig.today,51,1732381263,1732381314,1732381314.281307,-21600,,
com.apple.finder,2,1732381261,1732381263,1732381263.9233909,-21600,,
com.leomehlig.today,35,1732381225,1732381260,1732381260.467554,-21600,EB445137-D7F5-57EC-87DA-1DB460D64046,"iPhone13,2"
com.apple.findmy,5,1732381166,1732381171,1732381171.229881,-21600,EB445137-D7F5-57EC-87DA-1DB460D64046,"iPhone13,2"
com.apple.findmy,21,1732381123,1732381144,1732381145.0653281,-21600,EB445137-D7F5-57EC-87DA-1DB460D64046,"iPhone13,2"
com.leomehlig.today,144,1732381117,1732381261,1732381261.853428,-21600,,
com.apple.finder,2,1732381115,1732381117,1732381117.724592,-21600,,
com.leomehlig.today,26,1732381089,1732381115,1732381115.9510422,-21600,,
com.apple.finder,4,1732381085,1732381089,1732381089.491662,-21600,,
com.microsoft.VSCode,6,1732381079,1732381085,1732381085.76633,-21600,,
com.google.Chrome,4,1732381075,1732381079,1732381079.6313992,-21600,,
com.apple.findmy,8,1732380725,1732380733,1732380733.9000192,-21600,EB445137-D7F5-57EC-87DA-1DB460D64046,"iPhone13,2"
com.apple.findmy,2,1732380723,1732380725,1732380725.320035,-21600,EB445137-D7F5-57EC-87DA-1DB460D64046,"iPhone13,2"
com.renpho.health,4,1732380719,1732380723,1732380723.858274,-21600,EB445137-D7F5-57EC-87DA-1DB460D64046,"iPhone13,2"
com.renpho.health,10,1732380703,1732380713,1732380713.7277641,-21600,EB445137-D7F5-57EC-87DA-1DB460D64046,"iPhone13,2"
com.renpho.health,10,1732380583,1732380593,1732380593.777446,-21600,EB445137-D7F5-57EC-87DA-1DB460D64046,"iPhone13,2"
com.renpho.health,37,1732380071,1732380108,1732380108.6624131,-21600,EB445137-D7F5-57EC-87DA-1DB460D64046,"iPhone13,2"
com.apple.findmy,8,1732380060,1732380068,1732380068.730198,-21600,EB445137-D7F5-57EC-87DA-1DB460D64046,"iPhone13,2"
com.apple.findmy,9,1732378378,1732378387,1732378387.279284,-21600,EB445137-D7F5-57EC-87DA-1DB460D64046,"iPhone13,2"
com.apple.findmy,11,1732378309,1732378320,1732378320.901184,-21600,EB445137-D7F5-57EC-87DA-1DB460D64046,"iPhone13,2"
com.google.ios.youtube,178,1732378131,1732378309,1732378309.210985,-21600,EB445137-D7F5-57EC-87DA-1DB460D64046,"iPhone13,2"
com.apple.findmy,13,1732378089,1732378102,1732378102.7004318,-21600,EB445137-D7F5-57EC-87DA-1DB460D64046,"iPhone13,2"
com.google.ios.youtube,1213,1732376858,1732378071,1732378072.0469642,-21600,EB445137-D7F5-57EC-87DA-1DB460D64046,"iPhone13,2"
com.apple.weather,46,1732376763,1732376809,1732376809.7354589,-21600,EB445137-D7F5-57EC-87DA-1DB460D64046,"iPhone13,2"
com.apple.weather,8,1732376754,1732376762,1732376762.9078422,-21600,EB445137-D7F5-57EC-87DA-1DB460D64046,"iPhone13,2"
com.apple.mobileslideshow,13,1732346677,1732346690,1732346690.342746,-21600,EB445137-D7F5-57EC-87DA-1DB460D64046,"iPhone13,2"
com.apple.mobileslideshow,6,1732346669,1732346675,1732346675.926052,-21600,EB445137-D7F5-57EC-87DA-1DB460D64046,"iPhone13,2"
com.google.Chrome,1545,1732345090,1732346635,1732346635.691464,-21600,,
com.google.Chrome,310,1732343594,1732343904,1732343905.039456,-21600,,
com.google.Chrome,501,1732342889,1732343390,1732343390.49022,-21600,,
com.google.Chrome,812,1732342008,1732342820,1732342820.267767,-21600,,
com.google.Chrome,300,1732341094,1732341394,1732341394.352673,-21600,,
com.google.Chrome,413,1732340293,1732340706,1732340706.1885319,-21600,,
com.apple.finder,1,1732340292,1732340293,1732340293.529218,-21600,,
com.microsoft.Excel,3,1732340289,1732340292,1732340292.0770202,-21600,,
com.microsoft.VSCode,15,1732340274,1732340289,1732340289.854387,-21600,,
com.apple.mobileslideshow,20,1732340231,1732340251,1732340251.496321,-21600,EB445137-D7F5-57EC-87DA-1DB460D64046,"iPhone13,2"
com.apple.camera,0,1732339507,1732339507,1732339507.843092,-21600,EB445137-D7F5-57EC-87DA-1DB460D64046,"iPhone13,2"
com.apple.mobileslideshow,14,1732339506,1732339520,1732339520.450076,-21600,EB445137-D7F5-57EC-87DA-1DB460D64046,"iPhone13,2"
com.apple.mobileslideshow,10,1732338915,1732338925,1732338925.600146,-21600,EB445137-D7F5-57EC-87DA-1DB460D64046,"iPhone13,2"
com.apple.mobileslideshow,10,1732338904,1732338914,1732338914.585805,-21600,EB445137-D7F5-57EC-87DA-1DB460D64046,"iPhone13,2"
com.apple.mobileslideshow,19,1732337760,1732337779,1732337779.887244,-21600,EB445137-D7F5-57EC-87DA-1DB460D64046,"iPhone13,2"
com.apple.camera,0,1732337760,1732337760,1732337760.5339,-21600,EB445137-D7F5-57EC-87DA-1DB460D64046,"iPhone13,2"
com.apple.camera,0,1732337605,1732337605,1732337605.9791079,-21600,EB445137-D7F5-57EC-87DA-1DB460D64046,"iPhone13,2"
com.apple.mobileslideshow,113,1732337603,1732337716,1732337716.345952,-21600,EB445137-D7F5-57EC-87DA-1DB460D64046,"iPhone13,2"
com.apple.camera,0,1732336819,1732336819,1732336819.414818,-21600,EB445137-D7F5-57EC-87DA-1DB460D64046,"iPhone13,2"
com.apple.camera,0,1732336814,1732336814,1732336814.818766,-21600,EB445137-D7F5-57EC-87DA-1DB460D64046,"iPhone13,2"
com.apple.camera,1,1732336810,1732336811,1732336811.0447512,-21600,EB445137-D7F5-57EC-87DA-1DB460D64046,"iPhone13,2"
com.apple.mobileslideshow,69,1732336806,1732336875,1732336875.5753589,-21600,EB445137-D7F5-57EC-87DA-1DB460D64046,"iPhone13,2"
com.apple.camera,1,1732336774,1732336775,1732336775.518371,-21600,EB445137-D7F5-57EC-87DA-1DB460D64046,"iPhone13,2"
com.apple.mobileslideshow,12,1732336773,1732336785,1732336785.805306,-21600,EB445137-D7F5-57EC-87DA-1DB460D64046,"iPhone13,2"
com.apple.mobileslideshow,55,1732336715,1732336770,1732336771.582693,-21600,EB445137-D7F5-57EC-87DA-1DB460D64046,"iPhone13,2"
com.leomehlig.today,4,1732336707,1732336711,1732336711.166791,-21600,EB445137-D7F5-57EC-87DA-1DB460D64046,"iPhone13,2"
com.leomehlig.today,10,1732336210,1732336220,1732336220.217653,-21600,EB445137-D7F5-57EC-87DA-1DB460D64046,"iPhone13,2"
com.leomehlig.today,32,1732335224,1732335256,1732335256.566409,-21600,EB445137-D7F5-57EC-87DA-1DB460D64046,"iPhone13,2"
com.apple.camera,1,1732330142,1732330143,1732330143.692521,-21600,EB445137-D7F5-57EC-87DA-1DB460D64046,"iPhone13,2"
com.apple.camera,0,1732329195,1732329195,1732329195.656557,-21600,EB445137-D7F5-57EC-87DA-1DB460D64046,"iPhone13,2"
com.apple.MobileSMS,7,1732329177,1732329184,1732329184.0402632,-21600,EB445137-D7F5-57EC-87DA-1DB460D64046,"iPhone13,2"
com.apple.findmy,4,1732329173,1732329177,1732329177.820782,-21600,EB445137-D7F5-57EC-87DA-1DB460D64046,"iPhone13,2"
com.apple.findmy,8,1732329129,1732329137,1732329138.744851,-21600,EB445137-D7F5-57EC-87DA-1DB460D64046,"iPhone13,2"
com.apple.MobileSMS,10,1732329119,1732329129,1732329129.083102,-21600,EB445137-D7F5-57EC-87DA-1DB460D64046,"iPhone13,2"
com.apple.MobileSMS,3,1732328614,1732328617,1732328617.9257689,-21600,EB445137-D7F5-57EC-87DA-1DB460D64046,"iPhone13,2"
com.apple.MobileSMS,2,1732328461,1732328463,1732328463.290802,-21600,EB445137-D7F5-57EC-87DA-1DB460D64046,"iPhone13,2"
com.apple.MobileSMS,1,1732328238,1732328239,1732328239.610771,-21600,EB445137-D7F5-57EC-87DA-1DB460D64046,"iPhone13,2"
com.apple.MobileSMS,2,1732326965,1732326967,1732326967.582964,-21600,EB445137-D7F5-57EC-87DA-1DB460D64046,"iPhone13,2"
com.apple.MobileSMS,7,1732326444,1732326451,1732326452.0973492,-21600,EB445137-D7F5-57EC-87DA-1DB460D64046,"iPhone13,2"
com.apple.MobileSMS,14,1732325457,1732325471,1732325472.011584,-21600,EB445137-D7F5-57EC-87DA-1DB460D64046,"iPhone13,2"
com.apple.MobileSMS,3,1732325428,1732325431,1732325431.553464,-21600,EB445137-D7F5-57EC-87DA-1DB460D64046,"iPhone13,2"
com.apple.MobileSMS,17,1732325399,1732325416,1732325416.7461782,-21600,EB445137-D7F5-57EC-87DA-1DB460D64046,"iPhone13,2"
com.apple.MobileSMS,4,1732325277,1732325281,1732325281.920522,-21600,EB445137-D7F5-57EC-87DA-1DB460D64046,"iPhone13,2"
com.apple.MobileSMS,22,1732325144,1732325166,1732325166.839194,-21600,EB445137-D7F5-57EC-87DA-1DB460D64046,"iPhone13,2"
com.apple.MobileSMS,35,1732325070,1732325105,1732325105.49403,-21600,EB445137-D7F5-57EC-87DA-1DB460D64046,"iPhone13,2"
com.apple.findmy,13,1732323731,1732323744,1732323744.6494431,-21600,EB445137-D7F5-57EC-87DA-1DB460D64046,"iPhone13,2"
com.apple.findmy,6,1732323662,1732323668,1732323669.357907,-21600,EB445137-D7F5-57EC-87DA-1DB460D64046,"iPhone13,2"
com.instructure.icanvas,4,1732323658,1732323662,1732323662.595213,-21600,EB445137-D7F5-57EC-87DA-1DB460D64046,"iPhone13,2"
com.instructure.icanvas,17,1732323569,1732323586,1732323587.738295,-21600,EB445137-D7F5-57EC-87DA-1DB460D64046,"iPhone13,2"
com.microsoft.VSCode,563,1732321287,1732321850,1732321850.952575,-21600,,
com.microsoft.Excel,9,1732321278,1732321287,1732321287.068526,-21600,,
com.apple.finder,16,1732321262,1732321278,1732321278.1594958,-21600,,
com.microsoft.Excel,19,1732321243,1732321262,1732321262.788902,-21600,,
com.microsoft.VSCode,13,1732321230,1732321243,1732321243.888758,-21600,,
com.leomehlig.today,25,1732321205,1732321230,1732321230.388746,-21600,,
com.microsoft.VSCode,339,1732320866,1732321205,1732321205.607826,-21600,,
com.google.ios.youtube,2,1732320787,1732320789,1732320789.459101,-21600,EB445137-D7F5-57EC-87DA-1DB460D64046,"iPhone13,2"
com.apple.news,6,1732320781,1732320787,1732320787.9119,-21600,EB445137-D7F5-57EC-87DA-1DB460D64046,"iPhone13,2"
com.apple.news,2,1732320770,1732320772,1732320772.792855,-21600,EB445137-D7F5-57EC-87DA-1DB460D64046,"iPhone13,2"
com.apple.news,7,1732320759,1732320766,1732320766.854902,-21600,EB445137-D7F5-57EC-87DA-1DB460D64046,"iPhone13,2"
com.apple.news,4,1732320746,1732320750,1732320750.345916,-21600,EB445137-D7F5-57EC-87DA-1DB460D64046,"iPhone13,2"
com.apple.news,6,1732320687,1732320693,1732320693.0336552,-21600,EB445137-D7F5-57EC-87DA-1DB460D64046,"iPhone13,2"
com.apple.news,19,1732320664,1732320683,1732320683.7042341,-21600,EB445137-D7F5-57EC-87DA-1DB460D64046,"iPhone13,2"
com.apple.camera,1,1732320598,1732320599,1732320599.528178,-21600,EB445137-D7F5-57EC-87DA-1DB460D64046,"iPhone13,2"
com.apple.news,2,1732320597,1732320599,1732320599.440866,-21600,EB445137-D7F5-57EC-87DA-1DB460D64046,"iPhone13,2"
com.apple.news,6,1732320334,1732320340,1732320340.386502,-21600,EB445137-D7F5-57EC-87DA-1DB460D64046,"iPhone13,2"
com.apple.news,13,1732320270,1732320283,1732320283.373001,-21600,EB445137-D7F5-57EC-87DA-1DB460D64046,"iPhone13,2"
com.apple.news,6,1732320225,1732320231,1732320231.114437,-21600,EB445137-D7F5-57EC-87DA-1DB460D64046,"iPhone13,2"
com.apple.news,444,1732319573,1732320017,1732320018.461492,-21600,EB445137-D7F5-57EC-87DA-1DB460D64046,"iPhone13,2"
com.apple.Health,47,1732319514,1732319561,1732319561.943754,-21600,EB445137-D7F5-57EC-87DA-1DB460D64046,"iPhone13,2"
com.leomehlig.today,25,1732319489,1732319514,1732319514.19736,-21600,EB445137-D7F5-57EC-87DA-1DB460D64046,"iPhone13,2"
com.apple.Health,18,1732319461,1732319479,1732319479.80336,-21600,EB445137-D7F5-57EC-87DA-1DB460D64046,"iPhone13,2"
com.apple.findmy,9,1732319448,1732319457,1732319458.238591,-21600,EB445137-D7F5-57EC-87DA-1DB460D64046,"iPhone13,2"
com.apple.findmy,8,1732319404,1732319412,1732319412.8293,-21600,EB445137-D7F5-57EC-87DA-1DB460D64046,"iPhone13,2"
com.apple.findmy,4,1732319399,1732319403,1732319403.65048,-21600,EB445137-D7F5-57EC-87DA-1DB460D64046,"iPhone13,2"
com.apple.findmy,9,1732318664,1732318673,1732318673.5999799,-21600,EB445137-D7F5-57EC-87DA-1DB460D64046,"iPhone13,2"
com.apple.MobileSMS,3,1732318635,1732318638,1732318638.2732182,-21600,EB445137-D7F5-57EC-87DA-1DB460D64046,"iPhone13,2"
com.apple.MobileSMS,21,1732317785,1732317806,1732317807.2964191,-21600,EB445137-D7F5-57EC-87DA-1DB460D64046,"iPhone13,2"
com.apple.PosterBoard,2,1732317783,1732317785,1732317785.879781,-21600,EB445137-D7F5-57EC-87DA-1DB460D64046,"iPhone13,2"
com.apple.findmy,25,1732317619,1732317644,1732317644.7115312,-21600,EB445137-D7F5-57EC-87DA-1DB460D64046,"iPhone13,2"
com.hammerandchisel.discord,5,1732317614,1732317619,1732317619.167368,-21600,EB445137-D7F5-57EC-87DA-1DB460D64046,"iPhone13,2"
com.apple.news,49,1732317554,1732317603,1732317603.870445,-21600,EB445137-D7F5-57EC-87DA-1DB460D64046,"iPhone13,2"
com.microsoft.Office.Outlook,42,1732316600,1732316642,1732316642.202044,-21600,EB445137-D7F5-57EC-87DA-1DB460D64046,"iPhone13,2"
com.apple.findmy,18,1732313547,1732313565,1732313565.23415,-21600,EB445137-D7F5-57EC-87DA-1DB460D64046,"iPhone13,2"
com.apple.podcasts,4,1732313543,1732313547,1732313547.17681,-21600,EB445137-D7F5-57EC-87DA-1DB460D64046,"iPhone13,2"
com.apple.findmy,3,1732313540,1732313543,1732313544.765176,-21600,EB445137-D7F5-57EC-87DA-1DB460D64046,"iPhone13,2"
com.apple.podcasts,2,1732313537,1732313539,1732313539.852977,-21600,EB445137-D7F5-57EC-87DA-1DB460D64046,"iPhone13,2"
com.apple.podcasts,9,1732313195,1732313204,1732313205.004751,-21600,EB445137-D7F5-57EC-87DA-1DB460D64046,"iPhone13,2"
com.apple.podcasts,5,1732313058,1732313063,1732313063.4834352,-21600,EB445137-D7F5-57EC-87DA-1DB460D64046,"iPhone13,2"
com.apple.podcasts,6,1732313050,1732313056,1732313056.648284,-21600,EB445137-D7F5-57EC-87DA-1DB460D64046,"iPhone13,2"
com.apple.podcasts,6,1732313042,1732313048,1732313048.386339,-21600,EB445137-D7F5-57EC-87DA-1DB460D64046,"iPhone13,2"
com.apple.podcasts,5,1732312929,1732312934,1732312934.9946132,-21600,EB445137-D7F5-57EC-87DA-1DB460D64046,"iPhone13,2"
com.apple.podcasts,4,1732312423,1732312427,1732312427.540554,-21600,EB445137-D7F5-57EC-87DA-1DB460D64046,"iPhone13,2"
com.apple.podcasts,10,1732312385,1732312395,1732312395.7305732,-21600,EB445137-D7F5-57EC-87DA-1DB460D64046,"iPhone13,2"
com.apple.podcasts,88,1732309343,1732309431,1732309431.685559,-21600,EB445137-D7F5-57EC-87DA-1DB460D64046,"iPhone13,2"
com.apple.podcasts,107,1732305399,1732305506,1732305506.4778051,-21600,EB445137-D7F5-57EC-87DA-1DB460D64046,"iPhone13,2"
com.apple.podcasts,13,1732304574,1732304587,1732304587.785296,-21600,EB445137-D7F5-57EC-87DA-1DB460D64046,"iPhone13,2"
com.apple.podcasts,44,1732301659,1732301703,1732301703.586508,-21600,EB445137-D7F5-57EC-87DA-1DB460D64046,"iPhone13,2"
com.tinyspeck.chatlyio,5,1732301652,1732301657,1732301657.753563,-21600,EB445137-D7F5-57EC-87DA-1DB460D64046,"iPhone13,2"
com.tinyspeck.chatlyio,27,1732299124,1732299151,1732299151.649345,-21600,EB445137-D7F5-57EC-87DA-1DB460D64046,"iPhone13,2"
com.apple.news,2,1732299117,1732299119,1732299119.9672132,-21600,EB445137-D7F5-57EC-87DA-1DB460D64046,"iPhone13,2"
com.apple.news,78,1732298821,1732298899,1732298899.809319,-21600,EB445137-D7F5-57EC-87DA-1DB460D64046,"iPhone13,2"
com.apple.news,118,1732298663,1732298781,1732298781.609147,-21600,EB445137-D7F5-57EC-87DA-1DB460D64046,"iPhone13,2"
com.truebill.truebillnative,0,1732298086,1732298086,1732298086.199864,-21600,EB445137-D7F5-57EC-87DA-1DB460D64046,"iPhone13,2"
com.truebill.truebillnative,120,1732297647,1732297767,1732297767.425033,-21600,EB445137-D7F5-57EC-87DA-1DB460D64046,"iPhone13,2"
com.apple.podcasts,4,1732297629,1732297633,1732297633.8857641,-21600,EB445137-D7F5-57EC-87DA-1DB460D64046,"iPhone13,2"
com.apple.podcasts,6,1732297563,1732297569,1732297569.1238952,-21600,EB445137-D7F5-57EC-87DA-1DB460D64046,"iPhone13,2"
com.apple.podcasts,66,1732297496,1732297562,1732297563.135614,-21600,EB445137-D7F5-57EC-87DA-1DB460D64046,"iPhone13,2"
com.google.chrome.ios,11,1732297485,1732297496,1732297497.086996,-21600,EB445137-D7F5-57EC-87DA-1DB460D64046,"iPhone13,2"
com.apple.podcasts,60,1732297425,1732297485,1732297485.753377,-21600,EB445137-D7F5-57EC-87DA-1DB460D64046,"iPhone13,2"
com.apple.podcasts,151,1732297095,1732297246,1732297246.166415,-21600,EB445137-D7F5-57EC-87DA-1DB460D64046,"iPhone13,2"
com.apple.podcasts,59,1732296977,1732297036,1732297036.762881,-21600,EB445137-D7F5-57EC-87DA-1DB460D64046,"iPhone13,2"
com.google.chrome.ios,22,1732296952,1732296974,1732296974.825341,-21600,EB445137-D7F5-57EC-87DA-1DB460D64046,"iPhone13,2"
com.google.chrome.ios,25,1732296396,1732296421,1732296422.0250301,-21600,EB445137-D7F5-57EC-87DA-1DB460D64046,"iPhone13,2"
com.apple.news,36,1732296360,1732296396,1732296396.2388592,-21600,EB445137-D7F5-57EC-87DA-1DB460D64046,"iPhone13,2"
com.toyopagroup.picaboo,6,1732296344,1732296350,1732296351.0878382,-21600,EB445137-D7F5-57EC-87DA-1DB460D64046,"iPhone13,2"
com.toyopagroup.picaboo,2,1732296229,1732296231,1732296231.4617438,-21600,EB445137-D7F5-57EC-87DA-1DB460D64046,"iPhone13,2"
com.toyopagroup.picaboo,12,1732295983,1732295995,1732295995.7640429,-21600,EB445137-D7F5-57EC-87DA-1DB460D64046,"iPhone13,2"
com.apple.MobileSMS,3,1732295980,1732295983,1732295984.105165,-21600,EB445137-D7F5-57EC-87DA-1DB460D64046,"iPhone13,2"
com.apple.MobileSMS,18,1732295491,1732295509,1732295509.222189,-21600,EB445137-D7F5-57EC-87DA-1DB460D64046,"iPhone13,2"
com.google.ios.youtube,2,1732295489,1732295491,1732295491.211225,-21600,EB445137-D7F5-57EC-87DA-1DB460D64046,"iPhone13,2"
com.google.ios.youtube,203,1732295080,1732295283,1732295284.07833,-21600,EB445137-D7F5-57EC-87DA-1DB460D64046,"iPhone13,2"
com.google.ios.youtube,174,1732294891,1732295065,1732295065.519545,-21600,EB445137-D7F5-57EC-87DA-1DB460D64046,"iPhone13,2"
com.apple.podcasts,20,1732294615,1732294635,1732294635.213965,-21600,EB445137-D7F5-57EC-87DA-1DB460D64046,"iPhone13,2"
com.toyopagroup.picaboo,2,1732294607,1732294609,1732294610.028966,-21600,EB445137-D7F5-57EC-87DA-1DB460D64046,"iPhone13,2"
com.toyopagroup.picaboo,10,1732294526,1732294536,1732294536.190362,-21600,EB445137-D7F5-57EC-87DA-1DB460D64046,"iPhone13,2"
com.toyopagroup.picaboo,9,1732294515,1732294524,1732294524.881017,-21600,EB445137-D7F5-57EC-87DA-1DB460D64046,"iPhone13,2"
com.toyopagroup.picaboo,11,1732294496,1732294507,1732294507.476674,-21600,EB445137-D7F5-57EC-87DA-1DB460D64046,"iPhone13,2"
com.toyopagroup.picaboo,13,1732294408,1732294421,1732294421.618573,-21600,EB445137-D7F5-57EC-87DA-1DB460D64046,"iPhone13,2"
com.toyopagroup.picaboo,50,1732294345,1732294395,1732294395.584721,-21600,EB445137-D7F5-57EC-87DA-1DB460D64046,"iPhone13,2"
com.toyopagroup.picaboo,39,1732294280,1732294319,1732294320.138854,-21600,EB445137-D7F5-57EC-87DA-1DB460D64046,"iPhone13,2"
com.clairmail.fth.client,36,1732293926,1732293962,1732293962.427887,-21600,EB445137-D7F5-57EC-87DA-1DB460D64046,"iPhone13,2"
com.apple.MobileSMS,2,1732293919,1732293921,1732293921.269956,-21600,EB445137-D7F5-57EC-87DA-1DB460D64046,"iPhone13,2"
com.apple.MobileSMS,9,1732293603,1732293612,1732293612.361486,-21600,EB445137-D7F5-57EC-87DA-1DB460D64046,"iPhone13,2"
com.apple.MobileSMS,14,1732293589,1732293603,1732293604.995294,-21600,EB445137-D7F5-57EC-87DA-1DB460D64046,"iPhone13,2"
com.apple.camera,10,1732291097,1732291107,1732291107.337554,-21600,EB445137-D7F5-57EC-87DA-1DB460D64046,"iPhone13,2"
com.apple.MobileSMS,20,1732291087,1732291107,1732291107.334999,-21600,EB445137-D7F5-57EC-87DA-1DB460D64046,"iPhone13,2"
com.apple.MobileSMS,10,1732290684,1732290694,1732290694.5138102,-21600,EB445137-D7F5-57EC-87DA-1DB460D64046,"iPhone13,2"
com.apple.MobileSMS,27,1732290369,1732290396,1732290397.153449,-21600,EB445137-D7F5-57EC-87DA-1DB460D64046,"iPhone13,2"
com.renpho.health,5,1732290363,1732290368,1732290369.309064,-21600,EB445137-D7F5-57EC-87DA-1DB460D64046,"iPhone13,2"
com.renpho.health,2,1732290202,1732290204,1732290204.650331,-21600,EB445137-D7F5-57EC-87DA-1DB460D64046,"iPhone13,2"
com.renpho.health,1,1732289975,1732289976,1732289976.6612701,-21600,EB445137-D7F5-57EC-87DA-1DB460D64046,"iPhone13,2"
com.renpho.health,3,1732289443,1732289446,1732289446.2848248,-21600,EB445137-D7F5-57EC-87DA-1DB460D64046,"iPhone13,2"
com.renpho.health,26,1732288753,1732288779,1732288779.858541,-21600,EB445137-D7F5-57EC-87DA-1DB460D64046,"iPhone13,2"
com.apple.news,202,1732287298,1732287500,1732287500.296006,-21600,EB445137-D7F5-57EC-87DA-1DB460D64046,"iPhone13,2"
com.apple.Music,13,1732287253,1732287266,1732287267.594233,-21600,EB445137-D7F5-57EC-87DA-1DB460D64046,"iPhone13,2"
com.apple.Music,30,1732287214,1732287244,1732287244.5557199,-21600,EB445137-D7F5-57EC-87DA-1DB460D64046,"iPhone13,2"
com.apple.Music,27,1732286657,1732286684,1732286684.797492,-21600,EB445137-D7F5-57EC-87DA-1DB460D64046,"iPhone13,2"
com.apple.Music,25,1732286055,1732286080,1732286080.312926,-21600,EB445137-D7F5-57EC-87DA-1DB460D64046,"iPhone13,2"
com.apple.Music,24,1732285501,1732285525,1732285525.3868651,-21600,EB445137-D7F5-57EC-87DA-1DB460D64046,"iPhone13,2"
com.apple.Music,46,1732256768,1732256814,1732256814.9571471,-21600,EB445137-D7F5-57EC-87DA-1DB460D64046,"iPhone13,2"
com.google.chrome.ios,7,1732256759,1732256766,1732256766.949379,-21600,EB445137-D7F5-57EC-87DA-1DB460D64046,"iPhone13,2"
com.google.chrome.ios,14,1732256688,1732256702,1732256702.1037822,-21600,EB445137-D7F5-57EC-87DA-1DB460D64046,"iPhone13,2"
com.google.chrome.ios,2,1732256046,1732256048,1732256048.449936,-21600,EB445137-D7F5-57EC-87DA-1DB460D64046,"iPhone13,2"
com.google.chrome.ios,2,1732256022,1732256024,1732256024.22594,-21600,EB445137-D7F5-57EC-87DA-1DB460D64046,"iPhone13,2"
com.google.chrome.ios,18,1732255929,1732255947,1732255948.328474,-21600,EB445137-D7F5-57EC-87DA-1DB460D64046,"iPhone13,2"
org.name.serializdmobile,7,1732255922,1732255929,1732255929.898628,-21600,EB445137-D7F5-57EC-87DA-1DB460D64046,"iPhone13,2"
org.name.serializdmobile,40,1732254692,1732254732,1732254733.038453,-21600,EB445137-D7F5-57EC-87DA-1DB460D64046,"iPhone13,2"
com.google.chrome.ios,7,1732254684,1732254691,1732254691.3559499,-21600,EB445137-D7F5-57EC-87DA-1DB460D64046,"iPhone13,2"
com.google.chrome.ios,6,1732254448,1732254454,1732254454.611209,-21600,EB445137-D7F5-57EC-87DA-1DB460D64046,"iPhone13,2"
com.google.chrome.ios,6,1732254427,1732254433,1732254433.389833,-21600,EB445137-D7F5-57EC-87DA-1DB460D64046,"iPhone13,2"
com.google.chrome.ios,15,1732254404,1732254419,1732254419.489933,-21600,EB445137-D7F5-57EC-87DA-1DB460D64046,"iPhone13,2"
com.google.chrome.ios,6,1732254324,1732254330,1732254330.430966,-21600,EB445137-D7F5-57EC-87DA-1DB460D64046,"iPhone13,2"
com.google.chrome.ios,46,1732251193,1732251239,1732251239.351181,-21600,EB445137-D7F5-57EC-87DA-1DB460D64046,"iPhone13,2"
com.apple.news,4,1732251188,1732251192,1732251192.511921,-21600,EB445137-D7F5-57EC-87DA-1DB460D64046,"iPhone13,2"
com.microsoft.VSCode,171,1732250289,1732250460,1732250460.324111,-21600,,
com.google.Chrome,2,1732250287,1732250289,1732250292.374741,-21600,,
com.apple.news,10,1732249222,1732249232,1732249232.550915,-21600,EB445137-D7F5-57EC-87DA-1DB460D64046,"iPhone13,2"
com.apple.news,80,1732249137,1732249217,1732249217.578974,-21600,EB445137-D7F5-57EC-87DA-1DB460D64046,"iPhone13,2"
com.google.chrome.ios,35,1732249102,1732249137,1732249137.991585,-21600,EB445137-D7F5-57EC-87DA-1DB460D64046,"iPhone13,2"
com.apple.news,89,1732249013,1732249102,1732249102.706558,-21600,EB445137-D7F5-57EC-87DA-1DB460D64046,"iPhone13,2"
com.apple.news,121,1732248389,1732248510,1732248510.8307471,-21600,EB445137-D7F5-57EC-87DA-1DB460D64046,"iPhone13,2"
com.apple.news,97,1732247736,1732247833,1732247834.159233,-21600,EB445137-D7F5-57EC-87DA-1DB460D64046,"iPhone13,2"
com.google.Chrome,3,1732247209,1732247212,1732247212.7020988,-21600,,
com.instructure.icanvas,7,1732247041,1732247048,1732247048.104888,-21600,EB445137-D7F5-57EC-87DA-1DB460D64046,"iPhone13,2"
com.toyopagroup.picaboo,4,1732247037,1732247041,1732247042.267317,-21600,EB445137-D7F5-57EC-87DA-1DB460D64046,"iPhone13,2"
com.microsoft.VSCode,811,1732246390,1732247201,1732247201.5448,-21600,,
com.microsoft.VSCode,623,1732245748,1732246371,1732246371.792745,-21600,,
com.google.Chrome,1,1732245747,1732245748,1732245748.7223349,-21600,,
com.microsoft.VSCode,126,1732245621,1732245747,1732245747.9399838,-21600,,
com.google.Chrome,1,1732245620,1732245621,1732245621.9536982,-21600,,
com.microsoft.VSCode,351,1732245269,1732245620,1732245620.941428,-21600,,
com.google.Chrome,105,1732245164,1732245269,1732245269.467413,-21600,,
com.microsoft.VSCode,582,1732244582,1732245164,1732245164.405507,-21600,,
com.google.Chrome,138,1732244444,1732244582,1732244582.170501,-21600,,
com.toyopagroup.picaboo,15,1732244325,1732244340,1732244341.06882,-21600,EB445137-D7F5-57EC-87DA-1DB460D64046,"iPhone13,2"
com.apple.Music,3,1732244322,1732244325,1732244326.38843,-21600,EB445137-D7F5-57EC-87DA-1DB460D64046,"iPhone13,2"
com.google.Chrome,472,1732243887,1732244359,1732244360.320302,-21600,,
com.apple.MobileSMS,1,1732243886,1732243887,1732243887.5612922,-21600,,
com.google.Chrome,26,1732243860,1732243886,1732243886.3997412,-21600,,
com.apple.MobileSMS,2,1732243858,1732243860,1732243860.425105,-21600,,
com.google.Chrome,7,1732243851,1732243858,1732243858.374806,-21600,,
com.apple.MobileSMS,2,1732243849,1732243851,1732243851.6227589,-21600,,
com.google.Chrome,1,1732243848,1732243849,1732243849.499944,-21600,,
com.apple.MobileSMS,3,1732243845,1732243848,1732243849.0233731,-21600,,
com.google.Chrome,5,1732243840,1732243845,1732243845.154633,-21600,,
com.apple.MobileSMS,9,1732243831,1732243840,1732243840.775063,-21600,,
com.google.Chrome,66,1732243765,1732243831,1732243831.6428041,-21600,,
com.apple.MobileSMS,3,1732243762,1732243765,1732243765.185832,-21600,,
com.google.Chrome,6,1732243756,1732243762,1732243762.119698,-21600,,
com.apple.MobileSMS,0,1732243756,1732243756,1732243756.4842029,-21600,,
com.google.Chrome,6,1732243750,1732243756,1732243756.054431,-21600,,
com.apple.MobileSMS,3,1732243747,1732243750,1732243750.054315,-21600,,
com.google.Chrome,6,1732243741,1732243747,1732243747.657547,-21600,,
com.apple.MobileSMS,48,1732243693,1732243741,1732243741.2681289,-21600,,
com.google.Chrome,12,1732243681,1732243693,1732243693.9379,-21600,,
com.apple.MobileSMS,19,1732243662,1732243681,1732243681.146566,-21600,,
com.apple.Music,4,1732243656,1732243660,1732243660.386983,-21600,EB445137-D7F5-57EC-87DA-1DB460D64046,"iPhone13,2"
com.apple.MobileSMS,4,1732243652,1732243656,1732243657.112462,-21600,EB445137-D7F5-57EC-87DA-1DB460D64046,"iPhone13,2"
com.google.Chrome,12,1732243650,1732243662,1732243662.5974789,-21600,,
com.apple.Music,4,1732243646,1732243650,1732243650.3477612,-21600,,
com.google.Chrome,69,1732243577,1732243646,1732243646.2838922,-21600,,
com.apple.MobileSMS,8,1732241631,1732241639,1732241639.259206,-21600,EB445137-D7F5-57EC-87DA-1DB460D64046,"iPhone13,2"
com.apple.camera,0,1732241589,1732241589,1732241589.9366488,-21600,EB445137-D7F5-57EC-87DA-1DB460D64046,"iPhone13,2"
com.apple.MobileSMS,19,1732241588,1732241607,1732241607.1556811,-21600,EB445137-D7F5-57EC-87DA-1DB460D64046,"iPhone13,2"
com.apple.MobileSMS,4,1732241576,1732241580,1732241580.7236319,-21600,EB445137-D7F5-57EC-87DA-1DB460D64046,"iPhone13,2"
com.apple.MobileSMS,7,1732241495,1732241502,1732241502.530504,-21600,EB445137-D7F5-57EC-87DA-1DB460D64046,"iPhone13,2"
com.apple.MobileSMS,1,1732241493,1732241494,1732241494.639202,-21600,EB445137-D7F5-57EC-87DA-1DB460D64046,"iPhone13,2"
com.apple.MobileSMS,15,1732241218,1732241233,1732241233.9238958,-21600,EB445137-D7F5-57EC-87DA-1DB460D64046,"iPhone13,2"
com.apple.MobileSMS,30,1732241165,1732241195,1732241196.2323031,-21600,EB445137-D7F5-57EC-87DA-1DB460D64046,"iPhone13,2"
com.google.chrome.ios,19,1732241146,1732241165,1732241165.815611,-21600,EB445137-D7F5-57EC-87DA-1DB460D64046,"iPhone13,2"
com.apple.MobileSMS,35,1732241111,1732241146,1732241146.608262,-21600,EB445137-D7F5-57EC-87DA-1DB460D64046,"iPhone13,2"
com.apple.MobileSMS,18,1732241062,1732241080,1732241081.225676,-21600,EB445137-D7F5-57EC-87DA-1DB460D64046,"iPhone13,2"
com.apple.MobileSMS,65,1732240971,1732241036,1732241037.068296,-21600,EB445137-D7F5-57EC-87DA-1DB460D64046,"iPhone13,2"
com.apple.Music,3,1732240968,1732240971,1732240971.302779,-21600,EB445137-D7F5-57EC-87DA-1DB460D64046,"iPhone13,2"
com.apple.Music,12,1732240849,1732240861,1732240863.460495,-21600,EB445137-D7F5-57EC-87DA-1DB460D64046,"iPhone13,2"
com.tinyspeck.chatlyio,5,1732240844,1732240849,1732240850.979876,-21600,EB445137-D7F5-57EC-87DA-1DB460D64046,"iPhone13,2"
com.tinyspeck.chatlyio,80,1732240687,1732240767,1732240767.9968991,-21600,EB445137-D7F5-57EC-87DA-1DB460D64046,"iPhone13,2"
com.apple.news,2,1732240685,1732240687,1732240687.577637,-21600,EB445137-D7F5-57EC-87DA-1DB460D64046,"iPhone13,2"
com.google.Chrome,404,1732240181,1732240585,1732240585.989373,-21600,,
com.apple.iCal,0,1732240149,1732240149,1732240149.9199572,-21600,,
com.google.Chrome,1,1732240148,1732240149,1732240149.459919,-21600,,
com.apple.iCal,2,1732240146,1732240148,1732240148.405474,-21600,,
com.google.Chrome,16,1732240130,1732240146,1732240146.867775,-21600,,
com.apple.iCal,1,1732240129,1732240130,1732240130.1406531,-21600,,
com.google.Chrome,5,1732240124,1732240129,1732240129.1446772,-21600,,
com.apple.iCal,1,1732240123,1732240124,1732240124.915477,-21600,,
com.google.Chrome,14,1732240109,1732240123,1732240123.474536,-21600,,
com.apple.iCal,2,1732240107,1732240109,1732240109.598975,-21600,,
com.google.Chrome,4,1732240103,1732240107,1732240107.740613,-21600,,
com.apple.iCal,3,1732240100,1732240103,1732240103.6653252,-21600,,
com.google.Chrome,11,1732240089,1732240100,1732240100.981055,-21600,,
com.apple.iCal,2,1732240087,1732240089,1732240089.261454,-21600,,
com.google.Chrome,1,1732240086,1732240087,1732240087.452431,-21600,,
com.apple.iCal,7,1732240079,1732240086,1732240086.5959659,-21600,,
com.google.Chrome,5,1732240074,1732240079,1732240079.362467,-21600,,
com.apple.iCal,2,1732240072,1732240074,1732240074.529244,-21600,,
com.google.Chrome,8,1732240064,1732240072,1732240072.5056648,-21600,,
com.apple.iCal,6,1732240058,1732240064,1732240064.560038,-21600,,
com.google.Chrome,17,1732240041,1732240058,1732240058.144188,-21600,,
com.apple.iCal,1,1732239996,1732239997,1732239998.037535,-21600,,
com.google.Chrome,15,1732239981,1732239996,1732239996.308974,-21600,,
com.apple.iCal,0,1732239981,1732239981,1732239981.763112,-21600,,
com.google.Chrome,1,1732239980,1732239981,1732239981.285455,-21600,,
com.apple.iCal,4,1732239976,1732239980,1732239980.704822,-21600,,
com.google.Chrome,5,1732239971,1732239976,1732239976.2444391,-21600,,
com.apple.iCal,7,1732239964,1732239971,1732239971.258556,-21600,,
com.google.Chrome,169,1732239795,1732239964,1732239964.713984,-21600,,
com.apple.Terminal,3,1732239369,1732239372,1732239372.1870599,-21600,,
com.google.Chrome,5,1732239364,1732239369,1732239369.786108,-21600,,
com.apple.Terminal,1,1732239363,1732239364,1732239364.5847402,-21600,,
com.microsoft.VSCode,8,1732239355,1732239363,1732239363.277361,-21600,,
com.apple.Terminal,3,1732239352,1732239355,1732239355.11706,-21600,,
com.microsoft.VSCode,13,1732239339,1732239352,1732239352.933723,-21600,,
com.google.Chrome,11,1732239328,1732239339,1732239339.4952931,-21600,,
com.microsoft.VSCode,22,1732239306,1732239328,1732239328.535754,-21600,,
com.google.Chrome,2,1732239304,1732239306,1732239306.053955,-21600,,
com.microsoft.VSCode,35,1732239269,1732239304,1732239304.52211,-21600,,
com.google.Chrome,17,1732239252,1732239269,1732239269.835144,-21600,,
com.microsoft.VSCode,4,1732239248,1732239252,1732239252.931155,-21600,,
com.google.Chrome,81,1732239167,1732239248,1732239248.5754352,-21600,,
com.microsoft.VSCode,2,1732239165,1732239167,1732239167.273588,-21600,,
com.google.Chrome,7,1732239158,1732239165,1732239165.4214,-21600,,
com.microsoft.VSCode,0,1732239158,1732239158,1732239158.97889,-21600,,
com.google.Chrome,174,1732238984,1732239158,1732239158.283877,-21600,,
com.microsoft.VSCode,5,1732238979,1732238984,1732238984.287965,-21600,,
com.google.Chrome,5,1732238974,1732238979,1732238979.490943,-21600,,
com.microsoft.VSCode,14,1732238960,1732238974,1732238974.988525,-21600,,
com.google.Chrome,55,1732238905,1732238960,1732238960.537943,-21600,,
com.microsoft.VSCode,1,1732238904,1732238905,1732238905.7801142,-21600,,
com.google.Chrome,11,1732238893,1732238904,1732238904.472643,-21600,,
com.microsoft.VSCode,0,1732238893,1732238893,1732238893.622863,-21600,,
com.google.Chrome,255,1732238638,1732238893,1732238893.0468569,-21600,,
com.microsoft.VSCode,4,1732238634,1732238638,1732238638.2753,-21600,,
com.google.Chrome,6,1732238628,1732238634,1732238634.31153,-21600,,
com.microsoft.VSCode,16,1732238612,1732238628,1732238628.282586,-21600,,
com.google.Chrome,104,1732238508,1732238612,1732238612.911979,-21600,,
com.microsoft.VSCode,474,1732238034,1732238508,1732238508.285355,-21600,,
com.apple.iCal,89,1732237945,1732238034,1732238034.803256,-21600,,
com.microsoft.VSCode,23,1732237922,1732237945,1732237945.835143,-21600,,
com.google.Chrome,221,1732237701,1732237922,1732237922.084231,-21600,,
com.apple.news,32,1732237647,1732237679,1732237679.3296142,-21600,EB445137-D7F5-57EC-87DA-1DB460D64046,"iPhone13,2"
com.apple.news,18,1732237594,1732237612,1732237613.1984239,-21600,EB445137-D7F5-57EC-87DA-1DB460D64046,"iPhone13,2"
com.apple.MobileSMS,12,1732237576,1732237588,1732237588.702106,-21600,EB445137-D7F5-57EC-87DA-1DB460D64046,"iPhone13,2"
com.microsoft.VSCode,145,1732237556,1732237701,1732237701.807595,-21600,,
com.google.Chrome,6,1732237550,1732237556,1732237556.2303128,-21600,,
com.apple.camera,4,1732237393,1732237397,1732237398.869402,-21600,EB445137-D7F5-57EC-87DA-1DB460D64046,"iPhone13,2"
com.apple.camera,0,1732236871,1732236871,1732236871.372717,-21600,EB445137-D7F5-57EC-87DA-1DB460D64046,"iPhone13,2"
com.tinyspeck.chatlyio,5,1732236869,1732236874,1732236874.818183,-21600,EB445137-D7F5-57EC-87DA-1DB460D64046,"iPhone13,2"
com.tinyspeck.chatlyio,9,1732236722,1732236731,1732236731.1665468,-21600,EB445137-D7F5-57EC-87DA-1DB460D64046,"iPhone13,2"
com.tinyspeck.chatlyio,36,1732236661,1732236697,1732236697.9241729,-21600,EB445137-D7F5-57EC-87DA-1DB460D64046,"iPhone13,2"
com.apple.camera,11,1732236648,1732236659,1732236659.2952762,-21600,EB445137-D7F5-57EC-87DA-1DB460D64046,"iPhone13,2"
com.apple.weather,17,1732236644,1732236661,1732236661.18056,-21600,EB445137-D7F5-57EC-87DA-1DB460D64046,"iPhone13,2"
com.apple.weather,8,1732236438,1732236446,1732236447.0601258,-21600,EB445137-D7F5-57EC-87DA-1DB460D64046,"iPhone13,2"
com.apple.MobileSMS,5,1732236433,1732236438,1732236438.18793,-21600,EB445137-D7F5-57EC-87DA-1DB460D64046,"iPhone13,2"
com.apple.MobileSMS,2,1732236207,1732236209,1732236209.0998058,-21600,EB445137-D7F5-57EC-87DA-1DB460D64046,"iPhone13,2"
com.apple.MobileSMS,17,1732236027,1732236044,1732236044.789161,-21600,EB445137-D7F5-57EC-87DA-1DB460D64046,"iPhone13,2"
com.apple.MobileSMS,68,1732235927,1732235995,1732235995.7246351,-21600,EB445137-D7F5-57EC-87DA-1DB460D64046,"iPhone13,2"
com.apple.findmy,8,1732235919,1732235927,1732235927.488103,-21600,EB445137-D7F5-57EC-87DA-1DB460D64046,"iPhone13,2"
com.apple.MobileSMS,2,1732235917,1732235919,1732235919.759482,-21600,EB445137-D7F5-57EC-87DA-1DB460D64046,"iPhone13,2"
com.amazon.Amazon,28,1732235889,1732235917,1732235917.165038,-21600,EB445137-D7F5-57EC-87DA-1DB460D64046,"iPhone13,2"
com.apple.MobileSMS,53,1732235834,1732235887,1732235887.2481399,-21600,EB445137-D7F5-57EC-87DA-1DB460D64046,"iPhone13,2"
com.thestorygraph.thestorygraph,3,1732235827,1732235830,1732235830.646915,-21600,EB445137-D7F5-57EC-87DA-1DB460D64046,"iPhone13,2"
com.thestorygraph.thestorygraph,3,1732235810,1732235813,1732235813.35034,-21600,EB445137-D7F5-57EC-87DA-1DB460D64046,"iPhone13,2"
com.google.Chrome,303,1732235801,1732236104,1732236104.623666,-21600,,
com.microsoft.VSCode,2,1732235799,1732235801,1732235801.83385,-21600,,
com.google.Chrome,167,1732235632,1732235799,1732235799.1650949,-21600,,
com.apple.MobileSMS,4,1732235628,1732235632,1732235632.939775,-21600,,
com.thestorygraph.thestorygraph,64,1732235490,1732235554,1732235554.930338,-21600,EB445137-D7F5-57EC-87DA-1DB460D64046,"iPhone13,2"
com.thestorygraph.thestorygraph,159,1732235258,1732235417,1732235417.457458,-21600,EB445137-D7F5-57EC-87DA-1DB460D64046,"iPhone13,2"
com.google.Chrome,483,1732235145,1732235628,1732235628.599199,-21600,,
com.apple.MobileSMS,57,1732235088,1732235145,1732235146.035876,-21600,,
com.google.Chrome,6,1732235082,1732235088,1732235088.944262,-21600,,
com.apple.MobileSMS,35,1732235047,1732235082,1732235082.237803,-21600,,
com.microsoft.VSCode,482,1732234565,1732235047,1732235047.734105,-21600,,
com.google.Chrome,3,1732234562,1732234565,1732234565.753693,-21600,,
com.leomehlig.today,10,1732234552,1732234562,1732234562.237258,-21600,,
com.google.Chrome,68,1732234484,1732234552,1732234552.683796,-21600,,
com.apple.camera,0,1732234475,1732234475,1732234475.788041,-21600,EB445137-D7F5-57EC-87DA-1DB460D64046,"iPhone13,2"
com.apple.MobileSMS,10,1732234136,1732234146,1732234146.3132858,-21600,EB445137-D7F5-57EC-87DA-1DB460D64046,"iPhone13,2"
com.apple.MobileSMS,2,1732234120,1732234122,1732234122.770654,-21600,EB445137-D7F5-57EC-87DA-1DB460D64046,"iPhone13,2"
com.apple.weather,13,1732234107,1732234120,1732234120.8660002,-21600,EB445137-D7F5-57EC-87DA-1DB460D64046,"iPhone13,2"
com.apple.MobileSMS,3,1732234104,1732234107,1732234107.419069,-21600,EB445137-D7F5-57EC-87DA-1DB460D64046,"iPhone13,2"
com.apple.MobileSMS,120,1732233970,1732234090,1732234090.687614,-21600,EB445137-D7F5-57EC-87DA-1DB460D64046,"iPhone13,2"
com.tinyspeck.chatlyio,1,1732233969,1732233970,1732233970.64931,-21600,EB445137-D7F5-57EC-87DA-1DB460D64046,"iPhone13,2"
com.tinyspeck.chatlyio,13,1732233697,1732233710,1732233711.066584,-21600,EB445137-D7F5-57EC-87DA-1DB460D64046,"iPhone13,2"
com.google.Chrome,566,1732232087,1732232653,1732232653.829122,-21600,,
com.tinyspeck.chatlyio,10,1732231334,1732231344,1732231344.16413,-21600,EB445137-D7F5-57EC-87DA-1DB460D64046,"iPhone13,2"
com.google.Chrome,590,1732231331,1732231921,1732231921.162358,-21600,,
com.tinyspeck.chatlyio,43,1732231202,1732231245,1732231246.109274,-21600,EB445137-D7F5-57EC-87DA-1DB460D64046,"iPhone13,2"
com.tinyspeck.chatlyio,13,1732230564,1732230577,1732230577.7612119,-21600,EB445137-D7F5-57EC-87DA-1DB460D64046,"iPhone13,2"
com.instructure.icanvas,3,1732230561,1732230564,1732230564.403036,-21600,EB445137-D7F5-57EC-87DA-1DB460D64046,"iPhone13,2"
com.google.Chrome,430,1732230531,1732230961,1732230961.3089871,-21600,,
com.instructure.icanvas,26,1732230176,1732230202,1732230203.3711581,-21600,EB445137-D7F5-57EC-87DA-1DB460D64046,"iPhone13,2"
com.apple.news,8,1732230168,1732230176,1732230176.331655,-21600,EB445137-D7F5-57EC-87DA-1DB460D64046,"iPhone13,2"
com.google.Chrome,675,1732229791,1732230466,1732230466.135045,-21600,,
com.google.Chrome,304,1732229445,1732229749,1732229749.252986,-21600,,
com.apple.news,2,1732229396,1732229398,1732229398.4142761,-21600,EB445137-D7F5-57EC-87DA-1DB460D64046,"iPhone13,2"
com.google.Chrome,580,1732228789,1732229369,1732229369.3485808,-21600,,
com.leomehlig.today,44,1732228745,1732228789,1732228791.623431,-21600,,
com.apple.news,6,1732228744,1732228750,1732228750.006627,-21600,EB445137-D7F5-57EC-87DA-1DB460D64046,"iPhone13,2"
com.apple.news,156,1732228561,1732228717,1732228717.2058148,-21600,EB445137-D7F5-57EC-87DA-1DB460D64046,"iPhone13,2"
com.leomehlig.today,101,1732228449,1732228550,1732228551.0241961,-21600,,
com.google.Chrome,6,1732228443,1732228449,1732228449.609507,-21600,,
us.zoom.xos,9,1732228434,1732228443,1732228443.337246,-21600,,
com.google.Chrome,142,1732228292,1732228434,1732228434.816763,-21600,,
us.zoom.xos,4,1732228288,1732228292,1732228292.489855,-21600,,
com.google.Chrome,3,1732228285,1732228288,1732228288.3515549,-21600,,
com.apple.news,65,1732228139,1732228204,1732228204.474498,-21600,EB445137-D7F5-57EC-87DA-1DB460D64046,"iPhone13,2"
com.instructure.icanvas,7,1732228118,1732228125,1732228125.3701348,-21600,EB445137-D7F5-57EC-87DA-1DB460D64046,"iPhone13,2"
com.toyopagroup.picaboo,3,1732228114,1732228117,1732228117.321018,-21600,EB445137-D7F5-57EC-87DA-1DB460D64046,"iPhone13,2"
com.toyopagroup.picaboo,11,1732228098,1732228109,1732228109.840414,-21600,EB445137-D7F5-57EC-87DA-1DB460D64046,"iPhone13,2"
us.zoom.xos,1,1732228043,1732228044,1732228044.6116781,-21600,,
com.google.Chrome,1,1732228042,1732228043,1732228043.034625,-21600,,
us.zoom.xos,3,1732228039,1732228042,1732228042.387644,-21600,,
com.google.Chrome,269,1732227770,1732228039,1732228039.7474709,-21600,,
us.zoom.xos,1,1732227769,1732227770,1732227770.851217,-21600,,
com.toyopagroup.picaboo,16,1732227757,1732227773,1732227773.161093,-21600,EB445137-D7F5-57EC-87DA-1DB460D64046,"iPhone13,2"
com.google.Chrome,37,1732227732,1732227769,1732227769.652509,-21600,,
com.toyopagroup.picaboo,82,1732227675,1732227757,1732227757.992636,-21600,EB445137-D7F5-57EC-87DA-1DB460D64046,"iPhone13,2"
us.zoom.xos,67,1732227665,1732227732,1732227732.1770601,-21600,,
com.google.Chrome,4,1732227661,1732227665,1732227665.77417,-21600,,
us.zoom.xos,198,1732227463,1732227661,1732227661.764152,-21600,,
com.google.Chrome,5,1732227458,1732227463,1732227463.167505,-21600,,
us.zoom.xos,0,1732227458,1732227458,1732227458.887636,-21600,,
us.zoom.xos,300,1732226992,1732227292,1732227292.087501,-21600,,
com.google.Chrome,5,1732226987,1732226992,1732226992.090528,-21600,,
us.zoom.xos,255,1732226732,1732226987,1732226987.608372,-21600,,
com.google.Chrome,2,1732226730,1732226732,1732226732.5176039,-21600,,
com.apple.ScreenContinuity,1,1732226729,1732226730,1732226730.932281,-21600,,
com.toyopagroup.picaboo,14,1732226689,1732226703,1732226703.566409,-21600,EB445137-D7F5-57EC-87DA-1DB460D64046,"iPhone13,2"
com.google.Chrome,161,1732226568,1732226729,1732226729.727442,-21600,,
com.toyopagroup.picaboo,11,1732226553,1732226564,1732226564.5871701,-21600,EB445137-D7F5-57EC-87DA-1DB460D64046,"iPhone13,2"
com.microsoft.VSCode,40,1732226528,1732226568,1732226568.1717238,-21600,,
com.toyopagroup.picaboo,30,1732226499,1732226529,1732226529.280365,-21600,EB445137-D7F5-57EC-87DA-1DB460D64046,"iPhone13,2"
com.facebook.Facebook,3,1732226496,1732226499,1732226499.414454,-21600,EB445137-D7F5-57EC-87DA-1DB460D64046,"iPhone13,2"
com.google.Chrome,70,1732226458,1732226528,1732226528.693654,-21600,,
com.apple.finder,1,1732226457,1732226458,1732226458.367845,-21600,,
com.google.Chrome,22,1732226435,1732226457,1732226457.996904,-21600,,
com.microsoft.VSCode,12,1732226423,1732226435,1732226436.43217,-21600,,
com.google.Chrome,5,1732226418,1732226423,1732226423.931087,-21600,,
com.microsoft.VSCode,15,1732226403,1732226418,1732226418.1643128,-21600,,
com.google.Chrome,2,1732226401,1732226403,1732226403.854622,-21600,,
com.apple.finder,44,1732226357,1732226401,1732226401.949883,-21600,,
com.apple.archiveutility,0,1732226357,1732226357,1732226357.720343,-21600,,
com.apple.finder,19,1732226338,1732226357,1732226357.349918,-21600,,
com.google.Chrome,13,1732226325,1732226338,1732226338.5678701,-21600,,
com.apple.finder,3,1732226322,1732226325,1732226325.1366072,-21600,,
com.google.Chrome,5,1732226317,1732226322,1732226322.346167,-21600,,
us.zoom.xos,2,1732226315,1732226317,1732226318.006006,-21600,,
com.google.Chrome,35,1732226280,1732226315,1732226315.544959,-21600,,
com.facebook.Facebook,29,1732226280,1732226309,1732226309.659261,-21600,EB445137-D7F5-57EC-87DA-1DB460D64046,"iPhone13,2"
com.toyopagroup.picaboo,15,1732226254,1732226269,1732226269.907258,-21600,EB445137-D7F5-57EC-87DA-1DB460D64046,"iPhone13,2"
com.toyopagroup.picaboo,47,1732226202,1732226249,1732226249.1902928,-21600,EB445137-D7F5-57EC-87DA-1DB460D64046,"iPhone13,2"
com.microsoft.Office.Outlook,11,1732226179,1732226190,1732226190.848701,-21600,EB445137-D7F5-57EC-87DA-1DB460D64046,"iPhone13,2"
us.zoom.xos,124,1732226156,1732226280,1732226281.008462,-21600,,
com.google.Chrome,22,1732226134,1732226156,1732226156.908694,-21600,,
us.zoom.xos,1,1732226133,1732226134,1732226134.074654,-21600,,
com.google.Chrome,9,1732226124,1732226133,1732226133.566766,-21600,,
us.zoom.xos,64,1732226060,1732226124,1732226124.372905,-21600,,
com.google.Chrome,22,1732226038,1732226060,1732226060.494108,-21600,,
us.zoom.xos,1,1732226037,1732226038,1732226038.5767999,-21600,,
com.google.Chrome,237,1732225800,1732226037,1732226037.7917209,-21600,,
us.zoom.xos,2,1732225798,1732225800,1732225800.239166,-21600,,
com.google.Chrome,6,1732225792,1732225798,1732225798.752986,-21600,,
us.zoom.xos,16,1732225776,1732225792,1732225792.490769,-21600,,
com.google.Chrome,521,1732225255,1732225776,1732225776.994776,-21600,,
com.apple.finder,3,1732225252,1732225255,1732225255.106485,-21600,,
com.apple.archiveutility,0,1732225252,1732225252,1732225252.922615,-21600,,
com.apple.finder,4,1732225248,1732225252,1732225252.499233,-21600,,
com.google.Chrome,25,1732225223,1732225248,1732225248.458868,-21600,,
us.zoom.xos,5,1732225218,1732225223,1732225223.733193,-21600,,
com.google.Chrome,12,1732225206,1732225218,1732225218.9582949,-21600,,
us.zoom.xos,5,1732225201,1732225206,1732225206.07441,-21600,,
com.apple.Passwords,7,1732225194,1732225201,1732225201.751116,-21600,,
us.zoom.xos,4,1732225190,1732225194,1732225194.551396,-21600,,
com.microsoft.Outlook,1,1732225189,1732225190,1732225190.152489,-21600,,
com.google.Chrome,155,1732225034,1732225189,1732225189.538343,-21600,,
com.microsoft.Outlook,8,1732225026,1732225034,1732225034.271237,-21600,,
com.google.Chrome,13,1732225013,1732225026,1732225026.643968,-21600,,
us.zoom.xos,7,1732225006,1732225013,1732225013.417047,-21600,,
com.google.Chrome,30,1732224976,1732225006,1732225006.5992122,-21600,,
com.apple.Passwords,15,1732224961,1732224976,1732224976.43965,-21600,,
com.google.Chrome,105,1732224856,1732224961,1732224961.301377,-21600,,
us.zoom.xos,84,1732224772,1732224856,1732224856.5845919,-21600,,
com.google.Chrome,23,1732224749,1732224772,1732224772.324339,-21600,,
com.microsoft.VSCode,3,1732224733,1732224736,1732224736.7158651,-21600,,
com.google.Chrome,6,1732224727,1732224733,1732224733.679395,-21600,,
com.apple.camera,6,1732224555,1732224561,1732224562.252615,-21600,EB445137-D7F5-57EC-87DA-1DB460D64046,"iPhone13,2"
com.toyopagroup.picaboo,5,1732224554,1732224559,1732224561.08362,-21600,EB445137-D7F5-57EC-87DA-1DB460D64046,"iPhone13,2"
com.toyopagroup.picaboo,18,1732223917,1732223935,1732223935.6939359,-21600,EB445137-D7F5-57EC-87DA-1DB460D64046,"iPhone13,2"
com.toyopagroup.picaboo,3,1732223912,1732223915,1732223915.77196,-21600,EB445137-D7F5-57EC-87DA-1DB460D64046,"iPhone13,2"
com.toyopagroup.picaboo,5,1732223890,1732223895,1732223895.792558,-21600,EB445137-D7F5-57EC-87DA-1DB460D64046,"iPhone13,2"
com.toyopagroup.picaboo,19,1732223869,1732223888,1732223888.68384,-21600,EB445137-D7F5-57EC-87DA-1DB460D64046,"iPhone13,2"
com.facebook.Facebook,4,1732223865,1732223869,1732223869.435056,-21600,EB445137-D7F5-57EC-87DA-1DB460D64046,"iPhone13,2"
com.google.Chrome,3858,1732218781,1732222639,1732222639.427517,-21600,,
com.google.Chrome,337,1732217132,1732217469,1732217469.0589662,-21600,,
com.facebook.Facebook,33,1732216434,1732216467,1732216467.6883202,-21600,EB445137-D7F5-57EC-87DA-1DB460D64046,"iPhone13,2"
com.hammerandchisel.discord,7,1732216425,1732216432,1732216432.308319,-21600,EB445137-D7F5-57EC-87DA-1DB460D64046,"iPhone13,2"
com.google.Chrome,770,1732216115,1732216885,1732216885.731416,-21600,,
com.leomehlig.today,9,1732216106,1732216115,1732216115.590496,-21600,,
com.apple.iCal,14,1732216092,1732216106,1732216106.385573,-21600,,
com.leomehlig.today,8,1732216084,1732216092,1732216092.424391,-21600,,
com.apple.weather,33,1732215673,1732215706,1732215706.14801,-21600,EB445137-D7F5-57EC-87DA-1DB460D64046,"iPhone13,2"
com.apple.news,51,1732215621,1732215672,1732215672.9788551,-21600,EB445137-D7F5-57EC-87DA-1DB460D64046,"iPhone13,2"
com.apple.camera,5,1732215608,1732215613,1732215613.348445,-21600,EB445137-D7F5-57EC-87DA-1DB460D64046,"iPhone13,2"
com.apple.news,48,1732215556,1732215604,1732215604.62992,-21600,EB445137-D7F5-57EC-87DA-1DB460D64046,"iPhone13,2"
com.google.ios.youtube,411,1732214110,1732214521,1732214521.419609,-21600,EB445137-D7F5-57EC-87DA-1DB460D64046,"iPhone13,2"
com.instructure.icanvas,17,1732214093,1732214110,1732214110.921825,-21600,EB445137-D7F5-57EC-87DA-1DB460D64046,"iPhone13,2"
com.google.ios.youtube,3,1732214090,1732214093,1732214093.47421,-21600,EB445137-D7F5-57EC-87DA-1DB460D64046,"iPhone13,2"
com.google.ios.youtube,6,1732213981,1732213987,1732213987.373111,-21600,EB445137-D7F5-57EC-87DA-1DB460D64046,"iPhone13,2"
com.google.ios.youtube,555,1732212807,1732213362,1732213362.510006,-21600,EB445137-D7F5-57EC-87DA-1DB460D64046,"iPhone13,2"
com.truebill.truebillnative,3,1732212802,1732212805,1732212806.1390362,-21600,EB445137-D7F5-57EC-87DA-1DB460D64046,"iPhone13,2"
com.truebill.truebillnative,3,1732212772,1732212775,1732212775.7525759,-21600,EB445137-D7F5-57EC-87DA-1DB460D64046,"iPhone13,2"
com.apple.camera,1,1732212070,1732212071,1732212072.848871,-21600,EB445137-D7F5-57EC-87DA-1DB460D64046,"iPhone13,2"
com.truebill.truebillnative,3,1732212068,1732212071,1732212072.8418012,-21600,EB445137-D7F5-57EC-87DA-1DB460D64046,"iPhone13,2"
com.truebill.truebillnative,67,1732211999,1732212066,1732212067.5946,-21600,EB445137-D7F5-57EC-87DA-1DB460D64046,"iPhone13,2"
com.hammerandchisel.discord,77,1732211859,1732211936,1732211936.861568,-21600,EB445137-D7F5-57EC-87DA-1DB460D64046,"iPhone13,2"
com.microsoft.Office.Outlook,6,1732211841,1732211847,1732211847.1729732,-21600,EB445137-D7F5-57EC-87DA-1DB460D64046,"iPhone13,2"
com.apple.news,5,1732211827,1732211832,1732211832.705509,-21600,EB445137-D7F5-57EC-87DA-1DB460D64046,"iPhone13,2"
com.apple.news,91,1732211653,1732211744,1732211744.752924,-21600,EB445137-D7F5-57EC-87DA-1DB460D64046,"iPhone13,2"
com.apple.weather,16,1732211631,1732211647,1732211647.0975099,-21600,EB445137-D7F5-57EC-87DA-1DB460D64046,"iPhone13,2"
com.apple.weather,5,1732211625,1732211630,1732211630.6802669,-21600,EB445137-D7F5-57EC-87DA-1DB460D64046,"iPhone13,2"
com.google.ios.youtube,254,1732211370,1732211624,1732211625.4968371,-21600,EB445137-D7F5-57EC-87DA-1DB460D64046,"iPhone13,2"
com.google.ios.youtube,155,1732211195,1732211350,1732211351.247922,-21600,EB445137-D7F5-57EC-87DA-1DB460D64046,"iPhone13,2"
com.instructure.icanvas,24,1732211165,1732211189,1732211189.959974,-21600,EB445137-D7F5-57EC-87DA-1DB460D64046,"iPhone13,2"
com.google.chrome.ios,9,1732211145,1732211154,1732211154.818932,-21600,EB445137-D7F5-57EC-87DA-1DB460D64046,"iPhone13,2"
com.google.chrome.ios,5,1732210613,1732210618,1732210618.897691,-21600,EB445137-D7F5-57EC-87DA-1DB460D64046,"iPhone13,2"
com.google.chrome.ios,11,1732209981,1732209992,1732209992.1215138,-21600,EB445137-D7F5-57EC-87DA-1DB460D64046,"iPhone13,2"
com.google.chrome.ios,168,1732208966,1732209134,1732209134.2603679,-21600,EB445137-D7F5-57EC-87DA-1DB460D64046,"iPhone13,2"
com.google.chrome.ios,3,1732208961,1732208964,1732208964.9654021,-21600,EB445137-D7F5-57EC-87DA-1DB460D64046,"iPhone13,2"
com.google.chrome.ios,127,1732208756,1732208883,1732208884.087356,-21600,EB445137-D7F5-57EC-87DA-1DB460D64046,"iPhone13,2"
com.apple.Maps,4,1732208750,1732208754,1732208755.163712,-21600,EB445137-D7F5-57EC-87DA-1DB460D64046,"iPhone13,2"
com.apple.Maps,33,1732208705,1732208738,1732208739.219444,-21600,EB445137-D7F5-57EC-87DA-1DB460D64046,"iPhone13,2"
com.apple.weather,21,1732208643,1732208664,1732208664.3201761,-21600,EB445137-D7F5-57EC-87DA-1DB460D64046,"iPhone13,2"
com.apple.weather,35,1732208600,1732208635,1732208635.325661,-21600,EB445137-D7F5-57EC-87DA-1DB460D64046,"iPhone13,2"
com.hammerandchisel.discord,2,1732208598,1732208600,1732208600.7114038,-21600,EB445137-D7F5-57EC-87DA-1DB460D64046,"iPhone13,2"
com.instructure.icanvas,5,1732208571,1732208576,1732208576.26492,-21600,EB445137-D7F5-57EC-87DA-1DB460D64046,"iPhone13,2"
com.instructure.icanvas,2,1732207489,1732207491,1732207491.886106,-21600,EB445137-D7F5-57EC-87DA-1DB460D64046,"iPhone13,2"
com.leomehlig.today,21,1732207462,1732207483,1732207484.387258,-21600,,
com.google.Chrome,1,1732207461,1732207462,1732207462.7827768,-21600,,
com.leomehlig.today,12,1732207449,1732207461,1732207461.9238548,-21600,,
com.google.Chrome,1,1732207448,1732207449,1732207449.577458,-21600,,
com.leomehlig.today,9,1732207439,1732207448,1732207448.914124,-21600,,
com.google.Chrome,3,1732207436,1732207439,1732207439.675698,-21600,,
com.leomehlig.today,7,1732207429,1732207436,1732207436.53271,-21600,,
com.apple.iCal,5,1732207424,1732207429,1732207429.156518,-21600,,
com.leomehlig.today,8,1732207416,1732207424,1732207424.835143,-21600,,
com.google.Chrome,1,1732207415,1732207416,1732207416.7318091,-21600,,
com.leomehlig.today,1,1732207414,1732207415,1732207415.1301432,-21600,,
com.google.Chrome,27,1732207387,1732207414,1732207414.5931349,-21600,,
com.leomehlig.today,27,1732207360,1732207387,1732207387.426762,-21600,,
com.google.Chrome,22,1732207338,1732207360,1732207360.18926,-21600,,
com.leomehlig.today,11,1732207320,1732207331,1732207331.36605,-21600,,
com.apple.iCal,5,1732207315,1732207320,1732207320.2741718,-21600,,
com.leomehlig.today,22,1732207293,1732207315,1732207315.11448,-21600,,
com.google.Chrome,1,1732207292,1732207293,1732207293.681237,-21600,,
com.leomehlig.today,13,1732207279,1732207292,1732207292.5405211,-21600,,
com.google.Chrome,226,1732207053,1732207279,1732207279.8085241,-21600,,
com.microsoft.VSCode,0,1732207053,1732207053,1732207053.54419,-21600,,
com.apple.Preview,10,1732207043,1732207053,1732207053.2281299,-21600,,
com.instructure.icanvas,36,1732206981,1732207017,1732207018.411432,-21600,EB445137-D7F5-57EC-87DA-1DB460D64046,"iPhone13,2"
com.apple.news,9,1732206972,1732206981,1732206981.627139,-21600,EB445137-D7F5-57EC-87DA-1DB460D64046,"iPhone13,2"
com.microsoft.VSCode,323,1732206720,1732207043,1732207043.465708,-21600,,
com.google.Chrome,1,1732206719,1732206720,1732206720.983252,-21600,,
com.microsoft.VSCode,86,1732206633,1732206719,1732206719.9812999,-21600,,
com.google.Chrome,3,1732206630,1732206633,1732206633.531503,-21600,,
com.microsoft.VSCode,10,1732206620,1732206630,1732206631.012536,-21600,,
com.google.Chrome,1,1732206619,1732206620,1732206620.995967,-21600,,
com.microsoft.VSCode,62,1732206557,1732206619,1732206619.3269649,-21600,,
com.google.Chrome,3,1732206554,1732206557,1732206557.8447518,-21600,,
com.microsoft.VSCode,3,1732206551,1732206554,1732206554.3776531,-21600,,
com.google.Chrome,1,1732206550,1732206551,1732206551.8562841,-21600,,
com.microsoft.VSCode,0,1732206550,1732206550,1732206551.013513,-21600,,
com.google.Chrome,1,1732206549,1732206550,1732206550.5362802,-21600,,
com.microsoft.VSCode,1,1732206548,1732206549,1732206549.7905369,-21600,,
com.google.Chrome,12,1732206536,1732206548,1732206548.530407,-21600,,
com.microsoft.VSCode,12,1732206524,1732206536,1732206536.289567,-21600,,
com.google.Chrome,55,1732206469,1732206524,1732206524.531851,-21600,,
com.apple.news,281,1732206157,1732206438,1732206439.651726,-21600,EB445137-D7F5-57EC-87DA-1DB460D64046,"iPhone13,2"
com.microsoft.VSCode,362,1732206107,1732206469,1732206469.554865,-21600,,
com.google.Chrome,18,1732206089,1732206107,1732206107.46835,-21600,,
com.microsoft.VSCode,56,1732206033,1732206089,1732206089.669838,-21600,,
com.google.Chrome,1,1732206032,1732206033,1732206033.905737,-21600,,
com.microsoft.VSCode,51,1732205981,1732206032,1732206032.1189651,-21600,,
com.google.Chrome,2,1732205979,1732205981,1732205981.9691439,-21600,,
com.microsoft.VSCode,18,1732205961,1732205979,1732205979.950897,-21600,,
com.google.Chrome,1,1732205960,1732205961,1732205961.835062,-21600,,
com.microsoft.VSCode,1,1732205959,1732205960,1732205960.7597818,-21600,,
com.google.Chrome,2,1732205957,1732205959,1732205959.938603,-21600,,
com.microsoft.VSCode,1,1732205956,1732205957,1732205957.5822349,-21600,,
com.google.Chrome,2,1732205954,1732205956,1732205956.799072,-21600,,
com.microsoft.VSCode,1,1732205953,1732205954,1732205954.7413921,-21600,,
com.google.Chrome,2,1732205951,1732205953,1732205953.803592,-21600,,
com.microsoft.VSCode,3,1732205948,1732205951,1732205951.701066,-21600,,
com.google.Chrome,50,1732205898,1732205948,1732205948.7458901,-21600,,
com.microsoft.VSCode,28,1732205870,1732205898,1732205898.966864,-21600,,
com.google.Chrome,19,1732205851,1732205870,1732205870.4800959,-21600,,
com.microsoft.VSCode,1,1732205850,1732205851,1732205851.4704142,-21600,,
com.google.Chrome,52,1732205798,1732205850,1732205850.275535,-21600,,
com.microsoft.VSCode,7,1732205791,1732205798,1732205798.586275,-21600,,
com.google.Chrome,2,1732205789,1732205791,1732205791.559263,-21600,,
com.apple.news,96,1732205266,1732205362,1732205363.051527,-21600,EB445137-D7F5-57EC-87DA-1DB460D64046,"iPhone13,2"
com.renpho.health,3,1732205261,1732205264,1732205264.118763,-21600,EB445137-D7F5-57EC-87DA-1DB460D64046,"iPhone13,2"
com.microsoft.VSCode,827,1732204962,1732205789,1732205789.937325,-21600,,
com.google.Chrome,45,1732204917,1732204962,1732204962.925558,-21600,,
com.microsoft.VSCode,3,1732204914,1732204917,1732204917.512238,-21600,,
com.google.Chrome,3,1732204911,1732204914,1732204914.970416,-21600,,
com.microsoft.VSCode,30,1732204881,1732204911,1732204911.113998,-21600,,
com.google.Chrome,58,1732204823,1732204881,1732204881.106278,-21600,,
com.microsoft.VSCode,8,1732204815,1732204823,1732204823.768219,-21600,,
com.google.Chrome,3,1732204812,1732204815,1732204815.852135,-21600,,
com.microsoft.VSCode,70,1732204742,1732204812,1732204812.46189,-21600,,
com.google.Chrome,127,1732204615,1732204742,1732204742.2994308,-21600,,
com.microsoft.VSCode,22,1732204593,1732204615,1732204615.1421819,-21600,,
com.google.Chrome,3,1732204590,1732204593,1732204593.2165651,-21600,,
com.microsoft.VSCode,44,1732204546,1732204590,1732204590.140854,-21600,,
com.google.Chrome,19,1732204527,1732204546,1732204546.287897,-21600,,
com.microsoft.VSCode,4,1732204523,1732204527,1732204527.272141,-21600,,
com.google.Chrome,1,1732204522,1732204523,1732204523.61826,-21600,,
com.microsoft.VSCode,5,1732204517,1732204522,1732204522.106267,-21600,,
com.google.Chrome,6,1732204511,1732204517,1732204517.805692,-21600,,
com.microsoft.VSCode,14,1732204497,1732204511,1732204511.682248,-21600,,
com.google.Chrome,4,1732204493,1732204497,1732204497.9780378,-21600,,
com.microsoft.VSCode,7,1732204486,1732204493,1732204493.418576,-21600,,
com.google.Chrome,9,1732204477,1732204486,1732204486.124078,-21600,,
com.microsoft.VSCode,4,1732204473,1732204477,1732204477.944985,-21600,,
com.google.Chrome,4,1732204469,1732204473,1732204473.1702862,-21600,,
com.microsoft.VSCode,4,1732204465,1732204469,1732204469.389357,-21600,,
com.google.Chrome,1,1732204464,1732204465,1732204465.968992,-21600,,
com.microsoft.VSCode,2,1732204462,1732204464,1732204464.120987,-21600,,
com.google.Chrome,1,1732204461,1732204462,1732204462.8005872,-21600,,
com.microsoft.VSCode,145,1732204316,1732204461,1732204461.598995,-21600,,
com.google.Chrome,8,1732204308,1732204316,1732204316.4417682,-21600,,
com.microsoft.VSCode,48,1732204260,1732204308,1732204308.620568,-21600,,
com.google.Chrome,43,1732204217,1732204260,1732204260.423551,-21600,,
com.microsoft.VSCode,23,1732204194,1732204217,1732204217.076982,-21600,,
com.google.Chrome,167,1732204027,1732204194,1732204194.335484,-21600,,
com.microsoft.VSCode,279,1732203748,1732204027,1732204027.9334512,-21600,,
com.google.Chrome,259,1732203489,1732203748,1732203748.8444672,-21600,,
com.apple.finder,28,1732203461,1732203489,1732203489.837502,-21600,,
com.google.Chrome,32,1732203429,1732203461,1732203461.412389,-21600,,
com.apple.camera,9,1732203273,1732203282,1732203282.878632,-21600,EB445137-D7F5-57EC-87DA-1DB460D64046,"iPhone13,2"
com.renpho.health,14,1732203268,1732203282,1732203282.875766,-21600,EB445137-D7F5-57EC-87DA-1DB460D64046,"iPhone13,2"
com.renpho.health,0,1732203045,1732203045,1732203046.010288,-21600,EB445137-D7F5-57EC-87DA-1DB460D64046,"iPhone13,2"
com.renpho.health,1,1732202803,1732202804,1732202804.311263,-21600,EB445137-D7F5-57EC-87DA-1DB460D64046,"iPhone13,2"
com.renpho.health,1,1732202798,1732202799,1732202800.36731,-21600,EB445137-D7F5-57EC-87DA-1DB460D64046,"iPhone13,2"
com.renpho.health,79,1732201827,1732201906,1732201906.988997,-21600,EB445137-D7F5-57EC-87DA-1DB460D64046,"iPhone13,2"
com.renpho.health,73,1732201220,1732201293,1732201293.533514,-21600,EB445137-D7F5-57EC-87DA-1DB460D64046,"iPhone13,2"
com.apple.weather,6,1732201213,1732201219,1732201219.435838,-21600,EB445137-D7F5-57EC-87DA-1DB460D64046,"iPhone13,2"
com.apple.weather,11,1732201191,1732201202,1732201202.4891992,-21600,EB445137-D7F5-57EC-87DA-1DB460D64046,"iPhone13,2"
com.google.Chrome,3,1732169491,1732169494,1732169494.205336,-21600,,
com.google.Chrome,396,1732167574,1732167970,1732167970.060266,-21600,,
com.google.Chrome,505,1732166801,1732167306,1732167306.2605019,-21600,,
com.google.Chrome,352,1732166248,1732166600,1732166600.7535481,-21600,,
com.google.Chrome,1551,1732164551,1732166102,1732166102.2435942,-21600,,
com.google.Chrome,314,1732164144,1732164458,1732164458.777879,-21600,,
com.google.Chrome,309,1732163546,1732163855,1732163855.119113,-21600,,
com.google.Chrome,313,1732162877,1732163190,1732163190.3830419,-21600,,
com.google.Chrome,552,1732162225,1732162777,1732162777.4388242,-21600,,
com.google.Chrome,518,1732161471,1732161989,1732161989.427959,-21600,,
com.leomehlig.today,2,1732161469,1732161471,1732161471.1246982,-21600,,
com.goodreads.Goodreads,50,1732161409,1732161459,1732161459.168951,-21600,EB445137-D7F5-57EC-87DA-1DB460D64046,"iPhone13,2"
com.apple.MobileSMS,3,1732161403,1732161406,1732161406.594863,-21600,EB445137-D7F5-57EC-87DA-1DB460D64046,"iPhone13,2"
com.google.Chrome,93,1732161376,1732161469,1732161469.72291,-21600,,
com.leomehlig.today,93,1732161283,1732161376,1732161376.5765672,-21600,,
com.apple.MobileSMS,5,1732161276,1732161281,1732161282.0080872,-21600,EB445137-D7F5-57EC-87DA-1DB460D64046,"iPhone13,2"
com.apple.news,3,1732161272,1732161275,1732161275.823669,-21600,EB445137-D7F5-57EC-87DA-1DB460D64046,"iPhone13,2"
com.apple.finder,23,1732161260,1732161283,1732161283.977864,-21600,,
com.apple.MobileSMS,25,1732161235,1732161260,1732161260.9353352,-21600,,
com.apple.finder,58,1732161177,1732161235,1732161235.3302379,-21600,,
com.google.Chrome,78,1732161099,1732161177,1732161177.347971,-21600,,
com.apple.news,2,1732161036,1732161038,1732161038.667855,-21600,EB445137-D7F5-57EC-87DA-1DB460D64046,"iPhone13,2"
com.apple.news,2,1732161014,1732161016,1732161017.096033,-21600,EB445137-D7F5-57EC-87DA-1DB460D64046,"iPhone13,2"
com.apple.news,2,1732161011,1732161013,1732161013.553494,-21600,EB445137-D7F5-57EC-87DA-1DB460D64046,"iPhone13,2"
com.apple.news,2,1732160417,1732160419,1732160419.917769,-21600,EB445137-D7F5-57EC-87DA-1DB460D64046,"iPhone13,2"
com.apple.news,2,1732160320,1732160322,1732160322.5148501,-21600,EB445137-D7F5-57EC-87DA-1DB460D64046,"iPhone13,2"
com.apple.news,3,1732160314,1732160317,1732160317.618137,-21600,EB445137-D7F5-57EC-87DA-1DB460D64046,"iPhone13,2"
com.apple.news,6,1732159191,1732159197,1732159197.556281,-21600,EB445137-D7F5-57EC-87DA-1DB460D64046,"iPhone13,2"
com.apple.news,42,1732159040,1732159082,1732159083.052143,-21600,EB445137-D7F5-57EC-87DA-1DB460D64046,"iPhone13,2"
com.apple.news,3,1732159034,1732159037,1732159037.5451589,-21600,EB445137-D7F5-57EC-87DA-1DB460D64046,"iPhone13,2"
com.google.chrome.ios,21,1732157489,1732157510,1732157510.898416,-21600,EB445137-D7F5-57EC-87DA-1DB460D64046,"iPhone13,2"
com.google.chrome.ios,6,1732157272,1732157278,1732157278.018764,-21600,EB445137-D7F5-57EC-87DA-1DB460D64046,"iPhone13,2"
com.google.chrome.ios,31,1732157140,1732157171,1732157171.247489,-21600,EB445137-D7F5-57EC-87DA-1DB460D64046,"iPhone13,2"
com.facebook.Facebook,5,1732157135,1732157140,1732157140.197921,-21600,EB445137-D7F5-57EC-87DA-1DB460D64046,"iPhone13,2"
com.facebook.Facebook,3,1732156884,1732156887,1732156887.6469269,-21600,EB445137-D7F5-57EC-87DA-1DB460D64046,"iPhone13,2"
com.facebook.Facebook,6,1732156491,1732156497,1732156497.754909,-21600,EB445137-D7F5-57EC-87DA-1DB460D64046,"iPhone13,2"
com.facebook.Facebook,6,1732156436,1732156442,1732156442.317768,-21600,EB445137-D7F5-57EC-87DA-1DB460D64046,"iPhone13,2"
com.facebook.Facebook,12,1732155245,1732155257,1732155258.894398,-21600,EB445137-D7F5-57EC-87DA-1DB460D64046,"iPhone13,2"
com.apple.MobileSMS,19,1732155202,1732155221,1732155222.242296,-21600,EB445137-D7F5-57EC-87DA-1DB460D64046,"iPhone13,2"
com.apple.mobileslideshow,2,1732155200,1732155202,1732155204.058652,-21600,EB445137-D7F5-57EC-87DA-1DB460D64046,"iPhone13,2"
com.google.Chrome,15,1732155024,1732155039,1732155039.964507,-21600,,
com.google.Chrome,300,1732154067,1732154367,1732154367.253015,-21600,,
com.google.Chrome,310,1732153712,1732154022,1732154022.5067139,-21600,,
com.google.Chrome,315,1732152399,1732152714,1732152714.7448869,-21600,,
com.google.Chrome,300,1732151284,1732151584,1732151584.247905,-21600,,
com.google.Chrome,307,1732149742,1732150049,1732150049.623213,-21600,,
com.apple.mobileslideshow,4,1732148579,1732148583,1732148583.420374,-21600,EB445137-D7F5-57EC-87DA-1DB460D64046,"iPhone13,2"
com.google.Chrome,409,1732148333,1732148742,1732148742.307745,-21600,,
com.leomehlig.today,24,1732148309,1732148333,1732148333.729872,-21600,,
com.apple.mobileslideshow,3,1732147699,1732147702,1732147702.950525,-21600,EB445137-D7F5-57EC-87DA-1DB460D64046,"iPhone13,2"
com.apple.mobileslideshow,3,1732146530,1732146533,1732146533.276983,-21600,EB445137-D7F5-57EC-87DA-1DB460D64046,"iPhone13,2"
com.apple.mobileslideshow,368,1732145867,1732146235,1732146235.0992022,-21600,EB445137-D7F5-57EC-87DA-1DB460D64046,"iPhone13,2"
com.apple.mobileslideshow,294,1732145543,1732145837,1732145837.430808,-21600,EB445137-D7F5-57EC-87DA-1DB460D64046,"iPhone13,2"
com.apple.mobileslideshow,2,1732145379,1732145381,1732145381.721446,-21600,EB445137-D7F5-57EC-87DA-1DB460D64046,"iPhone13,2"
com.apple.mobileslideshow,55,1732145261,1732145316,1732145316.909803,-21600,EB445137-D7F5-57EC-87DA-1DB460D64046,"iPhone13,2"
com.apple.mobileslideshow,2,1732145207,1732145209,1732145209.805222,-21600,EB445137-D7F5-57EC-87DA-1DB460D64046,"iPhone13,2"
com.apple.mobileslideshow,193,1732145012,1732145205,1732145205.7283258,-21600,EB445137-D7F5-57EC-87DA-1DB460D64046,"iPhone13,2"
com.apple.MobileSMS,60,1732144952,1732145012,1732145012.349293,-21600,EB445137-D7F5-57EC-87DA-1DB460D64046,"iPhone13,2"
com.renpho.health,3,1732144922,1732144925,1732144925.4518042,-21600,EB445137-D7F5-57EC-87DA-1DB460D64046,"iPhone13,2"
com.apple.news,55,1732144850,1732144905,1732144905.22007,-21600,EB445137-D7F5-57EC-87DA-1DB460D64046,"iPhone13,2"
com.apple.news,136,1732144683,1732144819,1732144819.7335858,-21600,EB445137-D7F5-57EC-87DA-1DB460D64046,"iPhone13,2"
com.microsoft.Office.Outlook,8,1732144669,1732144677,1732144677.370549,-21600,EB445137-D7F5-57EC-87DA-1DB460D64046,"iPhone13,2"
com.tinyspeck.chatlyio,30,1732144608,1732144638,1732144638.884272,-21600,EB445137-D7F5-57EC-87DA-1DB460D64046,"iPhone13,2"
com.apple.Health,39,1732144569,1732144608,1732144608.25415,-21600,EB445137-D7F5-57EC-87DA-1DB460D64046,"iPhone13,2"
com.apple.news,190,1732144374,1732144564,1732144564.8987541,-21600,EB445137-D7F5-57EC-87DA-1DB460D64046,"iPhone13,2"
com.apple.weather,46,1732144323,1732144369,1732144369.8503652,-21600,EB445137-D7F5-57EC-87DA-1DB460D64046,"iPhone13,2"
com.hammerandchisel.discord,23,1732144288,1732144311,1732144311.434598,-21600,EB445137-D7F5-57EC-87DA-1DB460D64046,"iPhone13,2"
com.hammerandchisel.discord,1,1732144252,1732144253,1732144253.962506,-21600,EB445137-D7F5-57EC-87DA-1DB460D64046,"iPhone13,2"
com.hammerandchisel.discord,45,1732144193,1732144238,1732144238.3968282,-21600,EB445137-D7F5-57EC-87DA-1DB460D64046,"iPhone13,2"
com.hammerandchisel.discord,2,1732144116,1732144118,1732144118.625649,-21600,EB445137-D7F5-57EC-87DA-1DB460D64046,"iPhone13,2"
com.hammerandchisel.discord,32,1732143561,1732143593,1732143594.250361,-21600,EB445137-D7F5-57EC-87DA-1DB460D64046,"iPhone13,2"
com.apple.weather,33,1732143502,1732143535,1732143535.058696,-21600,EB445137-D7F5-57EC-87DA-1DB460D64046,"iPhone13,2"
com.apple.MobileSMS,13,1732143457,1732143470,1732143470.769408,-21600,EB445137-D7F5-57EC-87DA-1DB460D64046,"iPhone13,2"
com.apple.Music,53,1732143393,1732143446,1732143446.537734,-21600,EB445137-D7F5-57EC-87DA-1DB460D64046,"iPhone13,2"
com.toyopagroup.picaboo,17,1732143364,1732143381,1732143382.0493999,-21600,EB445137-D7F5-57EC-87DA-1DB460D64046,"iPhone13,2"
com.apple.weather,12,1732142531,1732142543,1732142543.335501,-21600,EB445137-D7F5-57EC-87DA-1DB460D64046,"iPhone13,2"
com.toyopagroup.picaboo,4,1732142524,1732142528,1732142528.4596171,-21600,EB445137-D7F5-57EC-87DA-1DB460D64046,"iPhone13,2"
com.google.ios.youtube,225,1732142299,1732142524,1732142524.996231,-21600,EB445137-D7F5-57EC-87DA-1DB460D64046,"iPhone13,2"
com.toyopagroup.picaboo,6,1732142265,1732142271,1732142271.563472,-21600,EB445137-D7F5-57EC-87DA-1DB460D64046,"iPhone13,2"
com.robinhood.release.Robinhood,4,1732142249,1732142253,1732142253.555785,-21600,EB445137-D7F5-57EC-87DA-1DB460D64046,"iPhone13,2"
com.leomehlig.today,301,1732142246,1732142547,1732142547.473967,-21600,,
com.apple.finder,2,1732142244,1732142246,1732142246.521048,-21600,,
com.microsoft.VSCode,3,1732142241,1732142244,1732142244.314857,-21600,,
com.google.Chrome,9,1732142232,1732142241,1732142241.3098788,-21600,,
us.zoom.xos,6,1732142226,1732142232,1732142232.508696,-21600,,
com.robinhood.release.Robinhood,11,1732141881,1732141892,1732141892.873636,-21600,EB445137-D7F5-57EC-87DA-1DB460D64046,"iPhone13,2"
com.robinhood.release.Robinhood,1,1732141779,1732141780,1732141780.5678449,-21600,EB445137-D7F5-57EC-87DA-1DB460D64046,"iPhone13,2"
com.google.Chrome,448,1732141778,1732142226,1732142226.728301,-21600,,
com.microsoft.Outlook,4,1732141774,1732141778,1732141778.222619,-21600,,
com.robinhood.release.Robinhood,45,1732141726,1732141771,1732141772.205265,-21600,EB445137-D7F5-57EC-87DA-1DB460D64046,"iPhone13,2"
us.zoom.xos,59,1732141715,1732141774,1732141774.3822598,-21600,,
com.microsoft.Outlook,24,1732141691,1732141715,1732141715.2690601,-21600,,
com.apple.MobileSMS,12,1732141671,1732141683,1732141683.971705,-21600,EB445137-D7F5-57EC-87DA-1DB460D64046,"iPhone13,2"
us.zoom.xos,38,1732141653,1732141691,1732141691.7977052,-21600,,
com.microsoft.VSCode,73,1732141580,1732141653,1732141653.962298,-21600,,
us.zoom.xos,19,1732141561,1732141580,1732141580.076923,-21600,,
com.toyopagroup.picaboo,240,1732141407,1732141647,1732141647.830927,-21600,EB445137-D7F5-57EC-87DA-1DB460D64046,"iPhone13,2"
com.toyopagroup.picaboo,43,1732141359,1732141402,1732141402.255206,-21600,EB445137-D7F5-57EC-87DA-1DB460D64046,"iPhone13,2"
com.apple.MobileSMS,3,1732141356,1732141359,1732141360.068448,-21600,EB445137-D7F5-57EC-87DA-1DB460D64046,"iPhone13,2"
com.microsoft.VSCode,451,1732141110,1732141561,1732141561.9153628,-21600,,
us.zoom.xos,14,1732141096,1732141110,1732141110.224467,-21600,,
com.google.Chrome,2,1732141094,1732141096,1732141096.856327,-21600,,
com.microsoft.VSCode,367,1732140727,1732141094,1732141094.721126,-21600,,
com.google.Chrome,63,1732140664,1732140727,1732140727.48945,-21600,,
com.microsoft.VSCode,55,1732140609,1732140664,1732140664.4168792,-21600,,
com.google.Chrome,9,1732140600,1732140609,1732140609.786831,-21600,,
com.microsoft.VSCode,20,1732140580,1732140600,1732140600.227207,-21600,,
com.google.Chrome,30,1732140550,1732140580,1732140580.840116,-21600,,
com.microsoft.VSCode,1,1732140549,1732140550,1732140550.726013,-21600,,
com.google.Chrome,5,1732140544,1732140549,1732140549.167676,-21600,,
com.microsoft.VSCode,440,1732140104,1732140544,1732140544.782768,-21600,,
com.google.Chrome,1,1732140103,1732140104,1732140104.449404,-21600,,
us.zoom.xos,2,1732140101,1732140103,1732140103.272738,-21600,,
com.apple.iCal,21,1732140080,1732140101,1732140101.956736,-21600,,
us.zoom.xos,2,1732140078,1732140080,1732140080.084861,-21600,,
com.google.Chrome,20,1732140058,1732140078,1732140078.512344,-21600,,
us.zoom.xos,4,1732140054,1732140058,1732140058.9789948,-21600,,
com.microsoft.VSCode,4,1732140050,1732140054,1732140054.417355,-21600,,
com.google.Chrome,6,1732140044,1732140050,1732140051.069273,-21600,,
us.zoom.xos,7,1732140037,1732140044,1732140044.709621,-21600,,
com.google.Chrome,5,1732140032,1732140037,1732140037.812417,-21600,,
com.microsoft.VSCode,161,1732139871,1732140032,1732140032.7956529,-21600,,
com.google.Chrome,10,1732139861,1732139871,1732139871.372645,-21600,,
com.microsoft.VSCode,299,1732139562,1732139861,1732139861.51511,-21600,,
com.apple.finder,1,1732139561,1732139562,1732139562.690392,-21600,,
com.google.Chrome,38,1732139523,1732139561,1732139561.72081,-21600,,
com.microsoft.Outlook,16,1732139507,1732139523,1732139523.291889,-21600,,
com.google.Chrome,13,1732139494,1732139507,1732139507.555378,-21600,,
com.apple.finder,3,1732139491,1732139494,1732139494.082777,-21600,,
com.microsoft.VSCode,765,1732138726,1732139491,1732139491.936331,-21600,,
com.google.Chrome,2,1732138724,1732138726,1732138726.668092,-21600,,
com.apple.Passwords,1,1732138723,1732138724,1732138724.244801,-21600,,
com.google.Chrome,48,1732138675,1732138723,1732138723.424464,-21600,,
com.leomehlig.today,37,1732138638,1732138675,1732138675.177678,-21600,,
com.apple.finder,7,1732138631,1732138638,1732138638.225985,-21600,,
com.leomehlig.today,22,1732138609,1732138631,1732138631.114028,-21600,,
com.apple.finder,13,1732138596,1732138609,1732138609.466686,-21600,,
com.leomehlig.today,21,1732138575,1732138596,1732138596.640949,-21600,,
com.google.Chrome,7,1732138568,1732138575,1732138576.243541,-21600,,
com.apple.MobileSMS,56,1732138504,1732138560,1732138560.7262158,-21600,EB445137-D7F5-57EC-87DA-1DB460D64046,"iPhone13,2"
com.apple.MobileSMS,24,1732138472,1732138496,1732138496.911397,-21600,EB445137-D7F5-57EC-87DA-1DB460D64046,"iPhone13,2"
com.google.Chrome,588,1732136624,1732137212,1732137212.498598,-21600,,
com.apple.news,14,1732132805,1732132819,1732132819.54357,-21600,EB445137-D7F5-57EC-87DA-1DB460D64046,"iPhone13,2"
com.apple.news,1,1732132561,1732132562,1732132562.650763,-21600,EB445137-D7F5-57EC-87DA-1DB460D64046,"iPhone13,2"
com.google.Chrome,20,1732131768,1732131788,1732131788.867313,-21600,,
com.apple.Passwords,7,1732131761,1732131768,1732131768.0787,-21600,,
com.google.Chrome,2,1732131759,1732131761,1732131761.894768,-21600,,
com.apple.news,4,1732131051,1732131055,1732131055.134855,-21600,EB445137-D7F5-57EC-87DA-1DB460D64046,"iPhone13,2"
com.google.Chrome,711,1732129697,1732130408,1732130408.444821,-21600,,
com.apple.news,3,1732129393,1732129396,1732129396.485537,-21600,EB445137-D7F5-57EC-87DA-1DB460D64046,"iPhone13,2"
com.apple.news,12,1732129318,1732129330,1732129330.478756,-21600,EB445137-D7F5-57EC-87DA-1DB460D64046,"iPhone13,2"
com.apple.news,303,1732129014,1732129317,1732129317.392735,-21600,EB445137-D7F5-57EC-87DA-1DB460D64046,"iPhone13,2"
com.google.Chrome,275,1732128118,1732128393,1732128393.487041,-21600,,
com.leomehlig.today,8,1732128110,1732128118,1732128118.6934772,-21600,,
com.apple.iCal,6,1732128104,1732128110,1732128110.849288,-21600,,
com.apple.mobilecal,35,1732128096,1732128131,1732128131.185307,-21600,EB445137-D7F5-57EC-87DA-1DB460D64046,"iPhone13,2"
com.apple.news,5,1732128082,1732128087,1732128087.9884892,-21600,EB445137-D7F5-57EC-87DA-1DB460D64046,"iPhone13,2"
com.apple.weather,7,1732128066,1732128073,1732128073.703401,-21600,EB445137-D7F5-57EC-87DA-1DB460D64046,"iPhone13,2"
com.apple.weather,48,1732128015,1732128063,1732128063.165726,-21600,EB445137-D7F5-57EC-87DA-1DB460D64046,"iPhone13,2"
com.microsoft.Office.Outlook,8,1732127996,1732128004,1732128004.899173,-21600,EB445137-D7F5-57EC-87DA-1DB460D64046,"iPhone13,2"
com.instructure.icanvas,22,1732127938,1732127960,1732127960.519131,-21600,EB445137-D7F5-57EC-87DA-1DB460D64046,"iPhone13,2"
com.apple.MobileSMS,8,1732127930,1732127938,1732127938.872665,-21600,EB445137-D7F5-57EC-87DA-1DB460D64046,"iPhone13,2"
com.google.Chrome,237,1732127867,1732128104,1732128104.358993,-21600,,
com.google.Chrome,433,1732127372,1732127805,1732127805.934325,-21600,,
com.google.Chrome,301,1732126837,1732127138,1732127138.635956,-21600,,
com.apple.MobileSMS,38,1732124643,1732124681,1732124681.627571,-21600,EB445137-D7F5-57EC-87DA-1DB460D64046,"iPhone13,2"
com.hammerandchisel.discord,1,1732124642,1732124643,1732124643.820921,-21600,EB445137-D7F5-57EC-87DA-1DB460D64046,"iPhone13,2"
com.google.Chrome,840,1732124288,1732125128,1732125128.226655,-21600,,
com.apple.Health,36,1732123968,1732124004,1732124004.1376781,-21600,EB445137-D7F5-57EC-87DA-1DB460D64046,"iPhone13,2"
com.apple.MobileSMS,3,1732123965,1732123968,1732123969.261704,-21600,EB445137-D7F5-57EC-87DA-1DB460D64046,"iPhone13,2"
com.google.Chrome,444,1732123818,1732124262,1732124262.807822,-21600,,
com.google.Chrome,460,1732123349,1732123809,1732123809.571094,-21600,,
com.apple.MobileSMS,33,1732123316,1732123349,1732123349.306258,-21600,,
com.apple.MobileSMS,91,1732123311,1732123402,1732123402.1480021,-21600,EB445137-D7F5-57EC-87DA-1DB460D64046,"iPhone13,2"
com.apple.journal,4,1732123307,1732123311,1732123311.8516889,-21600,EB445137-D7F5-57EC-87DA-1DB460D64046,"iPhone13,2"
com.google.Chrome,12,1732123304,1732123316,1732123317.002048,-21600,,
com.apple.MobileSMS,2,1732123302,1732123304,1732123304.233708,-21600,,
com.google.Chrome,2,1732123300,1732123302,1732123302.179618,-21600,,
com.apple.MobileSMS,7,1732123293,1732123300,1732123300.49516,-21600,,
com.google.Chrome,3,1732123290,1732123293,1732123293.923614,-21600,,
com.apple.MobileSMS,35,1732123255,1732123290,1732123290.964522,-21600,,
com.google.Chrome,79,1732123176,1732123255,1732123255.545473,-21600,,
com.leomehlig.today,3,1732123173,1732123176,1732123177.144328,-21600,,
com.apple.journal,8,1732123137,1732123145,1732123145.956547,-21600,EB445137-D7F5-57EC-87DA-1DB460D64046,"iPhone13,2"
com.apple.journal,9,1732121825,1732121834,1732121834.88427,-21600,EB445137-D7F5-57EC-87DA-1DB460D64046,"iPhone13,2"
com.apple.journal,4,1732121331,1732121335,1732121335.649149,-21600,EB445137-D7F5-57EC-87DA-1DB460D64046,"iPhone13,2"
com.apple.journal,1,1732118401,1732118402,1732118402.759945,-21600,EB445137-D7F5-57EC-87DA-1DB460D64046,"iPhone13,2"
com.apple.camera,12,1732118385,1732118397,1732118398.323364,-21600,EB445137-D7F5-57EC-87DA-1DB460D64046,"iPhone13,2"
com.apple.journal,15,1732118383,1732118398,1732118398.499926,-21600,EB445137-D7F5-57EC-87DA-1DB460D64046,"iPhone13,2"
com.apple.journal,3,1732118355,1732118358,1732118358.120944,-21600,EB445137-D7F5-57EC-87DA-1DB460D64046,"iPhone13,2"
com.apple.journal,2,1732118318,1732118320,1732118320.1007152,-21600,EB445137-D7F5-57EC-87DA-1DB460D64046,"iPhone13,2"
com.apple.journal,3,1732118221,1732118224,1732118224.9946861,-21600,EB445137-D7F5-57EC-87DA-1DB460D64046,"iPhone13,2"
com.apple.journal,1,1732118220,1732118221,1732118221.5413451,-21600,EB445137-D7F5-57EC-87DA-1DB460D64046,"iPhone13,2"
com.leomehlig.today,3,1732117539,1732117542,1732117542.524152,-21600,,
com.apple.iCal,26,1732117513,1732117539,1732117539.116373,-21600,,
com.leomehlig.today,94,1732117419,1732117513,1732117513.383851,-21600,,
com.apple.journal,315,1732117162,1732117477,1732117477.821831,-21600,EB445137-D7F5-57EC-87DA-1DB460D64046,"iPhone13,2"
com.apple.Health,2,1732117156,1732117158,1732117158.752009,-21600,EB445137-D7F5-57EC-87DA-1DB460D64046,"iPhone13,2"
com.apple.iCal,327,1732117092,1732117419,1732117419.6109638,-21600,,
com.apple.Health,10,1732117090,1732117100,1732117100.159687,-21600,EB445137-D7F5-57EC-87DA-1DB460D64046,"iPhone13,2"
com.leomehlig.today,15,1732117077,1732117092,1732117093.0171819,-21600,,
com.google.Chrome,2,1732117075,1732117077,1732117077.329376,-21600,,
com.leomehlig.today,6,1732117069,1732117075,1732117075.155561,-21600,,
com.apple.Health,10,1732117058,1732117068,1732117068.919106,-21600,EB445137-D7F5-57EC-87DA-1DB460D64046,"iPhone13,2"
com.toyopagroup.picaboo,30,1732117026,1732117056,1732117056.137371,-21600,EB445137-D7F5-57EC-87DA-1DB460D64046,"iPhone13,2"
com.microsoft.Office.Outlook,20,1732116342,1732116362,1732116362.317275,-21600,EB445137-D7F5-57EC-87DA-1DB460D64046,"iPhone13,2"
com.apple.news,4,1732116338,1732116342,1732116343.7688642,-21600,EB445137-D7F5-57EC-87DA-1DB460D64046,"iPhone13,2"
com.apple.news,1,1732116337,1732116338,1732116338.3316169,-21600,EB445137-D7F5-57EC-87DA-1DB460D64046,"iPhone13,2"
com.leomehlig.today,318,1732116194,1732116512,1732116512.70473,-21600,,
com.apple.news,46,1732116142,1732116188,1732116189.1594028,-21600,EB445137-D7F5-57EC-87DA-1DB460D64046,"iPhone13,2"
com.facebook.Facebook,47,1732116043,1732116090,1732116090.133936,-21600,EB445137-D7F5-57EC-87DA-1DB460D64046,"iPhone13,2"
com.facebook.Facebook,39,1732115998,1732116037,1732116037.6615682,-21600,EB445137-D7F5-57EC-87DA-1DB460D64046,"iPhone13,2"
com.apple.weather,7,1732115991,1732115998,1732115998.9948401,-21600,EB445137-D7F5-57EC-87DA-1DB460D64046,"iPhone13,2"
com.apple.weather,64,1732115442,1732115506,1732115506.715891,-21600,EB445137-D7F5-57EC-87DA-1DB460D64046,"iPhone13,2"
com.renpho.health,3,1732115439,1732115442,1732115442.433405,-21600,EB445137-D7F5-57EC-87DA-1DB460D64046,"iPhone13,2"
com.renpho.health,66,1732115357,1732115423,1732115423.781225,-21600,EB445137-D7F5-57EC-87DA-1DB460D64046,"iPhone13,2"

