app,usage,start_time,end_time,created_at,tz,device_id,device_model
com.apple.finder,3,1722822150,1722822153,1722822153.321301,-18000,,
com.google.Chrome,27,1722822123,1722822150,1722822150.995019,-18000,,
com.apple.finder,13,1722822110,1722822123,1722822123.515516,-18000,,
com.apple.Terminal,12,1722822098,1722822110,1722822110.954586,-18000,,
com.apple.finder,6,1722822092,1722822098,1722822098.5685868,-18000,,
com.google.Chrome,4,1722822088,1722822092,1722822092.454241,-18000,,
com.apple.Terminal,2,1722822086,1722822088,1722822088.102174,-18000,,
com.google.Chrome,17,1722822069,1722822086,1722822086.573312,-18000,,
com.apple.Terminal,5,1722822064,1722822069,1722822070.036514,-18000,,
com.apple.finder,1,1722822063,1722822064,1722822064.206768,-18000,,
com.google.Chrome,40,1722822023,1722822063,1722822063.336406,-18000,,
com.apple.finder,29,1722821994,1722822023,1722822024.5456429,-18000,,
com.apple.Terminal,1,1722821993,1722821994,1722821994.628635,-18000,,
com.apple.finder,35,1722821958,1722821993,1722821993.633229,-18000,,
com.apple.Terminal,38,1722821920,1722821958,1722821958.589287,-18000,,
com.apple.finder,152,1722821768,1722821920,1722821920.635356,-18000,,
com.google.Chrome,59,1722821709,1722821768,1722821768.1658602,-18000,,
com.apple.finder,8,1722821701,1722821709,1722821710.393066,-18000,,
com.apple.MobileSMS,3,1722821698,1722821701,1722821701.831746,-18000,,
com.apple.finder,9,1722821689,1722821698,1722821698.247373,-18000,,
com.apple.finder,16,1722792579,1722792595,1722792595.146037,-18000,,
com.apple.MobileSMS,3,1722792576,1722792579,1722792579.380867,-18000,,
com.apple.finder,67,1722792509,1722792576,1722792576.052064,-18000,,
com.google.Chrome,5,1722792504,1722792509,1722792509.382371,-18000,,
com.apple.MobileSMS,9,1722792495,1722792504,1722792504.549422,-18000,,
com.google.Chrome,81,1722792414,1722792495,1722792495.094626,-18000,,
com.google.Chrome,582,1722790182,1722790764,1722790764.8489199,-18000,,
com.google.Chrome,2,1722534198,1722534200,1722534201.153919,-14400,,
com.apple.findmy,4,1722534194,1722534198,1722534199.330493,-14400,EB445137-D7F5-57EC-87DA-1DB460D64046,"iPhone13,2"
com.apple.findmy,73,1722534017,1722534090,1722534090.1056871,-14400,EB445137-D7F5-57EC-87DA-1DB460D64046,"iPhone13,2"
com.apple.findmy,19,1722533849,1722533868,1722533868.752306,-14400,EB445137-D7F5-57EC-87DA-1DB460D64046,"iPhone13,2"
com.google.Chrome,455,1722533701,1722534156,1722534156.961564,-14400,,
com.apple.news,161,1722533686,1722533847,1722533847.203433,-14400,EB445137-D7F5-57EC-87DA-1DB460D64046,"iPhone13,2"
com.robinhood.release.Robinhood,10,1722533285,1722533295,1722533295.938066,-14400,EB445137-D7F5-57EC-87DA-1DB460D64046,"iPhone13,2"
com.apple.news,51,1722533178,1722533229,1722533229.652718,-14400,EB445137-D7F5-57EC-87DA-1DB460D64046,"iPhone13,2"
com.truebill.truebillnative,5,1722533166,1722533171,1722533171.6580749,-14400,EB445137-D7F5-57EC-87DA-1DB460D64046,"iPhone13,2"
com.truebill.truebillnative,27,1722533134,1722533161,1722533161.728905,-14400,EB445137-D7F5-57EC-87DA-1DB460D64046,"iPhone13,2"
com.google.Chrome,682,1722532861,1722533543,1722533543.47991,-14400,,
com.truebill.truebillnative,56,1722532789,1722532845,1722532845.630484,-14400,EB445137-D7F5-57EC-87DA-1DB460D64046,"iPhone13,2"
com.apple.news,18,1722532764,1722532782,1722532782.810925,-14400,EB445137-D7F5-57EC-87DA-1DB460D64046,"iPhone13,2"
com.google.Chrome,197,1722532538,1722532735,1722532736.003341,-14400,,
com.apple.news,84,1722532350,1722532434,1722532434.4094849,-14400,EB445137-D7F5-57EC-87DA-1DB460D64046,"iPhone13,2"
com.apple.findmy,48,1722532278,1722532326,1722532327.0546021,-14400,EB445137-D7F5-57EC-87DA-1DB460D64046,"iPhone13,2"
com.valvesoftware.steam,1,1722531364,1722531365,1722531366.441568,-14400,,
com.apple.MobileSMS,6,1722531093,1722531099,1722531099.419664,-14400,EB445137-D7F5-57EC-87DA-1DB460D64046,"iPhone13,2"
com.amazon.Amazon,11,1722531082,1722531093,1722531094.054132,-14400,EB445137-D7F5-57EC-87DA-1DB460D64046,"iPhone13,2"
com.apple.MobileSMS,2,1722531080,1722531082,1722531082.954613,-14400,EB445137-D7F5-57EC-87DA-1DB460D64046,"iPhone13,2"
com.google.chrome.ios,3,1722529687,1722529690,1722529690.9065099,-14400,EB445137-D7F5-57EC-87DA-1DB460D64046,"iPhone13,2"
com.google.chrome.ios,6,1722529659,1722529665,1722529665.378928,-14400,EB445137-D7F5-57EC-87DA-1DB460D64046,"iPhone13,2"
com.google.chrome.ios,180,1722529474,1722529654,1722529654.714107,-14400,EB445137-D7F5-57EC-87DA-1DB460D64046,"iPhone13,2"
com.google.chrome.ios,98,1722529368,1722529466,1722529466.093832,-14400,EB445137-D7F5-57EC-87DA-1DB460D64046,"iPhone13,2"
com.apple.news,3,1722529344,1722529347,1722529347.31397,-14400,EB445137-D7F5-57EC-87DA-1DB460D64046,"iPhone13,2"
com.apple.news,49,1722529237,1722529286,1722529286.9759688,-14400,EB445137-D7F5-57EC-87DA-1DB460D64046,"iPhone13,2"
com.apple.news,7,1722529152,1722529159,1722529159.296588,-14400,EB445137-D7F5-57EC-87DA-1DB460D64046,"iPhone13,2"
com.apple.news,237,1722528903,1722529140,1722529140.7091289,-14400,EB445137-D7F5-57EC-87DA-1DB460D64046,"iPhone13,2"
com.apple.Health,5,1722528890,1722528895,1722528895.364582,-14400,EB445137-D7F5-57EC-87DA-1DB460D64046,"iPhone13,2"
com.apple.Health,93,1722528730,1722528823,1722528823.319603,-14400,EB445137-D7F5-57EC-87DA-1DB460D64046,"iPhone13,2"
com.facebook.Facebook,232,1722528156,1722528388,1722528388.5729818,-14400,EB445137-D7F5-57EC-87DA-1DB460D64046,"iPhone13,2"
com.facebook.Facebook,175,1722527910,1722528085,1722528085.954823,-14400,EB445137-D7F5-57EC-87DA-1DB460D64046,"iPhone13,2"
com.apple.MobileSMS,3,1722527904,1722527907,1722527907.585906,-14400,EB445137-D7F5-57EC-87DA-1DB460D64046,"iPhone13,2"
com.apple.MobileSMS,4,1722527212,1722527216,1722527216.795545,-14400,EB445137-D7F5-57EC-87DA-1DB460D64046,"iPhone13,2"
com.apple.Health,31,1722519483,1722519514,1722519514.63443,-14400,EB445137-D7F5-57EC-87DA-1DB460D64046,"iPhone13,2"
com.google.Gmail,65,1722519380,1722519445,1722519445.202188,-14400,EB445137-D7F5-57EC-87DA-1DB460D64046,"iPhone13,2"
com.apple.Health,13,1722488605,1722488618,1722488618.7123408,-14400,EB445137-D7F5-57EC-87DA-1DB460D64046,"iPhone13,2"
com.apple.Health,42,1722488559,1722488601,1722488601.817954,-14400,EB445137-D7F5-57EC-87DA-1DB460D64046,"iPhone13,2"
com.apple.journal,1893,1722486662,1722488555,1722488555.755291,-14400,EB445137-D7F5-57EC-87DA-1DB460D64046,"iPhone13,2"
com.apple.mobiletimer,4,1722486657,1722486661,1722486661.1269078,-14400,EB445137-D7F5-57EC-87DA-1DB460D64046,"iPhone13,2"
com.apple.mobiletimer,13,1722486485,1722486498,1722486498.2061071,-14400,EB445137-D7F5-57EC-87DA-1DB460D64046,"iPhone13,2"
com.apple.mobiletimer,18,1722486459,1722486477,1722486477.965028,-14400,EB445137-D7F5-57EC-87DA-1DB460D64046,"iPhone13,2"
com.apple.MobileSMS,30,1722483368,1722483398,1722483398.6502662,-14400,EB445137-D7F5-57EC-87DA-1DB460D64046,"iPhone13,2"
com.innersloth.amongus,468,1722477263,1722477731,1722477731.379878,-14400,EB445137-D7F5-57EC-87DA-1DB460D64046,"iPhone13,2"
com.innersloth.amongus,3326,1722473866,1722477192,1722477192.6543899,-14400,EB445137-D7F5-57EC-87DA-1DB460D64046,"iPhone13,2"
com.google.chrome.ios,4,1722472828,1722472832,1722472832.120939,-14400,EB445137-D7F5-57EC-87DA-1DB460D64046,"iPhone13,2"
com.google.chrome.ios,6,1722471137,1722471143,1722471143.631499,-14400,EB445137-D7F5-57EC-87DA-1DB460D64046,"iPhone13,2"
com.google.chrome.ios,7,1722468081,1722468088,1722468088.5710301,-14400,EB445137-D7F5-57EC-87DA-1DB460D64046,"iPhone13,2"
com.google.chrome.ios,1192,1722466888,1722468080,1722468080.426735,-14400,EB445137-D7F5-57EC-87DA-1DB460D64046,"iPhone13,2"
com.apple.weather,3,1722466885,1722466888,1722466888.1711168,-14400,EB445137-D7F5-57EC-87DA-1DB460D64046,"iPhone13,2"
com.apple.weather,6,1722466876,1722466882,1722466882.213609,-14400,EB445137-D7F5-57EC-87DA-1DB460D64046,"iPhone13,2"
com.apple.camera,1,1722466873,1722466874,1722466874.2167559,-14400,EB445137-D7F5-57EC-87DA-1DB460D64046,"iPhone13,2"
com.apple.weather,4,1722466871,1722466875,1722466875.620815,-14400,EB445137-D7F5-57EC-87DA-1DB460D64046,"iPhone13,2"
com.apple.weather,2,1722466847,1722466849,1722466849.3807921,-14400,EB445137-D7F5-57EC-87DA-1DB460D64046,"iPhone13,2"
com.apple.weather,6,1722466823,1722466829,1722466829.273787,-14400,EB445137-D7F5-57EC-87DA-1DB460D64046,"iPhone13,2"
com.apple.weather,11,1722466762,1722466773,1722466773.2549791,-14400,EB445137-D7F5-57EC-87DA-1DB460D64046,"iPhone13,2"
com.apple.weather,6,1722466739,1722466745,1722466745.959015,-14400,EB445137-D7F5-57EC-87DA-1DB460D64046,"iPhone13,2"
com.apple.weather,11,1722466658,1722466669,1722466669.349492,-14400,EB445137-D7F5-57EC-87DA-1DB460D64046,"iPhone13,2"
com.apple.weather,6,1722465862,1722465868,1722465868.98508,-14400,EB445137-D7F5-57EC-87DA-1DB460D64046,"iPhone13,2"
com.apple.news,2,1722465859,1722465861,1722465861.613636,-14400,EB445137-D7F5-57EC-87DA-1DB460D64046,"iPhone13,2"
com.apple.news,7,1722465776,1722465783,1722465783.835058,-14400,EB445137-D7F5-57EC-87DA-1DB460D64046,"iPhone13,2"
com.apple.news,248,1722465517,1722465765,1722465765.724889,-14400,EB445137-D7F5-57EC-87DA-1DB460D64046,"iPhone13,2"
com.apple.mobiletimer,13,1722404290,1722404303,1722404303.409267,-14400,EB445137-D7F5-57EC-87DA-1DB460D64046,"iPhone13,2"
com.apple.mobiletimer,3,1722404282,1722404285,1722404285.653449,-14400,EB445137-D7F5-57EC-87DA-1DB460D64046,"iPhone13,2"
com.innersloth.amongus,1746,1722402322,1722404068,1722404068.118657,-14400,EB445137-D7F5-57EC-87DA-1DB460D64046,"iPhone13,2"
com.innersloth.amongus,1946,1722400098,1722402044,1722402044.07802,-14400,EB445137-D7F5-57EC-87DA-1DB460D64046,"iPhone13,2"
com.google.chrome.ios,166,1722399932,1722400098,1722400098.852745,-14400,EB445137-D7F5-57EC-87DA-1DB460D64046,"iPhone13,2"
com.apple.camera,6,1722399926,1722399932,1722399932.740569,-14400,EB445137-D7F5-57EC-87DA-1DB460D64046,"iPhone13,2"
com.google.chrome.ios,17,1722399909,1722399926,1722399926.909968,-14400,EB445137-D7F5-57EC-87DA-1DB460D64046,"iPhone13,2"
com.apple.camera,3,1722399906,1722399909,1722399910.338807,-14400,EB445137-D7F5-57EC-87DA-1DB460D64046,"iPhone13,2"
com.apple.Preferences,5,1722399904,1722399909,1722399910.7388902,-14400,EB445137-D7F5-57EC-87DA-1DB460D64046,"iPhone13,2"
com.apple.Preferences,96,1722399738,1722399834,1722399834.799631,-14400,EB445137-D7F5-57EC-87DA-1DB460D64046,"iPhone13,2"
com.innersloth.amongus,389,1722399349,1722399738,1722399738.690709,-14400,EB445137-D7F5-57EC-87DA-1DB460D64046,"iPhone13,2"
com.apple.Preferences,21,1722399328,1722399349,1722399349.5227141,-14400,EB445137-D7F5-57EC-87DA-1DB460D64046,"iPhone13,2"
com.apple.Preferences,3,1722399325,1722399328,1722399328.0160398,-14400,EB445137-D7F5-57EC-87DA-1DB460D64046,"iPhone13,2"
com.apple.Preferences,6,1722399316,1722399322,1722399322.172579,-14400,EB445137-D7F5-57EC-87DA-1DB460D64046,"iPhone13,2"
com.apple.Preferences,6,1722399286,1722399292,1722399292.5560079,-14400,EB445137-D7F5-57EC-87DA-1DB460D64046,"iPhone13,2"
com.apple.Preferences,68,1722399069,1722399137,1722399137.254385,-14400,EB445137-D7F5-57EC-87DA-1DB460D64046,"iPhone13,2"
com.apple.Preferences,42,1722399026,1722399068,1722399068.484539,-14400,EB445137-D7F5-57EC-87DA-1DB460D64046,"iPhone13,2"
com.google.chrome.ios,95,1722398912,1722399007,1722399007.761626,-14400,EB445137-D7F5-57EC-87DA-1DB460D64046,"iPhone13,2"
com.apple.camera,6,1722398905,1722398911,1722398912.759026,-14400,EB445137-D7F5-57EC-87DA-1DB460D64046,"iPhone13,2"
com.apple.Preferences,8,1722398904,1722398912,1722398913.077889,-14400,EB445137-D7F5-57EC-87DA-1DB460D64046,"iPhone13,2"
com.apple.Preferences,39,1722398824,1722398863,1722398863.056015,-14400,EB445137-D7F5-57EC-87DA-1DB460D64046,"iPhone13,2"
com.apple.mobiletimer,2,1722398816,1722398818,1722398819.015975,-14400,EB445137-D7F5-57EC-87DA-1DB460D64046,"iPhone13,2"
com.apple.mobiletimer,1,1722398775,1722398776,1722398776.5737019,-14400,EB445137-D7F5-57EC-87DA-1DB460D64046,"iPhone13,2"
com.apple.mobiletimer,3,1722398767,1722398770,1722398770.585065,-14400,EB445137-D7F5-57EC-87DA-1DB460D64046,"iPhone13,2"
com.valvesoftware.steam,48,1722398502,1722398550,1722398550.988229,-14400,,
com.apple.systempreferences,1,1722398501,1722398502,1722398502.800006,-14400,,
com.google.Chrome,3,1722398498,1722398501,1722398501.458533,-14400,,
com.valvesoftware.steam,2,1722398496,1722398498,1722398499.022558,-14400,,
com.google.Chrome,7,1722398489,1722398496,1722398496.0544028,-14400,,
com.valvesoftware.steam,7,1722398482,1722398489,1722398489.48425,-14400,,
com.apple.systempreferences,7,1722398475,1722398482,1722398482.894858,-14400,,
com.google.Chrome,5,1722398470,1722398475,1722398475.350944,-14400,,
com.valvesoftware.steam,7,1722398463,1722398470,1722398470.391144,-14400,,
com.apple.systempreferences,2,1722398461,1722398463,1722398463.101917,-14400,,
com.valvesoftware.steam,3,1722398458,1722398461,1722398461.2531118,-14400,,
com.apple.systempreferences,1,1722398457,1722398458,1722398458.898563,-14400,,
com.valvesoftware.steam,2,1722398455,1722398457,1722398457.20174,-14400,,
com.apple.systempreferences,1,1722398454,1722398455,1722398455.06536,-14400,,
com.valvesoftware.steam,0,1722398454,1722398454,1722398454.9647279,-14400,,
com.apple.systempreferences,4,1722398450,1722398454,1722398454.854144,-14400,,
com.valvesoftware.steam,0,1722398422,1722398422,1722398422.5787559,-14400,,
com.apple.systempreferences,9,1722398413,1722398422,1722398422.4030762,-14400,,
com.valvesoftware.steam,2,1722398411,1722398413,1722398414.010812,-14400,,
com.apple.systempreferences,3,1722398408,1722398411,1722398411.189722,-14400,,
com.valvesoftware.steam,0,1722398407,1722398407,1722398407.606419,-14400,,
com.apple.systempreferences,4,1722398403,1722398407,1722398407.4088988,-14400,,
com.valvesoftware.steam,4,1722398397,1722398401,1722398401.812646,-14400,,
com.apple.finder,1,1722398396,1722398397,1722398397.735855,-14400,,
com.valvesoftware.steam,6,1722398390,1722398396,1722398396.241023,-14400,,
com.apple.finder,7,1722398383,1722398390,1722398390.112962,-14400,,
com.valvesoftware.steam,4,1722398379,1722398383,1722398383.3052468,-14400,,
com.apple.finder,1,1722398378,1722398379,1722398379.481411,-14400,,
com.valvesoftware.steam,1,1722398377,1722398378,1722398378.329325,-14400,,
com.apple.finder,22,1722398355,1722398377,1722398377.467084,-14400,,
com.google.Chrome,30,1722398325,1722398355,1722398355.905428,-14400,,
com.apple.finder,0,1722398325,1722398325,1722398325.9413981,-14400,,
com.google.Chrome,22,1722398303,1722398325,1722398325.8011498,-14400,,
com.apple.mobiletimer,6,1722393482,1722393488,1722393488.951953,-14400,EB445137-D7F5-57EC-87DA-1DB460D64046,"iPhone13,2"
com.apple.mobiletimer,29,1722393453,1722393482,1722393482.311634,-14400,EB445137-D7F5-57EC-87DA-1DB460D64046,"iPhone13,2"
com.apple.findmy,5,1722393448,1722393453,1722393453.22364,-14400,EB445137-D7F5-57EC-87DA-1DB460D64046,"iPhone13,2"
com.apple.findmy,2,1722392278,1722392280,1722392280.1870608,-14400,EB445137-D7F5-57EC-87DA-1DB460D64046,"iPhone13,2"
com.apple.findmy,28,1722389716,1722389744,1722389744.627195,-14400,EB445137-D7F5-57EC-87DA-1DB460D64046,"iPhone13,2"
com.apple.findmy,2,1722389338,1722389340,1722389340.45696,-14400,EB445137-D7F5-57EC-87DA-1DB460D64046,"iPhone13,2"
com.apple.findmy,12,1722389318,1722389330,1722389330.772678,-14400,EB445137-D7F5-57EC-87DA-1DB460D64046,"iPhone13,2"
com.apple.MobileSMS,3,1722389315,1722389318,1722389318.400157,-14400,EB445137-D7F5-57EC-87DA-1DB460D64046,"iPhone13,2"
com.apple.MobileSMS,8,1722389219,1722389227,1722389227.107672,-14400,EB445137-D7F5-57EC-87DA-1DB460D64046,"iPhone13,2"
com.apple.MobileSMS,11,1722389198,1722389209,1722389209.858783,-14400,EB445137-D7F5-57EC-87DA-1DB460D64046,"iPhone13,2"
com.apple.MobileSMS,6,1722389189,1722389195,1722389195.576182,-14400,EB445137-D7F5-57EC-87DA-1DB460D64046,"iPhone13,2"
com.apple.MobileSMS,6,1722389182,1722389188,1722389188.531616,-14400,EB445137-D7F5-57EC-87DA-1DB460D64046,"iPhone13,2"
com.apple.MobileSMS,2,1722389121,1722389123,1722389123.894429,-14400,EB445137-D7F5-57EC-87DA-1DB460D64046,"iPhone13,2"
com.apple.MobileSMS,8,1722388161,1722388169,1722388169.609899,-14400,EB445137-D7F5-57EC-87DA-1DB460D64046,"iPhone13,2"
com.apple.MobileSMS,8,1722388153,1722388161,1722388161.2242541,-14400,EB445137-D7F5-57EC-87DA-1DB460D64046,"iPhone13,2"
com.apple.findmy,37,1722387705,1722387742,1722387742.344805,-14400,EB445137-D7F5-57EC-87DA-1DB460D64046,"iPhone13,2"
com.apple.findmy,8,1722385846,1722385854,1722385854.934897,-14400,EB445137-D7F5-57EC-87DA-1DB460D64046,"iPhone13,2"
com.apple.Maps,2,1722385844,1722385846,1722385846.979332,-14400,EB445137-D7F5-57EC-87DA-1DB460D64046,"iPhone13,2"
com.apple.Maps,6,1722385503,1722385509,1722385509.31092,-14400,EB445137-D7F5-57EC-87DA-1DB460D64046,"iPhone13,2"
com.apple.Maps,3,1722385494,1722385497,1722385497.133418,-14400,EB445137-D7F5-57EC-87DA-1DB460D64046,"iPhone13,2"
com.apple.Maps,6,1722385239,1722385245,1722385245.8739119,-14400,EB445137-D7F5-57EC-87DA-1DB460D64046,"iPhone13,2"
com.apple.Maps,16,1722385202,1722385218,1722385218.880447,-14400,EB445137-D7F5-57EC-87DA-1DB460D64046,"iPhone13,2"
com.apple.MobileSMS,10,1722385188,1722385198,1722385198.779746,-14400,EB445137-D7F5-57EC-87DA-1DB460D64046,"iPhone13,2"
com.apple.Maps,3,1722385185,1722385188,1722385188.831009,-14400,EB445137-D7F5-57EC-87DA-1DB460D64046,"iPhone13,2"
com.apple.Maps,51,1722384663,1722384714,1722384714.067161,-14400,EB445137-D7F5-57EC-87DA-1DB460D64046,"iPhone13,2"
com.apple.Maps,26,1722384620,1722384646,1722384646.854346,-14400,EB445137-D7F5-57EC-87DA-1DB460D64046,"iPhone13,2"
com.toyopagroup.picaboo,19,1722383284,1722383303,1722383303.571955,-14400,EB445137-D7F5-57EC-87DA-1DB460D64046,"iPhone13,2"
com.apple.MobileSMS,5,1722383277,1722383282,1722383282.1601691,-14400,EB445137-D7F5-57EC-87DA-1DB460D64046,"iPhone13,2"
com.apple.MobileSMS,4,1722383021,1722383025,1722383025.107625,-14400,EB445137-D7F5-57EC-87DA-1DB460D64046,"iPhone13,2"
com.apple.MobileSMS,6,1722382836,1722382842,1722382842.573022,-14400,EB445137-D7F5-57EC-87DA-1DB460D64046,"iPhone13,2"
com.apple.MobileSMS,6,1722382789,1722382795,1722382795.7048411,-14400,EB445137-D7F5-57EC-87DA-1DB460D64046,"iPhone13,2"
com.apple.MobileSMS,3,1722382772,1722382775,1722382775.8522801,-14400,EB445137-D7F5-57EC-87DA-1DB460D64046,"iPhone13,2"
com.apple.MobileSMS,10,1722382439,1722382449,1722382449.070215,-14400,EB445137-D7F5-57EC-87DA-1DB460D64046,"iPhone13,2"
com.apple.camera,10,1722382354,1722382364,1722382364.257544,-14400,EB445137-D7F5-57EC-87DA-1DB460D64046,"iPhone13,2"
com.apple.MobileSMS,12,1722382352,1722382364,1722382364.255856,-14400,EB445137-D7F5-57EC-87DA-1DB460D64046,"iPhone13,2"
com.apple.MobileSMS,1,1722382350,1722382351,1722382351.823678,-14400,EB445137-D7F5-57EC-87DA-1DB460D64046,"iPhone13,2"
com.apple.MobileSMS,6,1722377104,1722377110,1722377110.0583591,-14400,EB445137-D7F5-57EC-87DA-1DB460D64046,"iPhone13,2"
com.apple.findmy,5,1722377099,1722377104,1722377104.6442308,-14400,EB445137-D7F5-57EC-87DA-1DB460D64046,"iPhone13,2"
com.apple.findmy,6,1722375880,1722375886,1722375886.546582,-14400,EB445137-D7F5-57EC-87DA-1DB460D64046,"iPhone13,2"
com.apple.findmy,6,1722375582,1722375588,1722375588.384445,-14400,EB445137-D7F5-57EC-87DA-1DB460D64046,"iPhone13,2"
com.apple.findmy,6,1722375547,1722375553,1722375553.7732592,-14400,EB445137-D7F5-57EC-87DA-1DB460D64046,"iPhone13,2"
com.apple.findmy,8,1722375021,1722375029,1722375029.198215,-14400,EB445137-D7F5-57EC-87DA-1DB460D64046,"iPhone13,2"
com.apple.findmy,8,1722374853,1722374861,1722374861.3117108,-14400,EB445137-D7F5-57EC-87DA-1DB460D64046,"iPhone13,2"
com.apple.findmy,35,1722374811,1722374846,1722374846.921998,-14400,EB445137-D7F5-57EC-87DA-1DB460D64046,"iPhone13,2"
com.apple.MobileSMS,4,1722374805,1722374809,1722374809.065433,-14400,EB445137-D7F5-57EC-87DA-1DB460D64046,"iPhone13,2"
com.apple.MobileSMS,1,1722374577,1722374578,1722374578.145258,-14400,EB445137-D7F5-57EC-87DA-1DB460D64046,"iPhone13,2"
com.apple.MobileSMS,13,1722374443,1722374456,1722374456.461374,-14400,EB445137-D7F5-57EC-87DA-1DB460D64046,"iPhone13,2"
com.apple.findmy,2,1722374440,1722374442,1722374443.079434,-14400,EB445137-D7F5-57EC-87DA-1DB460D64046,"iPhone13,2"
com.apple.findmy,28,1722374402,1722374430,1722374430.864296,-14400,EB445137-D7F5-57EC-87DA-1DB460D64046,"iPhone13,2"
com.apple.news,2,1722374400,1722374402,1722374403.004154,-14400,EB445137-D7F5-57EC-87DA-1DB460D64046,"iPhone13,2"
com.apple.news,275,1722373899,1722374174,1722374174.2436051,-14400,EB445137-D7F5-57EC-87DA-1DB460D64046,"iPhone13,2"
com.apple.findmy,22,1722373872,1722373894,1722373894.343394,-14400,EB445137-D7F5-57EC-87DA-1DB460D64046,"iPhone13,2"
com.apple.Maps,7,1722373865,1722373872,1722373872.371139,-14400,EB445137-D7F5-57EC-87DA-1DB460D64046,"iPhone13,2"
com.apple.Maps,12,1722373493,1722373505,1722373505.374963,-14400,EB445137-D7F5-57EC-87DA-1DB460D64046,"iPhone13,2"
com.apple.MobileSMS,17,1722373474,1722373491,1722373491.465838,-14400,EB445137-D7F5-57EC-87DA-1DB460D64046,"iPhone13,2"
com.apple.MobileSMS,8,1722373313,1722373321,1722373321.024959,-14400,EB445137-D7F5-57EC-87DA-1DB460D64046,"iPhone13,2"
com.apple.MobileSMS,13,1722372663,1722372676,1722372676.756958,-14400,EB445137-D7F5-57EC-87DA-1DB460D64046,"iPhone13,2"
com.apple.Health,2,1722372661,1722372663,1722372663.989352,-14400,EB445137-D7F5-57EC-87DA-1DB460D64046,"iPhone13,2"
com.apple.camera,1,1722371999,1722372000,1722372000.5062819,-14400,EB445137-D7F5-57EC-87DA-1DB460D64046,"iPhone13,2"
com.apple.Health,2,1722371998,1722372000,1722372000.5029411,-14400,EB445137-D7F5-57EC-87DA-1DB460D64046,"iPhone13,2"
com.apple.Health,9,1722371981,1722371990,1722371990.4928179,-14400,EB445137-D7F5-57EC-87DA-1DB460D64046,"iPhone13,2"
com.apple.Health,41,1722371939,1722371980,1722371980.602775,-14400,EB445137-D7F5-57EC-87DA-1DB460D64046,"iPhone13,2"
com.thestorygraph.thestorygraph,90,1722371031,1722371121,1722371121.387834,-14400,EB445137-D7F5-57EC-87DA-1DB460D64046,"iPhone13,2"
com.google.Chrome,589,1722370702,1722371291,1722371292.059768,-14400,,
com.truebill.truebillnative,198,1722370428,1722370626,1722370626.641004,-14400,EB445137-D7F5-57EC-87DA-1DB460D64046,"iPhone13,2"
com.robinhood.release.Robinhood,57,1722370371,1722370428,1722370428.351512,-14400,EB445137-D7F5-57EC-87DA-1DB460D64046,"iPhone13,2"
com.truebill.truebillnative,72,1722370292,1722370364,1722370364.246554,-14400,EB445137-D7F5-57EC-87DA-1DB460D64046,"iPhone13,2"
com.apple.weather,69,1722370216,1722370285,1722370285.844598,-14400,EB445137-D7F5-57EC-87DA-1DB460D64046,"iPhone13,2"
com.apple.findmy,255,1722369837,1722370092,1722370092.802757,-14400,EB445137-D7F5-57EC-87DA-1DB460D64046,"iPhone13,2"
com.google.Chrome,641,1722369765,1722370406,1722370406.51017,-14400,,
com.apple.news,10,1722369572,1722369582,1722369582.337016,-14400,EB445137-D7F5-57EC-87DA-1DB460D64046,"iPhone13,2"
com.apple.news,39,1722368698,1722368737,1722368737.99634,-14400,EB445137-D7F5-57EC-87DA-1DB460D64046,"iPhone13,2"
com.google.Chrome,300,1722368686,1722368986,1722368986.117444,-14400,,
com.google.Chrome,486,1722368023,1722368509,1722368509.309649,-14400,,
com.apple.news,90,1722367546,1722367636,1722367636.740752,-14400,EB445137-D7F5-57EC-87DA-1DB460D64046,"iPhone13,2"
com.toyopagroup.picaboo,15,1722367519,1722367534,1722367534.3083448,-14400,EB445137-D7F5-57EC-87DA-1DB460D64046,"iPhone13,2"
com.thestorygraph.thestorygraph,73,1722360995,1722361068,1722361068.2195392,-14400,EB445137-D7F5-57EC-87DA-1DB460D64046,"iPhone13,2"
com.apple.news,13,1722360978,1722360991,1722360991.256627,-14400,EB445137-D7F5-57EC-87DA-1DB460D64046,"iPhone13,2"
com.apple.news,6,1722359114,1722359120,1722359120.052824,-14400,EB445137-D7F5-57EC-87DA-1DB460D64046,"iPhone13,2"
com.apple.news,896,1722358204,1722359100,1722359100.097929,-14400,EB445137-D7F5-57EC-87DA-1DB460D64046,"iPhone13,2"
com.google.chrome.ios,195,1722357691,1722357886,1722357887.088574,-14400,EB445137-D7F5-57EC-87DA-1DB460D64046,"iPhone13,2"
com.apple.weather,0,1722357691,1722357691,1722357691.797216,-14400,EB445137-D7F5-57EC-87DA-1DB460D64046,"iPhone13,2"
com.apple.MobileSMS,7,1722357684,1722357691,1722357691.105834,-14400,EB445137-D7F5-57EC-87DA-1DB460D64046,"iPhone13,2"
com.apple.MobileSMS,4,1722355159,1722355163,1722355163.325028,-14400,EB445137-D7F5-57EC-87DA-1DB460D64046,"iPhone13,2"
com.apple.findmy,2,1722352918,1722352920,1722352920.385268,-14400,EB445137-D7F5-57EC-87DA-1DB460D64046,"iPhone13,2"
com.apple.findmy,6,1722352911,1722352917,1722352917.295957,-14400,EB445137-D7F5-57EC-87DA-1DB460D64046,"iPhone13,2"
com.apple.findmy,13,1722352897,1722352910,1722352910.911819,-14400,EB445137-D7F5-57EC-87DA-1DB460D64046,"iPhone13,2"
com.apple.MobileSMS,2,1722352895,1722352897,1722352897.674615,-14400,EB445137-D7F5-57EC-87DA-1DB460D64046,"iPhone13,2"
com.apple.MobileSMS,8,1722352880,1722352888,1722352888.3184428,-14400,EB445137-D7F5-57EC-87DA-1DB460D64046,"iPhone13,2"
com.toyopagroup.picaboo,18,1722352862,1722352880,1722352880.4473472,-14400,EB445137-D7F5-57EC-87DA-1DB460D64046,"iPhone13,2"
com.toyopagroup.picaboo,12,1722352616,1722352628,1722352628.05902,-14400,EB445137-D7F5-57EC-87DA-1DB460D64046,"iPhone13,2"
com.apple.MobileSMS,3,1722352613,1722352616,1722352616.455481,-14400,EB445137-D7F5-57EC-87DA-1DB460D64046,"iPhone13,2"
com.apple.MobileSMS,8,1722352190,1722352198,1722352198.666456,-14400,EB445137-D7F5-57EC-87DA-1DB460D64046,"iPhone13,2"
com.apple.MobileSMS,2,1722351445,1722351447,1722351447.758553,-14400,EB445137-D7F5-57EC-87DA-1DB460D64046,"iPhone13,2"
com.apple.MobileSMS,4,1722351440,1722351444,1722351444.312881,-14400,EB445137-D7F5-57EC-87DA-1DB460D64046,"iPhone13,2"
com.apple.MobileSMS,7,1722351161,1722351168,1722351168.3369632,-14400,EB445137-D7F5-57EC-87DA-1DB460D64046,"iPhone13,2"
com.apple.MobileSMS,4,1722351127,1722351131,1722351131.8950992,-14400,EB445137-D7F5-57EC-87DA-1DB460D64046,"iPhone13,2"
com.apple.MobileSMS,0,1722351125,1722351125,1722351125.738029,-14400,EB445137-D7F5-57EC-87DA-1DB460D64046,"iPhone13,2"
com.apple.MobileSMS,12,1722351109,1722351121,1722351121.3097792,-14400,EB445137-D7F5-57EC-87DA-1DB460D64046,"iPhone13,2"
com.apple.MobileSMS,22,1722350327,1722350349,1722350349.789165,-14400,EB445137-D7F5-57EC-87DA-1DB460D64046,"iPhone13,2"
com.apple.mobilecal,6,1722350321,1722350327,1722350327.655086,-14400,EB445137-D7F5-57EC-87DA-1DB460D64046,"iPhone13,2"
com.apple.MobileSMS,6,1722350313,1722350319,1722350319.517206,-14400,EB445137-D7F5-57EC-87DA-1DB460D64046,"iPhone13,2"
com.apple.Health,15,1722346583,1722346598,1722346598.9697661,-14400,EB445137-D7F5-57EC-87DA-1DB460D64046,"iPhone13,2"
com.apple.news,152,1722346426,1722346578,1722346578.741696,-14400,EB445137-D7F5-57EC-87DA-1DB460D64046,"iPhone13,2"
com.toyopagroup.picaboo,54,1722346354,1722346408,1722346408.695374,-14400,EB445137-D7F5-57EC-87DA-1DB460D64046,"iPhone13,2"
com.apple.findmy,5,1722346345,1722346350,1722346350.799274,-14400,EB445137-D7F5-57EC-87DA-1DB460D64046,"iPhone13,2"
com.apple.mobiletimer,16,1722315832,1722315848,1722315848.03303,-14400,EB445137-D7F5-57EC-87DA-1DB460D64046,"iPhone13,2"
com.wbd.stream,95,1722315734,1722315829,1722315829.574368,-14400,EB445137-D7F5-57EC-87DA-1DB460D64046,"iPhone13,2"
com.apple.news,13,1722315711,1722315724,1722315724.416945,-14400,EB445137-D7F5-57EC-87DA-1DB460D64046,"iPhone13,2"
com.apple.news,11,1722315562,1722315573,1722315573.604018,-14400,EB445137-D7F5-57EC-87DA-1DB460D64046,"iPhone13,2"
com.apple.news,113,1722315133,1722315246,1722315246.955847,-14400,EB445137-D7F5-57EC-87DA-1DB460D64046,"iPhone13,2"
com.apple.news,176,1722314914,1722315090,1722315090.4503288,-14400,EB445137-D7F5-57EC-87DA-1DB460D64046,"iPhone13,2"
com.innersloth.amongus,4,1722314856,1722314860,1722314860.3180351,-14400,EB445137-D7F5-57EC-87DA-1DB460D64046,"iPhone13,2"
com.innersloth.amongus,3,1722313112,1722313115,1722313115.6845078,-14400,EB445137-D7F5-57EC-87DA-1DB460D64046,"iPhone13,2"
com.innersloth.amongus,10,1722311944,1722311954,1722311954.317237,-14400,EB445137-D7F5-57EC-87DA-1DB460D64046,"iPhone13,2"
com.innersloth.amongus,508,1722311427,1722311935,1722311936.055366,-14400,EB445137-D7F5-57EC-87DA-1DB460D64046,"iPhone13,2"
com.innersloth.amongus,2244,1722309118,1722311362,1722311362.525867,-14400,EB445137-D7F5-57EC-87DA-1DB460D64046,"iPhone13,2"
com.innersloth.amongus,34,1722308885,1722308919,1722308919.83493,-14400,EB445137-D7F5-57EC-87DA-1DB460D64046,"iPhone13,2"
com.innersloth.amongus,704,1722308037,1722308741,1722308741.327641,-14400,EB445137-D7F5-57EC-87DA-1DB460D64046,"iPhone13,2"
com.innersloth.amongus,5,1722307941,1722307946,1722307946.343556,-14400,EB445137-D7F5-57EC-87DA-1DB460D64046,"iPhone13,2"
com.innersloth.amongus,849,1722306828,1722307677,1722307677.3114839,-14400,EB445137-D7F5-57EC-87DA-1DB460D64046,"iPhone13,2"
com.apple.AppStore,193,1722306635,1722306828,1722306828.735486,-14400,EB445137-D7F5-57EC-87DA-1DB460D64046,"iPhone13,2"
com.apple.Preferences,22,1722306608,1722306630,1722306630.048039,-14400,EB445137-D7F5-57EC-87DA-1DB460D64046,"iPhone13,2"
com.hammerandchisel.discord,11,1722306082,1722306093,1722306093.2621078,-14400,EB445137-D7F5-57EC-87DA-1DB460D64046,"iPhone13,2"
com.apple.camera,21,1722304715,1722304736,1722304736.596765,-14400,EB445137-D7F5-57EC-87DA-1DB460D64046,"iPhone13,2"
com.apple.camera,5,1722295928,1722295933,1722295934.48684,-14400,EB445137-D7F5-57EC-87DA-1DB460D64046,"iPhone13,2"
com.apple.news,495,1722292784,1722293279,1722293279.827112,-14400,EB445137-D7F5-57EC-87DA-1DB460D64046,"iPhone13,2"
com.apple.news,61,1722292664,1722292725,1722292725.818964,-14400,EB445137-D7F5-57EC-87DA-1DB460D64046,"iPhone13,2"
com.apple.news,9,1722292486,1722292495,1722292495.2676048,-14400,EB445137-D7F5-57EC-87DA-1DB460D64046,"iPhone13,2"
com.apple.news,28,1722292398,1722292426,1722292426.9628038,-14400,EB445137-D7F5-57EC-87DA-1DB460D64046,"iPhone13,2"
com.google.chrome.ios,51,1722292347,1722292398,1722292398.974858,-14400,EB445137-D7F5-57EC-87DA-1DB460D64046,"iPhone13,2"
com.apple.news,342,1722292005,1722292347,1722292347.275363,-14400,EB445137-D7F5-57EC-87DA-1DB460D64046,"iPhone13,2"
com.apple.news,6,1722290004,1722290010,1722290010.088917,-14400,EB445137-D7F5-57EC-87DA-1DB460D64046,"iPhone13,2"
com.apple.news,1,1722289943,1722289944,1722289944.9300241,-14400,EB445137-D7F5-57EC-87DA-1DB460D64046,"iPhone13,2"
com.apple.news,603,1722280170,1722280773,1722280773.778481,-14400,EB445137-D7F5-57EC-87DA-1DB460D64046,"iPhone13,2"
com.apple.Preferences,10,1722280154,1722280164,1722280164.303618,-14400,EB445137-D7F5-57EC-87DA-1DB460D64046,"iPhone13,2"
com.apple.weather,10,1722280144,1722280154,1722280154.467362,-14400,EB445137-D7F5-57EC-87DA-1DB460D64046,"iPhone13,2"
com.apple.weather,6,1722280059,1722280065,1722280065.329921,-14400,EB445137-D7F5-57EC-87DA-1DB460D64046,"iPhone13,2"
com.apple.weather,6,1722278722,1722278728,1722278728.4435291,-14400,EB445137-D7F5-57EC-87DA-1DB460D64046,"iPhone13,2"
com.apple.weather,1,1722278720,1722278721,1722278721.621632,-14400,EB445137-D7F5-57EC-87DA-1DB460D64046,"iPhone13,2"
com.google.ios.youtube,65,1722275121,1722275186,1722275187.0279732,-14400,EB445137-D7F5-57EC-87DA-1DB460D64046,"iPhone13,2"
com.apple.MobileSMS,3,1722275118,1722275121,1722275121.684763,-14400,EB445137-D7F5-57EC-87DA-1DB460D64046,"iPhone13,2"
com.apple.news,2,1722275116,1722275118,1722275119.118264,-14400,EB445137-D7F5-57EC-87DA-1DB460D64046,"iPhone13,2"
com.apple.news,2,1722269474,1722269476,1722269476.1952229,-14400,EB445137-D7F5-57EC-87DA-1DB460D64046,"iPhone13,2"
com.apple.news,165,1722269131,1722269296,1722269297.043191,-14400,EB445137-D7F5-57EC-87DA-1DB460D64046,"iPhone13,2"
com.apple.news,4,1722268691,1722268695,1722268695.082663,-14400,EB445137-D7F5-57EC-87DA-1DB460D64046,"iPhone13,2"
com.apple.news,160,1722267974,1722268134,1722268134.534117,-14400,EB445137-D7F5-57EC-87DA-1DB460D64046,"iPhone13,2"
com.apple.Maps,7,1722267935,1722267942,1722267942.2336059,-14400,EB445137-D7F5-57EC-87DA-1DB460D64046,"iPhone13,2"
com.apple.Maps,6,1722267780,1722267786,1722267786.304768,-14400,EB445137-D7F5-57EC-87DA-1DB460D64046,"iPhone13,2"
com.apple.camera,0,1722266611,1722266611,1722266611.900078,-14400,EB445137-D7F5-57EC-87DA-1DB460D64046,"iPhone13,2"
com.apple.Maps,8,1722266609,1722266617,1722266617.883134,-14400,EB445137-D7F5-57EC-87DA-1DB460D64046,"iPhone13,2"
com.apple.Maps,2,1722266598,1722266600,1722266600.636623,-14400,EB445137-D7F5-57EC-87DA-1DB460D64046,"iPhone13,2"
com.apple.Maps,6,1722262921,1722262927,1722262927.9055681,-14400,EB445137-D7F5-57EC-87DA-1DB460D64046,"iPhone13,2"
com.apple.Maps,8,1722261334,1722261342,1722261342.135299,-14400,EB445137-D7F5-57EC-87DA-1DB460D64046,"iPhone13,2"
com.apple.Maps,20,1722261314,1722261334,1722261334.0776849,-14400,EB445137-D7F5-57EC-87DA-1DB460D64046,"iPhone13,2"
com.apple.Maps,3,1722261309,1722261312,1722261312.096537,-14400,EB445137-D7F5-57EC-87DA-1DB460D64046,"iPhone13,2"
com.apple.Maps,64,1722258569,1722258633,1722258633.5699348,-14400,EB445137-D7F5-57EC-87DA-1DB460D64046,"iPhone13,2"
com.apple.Maps,5,1722258531,1722258536,1722258536.580868,-14400,EB445137-D7F5-57EC-87DA-1DB460D64046,"iPhone13,2"
com.apple.Maps,51,1722258468,1722258519,1722258519.9795508,-14400,EB445137-D7F5-57EC-87DA-1DB460D64046,"iPhone13,2"
com.apple.Health,32,1722258356,1722258388,1722258388.044722,-14400,EB445137-D7F5-57EC-87DA-1DB460D64046,"iPhone13,2"
com.google.Gmail,4,1722256369,1722256373,1722256374.0046082,-14400,EB445137-D7F5-57EC-87DA-1DB460D64046,"iPhone13,2"
com.apple.mobiletimer,13,1722226710,1722226723,1722226723.5075731,-14400,EB445137-D7F5-57EC-87DA-1DB460D64046,"iPhone13,2"
com.apple.mobiletimer,4,1722226682,1722226686,1722226686.146974,-14400,EB445137-D7F5-57EC-87DA-1DB460D64046,"iPhone13,2"
com.apple.mobiletimer,22,1722226660,1722226682,1722226682.3931541,-14400,EB445137-D7F5-57EC-87DA-1DB460D64046,"iPhone13,2"
com.wbd.stream,1855,1722224793,1722226648,1722226648.434297,-14400,EB445137-D7F5-57EC-87DA-1DB460D64046,"iPhone13,2"
com.wbd.stream,58,1722224733,1722224791,1722224791.910077,-14400,EB445137-D7F5-57EC-87DA-1DB460D64046,"iPhone13,2"
com.apple.Preferences,11,1722224700,1722224711,1722224711.7947788,-14400,EB445137-D7F5-57EC-87DA-1DB460D64046,"iPhone13,2"
com.google.chrome.ios,100,1722205500,1722205600,1722205600.344266,-14400,EB445137-D7F5-57EC-87DA-1DB460D64046,"iPhone13,2"
com.apple.weather,1,1722205499,1722205500,1722205500.236339,-14400,EB445137-D7F5-57EC-87DA-1DB460D64046,"iPhone13,2"
com.apple.news,2,1722205497,1722205499,1722205499.299927,-14400,EB445137-D7F5-57EC-87DA-1DB460D64046,"iPhone13,2"
com.apple.news,51,1722203171,1722203222,1722203222.238799,-14400,EB445137-D7F5-57EC-87DA-1DB460D64046,"iPhone13,2"
com.apple.news,44,1722203120,1722203164,1722203164.7818642,-14400,EB445137-D7F5-57EC-87DA-1DB460D64046,"iPhone13,2"
com.thestorygraph.thestorygraph,30,1722202943,1722202973,1722202973.758471,-14400,EB445137-D7F5-57EC-87DA-1DB460D64046,"iPhone13,2"
com.apple.findmy,4,1722202939,1722202943,1722202943.139991,-14400,EB445137-D7F5-57EC-87DA-1DB460D64046,"iPhone13,2"
com.apple.PeopleViewService,3,1722202932,1722202935,1722202936.0012488,-14400,EB445137-D7F5-57EC-87DA-1DB460D64046,"iPhone13,2"
com.apple.PeopleViewService,1,1722202387,1722202388,1722202388.322288,-14400,EB445137-D7F5-57EC-87DA-1DB460D64046,"iPhone13,2"
com.apple.PeopleViewService,2,1722201051,1722201053,1722201053.493187,-14400,EB445137-D7F5-57EC-87DA-1DB460D64046,"iPhone13,2"
com.apple.PeopleViewService,2,1722198887,1722198889,1722198889.147794,-14400,EB445137-D7F5-57EC-87DA-1DB460D64046,"iPhone13,2"
com.thestorygraph.thestorygraph,81,1722198806,1722198887,1722198887.669269,-14400,EB445137-D7F5-57EC-87DA-1DB460D64046,"iPhone13,2"
com.apple.news,117,1722198426,1722198543,1722198544.0227408,-14400,EB445137-D7F5-57EC-87DA-1DB460D64046,"iPhone13,2"
com.apple.Maps,108,1722198308,1722198416,1722198416.4147959,-14400,EB445137-D7F5-57EC-87DA-1DB460D64046,"iPhone13,2"
com.apple.reminders,8,1722198281,1722198289,1722198289.995977,-14400,EB445137-D7F5-57EC-87DA-1DB460D64046,"iPhone13,2"
com.google.Chrome,367,1722198179,1722198546,1722198546.685559,-14400,,
com.apple.reminders,37,1722198093,1722198130,1722198130.9274049,-14400,EB445137-D7F5-57EC-87DA-1DB460D64046,"iPhone13,2"
com.apple.news,4,1722198089,1722198093,1722198093.69817,-14400,EB445137-D7F5-57EC-87DA-1DB460D64046,"iPhone13,2"
com.apple.news,6,1722198012,1722198018,1722198018.467124,-14400,EB445137-D7F5-57EC-87DA-1DB460D64046,"iPhone13,2"
com.apple.news,199,1722197141,1722197340,1722197340.3756151,-14400,EB445137-D7F5-57EC-87DA-1DB460D64046,"iPhone13,2"
com.doordash.dasher,21,1722196712,1722196733,1722196733.2045178,-14400,EB445137-D7F5-57EC-87DA-1DB460D64046,"iPhone13,2"
com.apple.news,3,1722196694,1722196697,1722196697.383662,-14400,EB445137-D7F5-57EC-87DA-1DB460D64046,"iPhone13,2"
com.google.Chrome,1380,1722196257,1722197637,1722197637.749958,-14400,,
com.apple.news,93,1722194438,1722194531,1722194531.8649368,-14400,EB445137-D7F5-57EC-87DA-1DB460D64046,"iPhone13,2"
com.apple.news,3,1722194410,1722194413,1722194413.898745,-14400,EB445137-D7F5-57EC-87DA-1DB460D64046,"iPhone13,2"
com.google.Chrome,1107,1722192380,1722193487,1722193487.3260078,-14400,,
com.apple.camera,1,1722192228,1722192229,1722192229.428011,-14400,EB445137-D7F5-57EC-87DA-1DB460D64046,"iPhone13,2"
com.google.Chrome,300,1722191736,1722192036,1722192036.900954,-14400,,
com.apple.news,41,1722190994,1722191035,1722191035.330142,-14400,EB445137-D7F5-57EC-87DA-1DB460D64046,"iPhone13,2"
com.apple.mobileslideshow,19,1722190942,1722190961,1722190961.620363,-14400,EB445137-D7F5-57EC-87DA-1DB460D64046,"iPhone13,2"
com.apple.mobileslideshow,9,1722190931,1722190940,1722190940.133086,-14400,EB445137-D7F5-57EC-87DA-1DB460D64046,"iPhone13,2"
com.apple.mobileslideshow,66,1722190787,1722190853,1722190853.540217,-14400,EB445137-D7F5-57EC-87DA-1DB460D64046,"iPhone13,2"
com.apple.camera,3,1722190781,1722190784,1722190784.1810741,-14400,EB445137-D7F5-57EC-87DA-1DB460D64046,"iPhone13,2"
com.google.Chrome,509,1722190770,1722191279,1722191279.258834,-14400,,
com.apple.camera,6,1722190188,1722190194,1722190194.2760181,-14400,EB445137-D7F5-57EC-87DA-1DB460D64046,"iPhone13,2"
com.apple.camera,6,1722189594,1722189600,1722189600.5716681,-14400,EB445137-D7F5-57EC-87DA-1DB460D64046,"iPhone13,2"
com.apple.camera,2,1722189357,1722189359,1722189359.864986,-14400,EB445137-D7F5-57EC-87DA-1DB460D64046,"iPhone13,2"
com.apple.camera,2,1722189259,1722189261,1722189261.484916,-14400,EB445137-D7F5-57EC-87DA-1DB460D64046,"iPhone13,2"
com.apple.camera,2,1722189217,1722189219,1722189219.4701939,-14400,EB445137-D7F5-57EC-87DA-1DB460D64046,"iPhone13,2"
com.apple.camera,9,1722185325,1722185334,1722185336.880235,-14400,EB445137-D7F5-57EC-87DA-1DB460D64046,"iPhone13,2"
com.apple.Maps,8,1722185316,1722185324,1722185324.592562,-14400,EB445137-D7F5-57EC-87DA-1DB460D64046,"iPhone13,2"
com.apple.Maps,84,1722185231,1722185315,1722185315.316227,-14400,EB445137-D7F5-57EC-87DA-1DB460D64046,"iPhone13,2"
com.apple.Maps,8,1722185151,1722185159,1722185160.0321732,-14400,EB445137-D7F5-57EC-87DA-1DB460D64046,"iPhone13,2"
com.apple.Maps,157,1722184799,1722184956,1722184956.196415,-14400,EB445137-D7F5-57EC-87DA-1DB460D64046,"iPhone13,2"
com.google.ios.youtube,1,1722184797,1722184798,1722184799.005618,-14400,EB445137-D7F5-57EC-87DA-1DB460D64046,"iPhone13,2"
com.google.ios.youtube,6,1722184782,1722184788,1722184788.483624,-14400,EB445137-D7F5-57EC-87DA-1DB460D64046,"iPhone13,2"
com.google.ios.youtube,12,1722184593,1722184605,1722184605.158276,-14400,EB445137-D7F5-57EC-87DA-1DB460D64046,"iPhone13,2"
com.google.ios.youtube,69,1722183827,1722183896,1722183896.754858,-14400,EB445137-D7F5-57EC-87DA-1DB460D64046,"iPhone13,2"
com.google.ios.youtube,0,1722183825,1722183825,1722183825.9632258,-14400,EB445137-D7F5-57EC-87DA-1DB460D64046,"iPhone13,2"
com.apple.MobileSMS,4,1722183823,1722183827,1722183828.019238,-14400,EB445137-D7F5-57EC-87DA-1DB460D64046,"iPhone13,2"
com.google.ios.youtube,15,1722183808,1722183823,1722183823.36046,-14400,EB445137-D7F5-57EC-87DA-1DB460D64046,"iPhone13,2"
com.google.chrome.ios,13,1722183795,1722183808,1722183809.053854,-14400,EB445137-D7F5-57EC-87DA-1DB460D64046,"iPhone13,2"
com.apple.weather,1,1722183794,1722183795,1722183795.874846,-14400,EB445137-D7F5-57EC-87DA-1DB460D64046,"iPhone13,2"
com.apple.MobileSMS,5,1722183688,1722183693,1722183693.880074,-14400,EB445137-D7F5-57EC-87DA-1DB460D64046,"iPhone13,2"
com.apple.MobileSMS,48,1722183637,1722183685,1722183685.397198,-14400,EB445137-D7F5-57EC-87DA-1DB460D64046,"iPhone13,2"
com.apple.MobileSMS,73,1722183553,1722183626,1722183626.889858,-14400,EB445137-D7F5-57EC-87DA-1DB460D64046,"iPhone13,2"
com.google.ios.youtube,9,1722183544,1722183553,1722183553.235992,-14400,EB445137-D7F5-57EC-87DA-1DB460D64046,"iPhone13,2"
com.apple.MobileSMS,2,1722183542,1722183544,1722183544.171727,-14400,EB445137-D7F5-57EC-87DA-1DB460D64046,"iPhone13,2"
com.apple.Music,1,1722183541,1722183542,1722183543.09745,-14400,EB445137-D7F5-57EC-87DA-1DB460D64046,"iPhone13,2"
com.apple.Music,6,1722183464,1722183470,1722183470.8000631,-14400,EB445137-D7F5-57EC-87DA-1DB460D64046,"iPhone13,2"
com.apple.Music,68,1722182576,1722182644,1722182644.8581672,-14400,EB445137-D7F5-57EC-87DA-1DB460D64046,"iPhone13,2"
com.apple.Music,22,1722182519,1722182541,1722182541.989193,-14400,EB445137-D7F5-57EC-87DA-1DB460D64046,"iPhone13,2"
com.apple.MobileSMS,2,1722182516,1722182518,1722182518.37534,-14400,EB445137-D7F5-57EC-87DA-1DB460D64046,"iPhone13,2"
com.hammerandchisel.discord,13,1722180190,1722180203,1722180203.533638,-14400,EB445137-D7F5-57EC-87DA-1DB460D64046,"iPhone13,2"
com.apple.MobileSMS,4,1722180185,1722180189,1722180189.536195,-14400,EB445137-D7F5-57EC-87DA-1DB460D64046,"iPhone13,2"
com.apple.findmy,1,1722180184,1722180185,1722180186.690956,-14400,EB445137-D7F5-57EC-87DA-1DB460D64046,"iPhone13,2"
com.apple.findmy,15,1722179242,1722179257,1722179257.110467,-14400,EB445137-D7F5-57EC-87DA-1DB460D64046,"iPhone13,2"
com.apple.news,87,1722179155,1722179242,1722179242.6602712,-14400,EB445137-D7F5-57EC-87DA-1DB460D64046,"iPhone13,2"
com.apple.findmy,34,1722179121,1722179155,1722179156.0625381,-14400,EB445137-D7F5-57EC-87DA-1DB460D64046,"iPhone13,2"
com.apple.news,149,1722178972,1722179121,1722179121.48986,-14400,EB445137-D7F5-57EC-87DA-1DB460D64046,"iPhone13,2"
com.apple.findmy,15,1722178957,1722178972,1722178973.278688,-14400,EB445137-D7F5-57EC-87DA-1DB460D64046,"iPhone13,2"
com.apple.news,375,1722178581,1722178956,1722178957.396106,-14400,EB445137-D7F5-57EC-87DA-1DB460D64046,"iPhone13,2"
com.truebill.truebillnative,73,1722178495,1722178568,1722178568.537966,-14400,EB445137-D7F5-57EC-87DA-1DB460D64046,"iPhone13,2"
com.robinhood.release.Robinhood,36,1722178454,1722178490,1722178490.47105,-14400,EB445137-D7F5-57EC-87DA-1DB460D64046,"iPhone13,2"
com.hammerandchisel.discord,3,1722178431,1722178434,1722178434.143178,-14400,EB445137-D7F5-57EC-87DA-1DB460D64046,"iPhone13,2"
com.apple.findmy,37,1722177681,1722177718,1722177718.846714,-14400,EB445137-D7F5-57EC-87DA-1DB460D64046,"iPhone13,2"
com.hammerandchisel.discord,14,1722177667,1722177681,1722177681.428679,-14400,EB445137-D7F5-57EC-87DA-1DB460D64046,"iPhone13,2"
com.apple.Health,36,1722177630,1722177666,1722177666.076459,-14400,EB445137-D7F5-57EC-87DA-1DB460D64046,"iPhone13,2"
com.google.chrome.ios,47,1722177572,1722177619,1722177620.1211739,-14400,EB445137-D7F5-57EC-87DA-1DB460D64046,"iPhone13,2"
com.apple.MobileSMS,20,1722177552,1722177572,1722177572.187016,-14400,EB445137-D7F5-57EC-87DA-1DB460D64046,"iPhone13,2"
com.apple.Health,4,1722177548,1722177552,1722177553.510361,-14400,EB445137-D7F5-57EC-87DA-1DB460D64046,"iPhone13,2"
com.apple.Health,3,1722174397,1722174400,1722174400.93242,-14400,EB445137-D7F5-57EC-87DA-1DB460D64046,"iPhone13,2"
com.apple.Health,9,1722174244,1722174253,1722174253.3208199,-14400,EB445137-D7F5-57EC-87DA-1DB460D64046,"iPhone13,2"
com.apple.Health,1,1722174241,1722174242,1722174242.9012098,-14400,EB445137-D7F5-57EC-87DA-1DB460D64046,"iPhone13,2"
com.apple.Health,91,1722172378,1722172469,1722172469.090602,-14400,EB445137-D7F5-57EC-87DA-1DB460D64046,"iPhone13,2"
com.apple.journal,1130,1722144021,1722145151,1722145151.950836,-14400,EB445137-D7F5-57EC-87DA-1DB460D64046,"iPhone13,2"
com.apple.mobiletimer,8,1722144010,1722144018,1722144018.292708,-14400,EB445137-D7F5-57EC-87DA-1DB460D64046,"iPhone13,2"
com.apple.camera,0,1722143984,1722143984,1722143984.437084,-14400,EB445137-D7F5-57EC-87DA-1DB460D64046,"iPhone13,2"
com.apple.mobiletimer,17,1722143983,1722144000,1722144000.382492,-14400,EB445137-D7F5-57EC-87DA-1DB460D64046,"iPhone13,2"
com.apple.mobiletimer,3,1722143858,1722143861,1722143861.266049,-14400,EB445137-D7F5-57EC-87DA-1DB460D64046,"iPhone13,2"
com.apple.mobiletimer,13,1722143760,1722143773,1722143773.547899,-14400,EB445137-D7F5-57EC-87DA-1DB460D64046,"iPhone13,2"
com.apple.mobiletimer,21,1722143604,1722143625,1722143625.152642,-14400,EB445137-D7F5-57EC-87DA-1DB460D64046,"iPhone13,2"
com.apple.MobileSMS,10,1722143585,1722143595,1722143595.335561,-14400,EB445137-D7F5-57EC-87DA-1DB460D64046,"iPhone13,2"
com.apple.MobileSMS,47,1722143007,1722143054,1722143054.705902,-14400,EB445137-D7F5-57EC-87DA-1DB460D64046,"iPhone13,2"
com.apple.MobileSMS,69,1722142936,1722143005,1722143005.26405,-14400,EB445137-D7F5-57EC-87DA-1DB460D64046,"iPhone13,2"
com.hammerandchisel.discord,6,1722136699,1722136705,1722136705.124162,-14400,EB445137-D7F5-57EC-87DA-1DB460D64046,"iPhone13,2"
com.apple.MobileSMS,10,1722136689,1722136699,1722136699.89706,-14400,EB445137-D7F5-57EC-87DA-1DB460D64046,"iPhone13,2"
com.apple.MobileSMS,15,1722135350,1722135365,1722135365.590685,-14400,EB445137-D7F5-57EC-87DA-1DB460D64046,"iPhone13,2"
com.apple.MobileSMS,53,1722134867,1722134920,1722134920.9876962,-14400,EB445137-D7F5-57EC-87DA-1DB460D64046,"iPhone13,2"
com.apple.mobiletimer,10,1722047910,1722047920,1722047920.142775,-14400,EB445137-D7F5-57EC-87DA-1DB460D64046,"iPhone13,2"
com.apple.mobiletimer,12,1722047400,1722047412,1722047412.1229138,-14400,EB445137-D7F5-57EC-87DA-1DB460D64046,"iPhone13,2"
com.apple.mobiletimer,13,1722046223,1722046236,1722046236.022471,-14400,EB445137-D7F5-57EC-87DA-1DB460D64046,"iPhone13,2"
com.apple.mobiletimer,14,1722046203,1722046217,1722046217.88209,-14400,EB445137-D7F5-57EC-87DA-1DB460D64046,"iPhone13,2"
com.apple.mobiletimer,3,1722046182,1722046185,1722046185.0052872,-14400,EB445137-D7F5-57EC-87DA-1DB460D64046,"iPhone13,2"
com.apple.mobiletimer,3,1722046177,1722046180,1722046180.238498,-14400,EB445137-D7F5-57EC-87DA-1DB460D64046,"iPhone13,2"
com.apple.mobiletimer,17,1722046159,1722046176,1722046176.2432752,-14400,EB445137-D7F5-57EC-87DA-1DB460D64046,"iPhone13,2"
com.hammerandchisel.discord,2,1722046154,1722046156,1722046156.20955,-14400,EB445137-D7F5-57EC-87DA-1DB460D64046,"iPhone13,2"
com.apple.MobileSMS,6,1722046143,1722046149,1722046149.310293,-14400,EB445137-D7F5-57EC-87DA-1DB460D64046,"iPhone13,2"
com.google.Chrome,300,1722046128,1722046428,1722046428.713232,-14400,,
com.google.Chrome,1670,1722044446,1722046116,1722046116.386975,-14400,,
com.apple.news,0,1722044175,1722044175,1722044175.864177,-14400,EB445137-D7F5-57EC-87DA-1DB460D64046,"iPhone13,2"
com.apple.news,27,1722044083,1722044110,1722044110.3538709,-14400,EB445137-D7F5-57EC-87DA-1DB460D64046,"iPhone13,2"
com.apple.news,37,1722043167,1722043204,1722043204.716928,-14400,EB445137-D7F5-57EC-87DA-1DB460D64046,"iPhone13,2"
com.apple.news,13,1722043153,1722043166,1722043166.981751,-14400,EB445137-D7F5-57EC-87DA-1DB460D64046,"iPhone13,2"
com.hammerandchisel.discord,9,1722043133,1722043142,1722043142.924526,-14400,EB445137-D7F5-57EC-87DA-1DB460D64046,"iPhone13,2"
com.apple.Maps,5,1722043128,1722043133,1722043134.406743,-14400,EB445137-D7F5-57EC-87DA-1DB460D64046,"iPhone13,2"
com.apple.Maps,26,1722042816,1722042842,1722042842.648532,-14400,EB445137-D7F5-57EC-87DA-1DB460D64046,"iPhone13,2"
com.apple.Maps,26,1722042607,1722042633,1722042633.077416,-14400,EB445137-D7F5-57EC-87DA-1DB460D64046,"iPhone13,2"
com.apple.calculator,1,1722042142,1722042143,1722042143.792592,-14400,EB445137-D7F5-57EC-87DA-1DB460D64046,"iPhone13,2"
com.google.chrome.ios,3,1722042139,1722042142,1722042142.5189981,-14400,EB445137-D7F5-57EC-87DA-1DB460D64046,"iPhone13,2"
com.apple.calculator,46,1722042093,1722042139,1722042139.568569,-14400,EB445137-D7F5-57EC-87DA-1DB460D64046,"iPhone13,2"
com.apple.Maps,21,1722042071,1722042092,1722042092.466212,-14400,EB445137-D7F5-57EC-87DA-1DB460D64046,"iPhone13,2"
com.google.chrome.ios,177,1722041890,1722042067,1722042067.4436278,-14400,EB445137-D7F5-57EC-87DA-1DB460D64046,"iPhone13,2"
com.apple.Maps,51,1722041809,1722041860,1722041860.889606,-14400,EB445137-D7F5-57EC-87DA-1DB460D64046,"iPhone13,2"
com.apple.Maps,15,1722041592,1722041607,1722041607.359613,-14400,EB445137-D7F5-57EC-87DA-1DB460D64046,"iPhone13,2"
com.apple.Maps,2,1722041589,1722041591,1722041591.278549,-14400,EB445137-D7F5-57EC-87DA-1DB460D64046,"iPhone13,2"
com.apple.Maps,3,1722041586,1722041589,1722041589.3712301,-14400,EB445137-D7F5-57EC-87DA-1DB460D64046,"iPhone13,2"
com.apple.Maps,5,1722041579,1722041584,1722041584.6402578,-14400,EB445137-D7F5-57EC-87DA-1DB460D64046,"iPhone13,2"
com.apple.Maps,29,1722040670,1722040699,1722040699.527697,-14400,EB445137-D7F5-57EC-87DA-1DB460D64046,"iPhone13,2"
com.apple.Maps,13,1722039687,1722039700,1722039700.565236,-14400,EB445137-D7F5-57EC-87DA-1DB460D64046,"iPhone13,2"
com.apple.Maps,21,1722039645,1722039666,1722039666.482579,-14400,EB445137-D7F5-57EC-87DA-1DB460D64046,"iPhone13,2"
com.apple.Maps,59,1722039574,1722039633,1722039633.3892221,-14400,EB445137-D7F5-57EC-87DA-1DB460D64046,"iPhone13,2"
com.apple.Maps,15,1722038215,1722038230,1722038230.564753,-14400,EB445137-D7F5-57EC-87DA-1DB460D64046,"iPhone13,2"
com.apple.Maps,17,1722038198,1722038215,1722038215.3241072,-14400,EB445137-D7F5-57EC-87DA-1DB460D64046,"iPhone13,2"
com.apple.Music,4,1722034847,1722034851,1722034851.827008,-14400,EB445137-D7F5-57EC-87DA-1DB460D64046,"iPhone13,2"
com.apple.Maps,15,1722034713,1722034728,1722034728.610718,-14400,EB445137-D7F5-57EC-87DA-1DB460D64046,"iPhone13,2"
com.apple.MobileSMS,2,1722034711,1722034713,1722034714.0017672,-14400,EB445137-D7F5-57EC-87DA-1DB460D64046,"iPhone13,2"
com.apple.Maps,8,1722034699,1722034707,1722034707.715553,-14400,EB445137-D7F5-57EC-87DA-1DB460D64046,"iPhone13,2"
com.apple.MobileSMS,4,1722034695,1722034699,1722034699.990343,-14400,EB445137-D7F5-57EC-87DA-1DB460D64046,"iPhone13,2"
com.apple.Maps,21,1722034672,1722034693,1722034693.359179,-14400,EB445137-D7F5-57EC-87DA-1DB460D64046,"iPhone13,2"
com.apple.Maps,61,1722032099,1722032160,1722032160.8437781,-14400,EB445137-D7F5-57EC-87DA-1DB460D64046,"iPhone13,2"
com.apple.Music,11,1722032088,1722032099,1722032099.114009,-14400,EB445137-D7F5-57EC-87DA-1DB460D64046,"iPhone13,2"
com.apple.Maps,25,1722032063,1722032088,1722032088.655675,-14400,EB445137-D7F5-57EC-87DA-1DB460D64046,"iPhone13,2"
com.apple.Music,31,1722032030,1722032061,1722032061.890894,-14400,EB445137-D7F5-57EC-87DA-1DB460D64046,"iPhone13,2"
com.apple.Music,29,1722031992,1722032021,1722032021.4864469,-14400,EB445137-D7F5-57EC-87DA-1DB460D64046,"iPhone13,2"
com.apple.Music,58,1722031927,1722031985,1722031985.8162751,-14400,EB445137-D7F5-57EC-87DA-1DB460D64046,"iPhone13,2"
com.apple.camera,5,1722031922,1722031927,1722031928.227951,-14400,EB445137-D7F5-57EC-87DA-1DB460D64046,"iPhone13,2"
com.apple.Music,73,1722031467,1722031540,1722031540.618009,-14400,EB445137-D7F5-57EC-87DA-1DB460D64046,"iPhone13,2"
com.apple.Maps,3,1722031458,1722031461,1722031461.701271,-14400,EB445137-D7F5-57EC-87DA-1DB460D64046,"iPhone13,2"
com.apple.Maps,48,1722031092,1722031140,1722031140.205639,-14400,EB445137-D7F5-57EC-87DA-1DB460D64046,"iPhone13,2"
com.apple.Maps,70,1722030382,1722030452,1722030452.770283,-14400,EB445137-D7F5-57EC-87DA-1DB460D64046,"iPhone13,2"
com.google.chrome.ios,6,1722030375,1722030381,1722030381.827213,-14400,EB445137-D7F5-57EC-87DA-1DB460D64046,"iPhone13,2"
com.google.chrome.ios,3,1722029943,1722029946,1722029946.2945051,-14400,EB445137-D7F5-57EC-87DA-1DB460D64046,"iPhone13,2"
com.google.chrome.ios,3,1722029595,1722029598,1722029598.4755058,-14400,EB445137-D7F5-57EC-87DA-1DB460D64046,"iPhone13,2"
com.google.chrome.ios,18,1722029388,1722029406,1722029406.8593578,-14400,EB445137-D7F5-57EC-87DA-1DB460D64046,"iPhone13,2"
com.apple.Music,16,1722028699,1722028715,1722028715.1483068,-14400,EB445137-D7F5-57EC-87DA-1DB460D64046,"iPhone13,2"
com.apple.Music,36,1722028591,1722028627,1722028627.077923,-14400,EB445137-D7F5-57EC-87DA-1DB460D64046,"iPhone13,2"
com.apple.Music,28,1722028561,1722028589,1722028589.109329,-14400,EB445137-D7F5-57EC-87DA-1DB460D64046,"iPhone13,2"
com.apple.camera,14,1722028547,1722028561,1722028561.598573,-14400,EB445137-D7F5-57EC-87DA-1DB460D64046,"iPhone13,2"
com.apple.Maps,108,1722027885,1722027993,1722027993.790015,-14400,EB445137-D7F5-57EC-87DA-1DB460D64046,"iPhone13,2"
com.apple.Maps,41,1722025624,1722025665,1722025665.191762,-14400,EB445137-D7F5-57EC-87DA-1DB460D64046,"iPhone13,2"
com.apple.Maps,3,1722025108,1722025111,1722025111.847628,-14400,EB445137-D7F5-57EC-87DA-1DB460D64046,"iPhone13,2"
com.apple.Maps,13,1722024453,1722024466,1722024466.384976,-14400,EB445137-D7F5-57EC-87DA-1DB460D64046,"iPhone13,2"
com.apple.MobileSMS,3,1722024450,1722024453,1722024453.0978231,-14400,EB445137-D7F5-57EC-87DA-1DB460D64046,"iPhone13,2"
com.apple.MobileSMS,5,1722023788,1722023793,1722023793.527416,-14400,EB445137-D7F5-57EC-87DA-1DB460D64046,"iPhone13,2"
com.apple.MobileSMS,3,1722023771,1722023774,1722023774.3449922,-14400,EB445137-D7F5-57EC-87DA-1DB460D64046,"iPhone13,2"
com.apple.mobilephone,6,1722022975,1722022981,1722022981.9102058,-14400,EB445137-D7F5-57EC-87DA-1DB460D64046,"iPhone13,2"
com.apple.Maps,18,1722022956,1722022974,1722022974.866209,-14400,EB445137-D7F5-57EC-87DA-1DB460D64046,"iPhone13,2"
com.apple.findmy,4,1722022952,1722022956,1722022956.2891688,-14400,EB445137-D7F5-57EC-87DA-1DB460D64046,"iPhone13,2"
com.apple.MobileSMS,4,1722020654,1722020658,1722020658.943136,-14400,EB445137-D7F5-57EC-87DA-1DB460D64046,"iPhone13,2"
com.apple.MobileSMS,10,1722020630,1722020640,1722020640.480716,-14400,EB445137-D7F5-57EC-87DA-1DB460D64046,"iPhone13,2"
com.apple.MobileSMS,15,1722020614,1722020629,1722020629.3477259,-14400,EB445137-D7F5-57EC-87DA-1DB460D64046,"iPhone13,2"
com.apple.MobileSMS,6,1722020580,1722020586,1722020586.25354,-14400,EB445137-D7F5-57EC-87DA-1DB460D64046,"iPhone13,2"
com.clairmail.fth.client,38,1722020542,1722020580,1722020580.331105,-14400,EB445137-D7F5-57EC-87DA-1DB460D64046,"iPhone13,2"
com.apple.MobileSMS,132,1722020408,1722020540,1722020540.131633,-14400,EB445137-D7F5-57EC-87DA-1DB460D64046,"iPhone13,2"
com.apple.camera,3,1722020391,1722020394,1722020394.6394238,-14400,EB445137-D7F5-57EC-87DA-1DB460D64046,"iPhone13,2"
com.apple.MobileSMS,23,1722020380,1722020403,1722020403.487278,-14400,EB445137-D7F5-57EC-87DA-1DB460D64046,"iPhone13,2"
com.apple.MobileSMS,8,1722020263,1722020271,1722020271.7613091,-14400,EB445137-D7F5-57EC-87DA-1DB460D64046,"iPhone13,2"
com.hammerandchisel.discord,7,1722020254,1722020261,1722020261.778613,-14400,EB445137-D7F5-57EC-87DA-1DB460D64046,"iPhone13,2"
com.apple.MobileSMS,6,1722020245,1722020251,1722020251.566829,-14400,EB445137-D7F5-57EC-87DA-1DB460D64046,"iPhone13,2"
com.apple.findmy,7,1722020238,1722020245,1722020245.77444,-14400,EB445137-D7F5-57EC-87DA-1DB460D64046,"iPhone13,2"
com.apple.MobileSMS,6,1722020231,1722020237,1722020238.082254,-14400,EB445137-D7F5-57EC-87DA-1DB460D64046,"iPhone13,2"
com.apple.Maps,33,1722020198,1722020231,1722020231.515574,-14400,EB445137-D7F5-57EC-87DA-1DB460D64046,"iPhone13,2"
com.apple.Maps,2,1722019801,1722019803,1722019803.582334,-14400,EB445137-D7F5-57EC-87DA-1DB460D64046,"iPhone13,2"
com.apple.Maps,9,1722019292,1722019301,1722019301.530209,-14400,EB445137-D7F5-57EC-87DA-1DB460D64046,"iPhone13,2"
com.apple.news,3,1722019287,1722019290,1722019290.525785,-14400,EB445137-D7F5-57EC-87DA-1DB460D64046,"iPhone13,2"
com.apple.news,787,1722018403,1722019190,1722019190.922964,-14400,EB445137-D7F5-57EC-87DA-1DB460D64046,"iPhone13,2"
com.apple.Maps,3,1722018396,1722018399,1722018399.871513,-14400,EB445137-D7F5-57EC-87DA-1DB460D64046,"iPhone13,2"
com.apple.Maps,11,1722018260,1722018271,1722018271.73824,-14400,EB445137-D7F5-57EC-87DA-1DB460D64046,"iPhone13,2"
com.apple.Maps,24,1722018232,1722018256,1722018256.385304,-14400,EB445137-D7F5-57EC-87DA-1DB460D64046,"iPhone13,2"
com.apple.Maps,3,1722018229,1722018232,1722018232.7523398,-14400,EB445137-D7F5-57EC-87DA-1DB460D64046,"iPhone13,2"
com.apple.Maps,6,1722017967,1722017973,1722017973.448673,-14400,EB445137-D7F5-57EC-87DA-1DB460D64046,"iPhone13,2"
com.apple.Maps,45,1722017629,1722017674,1722017674.1832209,-14400,EB445137-D7F5-57EC-87DA-1DB460D64046,"iPhone13,2"
com.apple.Music,2,1722017626,1722017628,1722017628.951241,-14400,EB445137-D7F5-57EC-87DA-1DB460D64046,"iPhone13,2"
com.apple.mobilenotes,13,1721967996,1721968009,1721968009.20536,-18000,EB445137-D7F5-57EC-87DA-1DB460D64046,"iPhone13,2"
com.apple.mobilenotes,12,1721967981,1721967993,1721967993.412159,-18000,EB445137-D7F5-57EC-87DA-1DB460D64046,"iPhone13,2"
com.apple.mobilenotes,71,1721967905,1721967976,1721967976.61874,-18000,EB445137-D7F5-57EC-87DA-1DB460D64046,"iPhone13,2"
com.apple.Maps,5,1721967897,1721967902,1721967902.726196,-18000,EB445137-D7F5-57EC-87DA-1DB460D64046,"iPhone13,2"
com.apple.Maps,12,1721967205,1721967217,1721967217.9164128,-18000,EB445137-D7F5-57EC-87DA-1DB460D64046,"iPhone13,2"
com.apple.Maps,4,1721967199,1721967203,1721967203.184928,-18000,EB445137-D7F5-57EC-87DA-1DB460D64046,"iPhone13,2"
com.google.Chrome,939,1721966086,1721967025,1721967025.873167,-18000,,
com.google.Chrome,414,1721965536,1721965950,1721965950.910249,-18000,,
com.google.Chrome,468,1721964923,1721965391,1721965391.513917,-18000,,
com.apple.MobileSMS,3,1721964920,1721964923,1721964923.872268,-18000,,
com.google.Chrome,1,1721964919,1721964920,1721964920.677496,-18000,,
com.apple.finder,1,1721964918,1721964919,1721964919.7606149,-18000,,
com.apple.systempreferences,0,1721964918,1721964918,1721964918.653775,-18000,,
com.apple.Maps,12,1721964600,1721964612,1721964612.640702,-18000,EB445137-D7F5-57EC-87DA-1DB460D64046,"iPhone13,2"
com.apple.Maps,6,1721964426,1721964432,1721964432.542297,-18000,EB445137-D7F5-57EC-87DA-1DB460D64046,"iPhone13,2"
com.apple.Maps,104,1721964169,1721964273,1721964273.9896111,-18000,EB445137-D7F5-57EC-87DA-1DB460D64046,"iPhone13,2"
com.apple.Maps,212,1721963816,1721964028,1721964028.393863,-18000,EB445137-D7F5-57EC-87DA-1DB460D64046,"iPhone13,2"
com.google.ios.youtube,2,1721963809,1721963811,1721963811.7373009,-18000,EB445137-D7F5-57EC-87DA-1DB460D64046,"iPhone13,2"
com.google.ios.youtube,39,1721963474,1721963513,1721963513.1016688,-18000,EB445137-D7F5-57EC-87DA-1DB460D64046,"iPhone13,2"
com.google.chrome.ios,9,1721963400,1721963409,1721963409.221803,-18000,EB445137-D7F5-57EC-87DA-1DB460D64046,"iPhone13,2"
com.google.chrome.ios,2,1721962968,1721962970,1721962970.4550261,-18000,EB445137-D7F5-57EC-87DA-1DB460D64046,"iPhone13,2"
com.google.chrome.ios,48,1721962920,1721962968,1721962968.195414,-18000,EB445137-D7F5-57EC-87DA-1DB460D64046,"iPhone13,2"
com.apple.MobileSMS,10,1721962879,1721962889,1721962889.284029,-18000,EB445137-D7F5-57EC-87DA-1DB460D64046,"iPhone13,2"
com.apple.MobileSMS,3,1721962721,1721962724,1721962724.210743,-18000,EB445137-D7F5-57EC-87DA-1DB460D64046,"iPhone13,2"
com.apple.MobileSMS,6,1721961950,1721961956,1721961956.307529,-18000,EB445137-D7F5-57EC-87DA-1DB460D64046,"iPhone13,2"
com.apple.MobileSMS,3,1721961444,1721961447,1721961447.087202,-18000,EB445137-D7F5-57EC-87DA-1DB460D64046,"iPhone13,2"
com.apple.mobiletimer,1,1721961443,1721961444,1721961445.0065,-18000,EB445137-D7F5-57EC-87DA-1DB460D64046,"iPhone13,2"
com.apple.mobiletimer,11,1721961343,1721961354,1721961354.5003,-18000,EB445137-D7F5-57EC-87DA-1DB460D64046,"iPhone13,2"
com.apple.mobiletimer,55,1721961279,1721961334,1721961334.6747642,-18000,EB445137-D7F5-57EC-87DA-1DB460D64046,"iPhone13,2"
com.hulu.plus,3,1721961276,1721961279,1721961279.8000112,-18000,EB445137-D7F5-57EC-87DA-1DB460D64046,"iPhone13,2"
com.hulu.plus,4,1721960784,1721960788,1721960788.090886,-18000,EB445137-D7F5-57EC-87DA-1DB460D64046,"iPhone13,2"
com.hulu.plus,3,1721958649,1721958652,1721958652.3668342,-18000,EB445137-D7F5-57EC-87DA-1DB460D64046,"iPhone13,2"
com.hulu.plus,67,1721957847,1721957914,1721957914.416017,-18000,EB445137-D7F5-57EC-87DA-1DB460D64046,"iPhone13,2"
com.truebill.truebillnative,45,1721957797,1721957842,1721957842.289985,-18000,EB445137-D7F5-57EC-87DA-1DB460D64046,"iPhone13,2"
com.hammerandchisel.discord,13,1721957768,1721957781,1721957781.637815,-18000,EB445137-D7F5-57EC-87DA-1DB460D64046,"iPhone13,2"
com.apple.MobileSMS,39,1721957726,1721957765,1721957765.196264,-18000,EB445137-D7F5-57EC-87DA-1DB460D64046,"iPhone13,2"
com.hammerandchisel.discord,3,1721957723,1721957726,1721957726.797172,-18000,EB445137-D7F5-57EC-87DA-1DB460D64046,"iPhone13,2"
com.hammerandchisel.discord,6,1721957659,1721957665,1721957665.501529,-18000,EB445137-D7F5-57EC-87DA-1DB460D64046,"iPhone13,2"
com.google.ios.youtube,4,1721957653,1721957657,1721957657.526751,-18000,EB445137-D7F5-57EC-87DA-1DB460D64046,"iPhone13,2"
com.google.ios.youtube,19,1721957514,1721957533,1721957533.8417192,-18000,EB445137-D7F5-57EC-87DA-1DB460D64046,"iPhone13,2"
com.google.ios.youtube,927,1721956586,1721957513,1721957513.673337,-18000,EB445137-D7F5-57EC-87DA-1DB460D64046,"iPhone13,2"
com.apple.MobileSMS,6,1721956554,1721956560,1721956560.4224591,-18000,EB445137-D7F5-57EC-87DA-1DB460D64046,"iPhone13,2"
com.hammerandchisel.discord,6,1721956548,1721956554,1721956554.210192,-18000,EB445137-D7F5-57EC-87DA-1DB460D64046,"iPhone13,2"
com.apple.weather,3,1721956545,1721956548,1721956548.6972032,-18000,EB445137-D7F5-57EC-87DA-1DB460D64046,"iPhone13,2"
com.apple.weather,5,1721956255,1721956260,1721956260.985873,-18000,EB445137-D7F5-57EC-87DA-1DB460D64046,"iPhone13,2"
com.apple.weather,15,1721956195,1721956210,1721956210.1925669,-18000,EB445137-D7F5-57EC-87DA-1DB460D64046,"iPhone13,2"
com.apple.systempreferences,1,1721955786,1721955787,1721955787.895901,-18000,,
com.apple.calculator,1,1721955785,1721955786,1721955786.193482,-18000,,
com.google.Chrome,850,1721954935,1721955785,1721955785.576202,-18000,,
com.apple.weather,3,1721954494,1721954497,1721954497.873155,-18000,EB445137-D7F5-57EC-87DA-1DB460D64046,"iPhone13,2"
com.google.Chrome,310,1721954373,1721954683,1721954683.847735,-18000,,
com.apple.weather,7,1721954327,1721954334,1721954334.5702949,-18000,EB445137-D7F5-57EC-87DA-1DB460D64046,"iPhone13,2"
com.apple.weather,10,1721953194,1721953204,1721953204.462906,-18000,EB445137-D7F5-57EC-87DA-1DB460D64046,"iPhone13,2"
com.google.Chrome,1148,1721952981,1721954129,1721954129.176636,-18000,,
com.google.Chrome,1304,1721951656,1721952960,1721952960.183269,-18000,,
com.apple.weather,3,1721951528,1721951531,1721951531.3419561,-18000,EB445137-D7F5-57EC-87DA-1DB460D64046,"iPhone13,2"
com.apple.weather,12,1721951514,1721951526,1721951526.413241,-18000,EB445137-D7F5-57EC-87DA-1DB460D64046,"iPhone13,2"
com.apple.weather,113,1721951113,1721951226,1721951226.784875,-18000,EB445137-D7F5-57EC-87DA-1DB460D64046,"iPhone13,2"
com.google.Chrome,416,1721950965,1721951381,1721951381.542177,-18000,,
com.apple.news,96,1721950942,1721951038,1721951039.0748901,-18000,EB445137-D7F5-57EC-87DA-1DB460D64046,"iPhone13,2"
com.google.Chrome,587,1721950376,1721950963,1721950963.54486,-18000,,
com.apple.news,289,1721950373,1721950662,1721950662.7706819,-18000,EB445137-D7F5-57EC-87DA-1DB460D64046,"iPhone13,2"
com.hammerandchisel.discord,6,1721950312,1721950318,1721950318.7381039,-18000,EB445137-D7F5-57EC-87DA-1DB460D64046,"iPhone13,2"
com.apple.news,3,1721950309,1721950312,1721950312.76578,-18000,EB445137-D7F5-57EC-87DA-1DB460D64046,"iPhone13,2"
com.apple.news,321,1721949682,1721950003,1721950003.707477,-18000,EB445137-D7F5-57EC-87DA-1DB460D64046,"iPhone13,2"
com.apple.findmy,8,1721949657,1721949665,1721949665.8926969,-18000,EB445137-D7F5-57EC-87DA-1DB460D64046,"iPhone13,2"
com.apple.findmy,12,1721949446,1721949458,1721949458.421412,-18000,EB445137-D7F5-57EC-87DA-1DB460D64046,"iPhone13,2"
com.apple.MobileSMS,4,1721949442,1721949446,1721949446.446305,-18000,EB445137-D7F5-57EC-87DA-1DB460D64046,"iPhone13,2"
com.google.ios.youtube,2,1721949440,1721949442,1721949442.536216,-18000,EB445137-D7F5-57EC-87DA-1DB460D64046,"iPhone13,2"
com.google.Chrome,709,1721949419,1721950128,1721950128.300432,-18000,,
com.google.ios.youtube,10,1721947504,1721947514,1721947514.401918,-18000,EB445137-D7F5-57EC-87DA-1DB460D64046,"iPhone13,2"
com.google.ios.youtube,517,1721946953,1721947470,1721947470.711275,-18000,EB445137-D7F5-57EC-87DA-1DB460D64046,"iPhone13,2"
com.truebill.truebillnative,58,1721946863,1721946921,1721946921.2794461,-18000,EB445137-D7F5-57EC-87DA-1DB460D64046,"iPhone13,2"
com.apple.findmy,28,1721946827,1721946855,1721946856.0336242,-18000,EB445137-D7F5-57EC-87DA-1DB460D64046,"iPhone13,2"
com.apple.news,182,1721946643,1721946825,1721946825.31993,-18000,EB445137-D7F5-57EC-87DA-1DB460D64046,"iPhone13,2"
com.hammerandchisel.discord,4,1721946631,1721946635,1721946635.1528668,-18000,EB445137-D7F5-57EC-87DA-1DB460D64046,"iPhone13,2"
com.microsoft.onenote,7,1721946624,1721946631,1721946631.5664492,-18000,EB445137-D7F5-57EC-87DA-1DB460D64046,"iPhone13,2"
com.microsoft.onenote,12,1721946269,1721946281,1721946281.478389,-18000,EB445137-D7F5-57EC-87DA-1DB460D64046,"iPhone13,2"
com.hammerandchisel.discord,11,1721946256,1721946267,1721946267.0807729,-18000,EB445137-D7F5-57EC-87DA-1DB460D64046,"iPhone13,2"
com.microsoft.onenote,4,1721946252,1721946256,1721946257.1055532,-18000,EB445137-D7F5-57EC-87DA-1DB460D64046,"iPhone13,2"
com.microsoft.onenote,18,1721945818,1721945836,1721945836.512454,-18000,EB445137-D7F5-57EC-87DA-1DB460D64046,"iPhone13,2"
com.google.ios.youtube,23,1721945794,1721945817,1721945817.2131128,-18000,EB445137-D7F5-57EC-87DA-1DB460D64046,"iPhone13,2"
com.apple.MobileSMS,28,1721945766,1721945794,1721945794.7923532,-18000,EB445137-D7F5-57EC-87DA-1DB460D64046,"iPhone13,2"
com.hammerandchisel.discord,12,1721945753,1721945765,1721945765.780633,-18000,EB445137-D7F5-57EC-87DA-1DB460D64046,"iPhone13,2"
com.apple.findmy,4,1721945749,1721945753,1721945753.8732271,-18000,EB445137-D7F5-57EC-87DA-1DB460D64046,"iPhone13,2"
com.apple.findmy,6,1721945712,1721945718,1721945718.164082,-18000,EB445137-D7F5-57EC-87DA-1DB460D64046,"iPhone13,2"
com.apple.mobilecal,6,1721945706,1721945712,1721945712.176728,-18000,EB445137-D7F5-57EC-87DA-1DB460D64046,"iPhone13,2"
com.apple.mobilecal,7,1721944685,1721944692,1721944692.6786761,-18000,EB445137-D7F5-57EC-87DA-1DB460D64046,"iPhone13,2"
com.apple.mobilecal,25,1721944022,1721944047,1721944047.173651,-18000,EB445137-D7F5-57EC-87DA-1DB460D64046,"iPhone13,2"
com.apple.camera,1,1721942661,1721942662,1721942662.196312,-18000,EB445137-D7F5-57EC-87DA-1DB460D64046,"iPhone13,2"
com.apple.news,91,1721942503,1721942594,1721942594.89826,-18000,EB445137-D7F5-57EC-87DA-1DB460D64046,"iPhone13,2"
com.apple.findmy,7,1721942496,1721942503,1721942503.1169019,-18000,EB445137-D7F5-57EC-87DA-1DB460D64046,"iPhone13,2"
com.apple.findmy,7,1721942358,1721942365,1721942366.0062819,-18000,EB445137-D7F5-57EC-87DA-1DB460D64046,"iPhone13,2"
com.google.chrome.ios,2,1721942356,1721942358,1721942358.627829,-18000,EB445137-D7F5-57EC-87DA-1DB460D64046,"iPhone13,2"
com.google.chrome.ios,49,1721941874,1721941923,1721941923.087072,-18000,EB445137-D7F5-57EC-87DA-1DB460D64046,"iPhone13,2"
com.google.chrome.ios,88,1721941682,1721941770,1721941770.321015,-18000,EB445137-D7F5-57EC-87DA-1DB460D64046,"iPhone13,2"
com.apple.findmy,4,1721941678,1721941682,1721941682.630718,-18000,EB445137-D7F5-57EC-87DA-1DB460D64046,"iPhone13,2"
com.apple.findmy,18,1721941513,1721941531,1721941532.004362,-18000,EB445137-D7F5-57EC-87DA-1DB460D64046,"iPhone13,2"
com.apple.news,19,1721941340,1721941359,1721941359.818869,-18000,EB445137-D7F5-57EC-87DA-1DB460D64046,"iPhone13,2"
com.apple.news,47,1721940828,1721940875,1721940875.5799298,-18000,EB445137-D7F5-57EC-87DA-1DB460D64046,"iPhone13,2"
com.google.Chrome,545,1721938634,1721939179,1721939179.691444,-18000,,
com.google.Chrome,540,1721937991,1721938531,1721938531.422769,-18000,,
com.google.Chrome,1246,1721936279,1721937525,1721937525.475507,-18000,,
com.apple.calculator,17,1721936262,1721936279,1721936279.951824,-18000,,
com.google.Chrome,15,1721936247,1721936262,1721936262.394712,-18000,,
com.apple.calculator,2,1721936245,1721936247,1721936247.9900842,-18000,,
com.google.Chrome,2,1721936243,1721936245,1721936245.451019,-18000,,
com.apple.calculator,5,1721936238,1721936243,1721936243.82218,-18000,,
com.google.Chrome,54,1721936184,1721936238,1721936238.496659,-18000,,
com.apple.systempreferences,3,1721936181,1721936184,1721936184.529877,-18000,,
com.google.Chrome,87,1721936087,1721936174,1721936174.56373,-18000,,
com.apple.iCal,16,1721935798,1721935814,1721935814.465558,-18000,,
com.google.Chrome,96,1721935702,1721935798,1721935799.025533,-18000,,
com.apple.news,223,1721935479,1721935702,1721935702.192317,-18000,,
com.google.Chrome,43,1721935436,1721935479,1721935479.17595,-18000,,
com.google.Chrome,492,1721932951,1721933443,1721933443.351386,-18000,,
com.google.Chrome,234,1721879919,1721880153,1721880153.784632,-18000,,
com.google.Chrome,305,1721878780,1721879085,1721879085.935972,-18000,,
com.google.Chrome,575,1721877718,1721878293,1721878293.194469,-18000,,
com.google.Chrome,501,1721876968,1721877469,1721877469.957475,-18000,,
com.google.Chrome,324,1721876273,1721876597,1721876597.540091,-18000,,
com.google.Chrome,478,1721875753,1721876231,1721876231.886473,-18000,,
com.google.Chrome,219,1721872984,1721873203,1721873203.580501,-18000,,
com.google.Chrome,302,1721872530,1721872832,1721872832.5015411,-18000,,
com.google.Chrome,301,1721872211,1721872512,1721872512.0921922,-18000,,
com.google.Chrome,325,1721871411,1721871736,1721871736.8420758,-18000,,
com.google.Chrome,513,1721870832,1721871345,1721871345.0493531,-18000,,
com.google.Chrome,1317,1721869447,1721870764,1721870764.118273,-18000,,
com.google.Chrome,1186,1721868035,1721869221,1721869221.2932749,-18000,,
com.google.Chrome,349,1721867339,1721867688,1721867688.9797292,-18000,,
com.google.Chrome,707,1721866617,1721867324,1721867325.0132508,-18000,,
com.google.Chrome,301,1721865369,1721865670,1721865670.434902,-18000,,
com.google.Chrome,302,1721864452,1721864754,1721864754.239156,-18000,,
com.google.Chrome,372,1721863930,1721864302,1721864302.0669842,-18000,,
com.apple.MobileSMS,7,1721863923,1721863930,1721863930.756505,-18000,,
com.google.Chrome,75,1721863848,1721863923,1721863923.598516,-18000,,
com.google.Chrome,329,1721861155,1721861484,1721861484.564877,-18000,,
com.google.Chrome,820,1721857461,1721858281,1721858281.768368,-18000,,
com.apple.weather,84,1721857377,1721857461,1721857461.7809029,-18000,,
com.google.Chrome,92,1721857285,1721857377,1721857377.525137,-18000,,
com.google.Chrome,1245,1721855872,1721857117,1721857117.658124,-18000,,
com.google.Chrome,3815,1721851568,1721855383,1721855383.518259,-18000,,
com.google.Chrome,1802,1721849463,1721851265,1721851265.5696821,-18000,,
com.apple.systempreferences,16,1721849447,1721849463,1721849463.756103,-18000,,
com.google.Chrome,238,1721849209,1721849447,1721849447.5297132,-18000,,
com.apple.systempreferences,6,1721849195,1721849201,1721849201.193485,-18000,,
com.google.Chrome,60,1721849135,1721849195,1721849195.2560859,-18000,,
com.apple.systempreferences,8,1721849127,1721849135,1721849135.768825,-18000,,
com.google.Chrome,1122,1721847999,1721849121,1721849121.339241,-18000,,
com.google.Chrome,399,1721847561,1721847960,1721847960.6880012,-18000,,
com.google.Chrome,1328,1721846150,1721847478,1721847478.484102,-18000,,
com.google.Chrome,507,1721845617,1721846124,1721846124.187109,-18000,,
com.google.Chrome,361,1721844819,1721845180,1721845180.222537,-18000,,
com.google.Chrome,1034,1721841408,1721842442,1721842442.853272,-18000,,
com.google.Chrome,304,1721840642,1721840946,1721840946.998639,-18000,,
com.apple.finder,1,1721840641,1721840642,1721840642.2396379,-18000,,
com.microsoft.onenote.mac,51,1721840590,1721840641,1721840641.331783,-18000,,
com.google.Chrome,1904,1721838686,1721840590,1721840590.1027122,-18000,,
com.google.Chrome,207,1721794805,1721795012,1721795012.913251,-18000,,
com.google.Chrome,923,1721793823,1721794746,1721794746.82761,-18000,,
com.google.Chrome,372,1721793285,1721793657,1721793657.539686,-18000,,
com.google.Chrome,301,1721792867,1721793168,1721793168.87181,-18000,,
com.google.Chrome,343,1721792237,1721792580,1721792581.0124822,-18000,,
com.google.Chrome,12,1721791649,1721791661,1721791661.6356158,-18000,,
com.google.Chrome,807,1721789014,1721789821,1721789821.8108659,-18000,,
com.google.Chrome,2938,1721785984,1721788922,1721788922.952417,-18000,,
com.google.Chrome,339,1721785298,1721785637,1721785637.4963598,-18000,,
com.google.Chrome,1103,1721783778,1721784881,1721784881.729459,-18000,,
com.google.Chrome,305,1721783063,1721783368,1721783368.307928,-18000,,
com.google.Chrome,1131,1721781904,1721783035,1721783035.182457,-18000,,
com.google.Chrome,531,1721781109,1721781640,1721781640.301409,-18000,,
com.google.Chrome,544,1721779824,1721780368,1721780368.7552,-18000,,
com.google.Chrome,300,1721779496,1721779796,1721779796.254006,-18000,,
com.google.Chrome,503,1721778955,1721779458,1721779458.389256,-18000,,
com.google.Chrome,351,1721778588,1721778939,1721778939.57914,-18000,,
com.google.Chrome,992,1721777571,1721778563,1721778563.31388,-18000,,
com.google.Chrome,420,1721776939,1721777359,1721777359.232223,-18000,,
com.google.Chrome,588,1721776158,1721776746,1721776746.777021,-18000,,
com.apple.MobileSMS,386,1721775772,1721776158,1721776158.435473,-18000,,
com.google.Chrome,85,1721775687,1721775772,1721775772.212033,-18000,,
com.google.Chrome,234,1721754968,1721755202,1721755202.3689551,-18000,,
com.apple.systempreferences,1,1721754834,1721754835,1721754835.9647179,-18000,,
com.google.Chrome,14,1721754820,1721754834,1721754834.2724462,-18000,,
com.apple.systempreferences,5,1721754739,1721754744,1721754744.561559,-18000,,
com.google.Chrome,15,1721754724,1721754739,1721754739.1665769,-18000,,
com.apple.systempreferences,3,1721754721,1721754724,1721754724.459723,-18000,,
com.google.Chrome,23,1721754698,1721754721,1721754721.5118132,-18000,,
com.apple.systempreferences,11,1721754687,1721754698,1721754698.673579,-18000,,
com.google.Chrome,54,1721754626,1721754680,1721754680.947106,-18000,,
com.google.Chrome,276,1721695841,1721696117,1721696117.365232,-18000,,
com.google.Chrome,5525,1721684181,1721689706,1721689707.174656,-18000,,
com.google.Chrome,363,1721683080,1721683443,1721683443.677577,-18000,,
com.google.Chrome,321,1721682666,1721682987,1721682987.618171,-18000,,
com.google.Chrome,490,1721681971,1721682461,1721682461.0773091,-18000,,
com.google.Chrome,587,1721681210,1721681797,1721681798.009358,-18000,,
com.google.Chrome,444,1721667549,1721667993,1721667993.3154411,-18000,,
com.google.Chrome,319,1721666596,1721666915,1721666915.916308,-18000,,
com.google.Chrome,28,1721666381,1721666409,1721666409.767988,-18000,,
com.apple.finder,8,1721666373,1721666381,1721666381.387751,-18000,,
com.google.Chrome,1382,1721664991,1721666373,1721666373.777102,-18000,,
com.google.Chrome,307,1721664317,1721664624,1721664624.707721,-18000,,
com.google.Chrome,780,1721662864,1721663644,1721663644.181994,-18000,,
com.google.Chrome,334,1721662463,1721662797,1721662797.740799,-18000,,
com.google.Chrome,300,1721662029,1721662329,1721662329.613577,-18000,,
com.google.Chrome,381,1721661372,1721661753,1721661753.9945822,-18000,,
com.microsoft.onenote.mac,210,1721661162,1721661372,1721661372.830004,-18000,,
com.google.Chrome,25,1721661137,1721661162,1721661162.332763,-18000,,
com.microsoft.onenote.mac,4,1721661102,1721661106,1721661106.172436,-18000,,
com.google.Chrome,111,1721660991,1721661102,1721661102.144844,-18000,,
com.google.Chrome,244,1721623365,1721623609,1721623610.010299,-18000,,
com.google.Chrome,425,1721621707,1721622132,1721622132.4373178,-18000,,
com.google.Chrome,342,1721620590,1721620932,1721620932.0532331,-18000,,
com.google.Chrome,591,1721619939,1721620530,1721620530.47118,-18000,,
com.apple.MobileSMS,6,1721619933,1721619939,1721619939.5892072,-18000,,
com.apple.MobileSMS,16,1721604971,1721604987,1721604987.49512,-18000,,
com.google.Chrome,317,1721604654,1721604971,1721604971.153805,-18000,,
com.google.Chrome,891,1721602960,1721603851,1721603851.222405,-18000,,
com.apple.finder,12,1721602948,1721602960,1721602960.79509,-18000,,
com.apple.finder,2934,1721595770,1721598704,1721598705.0533938,-18000,,
com.apple.finder,4,1721595718,1721595722,1721595722.220093,-18000,,
com.apple.iCal,2,1721595716,1721595718,1721595718.093649,-18000,,
com.google.Chrome,25,1721595691,1721595716,1721595716.4987001,-18000,,
com.google.Chrome,184,1721594369,1721594553,1721594554.11075,-18000,,
com.apple.MobileSMS,9,1721594360,1721594369,1721594369.264348,-18000,,
com.apple.MobileSMS,7,1721593540,1721593547,1721593547.684908,-18000,,
com.apple.Music,1,1721593539,1721593540,1721593540.08864,-18000,,
com.google.Chrome,10,1721593529,1721593539,1721593539.22435,-18000,,
com.apple.Music,1,1721593528,1721593529,1721593529.2013478,-18000,,
com.apple.MobileSMS,33,1721593495,1721593528,1721593528.1962361,-18000,,
com.apple.Music,1,1721593494,1721593495,1721593495.1403341,-18000,,
com.apple.MobileSMS,25,1721593469,1721593494,1721593494.168469,-18000,,
com.apple.Music,6,1721593463,1721593469,1721593469.122795,-18000,,
com.google.Chrome,14,1721593449,1721593463,1721593463.1217299,-18000,,
com.apple.Music,33,1721593416,1721593449,1721593449.897816,-18000,,
com.google.Chrome,24,1721593392,1721593416,1721593417.002847,-18000,,
com.apple.Music,19,1721593373,1721593392,1721593392.7515888,-18000,,
com.google.Chrome,20,1721593353,1721593373,1721593373.6263251,-18000,,
com.apple.Music,6,1721593347,1721593353,1721593353.314793,-18000,,
com.google.Chrome,2,1721593345,1721593347,1721593347.030201,-18000,,
com.apple.Music,26,1721593319,1721593345,1721593345.4336271,-18000,,
com.google.Chrome,1,1721593318,1721593319,1721593319.4866729,-18000,,
com.apple.Music,4,1721593314,1721593318,1721593318.978241,-18000,,
com.google.Chrome,2,1721593312,1721593314,1721593314.5734239,-18000,,
com.apple.Music,27,1721593285,1721593312,1721593312.812006,-18000,,
com.google.Chrome,4,1721593281,1721593285,1721593285.235246,-18000,,
com.apple.Music,1,1721593280,1721593281,1721593281.897594,-18000,,
com.google.Chrome,14,1721593266,1721593280,1721593280.3140578,-18000,,
com.apple.Music,19,1721593247,1721593266,1721593266.905056,-18000,,
com.google.Chrome,7,1721593240,1721593247,1721593247.524751,-18000,,
com.apple.Music,5,1721593235,1721593240,1721593240.45031,-18000,,
com.google.Chrome,1,1721593234,1721593235,1721593235.657223,-18000,,
com.apple.Music,32,1721593202,1721593234,1721593234.114358,-18000,,
com.google.Chrome,9,1721593193,1721593202,1721593202.697206,-18000,,
com.apple.Music,20,1721593173,1721593193,1721593193.324394,-18000,,
com.google.Chrome,10,1721593163,1721593173,1721593173.369564,-18000,,
com.apple.Music,16,1721593147,1721593163,1721593163.5813189,-18000,,
com.google.Chrome,108,1721593039,1721593147,1721593147.510264,-18000,,
com.apple.MobileSMS,101,1721592938,1721593039,1721593039.978808,-18000,,
com.google.Chrome,1,1721592937,1721592938,1721592938.118743,-18000,,
com.apple.iCal,2,1721592935,1721592937,1721592937.1776628,-18000,,
com.apple.MobileSMS,28,1721592907,1721592935,1721592935.723754,-18000,,
com.apple.iCal,3,1721592904,1721592907,1721592907.446305,-18000,,
com.apple.MobileSMS,3,1721592901,1721592904,1721592904.610373,-18000,,
com.apple.iCal,9,1721592892,1721592901,1721592901.294421,-18000,,
com.apple.MobileSMS,9,1721592883,1721592892,1721592892.1422439,-18000,,
com.apple.iCal,4,1721592879,1721592883,1721592883.2514238,-18000,,
com.apple.MobileSMS,6,1721592873,1721592879,1721592880.005443,-18000,,
com.apple.iCal,4,1721592869,1721592873,1721592873.12448,-18000,,
com.apple.MobileSMS,3,1721592866,1721592869,1721592869.6960468,-18000,,
com.apple.iCal,3,1721592863,1721592866,1721592866.4296699,-18000,,
com.apple.MobileSMS,25,1721592838,1721592863,1721592863.125362,-18000,,
com.apple.iCal,3,1721592835,1721592838,1721592838.2134662,-18000,,
com.apple.MobileSMS,15,1721592820,1721592835,1721592835.834446,-18000,,
com.apple.iCal,14,1721592806,1721592820,1721592820.347672,-18000,,
com.apple.MobileSMS,7,1721592799,1721592806,1721592806.232983,-18000,,
com.apple.iCal,4,1721592795,1721592799,1721592799.83491,-18000,,
com.google.Chrome,3,1721592792,1721592795,1721592795.990247,-18000,,
com.google.Chrome,175,1721535751,1721535926,1721535926.818054,-18000,,
com.google.Chrome,306,1721535296,1721535602,1721535602.366874,-18000,,
com.google.Chrome,458,1721534680,1721535138,1721535138.306632,-18000,,
com.google.Chrome,521,1721533985,1721534506,1721534506.957694,-18000,,
com.apple.iCal,38,1721533947,1721533985,1721533985.28191,-18000,,
com.google.Chrome,1,1721533946,1721533947,1721533947.3838139,-18000,,
com.apple.MobileSMS,3,1721533943,1721533946,1721533946.118144,-18000,,
com.google.Chrome,6,1721533937,1721533943,1721533943.169194,-18000,,
com.google.Chrome,805,1721499361,1721500166,1721500167.437819,-18000,,
com.google.Chrome,300,1721499001,1721499301,1721499301.753238,-18000,,
com.google.Chrome,669,1721498237,1721498906,1721498906.477277,-18000,,
com.google.Chrome,512,1721497564,1721498076,1721498076.184614,-18000,,
com.google.Chrome,126,1721495753,1721495879,1721495879.67457,-18000,,
com.apple.Notes,1,1721495752,1721495753,1721495753.515903,-18000,,
com.google.Chrome,31,1721495721,1721495752,1721495752.303069,-18000,,
com.apple.Notes,1,1721495720,1721495721,1721495721.6473222,-18000,,
com.google.Chrome,12,1721495708,1721495720,1721495720.047141,-18000,,
com.apple.Notes,2,1721495706,1721495708,1721495708.465939,-18000,,
com.google.Chrome,33,1721495673,1721495706,1721495706.448884,-18000,,
com.apple.Notes,2,1721495671,1721495673,1721495673.681618,-18000,,
com.google.Chrome,13,1721495658,1721495671,1721495671.773124,-18000,,
com.apple.Notes,2,1721495656,1721495658,1721495658.2196941,-18000,,
com.google.Chrome,45,1721495611,1721495656,1721495656.418373,-18000,,
com.apple.Notes,2,1721495609,1721495611,1721495611.929953,-18000,,
com.google.Chrome,34,1721495575,1721495609,1721495609.8858771,-18000,,
com.apple.Notes,1,1721495574,1721495575,1721495575.758569,-18000,,
com.google.Chrome,43,1721495531,1721495574,1721495574.127013,-18000,,
com.apple.Notes,6,1721495525,1721495531,1721495531.2323709,-18000,,
com.google.Chrome,3,1721495522,1721495525,1721495525.511755,-18000,,
com.google.Chrome,531,1721493252,1721493783,1721493783.6540031,-18000,,
com.google.Chrome,319,1721492897,1721493216,1721493216.207663,-18000,,
com.google.Chrome,558,1721434918,1721435476,1721435476.919722,-18000,,
com.google.Chrome,1607,1721433087,1721434694,1721434694.728544,-18000,,
com.google.Chrome,553,1721432245,1721432798,1721432798.5111809,-18000,,
com.google.Chrome,129,1721428725,1721428854,1721428855.032525,-18000,,
com.google.Chrome,420,1721428299,1721428719,1721428719.662209,-18000,,
com.apple.finder,1,1721428298,1721428299,1721428300.5148711,-18000,,
com.apple.finder,301,1721426975,1721427276,1721427276.582072,-18000,,
com.apple.systempreferences,1,1721426974,1721426975,1721426975.989513,-18000,,
com.google.Chrome,84,1721426890,1721426974,1721426974.860745,-18000,,
com.apple.systempreferences,11,1721426879,1721426890,1721426890.406805,-18000,,
com.google.Chrome,6,1721426873,1721426879,1721426879.945897,-18000,,
com.google.Chrome,337,1721424381,1721424718,1721424718.856108,-18000,,
com.google.Chrome,6,1721423347,1721423353,1721423353.428201,-18000,,
com.apple.MobileSMS,38,1721423309,1721423347,1721423347.510819,-18000,,
com.google.Chrome,53,1721423256,1721423309,1721423309.657381,-18000,,
com.apple.MobileSMS,19,1721423237,1721423256,1721423256.391264,-18000,,
com.google.Chrome,29,1721423208,1721423237,1721423237.457075,-18000,,
com.google.Chrome,1125,1721418976,1721420101,1721420101.2164578,-18000,,
cc.arduino.IDE2,25,1721418951,1721418976,1721418976.6875901,-18000,,
com.google.Chrome,283,1721418668,1721418951,1721418951.590456,-18000,,
com.google.Chrome,502,1721418137,1721418639,1721418639.483073,-18000,,
com.apple.Preview,535,1721417602,1721418137,1721418137.893512,-18000,,
com.google.Chrome,5,1721417597,1721417602,1721417602.375771,-18000,,
com.google.Chrome,602,1721416875,1721417477,1721417477.598174,-18000,,
cc.arduino.IDE2,2,1721416873,1721416875,1721416875.725811,-18000,,
cc.arduino.IDE2,317,1721416075,1721416392,1721416392.7417269,-18000,,
com.google.Chrome,2,1721416073,1721416075,1721416075.653576,-18000,,
com.google.Chrome,341,1721415557,1721415898,1721415898.6389961,-18000,,
com.apple.Preview,4,1721415553,1721415557,1721415557.262603,-18000,,
com.google.Chrome,2,1721415551,1721415553,1721415553.120471,-18000,,
com.apple.Preview,107,1721415444,1721415551,1721415552.195158,-18000,,
com.apple.finder,62,1721415382,1721415444,1721415444.788279,-18000,,
com.apple.finder,312,1721415067,1721415379,1721415379.8482342,-18000,,
cc.arduino.IDE2,22,1721414834,1721414856,1721414857.017311,-18000,,
com.apple.Preview,471,1721414363,1721414834,1721414834.68358,-18000,,
com.apple.finder,11,1721414352,1721414363,1721414363.3529382,-18000,,
com.google.Chrome,3,1721414349,1721414352,1721414352.126143,-18000,,
com.google.Chrome,156,1721365933,1721366089,1721366089.475112,-18000,,
com.google.Chrome,335,1721364228,1721364563,1721364563.763555,-18000,,
com.google.Chrome,583,1721355075,1721355658,1721355658.875454,-18000,,
com.google.Chrome,310,1721354533,1721354843,1721354843.786144,-18000,,
com.apple.Maps,2,1721348921,1721348923,1721348923.945456,-18000,EB445137-D7F5-57EC-87DA-1DB460D64046,"iPhone13,2"
com.apple.Maps,84,1721348665,1721348749,1721348749.516887,-18000,EB445137-D7F5-57EC-87DA-1DB460D64046,"iPhone13,2"
com.doordash.dasher,10,1721348655,1721348665,1721348665.6273699,-18000,EB445137-D7F5-57EC-87DA-1DB460D64046,"iPhone13,2"
com.apple.Maps,12,1721348643,1721348655,1721348655.668311,-18000,EB445137-D7F5-57EC-87DA-1DB460D64046,"iPhone13,2"
com.doordash.dasher,14,1721348629,1721348643,1721348643.408355,-18000,EB445137-D7F5-57EC-87DA-1DB460D64046,"iPhone13,2"
com.doordash.dasher,3,1721348596,1721348599,1721348599.103303,-18000,EB445137-D7F5-57EC-87DA-1DB460D64046,"iPhone13,2"
com.doordash.dasher,5,1721348590,1721348595,1721348595.996412,-18000,EB445137-D7F5-57EC-87DA-1DB460D64046,"iPhone13,2"
com.apple.Maps,7,1721348583,1721348590,1721348590.830745,-18000,EB445137-D7F5-57EC-87DA-1DB460D64046,"iPhone13,2"
com.apple.Maps,102,1721348306,1721348408,1721348408.058443,-18000,EB445137-D7F5-57EC-87DA-1DB460D64046,"iPhone13,2"
com.doordash.dasher,38,1721348268,1721348306,1721348306.399893,-18000,EB445137-D7F5-57EC-87DA-1DB460D64046,"iPhone13,2"
com.doordash.dasher,10,1721348229,1721348239,1721348239.635721,-18000,EB445137-D7F5-57EC-87DA-1DB460D64046,"iPhone13,2"
com.doordash.dasher,70,1721348141,1721348211,1721348211.557528,-18000,EB445137-D7F5-57EC-87DA-1DB460D64046,"iPhone13,2"
com.apple.Maps,2,1721348139,1721348141,1721348141.6899781,-18000,EB445137-D7F5-57EC-87DA-1DB460D64046,"iPhone13,2"
com.apple.Maps,12,1721348121,1721348133,1721348133.777617,-18000,EB445137-D7F5-57EC-87DA-1DB460D64046,"iPhone13,2"
com.apple.Maps,115,1721347872,1721347987,1721347987.224619,-18000,EB445137-D7F5-57EC-87DA-1DB460D64046,"iPhone13,2"
com.doordash.dasher,1,1721347871,1721347872,1721347872.701031,-18000,EB445137-D7F5-57EC-87DA-1DB460D64046,"iPhone13,2"
com.myfitnesspal.mfp,59,1721347812,1721347871,1721347871.4467049,-18000,EB445137-D7F5-57EC-87DA-1DB460D64046,"iPhone13,2"
com.doordash.dasher,25,1721347787,1721347812,1721347812.610198,-18000,EB445137-D7F5-57EC-87DA-1DB460D64046,"iPhone13,2"
com.myfitnesspal.mfp,90,1721347697,1721347787,1721347788.177134,-18000,EB445137-D7F5-57EC-87DA-1DB460D64046,"iPhone13,2"
com.doordash.dasher,280,1721347414,1721347694,1721347694.700142,-18000,EB445137-D7F5-57EC-87DA-1DB460D64046,"iPhone13,2"
com.toyopagroup.picaboo,37,1721347338,1721347375,1721347375.851637,-18000,EB445137-D7F5-57EC-87DA-1DB460D64046,"iPhone13,2"
com.doordash.dasher,428,1721346910,1721347338,1721347338.96871,-18000,EB445137-D7F5-57EC-87DA-1DB460D64046,"iPhone13,2"
com.apple.podcasts,173,1721346737,1721346910,1721346910.987444,-18000,EB445137-D7F5-57EC-87DA-1DB460D64046,"iPhone13,2"
com.doordash.dasher,41,1721346691,1721346732,1721346732.9724212,-18000,EB445137-D7F5-57EC-87DA-1DB460D64046,"iPhone13,2"
com.doordash.dasher,33,1721346513,1721346546,1721346546.122968,-18000,EB445137-D7F5-57EC-87DA-1DB460D64046,"iPhone13,2"
com.apple.weather,2,1721346511,1721346513,1721346513.5262299,-18000,EB445137-D7F5-57EC-87DA-1DB460D64046,"iPhone13,2"
com.apple.weather,6,1721346378,1721346384,1721346384.912897,-18000,EB445137-D7F5-57EC-87DA-1DB460D64046,"iPhone13,2"
com.apple.weather,9,1721346366,1721346375,1721346375.134142,-18000,EB445137-D7F5-57EC-87DA-1DB460D64046,"iPhone13,2"
com.toyopagroup.picaboo,18,1721346156,1721346174,1721346174.588686,-18000,EB445137-D7F5-57EC-87DA-1DB460D64046,"iPhone13,2"
com.doordash.dasher,35,1721346121,1721346156,1721346156.994806,-18000,EB445137-D7F5-57EC-87DA-1DB460D64046,"iPhone13,2"
com.toyopagroup.picaboo,31,1721346090,1721346121,1721346121.519254,-18000,EB445137-D7F5-57EC-87DA-1DB460D64046,"iPhone13,2"
com.toyopagroup.picaboo,10,1721346031,1721346041,1721346041.429529,-18000,EB445137-D7F5-57EC-87DA-1DB460D64046,"iPhone13,2"
com.toyopagroup.picaboo,228,1721345787,1721346015,1721346015.467709,-18000,EB445137-D7F5-57EC-87DA-1DB460D64046,"iPhone13,2"
com.toyopagroup.picaboo,51,1721345732,1721345783,1721345783.77233,-18000,EB445137-D7F5-57EC-87DA-1DB460D64046,"iPhone13,2"
com.apple.MobileSMS,10,1721345722,1721345732,1721345732.578875,-18000,EB445137-D7F5-57EC-87DA-1DB460D64046,"iPhone13,2"
com.apple.findmy,1,1721345721,1721345722,1721345723.967721,-18000,EB445137-D7F5-57EC-87DA-1DB460D64046,"iPhone13,2"
com.apple.findmy,2,1721343879,1721343881,1721343881.328927,-18000,EB445137-D7F5-57EC-87DA-1DB460D64046,"iPhone13,2"
com.apple.findmy,10,1721343861,1721343871,1721343871.424866,-18000,EB445137-D7F5-57EC-87DA-1DB460D64046,"iPhone13,2"
com.apple.findmy,0,1721343854,1721343854,1721343854.430934,-18000,EB445137-D7F5-57EC-87DA-1DB460D64046,"iPhone13,2"
com.google.Chrome,681,1721343012,1721343693,1721343693.549834,-18000,,
com.apple.finder,4,1721343008,1721343012,1721343012.04315,-18000,,
com.apple.findmy,9,1721342975,1721342984,1721342984.295855,-18000,EB445137-D7F5-57EC-87DA-1DB460D64046,"iPhone13,2"
com.apple.findmy,2,1721342972,1721342974,1721342974.1677098,-18000,EB445137-D7F5-57EC-87DA-1DB460D64046,"iPhone13,2"
com.apple.findmy,13,1721342299,1721342312,1721342312.1611938,-18000,EB445137-D7F5-57EC-87DA-1DB460D64046,"iPhone13,2"
com.apple.finder,30,1721342266,1721342296,1721342296.8754668,-18000,,
cc.arduino.IDE2,159,1721342107,1721342266,1721342266.7109098,-18000,,
com.apple.finder,3,1721342104,1721342107,1721342107.6475081,-18000,,
cc.arduino.IDE2,7,1721342097,1721342104,1721342104.996241,-18000,,
com.apple.finder,11,1721342086,1721342097,1721342097.256894,-18000,,
cc.arduino.IDE2,500,1721341586,1721342086,1721342086.671601,-18000,,
com.apple.finder,17,1721341569,1721341586,1721341587.0366302,-18000,,
cc.arduino.IDE2,40,1721341529,1721341569,1721341569.5145578,-18000,,
com.apple.MobileSMS,1,1721341528,1721341529,1721341529.265399,-18000,,
cc.arduino.IDE2,270,1721341258,1721341528,1721341528.373866,-18000,,
com.apple.MobileSMS,12,1721341246,1721341258,1721341258.75448,-18000,,
com.apple.iCal,15,1721341231,1721341246,1721341246.087113,-18000,,
com.apple.MobileSMS,13,1721341218,1721341231,1721341231.1808739,-18000,,
cc.arduino.IDE2,5,1721341207,1721341212,1721341212.147402,-18000,,
com.google.Chrome,0,1721341207,1721341207,1721341207.753268,-18000,,
com.apple.finder,22,1721341182,1721341204,1721341204.460517,-18000,,
com.google.Chrome,4,1721341178,1721341182,1721341182.6656919,-18000,,
com.apple.findmy,8,1721340975,1721340983,1721340983.5428581,-18000,EB445137-D7F5-57EC-87DA-1DB460D64046,"iPhone13,2"
com.apple.findmy,8,1721340939,1721340947,1721340948.098388,-18000,EB445137-D7F5-57EC-87DA-1DB460D64046,"iPhone13,2"
com.myfitnesspal.mfp,5,1721340919,1721340924,1721340924.435038,-18000,EB445137-D7F5-57EC-87DA-1DB460D64046,"iPhone13,2"
com.google.Chrome,6,1721340913,1721340919,1721340919.2047958,-18000,,
com.apple.MobileSMS,93,1721340820,1721340913,1721340913.5975962,-18000,,
com.myfitnesspal.mfp,10,1721340740,1721340750,1721340750.5477781,-18000,EB445137-D7F5-57EC-87DA-1DB460D64046,"iPhone13,2"
com.google.Chrome,1333,1721339487,1721340820,1721340820.499155,-18000,,
com.myfitnesspal.mfp,4,1721338974,1721338978,1721338978.036823,-18000,EB445137-D7F5-57EC-87DA-1DB460D64046,"iPhone13,2"
com.myfitnesspal.mfp,10,1721338943,1721338953,1721338953.689229,-18000,EB445137-D7F5-57EC-87DA-1DB460D64046,"iPhone13,2"
com.myfitnesspal.mfp,11,1721338825,1721338836,1721338836.79883,-18000,EB445137-D7F5-57EC-87DA-1DB460D64046,"iPhone13,2"
com.myfitnesspal.mfp,35,1721338605,1721338640,1721338640.1792212,-18000,EB445137-D7F5-57EC-87DA-1DB460D64046,"iPhone13,2"
com.apple.MobileSMS,3,1721338584,1721338587,1721338588.001754,-18000,EB445137-D7F5-57EC-87DA-1DB460D64046,"iPhone13,2"
com.robinhood.release.Robinhood,402,1721338182,1721338584,1721338584.298572,-18000,EB445137-D7F5-57EC-87DA-1DB460D64046,"iPhone13,2"
com.google.Chrome,1168,1721338077,1721339245,1721339245.903843,-18000,,
com.apple.MobileSMS,19,1721338058,1721338077,1721338077.488676,-18000,,
com.google.Chrome,238,1721337820,1721338058,1721338059.024302,-18000,,
com.robinhood.release.Robinhood,265,1721337648,1721337913,1721337913.995843,-18000,EB445137-D7F5-57EC-87DA-1DB460D64046,"iPhone13,2"
com.clairmail.fth.client,11,1721337637,1721337648,1721337648.81573,-18000,EB445137-D7F5-57EC-87DA-1DB460D64046,"iPhone13,2"
com.truebill.truebillnative,133,1721337502,1721337635,1721337635.654087,-18000,EB445137-D7F5-57EC-87DA-1DB460D64046,"iPhone13,2"
com.robinhood.release.Robinhood,50,1721337449,1721337499,1721337499.4169621,-18000,EB445137-D7F5-57EC-87DA-1DB460D64046,"iPhone13,2"
com.apple.news,111,1721337272,1721337383,1721337383.3734531,-18000,EB445137-D7F5-57EC-87DA-1DB460D64046,"iPhone13,2"
com.google.Chrome,774,1721336843,1721337617,1721337617.6614661,-18000,,
com.apple.news,293,1721336800,1721337093,1721337093.747863,-18000,EB445137-D7F5-57EC-87DA-1DB460D64046,"iPhone13,2"
com.apple.news,8,1721335215,1721335223,1721335223.793601,-18000,EB445137-D7F5-57EC-87DA-1DB460D64046,"iPhone13,2"
com.google.Chrome,1988,1721334774,1721336762,1721336762.847398,-18000,,
com.apple.finder,3,1721334771,1721334774,1721334774.30553,-18000,,
com.apple.news,2,1721334756,1721334758,1721334758.8807302,-18000,EB445137-D7F5-57EC-87DA-1DB460D64046,"iPhone13,2"
com.apple.news,118,1721334626,1721334744,1721334744.906014,-18000,EB445137-D7F5-57EC-87DA-1DB460D64046,"iPhone13,2"
com.myfitnesspal.mfp,8,1721334607,1721334615,1721334616.094867,-18000,EB445137-D7F5-57EC-87DA-1DB460D64046,"iPhone13,2"
com.myfitnesspal.mfp,6,1721334480,1721334486,1721334486.684503,-18000,EB445137-D7F5-57EC-87DA-1DB460D64046,"iPhone13,2"
com.myfitnesspal.mfp,42,1721334437,1721334479,1721334479.787565,-18000,EB445137-D7F5-57EC-87DA-1DB460D64046,"iPhone13,2"
com.apple.reminders,4,1721334433,1721334437,1721334437.17011,-18000,EB445137-D7F5-57EC-87DA-1DB460D64046,"iPhone13,2"
com.apple.findmy,2,1721334431,1721334433,1721334434.522408,-18000,EB445137-D7F5-57EC-87DA-1DB460D64046,"iPhone13,2"
com.apple.findmy,13,1721333931,1721333944,1721333944.669609,-18000,EB445137-D7F5-57EC-87DA-1DB460D64046,"iPhone13,2"
com.apple.findmy,11,1721333201,1721333212,1721333212.007067,-18000,EB445137-D7F5-57EC-87DA-1DB460D64046,"iPhone13,2"
com.apple.findmy,59,1721333140,1721333199,1721333199.1211271,-18000,EB445137-D7F5-57EC-87DA-1DB460D64046,"iPhone13,2"
com.apple.news,16,1721333124,1721333140,1721333140.973783,-18000,EB445137-D7F5-57EC-87DA-1DB460D64046,"iPhone13,2"
com.apple.findmy,19,1721333105,1721333124,1721333124.872663,-18000,EB445137-D7F5-57EC-87DA-1DB460D64046,"iPhone13,2"
com.apple.news,84,1721333021,1721333105,1721333105.764124,-18000,EB445137-D7F5-57EC-87DA-1DB460D64046,"iPhone13,2"
com.apple.findmy,54,1721332967,1721333021,1721333021.423054,-18000,EB445137-D7F5-57EC-87DA-1DB460D64046,"iPhone13,2"
com.apple.news,100,1721332867,1721332967,1721332967.255558,-18000,EB445137-D7F5-57EC-87DA-1DB460D64046,"iPhone13,2"
com.apple.findmy,10,1721332857,1721332867,1721332868.162722,-18000,EB445137-D7F5-57EC-87DA-1DB460D64046,"iPhone13,2"
com.doordash.dasher,46,1721332808,1721332854,1721332854.856923,-18000,EB445137-D7F5-57EC-87DA-1DB460D64046,"iPhone13,2"
com.apple.findmy,36,1721332771,1721332807,1721332807.308601,-18000,EB445137-D7F5-57EC-87DA-1DB460D64046,"iPhone13,2"
com.apple.news,69,1721332702,1721332771,1721332771.9679298,-18000,EB445137-D7F5-57EC-87DA-1DB460D64046,"iPhone13,2"
com.apple.findmy,13,1721332678,1721332691,1721332691.3457608,-18000,EB445137-D7F5-57EC-87DA-1DB460D64046,"iPhone13,2"
com.apple.MobileSMS,4,1721332672,1721332676,1721332677.001787,-18000,EB445137-D7F5-57EC-87DA-1DB460D64046,"iPhone13,2"
com.apple.findmy,34,1721332638,1721332672,1721332672.3401,-18000,EB445137-D7F5-57EC-87DA-1DB460D64046,"iPhone13,2"
com.hammerandchisel.discord,8,1721332627,1721332635,1721332635.396451,-18000,EB445137-D7F5-57EC-87DA-1DB460D64046,"iPhone13,2"
com.apple.findmy,12,1721332615,1721332627,1721332627.45449,-18000,EB445137-D7F5-57EC-87DA-1DB460D64046,"iPhone13,2"
com.apple.camera,0,1721332610,1721332610,1721332610.6877332,-18000,EB445137-D7F5-57EC-87DA-1DB460D64046,"iPhone13,2"
com.apple.findmy,8,1721332607,1721332615,1721332615.012485,-18000,EB445137-D7F5-57EC-87DA-1DB460D64046,"iPhone13,2"
com.apple.findmy,6,1721332600,1721332606,1721332606.182395,-18000,EB445137-D7F5-57EC-87DA-1DB460D64046,"iPhone13,2"
com.apple.findmy,14,1721332517,1721332531,1721332531.134939,-18000,EB445137-D7F5-57EC-87DA-1DB460D64046,"iPhone13,2"
com.apple.MobileSMS,2,1721332515,1721332517,1721332517.814997,-18000,EB445137-D7F5-57EC-87DA-1DB460D64046,"iPhone13,2"
com.apple.findmy,1,1721332514,1721332515,1721332516.523562,-18000,EB445137-D7F5-57EC-87DA-1DB460D64046,"iPhone13,2"
com.apple.findmy,6,1721332482,1721332488,1721332488.776613,-18000,EB445137-D7F5-57EC-87DA-1DB460D64046,"iPhone13,2"
com.apple.MobileSMS,8,1721332474,1721332482,1721332482.921912,-18000,EB445137-D7F5-57EC-87DA-1DB460D64046,"iPhone13,2"
com.hammerandchisel.discord,3,1721332471,1721332474,1721332474.50546,-18000,EB445137-D7F5-57EC-87DA-1DB460D64046,"iPhone13,2"
com.hammerandchisel.discord,4,1721331293,1721331297,1721331297.540707,-18000,EB445137-D7F5-57EC-87DA-1DB460D64046,"iPhone13,2"
com.toyopagroup.picaboo,21,1721331269,1721331290,1721331290.267101,-18000,EB445137-D7F5-57EC-87DA-1DB460D64046,"iPhone13,2"
com.apple.calculator,5,1721331264,1721331269,1721331269.414588,-18000,EB445137-D7F5-57EC-87DA-1DB460D64046,"iPhone13,2"
com.apple.calculator,3,1721330803,1721330806,1721330806.798936,-18000,EB445137-D7F5-57EC-87DA-1DB460D64046,"iPhone13,2"
com.apple.mobileslideshow,2,1721330801,1721330803,1721330803.337059,-18000,EB445137-D7F5-57EC-87DA-1DB460D64046,"iPhone13,2"
com.apple.mobileslideshow,9,1721330585,1721330594,1721330594.581242,-18000,EB445137-D7F5-57EC-87DA-1DB460D64046,"iPhone13,2"
com.apple.mobileslideshow,1,1721330057,1721330058,1721330058.611419,-18000,EB445137-D7F5-57EC-87DA-1DB460D64046,"iPhone13,2"
com.apple.mobileslideshow,22,1721329278,1721329300,1721329301.1926079,-18000,EB445137-D7F5-57EC-87DA-1DB460D64046,"iPhone13,2"
com.apple.MobileSMS,2,1721329274,1721329276,1721329276.9877172,-18000,EB445137-D7F5-57EC-87DA-1DB460D64046,"iPhone13,2"
com.apple.MobileSMS,2,1721325193,1721325195,1721325195.753172,-18000,EB445137-D7F5-57EC-87DA-1DB460D64046,"iPhone13,2"
com.apple.MobileSMS,14,1721325162,1721325176,1721325176.342773,-18000,EB445137-D7F5-57EC-87DA-1DB460D64046,"iPhone13,2"
com.apple.MobileSMS,6,1721325063,1721325069,1721325069.9904242,-18000,EB445137-D7F5-57EC-87DA-1DB460D64046,"iPhone13,2"
com.apple.MobileSMS,12,1721325008,1721325020,1721325020.916778,-18000,EB445137-D7F5-57EC-87DA-1DB460D64046,"iPhone13,2"
com.apple.MobileSMS,7,1721324459,1721324466,1721324466.926396,-18000,EB445137-D7F5-57EC-87DA-1DB460D64046,"iPhone13,2"
com.apple.MobileSMS,3,1721324350,1721324353,1721324353.236112,-18000,EB445137-D7F5-57EC-87DA-1DB460D64046,"iPhone13,2"
com.apple.MobileSMS,6,1721323871,1721323877,1721323877.843546,-18000,EB445137-D7F5-57EC-87DA-1DB460D64046,"iPhone13,2"
com.apple.MobileSMS,24,1721315027,1721315051,1721315051.2032418,-18000,EB445137-D7F5-57EC-87DA-1DB460D64046,"iPhone13,2"
com.apple.Bridge,23,1721315004,1721315027,1721315027.226958,-18000,EB445137-D7F5-57EC-87DA-1DB460D64046,"iPhone13,2"
com.apple.MobileSMS,2,1721314999,1721315001,1721315001.997895,-18000,EB445137-D7F5-57EC-87DA-1DB460D64046,"iPhone13,2"
com.apple.MobileSMS,4,1721314783,1721314787,1721314787.089374,-18000,EB445137-D7F5-57EC-87DA-1DB460D64046,"iPhone13,2"
com.apple.PosterBoard,0,1721314782,1721314782,1721314783.055022,-18000,EB445137-D7F5-57EC-87DA-1DB460D64046,"iPhone13,2"
com.apple.MobileSMS,2,1721314781,1721314783,1721314784.309341,-18000,EB445137-D7F5-57EC-87DA-1DB460D64046,"iPhone13,2"
com.apple.MobileSMS,28,1721314736,1721314764,1721314764.375856,-18000,EB445137-D7F5-57EC-87DA-1DB460D64046,"iPhone13,2"
com.apple.MobileSMS,11,1721314725,1721314736,1721314736.523059,-18000,EB445137-D7F5-57EC-87DA-1DB460D64046,"iPhone13,2"
com.apple.MobileSMS,11,1721314672,1721314683,1721314683.617183,-18000,EB445137-D7F5-57EC-87DA-1DB460D64046,"iPhone13,2"
com.muscleforlife.Stacked,0,1721313958,1721313958,1721313958.189633,-18000,EB445137-D7F5-57EC-87DA-1DB460D64046,"iPhone13,2"
com.muscleforlife.Stacked,1,1721313956,1721313957,1721313957.501734,-18000,EB445137-D7F5-57EC-87DA-1DB460D64046,"iPhone13,2"
com.muscleforlife.Stacked,8,1721312654,1721312662,1721312662.908226,-18000,EB445137-D7F5-57EC-87DA-1DB460D64046,"iPhone13,2"
com.muscleforlife.Stacked,2,1721312651,1721312653,1721312653.6081638,-18000,EB445137-D7F5-57EC-87DA-1DB460D64046,"iPhone13,2"
com.muscleforlife.Stacked,2,1721311967,1721311969,1721311969.288103,-18000,EB445137-D7F5-57EC-87DA-1DB460D64046,"iPhone13,2"
com.apple.camera,0,1721311829,1721311829,1721311829.8416982,-18000,EB445137-D7F5-57EC-87DA-1DB460D64046,"iPhone13,2"
com.apple.camera,1,1721311826,1721311827,1721311827.874454,-18000,EB445137-D7F5-57EC-87DA-1DB460D64046,"iPhone13,2"
com.muscleforlife.Stacked,10,1721311825,1721311835,1721311835.842071,-18000,EB445137-D7F5-57EC-87DA-1DB460D64046,"iPhone13,2"
com.muscleforlife.Stacked,15,1721311808,1721311823,1721311823.926237,-18000,EB445137-D7F5-57EC-87DA-1DB460D64046,"iPhone13,2"
com.muscleforlife.Stacked,3,1721311779,1721311782,1721311782.678046,-18000,EB445137-D7F5-57EC-87DA-1DB460D64046,"iPhone13,2"
com.muscleforlife.Stacked,5,1721311762,1721311767,1721311767.01617,-18000,EB445137-D7F5-57EC-87DA-1DB460D64046,"iPhone13,2"
com.muscleforlife.Stacked,64,1721311679,1721311743,1721311743.708864,-18000,EB445137-D7F5-57EC-87DA-1DB460D64046,"iPhone13,2"
com.muscleforlife.Stacked,4,1721311644,1721311648,1721311648.3224192,-18000,EB445137-D7F5-57EC-87DA-1DB460D64046,"iPhone13,2"
com.muscleforlife.Stacked,6,1721311624,1721311630,1721311630.017806,-18000,EB445137-D7F5-57EC-87DA-1DB460D64046,"iPhone13,2"
com.muscleforlife.Stacked,3,1721311597,1721311600,1721311600.24249,-18000,EB445137-D7F5-57EC-87DA-1DB460D64046,"iPhone13,2"
com.muscleforlife.Stacked,1,1721311554,1721311555,1721311555.55579,-18000,EB445137-D7F5-57EC-87DA-1DB460D64046,"iPhone13,2"
com.muscleforlife.Stacked,6,1721311547,1721311553,1721311553.875668,-18000,EB445137-D7F5-57EC-87DA-1DB460D64046,"iPhone13,2"
com.muscleforlife.Stacked,11,1721311478,1721311489,1721311489.051509,-18000,EB445137-D7F5-57EC-87DA-1DB460D64046,"iPhone13,2"
com.muscleforlife.Stacked,2,1721311465,1721311467,1721311467.111608,-18000,EB445137-D7F5-57EC-87DA-1DB460D64046,"iPhone13,2"
com.muscleforlife.Stacked,2,1721311432,1721311434,1721311434.7086549,-18000,EB445137-D7F5-57EC-87DA-1DB460D64046,"iPhone13,2"
com.muscleforlife.Stacked,3,1721311398,1721311401,1721311401.976649,-18000,EB445137-D7F5-57EC-87DA-1DB460D64046,"iPhone13,2"
com.muscleforlife.Stacked,11,1721311317,1721311328,1721311328.099797,-18000,EB445137-D7F5-57EC-87DA-1DB460D64046,"iPhone13,2"
com.muscleforlife.Stacked,3,1721311287,1721311290,1721311290.616991,-18000,EB445137-D7F5-57EC-87DA-1DB460D64046,"iPhone13,2"
com.muscleforlife.Stacked,1,1721311275,1721311276,1721311276.981873,-18000,EB445137-D7F5-57EC-87DA-1DB460D64046,"iPhone13,2"
com.muscleforlife.Stacked,3,1721311258,1721311261,1721311261.2566938,-18000,EB445137-D7F5-57EC-87DA-1DB460D64046,"iPhone13,2"
com.muscleforlife.Stacked,10,1721311182,1721311192,1721311192.533577,-18000,EB445137-D7F5-57EC-87DA-1DB460D64046,"iPhone13,2"
com.muscleforlife.Stacked,4,1721311138,1721311142,1721311142.287972,-18000,EB445137-D7F5-57EC-87DA-1DB460D64046,"iPhone13,2"
com.muscleforlife.Stacked,3,1721311118,1721311121,1721311121.988852,-18000,EB445137-D7F5-57EC-87DA-1DB460D64046,"iPhone13,2"
com.muscleforlife.Stacked,5,1721311057,1721311062,1721311062.1215239,-18000,EB445137-D7F5-57EC-87DA-1DB460D64046,"iPhone13,2"
com.muscleforlife.Stacked,6,1721311007,1721311013,1721311013.6148028,-18000,EB445137-D7F5-57EC-87DA-1DB460D64046,"iPhone13,2"
com.muscleforlife.Stacked,2,1721311003,1721311005,1721311005.9717898,-18000,EB445137-D7F5-57EC-87DA-1DB460D64046,"iPhone13,2"
com.muscleforlife.Stacked,3,1721310963,1721310966,1721310966.8258262,-18000,EB445137-D7F5-57EC-87DA-1DB460D64046,"iPhone13,2"
com.muscleforlife.Stacked,6,1721310897,1721310903,1721310903.3660588,-18000,EB445137-D7F5-57EC-87DA-1DB460D64046,"iPhone13,2"
com.muscleforlife.Stacked,10,1721310835,1721310845,1721310845.13908,-18000,EB445137-D7F5-57EC-87DA-1DB460D64046,"iPhone13,2"
com.muscleforlife.Stacked,3,1721310816,1721310819,1721310819.701861,-18000,EB445137-D7F5-57EC-87DA-1DB460D64046,"iPhone13,2"
com.muscleforlife.Stacked,6,1721310743,1721310749,1721310749.773333,-18000,EB445137-D7F5-57EC-87DA-1DB460D64046,"iPhone13,2"
com.muscleforlife.Stacked,6,1721310736,1721310742,1721310742.960736,-18000,EB445137-D7F5-57EC-87DA-1DB460D64046,"iPhone13,2"
com.muscleforlife.Stacked,10,1721310598,1721310608,1721310608.189709,-18000,EB445137-D7F5-57EC-87DA-1DB460D64046,"iPhone13,2"
com.lafitness.lafitness,2,1721310596,1721310598,1721310598.49748,-18000,EB445137-D7F5-57EC-87DA-1DB460D64046,"iPhone13,2"
com.lafitness.lafitness,11,1721310472,1721310483,1721310483.125396,-18000,EB445137-D7F5-57EC-87DA-1DB460D64046,"iPhone13,2"
com.lafitness.lafitness,11,1721309727,1721309738,1721309738.973716,-18000,EB445137-D7F5-57EC-87DA-1DB460D64046,"iPhone13,2"
com.google.Gmail,6,1721309721,1721309727,1721309728.009593,-18000,EB445137-D7F5-57EC-87DA-1DB460D64046,"iPhone13,2"
com.lafitness.lafitness,4,1721309717,1721309721,1721309724.954616,-18000,EB445137-D7F5-57EC-87DA-1DB460D64046,"iPhone13,2"
com.apple.AppStore,16,1721309701,1721309717,1721309717.398454,-18000,EB445137-D7F5-57EC-87DA-1DB460D64046,"iPhone13,2"
com.google.Gmail,6,1721309695,1721309701,1721309701.448254,-18000,EB445137-D7F5-57EC-87DA-1DB460D64046,"iPhone13,2"
com.google.ios.youtube,537,1721308999,1721309536,1721309536.917756,-18000,EB445137-D7F5-57EC-87DA-1DB460D64046,"iPhone13,2"
com.apple.news,10,1721308980,1721308990,1721308990.4522161,-18000,EB445137-D7F5-57EC-87DA-1DB460D64046,"iPhone13,2"
com.apple.Health,17,1721308715,1721308732,1721308732.985028,-18000,EB445137-D7F5-57EC-87DA-1DB460D64046,"iPhone13,2"
com.apple.findmy,48,1721307953,1721308001,1721308001.317703,-18000,EB445137-D7F5-57EC-87DA-1DB460D64046,"iPhone13,2"
com.apple.news,186,1721307715,1721307901,1721307901.477097,-18000,EB445137-D7F5-57EC-87DA-1DB460D64046,"iPhone13,2"
com.google.Gmail,42,1721307649,1721307691,1721307691.5026631,-18000,EB445137-D7F5-57EC-87DA-1DB460D64046,"iPhone13,2"
com.apple.finder,6,1721273371,1721273377,1721273377.222381,-18000,,
com.google.Chrome,231,1721273140,1721273371,1721273371.277807,-18000,,
com.google.Chrome,323,1721272625,1721272948,1721272948.901497,-18000,,
com.google.Chrome,1152,1721270875,1721272027,1721272027.0505981,-18000,,
com.google.Chrome,305,1721270431,1721270736,1721270736.5555758,-18000,,
com.google.Chrome,844,1721269582,1721270426,1721270426.095866,-18000,,
com.google.Chrome,861,1721268417,1721269278,1721269278.368715,-18000,,
com.google.Chrome,153,1721267758,1721267911,1721267911.553987,-18000,,
com.google.Chrome,304,1721267108,1721267412,1721267412.523637,-18000,,
com.google.Chrome,1688,1721265371,1721267059,1721267059.997886,-18000,,
com.google.Chrome,17,1721261633,1721261650,1721261651.088932,-18000,,
com.apple.MobileSMS,4,1721261174,1721261178,1721261178.276608,-18000,,
com.google.Chrome,79,1721261095,1721261174,1721261174.2795482,-18000,,
com.apple.Notes,5,1721261090,1721261095,1721261095.918688,-18000,,
com.google.Chrome,523,1721260567,1721261090,1721261090.630074,-18000,,
com.apple.Notes,1,1721260566,1721260567,1721260567.752843,-18000,,
com.google.Chrome,34,1721260532,1721260566,1721260566.222906,-18000,,
com.apple.Notes,2,1721260530,1721260532,1721260532.670799,-18000,,
com.google.Chrome,50,1721260480,1721260530,1721260530.674649,-18000,,
com.apple.Notes,2,1721260478,1721260480,1721260480.799382,-18000,,
com.google.Chrome,159,1721260319,1721260478,1721260479.0449882,-18000,,
com.apple.Notes,1,1721260318,1721260319,1721260319.8836498,-18000,,
com.google.Chrome,65,1721260253,1721260318,1721260318.229107,-18000,,
com.apple.Notes,3,1721260250,1721260253,1721260253.179147,-18000,,
com.google.Chrome,74,1721260176,1721260250,1721260251.010253,-18000,,
com.apple.Notes,2,1721260174,1721260176,1721260176.1418839,-18000,,
com.google.Chrome,91,1721260083,1721260174,1721260174.582536,-18000,,
com.apple.Notes,2,1721260081,1721260083,1721260083.267332,-18000,,
com.google.Chrome,3,1721260078,1721260081,1721260081.103621,-18000,,
com.apple.Notes,12,1721260066,1721260078,1721260078.1352282,-18000,,
com.google.Chrome,621,1721259445,1721260066,1721260066.4500952,-18000,,
com.google.chrome.ios,2,1721253924,1721253926,1721253927.105287,-18000,EB445137-D7F5-57EC-87DA-1DB460D64046,"iPhone13,2"
com.google.chrome.ios,37,1721253828,1721253865,1721253865.075829,-18000,EB445137-D7F5-57EC-87DA-1DB460D64046,"iPhone13,2"
com.apple.findmy,7,1721253821,1721253828,1721253828.299813,-18000,EB445137-D7F5-57EC-87DA-1DB460D64046,"iPhone13,2"
com.apple.findmy,13,1721253565,1721253578,1721253578.2516751,-18000,EB445137-D7F5-57EC-87DA-1DB460D64046,"iPhone13,2"
com.apple.findmy,2,1721253524,1721253526,1721253526.212662,-18000,EB445137-D7F5-57EC-87DA-1DB460D64046,"iPhone13,2"
com.apple.findmy,5,1721253516,1721253521,1721253521.137155,-18000,EB445137-D7F5-57EC-87DA-1DB460D64046,"iPhone13,2"
com.apple.news,2,1721253514,1721253516,1721253516.963266,-18000,EB445137-D7F5-57EC-87DA-1DB460D64046,"iPhone13,2"
com.apple.news,6,1721253445,1721253451,1721253451.3349519,-18000,EB445137-D7F5-57EC-87DA-1DB460D64046,"iPhone13,2"
com.google.Chrome,96,1721253327,1721253423,1721253423.435268,-18000,,
com.apple.news,33,1721253215,1721253248,1721253248.552784,-18000,EB445137-D7F5-57EC-87DA-1DB460D64046,"iPhone13,2"
com.thestorygraph.thestorygraph,94,1721253087,1721253181,1721253181.811358,-18000,EB445137-D7F5-57EC-87DA-1DB460D64046,"iPhone13,2"
Astrospheric.Astrospheric,17,1721253005,1721253022,1721253022.684524,-18000,EB445137-D7F5-57EC-87DA-1DB460D64046,"iPhone13,2"
com.google.Chrome,411,1721252728,1721253139,1721253139.043611,-18000,,
com.truebill.truebillnative,76,1721252537,1721252613,1721252613.1412969,-18000,EB445137-D7F5-57EC-87DA-1DB460D64046,"iPhone13,2"
com.apple.news,168,1721251413,1721251581,1721251581.501658,-18000,EB445137-D7F5-57EC-87DA-1DB460D64046,"iPhone13,2"
com.apple.news,28,1721250950,1721250978,1721250978.82604,-18000,EB445137-D7F5-57EC-87DA-1DB460D64046,"iPhone13,2"
com.google.Chrome,1502,1721250932,1721252434,1721252434.4448981,-18000,,
com.myfitnesspal.mfp,47,1721250048,1721250095,1721250095.162012,-18000,EB445137-D7F5-57EC-87DA-1DB460D64046,"iPhone13,2"
com.apple.reminders,11,1721250035,1721250046,1721250046.777052,-18000,EB445137-D7F5-57EC-87DA-1DB460D64046,"iPhone13,2"
com.robinhood.release.Robinhood,39,1721249855,1721249894,1721249894.676383,-18000,EB445137-D7F5-57EC-87DA-1DB460D64046,"iPhone13,2"
org.name.serializdmobile,6,1721249830,1721249836,1721249836.148364,-18000,EB445137-D7F5-57EC-87DA-1DB460D64046,"iPhone13,2"
org.name.serializdmobile,230,1721249435,1721249665,1721249665.2786632,-18000,EB445137-D7F5-57EC-87DA-1DB460D64046,"iPhone13,2"
com.doordash.dasher,3,1721249429,1721249432,1721249432.33935,-18000,EB445137-D7F5-57EC-87DA-1DB460D64046,"iPhone13,2"
com.google.Chrome,1267,1721249410,1721250677,1721250677.8429441,-18000,,
com.apple.MobileSMS,12,1721249398,1721249410,1721249410.63621,-18000,,
com.google.Chrome,9,1721249389,1721249398,1721249398.393462,-18000,,
com.doordash.dasher,54,1721249179,1721249233,1721249233.879941,-18000,EB445137-D7F5-57EC-87DA-1DB460D64046,"iPhone13,2"
com.google.ios.youtube,5,1721249174,1721249179,1721249179.217381,-18000,EB445137-D7F5-57EC-87DA-1DB460D64046,"iPhone13,2"
com.google.Chrome,429,1721248613,1721249042,1721249042.905765,-18000,,
com.google.ios.youtube,1191,1721247300,1721248491,1721248491.625987,-18000,EB445137-D7F5-57EC-87DA-1DB460D64046,"iPhone13,2"
com.apple.Health,45,1721247253,1721247298,1721247298.102227,-18000,EB445137-D7F5-57EC-87DA-1DB460D64046,"iPhone13,2"
com.apple.MobileSMS,2,1721247251,1721247253,1721247253.305829,-18000,EB445137-D7F5-57EC-87DA-1DB460D64046,"iPhone13,2"
com.apple.Health,2,1721247249,1721247251,1721247251.568083,-18000,EB445137-D7F5-57EC-87DA-1DB460D64046,"iPhone13,2"
com.apple.Health,11,1721247236,1721247247,1721247247.477277,-18000,EB445137-D7F5-57EC-87DA-1DB460D64046,"iPhone13,2"
com.apple.MobileSMS,1,1721247235,1721247236,1721247236.91882,-18000,EB445137-D7F5-57EC-87DA-1DB460D64046,"iPhone13,2"
com.apple.MobileSMS,26,1721247192,1721247218,1721247219.0015712,-18000,EB445137-D7F5-57EC-87DA-1DB460D64046,"iPhone13,2"
com.apple.weather,25,1721247167,1721247192,1721247192.414047,-18000,EB445137-D7F5-57EC-87DA-1DB460D64046,"iPhone13,2"
com.apple.camera,7,1721247127,1721247134,1721247134.976896,-18000,EB445137-D7F5-57EC-87DA-1DB460D64046,"iPhone13,2"
com.google.chrome.ios,8,1721247126,1721247134,1721247134.848421,-18000,EB445137-D7F5-57EC-87DA-1DB460D64046,"iPhone13,2"
com.google.chrome.ios,4,1721246918,1721246922,1721246922.964066,-18000,EB445137-D7F5-57EC-87DA-1DB460D64046,"iPhone13,2"
com.google.chrome.ios,9,1721245997,1721246006,1721246006.976313,-18000,EB445137-D7F5-57EC-87DA-1DB460D64046,"iPhone13,2"
com.google.chrome.ios,78,1721244064,1721244142,1721244142.555097,-18000,EB445137-D7F5-57EC-87DA-1DB460D64046,"iPhone13,2"
com.google.chrome.ios,9,1721243946,1721243955,1721243955.3559442,-18000,EB445137-D7F5-57EC-87DA-1DB460D64046,"iPhone13,2"
com.google.chrome.ios,118,1721243634,1721243752,1721243752.674652,-18000,EB445137-D7F5-57EC-87DA-1DB460D64046,"iPhone13,2"
com.apple.MobileSMS,3,1721243630,1721243633,1721243633.4564528,-18000,EB445137-D7F5-57EC-87DA-1DB460D64046,"iPhone13,2"
com.apple.MobileSMS,1,1721243556,1721243557,1721243557.6450338,-18000,EB445137-D7F5-57EC-87DA-1DB460D64046,"iPhone13,2"
com.apple.MobileSMS,11,1721241016,1721241027,1721241027.020442,-18000,EB445137-D7F5-57EC-87DA-1DB460D64046,"iPhone13,2"
com.apple.MobileSMS,9,1721241004,1721241013,1721241013.1934981,-18000,EB445137-D7F5-57EC-87DA-1DB460D64046,"iPhone13,2"
com.apple.MobileSMS,7,1721240994,1721241001,1721241002.017437,-18000,EB445137-D7F5-57EC-87DA-1DB460D64046,"iPhone13,2"
com.apple.MobileSMS,6,1721240164,1721240170,1721240170.1587691,-18000,EB445137-D7F5-57EC-87DA-1DB460D64046,"iPhone13,2"
com.apple.MobileSMS,7,1721239723,1721239730,1721239730.016228,-18000,EB445137-D7F5-57EC-87DA-1DB460D64046,"iPhone13,2"
com.apple.MobileSMS,11,1721239710,1721239721,1721239721.848397,-18000,EB445137-D7F5-57EC-87DA-1DB460D64046,"iPhone13,2"
com.apple.mobilephone,4,1721239706,1721239710,1721239710.8290582,-18000,EB445137-D7F5-57EC-87DA-1DB460D64046,"iPhone13,2"
com.apple.InCallService,0,1721239706,1721239706,1721239706.909851,-18000,EB445137-D7F5-57EC-87DA-1DB460D64046,"iPhone13,2"
com.apple.InCallService,1,1721239703,1721239704,1721239704.954418,-18000,EB445137-D7F5-57EC-87DA-1DB460D64046,"iPhone13,2"
com.apple.InCallService,2,1721239670,1721239672,1721239672.188935,-18000,EB445137-D7F5-57EC-87DA-1DB460D64046,"iPhone13,2"
com.apple.mobilephone,10,1721239660,1721239670,1721239670.465445,-18000,EB445137-D7F5-57EC-87DA-1DB460D64046,"iPhone13,2"
com.apple.InCallService,1,1721239659,1721239660,1721239660.309877,-18000,EB445137-D7F5-57EC-87DA-1DB460D64046,"iPhone13,2"
com.apple.InCallService,2,1721239628,1721239630,1721239630.134366,-18000,EB445137-D7F5-57EC-87DA-1DB460D64046,"iPhone13,2"
com.apple.mobilephone,11,1721239617,1721239628,1721239628.0625958,-18000,EB445137-D7F5-57EC-87DA-1DB460D64046,"iPhone13,2"
com.apple.MobileSMS,52,1721239560,1721239612,1721239613.005964,-18000,EB445137-D7F5-57EC-87DA-1DB460D64046,"iPhone13,2"
com.apple.mobilenotes,4,1721239556,1721239560,1721239560.5599442,-18000,EB445137-D7F5-57EC-87DA-1DB460D64046,"iPhone13,2"
com.apple.mobilenotes,3,1721239090,1721239093,1721239093.382059,-18000,EB445137-D7F5-57EC-87DA-1DB460D64046,"iPhone13,2"
com.apple.mobilenotes,3,1721238700,1721238703,1721238703.606862,-18000,EB445137-D7F5-57EC-87DA-1DB460D64046,"iPhone13,2"
com.apple.mobilenotes,6,1721238359,1721238365,1721238365.782022,-18000,EB445137-D7F5-57EC-87DA-1DB460D64046,"iPhone13,2"
com.apple.mobilenotes,2,1721238357,1721238359,1721238359.2971048,-18000,EB445137-D7F5-57EC-87DA-1DB460D64046,"iPhone13,2"
com.apple.mobilenotes,34,1721237622,1721237656,1721237656.9184,-18000,EB445137-D7F5-57EC-87DA-1DB460D64046,"iPhone13,2"
com.apple.MobileSMS,2,1721237616,1721237618,1721237618.9590158,-18000,EB445137-D7F5-57EC-87DA-1DB460D64046,"iPhone13,2"
com.apple.MobileSMS,6,1721237606,1721237612,1721237612.9920712,-18000,EB445137-D7F5-57EC-87DA-1DB460D64046,"iPhone13,2"
com.apple.MobileSMS,3,1721237602,1721237605,1721237605.612002,-18000,EB445137-D7F5-57EC-87DA-1DB460D64046,"iPhone13,2"
com.apple.news,0,1721237557,1721237557,1721237558.0824962,-18000,EB445137-D7F5-57EC-87DA-1DB460D64046,"iPhone13,2"
com.apple.news,9,1721236259,1721236268,1721236268.131495,-18000,EB445137-D7F5-57EC-87DA-1DB460D64046,"iPhone13,2"
com.apple.news,88,1721236068,1721236156,1721236156.717324,-18000,EB445137-D7F5-57EC-87DA-1DB460D64046,"iPhone13,2"
com.apple.MobileSMS,42,1721235998,1721236040,1721236040.2267451,-18000,EB445137-D7F5-57EC-87DA-1DB460D64046,"iPhone13,2"
com.apple.MobileSMS,2,1721232980,1721232982,1721232982.760145,-18000,EB445137-D7F5-57EC-87DA-1DB460D64046,"iPhone13,2"
com.apple.MobileSMS,83,1721232591,1721232674,1721232674.101554,-18000,EB445137-D7F5-57EC-87DA-1DB460D64046,"iPhone13,2"
com.apple.podcasts,25,1721232566,1721232591,1721232591.600872,-18000,EB445137-D7F5-57EC-87DA-1DB460D64046,"iPhone13,2"
com.apple.MobileSMS,2,1721232562,1721232564,1721232564.964679,-18000,EB445137-D7F5-57EC-87DA-1DB460D64046,"iPhone13,2"
com.apple.MobileSMS,12,1721232540,1721232552,1721232552.2929401,-18000,EB445137-D7F5-57EC-87DA-1DB460D64046,"iPhone13,2"
com.apple.podcasts,4,1721232536,1721232540,1721232541.4008899,-18000,EB445137-D7F5-57EC-87DA-1DB460D64046,"iPhone13,2"
com.apple.podcasts,54,1721229364,1721229418,1721229418.4477,-18000,EB445137-D7F5-57EC-87DA-1DB460D64046,"iPhone13,2"
com.apple.Music,3,1721229358,1721229361,1721229361.354158,-18000,EB445137-D7F5-57EC-87DA-1DB460D64046,"iPhone13,2"
com.muscleforlife.Stacked,3,1721229355,1721229358,1721229358.0944061,-18000,EB445137-D7F5-57EC-87DA-1DB460D64046,"iPhone13,2"
com.muscleforlife.Stacked,24,1721227962,1721227986,1721227986.5759459,-18000,EB445137-D7F5-57EC-87DA-1DB460D64046,"iPhone13,2"
com.muscleforlife.Stacked,38,1721227883,1721227921,1721227921.673003,-18000,EB445137-D7F5-57EC-87DA-1DB460D64046,"iPhone13,2"
com.muscleforlife.Stacked,64,1721227815,1721227879,1721227879.124969,-18000,EB445137-D7F5-57EC-87DA-1DB460D64046,"iPhone13,2"
com.muscleforlife.Stacked,106,1721227674,1721227780,1721227780.1015348,-18000,EB445137-D7F5-57EC-87DA-1DB460D64046,"iPhone13,2"
com.muscleforlife.Stacked,6,1721227569,1721227575,1721227575.527987,-18000,EB445137-D7F5-57EC-87DA-1DB460D64046,"iPhone13,2"
com.muscleforlife.Stacked,3,1721227515,1721227518,1721227518.106663,-18000,EB445137-D7F5-57EC-87DA-1DB460D64046,"iPhone13,2"
com.muscleforlife.Stacked,2,1721227481,1721227483,1721227483.462363,-18000,EB445137-D7F5-57EC-87DA-1DB460D64046,"iPhone13,2"
com.muscleforlife.Stacked,6,1721227419,1721227425,1721227425.710462,-18000,EB445137-D7F5-57EC-87DA-1DB460D64046,"iPhone13,2"
com.muscleforlife.Stacked,4,1721227414,1721227418,1721227418.930759,-18000,EB445137-D7F5-57EC-87DA-1DB460D64046,"iPhone13,2"
com.muscleforlife.Stacked,6,1721227374,1721227380,1721227380.41931,-18000,EB445137-D7F5-57EC-87DA-1DB460D64046,"iPhone13,2"
com.muscleforlife.Stacked,4,1721227345,1721227349,1721227349.904355,-18000,EB445137-D7F5-57EC-87DA-1DB460D64046,"iPhone13,2"
com.muscleforlife.Stacked,5,1721227278,1721227283,1721227283.0701551,-18000,EB445137-D7F5-57EC-87DA-1DB460D64046,"iPhone13,2"
com.muscleforlife.Stacked,93,1721227122,1721227215,1721227215.012666,-18000,EB445137-D7F5-57EC-87DA-1DB460D64046,"iPhone13,2"
com.muscleforlife.Stacked,110,1721226980,1721227090,1721227090.1544762,-18000,EB445137-D7F5-57EC-87DA-1DB460D64046,"iPhone13,2"
com.muscleforlife.Stacked,113,1721226841,1721226954,1721226954.2421699,-18000,EB445137-D7F5-57EC-87DA-1DB460D64046,"iPhone13,2"
com.muscleforlife.Stacked,9,1721226799,1721226808,1721226808.4646711,-18000,EB445137-D7F5-57EC-87DA-1DB460D64046,"iPhone13,2"
com.muscleforlife.Stacked,11,1721226691,1721226702,1721226702.4175239,-18000,EB445137-D7F5-57EC-87DA-1DB460D64046,"iPhone13,2"
com.muscleforlife.Stacked,3,1721226651,1721226654,1721226654.060983,-18000,EB445137-D7F5-57EC-87DA-1DB460D64046,"iPhone13,2"
com.muscleforlife.Stacked,91,1721226537,1721226628,1721226628.875808,-18000,EB445137-D7F5-57EC-87DA-1DB460D64046,"iPhone13,2"
com.muscleforlife.Stacked,113,1721226391,1721226504,1721226504.486452,-18000,EB445137-D7F5-57EC-87DA-1DB460D64046,"iPhone13,2"
com.muscleforlife.Stacked,6,1721226141,1721226147,1721226147.3104482,-18000,EB445137-D7F5-57EC-87DA-1DB460D64046,"iPhone13,2"
com.muscleforlife.Stacked,18,1721226121,1721226139,1721226139.968292,-18000,EB445137-D7F5-57EC-87DA-1DB460D64046,"iPhone13,2"
com.myfitnesspal.mfp,2,1721226119,1721226121,1721226121.311367,-18000,EB445137-D7F5-57EC-87DA-1DB460D64046,"iPhone13,2"
com.apple.news,71,1721224908,1721224979,1721224979.307267,-18000,EB445137-D7F5-57EC-87DA-1DB460D64046,"iPhone13,2"
com.apple.news,122,1721224776,1721224898,1721224898.872071,-18000,EB445137-D7F5-57EC-87DA-1DB460D64046,"iPhone13,2"
com.apple.MobileSMS,3,1721224773,1721224776,1721224776.814518,-18000,EB445137-D7F5-57EC-87DA-1DB460D64046,"iPhone13,2"
com.apple.MobileSMS,9,1721224657,1721224666,1721224666.633634,-18000,EB445137-D7F5-57EC-87DA-1DB460D64046,"iPhone13,2"
com.apple.MobileSMS,29,1721224540,1721224569,1721224569.7082062,-18000,EB445137-D7F5-57EC-87DA-1DB460D64046,"iPhone13,2"
com.apple.news,44,1721224494,1721224538,1721224538.649518,-18000,EB445137-D7F5-57EC-87DA-1DB460D64046,"iPhone13,2"
com.apple.weather,40,1721224430,1721224470,1721224470.206564,-18000,EB445137-D7F5-57EC-87DA-1DB460D64046,"iPhone13,2"
com.apple.MobileSMS,4,1721224083,1721224087,1721224087.921846,-18000,EB445137-D7F5-57EC-87DA-1DB460D64046,"iPhone13,2"
com.apple.Preferences,24,1721224058,1721224082,1721224082.757588,-18000,EB445137-D7F5-57EC-87DA-1DB460D64046,"iPhone13,2"
com.apple.findmy,7,1721224048,1721224055,1721224055.317367,-18000,EB445137-D7F5-57EC-87DA-1DB460D64046,"iPhone13,2"
com.apple.findmy,5,1721223837,1721223842,1721223842.352295,-18000,EB445137-D7F5-57EC-87DA-1DB460D64046,"iPhone13,2"
com.apple.camera,0,1721223764,1721223764,1721223764.527564,-18000,EB445137-D7F5-57EC-87DA-1DB460D64046,"iPhone13,2"
com.apple.camera,1,1721223762,1721223763,1721223763.189777,-18000,EB445137-D7F5-57EC-87DA-1DB460D64046,"iPhone13,2"
com.google.ios.youtube,758,1721222731,1721223489,1721223489.6571941,-18000,EB445137-D7F5-57EC-87DA-1DB460D64046,"iPhone13,2"
com.google.Chrome,642,1721185932,1721186574,1721186574.218977,-18000,,
com.google.Chrome,396,1721185510,1721185906,1721185906.114317,-18000,,
com.google.Chrome,1250,1721184058,1721185308,1721185308.352785,-18000,,
com.apple.finder,10,1721184048,1721184058,1721184058.542947,-18000,,
com.apple.finder,56,1721182362,1721182418,1721182418.6090732,-18000,,
com.google.Chrome,1,1721182361,1721182362,1721182362.431597,-18000,,
com.apple.Music,5,1721182356,1721182361,1721182362.042795,-18000,,
com.google.Chrome,12,1721182344,1721182356,1721182356.637061,-18000,,
com.google.Chrome,4,1721182339,1721182343,1721182343.167062,-18000,,
com.apple.finder,3,1721182336,1721182339,1721182339.687292,-18000,,
com.apple.dt.Xcode,83,1721182253,1721182336,1721182336.33019,-18000,,
com.apple.iphonesimulator,2,1721182251,1721182253,1721182253.0583038,-18000,,
org.stellarium.Stellarium,3,1721182248,1721182251,1721182251.1022959,-18000,,
com.apple.iphonesimulator,7,1721182241,1721182248,1721182248.442809,-18000,,
com.apple.dt.Xcode,646,1721181595,1721182241,1721182241.6191201,-18000,,
com.google.Chrome,592,1721181003,1721181595,1721181595.8031669,-18000,,
com.apple.dt.Xcode,1,1721181002,1721181003,1721181004.001802,-18000,,
com.google.Chrome,2,1721181000,1721181002,1721181002.231452,-18000,,
com.apple.dt.Xcode,2,1721180998,1721181000,1721181000.983001,-18000,,
com.google.Chrome,1,1721180997,1721180998,1721180998.8420959,-18000,,
com.apple.dt.Xcode,6,1721180991,1721180997,1721180997.28531,-18000,,
com.google.Chrome,2,1721180989,1721180991,1721180991.105783,-18000,,
com.apple.dt.Xcode,3,1721180986,1721180989,1721180989.573714,-18000,,
com.google.Chrome,8,1721180978,1721180986,1721180986.135644,-18000,,
com.apple.dt.Xcode,4,1721180974,1721180978,1721180978.532686,-18000,,
com.google.Chrome,3,1721180971,1721180974,1721180974.9362369,-18000,,
com.apple.dt.Xcode,6,1721180965,1721180971,1721180971.703821,-18000,,
com.google.Chrome,12,1721180953,1721180965,1721180965.9530811,-18000,,
com.apple.dt.Xcode,18,1721180935,1721180953,1721180953.11649,-18000,,
com.google.Chrome,116,1721180819,1721180935,1721180935.8077512,-18000,,
com.apple.dt.Xcode,85,1721180734,1721180819,1721180819.3989081,-18000,,
com.apple.iphonesimulator,3,1721180731,1721180734,1721180734.126754,-18000,,
com.apple.dt.Xcode,18,1721180713,1721180731,1721180731.73434,-18000,,
com.apple.iphonesimulator,4,1721180709,1721180713,1721180713.412931,-18000,,
com.apple.dt.Xcode,20,1721180689,1721180709,1721180710.021733,-18000,,
com.apple.iphonesimulator,2,1721180687,1721180689,1721180689.652154,-18000,,
org.stellarium.Stellarium,1,1721180686,1721180687,1721180687.037857,-18000,,
com.apple.iphonesimulator,3,1721180683,1721180686,1721180686.5144448,-18000,,
org.stellarium.Stellarium,16,1721180667,1721180683,1721180683.763431,-18000,,
com.apple.iphonesimulator,6,1721180661,1721180667,1721180667.186795,-18000,,
com.apple.dt.Xcode,63,1721180598,1721180661,1721180661.486999,-18000,,
com.google.Chrome,8,1721180590,1721180598,1721180598.528356,-18000,,
com.apple.dt.Xcode,8,1721180582,1721180590,1721180590.413734,-18000,,
com.google.Chrome,10,1721180572,1721180582,1721180582.213643,-18000,,
com.apple.dt.Xcode,4,1721180568,1721180572,1721180572.352638,-18000,,
com.google.Chrome,5,1721180563,1721180568,1721180568.365209,-18000,,
com.apple.dt.Xcode,0,1721180563,1721180563,1721180563.8876848,-18000,,
com.google.Chrome,2,1721180561,1721180563,1721180563.109143,-18000,,
com.apple.dt.Xcode,11,1721180550,1721180561,1721180561.709935,-18000,,
com.google.Chrome,6,1721180544,1721180550,1721180550.300062,-18000,,
com.apple.dt.Xcode,10,1721180534,1721180544,1721180544.277355,-18000,,
com.google.Chrome,5,1721180529,1721180534,1721180534.746677,-18000,,
com.apple.dt.Xcode,4,1721180525,1721180529,1721180529.4296231,-18000,,
com.google.Chrome,3,1721180522,1721180525,1721180525.475651,-18000,,
com.apple.dt.Xcode,2,1721180520,1721180522,1721180522.93806,-18000,,
com.apple.iphonesimulator,1,1721180519,1721180520,1721180520.862634,-18000,,
com.apple.dt.Xcode,38,1721180481,1721180519,1721180519.738383,-18000,,
com.apple.iphonesimulator,1,1721180480,1721180481,1721180481.3976622,-18000,,
com.google.Chrome,54,1721180426,1721180480,1721180480.476056,-18000,,
com.apple.iphonesimulator,1,1721180425,1721180426,1721180426.710069,-18000,,
com.apple.dt.Xcode,17,1721180408,1721180425,1721180425.935,-18000,,
com.apple.iphonesimulator,1,1721180407,1721180408,1721180408.2535682,-18000,,
com.google.Chrome,20,1721180387,1721180407,1721180407.459033,-18000,,
com.apple.iphonesimulator,2,1721180385,1721180387,1721180387.68671,-18000,,
com.apple.dt.Xcode,16,1721180369,1721180385,1721180385.4413729,-18000,,
com.apple.iphonesimulator,4,1721180365,1721180369,1721180369.238045,-18000,,
com.apple.dt.Xcode,28,1721180337,1721180365,1721180365.575619,-18000,,
com.google.Chrome,5,1721180332,1721180337,1721180337.398364,-18000,,
com.apple.dt.Xcode,7,1721180325,1721180332,1721180332.582933,-18000,,
com.google.Chrome,215,1721180110,1721180325,1721180325.6814451,-18000,,
com.apple.dt.Xcode,40,1721180070,1721180110,1721180110.27953,-18000,,
com.apple.iphonesimulator,1,1721180069,1721180070,1721180070.7793589,-18000,,
org.stellarium.Stellarium,3,1721180066,1721180069,1721180069.2026138,-18000,,
com.apple.iphonesimulator,2,1721180064,1721180066,1721180066.676774,-18000,,
org.stellarium.Stellarium,6,1721180058,1721180064,1721180064.948812,-18000,,
com.apple.iphonesimulator,3,1721180055,1721180058,1721180058.6718931,-18000,,
org.stellarium.Stellarium,11,1721180044,1721180055,1721180055.645874,-18000,,
com.apple.iphonesimulator,5,1721180039,1721180044,1721180044.0842419,-18000,,
com.apple.dt.Xcode,104,1721179935,1721180039,1721180039.900512,-18000,,
com.google.Chrome,3,1721179932,1721179935,1721179936.024013,-18000,,
com.apple.dt.Xcode,0,1721179932,1721179932,1721179932.901823,-18000,,
com.google.Chrome,2,1721179930,1721179932,1721179932.284574,-18000,,
com.apple.dt.Xcode,2,1721179928,1721179930,1721179930.224231,-18000,,
com.google.Chrome,5,1721179923,1721179928,1721179929.028157,-18000,,
com.apple.dt.Xcode,6,1721179917,1721179923,1721179923.9635339,-18000,,
com.google.Chrome,3,1721179914,1721179917,1721179917.818406,-18000,,
com.apple.dt.Xcode,2,1721179912,1721179914,1721179914.699706,-18000,,
com.google.Chrome,4,1721179908,1721179912,1721179912.4200091,-18000,,
com.apple.dt.Xcode,1,1721179907,1721179908,1721179908.631083,-18000,,
com.google.Chrome,2,1721179905,1721179907,1721179907.310852,-18000,,
com.apple.dt.Xcode,1,1721179904,1721179905,1721179905.794715,-18000,,
com.google.Chrome,1,1721179903,1721179904,1721179904.734868,-18000,,
com.apple.dt.Xcode,1,1721179902,1721179903,1721179903.17798,-18000,,
com.google.Chrome,6,1721179896,1721179902,1721179902.1664171,-18000,,
com.apple.dt.Xcode,8,1721179888,1721179896,1721179896.089402,-18000,,
com.google.Chrome,3,1721179885,1721179888,1721179888.192632,-18000,,
com.apple.dt.Xcode,2,1721179883,1721179885,1721179885.676972,-18000,,
com.google.Chrome,3,1721179880,1721179883,1721179883.2461572,-18000,,
com.apple.dt.Xcode,1,1721179879,1721179880,1721179880.499263,-18000,,
com.google.Chrome,3,1721179876,1721179879,1721179879.245681,-18000,,
com.apple.dt.Xcode,2,1721179874,1721179876,1721179876.497977,-18000,,
com.google.Chrome,2,1721179872,1721179874,1721179874.505938,-18000,,
com.apple.dt.Xcode,2,1721179870,1721179872,1721179872.277895,-18000,,
com.google.Chrome,3,1721179867,1721179870,1721179870.818972,-18000,,
com.google.Chrome,1,1721179864,1721179865,1721179865.384275,-18000,,
com.apple.dt.Xcode,2,1721179862,1721179864,1721179864.109531,-18000,,
com.google.Chrome,4,1721179858,1721179862,1721179862.9812021,-18000,,
com.apple.dt.Xcode,4,1721179854,1721179858,1721179858.316327,-18000,,
com.google.Chrome,1,1721179853,1721179854,1721179854.880919,-18000,,
com.apple.dt.Xcode,2,1721179851,1721179853,1721179853.8684192,-18000,,
com.google.Chrome,3,1721179848,1721179851,1721179851.7656379,-18000,,
com.apple.dt.Xcode,2,1721179846,1721179848,1721179848.865031,-18000,,
com.google.Chrome,2,1721179844,1721179846,1721179846.9694881,-18000,,
com.apple.dt.Xcode,1,1721179843,1721179844,1721179844.5703712,-18000,,
com.google.Chrome,1,1721179842,1721179843,1721179843.657809,-18000,,
com.apple.dt.Xcode,1,1721179841,1721179842,1721179842.191804,-18000,,
com.google.Chrome,2,1721179839,1721179841,1721179841.096895,-18000,,
com.apple.dt.Xcode,3,1721179836,1721179839,1721179839.443479,-18000,,
com.google.Chrome,2,1721179834,1721179836,1721179836.508321,-18000,,
com.apple.dt.Xcode,2,1721179832,1721179834,1721179834.204139,-18000,,
com.google.Chrome,1,1721179831,1721179832,1721179832.9451041,-18000,,
com.apple.dt.Xcode,2,1721179829,1721179831,1721179831.374168,-18000,,
com.google.Chrome,2,1721179827,1721179829,1721179829.28399,-18000,,
com.apple.dt.Xcode,1,1721179826,1721179827,1721179827.2917972,-18000,,
com.google.Chrome,2,1721179824,1721179826,1721179826.068056,-18000,,
com.apple.dt.Xcode,3,1721179821,1721179824,1721179824.642665,-18000,,
com.google.Chrome,1,1721179820,1721179821,1721179821.88416,-18000,,
com.apple.dt.Xcode,2,1721179818,1721179820,1721179820.2646952,-18000,,
com.google.Chrome,3,1721179815,1721179818,1721179818.230904,-18000,,
com.apple.dt.Xcode,2,1721179813,1721179815,1721179815.937577,-18000,,
com.google.Chrome,2,1721179811,1721179813,1721179813.783053,-18000,,
com.apple.dt.Xcode,1,1721179810,1721179811,1721179811.4420671,-18000,,
com.google.Chrome,2,1721179808,1721179810,1721179810.083349,-18000,,
com.apple.dt.Xcode,2,1721179806,1721179808,1721179808.825171,-18000,,
com.google.Chrome,2,1721179804,1721179806,1721179806.574727,-18000,,
com.apple.dt.Xcode,3,1721179801,1721179804,1721179804.906874,-18000,,
com.google.Chrome,2,1721179799,1721179801,1721179801.997967,-18000,,
com.apple.dt.Xcode,3,1721179796,1721179799,1721179799.786072,-18000,,
com.google.Chrome,3,1721179793,1721179796,1721179796.67348,-18000,,
com.apple.dt.Xcode,20,1721179773,1721179793,1721179793.553484,-18000,,
com.google.Chrome,1,1721179772,1721179773,1721179773.480648,-18000,,
com.apple.dt.Xcode,4,1721179768,1721179772,1721179772.810153,-18000,,
com.google.Chrome,2,1721179766,1721179768,1721179768.268266,-18000,,
com.apple.dt.Xcode,1,1721179765,1721179766,1721179766.690125,-18000,,
com.google.Chrome,5,1721179760,1721179765,1721179765.3917441,-18000,,
com.apple.dt.Xcode,3,1721179757,1721179760,1721179761.0092669,-18000,,
com.google.Chrome,6,1721179751,1721179757,1721179757.6846251,-18000,,
com.apple.dt.Xcode,4,1721179747,1721179751,1721179751.746087,-18000,,
com.google.Chrome,3,1721179744,1721179747,1721179747.301225,-18000,,
com.apple.dt.Xcode,2,1721179742,1721179744,1721179744.798612,-18000,,
com.google.Chrome,2,1721179740,1721179742,1721179742.189853,-18000,,
com.apple.dt.Xcode,1,1721179739,1721179740,1721179740.88162,-18000,,
com.google.Chrome,3,1721179736,1721179739,1721179739.467587,-18000,,
com.apple.dt.Xcode,9,1721179727,1721179736,1721179736.494987,-18000,,
com.google.Chrome,2,1721179725,1721179727,1721179727.104876,-18000,,
com.apple.dt.Xcode,2,1721179723,1721179725,1721179725.485344,-18000,,
com.google.Chrome,3,1721179720,1721179723,1721179723.185433,-18000,,
com.apple.dt.Xcode,3,1721179717,1721179720,1721179720.7366571,-18000,,
com.google.Chrome,2,1721179715,1721179717,1721179717.7143211,-18000,,
com.apple.dt.Xcode,4,1721179711,1721179715,1721179715.3275251,-18000,,
com.google.Chrome,3,1721179708,1721179711,1721179711.682407,-18000,,
com.apple.dt.Xcode,3,1721179705,1721179708,1721179708.692593,-18000,,
com.google.Chrome,1,1721179704,1721179705,1721179705.808753,-18000,,
com.apple.dt.Xcode,2,1721179702,1721179704,1721179704.064744,-18000,,
com.google.Chrome,2,1721179700,1721179702,1721179702.82097,-18000,,
com.apple.dt.Xcode,1,1721179699,1721179700,1721179700.3435621,-18000,,
com.google.Chrome,2,1721179697,1721179699,1721179699.2736468,-18000,,
com.apple.dt.Xcode,6,1721179691,1721179697,1721179697.541559,-18000,,
com.google.Chrome,4,1721179687,1721179691,1721179691.8903608,-18000,,
com.apple.dt.Xcode,1,1721179686,1721179687,1721179687.507438,-18000,,
com.google.Chrome,5,1721179681,1721179686,1721179686.3115358,-18000,,
com.apple.dt.Xcode,4,1721179677,1721179681,1721179681.8952022,-18000,,
com.google.Chrome,5,1721179672,1721179677,1721179677.689075,-18000,,
com.apple.dt.Xcode,2,1721179670,1721179672,1721179672.196003,-18000,,
com.google.Chrome,1,1721179669,1721179670,1721179670.621022,-18000,,
com.apple.dt.Xcode,3,1721179666,1721179669,1721179669.3066401,-18000,,
com.google.Chrome,2,1721179664,1721179666,1721179666.925091,-18000,,
com.apple.dt.Xcode,1,1721179663,1721179664,1721179664.823767,-18000,,
com.google.Chrome,4,1721179659,1721179663,1721179663.2154741,-18000,,
com.apple.dt.Xcode,6,1721179653,1721179659,1721179659.5007648,-18000,,
com.google.Chrome,2,1721179651,1721179653,1721179653.305254,-18000,,
com.apple.dt.Xcode,3,1721179648,1721179651,1721179651.831733,-18000,,
com.google.Chrome,7,1721179641,1721179648,1721179648.984891,-18000,,
com.apple.dt.Xcode,3,1721179638,1721179641,1721179641.182897,-18000,,
com.google.Chrome,3,1721179635,1721179638,1721179638.404474,-18000,,
com.apple.dt.Xcode,2,1721179633,1721179635,1721179635.076824,-18000,,
com.google.Chrome,3,1721179630,1721179633,1721179633.205934,-18000,,
com.apple.dt.Xcode,1,1721179629,1721179630,1721179630.6308289,-18000,,
com.google.Chrome,2,1721179627,1721179629,1721179629.309647,-18000,,
com.apple.dt.Xcode,3,1721179624,1721179627,1721179627.2383661,-18000,,
com.google.Chrome,1,1721179623,1721179624,1721179624.848491,-18000,,
com.apple.dt.Xcode,2,1721179621,1721179623,1721179623.5714312,-18000,,
com.google.Chrome,2,1721179619,1721179621,1721179621.4493608,-18000,,
com.apple.dt.Xcode,3,1721179616,1721179619,1721179619.9064531,-18000,,
com.google.Chrome,8,1721179608,1721179616,1721179616.8399959,-18000,,
com.apple.dt.Xcode,6,1721179602,1721179608,1721179608.184542,-18000,,
com.google.Chrome,2,1721179600,1721179602,1721179602.4895291,-18000,,
com.apple.dt.Xcode,2,1721179598,1721179600,1721179600.801062,-18000,,
com.google.Chrome,4,1721179594,1721179598,1721179598.3952441,-18000,,
com.apple.dt.Xcode,2,1721179592,1721179594,1721179594.0772018,-18000,,
com.google.Chrome,2,1721179590,1721179592,1721179592.426131,-18000,,
com.apple.dt.Xcode,2,1721179588,1721179590,1721179590.8453221,-18000,,
com.google.Chrome,3,1721179585,1721179588,1721179588.352501,-18000,,
com.apple.dt.Xcode,1,1721179584,1721179585,1721179586.01539,-18000,,
com.google.Chrome,5,1721179579,1721179584,1721179584.0840712,-18000,,
com.apple.dt.Xcode,9,1721179570,1721179579,1721179579.629978,-18000,,
com.google.Chrome,4,1721179566,1721179570,1721179570.206667,-18000,,
com.apple.dt.Xcode,2,1721179564,1721179566,1721179566.89356,-18000,,
com.google.Chrome,2,1721179562,1721179564,1721179564.435318,-18000,,
com.apple.dt.Xcode,4,1721179558,1721179562,1721179562.755659,-18000,,
com.google.Chrome,34,1721179524,1721179558,1721179558.183095,-18000,,
com.apple.dt.Xcode,25,1721179499,1721179524,1721179524.351299,-18000,,
com.google.Chrome,140,1721179359,1721179499,1721179499.3255339,-18000,,
com.apple.dt.Xcode,9,1721179350,1721179359,1721179359.199524,-18000,,
com.apple.iphonesimulator,3,1721179347,1721179350,1721179350.4982672,-18000,,
com.apple.dt.Xcode,16,1721179331,1721179347,1721179347.834354,-18000,,
com.google.Chrome,12,1721179319,1721179331,1721179331.893898,-18000,,
com.apple.dt.Xcode,2,1721179317,1721179319,1721179319.241077,-18000,,
com.google.Chrome,8,1721179309,1721179317,1721179317.495175,-18000,,
com.apple.dt.Xcode,6,1721179303,1721179309,1721179309.115838,-18000,,
com.apple.iphonesimulator,13,1721179290,1721179303,1721179303.38207,-18000,,
org.stellarium.Stellarium,14,1721179276,1721179290,1721179290.727068,-18000,,
com.apple.iphonesimulator,1,1721179275,1721179276,1721179276.4763432,-18000,,
org.stellarium.Stellarium,8,1721179267,1721179275,1721179275.835963,-18000,,
com.apple.iphonesimulator,7,1721179260,1721179267,1721179267.182462,-18000,,
com.apple.dt.Xcode,22,1721179238,1721179260,1721179260.5513859,-18000,,
com.google.Chrome,92,1721179146,1721179238,1721179238.061616,-18000,,
com.apple.dt.Xcode,12,1721179134,1721179146,1721179146.2692862,-18000,,
com.google.Chrome,58,1721179076,1721179134,1721179134.8774939,-18000,,
com.apple.dt.Xcode,9,1721179067,1721179076,1721179076.226053,-18000,,
com.google.Chrome,2,1721179065,1721179067,1721179067.1534119,-18000,,
com.apple.dt.Xcode,2,1721179063,1721179065,1721179065.3184419,-18000,,
com.google.Chrome,2,1721179061,1721179063,1721179063.389892,-18000,,
com.apple.dt.Xcode,2,1721179059,1721179061,1721179061.5727072,-18000,,
com.google.Chrome,2,1721179057,1721179059,1721179059.3049412,-18000,,
com.apple.dt.Xcode,2,1721179055,1721179057,1721179057.623714,-18000,,
com.google.Chrome,6,1721179049,1721179055,1721179055.682856,-18000,,
com.apple.dt.Xcode,4,1721179045,1721179049,1721179049.859219,-18000,,
com.google.Chrome,2,1721179043,1721179045,1721179045.867134,-18000,,
com.apple.dt.Xcode,4,1721179039,1721179043,1721179043.765102,-18000,,
com.google.Chrome,74,1721178965,1721179039,1721179039.874339,-18000,,
com.apple.dt.Xcode,3,1721178962,1721178965,1721178965.221674,-18000,,
com.google.Chrome,5,1721178957,1721178962,1721178962.2747478,-18000,,
com.apple.dt.Xcode,4,1721178953,1721178957,1721178957.1440902,-18000,,
com.google.Chrome,1,1721178952,1721178953,1721178953.4881182,-18000,,
com.apple.dt.Xcode,1,1721178951,1721178952,1721178952.695136,-18000,,
com.google.Chrome,5,1721178946,1721178951,1721178951.9031081,-18000,,
com.apple.dt.Xcode,3,1721178943,1721178946,1721178946.424574,-18000,,
com.google.Chrome,7,1721178936,1721178943,1721178943.692987,-18000,,
com.apple.dt.Xcode,16,1721178920,1721178936,1721178936.948334,-18000,,
com.google.Chrome,1,1721178919,1721178920,1721178920.731153,-18000,,
com.apple.dt.Xcode,0,1721178919,1721178919,1721178919.648573,-18000,,
com.google.Chrome,8,1721178911,1721178919,1721178919.1467109,-18000,,
com.apple.dt.Xcode,1,1721178910,1721178911,1721178911.513476,-18000,,
com.google.Chrome,3,1721178907,1721178910,1721178910.451453,-18000,,
com.apple.dt.Xcode,3,1721178904,1721178907,1721178907.400362,-18000,,
com.google.Chrome,5,1721178899,1721178904,1721178904.085054,-18000,,
com.apple.dt.Xcode,0,1721178899,1721178899,1721178899.761228,-18000,,
com.google.Chrome,5,1721178894,1721178899,1721178899.426787,-18000,,
com.apple.dt.Xcode,7,1721178887,1721178894,1721178894.4137669,-18000,,
com.google.Chrome,2,1721178885,1721178887,1721178887.198151,-18000,,
com.apple.dt.Xcode,2,1721178883,1721178885,1721178885.996183,-18000,,
com.google.Chrome,15,1721178868,1721178883,1721178883.181991,-18000,,
com.apple.dt.Xcode,4,1721178864,1721178868,1721178868.793913,-18000,,
com.google.Chrome,3,1721178861,1721178864,1721178864.622427,-18000,,
com.apple.dt.Xcode,2,1721178859,1721178861,1721178861.08143,-18000,,
com.google.Chrome,4,1721178855,1721178859,1721178859.258813,-18000,,
com.apple.dt.Xcode,2,1721178853,1721178855,1721178855.712081,-18000,,
com.google.Chrome,4,1721178849,1721178853,1721178853.35057,-18000,,
com.apple.dt.Xcode,4,1721178845,1721178849,1721178849.097104,-18000,,
com.google.Chrome,4,1721178841,1721178845,1721178845.4566522,-18000,,
com.apple.dt.Xcode,4,1721178837,1721178841,1721178841.8952742,-18000,,
com.google.Chrome,1,1721178836,1721178837,1721178837.540635,-18000,,
com.apple.dt.Xcode,2,1721178834,1721178836,1721178836.475657,-18000,,
com.google.Chrome,3,1721178831,1721178834,1721178834.251581,-18000,,
com.apple.dt.Xcode,5,1721178826,1721178831,1721178831.7421389,-18000,,
com.google.Chrome,5,1721178821,1721178826,1721178826.617622,-18000,,
com.apple.dt.Xcode,11,1721178810,1721178821,1721178821.570023,-18000,,
com.google.Chrome,1,1721178809,1721178810,1721178811.0086532,-18000,,
com.apple.dt.Xcode,2,1721178807,1721178809,1721178809.342404,-18000,,
com.google.Chrome,3,1721178804,1721178807,1721178807.417424,-18000,,
com.apple.dt.Xcode,2,1721178802,1721178804,1721178804.805433,-18000,,
com.google.Chrome,2,1721178800,1721178802,1721178802.6063452,-18000,,
com.apple.dt.Xcode,15,1721178785,1721178800,1721178800.674427,-18000,,
com.google.Chrome,6,1721178779,1721178785,1721178785.979844,-18000,,
com.apple.dt.Xcode,8,1721178771,1721178779,1721178779.7479,-18000,,
com.google.Chrome,38,1721178733,1721178771,1721178771.361721,-18000,,
com.apple.dt.Xcode,1,1721178732,1721178733,1721178733.617943,-18000,,
com.google.Chrome,3,1721178729,1721178732,1721178733.000449,-18000,,
com.apple.dt.Xcode,2,1721178727,1721178729,1721178729.1049662,-18000,,
com.google.Chrome,13,1721178714,1721178727,1721178727.5288758,-18000,,
com.apple.dt.Xcode,8,1721178706,1721178714,1721178715.0429258,-18000,,
com.apple.iphonesimulator,4,1721178702,1721178706,1721178706.6104941,-18000,,
com.apple.dt.Xcode,14,1721178688,1721178702,1721178702.573584,-18000,,
com.google.Chrome,3,1721178685,1721178688,1721178688.9190059,-18000,,
com.apple.dt.Xcode,11,1721178674,1721178685,1721178686.0181808,-18000,,
com.google.Chrome,3,1721178671,1721178674,1721178674.706946,-18000,,
com.apple.dt.Xcode,2,1721178669,1721178671,1721178671.059236,-18000,,
com.google.Chrome,15,1721178654,1721178669,1721178669.1161752,-18000,,
com.apple.dt.Xcode,16,1721178638,1721178654,1721178654.883,-18000,,
com.google.Chrome,31,1721178607,1721178638,1721178638.210434,-18000,,
com.apple.dt.Xcode,14,1721178593,1721178607,1721178607.1042042,-18000,,
com.google.Chrome,2,1721178591,1721178593,1721178593.132508,-18000,,
com.apple.dt.Xcode,1,1721178590,1721178591,1721178591.954434,-18000,,
com.google.Chrome,2,1721178588,1721178590,1721178590.423314,-18000,,
com.apple.dt.Xcode,4,1721178584,1721178588,1721178588.5762181,-18000,,
com.google.Chrome,3,1721178581,1721178584,1721178585.014286,-18000,,
com.apple.dt.Xcode,3,1721178578,1721178581,1721178581.1209931,-18000,,
com.google.Chrome,7,1721178571,1721178578,1721178578.4411922,-18000,,
com.apple.dt.Xcode,3,1721178568,1721178571,1721178571.223618,-18000,,
com.google.Chrome,7,1721178561,1721178568,1721178568.9830441,-18000,,
com.apple.dt.Xcode,4,1721178557,1721178561,1721178561.2872891,-18000,,
com.google.Chrome,10,1721178547,1721178557,1721178557.515578,-18000,,
com.apple.dt.Xcode,4,1721178543,1721178547,1721178548.0536861,-18000,,
com.google.Chrome,7,1721178536,1721178543,1721178543.9838572,-18000,,
com.apple.dt.Xcode,4,1721178532,1721178536,1721178536.171633,-18000,,
com.google.Chrome,10,1721178522,1721178532,1721178532.379581,-18000,,
com.apple.dt.Xcode,1,1721178521,1721178522,1721178522.6571531,-18000,,
com.google.Chrome,6,1721178515,1721178521,1721178521.374891,-18000,,
com.apple.dt.Xcode,41,1721178474,1721178515,1721178515.115063,-18000,,
com.apple.iphonesimulator,1,1721178473,1721178474,1721178475.0159159,-18000,,
com.apple.dt.Xcode,10,1721178463,1721178473,1721178473.763849,-18000,,
com.apple.iphonesimulator,6,1721178457,1721178463,1721178463.062655,-18000,,
com.apple.dt.Xcode,17,1721178440,1721178457,1721178457.782679,-18000,,
com.google.Chrome,3,1721178437,1721178440,1721178440.486628,-18000,,
com.apple.dt.Xcode,8,1721178429,1721178437,1721178437.452429,-18000,,
com.google.Chrome,7,1721178422,1721178429,1721178430.00633,-18000,,
com.apple.dt.Xcode,28,1721178394,1721178422,1721178422.796855,-18000,,
com.apple.iphonesimulator,6,1721178388,1721178394,1721178394.760745,-18000,,
com.apple.dt.Xcode,19,1721178369,1721178388,1721178388.193334,-18000,,
org.stellarium.Stellarium,2,1721178367,1721178369,1721178369.7787771,-18000,,
com.apple.iphonesimulator,1,1721178366,1721178367,1721178367.059805,-18000,,
com.apple.dt.Xcode,9,1721178357,1721178366,1721178366.344897,-18000,,
com.apple.iphonesimulator,2,1721178355,1721178357,1721178357.834106,-18000,,
org.stellarium.Stellarium,1,1721178354,1721178355,1721178355.9391441,-18000,,
com.apple.iphonesimulator,1,1721178353,1721178354,1721178354.46034,-18000,,
org.stellarium.Stellarium,2,1721178351,1721178353,1721178353.343028,-18000,,
com.apple.iphonesimulator,2,1721178349,1721178351,1721178351.072051,-18000,,
org.stellarium.Stellarium,1,1721178348,1721178349,1721178349.9617538,-18000,,
com.apple.iphonesimulator,5,1721178343,1721178348,1721178348.2250519,-18000,,
org.stellarium.Stellarium,16,1721178327,1721178343,1721178344.012203,-18000,,
com.apple.iphonesimulator,5,1721178322,1721178327,1721178327.176525,-18000,,
com.apple.dt.Xcode,7,1721178315,1721178322,1721178322.153995,-18000,,
com.apple.iphonesimulator,7,1721178308,1721178315,1721178315.4884028,-18000,,
org.stellarium.Stellarium,4,1721178304,1721178308,1721178308.192858,-18000,,
com.apple.iphonesimulator,3,1721178301,1721178304,1721178304.123307,-18000,,
org.stellarium.Stellarium,3,1721178298,1721178301,1721178301.29846,-18000,,
com.apple.iphonesimulator,6,1721178292,1721178298,1721178298.691567,-18000,,
com.apple.dt.Xcode,15,1721178277,1721178292,1721178292.364057,-18000,,
com.google.Chrome,29,1721178248,1721178277,1721178277.847183,-18000,,
com.apple.dt.Xcode,27,1721178221,1721178248,1721178248.466603,-18000,,
com.google.Chrome,149,1721178072,1721178221,1721178221.819314,-18000,,
com.apple.dt.Xcode,20,1721178052,1721178072,1721178072.6158519,-18000,,
org.stellarium.Stellarium,6,1721178046,1721178052,1721178052.307796,-18000,,
com.apple.dt.Xcode,0,1721178046,1721178046,1721178046.979183,-18000,,
com.apple.iphonesimulator,3,1721178043,1721178046,1721178046.1358562,-18000,,
com.apple.dt.Xcode,19,1721178024,1721178043,1721178043.767638,-18000,,
com.apple.iphonesimulator,9,1721178015,1721178024,1721178024.403436,-18000,,
org.stellarium.Stellarium,29,1721177986,1721178015,1721178015.790958,-18000,,
com.apple.iphonesimulator,12,1721177974,1721177986,1721177986.97358,-18000,,
org.stellarium.Stellarium,14,1721177960,1721177974,1721177974.259021,-18000,,
com.apple.iphonesimulator,15,1721177945,1721177960,1721177960.565912,-18000,,
org.stellarium.Stellarium,10,1721177935,1721177945,1721177945.902546,-18000,,
com.apple.iphonesimulator,5,1721177930,1721177935,1721177935.748982,-18000,,
org.stellarium.Stellarium,15,1721177915,1721177930,1721177930.7530131,-18000,,
com.apple.iphonesimulator,21,1721177894,1721177915,1721177915.8020701,-18000,,
org.stellarium.Stellarium,12,1721177882,1721177894,1721177894.103375,-18000,,
com.apple.iphonesimulator,20,1721177862,1721177882,1721177882.222456,-18000,,
com.apple.dt.Xcode,1,1721177859,1721177860,1721177860.04352,-18000,,
org.stellarium.Stellarium,20,1721177837,1721177857,1721177857.515695,-18000,,
com.apple.dt.Xcode,102,1721177735,1721177837,1721177837.84183,-18000,,
com.google.Chrome,35,1721177700,1721177735,1721177735.078669,-18000,,
com.apple.dt.Xcode,17,1721177683,1721177700,1721177700.809372,-18000,,
com.google.Chrome,54,1721177629,1721177683,1721177683.800343,-18000,,
com.google.Chrome,674,1721172601,1721173275,1721173276.190824,-18000,,
com.google.Chrome,501,1721171222,1721171723,1721171723.8813581,-18000,,
com.apple.finder,169,1721171053,1721171222,1721171222.523234,-18000,,
com.google.Chrome,109,1721170944,1721171053,1721171053.77103,-18000,,
com.google.Chrome,1794,1721163334,1721165128,1721165128.785253,-18000,,
com.google.Chrome,1360,1721161796,1721163156,1721163156.2748551,-18000,,
com.google.Chrome,684,1721159770,1721160454,1721160454.927233,-18000,,
com.apple.Notes,33,1721159737,1721159770,1721159770.3086572,-18000,,
com.google.Chrome,2,1721159735,1721159737,1721159737.4873838,-18000,,
com.apple.Notes,2,1721159733,1721159735,1721159735.883817,-18000,,
com.google.Chrome,339,1721159394,1721159733,1721159734.006566,-18000,,
com.apple.Notes,7,1721159387,1721159394,1721159394.218255,-18000,,
com.google.Chrome,184,1721159203,1721159387,1721159387.567431,-18000,,
com.apple.Notes,74,1721159129,1721159203,1721159203.890959,-18000,,
com.google.Chrome,104,1721159025,1721159129,1721159129.860877,-18000,,
com.apple.Notes,24,1721159001,1721159025,1721159025.965132,-18000,,
com.apple.Notes,300,1721154000,1721154300,1721154300.8620949,-18000,,
com.google.Chrome,7,1721153993,1721154000,1721154000.8353171,-18000,,
com.apple.Notes,21,1721153972,1721153993,1721153993.123685,-18000,,
com.google.Chrome,6,1721153966,1721153972,1721153972.591,-18000,,
com.apple.Notes,9,1721153957,1721153966,1721153966.311479,-18000,,
com.google.Chrome,1,1721153956,1721153957,1721153957.968508,-18000,,
com.apple.Notes,2,1721153954,1721153956,1721153957.014285,-18000,,
com.google.Chrome,1,1721153953,1721153954,1721153954.498005,-18000,,
com.apple.Notes,5,1721153948,1721153953,1721153953.053389,-18000,,
com.google.Chrome,1,1721153947,1721153948,1721153948.045382,-18000,,
com.apple.Notes,4,1721153943,1721153947,1721153947.12392,-18000,,
com.google.Chrome,2,1721153941,1721153943,1721153943.472869,-18000,,
com.apple.Notes,6,1721153935,1721153941,1721153941.998702,-18000,,
com.google.Chrome,121,1721153814,1721153935,1721153935.413396,-18000,,
com.apple.Notes,73,1721153741,1721153814,1721153814.537463,-18000,,
com.google.Chrome,586,1721153155,1721153741,1721153741.848239,-18000,,
com.apple.Notes,1,1721153154,1721153155,1721153156.0224051,-18000,,
com.google.Chrome,83,1721153071,1721153154,1721153154.517867,-18000,,
com.apple.Notes,195,1721152876,1721153071,1721153071.993084,-18000,,
com.google.Chrome,10,1721152866,1721152876,1721152876.610835,-18000,,
com.apple.Notes,57,1721152789,1721152846,1721152846.3959699,-18000,,
com.google.Chrome,407,1721152382,1721152789,1721152789.6537352,-18000,,
com.google.Chrome,1479,1721150902,1721152381,1721152381.004483,-18000,,
com.apple.Notes,10,1721150764,1721150774,1721150774.805457,-18000,,
com.google.Chrome,30,1721150734,1721150764,1721150764.680956,-18000,,
com.google.Chrome,235,1721145894,1721146129,1721146129.237165,-18000,,
com.microsoft.Outlook,25,1721145869,1721145894,1721145894.704444,-18000,,
com.google.Chrome,27,1721145842,1721145869,1721145869.213974,-18000,,
com.google.Chrome,251,1721101754,1721102005,1721102005.405962,-18000,,
com.google.Chrome,672,1721101045,1721101717,1721101717.58246,-18000,,
com.google.Chrome,343,1721100519,1721100862,1721100862.3190532,-18000,,
com.google.Chrome,913,1721099495,1721100408,1721100409.0127559,-18000,,
com.google.Chrome,300,1721099064,1721099364,1721099364.694181,-18000,,
com.google.Chrome,1113,1721097287,1721098400,1721098400.313539,-18000,,
com.apple.MobileSMS,8,1721097279,1721097287,1721097287.117134,-18000,,
com.google.Chrome,3,1721097276,1721097279,1721097279.1737719,-18000,,
com.google.Chrome,675,1721091293,1721091968,1721091968.328062,-18000,,
com.apple.finder,4,1721091289,1721091293,1721091293.5948582,-18000,,
com.apple.finder,1,1721083532,1721083533,1721083533.683679,-18000,,
com.apple.iCal,4,1721083528,1721083532,1721083532.531241,-18000,,
com.google.Chrome,5,1721083523,1721083528,1721083528.1463408,-18000,,
com.apple.MobileSMS,1,1721083522,1721083523,1721083524.014653,-18000,,
com.google.Chrome,391,1721083131,1721083522,1721083522.6254768,-18000,,
com.google.Chrome,1102,1721082023,1721083125,1721083125.8962479,-18000,,
com.apple.MobileSMS,1,1721082022,1721082023,1721082023.277388,-18000,,
com.google.Chrome,5,1721082017,1721082022,1721082022.40539,-18000,,
com.apple.MobileSMS,10,1721082007,1721082017,1721082017.276441,-18000,,
com.google.Chrome,79,1721081928,1721082007,1721082007.601915,-18000,,
com.apple.MobileSMS,4,1721081924,1721081928,1721081928.120494,-18000,,
com.google.Chrome,2,1721081922,1721081924,1721081924.499105,-18000,,
com.apple.MobileSMS,27,1721081895,1721081922,1721081922.575669,-18000,,
com.google.Chrome,127,1721081768,1721081895,1721081895.971177,-18000,,
com.apple.MobileSMS,116,1721081652,1721081768,1721081768.1175299,-18000,,
com.google.Chrome,1,1721081651,1721081652,1721081652.8277678,-18000,,
com.apple.Preview,1,1721081650,1721081651,1721081651.7706661,-18000,,
com.apple.iCal,10,1721081640,1721081650,1721081650.511646,-18000,,
com.apple.Preview,1,1721081639,1721081640,1721081640.761482,-18000,,
com.google.Chrome,1,1721081638,1721081639,1721081639.9826,-18000,,
com.apple.MobileSMS,6,1721081632,1721081638,1721081638.054967,-18000,,
com.apple.Preview,7,1721081625,1721081632,1721081632.166596,-18000,,
com.apple.MobileSMS,26,1721081599,1721081625,1721081625.563699,-18000,,
com.apple.Preview,3,1721081596,1721081599,1721081599.0688019,-18000,,
com.apple.MobileSMS,39,1721081557,1721081596,1721081597.00628,-18000,,
com.apple.Preview,15,1721081542,1721081557,1721081557.2260752,-18000,,
com.google.Chrome,6,1721081536,1721081542,1721081542.450896,-18000,,
com.apple.MobileSMS,8,1721081528,1721081536,1721081536.300117,-18000,,
com.google.Chrome,68,1721081460,1721081528,1721081528.148669,-18000,,
com.apple.iCal,4,1721081456,1721081460,1721081460.6155062,-18000,,
com.apple.MobileSMS,3,1721081453,1721081456,1721081456.702326,-18000,,
com.apple.iCal,10,1721081443,1721081453,1721081453.056244,-18000,,
com.apple.MobileSMS,30,1721081413,1721081443,1721081443.692494,-18000,,
com.apple.iCal,26,1721081387,1721081413,1721081413.5653949,-18000,,
com.apple.MobileSMS,147,1721081240,1721081387,1721081387.910033,-18000,,
com.google.Chrome,4,1721081236,1721081240,1721081240.047451,-18000,,
com.apple.MobileSMS,9,1721081227,1721081236,1721081236.027504,-18000,,
com.google.Chrome,7,1721081220,1721081227,1721081227.1710958,-18000,,
com.apple.MobileSMS,37,1721081183,1721081220,1721081220.541249,-18000,,
com.google.Chrome,330,1721080853,1721081183,1721081183.990068,-18000,,
com.apple.Preview,19,1721080834,1721080853,1721080853.84953,-18000,,
com.apple.finder,5,1721080829,1721080834,1721080835.01699,-18000,,
com.google.Chrome,55,1721080774,1721080829,1721080829.720453,-18000,,
com.apple.finder,64,1721080710,1721080774,1721080774.429113,-18000,,
com.google.Chrome,333,1721080377,1721080710,1721080710.965148,-18000,,
com.apple.finder,145,1721080232,1721080377,1721080377.447764,-18000,,
com.apple.iCal,192,1721080040,1721080232,1721080232.8392448,-18000,,
com.google.Chrome,11,1721080029,1721080040,1721080040.426945,-18000,,
com.google.Chrome,715,1721078938,1721079653,1721079653.7693992,-18000,,
com.google.Chrome,415,1721077646,1721078061,1721078061.7178478,-18000,,
com.google.Chrome,5552,1721067347,1721072899,1721072900.8502731,-18000,,
com.muscleforlife.Stacked,9,1721052297,1721052306,1721052306.0579,-18000,EB445137-D7F5-57EC-87DA-1DB460D64046,"iPhone13,2"
com.muscleforlife.Stacked,7,1721052200,1721052207,1721052207.022965,-18000,EB445137-D7F5-57EC-87DA-1DB460D64046,"iPhone13,2"
com.muscleforlife.Stacked,17,1721052180,1721052197,1721052198.002985,-18000,EB445137-D7F5-57EC-87DA-1DB460D64046,"iPhone13,2"
com.muscleforlife.Stacked,34,1721052088,1721052122,1721052122.9979339,-18000,EB445137-D7F5-57EC-87DA-1DB460D64046,"iPhone13,2"
com.muscleforlife.Stacked,22,1721052006,1721052028,1721052028.809964,-18000,EB445137-D7F5-57EC-87DA-1DB460D64046,"iPhone13,2"
com.muscleforlife.Stacked,26,1721051924,1721051950,1721051950.785501,-18000,EB445137-D7F5-57EC-87DA-1DB460D64046,"iPhone13,2"
com.apple.MobileSMS,20,1721051902,1721051922,1721051922.976577,-18000,EB445137-D7F5-57EC-87DA-1DB460D64046,"iPhone13,2"
com.muscleforlife.Stacked,64,1721051838,1721051902,1721051902.526252,-18000,EB445137-D7F5-57EC-87DA-1DB460D64046,"iPhone13,2"
com.muscleforlife.Stacked,2,1721051756,1721051758,1721051758.472223,-18000,EB445137-D7F5-57EC-87DA-1DB460D64046,"iPhone13,2"
com.muscleforlife.Stacked,13,1721051671,1721051684,1721051684.7623348,-18000,EB445137-D7F5-57EC-87DA-1DB460D64046,"iPhone13,2"
com.muscleforlife.Stacked,54,1721051540,1721051594,1721051594.997884,-18000,EB445137-D7F5-57EC-87DA-1DB460D64046,"iPhone13,2"
com.muscleforlife.Stacked,5,1721051491,1721051496,1721051496.158571,-18000,EB445137-D7F5-57EC-87DA-1DB460D64046,"iPhone13,2"
com.muscleforlife.Stacked,116,1721051341,1721051457,1721051457.90302,-18000,EB445137-D7F5-57EC-87DA-1DB460D64046,"iPhone13,2"
com.muscleforlife.Stacked,7,1721051107,1721051114,1721051114.12681,-18000,EB445137-D7F5-57EC-87DA-1DB460D64046,"iPhone13,2"
com.muscleforlife.Stacked,12,1721051043,1721051055,1721051055.412692,-18000,EB445137-D7F5-57EC-87DA-1DB460D64046,"iPhone13,2"
com.apple.weather,2,1721051040,1721051042,1721051042.7447062,-18000,EB445137-D7F5-57EC-87DA-1DB460D64046,"iPhone13,2"
com.apple.weather,3,1721050921,1721050924,1721050924.824286,-18000,EB445137-D7F5-57EC-87DA-1DB460D64046,"iPhone13,2"
com.apple.weather,3,1721050715,1721050718,1721050718.037576,-18000,EB445137-D7F5-57EC-87DA-1DB460D64046,"iPhone13,2"
com.apple.weather,4,1721050255,1721050259,1721050259.4025269,-18000,EB445137-D7F5-57EC-87DA-1DB460D64046,"iPhone13,2"
com.apple.Maps,706,1721050238,1721050944,1721050944.786833,-18000,EB445137-D7F5-57EC-87DA-1DB460D64046,"iPhone13,2"
com.apple.weather,7,1721050141,1721050148,1721050148.261911,-18000,EB445137-D7F5-57EC-87DA-1DB460D64046,"iPhone13,2"
com.apple.MobileSMS,6,1721050087,1721050093,1721050094.134722,-18000,EB445137-D7F5-57EC-87DA-1DB460D64046,"iPhone13,2"
com.apple.findmy,10,1721050077,1721050087,1721050087.916185,-18000,EB445137-D7F5-57EC-87DA-1DB460D64046,"iPhone13,2"
com.apple.camera,1,1721049917,1721049918,1721049918.088439,-18000,EB445137-D7F5-57EC-87DA-1DB460D64046,"iPhone13,2"
com.apple.findmy,2,1721049916,1721049918,1721049918.059413,-18000,EB445137-D7F5-57EC-87DA-1DB460D64046,"iPhone13,2"
com.apple.findmy,31,1721049860,1721049891,1721049891.801031,-18000,EB445137-D7F5-57EC-87DA-1DB460D64046,"iPhone13,2"
com.apple.news,76,1721049402,1721049478,1721049478.792655,-18000,EB445137-D7F5-57EC-87DA-1DB460D64046,"iPhone13,2"
com.apple.news,18,1721049384,1721049402,1721049402.371952,-18000,EB445137-D7F5-57EC-87DA-1DB460D64046,"iPhone13,2"
com.apple.weather,5,1721049353,1721049358,1721049358.8775191,-18000,EB445137-D7F5-57EC-87DA-1DB460D64046,"iPhone13,2"
com.truebill.truebillnative,2,1721049340,1721049342,1721049342.3017058,-18000,EB445137-D7F5-57EC-87DA-1DB460D64046,"iPhone13,2"
com.apple.Health,12,1721019596,1721019608,1721019608.84653,-18000,EB445137-D7F5-57EC-87DA-1DB460D64046,"iPhone13,2"
com.google.chrome.ios,2,1721019594,1721019596,1721019597.232135,-18000,EB445137-D7F5-57EC-87DA-1DB460D64046,"iPhone13,2"
com.apple.Health,54,1721019540,1721019594,1721019594.719362,-18000,EB445137-D7F5-57EC-87DA-1DB460D64046,"iPhone13,2"
com.apple.mobiletimer,8,1721019532,1721019540,1721019540.4217072,-18000,EB445137-D7F5-57EC-87DA-1DB460D64046,"iPhone13,2"
com.apple.mobiletimer,1,1721019531,1721019532,1721019532.2114239,-18000,EB445137-D7F5-57EC-87DA-1DB460D64046,"iPhone13,2"
com.apple.mobiletimer,13,1721019499,1721019512,1721019512.457854,-18000,EB445137-D7F5-57EC-87DA-1DB460D64046,"iPhone13,2"
com.apple.mobiletimer,2,1721019493,1721019495,1721019495.93161,-18000,EB445137-D7F5-57EC-87DA-1DB460D64046,"iPhone13,2"
com.apple.mobiletimer,9,1721019484,1721019493,1721019493.282642,-18000,EB445137-D7F5-57EC-87DA-1DB460D64046,"iPhone13,2"
com.google.chrome.ios,62,1721019412,1721019474,1721019474.641573,-18000,EB445137-D7F5-57EC-87DA-1DB460D64046,"iPhone13,2"
com.goodreads.Goodreads,13,1721019399,1721019412,1721019412.6598902,-18000,EB445137-D7F5-57EC-87DA-1DB460D64046,"iPhone13,2"
com.thestorygraph.thestorygraph,183,1721019216,1721019399,1721019399.2855139,-18000,EB445137-D7F5-57EC-87DA-1DB460D64046,"iPhone13,2"
com.apple.weather,6,1721019209,1721019215,1721019216.005254,-18000,EB445137-D7F5-57EC-87DA-1DB460D64046,"iPhone13,2"
com.apple.weather,11,1721019143,1721019154,1721019154.7388291,-18000,EB445137-D7F5-57EC-87DA-1DB460D64046,"iPhone13,2"
com.apple.weather,13,1721015716,1721015729,1721015729.341693,-18000,EB445137-D7F5-57EC-87DA-1DB460D64046,"iPhone13,2"
com.apple.weather,8,1721015706,1721015714,1721015714.294948,-18000,EB445137-D7F5-57EC-87DA-1DB460D64046,"iPhone13,2"
com.google.Chrome,10,1721015372,1721015382,1721015382.34052,-18000,,
com.google.Chrome,551,1721014730,1721015281,1721015281.3287358,-18000,,
com.google.Chrome,648,1721013983,1721014631,1721014631.324656,-18000,,
com.apple.finder,2,1721013981,1721013983,1721013983.55253,-18000,,
com.apple.dt.Xcode,74,1721013907,1721013981,1721013982.029858,-18000,,
com.google.Chrome,8,1721013899,1721013907,1721013907.1165118,-18000,,
com.apple.iCal,60,1721013839,1721013899,1721013899.096264,-18000,,
com.apple.weather,18,1721013809,1721013827,1721013827.564359,-18000,EB445137-D7F5-57EC-87DA-1DB460D64046,"iPhone13,2"
com.apple.Health,5,1721013799,1721013804,1721013804.929064,-18000,EB445137-D7F5-57EC-87DA-1DB460D64046,"iPhone13,2"
com.apple.MobileSMS,45,1721013028,1721013073,1721013073.7587729,-18000,EB445137-D7F5-57EC-87DA-1DB460D64046,"iPhone13,2"
com.hammerandchisel.discord,5,1721013016,1721013021,1721013021.832601,-18000,EB445137-D7F5-57EC-87DA-1DB460D64046,"iPhone13,2"
com.apple.weather,7,1721012309,1721012316,1721012316.4877958,-18000,EB445137-D7F5-57EC-87DA-1DB460D64046,"iPhone13,2"
com.hammerandchisel.discord,7,1721012302,1721012309,1721012309.177026,-18000,EB445137-D7F5-57EC-87DA-1DB460D64046,"iPhone13,2"
com.hammerandchisel.discord,3,1721012299,1721012302,1721012302.689028,-18000,EB445137-D7F5-57EC-87DA-1DB460D64046,"iPhone13,2"
com.hammerandchisel.discord,11,1721012273,1721012284,1721012284.452666,-18000,EB445137-D7F5-57EC-87DA-1DB460D64046,"iPhone13,2"
com.apple.news,8,1721012265,1721012273,1721012273.689733,-18000,EB445137-D7F5-57EC-87DA-1DB460D64046,"iPhone13,2"
com.apple.news,11,1721011120,1721011131,1721011131.616452,-18000,EB445137-D7F5-57EC-87DA-1DB460D64046,"iPhone13,2"
com.apple.news,3,1721010670,1721010673,1721010673.791332,-18000,EB445137-D7F5-57EC-87DA-1DB460D64046,"iPhone13,2"
com.apple.news,215,1721010446,1721010661,1721010661.405735,-18000,EB445137-D7F5-57EC-87DA-1DB460D64046,"iPhone13,2"
com.apple.weather,11,1721010435,1721010446,1721010447.12217,-18000,EB445137-D7F5-57EC-87DA-1DB460D64046,"iPhone13,2"
com.apple.news,35,1721010399,1721010434,1721010434.638638,-18000,EB445137-D7F5-57EC-87DA-1DB460D64046,"iPhone13,2"
com.apple.iCal,521,1721010143,1721010664,1721010664.205841,-18000,,
com.apple.MobileSMS,266,1721010121,1721010387,1721010387.707098,-18000,EB445137-D7F5-57EC-87DA-1DB460D64046,"iPhone13,2"
com.apple.weather,11,1721010105,1721010116,1721010116.496234,-18000,EB445137-D7F5-57EC-87DA-1DB460D64046,"iPhone13,2"
com.google.Chrome,74,1721010069,1721010143,1721010143.9437718,-18000,,
com.apple.iphonesimulator,1,1721010068,1721010069,1721010069.626797,-18000,,
com.apple.dt.Xcode,99,1721009969,1721010068,1721010068.657442,-18000,,
com.apple.iphonesimulator,1,1721009968,1721009969,1721009969.440217,-18000,,
com.google.Chrome,79,1721009889,1721009968,1721009968.6092582,-18000,,
com.apple.iphonesimulator,2,1721009887,1721009889,1721009889.199729,-18000,,
com.apple.dt.Xcode,13,1721009874,1721009887,1721009887.6346931,-18000,,
com.apple.iphonesimulator,2,1721009872,1721009874,1721009874.1329641,-18000,,
org.stellarium.Stellarium,1,1721009871,1721009872,1721009872.693474,-18000,,
com.apple.iphonesimulator,5,1721009866,1721009871,1721009871.719713,-18000,,
org.stellarium.Stellarium,4,1721009862,1721009866,1721009866.515078,-18000,,
com.apple.iphonesimulator,1,1721009861,1721009862,1721009862.761275,-18000,,
org.stellarium.Stellarium,16,1721009845,1721009861,1721009861.497272,-18000,,
com.apple.iphonesimulator,12,1721009833,1721009845,1721009845.7839332,-18000,,
com.apple.dt.Xcode,120,1721009713,1721009833,1721009833.86991,-18000,,
com.google.Chrome,5,1721009708,1721009713,1721009713.520402,-18000,,
com.apple.dt.Xcode,5,1721009703,1721009708,1721009708.437712,-18000,,
com.google.Chrome,1,1721009702,1721009703,1721009703.267204,-18000,,
com.apple.dt.Xcode,1,1721009701,1721009702,1721009702.8381371,-18000,,
com.apple.iphonesimulator,1,1721009700,1721009701,1721009701.819175,-18000,,
org.stellarium.Stellarium,2,1721009698,1721009700,1721009700.5489821,-18000,,
com.google.Chrome,122,1721009576,1721009698,1721009698.5275168,-18000,,
org.stellarium.Stellarium,3,1721009573,1721009576,1721009576.540166,-18000,,
com.apple.iphonesimulator,1,1721009572,1721009573,1721009573.6651359,-18000,,
com.apple.dt.Xcode,107,1721009465,1721009572,1721009572.184575,-18000,,
com.apple.iphonesimulator,3,1721009462,1721009465,1721009465.9869242,-18000,,
org.stellarium.Stellarium,5,1721009457,1721009462,1721009462.3576121,-18000,,
com.apple.iphonesimulator,2,1721009455,1721009457,1721009457.524808,-18000,,
org.stellarium.Stellarium,4,1721009451,1721009455,1721009455.9480572,-18000,,
com.apple.iphonesimulator,9,1721009442,1721009451,1721009451.828278,-18000,,
com.apple.dt.Xcode,16,1721009426,1721009442,1721009442.741677,-18000,,
com.google.Chrome,7,1721009419,1721009426,1721009426.291098,-18000,,
com.apple.dt.Xcode,5,1721009414,1721009419,1721009419.4139009,-18000,,
com.google.Chrome,13,1721009401,1721009414,1721009414.2291322,-18000,,
com.apple.dt.Xcode,4,1721009397,1721009401,1721009402.016741,-18000,,
com.google.Chrome,2,1721009395,1721009397,1721009397.241953,-18000,,
com.apple.dt.Xcode,8,1721009387,1721009395,1721009395.70277,-18000,,
com.google.Chrome,4,1721009383,1721009387,1721009387.6954389,-18000,,
com.apple.dt.Xcode,2,1721009381,1721009383,1721009383.781139,-18000,,
com.google.Chrome,1,1721009380,1721009381,1721009381.6175041,-18000,,
com.apple.dt.Xcode,4,1721009376,1721009380,1721009380.179074,-18000,,
com.google.Chrome,4,1721009372,1721009376,1721009376.530696,-18000,,
com.apple.dt.Xcode,2,1721009370,1721009372,1721009372.6106,-18000,,
com.google.Chrome,1,1721009369,1721009370,1721009371.0297909,-18000,,
com.apple.dt.Xcode,4,1721009365,1721009369,1721009369.0683122,-18000,,
com.google.Chrome,1,1721009364,1721009365,1721009365.964587,-18000,,
com.apple.dt.Xcode,1,1721009363,1721009364,1721009364.77381,-18000,,
com.google.Chrome,2,1721009361,1721009363,1721009363.675332,-18000,,
com.apple.dt.Xcode,2,1721009359,1721009361,1721009361.700903,-18000,,
com.google.Chrome,1,1721009358,1721009359,1721009359.553118,-18000,,
com.apple.dt.Xcode,2,1721009356,1721009358,1721009358.559258,-18000,,
com.google.Chrome,4,1721009352,1721009356,1721009356.4155731,-18000,,
com.apple.dt.Xcode,6,1721009346,1721009352,1721009352.966603,-18000,,
com.google.Chrome,13,1721009333,1721009346,1721009346.344924,-18000,,
com.apple.dt.Xcode,18,1721009315,1721009333,1721009333.708647,-18000,,
com.google.Chrome,6,1721009309,1721009315,1721009315.620033,-18000,,
com.apple.dt.Xcode,4,1721009305,1721009309,1721009309.6803079,-18000,,
com.google.Chrome,10,1721009295,1721009305,1721009305.261465,-18000,,
com.apple.dt.Xcode,10,1721009285,1721009295,1721009295.969826,-18000,,
com.google.Chrome,4,1721009281,1721009285,1721009286.0373611,-18000,,
com.apple.dt.Xcode,1,1721009280,1721009281,1721009281.393013,-18000,,
com.google.Chrome,8,1721009272,1721009280,1721009280.44305,-18000,,
com.apple.dt.Xcode,10,1721009262,1721009272,1721009272.5052528,-18000,,
com.google.Chrome,8,1721009254,1721009262,1721009262.444015,-18000,,
com.apple.dt.Xcode,7,1721009247,1721009254,1721009254.217896,-18000,,
com.google.Chrome,17,1721009230,1721009247,1721009247.07692,-18000,,
com.apple.dt.Xcode,7,1721009223,1721009230,1721009230.1011782,-18000,,
com.google.Chrome,3,1721009220,1721009223,1721009223.550013,-18000,,
com.apple.dt.Xcode,1,1721009219,1721009220,1721009220.884853,-18000,,
com.google.Chrome,1,1721009218,1721009219,1721009219.704303,-18000,,
com.apple.dt.Xcode,1,1721009217,1721009218,1721009218.914462,-18000,,
com.google.Chrome,4,1721009213,1721009217,1721009217.1654801,-18000,,
com.apple.dt.Xcode,3,1721009210,1721009213,1721009213.241091,-18000,,
com.google.Chrome,7,1721009203,1721009210,1721009210.587459,-18000,,
com.apple.dt.Xcode,12,1721009191,1721009203,1721009204.0252929,-18000,,
com.google.Chrome,14,1721009177,1721009191,1721009191.1562119,-18000,,
com.apple.dt.Xcode,3,1721009174,1721009177,1721009177.789013,-18000,,
com.google.Chrome,28,1721009146,1721009174,1721009174.096912,-18000,,
com.apple.dt.Xcode,4,1721009142,1721009146,1721009146.517241,-18000,,
com.google.Chrome,10,1721009132,1721009142,1721009142.39446,-18000,,
com.apple.dt.Xcode,24,1721009108,1721009132,1721009132.8096352,-18000,,
com.apple.iphonesimulator,6,1721009102,1721009108,1721009108.64377,-18000,,
org.stellarium.Stellarium,1,1721009101,1721009102,1721009102.697983,-18000,,
com.apple.iphonesimulator,3,1721009098,1721009101,1721009101.038238,-18000,,
org.stellarium.Stellarium,4,1721009094,1721009098,1721009098.687016,-18000,,
com.apple.iphonesimulator,4,1721009090,1721009094,1721009094.467949,-18000,,
org.stellarium.Stellarium,16,1721009074,1721009090,1721009091.0229878,-18000,,
com.apple.iphonesimulator,10,1721009064,1721009074,1721009074.2086902,-18000,,
com.apple.dt.Xcode,25,1721009039,1721009064,1721009064.67481,-18000,,
com.google.Chrome,132,1721008907,1721009039,1721009040.016417,-18000,,
com.apple.dt.Xcode,2,1721008905,1721008907,1721008907.539355,-18000,,
com.google.Chrome,77,1721008828,1721008905,1721008905.622365,-18000,,
com.apple.dt.Xcode,2,1721008826,1721008828,1721008828.547285,-18000,,
com.google.Chrome,17,1721008809,1721008826,1721008826.669345,-18000,,
com.apple.dt.Xcode,1,1721008808,1721008809,1721008809.5543509,-18000,,
com.google.Chrome,27,1721008781,1721008808,1721008808.178556,-18000,,
com.apple.dt.Xcode,2,1721008779,1721008781,1721008781.054922,-18000,,
com.google.Chrome,4,1721008775,1721008779,1721008779.578654,-18000,,
com.apple.dt.Xcode,3,1721008772,1721008775,1721008776.029103,-18000,,
com.google.Chrome,1,1721008771,1721008772,1721008772.525027,-18000,,
com.apple.dt.Xcode,2,1721008769,1721008771,1721008771.303924,-18000,,
com.google.Chrome,2,1721008767,1721008769,1721008769.658921,-18000,,
com.apple.dt.Xcode,2,1721008765,1721008767,1721008767.513977,-18000,,
com.google.Chrome,12,1721008753,1721008765,1721008765.2153292,-18000,,
com.apple.dt.Xcode,45,1721008708,1721008753,1721008753.639295,-18000,,
com.google.Chrome,7,1721008701,1721008708,1721008708.261677,-18000,,
com.google.Chrome,563,1721007454,1721008017,1721008017.368098,-18000,,
com.apple.dt.Xcode,7,1721007447,1721007454,1721007454.876741,-18000,,
com.myfitnesspal.mfp,160,1721003334,1721003494,1721003494.6301498,-18000,EB445137-D7F5-57EC-87DA-1DB460D64046,"iPhone13,2"
com.apple.weather,4,1721003329,1721003333,1721003333.632722,-18000,EB445137-D7F5-57EC-87DA-1DB460D64046,"iPhone13,2"
com.apple.weather,2,1721001721,1721001723,1721001723.755976,-18000,EB445137-D7F5-57EC-87DA-1DB460D64046,"iPhone13,2"
com.apple.weather,6,1721001364,1721001370,1721001370.4755878,-18000,EB445137-D7F5-57EC-87DA-1DB460D64046,"iPhone13,2"
com.apple.weather,8,1721001355,1721001363,1721001363.928712,-18000,EB445137-D7F5-57EC-87DA-1DB460D64046,"iPhone13,2"
com.thestorygraph.thestorygraph,32,1721000935,1721000967,1721000967.626587,-18000,EB445137-D7F5-57EC-87DA-1DB460D64046,"iPhone13,2"
com.apple.Maps,4,1721000927,1721000931,1721000931.071725,-18000,EB445137-D7F5-57EC-87DA-1DB460D64046,"iPhone13,2"
com.apple.Maps,1,1721000871,1721000872,1721000872.852583,-18000,EB445137-D7F5-57EC-87DA-1DB460D64046,"iPhone13,2"
com.apple.Maps,4,1721000790,1721000794,1721000794.596249,-18000,EB445137-D7F5-57EC-87DA-1DB460D64046,"iPhone13,2"
com.apple.Maps,14,1721000475,1721000489,1721000489.287705,-18000,EB445137-D7F5-57EC-87DA-1DB460D64046,"iPhone13,2"
com.apple.Maps,3,1721000446,1721000449,1721000449.9230552,-18000,EB445137-D7F5-57EC-87DA-1DB460D64046,"iPhone13,2"
com.apple.Maps,3,1721000431,1721000434,1721000434.795177,-18000,EB445137-D7F5-57EC-87DA-1DB460D64046,"iPhone13,2"
com.apple.Maps,3,1721000316,1721000319,1721000319.826993,-18000,EB445137-D7F5-57EC-87DA-1DB460D64046,"iPhone13,2"
com.apple.Maps,2,1721000277,1721000279,1721000279.752512,-18000,EB445137-D7F5-57EC-87DA-1DB460D64046,"iPhone13,2"
com.apple.Maps,20,1720999999,1721000019,1721000019.5401711,-18000,EB445137-D7F5-57EC-87DA-1DB460D64046,"iPhone13,2"
com.apple.MobileSMS,3,1720999825,1720999828,1720999828.025487,-18000,EB445137-D7F5-57EC-87DA-1DB460D64046,"iPhone13,2"
com.apple.MobileSMS,5,1720999738,1720999743,1720999743.485262,-18000,EB445137-D7F5-57EC-87DA-1DB460D64046,"iPhone13,2"
com.hammerandchisel.discord,11,1720999250,1720999261,1720999261.395588,-18000,EB445137-D7F5-57EC-87DA-1DB460D64046,"iPhone13,2"
com.toyopagroup.picaboo,98,1720999151,1720999249,1720999249.630378,-18000,EB445137-D7F5-57EC-87DA-1DB460D64046,"iPhone13,2"
com.toyopagroup.picaboo,6,1720998878,1720998884,1720998884.619011,-18000,EB445137-D7F5-57EC-87DA-1DB460D64046,"iPhone13,2"
com.toyopagroup.picaboo,77,1720998800,1720998877,1720998877.175914,-18000,EB445137-D7F5-57EC-87DA-1DB460D64046,"iPhone13,2"
com.toyopagroup.picaboo,27,1720998282,1720998309,1720998309.203371,-18000,EB445137-D7F5-57EC-87DA-1DB460D64046,"iPhone13,2"
com.toyopagroup.picaboo,30,1720998198,1720998228,1720998228.440092,-18000,EB445137-D7F5-57EC-87DA-1DB460D64046,"iPhone13,2"
com.apple.calculator,5,1720998193,1720998198,1720998198.0858278,-18000,EB445137-D7F5-57EC-87DA-1DB460D64046,"iPhone13,2"
com.apple.calculator,6,1720998158,1720998164,1720998164.088385,-18000,EB445137-D7F5-57EC-87DA-1DB460D64046,"iPhone13,2"
com.apple.calculator,6,1720997704,1720997710,1720997710.686914,-18000,EB445137-D7F5-57EC-87DA-1DB460D64046,"iPhone13,2"
com.ebay.iphone,195,1720989483,1720989678,1720989678.829138,-18000,EB445137-D7F5-57EC-87DA-1DB460D64046,"iPhone13,2"
com.apple.news,9,1720989461,1720989470,1720989470.913455,-18000,EB445137-D7F5-57EC-87DA-1DB460D64046,"iPhone13,2"
com.apple.Health,14,1720989138,1720989152,1720989153.0210428,-18000,EB445137-D7F5-57EC-87DA-1DB460D64046,"iPhone13,2"
com.apple.reminders,6,1720989129,1720989135,1720989135.364898,-18000,EB445137-D7F5-57EC-87DA-1DB460D64046,"iPhone13,2"
com.apple.Health,194,1720988933,1720989127,1720989127.8013601,-18000,EB445137-D7F5-57EC-87DA-1DB460D64046,"iPhone13,2"
com.amazon.Amazon,34,1720988896,1720988930,1720988930.7607598,-18000,EB445137-D7F5-57EC-87DA-1DB460D64046,"iPhone13,2"
com.amazon.Amazon,70,1720988825,1720988895,1720988895.341226,-18000,EB445137-D7F5-57EC-87DA-1DB460D64046,"iPhone13,2"
com.apple.mobileslideshow,15,1720988716,1720988731,1720988732.065501,-18000,EB445137-D7F5-57EC-87DA-1DB460D64046,"iPhone13,2"
com.apple.MobileSMS,5,1720988692,1720988697,1720988697.1265059,-18000,EB445137-D7F5-57EC-87DA-1DB460D64046,"iPhone13,2"
com.apple.MobileSMS,1,1720988690,1720988691,1720988691.713131,-18000,EB445137-D7F5-57EC-87DA-1DB460D64046,"iPhone13,2"
com.thestorygraph.thestorygraph,22,1720988644,1720988666,1720988666.354737,-18000,EB445137-D7F5-57EC-87DA-1DB460D64046,"iPhone13,2"
com.apple.MobileSMS,3,1720988641,1720988644,1720988644.3123112,-18000,EB445137-D7F5-57EC-87DA-1DB460D64046,"iPhone13,2"
com.apple.MobileSMS,12,1720988505,1720988517,1720988517.351942,-18000,EB445137-D7F5-57EC-87DA-1DB460D64046,"iPhone13,2"
com.apple.MobileSMS,2,1720987628,1720987630,1720987630.0967631,-18000,EB445137-D7F5-57EC-87DA-1DB460D64046,"iPhone13,2"
com.apple.MobileSMS,15,1720987567,1720987582,1720987583.015748,-18000,EB445137-D7F5-57EC-87DA-1DB460D64046,"iPhone13,2"
com.doordash.dasher,3,1720987564,1720987567,1720987567.9843311,-18000,EB445137-D7F5-57EC-87DA-1DB460D64046,"iPhone13,2"
com.doordash.dasher,48,1720987271,1720987319,1720987319.640559,-18000,EB445137-D7F5-57EC-87DA-1DB460D64046,"iPhone13,2"
com.thestorygraph.thestorygraph,2,1720987268,1720987270,1720987270.8421578,-18000,EB445137-D7F5-57EC-87DA-1DB460D64046,"iPhone13,2"
com.thestorygraph.thestorygraph,10,1720987215,1720987225,1720987225.323717,-18000,EB445137-D7F5-57EC-87DA-1DB460D64046,"iPhone13,2"
com.thestorygraph.thestorygraph,20,1720985169,1720985189,1720985189.890687,-18000,EB445137-D7F5-57EC-87DA-1DB460D64046,"iPhone13,2"
com.google.chrome.ios,156,1720985011,1720985167,1720985167.288943,-18000,EB445137-D7F5-57EC-87DA-1DB460D64046,"iPhone13,2"
com.robinhood.release.Robinhood,33,1720982556,1720982589,1720982589.157641,-18000,EB445137-D7F5-57EC-87DA-1DB460D64046,"iPhone13,2"
com.myfitnesspal.mfp,71,1720982473,1720982544,1720982544.5036268,-18000,EB445137-D7F5-57EC-87DA-1DB460D64046,"iPhone13,2"
com.apple.weather,5,1720982433,1720982438,1720982438.190813,-18000,EB445137-D7F5-57EC-87DA-1DB460D64046,"iPhone13,2"
com.apple.weather,1,1720982403,1720982404,1720982404.769815,-18000,EB445137-D7F5-57EC-87DA-1DB460D64046,"iPhone13,2"
com.apple.dt.Xcode,52,1720982348,1720982400,1720982400.236902,-18000,,
com.google.Chrome,2,1720982346,1720982348,1720982348.7859812,-18000,,
com.apple.dt.Xcode,3,1720982343,1720982346,1720982346.584831,-18000,,
com.google.Chrome,4,1720982339,1720982343,1720982343.9324598,-18000,,
com.apple.dt.Xcode,3,1720982336,1720982339,1720982339.483208,-18000,,
com.google.Chrome,19,1720982317,1720982336,1720982336.339848,-18000,,
com.apple.dt.Xcode,69,1720982248,1720982317,1720982317.815211,-18000,,
org.stellarium.Stellarium,2,1720982246,1720982248,1720982248.212819,-18000,,
com.google.Chrome,20,1720982226,1720982246,1720982246.33214,-18000,,
org.stellarium.Stellarium,1,1720982225,1720982226,1720982226.1441,-18000,,
com.apple.dt.Xcode,11,1720982214,1720982225,1720982225.4440389,-18000,,
org.stellarium.Stellarium,35,1720982179,1720982214,1720982214.809588,-18000,,
com.apple.weather,9,1720982132,1720982141,1720982141.913118,-18000,EB445137-D7F5-57EC-87DA-1DB460D64046,"iPhone13,2"
com.google.ios.youtube,4,1720982128,1720982132,1720982132.3977199,-18000,EB445137-D7F5-57EC-87DA-1DB460D64046,"iPhone13,2"
com.apple.dt.Xcode,61,1720982118,1720982179,1720982179.715022,-18000,,
com.google.Chrome,1,1720982117,1720982118,1720982118.790454,-18000,,
com.apple.dt.Xcode,1,1720982116,1720982117,1720982117.580212,-18000,,
com.google.Chrome,3,1720982113,1720982116,1720982116.1597462,-18000,,
com.apple.dt.Xcode,3,1720982110,1720982113,1720982113.758565,-18000,,
com.google.Chrome,2,1720982108,1720982110,1720982110.482386,-18000,,
com.apple.dt.Xcode,5,1720982103,1720982108,1720982108.767387,-18000,,
com.google.Chrome,6,1720982097,1720982103,1720982103.478064,-18000,,
com.apple.dt.Xcode,38,1720982059,1720982097,1720982097.7666302,-18000,,
com.google.Chrome,18,1720982041,1720982059,1720982059.2414842,-18000,,
com.apple.dt.Xcode,6,1720982035,1720982041,1720982041.519339,-18000,,
com.google.Chrome,4,1720982031,1720982035,1720982035.717006,-18000,,
com.apple.dt.Xcode,1,1720982030,1720982031,1720982031.8909879,-18000,,
com.google.Chrome,65,1720981965,1720982030,1720982030.151737,-18000,,
com.apple.dt.Xcode,3,1720981962,1720981965,1720981965.090853,-18000,,
com.apple.iphonesimulator,3,1720981959,1720981962,1720981962.305009,-18000,,
org.stellarium.Stellarium,3,1720981956,1720981959,1720981959.522894,-18000,,
com.apple.iphonesimulator,5,1720981951,1720981956,1720981956.1112509,-18000,,
com.apple.dt.Xcode,10,1720981941,1720981951,1720981951.9497871,-18000,,
com.google.Chrome,2,1720981939,1720981941,1720981942.092406,-18000,,
com.apple.dt.Xcode,9,1720981930,1720981939,1720981939.2400432,-18000,,
com.google.Chrome,47,1720981883,1720981930,1720981930.671196,-18000,,
com.apple.dt.Xcode,2,1720981881,1720981883,1720981883.3942761,-18000,,
com.google.Chrome,8,1720981873,1720981881,1720981881.772306,-18000,,
com.apple.dt.Xcode,21,1720981852,1720981873,1720981873.619443,-18000,,
com.google.ios.youtube,73,1720981774,1720981847,1720981847.647695,-18000,EB445137-D7F5-57EC-87DA-1DB460D64046,"iPhone13,2"
com.google.ios.youtube,2216,1720979492,1720981708,1720981708.468096,-18000,EB445137-D7F5-57EC-87DA-1DB460D64046,"iPhone13,2"
com.apple.dt.Xcode,372,1720979399,1720979771,1720979771.6592832,-18000,,
org.stellarium.Stellarium,5,1720979394,1720979399,1720979399.3042212,-18000,,
com.apple.dt.Xcode,2,1720979392,1720979394,1720979394.908114,-18000,,
org.stellarium.Stellarium,2,1720979390,1720979392,1720979392.8565679,-18000,,
com.apple.dt.Xcode,29,1720979361,1720979390,1720979390.36685,-18000,,
com.apple.iphonesimulator,5,1720979356,1720979361,1720979361.644208,-18000,,
com.apple.dt.Xcode,10,1720979346,1720979356,1720979356.800662,-18000,,
com.apple.iphonesimulator,9,1720979337,1720979346,1720979346.2467132,-18000,,
com.apple.dt.Xcode,123,1720979214,1720979337,1720979337.785434,-18000,,
org.stellarium.Stellarium,29,1720979185,1720979214,1720979214.892298,-18000,,
com.apple.dt.Xcode,3,1720979182,1720979185,1720979185.076855,-18000,,
org.stellarium.Stellarium,4,1720979178,1720979182,1720979182.606698,-18000,,
com.apple.dt.Xcode,1,1720979177,1720979178,1720979178.740305,-18000,,
com.apple.iphonesimulator,5,1720979172,1720979177,1720979177.4700608,-18000,,
com.apple.dt.Xcode,24,1720979148,1720979172,1720979172.870146,-18000,,
com.apple.iphonesimulator,4,1720979144,1720979148,1720979148.358204,-18000,,
org.stellarium.Stellarium,15,1720979129,1720979144,1720979144.286222,-18000,,
com.apple.iphonesimulator,3,1720979126,1720979129,1720979129.926794,-18000,,
com.apple.dt.Xcode,38,1720979088,1720979126,1720979126.254023,-18000,,
com.google.Chrome,20,1720979068,1720979088,1720979088.9144769,-18000,,
com.apple.dt.Xcode,12,1720979056,1720979068,1720979068.832623,-18000,,
com.google.Chrome,12,1720979044,1720979056,1720979056.7541718,-18000,,
com.apple.dt.Xcode,2,1720979042,1720979044,1720979044.435466,-18000,,
com.google.Chrome,3,1720979039,1720979042,1720979042.978874,-18000,,
com.apple.dt.Xcode,10,1720979029,1720979039,1720979039.753487,-18000,,
com.apple.iphonesimulator,2,1720979027,1720979029,1720979029.061977,-18000,,
org.stellarium.Stellarium,4,1720979023,1720979027,1720979027.443111,-18000,,
com.apple.iphonesimulator,4,1720979019,1720979023,1720979023.653816,-18000,,
com.apple.dt.Xcode,27,1720978992,1720979019,1720979019.558548,-18000,,
com.apple.iphonesimulator,2,1720978990,1720978992,1720978992.577365,-18000,,
com.apple.dt.Xcode,204,1720978786,1720978990,1720978990.893975,-18000,,
com.apple.iphonesimulator,3,1720978783,1720978786,1720978786.07249,-18000,,
org.stellarium.Stellarium,13,1720978770,1720978783,1720978784.0154982,-18000,,
com.apple.iphonesimulator,6,1720978764,1720978770,1720978770.1006432,-18000,,
com.apple.dt.Xcode,1,1720978756,1720978757,1720978757.268353,-18000,,
com.google.Chrome,5,1720978497,1720978502,1720978502.990643,-18000,,
com.apple.dt.Xcode,24,1720978473,1720978497,1720978497.397248,-18000,,
com.google.Chrome,2,1720978471,1720978473,1720978473.6525679,-18000,,
com.apple.dt.Xcode,6,1720978465,1720978471,1720978471.5475569,-18000,,
com.google.Chrome,16,1720978449,1720978465,1720978465.454896,-18000,,
com.apple.dt.Xcode,18,1720978431,1720978449,1720978449.1524339,-18000,,
com.google.Chrome,23,1720978408,1720978431,1720978431.435583,-18000,,
com.apple.dt.Xcode,10,1720978398,1720978408,1720978408.957051,-18000,,
com.google.Chrome,249,1720978149,1720978398,1720978398.533537,-18000,,
com.apple.dt.Xcode,3,1720978146,1720978149,1720978149.572829,-18000,,
com.google.Chrome,6,1720978140,1720978146,1720978146.963486,-18000,,
com.apple.dt.Xcode,2,1720978138,1720978140,1720978140.230506,-18000,,
com.google.Chrome,72,1720978066,1720978138,1720978138.323841,-18000,,
com.apple.dt.Xcode,5,1720978061,1720978066,1720978066.835775,-18000,,
com.facebook.Facebook,71,1720977618,1720977689,1720977689.083856,-18000,EB445137-D7F5-57EC-87DA-1DB460D64046,"iPhone13,2"
com.apple.camera,0,1720977059,1720977059,1720977059.875228,-18000,EB445137-D7F5-57EC-87DA-1DB460D64046,"iPhone13,2"
com.google.ios.youtube,1176,1720975875,1720977051,1720977051.378244,-18000,EB445137-D7F5-57EC-87DA-1DB460D64046,"iPhone13,2"
com.apple.dt.Xcode,301,1720975832,1720976133,1720976133.88132,-18000,,
com.google.Chrome,21,1720975811,1720975832,1720975832.1408691,-18000,,
com.apple.dt.Xcode,5,1720975806,1720975811,1720975811.187262,-18000,,
com.google.Chrome,1,1720975805,1720975806,1720975806.7457209,-18000,,
com.apple.dt.Xcode,1,1720975804,1720975805,1720975805.401176,-18000,,
com.google.Chrome,97,1720975707,1720975804,1720975804.477593,-18000,,
com.apple.dt.Xcode,4,1720975703,1720975707,1720975707.484661,-18000,,
com.google.Chrome,40,1720975663,1720975703,1720975703.516741,-18000,,
com.apple.dt.Xcode,2,1720975661,1720975663,1720975663.242014,-18000,,
com.google.Chrome,0,1720975661,1720975661,1720975662.00041,-18000,,
com.apple.dt.Xcode,1,1720975660,1720975661,1720975661.1593862,-18000,,
com.google.Chrome,2,1720975658,1720975660,1720975660.184787,-18000,,
com.apple.dt.Xcode,1,1720975657,1720975658,1720975658.533762,-18000,,
com.google.Chrome,3,1720975654,1720975657,1720975657.1073442,-18000,,
com.apple.dt.Xcode,2,1720975652,1720975654,1720975654.8875232,-18000,,
com.google.Chrome,1,1720975651,1720975652,1720975653.00769,-18000,,
com.apple.dt.Xcode,1,1720975650,1720975651,1720975651.80531,-18000,,
com.google.Chrome,2,1720975648,1720975650,1720975650.0598679,-18000,,
com.apple.dt.Xcode,12,1720975636,1720975648,1720975648.357161,-18000,,
com.google.Chrome,4,1720975632,1720975636,1720975636.464222,-18000,,
com.apple.dt.Xcode,2,1720975630,1720975632,1720975632.785219,-18000,,
com.google.Chrome,10,1720975620,1720975630,1720975630.3817549,-18000,,
com.apple.dt.Xcode,1,1720975619,1720975620,1720975620.385262,-18000,,
com.google.Chrome,5,1720975614,1720975619,1720975619.923234,-18000,,
com.apple.dt.Xcode,2,1720975612,1720975614,1720975614.726541,-18000,,
com.google.Chrome,4,1720975608,1720975612,1720975612.555767,-18000,,
com.apple.dt.Xcode,2,1720975606,1720975608,1720975608.863416,-18000,,
com.google.Chrome,4,1720975602,1720975606,1720975606.50776,-18000,,
com.apple.dt.Xcode,2,1720975600,1720975602,1720975602.204884,-18000,,
com.google.Chrome,3,1720975597,1720975600,1720975600.184928,-18000,,
com.apple.dt.Xcode,1,1720975596,1720975597,1720975597.879043,-18000,,
com.google.Chrome,3,1720975593,1720975596,1720975596.254502,-18000,,
com.apple.dt.Xcode,0,1720975593,1720975593,1720975593.854371,-18000,,
com.google.Chrome,1,1720975592,1720975593,1720975593.1723619,-18000,,
com.apple.dt.Xcode,3,1720975589,1720975592,1720975592.158575,-18000,,
com.google.Chrome,2,1720975587,1720975589,1720975589.539441,-18000,,
com.apple.dt.Xcode,1,1720975586,1720975587,1720975587.642425,-18000,,
com.google.Chrome,4,1720975582,1720975586,1720975586.118036,-18000,,
com.apple.dt.Xcode,2,1720975580,1720975582,1720975582.127029,-18000,,
com.google.Chrome,1,1720975579,1720975580,1720975580.775054,-18000,,
com.apple.dt.Xcode,4,1720975575,1720975579,1720975579.8733768,-18000,,
com.google.Chrome,5,1720975570,1720975575,1720975575.994526,-18000,,
com.apple.dt.Xcode,1,1720975569,1720975570,1720975570.9306722,-18000,,
com.google.Chrome,4,1720975565,1720975569,1720975569.475793,-18000,,
com.apple.dt.Xcode,58,1720975507,1720975565,1720975565.252145,-18000,,
com.google.Chrome,8,1720975499,1720975507,1720975507.472571,-18000,,
com.apple.dt.Xcode,48,1720975451,1720975499,1720975499.371592,-18000,,
com.google.Chrome,4,1720975447,1720975451,1720975451.987402,-18000,,
com.apple.dt.Xcode,0,1720975447,1720975447,1720975447.899839,-18000,,
com.google.Chrome,14,1720975433,1720975447,1720975447.0895271,-18000,,
com.apple.dt.Xcode,2,1720975431,1720975433,1720975433.701164,-18000,,
com.google.Chrome,3,1720975428,1720975431,1720975431.26846,-18000,,
com.apple.dt.Xcode,5,1720975423,1720975428,1720975428.113821,-18000,,
com.google.Chrome,4,1720975419,1720975423,1720975423.6526089,-18000,,
com.apple.dt.Xcode,17,1720975402,1720975419,1720975419.863267,-18000,,
com.google.Chrome,7,1720975395,1720975402,1720975402.425047,-18000,,
com.apple.dt.Xcode,5,1720975390,1720975395,1720975395.612169,-18000,,
com.google.Chrome,6,1720975384,1720975390,1720975390.891721,-18000,,
com.apple.dt.Xcode,3,1720975381,1720975384,1720975384.987524,-18000,,
com.google.Chrome,4,1720975377,1720975381,1720975381.678951,-18000,,
com.apple.dt.Xcode,2,1720975375,1720975377,1720975377.439363,-18000,,
com.google.Chrome,5,1720975370,1720975375,1720975375.5902429,-18000,,
com.apple.dt.Xcode,6,1720975364,1720975370,1720975370.963749,-18000,,
com.google.Chrome,3,1720975361,1720975364,1720975364.517925,-18000,,
com.apple.dt.Xcode,10,1720975351,1720975361,1720975361.810882,-18000,,
com.google.Chrome,6,1720975345,1720975351,1720975351.472036,-18000,,
com.apple.dt.Xcode,14,1720975331,1720975345,1720975345.262424,-18000,,
com.google.Chrome,5,1720975326,1720975331,1720975331.759661,-18000,,
com.apple.dt.Xcode,1,1720975325,1720975326,1720975326.846408,-18000,,
com.google.Chrome,3,1720975322,1720975325,1720975325.336879,-18000,,
com.apple.dt.Xcode,10,1720975312,1720975322,1720975322.6379042,-18000,,
com.google.Chrome,1,1720975311,1720975312,1720975312.4396272,-18000,,
com.apple.dt.Xcode,15,1720975296,1720975311,1720975311.887815,-18000,,
com.google.Chrome,30,1720975266,1720975296,1720975296.4265041,-18000,,
com.apple.dt.Xcode,2,1720975264,1720975266,1720975266.9755049,-18000,,
com.google.Chrome,1,1720975263,1720975264,1720975264.225884,-18000,,
com.apple.dt.Xcode,10,1720975253,1720975263,1720975263.891636,-18000,,
com.google.Chrome,22,1720975231,1720975253,1720975253.715685,-18000,,
com.apple.dt.Xcode,27,1720975204,1720975231,1720975231.8241,-18000,,
com.google.Chrome,11,1720975193,1720975204,1720975204.4523501,-18000,,
com.apple.dt.Xcode,13,1720975180,1720975193,1720975193.797626,-18000,,
com.google.Chrome,21,1720975159,1720975180,1720975181.024693,-18000,,
com.apple.dt.Xcode,138,1720975021,1720975159,1720975159.519957,-18000,,
com.google.Chrome,10,1720975011,1720975021,1720975021.238641,-18000,,
com.apple.dt.Xcode,49,1720974962,1720975011,1720975011.332203,-18000,,
com.google.Chrome,8,1720974954,1720974962,1720974962.39148,-18000,,
com.apple.dt.Xcode,12,1720974942,1720974954,1720974954.5899348,-18000,,
com.google.Chrome,3,1720974939,1720974942,1720974942.658648,-18000,,
com.apple.dt.Xcode,33,1720974906,1720974939,1720974939.935452,-18000,,
com.google.Chrome,133,1720974773,1720974906,1720974906.6370811,-18000,,
com.apple.dt.Xcode,4,1720974769,1720974773,1720974773.639655,-18000,,
com.google.Chrome,15,1720974754,1720974769,1720974769.897723,-18000,,
com.apple.dt.Xcode,34,1720974720,1720974754,1720974754.684873,-18000,,
com.google.Chrome,2,1720974718,1720974720,1720974720.614491,-18000,,
com.apple.dt.Xcode,9,1720974709,1720974718,1720974718.55338,-18000,,
com.google.Chrome,2,1720974707,1720974709,1720974709.76926,-18000,,
com.apple.dt.Xcode,152,1720974555,1720974707,1720974707.8068519,-18000,,
com.google.Chrome,21,1720974534,1720974555,1720974555.6696239,-18000,,
com.apple.dt.Xcode,17,1720974517,1720974534,1720974534.3529758,-18000,,
com.google.Chrome,6,1720974511,1720974517,1720974517.120017,-18000,,
com.apple.dt.Xcode,97,1720974414,1720974511,1720974511.265297,-18000,,
com.google.Chrome,2,1720974412,1720974414,1720974414.046025,-18000,,
com.apple.dt.Xcode,9,1720974403,1720974412,1720974412.511859,-18000,,
com.google.Chrome,1,1720974402,1720974403,1720974404.000957,-18000,,
com.apple.dt.Xcode,5,1720974397,1720974402,1720974402.0652351,-18000,,
com.google.Chrome,2,1720974395,1720974397,1720974397.993068,-18000,,
com.apple.dt.Xcode,10,1720974385,1720974395,1720974395.191906,-18000,,
com.google.Chrome,3,1720974382,1720974385,1720974385.139852,-18000,,
com.apple.dt.Xcode,8,1720974374,1720974382,1720974382.8705292,-18000,,
com.google.Chrome,2,1720974372,1720974374,1720974374.498862,-18000,,
com.apple.dt.Xcode,2,1720974370,1720974372,1720974372.3444262,-18000,,
com.google.Chrome,3,1720974367,1720974370,1720974370.623574,-18000,,
com.apple.dt.Xcode,1,1720974366,1720974367,1720974367.883219,-18000,,
com.google.Chrome,5,1720974361,1720974366,1720974366.635565,-18000,,
com.apple.dt.Xcode,34,1720974327,1720974361,1720974361.902719,-18000,,
com.google.Chrome,1,1720974326,1720974327,1720974327.9748468,-18000,,
com.apple.dt.Xcode,6,1720974320,1720974326,1720974326.174067,-18000,,
com.google.Chrome,13,1720974307,1720974320,1720974321.0426211,-18000,,
com.apple.dt.Xcode,4,1720974303,1720974307,1720974307.550047,-18000,,
com.google.Chrome,21,1720974282,1720974303,1720974303.2341762,-18000,,
com.apple.dt.Xcode,7,1720974275,1720974282,1720974282.516068,-18000,,
com.google.Chrome,2,1720974273,1720974275,1720974275.4358602,-18000,,
com.apple.dt.Xcode,11,1720974262,1720974273,1720974273.201447,-18000,,
com.google.Chrome,2,1720974260,1720974262,1720974262.53809,-18000,,
com.apple.dt.Xcode,7,1720974253,1720974260,1720974260.50565,-18000,,
com.google.Chrome,3,1720974250,1720974253,1720974253.2562041,-18000,,
com.apple.dt.Xcode,1,1720974249,1720974250,1720974250.765687,-18000,,
com.google.Chrome,2,1720974247,1720974249,1720974249.224687,-18000,,
com.apple.dt.Xcode,3,1720974244,1720974247,1720974248.0363278,-18000,,
com.google.Chrome,5,1720974239,1720974244,1720974244.4705591,-18000,,
com.apple.dt.Xcode,30,1720974209,1720974239,1720974239.676697,-18000,,
com.google.Chrome,3,1720974206,1720974209,1720974209.055402,-18000,,
com.apple.dt.Xcode,6,1720974200,1720974206,1720974206.8009691,-18000,,
com.google.Chrome,3,1720974197,1720974200,1720974200.070139,-18000,,
com.apple.dt.Xcode,6,1720974191,1720974197,1720974197.213489,-18000,,
com.google.Chrome,5,1720974186,1720974191,1720974191.776101,-18000,,
com.apple.dt.Xcode,3,1720974183,1720974186,1720974186.240673,-18000,,
com.google.Chrome,11,1720974172,1720974183,1720974183.5758219,-18000,,
com.apple.dt.Xcode,32,1720974140,1720974172,1720974172.9546661,-18000,,
com.google.Chrome,2,1720974138,1720974140,1720974140.087346,-18000,,
com.apple.dt.Xcode,2,1720974136,1720974138,1720974138.231987,-18000,,
com.google.Chrome,2,1720974134,1720974136,1720974136.174052,-18000,,
com.apple.dt.Xcode,2,1720974132,1720974134,1720974134.195242,-18000,,
com.google.Chrome,2,1720974130,1720974132,1720974132.472686,-18000,,
com.apple.dt.Xcode,9,1720974121,1720974130,1720974130.6257591,-18000,,
com.google.Chrome,5,1720974116,1720974121,1720974121.887,-18000,,
com.apple.dt.Xcode,32,1720974084,1720974116,1720974117.027108,-18000,,
com.google.Chrome,2,1720974082,1720974084,1720974084.273422,-18000,,
com.apple.dt.Xcode,4,1720974078,1720974082,1720974082.631987,-18000,,
com.google.Chrome,2,1720974076,1720974078,1720974078.373242,-18000,,
com.apple.dt.Xcode,5,1720974071,1720974076,1720974076.389111,-18000,,
com.google.Chrome,1,1720974070,1720974071,1720974071.884131,-18000,,
com.apple.dt.Xcode,4,1720974066,1720974070,1720974070.40808,-18000,,
com.google.Chrome,5,1720974061,1720974066,1720974066.0627341,-18000,,
com.apple.dt.Xcode,7,1720974054,1720974061,1720974061.275515,-18000,,
com.google.Chrome,7,1720974047,1720974054,1720974054.04291,-18000,,
com.apple.dt.Xcode,9,1720974038,1720974047,1720974047.725707,-18000,,
com.google.Chrome,3,1720974035,1720974038,1720974038.4021878,-18000,,
com.apple.dt.Xcode,10,1720974025,1720974035,1720974036.013925,-18000,,
com.google.Chrome,1,1720974024,1720974025,1720974025.961946,-18000,,
com.apple.dt.Xcode,2,1720974022,1720974024,1720974024.113896,-18000,,
com.google.Chrome,3,1720974019,1720974022,1720974023.0055451,-18000,,
com.apple.dt.Xcode,6,1720974013,1720974019,1720974019.710381,-18000,,
com.google.Chrome,1,1720974012,1720974013,1720974013.487859,-18000,,
com.apple.dt.Xcode,6,1720974006,1720974012,1720974012.771008,-18000,,
com.google.Chrome,10,1720973996,1720974006,1720974006.405705,-18000,,
com.apple.dt.Xcode,9,1720973987,1720973996,1720973996.9397001,-18000,,
com.google.Chrome,5,1720973982,1720973987,1720973987.286721,-18000,,
com.apple.dt.Xcode,28,1720973954,1720973982,1720973982.183929,-18000,,
com.google.Chrome,7,1720973947,1720973954,1720973954.432458,-18000,,
com.apple.dt.Xcode,3,1720973944,1720973947,1720973947.907958,-18000,,
com.google.Chrome,27,1720973917,1720973944,1720973945.0322108,-18000,,
com.apple.dt.Xcode,5,1720973912,1720973917,1720973917.975525,-18000,,
com.google.Chrome,46,1720973866,1720973912,1720973912.848971,-18000,,
com.apple.dt.Xcode,4,1720973862,1720973866,1720973866.360033,-18000,,
com.google.Chrome,13,1720973849,1720973862,1720973862.867394,-18000,,
com.apple.dt.Xcode,1,1720973848,1720973849,1720973849.692336,-18000,,
com.google.Chrome,2,1720973846,1720973848,1720973848.251451,-18000,,
com.apple.dt.Xcode,3,1720973843,1720973846,1720973846.5229511,-18000,,
com.google.Chrome,30,1720973813,1720973843,1720973843.925118,-18000,,
com.apple.dt.Xcode,3,1720973810,1720973813,1720973813.8378549,-18000,,
com.google.Chrome,1,1720973809,1720973810,1720973810.857802,-18000,,
com.apple.dt.Xcode,2,1720973807,1720973809,1720973809.839386,-18000,,
com.google.Chrome,2,1720973805,1720973807,1720973807.065301,-18000,,
com.apple.dt.Xcode,5,1720973800,1720973805,1720973805.99457,-18000,,
com.google.Chrome,1,1720973799,1720973800,1720973800.969585,-18000,,
com.apple.dt.Xcode,3,1720973796,1720973799,1720973799.461481,-18000,,
com.google.Chrome,1,1720973795,1720973796,1720973796.7863421,-18000,,
com.apple.dt.Xcode,5,1720973790,1720973795,1720973795.66194,-18000,,
com.google.Chrome,1,1720973789,1720973790,1720973790.763315,-18000,,
com.apple.dt.Xcode,5,1720973784,1720973789,1720973789.662099,-18000,,
com.google.Chrome,1,1720973783,1720973784,1720973784.745718,-18000,,
com.apple.dt.Xcode,3,1720973780,1720973783,1720973783.624429,-18000,,
com.google.Chrome,0,1720973780,1720973780,1720973781.010654,-18000,,
com.apple.dt.Xcode,5,1720973775,1720973780,1720973780.092113,-18000,,
com.google.Chrome,18,1720973757,1720973775,1720973775.935587,-18000,,
com.apple.dt.Xcode,1,1720973756,1720973757,1720973757.793283,-18000,,
com.google.Chrome,13,1720973743,1720973756,1720973756.240934,-18000,,
com.apple.dt.Xcode,14,1720973729,1720973743,1720973743.448897,-18000,,
com.google.Chrome,4,1720973725,1720973729,1720973729.66607,-18000,,
com.apple.dt.Xcode,8,1720973717,1720973725,1720973726.017847,-18000,,
com.google.Chrome,2,1720973715,1720973717,1720973717.548408,-18000,,
com.apple.dt.Xcode,4,1720973711,1720973715,1720973715.267867,-18000,,
com.google.Chrome,2,1720973709,1720973711,1720973711.5867748,-18000,,
com.apple.dt.Xcode,4,1720973705,1720973709,1720973709.901935,-18000,,
com.google.Chrome,2,1720973703,1720973705,1720973705.788169,-18000,,
com.apple.dt.Xcode,12,1720973691,1720973703,1720973703.743147,-18000,,
com.google.Chrome,9,1720973682,1720973691,1720973691.105315,-18000,,
com.apple.dt.Xcode,1,1720973681,1720973682,1720973682.331019,-18000,,
com.google.Chrome,39,1720973642,1720973681,1720973681.479412,-18000,,
com.apple.dt.Xcode,58,1720973584,1720973642,1720973642.569079,-18000,,
com.google.Chrome,448,1720973136,1720973584,1720973584.468898,-18000,,
com.apple.dt.Xcode,1,1720973135,1720973136,1720973136.5495338,-18000,,
com.microsoft.onenote.mac,1,1720973134,1720973135,1720973135.24349,-18000,,
com.google.Chrome,123,1720973011,1720973134,1720973134.090498,-18000,,
com.microsoft.onenote.mac,4,1720973007,1720973011,1720973011.3610458,-18000,,
com.google.Chrome,6,1720973001,1720973007,1720973007.6829638,-18000,,
com.microsoft.onenote.mac,0,1720973001,1720973001,1720973001.862033,-18000,,
com.apple.dt.Xcode,6,1720972995,1720973001,1720973001.106152,-18000,,
com.microsoft.onenote.mac,58,1720972937,1720972995,1720972995.8805618,-18000,,
com.google.Chrome,9,1720972928,1720972937,1720972937.347358,-18000,,
com.apple.MobileSMS,2,1720972916,1720972918,1720972918.584423,-18000,EB445137-D7F5-57EC-87DA-1DB460D64046,"iPhone13,2"
com.truebill.truebillnative,3,1720972913,1720972916,1720972917.2133322,-18000,EB445137-D7F5-57EC-87DA-1DB460D64046,"iPhone13,2"
com.apple.MobileSMS,20,1720972908,1720972928,1720972928.127943,-18000,,
com.google.Chrome,43,1720972865,1720972908,1720972908.5889568,-18000,,
com.apple.MobileSMS,3,1720972862,1720972865,1720972865.342448,-18000,,
com.google.Chrome,24,1720972838,1720972862,1720972862.243747,-18000,,
com.apple.MobileSMS,6,1720972832,1720972838,1720972838.686857,-18000,,
com.google.Chrome,62,1720972770,1720972832,1720972832.378354,-18000,,
com.apple.MobileSMS,8,1720972702,1720972710,1720972711.0132508,-18000,,
com.apple.finder,2,1720972700,1720972702,1720972702.706963,-18000,,
com.apple.MobileSMS,2,1720972698,1720972700,1720972700.575532,-18000,,
com.apple.finder,13,1720972685,1720972698,1720972698.449842,-18000,,
com.google.Chrome,1,1720972684,1720972685,1720972685.9157019,-18000,,
com.truebill.truebillnative,67,1720972563,1720972630,1720972630.8405871,-18000,EB445137-D7F5-57EC-87DA-1DB460D64046,"iPhone13,2"
com.apple.news,253,1720972309,1720972562,1720972563.014379,-18000,EB445137-D7F5-57EC-87DA-1DB460D64046,"iPhone13,2"
com.apple.findmy,20,1720972283,1720972303,1720972303.773514,-18000,EB445137-D7F5-57EC-87DA-1DB460D64046,"iPhone13,2"
com.doordash.dasher,10,1720972001,1720972011,1720972011.154931,-18000,EB445137-D7F5-57EC-87DA-1DB460D64046,"iPhone13,2"
com.apple.findmy,9,1720971992,1720972001,1720972001.400965,-18000,EB445137-D7F5-57EC-87DA-1DB460D64046,"iPhone13,2"
com.apple.findmy,5,1720971855,1720971860,1720971860.7724218,-18000,EB445137-D7F5-57EC-87DA-1DB460D64046,"iPhone13,2"
com.apple.MobileSMS,27,1720971824,1720971851,1720971851.232829,-18000,EB445137-D7F5-57EC-87DA-1DB460D64046,"iPhone13,2"
com.doordash.dasher,10,1720970177,1720970187,1720970187.1228662,-18000,EB445137-D7F5-57EC-87DA-1DB460D64046,"iPhone13,2"
com.google.ios.youtube,2284,1720967857,1720970141,1720970142.045268,-18000,EB445137-D7F5-57EC-87DA-1DB460D64046,"iPhone13,2"
com.apple.findmy,80,1720967776,1720967856,1720967856.2721848,-18000,EB445137-D7F5-57EC-87DA-1DB460D64046,"iPhone13,2"
com.apple.MobileSMS,32,1720966932,1720966964,1720966964.3337731,-18000,EB445137-D7F5-57EC-87DA-1DB460D64046,"iPhone13,2"
com.apple.weather,4,1720966928,1720966932,1720966932.227662,-18000,EB445137-D7F5-57EC-87DA-1DB460D64046,"iPhone13,2"
com.apple.mobiletimer,14,1720934738,1720934752,1720934752.443873,-18000,EB445137-D7F5-57EC-87DA-1DB460D64046,"iPhone13,2"
com.google.Chrome,931,1720933722,1720934653,1720934653.9958339,-18000,,
com.apple.keychainaccess,1,1720933721,1720933722,1720933722.749352,-18000,,
com.google.Chrome,52,1720933669,1720933721,1720933721.674714,-18000,,
com.apple.keychainaccess,2,1720933667,1720933669,1720933669.15552,-18000,,
com.google.Chrome,5,1720933662,1720933667,1720933667.42416,-18000,,
com.apple.keychainaccess,1,1720933661,1720933662,1720933662.2991629,-18000,,
com.google.Chrome,4,1720933657,1720933661,1720933661.219676,-18000,,
com.apple.keychainaccess,2,1720933655,1720933657,1720933657.363288,-18000,,
com.google.Chrome,8,1720933647,1720933655,1720933655.71144,-18000,,
com.apple.keychainaccess,3,1720933644,1720933647,1720933647.9816818,-18000,,
com.google.Chrome,138,1720933487,1720933625,1720933625.116591,-18000,,
com.google.chrome.ios,63,1720933396,1720933459,1720933459.19891,-18000,EB445137-D7F5-57EC-87DA-1DB460D64046,"iPhone13,2"
com.apple.weather,3,1720933393,1720933396,1720933396.9954472,-18000,EB445137-D7F5-57EC-87DA-1DB460D64046,"iPhone13,2"
com.apple.weather,13,1720933348,1720933361,1720933361.188064,-18000,EB445137-D7F5-57EC-87DA-1DB460D64046,"iPhone13,2"
com.apple.weather,7,1720933310,1720933317,1720933317.7716231,-18000,EB445137-D7F5-57EC-87DA-1DB460D64046,"iPhone13,2"
com.apple.mobilenotes,11,1720933299,1720933310,1720933310.572425,-18000,EB445137-D7F5-57EC-87DA-1DB460D64046,"iPhone13,2"
com.apple.weather,3,1720933296,1720933299,1720933299.9868832,-18000,EB445137-D7F5-57EC-87DA-1DB460D64046,"iPhone13,2"
com.google.Chrome,127,1720933194,1720933321,1720933321.265986,-18000,,
com.google.Chrome,330,1720931986,1720932316,1720932316.3267422,-18000,,
com.google.Chrome,642,1720931106,1720931748,1720931748.7516809,-18000,,
com.apple.weather,13,1720931095,1720931108,1720931108.832364,-18000,EB445137-D7F5-57EC-87DA-1DB460D64046,"iPhone13,2"
com.apple.weather,2,1720931091,1720931093,1720931093.672248,-18000,EB445137-D7F5-57EC-87DA-1DB460D64046,"iPhone13,2"
com.apple.weather,10,1720930643,1720930653,1720930653.941767,-18000,EB445137-D7F5-57EC-87DA-1DB460D64046,"iPhone13,2"
com.apple.mobilenotes,3,1720930640,1720930643,1720930643.213238,-18000,EB445137-D7F5-57EC-87DA-1DB460D64046,"iPhone13,2"
com.apple.mobilenotes,32,1720930590,1720930622,1720930622.9919472,-18000,EB445137-D7F5-57EC-87DA-1DB460D64046,"iPhone13,2"
com.google.Chrome,408,1720930480,1720930888,1720930889.00135,-18000,,
com.apple.mobilenotes,19,1720929972,1720929991,1720929991.848131,-18000,EB445137-D7F5-57EC-87DA-1DB460D64046,"iPhone13,2"
com.google.Chrome,347,1720929182,1720929529,1720929529.985523,-18000,,
com.apple.mobilenotes,16,1720929025,1720929041,1720929041.567893,-18000,EB445137-D7F5-57EC-87DA-1DB460D64046,"iPhone13,2"
com.google.Chrome,301,1720928738,1720929039,1720929039.42011,-18000,,
com.apple.mobilenotes,10,1720928326,1720928336,1720928336.7176828,-18000,EB445137-D7F5-57EC-87DA-1DB460D64046,"iPhone13,2"
com.apple.mobilenotes,33,1720927788,1720927821,1720927822.078823,-18000,EB445137-D7F5-57EC-87DA-1DB460D64046,"iPhone13,2"
com.google.Chrome,746,1720927675,1720928421,1720928421.934484,-18000,,
com.google.Chrome,464,1720927171,1720927635,1720927635.0379171,-18000,,
com.apple.mobilenotes,8,1720925926,1720925934,1720925934.30845,-18000,EB445137-D7F5-57EC-87DA-1DB460D64046,"iPhone13,2"
com.apple.mobilenotes,28,1720925478,1720925506,1720925507.0619621,-18000,EB445137-D7F5-57EC-87DA-1DB460D64046,"iPhone13,2"
com.apple.PosterBoard,0,1720925472,1720925472,1720925473.743174,-18000,EB445137-D7F5-57EC-87DA-1DB460D64046,"iPhone13,2"
com.letterboxd.LetterboxdApp,3,1720925471,1720925474,1720925474.138062,-18000,EB445137-D7F5-57EC-87DA-1DB460D64046,"iPhone13,2"
com.google.Chrome,1728,1720925351,1720927079,1720927079.7586699,-18000,,
com.letterboxd.LetterboxdApp,2,1720924485,1720924487,1720924487.863909,-18000,EB445137-D7F5-57EC-87DA-1DB460D64046,"iPhone13,2"
com.letterboxd.LetterboxdApp,7,1720924477,1720924484,1720924484.950666,-18000,EB445137-D7F5-57EC-87DA-1DB460D64046,"iPhone13,2"
com.letterboxd.LetterboxdApp,48,1720924258,1720924306,1720924306.38514,-18000,EB445137-D7F5-57EC-87DA-1DB460D64046,"iPhone13,2"
com.apple.news,4,1720924252,1720924256,1720924256.2661371,-18000,EB445137-D7F5-57EC-87DA-1DB460D64046,"iPhone13,2"
com.apple.news,34,1720924096,1720924130,1720924130.079164,-18000,EB445137-D7F5-57EC-87DA-1DB460D64046,"iPhone13,2"
com.apple.findmy,4,1720924083,1720924087,1720924087.490197,-18000,EB445137-D7F5-57EC-87DA-1DB460D64046,"iPhone13,2"
com.apple.findmy,55,1720923997,1720924052,1720924052.661197,-18000,EB445137-D7F5-57EC-87DA-1DB460D64046,"iPhone13,2"
com.apple.findmy,61,1720923883,1720923944,1720923944.742584,-18000,EB445137-D7F5-57EC-87DA-1DB460D64046,"iPhone13,2"
com.google.Chrome,1319,1720923683,1720925002,1720925002.188926,-18000,,
com.apple.findmy,61,1720923677,1720923738,1720923738.215139,-18000,EB445137-D7F5-57EC-87DA-1DB460D64046,"iPhone13,2"
com.apple.findmy,3,1720923674,1720923677,1720923677.381219,-18000,EB445137-D7F5-57EC-87DA-1DB460D64046,"iPhone13,2"
com.apple.findmy,13,1720923495,1720923508,1720923508.975819,-18000,EB445137-D7F5-57EC-87DA-1DB460D64046,"iPhone13,2"
com.apple.findmy,8,1720923359,1720923367,1720923367.230242,-18000,EB445137-D7F5-57EC-87DA-1DB460D64046,"iPhone13,2"
com.apple.findmy,2,1720923333,1720923335,1720923335.8011642,-18000,EB445137-D7F5-57EC-87DA-1DB460D64046,"iPhone13,2"
com.apple.findmy,30,1720923003,1720923033,1720923033.4387379,-18000,EB445137-D7F5-57EC-87DA-1DB460D64046,"iPhone13,2"
com.google.Chrome,447,1720922850,1720923297,1720923297.094448,-18000,,
com.apple.findmy,9,1720922631,1720922640,1720922640.758585,-18000,EB445137-D7F5-57EC-87DA-1DB460D64046,"iPhone13,2"
com.clairmail.fth.client,71,1720922512,1720922583,1720922583.653362,-18000,EB445137-D7F5-57EC-87DA-1DB460D64046,"iPhone13,2"
com.thestorygraph.thestorygraph,30,1720922482,1720922512,1720922512.4525971,-18000,EB445137-D7F5-57EC-87DA-1DB460D64046,"iPhone13,2"
com.apple.findmy,3,1720922477,1720922480,1720922480.9397612,-18000,EB445137-D7F5-57EC-87DA-1DB460D64046,"iPhone13,2"
com.apple.MobileSMS,2,1720922475,1720922477,1720922477.401196,-18000,EB445137-D7F5-57EC-87DA-1DB460D64046,"iPhone13,2"
com.apple.MobileSMS,7,1720922413,1720922420,1720922420.476897,-18000,EB445137-D7F5-57EC-87DA-1DB460D64046,"iPhone13,2"
com.apple.MobileSMS,24,1720922358,1720922382,1720922382.387058,-18000,EB445137-D7F5-57EC-87DA-1DB460D64046,"iPhone13,2"
com.apple.findmy,9,1720922349,1720922358,1720922358.593707,-18000,EB445137-D7F5-57EC-87DA-1DB460D64046,"iPhone13,2"
com.apple.MobileSMS,41,1720922308,1720922349,1720922349.32633,-18000,EB445137-D7F5-57EC-87DA-1DB460D64046,"iPhone13,2"
com.hammerandchisel.discord,15,1720922293,1720922308,1720922308.233562,-18000,EB445137-D7F5-57EC-87DA-1DB460D64046,"iPhone13,2"
com.apple.MobileSMS,36,1720922257,1720922293,1720922293.626822,-18000,EB445137-D7F5-57EC-87DA-1DB460D64046,"iPhone13,2"
com.apple.findmy,18,1720922239,1720922257,1720922257.393538,-18000,EB445137-D7F5-57EC-87DA-1DB460D64046,"iPhone13,2"
com.toyopagroup.picaboo,4,1720922235,1720922239,1720922239.406935,-18000,EB445137-D7F5-57EC-87DA-1DB460D64046,"iPhone13,2"
com.hammerandchisel.discord,10,1720922220,1720922230,1720922230.475882,-18000,EB445137-D7F5-57EC-87DA-1DB460D64046,"iPhone13,2"
com.apple.findmy,4,1720922216,1720922220,1720922220.427954,-18000,EB445137-D7F5-57EC-87DA-1DB460D64046,"iPhone13,2"
com.google.Chrome,1293,1720919084,1720920377,1720920377.288847,-18000,,
com.apple.findmy,6,1720919077,1720919083,1720919083.374377,-18000,EB445137-D7F5-57EC-87DA-1DB460D64046,"iPhone13,2"
com.google.ios.youtube,585,1720918490,1720919075,1720919075.7645512,-18000,EB445137-D7F5-57EC-87DA-1DB460D64046,"iPhone13,2"
com.apple.camera,1,1720918470,1720918471,1720918472.004943,-18000,EB445137-D7F5-57EC-87DA-1DB460D64046,"iPhone13,2"
com.google.Chrome,362,1720917924,1720918286,1720918286.471672,-18000,,
com.apple.findmy,12,1720917837,1720917849,1720917849.927613,-18000,EB445137-D7F5-57EC-87DA-1DB460D64046,"iPhone13,2"
com.apple.findmy,14,1720917682,1720917696,1720917696.911912,-18000,EB445137-D7F5-57EC-87DA-1DB460D64046,"iPhone13,2"
com.google.Chrome,329,1720917512,1720917841,1720917841.481266,-18000,,
com.apple.findmy,7,1720917206,1720917213,1720917213.627399,-18000,EB445137-D7F5-57EC-87DA-1DB460D64046,"iPhone13,2"
com.google.Chrome,310,1720916824,1720917134,1720917134.78442,-18000,,
com.truebill.truebillnative,110,1720916704,1720916814,1720916814.836082,-18000,EB445137-D7F5-57EC-87DA-1DB460D64046,"iPhone13,2"
com.apple.Maps,33,1720916671,1720916704,1720916704.510378,-18000,EB445137-D7F5-57EC-87DA-1DB460D64046,"iPhone13,2"
com.truebill.truebillnative,40,1720916630,1720916670,1720916670.8655891,-18000,EB445137-D7F5-57EC-87DA-1DB460D64046,"iPhone13,2"
com.apple.findmy,11,1720916588,1720916599,1720916599.856384,-18000,EB445137-D7F5-57EC-87DA-1DB460D64046,"iPhone13,2"
com.google.Chrome,864,1720915920,1720916784,1720916785.000988,-18000,,
com.apple.news,146,1720915772,1720915918,1720915918.689705,-18000,EB445137-D7F5-57EC-87DA-1DB460D64046,"iPhone13,2"
com.toyopagroup.picaboo,7,1720915761,1720915768,1720915768.777009,-18000,EB445137-D7F5-57EC-87DA-1DB460D64046,"iPhone13,2"
com.myfitnesspal.mfp,3,1720915758,1720915761,1720915761.930214,-18000,EB445137-D7F5-57EC-87DA-1DB460D64046,"iPhone13,2"
com.myfitnesspal.mfp,58,1720915469,1720915527,1720915527.9204922,-18000,EB445137-D7F5-57EC-87DA-1DB460D64046,"iPhone13,2"
com.apple.findmy,2,1720915467,1720915469,1720915469.773954,-18000,EB445137-D7F5-57EC-87DA-1DB460D64046,"iPhone13,2"
com.apple.findmy,8,1720915399,1720915407,1720915407.50566,-18000,EB445137-D7F5-57EC-87DA-1DB460D64046,"iPhone13,2"
com.myfitnesspal.mfp,2,1720915397,1720915399,1720915399.7050161,-18000,EB445137-D7F5-57EC-87DA-1DB460D64046,"iPhone13,2"
com.google.Chrome,45,1720915263,1720915308,1720915308.840303,-18000,,
com.google.Chrome,303,1720914833,1720915136,1720915136.0651321,-18000,,
com.myfitnesspal.mfp,57,1720914681,1720914738,1720914738.3405108,-18000,EB445137-D7F5-57EC-87DA-1DB460D64046,"iPhone13,2"
com.apple.news,61,1720914576,1720914637,1720914637.82548,-18000,EB445137-D7F5-57EC-87DA-1DB460D64046,"iPhone13,2"
com.toyopagroup.picaboo,14,1720914554,1720914568,1720914569.1546788,-18000,EB445137-D7F5-57EC-87DA-1DB460D64046,"iPhone13,2"
com.apple.news,5,1720914549,1720914554,1720914555.1410809,-18000,EB445137-D7F5-57EC-87DA-1DB460D64046,"iPhone13,2"
com.google.Chrome,639,1720913626,1720914265,1720914265.979593,-18000,,
com.apple.MobileSMS,3,1720913623,1720913626,1720913626.590176,-18000,,
com.apple.news,121,1720913609,1720913730,1720913730.844147,-18000,EB445137-D7F5-57EC-87DA-1DB460D64046,"iPhone13,2"
com.toyopagroup.picaboo,4,1720913602,1720913606,1720913606.824033,-18000,EB445137-D7F5-57EC-87DA-1DB460D64046,"iPhone13,2"
com.google.chrome.ios,3,1720913599,1720913602,1720913602.632872,-18000,EB445137-D7F5-57EC-87DA-1DB460D64046,"iPhone13,2"
com.google.Chrome,33,1720913590,1720913623,1720913623.163415,-18000,,
com.google.chrome.ios,15,1720913374,1720913389,1720913389.949161,-18000,EB445137-D7F5-57EC-87DA-1DB460D64046,"iPhone13,2"
com.letterboxd.LetterboxdApp,15,1720913355,1720913370,1720913370.6552281,-18000,EB445137-D7F5-57EC-87DA-1DB460D64046,"iPhone13,2"
com.thestorygraph.thestorygraph,2,1720913352,1720913354,1720913354.356246,-18000,EB445137-D7F5-57EC-87DA-1DB460D64046,"iPhone13,2"
com.toyopagroup.picaboo,25,1720913285,1720913310,1720913310.521512,-18000,EB445137-D7F5-57EC-87DA-1DB460D64046,"iPhone13,2"
com.myfitnesspal.mfp,6,1720913279,1720913285,1720913285.941961,-18000,EB445137-D7F5-57EC-87DA-1DB460D64046,"iPhone13,2"
com.myfitnesspal.mfp,9,1720912069,1720912078,1720912078.632797,-18000,EB445137-D7F5-57EC-87DA-1DB460D64046,"iPhone13,2"
com.myfitnesspal.mfp,94,1720911972,1720912066,1720912066.4239879,-18000,EB445137-D7F5-57EC-87DA-1DB460D64046,"iPhone13,2"
com.apple.news,106,1720911863,1720911969,1720911969.353047,-18000,EB445137-D7F5-57EC-87DA-1DB460D64046,"iPhone13,2"
com.apple.news,8,1720911854,1720911862,1720911862.381609,-18000,EB445137-D7F5-57EC-87DA-1DB460D64046,"iPhone13,2"
com.apple.news,28,1720911818,1720911846,1720911846.1878839,-18000,EB445137-D7F5-57EC-87DA-1DB460D64046,"iPhone13,2"
com.apple.news,54,1720911637,1720911691,1720911691.534387,-18000,EB445137-D7F5-57EC-87DA-1DB460D64046,"iPhone13,2"
com.doordash.dasher,16,1720911615,1720911631,1720911631.0672522,-18000,EB445137-D7F5-57EC-87DA-1DB460D64046,"iPhone13,2"
com.apple.news,5,1720911610,1720911615,1720911615.972219,-18000,EB445137-D7F5-57EC-87DA-1DB460D64046,"iPhone13,2"
com.apple.news,18,1720911277,1720911295,1720911295.40282,-18000,EB445137-D7F5-57EC-87DA-1DB460D64046,"iPhone13,2"
com.apple.news,10,1720911266,1720911276,1720911277.099283,-18000,EB445137-D7F5-57EC-87DA-1DB460D64046,"iPhone13,2"
com.thestorygraph.thestorygraph,99,1720911164,1720911263,1720911263.228047,-18000,EB445137-D7F5-57EC-87DA-1DB460D64046,"iPhone13,2"
com.apple.news,152,1720911009,1720911161,1720911161.8762078,-18000,EB445137-D7F5-57EC-87DA-1DB460D64046,"iPhone13,2"
com.thestorygraph.thestorygraph,236,1720910767,1720911003,1720911003.875423,-18000,EB445137-D7F5-57EC-87DA-1DB460D64046,"iPhone13,2"
com.apple.Maps,23,1720910740,1720910763,1720910763.242276,-18000,EB445137-D7F5-57EC-87DA-1DB460D64046,"iPhone13,2"
com.apple.MobileSMS,6,1720910732,1720910738,1720910738.481067,-18000,EB445137-D7F5-57EC-87DA-1DB460D64046,"iPhone13,2"
com.apple.MobileSMS,5,1720907707,1720907712,1720907713.089483,-18000,EB445137-D7F5-57EC-87DA-1DB460D64046,"iPhone13,2"
com.apple.reminders,5,1720907701,1720907706,1720907706.398707,-18000,EB445137-D7F5-57EC-87DA-1DB460D64046,"iPhone13,2"
com.hammerandchisel.discord,9,1720907676,1720907685,1720907685.179533,-18000,EB445137-D7F5-57EC-87DA-1DB460D64046,"iPhone13,2"
Astrospheric.Astrospheric,15,1720907661,1720907676,1720907676.793917,-18000,EB445137-D7F5-57EC-87DA-1DB460D64046,"iPhone13,2"
Astrospheric.Astrospheric,10,1720906442,1720906452,1720906452.458987,-18000,EB445137-D7F5-57EC-87DA-1DB460D64046,"iPhone13,2"
Astrospheric.Astrospheric,7,1720906404,1720906411,1720906411.2966142,-18000,EB445137-D7F5-57EC-87DA-1DB460D64046,"iPhone13,2"
com.apple.weather,5,1720906399,1720906404,1720906404.520259,-18000,EB445137-D7F5-57EC-87DA-1DB460D64046,"iPhone13,2"
com.apple.MobileSMS,2,1720904014,1720904016,1720904016.7780108,-18000,EB445137-D7F5-57EC-87DA-1DB460D64046,"iPhone13,2"
com.google.ios.youtube,700,1720903311,1720904011,1720904011.734509,-18000,EB445137-D7F5-57EC-87DA-1DB460D64046,"iPhone13,2"
com.apple.findmy,3,1720903306,1720903309,1720903309.64188,-18000,EB445137-D7F5-57EC-87DA-1DB460D64046,"iPhone13,2"
com.apple.findmy,10,1720903257,1720903267,1720903267.74071,-18000,EB445137-D7F5-57EC-87DA-1DB460D64046,"iPhone13,2"
com.apple.findmy,12,1720902625,1720902637,1720902637.219212,-18000,EB445137-D7F5-57EC-87DA-1DB460D64046,"iPhone13,2"
com.google.Chrome,2368,1720900880,1720903248,1720903248.289075,-18000,,
com.doordash.dasher,63,1720900807,1720900870,1720900871.009809,-18000,EB445137-D7F5-57EC-87DA-1DB460D64046,"iPhone13,2"
com.apple.findmy,5,1720900705,1720900710,1720900710.589147,-18000,EB445137-D7F5-57EC-87DA-1DB460D64046,"iPhone13,2"
com.google.ios.youtube,17,1720900683,1720900700,1720900700.70856,-18000,EB445137-D7F5-57EC-87DA-1DB460D64046,"iPhone13,2"
com.google.ios.youtube,5,1720900255,1720900260,1720900260.487804,-18000,EB445137-D7F5-57EC-87DA-1DB460D64046,"iPhone13,2"
com.google.Chrome,318,1720900224,1720900542,1720900542.469166,-18000,,
com.google.ios.youtube,5,1720898680,1720898685,1720898685.1730661,-18000,EB445137-D7F5-57EC-87DA-1DB460D64046,"iPhone13,2"
com.google.Chrome,1260,1720898560,1720899820,1720899820.745003,-18000,,
com.google.ios.youtube,753,1720897795,1720898548,1720898548.261565,-18000,EB445137-D7F5-57EC-87DA-1DB460D64046,"iPhone13,2"
com.myfitnesspal.mfp,72,1720897703,1720897775,1720897775.916782,-18000,EB445137-D7F5-57EC-87DA-1DB460D64046,"iPhone13,2"
com.apple.MobileSMS,5,1720897697,1720897702,1720897702.762624,-18000,EB445137-D7F5-57EC-87DA-1DB460D64046,"iPhone13,2"
com.apple.MobileSMS,3,1720897694,1720897697,1720897697.495792,-18000,EB445137-D7F5-57EC-87DA-1DB460D64046,"iPhone13,2"
com.google.chrome.ios,8,1720897686,1720897694,1720897694.668479,-18000,EB445137-D7F5-57EC-87DA-1DB460D64046,"iPhone13,2"
com.google.chrome.ios,10,1720897265,1720897275,1720897275.4799418,-18000,EB445137-D7F5-57EC-87DA-1DB460D64046,"iPhone13,2"
com.google.chrome.ios,10,1720896045,1720896055,1720896055.718307,-18000,EB445137-D7F5-57EC-87DA-1DB460D64046,"iPhone13,2"
com.google.chrome.ios,11,1720895929,1720895940,1720895940.465993,-18000,EB445137-D7F5-57EC-87DA-1DB460D64046,"iPhone13,2"
com.google.Chrome,229,1720895907,1720896136,1720896136.7554998,-18000,,
com.google.chrome.ios,8,1720895549,1720895557,1720895557.7326941,-18000,EB445137-D7F5-57EC-87DA-1DB460D64046,"iPhone13,2"
com.apple.camera,1,1720895549,1720895550,1720895550.417574,-18000,EB445137-D7F5-57EC-87DA-1DB460D64046,"iPhone13,2"
com.google.chrome.ios,189,1720894720,1720894909,1720894909.315069,-18000,EB445137-D7F5-57EC-87DA-1DB460D64046,"iPhone13,2"
com.apple.findmy,2,1720894718,1720894720,1720894720.994865,-18000,EB445137-D7F5-57EC-87DA-1DB460D64046,"iPhone13,2"
com.apple.findmy,10,1720894487,1720894497,1720894497.2042131,-18000,EB445137-D7F5-57EC-87DA-1DB460D64046,"iPhone13,2"
com.google.chrome.ios,2,1720894485,1720894487,1720894487.4728231,-18000,EB445137-D7F5-57EC-87DA-1DB460D64046,"iPhone13,2"
com.google.chrome.ios,26,1720893803,1720893829,1720893829.025872,-18000,EB445137-D7F5-57EC-87DA-1DB460D64046,"iPhone13,2"
com.google.chrome.ios,199,1720893500,1720893699,1720893699.463351,-18000,EB445137-D7F5-57EC-87DA-1DB460D64046,"iPhone13,2"
com.apple.Maps,1548,1720892976,1720894524,1720894525.075643,-18000,EB445137-D7F5-57EC-87DA-1DB460D64046,"iPhone13,2"
com.google.chrome.ios,39,1720892572,1720892611,1720892611.796951,-18000,EB445137-D7F5-57EC-87DA-1DB460D64046,"iPhone13,2"
com.apple.MobileSMS,2,1720892567,1720892569,1720892570.006979,-18000,EB445137-D7F5-57EC-87DA-1DB460D64046,"iPhone13,2"
com.apple.mobileslideshow,8,1720892559,1720892567,1720892567.230637,-18000,EB445137-D7F5-57EC-87DA-1DB460D64046,"iPhone13,2"
com.apple.mobileslideshow,5,1720891057,1720891062,1720891062.768508,-18000,EB445137-D7F5-57EC-87DA-1DB460D64046,"iPhone13,2"
com.apple.mobileslideshow,34,1720887788,1720887822,1720887822.815357,-18000,EB445137-D7F5-57EC-87DA-1DB460D64046,"iPhone13,2"
com.apple.mobileslideshow,27,1720881834,1720881861,1720881862.068046,-18000,EB445137-D7F5-57EC-87DA-1DB460D64046,"iPhone13,2"
com.apple.MobileSMS,2,1720881829,1720881831,1720881831.3516989,-18000,EB445137-D7F5-57EC-87DA-1DB460D64046,"iPhone13,2"
com.apple.MobileSMS,10,1720881612,1720881622,1720881622.823512,-18000,EB445137-D7F5-57EC-87DA-1DB460D64046,"iPhone13,2"
com.apple.MobileSMS,4,1720881606,1720881610,1720881610.9713712,-18000,EB445137-D7F5-57EC-87DA-1DB460D64046,"iPhone13,2"
com.apple.Maps,488,1720880788,1720881276,1720881276.5343518,-18000,EB445137-D7F5-57EC-87DA-1DB460D64046,"iPhone13,2"
com.apple.MobileSMS,17,1720879336,1720879353,1720879354.600544,-18000,EB445137-D7F5-57EC-87DA-1DB460D64046,"iPhone13,2"
com.apple.Maps,922,1720879334,1720880256,1720880256.7589722,-18000,EB445137-D7F5-57EC-87DA-1DB460D64046,"iPhone13,2"
com.apple.MobileSMS,4,1720879330,1720879334,1720879338.9000459,-18000,EB445137-D7F5-57EC-87DA-1DB460D64046,"iPhone13,2"
com.apple.Health,34,1720879129,1720879163,1720879163.348031,-18000,EB445137-D7F5-57EC-87DA-1DB460D64046,"iPhone13,2"
com.google.Chrome,14,1720878845,1720878859,1720878859.9167562,-18000,,
com.apple.Photos,8,1720878837,1720878845,1720878845.631227,-18000,,
com.google.Chrome,15,1720878822,1720878837,1720878837.841806,-18000,,
com.apple.news,111,1720878459,1720878570,1720878570.2573109,-18000,EB445137-D7F5-57EC-87DA-1DB460D64046,"iPhone13,2"
com.apple.findmy,10,1720878332,1720878342,1720878342.240077,-18000,EB445137-D7F5-57EC-87DA-1DB460D64046,"iPhone13,2"
com.apple.Preferences,56,1720878256,1720878312,1720878312.288441,-18000,EB445137-D7F5-57EC-87DA-1DB460D64046,"iPhone13,2"
com.apple.MobileSMS,36,1720878187,1720878223,1720878223.2758179,-18000,EB445137-D7F5-57EC-87DA-1DB460D64046,"iPhone13,2"
com.apple.Health,58,1720846917,1720846975,1720846975.723963,-18000,EB445137-D7F5-57EC-87DA-1DB460D64046,"iPhone13,2"
com.apple.journal,1210,1720845703,1720846913,1720846913.148192,-18000,EB445137-D7F5-57EC-87DA-1DB460D64046,"iPhone13,2"
com.google.Chrome,485,1720845185,1720845670,1720845670.424022,-18000,,
doordash.DoorDashConsumer,62,1720839265,1720839327,1720839327.781499,-18000,EB445137-D7F5-57EC-87DA-1DB460D64046,"iPhone13,2"
doordash.DoorDashConsumer,180,1720836142,1720836322,1720836322.436048,-18000,EB445137-D7F5-57EC-87DA-1DB460D64046,"iPhone13,2"
com.apple.AppStore,29,1720836050,1720836079,1720836079.974028,-18000,EB445137-D7F5-57EC-87DA-1DB460D64046,"iPhone13,2"
com.thestorygraph.thestorygraph,3,1720836037,1720836040,1720836040.8348742,-18000,EB445137-D7F5-57EC-87DA-1DB460D64046,"iPhone13,2"
com.thestorygraph.thestorygraph,2,1720835925,1720835927,1720835927.378186,-18000,EB445137-D7F5-57EC-87DA-1DB460D64046,"iPhone13,2"
com.thestorygraph.thestorygraph,23,1720835852,1720835875,1720835876.4284658,-18000,EB445137-D7F5-57EC-87DA-1DB460D64046,"iPhone13,2"
com.apple.findmy,6,1720835846,1720835852,1720835852.477769,-18000,EB445137-D7F5-57EC-87DA-1DB460D64046,"iPhone13,2"
com.apple.findmy,7,1720835532,1720835539,1720835539.9955502,-18000,EB445137-D7F5-57EC-87DA-1DB460D64046,"iPhone13,2"
com.myfitnesspal.mfp,14,1720835518,1720835532,1720835532.720213,-18000,EB445137-D7F5-57EC-87DA-1DB460D64046,"iPhone13,2"
com.doordash.dasher,12,1720835486,1720835498,1720835498.701252,-18000,EB445137-D7F5-57EC-87DA-1DB460D64046,"iPhone13,2"
com.google.Gmail,69,1720835417,1720835486,1720835486.2204242,-18000,EB445137-D7F5-57EC-87DA-1DB460D64046,"iPhone13,2"
com.google.Chrome,2020,1720833480,1720835500,1720835500.5646691,-18000,,
com.apple.Photos,60,1720833420,1720833480,1720833480.764564,-18000,,
com.google.Chrome,343,1720833077,1720833420,1720833420.362152,-18000,,
com.apple.calculator,37,1720833040,1720833077,1720833077.861012,-18000,,
com.google.Chrome,437,1720832603,1720833040,1720833040.584369,-18000,,
com.apple.Photos,0,1720832451,1720832451,1720832451.9425092,-18000,,
com.google.Chrome,2,1720832449,1720832451,1720832451.074373,-18000,,
com.apple.weather,14,1720832430,1720832444,1720832444.977048,-18000,EB445137-D7F5-57EC-87DA-1DB460D64046,"iPhone13,2"
com.apple.weather,8,1720832420,1720832428,1720832428.870175,-18000,EB445137-D7F5-57EC-87DA-1DB460D64046,"iPhone13,2"
com.apple.Photos,39,1720832410,1720832449,1720832449.18324,-18000,,
com.google.Chrome,7,1720832403,1720832410,1720832410.779832,-18000,,
com.google.Chrome,0,1720831882,1720831882,1720831882.7569041,-18000,,
com.google.Chrome,303,1720831568,1720831871,1720831871.230795,-18000,,
com.apple.finder,7,1720831561,1720831568,1720831568.829866,-18000,,
com.google.Chrome,6,1720831555,1720831561,1720831561.243254,-18000,,
com.google.android.studio,458,1720831097,1720831555,1720831555.099379,-18000,,
com.apple.dt.Xcode,47,1720831050,1720831097,1720831097.8930922,-18000,,
com.google.android.studio,103,1720830947,1720831050,1720831050.621721,-18000,,
com.apple.dt.Xcode,1,1720830946,1720830947,1720830947.757132,-18000,,
com.google.android.studio,91,1720830855,1720830946,1720830946.697937,-18000,,
com.apple.dt.Xcode,17,1720830838,1720830855,1720830855.115706,-18000,,
com.google.android.studio,147,1720830691,1720830838,1720830838.519981,-18000,,
com.google.Chrome,3,1720830595,1720830598,1720830598.990371,-18000,,
com.google.android.studio,10,1720830585,1720830595,1720830595.522826,-18000,,
com.google.Chrome,7,1720830578,1720830585,1720830585.357719,-18000,,
com.google.android.studio,39,1720830539,1720830578,1720830579.0481281,-18000,,
com.google.Chrome,83,1720830456,1720830539,1720830539.356336,-18000,,
com.google.android.studio,40,1720830416,1720830456,1720830456.6165419,-18000,,
com.google.Chrome,59,1720830357,1720830416,1720830416.341337,-18000,,
com.google.android.studio,16,1720830341,1720830357,1720830357.6581678,-18000,,
com.google.Chrome,37,1720830304,1720830341,1720830341.441824,-18000,,
com.google.android.studio,8,1720830296,1720830304,1720830304.260175,-18000,,
com.google.Chrome,3,1720830293,1720830296,1720830296.067797,-18000,,
com.google.android.studio,18,1720830275,1720830293,1720830293.786896,-18000,,
com.google.Chrome,4,1720830271,1720830275,1720830275.737984,-18000,,
com.google.android.studio,6,1720830265,1720830271,1720830271.9643412,-18000,,
com.google.Chrome,48,1720830217,1720830265,1720830265.248842,-18000,,
com.google.android.studio,8,1720830209,1720830217,1720830218.019625,-18000,,
com.google.Chrome,23,1720830186,1720830209,1720830210.0301728,-18000,,
com.google.android.studio,46,1720830140,1720830186,1720830186.073472,-18000,,
com.google.Chrome,2,1720830138,1720830140,1720830140.076891,-18000,,
com.google.android.studio,8,1720830130,1720830138,1720830138.831476,-18000,,
com.google.Chrome,51,1720830079,1720830130,1720830130.734267,-18000,,
com.google.android.studio,36,1720830043,1720830079,1720830079.097429,-18000,,
com.apple.dt.Xcode,2,1720830041,1720830043,1720830043.69026,-18000,,
com.google.android.studio,22,1720830019,1720830041,1720830041.1431699,-18000,,
com.apple.dt.Xcode,4,1720830015,1720830019,1720830019.213073,-18000,,
com.google.android.studio,7,1720830008,1720830015,1720830015.110599,-18000,,
com.apple.dt.Xcode,7,1720830001,1720830008,1720830008.776628,-18000,,
com.google.android.studio,17,1720829984,1720830001,1720830001.188888,-18000,,
com.apple.dt.Xcode,3,1720829981,1720829984,1720829984.431219,-18000,,
com.google.android.studio,14,1720829967,1720829981,1720829981.85131,-18000,,
com.apple.dt.Xcode,1,1720829966,1720829967,1720829967.920475,-18000,,
com.google.android.studio,40,1720829926,1720829966,1720829966.628022,-18000,,
com.apple.dt.Xcode,1,1720829925,1720829926,1720829926.863072,-18000,,
com.google.android.studio,8,1720829917,1720829925,1720829925.783819,-18000,,
com.apple.dt.Xcode,40,1720829877,1720829917,1720829917.62293,-18000,,
com.google.android.studio,183,1720829694,1720829877,1720829877.433803,-18000,,
com.apple.finder,1,1720829693,1720829694,1720829694.6433458,-18000,,
com.google.Chrome,18,1720829675,1720829693,1720829693.429216,-18000,,
com.apple.finder,1,1720829674,1720829675,1720829675.128542,-18000,,
com.google.android.studio,18,1720829656,1720829674,1720829674.357238,-18000,,
com.apple.finder,1,1720829655,1720829656,1720829656.354614,-18000,,
com.google.Chrome,60,1720829595,1720829655,1720829655.339833,-18000,,
com.apple.finder,3,1720829592,1720829595,1720829595.51691,-18000,,
com.google.android.studio,2,1720829590,1720829592,1720829592.408575,-18000,,
com.apple.finder,8,1720829582,1720829590,1720829590.535846,-18000,,
com.google.android.studio,2,1720829580,1720829582,1720829582.903583,-18000,,
com.apple.finder,8,1720829572,1720829580,1720829580.2610059,-18000,,
com.google.android.studio,4,1720829568,1720829572,1720829572.411892,-18000,,
com.apple.finder,5,1720829563,1720829568,1720829568.3705091,-18000,,
com.google.android.studio,12,1720829551,1720829563,1720829563.480406,-18000,,
com.apple.finder,32,1720829519,1720829551,1720829551.814039,-18000,,
com.google.android.studio,36,1720829483,1720829519,1720829519.8313298,-18000,,
com.apple.finder,29,1720829454,1720829483,1720829483.7858691,-18000,,
com.google.android.studio,74,1720829380,1720829454,1720829454.529976,-18000,,
com.apple.finder,10,1720829370,1720829380,1720829380.238213,-18000,,
com.apple.Photos,1,1720829369,1720829370,1720829370.599236,-18000,,
com.google.Chrome,89,1720829280,1720829369,1720829369.611078,-18000,,
com.google.Chrome,258,1720823228,1720823486,1720823487.101118,-18000,,
com.google.Chrome,487,1720822738,1720823225,1720823225.069926,-18000,,
com.google.Chrome,650,1720822063,1720822713,1720822713.2715092,-18000,,
com.google.Chrome,318,1720821585,1720821903,1720821903.912763,-18000,,
com.apple.MobileSMS,43,1720821542,1720821585,1720821585.734801,-18000,,
com.google.Chrome,231,1720821311,1720821542,1720821543.0237942,-18000,,
com.apple.Photos,9,1720821302,1720821311,1720821311.778531,-18000,,
com.google.Chrome,16,1720821286,1720821302,1720821302.538235,-18000,,
com.apple.Photos,2,1720821284,1720821286,1720821286.160983,-18000,,
com.google.Chrome,103,1720821181,1720821284,1720821284.052953,-18000,,
com.apple.MobileSMS,16,1720821165,1720821181,1720821181.758451,-18000,,
com.google.Chrome,2,1720821163,1720821165,1720821165.1429849,-18000,,
com.google.Chrome,18,1720817967,1720817985,1720817985.377081,-18000,,
com.apple.MobileSMS,291,1720817676,1720817967,1720817967.3052201,-18000,,
com.google.Chrome,43,1720817633,1720817676,1720817676.0518188,-18000,,
com.google.Chrome,333,1720817084,1720817417,1720817417.705873,-18000,,
com.apple.MobileSMS,108,1720816976,1720817084,1720817084.096439,-18000,,
com.google.Chrome,149,1720816827,1720816976,1720816976.898875,-18000,,
com.apple.findmy,7,1720816820,1720816827,1720816827.443118,-18000,,
com.google.Chrome,17,1720816803,1720816820,1720816820.2873511,-18000,,
com.google.Chrome,840,1720815950,1720816790,1720816790.706211,-18000,,
com.apple.MobileSMS,9,1720815941,1720815950,1720815950.272583,-18000,,
com.google.Chrome,98,1720815843,1720815941,1720815941.4675221,-18000,,
com.google.Chrome,236,1720814236,1720814472,1720814472.370213,-18000,,
com.google.Chrome,909,1720813200,1720814109,1720814109.87329,-18000,,
com.apple.MobileSMS,20,1720813180,1720813200,1720813200.688096,-18000,,
com.google.Chrome,7,1720813173,1720813180,1720813180.854504,-18000,,
com.apple.MobileSMS,6,1720808253,1720808259,1720808259.460876,-18000,EB445137-D7F5-57EC-87DA-1DB460D64046,"iPhone13,2"
com.apple.MobileSMS,32,1720808220,1720808252,1720808252.434336,-18000,EB445137-D7F5-57EC-87DA-1DB460D64046,"iPhone13,2"
com.apple.MobileSMS,4,1720808216,1720808220,1720808220.1068559,-18000,EB445137-D7F5-57EC-87DA-1DB460D64046,"iPhone13,2"
com.apple.MobileSMS,11,1720808193,1720808204,1720808204.007175,-18000,EB445137-D7F5-57EC-87DA-1DB460D64046,"iPhone13,2"
com.apple.MobileSMS,4,1720808162,1720808166,1720808166.118403,-18000,EB445137-D7F5-57EC-87DA-1DB460D64046,"iPhone13,2"
com.google.chrome.ios,2,1720808160,1720808162,1720808162.5932,-18000,EB445137-D7F5-57EC-87DA-1DB460D64046,"iPhone13,2"
com.apple.InCallService,0,1720808160,1720808160,1720808160.929888,-18000,EB445137-D7F5-57EC-87DA-1DB460D64046,"iPhone13,2"
com.apple.InCallService,35,1720808042,1720808077,1720808077.982164,-18000,EB445137-D7F5-57EC-87DA-1DB460D64046,"iPhone13,2"
com.google.chrome.ios,16,1720808026,1720808042,1720808042.495276,-18000,EB445137-D7F5-57EC-87DA-1DB460D64046,"iPhone13,2"
com.apple.mobilenotes,82,1720807943,1720808025,1720808025.854969,-18000,EB445137-D7F5-57EC-87DA-1DB460D64046,"iPhone13,2"
com.apple.MobileSMS,2,1720807940,1720807942,1720807942.489492,-18000,EB445137-D7F5-57EC-87DA-1DB460D64046,"iPhone13,2"
com.doordash.dasher,1,1720807938,1720807939,1720807940.0990338,-18000,EB445137-D7F5-57EC-87DA-1DB460D64046,"iPhone13,2"
com.doordash.dasher,7,1720807925,1720807932,1720807932.9476829,-18000,EB445137-D7F5-57EC-87DA-1DB460D64046,"iPhone13,2"
com.doordash.dasher,64,1720807624,1720807688,1720807688.650239,-18000,EB445137-D7F5-57EC-87DA-1DB460D64046,"iPhone13,2"
com.google.chrome.ios,158,1720807466,1720807624,1720807625.058013,-18000,EB445137-D7F5-57EC-87DA-1DB460D64046,"iPhone13,2"
com.apple.MobileSMS,4,1720807462,1720807466,1720807466.303339,-18000,EB445137-D7F5-57EC-87DA-1DB460D64046,"iPhone13,2"
com.doordash.dasher,225,1720807236,1720807461,1720807461.5169802,-18000,EB445137-D7F5-57EC-87DA-1DB460D64046,"iPhone13,2"
com.doordash.dasher,69,1720807049,1720807118,1720807118.5004392,-18000,EB445137-D7F5-57EC-87DA-1DB460D64046,"iPhone13,2"
com.doordash.dasher,10,1720807024,1720807034,1720807034.80373,-18000,EB445137-D7F5-57EC-87DA-1DB460D64046,"iPhone13,2"
com.doordash.dasher,69,1720806938,1720807007,1720807007.262305,-18000,EB445137-D7F5-57EC-87DA-1DB460D64046,"iPhone13,2"
com.doordash.dasher,1146,1720805614,1720806760,1720806760.866794,-18000,EB445137-D7F5-57EC-87DA-1DB460D64046,"iPhone13,2"
com.doordash.dasher,849,1720804755,1720805604,1720805604.1871672,-18000,EB445137-D7F5-57EC-87DA-1DB460D64046,"iPhone13,2"
com.doordash.dasher,187,1720804565,1720804752,1720804752.686277,-18000,EB445137-D7F5-57EC-87DA-1DB460D64046,"iPhone13,2"
com.doordash.dasher,294,1720804240,1720804534,1720804534.086698,-18000,EB445137-D7F5-57EC-87DA-1DB460D64046,"iPhone13,2"
com.doordash.dasher,92,1720804144,1720804236,1720804236.049851,-18000,EB445137-D7F5-57EC-87DA-1DB460D64046,"iPhone13,2"
com.apple.podcasts,40,1720804104,1720804144,1720804144.853736,-18000,EB445137-D7F5-57EC-87DA-1DB460D64046,"iPhone13,2"
com.doordash.dasher,244,1720803860,1720804104,1720804104.790451,-18000,EB445137-D7F5-57EC-87DA-1DB460D64046,"iPhone13,2"
com.apple.InCallService,24,1720803836,1720803860,1720803860.77274,-18000,EB445137-D7F5-57EC-87DA-1DB460D64046,"iPhone13,2"
com.doordash.dasher,1094,1720802742,1720803836,1720803837.112468,-18000,EB445137-D7F5-57EC-87DA-1DB460D64046,"iPhone13,2"
com.toyopagroup.picaboo,37,1720802705,1720802742,1720802742.9704618,-18000,EB445137-D7F5-57EC-87DA-1DB460D64046,"iPhone13,2"
com.apple.MobileSMS,10,1720802693,1720802703,1720802703.304033,-18000,EB445137-D7F5-57EC-87DA-1DB460D64046,"iPhone13,2"
com.doordash.dasher,71,1720802622,1720802693,1720802693.303059,-18000,EB445137-D7F5-57EC-87DA-1DB460D64046,"iPhone13,2"
com.doordash.dasher,130,1720802408,1720802538,1720802538.778325,-18000,EB445137-D7F5-57EC-87DA-1DB460D64046,"iPhone13,2"
com.doordash.dasher,1,1720802404,1720802405,1720802405.725119,-18000,EB445137-D7F5-57EC-87DA-1DB460D64046,"iPhone13,2"
com.doordash.dasher,2,1720802354,1720802356,1720802356.789363,-18000,EB445137-D7F5-57EC-87DA-1DB460D64046,"iPhone13,2"
com.apple.MobileSMS,22,1720802332,1720802354,1720802354.4431992,-18000,EB445137-D7F5-57EC-87DA-1DB460D64046,"iPhone13,2"
com.doordash.dasher,349,1720801979,1720802328,1720802328.804687,-18000,EB445137-D7F5-57EC-87DA-1DB460D64046,"iPhone13,2"
com.doordash.dasher,217,1720801757,1720801974,1720801974.2891889,-18000,EB445137-D7F5-57EC-87DA-1DB460D64046,"iPhone13,2"
com.doordash.dasher,1673,1720800073,1720801746,1720801746.383905,-18000,EB445137-D7F5-57EC-87DA-1DB460D64046,"iPhone13,2"
com.doordash.dasher,562,1720799507,1720800069,1720800070.07834,-18000,EB445137-D7F5-57EC-87DA-1DB460D64046,"iPhone13,2"
com.doordash.dasher,70,1720799417,1720799487,1720799487.565117,-18000,EB445137-D7F5-57EC-87DA-1DB460D64046,"iPhone13,2"
com.apple.podcasts,2,1720799415,1720799417,1720799417.2730489,-18000,EB445137-D7F5-57EC-87DA-1DB460D64046,"iPhone13,2"
com.apple.podcasts,75,1720799329,1720799404,1720799404.484721,-18000,EB445137-D7F5-57EC-87DA-1DB460D64046,"iPhone13,2"
com.doordash.dasher,17,1720799312,1720799329,1720799329.004406,-18000,EB445137-D7F5-57EC-87DA-1DB460D64046,"iPhone13,2"
com.apple.podcasts,66,1720799246,1720799312,1720799312.600946,-18000,EB445137-D7F5-57EC-87DA-1DB460D64046,"iPhone13,2"
com.doordash.dasher,697,1720798545,1720799242,1720799242.350366,-18000,EB445137-D7F5-57EC-87DA-1DB460D64046,"iPhone13,2"
com.apple.MobileSMS,10,1720798535,1720798545,1720798546.116547,-18000,EB445137-D7F5-57EC-87DA-1DB460D64046,"iPhone13,2"
com.doordash.dasher,30,1720798505,1720798535,1720798535.894928,-18000,EB445137-D7F5-57EC-87DA-1DB460D64046,"iPhone13,2"
com.apple.Health,7,1720798497,1720798504,1720798504.113244,-18000,EB445137-D7F5-57EC-87DA-1DB460D64046,"iPhone13,2"
com.apple.Health,49,1720798359,1720798408,1720798408.5398278,-18000,EB445137-D7F5-57EC-87DA-1DB460D64046,"iPhone13,2"
com.apple.reminders,11,1720798341,1720798352,1720798352.417999,-18000,EB445137-D7F5-57EC-87DA-1DB460D64046,"iPhone13,2"
com.apple.Music,3,1720798338,1720798341,1720798342.1623359,-18000,EB445137-D7F5-57EC-87DA-1DB460D64046,"iPhone13,2"
com.apple.Music,9,1720798126,1720798135,1720798136.5970712,-18000,EB445137-D7F5-57EC-87DA-1DB460D64046,"iPhone13,2"
com.apple.MobileSMS,3,1720798123,1720798126,1720798126.973878,-18000,EB445137-D7F5-57EC-87DA-1DB460D64046,"iPhone13,2"
com.google.Chrome,18,1720797821,1720797839,1720797839.55526,-18000,,
com.apple.printcenter,209,1720797612,1720797821,1720797821.75456,-18000,,
com.google.Chrome,9,1720797578,1720797587,1720797587.961693,-18000,,
com.google.Chrome,327,1720796960,1720797287,1720797287.94927,-18000,,
com.apple.calculator,109,1720796851,1720796960,1720796960.706568,-18000,,
com.google.Chrome,2,1720796849,1720796851,1720796851.045329,-18000,,
com.apple.calculator,4,1720796845,1720796849,1720796850.051309,-18000,,
com.robinhood.release.Robinhood,186,1720796763,1720796949,1720796949.904357,-18000,EB445137-D7F5-57EC-87DA-1DB460D64046,"iPhone13,2"
com.truebill.truebillnative,3,1720796756,1720796759,1720796759.9289432,-18000,EB445137-D7F5-57EC-87DA-1DB460D64046,"iPhone13,2"
com.google.Chrome,137,1720796708,1720796845,1720796845.526608,-18000,,
com.apple.calculator,0,1720796708,1720796708,1720796708.69594,-18000,,
com.google.Chrome,2,1720796706,1720796708,1720796708.162718,-18000,,
com.apple.calculator,1,1720796705,1720796706,1720796707.0556989,-18000,,
com.truebill.truebillnative,10,1720796686,1720796696,1720796696.6330929,-18000,EB445137-D7F5-57EC-87DA-1DB460D64046,"iPhone13,2"
com.google.Chrome,69,1720796636,1720796705,1720796705.157339,-18000,,
com.apple.systempreferences,2,1720796634,1720796636,1720796636.6098309,-18000,,
com.google.Chrome,16,1720796612,1720796628,1720796628.2725592,-18000,,
com.apple.calculator,4,1720796608,1720796612,1720796613.0623732,-18000,,
com.google.Chrome,2,1720796606,1720796608,1720796608.883657,-18000,,
com.apple.calculator,4,1720796602,1720796606,1720796606.713547,-18000,,
com.google.Chrome,1,1720796601,1720796602,1720796602.393089,-18000,,
com.apple.calculator,5,1720796596,1720796601,1720796601.104505,-18000,,
com.truebill.truebillnative,117,1720796508,1720796625,1720796625.718752,-18000,EB445137-D7F5-57EC-87DA-1DB460D64046,"iPhone13,2"
com.truebill.truebillnative,71,1720796433,1720796504,1720796504.173636,-18000,EB445137-D7F5-57EC-87DA-1DB460D64046,"iPhone13,2"
com.apple.news,2,1720796431,1720796433,1720796433.4636002,-18000,EB445137-D7F5-57EC-87DA-1DB460D64046,"iPhone13,2"
com.apple.news,2,1720796412,1720796414,1720796414.6312342,-18000,EB445137-D7F5-57EC-87DA-1DB460D64046,"iPhone13,2"
com.google.Chrome,200,1720796396,1720796596,1720796596.238562,-18000,,
com.apple.camera,25,1720796303,1720796328,1720796330.773181,-18000,EB445137-D7F5-57EC-87DA-1DB460D64046,"iPhone13,2"
com.apple.news,26,1720796302,1720796328,1720796330.814717,-18000,EB445137-D7F5-57EC-87DA-1DB460D64046,"iPhone13,2"
com.apple.news,0,1720796292,1720796292,1720796292.798728,-18000,EB445137-D7F5-57EC-87DA-1DB460D64046,"iPhone13,2"
com.apple.findmy,0,1720796282,1720796282,1720796282.2801409,-18000,EB445137-D7F5-57EC-87DA-1DB460D64046,"iPhone13,2"
com.apple.findmy,9,1720795021,1720795030,1720795030.086148,-18000,EB445137-D7F5-57EC-87DA-1DB460D64046,"iPhone13,2"
com.apple.findmy,7,1720795009,1720795016,1720795016.9609919,-18000,EB445137-D7F5-57EC-87DA-1DB460D64046,"iPhone13,2"
com.muscleforlife.Stacked,25,1720794167,1720794192,1720794192.572197,-18000,EB445137-D7F5-57EC-87DA-1DB460D64046,"iPhone13,2"
com.muscleforlife.Stacked,43,1720794078,1720794121,1720794121.493637,-18000,EB445137-D7F5-57EC-87DA-1DB460D64046,"iPhone13,2"
com.apple.findmy,7,1720794069,1720794076,1720794076.693307,-18000,EB445137-D7F5-57EC-87DA-1DB460D64046,"iPhone13,2"
com.muscleforlife.Stacked,3,1720794066,1720794069,1720794069.645094,-18000,EB445137-D7F5-57EC-87DA-1DB460D64046,"iPhone13,2"
com.muscleforlife.Stacked,53,1720794013,1720794066,1720794066.1267881,-18000,EB445137-D7F5-57EC-87DA-1DB460D64046,"iPhone13,2"
com.muscleforlife.Stacked,111,1720793865,1720793976,1720793976.6887078,-18000,EB445137-D7F5-57EC-87DA-1DB460D64046,"iPhone13,2"
com.muscleforlife.Stacked,3,1720793798,1720793801,1720793801.6007771,-18000,EB445137-D7F5-57EC-87DA-1DB460D64046,"iPhone13,2"
com.muscleforlife.Stacked,18,1720793779,1720793797,1720793797.750691,-18000,EB445137-D7F5-57EC-87DA-1DB460D64046,"iPhone13,2"
com.muscleforlife.Stacked,108,1720793631,1720793739,1720793739.88955,-18000,EB445137-D7F5-57EC-87DA-1DB460D64046,"iPhone13,2"
com.muscleforlife.Stacked,17,1720793569,1720793586,1720793586.104516,-18000,EB445137-D7F5-57EC-87DA-1DB460D64046,"iPhone13,2"
com.muscleforlife.Stacked,4,1720793550,1720793554,1720793554.242513,-18000,EB445137-D7F5-57EC-87DA-1DB460D64046,"iPhone13,2"
com.muscleforlife.Stacked,63,1720793477,1720793540,1720793540.9849439,-18000,EB445137-D7F5-57EC-87DA-1DB460D64046,"iPhone13,2"
com.muscleforlife.Stacked,7,1720793407,1720793414,1720793414.2545671,-18000,EB445137-D7F5-57EC-87DA-1DB460D64046,"iPhone13,2"
com.muscleforlife.Stacked,5,1720793401,1720793406,1720793406.342154,-18000,EB445137-D7F5-57EC-87DA-1DB460D64046,"iPhone13,2"
com.muscleforlife.Stacked,8,1720793338,1720793346,1720793346.002884,-18000,EB445137-D7F5-57EC-87DA-1DB460D64046,"iPhone13,2"
com.muscleforlife.Stacked,18,1720793319,1720793337,1720793337.153306,-18000,EB445137-D7F5-57EC-87DA-1DB460D64046,"iPhone13,2"
com.muscleforlife.Stacked,117,1720793134,1720793251,1720793251.041497,-18000,EB445137-D7F5-57EC-87DA-1DB460D64046,"iPhone13,2"
com.muscleforlife.Stacked,112,1720792963,1720793075,1720793075.481192,-18000,EB445137-D7F5-57EC-87DA-1DB460D64046,"iPhone13,2"
com.muscleforlife.Stacked,6,1720792716,1720792722,1720792722.840502,-18000,EB445137-D7F5-57EC-87DA-1DB460D64046,"iPhone13,2"
com.muscleforlife.Stacked,18,1720792573,1720792591,1720792591.302942,-18000,EB445137-D7F5-57EC-87DA-1DB460D64046,"iPhone13,2"
com.apple.Music,3,1720792558,1720792561,1720792561.762399,-18000,EB445137-D7F5-57EC-87DA-1DB460D64046,"iPhone13,2"
com.apple.Music,15,1720791806,1720791821,1720791821.74829,-18000,EB445137-D7F5-57EC-87DA-1DB460D64046,"iPhone13,2"
com.apple.Music,21,1720791784,1720791805,1720791805.297398,-18000,EB445137-D7F5-57EC-87DA-1DB460D64046,"iPhone13,2"
com.apple.news,2,1720791780,1720791782,1720791782.590939,-18000,EB445137-D7F5-57EC-87DA-1DB460D64046,"iPhone13,2"
com.apple.news,645,1720791017,1720791662,1720791662.3599901,-18000,EB445137-D7F5-57EC-87DA-1DB460D64046,"iPhone13,2"
com.robinhood.release.Robinhood,8,1720790970,1720790978,1720790978.160139,-18000,EB445137-D7F5-57EC-87DA-1DB460D64046,"iPhone13,2"
com.robinhood.release.Robinhood,14,1720790789,1720790803,1720790803.477988,-18000,EB445137-D7F5-57EC-87DA-1DB460D64046,"iPhone13,2"
com.apple.news,31,1720790742,1720790773,1720790774.062609,-18000,EB445137-D7F5-57EC-87DA-1DB460D64046,"iPhone13,2"
com.apple.news,61,1720790650,1720790711,1720790712.27605,-18000,EB445137-D7F5-57EC-87DA-1DB460D64046,"iPhone13,2"
com.apple.Health,6,1720790630,1720790636,1720790636.443245,-18000,EB445137-D7F5-57EC-87DA-1DB460D64046,"iPhone13,2"
com.apple.Health,2,1720790627,1720790629,1720790629.536819,-18000,EB445137-D7F5-57EC-87DA-1DB460D64046,"iPhone13,2"
com.apple.Health,6,1720790404,1720790410,1720790410.471704,-18000,EB445137-D7F5-57EC-87DA-1DB460D64046,"iPhone13,2"
com.apple.Health,16,1720790375,1720790391,1720790391.731982,-18000,EB445137-D7F5-57EC-87DA-1DB460D64046,"iPhone13,2"
com.apple.reminders,3,1720790370,1720790373,1720790373.768235,-18000,EB445137-D7F5-57EC-87DA-1DB460D64046,"iPhone13,2"
com.toyopagroup.picaboo,13,1720757540,1720757553,1720757553.4372768,-18000,EB445137-D7F5-57EC-87DA-1DB460D64046,"iPhone13,2"
com.apple.camera,0,1720757537,1720757537,1720757537.6735,-18000,EB445137-D7F5-57EC-87DA-1DB460D64046,"iPhone13,2"
com.toyopagroup.picaboo,3,1720757534,1720757537,1720757537.6728458,-18000,EB445137-D7F5-57EC-87DA-1DB460D64046,"iPhone13,2"
com.toyopagroup.picaboo,5,1720756985,1720756990,1720756990.090064,-18000,EB445137-D7F5-57EC-87DA-1DB460D64046,"iPhone13,2"
com.google.Chrome,590,1720756916,1720757506,1720757507.06513,-18000,,
com.google.Chrome,555,1720756251,1720756806,1720756806.045587,-18000,,
com.toyopagroup.picaboo,41,1720755327,1720755368,1720755368.235311,-18000,EB445137-D7F5-57EC-87DA-1DB460D64046,"iPhone13,2"
com.google.Chrome,1349,1720754875,1720756224,1720756224.368767,-18000,,
com.google.chrome.ios,194,1720754681,1720754875,1720754875.21734,-18000,EB445137-D7F5-57EC-87DA-1DB460D64046,"iPhone13,2"
com.doordash.dasher,299,1720754382,1720754681,1720754681.3737411,-18000,EB445137-D7F5-57EC-87DA-1DB460D64046,"iPhone13,2"
com.apple.calculator,12,1720754370,1720754382,1720754382.372478,-18000,EB445137-D7F5-57EC-87DA-1DB460D64046,"iPhone13,2"
com.doordash.dasher,13,1720754357,1720754370,1720754371.048733,-18000,EB445137-D7F5-57EC-87DA-1DB460D64046,"iPhone13,2"
com.google.Chrome,559,1720754303,1720754862,1720754862.284751,-18000,,
com.google.Chrome,676,1720753045,1720753721,1720753721.796624,-18000,,
com.goodreads.Goodreads,37,1720752907,1720752944,1720752944.731832,-18000,EB445137-D7F5-57EC-87DA-1DB460D64046,"iPhone13,2"
com.thestorygraph.thestorygraph,82,1720752823,1720752905,1720752905.6247358,-18000,EB445137-D7F5-57EC-87DA-1DB460D64046,"iPhone13,2"
com.myfitnesspal.mfp,6,1720752817,1720752823,1720752823.063729,-18000,EB445137-D7F5-57EC-87DA-1DB460D64046,"iPhone13,2"
com.myfitnesspal.mfp,1,1720750564,1720750565,1720750566.2340178,-18000,EB445137-D7F5-57EC-87DA-1DB460D64046,"iPhone13,2"
com.myfitnesspal.mfp,53,1720750509,1720750562,1720750565.670646,-18000,EB445137-D7F5-57EC-87DA-1DB460D64046,"iPhone13,2"
com.google.ios.youtube,2,1720750507,1720750509,1720750509.7438989,-18000,EB445137-D7F5-57EC-87DA-1DB460D64046,"iPhone13,2"
com.google.ios.youtube,85,1720750367,1720750452,1720750452.833513,-18000,EB445137-D7F5-57EC-87DA-1DB460D64046,"iPhone13,2"
com.toyopagroup.picaboo,22,1720749988,1720750010,1720750010.935052,-18000,EB445137-D7F5-57EC-87DA-1DB460D64046,"iPhone13,2"
com.toyopagroup.picaboo,1,1720749987,1720749988,1720749988.194633,-18000,EB445137-D7F5-57EC-87DA-1DB460D64046,"iPhone13,2"
com.toyopagroup.picaboo,2,1720748859,1720748861,1720748861.051234,-18000,EB445137-D7F5-57EC-87DA-1DB460D64046,"iPhone13,2"
com.toyopagroup.picaboo,42,1720748739,1720748781,1720748781.3107,-18000,EB445137-D7F5-57EC-87DA-1DB460D64046,"iPhone13,2"
com.myfitnesspal.mfp,30,1720748709,1720748739,1720748739.555955,-18000,EB445137-D7F5-57EC-87DA-1DB460D64046,"iPhone13,2"
com.apple.Health,4,1720748705,1720748709,1720748709.702414,-18000,EB445137-D7F5-57EC-87DA-1DB460D64046,"iPhone13,2"
com.toyopagroup.picaboo,58,1720748646,1720748704,1720748704.9081101,-18000,EB445137-D7F5-57EC-87DA-1DB460D64046,"iPhone13,2"
com.Splitwise.SplitwiseMobile,39,1720748605,1720748644,1720748644.750126,-18000,EB445137-D7F5-57EC-87DA-1DB460D64046,"iPhone13,2"
com.google.Chrome,264,1720748563,1720748827,1720748827.674739,-18000,,
com.myfitnesspal.mfp,8,1720748514,1720748522,1720748522.452856,-18000,EB445137-D7F5-57EC-87DA-1DB460D64046,"iPhone13,2"
com.apple.news,3,1720748511,1720748514,1720748514.35146,-18000,EB445137-D7F5-57EC-87DA-1DB460D64046,"iPhone13,2"
com.apple.news,154,1720748288,1720748442,1720748442.342936,-18000,EB445137-D7F5-57EC-87DA-1DB460D64046,"iPhone13,2"
com.toyopagroup.picaboo,29,1720748251,1720748280,1720748280.23176,-18000,EB445137-D7F5-57EC-87DA-1DB460D64046,"iPhone13,2"
com.toyopagroup.picaboo,78,1720748132,1720748210,1720748210.9889,-18000,EB445137-D7F5-57EC-87DA-1DB460D64046,"iPhone13,2"
com.apple.MobileSMS,6,1720748123,1720748129,1720748129.8912668,-18000,EB445137-D7F5-57EC-87DA-1DB460D64046,"iPhone13,2"
com.myfitnesspal.mfp,25,1720748088,1720748113,1720748113.660357,-18000,EB445137-D7F5-57EC-87DA-1DB460D64046,"iPhone13,2"
com.apple.camera,1,1720747632,1720747633,1720747633.1670818,-18000,EB445137-D7F5-57EC-87DA-1DB460D64046,"iPhone13,2"
com.apple.camera,1,1720747616,1720747617,1720747617.3088431,-18000,EB445137-D7F5-57EC-87DA-1DB460D64046,"iPhone13,2"
com.doordash.dasher,372,1720747130,1720747502,1720747502.654879,-18000,EB445137-D7F5-57EC-87DA-1DB460D64046,"iPhone13,2"
com.apple.Music,6,1720747124,1720747130,1720747130.794845,-18000,EB445137-D7F5-57EC-87DA-1DB460D64046,"iPhone13,2"
com.apple.weather,3,1720747116,1720747119,1720747119.1983008,-18000,EB445137-D7F5-57EC-87DA-1DB460D64046,"iPhone13,2"
com.doordash.dasher,76,1720747040,1720747116,1720747116.469459,-18000,EB445137-D7F5-57EC-87DA-1DB460D64046,"iPhone13,2"
com.doordash.dasher,6,1720746958,1720746964,1720746964.308183,-18000,EB445137-D7F5-57EC-87DA-1DB460D64046,"iPhone13,2"
com.doordash.dasher,291,1720746666,1720746957,1720746957.599289,-18000,EB445137-D7F5-57EC-87DA-1DB460D64046,"iPhone13,2"
com.apple.weather,13,1720746650,1720746663,1720746663.869429,-18000,EB445137-D7F5-57EC-87DA-1DB460D64046,"iPhone13,2"
Astrospheric.Astrospheric,7,1720746643,1720746650,1720746650.990752,-18000,EB445137-D7F5-57EC-87DA-1DB460D64046,"iPhone13,2"
com.doordash.dasher,43,1720746599,1720746642,1720746642.2530909,-18000,EB445137-D7F5-57EC-87DA-1DB460D64046,"iPhone13,2"
com.doordash.dasher,438,1720746133,1720746571,1720746571.185847,-18000,EB445137-D7F5-57EC-87DA-1DB460D64046,"iPhone13,2"
com.doordash.dasher,329,1720745746,1720746075,1720746075.3662229,-18000,EB445137-D7F5-57EC-87DA-1DB460D64046,"iPhone13,2"
com.doordash.dasher,556,1720745125,1720745681,1720745681.98032,-18000,EB445137-D7F5-57EC-87DA-1DB460D64046,"iPhone13,2"
com.doordash.dasher,586,1720744515,1720745101,1720745101.838445,-18000,EB445137-D7F5-57EC-87DA-1DB460D64046,"iPhone13,2"
com.doordash.dasher,98,1720744415,1720744513,1720744513.235955,-18000,EB445137-D7F5-57EC-87DA-1DB460D64046,"iPhone13,2"
com.doordash.dasher,24,1720744375,1720744399,1720744399.057643,-18000,EB445137-D7F5-57EC-87DA-1DB460D64046,"iPhone13,2"
com.doordash.dasher,31,1720744332,1720744363,1720744363.203763,-18000,EB445137-D7F5-57EC-87DA-1DB460D64046,"iPhone13,2"
com.doordash.dasher,180,1720744137,1720744317,1720744317.5922241,-18000,EB445137-D7F5-57EC-87DA-1DB460D64046,"iPhone13,2"
com.doordash.dasher,5,1720744115,1720744120,1720744120.145309,-18000,EB445137-D7F5-57EC-87DA-1DB460D64046,"iPhone13,2"
com.apple.MobileSMS,2,1720744097,1720744099,1720744099.930536,-18000,EB445137-D7F5-57EC-87DA-1DB460D64046,"iPhone13,2"
com.toyopagroup.picaboo,19,1720744075,1720744094,1720744094.2305279,-18000,EB445137-D7F5-57EC-87DA-1DB460D64046,"iPhone13,2"
com.google.chrome.ios,5,1720744069,1720744074,1720744074.887504,-18000,EB445137-D7F5-57EC-87DA-1DB460D64046,"iPhone13,2"
com.apple.MobileSMS,8,1720744061,1720744069,1720744069.73341,-18000,EB445137-D7F5-57EC-87DA-1DB460D64046,"iPhone13,2"
com.google.chrome.ios,54,1720744007,1720744061,1720744061.378357,-18000,EB445137-D7F5-57EC-87DA-1DB460D64046,"iPhone13,2"
com.apple.camera,1,1720743985,1720743986,1720743986.374693,-18000,EB445137-D7F5-57EC-87DA-1DB460D64046,"iPhone13,2"
com.doordash.dasher,603,1720742959,1720743562,1720743562.22233,-18000,EB445137-D7F5-57EC-87DA-1DB460D64046,"iPhone13,2"
com.google.chrome.ios,31,1720742928,1720742959,1720742959.118573,-18000,EB445137-D7F5-57EC-87DA-1DB460D64046,"iPhone13,2"
com.apple.Preferences,7,1720742921,1720742928,1720742929.102512,-18000,EB445137-D7F5-57EC-87DA-1DB460D64046,"iPhone13,2"
com.doordash.dasher,8,1720742905,1720742913,1720742913.528512,-18000,EB445137-D7F5-57EC-87DA-1DB460D64046,"iPhone13,2"
com.google.chrome.ios,4,1720742901,1720742905,1720742905.294375,-18000,EB445137-D7F5-57EC-87DA-1DB460D64046,"iPhone13,2"
com.google.chrome.ios,5,1720742893,1720742898,1720742898.5567589,-18000,EB445137-D7F5-57EC-87DA-1DB460D64046,"iPhone13,2"
com.apple.MobileSMS,6,1720742887,1720742893,1720742893.431806,-18000,EB445137-D7F5-57EC-87DA-1DB460D64046,"iPhone13,2"
com.google.chrome.ios,13,1720742874,1720742887,1720742888.0183868,-18000,EB445137-D7F5-57EC-87DA-1DB460D64046,"iPhone13,2"
com.apple.MobileSMS,8,1720742866,1720742874,1720742874.784718,-18000,EB445137-D7F5-57EC-87DA-1DB460D64046,"iPhone13,2"
com.google.chrome.ios,6,1720742860,1720742866,1720742866.7185512,-18000,EB445137-D7F5-57EC-87DA-1DB460D64046,"iPhone13,2"
com.doordash.dasher,5,1720742855,1720742860,1720742860.783973,-18000,EB445137-D7F5-57EC-87DA-1DB460D64046,"iPhone13,2"
com.doordash.dasher,16,1720742819,1720742835,1720742835.173734,-18000,EB445137-D7F5-57EC-87DA-1DB460D64046,"iPhone13,2"
com.doordash.dasher,6,1720742801,1720742807,1720742807.761701,-18000,EB445137-D7F5-57EC-87DA-1DB460D64046,"iPhone13,2"
com.doordash.dasher,1,1720742784,1720742785,1720742785.730194,-18000,EB445137-D7F5-57EC-87DA-1DB460D64046,"iPhone13,2"
com.doordash.dasher,85,1720742678,1720742763,1720742763.252646,-18000,EB445137-D7F5-57EC-87DA-1DB460D64046,"iPhone13,2"
com.google.chrome.ios,9,1720742669,1720742678,1720742678.575901,-18000,EB445137-D7F5-57EC-87DA-1DB460D64046,"iPhone13,2"
com.apple.MobileSMS,7,1720742661,1720742668,1720742669.6632519,-18000,EB445137-D7F5-57EC-87DA-1DB460D64046,"iPhone13,2"
com.apple.MobileSMS,5,1720742656,1720742661,1720742661.0868402,-18000,EB445137-D7F5-57EC-87DA-1DB460D64046,"iPhone13,2"
com.doordash.dasher,376,1720742280,1720742656,1720742656.9968371,-18000,EB445137-D7F5-57EC-87DA-1DB460D64046,"iPhone13,2"
com.Splitwise.SplitwiseMobile,34,1720742246,1720742280,1720742280.7054172,-18000,EB445137-D7F5-57EC-87DA-1DB460D64046,"iPhone13,2"
com.doordash.dasher,5,1720742241,1720742246,1720742246.512765,-18000,EB445137-D7F5-57EC-87DA-1DB460D64046,"iPhone13,2"
com.google.chrome.ios,23,1720742218,1720742241,1720742242.144516,-18000,EB445137-D7F5-57EC-87DA-1DB460D64046,"iPhone13,2"
com.apple.Maps,25,1720742193,1720742218,1720742218.399877,-18000,EB445137-D7F5-57EC-87DA-1DB460D64046,"iPhone13,2"
com.doordash.dasher,27,1720742134,1720742161,1720742161.550107,-18000,EB445137-D7F5-57EC-87DA-1DB460D64046,"iPhone13,2"
com.apple.podcasts,35,1720742092,1720742127,1720742127.368602,-18000,EB445137-D7F5-57EC-87DA-1DB460D64046,"iPhone13,2"
com.apple.MobileSMS,21,1720742069,1720742090,1720742090.9359632,-18000,EB445137-D7F5-57EC-87DA-1DB460D64046,"iPhone13,2"
com.apple.MobileSMS,5,1720742064,1720742069,1720742069.3656878,-18000,EB445137-D7F5-57EC-87DA-1DB460D64046,"iPhone13,2"
com.doordash.dasher,37,1720742027,1720742064,1720742064.391873,-18000,EB445137-D7F5-57EC-87DA-1DB460D64046,"iPhone13,2"
com.apple.MobileSMS,4,1720742014,1720742018,1720742018.851815,-18000,EB445137-D7F5-57EC-87DA-1DB460D64046,"iPhone13,2"
com.apple.MobileSMS,23,1720741970,1720741993,1720741993.7294989,-18000,EB445137-D7F5-57EC-87DA-1DB460D64046,"iPhone13,2"
com.apple.findmy,2,1720741968,1720741970,1720741970.823989,-18000,EB445137-D7F5-57EC-87DA-1DB460D64046,"iPhone13,2"
com.apple.findmy,5,1720741843,1720741848,1720741848.2006211,-18000,EB445137-D7F5-57EC-87DA-1DB460D64046,"iPhone13,2"
com.toyopagroup.picaboo,2,1720741841,1720741843,1720741843.970492,-18000,EB445137-D7F5-57EC-87DA-1DB460D64046,"iPhone13,2"
com.toyopagroup.picaboo,26,1720741809,1720741835,1720741835.72474,-18000,EB445137-D7F5-57EC-87DA-1DB460D64046,"iPhone13,2"
com.toyopagroup.picaboo,8,1720741722,1720741730,1720741731.007577,-18000,EB445137-D7F5-57EC-87DA-1DB460D64046,"iPhone13,2"
com.toyopagroup.picaboo,184,1720741532,1720741716,1720741716.0400162,-18000,EB445137-D7F5-57EC-87DA-1DB460D64046,"iPhone13,2"
com.apple.MobileSMS,13,1720741519,1720741532,1720741532.406635,-18000,EB445137-D7F5-57EC-87DA-1DB460D64046,"iPhone13,2"
com.toyopagroup.picaboo,8,1720741511,1720741519,1720741519.1557431,-18000,EB445137-D7F5-57EC-87DA-1DB460D64046,"iPhone13,2"
com.apple.AppStore,6,1720741504,1720741510,1720741510.86395,-18000,EB445137-D7F5-57EC-87DA-1DB460D64046,"iPhone13,2"
com.Splitwise.SplitwiseMobile,117,1720741387,1720741504,1720741505.089316,-18000,EB445137-D7F5-57EC-87DA-1DB460D64046,"iPhone13,2"
com.apple.MobileSMS,9,1720741378,1720741387,1720741387.3688679,-18000,EB445137-D7F5-57EC-87DA-1DB460D64046,"iPhone13,2"
com.Splitwise.SplitwiseMobile,76,1720741302,1720741378,1720741378.874785,-18000,EB445137-D7F5-57EC-87DA-1DB460D64046,"iPhone13,2"
com.apple.AppStore,1,1720741301,1720741302,1720741303.0722551,-18000,EB445137-D7F5-57EC-87DA-1DB460D64046,"iPhone13,2"
com.doordash.dasher,11,1720741290,1720741301,1720741301.736833,-18000,EB445137-D7F5-57EC-87DA-1DB460D64046,"iPhone13,2"
com.apple.AppStore,22,1720741268,1720741290,1720741291.201628,-18000,EB445137-D7F5-57EC-87DA-1DB460D64046,"iPhone13,2"
com.google.Chrome,916,1720741239,1720742155,1720742155.056826,-18000,,
com.toyopagroup.picaboo,389,1720740877,1720741266,1720741266.795288,-18000,EB445137-D7F5-57EC-87DA-1DB460D64046,"iPhone13,2"
com.google.Chrome,434,1720740742,1720741176,1720741176.500588,-18000,,
com.apple.finder,2,1720740740,1720740742,1720740742.140019,-18000,,
com.toyopagroup.picaboo,107,1720740690,1720740797,1720740797.160161,-18000,EB445137-D7F5-57EC-87DA-1DB460D64046,"iPhone13,2"
com.myfitnesspal.mfp,91,1720740599,1720740690,1720740690.868516,-18000,EB445137-D7F5-57EC-87DA-1DB460D64046,"iPhone13,2"
com.toyopagroup.picaboo,109,1720740486,1720740595,1720740595.854779,-18000,EB445137-D7F5-57EC-87DA-1DB460D64046,"iPhone13,2"
com.doordash.dasher,4,1720740482,1720740486,1720740486.542743,-18000,EB445137-D7F5-57EC-87DA-1DB460D64046,"iPhone13,2"
com.apple.finder,2,1720740480,1720740482,1720740482.568537,-18000,,
com.google.Chrome,1,1720740479,1720740480,1720740481.132607,-18000,,
com.apple.finder,1,1720740478,1720740479,1720740479.6486611,-18000,,
com.apple.dt.Xcode,41,1720740437,1720740478,1720740478.700608,-18000,,
com.google.android.studio,70,1720740367,1720740437,1720740438.4919171,-18000,,
com.doordash.dasher,35,1720740319,1720740354,1720740354.16114,-18000,EB445137-D7F5-57EC-87DA-1DB460D64046,"iPhone13,2"
com.doordash.dasher,88,1720740182,1720740270,1720740270.3269548,-18000,EB445137-D7F5-57EC-87DA-1DB460D64046,"iPhone13,2"
com.google.Chrome,283,1720740084,1720740367,1720740367.272877,-18000,,
com.google.android.studio,20,1720740064,1720740084,1720740084.6233091,-18000,,
com.apple.dt.Xcode,1,1720740063,1720740064,1720740064.4509668,-18000,,
com.apple.finder,22,1720740041,1720740063,1720740063.210557,-18000,,
com.apple.dt.Xcode,36,1720740005,1720740041,1720740041.396733,-18000,,
com.apple.iphonesimulator,70,1720739935,1720740005,1720740005.915071,-18000,,
com.apple.dt.Xcode,1,1720739928,1720739929,1720739929.732164,-18000,,
com.truebill.truebillnative,4,1720738374,1720738378,1720738378.5872889,-18000,EB445137-D7F5-57EC-87DA-1DB460D64046,"iPhone13,2"
com.apple.dt.Xcode,591,1720738076,1720738667,1720738667.0550451,-18000,,
com.ryansponzilli.DeepSkyCatalogMac,11,1720738065,1720738076,1720738076.373919,-18000,,
com.apple.dt.Xcode,306,1720737759,1720738065,1720738065.9683971,-18000,,
com.google.android.studio,4,1720737755,1720737759,1720737759.340536,-18000,,
com.apple.dt.Xcode,590,1720737165,1720737755,1720737755.440504,-18000,,
com.google.android.studio,15,1720737150,1720737165,1720737165.819175,-18000,,
com.apple.dt.Xcode,150,1720737000,1720737150,1720737150.5332341,-18000,,
com.google.android.studio,95,1720736905,1720737000,1720737000.8446898,-18000,,
com.apple.dt.Xcode,20,1720736885,1720736905,1720736905.4763699,-18000,,
com.google.android.studio,23,1720736862,1720736885,1720736885.417377,-18000,,
com.apple.dt.Xcode,0,1720736862,1720736862,1720736863.0532331,-18000,,
com.google.android.studio,7,1720736855,1720736862,1720736862.34748,-18000,,
com.apple.dt.Xcode,1,1720736854,1720736855,1720736856.041861,-18000,,
com.google.android.studio,2,1720736852,1720736854,1720736854.722614,-18000,,
com.apple.dt.Xcode,1,1720736851,1720736852,1720736852.547536,-18000,,
com.google.android.studio,3,1720736848,1720736851,1720736851.1648722,-18000,,
com.apple.dt.Xcode,1,1720736847,1720736848,1720736848.713932,-18000,,
com.google.android.studio,5,1720736842,1720736847,1720736847.490907,-18000,,
com.apple.dt.Xcode,5,1720736837,1720736842,1720736843.063379,-18000,,
com.google.android.studio,7,1720736830,1720736837,1720736837.4964762,-18000,,
com.apple.dt.Xcode,1,1720736829,1720736830,1720736830.215949,-18000,,
com.google.android.studio,3,1720736826,1720736829,1720736829.044567,-18000,,
com.apple.dt.Xcode,1,1720736825,1720736826,1720736826.874769,-18000,,
com.google.android.studio,5,1720736820,1720736825,1720736825.7468262,-18000,,
com.apple.dt.Xcode,2,1720736818,1720736820,1720736820.065151,-18000,,
com.google.android.studio,3,1720736815,1720736818,1720736818.548176,-18000,,
com.apple.dt.Xcode,1,1720736814,1720736815,1720736815.3660278,-18000,,
com.google.android.studio,4,1720736810,1720736814,1720736814.224379,-18000,,
com.apple.dt.Xcode,3,1720736807,1720736810,1720736810.960222,-18000,,
com.google.android.studio,1,1720736806,1720736807,1720736807.313374,-18000,,
com.apple.dt.Xcode,1,1720736805,1720736806,1720736806.81887,-18000,,
com.google.Chrome,0,1720736805,1720736805,1720736806.038625,-18000,,
com.google.android.studio,1,1720736804,1720736805,1720736805.120075,-18000,,
com.google.Chrome,1,1720736803,1720736804,1720736804.9571018,-18000,,
com.google.android.studio,14,1720736789,1720736803,1720736803.4221048,-18000,,
com.google.Chrome,1,1720736788,1720736789,1720736789.323495,-18000,,
com.apple.dt.Xcode,7,1720736781,1720736788,1720736788.347903,-18000,,
com.google.Chrome,2,1720736779,1720736781,1720736781.532815,-18000,,
com.google.android.studio,114,1720736665,1720736779,1720736779.749841,-18000,,
com.apple.dt.Xcode,7,1720736658,1720736665,1720736665.235152,-18000,,
com.google.android.studio,114,1720736544,1720736658,1720736658.3989239,-18000,,
com.google.Chrome,5,1720736539,1720736544,1720736544.038649,-18000,,
com.google.android.studio,31,1720736508,1720736539,1720736539.707975,-18000,,
com.google.Chrome,1,1720736507,1720736508,1720736508.944374,-18000,,
com.google.android.studio,25,1720736482,1720736507,1720736507.063268,-18000,,
com.google.Chrome,4,1720736478,1720736482,1720736483.008645,-18000,,
com.google.android.studio,7,1720736471,1720736478,1720736478.6658502,-18000,,
com.google.Chrome,1,1720736470,1720736471,1720736471.3578649,-18000,,
com.google.android.studio,2,1720736468,1720736470,1720736470.646518,-18000,,
com.google.Chrome,77,1720736391,1720736468,1720736468.775984,-18000,,
com.truebill.truebillnative,78,1720736056,1720736134,1720736134.4500551,-18000,EB445137-D7F5-57EC-87DA-1DB460D64046,"iPhone13,2"
com.apple.findmy,11,1720736028,1720736039,1720736039.251627,-18000,EB445137-D7F5-57EC-87DA-1DB460D64046,"iPhone13,2"
com.apple.reminders,6,1720736020,1720736026,1720736026.994125,-18000,EB445137-D7F5-57EC-87DA-1DB460D64046,"iPhone13,2"
com.apple.reminders,13,1720736005,1720736018,1720736018.771182,-18000,EB445137-D7F5-57EC-87DA-1DB460D64046,"iPhone13,2"
com.google.android.studio,451,1720735940,1720736391,1720736392.077158,-18000,,
com.google.Chrome,0,1720735940,1720735940,1720735941.013503,-18000,,
com.google.android.studio,5,1720735935,1720735940,1720735940.21826,-18000,,
com.google.Chrome,2,1720735933,1720735935,1720735935.2890182,-18000,,
com.apple.dt.Xcode,13,1720735920,1720735933,1720735933.989089,-18000,,
com.google.Chrome,3,1720735917,1720735920,1720735920.212154,-18000,,
com.google.android.studio,48,1720735869,1720735917,1720735917.970319,-18000,,
com.apple.dt.Xcode,3,1720735866,1720735869,1720735869.306727,-18000,,
com.google.android.studio,3,1720735863,1720735866,1720735866.977474,-18000,,
com.apple.dt.Xcode,1,1720735862,1720735863,1720735863.9835439,-18000,,
com.google.android.studio,3,1720735859,1720735862,1720735862.31548,-18000,,
com.apple.dt.Xcode,4,1720735855,1720735859,1720735859.4376168,-18000,,
com.google.android.studio,31,1720735824,1720735855,1720735855.969315,-18000,,
com.google.Chrome,1,1720735823,1720735824,1720735824.834962,-18000,,
com.apple.dt.Xcode,2,1720735821,1720735823,1720735823.6356559,-18000,,
com.google.Chrome,2,1720735819,1720735821,1720735821.061804,-18000,,
com.google.android.studio,122,1720735697,1720735819,1720735819.75031,-18000,,
com.google.Chrome,2,1720735695,1720735697,1720735697.970972,-18000,,
com.google.android.studio,13,1720735682,1720735695,1720735695.715436,-18000,,
com.google.Chrome,35,1720735647,1720735682,1720735682.388434,-18000,,
com.google.android.studio,1,1720735646,1720735647,1720735647.4289532,-18000,,
com.google.Chrome,7,1720735639,1720735646,1720735646.240601,-18000,,
com.google.android.studio,7,1720735632,1720735639,1720735639.435247,-18000,,
com.apple.dt.Xcode,26,1720735606,1720735632,1720735632.601949,-18000,,
com.google.android.studio,61,1720735545,1720735606,1720735606.227831,-18000,,
com.google.Chrome,1,1720735544,1720735545,1720735545.475555,-18000,,
com.google.android.studio,31,1720735513,1720735544,1720735544.39452,-18000,,
com.google.Chrome,2,1720735511,1720735513,1720735513.328865,-18000,,
com.apple.dt.Xcode,24,1720735487,1720735511,1720735511.654233,-18000,,
com.google.android.studio,74,1720735413,1720735487,1720735487.401081,-18000,,
com.google.Chrome,44,1720735369,1720735413,1720735413.2088718,-18000,,
com.google.android.studio,112,1720735257,1720735369,1720735369.865543,-18000,,
com.google.Chrome,58,1720735199,1720735257,1720735257.657495,-18000,,
com.google.android.studio,3,1720735196,1720735199,1720735200.051415,-18000,,
com.google.Chrome,74,1720735122,1720735196,1720735196.999583,-18000,,
com.google.android.studio,27,1720735095,1720735122,1720735122.503056,-18000,,
com.apple.dt.Xcode,3,1720735092,1720735095,1720735095.836154,-18000,,
com.google.android.studio,2,1720735090,1720735092,1720735092.671243,-18000,,
com.apple.dt.Xcode,8,1720735082,1720735090,1720735090.831326,-18000,,
com.google.android.studio,13,1720735069,1720735082,1720735082.524853,-18000,,
com.apple.dt.Xcode,48,1720735021,1720735069,1720735069.211518,-18000,,
com.google.android.studio,50,1720734971,1720735021,1720735021.4710279,-18000,,
com.google.Chrome,5,1720734966,1720734971,1720734971.869782,-18000,,
com.google.android.studio,49,1720734917,1720734966,1720734966.967249,-18000,,
com.google.Chrome,54,1720734863,1720734917,1720734917.917819,-18000,,
com.google.android.studio,3,1720734860,1720734863,1720734863.817052,-18000,,
com.google.Chrome,30,1720734830,1720734860,1720734860.878624,-18000,,
com.google.android.studio,129,1720734701,1720734830,1720734830.587078,-18000,,
com.google.Chrome,8,1720734676,1720734684,1720734684.978434,-18000,,
com.google.android.studio,12,1720734664,1720734676,1720734676.5096989,-18000,,
com.google.Chrome,22,1720734642,1720734664,1720734664.830564,-18000,,
com.google.android.studio,19,1720734623,1720734642,1720734642.731587,-18000,,
com.google.Chrome,1,1720734622,1720734623,1720734623.648658,-18000,,
com.google.android.studio,3,1720734619,1720734622,1720734622.3008208,-18000,,
com.google.Chrome,17,1720734602,1720734619,1720734619.794344,-18000,,
com.google.android.studio,63,1720734539,1720734602,1720734602.646926,-18000,,
com.google.Chrome,9,1720734530,1720734539,1720734539.970669,-18000,,
com.apple.dt.Xcode,26,1720734504,1720734530,1720734530.4101481,-18000,,
com.google.Chrome,21,1720734483,1720734504,1720734504.773354,-18000,,
com.google.android.studio,3,1720734480,1720734483,1720734483.1099648,-18000,,
com.google.Chrome,0,1720734480,1720734480,1720734480.622067,-18000,,
com.google.android.studio,40,1720734440,1720734480,1720734480.169845,-18000,,
com.google.Chrome,4,1720734436,1720734440,1720734440.577392,-18000,,
com.google.android.studio,8,1720734428,1720734436,1720734436.909565,-18000,,
com.google.Chrome,2,1720734426,1720734428,1720734428.195018,-18000,,
com.google.android.studio,16,1720734410,1720734426,1720734426.746844,-18000,,
com.google.Chrome,3,1720734407,1720734410,1720734410.5708652,-18000,,
com.google.android.studio,6,1720734401,1720734407,1720734407.9561582,-18000,,
com.google.Chrome,1,1720734400,1720734401,1720734401.731731,-18000,,
com.google.android.studio,14,1720734386,1720734400,1720734400.281493,-18000,,
com.google.Chrome,1,1720734385,1720734386,1720734386.311661,-18000,,
com.google.android.studio,8,1720734377,1720734385,1720734385.130886,-18000,,
com.google.Chrome,15,1720734362,1720734377,1720734377.608735,-18000,,
com.google.android.studio,23,1720734339,1720734362,1720734362.176599,-18000,,
com.apple.finder,21,1720734318,1720734339,1720734339.656238,-18000,,
com.google.android.studio,12,1720734306,1720734318,1720734318.888175,-18000,,
com.apple.finder,16,1720734290,1720734306,1720734306.639782,-18000,,
com.google.android.studio,8,1720734282,1720734290,1720734290.389894,-18000,,
com.google.Chrome,1,1720734281,1720734282,1720734282.655551,-18000,,
com.google.android.studio,3,1720734278,1720734281,1720734281.812292,-18000,,
com.google.Chrome,0,1720734278,1720734278,1720734278.932492,-18000,,
com.google.android.studio,16,1720734262,1720734278,1720734278.172873,-18000,,
com.google.Chrome,8,1720734254,1720734262,1720734262.8235412,-18000,,
com.google.android.studio,41,1720734213,1720734254,1720734254.827282,-18000,,
com.google.Chrome,42,1720734171,1720734213,1720734213.4965138,-18000,,
com.google.android.studio,8,1720734163,1720734171,1720734171.7721329,-18000,,
com.google.Chrome,159,1720734004,1720734163,1720734163.0636292,-18000,,
com.google.ios.youtube,825,1720733175,1720734000,1720734000.537263,-18000,EB445137-D7F5-57EC-87DA-1DB460D64046,"iPhone13,2"
com.netflix.Netflix,1378,1720731795,1720733173,1720733174.023614,-18000,EB445137-D7F5-57EC-87DA-1DB460D64046,"iPhone13,2"
com.apple.news,11,1720731772,1720731783,1720731783.134104,-18000,EB445137-D7F5-57EC-87DA-1DB460D64046,"iPhone13,2"
com.google.Gmail,15,1720731751,1720731766,1720731766.2392368,-18000,EB445137-D7F5-57EC-87DA-1DB460D64046,"iPhone13,2"
com.doordash.dasher,13,1720731735,1720731748,1720731748.753697,-18000,EB445137-D7F5-57EC-87DA-1DB460D64046,"iPhone13,2"
com.google.Chrome,2009,1720729605,1720731614,1720731614.146703,-18000,,
com.apple.printcenter,204,1720729401,1720729605,1720729605.2482982,-18000,,
com.google.Chrome,133,1720729207,1720729340,1720729340.817721,-18000,,
com.doordash.dasher,38,1720728645,1720728683,1720728683.833103,-18000,EB445137-D7F5-57EC-87DA-1DB460D64046,"iPhone13,2"
com.google.Chrome,343,1720726915,1720727258,1720727258.984774,-18000,,
com.apple.findmy,11,1720726298,1720726309,1720726309.9353662,-18000,EB445137-D7F5-57EC-87DA-1DB460D64046,"iPhone13,2"
com.apple.news,285,1720726012,1720726297,1720726297.5519,-18000,EB445137-D7F5-57EC-87DA-1DB460D64046,"iPhone13,2"
Astrospheric.Astrospheric,47,1720725954,1720726001,1720726001.253621,-18000,EB445137-D7F5-57EC-87DA-1DB460D64046,"iPhone13,2"
Astrospheric.Astrospheric,48,1720725904,1720725952,1720725952.435605,-18000,EB445137-D7F5-57EC-87DA-1DB460D64046,"iPhone13,2"
com.apple.weather,39,1720725863,1720725902,1720725902.104566,-18000,EB445137-D7F5-57EC-87DA-1DB460D64046,"iPhone13,2"
com.apple.Music,6,1720725846,1720725852,1720725852.087451,-18000,EB445137-D7F5-57EC-87DA-1DB460D64046,"iPhone13,2"
com.apple.Music,7,1720724892,1720724899,1720724899.031056,-18000,EB445137-D7F5-57EC-87DA-1DB460D64046,"iPhone13,2"
com.apple.Music,31,1720724586,1720724617,1720724617.1299481,-18000,EB445137-D7F5-57EC-87DA-1DB460D64046,"iPhone13,2"
com.apple.MobileSMS,4,1720724480,1720724484,1720724484.730861,-18000,EB445137-D7F5-57EC-87DA-1DB460D64046,"iPhone13,2"
com.muscleforlife.Stacked,36,1720724444,1720724480,1720724480.618105,-18000,EB445137-D7F5-57EC-87DA-1DB460D64046,"iPhone13,2"
com.muscleforlife.Stacked,6,1720724435,1720724441,1720724441.220967,-18000,EB445137-D7F5-57EC-87DA-1DB460D64046,"iPhone13,2"
com.muscleforlife.Stacked,105,1720724296,1720724401,1720724401.4977388,-18000,EB445137-D7F5-57EC-87DA-1DB460D64046,"iPhone13,2"
com.muscleforlife.Stacked,70,1720724195,1720724265,1720724265.866204,-18000,EB445137-D7F5-57EC-87DA-1DB460D64046,"iPhone13,2"
com.doordash.dasher,8,1720724187,1720724195,1720724195.447359,-18000,EB445137-D7F5-57EC-87DA-1DB460D64046,"iPhone13,2"
com.apple.calculator,8,1720724179,1720724187,1720724187.869587,-18000,EB445137-D7F5-57EC-87DA-1DB460D64046,"iPhone13,2"
com.doordash.dasher,18,1720724161,1720724179,1720724179.265003,-18000,EB445137-D7F5-57EC-87DA-1DB460D64046,"iPhone13,2"
com.muscleforlife.Stacked,3,1720724158,1720724161,1720724161.812211,-18000,EB445137-D7F5-57EC-87DA-1DB460D64046,"iPhone13,2"
com.doordash.dasher,6,1720724152,1720724158,1720724158.305331,-18000,EB445137-D7F5-57EC-87DA-1DB460D64046,"iPhone13,2"
com.muscleforlife.Stacked,4,1720724148,1720724152,1720724153.002245,-18000,EB445137-D7F5-57EC-87DA-1DB460D64046,"iPhone13,2"
com.muscleforlife.Stacked,2,1720724095,1720724097,1720724097.5983682,-18000,EB445137-D7F5-57EC-87DA-1DB460D64046,"iPhone13,2"
com.muscleforlife.Stacked,9,1720724084,1720724093,1720724093.923038,-18000,EB445137-D7F5-57EC-87DA-1DB460D64046,"iPhone13,2"
com.muscleforlife.Stacked,5,1720723980,1720723985,1720723985.588156,-18000,EB445137-D7F5-57EC-87DA-1DB460D64046,"iPhone13,2"
com.muscleforlife.Stacked,4,1720723952,1720723956,1720723956.2169771,-18000,EB445137-D7F5-57EC-87DA-1DB460D64046,"iPhone13,2"
com.muscleforlife.Stacked,8,1720723882,1720723890,1720723890.683588,-18000,EB445137-D7F5-57EC-87DA-1DB460D64046,"iPhone13,2"
com.muscleforlife.Stacked,14,1720723844,1720723858,1720723858.7994618,-18000,EB445137-D7F5-57EC-87DA-1DB460D64046,"iPhone13,2"
com.muscleforlife.Stacked,14,1720723778,1720723792,1720723792.022311,-18000,EB445137-D7F5-57EC-87DA-1DB460D64046,"iPhone13,2"
com.muscleforlife.Stacked,5,1720723750,1720723755,1720723755.048511,-18000,EB445137-D7F5-57EC-87DA-1DB460D64046,"iPhone13,2"
com.muscleforlife.Stacked,15,1720723677,1720723692,1720723692.341529,-18000,EB445137-D7F5-57EC-87DA-1DB460D64046,"iPhone13,2"
com.muscleforlife.Stacked,6,1720723508,1720723514,1720723514.407129,-18000,EB445137-D7F5-57EC-87DA-1DB460D64046,"iPhone13,2"
com.muscleforlife.Stacked,5,1720723502,1720723507,1720723507.4048529,-18000,EB445137-D7F5-57EC-87DA-1DB460D64046,"iPhone13,2"
com.muscleforlife.Stacked,6,1720723455,1720723461,1720723461.5645971,-18000,EB445137-D7F5-57EC-87DA-1DB460D64046,"iPhone13,2"
com.muscleforlife.Stacked,3,1720723450,1720723453,1720723453.845842,-18000,EB445137-D7F5-57EC-87DA-1DB460D64046,"iPhone13,2"
com.muscleforlife.Stacked,6,1720723440,1720723446,1720723446.588572,-18000,EB445137-D7F5-57EC-87DA-1DB460D64046,"iPhone13,2"
com.muscleforlife.Stacked,66,1720723353,1720723419,1720723419.7178311,-18000,EB445137-D7F5-57EC-87DA-1DB460D64046,"iPhone13,2"
com.muscleforlife.Stacked,33,1720723310,1720723343,1720723343.171078,-18000,EB445137-D7F5-57EC-87DA-1DB460D64046,"iPhone13,2"
com.muscleforlife.Stacked,70,1720723218,1720723288,1720723288.3967109,-18000,EB445137-D7F5-57EC-87DA-1DB460D64046,"iPhone13,2"
com.muscleforlife.Stacked,33,1720723180,1720723213,1720723213.984147,-18000,EB445137-D7F5-57EC-87DA-1DB460D64046,"iPhone13,2"
com.muscleforlife.Stacked,6,1720723147,1720723153,1720723153.67312,-18000,EB445137-D7F5-57EC-87DA-1DB460D64046,"iPhone13,2"
com.muscleforlife.Stacked,11,1720723085,1720723096,1720723096.696549,-18000,EB445137-D7F5-57EC-87DA-1DB460D64046,"iPhone13,2"
com.muscleforlife.Stacked,7,1720723066,1720723073,1720723073.028857,-18000,EB445137-D7F5-57EC-87DA-1DB460D64046,"iPhone13,2"
com.muscleforlife.Stacked,6,1720723059,1720723065,1720723065.8827991,-18000,EB445137-D7F5-57EC-87DA-1DB460D64046,"iPhone13,2"
com.muscleforlife.Stacked,3,1720723042,1720723045,1720723045.298326,-18000,EB445137-D7F5-57EC-87DA-1DB460D64046,"iPhone13,2"
com.doordash.dasher,4,1720723032,1720723036,1720723036.7747278,-18000,EB445137-D7F5-57EC-87DA-1DB460D64046,"iPhone13,2"
com.apple.camera,0,1720723014,1720723014,1720723014.909268,-18000,EB445137-D7F5-57EC-87DA-1DB460D64046,"iPhone13,2"
com.doordash.dasher,5,1720723009,1720723014,1720723014.858701,-18000,EB445137-D7F5-57EC-87DA-1DB460D64046,"iPhone13,2"
com.doordash.dasher,7,1720722154,1720722161,1720722161.989301,-18000,EB445137-D7F5-57EC-87DA-1DB460D64046,"iPhone13,2"
com.apple.camera,9,1720721716,1720721725,1720721726.014454,-18000,EB445137-D7F5-57EC-87DA-1DB460D64046,"iPhone13,2"
com.doordash.dasher,325,1720721710,1720722035,1720722035.445224,-18000,EB445137-D7F5-57EC-87DA-1DB460D64046,"iPhone13,2"
com.doordash.dasher,1573,1720720014,1720721587,1720721587.411487,-18000,EB445137-D7F5-57EC-87DA-1DB460D64046,"iPhone13,2"
com.doordash.dasher,4,1720720007,1720720011,1720720011.297822,-18000,EB445137-D7F5-57EC-87DA-1DB460D64046,"iPhone13,2"
com.doordash.dasher,9,1720719967,1720719976,1720719976.33118,-18000,EB445137-D7F5-57EC-87DA-1DB460D64046,"iPhone13,2"
com.doordash.dasher,20,1720719876,1720719896,1720719896.17364,-18000,EB445137-D7F5-57EC-87DA-1DB460D64046,"iPhone13,2"
com.doordash.dasher,95,1720719761,1720719856,1720719856.75004,-18000,EB445137-D7F5-57EC-87DA-1DB460D64046,"iPhone13,2"
com.doordash.dasher,50,1720719709,1720719759,1720719759.9908671,-18000,EB445137-D7F5-57EC-87DA-1DB460D64046,"iPhone13,2"
com.doordash.dasher,4,1720719659,1720719663,1720719663.8734632,-18000,EB445137-D7F5-57EC-87DA-1DB460D64046,"iPhone13,2"
com.doordash.dasher,54,1720719591,1720719645,1720719645.446657,-18000,EB445137-D7F5-57EC-87DA-1DB460D64046,"iPhone13,2"
com.doordash.dasher,107,1720719483,1720719590,1720719590.864904,-18000,EB445137-D7F5-57EC-87DA-1DB460D64046,"iPhone13,2"
com.doordash.dasher,8,1720719472,1720719480,1720719480.4744081,-18000,EB445137-D7F5-57EC-87DA-1DB460D64046,"iPhone13,2"
com.doordash.dasher,626,1720718801,1720719427,1720719427.651256,-18000,EB445137-D7F5-57EC-87DA-1DB460D64046,"iPhone13,2"
com.apple.podcasts,31,1720718770,1720718801,1720718801.122494,-18000,EB445137-D7F5-57EC-87DA-1DB460D64046,"iPhone13,2"
com.doordash.dasher,2001,1720716769,1720718770,1720718770.704986,-18000,EB445137-D7F5-57EC-87DA-1DB460D64046,"iPhone13,2"
com.apple.MobileSMS,1,1720716768,1720716769,1720716770.034208,-18000,EB445137-D7F5-57EC-87DA-1DB460D64046,"iPhone13,2"
com.doordash.dasher,10,1720716737,1720716747,1720716747.673905,-18000,EB445137-D7F5-57EC-87DA-1DB460D64046,"iPhone13,2"
com.apple.mobilenotes,2,1720716735,1720716737,1720716737.813525,-18000,EB445137-D7F5-57EC-87DA-1DB460D64046,"iPhone13,2"
com.apple.mobilenotes,4,1720716452,1720716456,1720716456.6570091,-18000,EB445137-D7F5-57EC-87DA-1DB460D64046,"iPhone13,2"
com.doordash.dasher,2,1720716449,1720716451,1720716451.287874,-18000,EB445137-D7F5-57EC-87DA-1DB460D64046,"iPhone13,2"
com.doordash.dasher,16,1720716294,1720716310,1720716311.429822,-18000,EB445137-D7F5-57EC-87DA-1DB460D64046,"iPhone13,2"
com.google.chrome.ios,31,1720716263,1720716294,1720716294.1740022,-18000,EB445137-D7F5-57EC-87DA-1DB460D64046,"iPhone13,2"
com.doordash.dasher,1416,1720714847,1720716263,1720716263.771147,-18000,EB445137-D7F5-57EC-87DA-1DB460D64046,"iPhone13,2"
com.doordash.dasher,130,1720714704,1720714834,1720714834.368475,-18000,EB445137-D7F5-57EC-87DA-1DB460D64046,"iPhone13,2"
com.doordash.dasher,464,1720714237,1720714701,1720714701.88937,-18000,EB445137-D7F5-57EC-87DA-1DB460D64046,"iPhone13,2"
com.apple.mobilecal,70,1720714167,1720714237,1720714237.6295,-18000,EB445137-D7F5-57EC-87DA-1DB460D64046,"iPhone13,2"
com.truebill.truebillnative,66,1720714098,1720714164,1720714164.463325,-18000,EB445137-D7F5-57EC-87DA-1DB460D64046,"iPhone13,2"
com.doordash.dasher,88,1720714006,1720714094,1720714095.044899,-18000,EB445137-D7F5-57EC-87DA-1DB460D64046,"iPhone13,2"
com.doordash.dasher,205,1720713794,1720713999,1720713999.832382,-18000,EB445137-D7F5-57EC-87DA-1DB460D64046,"iPhone13,2"
Astrospheric.Astrospheric,20,1720713774,1720713794,1720713794.9290729,-18000,EB445137-D7F5-57EC-87DA-1DB460D64046,"iPhone13,2"
com.doordash.dasher,297,1720713465,1720713762,1720713762.617199,-18000,EB445137-D7F5-57EC-87DA-1DB460D64046,"iPhone13,2"
com.doordash.dasher,3,1720713426,1720713429,1720713429.693533,-18000,EB445137-D7F5-57EC-87DA-1DB460D64046,"iPhone13,2"
com.doordash.dasher,772,1720712640,1720713412,1720713412.059411,-18000,EB445137-D7F5-57EC-87DA-1DB460D64046,"iPhone13,2"
com.doordash.dasher,54,1720712537,1720712591,1720712591.525305,-18000,EB445137-D7F5-57EC-87DA-1DB460D64046,"iPhone13,2"
com.doordash.dasher,201,1720712230,1720712431,1720712431.246175,-18000,EB445137-D7F5-57EC-87DA-1DB460D64046,"iPhone13,2"
com.apple.podcasts,162,1720712068,1720712230,1720712230.99266,-18000,EB445137-D7F5-57EC-87DA-1DB460D64046,"iPhone13,2"
com.apple.news,35,1720712021,1720712056,1720712056.8610392,-18000,EB445137-D7F5-57EC-87DA-1DB460D64046,"iPhone13,2"
com.apple.findmy,14,1720711995,1720712009,1720712009.303358,-18000,EB445137-D7F5-57EC-87DA-1DB460D64046,"iPhone13,2"
com.doordash.dasher,27,1720711968,1720711995,1720711995.616197,-18000,EB445137-D7F5-57EC-87DA-1DB460D64046,"iPhone13,2"
com.apple.news,3,1720711963,1720711966,1720711967.03023,-18000,EB445137-D7F5-57EC-87DA-1DB460D64046,"iPhone13,2"
com.apple.news,193,1720711514,1720711707,1720711707.924028,-18000,EB445137-D7F5-57EC-87DA-1DB460D64046,"iPhone13,2"
com.amazon.Amazon,107,1720711381,1720711488,1720711488.0124779,-18000,EB445137-D7F5-57EC-87DA-1DB460D64046,"iPhone13,2"
com.google.chrome.ios,414,1720710967,1720711381,1720711382.076895,-18000,EB445137-D7F5-57EC-87DA-1DB460D64046,"iPhone13,2"
com.google.chrome.ios,120,1720710687,1720710807,1720710807.30883,-18000,EB445137-D7F5-57EC-87DA-1DB460D64046,"iPhone13,2"
com.amazon.Amazon,21,1720710666,1720710687,1720710687.349948,-18000,EB445137-D7F5-57EC-87DA-1DB460D64046,"iPhone13,2"
com.apple.weather,4,1720710660,1720710664,1720710664.569334,-18000,EB445137-D7F5-57EC-87DA-1DB460D64046,"iPhone13,2"
com.apple.weather,3,1720710341,1720710344,1720710344.056771,-18000,EB445137-D7F5-57EC-87DA-1DB460D64046,"iPhone13,2"
com.apple.weather,15,1720710097,1720710112,1720710112.9302921,-18000,EB445137-D7F5-57EC-87DA-1DB460D64046,"iPhone13,2"
com.apple.weather,10,1720710087,1720710097,1720710097.351564,-18000,EB445137-D7F5-57EC-87DA-1DB460D64046,"iPhone13,2"
com.apple.findmy,14,1720710071,1720710085,1720710085.409305,-18000,EB445137-D7F5-57EC-87DA-1DB460D64046,"iPhone13,2"
com.google.ios.youtube,2165,1720707875,1720710040,1720710040.808852,-18000,EB445137-D7F5-57EC-87DA-1DB460D64046,"iPhone13,2"
com.apple.findmy,21,1720707854,1720707875,1720707875.199203,-18000,EB445137-D7F5-57EC-87DA-1DB460D64046,"iPhone13,2"
com.apple.Health,8,1720707846,1720707854,1720707854.156376,-18000,EB445137-D7F5-57EC-87DA-1DB460D64046,"iPhone13,2"
com.apple.Health,2,1720707805,1720707807,1720707807.439629,-18000,EB445137-D7F5-57EC-87DA-1DB460D64046,"iPhone13,2"
com.apple.Health,14,1720707672,1720707686,1720707686.719099,-18000,EB445137-D7F5-57EC-87DA-1DB460D64046,"iPhone13,2"
com.apple.Health,6,1720707043,1720707049,1720707049.5884042,-18000,EB445137-D7F5-57EC-87DA-1DB460D64046,"iPhone13,2"
com.apple.Health,79,1720706950,1720707029,1720707029.272079,-18000,EB445137-D7F5-57EC-87DA-1DB460D64046,"iPhone13,2"
com.markhambly.APOD,11,1720706939,1720706950,1720706950.4928641,-18000,EB445137-D7F5-57EC-87DA-1DB460D64046,"iPhone13,2"
com.markhambly.APOD,6,1720706930,1720706936,1720706936.9944859,-18000,EB445137-D7F5-57EC-87DA-1DB460D64046,"iPhone13,2"
com.markhambly.APOD,64,1720706572,1720706636,1720706636.430029,-18000,EB445137-D7F5-57EC-87DA-1DB460D64046,"iPhone13,2"
com.google.ios.youtube,814,1720705745,1720706559,1720706560.16578,-18000,EB445137-D7F5-57EC-87DA-1DB460D64046,"iPhone13,2"
com.clairmail.fth.client,9,1720705049,1720705058,1720705058.4439058,-18000,EB445137-D7F5-57EC-87DA-1DB460D64046,"iPhone13,2"
com.apple.MobileSMS,9,1720671291,1720671300,1720671300.3905349,-18000,EB445137-D7F5-57EC-87DA-1DB460D64046,"iPhone13,2"
com.apple.journal,217,1720671073,1720671290,1720671290.219291,-18000,EB445137-D7F5-57EC-87DA-1DB460D64046,"iPhone13,2"
com.apple.Health,12,1720671061,1720671073,1720671074.350661,-18000,EB445137-D7F5-57EC-87DA-1DB460D64046,"iPhone13,2"
com.thestorygraph.thestorygraph,222,1720670836,1720671058,1720671058.917877,-18000,EB445137-D7F5-57EC-87DA-1DB460D64046,"iPhone13,2"
com.google.Chrome,738,1720668349,1720669087,1720669087.811967,-18000,,
com.google.Chrome,499,1720667576,1720668075,1720668075.936897,-18000,,
com.google.Chrome,499,1720667055,1720667554,1720667554.6429272,-18000,,
com.google.Chrome,1560,1720665194,1720666754,1720666754.5996141,-18000,,
com.apple.news,3,1720665111,1720665114,1720665114.8105268,-18000,EB445137-D7F5-57EC-87DA-1DB460D64046,"iPhone13,2"
com.apple.news,7,1720665096,1720665103,1720665103.7750812,-18000,EB445137-D7F5-57EC-87DA-1DB460D64046,"iPhone13,2"
com.apple.news,6,1720662697,1720662703,1720662703.2186198,-18000,EB445137-D7F5-57EC-87DA-1DB460D64046,"iPhone13,2"
com.apple.news,2,1720662678,1720662680,1720662680.331958,-18000,EB445137-D7F5-57EC-87DA-1DB460D64046,"iPhone13,2"
com.apple.news,241,1720662315,1720662556,1720662556.2317982,-18000,EB445137-D7F5-57EC-87DA-1DB460D64046,"iPhone13,2"
com.netflix.Netflix,1377,1720660931,1720662308,1720662308.387912,-18000,EB445137-D7F5-57EC-87DA-1DB460D64046,"iPhone13,2"
com.apple.Health,46,1720660875,1720660921,1720660921.872906,-18000,EB445137-D7F5-57EC-87DA-1DB460D64046,"iPhone13,2"
com.myfitnesspal.mfp,97,1720660778,1720660875,1720660875.606082,-18000,EB445137-D7F5-57EC-87DA-1DB460D64046,"iPhone13,2"
com.doordash.dasher,13,1720660632,1720660645,1720660645.628236,-18000,EB445137-D7F5-57EC-87DA-1DB460D64046,"iPhone13,2"
com.doordash.dasher,3,1720660371,1720660374,1720660374.191637,-18000,EB445137-D7F5-57EC-87DA-1DB460D64046,"iPhone13,2"
com.doordash.dasher,363,1720660006,1720660369,1720660369.3792372,-18000,EB445137-D7F5-57EC-87DA-1DB460D64046,"iPhone13,2"
com.doordash.dasher,223,1720659783,1720660006,1720660006.457149,-18000,EB445137-D7F5-57EC-87DA-1DB460D64046,"iPhone13,2"
com.doordash.dasher,5,1720659714,1720659719,1720659719.314379,-18000,EB445137-D7F5-57EC-87DA-1DB460D64046,"iPhone13,2"
com.doordash.dasher,7,1720659705,1720659712,1720659712.674512,-18000,EB445137-D7F5-57EC-87DA-1DB460D64046,"iPhone13,2"
com.doordash.dasher,31,1720659573,1720659604,1720659604.651267,-18000,EB445137-D7F5-57EC-87DA-1DB460D64046,"iPhone13,2"
com.doordash.dasher,549,1720658714,1720659263,1720659263.7121139,-18000,EB445137-D7F5-57EC-87DA-1DB460D64046,"iPhone13,2"
com.doordash.dasher,62,1720658647,1720658709,1720658709.068726,-18000,EB445137-D7F5-57EC-87DA-1DB460D64046,"iPhone13,2"
com.doordash.dasher,17,1720658621,1720658638,1720658638.256295,-18000,EB445137-D7F5-57EC-87DA-1DB460D64046,"iPhone13,2"
com.doordash.dasher,39,1720658514,1720658553,1720658553.583644,-18000,EB445137-D7F5-57EC-87DA-1DB460D64046,"iPhone13,2"
com.doordash.dasher,346,1720658155,1720658501,1720658501.203047,-18000,EB445137-D7F5-57EC-87DA-1DB460D64046,"iPhone13,2"
com.apple.podcasts,49,1720658106,1720658155,1720658155.681783,-18000,EB445137-D7F5-57EC-87DA-1DB460D64046,"iPhone13,2"
com.doordash.dasher,88,1720658018,1720658106,1720658107.359421,-18000,EB445137-D7F5-57EC-87DA-1DB460D64046,"iPhone13,2"
com.doordash.dasher,41,1720657947,1720657988,1720657988.525815,-18000,EB445137-D7F5-57EC-87DA-1DB460D64046,"iPhone13,2"
com.doordash.dasher,6,1720657936,1720657942,1720657942.965403,-18000,EB445137-D7F5-57EC-87DA-1DB460D64046,"iPhone13,2"
com.doordash.dasher,8,1720657919,1720657927,1720657927.5467439,-18000,EB445137-D7F5-57EC-87DA-1DB460D64046,"iPhone13,2"
com.doordash.dasher,52,1720657864,1720657916,1720657916.9995918,-18000,EB445137-D7F5-57EC-87DA-1DB460D64046,"iPhone13,2"
com.thestorygraph.thestorygraph,11,1720657853,1720657864,1720657864.842416,-18000,EB445137-D7F5-57EC-87DA-1DB460D64046,"iPhone13,2"
com.doordash.dasher,17,1720657836,1720657853,1720657854.04756,-18000,EB445137-D7F5-57EC-87DA-1DB460D64046,"iPhone13,2"
com.apple.MobileSMS,15,1720657821,1720657836,1720657836.231539,-18000,EB445137-D7F5-57EC-87DA-1DB460D64046,"iPhone13,2"
com.thestorygraph.thestorygraph,19,1720657800,1720657819,1720657819.59591,-18000,EB445137-D7F5-57EC-87DA-1DB460D64046,"iPhone13,2"
com.doordash.dasher,8,1720657791,1720657799,1720657799.859748,-18000,EB445137-D7F5-57EC-87DA-1DB460D64046,"iPhone13,2"
com.doordash.dasher,46,1720657562,1720657608,1720657608.329118,-18000,EB445137-D7F5-57EC-87DA-1DB460D64046,"iPhone13,2"
com.doordash.dasher,225,1720657286,1720657511,1720657511.147661,-18000,EB445137-D7F5-57EC-87DA-1DB460D64046,"iPhone13,2"
com.toyopagroup.picaboo,12,1720657273,1720657285,1720657285.132811,-18000,EB445137-D7F5-57EC-87DA-1DB460D64046,"iPhone13,2"
com.doordash.dasher,26,1720657247,1720657273,1720657273.660373,-18000,EB445137-D7F5-57EC-87DA-1DB460D64046,"iPhone13,2"
com.doordash.dasher,58,1720657166,1720657224,1720657224.338166,-18000,EB445137-D7F5-57EC-87DA-1DB460D64046,"iPhone13,2"
com.apple.InCallService,19,1720657147,1720657166,1720657166.533541,-18000,EB445137-D7F5-57EC-87DA-1DB460D64046,"iPhone13,2"
com.doordash.dasher,44,1720657103,1720657147,1720657147.257279,-18000,EB445137-D7F5-57EC-87DA-1DB460D64046,"iPhone13,2"
com.apple.InCallService,62,1720656997,1720657059,1720657059.85058,-18000,EB445137-D7F5-57EC-87DA-1DB460D64046,"iPhone13,2"
com.doordash.dasher,761,1720656236,1720656997,1720656997.257097,-18000,EB445137-D7F5-57EC-87DA-1DB460D64046,"iPhone13,2"
com.doordash.dasher,568,1720655662,1720656230,1720656230.5536242,-18000,EB445137-D7F5-57EC-87DA-1DB460D64046,"iPhone13,2"
com.apple.podcasts,1,1720655661,1720655662,1720655664.122643,-18000,EB445137-D7F5-57EC-87DA-1DB460D64046,"iPhone13,2"
com.google.ios.youtube,26,1720655635,1720655661,1720655661.246124,-18000,EB445137-D7F5-57EC-87DA-1DB460D64046,"iPhone13,2"
com.thestorygraph.thestorygraph,26,1720655608,1720655634,1720655634.9815478,-18000,EB445137-D7F5-57EC-87DA-1DB460D64046,"iPhone13,2"
com.doordash.dasher,129,1720655475,1720655604,1720655604.563551,-18000,EB445137-D7F5-57EC-87DA-1DB460D64046,"iPhone13,2"
com.doordash.dasher,13,1720655457,1720655470,1720655470.0681028,-18000,EB445137-D7F5-57EC-87DA-1DB460D64046,"iPhone13,2"
com.doordash.dasher,10,1720655438,1720655448,1720655448.6026611,-18000,EB445137-D7F5-57EC-87DA-1DB460D64046,"iPhone13,2"
com.doordash.dasher,8,1720655422,1720655430,1720655430.385798,-18000,EB445137-D7F5-57EC-87DA-1DB460D64046,"iPhone13,2"
com.doordash.dasher,689,1720654732,1720655421,1720655421.097477,-18000,EB445137-D7F5-57EC-87DA-1DB460D64046,"iPhone13,2"
com.doordash.dasher,80,1720654651,1720654731,1720654731.9315581,-18000,EB445137-D7F5-57EC-87DA-1DB460D64046,"iPhone13,2"
com.doordash.dasher,19,1720654622,1720654641,1720654641.999899,-18000,EB445137-D7F5-57EC-87DA-1DB460D64046,"iPhone13,2"
com.apple.podcasts,9,1720654613,1720654622,1720654623.927926,-18000,EB445137-D7F5-57EC-87DA-1DB460D64046,"iPhone13,2"
com.apple.podcasts,85,1720654212,1720654297,1720654297.871335,-18000,EB445137-D7F5-57EC-87DA-1DB460D64046,"iPhone13,2"
com.doordash.dasher,14,1720654198,1720654212,1720654213.316788,-18000,EB445137-D7F5-57EC-87DA-1DB460D64046,"iPhone13,2"
com.apple.podcasts,62,1720654136,1720654198,1720654198.805974,-18000,EB445137-D7F5-57EC-87DA-1DB460D64046,"iPhone13,2"
com.doordash.dasher,45,1720654088,1720654133,1720654133.4882522,-18000,EB445137-D7F5-57EC-87DA-1DB460D64046,"iPhone13,2"
com.doordash.dasher,33,1720652376,1720652409,1720652409.8714662,-18000,EB445137-D7F5-57EC-87DA-1DB460D64046,"iPhone13,2"
com.ryansponzilli.DeepSkyCatalog,4,1720652371,1720652375,1720652375.0149941,-18000,EB445137-D7F5-57EC-87DA-1DB460D64046,"iPhone13,2"
com.ryansponzilli.DeepSkyCatalog,3,1720652293,1720652296,1720652296.996263,-18000,EB445137-D7F5-57EC-87DA-1DB460D64046,"iPhone13,2"
com.google.Chrome,3,1720652285,1720652288,1720652288.726922,-18000,,
com.apple.finder,1,1720652284,1720652285,1720652286.0447922,-18000,,
com.microsoft.onenote.mac,7,1720652277,1720652284,1720652284.614876,-18000,,
com.google.android.studio,13,1720652264,1720652277,1720652277.2108622,-18000,,
com.microsoft.onenote.mac,11,1720652253,1720652264,1720652264.420861,-18000,,
com.google.android.studio,108,1720652145,1720652253,1720652253.9387,-18000,,
com.apple.dt.Xcode,167,1720651978,1720652145,1720652145.231451,-18000,,
com.apple.iphonesimulator,18,1720651960,1720651978,1720651978.249549,-18000,,
com.ryansponzilli.DeepSkyCatalog,63,1720651927,1720651990,1720651990.836479,-18000,EB445137-D7F5-57EC-87DA-1DB460D64046,"iPhone13,2"
com.ryansponzilli.DeepSkyCatalog,32,1720651860,1720651892,1720651892.015981,-18000,EB445137-D7F5-57EC-87DA-1DB460D64046,"iPhone13,2"
com.ryansponzilli.DeepSkyCatalog,31,1720651827,1720651858,1720651858.477613,-18000,EB445137-D7F5-57EC-87DA-1DB460D64046,"iPhone13,2"
com.apple.dt.Xcode,132,1720651815,1720651947,1720651947.894748,-18000,,
com.ryansponzilli.DeepSkyCatalog,33,1720651756,1720651789,1720651789.128581,-18000,EB445137-D7F5-57EC-87DA-1DB460D64046,"iPhone13,2"
com.ryansponzilli.DeepSkyCatalog,31,1720651710,1720651741,1720651741.295784,-18000,EB445137-D7F5-57EC-87DA-1DB460D64046,"iPhone13,2"
com.ryansponzilli.DeepSkyCatalog,31,1720651672,1720651703,1720651703.506397,-18000,EB445137-D7F5-57EC-87DA-1DB460D64046,"iPhone13,2"
com.ryansponzilli.DeepSkyCatalog,31,1720651624,1720651655,1720651655.92197,-18000,EB445137-D7F5-57EC-87DA-1DB460D64046,"iPhone13,2"
com.ryansponzilli.DeepSkyCatalog,37,1720651580,1720651617,1720651617.194397,-18000,EB445137-D7F5-57EC-87DA-1DB460D64046,"iPhone13,2"
com.ryansponzilli.DeepSkyCatalog,34,1720651475,1720651509,1720651509.416071,-18000,EB445137-D7F5-57EC-87DA-1DB460D64046,"iPhone13,2"
com.google.android.studio,441,1720651374,1720651815,1720651815.548547,-18000,,
com.microsoft.onenote.mac,2,1720651372,1720651374,1720651374.431081,-18000,,
com.ryansponzilli.DeepSkyCatalog,86,1720651361,1720651447,1720651447.531283,-18000,EB445137-D7F5-57EC-87DA-1DB460D64046,"iPhone13,2"
com.ebay.iphone,3,1720651356,1720651359,1720651359.9204621,-18000,EB445137-D7F5-57EC-87DA-1DB460D64046,"iPhone13,2"
com.google.android.studio,26,1720651346,1720651372,1720651372.909422,-18000,,
com.microsoft.onenote.mac,20,1720651326,1720651346,1720651346.473845,-18000,,
com.google.Chrome,206,1720651120,1720651326,1720651326.434727,-18000,,
com.google.android.studio,69,1720651051,1720651120,1720651120.243623,-18000,,
com.ebay.iphone,20,1720651021,1720651041,1720651041.3683228,-18000,EB445137-D7F5-57EC-87DA-1DB460D64046,"iPhone13,2"
com.apple.findmy,10,1720651011,1720651021,1720651022.1712961,-18000,EB445137-D7F5-57EC-87DA-1DB460D64046,"iPhone13,2"
com.microsoft.onenote.mac,1,1720650095,1720650096,1720650096.234209,-18000,,
com.google.android.studio,20,1720650075,1720650095,1720650095.514945,-18000,,
com.apple.SFSymbols,8,1720650067,1720650075,1720650075.8054109,-18000,,
com.google.android.studio,3,1720650064,1720650067,1720650067.669395,-18000,,
com.apple.dt.Xcode,7,1720650057,1720650064,1720650064.703907,-18000,,
com.google.android.studio,69,1720649988,1720650057,1720650057.694263,-18000,,
com.microsoft.onenote.mac,1,1720649987,1720649988,1720649988.727655,-18000,,
com.google.android.studio,22,1720649965,1720649987,1720649987.9446769,-18000,,
com.apple.SFSymbols,14,1720649951,1720649965,1720649965.425478,-18000,,
com.apple.dt.Xcode,3,1720649948,1720649951,1720649951.97947,-18000,,
com.google.android.studio,58,1720649890,1720649948,1720649948.701745,-18000,,
com.microsoft.onenote.mac,1,1720649889,1720649890,1720649890.542876,-18000,,
com.google.android.studio,24,1720649865,1720649889,1720649889.35515,-18000,,
com.apple.SFSymbols,9,1720649856,1720649865,1720649866.001289,-18000,,
com.apple.dt.Xcode,2,1720649854,1720649856,1720649857.002893,-18000,,
com.google.android.studio,189,1720649665,1720649854,1720649854.750626,-18000,,
com.apple.SFSymbols,6,1720649659,1720649665,1720649665.28118,-18000,,
com.google.android.studio,26,1720649633,1720649659,1720649659.094246,-18000,,
com.microsoft.onenote.mac,3,1720649630,1720649633,1720649633.19957,-18000,,
com.google.android.studio,8,1720649622,1720649630,1720649630.90555,-18000,,
com.microsoft.onenote.mac,2,1720649620,1720649622,1720649622.989316,-18000,,
com.google.android.studio,29,1720649591,1720649620,1720649620.399413,-18000,,
com.apple.SFSymbols,18,1720649573,1720649591,1720649591.504211,-18000,,
com.apple.dt.Xcode,23,1720649550,1720649573,1720649573.150813,-18000,,
com.google.Chrome,8,1720649542,1720649550,1720649550.684973,-18000,,
com.google.Chrome,893,1720646971,1720647864,1720647864.159203,-18000,,
com.google.android.studio,3,1720646968,1720646971,1720646971.627285,-18000,,
com.google.android.studio,752,1720643051,1720643803,1720643803.4930968,-18000,,
com.google.Chrome,107,1720642944,1720643051,1720643051.8581328,-18000,,
com.google.android.studio,369,1720642575,1720642944,1720642944.652725,-18000,,
com.google.Chrome,48,1720642527,1720642575,1720642575.07107,-18000,,
com.google.android.studio,474,1720642053,1720642527,1720642527.553442,-18000,,
com.apple.SFSymbols,10,1720642043,1720642053,1720642053.1619291,-18000,,
com.google.android.studio,3,1720642040,1720642043,1720642043.7280579,-18000,,
com.microsoft.onenote.mac,6,1720642034,1720642040,1720642040.8960629,-18000,,
com.google.android.studio,293,1720641741,1720642034,1720642034.202433,-18000,,
com.apple.SFSymbols,8,1720641733,1720641741,1720641741.740892,-18000,,
com.google.android.studio,25,1720641708,1720641733,1720641733.931919,-18000,,
com.apple.SFSymbols,9,1720641699,1720641708,1720641708.199754,-18000,,
com.google.android.studio,4,1720641695,1720641699,1720641699.928516,-18000,,
com.apple.dt.Xcode,3,1720641692,1720641695,1720641695.935896,-18000,,
com.google.android.studio,38,1720641654,1720641692,1720641692.264013,-18000,,
com.google.android.studio,597,1720641013,1720641610,1720641610.146195,-18000,,
com.google.Chrome,27,1720640986,1720641013,1720641013.956167,-18000,,
com.google.android.studio,145,1720640841,1720640986,1720640986.807661,-18000,,
com.google.Chrome,7,1720640834,1720640841,1720640841.592619,-18000,,
com.google.android.studio,8,1720640826,1720640834,1720640834.7566051,-18000,,
com.google.Chrome,4,1720640822,1720640826,1720640826.304861,-18000,,
com.google.android.studio,4,1720640818,1720640822,1720640822.783318,-18000,,
com.google.Chrome,11,1720640807,1720640818,1720640819.007704,-18000,,
com.google.android.studio,46,1720640761,1720640807,1720640807.964264,-18000,,
com.google.Chrome,1,1720640760,1720640761,1720640761.279419,-18000,,
com.google.android.studio,5,1720640755,1720640760,1720640760.3483958,-18000,,
com.google.Chrome,5,1720640750,1720640755,1720640755.262438,-18000,,
com.google.android.studio,3,1720640747,1720640750,1720640751.014564,-18000,,
com.google.Chrome,1,1720640746,1720640747,1720640747.9602041,-18000,,
com.google.android.studio,8,1720640738,1720640746,1720640746.2851949,-18000,,
com.google.Chrome,8,1720640730,1720640738,1720640738.600315,-18000,,
com.google.android.studio,41,1720640689,1720640730,1720640730.281187,-18000,,
com.google.Chrome,9,1720640680,1720640689,1720640689.354158,-18000,,
com.google.android.studio,22,1720640658,1720640680,1720640680.722615,-18000,,
com.google.Chrome,9,1720640649,1720640658,1720640658.494313,-18000,,
com.google.android.studio,3,1720640646,1720640649,1720640649.750885,-18000,,
com.google.Chrome,3,1720640643,1720640646,1720640646.490941,-18000,,
com.google.android.studio,1,1720640642,1720640643,1720640643.997315,-18000,,
com.google.Chrome,13,1720640629,1720640642,1720640642.174166,-18000,,
com.google.android.studio,1,1720640628,1720640629,1720640629.8912191,-18000,,
com.google.Chrome,2,1720640626,1720640628,1720640628.100398,-18000,,
com.google.android.studio,4,1720640622,1720640626,1720640627.024406,-18000,,
com.google.Chrome,13,1720640609,1720640622,1720640622.323802,-18000,,
com.google.android.studio,7,1720640602,1720640609,1720640609.633984,-18000,,
com.google.Chrome,1,1720640601,1720640602,1720640602.491957,-18000,,
com.google.android.studio,13,1720640588,1720640601,1720640601.123698,-18000,,
com.google.Chrome,13,1720640575,1720640588,1720640588.62361,-18000,,
com.google.android.studio,2,1720640573,1720640575,1720640575.4761639,-18000,,
com.google.Chrome,3,1720640570,1720640573,1720640573.447197,-18000,,
com.google.android.studio,10,1720640560,1720640570,1720640571.034443,-18000,,
com.google.Chrome,7,1720640553,1720640560,1720640560.100302,-18000,,
com.google.android.studio,12,1720640541,1720640553,1720640553.560598,-18000,,
com.google.Chrome,14,1720640527,1720640541,1720640541.7743669,-18000,,
com.google.android.studio,7,1720640520,1720640527,1720640527.310051,-18000,,
com.google.Chrome,4,1720640516,1720640520,1720640520.8313289,-18000,,
com.google.android.studio,5,1720640511,1720640516,1720640516.131909,-18000,,
com.apple.SFSymbols,2,1720640509,1720640511,1720640511.090229,-18000,,
com.google.Chrome,5,1720640504,1720640509,1720640510.023127,-18000,,
com.apple.SFSymbols,2,1720640502,1720640504,1720640504.731879,-18000,,
com.google.Chrome,14,1720640488,1720640502,1720640502.835761,-18000,,
com.apple.SFSymbols,0,1720640488,1720640488,1720640488.8362699,-18000,,
com.google.Chrome,2,1720640486,1720640488,1720640488.099602,-18000,,
com.apple.SFSymbols,1,1720640485,1720640486,1720640487.02215,-18000,,
com.google.Chrome,10,1720640475,1720640485,1720640485.842887,-18000,,
com.apple.SFSymbols,10,1720640465,1720640475,1720640475.666635,-18000,,
com.google.Chrome,5,1720640460,1720640465,1720640465.953553,-18000,,
com.google.android.studio,6,1720640454,1720640460,1720640460.454313,-18000,,
com.google.Chrome,1,1720640453,1720640454,1720640454.427702,-18000,,
com.google.android.studio,1,1720640452,1720640453,1720640453.730946,-18000,,
com.google.Chrome,4,1720640448,1720640452,1720640452.401917,-18000,,
com.google.android.studio,2,1720640446,1720640448,1720640448.602905,-18000,,
com.google.Chrome,9,1720640437,1720640446,1720640446.1321368,-18000,,
com.google.android.studio,7,1720640430,1720640437,1720640437.743867,-18000,,
com.google.Chrome,8,1720640422,1720640430,1720640430.354187,-18000,,
com.google.android.studio,18,1720640404,1720640422,1720640422.631318,-18000,,
com.apple.SFSymbols,2,1720640402,1720640404,1720640404.96157,-18000,,
com.apple.dt.Xcode,4,1720640398,1720640402,1720640402.351409,-18000,,
com.apple.SFSymbols,7,1720640391,1720640398,1720640398.316225,-18000,,
com.apple.dt.Xcode,40,1720640351,1720640391,1720640391.788172,-18000,,
com.apple.SFSymbols,3,1720640348,1720640351,1720640351.378834,-18000,,
com.apple.dt.Xcode,7,1720640341,1720640348,1720640348.300874,-18000,,
com.apple.SFSymbols,5,1720640336,1720640341,1720640341.289387,-18000,,
com.google.android.studio,5,1720640331,1720640336,1720640336.971084,-18000,,
com.google.Chrome,9,1720640322,1720640331,1720640331.9253988,-18000,,
com.google.android.studio,4,1720640318,1720640322,1720640322.59692,-18000,,
com.google.Chrome,3,1720640315,1720640318,1720640318.128121,-18000,,
com.google.android.studio,4,1720640311,1720640315,1720640315.509808,-18000,,
com.google.Chrome,3,1720640308,1720640311,1720640311.354281,-18000,,
com.google.android.studio,5,1720640303,1720640308,1720640308.069098,-18000,,
com.google.Chrome,133,1720640170,1720640303,1720640303.626505,-18000,,
com.google.android.studio,146,1720640024,1720640170,1720640170.767305,-18000,,
com.google.Chrome,10,1720640014,1720640024,1720640024.310439,-18000,,
com.google.android.studio,1,1720640013,1720640014,1720640014.200609,-18000,,
com.google.Chrome,2,1720640011,1720640013,1720640013.820472,-18000,,
com.google.android.studio,117,1720639894,1720640011,1720640011.559267,-18000,,
com.google.Chrome,52,1720639842,1720639894,1720639894.348783,-18000,,
com.google.android.studio,4,1720639838,1720639842,1720639842.587045,-18000,,
com.google.Chrome,75,1720639763,1720639838,1720639838.909377,-18000,,
com.google.android.studio,22,1720639741,1720639763,1720639763.2510018,-18000,,
com.google.Chrome,1,1720639740,1720639741,1720639741.922768,-18000,,
com.google.android.studio,16,1720639724,1720639740,1720639740.232596,-18000,,
com.google.Chrome,4,1720639720,1720639724,1720639724.336168,-18000,,
com.google.android.studio,8,1720639712,1720639720,1720639720.7857862,-18000,,
com.google.Chrome,1,1720639711,1720639712,1720639712.439426,-18000,,
com.google.android.studio,8,1720639703,1720639711,1720639711.166892,-18000,,
com.google.Chrome,19,1720639684,1720639703,1720639703.626606,-18000,,
com.google.android.studio,21,1720639663,1720639684,1720639684.904158,-18000,,
com.google.Chrome,22,1720639641,1720639663,1720639663.861786,-18000,,
com.google.android.studio,47,1720639594,1720639641,1720639641.905653,-18000,,
com.google.Chrome,6,1720639588,1720639594,1720639594.211092,-18000,,
com.google.android.studio,35,1720639553,1720639588,1720639588.880902,-18000,,
com.google.Chrome,85,1720639468,1720639553,1720639554.0406818,-18000,,
com.apple.MobileSMS,5,1720639463,1720639468,1720639468.323813,-18000,,
com.google.Chrome,5,1720639458,1720639463,1720639463.770916,-18000,,
com.google.Chrome,2,1720626733,1720626735,1720626735.859052,-18000,,
com.google.Chrome,141,1720626591,1720626732,1720626732.5903192,-18000,,
com.google.Chrome,1811,1720578216,1720580027,1720580028.0130649,-18000,,
com.google.Chrome,840,1720576857,1720577697,1720577697.054838,-18000,,
com.google.Chrome,789,1720575467,1720576256,1720576256.1345348,-18000,,
com.google.Chrome,5,1720575240,1720575245,1720575245.052658,-18000,,
com.google.android.studio,37,1720575203,1720575240,1720575240.651494,-18000,,
com.google.Chrome,6,1720574428,1720574434,1720574434.8110108,-18000,,
com.google.android.studio,6,1720574422,1720574428,1720574429.0315309,-18000,,
com.google.Chrome,1,1720574421,1720574422,1720574422.607584,-18000,,
com.google.android.studio,3,1720574418,1720574421,1720574421.864756,-18000,,
com.google.Chrome,1,1720574417,1720574418,1720574418.74161,-18000,,
com.google.android.studio,5,1720574412,1720574417,1720574417.970078,-18000,,
com.google.Chrome,1,1720574411,1720574412,1720574412.587257,-18000,,
com.google.android.studio,2,1720574409,1720574411,1720574411.287386,-18000,,
com.google.Chrome,35,1720574374,1720574409,1720574409.9569678,-18000,,
com.google.android.studio,9,1720574365,1720574374,1720574374.177202,-18000,,
com.google.Chrome,4,1720574361,1720574365,1720574365.741856,-18000,,
com.google.android.studio,7,1720574354,1720574361,1720574361.806487,-18000,,
com.google.Chrome,3,1720574351,1720574354,1720574354.7769241,-18000,,
com.google.android.studio,24,1720574327,1720574351,1720574352.018753,-18000,,
com.google.Chrome,37,1720574290,1720574327,1720574327.8786712,-18000,,
com.google.android.studio,273,1720574017,1720574290,1720574290.7591,-18000,,
com.google.Chrome,58,1720573959,1720574017,1720574017.707763,-18000,,
com.google.android.studio,6,1720573953,1720573959,1720573959.204516,-18000,,
com.google.Chrome,10,1720573943,1720573953,1720573953.546297,-18000,,
com.google.android.studio,8,1720573935,1720573943,1720573943.524409,-18000,,
com.google.Chrome,209,1720573726,1720573935,1720573935.198597,-18000,,
com.google.android.studio,8,1720573718,1720573726,1720573726.9414392,-18000,,
com.google.Chrome,1,1720573717,1720573718,1720573718.75126,-18000,,
com.google.android.studio,12,1720573705,1720573717,1720573717.036539,-18000,,
com.google.Chrome,1,1720573704,1720573705,1720573705.910911,-18000,,
com.google.android.studio,3,1720573701,1720573704,1720573704.8748078,-18000,,
com.google.Chrome,2,1720573699,1720573701,1720573701.8327909,-18000,,
com.google.android.studio,6,1720573693,1720573699,1720573699.2286968,-18000,,
com.google.Chrome,101,1720573592,1720573693,1720573693.697414,-18000,,
com.google.android.studio,108,1720573484,1720573592,1720573592.793888,-18000,,
com.apple.dt.Xcode,2,1720573482,1720573484,1720573484.746243,-18000,,
com.google.android.studio,24,1720573458,1720573482,1720573482.60037,-18000,,
com.apple.dt.Xcode,27,1720573431,1720573458,1720573458.801951,-18000,,
com.google.android.studio,129,1720573302,1720573431,1720573431.288192,-18000,,
com.google.Chrome,2,1720573300,1720573302,1720573302.3855119,-18000,,
com.google.android.studio,9,1720573291,1720573300,1720573300.558549,-18000,,
com.google.Chrome,1,1720573290,1720573291,1720573291.905643,-18000,,
com.google.android.studio,2,1720573288,1720573290,1720573290.1032128,-18000,,
com.google.Chrome,274,1720573014,1720573288,1720573288.591054,-18000,,
com.google.android.studio,191,1720572823,1720573014,1720573014.089241,-18000,,
com.google.Chrome,293,1720572530,1720572823,1720572823.866158,-18000,,
com.google.android.studio,881,1720571649,1720572530,1720572531.000545,-18000,,
com.apple.dt.Xcode,56,1720571593,1720571649,1720571649.603486,-18000,,
com.google.android.studio,118,1720571475,1720571593,1720571593.40853,-18000,,
com.apple.dt.Xcode,1,1720571474,1720571475,1720571475.327882,-18000,,
com.google.android.studio,4,1720571470,1720571474,1720571474.422155,-18000,,
com.apple.dt.Xcode,1,1720571469,1720571470,1720571470.8331962,-18000,,
com.google.android.studio,6,1720571463,1720571469,1720571469.252274,-18000,,
com.apple.dt.Xcode,6,1720571457,1720571463,1720571463.0850239,-18000,,
com.google.android.studio,15,1720571442,1720571457,1720571457.257481,-18000,,
com.apple.dt.Xcode,8,1720571434,1720571442,1720571442.397927,-18000,,
com.google.android.studio,5,1720571429,1720571434,1720571434.9244409,-18000,,
com.apple.dt.Xcode,34,1720571395,1720571429,1720571429.81587,-18000,,
com.google.android.studio,184,1720571211,1720571395,1720571395.701981,-18000,,
com.google.Chrome,43,1720571168,1720571211,1720571211.203399,-18000,,
com.google.android.studio,6,1720571162,1720571168,1720571168.55365,-18000,,
com.google.Chrome,7,1720571155,1720571162,1720571162.729526,-18000,,
com.google.android.studio,3,1720571152,1720571155,1720571155.043717,-18000,,
com.google.Chrome,112,1720571040,1720571152,1720571152.742185,-18000,,
com.google.android.studio,3,1720571037,1720571040,1720571040.777096,-18000,,
com.google.Chrome,1,1720571036,1720571037,1720571038.0613909,-18000,,
com.google.android.studio,25,1720571011,1720571036,1720571036.5169458,-18000,,
com.google.Chrome,13,1720570998,1720571011,1720571011.961036,-18000,,
com.google.android.studio,538,1720570460,1720570998,1720570998.39564,-18000,,
com.google.Chrome,27,1720570433,1720570460,1720570460.3127198,-18000,,
com.google.android.studio,170,1720570263,1720570433,1720570433.317288,-18000,,
com.google.Chrome,23,1720570168,1720570191,1720570191.5387468,-18000,,
com.google.Chrome,300,1720569732,1720570032,1720570032.190361,-18000,,
com.doordash.dasher,33,1720501356,1720501389,1720501389.234819,-18000,EB445137-D7F5-57EC-87DA-1DB460D64046,"iPhone13,2"
com.doordash.dasher,48,1720501304,1720501352,1720501352.697318,-18000,EB445137-D7F5-57EC-87DA-1DB460D64046,"iPhone13,2"
com.apple.mobiletimer,7,1720501289,1720501296,1720501296.9406009,-18000,EB445137-D7F5-57EC-87DA-1DB460D64046,"iPhone13,2"
com.apple.mobiletimer,12,1720500654,1720500666,1720500666.967936,-18000,EB445137-D7F5-57EC-87DA-1DB460D64046,"iPhone13,2"
com.apple.mobiletimer,9,1720500641,1720500650,1720500650.761623,-18000,EB445137-D7F5-57EC-87DA-1DB460D64046,"iPhone13,2"
com.apple.journal,935,1720499701,1720500636,1720500636.224344,-18000,EB445137-D7F5-57EC-87DA-1DB460D64046,"iPhone13,2"
com.thestorygraph.thestorygraph,31,1720499664,1720499695,1720499695.825969,-18000,EB445137-D7F5-57EC-87DA-1DB460D64046,"iPhone13,2"
com.apple.MobileSMS,5,1720499658,1720499663,1720499663.925107,-18000,EB445137-D7F5-57EC-87DA-1DB460D64046,"iPhone13,2"
com.apple.MobileSMS,10,1720498421,1720498431,1720498431.451369,-18000,EB445137-D7F5-57EC-87DA-1DB460D64046,"iPhone13,2"
com.apple.MobileSMS,13,1720496908,1720496921,1720496921.843172,-18000,EB445137-D7F5-57EC-87DA-1DB460D64046,"iPhone13,2"
com.apple.MobileSMS,3,1720496903,1720496906,1720496906.419466,-18000,EB445137-D7F5-57EC-87DA-1DB460D64046,"iPhone13,2"
com.apple.MobileSMS,3,1720495805,1720495808,1720495808.048945,-18000,EB445137-D7F5-57EC-87DA-1DB460D64046,"iPhone13,2"
com.apple.MobileSMS,21,1720495316,1720495337,1720495337.12905,-18000,EB445137-D7F5-57EC-87DA-1DB460D64046,"iPhone13,2"
com.google.Chrome,1601,1720494924,1720496525,1720496525.736637,-18000,,
com.apple.MobileSMS,18,1720494603,1720494621,1720494621.606938,-18000,EB445137-D7F5-57EC-87DA-1DB460D64046,"iPhone13,2"
com.google.Chrome,352,1720494546,1720494898,1720494898.5950751,-18000,,
com.apple.MobileSMS,3,1720494497,1720494500,1720494500.29758,-18000,EB445137-D7F5-57EC-87DA-1DB460D64046,"iPhone13,2"
com.google.Chrome,620,1720493429,1720494049,1720494049.280709,-18000,,
com.google.Chrome,280,1720492405,1720492685,1720492685.3068008,-18000,,
com.google.Chrome,431,1720491778,1720492209,1720492209.5711842,-18000,,
com.myfitnesspal.mfp,65,1720491645,1720491710,1720491710.781184,-18000,EB445137-D7F5-57EC-87DA-1DB460D64046,"iPhone13,2"
com.google.Chrome,653,1720490792,1720491445,1720491445.155462,-18000,,
com.apple.MobileSMS,5,1720490362,1720490367,1720490367.171129,-18000,EB445137-D7F5-57EC-87DA-1DB460D64046,"iPhone13,2"
com.apple.mobilenotes,43,1720490319,1720490362,1720490362.3138041,-18000,EB445137-D7F5-57EC-87DA-1DB460D64046,"iPhone13,2"
com.google.Chrome,385,1720490150,1720490535,1720490535.3075418,-18000,,
com.tier9digital.sundial,61,1720489954,1720490015,1720490015.367758,-18000,EB445137-D7F5-57EC-87DA-1DB460D64046,"iPhone13,2"
com.ryansponzilli.DeepSkyCatalog,4,1720489935,1720489939,1720489939.83377,-18000,EB445137-D7F5-57EC-87DA-1DB460D64046,"iPhone13,2"
com.google.android.studio,850,1720489300,1720490150,1720490150.187625,-18000,,
com.ryansponzilli.DeepSkyCatalog,56,1720489283,1720489339,1720489339.938703,-18000,EB445137-D7F5-57EC-87DA-1DB460D64046,"iPhone13,2"
com.myfitnesspal.mfp,4,1720489277,1720489281,1720489281.675627,-18000,EB445137-D7F5-57EC-87DA-1DB460D64046,"iPhone13,2"
com.google.Chrome,1,1720488951,1720488952,1720488953.04585,-18000,,
com.apple.dt.Xcode,4,1720488947,1720488951,1720488951.865202,-18000,,
com.google.Chrome,1,1720488946,1720488947,1720488947.257191,-18000,,
com.google.android.studio,323,1720488623,1720488946,1720488946.244547,-18000,,
com.google.Chrome,41,1720488582,1720488623,1720488623.329784,-18000,,
com.apple.dt.Xcode,2,1720488580,1720488582,1720488582.057028,-18000,,
com.google.android.studio,11,1720488569,1720488580,1720488580.913045,-18000,,
com.apple.dt.Xcode,3,1720488566,1720488569,1720488569.270268,-18000,,
com.google.Chrome,35,1720488531,1720488566,1720488566.225288,-18000,,
com.apple.dt.Xcode,7,1720488524,1720488531,1720488532.025062,-18000,,
com.google.android.studio,273,1720488251,1720488524,1720488524.071704,-18000,,
com.apple.dt.Xcode,13,1720488238,1720488251,1720488251.381927,-18000,,
com.google.android.studio,134,1720488104,1720488238,1720488238.4115272,-18000,,
com.google.Chrome,17,1720488087,1720488104,1720488104.1895251,-18000,,
com.google.android.studio,1,1720488086,1720488087,1720488087.570262,-18000,,
com.apple.dt.Xcode,0,1720488086,1720488086,1720488086.514086,-18000,,
com.google.android.studio,124,1720487962,1720488086,1720488086.1290789,-18000,,
com.apple.dt.Xcode,2,1720487960,1720487962,1720487962.3872771,-18000,,
com.google.Chrome,19,1720487941,1720487960,1720487960.905858,-18000,,
com.apple.dt.Xcode,3,1720487938,1720487941,1720487941.1771312,-18000,,
com.google.android.studio,158,1720487780,1720487938,1720487938.981498,-18000,,
com.apple.dt.Xcode,2,1720487778,1720487780,1720487780.5633922,-18000,,
com.google.android.studio,26,1720487752,1720487778,1720487778.889206,-18000,,
com.apple.dt.Xcode,11,1720487741,1720487752,1720487752.6899939,-18000,,
com.google.android.studio,1,1720487740,1720487741,1720487741.095618,-18000,,
com.apple.dt.Xcode,1,1720487739,1720487740,1720487740.3594232,-18000,,
com.google.Chrome,1,1720487738,1720487739,1720487739.774915,-18000,,
com.google.android.studio,191,1720487547,1720487738,1720487738.8303819,-18000,,
com.google.Chrome,1,1720487546,1720487547,1720487547.492413,-18000,,
com.apple.dt.Xcode,6,1720487540,1720487546,1720487546.6682072,-18000,,
com.google.Chrome,1,1720487539,1720487540,1720487540.74544,-18000,,
com.google.android.studio,53,1720487486,1720487539,1720487539.8286052,-18000,,
com.google.Chrome,1,1720487485,1720487486,1720487486.48639,-18000,,
com.apple.dt.Xcode,5,1720487480,1720487485,1720487485.536741,-18000,,
com.google.Chrome,1,1720487479,1720487480,1720487480.865407,-18000,,
com.google.android.studio,137,1720487342,1720487479,1720487479.777134,-18000,,
com.google.Chrome,25,1720487317,1720487342,1720487342.1291971,-18000,,
com.google.android.studio,75,1720487242,1720487317,1720487317.077477,-18000,,
com.google.Chrome,1,1720487241,1720487242,1720487242.570333,-18000,,
com.google.android.studio,2,1720487239,1720487241,1720487241.878139,-18000,,
com.google.Chrome,59,1720487180,1720487239,1720487239.081337,-18000,,
com.google.android.studio,3,1720487177,1720487180,1720487180.712881,-18000,,
com.google.Chrome,138,1720487039,1720487177,1720487177.6727362,-18000,,
com.google.android.studio,8,1720487031,1720487039,1720487039.780684,-18000,,
com.google.Chrome,25,1720487006,1720487031,1720487031.81608,-18000,,
com.google.android.studio,50,1720486956,1720487006,1720487006.986934,-18000,,
com.google.Chrome,3,1720486953,1720486956,1720486956.251822,-18000,,
com.google.android.studio,13,1720486940,1720486953,1720486953.8205662,-18000,,
com.google.Chrome,56,1720486884,1720486940,1720486940.222085,-18000,,
com.google.android.studio,13,1720486871,1720486884,1720486884.518688,-18000,,
com.apple.dt.Xcode,1,1720486870,1720486871,1720486871.7988238,-18000,,
com.google.android.studio,66,1720486804,1720486870,1720486871.015507,-18000,,
com.apple.dt.Xcode,1,1720486803,1720486804,1720486804.0819101,-18000,,
com.google.android.studio,5,1720486798,1720486803,1720486803.359551,-18000,,
com.apple.dt.Xcode,6,1720486792,1720486798,1720486798.774609,-18000,,
com.google.android.studio,3,1720486789,1720486792,1720486792.784559,-18000,,
com.apple.dt.Xcode,21,1720486768,1720486789,1720486789.713455,-18000,,
com.google.android.studio,10,1720486758,1720486768,1720486768.631743,-18000,,
com.google.Chrome,2,1720486756,1720486758,1720486758.568959,-18000,,
com.google.android.studio,13,1720486743,1720486756,1720486756.85127,-18000,,
com.google.Chrome,1,1720486742,1720486743,1720486743.885906,-18000,,
com.apple.dt.Xcode,9,1720486733,1720486742,1720486742.866194,-18000,,
com.google.Chrome,1,1720486732,1720486733,1720486733.844877,-18000,,
com.google.android.studio,87,1720486645,1720486732,1720486732.6338549,-18000,,
com.google.Chrome,20,1720486625,1720486645,1720486645.7110891,-18000,,
com.google.android.studio,5,1720486620,1720486625,1720486625.644308,-18000,,
com.apple.finder,31,1720486589,1720486620,1720486620.878573,-18000,,
com.google.Chrome,65,1720486524,1720486589,1720486589.6088061,-18000,,
com.apple.finder,1,1720486523,1720486524,1720486524.264059,-18000,,
com.apple.dt.Xcode,1,1720486522,1720486523,1720486523.380069,-18000,,
com.google.android.studio,3,1720486519,1720486522,1720486522.586856,-18000,,
com.apple.dt.Xcode,7,1720486512,1720486519,1720486519.4062362,-18000,,
com.google.Chrome,22,1720486490,1720486512,1720486512.7087688,-18000,,
com.apple.dt.Xcode,3,1720486487,1720486490,1720486490.135632,-18000,,
com.google.Chrome,24,1720486463,1720486487,1720486487.6736422,-18000,,
com.apple.dt.Xcode,1,1720486462,1720486463,1720486463.862998,-18000,,
com.google.android.studio,23,1720486439,1720486462,1720486462.426269,-18000,,
com.apple.dt.Xcode,4,1720486435,1720486439,1720486439.514909,-18000,,
com.google.Chrome,40,1720486395,1720486435,1720486435.508465,-18000,,
com.apple.dt.Xcode,2,1720486393,1720486395,1720486395.156444,-18000,,
com.google.android.studio,34,1720486359,1720486393,1720486393.330791,-18000,,
com.apple.dt.Xcode,3,1720486356,1720486359,1720486359.4403481,-18000,,
com.google.Chrome,95,1720486261,1720486356,1720486356.8218231,-18000,,
com.apple.dt.Xcode,1,1720486260,1720486261,1720486261.144341,-18000,,
com.google.Chrome,24,1720486236,1720486260,1720486260.160938,-18000,,
com.apple.dt.Xcode,7,1720486229,1720486236,1720486236.3690782,-18000,,
com.google.Chrome,24,1720486205,1720486229,1720486229.994786,-18000,,
com.apple.dt.Xcode,2,1720486203,1720486205,1720486205.105634,-18000,,
com.google.android.studio,33,1720486170,1720486203,1720486204.011249,-18000,,
com.apple.dt.Xcode,4,1720486166,1720486170,1720486170.996362,-18000,,
com.google.android.studio,83,1720486083,1720486166,1720486166.932073,-18000,,
com.apple.dt.Xcode,5,1720486078,1720486083,1720486083.7797709,-18000,,
com.google.android.studio,55,1720486023,1720486078,1720486078.365515,-18000,,
com.google.Chrome,54,1720485969,1720486023,1720486023.2294579,-18000,,
com.google.android.studio,30,1720485939,1720485969,1720485969.765475,-18000,,
com.apple.dt.Xcode,5,1720485934,1720485939,1720485939.9397612,-18000,,
com.google.android.studio,7,1720485927,1720485934,1720485935.0317922,-18000,,
com.apple.dt.Xcode,5,1720485922,1720485927,1720485927.461746,-18000,,
com.google.android.studio,17,1720485905,1720485922,1720485922.198422,-18000,,
com.apple.dt.Xcode,3,1720485902,1720485905,1720485905.3723512,-18000,,
com.google.android.studio,7,1720485895,1720485902,1720485903.054243,-18000,,
com.apple.dt.Xcode,2,1720485893,1720485895,1720485895.2055721,-18000,,
com.google.android.studio,14,1720485879,1720485893,1720485893.370986,-18000,,
com.apple.dt.Xcode,1,1720485878,1720485879,1720485879.899843,-18000,,
com.google.android.studio,2,1720485876,1720485878,1720485878.039417,-18000,,
com.apple.dt.Xcode,17,1720485859,1720485876,1720485876.274181,-18000,,
com.google.Chrome,104,1720485755,1720485859,1720485859.3447208,-18000,,
com.apple.dt.Xcode,13,1720485742,1720485755,1720485755.071908,-18000,,
com.google.android.studio,2,1720485740,1720485742,1720485742.253082,-18000,,
com.google.Chrome,1,1720485739,1720485740,1720485740.257362,-18000,,
com.google.android.studio,11,1720485728,1720485739,1720485739.540022,-18000,,
com.google.Chrome,1,1720485727,1720485728,1720485728.9413671,-18000,,
com.google.android.studio,10,1720485717,1720485727,1720485727.228215,-18000,,
com.google.Chrome,28,1720485689,1720485717,1720485717.375976,-18000,,
com.google.android.studio,5,1720485684,1720485689,1720485689.258583,-18000,,
com.apple.dt.Xcode,2,1720485682,1720485684,1720485684.9646869,-18000,,
com.google.android.studio,14,1720485668,1720485682,1720485682.2566462,-18000,,
com.apple.dt.Xcode,6,1720485662,1720485668,1720485668.2039828,-18000,,
com.google.android.studio,2,1720485660,1720485662,1720485662.071847,-18000,,
com.apple.dt.Xcode,4,1720485656,1720485660,1720485660.125739,-18000,,
com.google.android.studio,1,1720485655,1720485656,1720485656.771696,-18000,,
com.apple.dt.Xcode,2,1720485653,1720485655,1720485655.082629,-18000,,
com.google.android.studio,10,1720485643,1720485653,1720485653.1742811,-18000,,
com.apple.dt.Xcode,3,1720485640,1720485643,1720485643.125718,-18000,,
com.google.android.studio,6,1720485634,1720485640,1720485640.920891,-18000,,
com.apple.dt.Xcode,0,1720485634,1720485634,1720485634.900347,-18000,,
com.google.android.studio,13,1720485621,1720485634,1720485634.324442,-18000,,
com.apple.dt.Xcode,2,1720485619,1720485621,1720485621.751576,-18000,,
com.google.android.studio,7,1720485612,1720485619,1720485619.634719,-18000,,
com.apple.dt.Xcode,3,1720485609,1720485612,1720485612.085213,-18000,,
com.google.android.studio,5,1720485604,1720485609,1720485609.296463,-18000,,
com.apple.dt.Xcode,3,1720485601,1720485604,1720485604.6482491,-18000,,
com.google.android.studio,8,1720485593,1720485601,1720485601.868371,-18000,,
com.apple.dt.Xcode,1,1720485592,1720485593,1720485593.960545,-18000,,
com.google.android.studio,23,1720485569,1720485592,1720485592.73674,-18000,,
com.apple.dt.Xcode,10,1720485559,1720485569,1720485569.962033,-18000,,
com.google.android.studio,34,1720485525,1720485559,1720485559.673392,-18000,,
com.apple.dt.Xcode,1,1720485524,1720485525,1720485525.630805,-18000,,
com.google.android.studio,12,1720485512,1720485524,1720485524.479739,-18000,,
com.apple.dt.Xcode,3,1720485509,1720485512,1720485512.419259,-18000,,
com.google.android.studio,8,1720485501,1720485509,1720485509.9640222,-18000,,
com.apple.dt.Xcode,1,1720485500,1720485501,1720485501.911936,-18000,,
com.google.android.studio,21,1720485479,1720485500,1720485500.176355,-18000,,
com.apple.dt.Xcode,13,1720485466,1720485479,1720485479.400413,-18000,,
com.google.android.studio,7,1720485459,1720485466,1720485466.08115,-18000,,
com.apple.dt.Xcode,3,1720485456,1720485459,1720485459.239506,-18000,,
com.google.android.studio,2,1720485454,1720485456,1720485456.702448,-18000,,
com.apple.dt.Xcode,4,1720485450,1720485454,1720485454.180053,-18000,,
com.google.android.studio,2,1720485448,1720485450,1720485450.69833,-18000,,
com.apple.dt.Xcode,3,1720485445,1720485448,1720485448.108612,-18000,,
com.google.android.studio,4,1720485441,1720485445,1720485445.3664331,-18000,,
com.apple.dt.Xcode,1,1720485440,1720485441,1720485441.889112,-18000,,
com.google.android.studio,16,1720485424,1720485440,1720485440.594576,-18000,,
com.apple.dt.Xcode,1,1720485423,1720485424,1720485424.7850718,-18000,,
com.google.android.studio,5,1720485418,1720485423,1720485423.613677,-18000,,
com.apple.dt.Xcode,3,1720485415,1720485418,1720485418.2234411,-18000,,
com.google.android.studio,2,1720485413,1720485415,1720485415.1503959,-18000,,
com.apple.dt.Xcode,1,1720485412,1720485413,1720485414.035064,-18000,,
com.google.android.studio,2,1720485410,1720485412,1720485412.26587,-18000,,
com.apple.dt.Xcode,4,1720485406,1720485410,1720485410.688559,-18000,,
com.google.android.studio,3,1720485403,1720485406,1720485406.570795,-18000,,
com.apple.dt.Xcode,2,1720485401,1720485403,1720485403.201281,-18000,,
com.google.android.studio,2,1720485399,1720485401,1720485401.6039019,-18000,,
com.apple.dt.Xcode,1,1720485398,1720485399,1720485399.119821,-18000,,
com.google.android.studio,2,1720485396,1720485398,1720485398.233536,-18000,,
com.apple.dt.Xcode,4,1720485392,1720485396,1720485396.207581,-18000,,
com.google.android.studio,3,1720485389,1720485392,1720485392.174622,-18000,,
com.apple.dt.Xcode,2,1720485387,1720485389,1720485389.080715,-18000,,
com.google.android.studio,4,1720485383,1720485387,1720485387.358965,-18000,,
com.apple.dt.Xcode,2,1720485381,1720485383,1720485383.422666,-18000,,
com.google.android.studio,1,1720485380,1720485381,1720485381.479703,-18000,,
com.apple.dt.Xcode,2,1720485378,1720485380,1720485380.726644,-18000,,
com.google.android.studio,26,1720485352,1720485378,1720485378.189573,-18000,,
com.apple.dt.Xcode,1,1720485351,1720485352,1720485352.726012,-18000,,
com.google.android.studio,3,1720485348,1720485351,1720485351.587414,-18000,,
com.apple.dt.Xcode,2,1720485346,1720485348,1720485348.074102,-18000,,
com.google.android.studio,2,1720485344,1720485346,1720485347.023614,-18000,,
com.apple.dt.Xcode,2,1720485342,1720485344,1720485344.164485,-18000,,
com.google.android.studio,74,1720485268,1720485342,1720485342.694416,-18000,,
com.apple.dt.Xcode,1,1720485267,1720485268,1720485268.827745,-18000,,
com.google.android.studio,3,1720485264,1720485267,1720485267.571206,-18000,,
com.apple.dt.Xcode,4,1720485260,1720485264,1720485264.665581,-18000,,
com.google.android.studio,20,1720485240,1720485260,1720485260.601231,-18000,,
com.apple.dt.Xcode,3,1720485237,1720485240,1720485240.298757,-18000,,
com.google.android.studio,5,1720485232,1720485237,1720485237.5247169,-18000,,
com.apple.dt.Xcode,28,1720485204,1720485232,1720485232.3549361,-18000,,
com.google.android.studio,9,1720485195,1720485204,1720485204.880795,-18000,,
com.apple.dt.Xcode,1,1720485194,1720485195,1720485196.01016,-18000,,
com.google.android.studio,4,1720485190,1720485194,1720485194.846302,-18000,,
com.apple.dt.Xcode,1,1720485189,1720485190,1720485190.3609462,-18000,,
com.google.android.studio,2,1720485187,1720485189,1720485189.4874291,-18000,,
com.apple.dt.Xcode,1,1720485186,1720485187,1720485187.52209,-18000,,
com.google.android.studio,2,1720485184,1720485186,1720485186.599289,-18000,,
com.apple.dt.Xcode,1,1720485183,1720485184,1720485184.311933,-18000,,
com.google.android.studio,3,1720485180,1720485183,1720485183.389059,-18000,,
com.apple.dt.Xcode,1,1720485179,1720485180,1720485180.514735,-18000,,
com.google.android.studio,4,1720485175,1720485179,1720485179.73718,-18000,,
com.apple.dt.Xcode,1,1720485174,1720485175,1720485175.653192,-18000,,
com.google.android.studio,2,1720485172,1720485174,1720485174.497396,-18000,,
com.apple.dt.Xcode,1,1720485171,1720485172,1720485172.510277,-18000,,
com.google.android.studio,2,1720485169,1720485171,1720485171.797793,-18000,,
com.apple.dt.Xcode,1,1720485168,1720485169,1720485169.984983,-18000,,
com.google.android.studio,5,1720485163,1720485168,1720485168.490741,-18000,,
com.apple.dt.Xcode,5,1720485158,1720485163,1720485163.896801,-18000,,
com.google.android.studio,51,1720485107,1720485158,1720485158.6359348,-18000,,
com.apple.dt.Xcode,24,1720485083,1720485107,1720485107.518382,-18000,,
com.google.android.studio,16,1720485067,1720485083,1720485083.662098,-18000,,
com.apple.dt.Xcode,2,1720485065,1720485067,1720485067.448794,-18000,,
com.google.android.studio,9,1720485056,1720485065,1720485065.4978771,-18000,,
com.apple.dt.Xcode,4,1720485052,1720485056,1720485056.6987162,-18000,,
com.google.android.studio,3,1720485049,1720485052,1720485052.940686,-18000,,
com.apple.dt.Xcode,6,1720485043,1720485049,1720485049.211495,-18000,,
com.google.android.studio,1,1720485042,1720485043,1720485043.889075,-18000,,
com.apple.dt.Xcode,3,1720485039,1720485042,1720485042.256425,-18000,,
com.google.android.studio,15,1720485024,1720485039,1720485039.6019611,-18000,,
com.apple.dt.Xcode,43,1720484981,1720485024,1720485024.76396,-18000,,
com.google.android.studio,14,1720484967,1720484981,1720484981.508333,-18000,,
com.apple.dt.Xcode,7,1720484960,1720484967,1720484967.637764,-18000,,
com.google.Chrome,9,1720484951,1720484960,1720484960.285404,-18000,,
com.myfitnesspal.mfp,64,1720484881,1720484945,1720484945.710491,-18000,EB445137-D7F5-57EC-87DA-1DB460D64046,"iPhone13,2"
com.apple.news,535,1720484189,1720484724,1720484724.998022,-18000,EB445137-D7F5-57EC-87DA-1DB460D64046,"iPhone13,2"
com.hammerandchisel.discord,8,1720484176,1720484184,1720484184.284326,-18000,EB445137-D7F5-57EC-87DA-1DB460D64046,"iPhone13,2"
com.thestorygraph.thestorygraph,18,1720484140,1720484158,1720484158.340333,-18000,EB445137-D7F5-57EC-87DA-1DB460D64046,"iPhone13,2"
com.google.chrome.ios,6,1720484129,1720484135,1720484135.079373,-18000,EB445137-D7F5-57EC-87DA-1DB460D64046,"iPhone13,2"
com.google.chrome.ios,31,1720482805,1720482836,1720482836.564228,-18000,EB445137-D7F5-57EC-87DA-1DB460D64046,"iPhone13,2"
Astrospheric.Astrospheric,35,1720482430,1720482465,1720482465.565555,-18000,EB445137-D7F5-57EC-87DA-1DB460D64046,"iPhone13,2"
com.apple.weather,6,1720482422,1720482428,1720482428.901043,-18000,EB445137-D7F5-57EC-87DA-1DB460D64046,"iPhone13,2"
com.doordash.dasher,1,1720482421,1720482422,1720482422.937697,-18000,EB445137-D7F5-57EC-87DA-1DB460D64046,"iPhone13,2"
com.doordash.dasher,10,1720480613,1720480623,1720480623.1656752,-18000,EB445137-D7F5-57EC-87DA-1DB460D64046,"iPhone13,2"
com.apple.MobileSMS,4,1720480609,1720480613,1720480613.9494128,-18000,EB445137-D7F5-57EC-87DA-1DB460D64046,"iPhone13,2"
com.apple.MobileSMS,4,1720478778,1720478782,1720478782.446824,-18000,EB445137-D7F5-57EC-87DA-1DB460D64046,"iPhone13,2"
com.apple.mobiletimer,25,1720478753,1720478778,1720478778.7526999,-18000,EB445137-D7F5-57EC-87DA-1DB460D64046,"iPhone13,2"
com.apple.camera,0,1720477862,1720477862,1720477862.992564,-18000,EB445137-D7F5-57EC-87DA-1DB460D64046,"iPhone13,2"
com.apple.mobiletimer,16,1720477846,1720477862,1720477862.9931479,-18000,EB445137-D7F5-57EC-87DA-1DB460D64046,"iPhone13,2"
com.apple.mobiletimer,11,1720477812,1720477823,1720477823.6908932,-18000,EB445137-D7F5-57EC-87DA-1DB460D64046,"iPhone13,2"
com.apple.mobiletimer,1,1720477388,1720477389,1720477389.0460582,-18000,EB445137-D7F5-57EC-87DA-1DB460D64046,"iPhone13,2"
com.apple.mobiletimer,8,1720476606,1720476614,1720476614.4206839,-18000,EB445137-D7F5-57EC-87DA-1DB460D64046,"iPhone13,2"
com.apple.findmy,5,1720476599,1720476604,1720476604.975008,-18000,EB445137-D7F5-57EC-87DA-1DB460D64046,"iPhone13,2"
com.apple.news,4,1720476595,1720476599,1720476599.254714,-18000,EB445137-D7F5-57EC-87DA-1DB460D64046,"iPhone13,2"
com.apple.camera,5,1720476573,1720476578,1720476578.366574,-18000,EB445137-D7F5-57EC-87DA-1DB460D64046,"iPhone13,2"
com.apple.news,10,1720476568,1720476578,1720476578.3628569,-18000,EB445137-D7F5-57EC-87DA-1DB460D64046,"iPhone13,2"
com.google.Chrome,4,1720474083,1720474087,1720474087.146307,-18000,,
com.apple.news,5,1720474076,1720474081,1720474081.723044,-18000,EB445137-D7F5-57EC-87DA-1DB460D64046,"iPhone13,2"
com.microsoft.onenote.mac,35,1720474048,1720474083,1720474083.4286308,-18000,,
com.google.Chrome,134,1720473914,1720474048,1720474048.7826328,-18000,,
com.apple.news,146,1720473819,1720473965,1720473965.947185,-18000,EB445137-D7F5-57EC-87DA-1DB460D64046,"iPhone13,2"
com.apple.MobileSMS,16,1720473723,1720473739,1720473739.508867,-18000,,
com.google.chrome.ios,86,1720473557,1720473643,1720473643.650722,-18000,EB445137-D7F5-57EC-87DA-1DB460D64046,"iPhone13,2"
com.ebay.iphone,3,1720473554,1720473557,1720473557.4977698,-18000,EB445137-D7F5-57EC-87DA-1DB460D64046,"iPhone13,2"
com.google.chrome.ios,16,1720473538,1720473554,1720473554.095704,-18000,EB445137-D7F5-57EC-87DA-1DB460D64046,"iPhone13,2"
com.ebay.iphone,15,1720473523,1720473538,1720473538.532965,-18000,EB445137-D7F5-57EC-87DA-1DB460D64046,"iPhone13,2"
com.myfitnesspal.mfp,8,1720473511,1720473519,1720473519.340135,-18000,EB445137-D7F5-57EC-87DA-1DB460D64046,"iPhone13,2"
com.google.Chrome,267,1720473456,1720473723,1720473723.657535,-18000,,
com.myfitnesspal.mfp,120,1720473304,1720473424,1720473424.269283,-18000,EB445137-D7F5-57EC-87DA-1DB460D64046,"iPhone13,2"
com.apple.findmy,52,1720473250,1720473302,1720473302.625834,-18000,EB445137-D7F5-57EC-87DA-1DB460D64046,"iPhone13,2"
com.myfitnesspal.mfp,1,1720473249,1720473250,1720473250.675332,-18000,EB445137-D7F5-57EC-87DA-1DB460D64046,"iPhone13,2"
com.apple.Music,5,1720473244,1720473249,1720473249.1237268,-18000,EB445137-D7F5-57EC-87DA-1DB460D64046,"iPhone13,2"
com.apple.Music,5,1720473076,1720473081,1720473081.187546,-18000,EB445137-D7F5-57EC-87DA-1DB460D64046,"iPhone13,2"
com.apple.Music,13,1720472325,1720472338,1720472338.073091,-18000,EB445137-D7F5-57EC-87DA-1DB460D64046,"iPhone13,2"
com.apple.Music,23,1720472018,1720472041,1720472041.032837,-18000,EB445137-D7F5-57EC-87DA-1DB460D64046,"iPhone13,2"
com.apple.Music,3,1720471826,1720471829,1720471829.444457,-18000,EB445137-D7F5-57EC-87DA-1DB460D64046,"iPhone13,2"
com.apple.reminders,4,1720471813,1720471817,1720471817.189774,-18000,EB445137-D7F5-57EC-87DA-1DB460D64046,"iPhone13,2"
com.doordash.dasher,8,1720471803,1720471811,1720471811.256468,-18000,EB445137-D7F5-57EC-87DA-1DB460D64046,"iPhone13,2"
com.ebay.iphone,105,1720471695,1720471800,1720471800.053876,-18000,EB445137-D7F5-57EC-87DA-1DB460D64046,"iPhone13,2"
com.apple.weather,5,1720471690,1720471695,1720471695.645053,-18000,EB445137-D7F5-57EC-87DA-1DB460D64046,"iPhone13,2"
com.apple.weather,31,1720470922,1720470953,1720470953.907055,-18000,EB445137-D7F5-57EC-87DA-1DB460D64046,"iPhone13,2"
com.google.chrome.ios,3,1720470919,1720470922,1720470922.650635,-18000,EB445137-D7F5-57EC-87DA-1DB460D64046,"iPhone13,2"
com.google.chrome.ios,3,1720470900,1720470903,1720470903.713521,-18000,EB445137-D7F5-57EC-87DA-1DB460D64046,"iPhone13,2"
com.google.chrome.ios,20,1720470740,1720470760,1720470760.888063,-18000,EB445137-D7F5-57EC-87DA-1DB460D64046,"iPhone13,2"
com.doordash.dasher,10,1720470730,1720470740,1720470740.622356,-18000,EB445137-D7F5-57EC-87DA-1DB460D64046,"iPhone13,2"
com.doordash.dasher,10,1720468920,1720468930,1720468930.040483,-18000,EB445137-D7F5-57EC-87DA-1DB460D64046,"iPhone13,2"
com.doordash.dasher,12,1720468907,1720468919,1720468919.410818,-18000,EB445137-D7F5-57EC-87DA-1DB460D64046,"iPhone13,2"
com.doordash.dasher,24,1720468846,1720468870,1720468871.0099769,-18000,EB445137-D7F5-57EC-87DA-1DB460D64046,"iPhone13,2"
com.google.chrome.ios,3,1720468843,1720468846,1720468846.38657,-18000,EB445137-D7F5-57EC-87DA-1DB460D64046,"iPhone13,2"
com.google.chrome.ios,1,1720468809,1720468810,1720468810.550006,-18000,EB445137-D7F5-57EC-87DA-1DB460D64046,"iPhone13,2"
com.google.chrome.ios,6,1720467204,1720467210,1720467210.390376,-18000,EB445137-D7F5-57EC-87DA-1DB460D64046,"iPhone13,2"
com.google.chrome.ios,198,1720467004,1720467202,1720467202.040699,-18000,EB445137-D7F5-57EC-87DA-1DB460D64046,"iPhone13,2"
com.google.chrome.ios,112,1720466881,1720466993,1720466993.45862,-18000,EB445137-D7F5-57EC-87DA-1DB460D64046,"iPhone13,2"
com.google.chrome.ios,7,1720466525,1720466532,1720466532.3971791,-18000,EB445137-D7F5-57EC-87DA-1DB460D64046,"iPhone13,2"
com.google.chrome.ios,216,1720466308,1720466524,1720466524.622994,-18000,EB445137-D7F5-57EC-87DA-1DB460D64046,"iPhone13,2"
com.apple.mobileslideshow,3,1720466305,1720466308,1720466308.635628,-18000,EB445137-D7F5-57EC-87DA-1DB460D64046,"iPhone13,2"
com.google.chrome.ios,16,1720466289,1720466305,1720466305.83764,-18000,EB445137-D7F5-57EC-87DA-1DB460D64046,"iPhone13,2"
com.apple.mobileslideshow,8,1720466281,1720466289,1720466289.778112,-18000,EB445137-D7F5-57EC-87DA-1DB460D64046,"iPhone13,2"
com.google.chrome.ios,263,1720466015,1720466278,1720466278.281048,-18000,EB445137-D7F5-57EC-87DA-1DB460D64046,"iPhone13,2"
com.google.chrome.ios,21,1720465392,1720465413,1720465413.915059,-18000,EB445137-D7F5-57EC-87DA-1DB460D64046,"iPhone13,2"
com.apple.news,135,1720461181,1720461316,1720461316.165351,-18000,EB445137-D7F5-57EC-87DA-1DB460D64046,"iPhone13,2"
com.apple.findmy,108,1720461070,1720461178,1720461178.334197,-18000,EB445137-D7F5-57EC-87DA-1DB460D64046,"iPhone13,2"
com.apple.Music,7,1720461060,1720461067,1720461067.2910938,-18000,EB445137-D7F5-57EC-87DA-1DB460D64046,"iPhone13,2"
com.apple.Music,3,1720461056,1720461059,1720461059.660094,-18000,EB445137-D7F5-57EC-87DA-1DB460D64046,"iPhone13,2"
com.apple.Music,6,1720459588,1720459594,1720459594.650725,-18000,EB445137-D7F5-57EC-87DA-1DB460D64046,"iPhone13,2"
com.apple.Music,2,1720458258,1720458260,1720458260.7043772,-18000,EB445137-D7F5-57EC-87DA-1DB460D64046,"iPhone13,2"
com.apple.weather,3,1720458255,1720458258,1720458258.626474,-18000,EB445137-D7F5-57EC-87DA-1DB460D64046,"iPhone13,2"
com.apple.Music,2,1720458252,1720458254,1720458255.04246,-18000,EB445137-D7F5-57EC-87DA-1DB460D64046,"iPhone13,2"
com.apple.Music,8,1720458193,1720458201,1720458201.412438,-18000,EB445137-D7F5-57EC-87DA-1DB460D64046,"iPhone13,2"
com.apple.Music,68,1720458055,1720458123,1720458123.0888171,-18000,EB445137-D7F5-57EC-87DA-1DB460D64046,"iPhone13,2"
com.apple.MobileSMS,3,1720458051,1720458054,1720458055.152087,-18000,EB445137-D7F5-57EC-87DA-1DB460D64046,"iPhone13,2"
com.apple.MobileSMS,12,1720458000,1720458012,1720458012.249589,-18000,EB445137-D7F5-57EC-87DA-1DB460D64046,"iPhone13,2"
com.apple.MobileSMS,1,1720457899,1720457900,1720457900.999963,-18000,EB445137-D7F5-57EC-87DA-1DB460D64046,"iPhone13,2"
com.google.Chrome,5,1720457886,1720457891,1720457892.034322,-18000,,
com.apple.MobileSMS,0,1720457886,1720457886,1720457886.9744902,-18000,,
com.google.Chrome,19,1720457867,1720457886,1720457886.1929631,-18000,,
com.apple.MobileSMS,28,1720457839,1720457867,1720457867.392418,-18000,,
com.google.Chrome,19,1720457820,1720457839,1720457839.898995,-18000,,
com.apple.MobileSMS,44,1720457776,1720457820,1720457820.5656881,-18000,,
com.google.Chrome,6,1720457770,1720457776,1720457776.0379438,-18000,,
com.apple.MobileSMS,1,1720457769,1720457770,1720457770.854579,-18000,,
com.google.Chrome,45,1720457724,1720457769,1720457769.638071,-18000,,
com.apple.MobileSMS,2,1720457722,1720457724,1720457724.790159,-18000,,
com.google.Chrome,0,1720457722,1720457722,1720457722.866328,-18000,,
com.apple.MobileSMS,2,1720457720,1720457722,1720457722.3770518,-18000,,
com.google.Chrome,16,1720457704,1720457720,1720457720.961234,-18000,,
com.apple.MobileSMS,1,1720457703,1720457704,1720457704.698386,-18000,,
com.apple.MobileSMS,61,1720457621,1720457682,1720457682.835692,-18000,EB445137-D7F5-57EC-87DA-1DB460D64046,"iPhone13,2"
com.google.Chrome,85,1720457618,1720457703,1720457703.483409,-18000,,
com.apple.MobileSMS,4,1720457614,1720457618,1720457618.2000751,-18000,,
com.google.Chrome,22,1720457592,1720457614,1720457614.7470322,-18000,,
com.doordash.dasher,10,1720457572,1720457582,1720457582.897691,-18000,EB445137-D7F5-57EC-87DA-1DB460D64046,"iPhone13,2"
com.muscleforlife.Stacked,6,1720457566,1720457572,1720457572.406355,-18000,EB445137-D7F5-57EC-87DA-1DB460D64046,"iPhone13,2"
com.muscleforlife.Stacked,10,1720457113,1720457123,1720457123.132884,-18000,EB445137-D7F5-57EC-87DA-1DB460D64046,"iPhone13,2"
com.muscleforlife.Stacked,8,1720456227,1720456235,1720456235.7348208,-18000,EB445137-D7F5-57EC-87DA-1DB460D64046,"iPhone13,2"
com.google.Chrome,909,1720396656,1720397565,1720397565.5502338,-18000,,
com.google.Chrome,791,1720395797,1720396588,1720396588.693157,-18000,,
com.google.Chrome,373,1720395224,1720395597,1720395597.349916,-18000,,
com.apple.MobileSMS,17,1720395207,1720395224,1720395224.900769,-18000,,
com.google.Chrome,179,1720395028,1720395207,1720395207.0422769,-18000,,
com.apple.MobileSMS,56,1720394972,1720395028,1720395028.6746101,-18000,,
com.google.Chrome,47,1720394925,1720394972,1720394972.92605,-18000,,
com.apple.dt.Xcode,32,1720394893,1720394925,1720394925.4116101,-18000,,
com.apple.dt.Xcode,311,1720392184,1720392495,1720392495.250762,-18000,,
com.google.android.studio,32,1720392152,1720392184,1720392184.863514,-18000,,
com.apple.dt.Xcode,2,1720392150,1720392152,1720392152.349406,-18000,,
com.google.android.studio,3,1720392147,1720392150,1720392150.812088,-18000,,
com.apple.dt.Xcode,3,1720392144,1720392147,1720392147.402378,-18000,,
com.google.android.studio,5,1720392139,1720392144,1720392144.883259,-18000,,
com.apple.dt.Xcode,18,1720392121,1720392139,1720392139.7194781,-18000,,
com.google.android.studio,18,1720392103,1720392121,1720392121.832014,-18000,,
com.apple.dt.Xcode,6,1720392097,1720392103,1720392103.449733,-18000,,
com.google.android.studio,7,1720392090,1720392097,1720392097.109369,-18000,,
com.apple.dt.Xcode,1,1720392089,1720392090,1720392090.306985,-18000,,
com.google.android.studio,9,1720392080,1720392089,1720392089.5733771,-18000,,
com.apple.dt.Xcode,2,1720392078,1720392080,1720392080.092389,-18000,,
com.google.android.studio,1,1720392077,1720392078,1720392078.992446,-18000,,
com.apple.dt.Xcode,1,1720392076,1720392077,1720392077.418521,-18000,,
com.google.android.studio,39,1720392037,1720392076,1720392076.122884,-18000,,
com.apple.dt.Xcode,3,1720392034,1720392037,1720392037.1576982,-18000,,
com.google.android.studio,3,1720392031,1720392034,1720392034.78215,-18000,,
com.apple.dt.Xcode,1,1720392030,1720392031,1720392031.6756392,-18000,,
com.google.android.studio,9,1720392021,1720392030,1720392030.122756,-18000,,
com.apple.dt.Xcode,3,1720392018,1720392021,1720392021.460678,-18000,,
com.google.android.studio,2,1720392016,1720392018,1720392018.405864,-18000,,
com.apple.dt.Xcode,3,1720392013,1720392016,1720392016.523466,-18000,,
com.google.android.studio,13,1720392000,1720392013,1720392013.396399,-18000,,
com.apple.dt.Xcode,32,1720391968,1720392000,1720392000.984077,-18000,,
com.google.android.studio,18,1720391950,1720391968,1720391968.669114,-18000,,
com.apple.dt.Xcode,2,1720391948,1720391950,1720391950.730157,-18000,,
com.google.android.studio,1,1720391947,1720391948,1720391948.4593391,-18000,,
com.apple.dt.Xcode,6,1720391941,1720391947,1720391947.9921489,-18000,,
com.google.android.studio,29,1720391912,1720391941,1720391941.917453,-18000,,
com.apple.dt.Xcode,1,1720391911,1720391912,1720391912.836265,-18000,,
com.google.android.studio,9,1720391902,1720391911,1720391911.3921828,-18000,,
com.apple.dt.Xcode,3,1720391899,1720391902,1720391902.762121,-18000,,
com.google.android.studio,21,1720391878,1720391899,1720391899.843416,-18000,,
com.apple.dt.Xcode,6,1720391872,1720391878,1720391878.757392,-18000,,
com.google.android.studio,20,1720391852,1720391872,1720391872.909816,-18000,,
com.apple.dt.Xcode,119,1720391733,1720391852,1720391852.839663,-18000,,
com.google.android.studio,26,1720391707,1720391733,1720391733.477573,-18000,,
com.apple.dt.Xcode,4,1720391703,1720391707,1720391707.1169472,-18000,,
com.google.android.studio,30,1720391673,1720391703,1720391703.705215,-18000,,
com.apple.dt.Xcode,43,1720391630,1720391673,1720391673.898048,-18000,,
com.google.android.studio,30,1720391600,1720391630,1720391630.488831,-18000,,
com.apple.dt.Xcode,5,1720391595,1720391600,1720391600.4255152,-18000,,
com.google.android.studio,3,1720391592,1720391595,1720391595.348462,-18000,,
com.apple.dt.Xcode,4,1720391588,1720391592,1720391592.6059098,-18000,,
com.google.android.studio,83,1720391505,1720391588,1720391588.464336,-18000,,
com.apple.dt.Xcode,20,1720391485,1720391505,1720391505.607386,-18000,,
com.google.android.studio,14,1720391471,1720391485,1720391485.9951792,-18000,,
com.apple.dt.Xcode,8,1720391463,1720391471,1720391472.040365,-18000,,
com.google.android.studio,3,1720391460,1720391463,1720391463.060823,-18000,,
com.apple.dt.Xcode,5,1720391455,1720391460,1720391460.6735559,-18000,,
com.google.android.studio,4,1720391451,1720391455,1720391455.1355991,-18000,,
com.google.Chrome,54,1720391397,1720391451,1720391451.757164,-18000,,
com.apple.weather,21,1720387150,1720387171,1720387171.506305,-18000,EB445137-D7F5-57EC-87DA-1DB460D64046,"iPhone13,2"
com.apple.MobileSMS,36,1720387114,1720387150,1720387150.683854,-18000,EB445137-D7F5-57EC-87DA-1DB460D64046,"iPhone13,2"
com.apple.weather,21,1720387093,1720387114,1720387114.261588,-18000,EB445137-D7F5-57EC-87DA-1DB460D64046,"iPhone13,2"
com.apple.weather,10,1720386994,1720387004,1720387004.326579,-18000,EB445137-D7F5-57EC-87DA-1DB460D64046,"iPhone13,2"
com.apple.weather,10,1720386613,1720386623,1720386623.062799,-18000,EB445137-D7F5-57EC-87DA-1DB460D64046,"iPhone13,2"
com.apple.weather,10,1720386288,1720386298,1720386298.907346,-18000,EB445137-D7F5-57EC-87DA-1DB460D64046,"iPhone13,2"
com.google.Chrome,556,1720385918,1720386474,1720386474.814683,-18000,,
com.apple.weather,26,1720385565,1720385591,1720385591.3550348,-18000,EB445137-D7F5-57EC-87DA-1DB460D64046,"iPhone13,2"
com.google.ios.youtube,3094,1720382471,1720385565,1720385566.142881,-18000,EB445137-D7F5-57EC-87DA-1DB460D64046,"iPhone13,2"
com.google.Chrome,300,1720382446,1720382746,1720382746.185515,-18000,,
com.doordash.dasher,94,1720382342,1720382436,1720382436.5164208,-18000,EB445137-D7F5-57EC-87DA-1DB460D64046,"iPhone13,2"
com.google.Chrome,370,1720381784,1720382154,1720382154.47218,-18000,,
com.burbn.instagram,855,1720381487,1720382342,1720382342.9082608,-18000,EB445137-D7F5-57EC-87DA-1DB460D64046,"iPhone13,2"
com.apple.news,9,1720381421,1720381430,1720381430.396031,-18000,EB445137-D7F5-57EC-87DA-1DB460D64046,"iPhone13,2"
com.google.Chrome,302,1720381383,1720381685,1720381685.669524,-18000,,
com.apple.MobileSMS,8,1720381375,1720381383,1720381383.859548,-18000,,
com.google.Chrome,97,1720381278,1720381375,1720381375.847146,-18000,,
com.apple.MobileSMS,5,1720381273,1720381278,1720381279.022141,-18000,,
com.apple.Photos,1,1720381272,1720381273,1720381273.088138,-18000,,
com.google.Chrome,54,1720381218,1720381272,1720381272.195063,-18000,,
com.apple.news,10,1720381216,1720381226,1720381226.270494,-18000,EB445137-D7F5-57EC-87DA-1DB460D64046,"iPhone13,2"
com.apple.news,98,1720380782,1720380880,1720380880.3216581,-18000,EB445137-D7F5-57EC-87DA-1DB460D64046,"iPhone13,2"
com.apple.MobileSMS,6,1720380765,1720380771,1720380771.880723,-18000,EB445137-D7F5-57EC-87DA-1DB460D64046,"iPhone13,2"
com.google.Chrome,597,1720380594,1720381191,1720381191.231145,-18000,,
com.apple.MobileSMS,2,1720380563,1720380565,1720380565.095419,-18000,EB445137-D7F5-57EC-87DA-1DB460D64046,"iPhone13,2"
com.apple.news,3,1720380560,1720380563,1720380564.4370399,-18000,EB445137-D7F5-57EC-87DA-1DB460D64046,"iPhone13,2"
com.google.Chrome,471,1720380091,1720380562,1720380562.742939,-18000,,
com.apple.news,45,1720379544,1720379589,1720379589.759571,-18000,EB445137-D7F5-57EC-87DA-1DB460D64046,"iPhone13,2"
com.myfitnesspal.mfp,7,1720379527,1720379534,1720379534.04703,-18000,EB445137-D7F5-57EC-87DA-1DB460D64046,"iPhone13,2"
com.myfitnesspal.mfp,4,1720379451,1720379455,1720379455.8055491,-18000,EB445137-D7F5-57EC-87DA-1DB460D64046,"iPhone13,2"
com.myfitnesspal.mfp,37,1720379413,1720379450,1720379450.929323,-18000,EB445137-D7F5-57EC-87DA-1DB460D64046,"iPhone13,2"
com.facebook.Facebook,321,1720379092,1720379413,1720379413.545728,-18000,EB445137-D7F5-57EC-87DA-1DB460D64046,"iPhone13,2"
com.ebay.iphone,35,1720379056,1720379091,1720379091.103755,-18000,EB445137-D7F5-57EC-87DA-1DB460D64046,"iPhone13,2"
com.apple.MobileSMS,6,1720379050,1720379056,1720379056.390063,-18000,EB445137-D7F5-57EC-87DA-1DB460D64046,"iPhone13,2"
com.apple.MobileSMS,6,1720378697,1720378703,1720378703.670193,-18000,EB445137-D7F5-57EC-87DA-1DB460D64046,"iPhone13,2"
com.apple.weather,7,1720378690,1720378697,1720378697.51677,-18000,EB445137-D7F5-57EC-87DA-1DB460D64046,"iPhone13,2"
com.apple.MobileSMS,18,1720378672,1720378690,1720378690.710197,-18000,EB445137-D7F5-57EC-87DA-1DB460D64046,"iPhone13,2"
com.apple.MobileSMS,4,1720378599,1720378603,1720378603.368046,-18000,EB445137-D7F5-57EC-87DA-1DB460D64046,"iPhone13,2"
com.apple.MobileSMS,29,1720377009,1720377038,1720377038.09944,-18000,EB445137-D7F5-57EC-87DA-1DB460D64046,"iPhone13,2"
com.apple.weather,11,1720376822,1720376833,1720376833.004541,-18000,EB445137-D7F5-57EC-87DA-1DB460D64046,"iPhone13,2"
com.facebook.Facebook,56,1720376681,1720376737,1720376737.277544,-18000,EB445137-D7F5-57EC-87DA-1DB460D64046,"iPhone13,2"
com.facebook.Facebook,106,1720376574,1720376680,1720376680.7745981,-18000,EB445137-D7F5-57EC-87DA-1DB460D64046,"iPhone13,2"
com.apple.weather,34,1720376537,1720376571,1720376571.28617,-18000,EB445137-D7F5-57EC-87DA-1DB460D64046,"iPhone13,2"
com.apple.news,36,1720376501,1720376537,1720376537.83131,-18000,EB445137-D7F5-57EC-87DA-1DB460D64046,"iPhone13,2"
com.apple.Maps,49,1720376452,1720376501,1720376501.5927582,-18000,EB445137-D7F5-57EC-87DA-1DB460D64046,"iPhone13,2"
com.apple.news,65,1720376384,1720376449,1720376449.9264,-18000,EB445137-D7F5-57EC-87DA-1DB460D64046,"iPhone13,2"
com.apple.findmy,7,1720376368,1720376375,1720376375.0848122,-18000,EB445137-D7F5-57EC-87DA-1DB460D64046,"iPhone13,2"
com.apple.findmy,6,1720376297,1720376303,1720376303.818102,-18000,EB445137-D7F5-57EC-87DA-1DB460D64046,"iPhone13,2"
com.apple.findmy,10,1720376005,1720376015,1720376015.681563,-18000,EB445137-D7F5-57EC-87DA-1DB460D64046,"iPhone13,2"
com.doordash.dasher,2,1720376003,1720376005,1720376005.4768639,-18000,EB445137-D7F5-57EC-87DA-1DB460D64046,"iPhone13,2"
com.doordash.dasher,54,1720375082,1720375136,1720375136.8446178,-18000,EB445137-D7F5-57EC-87DA-1DB460D64046,"iPhone13,2"
com.doordash.dasher,922,1720374159,1720375081,1720375081.211543,-18000,EB445137-D7F5-57EC-87DA-1DB460D64046,"iPhone13,2"
com.apple.news,66,1720374093,1720374159,1720374160.062283,-18000,EB445137-D7F5-57EC-87DA-1DB460D64046,"iPhone13,2"
com.doordash.dasher,16,1720374077,1720374093,1720374093.620285,-18000,EB445137-D7F5-57EC-87DA-1DB460D64046,"iPhone13,2"
com.apple.MobileSMS,11,1720374066,1720374077,1720374077.796421,-18000,EB445137-D7F5-57EC-87DA-1DB460D64046,"iPhone13,2"
com.doordash.dasher,20,1720374045,1720374065,1720374065.499944,-18000,EB445137-D7F5-57EC-87DA-1DB460D64046,"iPhone13,2"
com.apple.MobileSMS,6,1720374039,1720374045,1720374045.458307,-18000,EB445137-D7F5-57EC-87DA-1DB460D64046,"iPhone13,2"
com.doordash.dasher,14,1720374025,1720374039,1720374039.966039,-18000,EB445137-D7F5-57EC-87DA-1DB460D64046,"iPhone13,2"
com.apple.MobileSMS,12,1720374013,1720374025,1720374025.943801,-18000,EB445137-D7F5-57EC-87DA-1DB460D64046,"iPhone13,2"
com.doordash.dasher,1025,1720372988,1720374013,1720374014.102038,-18000,EB445137-D7F5-57EC-87DA-1DB460D64046,"iPhone13,2"
com.apple.InCallService,39,1720372949,1720372988,1720372989.0314422,-18000,EB445137-D7F5-57EC-87DA-1DB460D64046,"iPhone13,2"
com.doordash.dasher,431,1720372518,1720372949,1720372950.047554,-18000,EB445137-D7F5-57EC-87DA-1DB460D64046,"iPhone13,2"
com.doordash.dasher,705,1720371811,1720372516,1720372516.774808,-18000,EB445137-D7F5-57EC-87DA-1DB460D64046,"iPhone13,2"
com.doordash.dasher,4,1720371758,1720371762,1720371762.8376632,-18000,EB445137-D7F5-57EC-87DA-1DB460D64046,"iPhone13,2"
com.doordash.dasher,833,1720370917,1720371750,1720371750.604193,-18000,EB445137-D7F5-57EC-87DA-1DB460D64046,"iPhone13,2"
com.apple.Music,21,1720370896,1720370917,1720370917.823079,-18000,EB445137-D7F5-57EC-87DA-1DB460D64046,"iPhone13,2"
com.doordash.dasher,1110,1720369786,1720370896,1720370896.6504521,-18000,EB445137-D7F5-57EC-87DA-1DB460D64046,"iPhone13,2"
com.truebill.truebillnative,97,1720369435,1720369532,1720369533.00349,-18000,EB445137-D7F5-57EC-87DA-1DB460D64046,"iPhone13,2"
com.apple.news,10,1720369425,1720369435,1720369435.229398,-18000,EB445137-D7F5-57EC-87DA-1DB460D64046,"iPhone13,2"
com.apple.news,6,1720369159,1720369165,1720369165.1198049,-18000,EB445137-D7F5-57EC-87DA-1DB460D64046,"iPhone13,2"
com.google.Chrome,396,1720368734,1720369130,1720369130.320877,-18000,,
com.apple.finder,31,1720368703,1720368734,1720368734.836868,-18000,,
com.apple.reminders,9,1720368694,1720368703,1720368703.6474419,-18000,,
com.apple.Terminal,7,1720368687,1720368694,1720368694.4513478,-18000,,
com.apple.finder,10,1720368677,1720368687,1720368687.122652,-18000,,
com.apple.Terminal,41,1720368636,1720368677,1720368677.6788,-18000,,
com.apple.finder,3,1720368633,1720368636,1720368636.223349,-18000,,
com.apple.Terminal,5,1720368628,1720368633,1720368633.2945318,-18000,,
com.apple.finder,15,1720368613,1720368628,1720368628.777863,-18000,,
com.google.Chrome,2,1720368611,1720368613,1720368613.564989,-18000,,
com.apple.news,78,1720368527,1720368605,1720368605.157487,-18000,EB445137-D7F5-57EC-87DA-1DB460D64046,"iPhone13,2"
com.apple.Preferences,111,1720368390,1720368501,1720368502.025625,-18000,EB445137-D7F5-57EC-87DA-1DB460D64046,"iPhone13,2"
com.apple.news,8,1720368382,1720368390,1720368391.16756,-18000,EB445137-D7F5-57EC-87DA-1DB460D64046,"iPhone13,2"
com.apple.news,147,1720368069,1720368216,1720368216.388416,-18000,EB445137-D7F5-57EC-87DA-1DB460D64046,"iPhone13,2"
com.apple.findmy,41,1720368017,1720368058,1720368058.542171,-18000,EB445137-D7F5-57EC-87DA-1DB460D64046,"iPhone13,2"
com.apple.MobileSMS,3,1720368014,1720368017,1720368017.2942781,-18000,EB445137-D7F5-57EC-87DA-1DB460D64046,"iPhone13,2"
com.apple.Health,85,1720366254,1720366339,1720366339.8448238,-18000,EB445137-D7F5-57EC-87DA-1DB460D64046,"iPhone13,2"
com.apple.findmy,10,1720366233,1720366243,1720366243.30739,-18000,EB445137-D7F5-57EC-87DA-1DB460D64046,"iPhone13,2"
com.apple.mobiletimer,31,1720366200,1720366231,1720366231.8171458,-18000,EB445137-D7F5-57EC-87DA-1DB460D64046,"iPhone13,2"
com.apple.mobiletimer,6,1720366068,1720366074,1720366074.7676911,-18000,EB445137-D7F5-57EC-87DA-1DB460D64046,"iPhone13,2"
