app,usage,start_time,end_time,created_at,tz,device_id,device_model
com.apple.finder,4,1713238487,1713238491,1713238491.2229528,-18000,,
com.apple.Terminal,3,1713238484,1713238487,1713238487.7944489,-18000,,
com.apple.finder,16,1713238468,1713238484,1713238484.824403,-18000,,
com.google.Chrome,18,1713238450,1713238468,1713238468.3519769,-18000,,
com.microsoft.Outlook,80,1713238370,1713238450,1713238450.554615,-18000,,
com.google.Chrome,5,1713238365,1713238370,1713238370.162795,-18000,,
com.microsoft.Outlook,120,1713238245,1713238365,1713238365.5136561,-18000,,
com.google.Chrome,1,1713238244,1713238245,1713238245.191537,-18000,,
com.microsoft.Outlook,56,1713238188,1713238244,1713238244.416606,-18000,,
com.google.Chrome,119,1713238069,1713238188,1713238188.830302,-18000,,
com.microsoft.Outlook,2,1713238067,1713238069,1713238069.821233,-18000,,
com.google.Chrome,7,1713238060,1713238067,1713238067.0487962,-18000,,
com.microsoft.Outlook,4,1713238056,1713238060,1713238060.782185,-18000,,
com.google.Chrome,31,1713238025,1713238056,1713238057.001076,-18000,,
com.microsoft.Outlook,70,1713237955,1713238025,1713238025.350377,-18000,,
com.google.Chrome,10,1713237945,1713237955,1713237955.8292809,-18000,,
com.microsoft.Outlook,1,1713237944,1713237945,1713237945.6385489,-18000,,
com.google.Chrome,10,1713237934,1713237944,1713237944.884934,-18000,,
com.microsoft.Outlook,1,1713237933,1713237934,1713237934.565783,-18000,,
com.google.Chrome,10,1713237923,1713237933,1713237933.3786268,-18000,,
com.microsoft.Outlook,1,1713237922,1713237923,1713237923.303163,-18000,,
com.google.Chrome,11,1713237911,1713237922,1713237922.332748,-18000,,
com.microsoft.Outlook,1,1713237910,1713237911,1713237911.9768372,-18000,,
com.google.Chrome,10,1713237900,1713237910,1713237910.7719321,-18000,,
com.microsoft.Outlook,2,1713237898,1713237900,1713237900.787871,-18000,,
com.google.Chrome,32,1713237866,1713237898,1713237898.6923618,-18000,,
com.microsoft.Outlook,3,1713237863,1713237866,1713237866.186996,-18000,,
com.google.Chrome,6,1713237857,1713237863,1713237864.042438,-18000,,
com.microsoft.Outlook,3,1713237854,1713237857,1713237857.3210878,-18000,,
com.google.Chrome,2,1713237852,1713237854,1713237854.674501,-18000,,
com.microsoft.Outlook,3,1713237849,1713237852,1713237852.3820682,-18000,,
com.google.Chrome,7,1713237842,1713237849,1713237849.742124,-18000,,
com.microsoft.Outlook,68,1713237774,1713237842,1713237842.981286,-18000,,
com.google.Chrome,6,1713237768,1713237774,1713237774.180731,-18000,,
com.microsoft.Outlook,441,1713237327,1713237768,1713237768.068227,-18000,,
com.google.Chrome,45,1713237282,1713237327,1713237327.465419,-18000,,
com.microsoft.Outlook,4,1713237278,1713237282,1713237283.0149121,-18000,,
com.google.Chrome,1,1713237277,1713237278,1713237278.137147,-18000,,
com.microsoft.Outlook,2,1713237268,1713237270,1713237270.155871,-18000,,
com.apple.finder,1,1713237267,1713237268,1713237268.115145,-18000,,
com.google.Chrome,43,1713237224,1713237267,1713237267.18471,-18000,,
com.apple.finder,1,1713237223,1713237224,1713237225.303783,-18000,,
com.google.Chrome,1,1713237222,1713237223,1713237223.5257711,-18000,,
com.microsoft.Outlook,27,1713237195,1713237222,1713237222.501231,-18000,,
com.google.Chrome,277,1713236918,1713237195,1713237195.561338,-18000,,
com.leomehlig.today,1,1713236917,1713236918,1713236918.344658,-18000,,
com.google.Chrome,11,1713236906,1713236917,1713236917.839232,-18000,,
com.apple.iCal,21,1713236885,1713236906,1713236906.266145,-18000,,
com.google.Chrome,41,1713236844,1713236885,1713236885.850933,-18000,,
com.apple.iCal,4,1713236840,1713236844,1713236844.9154491,-18000,,
com.google.Chrome,32,1713236808,1713236840,1713236840.9111772,-18000,,
com.apple.iCal,2,1713236806,1713236808,1713236808.3598871,-18000,,
com.apple.MobileSMS,2,1713236804,1713236806,1713236806.921865,-18000,,
com.apple.iCal,8,1713236796,1713236804,1713236804.71345,-18000,,
com.apple.MobileSMS,17,1713236779,1713236796,1713236796.825774,-18000,,
com.apple.iCal,27,1713236752,1713236779,1713236779.60498,-18000,,
com.apple.MobileSMS,9,1713236743,1713236752,1713236752.548857,-18000,,
com.leomehlig.today,64,1713236679,1713236743,1713236743.825091,-18000,,
com.google.Chrome,585,1713236094,1713236679,1713236679.946706,-18000,,
com.leomehlig.today,2,1713236092,1713236094,1713236094.620163,-18000,,
com.google.Chrome,681,1713235411,1713236092,1713236092.9874191,-18000,,
com.leomehlig.today,11,1713235400,1713235411,1713235411.860332,-18000,,
com.google.Chrome,729,1713234671,1713235400,1713235400.0666862,-18000,,
com.leomehlig.today,6,1713234649,1713234655,1713234656.4583921,-18000,,
com.google.Chrome,3,1713234646,1713234649,1713234649.659029,-18000,,
com.google.Chrome,235,1713230240,1713230475,1713230475.66817,-18000,,
com.leomehlig.today,6,1713230234,1713230240,1713230240.137425,-18000,,
com.google.Chrome,15,1713230219,1713230234,1713230234.656431,-18000,,
com.google.Chrome,16,1713229832,1713229848,1713229848.699023,-18000,,
com.apple.MobileSMS,3,1713229788,1713229791,1713229791.700825,-18000,,
com.google.Chrome,3,1713229785,1713229788,1713229788.862311,-18000,,
com.leomehlig.today,45,1713229740,1713229785,1713229785.140369,-18000,,
com.leomehlig.today,81,1713227981,1713228062,1713228062.381108,-18000,,
com.google.Chrome,58,1713227923,1713227981,1713227981.814847,-18000,,
com.leomehlig.today,4,1713227919,1713227923,1713227923.86279,-18000,,
com.google.Chrome,627,1713227292,1713227919,1713227919.3461761,-18000,,
com.leomehlig.today,7,1713227285,1713227292,1713227292.639976,-18000,,
com.google.Chrome,1339,1713225946,1713227285,1713227285.498771,-18000,,
com.leomehlig.today,9,1713225937,1713225946,1713225946.7450309,-18000,,
com.google.Chrome,517,1713225420,1713225937,1713225937.713279,-18000,,
com.leomehlig.today,32,1713225388,1713225420,1713225420.920202,-18000,,
com.google.Chrome,373,1713225015,1713225388,1713225388.18928,-18000,,
com.leomehlig.today,48,1713224967,1713225015,1713225015.095238,-18000,,
com.google.Chrome,1315,1713223652,1713224967,1713224967.216886,-18000,,
com.google.Chrome,7,1713215999,1713216006,1713216007.01265,-18000,,
com.leomehlig.today,194,1713215805,1713215999,1713215999.13169,-18000,,
com.google.Chrome,774,1713215031,1713215805,1713215805.6008,-18000,,
com.google.Chrome,310,1713214321,1713214631,1713214631.306264,-18000,,
com.leomehlig.today,2,1713214319,1713214321,1713214321.898376,-18000,,
com.google.Chrome,631,1713213688,1713214319,1713214319.375558,-18000,,
com.leomehlig.today,33,1713213655,1713213688,1713213688.09089,-18000,,
com.google.Chrome,1243,1713212412,1713213655,1713213655.578141,-18000,,
com.leomehlig.today,3,1713212409,1713212412,1713212412.372791,-18000,,
com.google.Chrome,618,1713211791,1713212409,1713212409.204421,-18000,,
com.google.Chrome,325,1713211005,1713211330,1713211330.16524,-18000,,
com.google.Chrome,308,1713209694,1713210002,1713210002.29466,-18000,,
com.google.Chrome,345,1713209265,1713209610,1713209610.9321089,-18000,,
com.google.Chrome,434,1713208664,1713209098,1713209098.227483,-18000,,
com.leomehlig.today,15,1713208649,1713208664,1713208664.5133948,-18000,,
com.google.Chrome,79,1713208570,1713208649,1713208649.265564,-18000,,
com.google.Chrome,56,1713203849,1713203905,1713203905.542551,-18000,,
com.leomehlig.today,41,1713203808,1713203849,1713203849.678115,-18000,,
com.google.Chrome,591,1713203217,1713203808,1713203809.007302,-18000,,
com.apple.MobileSMS,4,1713203213,1713203217,1713203217.5368981,-18000,,
com.google.Chrome,45,1713203168,1713203213,1713203213.2836561,-18000,,
com.leomehlig.today,54,1713203114,1713203168,1713203168.191838,-18000,,
com.google.Chrome,2,1713203112,1713203114,1713203114.854738,-18000,,
com.leomehlig.today,20,1713203092,1713203112,1713203112.3100948,-18000,,
com.google.Chrome,513,1713202579,1713203092,1713203092.239227,-18000,,
com.leomehlig.today,25,1713202554,1713202579,1713202579.301597,-18000,,
com.google.Chrome,2,1713202552,1713202554,1713202554.459262,-18000,,
com.google.Chrome,318,1713201898,1713202216,1713202216.2740421,-18000,,
com.google.Chrome,74,1713196933,1713197007,1713197007.601263,-18000,,
com.apple.finder,65,1713196868,1713196933,1713196933.6873798,-18000,,
com.google.Chrome,11,1713196857,1713196868,1713196868.5421782,-18000,,
com.apple.finder,24,1713196833,1713196857,1713196857.61474,-18000,,
com.apple.archiveutility,1,1713196832,1713196833,1713196833.175181,-18000,,
com.apple.finder,3,1713196829,1713196832,1713196832.876103,-18000,,
com.apple.archiveutility,0,1713196829,1713196829,1713196829.4593391,-18000,,
com.apple.finder,9,1713196820,1713196829,1713196829.187952,-18000,,
com.google.Chrome,6,1713196814,1713196820,1713196820.100275,-18000,,
com.apple.finder,37,1713196777,1713196814,1713196814.441465,-18000,,
com.google.Chrome,12,1713196765,1713196777,1713196777.41328,-18000,,
com.apple.finder,1,1713196764,1713196765,1713196766.004924,-18000,,
com.google.Chrome,12,1713196752,1713196764,1713196764.605176,-18000,,
com.apple.finder,4,1713196748,1713196752,1713196752.929421,-18000,,
com.google.Chrome,1,1713196747,1713196748,1713196748.654553,-18000,,
com.leomehlig.today,7,1713196740,1713196747,1713196747.51601,-18000,,
com.google.Chrome,34,1713196706,1713196740,1713196740.902423,-18000,,
com.leomehlig.today,59,1713196647,1713196706,1713196706.788876,-18000,,
com.google.Chrome,87,1713196560,1713196647,1713196648.036532,-18000,,
com.leomehlig.today,79,1713196481,1713196560,1713196560.843793,-18000,,
com.google.Chrome,6,1713196475,1713196481,1713196481.997179,-18000,,
com.google.Chrome,258,1713194385,1713194643,1713194643.717598,-18000,,
com.leomehlig.today,21,1713194364,1713194385,1713194385.605766,-18000,,
com.google.Chrome,185,1713194179,1713194364,1713194364.888444,-18000,,
com.microsoft.Powerpoint,217,1713193962,1713194179,1713194179.2478719,-18000,,
com.google.Chrome,931,1713193031,1713193962,1713193962.982184,-18000,,
com.microsoft.Powerpoint,568,1713192463,1713193031,1713193031.645063,-18000,,
com.google.Chrome,340,1713192123,1713192463,1713192463.602998,-18000,,
com.leomehlig.today,14,1713192092,1713192106,1713192108.2691422,-18000,,
com.google.Chrome,151,1713191941,1713192092,1713192092.0858421,-18000,,
com.google.Chrome,264,1713154602,1713154866,1713154866.704433,-18000,,
com.google.Chrome,1004,1713153517,1713154521,1713154521.933068,-18000,,
com.apple.finder,11,1713153506,1713153517,1713153517.793686,-18000,,
com.apple.finder,4,1713150263,1713150267,1713150267.37878,-18000,,
com.apple.MobileSMS,3,1713150260,1713150263,1713150263.112853,-18000,,
com.apple.finder,7,1713150253,1713150260,1713150260.212235,-18000,,
com.hnc.Discord,33,1713150220,1713150253,1713150253.136352,-18000,,
com.google.Chrome,4,1713150216,1713150220,1713150220.301678,-18000,,
com.leomehlig.today,83,1713150133,1713150216,1713150216.573032,-18000,,
com.google.Chrome,15,1713150118,1713150133,1713150133.413203,-18000,,
com.leomehlig.today,39,1713150079,1713150118,1713150118.36403,-18000,,
com.google.Chrome,474,1713149605,1713150079,1713150079.832864,-18000,,
com.leomehlig.today,5,1713149600,1713149605,1713149605.898759,-18000,,
com.apple.Preview,1236,1713148364,1713149600,1713149601.0315142,-18000,,
com.leomehlig.today,1,1713148363,1713148364,1713148364.6035829,-18000,,
com.google.Chrome,2,1713148361,1713148363,1713148363.086283,-18000,,
com.apple.Photos,2,1713148359,1713148361,1713148362.0264149,-18000,,
com.google.Chrome,3,1713148356,1713148359,1713148360.046006,-18000,,
com.apple.MobileSMS,10,1713148346,1713148356,1713148356.850981,-18000,,
com.google.Chrome,98,1713148248,1713148346,1713148346.981851,-18000,,
com.apple.MobileSMS,29,1713148219,1713148248,1713148248.6510901,-18000,,
com.apple.Preview,11,1713148208,1713148219,1713148219.250129,-18000,,
com.google.Chrome,77,1713148131,1713148208,1713148208.993483,-18000,,
com.apple.finder,1,1713148130,1713148131,1713148131.785143,-18000,,
com.apple.Photos,5,1713148125,1713148130,1713148130.785764,-18000,,
com.apple.finder,1,1713148124,1713148125,1713148125.8295388,-18000,,
com.apple.Photos,3,1713148121,1713148124,1713148124.273185,-18000,,
com.apple.finder,2,1713148119,1713148121,1713148121.13375,-18000,,
com.google.Chrome,22,1713148097,1713148119,1713148119.874545,-18000,,
com.apple.Photos,5,1713148092,1713148097,1713148097.4143372,-18000,,
com.google.Chrome,1,1713148091,1713148092,1713148092.945281,-18000,,
com.apple.Photos,44,1713148047,1713148091,1713148092.043075,-18000,,
com.google.Chrome,32,1713148015,1713148047,1713148047.274966,-18000,,
com.apple.Preview,91,1713147924,1713148015,1713148015.483696,-18000,,
com.google.Chrome,46,1713147878,1713147924,1713147924.469635,-18000,,
com.apple.Preview,667,1713147211,1713147878,1713147878.2292361,-18000,,
com.google.Chrome,16,1713147195,1713147211,1713147211.2696939,-18000,,
com.apple.Preview,17,1713147178,1713147195,1713147195.4624538,-18000,,
com.leomehlig.today,26,1713147152,1713147178,1713147178.33336,-18000,,
com.google.Chrome,4,1713147148,1713147152,1713147152.359527,-18000,,
com.apple.iCal,235,1713146913,1713147148,1713147148.150406,-18000,,
com.google.Chrome,16,1713146897,1713146913,1713146913.272676,-18000,,
com.apple.Preview,19,1713146878,1713146897,1713146897.5368729,-18000,,
com.google.Chrome,2,1713146876,1713146878,1713146878.167023,-18000,,
com.apple.Preview,27,1713146849,1713146876,1713146876.613256,-18000,,
com.google.Chrome,14,1713146835,1713146849,1713146849.713091,-18000,,
com.apple.Preview,101,1713146734,1713146835,1713146835.544002,-18000,,
com.google.Chrome,228,1713146506,1713146734,1713146734.846833,-18000,,
com.apple.Preview,18,1713146488,1713146506,1713146506.059377,-18000,,
com.google.Chrome,2,1713146486,1713146488,1713146488.2398682,-18000,,
com.hnc.Discord,0,1713146486,1713146486,1713146486.776037,-18000,,
com.google.Chrome,151,1713146335,1713146486,1713146486.200656,-18000,,
com.hnc.Discord,9,1713146326,1713146335,1713146335.2872128,-18000,,
com.apple.Preview,9,1713146317,1713146326,1713146326.504888,-18000,,
com.hnc.Discord,58,1713146259,1713146317,1713146317.244838,-18000,,
com.apple.Preview,78,1713146181,1713146259,1713146259.926865,-18000,,
com.google.Chrome,10,1713146171,1713146181,1713146181.713478,-18000,,
com.apple.Preview,151,1713146020,1713146171,1713146171.44661,-18000,,
com.google.Chrome,3,1713146017,1713146020,1713146020.631229,-18000,,
com.apple.Preview,21,1713145996,1713146017,1713146017.846945,-18000,,
com.google.Chrome,69,1713145927,1713145996,1713145996.235275,-18000,,
com.leomehlig.today,28,1713145899,1713145927,1713145927.744893,-18000,,
com.google.Chrome,424,1713145475,1713145899,1713145899.219898,-18000,,
com.apple.Preview,1,1713145474,1713145475,1713145475.193831,-18000,,
com.google.Chrome,1091,1713144383,1713145474,1713145474.238803,-18000,,
com.apple.Preview,1,1713144382,1713144383,1713144383.531306,-18000,,
com.google.Chrome,243,1713144139,1713144382,1713144382.429841,-18000,,
com.apple.Preview,2,1713144137,1713144139,1713144139.091357,-18000,,
com.google.Chrome,1,1713144136,1713144137,1713144137.791893,-18000,,
com.apple.Preview,2,1713144134,1713144136,1713144136.5768142,-18000,,
com.google.Chrome,1,1713144133,1713144134,1713144134.7952042,-18000,,
com.apple.Preview,1,1713144132,1713144133,1713144133.725764,-18000,,
com.google.Chrome,2,1713144130,1713144132,1713144132.4565768,-18000,,
com.apple.Preview,2,1713144128,1713144130,1713144130.886354,-18000,,
com.google.Chrome,2,1713144126,1713144128,1713144128.7900171,-18000,,
com.apple.Preview,1,1713144125,1713144126,1713144126.657411,-18000,,
com.google.Chrome,1,1713144124,1713144125,1713144125.5943651,-18000,,
com.apple.Preview,1,1713144123,1713144124,1713144124.6520991,-18000,,
com.google.Chrome,1,1713144122,1713144123,1713144123.562257,-18000,,
com.apple.Preview,1,1713144121,1713144122,1713144122.6494222,-18000,,
com.google.Chrome,1,1713144120,1713144121,1713144121.742836,-18000,,
com.apple.Preview,1,1713144119,1713144120,1713144120.909409,-18000,,
com.google.Chrome,0,1713144119,1713144119,1713144120.033235,-18000,,
com.apple.Preview,3,1713144116,1713144119,1713144119.272314,-18000,,
com.google.Chrome,2,1713144114,1713144116,1713144116.9612079,-18000,,
com.apple.Preview,2,1713144112,1713144114,1713144114.639718,-18000,,
com.google.Chrome,88,1713144024,1713144112,1713144112.623044,-18000,,
com.apple.Preview,2,1713144022,1713144024,1713144024.751638,-18000,,
com.google.Chrome,2,1713144020,1713144022,1713144022.742043,-18000,,
com.apple.Preview,3,1713144017,1713144020,1713144020.1765661,-18000,,
com.google.Chrome,6,1713144011,1713144017,1713144017.9201632,-18000,,
com.apple.Preview,28,1713143983,1713144011,1713144011.659573,-18000,,
com.google.Chrome,54,1713143929,1713143983,1713143983.185637,-18000,,
com.leomehlig.today,12,1713143917,1713143929,1713143929.8074322,-18000,,
com.google.Chrome,15,1713143902,1713143917,1713143917.9824119,-18000,,
com.google.Chrome,305,1713143593,1713143898,1713143898.960184,-18000,,
com.apple.Preview,93,1713143500,1713143593,1713143593.8194451,-18000,,
com.google.Chrome,52,1713143448,1713143500,1713143500.3194041,-18000,,
com.apple.Preview,54,1713143394,1713143448,1713143448.122655,-18000,,
com.google.Chrome,741,1713142653,1713143394,1713143394.457501,-18000,,
com.google.Chrome,533,1713142120,1713142653,1713142653.098598,-18000,,
com.hnc.Discord,48,1713142072,1713142120,1713142120.281774,-18000,,
com.google.Chrome,140,1713141932,1713142072,1713142072.7263799,-18000,,
com.leomehlig.today,19,1713141913,1713141932,1713141932.636159,-18000,,
com.google.Chrome,82,1713141831,1713141913,1713141913.196847,-18000,,
com.google.Chrome,161,1713138350,1713138511,1713138511.95183,-18000,,
com.apple.MobileSMS,43,1713138307,1713138350,1713138350.551564,-18000,,
com.leomehlig.today,27,1713138280,1713138307,1713138307.771469,-18000,,
com.google.Chrome,16,1713138264,1713138280,1713138280.410656,-18000,,
com.leomehlig.today,5,1713138259,1713138264,1713138264.529325,-18000,,
com.google.Chrome,2,1713138257,1713138259,1713138259.285173,-18000,,
com.leomehlig.today,9,1713138248,1713138257,1713138257.252276,-18000,,
com.google.Chrome,28,1713138220,1713138248,1713138248.738935,-18000,,
com.leomehlig.today,79,1713138141,1713138220,1713138220.954557,-18000,,
com.google.Chrome,5,1713138136,1713138141,1713138141.802332,-18000,,
com.leomehlig.today,16,1713138120,1713138136,1713138136.0596519,-18000,,
com.google.Chrome,5,1713138115,1713138120,1713138120.753648,-18000,,
com.leomehlig.today,6,1713138109,1713138115,1713138115.185075,-18000,,
com.google.Chrome,2,1713138107,1713138109,1713138109.646628,-18000,,
com.leomehlig.today,15,1713138092,1713138107,1713138107.119123,-18000,,
com.google.Chrome,8,1713138084,1713138092,1713138092.063025,-18000,,
com.leomehlig.today,3,1713138081,1713138084,1713138084.3908129,-18000,,
com.google.Chrome,9,1713138072,1713138081,1713138081.778789,-18000,,
com.leomehlig.today,12,1713138060,1713138072,1713138073.029365,-18000,,
com.google.Chrome,2,1713138058,1713138060,1713138060.4219599,-18000,,
com.leomehlig.today,8,1713138050,1713138058,1713138058.941197,-18000,,
com.google.Chrome,9,1713138041,1713138050,1713138050.634032,-18000,,
com.leomehlig.today,1,1713138040,1713138041,1713138042.039995,-18000,,
com.google.Chrome,15,1713138025,1713138040,1713138040.514123,-18000,,
com.apple.iCal,51,1713137974,1713138025,1713138025.091836,-18000,,
com.leomehlig.today,159,1713137815,1713137974,1713137974.135406,-18000,,
com.google.Chrome,12,1713137803,1713137815,1713137815.879305,-18000,,
com.google.Chrome,871,1713116955,1713117826,1713117826.13195,-18000,,
com.google.Chrome,312,1713115930,1713116242,1713116242.657543,-18000,,
com.hnc.Discord,95,1713115835,1713115930,1713115930.5990028,-18000,,
com.google.Chrome,256,1713115579,1713115835,1713115835.2742891,-18000,,
com.leomehlig.today,39,1713115540,1713115579,1713115579.350517,-18000,,
com.google.Chrome,61,1713115479,1713115540,1713115540.7276878,-18000,,
com.google.Chrome,396,1713115082,1713115478,1713115478.935957,-18000,,
com.apple.Preview,22,1713115060,1713115082,1713115082.246828,-18000,,
com.google.Chrome,59,1713115001,1713115060,1713115060.73168,-18000,,
com.google.Chrome,303,1713113447,1713113750,1713113751.0272632,-18000,,
com.google.Chrome,783,1713112046,1713112829,1713112829.091562,-18000,,
com.leomehlig.today,14,1713112032,1713112046,1713112046.76318,-18000,,
com.leomehlig.today,304,1713111245,1713111549,1713111549.070193,-18000,,
com.google.Chrome,391,1713110854,1713111245,1713111245.388855,-18000,,
com.apple.Preview,15,1713110839,1713110854,1713110854.3467798,-18000,,
com.google.Chrome,28,1713110811,1713110839,1713110839.9111571,-18000,,
com.apple.Preview,61,1713110750,1713110811,1713110811.27845,-18000,,
com.google.Chrome,2,1713110748,1713110750,1713110750.115483,-18000,,
com.apple.Preview,83,1713110665,1713110748,1713110748.28164,-18000,,
com.google.Chrome,2,1713110663,1713110665,1713110665.031116,-18000,,
com.apple.Preview,17,1713110646,1713110663,1713110663.1547132,-18000,,
com.google.Chrome,16,1713110630,1713110646,1713110646.539926,-18000,,
com.apple.Preview,124,1713110506,1713110630,1713110630.314107,-18000,,
com.apple.finder,8,1713110498,1713110506,1713110506.180382,-18000,,
com.apple.Preview,2,1713110496,1713110498,1713110498.6530972,-18000,,
com.google.Chrome,611,1713109885,1713110496,1713110496.784143,-18000,,
com.hnc.Discord,36,1713109849,1713109885,1713109885.059636,-18000,,
com.google.Chrome,62,1713109787,1713109849,1713109849.702579,-18000,,
com.hnc.Discord,190,1713109597,1713109787,1713109787.081201,-18000,,
com.google.Chrome,3,1713109594,1713109597,1713109597.596972,-18000,,
com.hnc.Discord,4,1713109590,1713109594,1713109594.890933,-18000,,
com.google.Chrome,12,1713109578,1713109590,1713109590.106247,-18000,,
com.hnc.Discord,5,1713109573,1713109578,1713109579.223027,-18000,,
com.google.Chrome,658,1713108915,1713109573,1713109573.148109,-18000,,
com.google.Chrome,392,1713108520,1713108912,1713108912.230423,-18000,,
com.google.Chrome,859,1713107658,1713108517,1713108517.924839,-18000,,
com.leomehlig.today,53,1713107577,1713107630,1713107630.529571,-18000,,
com.apple.iCal,14,1713107563,1713107577,1713107577.867158,-18000,,
com.apple.iCal,13,1713067218,1713067231,1713067231.8308148,-18000,,
com.google.Chrome,22,1713067196,1713067218,1713067218.470269,-18000,,
com.google.Chrome,342,1713066810,1713067152,1713067152.208479,-18000,,
com.google.Chrome,954,1713065433,1713066387,1713066387.8403769,-18000,,
com.google.Chrome,645,1713064664,1713065309,1713065309.363017,-18000,,
com.google.Chrome,924,1713063674,1713064598,1713064598.2083468,-18000,,
com.google.Chrome,300,1713063161,1713063461,1713063461.8528771,-18000,,
com.google.Chrome,378,1713062601,1713062979,1713062979.535523,-18000,,
com.google.Chrome,302,1713062243,1713062545,1713062545.127181,-18000,,
com.google.Chrome,306,1713061714,1713062020,1713062020.4203439,-18000,,
com.google.Chrome,705,1713060931,1713061636,1713061636.741448,-18000,,
com.google.Chrome,871,1713059509,1713060380,1713060380.7039208,-18000,,
com.google.Chrome,478,1713058646,1713059124,1713059124.448461,-18000,,
com.apple.iCal,22,1713058624,1713058646,1713058646.5483441,-18000,,
com.google.Chrome,162,1713058462,1713058624,1713058624.065176,-18000,,
com.leomehlig.today,17,1713058445,1713058462,1713058462.329987,-18000,,
com.google.Chrome,729,1713057716,1713058445,1713058445.6668901,-18000,,
com.leomehlig.today,2,1713057714,1713057716,1713057716.265386,-18000,,
com.google.Chrome,6,1713057708,1713057714,1713057714.417434,-18000,,
com.apple.finder,430,1713057278,1713057708,1713057708.770915,-18000,,
com.google.Chrome,4,1713057274,1713057278,1713057278.361362,-18000,,
com.apple.Photos,628,1713056277,1713056905,1713056905.597646,-18000,,
com.google.Chrome,1065,1713055212,1713056277,1713056277.3384042,-18000,,
com.leomehlig.today,31,1713055181,1713055212,1713055212.51514,-18000,,
com.google.Chrome,54,1713055127,1713055181,1713055182.050709,-18000,,
com.leomehlig.today,6,1713055102,1713055108,1713055108.953055,-18000,,
com.google.Chrome,65,1713055037,1713055102,1713055102.7876248,-18000,,
com.google.Chrome,27,1713051208,1713051235,1713051235.1247559,-18000,,
com.apple.keychainaccess,1,1713051207,1713051208,1713051208.172728,-18000,,
com.google.Chrome,3,1713051204,1713051207,1713051207.2615929,-18000,,
com.apple.keychainaccess,1,1713051203,1713051204,1713051204.897789,-18000,,
com.google.Chrome,2,1713051201,1713051203,1713051203.8406348,-18000,,
com.apple.keychainaccess,2,1713051199,1713051201,1713051202.025094,-18000,,
com.google.Chrome,63,1713051127,1713051190,1713051190.747405,-18000,,
com.google.Chrome,215,1712981477,1712981692,1712981692.4896588,-18000,,
com.google.Chrome,308,1712981011,1712981319,1712981319.760462,-18000,,
com.google.Chrome,554,1712980106,1712980660,1712980660.786121,-18000,,
com.google.Chrome,354,1712979605,1712979959,1712979959.5657601,-18000,,
com.google.Chrome,462,1712978683,1712979145,1712979145.853379,-18000,,
com.google.Chrome,713,1712977952,1712978665,1712978665.5516229,-18000,,
com.google.Chrome,585,1712976568,1712977153,1712977153.800657,-18000,,
com.google.Chrome,305,1712975512,1712975817,1712975817.967486,-18000,,
com.google.Chrome,875,1712974401,1712975276,1712975276.347228,-18000,,
com.leomehlig.today,60,1712974248,1712974308,1712974308.995791,-18000,,
com.google.Chrome,524,1712973724,1712974248,1712974248.834857,-18000,,
com.leomehlig.today,6,1712973718,1712973724,1712973724.995899,-18000,,
com.apple.Preview,909,1712972809,1712973718,1712973718.5612779,-18000,,
com.google.Chrome,21,1712972788,1712972809,1712972809.473038,-18000,,
com.apple.Preview,279,1712972509,1712972788,1712972788.160321,-18000,,
com.google.Chrome,6,1712972503,1712972509,1712972510.026483,-18000,,
com.apple.iCal,18,1712972485,1712972503,1712972503.619406,-18000,,
com.google.Chrome,31,1712972454,1712972485,1712972485.9354548,-18000,,
com.apple.iCal,227,1712972218,1712972445,1712972445.355534,-18000,,
com.google.Chrome,21,1712972197,1712972218,1712972218.550328,-18000,,
com.apple.iCal,30,1712972167,1712972197,1712972197.0622811,-18000,,
com.apple.Preview,491,1712971676,1712972167,1712972168.011496,-18000,,
com.leomehlig.today,100,1712971576,1712971676,1712971676.8884091,-18000,,
com.google.Chrome,54,1712971522,1712971576,1712971577.0073571,-18000,,
com.leomehlig.today,88,1712971434,1712971522,1712971522.212161,-18000,,
com.google.Chrome,85,1712971349,1712971434,1712971434.534894,-18000,,
com.leomehlig.today,38,1712971311,1712971349,1712971349.276386,-18000,,
com.google.Chrome,1,1712971310,1712971311,1712971311.778189,-18000,,
com.apple.MobileSMS,3,1712971307,1712971310,1712971310.465415,-18000,,
com.google.Chrome,92,1712971215,1712971307,1712971307.538085,-18000,,
com.google.Chrome,232,1712970596,1712970828,1712970828.927517,-18000,,
com.google.Chrome,277,1712969964,1712970241,1712970241.276104,-18000,,
com.google.Chrome,772,1712967881,1712968653,1712968653.687285,-18000,,
com.google.Chrome,450,1712966680,1712967130,1712967130.257794,-18000,,
com.google.Chrome,665,1712965011,1712965676,1712965676.6563358,-18000,,
com.google.Chrome,764,1712963469,1712964233,1712964233.417424,-18000,,
com.google.Chrome,300,1712961688,1712961988,1712961988.360509,-18000,,
com.google.Chrome,924,1712960121,1712961045,1712961045.7965221,-18000,,
com.google.Chrome,595,1712959050,1712959645,1712959645.8412871,-18000,,
com.google.Chrome,737,1712958283,1712959020,1712959020.771854,-18000,,
com.google.Chrome,627,1712957249,1712957876,1712957876.288708,-18000,,
com.leomehlig.today,19,1712957230,1712957249,1712957249.699462,-18000,,
com.google.Chrome,62,1712957168,1712957230,1712957230.368952,-18000,,
com.apple.Preview,24,1712957144,1712957168,1712957168.4123368,-18000,,
com.google.Chrome,3,1712957141,1712957144,1712957144.874771,-18000,,
com.apple.Preview,15,1712957126,1712957141,1712957141.075935,-18000,,
com.google.Chrome,148,1712956978,1712957126,1712957126.511894,-18000,,
com.apple.Preview,9,1712956969,1712956978,1712956978.6342468,-18000,,
com.google.Chrome,27,1712956942,1712956969,1712956970.019726,-18000,,
com.apple.Preview,7,1712956935,1712956942,1712956942.566526,-18000,,
com.google.Chrome,25,1712956910,1712956935,1712956935.578854,-18000,,
com.apple.Preview,4,1712956906,1712956910,1712956910.9308429,-18000,,
com.google.Chrome,3,1712956903,1712956906,1712956906.19841,-18000,,
com.apple.Preview,6,1712956897,1712956903,1712956903.0612001,-18000,,
com.google.Chrome,3,1712956894,1712956897,1712956897.554781,-18000,,
com.apple.Preview,15,1712956879,1712956894,1712956894.387708,-18000,,
com.google.Chrome,2,1712956877,1712956879,1712956880.019053,-18000,,
com.apple.Preview,16,1712956861,1712956877,1712956877.748026,-18000,,
com.google.Chrome,53,1712956808,1712956861,1712956861.077674,-18000,,
com.apple.Preview,23,1712956785,1712956808,1712956808.77194,-18000,,
com.google.Chrome,6,1712956779,1712956785,1712956785.398984,-18000,,
com.apple.Preview,9,1712956770,1712956779,1712956779.564674,-18000,,
com.google.Chrome,26,1712956744,1712956770,1712956770.8812342,-18000,,
com.apple.Preview,48,1712956696,1712956744,1712956744.652234,-18000,,
com.leomehlig.today,2,1712956694,1712956696,1712956696.1929379,-18000,,
com.google.Chrome,20,1712956674,1712956694,1712956694.75267,-18000,,
com.leomehlig.today,12,1712956662,1712956674,1712956674.172596,-18000,,
com.google.Chrome,162,1712956500,1712956662,1712956662.4633698,-18000,,
com.apple.Preview,5,1712956495,1712956500,1712956500.827141,-18000,,
com.google.Chrome,16,1712956479,1712956495,1712956495.823989,-18000,,
com.apple.Preview,175,1712956304,1712956479,1712956479.5814838,-18000,,
com.google.Chrome,1584,1712954720,1712956304,1712956304.9579291,-18000,,
com.apple.Preview,13,1712954707,1712954720,1712954720.317193,-18000,,
com.google.Chrome,29,1712954678,1712954707,1712954707.9385428,-18000,,
com.apple.Preview,42,1712954636,1712954678,1712954678.149224,-18000,,
com.google.Chrome,217,1712954419,1712954636,1712954636.881009,-18000,,
com.apple.Preview,61,1712954358,1712954419,1712954419.580421,-18000,,
com.google.Chrome,76,1712954282,1712954358,1712954358.7325602,-18000,,
com.apple.Preview,47,1712954235,1712954282,1712954282.4771972,-18000,,
com.apple.finder,1,1712954234,1712954235,1712954235.162051,-18000,,
com.google.Chrome,2,1712954232,1712954234,1712954234.189487,-18000,,
com.apple.finder,1,1712954231,1712954232,1712954232.534241,-18000,,
com.apple.Preview,8,1712954223,1712954231,1712954231.100906,-18000,,
com.apple.finder,5,1712954218,1712954223,1712954223.38093,-18000,,
com.google.Chrome,584,1712953634,1712954218,1712954218.5176868,-18000,,
com.leomehlig.today,200,1712953434,1712953634,1712953634.060313,-18000,,
com.apple.Preview,3,1712953431,1712953434,1712953434.8347402,-18000,,
com.google.Chrome,42,1712953389,1712953431,1712953431.681701,-18000,,
com.google.Chrome,728,1712952534,1712953262,1712953263.0105681,-18000,,
com.google.Chrome,1007,1712951052,1712952059,1712952059.049151,-18000,,
com.google.Chrome,418,1712950088,1712950506,1712950506.7191892,-18000,,
com.google.Chrome,524,1712949539,1712950063,1712950063.3795772,-18000,,
com.google.Chrome,300,1712949238,1712949538,1712949538.330315,-18000,,
com.google.Chrome,494,1712948662,1712949156,1712949156.233273,-18000,,
com.google.Chrome,491,1712947832,1712948323,1712948323.349725,-18000,,
com.google.Chrome,650,1712947115,1712947765,1712947765.630033,-18000,,
com.google.Chrome,304,1712946345,1712946649,1712946649.136982,-18000,,
com.google.Chrome,338,1712945895,1712946233,1712946233.9551048,-18000,,
com.google.Chrome,343,1712944566,1712944909,1712944909.271747,-18000,,
com.google.Chrome,473,1712943708,1712944181,1712944181.685707,-18000,,
com.google.Chrome,361,1712943228,1712943589,1712943589.6683378,-18000,,
com.google.Chrome,1,1712942107,1712942108,1712942109.236508,-18000,,
com.google.Chrome,386,1712941718,1712942104,1712942105.147194,-18000,,
com.google.Chrome,341,1712940761,1712941102,1712941102.2603788,-18000,,
com.apple.MobileSMS,27,1712940734,1712940761,1712940761.3765101,-18000,,
com.google.Chrome,1120,1712939614,1712940734,1712940734.693492,-18000,,
com.google.Chrome,417,1712938979,1712939396,1712939396.263015,-18000,,
com.google.Chrome,347,1712938301,1712938648,1712938648.687942,-18000,,
com.google.Chrome,520,1712937707,1712938227,1712938227.930263,-18000,,
com.google.Chrome,300,1712936768,1712937068,1712937068.7624521,-18000,,
com.google.Chrome,438,1712935964,1712936402,1712936402.577205,-18000,,
com.leomehlig.today,3,1712935529,1712935532,1712935532.203446,-18000,,
com.google.Chrome,17,1712935512,1712935529,1712935529.372892,-18000,,
com.leomehlig.today,1,1712935511,1712935512,1712935512.389991,-18000,,
com.google.Chrome,86,1712935410,1712935496,1712935496.864507,-18000,,
com.google.Chrome,176,1712898050,1712898226,1712898227.146759,-18000,,
com.google.Chrome,300,1712897446,1712897746,1712897746.555639,-18000,,
com.google.Chrome,434,1712896924,1712897358,1712897358.870424,-18000,,
com.google.Chrome,620,1712895612,1712896232,1712896232.769428,-18000,,
com.google.Chrome,336,1712894300,1712894636,1712894636.513904,-18000,,
com.google.Chrome,653,1712892837,1712893490,1712893490.987893,-18000,,
com.google.Chrome,412,1712891644,1712892056,1712892056.661201,-18000,,
com.google.Chrome,343,1712891244,1712891587,1712891587.406795,-18000,,
com.google.Chrome,756,1712888508,1712889264,1712889264.138758,-18000,,
com.leomehlig.today,10,1712888498,1712888508,1712888508.494797,-18000,,
com.leomehlig.today,461,1712887984,1712888445,1712888445.926021,-18000,,
com.apple.Preview,1,1712887983,1712887984,1712887984.8366342,-18000,,
com.leomehlig.today,27,1712887956,1712887983,1712887983.231392,-18000,,
com.apple.Preview,2737,1712885219,1712887956,1712887956.479079,-18000,,
com.apple.finder,3,1712885216,1712885219,1712885219.5386891,-18000,,
com.leomehlig.today,4,1712885212,1712885216,1712885216.511948,-18000,,
com.apple.Preview,4,1712885208,1712885212,1712885212.7350621,-18000,,
com.google.Chrome,255,1712884953,1712885208,1712885208.6014261,-18000,,
com.google.Chrome,308,1712884358,1712884666,1712884666.4603128,-18000,,
com.google.Chrome,352,1712883608,1712883960,1712883960.944241,-18000,,
com.google.Chrome,505,1712883033,1712883538,1712883538.259371,-18000,,
com.google.Chrome,818,1712881811,1712882629,1712882629.2063642,-18000,,
com.leomehlig.today,89,1712881722,1712881811,1712881811.486944,-18000,,
com.google.Chrome,246,1712881476,1712881722,1712881722.159926,-18000,,
com.google.Chrome,762,1712880471,1712881233,1712881233.206812,-18000,,
com.google.Chrome,714,1712879732,1712880446,1712880446.280285,-18000,,
com.microsoft.VSCode,5,1712879727,1712879732,1712879732.452313,-18000,,
com.apple.MobileSMS,17,1712879710,1712879727,1712879727.706634,-18000,,
com.microsoft.VSCode,354,1712879356,1712879710,1712879711.0264568,-18000,,
com.microsoft.VSCode,310,1712878898,1712879208,1712879208.583902,-18000,,
com.leomehlig.today,25,1712878873,1712878898,1712878898.631936,-18000,,
com.microsoft.VSCode,50,1712878823,1712878873,1712878873.084,-18000,,
com.google.Chrome,21,1712878802,1712878823,1712878823.974617,-18000,,
com.microsoft.VSCode,3,1712878799,1712878802,1712878802.160399,-18000,,
com.google.Chrome,1,1712878798,1712878799,1712878799.326318,-18000,,
com.microsoft.VSCode,2,1712878796,1712878798,1712878798.405441,-18000,,
com.google.Chrome,14,1712878782,1712878796,1712878796.420701,-18000,,
com.microsoft.VSCode,6,1712878776,1712878782,1712878782.783005,-18000,,
com.leomehlig.today,45,1712878731,1712878776,1712878776.587901,-18000,,
com.google.Chrome,34,1712878697,1712878731,1712878731.672823,-18000,,
com.apple.Notes,27,1712878670,1712878697,1712878697.792399,-18000,,
com.leomehlig.today,59,1712878611,1712878670,1712878670.914932,-18000,,
com.apple.Preview,1812,1712876799,1712878611,1712878611.76067,-18000,,
com.leomehlig.today,20,1712876779,1712876799,1712876799.638729,-18000,,
com.google.Chrome,175,1712876604,1712876779,1712876779.382031,-18000,,
com.leomehlig.today,10,1712876594,1712876604,1712876604.66663,-18000,,
com.leomehlig.today,335,1712875372,1712875707,1712875707.946054,-18000,,
com.apple.Preview,1405,1712873967,1712875372,1712875372.162438,-18000,,
com.apple.iCal,20,1712873947,1712873967,1712873967.7188082,-18000,,
com.leomehlig.today,14,1712873933,1712873947,1712873947.8705559,-18000,,
com.apple.Preview,242,1712873691,1712873933,1712873933.371289,-18000,,
com.apple.finder,3,1712873688,1712873691,1712873691.182009,-18000,,
com.microsoft.Outlook,102,1712873586,1712873688,1712873688.356761,-18000,,
com.microsoft.Outlook,440,1712868294,1712868734,1712868734.2445722,-18000,,
com.apple.finder,6,1712868288,1712868294,1712868294.380217,-18000,,
com.apple.finder,28,1712863393,1712863421,1712863421.554356,-18000,,
us.zoom.xos,14,1712863379,1712863393,1712863393.810687,-18000,,
com.google.Chrome,0,1712863379,1712863379,1712863379.504345,-18000,,
com.google.Chrome,436,1712862351,1712862787,1712862787.373415,-18000,,
us.zoom.xos,80,1712862271,1712862351,1712862351.7131119,-18000,,
com.google.Chrome,11,1712862260,1712862271,1712862271.930522,-18000,,
us.zoom.xos,2,1712862258,1712862260,1712862260.920145,-18000,,
com.google.Chrome,11,1712862247,1712862258,1712862258.45906,-18000,,
us.zoom.xos,4,1712862243,1712862247,1712862247.238802,-18000,,
com.google.Chrome,2,1712862241,1712862243,1712862243.5922709,-18000,,
us.zoom.xos,10,1712862231,1712862241,1712862241.742581,-18000,,
com.google.Chrome,4,1712862227,1712862231,1712862231.369182,-18000,,
us.zoom.xos,4,1712862223,1712862227,1712862227.54432,-18000,,
com.google.Chrome,1,1712862222,1712862223,1712862223.8303761,-18000,,
us.zoom.xos,2,1712862220,1712862222,1712862222.948381,-18000,,
com.google.Chrome,47,1712862173,1712862220,1712862220.2628279,-18000,,
us.zoom.xos,86,1712862087,1712862173,1712862173.963568,-18000,,
com.leomehlig.today,2,1712862060,1712862062,1712862062.537158,-18000,,
us.zoom.xos,1,1712862059,1712862060,1712862060.84213,-18000,,
com.google.Chrome,2,1712862057,1712862059,1712862059.047318,-18000,,
com.leomehlig.today,21,1712862032,1712862053,1712862054.0205479,-18000,,
com.google.Chrome,6,1712862026,1712862032,1712862032.459807,-18000,,
com.leomehlig.today,23,1712862003,1712862026,1712862026.144374,-18000,,
com.google.Chrome,6,1712861997,1712862003,1712862003.609376,-18000,,
com.apple.Preview,2890,1712859107,1712861997,1712861997.335593,-18000,,
com.apple.finder,8,1712859099,1712859107,1712859107.76234,-18000,,
com.google.Chrome,231,1712858868,1712859099,1712859099.6065679,-18000,,
com.apple.finder,3,1712858850,1712858853,1712858853.5018148,-18000,,
com.google.Chrome,1042,1712857808,1712858850,1712858850.10118,-18000,,
com.google.Chrome,26,1712856548,1712856574,1712856574.313675,-18000,,
com.google.Chrome,185,1712854827,1712855012,1712855012.401177,-18000,,
com.google.Chrome,438,1712853530,1712853968,1712853968.947023,-18000,,
com.apple.MobileSMS,2,1712853528,1712853530,1712853530.498752,-18000,,
com.google.Chrome,63,1712853465,1712853528,1712853528.716773,-18000,,
com.apple.MobileSMS,3,1712853462,1712853465,1712853465.047509,-18000,,
com.google.Chrome,9,1712853453,1712853462,1712853462.438539,-18000,,
com.apple.MobileSMS,18,1712853435,1712853453,1712853453.447458,-18000,,
com.google.Chrome,151,1712853284,1712853435,1712853435.9937,-18000,,
com.apple.MobileSMS,3,1712853281,1712853284,1712853284.1042109,-18000,,
com.google.Chrome,46,1712853235,1712853281,1712853281.988337,-18000,,
com.apple.MobileSMS,19,1712853216,1712853235,1712853235.979663,-18000,,
com.google.Chrome,2,1712853214,1712853216,1712853216.591135,-18000,,
com.apple.findmy,20,1712853194,1712853214,1712853214.541255,-18000,,
com.google.Chrome,15,1712853179,1712853194,1712853195.037988,-18000,,
com.apple.MobileSMS,44,1712853135,1712853179,1712853179.381773,-18000,,
com.google.Chrome,94,1712853041,1712853135,1712853135.198141,-18000,,
com.google.Chrome,108,1712846812,1712846920,1712846920.9020371,-18000,,
com.apple.iCal,29,1712846783,1712846812,1712846812.52946,-18000,,
com.google.Chrome,776,1712846007,1712846783,1712846783.9470758,-18000,,
com.google.Chrome,284,1712806695,1712806979,1712806979.259715,-18000,,
com.google.Chrome,348,1712805908,1712806256,1712806256.7590399,-18000,,
com.google.Chrome,305,1712805538,1712805843,1712805843.5291939,-18000,,
com.leomehlig.today,88,1712805450,1712805538,1712805538.1606588,-18000,,
com.google.Chrome,35,1712805415,1712805450,1712805450.261067,-18000,,
com.google.Chrome,303,1712804669,1712804972,1712804972.994563,-18000,,
com.google.Chrome,667,1712803755,1712804422,1712804422.3952641,-18000,,
com.apple.Preview,1,1712803748,1712803749,1712803749.535718,-18000,,
com.google.Chrome,1,1712803747,1712803748,1712803748.294732,-18000,,
com.apple.iCal,1,1712803746,1712803747,1712803747.7684798,-18000,,
com.google.Chrome,2,1712803744,1712803746,1712803746.268511,-18000,,
com.leomehlig.today,1,1712803743,1712803744,1712803745.001555,-18000,,
com.google.Chrome,596,1712803147,1712803743,1712803743.23716,-18000,,
com.leomehlig.today,16,1712803118,1712803134,1712803134.5510778,-18000,,
com.apple.iCal,8,1712803110,1712803118,1712803118.551601,-18000,,
com.leomehlig.today,15,1712803095,1712803110,1712803110.927144,-18000,,
com.apple.iCal,67,1712803028,1712803095,1712803095.558625,-18000,,
com.leomehlig.today,3,1712803025,1712803028,1712803028.180059,-18000,,
com.google.Chrome,1,1712803024,1712803025,1712803025.559256,-18000,,
com.microsoft.Outlook,68,1712802956,1712803024,1712803024.934896,-18000,,
com.google.Chrome,28,1712802928,1712802956,1712802956.146714,-18000,,
com.microsoft.Outlook,166,1712802762,1712802928,1712802928.097543,-18000,,
com.google.Chrome,129,1712802633,1712802762,1712802762.0479631,-18000,,
com.microsoft.Outlook,105,1712802528,1712802633,1712802633.1450381,-18000,,
com.google.Chrome,7,1712802521,1712802528,1712802528.6412401,-18000,,
com.microsoft.Outlook,5,1712802516,1712802521,1712802521.7734308,-18000,,
com.google.Chrome,1,1712802515,1712802516,1712802516.790601,-18000,,
com.microsoft.Outlook,26,1712802489,1712802515,1712802515.623297,-18000,,
com.google.Chrome,9,1712802480,1712802489,1712802489.1185122,-18000,,
com.microsoft.Outlook,45,1712802435,1712802480,1712802480.717928,-18000,,
com.google.Chrome,36,1712802399,1712802435,1712802435.104473,-18000,,
com.microsoft.Outlook,8,1712802368,1712802376,1712802376.9150891,-18000,,
com.leomehlig.today,21,1712802347,1712802368,1712802368.219228,-18000,,
com.google.Chrome,6,1712802341,1712802347,1712802347.0985742,-18000,,
com.apple.MobileSMS,2,1712802339,1712802341,1712802341.223576,-18000,,
com.google.Chrome,8,1712802331,1712802339,1712802339.544738,-18000,,
com.microsoft.Outlook,323,1712802008,1712802331,1712802331.1232271,-18000,,
com.apple.Preview,65,1712801943,1712802008,1712802008.858522,-18000,,
com.microsoft.Outlook,20,1712801923,1712801943,1712801943.473566,-18000,,
com.google.Chrome,56,1712801867,1712801923,1712801923.9868631,-18000,,
com.google.Chrome,345,1712784505,1712784850,1712784850.390542,-18000,,
com.google.Chrome,479,1712783168,1712783647,1712783647.4422998,-18000,,
com.google.Chrome,300,1712782255,1712782555,1712782555.92359,-18000,,
com.google.Chrome,557,1712781681,1712782238,1712782238.530663,-18000,,
com.google.Chrome,404,1712780618,1712781022,1712781022.531565,-18000,,
com.apple.MobileSMS,6,1712780612,1712780618,1712780618.887938,-18000,,
com.google.Chrome,6,1712780606,1712780612,1712780612.549392,-18000,,
com.apple.MobileSMS,93,1712780513,1712780606,1712780606.6702971,-18000,,
com.google.Chrome,1,1712780512,1712780513,1712780513.339985,-18000,,
com.apple.MobileSMS,49,1712780463,1712780512,1712780512.446216,-18000,,
com.google.Chrome,419,1712780044,1712780463,1712780463.7412329,-18000,,
com.google.Chrome,481,1712779480,1712779961,1712779961.050926,-18000,,
com.microsoft.Outlook,2,1712779478,1712779480,1712779480.809194,-18000,,
com.apple.FaceTime,6,1712779472,1712779478,1712779478.1255631,-18000,,
com.google.Chrome,108,1712779364,1712779472,1712779472.749819,-18000,,
com.google.Chrome,377,1712778892,1712779269,1712779269.308718,-18000,,
com.google.Chrome,378,1712778379,1712778757,1712778757.800189,-18000,,
com.google.Chrome,682,1712777536,1712778218,1712778218.199399,-18000,,
com.google.Chrome,326,1712777084,1712777410,1712777410.549123,-18000,,
com.google.Chrome,310,1712776678,1712776988,1712776988.569799,-18000,,
com.google.Chrome,504,1712775731,1712776235,1712776235.7658072,-18000,,
com.google.Chrome,440,1712775127,1712775567,1712775567.787548,-18000,,
com.apple.MobileSMS,3,1712775124,1712775127,1712775127.725934,-18000,,
com.google.Chrome,596,1712774528,1712775124,1712775125.020664,-18000,,
com.google.Chrome,538,1712773946,1712774484,1712774484.947798,-18000,,
com.apple.MobileSMS,6,1712773940,1712773946,1712773946.890187,-18000,,
com.microsoft.Outlook,1,1712773939,1712773940,1712773940.9154081,-18000,,
com.google.Chrome,27,1712773912,1712773939,1712773939.941876,-18000,,
com.microsoft.Outlook,21,1712773891,1712773912,1712773912.457583,-18000,,
com.google.Chrome,18,1712773873,1712773891,1712773892.010116,-18000,,
com.apple.MobileSMS,21,1712773852,1712773873,1712773873.4256492,-18000,,
com.google.Chrome,36,1712773816,1712773852,1712773852.48482,-18000,,
com.apple.MobileSMS,16,1712773800,1712773816,1712773816.999236,-18000,,
com.google.Chrome,5,1712773795,1712773800,1712773800.6523309,-18000,,
com.apple.MobileSMS,2,1712773793,1712773795,1712773795.483543,-18000,,
com.google.Chrome,21,1712773772,1712773793,1712773793.611079,-18000,,
com.apple.MobileSMS,4,1712773768,1712773772,1712773772.207841,-18000,,
com.google.Chrome,18,1712773750,1712773768,1712773768.913636,-18000,,
com.apple.MobileSMS,9,1712773741,1712773750,1712773750.578002,-18000,,
com.google.Chrome,116,1712773625,1712773741,1712773741.183622,-18000,,
com.apple.MobileSMS,4,1712773621,1712773625,1712773625.703775,-18000,,
com.google.Chrome,8,1712773613,1712773621,1712773621.8366861,-18000,,
com.google.Chrome,679,1712772589,1712773268,1712773268.897424,-18000,,
com.google.Chrome,1011,1712771187,1712772198,1712772198.653234,-18000,,
com.google.Chrome,1136,1712769681,1712770817,1712770817.2808561,-18000,,
com.google.Chrome,3,1712767798,1712767801,1712767801.676825,-18000,,
com.google.Chrome,556,1712766841,1712767397,1712767397.334423,-18000,,
com.google.Chrome,475,1712765595,1712766070,1712766070.500346,-18000,,
com.microsoft.Outlook,83,1712765512,1712765595,1712765595.161819,-18000,,
com.google.Chrome,49,1712765463,1712765512,1712765512.973273,-18000,,
com.microsoft.Outlook,5,1712765458,1712765463,1712765463.219372,-18000,,
com.google.Chrome,33,1712765425,1712765458,1712765458.5245152,-18000,,
com.microsoft.Outlook,638,1712764787,1712765425,1712765425.6325989,-18000,,
com.apple.finder,2,1712764785,1712764787,1712764787.853612,-18000,,
com.google.Chrome,30,1712764755,1712764785,1712764785.1098309,-18000,,
com.apple.finder,17,1712764738,1712764755,1712764755.3149018,-18000,,
com.microsoft.Outlook,85,1712764653,1712764738,1712764738.434329,-18000,,
com.google.Chrome,8,1712764645,1712764653,1712764653.798675,-18000,,
com.microsoft.Outlook,98,1712764547,1712764645,1712764645.655144,-18000,,
com.google.Chrome,209,1712764338,1712764547,1712764547.622005,-18000,,
com.google.Chrome,167,1712759241,1712759408,1712759408.849555,-18000,,
com.google.Chrome,329,1712758862,1712759191,1712759191.671175,-18000,,
com.microsoft.Outlook,4,1712758858,1712758862,1712758862.759254,-18000,,
com.google.Chrome,5,1712758853,1712758858,1712758858.292644,-18000,,
com.microsoft.Outlook,1,1712758852,1712758853,1712758853.319024,-18000,,
com.google.Chrome,385,1712758467,1712758852,1712758852.613421,-18000,,
com.google.Chrome,47,1712721998,1712722045,1712722045.3632689,-18000,,
com.google.Chrome,301,1712721520,1712721821,1712721821.8889232,-18000,,
com.google.Chrome,1214,1712720251,1712721465,1712721465.796113,-18000,,
com.google.Chrome,623,1712719124,1712719747,1712719747.04371,-18000,,
com.google.Chrome,301,1712718759,1712719060,1712719060.450797,-18000,,
com.google.Chrome,2381,1712716271,1712718652,1712718652.928855,-18000,,
com.google.Chrome,325,1712715904,1712716229,1712716229.185639,-18000,,
com.leomehlig.today,4,1712715900,1712715904,1712715904.679374,-18000,,
com.leomehlig.today,3,1712715702,1712715705,1712715705.492285,-18000,,
com.leomehlig.today,311,1712714886,1712715197,1712715197.945307,-18000,,
com.apple.iCal,18,1712714868,1712714886,1712714886.447042,-18000,,
com.leomehlig.today,46,1712714822,1712714868,1712714868.761172,-18000,,
com.apple.Notes,5,1712714817,1712714822,1712714822.5513968,-18000,,
com.google.Chrome,1709,1712713108,1712714817,1712714817.755192,-18000,,
com.microsoft.Outlook,145,1712712963,1712713108,1712713108.493355,-18000,,
com.google.Chrome,5,1712712958,1712712963,1712712963.379128,-18000,,
com.google.Chrome,463,1712707445,1712707908,1712707908.3602219,-18000,,
com.apple.MobileSMS,135,1712707310,1712707445,1712707445.611095,-18000,,
com.google.Chrome,104,1712707206,1712707310,1712707310.48227,-18000,,
com.apple.Notes,234,1712706959,1712707193,1712707193.643774,-18000,,
us.zoom.xos,4,1712706955,1712706959,1712706959.440732,-18000,,
com.apple.Notes,24,1712706931,1712706955,1712706955.8084102,-18000,,
com.google.Chrome,124,1712706807,1712706931,1712706931.925586,-18000,,
com.apple.Notes,64,1712706743,1712706807,1712706807.8092031,-18000,,
com.google.Chrome,1,1712706742,1712706743,1712706743.464364,-18000,,
com.apple.Notes,130,1712706612,1712706742,1712706742.6541162,-18000,,
com.google.Chrome,1148,1712705464,1712706612,1712706612.885161,-18000,,
com.google.Chrome,524,1712704471,1712704995,1712704995.7302551,-18000,,
com.google.Chrome,410,1712703548,1712703958,1712703958.757905,-18000,,
com.google.Chrome,301,1712703244,1712703545,1712703545.937621,-18000,,
com.google.Chrome,365,1712702771,1712703136,1712703136.152128,-18000,,
com.google.Chrome,417,1712702097,1712702514,1712702515.014031,-18000,,
com.google.Chrome,871,1712701226,1712702097,1712702097.2298,-18000,,
com.google.Chrome,362,1712699954,1712700316,1712700316.851026,-18000,,
com.google.Chrome,300,1712699404,1712699704,1712699704.5813742,-18000,,
com.google.Chrome,320,1712698630,1712698950,1712698950.924041,-18000,,
com.google.Chrome,519,1712697985,1712698504,1712698504.834817,-18000,,
com.leomehlig.today,27,1712697958,1712697985,1712697985.690768,-18000,,
us.zoom.xos,4,1712697954,1712697958,1712697959.022007,-18000,,
us.zoom.xos,13,1712694156,1712694169,1712694169.314467,-18000,,
us.zoom.xos,300,1712693183,1712693483,1712693483.354152,-18000,,
us.zoom.xos,386,1712692659,1712693045,1712693045.152547,-18000,,
us.zoom.xos,340,1712692278,1712692618,1712692618.322523,-18000,,
us.zoom.xos,913,1712691360,1712692273,1712692273.176497,-18000,,
com.apple.iCal,9,1712691351,1712691360,1712691360.417605,-18000,,
com.leomehlig.today,41,1712691310,1712691351,1712691351.627487,-18000,,
us.zoom.xos,528,1712690782,1712691310,1712691310.952357,-18000,,
com.google.Chrome,197,1712690585,1712690782,1712690782.191252,-18000,,
us.zoom.xos,29,1712690556,1712690585,1712690585.434032,-18000,,
com.google.Chrome,46,1712690510,1712690556,1712690556.462148,-18000,,
us.zoom.xos,3,1712690507,1712690510,1712690510.417615,-18000,,
com.google.Chrome,63,1712690444,1712690507,1712690507.75038,-18000,,
us.zoom.xos,696,1712689737,1712690433,1712690433.284504,-18000,,
com.google.Chrome,27,1712689710,1712689737,1712689737.342249,-18000,,
com.apple.iCal,15,1712689695,1712689710,1712689710.495836,-18000,,
us.zoom.xos,137,1712689558,1712689695,1712689695.041049,-18000,,
com.google.Chrome,7,1712689551,1712689558,1712689558.9140239,-18000,,
us.zoom.xos,11,1712689540,1712689551,1712689551.662894,-18000,,
com.google.Chrome,0,1712689540,1712689540,1712689540.786823,-18000,,
us.zoom.xos,22,1712689512,1712689534,1712689534.885004,-18000,,
com.google.Chrome,86,1712689426,1712689512,1712689512.427341,-18000,,
us.zoom.xos,5,1712689421,1712689426,1712689426.2793,-18000,,
com.google.Chrome,38,1712689383,1712689421,1712689421.556254,-18000,,
us.zoom.xos,17,1712689366,1712689383,1712689383.849402,-18000,,
com.google.Chrome,5,1712689361,1712689366,1712689366.8970351,-18000,,
us.zoom.xos,2,1712689359,1712689361,1712689361.468627,-18000,,
com.microsoft.VSCode,60,1712689299,1712689359,1712689359.350764,-18000,,
us.zoom.xos,44,1712689255,1712689299,1712689299.745611,-18000,,
com.google.Chrome,7,1712689248,1712689255,1712689255.601805,-18000,,
us.zoom.xos,5,1712689243,1712689248,1712689248.229484,-18000,,
com.google.Chrome,11,1712689232,1712689243,1712689243.3558521,-18000,,
us.zoom.xos,2,1712689230,1712689232,1712689232.2537951,-18000,,
com.google.Chrome,1,1712689229,1712689230,1712689230.5764,-18000,,
us.zoom.xos,3,1712689226,1712689229,1712689230.023287,-18000,,
com.google.Chrome,26,1712689200,1712689226,1712689226.2503428,-18000,,
com.google.Chrome,598,1712684130,1712684728,1712684729.210236,-18000,,
com.google.Chrome,405,1712683527,1712683932,1712683932.213698,-18000,,
com.microsoft.Outlook,86,1712683441,1712683527,1712683527.5954518,-18000,,
com.google.Chrome,54,1712683387,1712683441,1712683441.163336,-18000,,
com.google.Chrome,471,1712682589,1712683060,1712683060.303297,-18000,,
com.leomehlig.today,34,1712682555,1712682589,1712682589.7132468,-18000,,
com.apple.finder,4,1712682551,1712682555,1712682555.398676,-18000,,
com.microsoft.Powerpoint,232,1712682319,1712682551,1712682551.627341,-18000,,
com.microsoft.Powerpoint,457,1712681130,1712681587,1712681587.0514069,-18000,,
com.microsoft.Powerpoint,313,1712680229,1712680542,1712680542.322787,-18000,,
com.apple.finder,2,1712680227,1712680229,1712680229.682047,-18000,,
com.microsoft.Powerpoint,8,1712680219,1712680227,1712680227.562022,-18000,,
com.microsoft.Powerpoint,749,1712679432,1712680181,1712680181.620833,-18000,,
com.apple.finder,5,1712679427,1712679432,1712679432.889079,-18000,,
com.leomehlig.today,17,1712679410,1712679427,1712679427.471107,-18000,,
com.google.Chrome,17,1712679393,1712679410,1712679410.930402,-18000,,
com.leomehlig.today,12,1712679381,1712679393,1712679393.191087,-18000,,
com.google.Chrome,256,1712679125,1712679381,1712679381.894685,-18000,,
com.leomehlig.today,25,1712679087,1712679112,1712679113.006207,-18000,,
com.google.Chrome,264,1712678823,1712679087,1712679087.821877,-18000,,
com.google.Chrome,941,1712677159,1712678100,1712678100.300811,-18000,,
com.google.Chrome,425,1712676219,1712676644,1712676644.935495,-18000,,
com.google.Chrome,647,1712675472,1712676119,1712676119.351728,-18000,,
com.google.Chrome,301,1712674248,1712674549,1712674549.051821,-18000,,
com.google.Chrome,468,1712673609,1712674077,1712674078.000062,-18000,,
com.leomehlig.today,3,1712673527,1712673530,1712673531.409141,-18000,,
com.apple.iCal,4,1712673523,1712673527,1712673527.628052,-18000,,
com.google.Chrome,363,1712673160,1712673523,1712673523.751905,-18000,,
com.leomehlig.today,25,1712673135,1712673160,1712673160.321054,-18000,,
com.apple.iCal,5,1712673130,1712673135,1712673135.7823749,-18000,,
com.leomehlig.today,10,1712673120,1712673130,1712673130.5444388,-18000,,
com.google.Chrome,1,1712673119,1712673120,1712673120.27033,-18000,,
com.leomehlig.today,3,1712673116,1712673119,1712673119.146203,-18000,,
com.microsoft.Outlook,3,1712673113,1712673116,1712673116.51018,-18000,,
com.leomehlig.today,36,1712673077,1712673113,1712673113.509099,-18000,,
com.google.Chrome,82,1712672995,1712673077,1712673077.8605971,-18000,,
com.microsoft.Outlook,15,1712672980,1712672995,1712672995.5978441,-18000,,
com.google.Chrome,43,1712672937,1712672980,1712672980.332253,-18000,,
com.microsoft.Outlook,25,1712672912,1712672937,1712672937.305073,-18000,,
com.google.Chrome,18,1712672894,1712672912,1712672912.895549,-18000,,
com.microsoft.Outlook,111,1712672783,1712672894,1712672894.564272,-18000,,
com.google.Chrome,27,1712672756,1712672783,1712672783.85795,-18000,,
com.microsoft.Outlook,38,1712672718,1712672756,1712672756.864019,-18000,,
com.leomehlig.today,2,1712672716,1712672718,1712672718.422546,-18000,,
com.google.Chrome,13,1712672703,1712672716,1712672716.889595,-18000,,
com.leomehlig.today,1,1712672702,1712672703,1712672703.07204,-18000,,
com.microsoft.Outlook,122,1712672580,1712672702,1712672702.3514528,-18000,,
com.leomehlig.today,1,1712672579,1712672580,1712672580.637895,-18000,,
com.google.Chrome,10,1712672569,1712672579,1712672579.884801,-18000,,
com.leomehlig.today,0,1712672569,1712672569,1712672569.89764,-18000,,
com.google.Chrome,1,1712672568,1712672569,1712672569.2737799,-18000,,
com.leomehlig.today,5,1712672563,1712672568,1712672568.95543,-18000,,
com.google.Chrome,2,1712672561,1712672563,1712672563.955704,-18000,,
com.microsoft.Outlook,28,1712672533,1712672561,1712672561.619251,-18000,,
com.google.Chrome,255,1712672278,1712672533,1712672533.5027661,-18000,,
com.google.Chrome,9,1712635636,1712635645,1712635645.754626,-18000,,
com.google.Chrome,326,1712634374,1712634700,1712634700.408047,-18000,,
com.google.Chrome,673,1712632928,1712633601,1712633601.427011,-18000,,
com.google.Chrome,341,1712632244,1712632585,1712632585.278973,-18000,,
com.google.Chrome,407,1712631612,1712632019,1712632019.1065722,-18000,,
com.google.Chrome,109,1712630875,1712630984,1712630984.988431,-18000,,
com.google.Chrome,409,1712630334,1712630743,1712630743.951964,-18000,,
com.google.Chrome,686,1712629579,1712630265,1712630265.8745708,-18000,,
com.apple.MobileSMS,7,1712629572,1712629579,1712629579.124648,-18000,,
com.google.Chrome,3,1712629569,1712629572,1712629572.2415252,-18000,,
com.apple.news,775,1712628794,1712629569,1712629569.183332,-18000,,
com.google.Chrome,16,1712628778,1712628794,1712628794.562697,-18000,,
com.google.Chrome,702,1712627424,1712628126,1712628126.295704,-18000,,
com.apple.MobileSMS,5,1712627419,1712627424,1712627424.259873,-18000,,
com.google.Chrome,53,1712627366,1712627419,1712627419.773392,-18000,,
com.google.Chrome,794,1712626402,1712627196,1712627196.493238,-18000,,
com.apple.MobileSMS,38,1712626364,1712626402,1712626402.542142,-18000,,
com.google.Chrome,6,1712626358,1712626364,1712626364.579159,-18000,,
com.google.Chrome,368,1712625944,1712626312,1712626312.290196,-18000,,
com.apple.finder,8,1712625936,1712625944,1712625944.779356,-18000,,
com.apple.finder,4,1712624539,1712624543,1712624543.483193,-18000,,
com.google.Chrome,206,1712624333,1712624539,1712624539.2476459,-18000,,
com.google.Chrome,304,1712623843,1712624147,1712624147.641326,-18000,,
com.google.Chrome,663,1712623167,1712623830,1712623830.145972,-18000,,
com.google.Chrome,646,1712621723,1712622369,1712622369.8420439,-18000,,
com.apple.iCal,5,1712621718,1712621723,1712621723.7408319,-18000,,
com.google.Chrome,16,1712621702,1712621718,1712621718.081882,-18000,,
com.google.Chrome,736,1712615220,1712615956,1712615956.5940309,-18000,,
com.google.Chrome,1024,1712614026,1712615050,1712615050.360303,-18000,,
com.leomehlig.today,12,1712614014,1712614026,1712614026.714541,-18000,,
com.apple.iCal,26,1712613988,1712614014,1712614014.7004662,-18000,,
com.toyopagroup.picaboo,6,1712613923,1712613929,1712613929.751168,-18000,EB445137-D7F5-57EC-87DA-1DB460D64046,"iPhone13,2"
com.leomehlig.today,239,1712613749,1712613988,1712613988.598001,-18000,,
com.toyopagroup.picaboo,4,1712613715,1712613719,1712613719.83428,-18000,EB445137-D7F5-57EC-87DA-1DB460D64046,"iPhone13,2"
com.google.Chrome,52,1712613697,1712613749,1712613749.043943,-18000,,
com.leomehlig.today,20,1712613677,1712613697,1712613697.227611,-18000,,
com.google.Chrome,51,1712613626,1712613677,1712613677.45768,-18000,,
com.leomehlig.today,35,1712613591,1712613626,1712613626.609693,-18000,,
com.google.Chrome,12,1712613579,1712613591,1712613591.707721,-18000,,
com.leomehlig.today,8,1712613571,1712613579,1712613579.314959,-18000,,
com.google.Chrome,2,1712613569,1712613571,1712613571.571882,-18000,,
com.leomehlig.today,37,1712613532,1712613569,1712613569.322937,-18000,,
com.google.Chrome,6,1712613526,1712613532,1712613532.923729,-18000,,
com.leomehlig.today,0,1712613526,1712613526,1712613526.478034,-18000,,
com.google.Chrome,5,1712613521,1712613526,1712613526.114303,-18000,,
com.leomehlig.today,17,1712613504,1712613521,1712613521.5233722,-18000,,
com.google.Chrome,26,1712613478,1712613504,1712613504.772431,-18000,,
com.leomehlig.today,28,1712613450,1712613478,1712613478.042276,-18000,,
com.google.Chrome,27,1712613423,1712613450,1712613450.3015962,-18000,,
com.leomehlig.today,5,1712613391,1712613396,1712613396.859817,-18000,,
com.microsoft.VSCode,14,1712613377,1712613391,1712613391.823021,-18000,,
com.google.Chrome,35,1712613342,1712613377,1712613377.8932881,-18000,,
com.microsoft.VSCode,49,1712613293,1712613342,1712613342.3151588,-18000,,
com.leomehlig.today,26,1712613267,1712613293,1712613293.422081,-18000,,
com.apple.Preview,1,1712613266,1712613267,1712613267.6821651,-18000,,
com.leomehlig.today,4,1712613262,1712613266,1712613266.561981,-18000,,
com.google.Chrome,6,1712613256,1712613262,1712613262.5478458,-18000,,
com.toyopagroup.picaboo,6,1712613245,1712613251,1712613251.114647,-18000,EB445137-D7F5-57EC-87DA-1DB460D64046,"iPhone13,2"
com.apple.findmy,1,1712613241,1712613242,1712613243.4487329,-18000,EB445137-D7F5-57EC-87DA-1DB460D64046,"iPhone13,2"
com.microsoft.rdc.macos,23,1712613233,1712613256,1712613256.090736,-18000,,
com.apple.findmy,9,1712612807,1712612816,1712612816.2374659,-18000,EB445137-D7F5-57EC-87DA-1DB460D64046,"iPhone13,2"
com.apple.findmy,2,1712612803,1712612805,1712612805.851888,-18000,EB445137-D7F5-57EC-87DA-1DB460D64046,"iPhone13,2"
com.apple.findmy,19,1712612224,1712612243,1712612243.581716,-18000,EB445137-D7F5-57EC-87DA-1DB460D64046,"iPhone13,2"
com.apple.mobilecal,6,1712612217,1712612223,1712612223.247175,-18000,EB445137-D7F5-57EC-87DA-1DB460D64046,"iPhone13,2"
com.apple.mobilecal,6,1712611838,1712611844,1712611844.934678,-18000,EB445137-D7F5-57EC-87DA-1DB460D64046,"iPhone13,2"
com.apple.mobilecal,20,1712611817,1712611837,1712611837.664587,-18000,EB445137-D7F5-57EC-87DA-1DB460D64046,"iPhone13,2"
com.apple.findmy,3,1712611811,1712611814,1712611814.427536,-18000,EB445137-D7F5-57EC-87DA-1DB460D64046,"iPhone13,2"
com.apple.findmy,11,1712611590,1712611601,1712611601.2161021,-18000,EB445137-D7F5-57EC-87DA-1DB460D64046,"iPhone13,2"
edu.illinois.rokwire.ios,6,1712611583,1712611589,1712611589.15608,-18000,EB445137-D7F5-57EC-87DA-1DB460D64046,"iPhone13,2"
edu.illinois.rokwire.ios,9,1712611484,1712611493,1712611493.993099,-18000,EB445137-D7F5-57EC-87DA-1DB460D64046,"iPhone13,2"
edu.illinois.rokwire.ios,6,1712611449,1712611455,1712611455.5724092,-18000,EB445137-D7F5-57EC-87DA-1DB460D64046,"iPhone13,2"
edu.illinois.rokwire.ios,6,1712611442,1712611448,1712611448.652971,-18000,EB445137-D7F5-57EC-87DA-1DB460D64046,"iPhone13,2"
edu.illinois.rokwire.ios,6,1712611436,1712611442,1712611442.040273,-18000,EB445137-D7F5-57EC-87DA-1DB460D64046,"iPhone13,2"
edu.illinois.rokwire.ios,6,1712611423,1712611429,1712611429.404135,-18000,EB445137-D7F5-57EC-87DA-1DB460D64046,"iPhone13,2"
edu.illinois.rokwire.ios,6,1712611416,1712611422,1712611422.323806,-18000,EB445137-D7F5-57EC-87DA-1DB460D64046,"iPhone13,2"
edu.illinois.rokwire.ios,6,1712611401,1712611407,1712611407.4978728,-18000,EB445137-D7F5-57EC-87DA-1DB460D64046,"iPhone13,2"
edu.illinois.rokwire.ios,8,1712611380,1712611388,1712611388.1531081,-18000,EB445137-D7F5-57EC-87DA-1DB460D64046,"iPhone13,2"
edu.illinois.rokwire.ios,11,1712611362,1712611373,1712611373.205635,-18000,EB445137-D7F5-57EC-87DA-1DB460D64046,"iPhone13,2"
edu.illinois.rokwire.ios,2,1712611308,1712611310,1712611310.362638,-18000,EB445137-D7F5-57EC-87DA-1DB460D64046,"iPhone13,2"
edu.illinois.rokwire.ios,5,1712611087,1712611092,1712611092.23484,-18000,EB445137-D7F5-57EC-87DA-1DB460D64046,"iPhone13,2"
edu.illinois.rokwire.ios,3,1712610991,1712610994,1712610994.091353,-18000,EB445137-D7F5-57EC-87DA-1DB460D64046,"iPhone13,2"
edu.illinois.rokwire.ios,21,1712610949,1712610970,1712610970.811617,-18000,EB445137-D7F5-57EC-87DA-1DB460D64046,"iPhone13,2"
com.apple.findmy,18,1712610902,1712610920,1712610920.4683452,-18000,EB445137-D7F5-57EC-87DA-1DB460D64046,"iPhone13,2"
com.apple.Maps,12,1712610890,1712610902,1712610902.2506871,-18000,EB445137-D7F5-57EC-87DA-1DB460D64046,"iPhone13,2"
com.apple.findmy,15,1712610875,1712610890,1712610891.40134,-18000,EB445137-D7F5-57EC-87DA-1DB460D64046,"iPhone13,2"
com.apple.findmy,6,1712610704,1712610710,1712610710.182761,-18000,EB445137-D7F5-57EC-87DA-1DB460D64046,"iPhone13,2"
com.apple.findmy,20,1712610663,1712610683,1712610683.7894049,-18000,EB445137-D7F5-57EC-87DA-1DB460D64046,"iPhone13,2"
com.apple.findmy,20,1712609907,1712609927,1712609927.437258,-18000,EB445137-D7F5-57EC-87DA-1DB460D64046,"iPhone13,2"
com.apple.findmy,3,1712609799,1712609802,1712609802.798664,-18000,EB445137-D7F5-57EC-87DA-1DB460D64046,"iPhone13,2"
com.apple.findmy,1,1712609468,1712609469,1712609469.960952,-18000,EB445137-D7F5-57EC-87DA-1DB460D64046,"iPhone13,2"
com.apple.findmy,2,1712609466,1712609468,1712609468.261508,-18000,EB445137-D7F5-57EC-87DA-1DB460D64046,"iPhone13,2"
com.apple.findmy,2,1712609428,1712609430,1712609430.222851,-18000,EB445137-D7F5-57EC-87DA-1DB460D64046,"iPhone13,2"
com.apple.findmy,13,1712609405,1712609418,1712609418.349595,-18000,EB445137-D7F5-57EC-87DA-1DB460D64046,"iPhone13,2"
com.apple.Maps,12,1712609391,1712609403,1712609403.099928,-18000,EB445137-D7F5-57EC-87DA-1DB460D64046,"iPhone13,2"
com.google.chrome.ios,186,1712608921,1712609107,1712609107.723023,-18000,EB445137-D7F5-57EC-87DA-1DB460D64046,"iPhone13,2"
com.google.chrome.ios,43,1712608873,1712608916,1712608916.88889,-18000,EB445137-D7F5-57EC-87DA-1DB460D64046,"iPhone13,2"
com.apple.Maps,5,1712608868,1712608873,1712608873.2266212,-18000,EB445137-D7F5-57EC-87DA-1DB460D64046,"iPhone13,2"
com.apple.Maps,2,1712608768,1712608770,1712608770.4416661,-18000,EB445137-D7F5-57EC-87DA-1DB460D64046,"iPhone13,2"
com.apple.Maps,3,1712608765,1712608768,1712608768.094414,-18000,EB445137-D7F5-57EC-87DA-1DB460D64046,"iPhone13,2"
com.apple.Maps,12,1712608597,1712608609,1712608609.796843,-18000,EB445137-D7F5-57EC-87DA-1DB460D64046,"iPhone13,2"
com.apple.Maps,6,1712608324,1712608330,1712608330.778833,-18000,EB445137-D7F5-57EC-87DA-1DB460D64046,"iPhone13,2"
com.apple.Maps,104,1712608219,1712608323,1712608323.786135,-18000,EB445137-D7F5-57EC-87DA-1DB460D64046,"iPhone13,2"
com.apple.findmy,5,1712608214,1712608219,1712608219.826513,-18000,EB445137-D7F5-57EC-87DA-1DB460D64046,"iPhone13,2"
com.apple.podcasts,10,1712608204,1712608214,1712608214.489592,-18000,EB445137-D7F5-57EC-87DA-1DB460D64046,"iPhone13,2"
com.apple.podcasts,6,1712607885,1712607891,1712607891.399633,-18000,EB445137-D7F5-57EC-87DA-1DB460D64046,"iPhone13,2"
com.apple.podcasts,8,1712607746,1712607754,1712607754.516694,-18000,EB445137-D7F5-57EC-87DA-1DB460D64046,"iPhone13,2"
com.apple.podcasts,162,1712607453,1712607615,1712607615.5951881,-18000,EB445137-D7F5-57EC-87DA-1DB460D64046,"iPhone13,2"
com.apple.findmy,14,1712606041,1712606055,1712606056.0861201,-18000,EB445137-D7F5-57EC-87DA-1DB460D64046,"iPhone13,2"
com.apple.MobileSMS,40,1712605999,1712606039,1712606039.7239652,-18000,EB445137-D7F5-57EC-87DA-1DB460D64046,"iPhone13,2"
com.apple.Maps,18,1712604169,1712604187,1712604187.7146559,-18000,EB445137-D7F5-57EC-87DA-1DB460D64046,"iPhone13,2"
com.google.chrome.ios,12,1712603704,1712603716,1712603716.822125,-18000,EB445137-D7F5-57EC-87DA-1DB460D64046,"iPhone13,2"
com.apple.podcasts,5,1712603699,1712603704,1712603704.55622,-18000,EB445137-D7F5-57EC-87DA-1DB460D64046,"iPhone13,2"
com.apple.podcasts,54,1712603633,1712603687,1712603687.20011,-18000,EB445137-D7F5-57EC-87DA-1DB460D64046,"iPhone13,2"
com.apple.MobileSMS,27,1712603605,1712603632,1712603632.090952,-18000,EB445137-D7F5-57EC-87DA-1DB460D64046,"iPhone13,2"
com.apple.podcasts,52,1712603553,1712603605,1712603605.343111,-18000,EB445137-D7F5-57EC-87DA-1DB460D64046,"iPhone13,2"
com.google.Maps,4,1712603500,1712603504,1712603504.93926,-18000,EB445137-D7F5-57EC-87DA-1DB460D64046,"iPhone13,2"
com.google.Maps,27,1712603382,1712603409,1712603409.184763,-18000,EB445137-D7F5-57EC-87DA-1DB460D64046,"iPhone13,2"
com.apple.Maps,33,1712603347,1712603380,1712603380.126893,-18000,EB445137-D7F5-57EC-87DA-1DB460D64046,"iPhone13,2"
com.apple.camera,7,1712603051,1712603058,1712603058.145894,-18000,EB445137-D7F5-57EC-87DA-1DB460D64046,"iPhone13,2"
com.t11.celeste,6,1712603050,1712603056,1712603056.892383,-18000,EB445137-D7F5-57EC-87DA-1DB460D64046,"iPhone13,2"
com.t11.celeste,34,1712602961,1712602995,1712602995.540236,-18000,EB445137-D7F5-57EC-87DA-1DB460D64046,"iPhone13,2"
Astrospheric.Astrospheric,1,1712602960,1712602961,1712602961.870362,-18000,EB445137-D7F5-57EC-87DA-1DB460D64046,"iPhone13,2"
com.burbn.instagram,3,1712602956,1712602959,1712602959.316977,-18000,EB445137-D7F5-57EC-87DA-1DB460D64046,"iPhone13,2"
com.apple.camera,5,1712602920,1712602925,1712602926.0901,-18000,EB445137-D7F5-57EC-87DA-1DB460D64046,"iPhone13,2"
com.burbn.instagram,8,1712602917,1712602925,1712602926.1956549,-18000,EB445137-D7F5-57EC-87DA-1DB460D64046,"iPhone13,2"
com.burbn.instagram,3,1712602606,1712602609,1712602609.6589642,-18000,EB445137-D7F5-57EC-87DA-1DB460D64046,"iPhone13,2"
com.apple.camera,19,1712602350,1712602369,1712602369.554669,-18000,EB445137-D7F5-57EC-87DA-1DB460D64046,"iPhone13,2"
com.apple.news,175,1712601700,1712601875,1712601875.6431909,-18000,EB445137-D7F5-57EC-87DA-1DB460D64046,"iPhone13,2"
com.google.chrome.ios,24,1712601667,1712601691,1712601691.796932,-18000,EB445137-D7F5-57EC-87DA-1DB460D64046,"iPhone13,2"
com.google.chrome.ios,90,1712601533,1712601623,1712601623.824202,-18000,EB445137-D7F5-57EC-87DA-1DB460D64046,"iPhone13,2"
com.burbn.instagram,2,1712601531,1712601533,1712601533.7141361,-18000,EB445137-D7F5-57EC-87DA-1DB460D64046,"iPhone13,2"
com.burbn.instagram,54,1712601475,1712601529,1712601529.848927,-18000,EB445137-D7F5-57EC-87DA-1DB460D64046,"iPhone13,2"
com.apple.news,46,1712601299,1712601345,1712601345.99479,-18000,EB445137-D7F5-57EC-87DA-1DB460D64046,"iPhone13,2"
com.burbn.instagram,40,1712601116,1712601156,1712601156.5395799,-18000,EB445137-D7F5-57EC-87DA-1DB460D64046,"iPhone13,2"
com.burbn.instagram,8,1712601001,1712601009,1712601009.838241,-18000,EB445137-D7F5-57EC-87DA-1DB460D64046,"iPhone13,2"
com.burbn.instagram,263,1712600726,1712600989,1712600989.68767,-18000,EB445137-D7F5-57EC-87DA-1DB460D64046,"iPhone13,2"
com.burbn.instagram,90,1712600626,1712600716,1712600716.752172,-18000,EB445137-D7F5-57EC-87DA-1DB460D64046,"iPhone13,2"
com.google.chrome.ios,4,1712600621,1712600625,1712600625.730744,-18000,EB445137-D7F5-57EC-87DA-1DB460D64046,"iPhone13,2"
com.google.chrome.ios,1,1712600547,1712600548,1712600548.148099,-18000,EB445137-D7F5-57EC-87DA-1DB460D64046,"iPhone13,2"
com.apple.MobileSMS,3,1712600543,1712600546,1712600546.0940108,-18000,EB445137-D7F5-57EC-87DA-1DB460D64046,"iPhone13,2"
com.apple.camera,36,1712600507,1712600543,1712600543.781352,-18000,EB445137-D7F5-57EC-87DA-1DB460D64046,"iPhone13,2"
com.apple.MobileSMS,29,1712600329,1712600358,1712600358.230731,-18000,EB445137-D7F5-57EC-87DA-1DB460D64046,"iPhone13,2"
com.apple.mobilecal,43,1712600286,1712600329,1712600329.9520369,-18000,EB445137-D7F5-57EC-87DA-1DB460D64046,"iPhone13,2"
com.apple.MobileSMS,20,1712600263,1712600283,1712600283.048948,-18000,EB445137-D7F5-57EC-87DA-1DB460D64046,"iPhone13,2"
com.apple.news,9,1712600254,1712600263,1712600263.017043,-18000,EB445137-D7F5-57EC-87DA-1DB460D64046,"iPhone13,2"
com.apple.news,59,1712600137,1712600196,1712600196.522548,-18000,EB445137-D7F5-57EC-87DA-1DB460D64046,"iPhone13,2"
com.burbn.instagram,3,1712600128,1712600131,1712600131.419464,-18000,EB445137-D7F5-57EC-87DA-1DB460D64046,"iPhone13,2"
com.burbn.instagram,18,1712600037,1712600055,1712600055.605413,-18000,EB445137-D7F5-57EC-87DA-1DB460D64046,"iPhone13,2"
com.burbn.instagram,315,1712599704,1712600019,1712600019.079427,-18000,EB445137-D7F5-57EC-87DA-1DB460D64046,"iPhone13,2"
com.apple.camera,3,1712599701,1712599704,1712599704.1295571,-18000,EB445137-D7F5-57EC-87DA-1DB460D64046,"iPhone13,2"
com.apple.camera,13,1712599666,1712599679,1712599679.334883,-18000,EB445137-D7F5-57EC-87DA-1DB460D64046,"iPhone13,2"
com.apple.camera,1,1712599660,1712599661,1712599662.014507,-18000,EB445137-D7F5-57EC-87DA-1DB460D64046,"iPhone13,2"
com.apple.camera,18,1712599636,1712599654,1712599654.867813,-18000,EB445137-D7F5-57EC-87DA-1DB460D64046,"iPhone13,2"
com.apple.camera,38,1712599595,1712599633,1712599633.179871,-18000,EB445137-D7F5-57EC-87DA-1DB460D64046,"iPhone13,2"
com.google.chrome.ios,6,1712599587,1712599593,1712599593.7180738,-18000,EB445137-D7F5-57EC-87DA-1DB460D64046,"iPhone13,2"
com.google.chrome.ios,2,1712599585,1712599587,1712599587.15208,-18000,EB445137-D7F5-57EC-87DA-1DB460D64046,"iPhone13,2"
com.apple.camera,0,1712599585,1712599585,1712599585.960814,-18000,EB445137-D7F5-57EC-87DA-1DB460D64046,"iPhone13,2"
com.google.chrome.ios,6,1712599355,1712599361,1712599361.194428,-18000,EB445137-D7F5-57EC-87DA-1DB460D64046,"iPhone13,2"
com.google.chrome.ios,57,1712599083,1712599140,1712599140.0761008,-18000,EB445137-D7F5-57EC-87DA-1DB460D64046,"iPhone13,2"
com.google.chrome.ios,2,1712599037,1712599039,1712599039.7357821,-18000,EB445137-D7F5-57EC-87DA-1DB460D64046,"iPhone13,2"
com.google.chrome.ios,1,1712599036,1712599037,1712599037.57955,-18000,EB445137-D7F5-57EC-87DA-1DB460D64046,"iPhone13,2"
com.apple.MobileSMS,15,1712599021,1712599036,1712599036.641639,-18000,EB445137-D7F5-57EC-87DA-1DB460D64046,"iPhone13,2"
com.apple.camera,51,1712598961,1712599012,1712599013.431108,-18000,EB445137-D7F5-57EC-87DA-1DB460D64046,"iPhone13,2"
com.apple.MobileSMS,53,1712598959,1712599012,1712599013.231131,-18000,EB445137-D7F5-57EC-87DA-1DB460D64046,"iPhone13,2"
com.apple.MobileSMS,44,1712598903,1712598947,1712598947.404949,-18000,EB445137-D7F5-57EC-87DA-1DB460D64046,"iPhone13,2"
com.apple.MobileSMS,8,1712598693,1712598701,1712598701.094695,-18000,EB445137-D7F5-57EC-87DA-1DB460D64046,"iPhone13,2"
com.hammerandchisel.discord,34,1712598456,1712598490,1712598490.852591,-18000,EB445137-D7F5-57EC-87DA-1DB460D64046,"iPhone13,2"
com.google.chrome.ios,3,1712598431,1712598434,1712598434.5713902,-18000,EB445137-D7F5-57EC-87DA-1DB460D64046,"iPhone13,2"
com.google.chrome.ios,14,1712598416,1712598430,1712598430.591048,-18000,EB445137-D7F5-57EC-87DA-1DB460D64046,"iPhone13,2"
com.apple.camera,0,1712598301,1712598301,1712598301.199491,-18000,EB445137-D7F5-57EC-87DA-1DB460D64046,"iPhone13,2"
com.google.chrome.ios,2,1712598299,1712598301,1712598301.464779,-18000,EB445137-D7F5-57EC-87DA-1DB460D64046,"iPhone13,2"
com.google.chrome.ios,6,1712598286,1712598292,1712598292.170082,-18000,EB445137-D7F5-57EC-87DA-1DB460D64046,"iPhone13,2"
com.google.chrome.ios,63,1712598188,1712598251,1712598251.966146,-18000,EB445137-D7F5-57EC-87DA-1DB460D64046,"iPhone13,2"
com.apple.MobileSMS,57,1712598129,1712598186,1712598186.1657438,-18000,EB445137-D7F5-57EC-87DA-1DB460D64046,"iPhone13,2"
com.apple.MobileSMS,12,1712597513,1712597525,1712597525.751425,-18000,EB445137-D7F5-57EC-87DA-1DB460D64046,"iPhone13,2"
com.apple.findmy,20,1712597493,1712597513,1712597513.423944,-18000,EB445137-D7F5-57EC-87DA-1DB460D64046,"iPhone13,2"
Astrospheric.Astrospheric,3,1712597489,1712597492,1712597492.630149,-18000,EB445137-D7F5-57EC-87DA-1DB460D64046,"iPhone13,2"
com.microsoft.rdc.macos,39,1712597195,1712597234,1712597234.5095959,-18000,,
com.google.Chrome,14,1712597181,1712597195,1712597195.573069,-18000,,
Astrospheric.Astrospheric,6,1712596771,1712596777,1712596777.5229058,-18000,EB445137-D7F5-57EC-87DA-1DB460D64046,"iPhone13,2"
Astrospheric.Astrospheric,72,1712596687,1712596759,1712596759.113935,-18000,EB445137-D7F5-57EC-87DA-1DB460D64046,"iPhone13,2"
com.apple.MobileSMS,3,1712596679,1712596682,1712596682.1292949,-18000,EB445137-D7F5-57EC-87DA-1DB460D64046,"iPhone13,2"
com.apple.MobileSMS,29,1712596536,1712596565,1712596566.2330909,-18000,EB445137-D7F5-57EC-87DA-1DB460D64046,"iPhone13,2"
com.apple.compass,2,1712596533,1712596535,1712596535.506957,-18000,EB445137-D7F5-57EC-87DA-1DB460D64046,"iPhone13,2"
com.apple.compass,40,1712596333,1712596373,1712596373.7972841,-18000,EB445137-D7F5-57EC-87DA-1DB460D64046,"iPhone13,2"
com.apple.findmy,22,1712595494,1712595516,1712595517.181538,-18000,EB445137-D7F5-57EC-87DA-1DB460D64046,"iPhone13,2"
com.apple.Maps,12,1712595482,1712595494,1712595494.254082,-18000,EB445137-D7F5-57EC-87DA-1DB460D64046,"iPhone13,2"
com.apple.Maps,25,1712595394,1712595419,1712595419.6267939,-18000,EB445137-D7F5-57EC-87DA-1DB460D64046,"iPhone13,2"
com.apple.Maps,2,1712595265,1712595267,1712595267.348895,-18000,EB445137-D7F5-57EC-87DA-1DB460D64046,"iPhone13,2"
com.apple.Maps,16,1712595033,1712595049,1712595049.6426601,-18000,EB445137-D7F5-57EC-87DA-1DB460D64046,"iPhone13,2"
com.apple.Maps,2,1712594864,1712594866,1712594866.836248,-18000,EB445137-D7F5-57EC-87DA-1DB460D64046,"iPhone13,2"
com.apple.Maps,46,1712594801,1712594847,1712594847.849683,-18000,EB445137-D7F5-57EC-87DA-1DB460D64046,"iPhone13,2"
com.apple.Maps,6,1712594762,1712594768,1712594768.767976,-18000,EB445137-D7F5-57EC-87DA-1DB460D64046,"iPhone13,2"
com.apple.Maps,1,1712594570,1712594571,1712594572.029671,-18000,EB445137-D7F5-57EC-87DA-1DB460D64046,"iPhone13,2"
com.apple.Maps,6,1712594477,1712594483,1712594483.968507,-18000,EB445137-D7F5-57EC-87DA-1DB460D64046,"iPhone13,2"
com.apple.Maps,50,1712593991,1712594041,1712594041.282414,-18000,EB445137-D7F5-57EC-87DA-1DB460D64046,"iPhone13,2"
com.apple.findmy,7,1712593984,1712593991,1712593991.2428951,-18000,EB445137-D7F5-57EC-87DA-1DB460D64046,"iPhone13,2"
com.apple.findmy,10,1712593818,1712593828,1712593828.681361,-18000,EB445137-D7F5-57EC-87DA-1DB460D64046,"iPhone13,2"
com.apple.findmy,17,1712593608,1712593625,1712593625.605097,-18000,EB445137-D7F5-57EC-87DA-1DB460D64046,"iPhone13,2"
com.apple.Maps,6,1712593602,1712593608,1712593608.5673409,-18000,EB445137-D7F5-57EC-87DA-1DB460D64046,"iPhone13,2"
com.apple.Maps,8,1712593236,1712593244,1712593244.7992,-18000,EB445137-D7F5-57EC-87DA-1DB460D64046,"iPhone13,2"
com.microsoft.Office.Outlook,6,1712593228,1712593234,1712593234.956398,-18000,EB445137-D7F5-57EC-87DA-1DB460D64046,"iPhone13,2"
com.microsoft.Office.Outlook,53,1712592886,1712592939,1712592939.833735,-18000,EB445137-D7F5-57EC-87DA-1DB460D64046,"iPhone13,2"
com.google.Maps,12,1712592867,1712592879,1712592879.298321,-18000,EB445137-D7F5-57EC-87DA-1DB460D64046,"iPhone13,2"
com.apple.Maps,21,1712592842,1712592863,1712592863.558006,-18000,EB445137-D7F5-57EC-87DA-1DB460D64046,"iPhone13,2"
com.apple.Maps,21,1712592186,1712592207,1712592210.549045,-18000,EB445137-D7F5-57EC-87DA-1DB460D64046,"iPhone13,2"
com.apple.Maps,2,1712592181,1712592183,1712592183.686079,-18000,EB445137-D7F5-57EC-87DA-1DB460D64046,"iPhone13,2"
com.apple.Maps,10,1712591681,1712591691,1712591691.372479,-18000,EB445137-D7F5-57EC-87DA-1DB460D64046,"iPhone13,2"
com.apple.Maps,10,1712591639,1712591649,1712591649.8676329,-18000,EB445137-D7F5-57EC-87DA-1DB460D64046,"iPhone13,2"
com.apple.Maps,2,1712590018,1712590020,1712590020.789061,-18000,EB445137-D7F5-57EC-87DA-1DB460D64046,"iPhone13,2"
com.apple.Maps,9,1712589838,1712589847,1712589847.409092,-18000,EB445137-D7F5-57EC-87DA-1DB460D64046,"iPhone13,2"
com.apple.findmy,13,1712589762,1712589775,1712589775.865387,-18000,EB445137-D7F5-57EC-87DA-1DB460D64046,"iPhone13,2"
com.apple.findmy,21,1712589516,1712589537,1712589537.697536,-18000,EB445137-D7F5-57EC-87DA-1DB460D64046,"iPhone13,2"
com.apple.camera,0,1712589452,1712589452,1712589452.90528,-18000,EB445137-D7F5-57EC-87DA-1DB460D64046,"iPhone13,2"
com.toyopagroup.picaboo,11,1712588822,1712588833,1712588833.883638,-18000,EB445137-D7F5-57EC-87DA-1DB460D64046,"iPhone13,2"
com.toyopagroup.picaboo,5,1712588783,1712588788,1712588788.385213,-18000,EB445137-D7F5-57EC-87DA-1DB460D64046,"iPhone13,2"
com.toyopagroup.picaboo,16,1712588744,1712588760,1712588760.216741,-18000,EB445137-D7F5-57EC-87DA-1DB460D64046,"iPhone13,2"
com.apple.Maps,7,1712588737,1712588744,1712588744.768477,-18000,EB445137-D7F5-57EC-87DA-1DB460D64046,"iPhone13,2"
com.apple.Maps,5,1712588627,1712588632,1712588632.6354132,-18000,EB445137-D7F5-57EC-87DA-1DB460D64046,"iPhone13,2"
com.apple.Maps,18,1712588492,1712588510,1712588510.060286,-18000,EB445137-D7F5-57EC-87DA-1DB460D64046,"iPhone13,2"
com.apple.MobileSMS,15,1712588475,1712588490,1712588490.985156,-18000,EB445137-D7F5-57EC-87DA-1DB460D64046,"iPhone13,2"
com.apple.MobileSMS,15,1712588216,1712588231,1712588231.3848581,-18000,EB445137-D7F5-57EC-87DA-1DB460D64046,"iPhone13,2"
com.toyopagroup.picaboo,8,1712588206,1712588214,1712588214.045788,-18000,EB445137-D7F5-57EC-87DA-1DB460D64046,"iPhone13,2"
edu.illinois.rokwire.ios,2,1712588204,1712588206,1712588206.568871,-18000,EB445137-D7F5-57EC-87DA-1DB460D64046,"iPhone13,2"
edu.illinois.rokwire.ios,12,1712587957,1712587969,1712587969.913682,-18000,EB445137-D7F5-57EC-87DA-1DB460D64046,"iPhone13,2"
edu.illinois.rokwire.ios,9,1712587947,1712587956,1712587956.441279,-18000,EB445137-D7F5-57EC-87DA-1DB460D64046,"iPhone13,2"
com.toyopagroup.picaboo,3,1712587942,1712587945,1712587945.804985,-18000,EB445137-D7F5-57EC-87DA-1DB460D64046,"iPhone13,2"
com.apple.MobileSMS,4,1712587938,1712587942,1712587942.779377,-18000,EB445137-D7F5-57EC-87DA-1DB460D64046,"iPhone13,2"
com.apple.MobileSMS,29,1712587882,1712587911,1712587911.919414,-18000,EB445137-D7F5-57EC-87DA-1DB460D64046,"iPhone13,2"
com.burbn.instagram,2,1712587880,1712587882,1712587882.7608418,-18000,EB445137-D7F5-57EC-87DA-1DB460D64046,"iPhone13,2"
com.burbn.instagram,417,1712586694,1712587111,1712587111.423718,-18000,EB445137-D7F5-57EC-87DA-1DB460D64046,"iPhone13,2"
com.google.Chrome,58,1712586602,1712586660,1712586660.774572,-18000,,
com.apple.findmy,5,1712586535,1712586540,1712586540.381791,-18000,EB445137-D7F5-57EC-87DA-1DB460D64046,"iPhone13,2"
com.apple.Maps,32,1712586499,1712586531,1712586531.365133,-18000,EB445137-D7F5-57EC-87DA-1DB460D64046,"iPhone13,2"
com.apple.weather,3,1712586494,1712586497,1712586497.562059,-18000,EB445137-D7F5-57EC-87DA-1DB460D64046,"iPhone13,2"
com.apple.weather,21,1712586270,1712586291,1712586291.959786,-18000,EB445137-D7F5-57EC-87DA-1DB460D64046,"iPhone13,2"
com.apple.Health,27,1712586242,1712586269,1712586269.824101,-18000,EB445137-D7F5-57EC-87DA-1DB460D64046,"iPhone13,2"
com.toyopagroup.picaboo,4,1712586234,1712586238,1712586238.628059,-18000,EB445137-D7F5-57EC-87DA-1DB460D64046,"iPhone13,2"
com.apple.Maps,9,1712586225,1712586234,1712586234.3376489,-18000,EB445137-D7F5-57EC-87DA-1DB460D64046,"iPhone13,2"
com.apple.Maps,6,1712586119,1712586125,1712586125.345059,-18000,EB445137-D7F5-57EC-87DA-1DB460D64046,"iPhone13,2"
com.apple.Maps,44,1712586034,1712586078,1712586078.3535671,-18000,EB445137-D7F5-57EC-87DA-1DB460D64046,"iPhone13,2"
com.microsoft.Office.Outlook,29,1712585986,1712586015,1712586015.058401,-18000,EB445137-D7F5-57EC-87DA-1DB460D64046,"iPhone13,2"
com.apple.Health,30,1712585954,1712585984,1712585984.224235,-18000,EB445137-D7F5-57EC-87DA-1DB460D64046,"iPhone13,2"
com.apple.news,41,1712585794,1712585835,1712585835.75496,-18000,EB445137-D7F5-57EC-87DA-1DB460D64046,"iPhone13,2"
com.apple.news,2,1712585791,1712585793,1712585793.795881,-18000,EB445137-D7F5-57EC-87DA-1DB460D64046,"iPhone13,2"
com.apple.findmy,32,1712585753,1712585785,1712585785.893153,-18000,EB445137-D7F5-57EC-87DA-1DB460D64046,"iPhone13,2"
com.toyopagroup.picaboo,24,1712585725,1712585749,1712585749.939595,-18000,EB445137-D7F5-57EC-87DA-1DB460D64046,"iPhone13,2"
com.apple.findmy,15,1712585710,1712585725,1712585725.1013021,-18000,EB445137-D7F5-57EC-87DA-1DB460D64046,"iPhone13,2"
com.toyopagroup.picaboo,4,1712585702,1712585706,1712585706.189162,-18000,EB445137-D7F5-57EC-87DA-1DB460D64046,"iPhone13,2"
com.toyopagroup.picaboo,4,1712585692,1712585696,1712585696.438126,-18000,EB445137-D7F5-57EC-87DA-1DB460D64046,"iPhone13,2"
com.toyopagroup.picaboo,57,1712585623,1712585680,1712585680.153287,-18000,EB445137-D7F5-57EC-87DA-1DB460D64046,"iPhone13,2"
com.apple.Maps,3,1712585620,1712585623,1712585623.0459661,-18000,EB445137-D7F5-57EC-87DA-1DB460D64046,"iPhone13,2"
com.google.Chrome,1042,1712585514,1712586556,1712586556.158025,-18000,,
com.apple.Maps,50,1712585462,1712585512,1712585512.138463,-18000,EB445137-D7F5-57EC-87DA-1DB460D64046,"iPhone13,2"
com.apple.Maps,6,1712585455,1712585461,1712585461.74514,-18000,EB445137-D7F5-57EC-87DA-1DB460D64046,"iPhone13,2"
com.apple.finder,89,1712585425,1712585514,1712585514.070147,-18000,,
com.google.Chrome,1,1712585424,1712585425,1712585425.4978251,-18000,,
com.google.Chrome,301,1712585118,1712585419,1712585419.246557,-18000,,
com.apple.dt.Xcode,58,1712585060,1712585118,1712585118.920507,-18000,,
com.google.Chrome,26,1712585034,1712585060,1712585060.12303,-18000,,
com.apple.Maps,80,1712584946,1712585026,1712585026.8762631,-18000,EB445137-D7F5-57EC-87DA-1DB460D64046,"iPhone13,2"
com.google.Maps,57,1712584886,1712584943,1712584943.278029,-18000,EB445137-D7F5-57EC-87DA-1DB460D64046,"iPhone13,2"
com.toyopagroup.picaboo,24,1712545696,1712545720,1712545720.9331079,-18000,EB445137-D7F5-57EC-87DA-1DB460D64046,"iPhone13,2"
com.google.Chrome,11,1712545241,1712545252,1712545253.2726521,-18000,,
com.google.Chrome,381,1712544008,1712544389,1712544389.948049,-18000,,
com.google.Chrome,433,1712542631,1712543064,1712543064.9461598,-18000,,
com.google.Chrome,301,1712542239,1712542540,1712542540.246448,-18000,,
com.google.Chrome,685,1712541313,1712541998,1712541998.550929,-18000,,
com.google.ios.youtube,0,1712541190,1712541190,1712541190.7165651,-18000,EB445137-D7F5-57EC-87DA-1DB460D64046,"iPhone13,2"
com.google.ios.youtube,2,1712541187,1712541189,1712541189.817601,-18000,EB445137-D7F5-57EC-87DA-1DB460D64046,"iPhone13,2"
com.google.ios.youtube,8,1712540708,1712540716,1712540716.659045,-18000,EB445137-D7F5-57EC-87DA-1DB460D64046,"iPhone13,2"
com.google.ios.youtube,6,1712540699,1712540705,1712540705.687362,-18000,EB445137-D7F5-57EC-87DA-1DB460D64046,"iPhone13,2"
com.google.ios.youtube,25,1712540296,1712540321,1712540321.855747,-18000,EB445137-D7F5-57EC-87DA-1DB460D64046,"iPhone13,2"
com.google.ios.youtube,29,1712540257,1712540286,1712540286.435749,-18000,EB445137-D7F5-57EC-87DA-1DB460D64046,"iPhone13,2"
com.google.chrome.ios,31,1712540226,1712540257,1712540258.055488,-18000,EB445137-D7F5-57EC-87DA-1DB460D64046,"iPhone13,2"
com.toyopagroup.picaboo,4,1712540221,1712540225,1712540225.975977,-18000,EB445137-D7F5-57EC-87DA-1DB460D64046,"iPhone13,2"
com.google.Chrome,335,1712539726,1712540061,1712540061.110141,-18000,,
com.toyopagroup.picaboo,10,1712538886,1712538896,1712538896.237711,-18000,EB445137-D7F5-57EC-87DA-1DB460D64046,"iPhone13,2"
com.toyopagroup.picaboo,11,1712538563,1712538574,1712538574.35539,-18000,EB445137-D7F5-57EC-87DA-1DB460D64046,"iPhone13,2"
com.toyopagroup.picaboo,7,1712538506,1712538513,1712538513.979291,-18000,EB445137-D7F5-57EC-87DA-1DB460D64046,"iPhone13,2"
com.toyopagroup.picaboo,6,1712538320,1712538326,1712538326.160944,-18000,EB445137-D7F5-57EC-87DA-1DB460D64046,"iPhone13,2"
com.google.Chrome,571,1712538283,1712538854,1712538854.743541,-18000,,
com.toyopagroup.picaboo,18,1712538132,1712538150,1712538150.943994,-18000,EB445137-D7F5-57EC-87DA-1DB460D64046,"iPhone13,2"
com.google.Chrome,465,1712537590,1712538055,1712538055.639199,-18000,,
com.toyopagroup.picaboo,5,1712536791,1712536796,1712536796.8513951,-18000,EB445137-D7F5-57EC-87DA-1DB460D64046,"iPhone13,2"
edu.illinois.rokwire.ios,4,1712536787,1712536791,1712536791.970488,-18000,EB445137-D7F5-57EC-87DA-1DB460D64046,"iPhone13,2"
com.google.Chrome,625,1712536583,1712537208,1712537208.86545,-18000,,
edu.illinois.rokwire.ios,6,1712536453,1712536459,1712536459.5911798,-18000,EB445137-D7F5-57EC-87DA-1DB460D64046,"iPhone13,2"
edu.illinois.rokwire.ios,4,1712536447,1712536451,1712536451.659971,-18000,EB445137-D7F5-57EC-87DA-1DB460D64046,"iPhone13,2"
edu.illinois.rokwire.ios,9,1712536047,1712536056,1712536056.42591,-18000,EB445137-D7F5-57EC-87DA-1DB460D64046,"iPhone13,2"
com.apple.MobileSMS,4,1712536042,1712536046,1712536047.578601,-18000,EB445137-D7F5-57EC-87DA-1DB460D64046,"iPhone13,2"
com.google.Chrome,315,1712535896,1712536211,1712536211.817288,-18000,,
com.leomehlig.today,5,1712535891,1712535896,1712535896.957614,-18000,,
com.google.Chrome,1,1712535890,1712535891,1712535891.705719,-18000,,
com.apple.Preview,0,1712535890,1712535890,1712535891.009866,-18000,,
com.google.Chrome,739,1712535151,1712535890,1712535890.610935,-18000,,
com.google.Chrome,708,1712534339,1712535047,1712535047.347357,-18000,,
com.leomehlig.today,63,1712534276,1712534339,1712534339.22922,-18000,,
com.google.Chrome,296,1712533980,1712534276,1712534276.1148272,-18000,,
com.apple.Preview,5,1712533975,1712533980,1712533980.752891,-18000,,
com.google.Chrome,2,1712533973,1712533975,1712533975.35915,-18000,,
com.apple.Preview,12,1712533961,1712533973,1712533973.202581,-18000,,
com.google.Chrome,349,1712533612,1712533961,1712533961.084382,-18000,,
com.apple.Preview,37,1712533575,1712533612,1712533612.7527828,-18000,,
com.google.Chrome,3,1712533572,1712533575,1712533575.560938,-18000,,
com.apple.finder,1,1712533571,1712533572,1712533573.033467,-18000,,
com.apple.Preview,1,1712533570,1712533571,1712533571.89552,-18000,,
com.apple.finder,6,1712533564,1712533570,1712533570.205893,-18000,,
com.google.Chrome,42,1712533522,1712533564,1712533564.7910938,-18000,,
com.apple.MobileSMS,6,1712532942,1712532948,1712532948.1532888,-18000,EB445137-D7F5-57EC-87DA-1DB460D64046,"iPhone13,2"
com.apple.MobileSMS,4,1712532913,1712532917,1712532917.3677359,-18000,EB445137-D7F5-57EC-87DA-1DB460D64046,"iPhone13,2"
com.apple.MobileSMS,6,1712532697,1712532703,1712532703.743916,-18000,EB445137-D7F5-57EC-87DA-1DB460D64046,"iPhone13,2"
com.burbn.instagram,1298,1712531397,1712532695,1712532695.9666991,-18000,EB445137-D7F5-57EC-87DA-1DB460D64046,"iPhone13,2"
com.truebill.truebillnative,36,1712531355,1712531391,1712531391.4666262,-18000,EB445137-D7F5-57EC-87DA-1DB460D64046,"iPhone13,2"
edu.illinois.rokwire.ios,33,1712531291,1712531324,1712531324.943938,-18000,EB445137-D7F5-57EC-87DA-1DB460D64046,"iPhone13,2"
com.burbn.instagram,434,1712530856,1712531290,1712531291.124786,-18000,EB445137-D7F5-57EC-87DA-1DB460D64046,"iPhone13,2"
com.apple.AppStore,3,1712530853,1712530856,1712530856.616116,-18000,EB445137-D7F5-57EC-87DA-1DB460D64046,"iPhone13,2"
com.burbn.instagram,14,1712530839,1712530853,1712530853.941605,-18000,EB445137-D7F5-57EC-87DA-1DB460D64046,"iPhone13,2"
com.apple.MobileSMS,26,1712526823,1712526849,1712526849.8918939,-18000,EB445137-D7F5-57EC-87DA-1DB460D64046,"iPhone13,2"
com.toyopagroup.picaboo,7,1712526815,1712526822,1712526822.971986,-18000,EB445137-D7F5-57EC-87DA-1DB460D64046,"iPhone13,2"
com.google.Chrome,101,1712525118,1712525219,1712525219.337482,-18000,,
com.google.Chrome,302,1712524656,1712524958,1712524958.958321,-18000,,
com.apple.MobileSMS,8,1712524445,1712524453,1712524453.644583,-18000,EB445137-D7F5-57EC-87DA-1DB460D64046,"iPhone13,2"
Astrospheric.Astrospheric,8,1712524437,1712524445,1712524445.671515,-18000,EB445137-D7F5-57EC-87DA-1DB460D64046,"iPhone13,2"
com.google.Chrome,350,1712523727,1712524077,1712524077.545362,-18000,,
com.apple.MobileSMS,32,1712523695,1712523727,1712523727.750545,-18000,,
com.google.Chrome,14,1712523681,1712523695,1712523695.5311608,-18000,,
com.apple.MobileSMS,23,1712523658,1712523681,1712523681.788189,-18000,,
com.google.Chrome,13,1712523645,1712523658,1712523658.4786282,-18000,,
com.apple.MobileSMS,3,1712523642,1712523645,1712523645.97433,-18000,,
Astrospheric.Astrospheric,63,1712523230,1712523293,1712523293.873182,-18000,EB445137-D7F5-57EC-87DA-1DB460D64046,"iPhone13,2"
com.apple.MobileSMS,2,1712523226,1712523228,1712523228.911871,-18000,EB445137-D7F5-57EC-87DA-1DB460D64046,"iPhone13,2"
com.apple.MobileSMS,1,1712523217,1712523218,1712523218.380496,-18000,EB445137-D7F5-57EC-87DA-1DB460D64046,"iPhone13,2"
com.apple.MobileSMS,39,1712523178,1712523217,1712523217.273862,-18000,EB445137-D7F5-57EC-87DA-1DB460D64046,"iPhone13,2"
com.google.Chrome,503,1712523139,1712523642,1712523642.437796,-18000,,
com.apple.Maps,569,1712521839,1712522408,1712522408.857765,-18000,EB445137-D7F5-57EC-87DA-1DB460D64046,"iPhone13,2"
com.apple.MobileSMS,9,1712521828,1712521837,1712521837.964336,-18000,EB445137-D7F5-57EC-87DA-1DB460D64046,"iPhone13,2"
com.apple.MobileSMS,34,1712521793,1712521827,1712521827.019284,-18000,EB445137-D7F5-57EC-87DA-1DB460D64046,"iPhone13,2"
com.apple.MobileSMS,21,1712521771,1712521792,1712521792.975698,-18000,EB445137-D7F5-57EC-87DA-1DB460D64046,"iPhone13,2"
com.apple.Maps,11,1712521541,1712521552,1712521553.2327042,-18000,EB445137-D7F5-57EC-87DA-1DB460D64046,"iPhone13,2"
com.apple.Maps,139,1712521400,1712521539,1712521539.414397,-18000,EB445137-D7F5-57EC-87DA-1DB460D64046,"iPhone13,2"
com.apple.camera,1,1712521397,1712521398,1712521398.3099508,-18000,EB445137-D7F5-57EC-87DA-1DB460D64046,"iPhone13,2"
com.apple.Maps,6,1712521393,1712521399,1712521399.477566,-18000,EB445137-D7F5-57EC-87DA-1DB460D64046,"iPhone13,2"
com.apple.Maps,7,1712521207,1712521214,1712521214.959588,-18000,EB445137-D7F5-57EC-87DA-1DB460D64046,"iPhone13,2"
com.apple.Maps,432,1712520774,1712521206,1712521206.551817,-18000,EB445137-D7F5-57EC-87DA-1DB460D64046,"iPhone13,2"
com.apple.Maps,22,1712520746,1712520768,1712520768.716145,-18000,EB445137-D7F5-57EC-87DA-1DB460D64046,"iPhone13,2"
com.apple.MobileSMS,103,1712520642,1712520745,1712520745.5191731,-18000,EB445137-D7F5-57EC-87DA-1DB460D64046,"iPhone13,2"
com.apple.Maps,10,1712520632,1712520642,1712520643.081156,-18000,EB445137-D7F5-57EC-87DA-1DB460D64046,"iPhone13,2"
com.apple.MobileSMS,55,1712520568,1712520623,1712520623.226307,-18000,EB445137-D7F5-57EC-87DA-1DB460D64046,"iPhone13,2"
com.microsoft.Office.Outlook,12,1712520528,1712520540,1712520540.141269,-18000,EB445137-D7F5-57EC-87DA-1DB460D64046,"iPhone13,2"
com.apple.MobileSMS,46,1712520451,1712520497,1712520497.26615,-18000,EB445137-D7F5-57EC-87DA-1DB460D64046,"iPhone13,2"
com.apple.MobileSMS,226,1712520218,1712520444,1712520444.769003,-18000,EB445137-D7F5-57EC-87DA-1DB460D64046,"iPhone13,2"
com.toyopagroup.picaboo,9,1712520206,1712520215,1712520215.8104548,-18000,EB445137-D7F5-57EC-87DA-1DB460D64046,"iPhone13,2"
com.apple.MobileSMS,100,1712520099,1712520199,1712520199.899503,-18000,EB445137-D7F5-57EC-87DA-1DB460D64046,"iPhone13,2"
com.apple.MobileSMS,15,1712520076,1712520091,1712520091.6549911,-18000,EB445137-D7F5-57EC-87DA-1DB460D64046,"iPhone13,2"
com.apple.MobileSMS,32,1712520038,1712520070,1712520070.509841,-18000,EB445137-D7F5-57EC-87DA-1DB460D64046,"iPhone13,2"
com.apple.MobileSMS,3,1712520026,1712520029,1712520029.2535,-18000,EB445137-D7F5-57EC-87DA-1DB460D64046,"iPhone13,2"
com.apple.MobileSMS,19,1712520007,1712520026,1712520026.721823,-18000,EB445137-D7F5-57EC-87DA-1DB460D64046,"iPhone13,2"
com.google.Sheets,117,1712519853,1712519970,1712519970.5706,-18000,EB445137-D7F5-57EC-87DA-1DB460D64046,"iPhone13,2"
com.apple.MobileSMS,3,1712519848,1712519851,1712519851.484556,-18000,EB445137-D7F5-57EC-87DA-1DB460D64046,"iPhone13,2"
com.apple.MobileSMS,6,1712519837,1712519843,1712519843.537246,-18000,EB445137-D7F5-57EC-87DA-1DB460D64046,"iPhone13,2"
com.apple.MobileSMS,14,1712519822,1712519836,1712519836.54478,-18000,EB445137-D7F5-57EC-87DA-1DB460D64046,"iPhone13,2"
com.apple.Preferences,6,1712515781,1712515787,1712515788.0412369,-18000,EB445137-D7F5-57EC-87DA-1DB460D64046,"iPhone13,2"
us.parkmobile.ParkMobile,15,1712515747,1712515762,1712515762.131802,-18000,EB445137-D7F5-57EC-87DA-1DB460D64046,"iPhone13,2"
us.parkmobile.ParkMobile,10,1712515726,1712515736,1712515736.9720511,-18000,EB445137-D7F5-57EC-87DA-1DB460D64046,"iPhone13,2"
us.parkmobile.ParkMobile,10,1712515607,1712515617,1712515617.4656038,-18000,EB445137-D7F5-57EC-87DA-1DB460D64046,"iPhone13,2"
us.parkmobile.ParkMobile,30,1712515509,1712515539,1712515539.3115602,-18000,EB445137-D7F5-57EC-87DA-1DB460D64046,"iPhone13,2"
com.apple.Preferences,3,1712515502,1712515505,1712515505.390956,-18000,EB445137-D7F5-57EC-87DA-1DB460D64046,"iPhone13,2"
com.apple.Preferences,15,1712514803,1712514818,1712514818.605513,-18000,EB445137-D7F5-57EC-87DA-1DB460D64046,"iPhone13,2"
com.burbn.instagram,450,1712513998,1712514448,1712514448.887559,-18000,EB445137-D7F5-57EC-87DA-1DB460D64046,"iPhone13,2"
com.apple.MobileSMS,5,1712513921,1712513926,1712513926.577944,-18000,EB445137-D7F5-57EC-87DA-1DB460D64046,"iPhone13,2"
com.apple.Maps,3,1712513918,1712513921,1712513921.580665,-18000,EB445137-D7F5-57EC-87DA-1DB460D64046,"iPhone13,2"
com.apple.Maps,8,1712513908,1712513916,1712513916.229439,-18000,EB445137-D7F5-57EC-87DA-1DB460D64046,"iPhone13,2"
com.google.Chrome,337,1712513869,1712514206,1712514206.842557,-18000,,
com.leomehlig.today,35,1712513834,1712513869,1712513869.3814669,-18000,,
com.google.Chrome,118,1712513716,1712513834,1712513834.600738,-18000,,
com.apple.MobileSMS,7,1712513709,1712513716,1712513717.019367,-18000,,
com.apple.Maps,19,1712513630,1712513649,1712513649.203834,-18000,EB445137-D7F5-57EC-87DA-1DB460D64046,"iPhone13,2"
com.google.Maps,6,1712513622,1712513628,1712513628.751854,-18000,EB445137-D7F5-57EC-87DA-1DB460D64046,"iPhone13,2"
com.toyopagroup.picaboo,3,1712513617,1712513620,1712513621.224158,-18000,EB445137-D7F5-57EC-87DA-1DB460D64046,"iPhone13,2"
com.google.Maps,4,1712513613,1712513617,1712513617.416548,-18000,EB445137-D7F5-57EC-87DA-1DB460D64046,"iPhone13,2"
com.google.Chrome,288,1712513421,1712513709,1712513709.598808,-18000,,
com.apple.Notes,5,1712513416,1712513421,1712513421.711304,-18000,,
com.google.Chrome,6,1712513410,1712513416,1712513416.777333,-18000,,
com.apple.MobileSMS,61,1712513349,1712513410,1712513410.0970569,-18000,,
com.google.Chrome,5,1712513344,1712513349,1712513349.192447,-18000,,
com.leomehlig.today,8,1712513336,1712513344,1712513344.671181,-18000,,
com.google.Maps,10,1712512845,1712512855,1712512855.910177,-18000,EB445137-D7F5-57EC-87DA-1DB460D64046,"iPhone13,2"
com.google.Maps,88,1712512429,1712512517,1712512517.560787,-18000,EB445137-D7F5-57EC-87DA-1DB460D64046,"iPhone13,2"
com.apple.MobileSMS,5,1712512419,1712512424,1712512424.724753,-18000,EB445137-D7F5-57EC-87DA-1DB460D64046,"iPhone13,2"
com.google.Chrome,919,1712512417,1712513336,1712513336.742577,-18000,,
com.leomehlig.today,21,1712512396,1712512417,1712512417.613631,-18000,,
com.google.Chrome,135,1712512261,1712512396,1712512396.09411,-18000,,
com.apple.iCal,16,1712512245,1712512261,1712512261.175994,-18000,,
com.google.Chrome,119,1712512126,1712512245,1712512245.039137,-18000,,
com.apple.MobileSMS,62,1712512062,1712512124,1712512124.387222,-18000,EB445137-D7F5-57EC-87DA-1DB460D64046,"iPhone13,2"
com.apple.MobileSMS,25,1712512016,1712512041,1712512041.9108691,-18000,EB445137-D7F5-57EC-87DA-1DB460D64046,"iPhone13,2"
com.apple.MobileSMS,19,1712511723,1712511742,1712511742.2174702,-18000,EB445137-D7F5-57EC-87DA-1DB460D64046,"iPhone13,2"
edu.illinois.rokwire.ios,2,1712510319,1712510321,1712510321.8894482,-18000,EB445137-D7F5-57EC-87DA-1DB460D64046,"iPhone13,2"
com.toyopagroup.picaboo,12,1712510306,1712510318,1712510319.015833,-18000,EB445137-D7F5-57EC-87DA-1DB460D64046,"iPhone13,2"
edu.illinois.rokwire.ios,2,1712510304,1712510306,1712510306.949069,-18000,EB445137-D7F5-57EC-87DA-1DB460D64046,"iPhone13,2"
com.google.Chrome,300,1712510294,1712510594,1712510594.371031,-18000,,
com.leomehlig.today,27,1712510267,1712510294,1712510294.368309,-18000,,
edu.illinois.rokwire.ios,1,1712510116,1712510117,1712510118.22222,-18000,EB445137-D7F5-57EC-87DA-1DB460D64046,"iPhone13,2"
edu.illinois.rokwire.ios,1,1712510028,1712510029,1712510029.561212,-18000,EB445137-D7F5-57EC-87DA-1DB460D64046,"iPhone13,2"
com.google.Chrome,743,1712509524,1712510267,1712510267.099628,-18000,,
com.leomehlig.today,31,1712509493,1712509524,1712509524.319106,-18000,,
com.google.Chrome,121,1712509372,1712509493,1712509493.551405,-18000,,
edu.illinois.rokwire.ios,10,1712509122,1712509132,1712509132.174776,-18000,EB445137-D7F5-57EC-87DA-1DB460D64046,"iPhone13,2"
com.google.Chrome,328,1712509004,1712509332,1712509332.952316,-18000,,
edu.illinois.rokwire.ios,10,1712508953,1712508963,1712508963.553443,-18000,EB445137-D7F5-57EC-87DA-1DB460D64046,"iPhone13,2"
edu.illinois.rokwire.ios,10,1712508876,1712508886,1712508886.560297,-18000,EB445137-D7F5-57EC-87DA-1DB460D64046,"iPhone13,2"
com.google.Chrome,334,1712508460,1712508794,1712508794.280056,-18000,,
com.apple.Notes,30,1712508430,1712508460,1712508460.727148,-18000,,
com.google.Chrome,27,1712508403,1712508430,1712508430.515194,-18000,,
edu.illinois.rokwire.ios,14,1712508315,1712508329,1712508329.177573,-18000,EB445137-D7F5-57EC-87DA-1DB460D64046,"iPhone13,2"
edu.illinois.rokwire.ios,10,1712508224,1712508234,1712508234.607761,-18000,EB445137-D7F5-57EC-87DA-1DB460D64046,"iPhone13,2"
edu.illinois.rokwire.ios,10,1712507657,1712507667,1712507667.2725248,-18000,EB445137-D7F5-57EC-87DA-1DB460D64046,"iPhone13,2"
com.google.Chrome,829,1712507310,1712508139,1712508139.187088,-18000,,
com.apple.Notes,3,1712507307,1712507310,1712507310.559294,-18000,,
edu.illinois.rokwire.ios,17,1712507103,1712507120,1712507120.747487,-18000,EB445137-D7F5-57EC-87DA-1DB460D64046,"iPhone13,2"
edu.illinois.rokwire.ios,12,1712506622,1712506634,1712506634.1482348,-18000,EB445137-D7F5-57EC-87DA-1DB460D64046,"iPhone13,2"
com.microsoft.Office.Outlook,4,1712506617,1712506621,1712506621.490972,-18000,EB445137-D7F5-57EC-87DA-1DB460D64046,"iPhone13,2"
com.microsoft.Office.Outlook,16,1712506570,1712506586,1712506586.338972,-18000,EB445137-D7F5-57EC-87DA-1DB460D64046,"iPhone13,2"
com.apple.Health,14,1712506556,1712506570,1712506570.515094,-18000,EB445137-D7F5-57EC-87DA-1DB460D64046,"iPhone13,2"
com.apple.Health,33,1712506325,1712506358,1712506358.409823,-18000,EB445137-D7F5-57EC-87DA-1DB460D64046,"iPhone13,2"
com.google.Chrome,1259,1712506048,1712507307,1712507307.918839,-18000,,
com.toyopagroup.picaboo,11,1712505911,1712505922,1712505922.063795,-18000,EB445137-D7F5-57EC-87DA-1DB460D64046,"iPhone13,2"
com.hammerandchisel.discord,4,1712505907,1712505911,1712505911.392225,-18000,EB445137-D7F5-57EC-87DA-1DB460D64046,"iPhone13,2"
com.apple.Notes,368,1712505680,1712506048,1712506048.878171,-18000,,
com.google.Chrome,738,1712504942,1712505680,1712505680.075676,-18000,,
com.leomehlig.today,22,1712504920,1712504942,1712504942.907154,-18000,,
com.google.Chrome,159,1712504761,1712504920,1712504920.636173,-18000,,
com.hammerandchisel.discord,137,1712504647,1712504784,1712504784.7210588,-18000,EB445137-D7F5-57EC-87DA-1DB460D64046,"iPhone13,2"
com.microsoft.Office.Outlook,19,1712503424,1712503443,1712503443.894834,-18000,EB445137-D7F5-57EC-87DA-1DB460D64046,"iPhone13,2"
com.apple.MobileSMS,4,1712503417,1712503421,1712503421.380824,-18000,EB445137-D7F5-57EC-87DA-1DB460D64046,"iPhone13,2"
com.microsoft.Office.Outlook,13,1712503403,1712503416,1712503417.026146,-18000,EB445137-D7F5-57EC-87DA-1DB460D64046,"iPhone13,2"
com.google.Chrome,724,1712503303,1712504027,1712504027.7467918,-18000,,
com.toyopagroup.picaboo,73,1712503301,1712503374,1712503375.01237,-18000,EB445137-D7F5-57EC-87DA-1DB460D64046,"iPhone13,2"
com.google.Chrome,407,1712502056,1712502463,1712502463.583184,-18000,,
com.google.Chrome,69,1712460857,1712460926,1712460926.791984,-18000,,
com.google.Chrome,39,1712460815,1712460854,1712460854.303618,-18000,,
com.google.Chrome,444,1712460360,1712460804,1712460804.1962261,-18000,,
com.google.Chrome,444,1712459442,1712459886,1712459886.574014,-18000,,
com.google.Chrome,306,1712458966,1712459272,1712459272.220315,-18000,,
com.google.Chrome,454,1712458074,1712458528,1712458528.12065,-18000,,
com.google.Chrome,318,1712457641,1712457959,1712457959.263108,-18000,,
com.google.Chrome,302,1712457284,1712457586,1712457586.875257,-18000,,
com.google.Chrome,415,1712456232,1712456647,1712456647.563299,-18000,,
com.google.Chrome,413,1712455640,1712456053,1712456053.1768079,-18000,,
com.apple.iCal,13,1712455627,1712455640,1712455640.135456,-18000,,
com.google.Chrome,807,1712454820,1712455627,1712455627.593351,-18000,,
com.google.Chrome,542,1712453120,1712453662,1712453662.747309,-18000,,
com.google.Chrome,345,1712452035,1712452380,1712452381.0266252,-18000,,
com.google.Chrome,382,1712451402,1712451784,1712451784.526264,-18000,,
com.microsoft.VSCode,415,1712444189,1712444604,1712444604.480483,-18000,,
com.google.Chrome,6,1712444183,1712444189,1712444189.3997889,-18000,,
com.microsoft.VSCode,16,1712444167,1712444183,1712444183.612187,-18000,,
com.google.Chrome,2,1712444165,1712444167,1712444167.310369,-18000,,
com.microsoft.VSCode,16,1712444149,1712444165,1712444165.511209,-18000,,
com.google.Chrome,1,1712444148,1712444149,1712444149.959941,-18000,,
com.microsoft.VSCode,2,1712444146,1712444148,1712444148.858943,-18000,,
com.google.Chrome,1,1712444145,1712444146,1712444146.7766008,-18000,,
com.microsoft.VSCode,26,1712444119,1712444145,1712444145.334423,-18000,,
com.google.Chrome,25,1712444094,1712444119,1712444119.309372,-18000,,
com.microsoft.VSCode,2,1712444092,1712444094,1712444094.4524379,-18000,,
com.google.Chrome,2,1712444090,1712444092,1712444092.307503,-18000,,
com.microsoft.VSCode,7,1712444083,1712444090,1712444090.1633592,-18000,,
com.google.Chrome,2,1712444081,1712444083,1712444083.06607,-18000,,
com.microsoft.VSCode,1,1712444080,1712444081,1712444081.916719,-18000,,
com.google.Chrome,2,1712444078,1712444080,1712444080.2271261,-18000,,
com.microsoft.VSCode,7,1712444071,1712444078,1712444078.5278049,-18000,,
com.google.Chrome,2,1712444069,1712444071,1712444071.273549,-18000,,
com.microsoft.VSCode,3,1712444066,1712444069,1712444069.298749,-18000,,
com.google.Chrome,26,1712444040,1712444066,1712444066.712882,-18000,,
com.microsoft.VSCode,4,1712444036,1712444040,1712444040.217737,-18000,,
com.google.Chrome,1,1712444035,1712444036,1712444036.123199,-18000,,
com.microsoft.VSCode,0,1712444035,1712444035,1712444035.620661,-18000,,
com.google.Chrome,22,1712444013,1712444035,1712444035.5863318,-18000,,
com.microsoft.VSCode,126,1712443887,1712444013,1712444013.8080769,-18000,,
com.microsoft.Excel,142,1712443745,1712443887,1712443887.209707,-18000,,
com.apple.finder,51,1712443694,1712443745,1712443745.483873,-18000,,
com.microsoft.VSCode,36,1712443658,1712443694,1712443694.055931,-18000,,
com.google.Chrome,6,1712443652,1712443658,1712443658.221277,-18000,,
com.google.Chrome,644,1712441681,1712442325,1712442325.6699119,-18000,,
com.google.Chrome,333,1712440505,1712440838,1712440838.841658,-18000,,
com.google.Chrome,623,1712439804,1712440427,1712440427.683934,-18000,,
com.google.Chrome,336,1712439093,1712439429,1712439429.701072,-18000,,
com.google.Chrome,300,1712438787,1712439087,1712439087.842135,-18000,,
com.google.Chrome,379,1712437753,1712438132,1712438132.417718,-18000,,
com.microsoft.VSCode,6,1712437747,1712437753,1712437754.945338,-18000,,
com.microsoft.VSCode,3,1712436739,1712436742,1712436742.6062489,-18000,,
com.google.Chrome,4,1712436735,1712436739,1712436739.1261191,-18000,,
com.apple.systempreferences,86,1712436649,1712436735,1712436735.778065,-18000,,
com.google.Chrome,4,1712436639,1712436643,1712436643.1949558,-18000,,
com.leomehlig.today,95,1712436544,1712436639,1712436639.724321,-18000,,
com.apple.Notes,89,1712436455,1712436544,1712436544.674765,-18000,,
com.google.Chrome,374,1712436081,1712436455,1712436455.251147,-18000,,
com.leomehlig.today,13,1712436068,1712436081,1712436081.841249,-18000,,
com.google.Chrome,841,1712435227,1712436068,1712436068.5663152,-18000,,
com.leomehlig.today,5,1712435222,1712435227,1712435227.222386,-18000,,
com.google.Chrome,79,1712435143,1712435222,1712435222.61158,-18000,,
com.apple.iCal,11,1712435132,1712435143,1712435143.8441792,-18000,,
com.google.Chrome,37,1712435095,1712435132,1712435132.485806,-18000,,
com.apple.iCal,3,1712435092,1712435095,1712435095.606869,-18000,,
com.google.Chrome,1817,1712433275,1712435092,1712435092.1561599,-18000,,
com.google.Chrome,1714,1712431541,1712433255,1712433255.6227121,-18000,,
com.leomehlig.today,32,1712431509,1712431541,1712431541.965673,-18000,,
com.google.Chrome,110,1712431399,1712431509,1712431509.0839329,-18000,,
com.google.Chrome,437,1712423328,1712423765,1712423765.798895,-18000,,
com.microsoft.VSCode,2,1712423326,1712423328,1712423328.603568,-18000,,
com.microsoft.VSCode,259,1712420347,1712420606,1712420606.356124,-18000,,
com.google.Chrome,20,1712420327,1712420347,1712420347.383576,-18000,,
com.apple.Notes,4,1712420323,1712420327,1712420327.617629,-18000,,
com.google.Chrome,59,1712420264,1712420323,1712420323.456266,-18000,,
com.apple.Notes,3,1712420261,1712420264,1712420264.3298779,-18000,,
com.google.Chrome,30,1712420231,1712420261,1712420261.541813,-18000,,
com.apple.Notes,29,1712420202,1712420231,1712420232.007937,-18000,,
com.google.Chrome,3,1712420199,1712420202,1712420202.6494799,-18000,,
com.apple.Notes,27,1712420172,1712420199,1712420199.965852,-18000,,
com.google.Chrome,7,1712420165,1712420172,1712420172.801796,-18000,,
com.apple.Notes,2,1712420163,1712420165,1712420165.2879949,-18000,,
com.google.Chrome,4,1712420159,1712420163,1712420163.877553,-18000,,
com.apple.Notes,3,1712420156,1712420159,1712420159.139719,-18000,,
com.google.Chrome,9,1712420147,1712420156,1712420156.0771751,-18000,,
com.apple.Notes,6,1712420141,1712420147,1712420147.303982,-18000,,
com.google.Chrome,68,1712420073,1712420141,1712420141.335075,-18000,,
com.apple.Notes,50,1712420007,1712420057,1712420057.108139,-18000,,
com.leomehlig.today,50,1712419957,1712420007,1712420007.096523,-18000,,
com.apple.Preview,5,1712419952,1712419957,1712419957.419868,-18000,,
com.apple.Preview,2,1712335958,1712335960,1712335961.138945,-18000,,
com.leomehlig.today,4,1712335954,1712335958,1712335958.1832771,-18000,,
com.apple.finder,2,1712335952,1712335954,1712335954.243579,-18000,,
com.apple.Preview,2,1712335950,1712335952,1712335952.637752,-18000,,
com.google.Chrome,35,1712335915,1712335950,1712335950.722498,-18000,,
com.apple.Preview,50,1712335865,1712335915,1712335915.884634,-18000,,
com.apple.finder,3,1712335862,1712335865,1712335865.104941,-18000,,
com.google.Chrome,3,1712335859,1712335862,1712335862.946014,-18000,,
com.microsoft.Outlook,6,1712335853,1712335859,1712335859.712881,-18000,,
com.apple.iCal,12,1712335841,1712335853,1712335853.318687,-18000,,
com.google.Chrome,2,1712335839,1712335841,1712335841.2513242,-18000,,
com.microsoft.Outlook,5,1712335834,1712335839,1712335839.898943,-18000,,
com.google.Chrome,1,1712335833,1712335834,1712335835.010015,-18000,,
com.apple.iCal,29,1712335804,1712335833,1712335833.912026,-18000,,
com.google.Chrome,36,1712335768,1712335804,1712335804.966799,-18000,,
com.microsoft.Outlook,19,1712335749,1712335768,1712335768.326782,-18000,,
com.google.Chrome,25,1712335724,1712335749,1712335749.333498,-18000,,
com.apple.iCal,3,1712335612,1712335615,1712335615.680676,-18000,,
com.microsoft.Outlook,4,1712335608,1712335612,1712335612.690539,-18000,,
com.apple.iCal,1,1712335607,1712335608,1712335608.337776,-18000,,
com.microsoft.Outlook,4,1712335603,1712335607,1712335607.683867,-18000,,
com.google.Chrome,2,1712335601,1712335603,1712335603.89026,-18000,,
com.apple.Preview,1,1712335600,1712335601,1712335601.689266,-18000,,
com.google.Chrome,27,1712335573,1712335600,1712335600.711762,-18000,,
com.leomehlig.today,33,1712335540,1712335573,1712335573.4635859,-18000,,
com.google.Chrome,20,1712335520,1712335540,1712335540.9086761,-18000,,
com.leomehlig.today,27,1712335493,1712335520,1712335520.9694052,-18000,,
com.google.Chrome,46,1712335447,1712335493,1712335494.0036669,-18000,,
com.apple.Preview,27,1712335420,1712335447,1712335447.186403,-18000,,
com.google.Chrome,3,1712335417,1712335420,1712335420.9390259,-18000,,
com.apple.Preview,10,1712335407,1712335417,1712335417.917541,-18000,,
com.google.Chrome,5,1712335402,1712335407,1712335407.8080611,-18000,,
com.apple.Preview,10,1712335392,1712335402,1712335402.5087662,-18000,,
com.google.Chrome,6,1712335386,1712335392,1712335392.468227,-18000,,
com.apple.Preview,14,1712335372,1712335386,1712335386.81482,-18000,,
com.google.Chrome,379,1712334993,1712335372,1712335373.02801,-18000,,
com.apple.Preview,17,1712334976,1712334993,1712334993.254004,-18000,,
com.google.Chrome,48,1712334928,1712334976,1712334976.077145,-18000,,
com.apple.Preview,238,1712334690,1712334928,1712334928.948869,-18000,,
com.google.Chrome,9,1712334681,1712334690,1712334690.6561809,-18000,,
com.apple.Preview,67,1712334614,1712334681,1712334681.116331,-18000,,
com.google.Chrome,3,1712334611,1712334614,1712334614.448228,-18000,,
com.apple.Preview,11,1712334600,1712334611,1712334611.3396459,-18000,,
com.google.Chrome,9,1712334591,1712334600,1712334600.170244,-18000,,
com.apple.Preview,20,1712334571,1712334591,1712334591.10086,-18000,,
com.google.Chrome,569,1712334002,1712334571,1712334571.860509,-18000,,
com.apple.Preview,53,1712333949,1712334002,1712334002.763804,-18000,,
com.google.Chrome,5,1712333944,1712333949,1712333949.2639089,-18000,,
com.apple.Preview,7,1712333937,1712333944,1712333945.0534558,-18000,,
com.google.Chrome,6,1712333931,1712333937,1712333937.559061,-18000,,
com.apple.Preview,18,1712333913,1712333931,1712333931.488889,-18000,,
com.google.Chrome,19,1712333894,1712333913,1712333913.6441932,-18000,,
com.apple.Preview,7,1712333887,1712333894,1712333894.4632568,-18000,,
com.google.Chrome,4,1712333883,1712333887,1712333887.570736,-18000,,
com.apple.Preview,2,1712333881,1712333883,1712333883.185717,-18000,,
com.google.Chrome,16,1712333865,1712333881,1712333881.569059,-18000,,
com.apple.Preview,2,1712333863,1712333865,1712333865.937592,-18000,,
com.google.Chrome,4,1712333859,1712333863,1712333863.365123,-18000,,
com.apple.Preview,8,1712333851,1712333859,1712333859.6646218,-18000,,
com.google.Chrome,5,1712333846,1712333851,1712333851.074438,-18000,,
com.apple.Preview,29,1712333817,1712333846,1712333846.679724,-18000,,
com.google.Chrome,4,1712333813,1712333817,1712333817.3429918,-18000,,
com.apple.Preview,2,1712333811,1712333813,1712333813.4911342,-18000,,
com.google.Chrome,5,1712333806,1712333811,1712333811.682838,-18000,,
com.apple.Preview,11,1712333795,1712333806,1712333806.806915,-18000,,
com.google.Chrome,3,1712333792,1712333795,1712333795.7220411,-18000,,
com.apple.Preview,21,1712333771,1712333792,1712333792.690857,-18000,,
com.google.Chrome,14,1712333757,1712333771,1712333771.8891978,-18000,,
com.apple.Preview,116,1712333641,1712333757,1712333757.914589,-18000,,
com.google.Chrome,3,1712333638,1712333641,1712333641.590039,-18000,,
com.apple.Preview,19,1712333619,1712333638,1712333639.0319428,-18000,,
com.google.Chrome,4,1712333615,1712333619,1712333619.590654,-18000,,
com.apple.Preview,60,1712333555,1712333615,1712333615.512485,-18000,,
com.apple.finder,4,1712333551,1712333555,1712333555.103149,-18000,,
com.google.Chrome,400,1712333151,1712333551,1712333551.899582,-18000,,
com.google.Chrome,300,1712332600,1712332900,1712332900.479329,-18000,,
com.leomehlig.today,40,1712332560,1712332600,1712332600.470261,-18000,,
com.google.Chrome,218,1712332342,1712332560,1712332560.362938,-18000,,
com.google.Chrome,479,1712331800,1712332279,1712332279.414154,-18000,,
com.google.Chrome,642,1712330475,1712331117,1712331117.151516,-18000,,
com.apple.iCal,15,1712330460,1712330475,1712330475.6971478,-18000,,
com.google.Chrome,17,1712330443,1712330460,1712330460.877749,-18000,,
com.apple.iCal,25,1712330418,1712330443,1712330443.723473,-18000,,
com.google.Chrome,29,1712330389,1712330418,1712330418.746269,-18000,,
com.microsoft.VSCode,2,1712330387,1712330389,1712330389.0518951,-18000,,
com.leomehlig.today,8,1712330379,1712330387,1712330387.49155,-18000,,
com.microsoft.VSCode,2,1712330377,1712330379,1712330379.15187,-18000,,
com.google.Chrome,16,1712330361,1712330377,1712330377.8342829,-18000,,
com.microsoft.VSCode,4,1712330347,1712330351,1712330351.7878861,-18000,,
com.leomehlig.today,16,1712330331,1712330347,1712330347.907412,-18000,,
com.microsoft.VSCode,2,1712330329,1712330331,1712330331.281392,-18000,,
com.google.Chrome,37,1712330292,1712330329,1712330329.634707,-18000,,
com.microsoft.VSCode,3,1712330289,1712330292,1712330292.847581,-18000,,
com.google.Chrome,24,1712330265,1712330289,1712330289.844563,-18000,,
com.microsoft.VSCode,13,1712330252,1712330265,1712330266.0390968,-18000,,
com.google.Chrome,74,1712330178,1712330252,1712330252.3029242,-18000,,
com.microsoft.VSCode,3,1712330175,1712330178,1712330178.611034,-18000,,
com.google.Chrome,1,1712330174,1712330175,1712330175.468618,-18000,,
com.microsoft.VSCode,10,1712330164,1712330174,1712330174.147303,-18000,,
com.google.Chrome,52,1712330112,1712330164,1712330164.2427511,-18000,,
com.microsoft.VSCode,13,1712330099,1712330112,1712330112.123392,-18000,,
com.google.Chrome,141,1712329958,1712330099,1712330099.8956962,-18000,,
com.microsoft.VSCode,5,1712329953,1712329958,1712329958.3426309,-18000,,
com.google.Chrome,7,1712329946,1712329953,1712329953.678759,-18000,,
com.microsoft.VSCode,5,1712329941,1712329946,1712329947.010445,-18000,,
com.google.Chrome,90,1712329851,1712329941,1712329941.5276818,-18000,,
com.microsoft.VSCode,18,1712329833,1712329851,1712329851.1302528,-18000,,
com.google.Chrome,1,1712329832,1712329833,1712329833.9485369,-18000,,
com.microsoft.VSCode,123,1712329709,1712329832,1712329832.563499,-18000,,
com.google.Chrome,3,1712329706,1712329709,1712329709.6143441,-18000,,
com.microsoft.VSCode,89,1712329617,1712329706,1712329706.322854,-18000,,
com.google.Chrome,8,1712329609,1712329617,1712329617.653974,-18000,,
com.microsoft.VSCode,43,1712329566,1712329609,1712329609.527238,-18000,,
com.google.Chrome,4,1712329562,1712329566,1712329566.745407,-18000,,
com.microsoft.VSCode,1,1712329561,1712329562,1712329562.082274,-18000,,
com.google.Chrome,1,1712329560,1712329561,1712329561.7343721,-18000,,
com.microsoft.Outlook,9,1712329551,1712329560,1712329560.210987,-18000,,
com.google.Chrome,2,1712329549,1712329551,1712329551.389597,-18000,,
com.microsoft.Outlook,28,1712329521,1712329549,1712329549.992594,-18000,,
com.google.Chrome,6,1712329515,1712329521,1712329522.001951,-18000,,
com.microsoft.VSCode,1,1712329514,1712329515,1712329515.7382321,-18000,,
com.google.Chrome,5,1712329509,1712329514,1712329514.816434,-18000,,
com.microsoft.VSCode,2,1712329507,1712329509,1712329510.038547,-18000,,
com.google.Chrome,37,1712329470,1712329507,1712329507.634575,-18000,,
com.microsoft.VSCode,18,1712329452,1712329470,1712329470.845337,-18000,,
com.google.Chrome,4,1712329448,1712329452,1712329452.3872619,-18000,,
com.leomehlig.today,16,1712329419,1712329435,1712329435.42865,-18000,,
com.apple.finder,2,1712329417,1712329419,1712329419.716076,-18000,,
com.apple.Music,4,1712329413,1712329417,1712329417.39874,-18000,,
com.apple.finder,7,1712329406,1712329413,1712329413.1674771,-18000,,
com.apple.finder,13,1712289951,1712289964,1712289965.057307,-18000,,
com.google.Chrome,174,1712289777,1712289951,1712289951.609332,-18000,,
com.google.Chrome,504,1712288459,1712288963,1712288963.9108992,-18000,,
com.apple.finder,8,1712288451,1712288459,1712288459.05695,-18000,,
com.microsoft.VSCode,739,1712287712,1712288451,1712288452.066722,-18000,,
com.apple.finder,8,1712287704,1712287712,1712287712.246813,-18000,,
com.microsoft.VSCode,96,1712287608,1712287704,1712287704.7631311,-18000,,
com.apple.finder,2,1712287606,1712287608,1712287609.039645,-18000,,
com.microsoft.VSCode,38,1712287568,1712287606,1712287606.142837,-18000,,
com.apple.finder,3,1712287565,1712287568,1712287568.186408,-18000,,
com.microsoft.VSCode,3,1712287562,1712287565,1712287565.494003,-18000,,
com.apple.finder,29,1712287533,1712287562,1712287562.251408,-18000,,
com.microsoft.VSCode,397,1712287136,1712287533,1712287533.62907,-18000,,
com.apple.finder,7,1712287129,1712287136,1712287136.443029,-18000,,
com.microsoft.VSCode,86,1712287043,1712287129,1712287129.6441631,-18000,,
com.apple.finder,5,1712287038,1712287043,1712287043.8736959,-18000,,
com.microsoft.VSCode,17,1712287021,1712287038,1712287038.7979531,-18000,,
com.apple.finder,19,1712287002,1712287021,1712287022.005435,-18000,,
com.apple.iWork.Numbers,10,1712286992,1712287002,1712287002.73742,-18000,,
com.apple.finder,16,1712286976,1712286992,1712286992.255604,-18000,,
com.microsoft.VSCode,44,1712286932,1712286976,1712286976.095354,-18000,,
com.apple.finder,10,1712286922,1712286932,1712286932.392729,-18000,,
com.microsoft.VSCode,91,1712286831,1712286922,1712286922.125945,-18000,,
com.apple.finder,9,1712286822,1712286831,1712286831.4781651,-18000,,
com.apple.finder,31,1712285653,1712285684,1712285685.3383632,-18000,,
com.apple.Preview,3,1712285650,1712285653,1712285653.588428,-18000,,
com.apple.finder,1,1712285649,1712285650,1712285650.615151,-18000,,
com.leomehlig.today,8,1712285641,1712285649,1712285649.3604798,-18000,,
com.google.Chrome,1,1712285640,1712285641,1712285642.110636,-18000,,
com.microsoft.VSCode,386,1712285254,1712285640,1712285640.936038,-18000,,
com.apple.finder,20,1712285234,1712285254,1712285254.787866,-18000,,
com.microsoft.VSCode,4,1712285230,1712285234,1712285234.935674,-18000,,
com.apple.dt.Xcode,8,1712285222,1712285230,1712285230.745702,-18000,,
com.microsoft.VSCode,3,1712285219,1712285222,1712285222.867104,-18000,,
com.apple.dt.Xcode,4,1712285215,1712285219,1712285219.5075722,-18000,,
com.microsoft.VSCode,262,1712284953,1712285215,1712285215.474103,-18000,,
com.apple.dt.Xcode,5,1712284948,1712284953,1712284954.050811,-18000,,
com.microsoft.VSCode,0,1712284948,1712284948,1712284949.115011,-18000,,
com.apple.finder,7,1712284941,1712284948,1712284948.91006,-18000,,
com.microsoft.VSCode,15,1712284926,1712284941,1712284941.241661,-18000,,
com.apple.finder,1,1712284925,1712284926,1712284926.121368,-18000,,
com.microsoft.VSCode,1,1712284924,1712284925,1712284925.594821,-18000,,
com.apple.finder,53,1712284871,1712284924,1712284924.441673,-18000,,
com.apple.archiveutility,2,1712284869,1712284871,1712284872.074051,-18000,,
com.apple.finder,22,1712284847,1712284869,1712284869.155353,-18000,,
com.microsoft.VSCode,565,1712284282,1712284847,1712284847.479543,-18000,,
com.apple.finder,8,1712284274,1712284282,1712284282.913589,-18000,,
com.microsoft.VSCode,241,1712284033,1712284274,1712284274.2914538,-18000,,
com.google.Chrome,124,1712283909,1712284033,1712284033.225915,-18000,,
com.microsoft.VSCode,144,1712283765,1712283909,1712283910.063024,-18000,,
com.apple.finder,5,1712283760,1712283765,1712283765.650744,-18000,,
com.microsoft.VSCode,208,1712283552,1712283760,1712283760.114733,-18000,,
com.apple.finder,1,1712283551,1712283552,1712283552.9420052,-18000,,
com.microsoft.VSCode,40,1712283511,1712283551,1712283551.470357,-18000,,
com.apple.finder,10,1712283501,1712283511,1712283511.309482,-18000,,
com.microsoft.VSCode,5,1712283496,1712283501,1712283502.029066,-18000,,
com.apple.finder,6,1712283490,1712283496,1712283496.726328,-18000,,
com.microsoft.Excel,1,1712283489,1712283490,1712283490.921936,-18000,,
com.apple.finder,1,1712283488,1712283489,1712283489.674411,-18000,,
com.microsoft.VSCode,26,1712283462,1712283488,1712283488.466679,-18000,,
com.apple.finder,2,1712283460,1712283462,1712283462.138379,-18000,,
com.microsoft.VSCode,48,1712283412,1712283460,1712283460.4767709,-18000,,
com.apple.finder,28,1712283384,1712283412,1712283412.1865249,-18000,,
com.microsoft.Excel,202,1712283182,1712283384,1712283384.39609,-18000,,
com.apple.finder,9,1712283173,1712283182,1712283183.09234,-18000,,
com.microsoft.Excel,7,1712283166,1712283173,1712283173.877884,-18000,,
com.leomehlig.today,0,1712283166,1712283166,1712283166.956839,-18000,,
com.microsoft.Excel,25,1712283141,1712283166,1712283166.2840328,-18000,,
com.leomehlig.today,7,1712283134,1712283141,1712283141.0801392,-18000,,
com.microsoft.Excel,2,1712283132,1712283134,1712283134.8956308,-18000,,
com.leomehlig.today,5,1712283127,1712283132,1712283132.411145,-18000,,
com.microsoft.Excel,2,1712283125,1712283127,1712283127.547236,-18000,,
com.leomehlig.today,8,1712283117,1712283125,1712283125.669631,-18000,,
com.microsoft.Excel,4,1712283113,1712283117,1712283117.2475119,-18000,,
com.leomehlig.today,7,1712283106,1712283113,1712283113.4772859,-18000,,
com.microsoft.Excel,8,1712283098,1712283106,1712283106.149085,-18000,,
com.leomehlig.today,5,1712283093,1712283098,1712283098.898494,-18000,,
com.microsoft.Excel,2,1712283091,1712283093,1712283093.1039991,-18000,,
com.leomehlig.today,5,1712283086,1712283091,1712283091.753985,-18000,,
com.microsoft.Excel,1,1712283085,1712283086,1712283086.295868,-18000,,
com.leomehlig.today,5,1712283080,1712283085,1712283085.2788382,-18000,,
com.microsoft.Excel,4,1712283076,1712283080,1712283080.856144,-18000,,
com.leomehlig.today,6,1712283070,1712283076,1712283076.6230102,-18000,,
com.microsoft.Excel,5,1712283065,1712283070,1712283070.590228,-18000,,
com.leomehlig.today,8,1712283057,1712283065,1712283065.344208,-18000,,
com.microsoft.Excel,1,1712283056,1712283057,1712283057.570956,-18000,,
com.leomehlig.today,3,1712283053,1712283056,1712283056.200732,-18000,,
com.microsoft.Excel,1,1712283052,1712283053,1712283053.5204148,-18000,,
com.leomehlig.today,16,1712283036,1712283052,1712283052.270358,-18000,,
com.microsoft.Excel,2,1712283034,1712283036,1712283036.175031,-18000,,
com.leomehlig.today,8,1712283026,1712283034,1712283034.3129768,-18000,,
com.microsoft.Excel,2,1712283024,1712283026,1712283026.8797321,-18000,,
com.leomehlig.today,10,1712283014,1712283024,1712283024.7171311,-18000,,
com.microsoft.Excel,6,1712283008,1712283014,1712283014.873571,-18000,,
com.leomehlig.today,3,1712283005,1712283008,1712283008.717047,-18000,,
com.microsoft.Excel,2,1712283003,1712283005,1712283005.842338,-18000,,
com.leomehlig.today,19,1712282984,1712283003,1712283003.967809,-18000,,
com.microsoft.Excel,3,1712282981,1712282984,1712282984.378677,-18000,,
com.leomehlig.today,5,1712282976,1712282981,1712282981.548409,-18000,,
com.microsoft.Excel,5,1712282971,1712282976,1712282976.475195,-18000,,
com.leomehlig.today,11,1712282960,1712282971,1712282971.149235,-18000,,
com.microsoft.Excel,7,1712282953,1712282960,1712282960.245431,-18000,,
com.leomehlig.today,14,1712282939,1712282953,1712282953.1485438,-18000,,
com.microsoft.Excel,2,1712282937,1712282939,1712282939.210565,-18000,,
com.leomehlig.today,8,1712282929,1712282937,1712282937.6205049,-18000,,
com.microsoft.Excel,5,1712282924,1712282929,1712282929.6898499,-18000,,
com.leomehlig.today,13,1712282911,1712282924,1712282924.178657,-18000,,
com.microsoft.Excel,0,1712282911,1712282911,1712282911.756678,-18000,,
com.leomehlig.today,5,1712282906,1712282911,1712282911.206743,-18000,,
com.microsoft.Excel,1,1712282905,1712282906,1712282906.351583,-18000,,
com.leomehlig.today,7,1712282898,1712282905,1712282905.748101,-18000,,
com.microsoft.Excel,1,1712282897,1712282898,1712282898.355494,-18000,,
com.leomehlig.today,2,1712282895,1712282897,1712282897.620103,-18000,,
com.microsoft.Excel,3,1712282892,1712282895,1712282895.2629452,-18000,,
com.leomehlig.today,8,1712282884,1712282892,1712282892.652986,-18000,,
com.microsoft.Excel,34,1712282850,1712282884,1712282884.247912,-18000,,
com.apple.finder,16,1712282834,1712282850,1712282850.6198049,-18000,,
com.google.Chrome,5,1712282829,1712282834,1712282834.2206569,-18000,,
com.leomehlig.today,372,1712282457,1712282829,1712282829.450088,-18000,,
com.google.Chrome,13,1712282444,1712282457,1712282457.3268871,-18000,,
com.leomehlig.today,4,1712282440,1712282444,1712282444.8334842,-18000,,
com.google.Chrome,189,1712282251,1712282440,1712282440.049213,-18000,,
com.apple.Preview,701,1712281533,1712282234,1712282236.315063,-18000,,
com.google.Chrome,172,1712281361,1712281533,1712281533.695411,-18000,,
com.leomehlig.today,28,1712281333,1712281361,1712281361.645442,-18000,,
com.microsoft.VSCode,1,1712281332,1712281333,1712281333.237314,-18000,,
com.google.Chrome,1083,1712280249,1712281332,1712281332.183126,-18000,,
com.microsoft.VSCode,122,1712280127,1712280249,1712280249.8358169,-18000,,
com.google.Chrome,3,1712280124,1712280127,1712280127.466401,-18000,,
com.microsoft.VSCode,1,1712280123,1712280124,1712280124.386365,-18000,,
com.leomehlig.today,10,1712280113,1712280123,1712280123.7610269,-18000,,
com.microsoft.VSCode,1,1712280112,1712280113,1712280114.121025,-18000,,
com.google.Chrome,19,1712280093,1712280112,1712280112.827862,-18000,,
com.microsoft.VSCode,18,1712280075,1712280093,1712280093.6542702,-18000,,
com.microsoft.VSCode,82,1712278987,1712279069,1712279069.287502,-18000,,
com.microsoft.VSCode,107,1712278800,1712278907,1712278907.649055,-18000,,
com.google.Chrome,109,1712278691,1712278800,1712278800.407083,-18000,,
com.microsoft.VSCode,142,1712278549,1712278691,1712278691.986007,-18000,,
com.google.Chrome,10,1712278539,1712278549,1712278549.464622,-18000,,
com.microsoft.VSCode,625,1712277914,1712278539,1712278539.6529841,-18000,,
com.google.Chrome,31,1712277883,1712277914,1712277914.650227,-18000,,
com.microsoft.VSCode,1,1712277882,1712277883,1712277883.62727,-18000,,
com.google.Chrome,26,1712277856,1712277882,1712277882.8650532,-18000,,
com.microsoft.VSCode,169,1712277687,1712277856,1712277857.773264,-18000,,
com.google.Chrome,47,1712277640,1712277687,1712277687.8003922,-18000,,
com.microsoft.VSCode,174,1712277466,1712277640,1712277640.766252,-18000,,
com.google.Chrome,31,1712277435,1712277466,1712277466.5516372,-18000,,
com.microsoft.VSCode,2,1712277433,1712277435,1712277435.516623,-18000,,
com.google.Chrome,60,1712277373,1712277433,1712277433.332361,-18000,,
com.microsoft.VSCode,39,1712277334,1712277373,1712277373.905159,-18000,,
com.google.Chrome,39,1712277295,1712277334,1712277334.611486,-18000,,
com.microsoft.VSCode,111,1712277184,1712277295,1712277295.810583,-18000,,
com.google.Chrome,156,1712277028,1712277184,1712277184.806948,-18000,,
com.microsoft.VSCode,53,1712276975,1712277028,1712277028.951489,-18000,,
com.google.Chrome,47,1712276928,1712276975,1712276982.815473,-18000,,
com.microsoft.VSCode,1,1712276927,1712276928,1712276982.707998,-18000,,
com.google.Chrome,41,1712276886,1712276927,1712276982.457409,-18000,,
com.microsoft.VSCode,19,1712276867,1712276886,1712276982.3813128,-18000,,
com.google.Chrome,26,1712276841,1712276867,1712276982.31645,-18000,,
com.microsoft.VSCode,1,1712276840,1712276841,1712276980.191011,-18000,,
com.google.Chrome,40,1712276800,1712276840,1712276840.629407,-18000,,
com.microsoft.VSCode,122,1712276678,1712276800,1712276800.820983,-18000,,
com.apple.finder,36,1712276642,1712276678,1712276678.6706471,-18000,,
com.microsoft.VSCode,780,1712275862,1712276642,1712276642.742333,-18000,,
com.apple.finder,2,1712275860,1712275862,1712275862.546916,-18000,,
com.microsoft.VSCode,84,1712275776,1712275860,1712275860.492721,-18000,,
com.apple.finder,8,1712275768,1712275776,1712275776.3747392,-18000,,
com.leomehlig.today,1,1712275767,1712275768,1712275768.26658,-18000,,
com.google.Chrome,20,1712275747,1712275767,1712275767.623187,-18000,,
com.leomehlig.today,2,1712275745,1712275747,1712275748.0375562,-18000,,
com.leomehlig.today,23,1712270346,1712270369,1712270369.911475,-18000,,
com.apple.Preview,1227,1712269119,1712270346,1712270346.975276,-18000,,
com.google.Chrome,17,1712269102,1712269119,1712269119.938569,-18000,,
com.apple.Preview,465,1712268637,1712269102,1712269102.879477,-18000,,
com.leomehlig.today,17,1712268620,1712268637,1712268637.50318,-18000,,
com.google.Chrome,2,1712268618,1712268620,1712268620.7542,-18000,,
com.toyopagroup.picaboo,4,1712267960,1712267964,1712267964.44678,-18000,EB445137-D7F5-57EC-87DA-1DB460D64046,"iPhone13,2"
com.toyopagroup.picaboo,19,1712267930,1712267949,1712267949.326926,-18000,EB445137-D7F5-57EC-87DA-1DB460D64046,"iPhone13,2"
edu.illinois.rokwire.ios,11,1712267919,1712267930,1712267930.265314,-18000,EB445137-D7F5-57EC-87DA-1DB460D64046,"iPhone13,2"
com.toyopagroup.picaboo,12,1712267906,1712267918,1712267918.5277581,-18000,EB445137-D7F5-57EC-87DA-1DB460D64046,"iPhone13,2"
edu.illinois.rokwire.ios,12,1712267894,1712267906,1712267906.306625,-18000,EB445137-D7F5-57EC-87DA-1DB460D64046,"iPhone13,2"
com.toyopagroup.picaboo,2,1712267892,1712267894,1712267894.5284672,-18000,EB445137-D7F5-57EC-87DA-1DB460D64046,"iPhone13,2"
edu.illinois.rokwire.ios,25,1712267867,1712267892,1712267892.141972,-18000,EB445137-D7F5-57EC-87DA-1DB460D64046,"iPhone13,2"
com.toyopagroup.picaboo,6,1712267860,1712267866,1712267866.9957871,-18000,EB445137-D7F5-57EC-87DA-1DB460D64046,"iPhone13,2"
edu.illinois.rokwire.ios,25,1712267546,1712267571,1712267572.13475,-18000,EB445137-D7F5-57EC-87DA-1DB460D64046,"iPhone13,2"
com.hammerandchisel.discord,101,1712265006,1712265107,1712265107.742217,-18000,EB445137-D7F5-57EC-87DA-1DB460D64046,"iPhone13,2"
com.google.chrome.ios,3,1712264919,1712264922,1712264922.56812,-18000,EB445137-D7F5-57EC-87DA-1DB460D64046,"iPhone13,2"
com.google.chrome.ios,23,1712264831,1712264854,1712264854.4209862,-18000,EB445137-D7F5-57EC-87DA-1DB460D64046,"iPhone13,2"
com.microsoft.Office.Outlook,2,1712264828,1712264830,1712264831.1593208,-18000,EB445137-D7F5-57EC-87DA-1DB460D64046,"iPhone13,2"
com.microsoft.Office.Outlook,2,1712264825,1712264827,1712264827.1615481,-18000,EB445137-D7F5-57EC-87DA-1DB460D64046,"iPhone13,2"
com.microsoft.Office.Outlook,6,1712264496,1712264502,1712264502.782002,-18000,EB445137-D7F5-57EC-87DA-1DB460D64046,"iPhone13,2"
com.microsoft.Office.Outlook,74,1712264346,1712264420,1712264420.304747,-18000,EB445137-D7F5-57EC-87DA-1DB460D64046,"iPhone13,2"
com.hammerandchisel.discord,7,1712264335,1712264342,1712264342.527783,-18000,EB445137-D7F5-57EC-87DA-1DB460D64046,"iPhone13,2"
com.google.Chrome,466,1712262854,1712263320,1712263320.840063,-18000,,
com.leomehlig.today,9,1712262845,1712262854,1712262854.210346,-18000,,
com.google.Chrome,5,1712262840,1712262845,1712262845.6982121,-18000,,
com.leomehlig.today,3,1712262837,1712262840,1712262840.726196,-18000,,
com.leomehlig.today,4,1712262287,1712262291,1712262291.4907079,-18000,EB445137-D7F5-57EC-87DA-1DB460D64046,"iPhone13,2"
edu.illinois.rokwire.ios,22,1712262265,1712262287,1712262287.0917711,-18000,EB445137-D7F5-57EC-87DA-1DB460D64046,"iPhone13,2"
com.microsoft.Office.Outlook,11,1712262250,1712262261,1712262261.683079,-18000,EB445137-D7F5-57EC-87DA-1DB460D64046,"iPhone13,2"
com.burbn.instagram,9,1712256808,1712256817,1712256817.6663961,-18000,EB445137-D7F5-57EC-87DA-1DB460D64046,"iPhone13,2"
com.microsoft.Office.Outlook,64,1712256743,1712256807,1712256807.5898619,-18000,EB445137-D7F5-57EC-87DA-1DB460D64046,"iPhone13,2"
com.burbn.instagram,32,1712256701,1712256733,1712256733.510788,-18000,EB445137-D7F5-57EC-87DA-1DB460D64046,"iPhone13,2"
com.microsoft.Office.Outlook,3,1712256697,1712256700,1712256700.3081741,-18000,EB445137-D7F5-57EC-87DA-1DB460D64046,"iPhone13,2"
com.microsoft.Office.Outlook,3,1712256671,1712256674,1712256674.2569351,-18000,EB445137-D7F5-57EC-87DA-1DB460D64046,"iPhone13,2"
com.microsoft.Office.Outlook,5,1712255843,1712255848,1712255848.0986838,-18000,EB445137-D7F5-57EC-87DA-1DB460D64046,"iPhone13,2"
com.toyopagroup.picaboo,4,1712255838,1712255842,1712255842.6815681,-18000,EB445137-D7F5-57EC-87DA-1DB460D64046,"iPhone13,2"
com.hammerandchisel.discord,1,1712255837,1712255838,1712255839.3393579,-18000,EB445137-D7F5-57EC-87DA-1DB460D64046,"iPhone13,2"
com.leomehlig.today,85,1712255618,1712255703,1712255703.907167,-18000,,
com.google.Chrome,19,1712255599,1712255618,1712255619.0699759,-18000,,
com.google.Chrome,373,1712255037,1712255410,1712255410.114802,-18000,,
com.hammerandchisel.discord,2,1712254813,1712254815,1712254815.596483,-18000,EB445137-D7F5-57EC-87DA-1DB460D64046,"iPhone13,2"
com.hammerandchisel.discord,3,1712254809,1712254812,1712254812.730517,-18000,EB445137-D7F5-57EC-87DA-1DB460D64046,"iPhone13,2"
com.hammerandchisel.discord,3,1712254551,1712254554,1712254554.8400369,-18000,EB445137-D7F5-57EC-87DA-1DB460D64046,"iPhone13,2"
com.google.Chrome,1814,1712253222,1712255036,1712255036.76139,-18000,,
com.hammerandchisel.discord,12,1712253020,1712253032,1712253032.539561,-18000,EB445137-D7F5-57EC-87DA-1DB460D64046,"iPhone13,2"
com.toyopagroup.picaboo,4,1712253016,1712253020,1712253020.868341,-18000,EB445137-D7F5-57EC-87DA-1DB460D64046,"iPhone13,2"
com.apple.mobiletimer,6,1712253006,1712253012,1712253012.147915,-18000,EB445137-D7F5-57EC-87DA-1DB460D64046,"iPhone13,2"
com.toyopagroup.picaboo,4,1712252932,1712252936,1712252936.5477371,-18000,EB445137-D7F5-57EC-87DA-1DB460D64046,"iPhone13,2"
com.toyopagroup.picaboo,10,1712252891,1712252901,1712252901.5512052,-18000,EB445137-D7F5-57EC-87DA-1DB460D64046,"iPhone13,2"
com.instructure.icanvas,2,1712252889,1712252891,1712252891.0867019,-18000,EB445137-D7F5-57EC-87DA-1DB460D64046,"iPhone13,2"
com.instructure.icanvas,10,1712252811,1712252821,1712252821.4429998,-18000,EB445137-D7F5-57EC-87DA-1DB460D64046,"iPhone13,2"
com.google.Chrome,959,1712252062,1712253021,1712253021.145687,-18000,,
com.leomehlig.today,37,1712252025,1712252062,1712252062.231775,-18000,,
com.leomehlig.today,53,1712251520,1712251573,1712251573.2675462,-18000,,
com.google.Chrome,2,1712251518,1712251520,1712251520.927857,-18000,,
com.microsoft.Office.Outlook,13,1712251466,1712251479,1712251479.406479,-18000,EB445137-D7F5-57EC-87DA-1DB460D64046,"iPhone13,2"
com.apple.mobiletimer,3,1712251463,1712251466,1712251467.343101,-18000,EB445137-D7F5-57EC-87DA-1DB460D64046,"iPhone13,2"
com.apple.mobiletimer,2,1712251455,1712251457,1712251457.544115,-18000,EB445137-D7F5-57EC-87DA-1DB460D64046,"iPhone13,2"
com.apple.mobiletimer,5,1712251424,1712251429,1712251429.291513,-18000,EB445137-D7F5-57EC-87DA-1DB460D64046,"iPhone13,2"
com.apple.MobileSMS,3,1712251421,1712251424,1712251424.609779,-18000,EB445137-D7F5-57EC-87DA-1DB460D64046,"iPhone13,2"
com.apple.MobileSMS,16,1712251120,1712251136,1712251137.9933,-18000,EB445137-D7F5-57EC-87DA-1DB460D64046,"iPhone13,2"
com.apple.news,2,1712251118,1712251120,1712251121.974783,-18000,EB445137-D7F5-57EC-87DA-1DB460D64046,"iPhone13,2"
com.apple.news,9,1712250905,1712250914,1712250914.85174,-18000,EB445137-D7F5-57EC-87DA-1DB460D64046,"iPhone13,2"
com.apple.news,8,1712250881,1712250889,1712250889.937387,-18000,EB445137-D7F5-57EC-87DA-1DB460D64046,"iPhone13,2"
com.apple.news,6,1712250854,1712250860,1712250860.2616181,-18000,EB445137-D7F5-57EC-87DA-1DB460D64046,"iPhone13,2"
com.apple.news,931,1712249602,1712250533,1712250533.373729,-18000,EB445137-D7F5-57EC-87DA-1DB460D64046,"iPhone13,2"
com.apple.MobileSMS,40,1712249559,1712249599,1712249599.1746511,-18000,EB445137-D7F5-57EC-87DA-1DB460D64046,"iPhone13,2"
com.zhiliaoapp.musically,25,1712249534,1712249559,1712249559.536607,-18000,EB445137-D7F5-57EC-87DA-1DB460D64046,"iPhone13,2"
com.apple.MobileSMS,8,1712249526,1712249534,1712249534.399076,-18000,EB445137-D7F5-57EC-87DA-1DB460D64046,"iPhone13,2"
com.apple.mobilecal,3,1712249521,1712249524,1712249524.666234,-18000,EB445137-D7F5-57EC-87DA-1DB460D64046,"iPhone13,2"
com.apple.mobilecal,31,1712249453,1712249484,1712249484.766906,-18000,EB445137-D7F5-57EC-87DA-1DB460D64046,"iPhone13,2"
com.apple.MobileSMS,3,1712248319,1712248322,1712248322.59624,-18000,EB445137-D7F5-57EC-87DA-1DB460D64046,"iPhone13,2"
com.microsoft.Office.Outlook,35,1712248079,1712248114,1712248114.158255,-18000,EB445137-D7F5-57EC-87DA-1DB460D64046,"iPhone13,2"
com.apple.calculator,298,1712247779,1712248077,1712248077.18942,-18000,EB445137-D7F5-57EC-87DA-1DB460D64046,"iPhone13,2"
com.apple.calculator,6,1712247454,1712247460,1712247460.454824,-18000,EB445137-D7F5-57EC-87DA-1DB460D64046,"iPhone13,2"
com.apple.calculator,1,1712247452,1712247453,1712247453.8475242,-18000,EB445137-D7F5-57EC-87DA-1DB460D64046,"iPhone13,2"
com.apple.calculator,14,1712246801,1712246815,1712246815.904558,-18000,EB445137-D7F5-57EC-87DA-1DB460D64046,"iPhone13,2"
com.apple.calculator,28,1712246684,1712246712,1712246712.1352,-18000,EB445137-D7F5-57EC-87DA-1DB460D64046,"iPhone13,2"
com.apple.calculator,82,1712246405,1712246487,1712246487.8216481,-18000,EB445137-D7F5-57EC-87DA-1DB460D64046,"iPhone13,2"
com.apple.calculator,46,1712246204,1712246250,1712246250.7296538,-18000,EB445137-D7F5-57EC-87DA-1DB460D64046,"iPhone13,2"
com.apple.calculator,18,1712246136,1712246154,1712246154.2837172,-18000,EB445137-D7F5-57EC-87DA-1DB460D64046,"iPhone13,2"
com.toyopagroup.picaboo,3,1712246133,1712246136,1712246139.067402,-18000,EB445137-D7F5-57EC-87DA-1DB460D64046,"iPhone13,2"
com.toyopagroup.picaboo,0,1712243394,1712243394,1712243396.605579,-18000,EB445137-D7F5-57EC-87DA-1DB460D64046,"iPhone13,2"
com.toyopagroup.picaboo,33,1712243336,1712243369,1712243370.113494,-18000,EB445137-D7F5-57EC-87DA-1DB460D64046,"iPhone13,2"
com.google.Chrome,262,1712243152,1712243414,1712243414.124867,-18000,,
Astrospheric.Astrospheric,17,1712242799,1712242816,1712242816.983609,-18000,EB445137-D7F5-57EC-87DA-1DB460D64046,"iPhone13,2"
com.hammerandchisel.discord,52,1712242743,1712242795,1712242795.039547,-18000,EB445137-D7F5-57EC-87DA-1DB460D64046,"iPhone13,2"
com.google.chrome.ios,97,1712242644,1712242741,1712242741.2289948,-18000,EB445137-D7F5-57EC-87DA-1DB460D64046,"iPhone13,2"
com.microsoft.Office.Outlook,30,1712242614,1712242644,1712242644.707679,-18000,EB445137-D7F5-57EC-87DA-1DB460D64046,"iPhone13,2"
com.google.chrome.ios,48,1712242566,1712242614,1712242614.7986178,-18000,EB445137-D7F5-57EC-87DA-1DB460D64046,"iPhone13,2"
com.microsoft.Office.Outlook,4,1712242562,1712242566,1712242566.227538,-18000,EB445137-D7F5-57EC-87DA-1DB460D64046,"iPhone13,2"
com.apple.MobileSMS,11,1712242551,1712242562,1712242562.874433,-18000,EB445137-D7F5-57EC-87DA-1DB460D64046,"iPhone13,2"
com.microsoft.Office.Outlook,17,1712242534,1712242551,1712242551.372871,-18000,EB445137-D7F5-57EC-87DA-1DB460D64046,"iPhone13,2"
edu.illinois.rokwire.ios,3,1712242531,1712242534,1712242534.9983768,-18000,EB445137-D7F5-57EC-87DA-1DB460D64046,"iPhone13,2"
edu.illinois.rokwire.ios,10,1712242462,1712242472,1712242472.820809,-18000,EB445137-D7F5-57EC-87DA-1DB460D64046,"iPhone13,2"
edu.illinois.rokwire.ios,34,1712242341,1712242375,1712242375.130816,-18000,EB445137-D7F5-57EC-87DA-1DB460D64046,"iPhone13,2"
com.google.Chrome,143,1712241335,1712241478,1712241478.810817,-18000,,
com.apple.finder,4,1712241331,1712241335,1712241335.09881,-18000,,
com.google.Chrome,24,1712241307,1712241331,1712241331.363371,-18000,,
com.leomehlig.today,16,1712241284,1712241300,1712241300.661819,-18000,,
com.google.Chrome,6,1712241278,1712241284,1712241284.74138,-18000,,
com.google.Chrome,759,1712202545,1712203304,1712203304.97077,-18000,,
com.google.Chrome,1737,1712200286,1712202023,1712202023.9495711,-18000,,
com.google.Chrome,665,1712199610,1712200275,1712200275.653878,-18000,,
com.google.Chrome,362,1712199205,1712199567,1712199567.750533,-18000,,
com.leomehlig.today,12,1712199193,1712199205,1712199205.2939,-18000,,
com.google.Chrome,16,1712199177,1712199193,1712199193.857492,-18000,,
com.google.Chrome,24,1712197612,1712197636,1712197637.322404,-18000,,
com.apple.Preview,11,1712197601,1712197612,1712197612.432076,-18000,,
com.apple.finder,3,1712197598,1712197601,1712197601.659333,-18000,,
com.apple.Preview,129,1712197469,1712197598,1712197598.954922,-18000,,
com.apple.finder,5,1712197464,1712197469,1712197469.236851,-18000,,
com.google.Chrome,267,1712197197,1712197464,1712197464.694906,-18000,,
com.apple.Preview,36,1712197161,1712197197,1712197197.109237,-18000,,
com.apple.finder,2,1712197159,1712197161,1712197161.054189,-18000,,
com.apple.Preview,3,1712197156,1712197159,1712197159.116898,-18000,,
com.leomehlig.today,9,1712197147,1712197156,1712197156.3225121,-18000,,
com.apple.Preview,916,1712196231,1712197147,1712197147.661032,-18000,,
com.leomehlig.today,3,1712196228,1712196231,1712196231.843728,-18000,,
com.apple.Preview,502,1712195726,1712196228,1712196228.9267778,-18000,,
com.apple.finder,1,1712195725,1712195726,1712195727.028225,-18000,,
com.apple.Preview,8,1712195717,1712195725,1712195725.7297091,-18000,,
com.apple.finder,2,1712195715,1712195717,1712195717.4637198,-18000,,
com.apple.Preview,9,1712195706,1712195715,1712195716.030482,-18000,,
com.apple.finder,2,1712195704,1712195706,1712195706.066955,-18000,,
com.apple.Preview,1050,1712194654,1712195704,1712195704.502471,-18000,,
com.apple.finder,2,1712194652,1712194654,1712194654.1507812,-18000,,
com.apple.Preview,995,1712193657,1712194652,1712194652.740906,-18000,,
com.apple.finder,7,1712193650,1712193657,1712193657.846552,-18000,,
com.leomehlig.today,12,1712193638,1712193650,1712193650.792303,-18000,,
com.google.Chrome,20,1712193618,1712193638,1712193638.068541,-18000,,
com.google.Chrome,920,1712186008,1712186928,1712186928.9149508,-18000,,
com.google.Chrome,1,1712185977,1712185978,1712185978.384438,-18000,,
com.leomehlig.today,3,1712185974,1712185977,1712185977.3809152,-18000,,
com.google.Chrome,6,1712185968,1712185974,1712185975.024002,-18000,,
com.leomehlig.today,9,1712185959,1712185968,1712185968.69152,-18000,,
com.leomehlig.today,2,1712183719,1712183721,1712183721.502768,-18000,,
com.leomehlig.today,115,1712183604,1712183719,1712183719.386482,-18000,,
com.leomehlig.today,103,1712182682,1712182785,1712182786.046387,-18000,,
com.google.Chrome,55,1712182627,1712182682,1712182682.949203,-18000,,
com.apple.Preview,2191,1712180436,1712182627,1712182627.086513,-18000,,
com.leomehlig.today,18,1712180418,1712180436,1712180436.874442,-18000,,
com.apple.Maps,3,1712178089,1712178092,1712178092.4694781,-18000,EB445137-D7F5-57EC-87DA-1DB460D64046,"iPhone13,2"
com.apple.Music,4,1712178085,1712178089,1712178089.767025,-18000,EB445137-D7F5-57EC-87DA-1DB460D64046,"iPhone13,2"
com.apple.Music,21,1712177932,1712177953,1712177953.267029,-18000,EB445137-D7F5-57EC-87DA-1DB460D64046,"iPhone13,2"
com.apple.Music,9,1712177645,1712177654,1712177654.5153298,-18000,EB445137-D7F5-57EC-87DA-1DB460D64046,"iPhone13,2"
com.apple.weather,4,1712177639,1712177643,1712177643.564762,-18000,EB445137-D7F5-57EC-87DA-1DB460D64046,"iPhone13,2"
com.apple.Maps,4,1712177634,1712177638,1712177639.230514,-18000,EB445137-D7F5-57EC-87DA-1DB460D64046,"iPhone13,2"
com.apple.Maps,29,1712177601,1712177630,1712177630.8506498,-18000,EB445137-D7F5-57EC-87DA-1DB460D64046,"iPhone13,2"
com.toyopagroup.picaboo,5,1712177593,1712177598,1712177598.747606,-18000,EB445137-D7F5-57EC-87DA-1DB460D64046,"iPhone13,2"
com.apple.Maps,3,1712177590,1712177593,1712177593.9092221,-18000,EB445137-D7F5-57EC-87DA-1DB460D64046,"iPhone13,2"
com.apple.Maps,4,1712177162,1712177166,1712177166.247779,-18000,EB445137-D7F5-57EC-87DA-1DB460D64046,"iPhone13,2"
com.apple.Maps,6,1712177107,1712177113,1712177113.685878,-18000,EB445137-D7F5-57EC-87DA-1DB460D64046,"iPhone13,2"
com.apple.Maps,43,1712177063,1712177106,1712177107.466967,-18000,EB445137-D7F5-57EC-87DA-1DB460D64046,"iPhone13,2"
com.whentowork.iOS.WhenToWork-Employee-Scheduling,22,1712177038,1712177060,1712177060.53789,-18000,EB445137-D7F5-57EC-87DA-1DB460D64046,"iPhone13,2"
com.apple.mobilecal,8,1712177029,1712177037,1712177037.6137838,-18000,EB445137-D7F5-57EC-87DA-1DB460D64046,"iPhone13,2"
com.instructure.icanvas,4,1712177019,1712177023,1712177023.309123,-18000,EB445137-D7F5-57EC-87DA-1DB460D64046,"iPhone13,2"
com.whentowork.iOS.WhenToWork-Employee-Scheduling,3,1712177016,1712177019,1712177019.381356,-18000,EB445137-D7F5-57EC-87DA-1DB460D64046,"iPhone13,2"
com.whentowork.iOS.WhenToWork-Employee-Scheduling,10,1712176873,1712176883,1712176883.2351089,-18000,EB445137-D7F5-57EC-87DA-1DB460D64046,"iPhone13,2"
com.leomehlig.today,58,1712176787,1712176845,1712176845.67734,-18000,,
com.google.Chrome,350,1712176437,1712176787,1712176788.094758,-18000,,
com.leomehlig.today,3,1712176434,1712176437,1712176437.527367,-18000,,
com.whentowork.iOS.WhenToWork-Employee-Scheduling,3,1712175795,1712175798,1712175798.8397598,-18000,EB445137-D7F5-57EC-87DA-1DB460D64046,"iPhone13,2"
com.google.Chrome,812,1712175622,1712176434,1712176434.385709,-18000,,
com.leomehlig.today,3,1712175619,1712175622,1712175622.685062,-18000,,
com.google.Chrome,11,1712175608,1712175619,1712175619.717356,-18000,,
com.whentowork.iOS.WhenToWork-Employee-Scheduling,4,1712175522,1712175526,1712175526.0138512,-18000,EB445137-D7F5-57EC-87DA-1DB460D64046,"iPhone13,2"
com.whentowork.iOS.WhenToWork-Employee-Scheduling,103,1712175255,1712175358,1712175358.9752479,-18000,EB445137-D7F5-57EC-87DA-1DB460D64046,"iPhone13,2"
com.google.Chrome,300,1712175240,1712175540,1712175540.779007,-18000,,
com.leomehlig.today,15,1712175225,1712175240,1712175240.7565432,-18000,,
com.google.Chrome,53,1712175172,1712175225,1712175225.9714289,-18000,,
com.toyopagroup.picaboo,109,1712174446,1712174555,1712174555.3769078,-18000,EB445137-D7F5-57EC-87DA-1DB460D64046,"iPhone13,2"
com.google.Chrome,698,1712174216,1712174914,1712174914.410667,-18000,,
com.leomehlig.today,18,1712174198,1712174216,1712174216.607893,-18000,,
com.google.Chrome,1238,1712172960,1712174198,1712174198.3149261,-18000,,
com.google.Chrome,553,1712172253,1712172806,1712172806.344136,-18000,,
com.apple.Health,44,1712171722,1712171766,1712171766.974272,-18000,EB445137-D7F5-57EC-87DA-1DB460D64046,"iPhone13,2"
com.google.Chrome,424,1712171648,1712172072,1712172072.9382849,-18000,,
com.leomehlig.today,40,1712171608,1712171648,1712171648.7371402,-18000,,
com.apple.Preview,3,1712171605,1712171608,1712171608.983119,-18000,,
com.burbn.instagram,263,1712171341,1712171604,1712171604.6240258,-18000,EB445137-D7F5-57EC-87DA-1DB460D64046,"iPhone13,2"
com.microsoft.Office.Outlook,10,1712171328,1712171338,1712171338.930192,-18000,EB445137-D7F5-57EC-87DA-1DB460D64046,"iPhone13,2"
com.instructure.icanvas,24,1712167093,1712167117,1712167117.7268329,-18000,EB445137-D7F5-57EC-87DA-1DB460D64046,"iPhone13,2"
com.hammerandchisel.discord,5,1712167083,1712167088,1712167088.665582,-18000,EB445137-D7F5-57EC-87DA-1DB460D64046,"iPhone13,2"
com.hammerandchisel.discord,2,1712165825,1712165827,1712165827.982215,-18000,EB445137-D7F5-57EC-87DA-1DB460D64046,"iPhone13,2"
com.apple.Preview,1268,1712165771,1712167039,1712167039.2129369,-18000,,
com.google.Chrome,17,1712165754,1712165771,1712165771.5068989,-18000,,
com.apple.Preview,2,1712165736,1712165738,1712165739.227096,-18000,,
com.apple.finder,4,1712165732,1712165736,1712165736.445805,-18000,,
com.leomehlig.today,1,1712165731,1712165732,1712165732.751567,-18000,,
com.microsoft.VSCode,8,1712165723,1712165731,1712165731.791833,-18000,,
com.google.Chrome,520,1712165203,1712165723,1712165724.095006,-18000,,
com.leomehlig.today,17,1712165186,1712165203,1712165203.960383,-18000,,
com.google.Chrome,261,1712164925,1712165186,1712165186.74265,-18000,,
com.apple.MobileSMS,13,1712164912,1712164925,1712164925.948046,-18000,,
com.google.Chrome,136,1712164776,1712164912,1712164912.491235,-18000,,
com.hammerandchisel.discord,4,1712163495,1712163499,1712163499.533039,-18000,EB445137-D7F5-57EC-87DA-1DB460D64046,"iPhone13,2"
com.hammerandchisel.discord,3,1712162771,1712162774,1712162774.316725,-18000,EB445137-D7F5-57EC-87DA-1DB460D64046,"iPhone13,2"
com.hammerandchisel.discord,6,1712162732,1712162738,1712162738.158815,-18000,EB445137-D7F5-57EC-87DA-1DB460D64046,"iPhone13,2"
com.hammerandchisel.discord,93,1712161720,1712161813,1712161813.935688,-18000,EB445137-D7F5-57EC-87DA-1DB460D64046,"iPhone13,2"
com.whentowork.iOS.WhenToWork-Employee-Scheduling,53,1712161665,1712161718,1712161718.650661,-18000,EB445137-D7F5-57EC-87DA-1DB460D64046,"iPhone13,2"
com.google.Chrome,266,1712160897,1712161163,1712161163.912813,-18000,,
com.microsoft.VSCode,2,1712160821,1712160823,1712160823.391541,-18000,,
edu.illinois.rokwire.ios,45,1712160675,1712160720,1712160720.263659,-18000,EB445137-D7F5-57EC-87DA-1DB460D64046,"iPhone13,2"
com.hammerandchisel.discord,52,1712160622,1712160674,1712160674.847327,-18000,EB445137-D7F5-57EC-87DA-1DB460D64046,"iPhone13,2"
com.microsoft.VSCode,9,1712160300,1712160309,1712160309.629513,-18000,,
com.apple.iCal,1,1712160299,1712160300,1712160300.84262,-18000,,
com.google.Chrome,6,1712160293,1712160299,1712160299.439173,-18000,,
com.apple.iCal,1,1712160292,1712160293,1712160293.525134,-18000,,
com.microsoft.VSCode,7,1712160285,1712160292,1712160292.043788,-18000,,
com.apple.iCal,35,1712160250,1712160285,1712160286.0262709,-18000,,
com.microsoft.VSCode,102,1712160148,1712160250,1712160250.474616,-18000,,
com.google.Chrome,3,1712160145,1712160148,1712160148.638874,-18000,,
com.microsoft.VSCode,7,1712160138,1712160145,1712160145.274888,-18000,,
com.google.Chrome,2,1712160136,1712160138,1712160138.813196,-18000,,
com.microsoft.VSCode,9,1712160127,1712160136,1712160136.773186,-18000,,
com.google.Chrome,10,1712160117,1712160127,1712160127.090838,-18000,,
com.microsoft.VSCode,36,1712160081,1712160117,1712160117.586724,-18000,,
com.google.Chrome,50,1712160031,1712160081,1712160081.137733,-18000,,
com.microsoft.VSCode,170,1712159861,1712160031,1712160032.0144,-18000,,
com.google.Chrome,156,1712159705,1712159861,1712159861.190902,-18000,,
com.hammerandchisel.discord,5,1712159624,1712159629,1712159629.693651,-18000,EB445137-D7F5-57EC-87DA-1DB460D64046,"iPhone13,2"
com.microsoft.Office.Outlook,2,1712159622,1712159624,1712159624.590955,-18000,EB445137-D7F5-57EC-87DA-1DB460D64046,"iPhone13,2"
com.microsoft.Office.Outlook,11,1712159588,1712159599,1712159599.106975,-18000,EB445137-D7F5-57EC-87DA-1DB460D64046,"iPhone13,2"
com.microsoft.Office.Outlook,3,1712159583,1712159586,1712159586.763933,-18000,EB445137-D7F5-57EC-87DA-1DB460D64046,"iPhone13,2"
com.microsoft.Office.Outlook,1,1712159577,1712159578,1712159578.773086,-18000,EB445137-D7F5-57EC-87DA-1DB460D64046,"iPhone13,2"
com.google.Chrome,100,1712158450,1712158550,1712158550.2199721,-18000,,
com.microsoft.VSCode,8,1712158442,1712158450,1712158450.52838,-18000,,
com.google.Chrome,23,1712158419,1712158442,1712158442.471379,-18000,,
com.microsoft.VSCode,2,1712158417,1712158419,1712158420.006289,-18000,,
com.microsoft.VSCode,17,1712158370,1712158387,1712158387.282236,-18000,,
com.google.Chrome,6,1712158364,1712158370,1712158370.1934361,-18000,,
com.microsoft.VSCode,5,1712158359,1712158364,1712158364.655974,-18000,,
com.google.Chrome,8,1712158351,1712158359,1712158359.2875419,-18000,,
com.microsoft.VSCode,0,1712158351,1712158351,1712158351.882876,-18000,,
com.google.Chrome,1,1712158350,1712158351,1712158351.224917,-18000,,
com.apple.Preview,1,1712158349,1712158350,1712158350.453145,-18000,,
com.microsoft.VSCode,42,1712158307,1712158349,1712158349.28881,-18000,,
com.apple.Preview,1,1712158306,1712158307,1712158307.764606,-18000,,
com.google.Chrome,7,1712158299,1712158306,1712158306.545337,-18000,,
com.apple.Preview,1,1712158298,1712158299,1712158299.7278929,-18000,,
com.microsoft.VSCode,14,1712158284,1712158298,1712158298.182157,-18000,,
com.apple.Preview,2,1712158282,1712158284,1712158284.2310681,-18000,,
com.google.Chrome,96,1712158186,1712158282,1712158282.511728,-18000,,
com.apple.Preview,2,1712158184,1712158186,1712158186.186255,-18000,,
com.microsoft.VSCode,6,1712158178,1712158184,1712158184.299926,-18000,,
com.apple.Preview,7,1712158171,1712158178,1712158178.0534492,-18000,,
com.microsoft.VSCode,19,1712158152,1712158171,1712158171.516231,-18000,,
com.apple.Preview,4,1712158148,1712158152,1712158152.548578,-18000,,
com.microsoft.VSCode,2,1712158146,1712158148,1712158148.677031,-18000,,
com.apple.Preview,3,1712158143,1712158146,1712158146.2311811,-18000,,
com.microsoft.VSCode,26,1712158117,1712158143,1712158143.111909,-18000,,
com.apple.Preview,64,1712158053,1712158117,1712158117.239172,-18000,,
com.microsoft.VSCode,89,1712157964,1712158053,1712158053.935657,-18000,,
com.apple.Preview,7,1712157957,1712157964,1712157964.573767,-18000,,
com.google.Chrome,7,1712157950,1712157957,1712157957.690038,-18000,,
com.apple.Preview,5,1712157945,1712157950,1712157950.392103,-18000,,
com.google.Chrome,31,1712157914,1712157945,1712157945.412667,-18000,,
com.apple.Preview,2,1712157912,1712157914,1712157914.849585,-18000,,
com.microsoft.VSCode,2,1712157910,1712157912,1712157912.2343268,-18000,,
com.apple.Preview,14,1712157896,1712157910,1712157910.440876,-18000,,
com.microsoft.VSCode,76,1712157820,1712157896,1712157896.199929,-18000,,
com.apple.Preview,5,1712157815,1712157820,1712157820.719863,-18000,,
com.microsoft.VSCode,78,1712157737,1712157815,1712157815.51488,-18000,,
com.apple.Preview,4,1712157733,1712157737,1712157738.035955,-18000,,
com.microsoft.VSCode,7,1712157726,1712157733,1712157733.829833,-18000,,
com.apple.Preview,1,1712157725,1712157726,1712157726.860664,-18000,,
com.microsoft.VSCode,3,1712157722,1712157725,1712157725.946598,-18000,,
com.apple.Preview,5,1712157717,1712157722,1712157722.359937,-18000,,
com.microsoft.VSCode,2,1712157715,1712157717,1712157717.140222,-18000,,
com.apple.Preview,1,1712157714,1712157715,1712157715.2829862,-18000,,
com.microsoft.VSCode,2,1712157712,1712157714,1712157714.4000258,-18000,,
com.apple.Preview,2,1712157710,1712157712,1712157712.174141,-18000,,
com.microsoft.VSCode,9,1712157701,1712157710,1712157710.737276,-18000,,
com.apple.Preview,2,1712157699,1712157701,1712157701.727642,-18000,,
com.microsoft.VSCode,5,1712157694,1712157699,1712157699.8358831,-18000,,
com.apple.Preview,55,1712157639,1712157694,1712157695.052294,-18000,,
com.microsoft.VSCode,2,1712157637,1712157639,1712157639.878018,-18000,,
com.apple.finder,1,1712157636,1712157637,1712157637.628333,-18000,,
com.apple.Preview,35,1712157601,1712157636,1712157636.6324449,-18000,,
com.microsoft.Office.Outlook,15,1712157579,1712157594,1712157594.180879,-18000,EB445137-D7F5-57EC-87DA-1DB460D64046,"iPhone13,2"
com.apple.iCal,57,1712157544,1712157601,1712157601.575053,-18000,,
com.instructure.icanvas,56,1712157517,1712157573,1712157573.9459882,-18000,EB445137-D7F5-57EC-87DA-1DB460D64046,"iPhone13,2"
com.apple.Health,8,1712157509,1712157517,1712157517.179543,-18000,EB445137-D7F5-57EC-87DA-1DB460D64046,"iPhone13,2"
com.apple.Preview,42,1712157502,1712157544,1712157544.9705648,-18000,,
com.apple.finder,21,1712157481,1712157502,1712157502.1016169,-18000,,
com.microsoft.VSCode,448,1712157033,1712157481,1712157481.993779,-18000,,
com.google.Chrome,11,1712157022,1712157033,1712157033.434196,-18000,,
com.microsoft.VSCode,18,1712157004,1712157022,1712157022.877215,-18000,,
com.google.Chrome,11,1712156993,1712157004,1712157004.931131,-18000,,
com.microsoft.VSCode,1,1712156992,1712156993,1712156993.9441152,-18000,,
com.google.Chrome,12,1712156980,1712156992,1712156992.5883188,-18000,,
com.microsoft.VSCode,4,1712156976,1712156980,1712156980.96075,-18000,,
com.google.Chrome,1,1712156975,1712156976,1712156976.8455548,-18000,,
com.microsoft.VSCode,1,1712156974,1712156975,1712156975.2690392,-18000,,
com.google.Chrome,3,1712156971,1712156974,1712156974.291541,-18000,,
com.microsoft.VSCode,12,1712156959,1712156971,1712156971.291854,-18000,,
com.google.Chrome,1,1712156958,1712156959,1712156959.47511,-18000,,
com.microsoft.VSCode,16,1712156942,1712156958,1712156958.131607,-18000,,
com.google.Chrome,45,1712156897,1712156942,1712156942.848112,-18000,,
com.microsoft.VSCode,406,1712156491,1712156897,1712156897.478019,-18000,,
com.google.Chrome,179,1712156312,1712156491,1712156491.300055,-18000,,
com.microsoft.VSCode,46,1712156266,1712156312,1712156312.861312,-18000,,
com.google.Chrome,9,1712156257,1712156266,1712156266.307207,-18000,,
com.microsoft.VSCode,21,1712156236,1712156257,1712156257.054832,-18000,,
com.google.Chrome,3,1712156233,1712156236,1712156236.545438,-18000,,
com.microsoft.VSCode,0,1712156233,1712156233,1712156233.946346,-18000,,
com.google.Chrome,9,1712156224,1712156233,1712156233.049881,-18000,,
com.microsoft.VSCode,6,1712156218,1712156224,1712156224.2297049,-18000,,
com.google.Chrome,1,1712156217,1712156218,1712156218.335095,-18000,,
com.microsoft.VSCode,0,1712156217,1712156217,1712156217.909205,-18000,,
com.google.Chrome,4,1712156213,1712156217,1712156217.177401,-18000,,
com.microsoft.VSCode,2,1712156211,1712156213,1712156213.893415,-18000,,
com.google.Chrome,1,1712156210,1712156211,1712156211.931587,-18000,,
com.microsoft.VSCode,12,1712156198,1712156210,1712156210.7149749,-18000,,
com.google.Chrome,6,1712156192,1712156198,1712156198.572732,-18000,,
com.microsoft.VSCode,57,1712156135,1712156192,1712156192.4202142,-18000,,
com.google.Chrome,2,1712156133,1712156135,1712156135.136485,-18000,,
com.microsoft.VSCode,9,1712156124,1712156133,1712156133.4781861,-18000,,
com.google.Chrome,1,1712156123,1712156124,1712156124.30542,-18000,,
com.microsoft.VSCode,4,1712156119,1712156123,1712156123.101935,-18000,,
com.google.Chrome,5,1712156114,1712156119,1712156119.111237,-18000,,
com.microsoft.VSCode,7,1712156107,1712156114,1712156114.826436,-18000,,
com.google.Chrome,1,1712156106,1712156107,1712156107.175146,-18000,,
com.microsoft.VSCode,2,1712156104,1712156106,1712156106.534775,-18000,,
com.google.Chrome,21,1712156083,1712156104,1712156104.442066,-18000,,
com.microsoft.VSCode,11,1712156072,1712156083,1712156083.481316,-18000,,
com.google.Chrome,19,1712156053,1712156072,1712156072.9504042,-18000,,
com.microsoft.VSCode,41,1712156012,1712156053,1712156053.5637898,-18000,,
com.google.Chrome,14,1712155998,1712156012,1712156012.938243,-18000,,
com.microsoft.VSCode,27,1712155971,1712155998,1712155998.294678,-18000,,
com.google.Chrome,2,1712155969,1712155971,1712155971.209344,-18000,,
com.microsoft.VSCode,8,1712155961,1712155969,1712155969.937788,-18000,,
com.google.Chrome,2,1712155959,1712155961,1712155961.771596,-18000,,
com.microsoft.VSCode,24,1712155935,1712155959,1712155960.035502,-18000,,
com.google.Chrome,4,1712155931,1712155935,1712155936.037494,-18000,,
com.microsoft.VSCode,16,1712155915,1712155931,1712155931.745631,-18000,,
com.google.Chrome,3,1712155912,1712155915,1712155915.890469,-18000,,
com.microsoft.VSCode,1,1712155911,1712155912,1712155913.042758,-18000,,
com.google.Chrome,3,1712155908,1712155911,1712155911.56639,-18000,,
com.microsoft.VSCode,16,1712155892,1712155908,1712155908.34832,-18000,,
com.google.Chrome,5,1712155887,1712155892,1712155892.088367,-18000,,
com.microsoft.VSCode,8,1712155879,1712155887,1712155887.971908,-18000,,
com.google.Chrome,5,1712155874,1712155879,1712155879.457172,-18000,,
com.microsoft.VSCode,3,1712155871,1712155874,1712155874.658256,-18000,,
com.google.Chrome,1,1712155870,1712155871,1712155871.6394339,-18000,,
com.microsoft.VSCode,1,1712155869,1712155870,1712155870.62622,-18000,,
com.google.Chrome,1,1712155868,1712155869,1712155869.6158462,-18000,,
com.microsoft.VSCode,1,1712155867,1712155868,1712155868.213574,-18000,,
com.google.Chrome,2,1712155865,1712155867,1712155867.1288319,-18000,,
com.microsoft.VSCode,2,1712155863,1712155865,1712155865.2861571,-18000,,
com.google.Chrome,10,1712155853,1712155863,1712155863.5454469,-18000,,
com.microsoft.VSCode,2,1712155851,1712155853,1712155853.0532951,-18000,,
com.google.Chrome,5,1712155846,1712155851,1712155851.522619,-18000,,
com.microsoft.VSCode,33,1712155813,1712155846,1712155846.80483,-18000,,
com.google.Chrome,8,1712155805,1712155813,1712155813.239318,-18000,,
com.microsoft.VSCode,1,1712155804,1712155805,1712155806.033862,-18000,,
com.google.Chrome,60,1712155744,1712155804,1712155804.107456,-18000,,
com.microsoft.VSCode,52,1712155692,1712155744,1712155745.0168362,-18000,,
com.google.Chrome,14,1712155678,1712155692,1712155692.519023,-18000,,
com.microsoft.VSCode,4,1712155674,1712155678,1712155678.428055,-18000,,
com.google.Chrome,103,1712155571,1712155674,1712155674.995789,-18000,,
com.microsoft.VSCode,684,1712154887,1712155571,1712155573.1906672,-18000,,
com.google.Chrome,107,1712154780,1712154887,1712154887.9919229,-18000,,
com.apple.Health,23,1712154755,1712154778,1712154778.277216,-18000,EB445137-D7F5-57EC-87DA-1DB460D64046,"iPhone13,2"
com.microsoft.VSCode,93,1712154687,1712154780,1712154780.309927,-18000,,
com.google.Chrome,2,1712154685,1712154687,1712154687.638983,-18000,,
com.microsoft.VSCode,8,1712154677,1712154685,1712154685.7771292,-18000,,
com.google.Chrome,1,1712154676,1712154677,1712154677.909208,-18000,,
com.microsoft.VSCode,24,1712154652,1712154676,1712154676.8057408,-18000,,
com.google.Chrome,15,1712154637,1712154652,1712154652.593031,-18000,,
com.apple.finder,4,1712154633,1712154637,1712154642.051042,-18000,,
com.thestorygraph.thestorygraph,13,1712128155,1712128168,1712128168.539392,-18000,EB445137-D7F5-57EC-87DA-1DB460D64046,"iPhone13,2"
com.thestorygraph.thestorygraph,12,1712128136,1712128148,1712128148.987074,-18000,EB445137-D7F5-57EC-87DA-1DB460D64046,"iPhone13,2"
com.thestorygraph.thestorygraph,10,1712127556,1712127566,1712127566.5891042,-18000,EB445137-D7F5-57EC-87DA-1DB460D64046,"iPhone13,2"
com.thestorygraph.thestorygraph,13,1712125727,1712125740,1712125740.106339,-18000,EB445137-D7F5-57EC-87DA-1DB460D64046,"iPhone13,2"
com.thestorygraph.thestorygraph,10,1712125356,1712125366,1712125366.1038551,-18000,EB445137-D7F5-57EC-87DA-1DB460D64046,"iPhone13,2"
com.thestorygraph.thestorygraph,13,1712125074,1712125087,1712125087.704307,-18000,EB445137-D7F5-57EC-87DA-1DB460D64046,"iPhone13,2"
com.thestorygraph.thestorygraph,11,1712124699,1712124710,1712124710.016666,-18000,EB445137-D7F5-57EC-87DA-1DB460D64046,"iPhone13,2"
com.thestorygraph.thestorygraph,13,1712124553,1712124566,1712124566.7653332,-18000,EB445137-D7F5-57EC-87DA-1DB460D64046,"iPhone13,2"
com.thestorygraph.thestorygraph,10,1712124174,1712124184,1712124184.7416449,-18000,EB445137-D7F5-57EC-87DA-1DB460D64046,"iPhone13,2"
com.thestorygraph.thestorygraph,13,1712123979,1712123992,1712123992.0087461,-18000,EB445137-D7F5-57EC-87DA-1DB460D64046,"iPhone13,2"
com.thestorygraph.thestorygraph,10,1712123689,1712123699,1712123699.6635919,-18000,EB445137-D7F5-57EC-87DA-1DB460D64046,"iPhone13,2"
com.thestorygraph.thestorygraph,13,1712123566,1712123579,1712123579.786958,-18000,EB445137-D7F5-57EC-87DA-1DB460D64046,"iPhone13,2"
com.thestorygraph.thestorygraph,10,1712123247,1712123257,1712123257.6346622,-18000,EB445137-D7F5-57EC-87DA-1DB460D64046,"iPhone13,2"
com.thestorygraph.thestorygraph,13,1712122952,1712122965,1712122965.351969,-18000,EB445137-D7F5-57EC-87DA-1DB460D64046,"iPhone13,2"
com.thestorygraph.thestorygraph,10,1712122841,1712122851,1712122851.299306,-18000,EB445137-D7F5-57EC-87DA-1DB460D64046,"iPhone13,2"
com.thestorygraph.thestorygraph,13,1712122715,1712122728,1712122728.0264091,-18000,EB445137-D7F5-57EC-87DA-1DB460D64046,"iPhone13,2"
com.thestorygraph.thestorygraph,10,1712122373,1712122383,1712122383.962484,-18000,EB445137-D7F5-57EC-87DA-1DB460D64046,"iPhone13,2"
com.thestorygraph.thestorygraph,13,1712122176,1712122189,1712122189.155586,-18000,EB445137-D7F5-57EC-87DA-1DB460D64046,"iPhone13,2"
com.thestorygraph.thestorygraph,10,1712121793,1712121803,1712121803.1898289,-18000,EB445137-D7F5-57EC-87DA-1DB460D64046,"iPhone13,2"
com.thestorygraph.thestorygraph,13,1712121486,1712121499,1712121499.190176,-18000,EB445137-D7F5-57EC-87DA-1DB460D64046,"iPhone13,2"
com.thestorygraph.thestorygraph,10,1712121005,1712121015,1712121015.693746,-18000,EB445137-D7F5-57EC-87DA-1DB460D64046,"iPhone13,2"
com.thestorygraph.thestorygraph,13,1712120695,1712120708,1712120708.803615,-18000,EB445137-D7F5-57EC-87DA-1DB460D64046,"iPhone13,2"
com.thestorygraph.thestorygraph,10,1712120263,1712120273,1712120273.078697,-18000,EB445137-D7F5-57EC-87DA-1DB460D64046,"iPhone13,2"
com.thestorygraph.thestorygraph,13,1712119975,1712119988,1712119988.14784,-18000,EB445137-D7F5-57EC-87DA-1DB460D64046,"iPhone13,2"
com.thestorygraph.thestorygraph,10,1712119915,1712119925,1712119925.969226,-18000,EB445137-D7F5-57EC-87DA-1DB460D64046,"iPhone13,2"
com.thestorygraph.thestorygraph,13,1712119820,1712119833,1712119833.685528,-18000,EB445137-D7F5-57EC-87DA-1DB460D64046,"iPhone13,2"
com.thestorygraph.thestorygraph,10,1712119590,1712119600,1712119600.2155461,-18000,EB445137-D7F5-57EC-87DA-1DB460D64046,"iPhone13,2"
com.thestorygraph.thestorygraph,13,1712119466,1712119479,1712119479.6189651,-18000,EB445137-D7F5-57EC-87DA-1DB460D64046,"iPhone13,2"
com.thestorygraph.thestorygraph,10,1712119301,1712119311,1712119311.534937,-18000,EB445137-D7F5-57EC-87DA-1DB460D64046,"iPhone13,2"
com.thestorygraph.thestorygraph,13,1712119205,1712119218,1712119218.861958,-18000,EB445137-D7F5-57EC-87DA-1DB460D64046,"iPhone13,2"
com.thestorygraph.thestorygraph,23,1712119044,1712119067,1712119067.107429,-18000,EB445137-D7F5-57EC-87DA-1DB460D64046,"iPhone13,2"
com.apple.finder,3,1712115157,1712115160,1712115160.964448,-18000,,
com.apple.Music,2,1712113810,1712113812,1712113812.585943,-18000,EB445137-D7F5-57EC-87DA-1DB460D64046,"iPhone13,2"
com.google.Chrome,1562,1712113595,1712115157,1712115157.999238,-18000,,
com.google.Chrome,1322,1712111647,1712112969,1712112969.111374,-18000,,
com.apple.Music,12,1712111634,1712111646,1712111646.380362,-18000,EB445137-D7F5-57EC-87DA-1DB460D64046,"iPhone13,2"
com.microsoft.onenote.mac,45,1712111602,1712111647,1712111647.926822,-18000,,
com.apple.iCal,4,1712111598,1712111602,1712111602.157238,-18000,,
com.google.Chrome,9,1712111589,1712111598,1712111599.021236,-18000,,
com.apple.iCal,0,1712111589,1712111589,1712111589.593639,-18000,,
com.google.Chrome,270,1712111319,1712111589,1712111589.181843,-18000,,
com.apple.iCal,7,1712111312,1712111319,1712111319.554946,-18000,,
com.microsoft.onenote.mac,13,1712111299,1712111312,1712111312.801609,-18000,,
com.apple.iCal,2,1712111297,1712111299,1712111299.467375,-18000,,
com.microsoft.onenote.mac,5,1712111292,1712111297,1712111297.976068,-18000,,
com.apple.iCal,2,1712111290,1712111292,1712111292.603626,-18000,,
com.microsoft.onenote.mac,40,1712111250,1712111290,1712111290.41635,-18000,,
com.apple.iCal,16,1712111234,1712111250,1712111250.740703,-18000,,
com.apple.finder,8,1712111226,1712111234,1712111234.109223,-18000,,
com.apple.Music,1,1712110794,1712110795,1712110795.791315,-18000,EB445137-D7F5-57EC-87DA-1DB460D64046,"iPhone13,2"
com.apple.Music,4,1712110736,1712110740,1712110740.107596,-18000,EB445137-D7F5-57EC-87DA-1DB460D64046,"iPhone13,2"
com.apple.Music,3,1712110486,1712110489,1712110489.419996,-18000,EB445137-D7F5-57EC-87DA-1DB460D64046,"iPhone13,2"
com.apple.Music,11,1712110221,1712110232,1712110232.423559,-18000,EB445137-D7F5-57EC-87DA-1DB460D64046,"iPhone13,2"
com.apple.MobileSMS,2,1712110216,1712110218,1712110218.546735,-18000,EB445137-D7F5-57EC-87DA-1DB460D64046,"iPhone13,2"
com.apple.MobileSMS,27,1712109993,1712110020,1712110020.803887,-18000,EB445137-D7F5-57EC-87DA-1DB460D64046,"iPhone13,2"
com.zhiliaoapp.musically,31,1712109962,1712109993,1712109993.4570541,-18000,EB445137-D7F5-57EC-87DA-1DB460D64046,"iPhone13,2"
com.apple.MobileSMS,5,1712109957,1712109962,1712109963.06306,-18000,EB445137-D7F5-57EC-87DA-1DB460D64046,"iPhone13,2"
com.apple.finder,3,1712109922,1712109925,1712109925.861411,-18000,,
com.google.Chrome,3,1712109919,1712109922,1712109922.156435,-18000,,
com.leomehlig.today,7,1712109912,1712109919,1712109919.609827,-18000,,
com.google.Chrome,127,1712109785,1712109912,1712109912.241144,-18000,,
com.leomehlig.today,139,1712109637,1712109776,1712109776.332065,-18000,,
com.apple.finder,21,1712109616,1712109637,1712109638.047436,-18000,,
com.apple.Preview,213,1712109403,1712109616,1712109616.33185,-18000,,
com.google.Chrome,21,1712109382,1712109403,1712109403.622593,-18000,,
com.apple.Preview,791,1712108591,1712109382,1712109382.12345,-18000,,
com.google.Chrome,59,1712108532,1712108591,1712108591.666137,-18000,,
com.apple.Preview,34,1712108498,1712108532,1712108532.457721,-18000,,
com.leomehlig.today,67,1712108431,1712108498,1712108498.113646,-18000,,
com.apple.Preview,137,1712108294,1712108431,1712108431.399432,-18000,,
com.apple.finder,2,1712108292,1712108294,1712108294.281718,-18000,,
com.apple.Preview,1189,1712107103,1712108292,1712108292.630254,-18000,,
com.apple.finder,1,1712107102,1712107103,1712107103.4540792,-18000,,
com.apple.Preview,398,1712106704,1712107102,1712107102.632251,-18000,,
com.apple.finder,9,1712106695,1712106704,1712106704.8640141,-18000,,
com.google.Chrome,13,1712106682,1712106695,1712106695.446519,-18000,,
com.apple.Preview,140,1712106542,1712106682,1712106682.9550018,-18000,,
com.google.Chrome,264,1712106278,1712106542,1712106542.052283,-18000,,
com.apple.Preview,25,1712106237,1712106262,1712106262.320808,-18000,,
com.apple.finder,42,1712106195,1712106237,1712106237.8238912,-18000,,
com.leomehlig.today,0,1712106195,1712106195,1712106195.74072,-18000,,
com.apple.finder,11,1712106184,1712106195,1712106195.1592731,-18000,,
com.google.Chrome,8,1712106176,1712106184,1712106184.756115,-18000,,
com.leomehlig.today,1,1712106175,1712106176,1712106176.6267629,-18000,,
com.google.Chrome,2,1712106173,1712106175,1712106175.342258,-18000,,
com.leomehlig.today,1,1712106172,1712106173,1712106173.201726,-18000,,
com.google.Chrome,20,1712106152,1712106172,1712106172.1788402,-18000,,
com.leomehlig.today,12,1712106140,1712106152,1712106152.211848,-18000,,
com.burbn.instagram,291,1712105787,1712106078,1712106078.998194,-18000,EB445137-D7F5-57EC-87DA-1DB460D64046,"iPhone13,2"
com.leomehlig.today,310,1712105593,1712105903,1712105903.449065,-18000,,
com.intsig.CamScannerLite,158,1712105583,1712105741,1712105741.895801,-18000,EB445137-D7F5-57EC-87DA-1DB460D64046,"iPhone13,2"
com.microsoft.Office.Outlook,9,1712105565,1712105574,1712105574.5695682,-18000,EB445137-D7F5-57EC-87DA-1DB460D64046,"iPhone13,2"
com.burbn.instagram,4,1712105561,1712105565,1712105565.7017,-18000,EB445137-D7F5-57EC-87DA-1DB460D64046,"iPhone13,2"
com.google.Chrome,124,1712105469,1712105593,1712105593.696929,-18000,,
com.google.Chrome,534,1712104934,1712105468,1712105468.687364,-18000,,
com.apple.Preview,17,1712104917,1712104934,1712104934.474457,-18000,,
com.google.Chrome,50,1712104867,1712104917,1712104917.783763,-18000,,
com.apple.Preview,7,1712104860,1712104867,1712104867.419475,-18000,,
com.google.Chrome,72,1712104788,1712104860,1712104860.419141,-18000,,
com.google.Chrome,300,1712104376,1712104676,1712104676.262265,-18000,,
com.google.Chrome,318,1712104057,1712104375,1712104375.25991,-18000,,
com.apple.Preview,64,1712103993,1712104057,1712104057.052061,-18000,,
com.google.Chrome,39,1712103954,1712103993,1712103993.240893,-18000,,
com.google.Chrome,480,1712103294,1712103774,1712103774.11944,-18000,,
com.google.Chrome,827,1712102460,1712103287,1712103287.3422508,-18000,,
com.google.Chrome,610,1712101837,1712102447,1712102447.314917,-18000,,
com.apple.Preview,49,1712101788,1712101837,1712101837.4019861,-18000,,
com.google.Chrome,172,1712101616,1712101788,1712101788.471173,-18000,,
com.apple.Preview,804,1712100812,1712101616,1712101616.1593409,-18000,,
com.google.Chrome,3,1712100809,1712100812,1712100812.345286,-18000,,
com.leomehlig.today,24,1712100785,1712100809,1712100809.0817142,-18000,,
com.google.Chrome,26,1712100759,1712100785,1712100785.179868,-18000,,
com.burbn.instagram,6,1712096677,1712096683,1712096683.364421,-18000,EB445137-D7F5-57EC-87DA-1DB460D64046,"iPhone13,2"
com.burbn.instagram,27,1712096649,1712096676,1712096676.6425772,-18000,EB445137-D7F5-57EC-87DA-1DB460D64046,"iPhone13,2"
com.burbn.instagram,6,1712096634,1712096640,1712096640.883517,-18000,EB445137-D7F5-57EC-87DA-1DB460D64046,"iPhone13,2"
com.google.Chrome,3,1712096519,1712096522,1712096522.067184,-18000,,
com.apple.weather,54,1712096443,1712096497,1712096498.00357,-18000,EB445137-D7F5-57EC-87DA-1DB460D64046,"iPhone13,2"
com.leomehlig.today,52,1712096384,1712096436,1712096437.041467,-18000,,
com.apple.weather,73,1712096361,1712096434,1712096434.64355,-18000,EB445137-D7F5-57EC-87DA-1DB460D64046,"iPhone13,2"
com.google.chrome.ios,58,1712096303,1712096361,1712096361.355339,-18000,EB445137-D7F5-57EC-87DA-1DB460D64046,"iPhone13,2"
com.tinyspeck.chatlyio,9,1712096291,1712096300,1712096300.4946141,-18000,EB445137-D7F5-57EC-87DA-1DB460D64046,"iPhone13,2"
com.google.ios.youtube,3,1712096217,1712096220,1712096220.46808,-18000,EB445137-D7F5-57EC-87DA-1DB460D64046,"iPhone13,2"
com.google.ios.youtube,12,1712096200,1712096212,1712096212.352563,-18000,EB445137-D7F5-57EC-87DA-1DB460D64046,"iPhone13,2"
com.google.ios.youtube,2,1712096197,1712096199,1712096200.0151482,-18000,EB445137-D7F5-57EC-87DA-1DB460D64046,"iPhone13,2"
com.google.Chrome,378,1712096006,1712096384,1712096384.696161,-18000,,
com.leomehlig.today,8,1712095998,1712096006,1712096006.689589,-18000,,
org.stellarium.Stellarium,104,1712095894,1712095998,1712095998.299189,-18000,,
com.google.ios.youtube,24,1712095871,1712095895,1712095895.9537148,-18000,EB445137-D7F5-57EC-87DA-1DB460D64046,"iPhone13,2"
com.apple.Health,33,1712095833,1712095866,1712095866.393214,-18000,EB445137-D7F5-57EC-87DA-1DB460D64046,"iPhone13,2"
com.leomehlig.today,83,1712095811,1712095894,1712095895.011872,-18000,,
com.google.Chrome,192,1712095619,1712095811,1712095811.3527908,-18000,,
com.tinyspeck.chatlyio,5,1712095560,1712095565,1712095565.684579,-18000,EB445137-D7F5-57EC-87DA-1DB460D64046,"iPhone13,2"
com.apple.MobileSMS,28,1712095179,1712095207,1712095207.65314,-18000,EB445137-D7F5-57EC-87DA-1DB460D64046,"iPhone13,2"
com.apple.weather,5,1712095174,1712095179,1712095180.5906749,-18000,EB445137-D7F5-57EC-87DA-1DB460D64046,"iPhone13,2"
com.apple.finder,2,1712095102,1712095104,1712095104.278168,-18000,,
com.apple.weather,6,1712093825,1712093831,1712093831.123718,-18000,EB445137-D7F5-57EC-87DA-1DB460D64046,"iPhone13,2"
com.thestorygraph.thestorygraph,10,1712093815,1712093825,1712093825.258285,-18000,EB445137-D7F5-57EC-87DA-1DB460D64046,"iPhone13,2"
com.thestorygraph.thestorygraph,22,1712093730,1712093752,1712093752.643014,-18000,EB445137-D7F5-57EC-87DA-1DB460D64046,"iPhone13,2"
com.apple.finder,9,1712091515,1712091524,1712091525.1887531,-18000,,
us.zoom.xos,3,1712091512,1712091515,1712091515.3105469,-18000,,
com.apple.finder,3,1712091509,1712091512,1712091512.8445249,-18000,,
com.leomehlig.today,16,1712091493,1712091509,1712091509.979744,-18000,,
com.apple.finder,5,1712091488,1712091493,1712091493.124691,-18000,,
com.google.Chrome,2,1712091486,1712091488,1712091488.12754,-18000,,
com.microsoft.Powerpoint,4,1712091482,1712091486,1712091486.856583,-18000,,
com.google.Chrome,127,1712091355,1712091482,1712091482.2913651,-18000,,
com.microsoft.Powerpoint,2,1712091353,1712091355,1712091356.013418,-18000,,
com.google.Chrome,67,1712091286,1712091353,1712091353.3738232,-18000,,
com.microsoft.Powerpoint,2,1712091284,1712091286,1712091286.6057901,-18000,,
com.google.Chrome,158,1712091126,1712091284,1712091284.787866,-18000,,
com.microsoft.Powerpoint,32,1712091094,1712091126,1712091126.3721051,-18000,,
com.google.Chrome,26,1712091068,1712091094,1712091094.908936,-18000,,
com.microsoft.Powerpoint,4,1712091064,1712091068,1712091068.968416,-18000,,
com.apple.finder,0,1712091039,1712091039,1712091039.805704,-18000,,
com.microsoft.Powerpoint,7,1712091032,1712091039,1712091039.562389,-18000,,
com.google.Gmail,10,1712090372,1712090382,1712090382.257652,-18000,EB445137-D7F5-57EC-87DA-1DB460D64046,"iPhone13,2"
com.microsoft.Powerpoint,622,1712089788,1712090410,1712090410.934517,-18000,,
com.apple.Music,5,1712089783,1712089788,1712089788.221232,-18000,,
com.microsoft.Powerpoint,118,1712089665,1712089783,1712089783.22511,-18000,,
com.apple.finder,4,1712089661,1712089665,1712089665.3660111,-18000,,
com.google.Chrome,2,1712089659,1712089661,1712089661.465259,-18000,,
com.leomehlig.today,9,1712089650,1712089659,1712089659.190527,-18000,,
com.apple.finder,17,1712089633,1712089650,1712089650.1143188,-18000,,
com.apple.finder,7,1712089498,1712089505,1712089505.0258598,-18000,,
com.leomehlig.today,9,1712089489,1712089498,1712089498.900302,-18000,,
com.google.Chrome,5,1712089484,1712089489,1712089489.891182,-18000,,
us.zoom.xos,56,1712089428,1712089484,1712089484.731827,-18000,,
com.apple.news,515,1712088967,1712089482,1712089482.3339849,-18000,EB445137-D7F5-57EC-87DA-1DB460D64046,"iPhone13,2"
us.zoom.xos,318,1712088931,1712089249,1712089249.159514,-18000,,
us.zoom.xos,303,1712088558,1712088861,1712088861.4161081,-18000,,
com.google.Chrome,1,1712088557,1712088558,1712088558.997385,-18000,,
com.microsoft.VSCode,3,1712088554,1712088557,1712088557.559373,-18000,,
com.apple.MobileSMS,6,1712088548,1712088554,1712088554.803457,-18000,,
com.microsoft.VSCode,229,1712088319,1712088548,1712088548.8764992,-18000,,
com.apple.finder,2,1712088317,1712088319,1712088319.2202349,-18000,,
com.google.Chrome,32,1712088285,1712088317,1712088317.232832,-18000,,
com.apple.finder,14,1712088271,1712088285,1712088285.746928,-18000,,
com.apple.FolderActionsSetup,14,1712088257,1712088271,1712088271.30183,-18000,,
com.apple.finder,18,1712088239,1712088257,1712088257.2572289,-18000,,
com.microsoft.VSCode,37,1712088202,1712088239,1712088239.2504249,-18000,,
com.apple.MobileSMS,3,1712088199,1712088202,1712088202.58138,-18000,,
com.microsoft.VSCode,2,1712088197,1712088199,1712088201.2631822,-18000,,
us.zoom.xos,1,1712088196,1712088197,1712088198.001573,-18000,,
us.zoom.xos,372,1712087791,1712088163,1712088163.818431,-18000,,
com.apple.MobileSMS,4,1712087787,1712087791,1712087791.476517,-18000,,
us.zoom.xos,59,1712087728,1712087787,1712087787.859813,-18000,,
com.apple.MobileSMS,50,1712087678,1712087728,1712087728.183086,-18000,,
us.zoom.xos,38,1712087640,1712087678,1712087678.978469,-18000,,
com.apple.MobileSMS,71,1712087569,1712087640,1712087640.98915,-18000,,
us.zoom.xos,1,1712087568,1712087569,1712087569.839509,-18000,,
com.apple.MobileSMS,136,1712087432,1712087568,1712087568.3063369,-18000,,
com.apple.MobileSMS,5,1712087301,1712087306,1712087306.0281858,-18000,EB445137-D7F5-57EC-87DA-1DB460D64046,"iPhone13,2"
com.burbn.instagram,1,1712087300,1712087301,1712087302.307687,-18000,EB445137-D7F5-57EC-87DA-1DB460D64046,"iPhone13,2"
us.zoom.xos,216,1712087216,1712087432,1712087432.747643,-18000,,
com.apple.MobileSMS,73,1712087143,1712087216,1712087216.2639399,-18000,,
com.burbn.instagram,104,1712086958,1712087062,1712087062.917295,-18000,EB445137-D7F5-57EC-87DA-1DB460D64046,"iPhone13,2"
us.zoom.xos,244,1712086899,1712087143,1712087143.180984,-18000,,
com.google.Chrome,70,1712086829,1712086899,1712086899.105519,-18000,,
com.apple.MobileSMS,28,1712086781,1712086809,1712086809.381997,-18000,EB445137-D7F5-57EC-87DA-1DB460D64046,"iPhone13,2"
edu.illinois.rokwire.ios,2,1712086779,1712086781,1712086781.605525,-18000,EB445137-D7F5-57EC-87DA-1DB460D64046,"iPhone13,2"
us.zoom.xos,53,1712086776,1712086829,1712086829.5063539,-18000,,
com.leomehlig.today,23,1712086753,1712086776,1712086776.549045,-18000,,
com.apple.finder,26,1712086727,1712086753,1712086753.1867871,-18000,,
com.google.Chrome,39,1712086688,1712086727,1712086727.938233,-18000,,
com.microsoft.Powerpoint,47,1712086641,1712086688,1712086688.4698548,-18000,,
edu.illinois.rokwire.ios,2,1712086612,1712086614,1712086614.0842671,-18000,EB445137-D7F5-57EC-87DA-1DB460D64046,"iPhone13,2"
edu.illinois.rokwire.ios,1,1712086484,1712086485,1712086485.9186811,-18000,EB445137-D7F5-57EC-87DA-1DB460D64046,"iPhone13,2"
edu.illinois.rokwire.ios,10,1712086270,1712086280,1712086280.0537,-18000,EB445137-D7F5-57EC-87DA-1DB460D64046,"iPhone13,2"
edu.illinois.rokwire.ios,61,1712086123,1712086184,1712086184.616002,-18000,EB445137-D7F5-57EC-87DA-1DB460D64046,"iPhone13,2"
com.tinyspeck.chatlyio,59,1712086062,1712086121,1712086121.520461,-18000,EB445137-D7F5-57EC-87DA-1DB460D64046,"iPhone13,2"
com.microsoft.Powerpoint,675,1712085868,1712086543,1712086543.4043741,-18000,,
com.apple.finder,6,1712085862,1712085868,1712085868.71521,-18000,,
com.microsoft.Powerpoint,3,1712085859,1712085862,1712085862.994427,-18000,,
com.apple.finder,3,1712085856,1712085859,1712085859.6702619,-18000,,
us.zoom.xos,34,1712085822,1712085856,1712085857.072634,-18000,,
com.google.Chrome,211,1712085611,1712085822,1712085822.141459,-18000,,
us.zoom.xos,3,1712085608,1712085611,1712085611.5202641,-18000,,
com.google.Chrome,534,1712085074,1712085608,1712085608.573279,-18000,,
us.zoom.xos,28,1712085046,1712085074,1712085074.828594,-18000,,
com.google.Chrome,8,1712085038,1712085046,1712085046.549996,-18000,,
us.zoom.xos,4,1712085034,1712085038,1712085038.187238,-18000,,
com.apple.Photos,91,1712084943,1712085034,1712085034.986692,-18000,,
com.apple.mobileslideshow,59,1712084874,1712084933,1712084933.584694,-18000,EB445137-D7F5-57EC-87DA-1DB460D64046,"iPhone13,2"
com.microsoft.Office.Outlook,0,1712084862,1712084862,1712084863.286927,-18000,EB445137-D7F5-57EC-87DA-1DB460D64046,"iPhone13,2"
us.zoom.xos,273,1712084670,1712084943,1712084943.248055,-18000,,
com.apple.finder,4,1712084666,1712084670,1712084670.4917579,-18000,,
com.microsoft.VSCode,86,1712084580,1712084666,1712084666.228755,-18000,,
com.apple.finder,7,1712084573,1712084580,1712084580.131635,-18000,,
com.microsoft.Outlook,19,1712084554,1712084573,1712084573.201612,-18000,,
com.microsoft.Office.Outlook,17,1712084535,1712084552,1712084552.482346,-18000,EB445137-D7F5-57EC-87DA-1DB460D64046,"iPhone13,2"
com.google.Chrome,64,1712084490,1712084554,1712084554.910873,-18000,,
us.zoom.xos,17,1712084473,1712084490,1712084490.802007,-18000,,
com.apple.iCal,4,1712084469,1712084473,1712084473.242238,-18000,,
us.zoom.xos,17,1712084452,1712084469,1712084469.302669,-18000,,
com.apple.iCal,17,1712084435,1712084452,1712084453.0165172,-18000,,
us.zoom.xos,67,1712084368,1712084435,1712084435.984271,-18000,,
com.google.Chrome,23,1712084345,1712084368,1712084368.136416,-18000,,
com.leomehlig.today,24,1712084321,1712084345,1712084345.3232079,-18000,,
com.apple.finder,30,1712084291,1712084321,1712084321.717176,-18000,,
com.google.Chrome,57,1712084234,1712084291,1712084291.2784948,-18000,,
com.apple.finder,5,1712084229,1712084234,1712084234.298645,-18000,,
com.google.Chrome,33,1712084196,1712084229,1712084229.5649729,-18000,,
com.leomehlig.today,11,1712084185,1712084196,1712084196.612397,-18000,,
com.burbn.instagram,501,1712083601,1712084102,1712084102.789466,-18000,EB445137-D7F5-57EC-87DA-1DB460D64046,"iPhone13,2"
com.amazon.Amazon,13,1712083581,1712083594,1712083594.6057491,-18000,EB445137-D7F5-57EC-87DA-1DB460D64046,"iPhone13,2"
com.amazon.Amazon,24,1712083519,1712083543,1712083544.713529,-18000,EB445137-D7F5-57EC-87DA-1DB460D64046,"iPhone13,2"
com.leomehlig.today,26,1712083427,1712083453,1712083453.86438,-18000,,
com.google.Chrome,5,1712083422,1712083427,1712083427.0424728,-18000,,
com.leomehlig.today,2,1712083420,1712083422,1712083422.8121839,-18000,,
com.google.Chrome,585,1712082835,1712083420,1712083420.8725672,-18000,,
com.apple.finder,11,1712082824,1712082835,1712082835.153154,-18000,,
com.google.Chrome,1865,1712080959,1712082824,1712082824.5265841,-18000,,
com.microsoft.Outlook,61,1712080898,1712080959,1712080959.811586,-18000,,
com.google.Chrome,12,1712080886,1712080898,1712080898.2406769,-18000,,
com.leomehlig.today,7,1712080879,1712080886,1712080886.126437,-18000,,
com.google.Chrome,19,1712080860,1712080879,1712080879.3423672,-18000,,
com.moodle.moodlemobile,63,1712077367,1712077430,1712077430.54452,-18000,EB445137-D7F5-57EC-87DA-1DB460D64046,"iPhone13,2"
com.burbn.instagram,13,1712077351,1712077364,1712077364.280782,-18000,EB445137-D7F5-57EC-87DA-1DB460D64046,"iPhone13,2"
com.capp.poplive,83,1712077221,1712077304,1712077304.032555,-18000,EB445137-D7F5-57EC-87DA-1DB460D64046,"iPhone13,2"
com.instructure.icanvas,27,1712077192,1712077219,1712077219.515007,-18000,EB445137-D7F5-57EC-87DA-1DB460D64046,"iPhone13,2"
com.burbn.instagram,532,1712075669,1712076201,1712076201.716289,-18000,EB445137-D7F5-57EC-87DA-1DB460D64046,"iPhone13,2"
com.apple.weather,15,1712075652,1712075667,1712075667.8886418,-18000,EB445137-D7F5-57EC-87DA-1DB460D64046,"iPhone13,2"
com.apple.weather,1,1712075546,1712075547,1712075547.937742,-18000,EB445137-D7F5-57EC-87DA-1DB460D64046,"iPhone13,2"
com.apple.weather,3,1712075522,1712075525,1712075525.411065,-18000,EB445137-D7F5-57EC-87DA-1DB460D64046,"iPhone13,2"
com.apple.weather,5,1712075085,1712075090,1712075090.6241732,-18000,EB445137-D7F5-57EC-87DA-1DB460D64046,"iPhone13,2"
edu.illinois.rokwire.ios,2,1712075083,1712075085,1712075085.6795158,-18000,EB445137-D7F5-57EC-87DA-1DB460D64046,"iPhone13,2"
com.google.Chrome,2,1712074992,1712074994,1712074994.9511619,-18000,,
com.apple.iCal,4,1712074988,1712074992,1712074993.0453281,-18000,,
com.leomehlig.today,43,1712074945,1712074988,1712074988.32815,-18000,,
com.google.Chrome,173,1712074772,1712074945,1712074945.22596,-18000,,
com.apple.Preview,44,1712074728,1712074772,1712074772.65069,-18000,,
com.google.Chrome,23,1712074705,1712074728,1712074728.380001,-18000,,
com.apple.Preview,22,1712074683,1712074705,1712074705.109097,-18000,,
com.google.Chrome,100,1712074583,1712074683,1712074683.32777,-18000,,
com.apple.Preview,135,1712074448,1712074583,1712074583.57381,-18000,,
edu.illinois.rokwire.ios,10,1712074278,1712074288,1712074288.442206,-18000,EB445137-D7F5-57EC-87DA-1DB460D64046,"iPhone13,2"
com.google.Chrome,217,1712074231,1712074448,1712074448.046649,-18000,,
com.apple.Preview,331,1712073900,1712074231,1712074231.071341,-18000,,
com.google.Chrome,7,1712073893,1712073900,1712073900.373025,-18000,,
com.apple.Preview,140,1712073753,1712073893,1712073893.079183,-18000,,
com.google.Chrome,8,1712073745,1712073753,1712073753.8389668,-18000,,
edu.illinois.rokwire.ios,27,1712073712,1712073739,1712073739.3634949,-18000,EB445137-D7F5-57EC-87DA-1DB460D64046,"iPhone13,2"
com.microsoft.Office.Outlook,3,1712073708,1712073711,1712073711.403061,-18000,EB445137-D7F5-57EC-87DA-1DB460D64046,"iPhone13,2"
com.apple.Preview,70,1712073675,1712073745,1712073745.1864161,-18000,,
com.google.Chrome,5,1712073670,1712073675,1712073675.9242969,-18000,,
com.apple.Preview,20,1712073650,1712073670,1712073670.217814,-18000,,
com.google.Chrome,10,1712073640,1712073650,1712073650.7728891,-18000,,
com.apple.Preview,2,1712073638,1712073640,1712073640.4426498,-18000,,
com.google.Chrome,4,1712073634,1712073638,1712073638.766024,-18000,,
com.apple.Preview,21,1712073613,1712073634,1712073634.11943,-18000,,
com.google.Chrome,147,1712073466,1712073613,1712073613.134731,-18000,,
com.apple.Preview,9,1712073457,1712073466,1712073466.581322,-18000,,
com.google.Chrome,6,1712073451,1712073457,1712073457.974621,-18000,,
com.apple.Preview,516,1712072935,1712073451,1712073451.518715,-18000,,
com.google.Chrome,9,1712072926,1712072935,1712072935.494715,-18000,,
com.leomehlig.today,35,1712072891,1712072926,1712072927.042149,-18000,,
com.google.Chrome,265,1712072626,1712072891,1712072891.686473,-18000,,
com.leomehlig.today,3,1712072614,1712072617,1712072617.769195,-18000,,
com.google.Chrome,64,1712072550,1712072614,1712072614.1136441,-18000,,
com.leomehlig.today,14,1712072536,1712072550,1712072550.8640141,-18000,,
com.microsoft.Office.Outlook,35,1712072496,1712072531,1712072531.683043,-18000,EB445137-D7F5-57EC-87DA-1DB460D64046,"iPhone13,2"
com.amazon.Amazon,9,1712072484,1712072493,1712072493.851478,-18000,EB445137-D7F5-57EC-87DA-1DB460D64046,"iPhone13,2"
com.amazon.Amazon,12,1712072135,1712072147,1712072147.698241,-18000,EB445137-D7F5-57EC-87DA-1DB460D64046,"iPhone13,2"
com.google.Chrome,450,1712072086,1712072536,1712072536.55392,-18000,,
com.leomehlig.today,26,1712072060,1712072086,1712072086.3502002,-18000,,
com.google.Chrome,74,1712071986,1712072060,1712072061.020416,-18000,,
com.amazon.Amazon,14,1712071719,1712071733,1712071733.87047,-18000,EB445137-D7F5-57EC-87DA-1DB460D64046,"iPhone13,2"
com.microsoft.Office.Outlook,2,1712071714,1712071716,1712071716.886047,-18000,EB445137-D7F5-57EC-87DA-1DB460D64046,"iPhone13,2"
com.microsoft.Office.Outlook,1,1712071713,1712071714,1712071714.265336,-18000,EB445137-D7F5-57EC-87DA-1DB460D64046,"iPhone13,2"
com.google.Chrome,676,1712071307,1712071983,1712071983.5944529,-18000,,
com.microsoft.Office.Outlook,9,1712070792,1712070801,1712070801.386261,-18000,EB445137-D7F5-57EC-87DA-1DB460D64046,"iPhone13,2"
com.google.Chrome,486,1712070780,1712071266,1712071266.832004,-18000,,
com.leomehlig.today,16,1712070764,1712070780,1712070780.640429,-18000,,
com.microsoft.Office.Outlook,17,1712070458,1712070475,1712070475.2112179,-18000,EB445137-D7F5-57EC-87DA-1DB460D64046,"iPhone13,2"
com.apple.weather,8,1712070450,1712070458,1712070458.180862,-18000,EB445137-D7F5-57EC-87DA-1DB460D64046,"iPhone13,2"
com.apple.weather,6,1712070360,1712070366,1712070366.786679,-18000,EB445137-D7F5-57EC-87DA-1DB460D64046,"iPhone13,2"
com.apple.weather,12,1712070178,1712070190,1712070190.935264,-18000,EB445137-D7F5-57EC-87DA-1DB460D64046,"iPhone13,2"
com.apple.Music,9,1712070168,1712070177,1712070177.897375,-18000,EB445137-D7F5-57EC-87DA-1DB460D64046,"iPhone13,2"
com.apple.Music,10,1712069975,1712069985,1712069985.21702,-18000,EB445137-D7F5-57EC-87DA-1DB460D64046,"iPhone13,2"
com.apple.Music,6,1712069886,1712069892,1712069892.6350842,-18000,EB445137-D7F5-57EC-87DA-1DB460D64046,"iPhone13,2"
com.google.Chrome,1276,1712069488,1712070764,1712070764.302414,-18000,,
com.apple.Music,8,1712069465,1712069473,1712069473.8610191,-18000,EB445137-D7F5-57EC-87DA-1DB460D64046,"iPhone13,2"
com.leomehlig.today,72,1712069416,1712069488,1712069488.785084,-18000,,
com.hammerandchisel.discord,63,1712067298,1712067361,1712067361.7385669,-18000,EB445137-D7F5-57EC-87DA-1DB460D64046,"iPhone13,2"
com.microsoft.Office.Outlook,115,1712067178,1712067293,1712067293.8100262,-18000,EB445137-D7F5-57EC-87DA-1DB460D64046,"iPhone13,2"
com.burbn.instagram,1214,1712065962,1712067176,1712067177.044168,-18000,EB445137-D7F5-57EC-87DA-1DB460D64046,"iPhone13,2"
com.apple.weather,27,1712065906,1712065933,1712065933.981694,-18000,EB445137-D7F5-57EC-87DA-1DB460D64046,"iPhone13,2"
com.apple.weather,13,1712065886,1712065899,1712065899.5305119,-18000,EB445137-D7F5-57EC-87DA-1DB460D64046,"iPhone13,2"
com.markhambly.APOD,54,1712065829,1712065883,1712065883.145204,-18000,EB445137-D7F5-57EC-87DA-1DB460D64046,"iPhone13,2"
com.thestorygraph.thestorygraph,15,1712032351,1712032366,1712032366.4221401,-18000,EB445137-D7F5-57EC-87DA-1DB460D64046,"iPhone13,2"
com.apple.journal,10,1712032341,1712032351,1712032351.466176,-18000,EB445137-D7F5-57EC-87DA-1DB460D64046,"iPhone13,2"
com.leomehlig.today,110,1712030031,1712030141,1712030141.5675569,-18000,,
com.apple.iCal,5,1712030026,1712030031,1712030031.884942,-18000,,
com.leomehlig.today,154,1712029872,1712030026,1712030026.466949,-18000,,
com.google.Chrome,0,1712029872,1712029872,1712029873.083956,-18000,,
com.microsoft.Outlook,2,1712029870,1712029872,1712029872.536381,-18000,,
com.google.Chrome,750,1712029120,1712029870,1712029870.66554,-18000,,
com.apple.Preview,19,1712029101,1712029120,1712029120.0715709,-18000,,
com.google.Chrome,455,1712028646,1712029101,1712029101.134993,-18000,,
com.apple.Preview,131,1712028515,1712028646,1712028646.3235989,-18000,,
com.google.Chrome,8,1712028507,1712028515,1712028515.812036,-18000,,
com.apple.Preview,5,1712028502,1712028507,1712028507.1790318,-18000,,
com.google.Chrome,938,1712027564,1712028502,1712028502.285657,-18000,,
com.google.Chrome,878,1712026685,1712027563,1712027563.379959,-18000,,
com.apple.Preview,79,1712026606,1712026685,1712026685.2439551,-18000,,
com.google.Chrome,520,1712026086,1712026606,1712026606.7580662,-18000,,
com.apple.Preview,137,1712025949,1712026086,1712026086.820836,-18000,,
com.google.Chrome,2,1712025947,1712025949,1712025949.633399,-18000,,
com.apple.Preview,18,1712025929,1712025947,1712025947.751492,-18000,,
com.google.Chrome,745,1712025184,1712025929,1712025929.572742,-18000,,
com.leomehlig.today,1,1712025183,1712025184,1712025184.461491,-18000,,
com.hnc.Discord,30,1712025153,1712025183,1712025183.152457,-18000,,
com.leomehlig.today,20,1712025133,1712025153,1712025154.01209,-18000,,
com.hnc.Discord,2,1712025131,1712025133,1712025133.689327,-18000,,
com.leomehlig.today,1,1712025130,1712025131,1712025133.316407,-18000,,
com.google.Chrome,4,1712025126,1712025130,1712025131.234617,-18000,,
com.google.Chrome,1212,1712017884,1712019096,1712019096.785898,-18000,,
com.google.Chrome,376,1712017492,1712017868,1712017868.3645458,-18000,,
com.hnc.Discord,41,1712017451,1712017492,1712017492.4222422,-18000,,
com.google.Chrome,823,1712016628,1712017451,1712017451.6724792,-18000,,
com.apple.Preview,141,1712016487,1712016628,1712016628.5817661,-18000,,
com.google.Chrome,2846,1712013641,1712016487,1712016487.16896,-18000,,
com.apple.Preview,15,1712013626,1712013641,1712013641.900387,-18000,,
com.apple.finder,2,1712013624,1712013626,1712013626.465651,-18000,,
com.google.Chrome,37,1712013587,1712013624,1712013624.6534472,-18000,,
com.apple.Preview,4,1712013583,1712013587,1712013587.797494,-18000,,
com.google.Chrome,7,1712013576,1712013583,1712013583.9094958,-18000,,
com.leomehlig.today,24,1712013552,1712013576,1712013576.48804,-18000,,
com.google.Chrome,35,1712013517,1712013552,1712013552.611782,-18000,,
com.google.Chrome,413,1712004509,1712004922,1712004922.36549,-18000,,
com.leomehlig.today,122,1712004387,1712004509,1712004509.97923,-18000,,
com.leomehlig.today,47,1712004121,1712004168,1712004168.756592,-18000,,
com.microsoft.Outlook,116,1712004005,1712004121,1712004121.348435,-18000,,
com.google.Chrome,7,1712003998,1712004005,1712004005.048455,-18000,,
com.leomehlig.today,16,1712003982,1712003998,1712003998.621836,-18000,,
com.leomehlig.today,52,1712003441,1712003493,1712003493.881665,-18000,,
com.google.Chrome,968,1712002473,1712003441,1712003441.986188,-18000,,
com.google.Chrome,1352,1712000477,1712001829,1712001829.934836,-18000,,
com.google.Chrome,802,1711999446,1712000248,1712000248.409648,-18000,,
com.apple.MobileSMS,10,1711999436,1711999446,1711999446.560431,-18000,,
com.google.Chrome,43,1711999393,1711999436,1711999436.451771,-18000,,
com.apple.MobileSMS,10,1711999383,1711999393,1711999393.237379,-18000,,
com.google.Chrome,2,1711999381,1711999383,1711999383.583562,-18000,,
com.leomehlig.today,3,1711999378,1711999381,1711999381.875509,-18000,,
com.google.Chrome,2,1711999376,1711999378,1711999378.1933599,-18000,,
com.leomehlig.today,9,1711999367,1711999376,1711999376.621656,-18000,,
com.google.Chrome,13,1711999354,1711999367,1711999367.847271,-18000,,
com.leomehlig.today,3,1711999351,1711999354,1711999354.838939,-18000,,
com.leomehlig.today,21,1711994378,1711994399,1711994399.917973,-18000,,
com.apple.Preview,1480,1711992898,1711994378,1711994378.929463,-18000,,
com.google.Chrome,9,1711992889,1711992898,1711992898.305258,-18000,,
com.apple.Preview,312,1711992577,1711992889,1711992889.229064,-18000,,
com.apple.finder,4,1711992573,1711992577,1711992577.535736,-18000,,
com.google.Chrome,114,1711992459,1711992573,1711992573.7769399,-18000,,
com.leomehlig.today,4,1711992441,1711992445,1711992446.654675,-18000,,
com.google.Chrome,5,1711992436,1711992441,1711992441.1146169,-18000,,
com.google.Chrome,18,1711989259,1711989277,1711989277.364728,-18000,,
com.apple.finder,3,1711989256,1711989259,1711989259.7791939,-18000,,
com.microsoft.Powerpoint,9,1711989247,1711989256,1711989256.452595,-18000,,
com.apple.finder,1,1711989246,1711989247,1711989247.2611651,-18000,,
com.microsoft.Powerpoint,66,1711989180,1711989246,1711989247.024596,-18000,,
com.apple.finder,4,1711989176,1711989180,1711989180.4320822,-18000,,
com.google.Chrome,46,1711989130,1711989176,1711989176.369585,-18000,,
com.apple.finder,18,1711989099,1711989117,1711989117.471187,-18000,,
com.google.Chrome,5,1711989094,1711989099,1711989099.08181,-18000,,
com.google.Chrome,160,1711988801,1711988961,1711988962.12496,-18000,,
com.leomehlig.today,13,1711988788,1711988801,1711988801.3158169,-18000,,
com.google.Chrome,1,1711988787,1711988788,1711988788.734916,-18000,,
com.leomehlig.today,10,1711988777,1711988787,1711988788.016511,-18000,,
com.google.Chrome,4,1711988773,1711988777,1711988778.0477018,-18000,,
com.leomehlig.today,5,1711988768,1711988773,1711988773.933372,-18000,,
com.google.Chrome,346,1711988422,1711988768,1711988768.9908838,-18000,,
com.google.Chrome,373,1711987988,1711988361,1711988361.016578,-18000,,
com.leomehlig.today,94,1711987894,1711987988,1711987988.987057,-18000,,
com.google.Chrome,150,1711987744,1711987894,1711987894.238142,-18000,,
com.leomehlig.today,21,1711987723,1711987744,1711987744.1368918,-18000,,
com.google.Chrome,2,1711987721,1711987723,1711987723.3149428,-18000,,
com.leomehlig.today,39,1711987682,1711987721,1711987721.391495,-18000,,
com.google.Chrome,6,1711987676,1711987682,1711987682.191584,-18000,,
com.leomehlig.today,1,1711987675,1711987676,1711987676.715633,-18000,,
com.google.Chrome,5,1711987670,1711987675,1711987675.881198,-18000,,
com.leomehlig.today,19,1711987651,1711987670,1711987670.74385,-18000,,
com.google.Chrome,4,1711987647,1711987651,1711987651.053175,-18000,,
com.leomehlig.today,14,1711987633,1711987647,1711987647.447098,-18000,,
com.google.Chrome,6,1711987627,1711987633,1711987633.32145,-18000,,
com.leomehlig.today,17,1711987610,1711987627,1711987627.8989,-18000,,
com.google.Chrome,2,1711987608,1711987610,1711987610.314836,-18000,,
com.leomehlig.today,2,1711987606,1711987608,1711987608.5637078,-18000,,
com.google.Chrome,101,1711987505,1711987606,1711987606.05614,-18000,,
com.leomehlig.today,52,1711987453,1711987505,1711987505.212435,-18000,,
com.google.Chrome,7,1711987446,1711987453,1711987453.522739,-18000,,
com.apple.iCal,55,1711987391,1711987446,1711987446.5037441,-18000,,
com.google.Chrome,252,1711987139,1711987391,1711987391.4197512,-18000,,
com.microsoft.Powerpoint,57,1711987082,1711987139,1711987140.008481,-18000,,
com.google.Chrome,22,1711987060,1711987082,1711987082.555654,-18000,,
com.apple.finder,16,1711987044,1711987060,1711987060.575387,-18000,,
com.google.Chrome,30,1711987014,1711987044,1711987044.566997,-18000,,
com.apple.finder,2,1711986990,1711986992,1711986998.17061,-18000,,
Astrospheric.Astrospheric,34,1711945456,1711945490,1711945490.6741018,-18000,EB445137-D7F5-57EC-87DA-1DB460D64046,"iPhone13,2"
com.apple.weather,21,1711945433,1711945454,1711945454.757112,-18000,EB445137-D7F5-57EC-87DA-1DB460D64046,"iPhone13,2"
com.apple.weather,81,1711945348,1711945429,1711945429.7696872,-18000,EB445137-D7F5-57EC-87DA-1DB460D64046,"iPhone13,2"
com.apple.journal,360,1711944987,1711945347,1711945347.9270148,-18000,EB445137-D7F5-57EC-87DA-1DB460D64046,"iPhone13,2"
com.apple.Health,25,1711944958,1711944983,1711944983.468962,-18000,EB445137-D7F5-57EC-87DA-1DB460D64046,"iPhone13,2"
com.microsoft.Office.Outlook,9,1711944933,1711944942,1711944942.462879,-18000,EB445137-D7F5-57EC-87DA-1DB460D64046,"iPhone13,2"
com.apple.mobiletimer,7,1711944925,1711944932,1711944932.568373,-18000,EB445137-D7F5-57EC-87DA-1DB460D64046,"iPhone13,2"
com.burbn.instagram,87,1711943065,1711943152,1711943152.531723,-18000,EB445137-D7F5-57EC-87DA-1DB460D64046,"iPhone13,2"
com.capp.poplive,19,1711940624,1711940643,1711940643.347832,-18000,EB445137-D7F5-57EC-87DA-1DB460D64046,"iPhone13,2"
com.apple.MobileSMS,3,1711940612,1711940615,1711940615.7089272,-18000,EB445137-D7F5-57EC-87DA-1DB460D64046,"iPhone13,2"
com.toyopagroup.picaboo,56,1711940555,1711940611,1711940611.974894,-18000,EB445137-D7F5-57EC-87DA-1DB460D64046,"iPhone13,2"
com.microsoft.Office.Outlook,77,1711940475,1711940552,1711940552.316134,-18000,EB445137-D7F5-57EC-87DA-1DB460D64046,"iPhone13,2"
com.strava.stravaride,123,1711940348,1711940471,1711940471.6983209,-18000,EB445137-D7F5-57EC-87DA-1DB460D64046,"iPhone13,2"
com.apple.MobileSMS,10,1711940338,1711940348,1711940349.23251,-18000,EB445137-D7F5-57EC-87DA-1DB460D64046,"iPhone13,2"
com.apple.MobileSMS,10,1711940064,1711940074,1711940074.607339,-18000,EB445137-D7F5-57EC-87DA-1DB460D64046,"iPhone13,2"
com.apple.MobileSMS,4,1711940001,1711940005,1711940005.668885,-18000,EB445137-D7F5-57EC-87DA-1DB460D64046,"iPhone13,2"
com.apple.MobileSMS,2,1711939063,1711939065,1711939065.921132,-18000,EB445137-D7F5-57EC-87DA-1DB460D64046,"iPhone13,2"
com.apple.MobileSMS,10,1711938945,1711938955,1711938955.681964,-18000,EB445137-D7F5-57EC-87DA-1DB460D64046,"iPhone13,2"
com.apple.MobileSMS,7,1711938920,1711938927,1711938927.911608,-18000,EB445137-D7F5-57EC-87DA-1DB460D64046,"iPhone13,2"
com.apple.MobileSMS,2,1711938761,1711938763,1711938763.925055,-18000,EB445137-D7F5-57EC-87DA-1DB460D64046,"iPhone13,2"
com.apple.MobileSMS,11,1711934680,1711934691,1711934691.979912,-18000,EB445137-D7F5-57EC-87DA-1DB460D64046,"iPhone13,2"
com.apple.MobileSMS,13,1711933755,1711933768,1711933768.905947,-18000,EB445137-D7F5-57EC-87DA-1DB460D64046,"iPhone13,2"
com.apple.MobileSMS,7,1711930657,1711930664,1711930664.1619282,-18000,EB445137-D7F5-57EC-87DA-1DB460D64046,"iPhone13,2"
com.apple.MobileSMS,11,1711928118,1711928129,1711928129.791212,-18000,EB445137-D7F5-57EC-87DA-1DB460D64046,"iPhone13,2"
com.apple.MobileSMS,4,1711927901,1711927905,1711927905.600234,-18000,EB445137-D7F5-57EC-87DA-1DB460D64046,"iPhone13,2"
com.apple.MobileSMS,7,1711927287,1711927294,1711927294.978698,-18000,EB445137-D7F5-57EC-87DA-1DB460D64046,"iPhone13,2"
com.apple.MobileSMS,10,1711927030,1711927040,1711927040.338079,-18000,EB445137-D7F5-57EC-87DA-1DB460D64046,"iPhone13,2"
com.apple.MobileSMS,31,1711926987,1711927018,1711927018.525183,-18000,EB445137-D7F5-57EC-87DA-1DB460D64046,"iPhone13,2"
com.apple.Maps,23,1711926715,1711926738,1711926738.653864,-18000,EB445137-D7F5-57EC-87DA-1DB460D64046,"iPhone13,2"
com.apple.Music,3,1711926710,1711926713,1711926714.833605,-18000,EB445137-D7F5-57EC-87DA-1DB460D64046,"iPhone13,2"
com.apple.Music,8,1711926697,1711926705,1711926705.569917,-18000,EB445137-D7F5-57EC-87DA-1DB460D64046,"iPhone13,2"
com.apple.Music,22,1711926638,1711926660,1711926660.851126,-18000,EB445137-D7F5-57EC-87DA-1DB460D64046,"iPhone13,2"
com.apple.MobileSMS,3,1711926631,1711926634,1711926634.129871,-18000,EB445137-D7F5-57EC-87DA-1DB460D64046,"iPhone13,2"
com.apple.MobileSMS,38,1711926593,1711926631,1711926631.191174,-18000,EB445137-D7F5-57EC-87DA-1DB460D64046,"iPhone13,2"
com.toyopagroup.picaboo,9,1711926575,1711926584,1711926584.581326,-18000,EB445137-D7F5-57EC-87DA-1DB460D64046,"iPhone13,2"
com.apple.Maps,3,1711926572,1711926575,1711926575.0635018,-18000,EB445137-D7F5-57EC-87DA-1DB460D64046,"iPhone13,2"
com.apple.Maps,6,1711926559,1711926565,1711926565.059241,-18000,EB445137-D7F5-57EC-87DA-1DB460D64046,"iPhone13,2"
com.apple.Maps,6,1711926519,1711926525,1711926525.731694,-18000,EB445137-D7F5-57EC-87DA-1DB460D64046,"iPhone13,2"
com.apple.Maps,7,1711926398,1711926405,1711926405.173517,-18000,EB445137-D7F5-57EC-87DA-1DB460D64046,"iPhone13,2"
com.apple.Maps,17,1711926035,1711926052,1711926052.3229342,-18000,EB445137-D7F5-57EC-87DA-1DB460D64046,"iPhone13,2"
com.capp.poplive,43,1711925373,1711925416,1711925416.0142798,-18000,EB445137-D7F5-57EC-87DA-1DB460D64046,"iPhone13,2"
com.apple.findmy,10,1711925321,1711925331,1711925331.8740659,-18000,EB445137-D7F5-57EC-87DA-1DB460D64046,"iPhone13,2"
com.apple.MobileSMS,27,1711925291,1711925318,1711925318.8262029,-18000,EB445137-D7F5-57EC-87DA-1DB460D64046,"iPhone13,2"
com.apple.finder,2,1711925243,1711925245,1711925245.854691,-18000,,
com.google.Chrome,2718,1711922525,1711925243,1711925243.2009292,-18000,,
com.apple.mobilephone,23,1711919590,1711919613,1711919613.5307899,-18000,EB445137-D7F5-57EC-87DA-1DB460D64046,"iPhone13,2"
com.apple.MobileSMS,2,1711919584,1711919586,1711919586.456202,-18000,EB445137-D7F5-57EC-87DA-1DB460D64046,"iPhone13,2"
com.apple.MobileSMS,22,1711919424,1711919446,1711919446.907535,-18000,EB445137-D7F5-57EC-87DA-1DB460D64046,"iPhone13,2"
com.microsoft.Office.Outlook,5,1711919419,1711919424,1711919424.2306042,-18000,EB445137-D7F5-57EC-87DA-1DB460D64046,"iPhone13,2"
com.microsoft.Office.Outlook,2,1711919363,1711919365,1711919365.810612,-18000,EB445137-D7F5-57EC-87DA-1DB460D64046,"iPhone13,2"
com.microsoft.Office.Outlook,45,1711919022,1711919067,1711919067.386338,-18000,EB445137-D7F5-57EC-87DA-1DB460D64046,"iPhone13,2"
com.apple.Maps,3,1711919019,1711919022,1711919022.967246,-18000,EB445137-D7F5-57EC-87DA-1DB460D64046,"iPhone13,2"
com.apple.Maps,3,1711917696,1711917699,1711917699.3937469,-18000,EB445137-D7F5-57EC-87DA-1DB460D64046,"iPhone13,2"
com.apple.Maps,6,1711914302,1711914308,1711914308.4245272,-18000,EB445137-D7F5-57EC-87DA-1DB460D64046,"iPhone13,2"
com.apple.Maps,11,1711914247,1711914258,1711914258.263128,-18000,EB445137-D7F5-57EC-87DA-1DB460D64046,"iPhone13,2"
com.apple.camera,5,1711914247,1711914252,1711914252.276854,-18000,EB445137-D7F5-57EC-87DA-1DB460D64046,"iPhone13,2"
com.apple.Maps,11,1711914225,1711914236,1711914236.079846,-18000,EB445137-D7F5-57EC-87DA-1DB460D64046,"iPhone13,2"
com.apple.Maps,20,1711914197,1711914217,1711914217.339416,-18000,EB445137-D7F5-57EC-87DA-1DB460D64046,"iPhone13,2"
com.apple.Maps,19,1711914162,1711914181,1711914181.1288118,-18000,EB445137-D7F5-57EC-87DA-1DB460D64046,"iPhone13,2"
com.apple.Maps,1,1711914157,1711914158,1711914158.5500488,-18000,EB445137-D7F5-57EC-87DA-1DB460D64046,"iPhone13,2"
com.google.chrome.ios,86,1711914064,1711914150,1711914150.763391,-18000,EB445137-D7F5-57EC-87DA-1DB460D64046,"iPhone13,2"
com.apple.mobilecal,2,1711914062,1711914064,1711914064.5611901,-18000,EB445137-D7F5-57EC-87DA-1DB460D64046,"iPhone13,2"
com.apple.mobilecal,2,1711913803,1711913805,1711913805.614474,-18000,EB445137-D7F5-57EC-87DA-1DB460D64046,"iPhone13,2"
com.apple.mobilecal,13,1711912080,1711912093,1711912093.962002,-18000,EB445137-D7F5-57EC-87DA-1DB460D64046,"iPhone13,2"
com.apple.findmy,2,1711912077,1711912079,1711912079.5257611,-18000,EB445137-D7F5-57EC-87DA-1DB460D64046,"iPhone13,2"
com.apple.findmy,19,1711910435,1711910454,1711910454.092176,-18000,EB445137-D7F5-57EC-87DA-1DB460D64046,"iPhone13,2"
com.apple.MobileSMS,2,1711909734,1711909736,1711909736.254549,-18000,EB445137-D7F5-57EC-87DA-1DB460D64046,"iPhone13,2"
com.apple.MobileSMS,12,1711909722,1711909734,1711909734.042433,-18000,EB445137-D7F5-57EC-87DA-1DB460D64046,"iPhone13,2"
com.apple.findmy,4,1711909718,1711909722,1711909722.798421,-18000,EB445137-D7F5-57EC-87DA-1DB460D64046,"iPhone13,2"
com.apple.findmy,15,1711909548,1711909563,1711909563.66706,-18000,EB445137-D7F5-57EC-87DA-1DB460D64046,"iPhone13,2"
com.apple.findmy,31,1711909180,1711909211,1711909212.672234,-18000,EB445137-D7F5-57EC-87DA-1DB460D64046,"iPhone13,2"
com.google.Chrome,1141,1711907162,1711908303,1711908304.248342,-18000,,
com.burbn.instagram,139,1711907021,1711907160,1711907160.769361,-18000,EB445137-D7F5-57EC-87DA-1DB460D64046,"iPhone13,2"
com.hammerandchisel.discord,32,1711906361,1711906393,1711906393.722894,-18000,EB445137-D7F5-57EC-87DA-1DB460D64046,"iPhone13,2"
com.microsoft.Office.Outlook,5,1711906350,1711906355,1711906355.129973,-18000,EB445137-D7F5-57EC-87DA-1DB460D64046,"iPhone13,2"
com.apple.MobileSMS,3,1711906345,1711906348,1711906348.611084,-18000,EB445137-D7F5-57EC-87DA-1DB460D64046,"iPhone13,2"
com.apple.podcasts,3,1711906339,1711906342,1711906342.208749,-18000,EB445137-D7F5-57EC-87DA-1DB460D64046,"iPhone13,2"
com.google.Chrome,500,1711906137,1711906637,1711906637.193832,-18000,,
com.apple.podcasts,61,1711906122,1711906183,1711906183.6320992,-18000,EB445137-D7F5-57EC-87DA-1DB460D64046,"iPhone13,2"
com.burbn.instagram,2,1711906119,1711906121,1711906121.5431771,-18000,EB445137-D7F5-57EC-87DA-1DB460D64046,"iPhone13,2"
com.burbn.instagram,29,1711905745,1711905774,1711905774.711236,-18000,EB445137-D7F5-57EC-87DA-1DB460D64046,"iPhone13,2"
com.google.Chrome,328,1711905621,1711905949,1711905949.3351932,-18000,,
com.google.Chrome,570,1711905047,1711905617,1711905617.228294,-18000,,
com.apple.Maps,152,1711904895,1711905047,1711905047.650982,-18000,,
com.google.Chrome,9,1711904886,1711904895,1711904895.052259,-18000,,
com.capp.poplive,2,1711904783,1711904785,1711904785.931581,-18000,EB445137-D7F5-57EC-87DA-1DB460D64046,"iPhone13,2"
com.markhambly.APOD,37,1711904739,1711904776,1711904776.902426,-18000,EB445137-D7F5-57EC-87DA-1DB460D64046,"iPhone13,2"
com.apple.news,146,1711904586,1711904732,1711904732.1176848,-18000,EB445137-D7F5-57EC-87DA-1DB460D64046,"iPhone13,2"
com.apple.MobileSMS,3,1711904572,1711904575,1711904575.357304,-18000,EB445137-D7F5-57EC-87DA-1DB460D64046,"iPhone13,2"
com.strava.stravaride,58,1711904514,1711904572,1711904572.6259918,-18000,EB445137-D7F5-57EC-87DA-1DB460D64046,"iPhone13,2"
com.apple.MobileSMS,25,1711904482,1711904507,1711904507.370779,-18000,EB445137-D7F5-57EC-87DA-1DB460D64046,"iPhone13,2"
com.toyopagroup.picaboo,171,1711904311,1711904482,1711904482.370593,-18000,EB445137-D7F5-57EC-87DA-1DB460D64046,"iPhone13,2"
com.apple.MobileSMS,11,1711904300,1711904311,1711904311.488933,-18000,EB445137-D7F5-57EC-87DA-1DB460D64046,"iPhone13,2"
com.toyopagroup.picaboo,3,1711904297,1711904300,1711904300.600676,-18000,EB445137-D7F5-57EC-87DA-1DB460D64046,"iPhone13,2"
com.toyopagroup.picaboo,22,1711904245,1711904267,1711904267.329222,-18000,EB445137-D7F5-57EC-87DA-1DB460D64046,"iPhone13,2"
com.apple.weather,12,1711904233,1711904245,1711904245.821778,-18000,EB445137-D7F5-57EC-87DA-1DB460D64046,"iPhone13,2"
com.capp.poplive,86,1711904147,1711904233,1711904233.1032882,-18000,EB445137-D7F5-57EC-87DA-1DB460D64046,"iPhone13,2"
com.capp.poplive,192,1711899954,1711900146,1711900146.7466412,-18000,EB445137-D7F5-57EC-87DA-1DB460D64046,"iPhone13,2"
com.google.chrome.ios,31,1711899923,1711899954,1711899954.8810391,-18000,EB445137-D7F5-57EC-87DA-1DB460D64046,"iPhone13,2"
com.apple.MobileSMS,9,1711899914,1711899923,1711899923.046496,-18000,EB445137-D7F5-57EC-87DA-1DB460D64046,"iPhone13,2"
com.google.chrome.ios,29,1711899885,1711899914,1711899914.145469,-18000,EB445137-D7F5-57EC-87DA-1DB460D64046,"iPhone13,2"
com.apple.MobileSMS,3,1711899882,1711899885,1711899885.118166,-18000,EB445137-D7F5-57EC-87DA-1DB460D64046,"iPhone13,2"
com.apple.MobileSMS,16,1711899857,1711899873,1711899873.0921159,-18000,EB445137-D7F5-57EC-87DA-1DB460D64046,"iPhone13,2"
com.apple.MobileSMS,18,1711899816,1711899834,1711899834.868701,-18000,EB445137-D7F5-57EC-87DA-1DB460D64046,"iPhone13,2"
com.burbn.instagram,270,1711891921,1711892191,1711892191.128602,-18000,EB445137-D7F5-57EC-87DA-1DB460D64046,"iPhone13,2"
com.apple.Preferences,29,1711891890,1711891919,1711891919.484571,-18000,EB445137-D7F5-57EC-87DA-1DB460D64046,"iPhone13,2"
com.burbn.instagram,8,1711891882,1711891890,1711891890.547076,-18000,EB445137-D7F5-57EC-87DA-1DB460D64046,"iPhone13,2"
com.apple.news,1,1711891877,1711891878,1711891878.735759,-18000,EB445137-D7F5-57EC-87DA-1DB460D64046,"iPhone13,2"
com.apple.Preferences,15,1711891855,1711891870,1711891870.0338058,-18000,EB445137-D7F5-57EC-87DA-1DB460D64046,"iPhone13,2"
com.apple.findmy,9,1711849661,1711849670,1711849670.246443,-18000,EB445137-D7F5-57EC-87DA-1DB460D64046,"iPhone13,2"
com.google.chrome.ios,3,1711849641,1711849644,1711849645.054203,-18000,EB445137-D7F5-57EC-87DA-1DB460D64046,"iPhone13,2"
com.google.chrome.ios,89,1711849548,1711849637,1711849637.46734,-18000,EB445137-D7F5-57EC-87DA-1DB460D64046,"iPhone13,2"
com.letterboxd.LetterboxdApp,24,1711849524,1711849548,1711849548.2886271,-18000,EB445137-D7F5-57EC-87DA-1DB460D64046,"iPhone13,2"
com.google.chrome.ios,41,1711849483,1711849524,1711849525.067183,-18000,EB445137-D7F5-57EC-87DA-1DB460D64046,"iPhone13,2"
com.google.Chrome,2,1711849364,1711849366,1711849366.5055609,-18000,,
com.google.Chrome,2,1711849360,1711849362,1711849362.972176,-18000,,
com.apple.findmy,9,1711849330,1711849339,1711849340.108903,-18000,EB445137-D7F5-57EC-87DA-1DB460D64046,"iPhone13,2"
com.apple.MobileSMS,3,1711849326,1711849329,1711849330.318955,-18000,EB445137-D7F5-57EC-87DA-1DB460D64046,"iPhone13,2"
com.letterboxd.LetterboxdApp,2,1711849324,1711849326,1711849326.659317,-18000,EB445137-D7F5-57EC-87DA-1DB460D64046,"iPhone13,2"
com.google.Chrome,481,1711848655,1711849136,1711849136.789999,-18000,,
com.leomehlig.today,22,1711848633,1711848655,1711848655.679017,-18000,,
com.letterboxd.LetterboxdApp,1,1711848563,1711848564,1711848564.4228702,-18000,EB445137-D7F5-57EC-87DA-1DB460D64046,"iPhone13,2"
com.letterboxd.LetterboxdApp,49,1711848470,1711848519,1711848519.592555,-18000,EB445137-D7F5-57EC-87DA-1DB460D64046,"iPhone13,2"
com.apple.findmy,6,1711848464,1711848470,1711848470.4648619,-18000,EB445137-D7F5-57EC-87DA-1DB460D64046,"iPhone13,2"
com.apple.Maps,6,1711848458,1711848464,1711848464.160871,-18000,EB445137-D7F5-57EC-87DA-1DB460D64046,"iPhone13,2"
com.google.Chrome,198,1711848435,1711848633,1711848633.6335502,-18000,,
com.apple.Maps,55,1711848345,1711848400,1711848400.4545631,-18000,EB445137-D7F5-57EC-87DA-1DB460D64046,"iPhone13,2"
com.apple.news,2,1711848343,1711848345,1711848345.2792711,-18000,EB445137-D7F5-57EC-87DA-1DB460D64046,"iPhone13,2"
com.apple.news,506,1711847785,1711848291,1711848292.051297,-18000,EB445137-D7F5-57EC-87DA-1DB460D64046,"iPhone13,2"
com.apple.findmy,6,1711847767,1711847773,1711847773.862926,-18000,EB445137-D7F5-57EC-87DA-1DB460D64046,"iPhone13,2"
com.apple.Music,61,1711847700,1711847761,1711847761.82975,-18000,EB445137-D7F5-57EC-87DA-1DB460D64046,"iPhone13,2"
com.burbn.instagram,15,1711847673,1711847688,1711847688.9095469,-18000,EB445137-D7F5-57EC-87DA-1DB460D64046,"iPhone13,2"
com.apple.MobileSMS,102,1711847558,1711847660,1711847660.516046,-18000,EB445137-D7F5-57EC-87DA-1DB460D64046,"iPhone13,2"
com.apple.findmy,11,1711847546,1711847557,1711847558.089795,-18000,EB445137-D7F5-57EC-87DA-1DB460D64046,"iPhone13,2"
com.apple.MobileSMS,5,1711847540,1711847545,1711847546.378169,-18000,EB445137-D7F5-57EC-87DA-1DB460D64046,"iPhone13,2"
com.letterboxd.LetterboxdApp,165,1711847374,1711847539,1711847539.210618,-18000,EB445137-D7F5-57EC-87DA-1DB460D64046,"iPhone13,2"
com.letterboxd.LetterboxdApp,51,1711847310,1711847361,1711847361.1091719,-18000,EB445137-D7F5-57EC-87DA-1DB460D64046,"iPhone13,2"
com.apple.MobileSMS,2,1711847306,1711847308,1711847308.761317,-18000,EB445137-D7F5-57EC-87DA-1DB460D64046,"iPhone13,2"
com.apple.findmy,31,1711847273,1711847304,1711847304.935369,-18000,EB445137-D7F5-57EC-87DA-1DB460D64046,"iPhone13,2"
com.apple.findmy,3,1711847268,1711847271,1711847271.9041471,-18000,EB445137-D7F5-57EC-87DA-1DB460D64046,"iPhone13,2"
com.apple.findmy,12,1711846603,1711846615,1711846615.8810282,-18000,EB445137-D7F5-57EC-87DA-1DB460D64046,"iPhone13,2"
com.toyopagroup.picaboo,25,1711846571,1711846596,1711846596.2437139,-18000,EB445137-D7F5-57EC-87DA-1DB460D64046,"iPhone13,2"
com.apple.MobileSMS,3,1711846568,1711846571,1711846572.073151,-18000,EB445137-D7F5-57EC-87DA-1DB460D64046,"iPhone13,2"
com.apple.MobileSMS,13,1711839640,1711839653,1711839653.995285,-18000,EB445137-D7F5-57EC-87DA-1DB460D64046,"iPhone13,2"
com.apple.MobileSMS,14,1711839606,1711839620,1711839620.421242,-18000,EB445137-D7F5-57EC-87DA-1DB460D64046,"iPhone13,2"
com.apple.MobileSMS,26,1711839578,1711839604,1711839604.875019,-18000,EB445137-D7F5-57EC-87DA-1DB460D64046,"iPhone13,2"
com.apple.MobileSMS,30,1711839528,1711839558,1711839558.608276,-18000,EB445137-D7F5-57EC-87DA-1DB460D64046,"iPhone13,2"
com.apple.MobileSMS,7,1711839472,1711839479,1711839479.044141,-18000,EB445137-D7F5-57EC-87DA-1DB460D64046,"iPhone13,2"
com.apple.MobileSMS,3,1711839469,1711839472,1711839472.383829,-18000,EB445137-D7F5-57EC-87DA-1DB460D64046,"iPhone13,2"
com.toyopagroup.picaboo,6,1711838863,1711838869,1711838869.247208,-18000,EB445137-D7F5-57EC-87DA-1DB460D64046,"iPhone13,2"
com.apple.MobileSMS,3,1711838860,1711838863,1711838864.946237,-18000,EB445137-D7F5-57EC-87DA-1DB460D64046,"iPhone13,2"
com.apple.MobileSMS,48,1711838696,1711838744,1711838744.3151321,-18000,EB445137-D7F5-57EC-87DA-1DB460D64046,"iPhone13,2"
com.toyopagroup.picaboo,31,1711838665,1711838696,1711838696.822787,-18000,EB445137-D7F5-57EC-87DA-1DB460D64046,"iPhone13,2"
com.apple.findmy,6,1711838657,1711838663,1711838663.349286,-18000,EB445137-D7F5-57EC-87DA-1DB460D64046,"iPhone13,2"
com.toyopagroup.picaboo,7,1711838649,1711838656,1711838657.575333,-18000,EB445137-D7F5-57EC-87DA-1DB460D64046,"iPhone13,2"
com.apple.Music,4,1711838644,1711838648,1711838648.586344,-18000,EB445137-D7F5-57EC-87DA-1DB460D64046,"iPhone13,2"
com.apple.Music,46,1711838386,1711838432,1711838432.980377,-18000,EB445137-D7F5-57EC-87DA-1DB460D64046,"iPhone13,2"
com.apple.Music,419,1711837960,1711838379,1711838379.0678658,-18000,EB445137-D7F5-57EC-87DA-1DB460D64046,"iPhone13,2"
com.apple.Music,15,1711837667,1711837682,1711837682.2566319,-18000,EB445137-D7F5-57EC-87DA-1DB460D64046,"iPhone13,2"
com.strava.stravaride,11,1711835805,1711835816,1711835816.7496939,-18000,EB445137-D7F5-57EC-87DA-1DB460D64046,"iPhone13,2"
com.google.Chrome,3,1711835628,1711835631,1711835631.350918,-18000,,
com.google.Chrome,822,1711834806,1711835628,1711835628.463019,-18000,,
com.google.Chrome,300,1711834275,1711834575,1711834575.5136042,-18000,,
com.google.Chrome,430,1711833560,1711833990,1711833990.361531,-18000,,
com.google.ios.youtube,1705,1711831826,1711833531,1711833531.377777,-18000,EB445137-D7F5-57EC-87DA-1DB460D64046,"iPhone13,2"
com.thestorygraph.thestorygraph,139,1711831626,1711831765,1711831765.3569288,-18000,EB445137-D7F5-57EC-87DA-1DB460D64046,"iPhone13,2"
com.robinhood.release.Robinhood,2,1711831618,1711831620,1711831620.77805,-18000,EB445137-D7F5-57EC-87DA-1DB460D64046,"iPhone13,2"
com.robinhood.release.Robinhood,6,1711827834,1711827840,1711827840.739972,-18000,EB445137-D7F5-57EC-87DA-1DB460D64046,"iPhone13,2"
com.robinhood.release.Robinhood,62,1711827769,1711827831,1711827832.726968,-18000,EB445137-D7F5-57EC-87DA-1DB460D64046,"iPhone13,2"
com.apple.Health,105,1711827656,1711827761,1711827761.794011,-18000,EB445137-D7F5-57EC-87DA-1DB460D64046,"iPhone13,2"
com.burbn.instagram,12,1711827633,1711827645,1711827646.280254,-18000,EB445137-D7F5-57EC-87DA-1DB460D64046,"iPhone13,2"
com.strava.stravaride,3,1711827629,1711827632,1711827632.973187,-18000,EB445137-D7F5-57EC-87DA-1DB460D64046,"iPhone13,2"
com.google.Chrome,326,1711827556,1711827882,1711827882.438479,-18000,,
com.microsoft.VSCode,7,1711827549,1711827556,1711827557.0899858,-18000,,
com.leomehlig.today,28,1711827521,1711827549,1711827549.6193771,-18000,,
com.microsoft.VSCode,296,1711827225,1711827521,1711827521.807702,-18000,,
com.google.Chrome,29,1711827196,1711827225,1711827225.275322,-18000,,
com.microsoft.VSCode,212,1711826984,1711827196,1711827196.601066,-18000,,
com.google.Chrome,48,1711826936,1711826984,1711826984.35631,-18000,,
com.microsoft.VSCode,220,1711826716,1711826936,1711826936.351711,-18000,,
com.google.Chrome,12,1711826704,1711826716,1711826716.129043,-18000,,
com.microsoft.VSCode,426,1711826278,1711826704,1711826704.620261,-18000,,
com.leomehlig.today,5,1711826273,1711826278,1711826278.994872,-18000,,
com.microsoft.VSCode,2,1711826271,1711826273,1711826273.295826,-18000,,
com.leomehlig.today,14,1711826257,1711826271,1711826271.6673741,-18000,,
com.microsoft.VSCode,214,1711826043,1711826257,1711826257.99068,-18000,,
com.google.Chrome,189,1711825854,1711826043,1711826043.377935,-18000,,
com.apple.news,200,1711825646,1711825846,1711825846.7604241,-18000,EB445137-D7F5-57EC-87DA-1DB460D64046,"iPhone13,2"
com.google.Chrome,348,1711825494,1711825842,1711825842.8134751,-18000,,
com.microsoft.VSCode,2,1711825492,1711825494,1711825494.443542,-18000,,
com.google.Chrome,0,1711825492,1711825492,1711825492.750148,-18000,,
com.microsoft.VSCode,59,1711825433,1711825492,1711825492.2988,-18000,,
com.google.Chrome,89,1711825344,1711825433,1711825433.765737,-18000,,
com.microsoft.VSCode,7,1711825337,1711825344,1711825345.0361838,-18000,,
com.strava.stravaride,56,1711825281,1711825337,1711825337.726839,-18000,EB445137-D7F5-57EC-87DA-1DB460D64046,"iPhone13,2"
com.apple.PosterBoard,2,1711825278,1711825280,1711825281.016705,-18000,EB445137-D7F5-57EC-87DA-1DB460D64046,"iPhone13,2"
com.microsoft.VSCode,462,1711824813,1711825275,1711825275.0516028,-18000,,
com.google.Chrome,2,1711824811,1711824813,1711824813.1257281,-18000,,
com.microsoft.VSCode,3,1711824808,1711824811,1711824811.7137032,-18000,,
com.google.Chrome,1,1711824807,1711824808,1711824808.1300569,-18000,,
com.microsoft.VSCode,9,1711824798,1711824807,1711824807.1638489,-18000,,
com.google.Chrome,21,1711824777,1711824798,1711824798.727514,-18000,,
com.microsoft.VSCode,3,1711824774,1711824777,1711824777.586082,-18000,,
com.google.Chrome,5,1711824769,1711824774,1711824774.1593208,-18000,,
com.microsoft.VSCode,1,1711824768,1711824769,1711824769.9317079,-18000,,
com.google.Chrome,5,1711824763,1711824768,1711824768.504683,-18000,,
com.microsoft.VSCode,0,1711824763,1711824763,1711824764.015815,-18000,,
com.google.Chrome,2,1711824761,1711824763,1711824763.067953,-18000,,
com.microsoft.VSCode,6,1711824755,1711824761,1711824761.335069,-18000,,
com.google.Chrome,8,1711824747,1711824755,1711824755.830319,-18000,,
com.microsoft.VSCode,15,1711824732,1711824747,1711824747.3100939,-18000,,
com.google.Chrome,7,1711824725,1711824732,1711824732.368371,-18000,,
com.microsoft.VSCode,1,1711824724,1711824725,1711824725.768409,-18000,,
com.google.Chrome,2,1711824722,1711824724,1711824724.7914948,-18000,,
com.microsoft.VSCode,4,1711824718,1711824722,1711824722.9477692,-18000,,
com.google.Chrome,1,1711824717,1711824718,1711824718.793819,-18000,,
com.microsoft.VSCode,3,1711824714,1711824717,1711824717.0693479,-18000,,
com.google.Chrome,3,1711824711,1711824714,1711824714.750674,-18000,,
com.microsoft.VSCode,10,1711824701,1711824711,1711824712.0420341,-18000,,
com.google.Chrome,100,1711824601,1711824701,1711824701.892755,-18000,,
com.microsoft.VSCode,48,1711824553,1711824601,1711824602.001124,-18000,,
com.google.Chrome,91,1711824462,1711824553,1711824553.50283,-18000,,
com.microsoft.VSCode,100,1711824362,1711824462,1711824462.9122791,-18000,,
com.google.Chrome,2,1711824360,1711824362,1711824362.2279139,-18000,,
com.microsoft.VSCode,6,1711824354,1711824360,1711824360.745856,-18000,,
com.google.Chrome,10,1711824344,1711824354,1711824354.330274,-18000,,
com.microsoft.VSCode,21,1711824323,1711824344,1711824344.681446,-18000,,
com.google.Chrome,2,1711824321,1711824323,1711824323.7010798,-18000,,
com.microsoft.VSCode,1,1711824320,1711824321,1711824321.7787051,-18000,,
com.google.Chrome,5,1711824315,1711824320,1711824320.584494,-18000,,
com.microsoft.VSCode,5,1711824310,1711824315,1711824315.390421,-18000,,
com.google.Chrome,16,1711824294,1711824310,1711824310.4254909,-18000,,
com.microsoft.VSCode,6,1711824288,1711824294,1711824294.636932,-18000,,
com.google.Chrome,15,1711824273,1711824288,1711824288.044395,-18000,,
com.microsoft.VSCode,82,1711824191,1711824273,1711824274.046716,-18000,,
com.google.Chrome,33,1711824158,1711824191,1711824191.654118,-18000,,
com.microsoft.VSCode,20,1711824138,1711824158,1711824158.306853,-18000,,
com.google.Chrome,7,1711824131,1711824138,1711824138.441561,-18000,,
com.microsoft.VSCode,8,1711824123,1711824131,1711824131.4996948,-18000,,
com.google.Chrome,2,1711824121,1711824123,1711824123.2078462,-18000,,
com.microsoft.VSCode,6,1711824115,1711824121,1711824121.906764,-18000,,
com.google.Chrome,8,1711824107,1711824115,1711824116.033457,-18000,,
com.microsoft.VSCode,8,1711824099,1711824107,1711824107.4865289,-18000,,
com.google.Chrome,1,1711824098,1711824099,1711824099.3353071,-18000,,
com.microsoft.VSCode,10,1711824088,1711824098,1711824098.798975,-18000,,
com.google.Chrome,6,1711824082,1711824088,1711824088.488264,-18000,,
com.microsoft.VSCode,5,1711824077,1711824082,1711824082.900029,-18000,,
com.google.Chrome,2,1711824075,1711824077,1711824077.736381,-18000,,
com.microsoft.VSCode,27,1711824048,1711824075,1711824075.7633,-18000,,
com.google.Chrome,32,1711824016,1711824048,1711824048.495335,-18000,,
com.microsoft.VSCode,338,1711823678,1711824016,1711824016.9034328,-18000,,
com.google.Chrome,7,1711823671,1711823678,1711823678.8129811,-18000,,
com.microsoft.VSCode,21,1711823650,1711823671,1711823671.4965959,-18000,,
com.google.Chrome,6,1711823644,1711823650,1711823650.144388,-18000,,
com.microsoft.VSCode,19,1711823625,1711823644,1711823644.523786,-18000,,
com.google.Chrome,5,1711823620,1711823625,1711823625.212424,-18000,,
com.microsoft.VSCode,2,1711823618,1711823620,1711823620.3567839,-18000,,
com.google.Chrome,6,1711823612,1711823618,1711823618.189389,-18000,,
com.microsoft.VSCode,1,1711823611,1711823612,1711823612.976482,-18000,,
com.google.Chrome,1,1711823610,1711823611,1711823611.253483,-18000,,
com.leomehlig.today,1,1711823609,1711823610,1711823610.6869102,-18000,,
com.google.Chrome,13,1711823596,1711823609,1711823609.632865,-18000,,
com.leomehlig.today,16,1711823580,1711823596,1711823596.602273,-18000,,
com.google.Chrome,2,1711823578,1711823580,1711823580.8957229,-18000,,
com.google.ios.youtube,2076,1711821471,1711823547,1711823547.21578,-18000,EB445137-D7F5-57EC-87DA-1DB460D64046,"iPhone13,2"
com.apple.PosterBoard,0,1711821468,1711821468,1711821468.972367,-18000,EB445137-D7F5-57EC-87DA-1DB460D64046,"iPhone13,2"
com.google.Chrome,304,1711821444,1711821748,1711821748.884253,-18000,,
com.microsoft.VSCode,7,1711821437,1711821444,1711821444.720138,-18000,,
com.google.Chrome,252,1711821185,1711821437,1711821437.307756,-18000,,
com.apple.MobileSMS,44,1711821141,1711821185,1711821185.1273909,-18000,,
com.google.Chrome,41,1711821100,1711821141,1711821141.260253,-18000,,
com.microsoft.VSCode,1245,1711819841,1711821086,1711821087.481505,-18000,,
com.leomehlig.today,37,1711819804,1711819841,1711819841.838351,-18000,,
com.google.Chrome,75,1711819729,1711819804,1711819804.587646,-18000,,
com.toyopagroup.picaboo,23,1711819549,1711819572,1711819572.765181,-18000,EB445137-D7F5-57EC-87DA-1DB460D64046,"iPhone13,2"
com.toyopagroup.picaboo,5,1711819363,1711819368,1711819368.3737168,-18000,EB445137-D7F5-57EC-87DA-1DB460D64046,"iPhone13,2"
com.burbn.instagram,10,1711819344,1711819354,1711819354.53863,-18000,EB445137-D7F5-57EC-87DA-1DB460D64046,"iPhone13,2"
com.toyopagroup.picaboo,4,1711819336,1711819340,1711819340.683013,-18000,EB445137-D7F5-57EC-87DA-1DB460D64046,"iPhone13,2"
com.toyopagroup.picaboo,38,1711819293,1711819331,1711819331.862895,-18000,EB445137-D7F5-57EC-87DA-1DB460D64046,"iPhone13,2"
com.google.ios.youtube,26,1711819264,1711819290,1711819290.836776,-18000,EB445137-D7F5-57EC-87DA-1DB460D64046,"iPhone13,2"
com.strava.stravaride,3,1711819260,1711819263,1711819263.759107,-18000,EB445137-D7F5-57EC-87DA-1DB460D64046,"iPhone13,2"
com.strava.stravaride,167,1711818342,1711818509,1711818509.620875,-18000,EB445137-D7F5-57EC-87DA-1DB460D64046,"iPhone13,2"
com.microsoft.Office.Outlook,29,1711818277,1711818306,1711818306.378533,-18000,EB445137-D7F5-57EC-87DA-1DB460D64046,"iPhone13,2"
com.apple.MobileSMS,5,1711818272,1711818277,1711818277.8365831,-18000,EB445137-D7F5-57EC-87DA-1DB460D64046,"iPhone13,2"
com.google.Chrome,1685,1711818020,1711819705,1711819705.5696192,-18000,,
com.apple.MobileSMS,3,1711817847,1711817850,1711817850.715708,-18000,EB445137-D7F5-57EC-87DA-1DB460D64046,"iPhone13,2"
com.apple.Health,4,1711817843,1711817847,1711817847.266901,-18000,EB445137-D7F5-57EC-87DA-1DB460D64046,"iPhone13,2"
com.apple.iCal,8,1711817727,1711817735,1711817735.217904,-18000,,
com.apple.Health,24,1711817688,1711817712,1711817712.9615831,-18000,EB445137-D7F5-57EC-87DA-1DB460D64046,"iPhone13,2"
com.truebill.truebillnative,25,1711817033,1711817058,1711817058.922882,-18000,EB445137-D7F5-57EC-87DA-1DB460D64046,"iPhone13,2"
com.truebill.truebillnative,138,1711816895,1711817033,1711817033.276046,-18000,EB445137-D7F5-57EC-87DA-1DB460D64046,"iPhone13,2"
com.clairmail.fth.client,24,1711816869,1711816893,1711816893.892291,-18000,EB445137-D7F5-57EC-87DA-1DB460D64046,"iPhone13,2"
com.moodle.moodlemobile,3,1711816863,1711816866,1711816866.756362,-18000,EB445137-D7F5-57EC-87DA-1DB460D64046,"iPhone13,2"
com.moodle.moodlemobile,9,1711816279,1711816288,1711816288.13393,-18000,EB445137-D7F5-57EC-87DA-1DB460D64046,"iPhone13,2"
com.apple.findmy,5,1711816274,1711816279,1711816280.798948,-18000,EB445137-D7F5-57EC-87DA-1DB460D64046,"iPhone13,2"
com.apple.findmy,6,1711813740,1711813746,1711813746.4499469,-18000,EB445137-D7F5-57EC-87DA-1DB460D64046,"iPhone13,2"
com.apple.findmy,7,1711813666,1711813673,1711813674.057807,-18000,EB445137-D7F5-57EC-87DA-1DB460D64046,"iPhone13,2"
com.toyopagroup.picaboo,25,1711813281,1711813306,1711813306.427495,-18000,EB445137-D7F5-57EC-87DA-1DB460D64046,"iPhone13,2"
com.apple.MobileSMS,13,1711813268,1711813281,1711813281.2680612,-18000,EB445137-D7F5-57EC-87DA-1DB460D64046,"iPhone13,2"
com.apple.MobileSMS,7,1711813259,1711813266,1711813266.569295,-18000,EB445137-D7F5-57EC-87DA-1DB460D64046,"iPhone13,2"
com.apple.MobileSMS,1,1711813224,1711813225,1711813226.1054258,-18000,EB445137-D7F5-57EC-87DA-1DB460D64046,"iPhone13,2"
com.apple.findmy,6,1711813218,1711813224,1711813224.450705,-18000,EB445137-D7F5-57EC-87DA-1DB460D64046,"iPhone13,2"
com.apple.findmy,10,1711813159,1711813169,1711813169.22349,-18000,EB445137-D7F5-57EC-87DA-1DB460D64046,"iPhone13,2"
com.apple.PosterBoard,1,1711813157,1711813158,1711813158.88095,-18000,EB445137-D7F5-57EC-87DA-1DB460D64046,"iPhone13,2"
com.apple.findmy,3,1711813156,1711813159,1711813159.868711,-18000,EB445137-D7F5-57EC-87DA-1DB460D64046,"iPhone13,2"
com.apple.findmy,10,1711813095,1711813105,1711813105.821443,-18000,EB445137-D7F5-57EC-87DA-1DB460D64046,"iPhone13,2"
com.apple.findmy,5,1711813031,1711813036,1711813036.85185,-18000,EB445137-D7F5-57EC-87DA-1DB460D64046,"iPhone13,2"
com.apple.MobileSMS,2,1711813029,1711813031,1711813031.3935971,-18000,EB445137-D7F5-57EC-87DA-1DB460D64046,"iPhone13,2"
com.apple.MobileSMS,7,1711812977,1711812984,1711812984.671935,-18000,EB445137-D7F5-57EC-87DA-1DB460D64046,"iPhone13,2"
com.apple.findmy,8,1711812969,1711812977,1711812977.571295,-18000,EB445137-D7F5-57EC-87DA-1DB460D64046,"iPhone13,2"
com.apple.findmy,4,1711812909,1711812913,1711812913.34905,-18000,EB445137-D7F5-57EC-87DA-1DB460D64046,"iPhone13,2"
com.apple.MobileSMS,5,1711812904,1711812909,1711812909.845526,-18000,EB445137-D7F5-57EC-87DA-1DB460D64046,"iPhone13,2"
com.apple.MobileSMS,8,1711812847,1711812855,1711812855.6924791,-18000,EB445137-D7F5-57EC-87DA-1DB460D64046,"iPhone13,2"
com.apple.MobileSMS,10,1711812727,1711812737,1711812737.7275739,-18000,EB445137-D7F5-57EC-87DA-1DB460D64046,"iPhone13,2"
com.apple.MobileSMS,12,1711812616,1711812628,1711812628.889967,-18000,EB445137-D7F5-57EC-87DA-1DB460D64046,"iPhone13,2"
com.apple.MobileSMS,68,1711812523,1711812591,1711812591.2778568,-18000,EB445137-D7F5-57EC-87DA-1DB460D64046,"iPhone13,2"
com.burbn.instagram,15,1711812508,1711812523,1711812523.669384,-18000,EB445137-D7F5-57EC-87DA-1DB460D64046,"iPhone13,2"
com.facebook.Facebook,5,1711812502,1711812507,1711812507.8070478,-18000,EB445137-D7F5-57EC-87DA-1DB460D64046,"iPhone13,2"
com.apple.findmy,5,1711812497,1711812502,1711812502.304471,-18000,EB445137-D7F5-57EC-87DA-1DB460D64046,"iPhone13,2"
com.apple.MobileSMS,8,1711812489,1711812497,1711812497.908049,-18000,EB445137-D7F5-57EC-87DA-1DB460D64046,"iPhone13,2"
com.apple.Maps,10,1711811162,1711811172,1711811172.32535,-18000,EB445137-D7F5-57EC-87DA-1DB460D64046,"iPhone13,2"
com.apple.findmy,4,1711811157,1711811161,1711811161.926017,-18000,EB445137-D7F5-57EC-87DA-1DB460D64046,"iPhone13,2"
com.apple.findmy,5,1711810695,1711810700,1711810700.969339,-18000,EB445137-D7F5-57EC-87DA-1DB460D64046,"iPhone13,2"
com.apple.findmy,18,1711808300,1711808318,1711808318.5821218,-18000,EB445137-D7F5-57EC-87DA-1DB460D64046,"iPhone13,2"
com.apple.findmy,2,1711807971,1711807973,1711807973.2577991,-18000,EB445137-D7F5-57EC-87DA-1DB460D64046,"iPhone13,2"
com.apple.findmy,30,1711807875,1711807905,1711807905.638596,-18000,EB445137-D7F5-57EC-87DA-1DB460D64046,"iPhone13,2"
com.apple.findmy,6,1711807857,1711807863,1711807863.325416,-18000,EB445137-D7F5-57EC-87DA-1DB460D64046,"iPhone13,2"
com.apple.findmy,8,1711807520,1711807528,1711807528.7034721,-18000,EB445137-D7F5-57EC-87DA-1DB460D64046,"iPhone13,2"
com.apple.weather,4,1711807516,1711807520,1711807520.2358232,-18000,EB445137-D7F5-57EC-87DA-1DB460D64046,"iPhone13,2"
com.apple.weather,62,1711807383,1711807445,1711807445.567033,-18000,EB445137-D7F5-57EC-87DA-1DB460D64046,"iPhone13,2"
com.apple.findmy,9,1711805499,1711805508,1711805508.661576,-18000,EB445137-D7F5-57EC-87DA-1DB460D64046,"iPhone13,2"
com.apple.iCal,23,1711763410,1711763433,1711763433.0944881,-18000,,
com.apple.iCal,305,1711762636,1711762941,1711762941.072047,-18000,,
com.apple.finder,261,1711762375,1711762636,1711762636.5013208,-18000,,
com.apple.findmy,18,1711760181,1711760199,1711760200.0104442,-18000,EB445137-D7F5-57EC-87DA-1DB460D64046,"iPhone13,2"
com.apple.findmy,8,1711759972,1711759980,1711759980.87956,-18000,EB445137-D7F5-57EC-87DA-1DB460D64046,"iPhone13,2"
com.apple.findmy,14,1711759800,1711759814,1711759814.610827,-18000,EB445137-D7F5-57EC-87DA-1DB460D64046,"iPhone13,2"
com.apple.findmy,11,1711759446,1711759457,1711759457.235676,-18000,EB445137-D7F5-57EC-87DA-1DB460D64046,"iPhone13,2"
com.apple.findmy,9,1711759297,1711759306,1711759306.447757,-18000,EB445137-D7F5-57EC-87DA-1DB460D64046,"iPhone13,2"
com.apple.findmy,11,1711758884,1711758895,1711758895.5309029,-18000,EB445137-D7F5-57EC-87DA-1DB460D64046,"iPhone13,2"
com.apple.findmy,12,1711758471,1711758483,1711758483.8732219,-18000,EB445137-D7F5-57EC-87DA-1DB460D64046,"iPhone13,2"
com.apple.findmy,14,1711758309,1711758323,1711758324.087395,-18000,EB445137-D7F5-57EC-87DA-1DB460D64046,"iPhone13,2"
com.thestorygraph.thestorygraph,4,1711758304,1711758308,1711758308.2009668,-18000,EB445137-D7F5-57EC-87DA-1DB460D64046,"iPhone13,2"
com.thestorygraph.thestorygraph,33,1711758255,1711758288,1711758288.163241,-18000,EB445137-D7F5-57EC-87DA-1DB460D64046,"iPhone13,2"
com.apple.findmy,2,1711758247,1711758249,1711758250.738733,-18000,EB445137-D7F5-57EC-87DA-1DB460D64046,"iPhone13,2"
com.apple.findmy,4,1711757844,1711757848,1711757848.814182,-18000,EB445137-D7F5-57EC-87DA-1DB460D64046,"iPhone13,2"
com.apple.MobileSMS,4,1711757465,1711757469,1711757469.2405062,-18000,EB445137-D7F5-57EC-87DA-1DB460D64046,"iPhone13,2"
com.hammerandchisel.discord,57,1711757408,1711757465,1711757465.2423968,-18000,EB445137-D7F5-57EC-87DA-1DB460D64046,"iPhone13,2"
com.instructure.icanvas,50,1711757357,1711757407,1711757407.1204019,-18000,EB445137-D7F5-57EC-87DA-1DB460D64046,"iPhone13,2"
com.apple.calculator,5,1711757352,1711757357,1711757357.8098888,-18000,EB445137-D7F5-57EC-87DA-1DB460D64046,"iPhone13,2"
com.instructure.icanvas,12,1711757340,1711757352,1711757352.3798242,-18000,EB445137-D7F5-57EC-87DA-1DB460D64046,"iPhone13,2"
com.apple.findmy,3,1711757337,1711757340,1711757340.909491,-18000,EB445137-D7F5-57EC-87DA-1DB460D64046,"iPhone13,2"
com.apple.findmy,6,1711756860,1711756866,1711756866.512144,-18000,EB445137-D7F5-57EC-87DA-1DB460D64046,"iPhone13,2"
com.apple.MobileSMS,6,1711756854,1711756860,1711756860.180523,-18000,EB445137-D7F5-57EC-87DA-1DB460D64046,"iPhone13,2"
com.apple.MobileSMS,6,1711756746,1711756752,1711756752.418304,-18000,EB445137-D7F5-57EC-87DA-1DB460D64046,"iPhone13,2"
com.apple.MobileSMS,7,1711756735,1711756742,1711756742.627915,-18000,EB445137-D7F5-57EC-87DA-1DB460D64046,"iPhone13,2"
com.apple.MobileSMS,9,1711755642,1711755651,1711755651.414974,-18000,EB445137-D7F5-57EC-87DA-1DB460D64046,"iPhone13,2"
com.apple.MobileSMS,44,1711755568,1711755612,1711755612.0717869,-18000,EB445137-D7F5-57EC-87DA-1DB460D64046,"iPhone13,2"
com.apple.weather,2,1711755566,1711755568,1711755568.733129,-18000,EB445137-D7F5-57EC-87DA-1DB460D64046,"iPhone13,2"
com.apple.weather,7,1711755436,1711755443,1711755443.7755451,-18000,EB445137-D7F5-57EC-87DA-1DB460D64046,"iPhone13,2"
com.apple.weather,7,1711755423,1711755430,1711755430.481945,-18000,EB445137-D7F5-57EC-87DA-1DB460D64046,"iPhone13,2"
com.apple.MobileSMS,9,1711755414,1711755423,1711755423.203055,-18000,EB445137-D7F5-57EC-87DA-1DB460D64046,"iPhone13,2"
com.apple.MobileSMS,10,1711755246,1711755256,1711755256.4849072,-18000,EB445137-D7F5-57EC-87DA-1DB460D64046,"iPhone13,2"
com.apple.MobileSMS,5,1711755031,1711755036,1711755036.067626,-18000,EB445137-D7F5-57EC-87DA-1DB460D64046,"iPhone13,2"
com.apple.MobileSMS,16,1711754734,1711754750,1711754750.8449621,-18000,EB445137-D7F5-57EC-87DA-1DB460D64046,"iPhone13,2"
com.apple.MobileSMS,42,1711754684,1711754726,1711754726.343848,-18000,EB445137-D7F5-57EC-87DA-1DB460D64046,"iPhone13,2"
com.apple.Maps,3,1711754680,1711754683,1711754683.914674,-18000,EB445137-D7F5-57EC-87DA-1DB460D64046,"iPhone13,2"
com.apple.Maps,7,1711754652,1711754659,1711754659.345594,-18000,EB445137-D7F5-57EC-87DA-1DB460D64046,"iPhone13,2"
com.apple.Maps,6,1711752784,1711752790,1711752790.8759642,-18000,EB445137-D7F5-57EC-87DA-1DB460D64046,"iPhone13,2"
com.apple.Maps,6,1711752698,1711752704,1711752704.876764,-18000,EB445137-D7F5-57EC-87DA-1DB460D64046,"iPhone13,2"
com.apple.Maps,26,1711743365,1711743391,1711743391.145117,-18000,EB445137-D7F5-57EC-87DA-1DB460D64046,"iPhone13,2"
com.apple.Music,2,1711743361,1711743363,1711743363.712486,-18000,EB445137-D7F5-57EC-87DA-1DB460D64046,"iPhone13,2"
com.apple.Music,6,1711743354,1711743360,1711743360.644037,-18000,EB445137-D7F5-57EC-87DA-1DB460D64046,"iPhone13,2"
com.apple.Music,2,1711743343,1711743345,1711743345.6532578,-18000,EB445137-D7F5-57EC-87DA-1DB460D64046,"iPhone13,2"
com.apple.Music,22,1711743232,1711743254,1711743254.2961202,-18000,EB445137-D7F5-57EC-87DA-1DB460D64046,"iPhone13,2"
com.apple.MobileSMS,13,1711742945,1711742958,1711742958.271085,-18000,EB445137-D7F5-57EC-87DA-1DB460D64046,"iPhone13,2"
com.apple.MobileSMS,25,1711742643,1711742668,1711742668.25943,-18000,EB445137-D7F5-57EC-87DA-1DB460D64046,"iPhone13,2"
com.apple.findmy,6,1711742637,1711742643,1711742643.5312681,-18000,EB445137-D7F5-57EC-87DA-1DB460D64046,"iPhone13,2"
com.apple.MobileSMS,11,1711742625,1711742636,1711742637.028273,-18000,EB445137-D7F5-57EC-87DA-1DB460D64046,"iPhone13,2"
com.apple.weather,9,1711742616,1711742625,1711742625.58014,-18000,EB445137-D7F5-57EC-87DA-1DB460D64046,"iPhone13,2"
com.microsoft.Office.Outlook,2,1711742614,1711742616,1711742616.686355,-18000,EB445137-D7F5-57EC-87DA-1DB460D64046,"iPhone13,2"
com.microsoft.Office.Outlook,30,1711742323,1711742353,1711742353.94333,-18000,EB445137-D7F5-57EC-87DA-1DB460D64046,"iPhone13,2"
com.burbn.instagram,258,1711742064,1711742322,1711742322.03434,-18000,EB445137-D7F5-57EC-87DA-1DB460D64046,"iPhone13,2"
com.facebook.Facebook,152,1711741912,1711742064,1711742064.404801,-18000,EB445137-D7F5-57EC-87DA-1DB460D64046,"iPhone13,2"
com.apple.weather,4,1711741907,1711741911,1711741911.212034,-18000,EB445137-D7F5-57EC-87DA-1DB460D64046,"iPhone13,2"
com.apple.weather,15,1711741870,1711741885,1711741885.251772,-18000,EB445137-D7F5-57EC-87DA-1DB460D64046,"iPhone13,2"
com.apple.finder,3,1711741557,1711741560,1711741560.837555,-18000,,
com.google.Chrome,1,1711741556,1711741557,1711741557.773532,-18000,,
com.apple.finder,1,1711741555,1711741556,1711741556.449658,-18000,,
com.apple.Notes,1,1711741554,1711741555,1711741555.852786,-18000,,
com.leomehlig.today,29,1711741525,1711741554,1711741554.7788801,-18000,,
com.google.Chrome,33,1711741492,1711741525,1711741526.020603,-18000,,
com.microsoft.VSCode,87,1711741405,1711741492,1711741492.510848,-18000,,
com.google.Chrome,21,1711741384,1711741405,1711741405.9683251,-18000,,
com.microsoft.VSCode,3,1711741381,1711741384,1711741384.156914,-18000,,
com.google.Chrome,21,1711741360,1711741381,1711741381.701119,-18000,,
com.microsoft.VSCode,115,1711741245,1711741360,1711741360.461442,-18000,,
com.leomehlig.today,2,1711741243,1711741245,1711741245.427545,-18000,,
com.microsoft.VSCode,331,1711740912,1711741243,1711741243.671764,-18000,,
com.leomehlig.today,12,1711740900,1711740912,1711740912.903451,-18000,,
com.apple.Preview,23,1711740877,1711740900,1711740900.543741,-18000,,
com.microsoft.Office.Outlook,56,1711739912,1711739968,1711739968.381855,-18000,EB445137-D7F5-57EC-87DA-1DB460D64046,"iPhone13,2"
com.google.chrome.ios,3,1711739909,1711739912,1711739913.188367,-18000,EB445137-D7F5-57EC-87DA-1DB460D64046,"iPhone13,2"
com.google.chrome.ios,29,1711738484,1711738513,1711738513.288079,-18000,EB445137-D7F5-57EC-87DA-1DB460D64046,"iPhone13,2"
com.apple.mobilecal,4,1711738479,1711738483,1711738483.368075,-18000,EB445137-D7F5-57EC-87DA-1DB460D64046,"iPhone13,2"
com.apple.mobilecal,70,1711735396,1711735466,1711735466.836088,-18000,EB445137-D7F5-57EC-87DA-1DB460D64046,"iPhone13,2"
Astrospheric.Astrospheric,25,1711735272,1711735297,1711735297.2718592,-18000,EB445137-D7F5-57EC-87DA-1DB460D64046,"iPhone13,2"
com.instructure.icanvas,4,1711735267,1711735271,1711735271.1741118,-18000,EB445137-D7F5-57EC-87DA-1DB460D64046,"iPhone13,2"
com.apple.Preview,389,1711734824,1711735213,1711735213.640658,-18000,,
com.leomehlig.today,6,1711734818,1711734824,1711734824.70892,-18000,,
com.instructure.icanvas,14,1711734688,1711734702,1711734702.0804949,-18000,EB445137-D7F5-57EC-87DA-1DB460D64046,"iPhone13,2"
com.instructure.icanvas,112,1711734565,1711734677,1711734677.168747,-18000,EB445137-D7F5-57EC-87DA-1DB460D64046,"iPhone13,2"
com.apple.Maps,2,1711734563,1711734565,1711734565.203805,-18000,EB445137-D7F5-57EC-87DA-1DB460D64046,"iPhone13,2"
com.apple.Maps,6,1711733605,1711733611,1711733611.856143,-18000,EB445137-D7F5-57EC-87DA-1DB460D64046,"iPhone13,2"
com.apple.Maps,21,1711733584,1711733605,1711733605.190871,-18000,EB445137-D7F5-57EC-87DA-1DB460D64046,"iPhone13,2"
com.leomehlig.today,17,1711733248,1711733265,1711733265.849351,-18000,,
com.microsoft.VSCode,159,1711733089,1711733248,1711733248.187618,-18000,,
com.leomehlig.today,28,1711733061,1711733089,1711733089.211797,-18000,,
com.microsoft.VSCode,159,1711732902,1711733061,1711733061.299131,-18000,,
com.google.Chrome,1,1711732901,1711732902,1711732902.1884499,-18000,,
com.microsoft.VSCode,6,1711732895,1711732901,1711732901.438057,-18000,,
com.google.Chrome,19,1711732876,1711732895,1711732895.340877,-18000,,
com.microsoft.VSCode,459,1711732401,1711732860,1711732860.640271,-18000,,
com.google.Chrome,0,1711732401,1711732401,1711732402.025877,-18000,,
com.microsoft.VSCode,534,1711731867,1711732401,1711732401.5791512,-18000,,
com.google.Chrome,4,1711731863,1711731867,1711731867.313875,-18000,,
com.microsoft.VSCode,9,1711731854,1711731863,1711731863.246501,-18000,,
com.google.Chrome,4,1711731850,1711731854,1711731854.498413,-18000,,
com.microsoft.VSCode,8,1711731842,1711731850,1711731850.821933,-18000,,
com.google.Chrome,28,1711731814,1711731842,1711731842.242043,-18000,,
com.google.Gmail,86,1711730936,1711731022,1711731022.736723,-18000,EB445137-D7F5-57EC-87DA-1DB460D64046,"iPhone13,2"
com.microsoft.VSCode,886,1711730928,1711731814,1711731815.853681,-18000,,
com.google.Chrome,10,1711730918,1711730928,1711730928.524375,-18000,,
com.leomehlig.today,17,1711730901,1711730918,1711730919.000647,-18000,,
com.google.Chrome,206,1711730695,1711730901,1711730902.039038,-18000,,
com.apple.Preview,165,1711730530,1711730695,1711730695.679132,-18000,,
com.apple.finder,2,1711730528,1711730530,1711730530.84148,-18000,,
com.google.Chrome,696,1711729832,1711730528,1711730528.4731479,-18000,,
com.google.Chrome,300,1711729480,1711729780,1711729780.413468,-18000,,
com.leomehlig.today,5,1711729475,1711729480,1711729480.392992,-18000,,
com.google.Chrome,94,1711729381,1711729475,1711729475.6129231,-18000,,
com.leomehlig.today,4,1711729377,1711729381,1711729381.6866488,-18000,,
com.google.Chrome,1396,1711727981,1711729377,1711729377.515417,-18000,,
com.leomehlig.today,3,1711727978,1711727981,1711727981.1698852,-18000,,
com.google.Chrome,200,1711727778,1711727978,1711727978.4291549,-18000,,
com.apple.Preview,2,1711727776,1711727778,1711727778.4971519,-18000,,
com.apple.MobileSMS,98,1711727352,1711727450,1711727450.29735,-18000,EB445137-D7F5-57EC-87DA-1DB460D64046,"iPhone13,2"
com.amazon.Amazon,33,1711727316,1711727349,1711727349.9500341,-18000,EB445137-D7F5-57EC-87DA-1DB460D64046,"iPhone13,2"
com.apple.MobileSMS,7,1711727306,1711727313,1711727313.751981,-18000,EB445137-D7F5-57EC-87DA-1DB460D64046,"iPhone13,2"
com.hammerandchisel.discord,89,1711727216,1711727305,1711727306.2462611,-18000,EB445137-D7F5-57EC-87DA-1DB460D64046,"iPhone13,2"
com.whentowork.iOS.WhenToWork-Employee-Scheduling,11,1711727205,1711727216,1711727216.407576,-18000,EB445137-D7F5-57EC-87DA-1DB460D64046,"iPhone13,2"
com.whentowork.iOS.WhenToWork-Employee-Scheduling,14,1711727191,1711727205,1711727205.126347,-18000,EB445137-D7F5-57EC-87DA-1DB460D64046,"iPhone13,2"
com.whentowork.iOS.WhenToWork-Employee-Scheduling,209,1711726792,1711727001,1711727001.7646089,-18000,EB445137-D7F5-57EC-87DA-1DB460D64046,"iPhone13,2"
com.apple.calculator,44,1711726745,1711726789,1711726789.424721,-18000,EB445137-D7F5-57EC-87DA-1DB460D64046,"iPhone13,2"
edu.illinois.rokwire.ios,11,1711726672,1711726683,1711726683.073361,-18000,EB445137-D7F5-57EC-87DA-1DB460D64046,"iPhone13,2"
edu.illinois.rokwire.ios,11,1711726655,1711726666,1711726666.115843,-18000,EB445137-D7F5-57EC-87DA-1DB460D64046,"iPhone13,2"
edu.illinois.rokwire.ios,28,1711726004,1711726032,1711726032.344363,-18000,EB445137-D7F5-57EC-87DA-1DB460D64046,"iPhone13,2"
com.apple.weather,7,1711725997,1711726004,1711726004.137223,-18000,EB445137-D7F5-57EC-87DA-1DB460D64046,"iPhone13,2"
com.apple.Preview,655,1711725858,1711726513,1711726513.214229,-18000,,
com.apple.finder,4,1711725854,1711725858,1711725858.083255,-18000,,
com.microsoft.VSCode,14,1711725840,1711725854,1711725854.626548,-18000,,
com.google.Chrome,89,1711725751,1711725840,1711725840.394009,-18000,,
com.apple.Notes,18,1711725733,1711725751,1711725751.213251,-18000,,
com.google.Chrome,7,1711725726,1711725733,1711725733.1747499,-18000,,
com.leomehlig.today,27,1711725684,1711725711,1711725712.981386,-18000,,
com.apple.weather,27,1711725070,1711725097,1711725097.349018,-18000,EB445137-D7F5-57EC-87DA-1DB460D64046,"iPhone13,2"
com.leomehlig.today,4,1711723275,1711723279,1711723279.125002,-18000,,
com.google.Chrome,3,1711723272,1711723275,1711723275.989707,-18000,,
com.apple.MobileSMS,32,1711723240,1711723272,1711723272.779743,-18000,,
com.google.Chrome,77,1711723163,1711723240,1711723240.44941,-18000,,
us.zoom.xos,14,1711723149,1711723163,1711723163.44772,-18000,,
com.google.Chrome,9,1711723140,1711723149,1711723149.32568,-18000,,
us.zoom.xos,8,1711723132,1711723140,1711723140.533237,-18000,,
com.apple.Health,42,1711722860,1711722902,1711722902.288255,-18000,EB445137-D7F5-57EC-87DA-1DB460D64046,"iPhone13,2"
com.apple.MobileSMS,42,1711722814,1711722856,1711722856.7681432,-18000,EB445137-D7F5-57EC-87DA-1DB460D64046,"iPhone13,2"
com.google.Chrome,1076,1711722056,1711723132,1711723132.315573,-18000,,
us.zoom.xos,0,1711722056,1711722056,1711722057.026573,-18000,,
com.google.Chrome,1,1711722055,1711722056,1711722056.408462,-18000,,
com.apple.MobileSMS,16,1711722039,1711722055,1711722055.591518,-18000,,
com.google.Chrome,970,1711721069,1711722039,1711722039.554671,-18000,,
us.zoom.xos,3,1711721066,1711721069,1711721069.739407,-18000,,
com.google.Chrome,24,1711721042,1711721066,1711721066.561178,-18000,,
us.zoom.xos,1,1711721041,1711721042,1711721042.3030748,-18000,,
com.google.Chrome,3,1711721038,1711721041,1711721041.411357,-18000,,
us.zoom.xos,1,1711721037,1711721038,1711721038.296094,-18000,,
com.google.Chrome,1,1711721036,1711721037,1711721037.682001,-18000,,
us.zoom.xos,1,1711721035,1711721036,1711721036.06469,-18000,,
com.google.Chrome,25,1711721010,1711721035,1711721035.255974,-18000,,
us.zoom.xos,22,1711720988,1711721010,1711721010.409565,-18000,,
com.google.Chrome,20,1711720968,1711720988,1711720988.228493,-18000,,
us.zoom.xos,7,1711720961,1711720968,1711720968.846756,-18000,,
com.google.Chrome,10,1711720951,1711720961,1711720961.565263,-18000,,
us.zoom.xos,3,1711720948,1711720951,1711720951.5246701,-18000,,
com.google.Chrome,5,1711720943,1711720948,1711720948.666584,-18000,,
us.zoom.xos,62,1711720881,1711720943,1711720944.041422,-18000,,
com.apple.MobileSMS,7,1711720874,1711720881,1711720881.5765529,-18000,,
us.zoom.xos,4,1711720870,1711720874,1711720874.730307,-18000,,
com.google.Chrome,29,1711720841,1711720870,1711720870.191259,-18000,,
us.zoom.xos,1,1711720840,1711720841,1711720841.90519,-18000,,
com.google.Chrome,2,1711720838,1711720840,1711720840.690582,-18000,,
us.zoom.xos,1,1711720837,1711720838,1711720838.7554998,-18000,,
com.google.Chrome,1,1711720836,1711720837,1711720837.372906,-18000,,
us.zoom.xos,2,1711720834,1711720836,1711720836.409062,-18000,,
com.google.Chrome,8,1711720826,1711720834,1711720834.671807,-18000,,
us.zoom.xos,3,1711720823,1711720826,1711720826.8035169,-18000,,
com.google.Chrome,4,1711720819,1711720823,1711720823.531877,-18000,,
us.zoom.xos,1,1711720818,1711720819,1711720819.249977,-18000,,
com.google.Chrome,2,1711720816,1711720818,1711720818.0532498,-18000,,
us.zoom.xos,8,1711720808,1711720816,1711720816.767902,-18000,,
com.google.Chrome,17,1711720791,1711720808,1711720808.868465,-18000,,
com.google.ios.youtube,830,1711719722,1711720552,1711720552.918157,-18000,EB445137-D7F5-57EC-87DA-1DB460D64046,"iPhone13,2"
com.instructure.icanvas,25,1711719640,1711719665,1711719665.444858,-18000,EB445137-D7F5-57EC-87DA-1DB460D64046,"iPhone13,2"
com.google.Chrome,337,1711680543,1711680880,1711680880.802588,-18000,,
com.google.Chrome,1023,1711679447,1711680470,1711680470.7725239,-18000,,
com.burbn.instagram,144,1711679055,1711679199,1711679199.156863,-18000,EB445137-D7F5-57EC-87DA-1DB460D64046,"iPhone13,2"
com.facebook.Facebook,3,1711679051,1711679054,1711679054.300488,-18000,EB445137-D7F5-57EC-87DA-1DB460D64046,"iPhone13,2"
com.google.Chrome,314,1711678982,1711679296,1711679296.9428868,-18000,,
com.google.Chrome,420,1711678514,1711678934,1711678934.245091,-18000,,
com.apple.finder,1,1711678513,1711678514,1711678514.976791,-18000,,
com.google.Chrome,10,1711678503,1711678513,1711678513.16275,-18000,,
com.apple.iCal,88,1711678415,1711678503,1711678503.558604,-18000,,
com.leomehlig.today,52,1711678363,1711678415,1711678415.107403,-18000,,
com.apple.iCal,52,1711678311,1711678363,1711678363.807509,-18000,,
com.leomehlig.today,39,1711678272,1711678311,1711678311.25441,-18000,,
com.google.Chrome,120,1711678152,1711678272,1711678272.340003,-18000,,
com.microsoft.VSCode,22,1711678130,1711678152,1711678152.368538,-18000,,
com.facebook.Facebook,565,1711677256,1711677821,1711677821.608776,-18000,EB445137-D7F5-57EC-87DA-1DB460D64046,"iPhone13,2"
com.instructure.icanvas,92,1711677155,1711677247,1711677247.312183,-18000,EB445137-D7F5-57EC-87DA-1DB460D64046,"iPhone13,2"
com.whentowork.iOS.WhenToWork-Employee-Scheduling,36,1711677085,1711677121,1711677121.323374,-18000,EB445137-D7F5-57EC-87DA-1DB460D64046,"iPhone13,2"
com.whentowork.iOS.WhenToWork-Employee-Scheduling,43,1711677041,1711677084,1711677084.598682,-18000,EB445137-D7F5-57EC-87DA-1DB460D64046,"iPhone13,2"
com.microsoft.VSCode,13,1711675292,1711675305,1711675306.044386,-18000,,
com.apple.finder,5,1711675287,1711675292,1711675292.119847,-18000,,
com.microsoft.VSCode,437,1711674850,1711675287,1711675287.474131,-18000,,
com.apple.MobileSMS,5,1711674845,1711674850,1711674851.013987,-18000,,
com.google.Chrome,7,1711674838,1711674845,1711674845.682677,-18000,,
com.apple.MobileSMS,43,1711674795,1711674838,1711674838.855315,-18000,,
com.google.Chrome,7,1711674788,1711674795,1711674795.067813,-18000,,
com.apple.MobileSMS,4,1711674784,1711674788,1711674789.0313668,-18000,,
com.google.chrome.ios,10,1711674773,1711674783,1711674783.289494,-18000,EB445137-D7F5-57EC-87DA-1DB460D64046,"iPhone13,2"
com.apple.MobileSMS,17,1711674756,1711674773,1711674773.3040562,-18000,EB445137-D7F5-57EC-87DA-1DB460D64046,"iPhone13,2"
com.google.chrome.ios,27,1711674728,1711674755,1711674755.838346,-18000,EB445137-D7F5-57EC-87DA-1DB460D64046,"iPhone13,2"
com.microsoft.Office.Outlook,48,1711674677,1711674725,1711674725.341066,-18000,EB445137-D7F5-57EC-87DA-1DB460D64046,"iPhone13,2"
com.google.chrome.ios,4,1711674673,1711674677,1711674677.300555,-18000,EB445137-D7F5-57EC-87DA-1DB460D64046,"iPhone13,2"
com.google.chrome.ios,2,1711674321,1711674323,1711674323.2433271,-18000,EB445137-D7F5-57EC-87DA-1DB460D64046,"iPhone13,2"
com.microsoft.VSCode,656,1711674128,1711674784,1711674785.034502,-18000,,
com.google.Chrome,4,1711674124,1711674128,1711674129.0133529,-18000,,
com.microsoft.VSCode,7,1711674117,1711674124,1711674125.0071568,-18000,,
com.google.Chrome,8,1711674109,1711674117,1711674117.1615272,-18000,,
com.microsoft.VSCode,7,1711674102,1711674109,1711674109.3735352,-18000,,
com.google.Chrome,59,1711674043,1711674102,1711674102.7999701,-18000,,
com.google.chrome.ios,61,1711673984,1711674045,1711674045.2986941,-18000,EB445137-D7F5-57EC-87DA-1DB460D64046,"iPhone13,2"
com.apple.camera,5,1711673978,1711673983,1711673984.20243,-18000,EB445137-D7F5-57EC-87DA-1DB460D64046,"iPhone13,2"
com.whentowork.iOS.WhenToWork-Employee-Scheduling,8,1711673976,1711673984,1711673985.1580229,-18000,EB445137-D7F5-57EC-87DA-1DB460D64046,"iPhone13,2"
com.microsoft.VSCode,1614,1711672429,1711674043,1711674044.27185,-18000,,
com.apple.Dictionary,1,1711672428,1711672429,1711672429.55412,-18000,,
com.microsoft.VSCode,522,1711671906,1711672428,1711672428.4576201,-18000,,
com.microsoft.VSCode,512,1711671391,1711671903,1711671903.545928,-18000,,
com.apple.finder,15,1711671376,1711671391,1711671391.724179,-18000,,
com.microsoft.VSCode,353,1711671023,1711671376,1711671376.730514,-18000,,
com.apple.MobileSMS,3,1711671020,1711671023,1711671024.027942,-18000,,
com.microsoft.VSCode,6,1711671014,1711671020,1711671020.655573,-18000,,
com.google.Chrome,6,1711671008,1711671014,1711671015.022742,-18000,,
com.whentowork.iOS.WhenToWork-Employee-Scheduling,12,1711670874,1711670886,1711670886.563669,-18000,EB445137-D7F5-57EC-87DA-1DB460D64046,"iPhone13,2"
com.microsoft.Office.Outlook,5,1711670869,1711670874,1711670874.975123,-18000,EB445137-D7F5-57EC-87DA-1DB460D64046,"iPhone13,2"
com.microsoft.Office.Outlook,35,1711670698,1711670733,1711670733.477485,-18000,EB445137-D7F5-57EC-87DA-1DB460D64046,"iPhone13,2"
com.google.chrome.ios,9,1711670689,1711670698,1711670698.333397,-18000,EB445137-D7F5-57EC-87DA-1DB460D64046,"iPhone13,2"
com.google.chrome.ios,82,1711668207,1711668289,1711668289.839042,-18000,EB445137-D7F5-57EC-87DA-1DB460D64046,"iPhone13,2"
com.toyopagroup.picaboo,3,1711668204,1711668207,1711668208.0981221,-18000,EB445137-D7F5-57EC-87DA-1DB460D64046,"iPhone13,2"
com.toyopagroup.picaboo,6,1711667173,1711667179,1711667179.2509608,-18000,EB445137-D7F5-57EC-87DA-1DB460D64046,"iPhone13,2"
com.toyopagroup.picaboo,7,1711666929,1711666936,1711666936.8889608,-18000,EB445137-D7F5-57EC-87DA-1DB460D64046,"iPhone13,2"
com.apple.weather,3,1711666926,1711666929,1711666931.221623,-18000,EB445137-D7F5-57EC-87DA-1DB460D64046,"iPhone13,2"
com.apple.weather,10,1711666784,1711666794,1711666794.623158,-18000,EB445137-D7F5-57EC-87DA-1DB460D64046,"iPhone13,2"
com.apple.weather,1,1711666782,1711666783,1711666783.7442741,-18000,EB445137-D7F5-57EC-87DA-1DB460D64046,"iPhone13,2"
com.apple.weather,8,1711665735,1711665743,1711665743.685103,-18000,EB445137-D7F5-57EC-87DA-1DB460D64046,"iPhone13,2"
com.microsoft.Office.Outlook,2,1711665732,1711665734,1711665735.3189502,-18000,EB445137-D7F5-57EC-87DA-1DB460D64046,"iPhone13,2"
com.microsoft.Office.Outlook,6,1711664251,1711664257,1711664257.2282891,-18000,EB445137-D7F5-57EC-87DA-1DB460D64046,"iPhone13,2"
com.google.Chrome,122,1711664239,1711664361,1711664361.138303,-18000,,
com.microsoft.VSCode,65,1711664174,1711664239,1711664239.090859,-18000,,
com.google.Chrome,14,1711664160,1711664174,1711664174.8037848,-18000,,
com.microsoft.VSCode,1944,1711662216,1711664160,1711664162.2793078,-18000,,
com.apple.finder,9,1711662207,1711662216,1711662216.661479,-18000,,
com.microsoft.VSCode,120,1711662087,1711662207,1711662207.2901192,-18000,,
com.apple.finder,15,1711662072,1711662087,1711662087.4158912,-18000,,
com.microsoft.VSCode,1,1711662071,1711662072,1711662072.989932,-18000,,
com.google.Chrome,708,1711661363,1711662071,1711662071.898421,-18000,,
com.google.Chrome,686,1711660308,1711660994,1711660994.4987679,-18000,,
com.microsoft.Office.Outlook,1,1711659804,1711659805,1711659805.94503,-18000,EB445137-D7F5-57EC-87DA-1DB460D64046,"iPhone13,2"
com.google.Chrome,353,1711659732,1711660085,1711660085.743093,-18000,,
com.microsoft.Office.Outlook,55,1711659722,1711659777,1711659777.267087,-18000,EB445137-D7F5-57EC-87DA-1DB460D64046,"iPhone13,2"
com.google.Chrome,618,1711659011,1711659629,1711659629.2643142,-18000,,
com.leomehlig.today,258,1711658753,1711659011,1711659012.5859342,-18000,,
com.apple.finder,12,1711658741,1711658753,1711658753.363809,-18000,,
com.google.Chrome,36,1711658705,1711658741,1711658741.640562,-18000,,
com.hnc.Discord,34,1711658671,1711658705,1711658706.445489,-18000,,
com.apple.Preview,2,1711658669,1711658671,1711658671.25653,-18000,,
com.google.Chrome,9,1711658660,1711658669,1711658669.5278702,-18000,,
com.leomehlig.today,8,1711658652,1711658660,1711658660.645979,-18000,,
com.google.Chrome,24,1711658628,1711658652,1711658652.609363,-18000,,
com.leomehlig.today,20,1711658608,1711658628,1711658628.650981,-18000,,
com.google.Chrome,47,1711658561,1711658608,1711658608.8556252,-18000,,
com.apple.Preview,9,1711658552,1711658561,1711658561.9680219,-18000,,
com.google.Chrome,3,1711658549,1711658552,1711658552.135117,-18000,,
com.apple.Preview,12,1711658537,1711658549,1711658549.5719662,-18000,,
com.google.Chrome,126,1711658411,1711658537,1711658537.506662,-18000,,
com.apple.Preview,16,1711658395,1711658411,1711658411.706847,-18000,,
com.google.Chrome,44,1711658351,1711658395,1711658395.8865309,-18000,,
com.apple.Preview,20,1711658331,1711658351,1711658351.654735,-18000,,
com.google.Chrome,6,1711658325,1711658331,1711658331.100682,-18000,,
com.apple.Preview,16,1711658309,1711658325,1711658325.127349,-18000,,
com.google.Chrome,2,1711658307,1711658309,1711658310.005074,-18000,,
com.apple.Preview,40,1711658267,1711658307,1711658308.007876,-18000,,
com.google.Chrome,116,1711658151,1711658267,1711658267.711502,-18000,,
com.apple.Preview,21,1711658130,1711658151,1711658151.273767,-18000,,
com.google.Chrome,113,1711658017,1711658130,1711658130.6721601,-18000,,
com.apple.Preview,6,1711658011,1711658017,1711658017.140922,-18000,,
com.google.Chrome,11,1711658000,1711658011,1711658011.689208,-18000,,
com.apple.Preview,13,1711657987,1711658000,1711658000.8168302,-18000,,
com.google.Chrome,6,1711657981,1711657987,1711657987.219479,-18000,,
com.apple.Preview,17,1711657964,1711657981,1711657981.190332,-18000,,
com.google.Chrome,42,1711657922,1711657964,1711657965.0115209,-18000,,
com.apple.Preview,25,1711657897,1711657922,1711657922.79569,-18000,,
com.google.Chrome,16,1711657881,1711657897,1711657897.277605,-18000,,
com.apple.Preview,16,1711657865,1711657881,1711657881.594383,-18000,,
com.google.Chrome,4,1711657861,1711657865,1711657865.089077,-18000,,
com.apple.Preview,14,1711657847,1711657861,1711657861.447325,-18000,,
com.google.Chrome,2,1711657845,1711657847,1711657848.007638,-18000,,
com.apple.Preview,14,1711657831,1711657845,1711657845.2864652,-18000,,
com.google.Chrome,137,1711657694,1711657831,1711657831.469119,-18000,,
com.apple.Preview,11,1711657683,1711657694,1711657694.638116,-18000,,
com.google.Chrome,47,1711657636,1711657683,1711657683.4526892,-18000,,
com.apple.Preview,18,1711657618,1711657636,1711657636.356653,-18000,,
com.google.Chrome,3,1711657615,1711657618,1711657618.9415321,-18000,,
com.apple.Preview,19,1711657596,1711657615,1711657615.1094909,-18000,,
com.google.Chrome,5,1711657591,1711657596,1711657597.008296,-18000,,
com.apple.Preview,15,1711657576,1711657591,1711657591.853568,-18000,,
com.google.Chrome,36,1711657516,1711657552,1711657552.6213942,-18000,,
us.zoom.xos,2,1711657514,1711657516,1711657516.8179889,-18000,,
com.toyopagroup.picaboo,8,1711657492,1711657500,1711657500.5889869,-18000,EB445137-D7F5-57EC-87DA-1DB460D64046,"iPhone13,2"
edu.illinois.rokwire.ios,2,1711657490,1711657492,1711657492.470543,-18000,EB445137-D7F5-57EC-87DA-1DB460D64046,"iPhone13,2"
edu.illinois.rokwire.ios,3,1711657392,1711657395,1711657395.391954,-18000,EB445137-D7F5-57EC-87DA-1DB460D64046,"iPhone13,2"
edu.illinois.rokwire.ios,38,1711657041,1711657079,1711657079.320384,-18000,EB445137-D7F5-57EC-87DA-1DB460D64046,"iPhone13,2"
com.toyopagroup.picaboo,8,1711657033,1711657041,1711657041.919178,-18000,EB445137-D7F5-57EC-87DA-1DB460D64046,"iPhone13,2"
us.zoom.xos,357,1711657021,1711657378,1711657378.617918,-18000,,
com.google.Chrome,104,1711656917,1711657021,1711657021.183395,-18000,,
us.zoom.xos,95,1711656822,1711656917,1711656917.384938,-18000,,
com.google.Chrome,239,1711656583,1711656822,1711656822.3268042,-18000,,
us.zoom.xos,116,1711656467,1711656583,1711656583.3059049,-18000,,
com.burbn.instagram,537,1711655927,1711656464,1711656464.615133,-18000,EB445137-D7F5-57EC-87DA-1DB460D64046,"iPhone13,2"
com.apple.weather,9,1711655908,1711655917,1711655917.3985639,-18000,EB445137-D7F5-57EC-87DA-1DB460D64046,"iPhone13,2"
com.toyopagroup.picaboo,22,1711655827,1711655849,1711655849.9478111,-18000,EB445137-D7F5-57EC-87DA-1DB460D64046,"iPhone13,2"
us.zoom.xos,301,1711655673,1711655974,1711655974.459074,-18000,,
com.google.Chrome,52,1711655621,1711655673,1711655673.324667,-18000,,
com.leomehlig.today,62,1711655543,1711655605,1711655605.248359,-18000,,
com.apple.finder,17,1711655526,1711655543,1711655544.039547,-18000,,
us.zoom.xos,13,1711655513,1711655526,1711655526.883675,-18000,,
com.apple.finder,38,1711655475,1711655513,1711655513.780009,-18000,,
com.apple.archiveutility,1,1711655474,1711655475,1711655475.332053,-18000,,
com.apple.finder,14,1711655460,1711655474,1711655474.703079,-18000,,
com.google.Chrome,49,1711655411,1711655460,1711655460.4760442,-18000,,
us.zoom.xos,138,1711655273,1711655411,1711655411.5272532,-18000,,
us.zoom.xos,300,1711654877,1711655177,1711655177.8149571,-18000,,
us.zoom.xos,301,1711654452,1711654753,1711654753.86253,-18000,,
com.toyopagroup.picaboo,4,1711654257,1711654261,1711654261.785085,-18000,EB445137-D7F5-57EC-87DA-1DB460D64046,"iPhone13,2"
com.google.Maps,2,1711654255,1711654257,1711654259.105842,-18000,EB445137-D7F5-57EC-87DA-1DB460D64046,"iPhone13,2"
us.zoom.xos,300,1711653972,1711654272,1711654272.535428,-18000,,
com.google.Chrome,112,1711653860,1711653972,1711653972.545995,-18000,,
us.zoom.xos,117,1711653743,1711653860,1711653862.270718,-18000,,
com.google.Maps,34,1711653665,1711653699,1711653699.901406,-18000,EB445137-D7F5-57EC-87DA-1DB460D64046,"iPhone13,2"
com.apple.camera,0,1711653661,1711653661,1711653662.251396,-18000,EB445137-D7F5-57EC-87DA-1DB460D64046,"iPhone13,2"
com.apple.news,5,1711653660,1711653665,1711653666.164912,-18000,EB445137-D7F5-57EC-87DA-1DB460D64046,"iPhone13,2"
com.google.Chrome,174,1711653569,1711653743,1711653743.988966,-18000,,
com.apple.news,151,1711653331,1711653482,1711653482.638307,-18000,EB445137-D7F5-57EC-87DA-1DB460D64046,"iPhone13,2"
us.zoom.xos,309,1711653260,1711653569,1711653569.317395,-18000,,
com.google.Chrome,0,1711653260,1711653260,1711653260.6360888,-18000,,
us.zoom.xos,3,1711653257,1711653260,1711653260.202302,-18000,,
com.google.Chrome,531,1711652726,1711653257,1711653257.852178,-18000,,
us.zoom.xos,10,1711652716,1711652726,1711652726.69503,-18000,,
com.google.Chrome,48,1711652668,1711652716,1711652716.2120671,-18000,,
com.hnc.Discord,25,1711652643,1711652668,1711652668.49269,-18000,,
com.google.Chrome,181,1711652462,1711652643,1711652644.020509,-18000,,
us.zoom.xos,82,1711652380,1711652462,1711652462.9079819,-18000,,
com.google.Chrome,2,1711652378,1711652380,1711652380.1088629,-18000,,
us.zoom.xos,1,1711652377,1711652378,1711652378.497384,-18000,,
com.google.Chrome,358,1711652019,1711652377,1711652377.4317641,-18000,,
com.leomehlig.today,9,1711652010,1711652019,1711652019.601478,-18000,,
com.google.Chrome,8,1711652002,1711652010,1711652011.060855,-18000,,
com.burbn.instagram,246,1711651673,1711651919,1711651919.270397,-18000,EB445137-D7F5-57EC-87DA-1DB460D64046,"iPhone13,2"
com.instructure.icanvas,28,1711651634,1711651662,1711651662.707127,-18000,EB445137-D7F5-57EC-87DA-1DB460D64046,"iPhone13,2"
com.apple.news,4,1711651630,1711651634,1711651634.784085,-18000,EB445137-D7F5-57EC-87DA-1DB460D64046,"iPhone13,2"
com.google.Chrome,532,1711651368,1711651900,1711651900.536501,-18000,,
com.leomehlig.today,8,1711651360,1711651368,1711651368.290897,-18000,,
com.google.Chrome,3,1711651357,1711651360,1711651360.205594,-18000,,
com.leomehlig.today,8,1711651349,1711651357,1711651357.687,-18000,,
com.google.Chrome,1283,1711650066,1711651349,1711651349.187694,-18000,,
com.apple.Preview,12,1711650054,1711650066,1711650066.095317,-18000,,
com.google.Chrome,55,1711649999,1711650054,1711650054.783934,-18000,,
com.apple.Preview,16,1711649983,1711649999,1711649999.682543,-18000,,
com.google.Chrome,32,1711649951,1711649983,1711649983.6834788,-18000,,
com.apple.Preview,29,1711649922,1711649951,1711649951.6941261,-18000,,
com.google.Chrome,20,1711649902,1711649922,1711649922.561238,-18000,,
com.apple.Preview,5,1711649897,1711649902,1711649902.0866961,-18000,,
com.google.Chrome,5,1711649892,1711649897,1711649897.54826,-18000,,
com.apple.Preview,2,1711649890,1711649892,1711649892.469073,-18000,,
com.google.Chrome,2,1711649888,1711649890,1711649890.318585,-18000,,
com.apple.Preview,2,1711649886,1711649888,1711649888.4327679,-18000,,
com.google.Chrome,1,1711649885,1711649886,1711649886.934206,-18000,,
com.apple.Preview,2,1711649883,1711649885,1711649885.7779288,-18000,,
com.google.Chrome,29,1711649854,1711649883,1711649883.738579,-18000,,
com.apple.Preview,10,1711649844,1711649854,1711649854.812942,-18000,,
com.google.Chrome,147,1711649697,1711649844,1711649844.211771,-18000,,
com.leomehlig.today,6,1711649691,1711649697,1711649697.346056,-18000,,
com.apple.news,21,1711649466,1711649487,1711649487.906888,-18000,EB445137-D7F5-57EC-87DA-1DB460D64046,"iPhone13,2"
com.apple.mobiletimer,3,1711649446,1711649449,1711649449.5697498,-18000,EB445137-D7F5-57EC-87DA-1DB460D64046,"iPhone13,2"
com.apple.mobiletimer,3,1711649415,1711649418,1711649418.220975,-18000,EB445137-D7F5-57EC-87DA-1DB460D64046,"iPhone13,2"
com.apple.mobiletimer,9,1711649406,1711649415,1711649415.2540069,-18000,EB445137-D7F5-57EC-87DA-1DB460D64046,"iPhone13,2"
com.apple.mobiletimer,1,1711649322,1711649323,1711649325.3457189,-18000,EB445137-D7F5-57EC-87DA-1DB460D64046,"iPhone13,2"
com.google.Chrome,762,1711648929,1711649691,1711649691.374903,-18000,,
com.apple.Preview,33,1711648896,1711648929,1711648929.955659,-18000,,
com.apple.finder,12,1711648884,1711648896,1711648896.780792,-18000,,
com.apple.Preview,1,1711648883,1711648884,1711648884.797936,-18000,,
com.apple.finder,1,1711648882,1711648883,1711648883.7000499,-18000,,
com.apple.Preview,2,1711648880,1711648882,1711648882.130124,-18000,,
com.google.Chrome,1,1711648879,1711648880,1711648880.8979049,-18000,,
com.microsoft.Outlook,1,1711648878,1711648879,1711648879.731155,-18000,,
com.google.Chrome,118,1711648760,1711648878,1711648878.519232,-18000,,
com.microsoft.Outlook,1,1711648745,1711648746,1711648748.25732,-18000,,
com.google.Chrome,1,1711648744,1711648745,1711648746.833857,-18000,,
com.apple.mobiletimer,2,1711648731,1711648733,1711648733.698144,-18000,EB445137-D7F5-57EC-87DA-1DB460D64046,"iPhone13,2"
com.leomehlig.today,31,1711648713,1711648744,1711648745.7261748,-18000,,
com.apple.Preview,783,1711647930,1711648713,1711648713.638698,-18000,,
com.apple.mobiletimer,6,1711647864,1711647870,1711647870.218892,-18000,EB445137-D7F5-57EC-87DA-1DB460D64046,"iPhone13,2"
com.apple.mobiletimer,4,1711647844,1711647848,1711647848.142935,-18000,EB445137-D7F5-57EC-87DA-1DB460D64046,"iPhone13,2"
com.apple.news,4,1711647840,1711647844,1711647844.58146,-18000,EB445137-D7F5-57EC-87DA-1DB460D64046,"iPhone13,2"
com.apple.news,64,1711647613,1711647677,1711647677.4232621,-18000,EB445137-D7F5-57EC-87DA-1DB460D64046,"iPhone13,2"
com.clairmail.fth.client,27,1711647415,1711647442,1711647442.966378,-18000,EB445137-D7F5-57EC-87DA-1DB460D64046,"iPhone13,2"
com.apple.MobileSMS,5,1711647410,1711647415,1711647415.845782,-18000,EB445137-D7F5-57EC-87DA-1DB460D64046,"iPhone13,2"
com.apple.MobileSMS,2,1711647317,1711647319,1711647319.315731,-18000,EB445137-D7F5-57EC-87DA-1DB460D64046,"iPhone13,2"
com.apple.MobileSMS,2,1711647241,1711647243,1711647243.3353481,-18000,EB445137-D7F5-57EC-87DA-1DB460D64046,"iPhone13,2"
com.apple.MobileSMS,2,1711646907,1711646909,1711646909.653652,-18000,EB445137-D7F5-57EC-87DA-1DB460D64046,"iPhone13,2"
com.apple.MobileSMS,3,1711646695,1711646698,1711646698.157847,-18000,EB445137-D7F5-57EC-87DA-1DB460D64046,"iPhone13,2"
com.apple.Preview,1299,1711646446,1711647745,1711647745.469188,-18000,,
com.leomehlig.today,25,1711646421,1711646446,1711646446.935535,-18000,,
com.apple.finder,7,1711646414,1711646421,1711646421.595027,-18000,,
com.leomehlig.today,4,1711646410,1711646414,1711646414.5760741,-18000,,
com.apple.MobileSMS,5,1711646095,1711646100,1711646100.22652,-18000,EB445137-D7F5-57EC-87DA-1DB460D64046,"iPhone13,2"
com.apple.MobileSMS,6,1711646060,1711646066,1711646066.454601,-18000,EB445137-D7F5-57EC-87DA-1DB460D64046,"iPhone13,2"
com.apple.Preview,368,1711646042,1711646410,1711646410.660562,-18000,,
com.apple.MobileSMS,4,1711646031,1711646035,1711646035.72564,-18000,EB445137-D7F5-57EC-87DA-1DB460D64046,"iPhone13,2"
com.apple.MobileSMS,25,1711646005,1711646030,1711646030.6303449,-18000,EB445137-D7F5-57EC-87DA-1DB460D64046,"iPhone13,2"
com.apple.mobiletimer,3,1711646002,1711646005,1711646005.204139,-18000,EB445137-D7F5-57EC-87DA-1DB460D64046,"iPhone13,2"
com.apple.mobiletimer,7,1711645947,1711645954,1711645954.54445,-18000,EB445137-D7F5-57EC-87DA-1DB460D64046,"iPhone13,2"
com.burbn.instagram,2,1711645945,1711645947,1711645947.477838,-18000,EB445137-D7F5-57EC-87DA-1DB460D64046,"iPhone13,2"
com.burbn.instagram,364,1711645474,1711645838,1711645838.3411078,-18000,EB445137-D7F5-57EC-87DA-1DB460D64046,"iPhone13,2"
com.burbn.instagram,9,1711645452,1711645461,1711645461.312554,-18000,EB445137-D7F5-57EC-87DA-1DB460D64046,"iPhone13,2"
edu.illinois.rokwire.ios,13,1711645439,1711645452,1711645452.103677,-18000,EB445137-D7F5-57EC-87DA-1DB460D64046,"iPhone13,2"
com.apple.Preview,917,1711644711,1711645628,1711645628.60425,-18000,,
com.apple.finder,3,1711644708,1711644711,1711644712.060121,-18000,,
com.google.Chrome,8,1711644700,1711644708,1711644708.193428,-18000,,
com.leomehlig.today,58,1711644642,1711644700,1711644701.52262,-18000,,
com.google.Chrome,6,1711644636,1711644642,1711644642.416775,-18000,,
edu.illinois.rokwire.ios,6,1711643969,1711643975,1711643975.180974,-18000,EB445137-D7F5-57EC-87DA-1DB460D64046,"iPhone13,2"
edu.illinois.rokwire.ios,3,1711643965,1711643968,1711643968.3218942,-18000,EB445137-D7F5-57EC-87DA-1DB460D64046,"iPhone13,2"
edu.illinois.rokwire.ios,34,1711643080,1711643114,1711643114.1581059,-18000,EB445137-D7F5-57EC-87DA-1DB460D64046,"iPhone13,2"
edu.illinois.rokwire.ios,3,1711641858,1711641861,1711641861.018364,-18000,EB445137-D7F5-57EC-87DA-1DB460D64046,"iPhone13,2"
edu.illinois.rokwire.ios,14,1711641809,1711641823,1711641823.525599,-18000,EB445137-D7F5-57EC-87DA-1DB460D64046,"iPhone13,2"
com.google.Gmail,3,1711641804,1711641807,1711641807.9783468,-18000,EB445137-D7F5-57EC-87DA-1DB460D64046,"iPhone13,2"
edu.illinois.rokwire.ios,14,1711641789,1711641803,1711641803.612196,-18000,EB445137-D7F5-57EC-87DA-1DB460D64046,"iPhone13,2"
com.microsoft.Office.Outlook,4,1711641784,1711641788,1711641788.3811522,-18000,EB445137-D7F5-57EC-87DA-1DB460D64046,"iPhone13,2"
com.google.Chrome,6,1711641668,1711641674,1711641674.300161,-18000,,
com.apple.Preview,11,1711641657,1711641668,1711641668.9426808,-18000,,
com.google.Chrome,12,1711641645,1711641657,1711641657.482325,-18000,,
com.apple.finder,19,1711641626,1711641645,1711641645.1011171,-18000,,
com.google.Chrome,10,1711641616,1711641626,1711641626.823948,-18000,,
com.apple.finder,3,1711641613,1711641616,1711641616.606447,-18000,,
com.apple.Preview,104,1711641509,1711641613,1711641613.641471,-18000,,
com.google.Chrome,24,1711641485,1711641509,1711641509.855166,-18000,,
com.apple.Preview,221,1711641264,1711641485,1711641485.8950071,-18000,,
com.google.Chrome,22,1711641242,1711641264,1711641264.5460482,-18000,,
com.apple.Preview,221,1711641021,1711641242,1711641242.6021771,-18000,,
com.google.Chrome,19,1711641002,1711641021,1711641021.543802,-18000,,
com.apple.Preview,208,1711640794,1711641002,1711641002.767096,-18000,,
com.google.Chrome,3,1711640791,1711640794,1711640794.161608,-18000,,
com.apple.Preview,121,1711640670,1711640791,1711640792.049691,-18000,,
com.google.Chrome,19,1711640651,1711640670,1711640670.462563,-18000,,
com.apple.Preview,435,1711640216,1711640651,1711640651.68262,-18000,,
com.apple.Preview,302,1711639878,1711640180,1711640180.356256,-18000,,
com.microsoft.Office.Outlook,123,1711638563,1711638686,1711638686.7519999,-18000,EB445137-D7F5-57EC-87DA-1DB460D64046,"iPhone13,2"
com.google.Chrome,1345,1711638533,1711639878,1711639878.435732,-18000,,
com.leomehlig.today,19,1711638514,1711638533,1711638533.4036021,-18000,,
com.google.Chrome,6,1711638508,1711638514,1711638514.6446838,-18000,,
com.leomehlig.today,10,1711638498,1711638508,1711638508.400275,-18000,,
com.google.Chrome,12,1711638486,1711638498,1711638498.411475,-18000,,
com.leomehlig.today,22,1711638464,1711638486,1711638486.325973,-18000,,
com.google.Chrome,4,1711638460,1711638464,1711638464.890366,-18000,,
com.leomehlig.today,3,1711638457,1711638460,1711638460.949435,-18000,,
com.google.Chrome,101,1711638356,1711638457,1711638457.721813,-18000,,
com.apple.Preview,8,1711638348,1711638356,1711638356.688377,-18000,,
com.apple.finder,2,1711638346,1711638348,1711638348.277775,-18000,,
com.apple.Preview,3,1711638343,1711638346,1711638346.2574692,-18000,,
com.apple.finder,5,1711638338,1711638343,1711638343.7313418,-18000,,
com.google.Chrome,235,1711638103,1711638338,1711638338.194244,-18000,,
com.leomehlig.today,3,1711638067,1711638070,1711638072.567532,-18000,,
com.letterboxd.LetterboxdApp,78,1711636842,1711636920,1711636920.467328,-18000,EB445137-D7F5-57EC-87DA-1DB460D64046,"iPhone13,2"
com.markhambly.APOD,43,1711636794,1711636837,1711636837.1367779,-18000,EB445137-D7F5-57EC-87DA-1DB460D64046,"iPhone13,2"
com.apple.weather,82,1711636704,1711636786,1711636786.962411,-18000,EB445137-D7F5-57EC-87DA-1DB460D64046,"iPhone13,2"
com.apple.news,130,1711636563,1711636693,1711636693.4100552,-18000,EB445137-D7F5-57EC-87DA-1DB460D64046,"iPhone13,2"
com.apple.Health,36,1711636479,1711636515,1711636515.808466,-18000,EB445137-D7F5-57EC-87DA-1DB460D64046,"iPhone13,2"
com.instructure.icanvas,7,1711636469,1711636476,1711636476.9442039,-18000,EB445137-D7F5-57EC-87DA-1DB460D64046,"iPhone13,2"
com.instructure.icanvas,3,1711636463,1711636466,1711636466.15023,-18000,EB445137-D7F5-57EC-87DA-1DB460D64046,"iPhone13,2"
com.leomehlig.today,29,1711636384,1711636413,1711636413.220921,-18000,,
com.instructure.icanvas,14,1711636214,1711636228,1711636228.3715239,-18000,EB445137-D7F5-57EC-87DA-1DB460D64046,"iPhone13,2"
com.instructure.icanvas,17,1711636196,1711636213,1711636213.761697,-18000,EB445137-D7F5-57EC-87DA-1DB460D64046,"iPhone13,2"
com.apple.Preferences,13,1711636177,1711636190,1711636190.565473,-18000,EB445137-D7F5-57EC-87DA-1DB460D64046,"iPhone13,2"
com.thestorygraph.thestorygraph,17,1711600308,1711600325,1711600325.788497,-18000,EB445137-D7F5-57EC-87DA-1DB460D64046,"iPhone13,2"
com.toyopagroup.picaboo,17,1711598680,1711598697,1711598697.181951,-18000,EB445137-D7F5-57EC-87DA-1DB460D64046,"iPhone13,2"
com.apple.Health,15,1711596438,1711596453,1711596455.337205,-18000,EB445137-D7F5-57EC-87DA-1DB460D64046,"iPhone13,2"
com.toyopagroup.picaboo,51,1711596269,1711596320,1711596320.5787802,-18000,EB445137-D7F5-57EC-87DA-1DB460D64046,"iPhone13,2"
com.apple.Health,67,1711596200,1711596267,1711596267.8885288,-18000,EB445137-D7F5-57EC-87DA-1DB460D64046,"iPhone13,2"
com.apple.Music,1,1711596199,1711596200,1711596201.0246549,-18000,EB445137-D7F5-57EC-87DA-1DB460D64046,"iPhone13,2"
com.apple.Music,11,1711596148,1711596159,1711596159.841257,-18000,EB445137-D7F5-57EC-87DA-1DB460D64046,"iPhone13,2"
com.apple.Music,12,1711596093,1711596105,1711596105.17002,-18000,EB445137-D7F5-57EC-87DA-1DB460D64046,"iPhone13,2"
com.leomehlig.today,3,1711596078,1711596081,1711596082.1005979,-18000,,
com.apple.finder,2,1711596076,1711596078,1711596078.407193,-18000,,
com.microsoft.Excel,45,1711596031,1711596076,1711596077.003111,-18000,,
com.leomehlig.today,12,1711596019,1711596031,1711596031.3130422,-18000,,
com.microsoft.Excel,2,1711596017,1711596019,1711596019.30919,-18000,,
com.leomehlig.today,6,1711596011,1711596017,1711596018.0804229,-18000,,
com.microsoft.Excel,7,1711596004,1711596011,1711596011.430911,-18000,,
com.leomehlig.today,23,1711595981,1711596004,1711596004.30482,-18000,,
com.microsoft.Excel,6,1711595975,1711595981,1711595981.3466349,-18000,,
com.leomehlig.today,5,1711595970,1711595975,1711595975.2686381,-18000,,
com.microsoft.Excel,11,1711595951,1711595962,1711595962.989445,-18000,,
com.leomehlig.today,9,1711595942,1711595951,1711595951.5686789,-18000,,
com.microsoft.Excel,3,1711595939,1711595942,1711595942.542412,-18000,,
com.leomehlig.today,4,1711595935,1711595939,1711595939.706699,-18000,,
com.microsoft.Excel,2,1711595933,1711595935,1711595935.096418,-18000,,
com.leomehlig.today,4,1711595929,1711595933,1711595933.918469,-18000,,
com.microsoft.Excel,1,1711595928,1711595929,1711595929.771696,-18000,,
com.leomehlig.today,6,1711595922,1711595928,1711595928.1379251,-18000,,
com.microsoft.Excel,5,1711595917,1711595922,1711595922.9695,-18000,,
com.leomehlig.today,11,1711595906,1711595917,1711595917.51713,-18000,,
com.microsoft.Excel,13,1711595893,1711595906,1711595906.4815001,-18000,,
com.apple.finder,14,1711595879,1711595893,1711595893.9048529,-18000,,
com.leomehlig.today,1,1711595878,1711595879,1711595879.47527,-18000,,
com.google.Chrome,68,1711595810,1711595878,1711595878.861053,-18000,,
com.apple.Music,18,1711595793,1711595811,1711595811.566074,-18000,EB445137-D7F5-57EC-87DA-1DB460D64046,"iPhone13,2"
com.apple.finder,3,1711595783,1711595786,1711595786.957921,-18000,,
com.apple.Music,3,1711595648,1711595651,1711595651.895215,-18000,EB445137-D7F5-57EC-87DA-1DB460D64046,"iPhone13,2"
com.apple.Music,3,1711595639,1711595642,1711595642.8875341,-18000,EB445137-D7F5-57EC-87DA-1DB460D64046,"iPhone13,2"
com.apple.Music,14,1711595264,1711595278,1711595278.089704,-18000,EB445137-D7F5-57EC-87DA-1DB460D64046,"iPhone13,2"
com.apple.Music,11,1711595247,1711595258,1711595258.1748362,-18000,EB445137-D7F5-57EC-87DA-1DB460D64046,"iPhone13,2"
com.apple.Music,3,1711595239,1711595242,1711595242.3017612,-18000,EB445137-D7F5-57EC-87DA-1DB460D64046,"iPhone13,2"
com.apple.Music,3,1711595028,1711595031,1711595031.758918,-18000,EB445137-D7F5-57EC-87DA-1DB460D64046,"iPhone13,2"
com.apple.Music,15,1711594552,1711594567,1711594567.440095,-18000,EB445137-D7F5-57EC-87DA-1DB460D64046,"iPhone13,2"
com.apple.finder,23,1711594489,1711594512,1711594512.301583,-18000,,
com.microsoft.VSCode,2,1711594487,1711594489,1711594489.650175,-18000,,
com.apple.finder,2,1711594485,1711594487,1711594487.055256,-18000,,
com.apple.Preview,1,1711594484,1711594485,1711594485.47372,-18000,,
com.google.Chrome,2,1711594482,1711594484,1711594484.573102,-18000,,
com.apple.MobileSMS,0,1711594482,1711594482,1711594482.703749,-18000,,
com.google.Chrome,4,1711594478,1711594482,1711594482.419156,-18000,,
com.leomehlig.today,56,1711594422,1711594478,1711594478.390602,-18000,,
com.microsoft.VSCode,1934,1711592488,1711594422,1711594422.870201,-18000,,
com.google.Chrome,50,1711592438,1711592488,1711592488.353445,-18000,,
com.apple.Music,9,1711591292,1711591301,1711591302.169334,-18000,EB445137-D7F5-57EC-87DA-1DB460D64046,"iPhone13,2"
com.apple.PeopleViewService,2,1711591289,1711591291,1711591291.757012,-18000,EB445137-D7F5-57EC-87DA-1DB460D64046,"iPhone13,2"
com.microsoft.VSCode,1234,1711591204,1711592438,1711592438.318984,-18000,,
com.leomehlig.today,68,1711591136,1711591204,1711591204.34306,-18000,,
com.google.Chrome,1,1711591135,1711591136,1711591136.11464,-18000,,
com.apple.finder,7,1711591128,1711591135,1711591135.16743,-18000,,
com.leomehlig.today,16,1711591112,1711591128,1711591128.412487,-18000,,
com.intsig.CamScannerLite,171,1711590879,1711591050,1711591050.966586,-18000,EB445137-D7F5-57EC-87DA-1DB460D64046,"iPhone13,2"
com.apple.MobileSMS,2,1711590874,1711590876,1711590877.043133,-18000,EB445137-D7F5-57EC-87DA-1DB460D64046,"iPhone13,2"
com.google.Chrome,241,1711590871,1711591112,1711591112.621722,-18000,,
com.google.Chrome,547,1711590223,1711590770,1711590770.7768679,-18000,,
com.leomehlig.today,22,1711590201,1711590223,1711590223.3947458,-18000,,
com.google.Chrome,369,1711589832,1711590201,1711590201.863178,-18000,,
com.leomehlig.today,19,1711589813,1711589832,1711589832.787818,-18000,,
com.google.Chrome,1442,1711588371,1711589813,1711589813.6871471,-18000,,
com.google.Chrome,873,1711587396,1711588269,1711588269.142663,-18000,,
com.leomehlig.today,149,1711587223,1711587372,1711587372.579638,-18000,,
com.google.Chrome,803,1711586420,1711587223,1711587223.845138,-18000,,
com.apple.MobileSMS,30,1711586390,1711586420,1711586420.041132,-18000,,
com.google.Chrome,379,1711586011,1711586390,1711586390.573423,-18000,,
com.apple.MobileSMS,15,1711585996,1711586011,1711586011.421483,-18000,,
com.apple.finder,12,1711585984,1711585996,1711585996.428269,-18000,,
com.apple.MobileSMS,8,1711585976,1711585984,1711585984.260707,-18000,,
com.microsoft.VSCode,50,1711585926,1711585976,1711585976.6730819,-18000,,
com.apple.MobileSMS,3,1711584261,1711584264,1711584264.1518111,-18000,EB445137-D7F5-57EC-87DA-1DB460D64046,"iPhone13,2"
com.google.Chrome,2125,1711583801,1711585926,1711585926.941591,-18000,,
com.leomehlig.today,1,1711583800,1711583801,1711583801.30902,-18000,,
com.google.Chrome,11,1711583789,1711583800,1711583800.332217,-18000,,
com.apple.MobileSMS,3,1711583777,1711583780,1711583780.240268,-18000,EB445137-D7F5-57EC-87DA-1DB460D64046,"iPhone13,2"
com.apple.MobileSMS,4,1711583612,1711583616,1711583616.565534,-18000,EB445137-D7F5-57EC-87DA-1DB460D64046,"iPhone13,2"
com.apple.Music,4,1711583608,1711583612,1711583612.3886662,-18000,EB445137-D7F5-57EC-87DA-1DB460D64046,"iPhone13,2"
com.apple.Music,20,1711582968,1711582988,1711582988.162539,-18000,EB445137-D7F5-57EC-87DA-1DB460D64046,"iPhone13,2"
com.burbn.instagram,4,1711582963,1711582967,1711582967.879125,-18000,EB445137-D7F5-57EC-87DA-1DB460D64046,"iPhone13,2"
com.burbn.instagram,89,1711582385,1711582474,1711582474.9066958,-18000,EB445137-D7F5-57EC-87DA-1DB460D64046,"iPhone13,2"
com.instructure.icanvas,60,1711582321,1711582381,1711582381.961011,-18000,EB445137-D7F5-57EC-87DA-1DB460D64046,"iPhone13,2"
com.google.Chrome,403,1711582286,1711582689,1711582690.3563008,-18000,,
com.google.Chrome,862,1711581366,1711582228,1711582228.354063,-18000,,
com.google.Chrome,420,1711580833,1711581253,1711581253.8307319,-18000,,
com.burbn.instagram,267,1711580798,1711581065,1711581066.001502,-18000,EB445137-D7F5-57EC-87DA-1DB460D64046,"iPhone13,2"
com.google.Chrome,301,1711580523,1711580824,1711580824.057894,-18000,,
com.apple.Health,18,1711580076,1711580094,1711580095.0030751,-18000,EB445137-D7F5-57EC-87DA-1DB460D64046,"iPhone13,2"
com.letterboxd.LetterboxdApp,2,1711580071,1711580073,1711580073.928471,-18000,EB445137-D7F5-57EC-87DA-1DB460D64046,"iPhone13,2"
com.letterboxd.LetterboxdApp,10,1711579994,1711580004,1711580004.520464,-18000,EB445137-D7F5-57EC-87DA-1DB460D64046,"iPhone13,2"
com.letterboxd.LetterboxdApp,85,1711579898,1711579983,1711579983.446459,-18000,EB445137-D7F5-57EC-87DA-1DB460D64046,"iPhone13,2"
com.google.Chrome,569,1711579848,1711580417,1711580417.518018,-18000,,
com.leomehlig.today,36,1711579812,1711579848,1711579848.108346,-18000,,
com.google.Chrome,2,1711579810,1711579812,1711579812.481967,-18000,,
com.leomehlig.today,9,1711579801,1711579810,1711579810.910832,-18000,,
com.google.Chrome,16,1711579785,1711579801,1711579801.471262,-18000,,
com.microsoft.Office.Outlook,23,1711579657,1711579680,1711579680.190206,-18000,EB445137-D7F5-57EC-87DA-1DB460D64046,"iPhone13,2"
com.apple.MobileSMS,2,1711578977,1711578979,1711578979.7584639,-18000,EB445137-D7F5-57EC-87DA-1DB460D64046,"iPhone13,2"
com.google.Chrome,263,1711576654,1711576917,1711576918.16255,-18000,,
com.apple.finder,19,1711576635,1711576654,1711576655.170932,-18000,,
com.microsoft.Excel,321,1711576314,1711576635,1711576635.782436,-18000,,
com.apple.finder,23,1711576291,1711576314,1711576314.5151749,-18000,,
com.google.Chrome,64,1711576227,1711576291,1711576291.913831,-18000,,
com.apple.finder,23,1711576171,1711576194,1711576195.330185,-18000,,
com.google.Chrome,22,1711576149,1711576171,1711576171.245265,-18000,,
com.leomehlig.today,92,1711576057,1711576149,1711576150.040959,-18000,,
com.apple.Preview,968,1711575089,1711576057,1711576057.7757568,-18000,,
com.google.Chrome,1,1711575088,1711575089,1711575089.879737,-18000,,
com.apple.Preview,999,1711574089,1711575088,1711575088.0685658,-18000,,
com.google.Chrome,42,1711574047,1711574089,1711574089.698543,-18000,,
com.facebook.Facebook,501,1711573453,1711573954,1711573954.683078,-18000,EB445137-D7F5-57EC-87DA-1DB460D64046,"iPhone13,2"
com.strava.stravaride,16,1711573429,1711573445,1711573445.56463,-18000,EB445137-D7F5-57EC-87DA-1DB460D64046,"iPhone13,2"
com.clairmail.fth.client,4,1711573390,1711573394,1711573394.372992,-18000,EB445137-D7F5-57EC-87DA-1DB460D64046,"iPhone13,2"
com.apple.MobileSMS,2,1711573381,1711573383,1711573383.937717,-18000,EB445137-D7F5-57EC-87DA-1DB460D64046,"iPhone13,2"
com.apple.MobileSMS,6,1711573372,1711573378,1711573378.767325,-18000,EB445137-D7F5-57EC-87DA-1DB460D64046,"iPhone13,2"
com.amazon.Amazon,50,1711573304,1711573354,1711573354.008023,-18000,EB445137-D7F5-57EC-87DA-1DB460D64046,"iPhone13,2"
com.hammerandchisel.discord,23,1711573280,1711573303,1711573303.345689,-18000,EB445137-D7F5-57EC-87DA-1DB460D64046,"iPhone13,2"
com.hammerandchisel.discord,23,1711573214,1711573237,1711573238.480356,-18000,EB445137-D7F5-57EC-87DA-1DB460D64046,"iPhone13,2"
edu.illinois.rokwire.ios,5,1711573209,1711573214,1711573214.361233,-18000,EB445137-D7F5-57EC-87DA-1DB460D64046,"iPhone13,2"
com.google.Chrome,1470,1711571708,1711573178,1711573178.446237,-18000,,
com.leomehlig.today,17,1711571691,1711571708,1711571708.942208,-18000,,
com.apple.iCal,3,1711571688,1711571691,1711571691.379562,-18000,,
com.leomehlig.today,10,1711571678,1711571688,1711571688.3306541,-18000,,
edu.illinois.rokwire.ios,2,1711571562,1711571564,1711571564.4346209,-18000,EB445137-D7F5-57EC-87DA-1DB460D64046,"iPhone13,2"
edu.illinois.rokwire.ios,32,1711571472,1711571504,1711571504.343841,-18000,EB445137-D7F5-57EC-87DA-1DB460D64046,"iPhone13,2"
edu.illinois.rokwire.ios,67,1711571248,1711571315,1711571315.1768641,-18000,EB445137-D7F5-57EC-87DA-1DB460D64046,"iPhone13,2"
com.apple.Health,45,1711571188,1711571233,1711571233.3863192,-18000,EB445137-D7F5-57EC-87DA-1DB460D64046,"iPhone13,2"
com.toyopagroup.picaboo,7,1711570296,1711570303,1711570303.427827,-18000,EB445137-D7F5-57EC-87DA-1DB460D64046,"iPhone13,2"
com.apple.mobilenotes,8,1711569457,1711569465,1711569465.3364758,-18000,EB445137-D7F5-57EC-87DA-1DB460D64046,"iPhone13,2"
com.microsoft.Office.Outlook,2,1711569453,1711569455,1711569455.658132,-18000,EB445137-D7F5-57EC-87DA-1DB460D64046,"iPhone13,2"
com.microsoft.Office.Outlook,1,1711569381,1711569382,1711569382.473093,-18000,EB445137-D7F5-57EC-87DA-1DB460D64046,"iPhone13,2"
com.microsoft.Office.Outlook,2,1711569231,1711569233,1711569233.151068,-18000,EB445137-D7F5-57EC-87DA-1DB460D64046,"iPhone13,2"
com.microsoft.Office.Outlook,7,1711569020,1711569027,1711569027.313088,-18000,EB445137-D7F5-57EC-87DA-1DB460D64046,"iPhone13,2"
com.microsoft.Office.Outlook,11,1711568993,1711569004,1711569004.386852,-18000,EB445137-D7F5-57EC-87DA-1DB460D64046,"iPhone13,2"
com.leomehlig.today,28,1711568934,1711568962,1711568962.77072,-18000,,
com.microsoft.Office.Outlook,6,1711568703,1711568709,1711568709.0780091,-18000,EB445137-D7F5-57EC-87DA-1DB460D64046,"iPhone13,2"
com.apple.Preview,1035,1711567899,1711568934,1711568934.446216,-18000,,
com.apple.finder,4,1711567895,1711567899,1711567900.076585,-18000,,
com.google.Chrome,43,1711567852,1711567895,1711567895.565129,-18000,,
com.leomehlig.today,20,1711567832,1711567852,1711567852.76853,-18000,,
com.google.Chrome,2,1711567830,1711567832,1711567832.412208,-18000,,
com.leomehlig.today,54,1711567776,1711567830,1711567830.847934,-18000,,
com.microsoft.Office.Outlook,10,1711566025,1711566035,1711566035.407692,-18000,EB445137-D7F5-57EC-87DA-1DB460D64046,"iPhone13,2"
com.apple.findmy,3,1711566022,1711566025,1711566026.254987,-18000,EB445137-D7F5-57EC-87DA-1DB460D64046,"iPhone13,2"
com.google.Chrome,2060,1711565716,1711567776,1711567776.4591699,-18000,,
com.apple.findmy,1,1711565417,1711565418,1711565418.321568,-18000,EB445137-D7F5-57EC-87DA-1DB460D64046,"iPhone13,2"
com.apple.findmy,2,1711565413,1711565415,1711565415.476822,-18000,EB445137-D7F5-57EC-87DA-1DB460D64046,"iPhone13,2"
com.apple.findmy,34,1711564371,1711564405,1711564405.704032,-18000,EB445137-D7F5-57EC-87DA-1DB460D64046,"iPhone13,2"
com.ryansponzilli.DeepSkyCatalog,1,1711564366,1711564367,1711564367.595743,-18000,EB445137-D7F5-57EC-87DA-1DB460D64046,"iPhone13,2"
com.google.chrome.ios,13,1711564353,1711564366,1711564366.107767,-18000,EB445137-D7F5-57EC-87DA-1DB460D64046,"iPhone13,2"
com.ryansponzilli.DeepSkyCatalog,9,1711564344,1711564353,1711564353.32295,-18000,EB445137-D7F5-57EC-87DA-1DB460D64046,"iPhone13,2"
com.google.Chrome,25,1711562354,1711562379,1711562379.560446,-18000,,
com.hammerandchisel.discord,11,1711562279,1711562290,1711562290.3952,-18000,EB445137-D7F5-57EC-87DA-1DB460D64046,"iPhone13,2"
com.microsoft.Office.Outlook,27,1711562236,1711562263,1711562263.962679,-18000,EB445137-D7F5-57EC-87DA-1DB460D64046,"iPhone13,2"
com.microsoft.Office.Outlook,9,1711562226,1711562235,1711562235.2489471,-18000,EB445137-D7F5-57EC-87DA-1DB460D64046,"iPhone13,2"
com.microsoft.Office.Outlook,6,1711561802,1711561808,1711561808.6533961,-18000,EB445137-D7F5-57EC-87DA-1DB460D64046,"iPhone13,2"
com.apple.Preview,571,1711561783,1711562354,1711562354.605773,-18000,,
com.google.Chrome,34,1711561749,1711561783,1711561783.556303,-18000,,
com.apple.Preview,157,1711561592,1711561749,1711561749.6024709,-18000,,
com.google.Chrome,9,1711561583,1711561592,1711561592.1598,-18000,,
com.leomehlig.today,32,1711561551,1711561583,1711561583.706702,-18000,,
com.apple.Preview,62,1711561489,1711561551,1711561552.013015,-18000,,
com.google.Chrome,82,1711561407,1711561489,1711561489.3674688,-18000,,
com.apple.Preview,16,1711561391,1711561407,1711561407.759008,-18000,,
com.microsoft.Office.Outlook,9,1711561292,1711561301,1711561302.2513871,-18000,EB445137-D7F5-57EC-87DA-1DB460D64046,"iPhone13,2"
com.instructure.icanvas,59,1711561232,1711561291,1711561291.375946,-18000,EB445137-D7F5-57EC-87DA-1DB460D64046,"iPhone13,2"
com.hammerandchisel.discord,31,1711561199,1711561230,1711561230.310408,-18000,EB445137-D7F5-57EC-87DA-1DB460D64046,"iPhone13,2"
com.burbn.instagram,3,1711561196,1711561199,1711561200.023987,-18000,EB445137-D7F5-57EC-87DA-1DB460D64046,"iPhone13,2"
com.burbn.instagram,10,1711561185,1711561195,1711561195.519575,-18000,EB445137-D7F5-57EC-87DA-1DB460D64046,"iPhone13,2"
com.google.Chrome,277,1711561114,1711561391,1711561391.666182,-18000,,
com.apple.Preview,157,1711560957,1711561114,1711561114.980205,-18000,,
com.google.Chrome,12,1711560945,1711560957,1711560957.862746,-18000,,
com.apple.Preview,3,1711560942,1711560945,1711560945.190981,-18000,,
com.google.Chrome,676,1711560266,1711560942,1711560942.682198,-18000,,
com.apple.Preview,42,1711560224,1711560266,1711560266.818624,-18000,,
com.apple.finder,1,1711560223,1711560224,1711560224.9563031,-18000,,
com.apple.Preview,2,1711560221,1711560223,1711560223.6047091,-18000,,
com.google.Chrome,380,1711559841,1711560221,1711560221.316535,-18000,,
com.google.Chrome,947,1711558816,1711559763,1711559763.581248,-18000,,
com.leomehlig.today,6,1711558810,1711558816,1711558816.766249,-18000,,
com.apple.Preview,15,1711558795,1711558810,1711558810.516402,-18000,,
com.burbn.instagram,130,1711558628,1711558758,1711558759.324874,-18000,EB445137-D7F5-57EC-87DA-1DB460D64046,"iPhone13,2"
com.google.chrome.ios,45,1711558580,1711558625,1711558625.6880121,-18000,EB445137-D7F5-57EC-87DA-1DB460D64046,"iPhone13,2"
com.google.chrome.ios,6,1711558081,1711558087,1711558087.940011,-18000,EB445137-D7F5-57EC-87DA-1DB460D64046,"iPhone13,2"
com.google.chrome.ios,229,1711557814,1711558043,1711558043.532259,-18000,EB445137-D7F5-57EC-87DA-1DB460D64046,"iPhone13,2"
com.burbn.instagram,190,1711556794,1711556984,1711556984.4349499,-18000,EB445137-D7F5-57EC-87DA-1DB460D64046,"iPhone13,2"
com.instructure.icanvas,124,1711556588,1711556712,1711556712.521703,-18000,EB445137-D7F5-57EC-87DA-1DB460D64046,"iPhone13,2"
edu.illinois.rokwire.ios,1,1711556587,1711556588,1711556588.6077871,-18000,EB445137-D7F5-57EC-87DA-1DB460D64046,"iPhone13,2"
com.apple.mobilenotes,2,1711556581,1711556583,1711556583.986261,-18000,EB445137-D7F5-57EC-87DA-1DB460D64046,"iPhone13,2"
com.apple.mobilenotes,76,1711555869,1711555945,1711555946.1250072,-18000,EB445137-D7F5-57EC-87DA-1DB460D64046,"iPhone13,2"
edu.illinois.rokwire.ios,2,1711555864,1711555866,1711555866.9891891,-18000,EB445137-D7F5-57EC-87DA-1DB460D64046,"iPhone13,2"
com.apple.Preview,135,1711555322,1711555457,1711555457.710449,-18000,,
com.google.Chrome,2,1711555320,1711555322,1711555322.119364,-18000,,
com.apple.Preview,8,1711555312,1711555320,1711555320.6592379,-18000,,
com.apple.finder,3,1711555309,1711555312,1711555312.654663,-18000,,
com.google.Chrome,98,1711555211,1711555309,1711555309.971075,-18000,,
com.microsoft.VSCode,25,1711555186,1711555211,1711555211.6025329,-18000,,
com.leomehlig.today,247,1711554939,1711555186,1711555186.272715,-18000,,
com.microsoft.VSCode,8,1711554931,1711554939,1711554939.6217198,-18000,,
com.microsoft.Outlook,60,1711554871,1711554931,1711554931.373609,-18000,,
com.microsoft.VSCode,6,1711554865,1711554871,1711554871.899636,-18000,,
edu.illinois.rokwire.ios,1,1711554712,1711554713,1711554714.110385,-18000,EB445137-D7F5-57EC-87DA-1DB460D64046,"iPhone13,2"
edu.illinois.rokwire.ios,1,1711553930,1711553931,1711553931.928893,-18000,EB445137-D7F5-57EC-87DA-1DB460D64046,"iPhone13,2"
edu.illinois.rokwire.ios,62,1711553849,1711553911,1711553911.228053,-18000,EB445137-D7F5-57EC-87DA-1DB460D64046,"iPhone13,2"
com.microsoft.Office.Outlook,4,1711553845,1711553849,1711553849.123905,-18000,EB445137-D7F5-57EC-87DA-1DB460D64046,"iPhone13,2"
com.microsoft.Office.Outlook,6,1711553789,1711553795,1711553795.685544,-18000,EB445137-D7F5-57EC-87DA-1DB460D64046,"iPhone13,2"
com.microsoft.Office.Outlook,4,1711553784,1711553788,1711553788.9187899,-18000,EB445137-D7F5-57EC-87DA-1DB460D64046,"iPhone13,2"
com.microsoft.Office.Outlook,9,1711553732,1711553741,1711553741.478922,-18000,EB445137-D7F5-57EC-87DA-1DB460D64046,"iPhone13,2"
com.apple.MobileSMS,4,1711553727,1711553731,1711553731.809551,-18000,EB445137-D7F5-57EC-87DA-1DB460D64046,"iPhone13,2"
com.apple.MobileSMS,8,1711553400,1711553408,1711553408.839561,-18000,EB445137-D7F5-57EC-87DA-1DB460D64046,"iPhone13,2"
com.microsoft.Office.Outlook,2,1711553398,1711553400,1711553401.3511019,-18000,EB445137-D7F5-57EC-87DA-1DB460D64046,"iPhone13,2"
com.microsoft.VSCode,436,1711553307,1711553743,1711553743.1019158,-18000,,
com.google.Chrome,10,1711553297,1711553307,1711553307.7386951,-18000,,
com.microsoft.VSCode,34,1711553263,1711553297,1711553298.030189,-18000,,
com.google.Chrome,1,1711553262,1711553263,1711553263.968824,-18000,,
com.microsoft.VSCode,12,1711553250,1711553262,1711553262.6728659,-18000,,
com.google.Chrome,9,1711553241,1711553250,1711553250.5253692,-18000,,
com.microsoft.VSCode,10,1711553231,1711553241,1711553241.240684,-18000,,
com.google.Chrome,33,1711553198,1711553231,1711553231.773632,-18000,,
com.microsoft.VSCode,19,1711553179,1711553198,1711553198.130342,-18000,,
com.google.Chrome,52,1711553127,1711553179,1711553179.623011,-18000,,
com.microsoft.Office.Outlook,42,1711552751,1711552793,1711552793.821364,-18000,EB445137-D7F5-57EC-87DA-1DB460D64046,"iPhone13,2"
com.microsoft.VSCode,406,1711552692,1711553098,1711553098.7402492,-18000,,
com.microsoft.Outlook,60,1711552632,1711552692,1711552692.5069299,-18000,,
com.microsoft.VSCode,131,1711552501,1711552632,1711552632.299346,-18000,,
com.microsoft.Outlook,14,1711552487,1711552501,1711552501.253714,-18000,,
com.microsoft.VSCode,3,1711552484,1711552487,1711552487.502945,-18000,,
com.microsoft.Outlook,3,1711552481,1711552484,1711552484.3031092,-18000,,
com.microsoft.VSCode,3,1711552478,1711552481,1711552481.807117,-18000,,
com.microsoft.Outlook,2,1711552476,1711552478,1711552478.1403909,-18000,,
com.microsoft.VSCode,5,1711552471,1711552476,1711552476.268921,-18000,,
com.microsoft.Outlook,6,1711552465,1711552471,1711552472.032516,-18000,,
com.microsoft.VSCode,4,1711552461,1711552465,1711552465.981851,-18000,,
com.microsoft.Outlook,5,1711552456,1711552461,1711552461.12797,-18000,,
com.microsoft.VSCode,0,1711552456,1711552456,1711552457.030165,-18000,,
com.microsoft.Outlook,4,1711552452,1711552456,1711552456.422371,-18000,,
com.microsoft.VSCode,5,1711552447,1711552452,1711552452.386056,-18000,,
com.microsoft.Outlook,22,1711552425,1711552447,1711552447.647314,-18000,,
com.microsoft.VSCode,128,1711552297,1711552425,1711552425.7206578,-18000,,
com.google.Chrome,1,1711552296,1711552297,1711552297.796946,-18000,,
com.microsoft.VSCode,152,1711552144,1711552296,1711552296.30057,-18000,,
com.google.Chrome,41,1711552103,1711552144,1711552144.6075668,-18000,,
com.microsoft.VSCode,96,1711552007,1711552103,1711552103.125732,-18000,,
com.google.Chrome,1,1711552006,1711552007,1711552007.91857,-18000,,
com.microsoft.VSCode,10,1711551996,1711552006,1711552006.684712,-18000,,
com.google.Chrome,2,1711551994,1711551996,1711551996.5008678,-18000,,
com.microsoft.VSCode,334,1711551660,1711551994,1711551994.930619,-18000,,
com.google.Chrome,10,1711551650,1711551660,1711551660.292093,-18000,,
com.microsoft.VSCode,658,1711550992,1711551650,1711551650.306839,-18000,,
com.google.Chrome,1,1711550991,1711550992,1711550992.3374062,-18000,,
com.microsoft.VSCode,17,1711550974,1711550991,1711550991.420955,-18000,,
com.google.Chrome,0,1711550974,1711550974,1711550974.917835,-18000,,
com.microsoft.VSCode,26,1711550948,1711550974,1711550974.433652,-18000,,
com.google.Chrome,13,1711550935,1711550948,1711550948.622325,-18000,,
com.microsoft.VSCode,44,1711550891,1711550935,1711550935.950706,-18000,,
com.google.Chrome,8,1711550883,1711550891,1711550891.628974,-18000,,
com.microsoft.VSCode,3,1711550880,1711550883,1711550883.6594381,-18000,,
com.google.Chrome,33,1711550847,1711550880,1711550880.382698,-18000,,
com.microsoft.VSCode,8,1711550839,1711550847,1711550847.737865,-18000,,
com.google.Chrome,28,1711550811,1711550839,1711550839.7961512,-18000,,
com.microsoft.VSCode,52,1711550759,1711550811,1711550811.333256,-18000,,
com.google.Chrome,23,1711550736,1711550759,1711550759.857171,-18000,,
com.microsoft.VSCode,8,1711550728,1711550736,1711550736.344633,-18000,,
com.google.Chrome,29,1711550699,1711550728,1711550728.594739,-18000,,
com.microsoft.VSCode,166,1711550533,1711550699,1711550699.886559,-18000,,
com.google.Chrome,1,1711550532,1711550533,1711550533.192662,-18000,,
com.microsoft.VSCode,353,1711550179,1711550532,1711550532.762013,-18000,,
com.google.Chrome,6,1711550173,1711550179,1711550179.749703,-18000,,
com.microsoft.VSCode,169,1711550004,1711550173,1711550174.056479,-18000,,
com.google.Chrome,25,1711549979,1711550004,1711550004.313692,-18000,,
com.microsoft.VSCode,18,1711549961,1711549979,1711549979.765099,-18000,,
com.apple.MobileSMS,81,1711549833,1711549914,1711549914.7701778,-18000,EB445137-D7F5-57EC-87DA-1DB460D64046,"iPhone13,2"
com.apple.MobileSMS,5,1711549646,1711549651,1711549651.1553159,-18000,EB445137-D7F5-57EC-87DA-1DB460D64046,"iPhone13,2"
com.microsoft.Office.Outlook,39,1711549607,1711549646,1711549646.675416,-18000,EB445137-D7F5-57EC-87DA-1DB460D64046,"iPhone13,2"
com.apple.MobileSMS,2,1711549605,1711549607,1711549607.949819,-18000,EB445137-D7F5-57EC-87DA-1DB460D64046,"iPhone13,2"
com.apple.MobileSMS,2,1711549600,1711549602,1711549602.79596,-18000,EB445137-D7F5-57EC-87DA-1DB460D64046,"iPhone13,2"
com.apple.MobileSMS,2,1711549313,1711549315,1711549315.821402,-18000,EB445137-D7F5-57EC-87DA-1DB460D64046,"iPhone13,2"
com.apple.MobileSMS,5,1711548677,1711548682,1711548682.304244,-18000,EB445137-D7F5-57EC-87DA-1DB460D64046,"iPhone13,2"
com.apple.MobileSMS,5,1711548629,1711548634,1711548634.802703,-18000,EB445137-D7F5-57EC-87DA-1DB460D64046,"iPhone13,2"
com.goodreads.Goodreads,48,1711513374,1711513422,1711513422.7658439,-18000,EB445137-D7F5-57EC-87DA-1DB460D64046,"iPhone13,2"
com.thestorygraph.thestorygraph,64,1711513309,1711513373,1711513373.9248152,-18000,EB445137-D7F5-57EC-87DA-1DB460D64046,"iPhone13,2"
com.apple.camera,0,1711512601,1711512601,1711512601.977044,-18000,EB445137-D7F5-57EC-87DA-1DB460D64046,"iPhone13,2"
com.thestorygraph.thestorygraph,32,1711512582,1711512614,1711512615.04594,-18000,EB445137-D7F5-57EC-87DA-1DB460D64046,"iPhone13,2"
com.thestorygraph.thestorygraph,3,1711512575,1711512578,1711512578.607985,-18000,EB445137-D7F5-57EC-87DA-1DB460D64046,"iPhone13,2"
com.thestorygraph.thestorygraph,89,1711511048,1711511137,1711511137.6789122,-18000,EB445137-D7F5-57EC-87DA-1DB460D64046,"iPhone13,2"
com.apple.journal,721,1711510324,1711511045,1711511045.46109,-18000,EB445137-D7F5-57EC-87DA-1DB460D64046,"iPhone13,2"
com.apple.Health,63,1711510260,1711510323,1711510323.2132812,-18000,EB445137-D7F5-57EC-87DA-1DB460D64046,"iPhone13,2"
com.apple.Music,11,1711510041,1711510052,1711510052.3874202,-18000,EB445137-D7F5-57EC-87DA-1DB460D64046,"iPhone13,2"
com.apple.Music,13,1711510023,1711510036,1711510036.628427,-18000,EB445137-D7F5-57EC-87DA-1DB460D64046,"iPhone13,2"
com.apple.Music,1,1711510017,1711510018,1711510019.0115461,-18000,EB445137-D7F5-57EC-87DA-1DB460D64046,"iPhone13,2"
com.microsoft.VSCode,41,1711509994,1711510035,1711510035.942253,-18000,,
com.apple.Music,2,1711508933,1711508935,1711508935.665776,-18000,EB445137-D7F5-57EC-87DA-1DB460D64046,"iPhone13,2"
com.microsoft.VSCode,3,1711508765,1711508768,1711508768.653506,-18000,,
com.leomehlig.today,70,1711508695,1711508765,1711508765.2132769,-18000,,
com.microsoft.VSCode,360,1711508335,1711508695,1711508695.250061,-18000,,
com.google.Chrome,8,1711508327,1711508335,1711508335.820812,-18000,,
com.microsoft.VSCode,25,1711508302,1711508327,1711508327.556072,-18000,,
com.google.Chrome,3,1711508299,1711508302,1711508302.110219,-18000,,
com.microsoft.VSCode,2,1711508297,1711508299,1711508299.718265,-18000,,
com.google.Chrome,5,1711508292,1711508297,1711508297.1290898,-18000,,
com.microsoft.VSCode,3,1711508289,1711508292,1711508292.1449351,-18000,,
com.google.Chrome,2,1711508287,1711508289,1711508289.6657,-18000,,
com.apple.Music,6,1711508276,1711508282,1711508282.664763,-18000,EB445137-D7F5-57EC-87DA-1DB460D64046,"iPhone13,2"
com.microsoft.VSCode,62,1711508225,1711508287,1711508287.6073399,-18000,,
com.google.Chrome,56,1711508169,1711508225,1711508225.441115,-18000,,
com.microsoft.VSCode,177,1711507992,1711508169,1711508169.38223,-18000,,
com.google.Chrome,4,1711507988,1711507992,1711507992.202115,-18000,,
com.microsoft.VSCode,23,1711507965,1711507988,1711507989.0192208,-18000,,
com.google.Chrome,5,1711507960,1711507965,1711507965.9115891,-18000,,
com.apple.Music,6,1711507775,1711507781,1711507781.440855,-18000,EB445137-D7F5-57EC-87DA-1DB460D64046,"iPhone13,2"
com.microsoft.VSCode,515,1711507445,1711507960,1711507960.720206,-18000,,
com.google.Chrome,40,1711507405,1711507445,1711507445.772232,-18000,,
com.microsoft.VSCode,1307,1711506098,1711507405,1711507406.346523,-18000,,
com.leomehlig.today,19,1711506079,1711506098,1711506098.484013,-18000,,
com.apple.Music,12,1711504580,1711504592,1711504592.2251658,-18000,EB445137-D7F5-57EC-87DA-1DB460D64046,"iPhone13,2"
com.apple.Music,6,1711503330,1711503336,1711503336.392698,-18000,EB445137-D7F5-57EC-87DA-1DB460D64046,"iPhone13,2"
com.apple.Music,3,1711501630,1711501633,1711501633.7057939,-18000,EB445137-D7F5-57EC-87DA-1DB460D64046,"iPhone13,2"
com.apple.Music,13,1711501591,1711501604,1711501604.949421,-18000,EB445137-D7F5-57EC-87DA-1DB460D64046,"iPhone13,2"
com.microsoft.Office.Outlook,18,1711501571,1711501589,1711501589.74242,-18000,EB445137-D7F5-57EC-87DA-1DB460D64046,"iPhone13,2"
com.microsoft.VSCode,4701,1711501378,1711506079,1711506079.340606,-18000,,
com.leomehlig.today,2,1711501376,1711501378,1711501378.392667,-18000,,
com.hnc.Discord,1,1711501375,1711501376,1711501376.888341,-18000,,
com.apple.Preview,15,1711501360,1711501375,1711501375.997869,-18000,,
com.leomehlig.today,12,1711501348,1711501360,1711501360.735602,-18000,,
com.google.Chrome,13,1711501335,1711501348,1711501348.2870522,-18000,,
com.apple.MobileSMS,2,1711501243,1711501245,1711501245.3485332,-18000,EB445137-D7F5-57EC-87DA-1DB460D64046,"iPhone13,2"
com.apple.weather,3,1711501240,1711501243,1711501243.611856,-18000,EB445137-D7F5-57EC-87DA-1DB460D64046,"iPhone13,2"
com.apple.weather,6,1711501203,1711501209,1711501209.068594,-18000,EB445137-D7F5-57EC-87DA-1DB460D64046,"iPhone13,2"
com.apple.MobileSMS,5,1711501186,1711501191,1711501191.216117,-18000,EB445137-D7F5-57EC-87DA-1DB460D64046,"iPhone13,2"
edu.illinois.rokwire.ios,1,1711501185,1711501186,1711501187.13067,-18000,EB445137-D7F5-57EC-87DA-1DB460D64046,"iPhone13,2"
edu.illinois.rokwire.ios,4,1711501117,1711501121,1711501121.5249372,-18000,EB445137-D7F5-57EC-87DA-1DB460D64046,"iPhone13,2"
edu.illinois.rokwire.ios,6,1711501110,1711501116,1711501116.089251,-18000,EB445137-D7F5-57EC-87DA-1DB460D64046,"iPhone13,2"
edu.illinois.rokwire.ios,10,1711500860,1711500870,1711500870.480283,-18000,EB445137-D7F5-57EC-87DA-1DB460D64046,"iPhone13,2"
edu.illinois.rokwire.ios,10,1711500740,1711500750,1711500750.4834719,-18000,EB445137-D7F5-57EC-87DA-1DB460D64046,"iPhone13,2"
edu.illinois.rokwire.ios,10,1711500620,1711500630,1711500630.5412621,-18000,EB445137-D7F5-57EC-87DA-1DB460D64046,"iPhone13,2"
com.google.Chrome,312,1711499072,1711499384,1711499385.062597,-18000,,
com.leomehlig.today,2,1711499070,1711499072,1711499073.163539,-18000,,
edu.illinois.rokwire.ios,8,1711498967,1711498975,1711498975.658018,-18000,EB445137-D7F5-57EC-87DA-1DB460D64046,"iPhone13,2"
edu.illinois.rokwire.ios,6,1711498525,1711498531,1711498531.9077501,-18000,EB445137-D7F5-57EC-87DA-1DB460D64046,"iPhone13,2"
com.google.chrome.ios,18,1711498070,1711498088,1711498088.402822,-18000,EB445137-D7F5-57EC-87DA-1DB460D64046,"iPhone13,2"
com.instructure.icanvas,15,1711498055,1711498070,1711498070.494895,-18000,EB445137-D7F5-57EC-87DA-1DB460D64046,"iPhone13,2"
com.apple.Music,10,1711498045,1711498055,1711498055.218789,-18000,EB445137-D7F5-57EC-87DA-1DB460D64046,"iPhone13,2"
com.apple.Music,25,1711498005,1711498030,1711498030.5655499,-18000,EB445137-D7F5-57EC-87DA-1DB460D64046,"iPhone13,2"
edu.illinois.rokwire.ios,3,1711498000,1711498003,1711498004.003316,-18000,EB445137-D7F5-57EC-87DA-1DB460D64046,"iPhone13,2"
edu.illinois.rokwire.ios,6,1711497988,1711497994,1711497994.632299,-18000,EB445137-D7F5-57EC-87DA-1DB460D64046,"iPhone13,2"
com.leomehlig.today,124,1711497793,1711497917,1711497917.462374,-18000,,
com.apple.iCal,33,1711497760,1711497793,1711497793.533585,-18000,,
com.leomehlig.today,2,1711497758,1711497760,1711497761.0393329,-18000,,
com.google.Chrome,39,1711497719,1711497758,1711497759.055561,-18000,,
com.leomehlig.today,109,1711497610,1711497719,1711497720.0539699,-18000,,
com.google.Chrome,15,1711497595,1711497610,1711497610.718055,-18000,,
com.google.Chrome,700,1711496629,1711497329,1711497329.305787,-18000,,
com.apple.Preview,2,1711496627,1711496629,1711496629.660009,-18000,,
com.hnc.Discord,116,1711496511,1711496627,1711496627.565032,-18000,,
com.google.Chrome,3,1711496508,1711496511,1711496511.8028312,-18000,,
com.hnc.Discord,43,1711496465,1711496508,1711496508.7121282,-18000,,
com.google.Chrome,7,1711496458,1711496465,1711496465.432877,-18000,,
com.hnc.Discord,106,1711496352,1711496458,1711496458.4156141,-18000,,
com.google.Chrome,1,1711496351,1711496352,1711496352.721843,-18000,,
com.hnc.Discord,12,1711496339,1711496351,1711496351.379115,-18000,,
com.google.Chrome,280,1711496059,1711496339,1711496339.9696732,-18000,,
com.hnc.Discord,35,1711496024,1711496059,1711496059.487422,-18000,,
com.google.Chrome,133,1711495891,1711496024,1711496024.9058518,-18000,,
com.apple.Preview,83,1711495808,1711495891,1711495891.307622,-18000,,
com.google.Chrome,10,1711495798,1711495808,1711495808.943932,-18000,,
com.apple.Preview,38,1711495760,1711495798,1711495798.160812,-18000,,
com.google.Chrome,4,1711495756,1711495760,1711495760.577966,-18000,,
com.apple.Preview,291,1711495465,1711495756,1711495756.3916512,-18000,,
com.apple.MobileSMS,13,1711495452,1711495465,1711495465.789826,-18000,,
com.apple.Preview,9,1711495443,1711495452,1711495452.9320478,-18000,,
com.google.Chrome,21,1711495422,1711495443,1711495443.952481,-18000,,
com.apple.Preview,88,1711495334,1711495422,1711495422.26929,-18000,,
com.hnc.Discord,16,1711495318,1711495334,1711495334.39165,-18000,,
com.apple.Preview,517,1711494801,1711495318,1711495318.404221,-18000,,
com.apple.finder,4,1711494797,1711494801,1711494801.608211,-18000,,
com.google.Chrome,20,1711494777,1711494797,1711494797.5479832,-18000,,
com.hnc.Discord,1,1711494776,1711494777,1711494777.942692,-18000,,
com.apple.finder,29,1711494747,1711494776,1711494776.474607,-18000,,
com.google.Chrome,37,1711494710,1711494747,1711494747.2986941,-18000,,
com.hnc.Discord,311,1711494399,1711494710,1711494710.660207,-18000,,
com.google.Chrome,62,1711494337,1711494399,1711494399.707969,-18000,,
com.hnc.Discord,37,1711494300,1711494337,1711494337.9185982,-18000,,
com.apple.MobileSMS,16,1711494284,1711494300,1711494300.180283,-18000,,
com.hnc.Discord,1,1711494283,1711494284,1711494284.7690601,-18000,,
com.apple.MobileSMS,6,1711494277,1711494283,1711494283.464363,-18000,,
com.hnc.Discord,3,1711494274,1711494277,1711494277.6128302,-18000,,
com.google.Chrome,10,1711494264,1711494274,1711494274.65555,-18000,,
com.hnc.Discord,9,1711494255,1711494264,1711494264.5410419,-18000,,
com.google.Chrome,57,1711494198,1711494255,1711494255.781919,-18000,,
com.leomehlig.today,44,1711494154,1711494198,1711494199.0254312,-18000,,
com.apple.iCal,13,1711494141,1711494154,1711494154.856254,-18000,,
com.leomehlig.today,58,1711494083,1711494141,1711494141.1198668,-18000,,
edu.illinois.rokwire.ios,2,1711491265,1711491267,1711491267.419323,-18000,EB445137-D7F5-57EC-87DA-1DB460D64046,"iPhone13,2"
edu.illinois.rokwire.ios,22,1711490425,1711490447,1711490447.384244,-18000,EB445137-D7F5-57EC-87DA-1DB460D64046,"iPhone13,2"
com.burbn.instagram,6,1711490387,1711490393,1711490393.780731,-18000,EB445137-D7F5-57EC-87DA-1DB460D64046,"iPhone13,2"
com.burbn.instagram,35,1711490351,1711490386,1711490386.794415,-18000,EB445137-D7F5-57EC-87DA-1DB460D64046,"iPhone13,2"
edu.illinois.rokwire.ios,2,1711490348,1711490350,1711490350.815939,-18000,EB445137-D7F5-57EC-87DA-1DB460D64046,"iPhone13,2"
edu.illinois.rokwire.ios,24,1711488563,1711488587,1711488587.808862,-18000,EB445137-D7F5-57EC-87DA-1DB460D64046,"iPhone13,2"
com.google.Maps,3,1711488560,1711488563,1711488563.138571,-18000,EB445137-D7F5-57EC-87DA-1DB460D64046,"iPhone13,2"
com.google.Maps,1,1711488420,1711488421,1711488421.6875749,-18000,EB445137-D7F5-57EC-87DA-1DB460D64046,"iPhone13,2"
com.google.Maps,2,1711488227,1711488229,1711488229.074866,-18000,EB445137-D7F5-57EC-87DA-1DB460D64046,"iPhone13,2"
com.google.Maps,2,1711487891,1711487893,1711487893.5101,-18000,EB445137-D7F5-57EC-87DA-1DB460D64046,"iPhone13,2"
com.google.Maps,16,1711487860,1711487876,1711487876.572382,-18000,EB445137-D7F5-57EC-87DA-1DB460D64046,"iPhone13,2"
com.leomehlig.today,11,1711485316,1711485327,1711485327.908846,-18000,,
com.google.Chrome,18,1711485298,1711485316,1711485316.270549,-18000,,
com.leomehlig.today,26,1711485272,1711485298,1711485298.770766,-18000,,
com.google.Chrome,490,1711484782,1711485272,1711485272.112424,-18000,,
com.google.Chrome,3,1711484629,1711484632,1711484632.4432611,-18000,,
com.leomehlig.today,10,1711484619,1711484629,1711484629.410219,-18000,,
com.google.Chrome,4,1711484615,1711484619,1711484619.618108,-18000,,
com.leomehlig.today,9,1711484606,1711484615,1711484615.3801808,-18000,,
com.microsoft.Excel,102,1711484504,1711484606,1711484606.260458,-18000,,
com.leomehlig.today,2,1711484502,1711484504,1711484504.2973142,-18000,,
us.zoom.xos,9,1711484493,1711484502,1711484502.47782,-18000,,
com.microsoft.Excel,6,1711484487,1711484493,1711484493.3034549,-18000,,
com.leomehlig.today,5,1711484482,1711484487,1711484487.93601,-18000,,
com.microsoft.Excel,23,1711484459,1711484482,1711484482.794541,-18000,,
com.leomehlig.today,5,1711484454,1711484459,1711484460.047358,-18000,,
com.microsoft.Excel,25,1711484429,1711484454,1711484454.362304,-18000,,
com.leomehlig.today,20,1711484409,1711484429,1711484429.6196718,-18000,,
com.microsoft.Excel,2,1711484407,1711484409,1711484409.3527532,-18000,,
com.leomehlig.today,3,1711484404,1711484407,1711484407.1091418,-18000,,
com.microsoft.Excel,17,1711484387,1711484404,1711484404.280707,-18000,,
com.apple.finder,13,1711484374,1711484387,1711484387.9971352,-18000,,
us.zoom.xos,52,1711484322,1711484374,1711484374.185251,-18000,,
com.microsoft.VSCode,15,1711484307,1711484322,1711484322.161344,-18000,,
com.leomehlig.today,18,1711484289,1711484307,1711484307.512167,-18000,,
us.zoom.xos,6,1711484283,1711484289,1711484289.385232,-18000,,
com.apple.finder,16,1711484267,1711484283,1711484283.069005,-18000,,
com.apple.systempreferences,1,1711484266,1711484267,1711484268.034154,-18000,,
com.apple.finder,22,1711484237,1711484259,1711484259.974966,-18000,,
us.zoom.xos,3,1711484234,1711484237,1711484237.178534,-18000,,
com.apple.MobileSMS,6,1711484228,1711484234,1711484234.7139978,-18000,,
us.zoom.xos,2,1711484226,1711484228,1711484228.847475,-18000,,
com.apple.MobileSMS,1,1711484225,1711484226,1711484227.020397,-18000,,
com.bresink.system.tinkertool,19,1711484206,1711484225,1711484225.191566,-18000,,
com.google.Chrome,32,1711484174,1711484206,1711484206.0690498,-18000,,
com.apple.MobileSMS,14,1711484160,1711484174,1711484175.7839432,-18000,,
us.zoom.xos,11,1711484149,1711484160,1711484160.941333,-18000,,
com.apple.news,477,1711483495,1711483972,1711483972.423948,-18000,EB445137-D7F5-57EC-87DA-1DB460D64046,"iPhone13,2"
com.apple.Health,73,1711483344,1711483417,1711483417.622643,-18000,EB445137-D7F5-57EC-87DA-1DB460D64046,"iPhone13,2"
us.zoom.xos,487,1711483303,1711483790,1711483790.323812,-18000,,
com.microsoft.Office.Outlook,46,1711483257,1711483303,1711483303.793764,-18000,EB445137-D7F5-57EC-87DA-1DB460D64046,"iPhone13,2"
com.tinyspeck.chatlyio,11,1711483246,1711483257,1711483257.117554,-18000,EB445137-D7F5-57EC-87DA-1DB460D64046,"iPhone13,2"
com.leomehlig.today,92,1711483211,1711483303,1711483304.031322,-18000,,
com.google.Chrome,16,1711483195,1711483211,1711483212.020201,-18000,,
com.apple.MobileSMS,12,1711483183,1711483195,1711483195.636956,-18000,,
com.google.Chrome,29,1711483154,1711483183,1711483184.03267,-18000,,
com.apple.MobileSMS,14,1711483140,1711483154,1711483154.155819,-18000,,
com.google.Chrome,23,1711483117,1711483140,1711483140.693225,-18000,,
com.apple.MobileSMS,17,1711483100,1711483117,1711483117.665835,-18000,,
com.google.Chrome,17,1711483083,1711483100,1711483100.747484,-18000,,
com.tinyspeck.chatlyio,68,1711483063,1711483131,1711483131.058776,-18000,EB445137-D7F5-57EC-87DA-1DB460D64046,"iPhone13,2"
com.apple.Health,3,1711483059,1711483062,1711483062.115155,-18000,EB445137-D7F5-57EC-87DA-1DB460D64046,"iPhone13,2"
com.apple.MobileSMS,44,1711483039,1711483083,1711483084.538141,-18000,,
us.zoom.xos,9,1711483030,1711483039,1711483039.6412868,-18000,,
com.apple.MobileSMS,12,1711483018,1711483030,1711483030.746726,-18000,,
us.zoom.xos,28,1711482990,1711483018,1711483018.378201,-18000,,
com.leomehlig.today,6,1711482984,1711482990,1711482990.555918,-18000,,
com.apple.MobileSMS,37,1711482947,1711482984,1711482984.94069,-18000,,
com.leomehlig.today,133,1711482814,1711482947,1711482947.6155128,-18000,,
us.zoom.xos,10,1711482804,1711482814,1711482814.385818,-18000,,
com.apple.Health,5,1711482801,1711482806,1711482806.8556762,-18000,EB445137-D7F5-57EC-87DA-1DB460D64046,"iPhone13,2"
com.toyopagroup.picaboo,54,1711482744,1711482798,1711482798.719224,-18000,EB445137-D7F5-57EC-87DA-1DB460D64046,"iPhone13,2"
com.apple.MobileSMS,46,1711482696,1711482742,1711482742.242577,-18000,EB445137-D7F5-57EC-87DA-1DB460D64046,"iPhone13,2"
edu.illinois.rokwire.ios,79,1711482617,1711482696,1711482696.736809,-18000,EB445137-D7F5-57EC-87DA-1DB460D64046,"iPhone13,2"
com.leomehlig.today,210,1711482594,1711482804,1711482804.931988,-18000,,
com.microsoft.onenote.mac,16,1711482578,1711482594,1711482595.0869,-18000,,
com.google.Chrome,257,1711482321,1711482578,1711482578.714456,-18000,,
com.apple.PosterBoard,2,1711482318,1711482320,1711482320.277659,-18000,EB445137-D7F5-57EC-87DA-1DB460D64046,"iPhone13,2"
com.microsoft.onenote.mac,123,1711482198,1711482321,1711482321.821976,-18000,,
com.apple.iCal,1,1711482197,1711482198,1711482199.0287309,-18000,,
com.google.Chrome,2,1711482195,1711482197,1711482197.387578,-18000,,
com.apple.iCal,5,1711482190,1711482195,1711482195.612973,-18000,,
com.microsoft.onenote.mac,26,1711482164,1711482190,1711482190.87718,-18000,,
com.apple.iCal,3,1711482161,1711482164,1711482164.053907,-18000,,
com.microsoft.onenote.mac,3,1711482158,1711482161,1711482161.770073,-18000,,
com.apple.iCal,11,1711482147,1711482158,1711482158.32028,-18000,,
com.microsoft.onenote.mac,25,1711482122,1711482147,1711482147.757103,-18000,,
com.google.Chrome,69,1711482053,1711482122,1711482122.93888,-18000,,
us.zoom.xos,2,1711482051,1711482053,1711482053.241575,-18000,,
com.google.Chrome,123,1711481928,1711482051,1711482051.413803,-18000,,
com.whentowork.iOS.WhenToWork-Employee-Scheduling,123,1711481925,1711482048,1711482048.963694,-18000,EB445137-D7F5-57EC-87DA-1DB460D64046,"iPhone13,2"
us.zoom.xos,1,1711481877,1711481878,1711481878.1983051,-18000,,
com.planetfitness.lunkinator,96,1711481649,1711481745,1711481745.4876819,-18000,EB445137-D7F5-57EC-87DA-1DB460D64046,"iPhone13,2"
com.truebill.truebillnative,199,1711481381,1711481580,1711481580.73699,-18000,EB445137-D7F5-57EC-87DA-1DB460D64046,"iPhone13,2"
com.goodreads.Goodreads,3,1711481374,1711481377,1711481377.52331,-18000,EB445137-D7F5-57EC-87DA-1DB460D64046,"iPhone13,2"
us.zoom.xos,490,1711481292,1711481782,1711481782.985168,-18000,,
com.google.Chrome,245,1711481047,1711481292,1711481292.741601,-18000,,
us.zoom.xos,11,1711481036,1711481047,1711481047.4070668,-18000,,
com.google.Chrome,167,1711480869,1711481036,1711481036.1388888,-18000,,
us.zoom.xos,6,1711480863,1711480869,1711480870.05987,-18000,,
com.google.Chrome,155,1711480708,1711480863,1711480864.046125,-18000,,
us.zoom.xos,3,1711480705,1711480708,1711480708.9025111,-18000,,
com.google.Chrome,1,1711480704,1711480705,1711480705.956775,-18000,,
com.apple.Preview,2,1711480702,1711480704,1711480704.3197742,-18000,,
com.goodreads.Goodreads,158,1711480431,1711480589,1711480589.859868,-18000,EB445137-D7F5-57EC-87DA-1DB460D64046,"iPhone13,2"
com.google.Chrome,314,1711480388,1711480702,1711480702.7621331,-18000,,
us.zoom.xos,5,1711480383,1711480388,1711480388.650488,-18000,,
com.google.Chrome,187,1711480196,1711480383,1711480383.628036,-18000,,
us.zoom.xos,9,1711480187,1711480196,1711480196.801934,-18000,,
com.apple.iCal,120,1711480067,1711480187,1711480187.655867,-18000,,
com.tinyspeck.chatlyio,119,1711480034,1711480153,1711480153.21072,-18000,EB445137-D7F5-57EC-87DA-1DB460D64046,"iPhone13,2"
com.instructure.icanvas,130,1711479900,1711480030,1711480030.658774,-18000,EB445137-D7F5-57EC-87DA-1DB460D64046,"iPhone13,2"
com.moodle.moodlemobile,3,1711479897,1711479900,1711479900.870908,-18000,EB445137-D7F5-57EC-87DA-1DB460D64046,"iPhone13,2"
us.zoom.xos,185,1711479882,1711480067,1711480067.129974,-18000,,
com.apple.iCal,25,1711479857,1711479882,1711479882.96071,-18000,,
com.microsoft.Outlook,47,1711479810,1711479857,1711479857.992842,-18000,,
com.microsoft.VSCode,102,1711479708,1711479810,1711479810.513103,-18000,,
com.apple.finder,8,1711479700,1711479708,1711479708.487187,-18000,,
com.microsoft.Outlook,21,1711479679,1711479700,1711479700.321404,-18000,,
us.zoom.xos,77,1711479602,1711479679,1711479679.177376,-18000,,
com.google.Chrome,1,1711479601,1711479602,1711479602.717392,-18000,,
us.zoom.xos,1,1711479600,1711479601,1711479601.5284,-18000,,
com.google.Chrome,5,1711479595,1711479600,1711479600.163806,-18000,,
com.leomehlig.today,78,1711479517,1711479595,1711479595.746255,-18000,,
com.apple.finder,40,1711479477,1711479517,1711479517.154759,-18000,,
com.apple.archiveutility,0,1711479477,1711479477,1711479477.91874,-18000,,
com.apple.finder,6,1711479471,1711479477,1711479477.626452,-18000,,
com.google.Chrome,22,1711479449,1711479471,1711479471.441403,-18000,,
com.microsoft.VSCode,1,1711479448,1711479449,1711479449.288221,-18000,,
com.apple.MobileSMS,9,1711479439,1711479448,1711479448.16986,-18000,,
com.microsoft.VSCode,625,1711478814,1711479439,1711479439.266855,-18000,,
com.google.Chrome,7,1711478807,1711478814,1711478814.118587,-18000,,
com.microsoft.VSCode,738,1711478069,1711478807,1711478807.9042702,-18000,,
com.google.Chrome,10,1711478059,1711478069,1711478069.893025,-18000,,
com.microsoft.VSCode,66,1711477993,1711478059,1711478059.461973,-18000,,
com.apple.finder,1,1711477992,1711477993,1711477993.326462,-18000,,
com.google.Chrome,12,1711477980,1711477992,1711477992.452246,-18000,,
com.apple.finder,0,1711477980,1711477980,1711477981.054007,-18000,,
com.microsoft.VSCode,4,1711477976,1711477980,1711477980.375414,-18000,,
com.apple.finder,1,1711477975,1711477976,1711477976.286127,-18000,,
com.google.Chrome,20,1711477955,1711477975,1711477975.4219918,-18000,,
com.apple.finder,1,1711477954,1711477955,1711477955.3251019,-18000,,
com.microsoft.VSCode,48,1711477906,1711477954,1711477954.54914,-18000,,
com.apple.finder,1,1711477905,1711477906,1711477906.2524781,-18000,,
com.google.Chrome,14,1711477891,1711477905,1711477905.3223472,-18000,,
com.apple.finder,1,1711477890,1711477891,1711477891.765074,-18000,,
com.microsoft.VSCode,91,1711477799,1711477890,1711477890.745748,-18000,,
com.apple.finder,16,1711477783,1711477799,1711477799.91392,-18000,,
com.google.Chrome,217,1711477566,1711477783,1711477783.786639,-18000,,
com.microsoft.VSCode,3,1711477563,1711477566,1711477566.501751,-18000,,
com.google.Chrome,138,1711477425,1711477563,1711477563.775704,-18000,,
com.microsoft.VSCode,615,1711476810,1711477425,1711477426.045918,-18000,,
com.google.Chrome,1,1711476809,1711476810,1711476810.662368,-18000,,
com.microsoft.VSCode,343,1711476466,1711476809,1711476809.909745,-18000,,
com.google.Chrome,1,1711476465,1711476466,1711476467.005048,-18000,,
com.microsoft.VSCode,6,1711476459,1711476465,1711476465.6286678,-18000,,
com.google.Chrome,1,1711476458,1711476459,1711476459.089977,-18000,,
com.microsoft.VSCode,9,1711476449,1711476458,1711476458.192702,-18000,,
com.google.Chrome,2,1711476447,1711476449,1711476449.303999,-18000,,
com.microsoft.VSCode,427,1711476020,1711476447,1711476447.98651,-18000,,
com.google.Chrome,9,1711476011,1711476020,1711476020.226742,-18000,,
com.leomehlig.today,11,1711476000,1711476011,1711476011.413348,-18000,,
com.google.Chrome,64,1711475936,1711476000,1711476000.502661,-18000,,
com.moodle.moodlemobile,4,1711475589,1711475593,1711475593.715581,-18000,EB445137-D7F5-57EC-87DA-1DB460D64046,"iPhone13,2"
com.moodle.moodlemobile,36,1711472710,1711472746,1711472746.596541,-18000,EB445137-D7F5-57EC-87DA-1DB460D64046,"iPhone13,2"
com.google.chrome.ios,83,1711472627,1711472710,1711472710.6056008,-18000,EB445137-D7F5-57EC-87DA-1DB460D64046,"iPhone13,2"
com.moodle.moodlemobile,47,1711472580,1711472627,1711472627.6024761,-18000,EB445137-D7F5-57EC-87DA-1DB460D64046,"iPhone13,2"
com.google.chrome.ios,112,1711472465,1711472577,1711472577.164824,-18000,EB445137-D7F5-57EC-87DA-1DB460D64046,"iPhone13,2"
com.goodreads.Goodreads,112,1711472353,1711472465,1711472465.253735,-18000,EB445137-D7F5-57EC-87DA-1DB460D64046,"iPhone13,2"
com.google.chrome.ios,32,1711472321,1711472353,1711472353.185128,-18000,EB445137-D7F5-57EC-87DA-1DB460D64046,"iPhone13,2"
com.google.chrome.ios,10,1711472311,1711472321,1711472321.943818,-18000,EB445137-D7F5-57EC-87DA-1DB460D64046,"iPhone13,2"
com.strava.stravaride,30,1711472280,1711472310,1711472310.232222,-18000,EB445137-D7F5-57EC-87DA-1DB460D64046,"iPhone13,2"
com.apple.mobilecal,3,1711472277,1711472280,1711472280.4432569,-18000,EB445137-D7F5-57EC-87DA-1DB460D64046,"iPhone13,2"
com.apple.mobilecal,1,1711472194,1711472195,1711472195.86179,-18000,EB445137-D7F5-57EC-87DA-1DB460D64046,"iPhone13,2"
com.apple.mobilecal,2,1711472190,1711472192,1711472192.801807,-18000,EB445137-D7F5-57EC-87DA-1DB460D64046,"iPhone13,2"
com.apple.Health,3,1711472186,1711472189,1711472189.391405,-18000,EB445137-D7F5-57EC-87DA-1DB460D64046,"iPhone13,2"
com.google.Chrome,315,1711471428,1711471743,1711471743.254529,-18000,,
com.leomehlig.today,17,1711471411,1711471428,1711471428.824678,-18000,,
com.google.Chrome,2385,1711469026,1711471411,1711471411.365099,-18000,,
com.apple.Health,3,1711468798,1711468801,1711468801.794975,-18000,EB445137-D7F5-57EC-87DA-1DB460D64046,"iPhone13,2"
com.apple.Health,10,1711468174,1711468184,1711468184.450194,-18000,EB445137-D7F5-57EC-87DA-1DB460D64046,"iPhone13,2"
com.apple.Health,239,1711467914,1711468153,1711468153.140926,-18000,EB445137-D7F5-57EC-87DA-1DB460D64046,"iPhone13,2"
com.strava.stravaride,119,1711467794,1711467913,1711467913.9411201,-18000,EB445137-D7F5-57EC-87DA-1DB460D64046,"iPhone13,2"
com.apple.news,3,1711467786,1711467789,1711467790.055461,-18000,EB445137-D7F5-57EC-87DA-1DB460D64046,"iPhone13,2"
com.apple.news,61,1711466960,1711467021,1711467022.007946,-18000,EB445137-D7F5-57EC-87DA-1DB460D64046,"iPhone13,2"
com.tinyspeck.chatlyio,27,1711466742,1711466769,1711466769.5752702,-18000,EB445137-D7F5-57EC-87DA-1DB460D64046,"iPhone13,2"
edu.illinois.rokwire.ios,38,1711466702,1711466740,1711466740.310817,-18000,EB445137-D7F5-57EC-87DA-1DB460D64046,"iPhone13,2"
com.google.Chrome,5,1711466676,1711466681,1711466681.2005029,-18000,,
com.leomehlig.today,32,1711466644,1711466676,1711466676.978837,-18000,,
com.google.Chrome,1,1711466643,1711466644,1711466644.602919,-18000,,
com.leomehlig.today,12,1711466631,1711466643,1711466643.4390302,-18000,,
com.google.Chrome,3,1711466628,1711466631,1711466631.897486,-18000,,
com.leomehlig.today,12,1711466616,1711466628,1711466628.365117,-18000,,
com.google.Chrome,2,1711466614,1711466616,1711466616.933445,-18000,,
com.leomehlig.today,16,1711466598,1711466614,1711466614.303309,-18000,,
com.google.Chrome,4,1711466594,1711466598,1711466598.1894841,-18000,,
com.leomehlig.today,21,1711466573,1711466594,1711466594.535668,-18000,,
com.google.Chrome,60,1711466513,1711466573,1711466573.05554,-18000,,
com.leomehlig.today,20,1711466493,1711466513,1711466513.249619,-18000,,
com.google.Chrome,4,1711466489,1711466493,1711466493.159513,-18000,,
com.leomehlig.today,71,1711466418,1711466489,1711466489.938487,-18000,,
com.google.Chrome,189,1711466229,1711466418,1711466418.1930141,-18000,,
com.apple.weather,0,1711464115,1711464115,1711464115.227926,-18000,EB445137-D7F5-57EC-87DA-1DB460D64046,"iPhone13,2"
com.apple.weather,8,1711461647,1711461655,1711461655.654951,-18000,EB445137-D7F5-57EC-87DA-1DB460D64046,"iPhone13,2"
com.apple.weather,7,1711461637,1711461644,1711461644.430293,-18000,EB445137-D7F5-57EC-87DA-1DB460D64046,"iPhone13,2"
com.burbn.instagram,585,1711460802,1711461387,1711461387.685543,-18000,EB445137-D7F5-57EC-87DA-1DB460D64046,"iPhone13,2"
com.apple.Health,34,1711460744,1711460778,1711460778.317258,-18000,EB445137-D7F5-57EC-87DA-1DB460D64046,"iPhone13,2"
com.apple.weather,40,1711460634,1711460674,1711460674.5659862,-18000,EB445137-D7F5-57EC-87DA-1DB460D64046,"iPhone13,2"
com.google.Chrome,6,1711426282,1711426288,1711426288.3262959,-18000,,
com.google.Chrome,300,1711425915,1711426215,1711426215.742408,-18000,,
com.leomehlig.today,41,1711425874,1711425915,1711425915.778497,-18000,,
com.google.Chrome,119,1711425755,1711425874,1711425874.3430948,-18000,,
com.google.Chrome,397,1711425157,1711425554,1711425554.9866,-18000,,
com.apple.Preview,120,1711425037,1711425157,1711425157.526398,-18000,,
com.google.Chrome,587,1711424450,1711425037,1711425037.268293,-18000,,
com.leomehlig.today,25,1711424425,1711424450,1711424450.189445,-18000,,
com.google.Chrome,51,1711424374,1711424425,1711424425.414289,-18000,,
com.apple.Preview,5,1711424369,1711424374,1711424374.3140001,-18000,,
com.google.Chrome,651,1711423718,1711424369,1711424369.31303,-18000,,
com.apple.Preview,8,1711423710,1711423718,1711423718.138053,-18000,,
com.google.Chrome,10,1711423700,1711423710,1711423710.075654,-18000,,
com.apple.Preview,154,1711423546,1711423700,1711423700.161133,-18000,,
com.google.Chrome,250,1711423296,1711423546,1711423546.5504708,-18000,,
com.apple.Preview,27,1711423269,1711423296,1711423296.270716,-18000,,
com.google.Chrome,2,1711423267,1711423269,1711423269.4943008,-18000,,
com.apple.Preview,7,1711423260,1711423267,1711423267.968149,-18000,,
com.google.Chrome,672,1711422588,1711423260,1711423260.585304,-18000,,
com.apple.Preview,1,1711422587,1711422588,1711422588.9853911,-18000,,
com.google.Chrome,12,1711422575,1711422587,1711422588.0275822,-18000,,
com.apple.Preview,12,1711422563,1711422575,1711422575.767702,-18000,,
com.google.Chrome,1259,1711421304,1711422563,1711422563.428541,-18000,,
com.apple.Preview,83,1711421221,1711421304,1711421304.601418,-18000,,
com.google.Chrome,2,1711421219,1711421221,1711421221.764045,-18000,,
com.apple.Preview,12,1711421207,1711421219,1711421219.401087,-18000,,
com.google.Chrome,180,1711421027,1711421207,1711421207.5625281,-18000,,
com.apple.Preview,81,1711420946,1711421027,1711421027.9068398,-18000,,
com.google.Chrome,368,1711420578,1711420946,1711420946.5109181,-18000,,
com.apple.Preview,0,1711420578,1711420578,1711420578.468677,-18000,,
com.google.Chrome,31,1711420547,1711420578,1711420578.0680509,-18000,,
com.apple.Preview,97,1711420450,1711420547,1711420547.5417519,-18000,,
com.google.Chrome,478,1711419972,1711420450,1711420450.307998,-18000,,
com.apple.Preview,58,1711419914,1711419972,1711419972.735295,-18000,,
com.google.Chrome,167,1711419747,1711419914,1711419915.010982,-18000,,
com.apple.Preview,86,1711419661,1711419747,1711419747.578624,-18000,,
com.google.Chrome,1328,1711418333,1711419661,1711419661.641231,-18000,,
com.apple.Preview,4,1711418329,1711418333,1711418333.318527,-18000,,
com.google.Chrome,24,1711418305,1711418329,1711418329.705281,-18000,,
com.apple.Preview,26,1711418279,1711418305,1711418305.718971,-18000,,
com.google.Chrome,340,1711417939,1711418279,1711418279.214143,-18000,,
com.apple.Preview,9,1711417930,1711417939,1711417939.911852,-18000,,
com.google.Chrome,24,1711417906,1711417930,1711417930.412517,-18000,,
com.apple.Preview,122,1711417784,1711417906,1711417906.277319,-18000,,
com.google.Chrome,3,1711417781,1711417784,1711417784.3462958,-18000,,
com.apple.Preview,53,1711417728,1711417781,1711417781.9253979,-18000,,
com.apple.finder,1,1711417727,1711417728,1711417728.6316361,-18000,,
com.google.Chrome,219,1711417508,1711417727,1711417727.399617,-18000,,
com.leomehlig.today,12,1711417496,1711417508,1711417508.745422,-18000,,
com.google.Chrome,647,1711416849,1711417496,1711417496.169944,-18000,,
com.apple.Preview,1200,1711415649,1711416849,1711416849.1676521,-18000,,
com.leomehlig.today,22,1711415627,1711415649,1711415649.542197,-18000,,
com.leomehlig.today,309,1711415251,1711415560,1711415560.733418,-18000,,
com.google.Chrome,697,1711414554,1711415251,1711415251.46311,-18000,,
com.apple.Preview,1,1711414553,1711414554,1711414554.692737,-18000,,
com.apple.Preview,13,1711399221,1711399234,1711399234.589058,-18000,,
com.apple.finder,5,1711399216,1711399221,1711399221.0533872,-18000,,
com.google.Chrome,194,1711399022,1711399216,1711399217.118171,-18000,,
com.leomehlig.today,54,1711398968,1711399022,1711399022.944436,-18000,,
com.google.Chrome,509,1711398459,1711398968,1711398968.145924,-18000,,
com.leomehlig.today,207,1711398252,1711398459,1711398459.942143,-18000,,
com.google.Chrome,27,1711398225,1711398252,1711398253.088073,-18000,,
com.google.Chrome,307,1711397908,1711398215,1711398215.2138171,-18000,,
com.google.Chrome,318,1711397172,1711397490,1711397490.283751,-18000,,
com.google.Chrome,693,1711396469,1711397162,1711397162.7259002,-18000,,
com.google.Chrome,319,1711396011,1711396330,1711396330.968461,-18000,,
com.google.Chrome,306,1711395464,1711395770,1711395770.7730489,-18000,,
com.google.Chrome,614,1711394751,1711395365,1711395365.2945828,-18000,,
com.leomehlig.today,40,1711394711,1711394751,1711394751.196512,-18000,,
com.google.Chrome,79,1711394632,1711394711,1711394711.659481,-18000,,
com.apple.finder,2,1711394614,1711394616,1711394617.190158,-18000,,
com.apple.Preview,16,1711394598,1711394614,1711394614.123448,-18000,,
com.apple.Preview,386,1711389222,1711389608,1711389608.188381,-18000,,
com.apple.finder,4,1711389218,1711389222,1711389222.780405,-18000,,
com.apple.Notes,25,1711389193,1711389218,1711389218.265655,-18000,,
com.google.Chrome,8,1711389185,1711389193,1711389193.475682,-18000,,
com.google.Chrome,5,1711382868,1711382873,1711382873.68556,-18000,,
com.apple.iCal,19,1711382830,1711382849,1711382849.513819,-18000,,
com.google.Chrome,101,1711382729,1711382830,1711382830.912358,-18000,,
com.google.Chrome,2,1711376920,1711376922,1711376922.1449142,-18000,,
com.google.Chrome,2,1711376781,1711376783,1711376783.612865,-18000,,
com.google.Chrome,258,1711376521,1711376779,1711376779.700187,-18000,,
com.google.Chrome,123,1711339229,1711339352,1711339353.050418,-18000,,
com.google.Chrome,1104,1711337952,1711339056,1711339056.403507,-18000,,
com.google.Chrome,324,1711337566,1711337890,1711337890.421198,-18000,,
com.google.Chrome,1095,1711336200,1711337295,1711337295.1147141,-18000,,
com.google.Chrome,312,1711335752,1711336064,1711336064.134142,-18000,,
com.google.Chrome,1,1711335396,1711335397,1711335397.66111,-18000,,
com.google.Chrome,750,1711334042,1711334792,1711334792.5199971,-18000,,
com.google.Chrome,313,1711333198,1711333511,1711333511.926496,-18000,,
com.google.Chrome,411,1711332612,1711333023,1711333023.4242868,-18000,,
com.google.Chrome,392,1711330544,1711330936,1711330936.0659971,-18000,,
com.google.Chrome,330,1711329509,1711329839,1711329839.8348231,-18000,,
com.google.Chrome,2686,1711326473,1711329159,1711329159.690577,-18000,,
com.google.Chrome,338,1711326036,1711326374,1711326374.9051871,-18000,,
com.google.Chrome,314,1711325562,1711325876,1711325876.886897,-18000,,
com.google.Chrome,1334,1711324041,1711325375,1711325375.212292,-18000,,
com.google.Chrome,3,1711320110,1711320113,1711320113.062187,-18000,,
com.leomehlig.today,17,1711320093,1711320110,1711320111.295765,-18000,,
com.google.Chrome,1,1711320092,1711320093,1711320093.223877,-18000,,
com.leomehlig.today,6,1711320086,1711320092,1711320092.76971,-18000,,
com.google.Chrome,3,1711320083,1711320086,1711320086.192766,-18000,,
com.leomehlig.today,4,1711320079,1711320083,1711320083.378995,-18000,,
com.google.Chrome,8,1711320071,1711320079,1711320079.12611,-18000,,
com.leomehlig.today,10,1711320061,1711320071,1711320072.246666,-18000,,
com.apple.MobileSMS,3,1711320058,1711320061,1711320061.1016579,-18000,,
com.leomehlig.today,2,1711320056,1711320058,1711320058.603235,-18000,,
com.google.Chrome,83,1711319973,1711320056,1711320056.8926191,-18000,,
com.apple.finder,5,1711319947,1711319952,1711319952.3496199,-18000,,
com.apple.Notes,2,1711319945,1711319947,1711319947.977036,-18000,,
com.apple.finder,4,1711319941,1711319945,1711319945.753515,-18000,,
com.apple.finder,6,1711312337,1711312343,1711312343.975862,-18000,,
com.leomehlig.today,46,1711312291,1711312337,1711312337.248673,-18000,,
com.google.Chrome,1,1711312290,1711312291,1711312292.0827,-18000,,
com.google.Chrome,362,1711143140,1711143502,1711143503.195286,-18000,,
com.apple.MobileSMS,48,1711142703,1711142751,1711142751.407783,-18000,,
com.google.Chrome,815,1711141888,1711142703,1711142703.3285918,-18000,,
com.apple.finder,3,1711141871,1711141874,1711141874.7351398,-18000,,
com.google.Chrome,3,1711141868,1711141871,1711141871.630713,-18000,,
com.leomehlig.today,32,1711141836,1711141868,1711141868.662848,-18000,,
com.leomehlig.today,20,1711137618,1711137638,1711137638.5574331,-18000,,
com.apple.Notes,3,1711137615,1711137618,1711137618.180142,-18000,,
com.google.Chrome,87,1711137528,1711137615,1711137615.706698,-18000,,
com.google.Chrome,121,1711135889,1711136010,1711136010.1910071,-18000,,
com.apple.finder,1,1711135888,1711135889,1711135889.448766,-18000,,
com.google.Chrome,1,1711135887,1711135888,1711135888.368555,-18000,,
com.apple.finder,16,1711135871,1711135887,1711135887.148504,-18000,,
com.google.Chrome,9,1711135862,1711135871,1711135872.0475821,-18000,,
com.apple.QuickTimePlayerX,116,1711135746,1711135862,1711135862.450921,-18000,,
com.google.Chrome,20,1711135726,1711135746,1711135746.740614,-18000,,
com.apple.QuickTimePlayerX,92,1711135634,1711135726,1711135726.161305,-18000,,
com.google.Chrome,11,1711135623,1711135634,1711135634.6140761,-18000,,
com.apple.QuickTimePlayerX,4,1711135619,1711135623,1711135624.007824,-18000,,
com.apple.Notes,198,1711135421,1711135619,1711135619.815269,-18000,,
com.apple.QuickTimePlayerX,27,1711135394,1711135421,1711135421.314534,-18000,,
com.apple.Notes,19,1711135375,1711135394,1711135395.04698,-18000,,
com.apple.QuickTimePlayerX,1,1711135374,1711135375,1711135375.2147322,-18000,,
com.google.Chrome,1,1711135373,1711135374,1711135374.656595,-18000,,
com.apple.QuickTimePlayerX,14,1711135359,1711135373,1711135374.0131102,-18000,,
com.google.Chrome,1,1711135358,1711135359,1711135359.916051,-18000,,
com.apple.QuickTimePlayerX,23,1711135335,1711135358,1711135358.66777,-18000,,
com.google.Chrome,17,1711135318,1711135335,1711135335.816235,-18000,,
com.apple.Notes,4,1711135314,1711135318,1711135318.530006,-18000,,
com.google.Chrome,5,1711135309,1711135314,1711135314.778038,-18000,,
com.apple.Notes,4,1711135305,1711135309,1711135309.358563,-18000,,
com.google.Chrome,2,1711135303,1711135305,1711135305.59452,-18000,,
com.apple.Notes,5,1711135298,1711135303,1711135303.4590778,-18000,,
com.google.Chrome,1,1711135297,1711135298,1711135298.529869,-18000,,
com.apple.Notes,5,1711135292,1711135297,1711135297.494969,-18000,,
com.google.Chrome,2,1711135290,1711135292,1711135292.7499042,-18000,,
com.apple.Notes,5,1711135285,1711135290,1711135290.54124,-18000,,
com.google.Chrome,2,1711135283,1711135285,1711135285.866331,-18000,,
com.apple.Notes,6,1711135277,1711135283,1711135283.132327,-18000,,
com.google.Chrome,8,1711135269,1711135277,1711135277.514066,-18000,,
com.apple.Notes,5,1711135264,1711135269,1711135269.271308,-18000,,
com.google.Chrome,1,1711135263,1711135264,1711135265.021902,-18000,,
com.apple.Notes,3,1711135260,1711135263,1711135263.693551,-18000,,
com.google.Chrome,21,1711135239,1711135260,1711135260.857294,-18000,,
com.leomehlig.today,12,1711135227,1711135239,1711135239.311171,-18000,,
com.leomehlig.today,55,1711129140,1711129195,1711129195.828515,-18000,,
com.google.Chrome,783,1711128357,1711129140,1711129140.523992,-18000,,
com.apple.Preview,0,1711128286,1711128286,1711128286.912019,-18000,,
com.google.Chrome,1,1711128285,1711128286,1711128286.6506639,-18000,,
com.apple.finder,1,1711128284,1711128285,1711128285.819264,-18000,,
com.apple.Preview,75,1711128209,1711128284,1711128285.075541,-18000,,
com.apple.finder,2,1711128207,1711128209,1711128209.140553,-18000,,
com.google.Chrome,2,1711128205,1711128207,1711128207.555667,-18000,,
com.apple.Preview,3,1711128202,1711128205,1711128205.859416,-18000,,
com.google.Chrome,329,1711127873,1711128202,1711128202.563267,-18000,,
com.apple.Preview,88,1711127785,1711127873,1711127873.734267,-18000,,
com.google.Chrome,718,1711127067,1711127785,1711127785.747953,-18000,,
com.apple.Preview,69,1711126998,1711127067,1711127067.48297,-18000,,
com.apple.finder,5,1711126993,1711126998,1711126998.68561,-18000,,
com.google.Chrome,110,1711126883,1711126993,1711126994.078676,-18000,,
com.apple.iCal,44,1711126839,1711126883,1711126883.2938972,-18000,,
com.google.Chrome,4,1711126835,1711126839,1711126839.9657102,-18000,,
com.apple.Maps,44,1711126778,1711126822,1711126823.2098498,-18000,,
com.apple.Maps,79,1711125981,1711126060,1711126060.5124412,-18000,,
com.leomehlig.today,3,1711125978,1711125981,1711125982.725555,-18000,,
com.leomehlig.today,31,1711123449,1711123480,1711123480.663063,-18000,,
com.google.Chrome,49,1711123400,1711123449,1711123449.343081,-18000,,
com.leomehlig.today,76,1711123324,1711123400,1711123400.428259,-18000,,
com.google.Chrome,1,1711123323,1711123324,1711123324.152009,-18000,,
com.leomehlig.today,15,1711123308,1711123323,1711123323.3135161,-18000,,
com.google.Chrome,1,1711123307,1711123308,1711123308.422243,-18000,,
com.leomehlig.today,11,1711123296,1711123307,1711123307.65045,-18000,,
com.google.Chrome,29,1711123267,1711123296,1711123296.08256,-18000,,
com.leomehlig.today,3,1711123264,1711123267,1711123267.3960118,-18000,,
com.google.Chrome,42,1711123222,1711123264,1711123264.981611,-18000,,
com.leomehlig.today,64,1711123158,1711123222,1711123222.395718,-18000,,
com.google.Chrome,13,1711123145,1711123158,1711123158.1011739,-18000,,
com.leomehlig.today,14,1711123131,1711123145,1711123145.9288921,-18000,,
com.google.Chrome,27,1711123104,1711123131,1711123131.375667,-18000,,
com.leomehlig.today,38,1711123066,1711123104,1711123104.5224938,-18000,,
com.google.Chrome,77,1711122989,1711123066,1711123066.631212,-18000,,
com.leomehlig.today,44,1711122945,1711122989,1711122989.732975,-18000,,
com.google.Chrome,65,1711122880,1711122945,1711122945.720382,-18000,,
com.apple.Preview,22,1711122858,1711122880,1711122880.362177,-18000,,
com.google.Chrome,2,1711122856,1711122858,1711122858.440342,-18000,,
com.apple.Preview,18,1711122838,1711122856,1711122856.1078491,-18000,,
com.google.Chrome,44,1711122794,1711122838,1711122838.515448,-18000,,
com.apple.Preview,5,1711122789,1711122794,1711122794.164994,-18000,,
com.google.Chrome,26,1711122763,1711122789,1711122789.588952,-18000,,
com.apple.Preview,4,1711122759,1711122763,1711122763.920529,-18000,,
com.google.Chrome,13,1711122746,1711122759,1711122759.083138,-18000,,
com.apple.Preview,33,1711122713,1711122746,1711122746.736308,-18000,,
com.google.Chrome,11,1711122702,1711122713,1711122713.514832,-18000,,
com.apple.Preview,8,1711122694,1711122702,1711122702.58677,-18000,,
com.google.Chrome,25,1711122669,1711122694,1711122694.798455,-18000,,
com.apple.Preview,37,1711122632,1711122669,1711122669.857923,-18000,,
com.google.Chrome,7,1711122625,1711122632,1711122632.578403,-18000,,
com.apple.Preview,15,1711122610,1711122625,1711122625.571082,-18000,,
com.google.Chrome,1,1711122609,1711122610,1711122610.631017,-18000,,
com.apple.Preview,11,1711122598,1711122609,1711122609.172493,-18000,,
com.google.Chrome,3,1711122595,1711122598,1711122598.543892,-18000,,
com.apple.Preview,52,1711122543,1711122595,1711122595.642925,-18000,,
com.google.Chrome,43,1711122500,1711122543,1711122543.9743772,-18000,,
com.apple.Preview,9,1711122491,1711122500,1711122500.367432,-18000,,
com.google.Chrome,76,1711122415,1711122491,1711122491.939326,-18000,,
com.apple.Preview,1,1711122414,1711122415,1711122415.831499,-18000,,
com.google.Chrome,1,1711122413,1711122414,1711122414.779908,-18000,,
com.apple.Preview,6,1711122407,1711122413,1711122413.542872,-18000,,
com.google.Chrome,6,1711122401,1711122407,1711122407.358248,-18000,,
com.apple.Preview,12,1711122389,1711122401,1711122401.694072,-18000,,
com.google.Chrome,9,1711122380,1711122389,1711122390.026308,-18000,,
com.apple.Preview,12,1711122368,1711122380,1711122380.3245602,-18000,,
com.google.Chrome,11,1711122357,1711122368,1711122368.1657748,-18000,,
com.apple.finder,1,1711122356,1711122357,1711122357.3933802,-18000,,
com.apple.Preview,29,1711122327,1711122356,1711122356.251134,-18000,,
com.apple.finder,5,1711122322,1711122327,1711122327.087518,-18000,,
com.google.Chrome,251,1711122071,1711122322,1711122322.742588,-18000,,
com.leomehlig.today,1,1711122070,1711122071,1711122071.7941132,-18000,,
com.google.Chrome,20,1711122050,1711122070,1711122070.5954099,-18000,,
com.leomehlig.today,4,1711122046,1711122050,1711122050.353105,-18000,,
com.google.Chrome,753,1711121293,1711122046,1711122046.904413,-18000,,
com.leomehlig.today,14,1711121279,1711121293,1711121293.2270532,-18000,,
com.google.Chrome,831,1711120448,1711121279,1711121279.1512918,-18000,,
com.leomehlig.today,10,1711120438,1711120448,1711120448.356741,-18000,,
com.google.Chrome,219,1711120219,1711120438,1711120438.753703,-18000,,
com.google.Chrome,24,1711118430,1711118454,1711118454.6852322,-18000,,
us.zoom.xos,27,1711118403,1711118430,1711118430.24746,-18000,,
com.google.Chrome,2165,1711116238,1711118403,1711118403.260709,-18000,,
us.zoom.xos,4,1711116234,1711116238,1711116238.724747,-18000,,
com.google.Chrome,6,1711116228,1711116234,1711116234.753631,-18000,,
us.zoom.xos,4,1711116224,1711116228,1711116228.428419,-18000,,
com.google.Chrome,23,1711116201,1711116224,1711116224.088488,-18000,,
us.zoom.xos,0,1711116201,1711116201,1711116202.028751,-18000,,
com.google.Chrome,1,1711116200,1711116201,1711116201.2108278,-18000,,
us.zoom.xos,2,1711116198,1711116200,1711116200.083391,-18000,,
com.google.Chrome,2,1711116196,1711116198,1711116198.850904,-18000,,
us.zoom.xos,112,1711116084,1711116196,1711116196.4982991,-18000,,
com.google.Chrome,35,1711116049,1711116084,1711116084.261217,-18000,,
us.zoom.xos,2,1711116047,1711116049,1711116049.414031,-18000,,
com.google.Chrome,1,1711116046,1711116047,1711116047.7043982,-18000,,
us.zoom.xos,1,1711116045,1711116046,1711116046.624877,-18000,,
com.google.Chrome,3,1711116042,1711116045,1711116045.458127,-18000,,
us.zoom.xos,20,1711116022,1711116042,1711116042.909373,-18000,,
com.google.Chrome,14,1711116008,1711116022,1711116022.382036,-18000,,
com.google.ios.youtube,2089,1711079523,1711081612,1711081613.084472,-18000,EB445137-D7F5-57EC-87DA-1DB460D64046,"iPhone13,2"
com.microsoft.Office.Outlook,6,1711079247,1711079253,1711079253.2777839,-18000,EB445137-D7F5-57EC-87DA-1DB460D64046,"iPhone13,2"
com.toyopagroup.picaboo,48,1711079197,1711079245,1711079245.229007,-18000,EB445137-D7F5-57EC-87DA-1DB460D64046,"iPhone13,2"
com.apple.Health,39,1711079155,1711079194,1711079194.460748,-18000,EB445137-D7F5-57EC-87DA-1DB460D64046,"iPhone13,2"
com.thestorygraph.thestorygraph,125,1711079026,1711079151,1711079151.2776818,-18000,EB445137-D7F5-57EC-87DA-1DB460D64046,"iPhone13,2"
com.google.chrome.ios,7,1711079019,1711079026,1711079027.119245,-18000,EB445137-D7F5-57EC-87DA-1DB460D64046,"iPhone13,2"
com.thestorygraph.thestorygraph,90,1711078929,1711079019,1711079019.278839,-18000,EB445137-D7F5-57EC-87DA-1DB460D64046,"iPhone13,2"
com.goodreads.Goodreads,38,1711078891,1711078929,1711078929.996737,-18000,EB445137-D7F5-57EC-87DA-1DB460D64046,"iPhone13,2"
com.thestorygraph.thestorygraph,3,1711078888,1711078891,1711078891.031054,-18000,EB445137-D7F5-57EC-87DA-1DB460D64046,"iPhone13,2"
com.goodreads.Goodreads,38,1711078850,1711078888,1711078888.4498281,-18000,EB445137-D7F5-57EC-87DA-1DB460D64046,"iPhone13,2"
com.thestorygraph.thestorygraph,3,1711078847,1711078850,1711078850.209581,-18000,EB445137-D7F5-57EC-87DA-1DB460D64046,"iPhone13,2"
com.goodreads.Goodreads,21,1711078826,1711078847,1711078847.9691591,-18000,EB445137-D7F5-57EC-87DA-1DB460D64046,"iPhone13,2"
com.thestorygraph.thestorygraph,97,1711078727,1711078824,1711078824.483247,-18000,EB445137-D7F5-57EC-87DA-1DB460D64046,"iPhone13,2"
com.thestorygraph.thestorygraph,11,1711078200,1711078211,1711078211.458785,-18000,EB445137-D7F5-57EC-87DA-1DB460D64046,"iPhone13,2"
com.thestorygraph.thestorygraph,10,1711078141,1711078151,1711078151.24932,-18000,EB445137-D7F5-57EC-87DA-1DB460D64046,"iPhone13,2"
com.thestorygraph.thestorygraph,14,1711077105,1711077119,1711077119.823498,-18000,EB445137-D7F5-57EC-87DA-1DB460D64046,"iPhone13,2"
com.toyopagroup.picaboo,2,1711077100,1711077102,1711077102.242954,-18000,EB445137-D7F5-57EC-87DA-1DB460D64046,"iPhone13,2"
com.toyopagroup.picaboo,10,1711077004,1711077014,1711077014.9169888,-18000,EB445137-D7F5-57EC-87DA-1DB460D64046,"iPhone13,2"
com.toyopagroup.picaboo,3,1711075436,1711075439,1711075439.677882,-18000,EB445137-D7F5-57EC-87DA-1DB460D64046,"iPhone13,2"
com.toyopagroup.picaboo,7,1711075398,1711075405,1711075405.348771,-18000,EB445137-D7F5-57EC-87DA-1DB460D64046,"iPhone13,2"
com.toyopagroup.picaboo,6,1711075344,1711075350,1711075350.236425,-18000,EB445137-D7F5-57EC-87DA-1DB460D64046,"iPhone13,2"
com.toyopagroup.picaboo,3,1711075338,1711075341,1711075341.581341,-18000,EB445137-D7F5-57EC-87DA-1DB460D64046,"iPhone13,2"
com.google.Chrome,12,1711075009,1711075021,1711075021.718252,-18000,,
com.leomehlig.today,19,1711074990,1711075009,1711075009.02781,-18000,,
com.google.Chrome,90,1711074900,1711074990,1711074990.465837,-18000,,
com.leomehlig.today,5,1711074895,1711074900,1711074900.413019,-18000,,
com.google.Chrome,2,1711074893,1711074895,1711074895.1232572,-18000,,
com.leomehlig.today,26,1711074867,1711074893,1711074893.389226,-18000,,
com.google.Chrome,1,1711074866,1711074867,1711074867.331509,-18000,,
com.leomehlig.today,4,1711074862,1711074866,1711074866.729846,-18000,,
com.google.Chrome,23,1711074839,1711074862,1711074862.474113,-18000,,
com.leomehlig.today,35,1711074804,1711074839,1711074839.761073,-18000,,
com.google.Chrome,337,1711074467,1711074804,1711074804.543819,-18000,,
com.leomehlig.today,1,1711074466,1711074467,1711074467.450571,-18000,,
com.google.Chrome,428,1711074038,1711074466,1711074466.403061,-18000,,
com.apple.Preview,14,1711074024,1711074038,1711074038.916857,-18000,,
com.google.Chrome,15,1711074009,1711074024,1711074024.3098989,-18000,,
com.apple.Preview,1,1711074008,1711074009,1711074009.553107,-18000,,
com.google.Chrome,87,1711073921,1711074008,1711074008.559663,-18000,,
com.apple.Preview,6,1711073915,1711073921,1711073921.9277139,-18000,,
com.google.Chrome,620,1711073295,1711073915,1711073915.209117,-18000,,
com.apple.Preview,32,1711073263,1711073295,1711073295.7170758,-18000,,
com.google.Chrome,1,1711073262,1711073263,1711073263.58434,-18000,,
com.apple.Preview,9,1711073253,1711073262,1711073263.0175,-18000,,
com.google.Chrome,289,1711072964,1711073253,1711073253.423164,-18000,,
com.apple.Preview,1,1711072963,1711072964,1711072964.719718,-18000,,
com.google.Chrome,3,1711072960,1711072963,1711072963.2592,-18000,,
com.apple.Preview,20,1711072940,1711072960,1711072960.484937,-18000,,
com.google.Chrome,17,1711072923,1711072940,1711072940.817272,-18000,,
com.apple.Preview,39,1711072884,1711072923,1711072923.482491,-18000,,
com.google.Chrome,12,1711072872,1711072884,1711072884.9059181,-18000,,
com.apple.finder,1,1711072871,1711072872,1711072872.2367702,-18000,,
com.google.Chrome,32,1711072839,1711072871,1711072871.293467,-18000,,
com.apple.finder,1,1711072838,1711072839,1711072839.904252,-18000,,
com.apple.Preview,2,1711072836,1711072838,1711072838.7410989,-18000,,
com.google.Chrome,152,1711072684,1711072836,1711072836.478111,-18000,,
com.apple.Preview,80,1711072604,1711072684,1711072684.2930732,-18000,,
com.apple.finder,26,1711072578,1711072604,1711072604.162362,-18000,,
com.google.Chrome,34,1711072544,1711072578,1711072578.428961,-18000,,
com.apple.finder,2,1711072542,1711072544,1711072544.099121,-18000,,
com.google.Chrome,819,1711071723,1711072542,1711072542.4250069,-18000,,
com.leomehlig.today,9,1711071513,1711071522,1711071523.2806668,-18000,,
com.microsoft.VSCode,14,1711071499,1711071513,1711071513.422334,-18000,,
com.toyopagroup.picaboo,4,1711071292,1711071296,1711071296.6105099,-18000,EB445137-D7F5-57EC-87DA-1DB460D64046,"iPhone13,2"
com.toyopagroup.picaboo,10,1711070593,1711070603,1711070603.203327,-18000,EB445137-D7F5-57EC-87DA-1DB460D64046,"iPhone13,2"
com.toyopagroup.picaboo,6,1711070577,1711070583,1711070583.4669719,-18000,EB445137-D7F5-57EC-87DA-1DB460D64046,"iPhone13,2"
com.toyopagroup.picaboo,6,1711070561,1711070567,1711070567.957103,-18000,EB445137-D7F5-57EC-87DA-1DB460D64046,"iPhone13,2"
com.apple.camera,0,1711070512,1711070512,1711070512.540201,-18000,EB445137-D7F5-57EC-87DA-1DB460D64046,"iPhone13,2"
com.toyopagroup.picaboo,7,1711070511,1711070518,1711070518.584161,-18000,EB445137-D7F5-57EC-87DA-1DB460D64046,"iPhone13,2"
com.toyopagroup.picaboo,14,1711070497,1711070511,1711070512.110451,-18000,EB445137-D7F5-57EC-87DA-1DB460D64046,"iPhone13,2"
com.google.chrome.ios,6,1711070487,1711070493,1711070493.396075,-18000,EB445137-D7F5-57EC-87DA-1DB460D64046,"iPhone13,2"
com.google.chrome.ios,7,1711070480,1711070487,1711070487.048987,-18000,EB445137-D7F5-57EC-87DA-1DB460D64046,"iPhone13,2"
com.google.chrome.ios,6,1711070473,1711070479,1711070479.997291,-18000,EB445137-D7F5-57EC-87DA-1DB460D64046,"iPhone13,2"
com.google.chrome.ios,46,1711070230,1711070276,1711070276.377568,-18000,EB445137-D7F5-57EC-87DA-1DB460D64046,"iPhone13,2"
com.apple.MobileSMS,3,1711070227,1711070230,1711070230.2018728,-18000,EB445137-D7F5-57EC-87DA-1DB460D64046,"iPhone13,2"
com.microsoft.onenote,2,1711070225,1711070227,1711070228.2737122,-18000,EB445137-D7F5-57EC-87DA-1DB460D64046,"iPhone13,2"
com.microsoft.VSCode,90,1711069996,1711070086,1711070086.949822,-18000,,
com.google.Chrome,43,1711069953,1711069996,1711069996.711473,-18000,,
com.microsoft.VSCode,88,1711069865,1711069953,1711069953.831723,-18000,,
com.google.Chrome,4,1711069861,1711069865,1711069865.601595,-18000,,
com.microsoft.VSCode,8,1711069853,1711069861,1711069861.694094,-18000,,
com.google.Chrome,7,1711069846,1711069853,1711069853.9896169,-18000,,
com.microsoft.VSCode,8,1711069838,1711069846,1711069846.635198,-18000,,
com.google.Chrome,19,1711069819,1711069838,1711069838.142463,-18000,,
com.microsoft.VSCode,27,1711069792,1711069819,1711069819.5967479,-18000,,
com.google.Chrome,5,1711069787,1711069792,1711069792.2874122,-18000,,
com.microsoft.VSCode,10,1711069777,1711069787,1711069787.098211,-18000,,
com.google.Chrome,3,1711069774,1711069777,1711069777.4924378,-18000,,
com.microsoft.VSCode,6,1711069768,1711069774,1711069774.5118089,-18000,,
com.google.Chrome,3,1711069765,1711069768,1711069768.385962,-18000,,
com.microsoft.VSCode,4,1711069761,1711069765,1711069765.437324,-18000,,
com.google.Chrome,43,1711069718,1711069761,1711069761.848314,-18000,,
com.microsoft.VSCode,3,1711069715,1711069718,1711069718.7927542,-18000,,
com.google.Chrome,9,1711069706,1711069715,1711069715.996422,-18000,,
com.microsoft.VSCode,32,1711069674,1711069706,1711069706.736281,-18000,,
com.google.Chrome,27,1711069647,1711069674,1711069674.860975,-18000,,
com.microsoft.VSCode,66,1711069581,1711069647,1711069647.272465,-18000,,
com.google.Chrome,55,1711069526,1711069581,1711069581.184317,-18000,,
com.microsoft.VSCode,64,1711069462,1711069526,1711069526.792821,-18000,,
com.google.Chrome,67,1711069395,1711069462,1711069462.205586,-18000,,
com.microsoft.VSCode,1,1711069394,1711069395,1711069395.482088,-18000,,
com.google.Chrome,2,1711069392,1711069394,1711069394.4902449,-18000,,
com.microsoft.VSCode,1,1711069391,1711069392,1711069392.422853,-18000,,
com.google.Chrome,1,1711069390,1711069391,1711069391.116067,-18000,,
com.microsoft.VSCode,993,1711068397,1711069390,1711069390.0925841,-18000,,
com.google.Chrome,70,1711068327,1711068397,1711068397.130094,-18000,,
com.microsoft.VSCode,225,1711068102,1711068327,1711068327.467094,-18000,,
com.apple.finder,9,1711068093,1711068102,1711068102.8733668,-18000,,
com.microsoft.VSCode,104,1711067989,1711068093,1711068093.652697,-18000,,
com.google.Chrome,32,1711067957,1711067989,1711067989.9586282,-18000,,
com.microsoft.VSCode,179,1711067778,1711067957,1711067957.759602,-18000,,
com.google.Chrome,16,1711067762,1711067778,1711067778.341425,-18000,,
com.microsoft.VSCode,154,1711067608,1711067762,1711067762.308171,-18000,,
com.google.Chrome,0,1711067608,1711067608,1711067608.946275,-18000,,
com.microsoft.VSCode,16,1711067592,1711067608,1711067608.565362,-18000,,
com.google.Chrome,0,1711067592,1711067592,1711067592.87205,-18000,,
com.microsoft.VSCode,391,1711067201,1711067592,1711067592.273154,-18000,,
com.google.Chrome,82,1711067119,1711067201,1711067201.234517,-18000,,
com.apple.iWork.Numbers,14,1711067105,1711067119,1711067119.459907,-18000,,
com.google.Chrome,3,1711067102,1711067105,1711067105.829154,-18000,,
com.microsoft.VSCode,2,1711067100,1711067102,1711067102.211065,-18000,,
com.apple.iWork.Numbers,3,1711067097,1711067100,1711067100.327107,-18000,,
com.microsoft.VSCode,2,1711067095,1711067097,1711067097.661097,-18000,,
com.google.Chrome,6,1711067089,1711067095,1711067095.6829062,-18000,,
com.microsoft.VSCode,3,1711067086,1711067089,1711067089.245239,-18000,,
com.google.Chrome,0,1711067086,1711067086,1711067086.810011,-18000,,
com.microsoft.VSCode,2,1711067084,1711067086,1711067086.496132,-18000,,
com.google.Chrome,3,1711067081,1711067084,1711067085.054446,-18000,,
com.apple.iWork.Numbers,3,1711067078,1711067081,1711067081.998059,-18000,,
com.google.Chrome,10,1711067068,1711067078,1711067078.5270739,-18000,,
com.microsoft.VSCode,1,1711067067,1711067068,1711067068.788547,-18000,,
com.apple.iWork.Numbers,23,1711067044,1711067067,1711067067.239028,-18000,,
com.microsoft.VSCode,3,1711067041,1711067044,1711067044.6823611,-18000,,
com.apple.iWork.Numbers,5,1711067036,1711067041,1711067041.776725,-18000,,
com.google.Chrome,3,1711067033,1711067036,1711067036.975615,-18000,,
com.apple.iWork.Numbers,2,1711067031,1711067033,1711067034.021274,-18000,,
com.google.Chrome,2,1711067029,1711067031,1711067031.044951,-18000,,
com.apple.iWork.Numbers,4,1711067025,1711067029,1711067029.1079478,-18000,,
com.google.Chrome,2,1711067023,1711067025,1711067025.52564,-18000,,
com.apple.iWork.Numbers,227,1711066796,1711067023,1711067023.3809109,-18000,,
com.google.Chrome,9,1711066787,1711066796,1711066796.5304809,-18000,,
com.microsoft.VSCode,3,1711066784,1711066787,1711066787.31867,-18000,,
com.google.Chrome,14,1711066770,1711066784,1711066784.400546,-18000,,
com.apple.iWork.Numbers,10,1711066760,1711066770,1711066770.749243,-18000,,
com.google.Chrome,7,1711066753,1711066760,1711066760.4304318,-18000,,
com.microsoft.VSCode,6,1711066747,1711066753,1711066754.00704,-18000,,
com.google.Chrome,1,1711066746,1711066747,1711066747.790024,-18000,,
com.apple.iWork.Numbers,4,1711066742,1711066746,1711066746.3359752,-18000,,
com.google.Chrome,10,1711066732,1711066742,1711066742.8919091,-18000,,
com.microsoft.VSCode,4,1711066728,1711066732,1711066732.8119721,-18000,,
com.google.Chrome,15,1711066713,1711066728,1711066728.504199,-18000,,
com.microsoft.VSCode,1,1711066712,1711066713,1711066713.446854,-18000,,
com.apple.iWork.Numbers,9,1711066703,1711066712,1711066712.446034,-18000,,
com.microsoft.VSCode,2,1711066701,1711066703,1711066703.3367481,-18000,,
com.google.Chrome,1,1711066700,1711066701,1711066701.129838,-18000,,
com.apple.iWork.Numbers,7,1711066693,1711066700,1711066700.292944,-18000,,
com.google.Chrome,1,1711066692,1711066693,1711066693.959021,-18000,,
com.microsoft.VSCode,3,1711066689,1711066692,1711066693.041521,-18000,,
com.google.Chrome,7,1711066682,1711066689,1711066689.929596,-18000,,
com.apple.iWork.Numbers,10,1711066672,1711066682,1711066682.3753471,-18000,,
com.google.Chrome,11,1711066661,1711066672,1711066672.76144,-18000,,
com.apple.iWork.Numbers,2,1711066659,1711066661,1711066661.8711061,-18000,,
com.google.Chrome,4,1711066655,1711066659,1711066659.49444,-18000,,
com.apple.iWork.Numbers,8,1711066647,1711066655,1711066655.4390569,-18000,,
com.google.Chrome,65,1711066582,1711066647,1711066647.928393,-18000,,
com.apple.iWork.Numbers,6,1711066576,1711066582,1711066582.303782,-18000,,
com.google.Chrome,8,1711066568,1711066576,1711066576.882585,-18000,,
com.apple.iWork.Numbers,7,1711066561,1711066568,1711066568.0394359,-18000,,
com.google.Chrome,15,1711066546,1711066561,1711066561.323876,-18000,,
com.apple.iWork.Numbers,63,1711066483,1711066546,1711066546.949822,-18000,,
com.google.Chrome,1,1711066482,1711066483,1711066483.793095,-18000,,
com.apple.iWork.Numbers,9,1711066473,1711066482,1711066482.4528,-18000,,
com.google.Chrome,1,1711066472,1711066473,1711066473.8607922,-18000,,
com.apple.iWork.Numbers,23,1711066449,1711066472,1711066472.150858,-18000,,
com.google.Chrome,2,1711066447,1711066449,1711066449.8120608,-18000,,
com.apple.iWork.Numbers,6,1711066441,1711066447,1711066447.175308,-18000,,
com.apple.finder,140,1711066301,1711066441,1711066441.394355,-18000,,
com.google.Chrome,14,1711066287,1711066301,1711066301.74861,-18000,,
com.microsoft.VSCode,17,1711066270,1711066287,1711066287.585916,-18000,,
com.google.Chrome,2,1711066268,1711066270,1711066270.702114,-18000,,
com.microsoft.VSCode,41,1711066227,1711066268,1711066268.14698,-18000,,
com.google.Chrome,44,1711066183,1711066227,1711066227.3245292,-18000,,
com.microsoft.VSCode,2,1711066181,1711066183,1711066183.697105,-18000,,
com.microsoft.onenote,4,1711066038,1711066042,1711066042.808531,-18000,EB445137-D7F5-57EC-87DA-1DB460D64046,"iPhone13,2"
com.microsoft.onenote,76,1711065307,1711065383,1711065383.084158,-18000,EB445137-D7F5-57EC-87DA-1DB460D64046,"iPhone13,2"
com.google.chrome.ios,3,1711065301,1711065304,1711065304.532295,-18000,EB445137-D7F5-57EC-87DA-1DB460D64046,"iPhone13,2"
com.google.chrome.ios,18,1711063521,1711063539,1711063540.816472,-18000,EB445137-D7F5-57EC-87DA-1DB460D64046,"iPhone13,2"
com.google.chrome.ios,17,1711063449,1711063466,1711063466.6229758,-18000,EB445137-D7F5-57EC-87DA-1DB460D64046,"iPhone13,2"
com.apple.mobileslideshow,27,1711063421,1711063448,1711063448.984283,-18000,EB445137-D7F5-57EC-87DA-1DB460D64046,"iPhone13,2"
com.toyopagroup.picaboo,2,1711063415,1711063417,1711063417.498003,-18000,EB445137-D7F5-57EC-87DA-1DB460D64046,"iPhone13,2"
com.toyopagroup.picaboo,4,1711062537,1711062541,1711062541.693649,-18000,EB445137-D7F5-57EC-87DA-1DB460D64046,"iPhone13,2"
com.thestorygraph.thestorygraph,67,1711060901,1711060968,1711060968.9092832,-18000,EB445137-D7F5-57EC-87DA-1DB460D64046,"iPhone13,2"
com.microsoft.VSCode,65,1711060691,1711060756,1711060756.429923,-18000,,
com.leomehlig.today,26,1711060665,1711060691,1711060691.65562,-18000,,
com.leomehlig.today,182,1711060200,1711060382,1711060382.860742,-18000,,
com.apple.news,401,1711060170,1711060571,1711060571.15924,-18000,EB445137-D7F5-57EC-87DA-1DB460D64046,"iPhone13,2"
com.apple.MobileSMS,10,1711060143,1711060153,1711060153.8778281,-18000,EB445137-D7F5-57EC-87DA-1DB460D64046,"iPhone13,2"
com.apple.MobileSMS,4,1711060092,1711060096,1711060096.8518028,-18000,EB445137-D7F5-57EC-87DA-1DB460D64046,"iPhone13,2"
com.apple.MobileSMS,14,1711058786,1711058800,1711058800.512066,-18000,EB445137-D7F5-57EC-87DA-1DB460D64046,"iPhone13,2"
com.microsoft.VSCode,2684,1711057369,1711060053,1711060053.802352,-18000,,
com.apple.finder,1,1711057368,1711057369,1711057369.2322068,-18000,,
com.microsoft.VSCode,50,1711057318,1711057368,1711057368.174757,-18000,,
com.apple.finder,1,1711057317,1711057318,1711057318.710432,-18000,,
com.leomehlig.today,1,1711057316,1711057317,1711057317.3202338,-18000,,
com.microsoft.VSCode,159,1711057157,1711057316,1711057316.1578069,-18000,,
com.leomehlig.today,23,1711057134,1711057157,1711057157.641443,-18000,,
com.google.Chrome,2,1711057132,1711057134,1711057134.959728,-18000,,
com.google.ios.youtube,885,1711055874,1711056759,1711056760.040234,-18000,EB445137-D7F5-57EC-87DA-1DB460D64046,"iPhone13,2"
com.burbn.instagram,41,1711055833,1711055874,1711055874.2338228,-18000,EB445137-D7F5-57EC-87DA-1DB460D64046,"iPhone13,2"
com.apple.AppStore,2,1711055831,1711055833,1711055833.450134,-18000,EB445137-D7F5-57EC-87DA-1DB460D64046,"iPhone13,2"
com.burbn.instagram,25,1711055806,1711055831,1711055831.482398,-18000,EB445137-D7F5-57EC-87DA-1DB460D64046,"iPhone13,2"
com.google.Chrome,303,1711055323,1711055626,1711055626.721782,-18000,,
com.google.Chrome,302,1711054984,1711055286,1711055286.8543239,-18000,,
com.google.Chrome,315,1711054054,1711054369,1711054369.87928,-18000,,
com.google.Chrome,359,1711052734,1711053093,1711053093.759413,-18000,,
com.leomehlig.today,8,1711052726,1711052734,1711052734.600811,-18000,,
com.google.Chrome,73,1711052653,1711052726,1711052726.777689,-18000,,
com.leomehlig.today,13,1711052640,1711052653,1711052653.79335,-18000,,
com.leomehlig.today,4,1711052464,1711052468,1711052468.485764,-18000,,
com.google.Chrome,5,1711052459,1711052464,1711052465.156033,-18000,,
us.zoom.xos,174,1711052285,1711052459,1711052459.785255,-18000,,
com.google.Chrome,76,1711052209,1711052285,1711052285.303343,-18000,,
com.apple.MobileSMS,10,1711052197,1711052207,1711052207.4746032,-18000,EB445137-D7F5-57EC-87DA-1DB460D64046,"iPhone13,2"
com.apple.MobileSMS,40,1711052169,1711052209,1711052209.92319,-18000,,
com.google.Chrome,304,1711051865,1711052169,1711052169.799882,-18000,,
us.zoom.xos,136,1711051729,1711051865,1711051865.2051811,-18000,,
com.google.Chrome,345,1711051384,1711051729,1711051730.024411,-18000,,
us.zoom.xos,189,1711051195,1711051384,1711051384.100215,-18000,,
com.google.Chrome,282,1711050913,1711051195,1711051195.3001451,-18000,,
us.zoom.xos,256,1711050631,1711050887,1711050887.380383,-18000,,
com.leomehlig.today,240,1711050391,1711050631,1711050631.181281,-18000,,
com.truebill.truebillnative,42,1711050266,1711050308,1711050308.89761,-18000,EB445137-D7F5-57EC-87DA-1DB460D64046,"iPhone13,2"
us.zoom.xos,196,1711050195,1711050391,1711050391.805403,-18000,,
com.google.Chrome,67,1711050128,1711050195,1711050195.534799,-18000,,
us.zoom.xos,2,1711050126,1711050128,1711050128.399061,-18000,,
com.google.Chrome,1,1711050125,1711050126,1711050126.164062,-18000,,
us.zoom.xos,2,1711050123,1711050125,1711050125.7731829,-18000,,
com.google.Chrome,236,1711049887,1711050123,1711050123.545004,-18000,,
us.zoom.xos,50,1711049837,1711049887,1711049887.941879,-18000,,
com.apple.news,72,1711049408,1711049480,1711049480.7171311,-18000,EB445137-D7F5-57EC-87DA-1DB460D64046,"iPhone13,2"
us.zoom.xos,358,1711049348,1711049706,1711049706.605439,-18000,,
com.google.Chrome,26,1711049322,1711049348,1711049348.6936069,-18000,,
com.apple.iCal,39,1711049283,1711049322,1711049322.4466171,-18000,,
com.google.Chrome,30,1711049253,1711049283,1711049283.372243,-18000,,
us.zoom.xos,41,1711049202,1711049243,1711049243.961761,-18000,,
com.leomehlig.today,163,1711049039,1711049202,1711049202.701079,-18000,,
com.apple.news,348,1711048571,1711048919,1711048919.668984,-18000,EB445137-D7F5-57EC-87DA-1DB460D64046,"iPhone13,2"
us.zoom.xos,493,1711048546,1711049039,1711049039.9578261,-18000,,
us.zoom.xos,408,1711047601,1711048009,1711048009.202801,-18000,,
com.google.Chrome,28,1711047573,1711047601,1711047601.670284,-18000,,
com.leomehlig.today,113,1711047460,1711047573,1711047574.0365062,-18000,,
com.google.Chrome,208,1711047252,1711047460,1711047460.9826078,-18000,,
com.leomehlig.today,2,1711047250,1711047252,1711047252.780729,-18000,,
com.toyopagroup.picaboo,4,1711045896,1711045900,1711045901.235735,-18000,EB445137-D7F5-57EC-87DA-1DB460D64046,"iPhone13,2"
com.apple.mobiletimer,4,1711045892,1711045896,1711045896.009819,-18000,EB445137-D7F5-57EC-87DA-1DB460D64046,"iPhone13,2"
com.apple.mobiletimer,16,1711045865,1711045881,1711045881.0514889,-18000,EB445137-D7F5-57EC-87DA-1DB460D64046,"iPhone13,2"
com.google.Chrome,1417,1711045833,1711047250,1711047250.665204,-18000,,
com.apple.finder,7,1711045826,1711045833,1711045833.2031798,-18000,,
com.apple.Preview,38,1711045788,1711045826,1711045826.850754,-18000,,
com.apple.finder,9,1711045779,1711045788,1711045788.764859,-18000,,
com.google.Chrome,919,1711044860,1711045779,1711045779.354642,-18000,,
com.leomehlig.today,18,1711044842,1711044860,1711044860.700398,-18000,,
com.google.Chrome,5,1711044837,1711044842,1711044842.4001842,-18000,,
com.apple.Notes,7,1711044830,1711044837,1711044837.383518,-18000,,
com.google.Chrome,33,1711044797,1711044830,1711044830.899183,-18000,,
com.apple.Notes,50,1711044747,1711044797,1711044797.9015121,-18000,,
com.google.Chrome,64,1711044683,1711044747,1711044747.144108,-18000,,
com.apple.finder,6,1711044677,1711044683,1711044683.79535,-18000,,
com.google.Chrome,2,1711044675,1711044677,1711044677.710794,-18000,,
com.apple.finder,22,1711044653,1711044675,1711044675.509848,-18000,,
com.google.Chrome,6,1711044647,1711044653,1711044653.370445,-18000,,
com.apple.Notes,6,1711044641,1711044647,1711044647.2060719,-18000,,
com.google.Chrome,1,1711044640,1711044641,1711044641.9205,-18000,,
com.apple.finder,1,1711044639,1711044640,1711044640.9691138,-18000,,
com.google.Chrome,158,1711044481,1711044639,1711044639.683237,-18000,,
com.apple.finder,22,1711044459,1711044481,1711044481.5898209,-18000,,
com.google.Chrome,70,1711044389,1711044459,1711044459.523752,-18000,,
com.apple.Notes,13,1711044376,1711044389,1711044389.886395,-18000,,
com.google.Chrome,19,1711044357,1711044376,1711044376.781276,-18000,,
com.apple.mobiletimer,8,1711044239,1711044247,1711044247.1373491,-18000,EB445137-D7F5-57EC-87DA-1DB460D64046,"iPhone13,2"
com.microsoft.Office.Outlook,3,1711044236,1711044239,1711044239.2190418,-18000,EB445137-D7F5-57EC-87DA-1DB460D64046,"iPhone13,2"
com.microsoft.Office.Outlook,14,1711044042,1711044056,1711044056.643826,-18000,EB445137-D7F5-57EC-87DA-1DB460D64046,"iPhone13,2"
com.google.Chrome,438,1711043905,1711044343,1711044343.7663379,-18000,,
com.apple.Notes,7,1711043898,1711043905,1711043905.1075401,-18000,,
com.google.Chrome,49,1711043849,1711043898,1711043898.3168612,-18000,,
com.microsoft.VSCode,55,1711043794,1711043849,1711043849.598236,-18000,,
com.google.Chrome,30,1711043764,1711043794,1711043794.882011,-18000,,
com.microsoft.VSCode,65,1711043699,1711043764,1711043764.6631231,-18000,,
com.google.Chrome,11,1711043688,1711043699,1711043699.25209,-18000,,
com.microsoft.VSCode,60,1711043628,1711043688,1711043688.926343,-18000,,
com.google.Chrome,3,1711043625,1711043628,1711043628.368692,-18000,,
com.microsoft.VSCode,12,1711043613,1711043625,1711043625.560824,-18000,,
com.google.Chrome,48,1711043565,1711043613,1711043613.859096,-18000,,
com.apple.Notes,270,1711043295,1711043565,1711043565.3027492,-18000,,
com.google.Chrome,0,1711043295,1711043295,1711043295.976931,-18000,,
com.apple.Notes,4,1711043291,1711043295,1711043295.418596,-18000,,
com.google.Chrome,1,1711043290,1711043291,1711043291.755929,-18000,,
com.apple.Notes,2,1711043288,1711043290,1711043290.567587,-18000,,
com.google.Chrome,3,1711043285,1711043288,1711043288.8029308,-18000,,
com.microsoft.Office.Outlook,19,1711043264,1711043283,1711043283.103352,-18000,EB445137-D7F5-57EC-87DA-1DB460D64046,"iPhone13,2"
com.apple.mobiletimer,1,1711043263,1711043264,1711043265.188885,-18000,EB445137-D7F5-57EC-87DA-1DB460D64046,"iPhone13,2"
com.apple.Notes,37,1711043248,1711043285,1711043285.538529,-18000,,
com.google.Chrome,0,1711043248,1711043248,1711043249.03188,-18000,,
com.apple.Notes,7,1711043241,1711043248,1711043248.365314,-18000,,
com.google.Chrome,3,1711043238,1711043241,1711043241.096366,-18000,,
com.apple.Notes,2,1711043236,1711043238,1711043238.680243,-18000,,
com.google.Chrome,1,1711043235,1711043236,1711043236.340476,-18000,,
com.apple.Notes,8,1711043227,1711043235,1711043235.208647,-18000,,
com.google.Chrome,1,1711043226,1711043227,1711043228.002606,-18000,,
com.apple.Notes,7,1711043219,1711043226,1711043226.107163,-18000,,
com.google.Chrome,1,1711043218,1711043219,1711043219.5854,-18000,,
com.apple.Notes,7,1711043211,1711043218,1711043218.3665829,-18000,,
com.google.Chrome,3,1711043208,1711043211,1711043211.2073321,-18000,,
com.apple.Notes,5,1711043203,1711043208,1711043208.5196872,-18000,,
com.google.Chrome,2,1711043201,1711043203,1711043203.787113,-18000,,
com.apple.Notes,5,1711043196,1711043201,1711043201.693822,-18000,,
com.google.Chrome,2,1711043194,1711043196,1711043196.078058,-18000,,
com.apple.Notes,7,1711043187,1711043194,1711043194.8084378,-18000,,
com.google.Chrome,2,1711043185,1711043187,1711043187.572699,-18000,,
com.apple.Notes,3,1711043182,1711043185,1711043185.959554,-18000,,
com.google.Chrome,3,1711043179,1711043182,1711043182.057529,-18000,,
com.apple.Notes,6,1711043173,1711043179,1711043179.716559,-18000,,
com.google.Chrome,4,1711043169,1711043173,1711043173.743307,-18000,,
com.apple.Notes,11,1711043158,1711043169,1711043170.028379,-18000,,
com.google.Chrome,3,1711043155,1711043158,1711043158.113327,-18000,,
com.apple.Notes,6,1711043149,1711043155,1711043155.7499352,-18000,,
com.google.Chrome,1,1711043148,1711043149,1711043149.154942,-18000,,
com.apple.Notes,11,1711043137,1711043148,1711043148.383199,-18000,,
com.google.Chrome,1,1711043136,1711043137,1711043137.437347,-18000,,
com.apple.Notes,4,1711043132,1711043136,1711043136.574259,-18000,,
com.google.Chrome,1,1711043131,1711043132,1711043132.836416,-18000,,
com.apple.Notes,5,1711043126,1711043131,1711043131.127317,-18000,,
com.google.Chrome,7,1711043119,1711043126,1711043126.9885879,-18000,,
com.apple.Notes,4,1711043115,1711043119,1711043119.641746,-18000,,
com.google.Chrome,1,1711043114,1711043115,1711043115.891505,-18000,,
com.apple.Notes,6,1711043108,1711043114,1711043114.56073,-18000,,
com.google.Chrome,3,1711043105,1711043108,1711043108.22302,-18000,,
com.apple.Notes,5,1711043100,1711043105,1711043105.757638,-18000,,
com.google.Chrome,26,1711043074,1711043100,1711043100.821307,-18000,,
com.apple.Notes,7,1711043067,1711043074,1711043074.3618789,-18000,,
com.google.Chrome,13,1711043054,1711043067,1711043067.144446,-18000,,
com.apple.Notes,17,1711043037,1711043054,1711043055.053022,-18000,,
com.google.Chrome,4,1711043033,1711043037,1711043037.257053,-18000,,
com.apple.Notes,4,1711043029,1711043033,1711043033.469221,-18000,,
com.google.Chrome,7,1711043022,1711043029,1711043029.843862,-18000,,
com.apple.Notes,12,1711043010,1711043022,1711043022.807817,-18000,,
com.google.Chrome,4,1711043006,1711043010,1711043010.642432,-18000,,
com.apple.Notes,1,1711043005,1711043006,1711043006.446435,-18000,,
com.google.Chrome,2,1711043003,1711043005,1711043005.381863,-18000,,
com.apple.Notes,3,1711043000,1711043003,1711043003.652378,-18000,,
com.google.Chrome,15,1711042985,1711043000,1711043000.9441319,-18000,,
com.apple.Notes,50,1711042935,1711042985,1711042985.7315822,-18000,,
com.apple.mobiletimer,9,1711042714,1711042723,1711042723.319493,-18000,EB445137-D7F5-57EC-87DA-1DB460D64046,"iPhone13,2"
com.apple.MobileSMS,2,1711042712,1711042714,1711042714.902553,-18000,EB445137-D7F5-57EC-87DA-1DB460D64046,"iPhone13,2"
com.apple.MobileSMS,9,1711042703,1711042712,1711042712.378444,-18000,EB445137-D7F5-57EC-87DA-1DB460D64046,"iPhone13,2"
com.apple.MobileSMS,4,1711042398,1711042402,1711042402.6249309,-18000,EB445137-D7F5-57EC-87DA-1DB460D64046,"iPhone13,2"
com.apple.Notes,305,1711042228,1711042533,1711042533.360074,-18000,,
com.apple.MobileSMS,8,1711042220,1711042228,1711042228.754702,-18000,,
com.apple.Notes,19,1711042201,1711042220,1711042220.764597,-18000,,
com.google.Chrome,15,1711042186,1711042201,1711042201.216557,-18000,,
com.apple.Notes,2,1711042184,1711042186,1711042186.4594011,-18000,,
com.google.Chrome,2,1711042182,1711042184,1711042184.791295,-18000,,
com.apple.Notes,17,1711042165,1711042182,1711042182.4865952,-18000,,
com.google.Chrome,29,1711042136,1711042165,1711042165.540022,-18000,,
com.apple.Notes,9,1711042127,1711042136,1711042136.329344,-18000,,
com.google.Chrome,20,1711042107,1711042127,1711042127.081835,-18000,,
com.apple.Notes,12,1711042095,1711042107,1711042107.2693648,-18000,,
com.google.Chrome,37,1711042058,1711042095,1711042095.753684,-18000,,
com.apple.Notes,3,1711042055,1711042058,1711042058.824687,-18000,,
com.apple.iCal,15,1711042040,1711042055,1711042055.954025,-18000,,
com.apple.Notes,14,1711042026,1711042040,1711042040.804796,-18000,,
com.apple.iCal,19,1711042007,1711042026,1711042026.858906,-18000,,
com.google.Chrome,17,1711041990,1711042007,1711042007.297497,-18000,,
com.apple.iCal,1,1711041989,1711041990,1711041990.183789,-18000,,
com.google.Chrome,2,1711041987,1711041989,1711041989.546401,-18000,,
com.apple.iCal,15,1711041972,1711041987,1711041987.552489,-18000,,
com.google.Chrome,37,1711041935,1711041972,1711041972.27561,-18000,,
com.apple.Notes,8,1711041927,1711041935,1711041935.173211,-18000,,
com.google.Chrome,7,1711041920,1711041927,1711041927.370774,-18000,,
com.apple.Notes,33,1711041887,1711041920,1711041920.396222,-18000,,
com.google.Chrome,8,1711041879,1711041887,1711041887.669516,-18000,,
com.apple.Notes,6,1711041873,1711041879,1711041879.349784,-18000,,
com.google.Chrome,5,1711041868,1711041873,1711041873.8309522,-18000,,
com.apple.Notes,13,1711041855,1711041868,1711041868.256987,-18000,,
com.google.Chrome,6,1711041849,1711041855,1711041855.91994,-18000,,
com.apple.Notes,10,1711041839,1711041849,1711041850.022881,-18000,,
com.google.Chrome,10,1711041829,1711041839,1711041839.080917,-18000,,
com.apple.Notes,15,1711041814,1711041829,1711041829.157862,-18000,,
com.google.Chrome,5,1711041809,1711041814,1711041814.1646209,-18000,,
com.apple.Notes,12,1711041797,1711041809,1711041810.008377,-18000,,
com.google.Chrome,16,1711041781,1711041797,1711041797.588321,-18000,,
com.apple.Notes,10,1711041771,1711041781,1711041782.1014528,-18000,,
com.google.Chrome,1,1711041770,1711041771,1711041771.428289,-18000,,
com.apple.Notes,6,1711041764,1711041770,1711041770.141086,-18000,,
com.google.Chrome,9,1711041755,1711041764,1711041764.639279,-18000,,
com.apple.Notes,7,1711041748,1711041755,1711041755.562166,-18000,,
com.google.Chrome,7,1711041741,1711041748,1711041749.057811,-18000,,
com.apple.Notes,2,1711041739,1711041741,1711041741.790499,-18000,,
com.google.Chrome,13,1711041726,1711041739,1711041739.502641,-18000,,
com.apple.Notes,3,1711041723,1711041726,1711041726.5257769,-18000,,
com.google.Chrome,7,1711041716,1711041723,1711041723.1115808,-18000,,
com.apple.Notes,4,1711041712,1711041716,1711041716.7937021,-18000,,
com.google.Chrome,5,1711041707,1711041712,1711041712.560211,-18000,,
com.apple.Notes,3,1711041704,1711041707,1711041707.5255342,-18000,,
com.google.Chrome,2,1711041702,1711041704,1711041704.362387,-18000,,
com.apple.Notes,3,1711041699,1711041702,1711041702.087237,-18000,,
com.google.Chrome,14,1711041685,1711041699,1711041699.797457,-18000,,
com.apple.Notes,10,1711041660,1711041670,1711041671.454282,-18000,,
com.apple.finder,8,1711041652,1711041660,1711041660.61361,-18000,,
com.leomehlig.today,30,1711041622,1711041652,1711041652.948982,-18000,,
com.google.Chrome,3,1711041619,1711041622,1711041622.976437,-18000,,
com.burbn.instagram,628,1711040897,1711041525,1711041525.611299,-18000,EB445137-D7F5-57EC-87DA-1DB460D64046,"iPhone13,2"
com.facebook.Facebook,11,1711040879,1711040890,1711040890.937265,-18000,EB445137-D7F5-57EC-87DA-1DB460D64046,"iPhone13,2"
com.facebook.Facebook,26,1711040772,1711040798,1711040798.652868,-18000,EB445137-D7F5-57EC-87DA-1DB460D64046,"iPhone13,2"
com.apple.MobileSMS,4,1711040755,1711040759,1711040759.38814,-18000,EB445137-D7F5-57EC-87DA-1DB460D64046,"iPhone13,2"
com.apple.MobileSMS,8,1711040625,1711040633,1711040633.9005718,-18000,EB445137-D7F5-57EC-87DA-1DB460D64046,"iPhone13,2"
com.apple.MobileSMS,5,1711040619,1711040624,1711040624.199308,-18000,EB445137-D7F5-57EC-87DA-1DB460D64046,"iPhone13,2"
com.apple.MobileSMS,60,1711040412,1711040472,1711040472.642223,-18000,EB445137-D7F5-57EC-87DA-1DB460D64046,"iPhone13,2"
com.apple.MobileSMS,111,1711040106,1711040217,1711040217.844199,-18000,EB445137-D7F5-57EC-87DA-1DB460D64046,"iPhone13,2"
com.apple.MobileSMS,1,1711040073,1711040074,1711040074.94175,-18000,EB445137-D7F5-57EC-87DA-1DB460D64046,"iPhone13,2"
com.apple.InCallService,34,1711040039,1711040073,1711040073.831551,-18000,EB445137-D7F5-57EC-87DA-1DB460D64046,"iPhone13,2"
com.apple.MobileSMS,8,1711040031,1711040039,1711040039.6976671,-18000,EB445137-D7F5-57EC-87DA-1DB460D64046,"iPhone13,2"
com.apple.findmy,10,1711039920,1711039930,1711039930.912436,-18000,EB445137-D7F5-57EC-87DA-1DB460D64046,"iPhone13,2"
com.apple.findmy,8,1711039785,1711039793,1711039794.045825,-18000,EB445137-D7F5-57EC-87DA-1DB460D64046,"iPhone13,2"
edu.illinois.rokwire.ios,5,1711039779,1711039784,1711039785.1160278,-18000,EB445137-D7F5-57EC-87DA-1DB460D64046,"iPhone13,2"
edu.illinois.rokwire.ios,41,1711039605,1711039646,1711039646.744091,-18000,EB445137-D7F5-57EC-87DA-1DB460D64046,"iPhone13,2"
com.apple.news,3,1711039601,1711039604,1711039604.2457762,-18000,EB445137-D7F5-57EC-87DA-1DB460D64046,"iPhone13,2"
com.apple.news,96,1711038898,1711038994,1711038994.6672611,-18000,EB445137-D7F5-57EC-87DA-1DB460D64046,"iPhone13,2"
com.microsoft.Office.Outlook,7,1711038739,1711038746,1711038747.042206,-18000,EB445137-D7F5-57EC-87DA-1DB460D64046,"iPhone13,2"
com.microsoft.Office.Outlook,4,1711038253,1711038257,1711038257.731245,-18000,EB445137-D7F5-57EC-87DA-1DB460D64046,"iPhone13,2"
com.microsoft.Office.Outlook,6,1711038218,1711038224,1711038224.935019,-18000,EB445137-D7F5-57EC-87DA-1DB460D64046,"iPhone13,2"
com.microsoft.Office.Outlook,6,1711038210,1711038216,1711038216.369903,-18000,EB445137-D7F5-57EC-87DA-1DB460D64046,"iPhone13,2"
com.microsoft.Office.Outlook,11,1711038194,1711038205,1711038205.08609,-18000,EB445137-D7F5-57EC-87DA-1DB460D64046,"iPhone13,2"
com.apple.camera,1,1711038181,1711038182,1711038182.7414188,-18000,EB445137-D7F5-57EC-87DA-1DB460D64046,"iPhone13,2"
com.microsoft.Office.Outlook,34,1711038160,1711038194,1711038194.030225,-18000,EB445137-D7F5-57EC-87DA-1DB460D64046,"iPhone13,2"
com.microsoft.Office.Outlook,6,1711038149,1711038155,1711038155.710329,-18000,EB445137-D7F5-57EC-87DA-1DB460D64046,"iPhone13,2"
com.microsoft.Office.Outlook,9,1711038139,1711038148,1711038148.574863,-18000,EB445137-D7F5-57EC-87DA-1DB460D64046,"iPhone13,2"
com.microsoft.Office.Outlook,6,1711038117,1711038123,1711038123.770782,-18000,EB445137-D7F5-57EC-87DA-1DB460D64046,"iPhone13,2"
com.microsoft.Office.Outlook,6,1711038105,1711038111,1711038111.827776,-18000,EB445137-D7F5-57EC-87DA-1DB460D64046,"iPhone13,2"
com.microsoft.Office.Outlook,6,1711038088,1711038094,1711038094.0391788,-18000,EB445137-D7F5-57EC-87DA-1DB460D64046,"iPhone13,2"
com.microsoft.Office.Outlook,33,1711037818,1711037851,1711037851.419475,-18000,EB445137-D7F5-57EC-87DA-1DB460D64046,"iPhone13,2"
com.apple.findmy,10,1711037808,1711037818,1711037818.558387,-18000,EB445137-D7F5-57EC-87DA-1DB460D64046,"iPhone13,2"
com.apple.findmy,2,1711037802,1711037804,1711037804.4123201,-18000,EB445137-D7F5-57EC-87DA-1DB460D64046,"iPhone13,2"
com.apple.findmy,2,1711037799,1711037801,1711037802.131484,-18000,EB445137-D7F5-57EC-87DA-1DB460D64046,"iPhone13,2"
com.apple.findmy,19,1711037675,1711037694,1711037694.622208,-18000,EB445137-D7F5-57EC-87DA-1DB460D64046,"iPhone13,2"
com.apple.findmy,20,1711037635,1711037655,1711037655.497504,-18000,EB445137-D7F5-57EC-87DA-1DB460D64046,"iPhone13,2"
com.google.chrome.ios,6,1711037629,1711037635,1711037635.429758,-18000,EB445137-D7F5-57EC-87DA-1DB460D64046,"iPhone13,2"
com.google.Chrome,26,1711037313,1711037339,1711037339.905912,-18000,,
com.apple.finder,10,1711037303,1711037313,1711037313.221583,-18000,,
com.google.Chrome,49,1711037254,1711037303,1711037303.159383,-18000,,
com.apple.finder,6,1711037248,1711037254,1711037254.603461,-18000,,
com.google.Chrome,12,1711037236,1711037248,1711037248.283236,-18000,,
com.apple.Preview,2336,1711034900,1711037236,1711037236.986051,-18000,,
com.apple.Preview,304,1711034201,1711034505,1711034505.969427,-18000,,
com.google.Chrome,268,1711033933,1711034201,1711034201.469676,-18000,,
com.apple.Preview,24,1711033909,1711033933,1711033933.9704108,-18000,,
com.leomehlig.today,22,1711033887,1711033909,1711033909.782577,-18000,,
com.apple.Preview,407,1711033480,1711033887,1711033888.05844,-18000,,
com.google.Chrome,259,1711033221,1711033480,1711033480.2728891,-18000,,
com.apple.Preview,82,1711033139,1711033221,1711033221.469409,-18000,,
com.apple.finder,27,1711033112,1711033139,1711033139.678258,-18000,,
com.google.Chrome,56,1711033056,1711033112,1711033112.6834168,-18000,,
com.google.chrome.ios,92,1711032867,1711032959,1711032959.307903,-18000,EB445137-D7F5-57EC-87DA-1DB460D64046,"iPhone13,2"
com.hammerandchisel.discord,33,1711032832,1711032865,1711032865.973206,-18000,EB445137-D7F5-57EC-87DA-1DB460D64046,"iPhone13,2"
com.hammerandchisel.discord,1,1711032742,1711032743,1711032743.935956,-18000,EB445137-D7F5-57EC-87DA-1DB460D64046,"iPhone13,2"
com.hammerandchisel.discord,6,1711032341,1711032347,1711032347.509376,-18000,EB445137-D7F5-57EC-87DA-1DB460D64046,"iPhone13,2"
com.hammerandchisel.discord,21,1711032318,1711032339,1711032339.5853071,-18000,EB445137-D7F5-57EC-87DA-1DB460D64046,"iPhone13,2"
edu.illinois.rokwire.ios,33,1711032284,1711032317,1711032317.3849711,-18000,EB445137-D7F5-57EC-87DA-1DB460D64046,"iPhone13,2"
com.microsoft.Office.Outlook,8,1711032273,1711032281,1711032281.7726011,-18000,EB445137-D7F5-57EC-87DA-1DB460D64046,"iPhone13,2"
com.google.Chrome,214,1711031469,1711031683,1711031683.614192,-18000,,
com.leomehlig.today,54,1711031401,1711031455,1711031456.5297298,-18000,,
com.microsoft.Office.Outlook,4,1711031181,1711031185,1711031185.45365,-18000,EB445137-D7F5-57EC-87DA-1DB460D64046,"iPhone13,2"
com.microsoft.Office.Outlook,17,1711031157,1711031174,1711031174.481008,-18000,EB445137-D7F5-57EC-87DA-1DB460D64046,"iPhone13,2"
com.apple.Health,10,1711031145,1711031155,1711031155.246028,-18000,EB445137-D7F5-57EC-87DA-1DB460D64046,"iPhone13,2"
com.leomehlig.today,16,1710992688,1710992704,1710992704.994038,-18000,,
com.apple.finder,5,1710992683,1710992688,1710992688.082932,-18000,,
com.microsoft.VSCode,10,1710992673,1710992683,1710992683.800796,-18000,,
com.apple.finder,4,1710992669,1710992673,1710992673.628346,-18000,,
com.apple.TextEdit,15,1710992654,1710992669,1710992670.047857,-18000,,
com.apple.finder,17,1710992637,1710992654,1710992654.750938,-18000,,
com.leomehlig.today,2,1710992635,1710992637,1710992637.154506,-18000,,
com.microsoft.Excel,14,1710992621,1710992635,1710992635.865485,-18000,,
com.leomehlig.today,3,1710992618,1710992621,1710992621.6566172,-18000,,
com.microsoft.Excel,4,1710992614,1710992618,1710992618.8424191,-18000,,
com.leomehlig.today,1,1710992613,1710992614,1710992614.937549,-18000,,
com.microsoft.Excel,3,1710992610,1710992613,1710992613.225424,-18000,,
com.leomehlig.today,3,1710992607,1710992610,1710992610.283668,-18000,,
com.microsoft.Excel,2,1710992605,1710992607,1710992607.206079,-18000,,
com.leomehlig.today,3,1710992602,1710992605,1710992605.718375,-18000,,
com.microsoft.Excel,2,1710992600,1710992602,1710992602.594193,-18000,,
com.leomehlig.today,4,1710992596,1710992600,1710992600.597262,-18000,,
com.microsoft.Excel,5,1710992591,1710992596,1710992596.525398,-18000,,
com.leomehlig.today,4,1710992587,1710992591,1710992591.786869,-18000,,
com.microsoft.Excel,2,1710992585,1710992587,1710992587.246764,-18000,,
com.leomehlig.today,4,1710992581,1710992585,1710992585.807228,-18000,,
com.microsoft.Excel,1,1710992580,1710992581,1710992581.210957,-18000,,
com.leomehlig.today,9,1710992571,1710992580,1710992580.146918,-18000,,
com.microsoft.Excel,2,1710992569,1710992571,1710992571.591656,-18000,,
com.leomehlig.today,8,1710992561,1710992569,1710992569.115584,-18000,,
com.microsoft.Excel,3,1710992558,1710992561,1710992561.991787,-18000,,
com.leomehlig.today,11,1710992547,1710992558,1710992558.277028,-18000,,
com.microsoft.Excel,47,1710992500,1710992547,1710992547.512419,-18000,,
com.leomehlig.today,4,1710992496,1710992500,1710992500.609597,-18000,,
com.microsoft.Excel,5,1710992491,1710992496,1710992496.240426,-18000,,
com.leomehlig.today,15,1710992476,1710992491,1710992491.161592,-18000,,
com.microsoft.Excel,2,1710992474,1710992476,1710992476.835201,-18000,,
com.leomehlig.today,8,1710992466,1710992474,1710992475.010488,-18000,,
com.microsoft.Excel,2,1710992464,1710992466,1710992466.5332088,-18000,,
com.leomehlig.today,7,1710992457,1710992464,1710992464.763026,-18000,,
com.microsoft.Excel,2,1710992455,1710992457,1710992457.922773,-18000,,
com.leomehlig.today,2,1710992453,1710992455,1710992455.450194,-18000,,
com.microsoft.Excel,3,1710992450,1710992453,1710992453.632889,-18000,,
com.leomehlig.today,13,1710992437,1710992450,1710992450.399571,-18000,,
com.microsoft.Excel,2,1710992435,1710992437,1710992438.013815,-18000,,
com.leomehlig.today,6,1710992429,1710992435,1710992435.2089949,-18000,,
com.microsoft.Excel,2,1710992427,1710992429,1710992429.546778,-18000,,
com.leomehlig.today,5,1710992422,1710992427,1710992427.27035,-18000,,
com.microsoft.Excel,3,1710992419,1710992422,1710992422.2043781,-18000,,
com.leomehlig.today,8,1710992411,1710992419,1710992419.639275,-18000,,
com.microsoft.Excel,3,1710992408,1710992411,1710992411.699275,-18000,,
com.leomehlig.today,7,1710992401,1710992408,1710992408.7648602,-18000,,
com.microsoft.Excel,3,1710992398,1710992401,1710992402.033421,-18000,,
com.leomehlig.today,5,1710992393,1710992398,1710992398.955809,-18000,,
com.microsoft.Excel,3,1710992390,1710992393,1710992393.491576,-18000,,
com.leomehlig.today,4,1710992386,1710992390,1710992390.225224,-18000,,
com.microsoft.Excel,2,1710992384,1710992386,1710992386.596801,-18000,,
com.leomehlig.today,4,1710992380,1710992384,1710992384.690463,-18000,,
com.microsoft.Excel,3,1710992377,1710992380,1710992380.835587,-18000,,
com.leomehlig.today,8,1710992369,1710992377,1710992377.706203,-18000,,
com.microsoft.Excel,2,1710992367,1710992369,1710992369.3680902,-18000,,
com.leomehlig.today,7,1710992360,1710992367,1710992368.0395188,-18000,,
com.microsoft.Excel,1,1710992359,1710992360,1710992360.741837,-18000,,
com.leomehlig.today,6,1710992353,1710992359,1710992359.821289,-18000,,
com.microsoft.Excel,1,1710992352,1710992353,1710992353.791758,-18000,,
com.leomehlig.today,23,1710992329,1710992352,1710992352.7023811,-18000,,
com.microsoft.Excel,9,1710992320,1710992329,1710992329.959774,-18000,,
com.apple.iCal,7,1710992313,1710992320,1710992320.6388988,-18000,,
com.microsoft.Excel,2,1710992311,1710992313,1710992313.912606,-18000,,
com.apple.iCal,7,1710992304,1710992311,1710992311.8896,-18000,,
com.apple.finder,9,1710992295,1710992304,1710992304.926179,-18000,,
com.microsoft.Excel,2,1710992293,1710992295,1710992295.3979192,-18000,,
com.apple.iCal,7,1710992286,1710992293,1710992293.3695521,-18000,,
com.microsoft.Excel,9,1710992277,1710992286,1710992286.967628,-18000,,
com.apple.finder,1,1710992276,1710992277,1710992278.083751,-18000,,
com.apple.iCal,37,1710992239,1710992276,1710992276.306948,-18000,,
com.apple.finder,13,1710992226,1710992239,1710992239.42343,-18000,,
com.microsoft.Excel,41,1710992185,1710992226,1710992226.68882,-18000,,
com.apple.finder,17,1710992168,1710992185,1710992185.310139,-18000,,
com.microsoft.Excel,128,1710992040,1710992168,1710992168.7427979,-18000,,
com.apple.finder,13,1710992027,1710992040,1710992040.145653,-18000,,
com.apple.iWork.Numbers,55,1710991972,1710992027,1710992028.0139132,-18000,,
com.apple.finder,21,1710991951,1710991972,1710991972.3803558,-18000,,
com.microsoft.VSCode,89,1710991862,1710991951,1710991951.228757,-18000,,
com.apple.finder,28,1710991834,1710991862,1710991863.057939,-18000,,
com.apple.Terminal,10,1710991824,1710991834,1710991834.725127,-18000,,
com.apple.finder,1,1710991823,1710991824,1710991824.99898,-18000,,
com.google.Chrome,19,1710991804,1710991823,1710991823.793408,-18000,,
com.apple.finder,2,1710991802,1710991804,1710991804.699504,-18000,,
com.apple.Terminal,30,1710991772,1710991802,1710991802.820313,-18000,,
com.google.Chrome,10,1710991762,1710991772,1710991772.78763,-18000,,
com.apple.Terminal,17,1710991745,1710991762,1710991762.735448,-18000,,
com.apple.finder,5,1710991740,1710991745,1710991745.854815,-18000,,
org.python.IDLE,21,1710991719,1710991740,1710991740.719225,-18000,,
com.apple.finder,10,1710991709,1710991719,1710991719.66012,-18000,,
org.python.IDLE,20,1710991689,1710991709,1710991709.79091,-18000,,
com.apple.finder,34,1710991655,1710991689,1710991689.568953,-18000,,
com.google.Chrome,6,1710991649,1710991655,1710991655.180063,-18000,,
com.google.Chrome,3,1710985536,1710985539,1710985539.6696959,-18000,,
com.apple.finder,1,1710985535,1710985536,1710985536.561325,-18000,,
com.apple.Notes,14,1710985521,1710985535,1710985535.601831,-18000,,
com.google.Chrome,5,1710985516,1710985521,1710985521.281804,-18000,,
com.leomehlig.today,14,1710985502,1710985516,1710985516.964884,-18000,,
com.google.Chrome,86,1710985416,1710985502,1710985502.589021,-18000,,
com.leomehlig.today,63,1710985353,1710985416,1710985416.7241359,-18000,,
com.apple.finder,13,1710985340,1710985353,1710985353.29741,-18000,,
com.leomehlig.today,46,1710985294,1710985340,1710985340.250803,-18000,,
com.apple.Notes,7,1710985287,1710985294,1710985295.039298,-18000,,
com.leomehlig.today,29,1710985258,1710985287,1710985288.002403,-18000,,
com.apple.Notes,91,1710985167,1710985258,1710985258.830772,-18000,,
com.google.Chrome,3,1710985164,1710985167,1710985167.66695,-18000,,
com.google.Chrome,300,1710984772,1710985072,1710985072.1882648,-18000,,
com.leomehlig.today,40,1710984732,1710984772,1710984772.252734,-18000,,
com.google.Chrome,547,1710984185,1710984732,1710984732.6860042,-18000,,
com.leomehlig.today,3,1710984182,1710984185,1710984185.386399,-18000,,
com.google.Chrome,1134,1710983048,1710984182,1710984182.178796,-18000,,
com.leomehlig.today,6,1710983042,1710983048,1710983048.769397,-18000,,
com.google.Chrome,1592,1710981450,1710983042,1710983042.990031,-18000,,
com.google.Chrome,301,1710981114,1710981415,1710981415.4962091,-18000,,
com.google.Chrome,1729,1710979372,1710981101,1710981101.216414,-18000,,
com.leomehlig.today,2,1710979232,1710979234,1710979234.2335482,-18000,,
com.google.Chrome,218,1710979014,1710979232,1710979232.467451,-18000,,
com.leomehlig.today,14,1710979000,1710979014,1710979014.87307,-18000,,
com.leomehlig.today,58,1710976536,1710976594,1710976594.325235,-18000,,
com.google.Chrome,249,1710976287,1710976536,1710976536.873289,-18000,,
com.leomehlig.today,19,1710976258,1710976277,1710976277.6955929,-18000,,
com.google.Chrome,3,1710976255,1710976258,1710976258.270469,-18000,,
com.apple.finder,20,1710976235,1710976255,1710976255.914864,-18000,,
com.apple.Photos,15,1710976220,1710976235,1710976235.698463,-18000,,
com.apple.finder,24,1710976196,1710976220,1710976220.338993,-18000,,
com.apple.Photos,52,1710976144,1710976196,1710976196.6471748,-18000,,
com.google.Chrome,87,1710976057,1710976144,1710976144.8992538,-18000,,
com.apple.Photos,9,1710976048,1710976057,1710976057.1456919,-18000,,
com.google.Chrome,38,1710976010,1710976048,1710976048.831634,-18000,,
com.apple.Photos,62,1710975948,1710976010,1710976010.909593,-18000,,
com.apple.finder,48,1710975900,1710975948,1710975948.4499931,-18000,,
com.apple.Photos,55,1710975845,1710975900,1710975900.151318,-18000,,
com.apple.finder,82,1710975763,1710975845,1710975845.4999108,-18000,,
com.apple.Photos,74,1710975689,1710975763,1710975764.165133,-18000,,
com.google.Chrome,44,1710975645,1710975689,1710975689.198586,-18000,,
com.apple.Photos,1,1710975644,1710975645,1710975645.784883,-18000,,
com.google.Chrome,19,1710975625,1710975644,1710975645.0201,-18000,,
com.apple.Photos,7,1710975618,1710975625,1710975625.697964,-18000,,
com.leomehlig.today,51,1710975567,1710975618,1710975618.2113562,-18000,,
com.google.Chrome,26,1710975541,1710975567,1710975567.323215,-18000,,
com.apple.news,528,1710969777,1710970305,1710970307.456316,-18000,EB445137-D7F5-57EC-87DA-1DB460D64046,"iPhone13,2"
com.instructure.icanvas,20,1710969746,1710969766,1710969766.390331,-18000,EB445137-D7F5-57EC-87DA-1DB460D64046,"iPhone13,2"
edu.illinois.rokwire.ios,3,1710969743,1710969746,1710969747.18671,-18000,EB445137-D7F5-57EC-87DA-1DB460D64046,"iPhone13,2"
edu.illinois.rokwire.ios,20,1710967499,1710967519,1710967519.328843,-18000,EB445137-D7F5-57EC-87DA-1DB460D64046,"iPhone13,2"
com.google.Chrome,2,1710967447,1710967449,1710967449.0576801,-18000,,
com.apple.finder,1,1710967446,1710967447,1710967447.411924,-18000,,
com.google.Chrome,9,1710967437,1710967446,1710967446.187005,-18000,,
com.microsoft.Outlook,4,1710967433,1710967437,1710967437.9537668,-18000,,
com.apple.iCal,20,1710967413,1710967433,1710967433.067473,-18000,,
com.google.Chrome,17,1710967396,1710967413,1710967413.802702,-18000,,
com.microsoft.Outlook,5,1710967391,1710967396,1710967396.2916079,-18000,,
com.google.Chrome,68,1710967323,1710967391,1710967391.321176,-18000,,
com.microsoft.Outlook,5,1710967318,1710967323,1710967323.423557,-18000,,
com.facebook.Facebook,124,1710967102,1710967226,1710967226.328875,-18000,EB445137-D7F5-57EC-87DA-1DB460D64046,"iPhone13,2"
com.burbn.instagram,16,1710967082,1710967098,1710967098.994629,-18000,EB445137-D7F5-57EC-87DA-1DB460D64046,"iPhone13,2"
com.apple.Music,5,1710967068,1710967073,1710967073.820529,-18000,EB445137-D7F5-57EC-87DA-1DB460D64046,"iPhone13,2"
com.microsoft.Outlook,303,1710966846,1710967149,1710967149.923347,-18000,,
com.google.Chrome,8,1710966838,1710966846,1710966846.232341,-18000,,
com.apple.finder,2,1710966832,1710966834,1710966835.772503,-18000,,
com.apple.Music,1,1710966198,1710966199,1710966200.572187,-18000,EB445137-D7F5-57EC-87DA-1DB460D64046,"iPhone13,2"
com.apple.Music,1,1710966196,1710966197,1710966197.944893,-18000,EB445137-D7F5-57EC-87DA-1DB460D64046,"iPhone13,2"
com.apple.Music,12,1710966178,1710966190,1710966190.5072842,-18000,EB445137-D7F5-57EC-87DA-1DB460D64046,"iPhone13,2"
com.microsoft.Office.Outlook,3,1710966173,1710966176,1710966176.798001,-18000,EB445137-D7F5-57EC-87DA-1DB460D64046,"iPhone13,2"
com.apple.finder,3,1710966035,1710966038,1710966038.925111,-18000,,
com.google.Chrome,3,1710966032,1710966035,1710966035.351965,-18000,,
com.leomehlig.today,70,1710965962,1710966032,1710966032.8947911,-18000,,
com.google.Chrome,456,1710965506,1710965962,1710965962.54321,-18000,,
com.google.Chrome,909,1710964530,1710965439,1710965439.77909,-18000,,
com.google.Chrome,525,1710963931,1710964456,1710964456.791647,-18000,,
com.microsoft.Office.Outlook,20,1710963270,1710963290,1710963291.1616921,-18000,EB445137-D7F5-57EC-87DA-1DB460D64046,"iPhone13,2"
com.apple.news,3,1710963267,1710963270,1710963270.7387729,-18000,EB445137-D7F5-57EC-87DA-1DB460D64046,"iPhone13,2"
com.google.Chrome,975,1710962895,1710963870,1710963870.1384811,-18000,,
com.google.Chrome,332,1710962553,1710962885,1710962885.714837,-18000,,
com.leomehlig.today,8,1710962522,1710962530,1710962530.26409,-18000,,
com.apple.news,381,1710962066,1710962447,1710962448.0381331,-18000,EB445137-D7F5-57EC-87DA-1DB460D64046,"iPhone13,2"
com.apple.mobilecal,21,1710962020,1710962041,1710962041.56832,-18000,EB445137-D7F5-57EC-87DA-1DB460D64046,"iPhone13,2"
com.apple.MobileSMS,4,1710962014,1710962018,1710962018.24647,-18000,EB445137-D7F5-57EC-87DA-1DB460D64046,"iPhone13,2"
com.microsoft.Office.Outlook,8,1710962006,1710962014,1710962014.589785,-18000,EB445137-D7F5-57EC-87DA-1DB460D64046,"iPhone13,2"
com.microsoft.Office.Outlook,3,1710961902,1710961905,1710961905.490045,-18000,EB445137-D7F5-57EC-87DA-1DB460D64046,"iPhone13,2"
com.microsoft.Office.Outlook,24,1710960159,1710960183,1710960183.4450169,-18000,EB445137-D7F5-57EC-87DA-1DB460D64046,"iPhone13,2"
com.apple.MobileSMS,40,1710957617,1710957657,1710957657.109356,-18000,EB445137-D7F5-57EC-87DA-1DB460D64046,"iPhone13,2"
com.apple.news,1,1710957616,1710957617,1710957618.923039,-18000,EB445137-D7F5-57EC-87DA-1DB460D64046,"iPhone13,2"
com.apple.news,2,1710957612,1710957614,1710957615.881201,-18000,EB445137-D7F5-57EC-87DA-1DB460D64046,"iPhone13,2"
com.apple.PosterBoard,1,1710957609,1710957610,1710957610.786809,-18000,EB445137-D7F5-57EC-87DA-1DB460D64046,"iPhone13,2"
com.toyopagroup.picaboo,47,1710957532,1710957579,1710957579.704406,-18000,EB445137-D7F5-57EC-87DA-1DB460D64046,"iPhone13,2"
com.apple.MobileSMS,7,1710957519,1710957526,1710957526.821527,-18000,EB445137-D7F5-57EC-87DA-1DB460D64046,"iPhone13,2"
com.leomehlig.today,23,1710957452,1710957475,1710957475.791235,-18000,,
com.apple.Preview,194,1710957258,1710957452,1710957452.5613708,-18000,,
com.apple.iCal,4,1710957254,1710957258,1710957258.242972,-18000,,
com.apple.MobileSMS,6,1710956471,1710956477,1710956477.3497272,-18000,EB445137-D7F5-57EC-87DA-1DB460D64046,"iPhone13,2"
com.apple.MobileSMS,9,1710956242,1710956251,1710956251.51339,-18000,EB445137-D7F5-57EC-87DA-1DB460D64046,"iPhone13,2"
com.apple.MobileSMS,4,1710956084,1710956088,1710956089.0259042,-18000,EB445137-D7F5-57EC-87DA-1DB460D64046,"iPhone13,2"
com.apple.Preview,1231,1710956023,1710957254,1710957254.772274,-18000,,
com.apple.MobileSMS,5,1710956018,1710956023,1710956023.079114,-18000,,
com.apple.Preview,12,1710956006,1710956018,1710956018.861826,-18000,,
com.apple.MobileSMS,23,1710955983,1710956006,1710956006.595749,-18000,,
com.apple.iCal,17,1710955966,1710955983,1710955983.370527,-18000,,
com.apple.MobileSMS,206,1710955760,1710955966,1710955966.6942558,-18000,,
com.apple.iCal,45,1710955715,1710955760,1710955761.0606298,-18000,,
com.apple.MobileSMS,93,1710955622,1710955715,1710955715.242672,-18000,,
com.apple.Preview,34,1710955588,1710955622,1710955622.1703649,-18000,,
com.apple.finder,4,1710955584,1710955588,1710955588.701762,-18000,,
com.apple.Preview,1,1710955583,1710955584,1710955584.8084512,-18000,,
com.apple.Notes,49,1710955534,1710955583,1710955583.7649589,-18000,,
com.leomehlig.today,2,1710955530,1710955532,1710955532.504198,-18000,,
com.apple.systempreferences,1,1710955529,1710955530,1710955530.355685,-18000,,
com.leomehlig.today,10,1710955518,1710955528,1710955528.24195,-18000,,
com.apple.reminders,4,1710955499,1710955503,1710955503.867418,-18000,EB445137-D7F5-57EC-87DA-1DB460D64046,"iPhone13,2"
com.apple.MobileSMS,82,1710955415,1710955497,1710955497.1804671,-18000,EB445137-D7F5-57EC-87DA-1DB460D64046,"iPhone13,2"
com.apple.mobilecal,4,1710955411,1710955415,1710955415.274137,-18000,EB445137-D7F5-57EC-87DA-1DB460D64046,"iPhone13,2"
com.apple.MobileSMS,141,1710955270,1710955411,1710955412.031781,-18000,EB445137-D7F5-57EC-87DA-1DB460D64046,"iPhone13,2"
com.apple.mobilecal,13,1710955257,1710955270,1710955270.804487,-18000,EB445137-D7F5-57EC-87DA-1DB460D64046,"iPhone13,2"
com.apple.MobileSMS,65,1710955189,1710955254,1710955254.9244761,-18000,EB445137-D7F5-57EC-87DA-1DB460D64046,"iPhone13,2"
edu.illinois.rokwire.ios,2,1710955187,1710955189,1710955189.72578,-18000,EB445137-D7F5-57EC-87DA-1DB460D64046,"iPhone13,2"
edu.illinois.rokwire.ios,63,1710953832,1710953895,1710953895.9858809,-18000,EB445137-D7F5-57EC-87DA-1DB460D64046,"iPhone13,2"
com.google.chrome.ios,3,1710953828,1710953831,1710953831.512913,-18000,EB445137-D7F5-57EC-87DA-1DB460D64046,"iPhone13,2"
com.google.chrome.ios,8,1710953805,1710953813,1710953813.849427,-18000,EB445137-D7F5-57EC-87DA-1DB460D64046,"iPhone13,2"
com.google.chrome.ios,37,1710953425,1710953462,1710953462.6779032,-18000,EB445137-D7F5-57EC-87DA-1DB460D64046,"iPhone13,2"
com.apple.news,3,1710953421,1710953424,1710953424.983523,-18000,EB445137-D7F5-57EC-87DA-1DB460D64046,"iPhone13,2"
com.apple.news,108,1710951042,1710951150,1710951151.1724691,-18000,EB445137-D7F5-57EC-87DA-1DB460D64046,"iPhone13,2"
com.hammerandchisel.discord,83,1710950927,1710951010,1710951010.255332,-18000,EB445137-D7F5-57EC-87DA-1DB460D64046,"iPhone13,2"
com.leomehlig.today,4,1710950794,1710950798,1710950798.420092,-18000,,
com.microsoft.VSCode,7,1710950787,1710950794,1710950795.050487,-18000,,
com.google.Chrome,289,1710950498,1710950787,1710950787.185128,-18000,,
com.microsoft.VSCode,4,1710950475,1710950479,1710950479.2025561,-18000,,
com.apple.MobileSMS,2,1710949452,1710949454,1710949454.574562,-18000,EB445137-D7F5-57EC-87DA-1DB460D64046,"iPhone13,2"
com.apple.Health,5,1710949395,1710949400,1710949400.746788,-18000,EB445137-D7F5-57EC-87DA-1DB460D64046,"iPhone13,2"
com.apple.Health,10,1710949375,1710949385,1710949388.467698,-18000,EB445137-D7F5-57EC-87DA-1DB460D64046,"iPhone13,2"
com.apple.MobileSMS,2,1710949371,1710949373,1710949373.619121,-18000,EB445137-D7F5-57EC-87DA-1DB460D64046,"iPhone13,2"
com.instructure.icanvas,2,1710949369,1710949371,1710949372.289413,-18000,EB445137-D7F5-57EC-87DA-1DB460D64046,"iPhone13,2"
com.microsoft.VSCode,3059,1710946264,1710949323,1710949323.987154,-18000,,
com.apple.iCal,49,1710946215,1710946264,1710946265.009983,-18000,,
com.google.Chrome,35,1710946180,1710946215,1710946215.483735,-18000,,
com.microsoft.VSCode,279,1710945901,1710946180,1710946180.258735,-18000,,
com.leomehlig.today,100,1710945801,1710945901,1710945901.275731,-18000,,
com.google.Chrome,6,1710945795,1710945801,1710945801.549041,-18000,,
com.microsoft.VSCode,436,1710945359,1710945795,1710945795.7298021,-18000,,
com.apple.MobileSMS,6,1710945353,1710945359,1710945359.5428429,-18000,,
com.microsoft.VSCode,133,1710945220,1710945353,1710945353.120214,-18000,,
com.google.Chrome,10,1710945210,1710945220,1710945220.484416,-18000,,
com.microsoft.VSCode,2,1710945208,1710945210,1710945211.30652,-18000,,
com.google.Chrome,12,1710945196,1710945208,1710945208.854982,-18000,,
com.apple.finder,2,1710945194,1710945196,1710945198.573189,-18000,,
com.instructure.icanvas,12,1710945175,1710945187,1710945188.0468678,-18000,EB445137-D7F5-57EC-87DA-1DB460D64046,"iPhone13,2"
com.apple.MobileSMS,67,1710945104,1710945171,1710945171.810454,-18000,EB445137-D7F5-57EC-87DA-1DB460D64046,"iPhone13,2"
com.apple.finder,10,1710907177,1710907187,1710907187.717303,-18000,,
com.apple.Photos,2,1710907175,1710907177,1710907178.436393,-18000,,
com.letterboxd.LetterboxdApp,112,1710907008,1710907120,1710907120.247188,-18000,EB445137-D7F5-57EC-87DA-1DB460D64046,"iPhone13,2"
com.letterboxd.LetterboxdApp,1,1710907005,1710907006,1710907007.102336,-18000,EB445137-D7F5-57EC-87DA-1DB460D64046,"iPhone13,2"
com.google.Chrome,404,1710906771,1710907175,1710907175.817974,-18000,,
com.google.Chrome,736,1710905691,1710906427,1710906427.0334392,-18000,,
com.google.Chrome,762,1710904567,1710905329,1710905329.010257,-18000,,
com.letterboxd.LetterboxdApp,162,1710904296,1710904458,1710904458.422029,-18000,EB445137-D7F5-57EC-87DA-1DB460D64046,"iPhone13,2"
com.google.Chrome,907,1710903507,1710904414,1710904414.445723,-18000,,
com.letterboxd.LetterboxdApp,47,1710903093,1710903140,1710903140.46401,-18000,EB445137-D7F5-57EC-87DA-1DB460D64046,"iPhone13,2"
com.google.Chrome,374,1710902853,1710903227,1710903227.5756001,-18000,,
com.facebook.Facebook,91,1710902834,1710902925,1710902925.222851,-18000,EB445137-D7F5-57EC-87DA-1DB460D64046,"iPhone13,2"
com.toyopagroup.picaboo,32,1710902551,1710902583,1710902583.650049,-18000,EB445137-D7F5-57EC-87DA-1DB460D64046,"iPhone13,2"
com.letterboxd.LetterboxdApp,8,1710902543,1710902551,1710902551.188668,-18000,EB445137-D7F5-57EC-87DA-1DB460D64046,"iPhone13,2"
com.google.Chrome,301,1710902447,1710902748,1710902748.3843179,-18000,,
com.letterboxd.LetterboxdApp,6,1710902328,1710902334,1710902334.613766,-18000,EB445137-D7F5-57EC-87DA-1DB460D64046,"iPhone13,2"
com.letterboxd.LetterboxdApp,6,1710902041,1710902047,1710902047.4083738,-18000,EB445137-D7F5-57EC-87DA-1DB460D64046,"iPhone13,2"
com.google.Chrome,490,1710901708,1710902198,1710902198.432375,-18000,,
com.letterboxd.LetterboxdApp,46,1710901684,1710901730,1710901730.238301,-18000,EB445137-D7F5-57EC-87DA-1DB460D64046,"iPhone13,2"
com.apple.reminders,2,1710901682,1710901684,1710901684.664424,-18000,EB445137-D7F5-57EC-87DA-1DB460D64046,"iPhone13,2"
com.apple.reminders,3,1710901467,1710901470,1710901470.097718,-18000,EB445137-D7F5-57EC-87DA-1DB460D64046,"iPhone13,2"
com.google.Chrome,396,1710901194,1710901590,1710901590.2509708,-18000,,
com.google.Chrome,598,1710900107,1710900705,1710900705.380515,-18000,,
com.apple.finder,2,1710900105,1710900107,1710900108.002603,-18000,,
com.microsoft.VSCode,505,1710899600,1710900105,1710900105.830375,-18000,,
com.apple.finder,0,1710899600,1710899600,1710899601.022931,-18000,,
com.google.Chrome,1,1710899599,1710899600,1710899600.414837,-18000,,
com.apple.finder,1,1710899598,1710899599,1710899599.485167,-18000,,
com.microsoft.VSCode,6,1710899592,1710899598,1710899598.749541,-18000,,
com.apple.finder,6,1710899586,1710899592,1710899592.9359698,-18000,,
com.google.Chrome,2,1710899584,1710899586,1710899586.307375,-18000,,
com.microsoft.VSCode,34,1710899550,1710899584,1710899584.487763,-18000,,
com.google.Chrome,27,1710899523,1710899550,1710899550.213976,-18000,,
com.microsoft.VSCode,1,1710899522,1710899523,1710899523.9172,-18000,,
com.apple.reminders,20,1710899427,1710899447,1710899448.024581,-18000,EB445137-D7F5-57EC-87DA-1DB460D64046,"iPhone13,2"
com.apple.camera,1,1710898881,1710898882,1710898882.283426,-18000,EB445137-D7F5-57EC-87DA-1DB460D64046,"iPhone13,2"
com.apple.MobileSMS,4,1710896970,1710896974,1710896974.092009,-18000,EB445137-D7F5-57EC-87DA-1DB460D64046,"iPhone13,2"
com.target.Target,46,1710896923,1710896969,1710896969.079155,-18000,EB445137-D7F5-57EC-87DA-1DB460D64046,"iPhone13,2"
com.google.chrome.ios,6,1710896910,1710896916,1710896916.5614228,-18000,EB445137-D7F5-57EC-87DA-1DB460D64046,"iPhone13,2"
com.google.chrome.ios,26,1710896334,1710896360,1710896361.1008,-18000,EB445137-D7F5-57EC-87DA-1DB460D64046,"iPhone13,2"
com.google.chrome.ios,16,1710896279,1710896295,1710896295.973637,-18000,EB445137-D7F5-57EC-87DA-1DB460D64046,"iPhone13,2"
com.apple.camera,5,1710896273,1710896278,1710896278.426344,-18000,EB445137-D7F5-57EC-87DA-1DB460D64046,"iPhone13,2"
com.apple.camera,2,1710896268,1710896270,1710896272.5170898,-18000,EB445137-D7F5-57EC-87DA-1DB460D64046,"iPhone13,2"
com.microsoft.VSCode,712,1710895396,1710896108,1710896108.129942,-18000,,
com.microsoft.VSCode,311,1710895083,1710895394,1710895394.6544461,-18000,,
com.apple.finder,2,1710895081,1710895083,1710895083.985653,-18000,,
com.microsoft.VSCode,53,1710895028,1710895081,1710895081.51292,-18000,,
com.apple.finder,1,1710895027,1710895028,1710895028.4274812,-18000,,
com.apple.systempreferences,4,1710895022,1710895026,1710895026.823236,-18000,,
com.apple.finder,2,1710895019,1710895021,1710895021.1204782,-18000,,
com.apple.iWork.Numbers,17,1710895002,1710895019,1710895019.391035,-18000,,
com.apple.finder,203,1710894799,1710895002,1710895003.00895,-18000,,
com.microsoft.VSCode,33,1710894766,1710894799,1710894800.06608,-18000,,
com.apple.finder,30,1710894736,1710894766,1710894766.971754,-18000,,
com.microsoft.VSCode,13,1710894723,1710894736,1710894736.25695,-18000,,
com.apple.finder,3,1710894720,1710894723,1710894723.953755,-18000,,
com.microsoft.VSCode,13,1710894707,1710894720,1710894720.3868089,-18000,,
com.apple.finder,4,1710894703,1710894707,1710894707.5595598,-18000,,
com.microsoft.VSCode,3,1710894700,1710894703,1710894704.142313,-18000,,
com.apple.finder,4,1710894696,1710894700,1710894700.1912231,-18000,,
com.microsoft.VSCode,23,1710894673,1710894696,1710894696.763444,-18000,,
com.apple.finder,5,1710894668,1710894673,1710894673.252506,-18000,,
com.google.Chrome,1,1710894667,1710894668,1710894668.954589,-18000,,
com.microsoft.VSCode,14,1710894653,1710894667,1710894667.098331,-18000,,
com.google.Chrome,30,1710894623,1710894653,1710894653.640122,-18000,,
com.microsoft.Outlook,21,1710894602,1710894623,1710894623.3422809,-18000,,
com.google.Chrome,23,1710894579,1710894602,1710894602.210401,-18000,,
com.apple.finder,7,1710894572,1710894579,1710894579.076369,-18000,,
com.google.Chrome,2,1710894570,1710894572,1710894572.521976,-18000,,
com.microsoft.VSCode,594,1710893976,1710894570,1710894570.923655,-18000,,
com.apple.finder,6,1710893970,1710893976,1710893976.48107,-18000,,
com.microsoft.VSCode,40,1710893930,1710893970,1710893971.031228,-18000,,
com.google.Chrome,43,1710893887,1710893930,1710893931.0352058,-18000,,
com.microsoft.VSCode,866,1710893021,1710893887,1710893887.705071,-18000,,
com.apple.finder,27,1710892994,1710893021,1710893022.0538359,-18000,,
com.microsoft.Outlook,38,1710892956,1710892994,1710892994.447896,-18000,,
com.google.Chrome,4,1710892952,1710892956,1710892956.521265,-18000,,
com.apple.finder,11,1710892941,1710892952,1710892952.1317,-18000,,
com.whentowork.iOS.WhenToWork-Employee-Scheduling,23,1710892881,1710892904,1710892905.001761,-18000,EB445137-D7F5-57EC-87DA-1DB460D64046,"iPhone13,2"
com.instructure.icanvas,8,1710892872,1710892880,1710892880.5391688,-18000,EB445137-D7F5-57EC-87DA-1DB460D64046,"iPhone13,2"
com.apple.calculator,8,1710892864,1710892872,1710892872.6265721,-18000,EB445137-D7F5-57EC-87DA-1DB460D64046,"iPhone13,2"
com.instructure.icanvas,12,1710892852,1710892864,1710892864.74557,-18000,EB445137-D7F5-57EC-87DA-1DB460D64046,"iPhone13,2"
com.apple.MobileSMS,5,1710892847,1710892852,1710892852.1239629,-18000,EB445137-D7F5-57EC-87DA-1DB460D64046,"iPhone13,2"
com.apple.finder,24,1710891862,1710891886,1710891886.9648871,-18000,,
com.apple.Photos,1,1710891861,1710891862,1710891862.568015,-18000,,
com.apple.finder,1,1710891860,1710891861,1710891862.026236,-18000,,
com.apple.Photos,1,1710891859,1710891860,1710891860.2246308,-18000,,
com.apple.finder,2,1710891857,1710891859,1710891859.778311,-18000,,
com.apple.Photos,0,1710891857,1710891857,1710891857.8911772,-18000,,
com.apple.finder,1,1710891856,1710891857,1710891857.18061,-18000,,
com.apple.Photos,8,1710891848,1710891856,1710891856.32655,-18000,,
com.apple.finder,88,1710891760,1710891848,1710891848.105269,-18000,,
com.google.Chrome,51,1710891709,1710891760,1710891760.931635,-18000,,
com.apple.Photos,65,1710891644,1710891709,1710891709.511125,-18000,,
com.apple.MobileSMS,6,1710891572,1710891578,1710891578.269072,-18000,EB445137-D7F5-57EC-87DA-1DB460D64046,"iPhone13,2"
com.google.Chrome,91,1710891553,1710891644,1710891644.648309,-18000,,
com.google.Chrome,8,1710891426,1710891434,1710891434.178463,-18000,,
com.leomehlig.today,94,1710891332,1710891426,1710891426.54747,-18000,,
com.apple.Preview,209,1710891123,1710891332,1710891332.643311,-18000,,
com.google.Chrome,8,1710891115,1710891123,1710891124.000351,-18000,,
com.apple.Preview,1004,1710890111,1710891115,1710891115.661654,-18000,,
com.google.Chrome,56,1710890055,1710890111,1710890111.914257,-18000,,
com.apple.Preview,69,1710889986,1710890055,1710890055.7045,-18000,,
com.google.Chrome,2,1710889984,1710889986,1710889986.6976671,-18000,,
com.apple.Preview,1602,1710888382,1710889984,1710889984.2428532,-18000,,
com.apple.finder,2,1710888380,1710888382,1710888382.8989248,-18000,,
com.apple.MobileSMS,48,1710888321,1710888369,1710888369.3138971,-18000,EB445137-D7F5-57EC-87DA-1DB460D64046,"iPhone13,2"
com.google.chrome.ios,4,1710888317,1710888321,1710888321.396545,-18000,EB445137-D7F5-57EC-87DA-1DB460D64046,"iPhone13,2"
com.leomehlig.today,108,1710888272,1710888380,1710888381.0391731,-18000,,
com.google.chrome.ios,10,1710888157,1710888167,1710888167.542623,-18000,EB445137-D7F5-57EC-87DA-1DB460D64046,"iPhone13,2"
com.google.chrome.ios,3,1710888153,1710888156,1710888156.524972,-18000,EB445137-D7F5-57EC-87DA-1DB460D64046,"iPhone13,2"
com.google.chrome.ios,29,1710887835,1710887864,1710887864.307347,-18000,EB445137-D7F5-57EC-87DA-1DB460D64046,"iPhone13,2"
com.microsoft.Office.Outlook,24,1710887809,1710887833,1710887833.924799,-18000,EB445137-D7F5-57EC-87DA-1DB460D64046,"iPhone13,2"
edu.illinois.rokwire.ios,5,1710887804,1710887809,1710887809.449191,-18000,EB445137-D7F5-57EC-87DA-1DB460D64046,"iPhone13,2"
edu.illinois.rokwire.ios,6,1710886197,1710886203,1710886203.215949,-18000,EB445137-D7F5-57EC-87DA-1DB460D64046,"iPhone13,2"
edu.illinois.rokwire.ios,23,1710886146,1710886169,1710886169.132468,-18000,EB445137-D7F5-57EC-87DA-1DB460D64046,"iPhone13,2"
com.burbn.instagram,383,1710885763,1710886146,1710886146.9476929,-18000,EB445137-D7F5-57EC-87DA-1DB460D64046,"iPhone13,2"
com.apple.MobileSMS,8,1710885755,1710885763,1710885763.530878,-18000,EB445137-D7F5-57EC-87DA-1DB460D64046,"iPhone13,2"
com.burbn.instagram,273,1710885482,1710885755,1710885755.633191,-18000,EB445137-D7F5-57EC-87DA-1DB460D64046,"iPhone13,2"
com.apple.MobileSMS,2,1710885466,1710885468,1710885468.630856,-18000,EB445137-D7F5-57EC-87DA-1DB460D64046,"iPhone13,2"
com.apple.findmy,4,1710885461,1710885465,1710885466.4185019,-18000,EB445137-D7F5-57EC-87DA-1DB460D64046,"iPhone13,2"
com.apple.MobileSMS,12,1710885449,1710885461,1710885461.478747,-18000,EB445137-D7F5-57EC-87DA-1DB460D64046,"iPhone13,2"
com.apple.findmy,2,1710885447,1710885449,1710885449.888737,-18000,EB445137-D7F5-57EC-87DA-1DB460D64046,"iPhone13,2"
com.leomehlig.today,29,1710885384,1710885413,1710885413.292543,-18000,,
com.apple.Preview,803,1710884581,1710885384,1710885384.2077909,-18000,,
com.google.Chrome,3,1710884578,1710884581,1710884581.5189462,-18000,,
com.apple.Preview,1761,1710882817,1710884578,1710884578.703718,-18000,,
com.google.Chrome,3,1710882814,1710882817,1710882817.067502,-18000,,
com.apple.Preview,9,1710882805,1710882814,1710882814.859293,-18000,,
com.apple.finder,7,1710882798,1710882805,1710882805.3068218,-18000,,
com.google.Chrome,29,1710882769,1710882798,1710882798.243252,-18000,,
com.leomehlig.today,10,1710882759,1710882769,1710882769.04056,-18000,,
com.google.Chrome,44,1710882715,1710882759,1710882759.761852,-18000,,
com.leomehlig.today,35,1710882661,1710882696,1710882696.367774,-18000,,
com.apple.findmy,7,1710882578,1710882585,1710882585.149022,-18000,EB445137-D7F5-57EC-87DA-1DB460D64046,"iPhone13,2"
com.apple.findmy,2,1710882141,1710882143,1710882143.4257011,-18000,EB445137-D7F5-57EC-87DA-1DB460D64046,"iPhone13,2"
com.apple.findmy,8,1710881747,1710881755,1710881755.678328,-18000,EB445137-D7F5-57EC-87DA-1DB460D64046,"iPhone13,2"
com.apple.camera,6,1710881184,1710881190,1710881190.499075,-18000,EB445137-D7F5-57EC-87DA-1DB460D64046,"iPhone13,2"
com.apple.camera,5,1710881034,1710881039,1710881040.317566,-18000,EB445137-D7F5-57EC-87DA-1DB460D64046,"iPhone13,2"
com.apple.camera,6,1710880796,1710880802,1710880803.225868,-18000,EB445137-D7F5-57EC-87DA-1DB460D64046,"iPhone13,2"
com.apple.camera,7,1710880536,1710880543,1710880550.475072,-18000,EB445137-D7F5-57EC-87DA-1DB460D64046,"iPhone13,2"
com.apple.camera,24,1710880376,1710880400,1710880400.773679,-18000,EB445137-D7F5-57EC-87DA-1DB460D64046,"iPhone13,2"
com.leomehlig.today,3,1710879648,1710879651,1710879651.360828,-18000,,
com.google.Chrome,98,1710879550,1710879648,1710879648.845811,-18000,,
com.leomehlig.today,9,1710879541,1710879550,1710879550.627277,-18000,,
us.zoom.xos,395,1710879146,1710879541,1710879541.911886,-18000,,
com.leomehlig.today,1,1710879145,1710879146,1710879146.890294,-18000,,
com.google.Chrome,1,1710879144,1710879145,1710879145.7442222,-18000,,
com.leomehlig.today,13,1710879131,1710879144,1710879145.015918,-18000,,
com.google.Chrome,16,1710879115,1710879131,1710879131.667687,-18000,,
us.zoom.xos,358,1710878757,1710879115,1710879115.994872,-18000,,
com.leomehlig.today,82,1710878675,1710878757,1710878757.131172,-18000,,
com.google.Chrome,23,1710878652,1710878675,1710878675.4214668,-18000,,
us.zoom.xos,65,1710878587,1710878652,1710878652.9967,-18000,,
com.google.Chrome,1,1710878586,1710878587,1710878587.141934,-18000,,
com.apple.iCal,106,1710878480,1710878586,1710878586.285311,-18000,,
com.google.Chrome,21,1710878459,1710878480,1710878480.660078,-18000,,
us.zoom.xos,570,1710877889,1710878459,1710878459.6991029,-18000,,
us.zoom.xos,311,1710877122,1710877433,1710877433.1994328,-18000,,
com.burbn.instagram,628,1710876992,1710877620,1710877620.091239,-18000,EB445137-D7F5-57EC-87DA-1DB460D64046,"iPhone13,2"
us.zoom.xos,304,1710876587,1710876891,1710876891.3174682,-18000,,
com.truebill.truebillnative,38,1710876383,1710876421,1710876421.7744942,-18000,EB445137-D7F5-57EC-87DA-1DB460D64046,"iPhone13,2"
edu.illinois.rokwire.ios,36,1710876322,1710876358,1710876358.820725,-18000,EB445137-D7F5-57EC-87DA-1DB460D64046,"iPhone13,2"
com.clairmail.fth.client,26,1710876289,1710876315,1710876315.888494,-18000,EB445137-D7F5-57EC-87DA-1DB460D64046,"iPhone13,2"
us.zoom.xos,312,1710876208,1710876520,1710876520.4976969,-18000,,
com.apple.calculator,30,1710876178,1710876208,1710876208.456294,-18000,,
us.zoom.xos,1,1710876177,1710876178,1710876178.91089,-18000,,
com.apple.finder,74,1710876103,1710876177,1710876177.298545,-18000,,
com.google.Chrome,40,1710876063,1710876103,1710876103.98719,-18000,,
com.apple.iCal,30,1710876033,1710876063,1710876063.42982,-18000,,
com.leomehlig.today,145,1710875888,1710876033,1710876033.43764,-18000,,
com.leomehlig.today,303,1710875400,1710875703,1710875703.587378,-18000,,
com.burbn.instagram,697,1710875095,1710875792,1710875792.4289432,-18000,EB445137-D7F5-57EC-87DA-1DB460D64046,"iPhone13,2"
com.leomehlig.today,326,1710875058,1710875384,1710875384.048686,-18000,,
us.zoom.xos,35,1710875023,1710875058,1710875058.589494,-18000,,
com.apple.finder,59,1710874964,1710875023,1710875023.210565,-18000,,
com.apple.archiveutility,0,1710874964,1710874964,1710874964.652169,-18000,,
com.apple.finder,12,1710874952,1710874964,1710874964.342657,-18000,,
com.google.Chrome,53,1710874899,1710874952,1710874952.5632858,-18000,,
us.zoom.xos,10,1710874889,1710874899,1710874899.767815,-18000,,
com.microsoft.Outlook,20,1710874869,1710874889,1710874889.58819,-18000,,
us.zoom.xos,111,1710874758,1710874869,1710874870.0052361,-18000,,
com.google.Chrome,1,1710874757,1710874758,1710874758.1976728,-18000,,
us.zoom.xos,3,1710874754,1710874757,1710874757.893609,-18000,,
com.microsoft.Office.Outlook,5,1710874217,1710874222,1710874222.952837,-18000,EB445137-D7F5-57EC-87DA-1DB460D64046,"iPhone13,2"
com.google.Chrome,688,1710874066,1710874754,1710874754.27297,-18000,,
com.leomehlig.today,21,1710874045,1710874066,1710874066.241428,-18000,,
com.microsoft.Office.Outlook,29,1710873982,1710874011,1710874011.2679439,-18000,EB445137-D7F5-57EC-87DA-1DB460D64046,"iPhone13,2"
com.burbn.instagram,51,1710873931,1710873982,1710873982.172384,-18000,EB445137-D7F5-57EC-87DA-1DB460D64046,"iPhone13,2"
com.intsig.CamScannerLite,11,1710873909,1710873920,1710873920.63841,-18000,EB445137-D7F5-57EC-87DA-1DB460D64046,"iPhone13,2"
com.google.Chrome,288,1710873757,1710874045,1710874045.818836,-18000,,
com.apple.finder,32,1710873725,1710873757,1710873758.0261521,-18000,,
com.apple.archiveutility,1,1710873724,1710873725,1710873725.117159,-18000,,
com.apple.finder,16,1710873708,1710873724,1710873724.870613,-18000,,
com.google.Chrome,5,1710873703,1710873708,1710873708.9076939,-18000,,
com.apple.finder,7,1710873696,1710873703,1710873703.5611758,-18000,,
com.google.Chrome,83,1710873613,1710873696,1710873696.2637339,-18000,,
com.apple.finder,17,1710873596,1710873613,1710873613.1142778,-18000,,
com.apple.archiveutility,0,1710873596,1710873596,1710873596.3932009,-18000,,
com.apple.finder,4,1710873592,1710873596,1710873596.0974622,-18000,,
com.google.Chrome,29,1710873563,1710873592,1710873592.2910419,-18000,,
com.leomehlig.today,17,1710873546,1710873563,1710873563.851687,-18000,,
com.google.Chrome,10,1710873536,1710873546,1710873546.825484,-18000,,
com.microsoft.Powerpoint,9,1710873527,1710873536,1710873536.848696,-18000,,
com.apple.finder,11,1710873516,1710873527,1710873527.953065,-18000,,
com.microsoft.Powerpoint,8,1710873508,1710873516,1710873516.6657162,-18000,,
com.apple.finder,0,1710873508,1710873508,1710873508.87902,-18000,,
com.microsoft.Powerpoint,3,1710873505,1710873508,1710873508.182948,-18000,,
com.apple.finder,10,1710873495,1710873505,1710873505.245898,-18000,,
com.intsig.CamScannerLite,6,1710872584,1710872590,1710872590.549267,-18000,EB445137-D7F5-57EC-87DA-1DB460D64046,"iPhone13,2"
com.google.Chrome,1388,1710872107,1710873495,1710873495.838891,-18000,,
com.leomehlig.today,19,1710872088,1710872107,1710872107.394584,-18000,,
com.google.Chrome,636,1710871452,1710872088,1710872088.346369,-18000,,
com.leomehlig.today,41,1710871411,1710871452,1710871452.263274,-18000,,
com.microsoft.Word,3,1710871408,1710871411,1710871411.41788,-18000,,
com.google.Chrome,33,1710871375,1710871408,1710871408.721267,-18000,,
com.microsoft.Word,9,1710871366,1710871375,1710871375.597107,-18000,,
com.google.Chrome,1,1710871365,1710871366,1710871366.9941602,-18000,,
com.microsoft.Word,67,1710871298,1710871365,1710871365.2230039,-18000,,
com.apple.finder,13,1710871285,1710871298,1710871298.270006,-18000,,
com.google.Chrome,139,1710871146,1710871285,1710871285.610032,-18000,,
com.leomehlig.today,29,1710871117,1710871146,1710871146.842227,-18000,,
com.intsig.CamScannerLite,145,1710871032,1710871177,1710871177.288745,-18000,EB445137-D7F5-57EC-87DA-1DB460D64046,"iPhone13,2"
com.google.chrome.ios,48,1710870984,1710871032,1710871032.206398,-18000,EB445137-D7F5-57EC-87DA-1DB460D64046,"iPhone13,2"
com.intsig.CamScannerLite,29,1710870954,1710870983,1710870984.038725,-18000,EB445137-D7F5-57EC-87DA-1DB460D64046,"iPhone13,2"
com.google.Chrome,210,1710870907,1710871117,1710871118.09393,-18000,,
com.apple.Preview,168,1710870739,1710870907,1710870907.466887,-18000,,
com.google.Chrome,2,1710870737,1710870739,1710870739.283102,-18000,,
com.apple.Preview,83,1710870654,1710870737,1710870738.050669,-18000,,
com.google.Chrome,4,1710870650,1710870654,1710870654.420298,-18000,,
com.apple.Preview,143,1710870507,1710870650,1710870650.749661,-18000,,
com.google.Chrome,2,1710870505,1710870507,1710870507.802874,-18000,,
com.apple.Preview,182,1710870323,1710870505,1710870505.383356,-18000,,
com.google.Chrome,1,1710870322,1710870323,1710870323.7780719,-18000,,
com.apple.Preview,15,1710870307,1710870322,1710870322.399067,-18000,,
com.google.Chrome,3,1710870304,1710870307,1710870307.968566,-18000,,
com.apple.Preview,6,1710870298,1710870304,1710870304.704252,-18000,,
com.google.Chrome,5,1710870293,1710870298,1710870298.582999,-18000,,
com.apple.Preview,115,1710870178,1710870293,1710870293.958307,-18000,,
com.google.Chrome,2,1710870176,1710870178,1710870178.68137,-18000,,
com.apple.Preview,29,1710870147,1710870176,1710870176.832401,-18000,,
com.google.Chrome,89,1710870058,1710870147,1710870147.984237,-18000,,
com.apple.Preview,62,1710869996,1710870058,1710870058.987509,-18000,,
com.google.Chrome,33,1710869963,1710869996,1710869996.409595,-18000,,
com.apple.Preview,252,1710869711,1710869963,1710869963.643138,-18000,,
com.apple.news,421,1710869219,1710869640,1710869640.855764,-18000,EB445137-D7F5-57EC-87DA-1DB460D64046,"iPhone13,2"
com.burbn.instagram,29,1710869162,1710869191,1710869191.9094338,-18000,EB445137-D7F5-57EC-87DA-1DB460D64046,"iPhone13,2"
com.apple.findmy,7,1710869151,1710869158,1710869158.441544,-18000,EB445137-D7F5-57EC-87DA-1DB460D64046,"iPhone13,2"
com.apple.news,5,1710869050,1710869055,1710869055.240272,-18000,EB445137-D7F5-57EC-87DA-1DB460D64046,"iPhone13,2"
com.apple.news,6,1710869020,1710869026,1710869026.553496,-18000,EB445137-D7F5-57EC-87DA-1DB460D64046,"iPhone13,2"
com.apple.Preview,512,1710868796,1710869308,1710869308.646541,-18000,,
com.google.Chrome,5,1710868791,1710868796,1710868796.146826,-18000,,
com.apple.Preview,122,1710868669,1710868791,1710868791.276926,-18000,,
com.google.Chrome,60,1710868609,1710868669,1710868669.887615,-18000,,
com.apple.Preview,151,1710868458,1710868609,1710868609.212498,-18000,,
com.google.Chrome,86,1710868372,1710868458,1710868458.529655,-18000,,
com.apple.news,238,1710868132,1710868370,1710868370.73019,-18000,EB445137-D7F5-57EC-87DA-1DB460D64046,"iPhone13,2"
com.microsoft.Office.Outlook,13,1710868112,1710868125,1710868125.669485,-18000,EB445137-D7F5-57EC-87DA-1DB460D64046,"iPhone13,2"
com.leomehlig.today,279,1710868093,1710868372,1710868372.171804,-18000,,
com.apple.iCal,8,1710868085,1710868093,1710868093.427277,-18000,,
com.leomehlig.today,7,1710868078,1710868085,1710868085.852446,-18000,,
com.apple.news,81,1710867982,1710868063,1710868064.432626,-18000,EB445137-D7F5-57EC-87DA-1DB460D64046,"iPhone13,2"
com.robinhood.release.Robinhood,38,1710867940,1710867978,1710867978.117567,-18000,EB445137-D7F5-57EC-87DA-1DB460D64046,"iPhone13,2"
com.apple.MobileSMS,6,1710867926,1710867932,1710867932.069741,-18000,EB445137-D7F5-57EC-87DA-1DB460D64046,"iPhone13,2"
com.apple.MobileSMS,1,1710867793,1710867794,1710867794.914475,-18000,EB445137-D7F5-57EC-87DA-1DB460D64046,"iPhone13,2"
com.apple.InCallService,1,1710867792,1710867793,1710867793.739985,-18000,EB445137-D7F5-57EC-87DA-1DB460D64046,"iPhone13,2"
com.apple.InCallService,4,1710867642,1710867646,1710867646.2629662,-18000,EB445137-D7F5-57EC-87DA-1DB460D64046,"iPhone13,2"
com.apple.MobileSMS,6,1710867636,1710867642,1710867643.269798,-18000,EB445137-D7F5-57EC-87DA-1DB460D64046,"iPhone13,2"
com.google.chrome.ios,149,1710867473,1710867622,1710867622.773596,-18000,EB445137-D7F5-57EC-87DA-1DB460D64046,"iPhone13,2"
com.apple.MobileSMS,2,1710867470,1710867472,1710867472.8065991,-18000,EB445137-D7F5-57EC-87DA-1DB460D64046,"iPhone13,2"
com.apple.MobileSMS,3,1710867442,1710867445,1710867446.242599,-18000,EB445137-D7F5-57EC-87DA-1DB460D64046,"iPhone13,2"
com.apple.MobileSMS,1,1710867321,1710867322,1710867322.781919,-18000,EB445137-D7F5-57EC-87DA-1DB460D64046,"iPhone13,2"
com.apple.MobileSMS,25,1710867271,1710867296,1710867296.578802,-18000,EB445137-D7F5-57EC-87DA-1DB460D64046,"iPhone13,2"
com.apple.news,392,1710866592,1710866984,1710866984.741421,-18000,EB445137-D7F5-57EC-87DA-1DB460D64046,"iPhone13,2"
edu.illinois.rokwire.ios,3,1710866584,1710866587,1710866587.786744,-18000,EB445137-D7F5-57EC-87DA-1DB460D64046,"iPhone13,2"
edu.illinois.rokwire.ios,4,1710866490,1710866494,1710866494.871808,-18000,EB445137-D7F5-57EC-87DA-1DB460D64046,"iPhone13,2"
edu.illinois.rokwire.ios,22,1710866053,1710866075,1710866075.7809339,-18000,EB445137-D7F5-57EC-87DA-1DB460D64046,"iPhone13,2"
com.leomehlig.today,23,1710865954,1710865977,1710865977.849529,-18000,,
com.google.Chrome,97,1710865857,1710865954,1710865954.455087,-18000,,
com.apple.Preview,260,1710865597,1710865857,1710865857.220848,-18000,,
com.google.Chrome,54,1710865543,1710865597,1710865597.725836,-18000,,
com.apple.Preview,713,1710864830,1710865543,1710865543.39625,-18000,,
com.apple.MobileSMS,7,1710864823,1710864830,1710864830.75681,-18000,,
edu.illinois.rokwire.ios,41,1710864495,1710864536,1710864536.4292312,-18000,EB445137-D7F5-57EC-87DA-1DB460D64046,"iPhone13,2"
com.apple.calculator,16,1710864479,1710864495,1710864495.628293,-18000,EB445137-D7F5-57EC-87DA-1DB460D64046,"iPhone13,2"
com.apple.Preview,368,1710864455,1710864823,1710864823.842956,-18000,,
com.apple.calculator,10,1710864359,1710864369,1710864369.6392179,-18000,EB445137-D7F5-57EC-87DA-1DB460D64046,"iPhone13,2"
com.apple.calculator,10,1710864239,1710864249,1710864249.705295,-18000,EB445137-D7F5-57EC-87DA-1DB460D64046,"iPhone13,2"
com.google.Chrome,828,1710863627,1710864455,1710864455.430708,-18000,,
com.hnc.Discord,24,1710863603,1710863627,1710863627.53387,-18000,,
com.google.Chrome,8,1710863595,1710863603,1710863603.877847,-18000,,
com.hnc.Discord,9,1710863586,1710863595,1710863595.866931,-18000,,
com.google.Chrome,222,1710863364,1710863586,1710863586.6325011,-18000,,
com.apple.Preview,30,1710863334,1710863364,1710863364.350519,-18000,,
com.google.Chrome,43,1710863291,1710863334,1710863334.7945518,-18000,,
com.apple.Preview,178,1710863113,1710863291,1710863291.1573749,-18000,,
com.apple.finder,1,1710863112,1710863113,1710863113.76173,-18000,,
com.google.Chrome,88,1710863024,1710863112,1710863112.2243428,-18000,,
com.leomehlig.today,23,1710862988,1710863011,1710863012.7552981,-18000,,
com.apple.calculator,9,1710861556,1710861565,1710861565.0529652,-18000,EB445137-D7F5-57EC-87DA-1DB460D64046,"iPhone13,2"
com.apple.calculator,4,1710861442,1710861446,1710861446.5909982,-18000,EB445137-D7F5-57EC-87DA-1DB460D64046,"iPhone13,2"
com.apple.calculator,4,1710861435,1710861439,1710861439.1337528,-18000,EB445137-D7F5-57EC-87DA-1DB460D64046,"iPhone13,2"
com.apple.calculator,9,1710861406,1710861415,1710861415.4337149,-18000,EB445137-D7F5-57EC-87DA-1DB460D64046,"iPhone13,2"
com.google.Maps,5,1710861401,1710861406,1710861406.4278278,-18000,EB445137-D7F5-57EC-87DA-1DB460D64046,"iPhone13,2"
com.google.Maps,6,1710861202,1710861208,1710861208.8176842,-18000,EB445137-D7F5-57EC-87DA-1DB460D64046,"iPhone13,2"
com.google.Maps,24,1710860893,1710860917,1710860917.381868,-18000,EB445137-D7F5-57EC-87DA-1DB460D64046,"iPhone13,2"
com.hulu.plus,2,1710860891,1710860893,1710860893.164547,-18000,EB445137-D7F5-57EC-87DA-1DB460D64046,"iPhone13,2"
com.hulu.plus,2,1710860683,1710860685,1710860685.232812,-18000,EB445137-D7F5-57EC-87DA-1DB460D64046,"iPhone13,2"
com.hulu.plus,1545,1710859137,1710860682,1710860682.833919,-18000,EB445137-D7F5-57EC-87DA-1DB460D64046,"iPhone13,2"
com.hulu.plus,98,1710858968,1710859066,1710859066.996838,-18000,EB445137-D7F5-57EC-87DA-1DB460D64046,"iPhone13,2"
com.apple.MobileSMS,5,1710858957,1710858962,1710858962.565034,-18000,EB445137-D7F5-57EC-87DA-1DB460D64046,"iPhone13,2"
com.apple.MobileSMS,6,1710858834,1710858840,1710858840.473856,-18000,EB445137-D7F5-57EC-87DA-1DB460D64046,"iPhone13,2"
com.apple.camera,0,1710858754,1710858754,1710858754.504161,-18000,EB445137-D7F5-57EC-87DA-1DB460D64046,"iPhone13,2"
com.apple.MobileSMS,11,1710858749,1710858760,1710858760.465849,-18000,EB445137-D7F5-57EC-87DA-1DB460D64046,"iPhone13,2"
com.apple.MobileSMS,6,1710858329,1710858335,1710858335.1705031,-18000,EB445137-D7F5-57EC-87DA-1DB460D64046,"iPhone13,2"
com.leomehlig.today,44,1710858251,1710858295,1710858295.471448,-18000,,
com.google.Chrome,2,1710858249,1710858251,1710858251.810766,-18000,,
com.apple.Health,14,1710858180,1710858194,1710858194.9063501,-18000,EB445137-D7F5-57EC-87DA-1DB460D64046,"iPhone13,2"
com.google.Maps,16,1710858157,1710858173,1710858173.780112,-18000,EB445137-D7F5-57EC-87DA-1DB460D64046,"iPhone13,2"
com.thestorygraph.thestorygraph,59,1710822889,1710822948,1710822948.271535,-18000,EB445137-D7F5-57EC-87DA-1DB460D64046,"iPhone13,2"
com.apple.Health,27,1710821300,1710821327,1710821328.0121841,-18000,EB445137-D7F5-57EC-87DA-1DB460D64046,"iPhone13,2"
com.toyopagroup.picaboo,37,1710821261,1710821298,1710821298.17839,-18000,EB445137-D7F5-57EC-87DA-1DB460D64046,"iPhone13,2"
com.apple.mobiletimer,10,1710821243,1710821253,1710821253.8842912,-18000,EB445137-D7F5-57EC-87DA-1DB460D64046,"iPhone13,2"
com.apple.news,12,1710821231,1710821243,1710821243.278919,-18000,EB445137-D7F5-57EC-87DA-1DB460D64046,"iPhone13,2"
com.apple.news,13,1710821213,1710821226,1710821226.985517,-18000,EB445137-D7F5-57EC-87DA-1DB460D64046,"iPhone13,2"
com.apple.news,16,1710820937,1710820953,1710820953.6281219,-18000,EB445137-D7F5-57EC-87DA-1DB460D64046,"iPhone13,2"
com.google.Chrome,214,1710820706,1710820920,1710820920.3886929,-18000,,
com.apple.news,5,1710820382,1710820387,1710820388.005118,-18000,EB445137-D7F5-57EC-87DA-1DB460D64046,"iPhone13,2"
com.google.Chrome,300,1710820377,1710820677,1710820677.8372478,-18000,,
com.apple.news,360,1710817768,1710818128,1710818128.3587499,-18000,EB445137-D7F5-57EC-87DA-1DB460D64046,"iPhone13,2"
com.apple.MobileSMS,5,1710817760,1710817765,1710817765.309463,-18000,EB445137-D7F5-57EC-87DA-1DB460D64046,"iPhone13,2"
com.apple.findmy,7,1710817753,1710817760,1710817760.5718331,-18000,EB445137-D7F5-57EC-87DA-1DB460D64046,"iPhone13,2"
com.apple.news,8,1710817744,1710817752,1710817752.580055,-18000,EB445137-D7F5-57EC-87DA-1DB460D64046,"iPhone13,2"
com.google.Chrome,700,1710817731,1710818431,1710818431.349424,-18000,,
com.google.Chrome,301,1710817171,1710817472,1710817472.15745,-18000,,
com.google.Chrome,311,1710816677,1710816988,1710816988.512641,-18000,,
com.strava.stravaride,30,1710816668,1710816698,1710816698.40526,-18000,EB445137-D7F5-57EC-87DA-1DB460D64046,"iPhone13,2"
com.google.Chrome,1067,1710815535,1710816602,1710816602.234227,-18000,,
com.google.Chrome,429,1710814622,1710815051,1710815051.9859982,-18000,,
com.google.Chrome,450,1710813937,1710814387,1710814387.283294,-18000,,
com.microsoft.Outlook,1,1710813936,1710813937,1710813938.0041819,-18000,,
com.google.Chrome,1,1710813935,1710813936,1710813937.012111,-18000,,
com.microsoft.Outlook,11,1710813924,1710813935,1710813935.087809,-18000,,
com.google.Chrome,404,1710813520,1710813924,1710813924.700916,-18000,,
com.microsoft.Outlook,1,1710813519,1710813520,1710813520.885596,-18000,,
com.google.Chrome,12,1710813507,1710813519,1710813519.781509,-18000,,
com.microsoft.Outlook,2,1710813505,1710813507,1710813507.299316,-18000,,
com.google.Chrome,5,1710813500,1710813505,1710813505.685978,-18000,,
com.microsoft.Outlook,8,1710813474,1710813482,1710813482.386652,-18000,,
com.google.Chrome,281,1710813193,1710813474,1710813474.054421,-18000,,
com.apple.finder,15,1710813178,1710813193,1710813193.380878,-18000,,
com.microsoft.Office.Outlook,88,1710812983,1710813071,1710813071.978143,-18000,EB445137-D7F5-57EC-87DA-1DB460D64046,"iPhone13,2"
com.burbn.instagram,536,1710812447,1710812983,1710812983.31427,-18000,EB445137-D7F5-57EC-87DA-1DB460D64046,"iPhone13,2"
com.apple.weather,10,1710812404,1710812414,1710812414.393029,-18000,EB445137-D7F5-57EC-87DA-1DB460D64046,"iPhone13,2"
com.letterboxd.LetterboxdApp,42,1710812358,1710812400,1710812400.786878,-18000,EB445137-D7F5-57EC-87DA-1DB460D64046,"iPhone13,2"
com.apple.Maps,19,1710812332,1710812351,1710812351.445771,-18000,EB445137-D7F5-57EC-87DA-1DB460D64046,"iPhone13,2"
com.apple.findmy,14,1710812316,1710812330,1710812330.974062,-18000,EB445137-D7F5-57EC-87DA-1DB460D64046,"iPhone13,2"
com.microsoft.Office.Outlook,2,1710812314,1710812316,1710812316.279531,-18000,EB445137-D7F5-57EC-87DA-1DB460D64046,"iPhone13,2"
com.hammerandchisel.discord,91,1710812222,1710812313,1710812313.631783,-18000,EB445137-D7F5-57EC-87DA-1DB460D64046,"iPhone13,2"
com.microsoft.Office.Outlook,16,1710812202,1710812218,1710812218.7199001,-18000,EB445137-D7F5-57EC-87DA-1DB460D64046,"iPhone13,2"
com.apple.finder,2,1710812153,1710812155,1710812155.970662,-18000,,
com.google.Chrome,8,1710812145,1710812153,1710812153.510637,-18000,,
com.leomehlig.today,85,1710812060,1710812145,1710812145.669699,-18000,,
com.apple.MobileSMS,42,1710812018,1710812060,1710812060.674829,-18000,,
com.leomehlig.today,1,1710812017,1710812018,1710812018.8291779,-18000,,
com.google.Chrome,13,1710812004,1710812017,1710812017.665189,-18000,,
com.leomehlig.today,30,1710811974,1710812004,1710812004.278929,-18000,,
com.google.Chrome,358,1710811616,1710811974,1710811974.83272,-18000,,
com.apple.news,2,1710811614,1710811616,1710811616.383675,-18000,,
com.apple.MobileSMS,35,1710811579,1710811614,1710811614.7080321,-18000,,
com.apple.news,66,1710811513,1710811579,1710811579.893073,-18000,,
com.apple.MobileSMS,3,1710811510,1710811513,1710811513.897836,-18000,,
com.google.Chrome,23,1710811487,1710811510,1710811510.507481,-18000,,
com.leomehlig.today,34,1710811453,1710811487,1710811487.759871,-18000,,
com.google.Chrome,486,1710810967,1710811453,1710811453.824882,-18000,,
com.microsoft.Office.Outlook,5,1710809874,1710809879,1710809879.980645,-18000,EB445137-D7F5-57EC-87DA-1DB460D64046,"iPhone13,2"
com.apple.MobileSMS,5,1710809869,1710809874,1710809875.1852422,-18000,EB445137-D7F5-57EC-87DA-1DB460D64046,"iPhone13,2"
com.google.Chrome,95,1710809707,1710809802,1710809802.485804,-18000,,
com.apple.MobileSMS,5,1710809167,1710809172,1710809172.620144,-18000,EB445137-D7F5-57EC-87DA-1DB460D64046,"iPhone13,2"
com.google.Chrome,75,1710809034,1710809109,1710809109.077373,-18000,,
com.google.Chrome,70,1710808900,1710808970,1710808970.3960881,-18000,,
com.leomehlig.today,36,1710808864,1710808900,1710808900.434658,-18000,,
com.google.Chrome,633,1710808231,1710808864,1710808864.480142,-18000,,
com.apple.finder,2,1710808229,1710808231,1710808231.7343721,-18000,,
com.google.Chrome,46,1710808183,1710808229,1710808229.19795,-18000,,
com.apple.finder,1,1710808182,1710808183,1710808183.874933,-18000,,
com.google.Chrome,0,1710808182,1710808182,1710808182.798455,-18000,,
com.apple.Notes,2,1710808180,1710808182,1710808182.1553411,-18000,,
com.google.Chrome,12,1710808168,1710808180,1710808180.816938,-18000,,
com.apple.Notes,2,1710808166,1710808168,1710808168.68542,-18000,,
com.google.Chrome,16,1710808150,1710808166,1710808166.085232,-18000,,
com.apple.Notes,3,1710808147,1710808150,1710808150.7651129,-18000,,
com.google.Chrome,19,1710808128,1710808147,1710808147.66542,-18000,,
com.apple.Notes,2,1710808126,1710808128,1710808128.4982228,-18000,,
com.google.Chrome,10,1710808116,1710808126,1710808127.009064,-18000,,
com.apple.Notes,1,1710808115,1710808116,1710808117.011339,-18000,,
com.google.Chrome,8,1710808107,1710808115,1710808115.54362,-18000,,
com.apple.Notes,1,1710808106,1710808107,1710808107.593344,-18000,,
com.google.Chrome,7,1710808099,1710808106,1710808106.558619,-18000,,
com.apple.Notes,1,1710808098,1710808099,1710808099.6163511,-18000,,
com.google.Chrome,48,1710808050,1710808098,1710808098.127454,-18000,,
com.apple.Notes,159,1710807891,1710808050,1710808050.351469,-18000,,
com.google.Chrome,3,1710807888,1710807891,1710807891.097364,-18000,,
com.apple.Notes,6,1710807882,1710807888,1710807888.690565,-18000,,
com.google.Chrome,210,1710807672,1710807882,1710807882.092475,-18000,,
com.apple.finder,15,1710807657,1710807672,1710807672.186387,-18000,,
com.apple.Photos,7,1710807650,1710807657,1710807658.055348,-18000,,
com.apple.finder,43,1710807607,1710807650,1710807650.869351,-18000,,
com.google.Chrome,440,1710807167,1710807607,1710807608.0641189,-18000,,
com.leomehlig.today,5,1710807162,1710807167,1710807167.207779,-18000,,
com.google.Chrome,230,1710806932,1710807162,1710807162.468021,-18000,,
com.leomehlig.today,56,1710806876,1710806932,1710806932.2586799,-18000,,
com.microsoft.Word,257,1710806619,1710806876,1710806876.1269531,-18000,,
com.google.Chrome,6,1710806613,1710806619,1710806619.67523,-18000,,
com.microsoft.Word,256,1710806357,1710806613,1710806613.814271,-18000,,
com.google.Chrome,2,1710806355,1710806357,1710806357.059515,-18000,,
com.google.chrome.ios,61,1710806280,1710806341,1710806341.851366,-18000,EB445137-D7F5-57EC-87DA-1DB460D64046,"iPhone13,2"
com.microsoft.Office.Outlook,13,1710806267,1710806280,1710806280.536178,-18000,EB445137-D7F5-57EC-87DA-1DB460D64046,"iPhone13,2"
com.microsoft.Word,97,1710806258,1710806355,1710806355.794616,-18000,,
com.google.Chrome,3,1710806255,1710806258,1710806259.049073,-18000,,
com.apple.MobileSMS,3,1710806252,1710806255,1710806255.2484488,-18000,,
com.google.Chrome,143,1710806109,1710806252,1710806252.437303,-18000,,
com.apple.MobileSMS,46,1710806063,1710806109,1710806109.169763,-18000,,
com.microsoft.VSCode,5,1710806058,1710806063,1710806063.083982,-18000,,
com.apple.MobileSMS,10,1710806048,1710806058,1710806058.12191,-18000,,
com.microsoft.VSCode,15,1710806033,1710806048,1710806049.0430999,-18000,,
com.apple.MobileSMS,2,1710806031,1710806033,1710806033.196652,-18000,,
com.microsoft.VSCode,14,1710806017,1710806031,1710806031.486418,-18000,,
com.google.Chrome,92,1710805925,1710806017,1710806017.20227,-18000,,
com.leomehlig.today,15,1710805910,1710805925,1710805925.377942,-18000,,
com.microsoft.Office.Outlook,2,1710805805,1710805807,1710805807.6381311,-18000,EB445137-D7F5-57EC-87DA-1DB460D64046,"iPhone13,2"
com.microsoft.Office.Outlook,6,1710805792,1710805798,1710805798.018785,-18000,EB445137-D7F5-57EC-87DA-1DB460D64046,"iPhone13,2"
com.google.Chrome,126,1710805784,1710805910,1710805910.369426,-18000,,
com.microsoft.VSCode,2,1710805782,1710805784,1710805784.495164,-18000,,
com.leomehlig.today,38,1710805744,1710805782,1710805782.638777,-18000,,
com.microsoft.Office.Outlook,19,1710805515,1710805534,1710805534.797853,-18000,EB445137-D7F5-57EC-87DA-1DB460D64046,"iPhone13,2"
com.apple.findmy,29,1710805483,1710805512,1710805512.577095,-18000,EB445137-D7F5-57EC-87DA-1DB460D64046,"iPhone13,2"
com.microsoft.VSCode,348,1710805396,1710805744,1710805744.971438,-18000,,
com.google.Chrome,1,1710805395,1710805396,1710805396.136097,-18000,,
com.microsoft.VSCode,7,1710805388,1710805395,1710805395.199456,-18000,,
com.google.Chrome,3,1710805385,1710805388,1710805388.132015,-18000,,
com.microsoft.VSCode,14,1710805371,1710805385,1710805385.302846,-18000,,
com.google.Chrome,16,1710805355,1710805371,1710805371.224436,-18000,,
com.microsoft.VSCode,10,1710805345,1710805355,1710805355.9353352,-18000,,
com.google.Chrome,7,1710805338,1710805345,1710805345.0827498,-18000,,
com.microsoft.VSCode,2,1710805336,1710805338,1710805338.487273,-18000,,
com.google.Chrome,29,1710805307,1710805336,1710805336.077239,-18000,,
com.microsoft.VSCode,433,1710804874,1710805307,1710805307.850946,-18000,,
com.google.Chrome,32,1710804842,1710804874,1710804874.626385,-18000,,
com.microsoft.VSCode,17,1710804825,1710804842,1710804842.180665,-18000,,
com.google.Chrome,70,1710804755,1710804825,1710804825.108508,-18000,,
com.microsoft.VSCode,574,1710804181,1710804755,1710804755.099561,-18000,,
com.apple.finder,83,1710804098,1710804181,1710804181.276861,-18000,,
com.microsoft.VSCode,416,1710803682,1710804098,1710804098.293213,-18000,,
com.apple.MobileSMS,36,1710803646,1710803682,1710803682.3960361,-18000,,
com.microsoft.VSCode,20,1710803626,1710803646,1710803646.611926,-18000,,
com.apple.MobileSMS,5,1710803621,1710803626,1710803626.562368,-18000,,
com.microsoft.VSCode,126,1710803495,1710803621,1710803621.37691,-18000,,
com.apple.MobileSMS,0,1710803495,1710803495,1710803495.955665,-18000,,
com.microsoft.VSCode,2,1710803493,1710803495,1710803495.360475,-18000,,
com.apple.MobileSMS,5,1710803488,1710803493,1710803493.387438,-18000,,
com.microsoft.VSCode,11,1710803477,1710803488,1710803488.8864012,-18000,,
com.apple.MobileSMS,7,1710803470,1710803477,1710803477.993109,-18000,,
com.microsoft.VSCode,6,1710803464,1710803470,1710803470.402872,-18000,,
com.apple.MobileSMS,5,1710803459,1710803464,1710803464.892737,-18000,,
com.microsoft.VSCode,5,1710803454,1710803459,1710803459.890864,-18000,,
com.apple.MobileSMS,2,1710803452,1710803454,1710803454.199697,-18000,,
com.microsoft.VSCode,5,1710803447,1710803452,1710803452.464026,-18000,,
com.apple.MobileSMS,10,1710803437,1710803447,1710803447.710098,-18000,,
com.microsoft.VSCode,568,1710802869,1710803437,1710803437.614362,-18000,,
com.apple.finder,1,1710802868,1710802869,1710802870.0399299,-18000,,
com.microsoft.VSCode,205,1710802663,1710802868,1710802868.4234009,-18000,,
com.apple.finder,77,1710802586,1710802663,1710802663.572703,-18000,,
com.google.Chrome,17,1710802569,1710802586,1710802586.872529,-18000,,
com.apple.systempreferences,46,1710802523,1710802569,1710802569.716836,-18000,,
com.google.Chrome,112,1710802405,1710802517,1710802517.7667499,-18000,,
com.leomehlig.today,23,1710802382,1710802405,1710802405.711024,-18000,,
com.apple.findmy,26,1710802350,1710802376,1710802376.7279081,-18000,EB445137-D7F5-57EC-87DA-1DB460D64046,"iPhone13,2"
com.apple.MobileSMS,3,1710802347,1710802350,1710802350.674067,-18000,EB445137-D7F5-57EC-87DA-1DB460D64046,"iPhone13,2"
com.apple.MobileSMS,10,1710802072,1710802082,1710802082.810542,-18000,EB445137-D7F5-57EC-87DA-1DB460D64046,"iPhone13,2"
com.apple.MobileSMS,6,1710802055,1710802061,1710802062.0571609,-18000,EB445137-D7F5-57EC-87DA-1DB460D64046,"iPhone13,2"
com.apple.MobileSMS,3,1710801769,1710801772,1710801773.0186958,-18000,EB445137-D7F5-57EC-87DA-1DB460D64046,"iPhone13,2"
com.apple.MobileSMS,17,1710801506,1710801523,1710801523.793298,-18000,EB445137-D7F5-57EC-87DA-1DB460D64046,"iPhone13,2"
com.toyopagroup.picaboo,2,1710799142,1710799144,1710799144.601965,-18000,EB445137-D7F5-57EC-87DA-1DB460D64046,"iPhone13,2"
com.apple.Health,2,1710799140,1710799142,1710799142.61122,-18000,EB445137-D7F5-57EC-87DA-1DB460D64046,"iPhone13,2"
com.apple.Health,6,1710798550,1710798556,1710798556.5394502,-18000,EB445137-D7F5-57EC-87DA-1DB460D64046,"iPhone13,2"
com.apple.Health,28,1710798521,1710798549,1710798549.6737761,-18000,EB445137-D7F5-57EC-87DA-1DB460D64046,"iPhone13,2"
com.microsoft.Office.Outlook,6,1710798496,1710798502,1710798502.731285,-18000,EB445137-D7F5-57EC-87DA-1DB460D64046,"iPhone13,2"
com.thestorygraph.thestorygraph,36,1710798281,1710798317,1710798317.885943,-18000,EB445137-D7F5-57EC-87DA-1DB460D64046,"iPhone13,2"
com.toyopagroup.picaboo,7,1710798274,1710798281,1710798281.072044,-18000,EB445137-D7F5-57EC-87DA-1DB460D64046,"iPhone13,2"
com.toyopagroup.picaboo,2,1710797614,1710797616,1710797616.841807,-18000,EB445137-D7F5-57EC-87DA-1DB460D64046,"iPhone13,2"
com.toyopagroup.picaboo,44,1710797548,1710797592,1710797592.913614,-18000,EB445137-D7F5-57EC-87DA-1DB460D64046,"iPhone13,2"
com.toyopagroup.picaboo,89,1710797340,1710797429,1710797429.68577,-18000,EB445137-D7F5-57EC-87DA-1DB460D64046,"iPhone13,2"
edu.illinois.rokwire.ios,3,1710797337,1710797340,1710797340.579139,-18000,EB445137-D7F5-57EC-87DA-1DB460D64046,"iPhone13,2"
edu.illinois.rokwire.ios,15,1710795686,1710795701,1710795701.772129,-18000,EB445137-D7F5-57EC-87DA-1DB460D64046,"iPhone13,2"
com.toyopagroup.picaboo,19,1710795667,1710795686,1710795686.448987,-18000,EB445137-D7F5-57EC-87DA-1DB460D64046,"iPhone13,2"
com.leomehlig.today,173,1710795554,1710795727,1710795727.210639,-18000,,
com.microsoft.Word,22,1710795532,1710795554,1710795554.529592,-18000,,
com.burbn.instagram,402,1710795263,1710795665,1710795665.39219,-18000,EB445137-D7F5-57EC-87DA-1DB460D64046,"iPhone13,2"
com.toyopagroup.picaboo,4,1710795258,1710795262,1710795262.94847,-18000,EB445137-D7F5-57EC-87DA-1DB460D64046,"iPhone13,2"
com.microsoft.Word,343,1710795188,1710795531,1710795531.253006,-18000,,
com.microsoft.Office.Outlook,14,1710795122,1710795136,1710795136.20804,-18000,EB445137-D7F5-57EC-87DA-1DB460D64046,"iPhone13,2"
com.google.Gmail,5,1710795117,1710795122,1710795122.694788,-18000,EB445137-D7F5-57EC-87DA-1DB460D64046,"iPhone13,2"
com.google.Chrome,409,1710794779,1710795188,1710795188.9407449,-18000,,
com.microsoft.Word,4,1710794775,1710794779,1710794779.383961,-18000,,
com.google.Chrome,149,1710794626,1710794775,1710794775.226942,-18000,,
com.microsoft.Word,1,1710794625,1710794626,1710794626.583096,-18000,,
com.google.Chrome,1,1710794624,1710794625,1710794625.527882,-18000,,
com.microsoft.Word,12,1710794612,1710794624,1710794624.194646,-18000,,
com.google.Chrome,228,1710794384,1710794612,1710794612.862458,-18000,,
com.microsoft.Word,12,1710794372,1710794384,1710794384.885573,-18000,,
com.google.Chrome,37,1710794335,1710794372,1710794372.519631,-18000,,
com.microsoft.Word,6,1710794329,1710794335,1710794335.66103,-18000,,
com.google.Chrome,13,1710794316,1710794329,1710794329.807053,-18000,,
com.microsoft.Word,3,1710794313,1710794316,1710794316.9853868,-18000,,
com.google.Chrome,10,1710794303,1710794313,1710794313.466397,-18000,,
com.microsoft.Word,3,1710794300,1710794303,1710794303.255045,-18000,,
com.google.Chrome,10,1710794290,1710794300,1710794300.838953,-18000,,
com.microsoft.Word,4,1710794286,1710794290,1710794290.089591,-18000,,
com.google.Chrome,13,1710794273,1710794286,1710794286.102715,-18000,,
com.microsoft.Word,4,1710794269,1710794273,1710794273.668457,-18000,,
com.google.Chrome,19,1710794250,1710794269,1710794269.7694979,-18000,,
com.microsoft.Word,1,1710794249,1710794250,1710794250.984967,-18000,,
com.google.Chrome,9,1710794240,1710794249,1710794249.428245,-18000,,
com.microsoft.Word,4,1710794236,1710794240,1710794240.6868649,-18000,,
com.google.Chrome,5,1710794231,1710794236,1710794236.912416,-18000,,
com.microsoft.Word,2,1710794229,1710794231,1710794231.775209,-18000,,
com.google.Chrome,4,1710794225,1710794229,1710794229.263047,-18000,,
com.microsoft.Word,5,1710794220,1710794225,1710794225.8080149,-18000,,
com.google.Chrome,15,1710794205,1710794220,1710794220.22312,-18000,,
com.microsoft.Word,3,1710794202,1710794205,1710794206.0242538,-18000,,
com.google.Chrome,6,1710794196,1710794202,1710794203.029777,-18000,,
com.microsoft.Word,3,1710794193,1710794196,1710794196.2474,-18000,,
com.google.Chrome,59,1710794134,1710794193,1710794193.383898,-18000,,
com.microsoft.Word,3,1710794131,1710794134,1710794134.1464682,-18000,,
com.google.Chrome,61,1710794070,1710794131,1710794131.248157,-18000,,
com.microsoft.Word,2,1710794068,1710794070,1710794070.912704,-18000,,
com.google.Chrome,56,1710794012,1710794068,1710794068.1424541,-18000,,
com.microsoft.Word,5,1710794007,1710794012,1710794012.6160011,-18000,,
com.google.Gmail,10,1710793997,1710794007,1710794007.3192182,-18000,EB445137-D7F5-57EC-87DA-1DB460D64046,"iPhone13,2"
edu.illinois.rokwire.ios,4,1710793993,1710793997,1710793997.073135,-18000,EB445137-D7F5-57EC-87DA-1DB460D64046,"iPhone13,2"
com.google.Chrome,81,1710793926,1710794007,1710794007.491075,-18000,,
com.microsoft.Word,4,1710793922,1710793926,1710793926.421943,-18000,,
com.google.Chrome,70,1710793852,1710793922,1710793923.076692,-18000,,
com.microsoft.Word,3,1710793849,1710793852,1710793852.985289,-18000,,
com.google.Chrome,0,1710793849,1710793849,1710793849.761821,-18000,,
com.microsoft.Word,7,1710793842,1710793849,1710793849.187509,-18000,,
com.google.Chrome,1,1710793841,1710793842,1710793842.4243069,-18000,,
com.microsoft.Word,1,1710793840,1710793841,1710793841.466836,-18000,,
com.apple.finder,4,1710793836,1710793840,1710793840.300945,-18000,,
com.apple.Preview,2,1710793834,1710793836,1710793836.385397,-18000,,
com.apple.finder,7,1710793827,1710793834,1710793834.198637,-18000,,
com.leomehlig.today,1,1710793826,1710793827,1710793828.094219,-18000,,
com.google.Chrome,2,1710793824,1710793826,1710793826.901465,-18000,,
com.leomehlig.today,9,1710793815,1710793824,1710793824.514334,-18000,,
com.google.Chrome,2,1710793813,1710793815,1710793815.14144,-18000,,
com.microsoft.Word,2,1710793811,1710793813,1710793813.401,-18000,,
com.google.Chrome,19,1710793792,1710793811,1710793811.815222,-18000,,
com.microsoft.Word,2,1710793790,1710793792,1710793792.2849731,-18000,,
com.google.Chrome,0,1710793790,1710793790,1710793790.713146,-18000,,
com.microsoft.Word,5,1710793785,1710793790,1710793790.300719,-18000,,
com.google.Chrome,17,1710793768,1710793785,1710793785.298847,-18000,,
com.microsoft.Word,18,1710793750,1710793768,1710793769.00226,-18000,,
com.google.Chrome,2,1710793748,1710793750,1710793750.838832,-18000,,
com.microsoft.Word,2,1710793746,1710793748,1710793748.7771978,-18000,,
com.google.Chrome,43,1710793703,1710793746,1710793746.152659,-18000,,
com.microsoft.Word,70,1710793633,1710793703,1710793703.514183,-18000,,
com.google.Chrome,8,1710793625,1710793633,1710793633.386263,-18000,,
com.microsoft.Word,1,1710793624,1710793625,1710793625.887387,-18000,,
com.google.Chrome,8,1710793616,1710793624,1710793624.4282851,-18000,,
com.microsoft.Word,16,1710793600,1710793616,1710793616.4404778,-18000,,
com.apple.finder,18,1710793582,1710793600,1710793600.194954,-18000,,
com.google.Chrome,103,1710793479,1710793582,1710793583.097828,-18000,,
com.leomehlig.today,168,1710793311,1710793479,1710793479.696698,-18000,,
com.microsoft.Outlook,11,1710793300,1710793311,1710793311.084564,-18000,,
com.google.Chrome,41,1710793259,1710793300,1710793300.5956712,-18000,,
com.microsoft.Outlook,11,1710793248,1710793259,1710793259.07301,-18000,,
com.google.Chrome,32,1710793216,1710793248,1710793249.002856,-18000,,
com.microsoft.Outlook,119,1710793097,1710793216,1710793216.761945,-18000,,
com.google.Chrome,83,1710793014,1710793097,1710793097.2099009,-18000,,
com.leomehlig.today,55,1710792959,1710793014,1710793014.403016,-18000,,
com.google.Chrome,5,1710792954,1710792959,1710792959.617903,-18000,,
com.leomehlig.today,5,1710792949,1710792954,1710792954.175932,-18000,,
com.google.Chrome,1399,1710791550,1710792949,1710792949.170055,-18000,,
com.google.Chrome,305,1710791109,1710791414,1710791414.485618,-18000,,
com.apple.MobileSMS,4,1710791105,1710791109,1710791109.858773,-18000,,
com.google.Chrome,31,1710791074,1710791105,1710791106.020129,-18000,,
com.apple.MobileSMS,5,1710791069,1710791074,1710791074.118159,-18000,,
com.google.Chrome,4,1710791065,1710791069,1710791069.183217,-18000,,
com.apple.MobileSMS,11,1710791054,1710791065,1710791065.5163178,-18000,,
com.google.Chrome,2,1710791052,1710791054,1710791054.063827,-18000,,
com.apple.MobileSMS,8,1710791044,1710791052,1710791052.7085428,-18000,,
com.google.Chrome,3,1710791041,1710791044,1710791044.977308,-18000,,
com.apple.MobileSMS,6,1710791035,1710791041,1710791041.9911041,-18000,,
com.google.Chrome,6,1710791029,1710791035,1710791035.919781,-18000,,
com.apple.MobileSMS,28,1710791001,1710791029,1710791029.9298959,-18000,,
com.google.Chrome,5,1710790996,1710791001,1710791001.5882468,-18000,,
com.apple.MobileSMS,19,1710790977,1710790996,1710790996.0633888,-18000,,
com.google.Chrome,55,1710790922,1710790977,1710790977.9300199,-18000,,
edu.illinois.rokwire.ios,22,1710790821,1710790843,1710790843.237953,-18000,EB445137-D7F5-57EC-87DA-1DB460D64046,"iPhone13,2"
com.microsoft.Office.Outlook,14,1710790803,1710790817,1710790817.8489652,-18000,EB445137-D7F5-57EC-87DA-1DB460D64046,"iPhone13,2"
com.microsoft.Office.Outlook,6,1710789423,1710789429,1710789429.287857,-18000,EB445137-D7F5-57EC-87DA-1DB460D64046,"iPhone13,2"
com.google.Chrome,914,1710789412,1710790326,1710790326.9893498,-18000,,
com.microsoft.Office.Outlook,11,1710789397,1710789408,1710789408.9099522,-18000,EB445137-D7F5-57EC-87DA-1DB460D64046,"iPhone13,2"
com.microsoft.Office.Outlook,66,1710788604,1710788670,1710788670.446114,-18000,EB445137-D7F5-57EC-87DA-1DB460D64046,"iPhone13,2"
com.hammerandchisel.discord,5,1710788599,1710788604,1710788604.947047,-18000,EB445137-D7F5-57EC-87DA-1DB460D64046,"iPhone13,2"
com.google.Chrome,496,1710788507,1710789003,1710789003.934404,-18000,,
com.leomehlig.today,5,1710788502,1710788507,1710788507.984086,-18000,,
com.google.Chrome,22,1710788480,1710788502,1710788502.163896,-18000,,
com.apple.Preview,10,1710788470,1710788480,1710788480.405264,-18000,,
com.hammerandchisel.discord,33,1710784458,1710784491,1710784491.898633,-18000,EB445137-D7F5-57EC-87DA-1DB460D64046,"iPhone13,2"
com.apple.news,3,1710784455,1710784458,1710784458.950479,-18000,EB445137-D7F5-57EC-87DA-1DB460D64046,"iPhone13,2"
com.apple.Preview,775,1710783991,1710784766,1710784766.34408,-18000,,
com.google.Chrome,49,1710783942,1710783991,1710783991.1009278,-18000,,
com.apple.Preview,2,1710783940,1710783942,1710783942.217377,-18000,,
com.apple.finder,6,1710783934,1710783940,1710783940.9164271,-18000,,
com.leomehlig.today,4,1710783930,1710783934,1710783935.206377,-18000,,
com.apple.news,6,1710782468,1710782474,1710782474.970767,-18000,EB445137-D7F5-57EC-87DA-1DB460D64046,"iPhone13,2"
com.apple.news,2,1710782442,1710782444,1710782444.2773972,-18000,EB445137-D7F5-57EC-87DA-1DB460D64046,"iPhone13,2"
com.apple.news,6,1710782313,1710782319,1710782319.4453201,-18000,EB445137-D7F5-57EC-87DA-1DB460D64046,"iPhone13,2"
com.apple.news,5,1710782299,1710782304,1710782305.229157,-18000,EB445137-D7F5-57EC-87DA-1DB460D64046,"iPhone13,2"
com.apple.news,2,1710781409,1710781411,1710781411.891335,-18000,EB445137-D7F5-57EC-87DA-1DB460D64046,"iPhone13,2"
com.leomehlig.today,47,1710781052,1710781099,1710781099.595471,-18000,,
com.apple.iCal,27,1710781025,1710781052,1710781052.902436,-18000,,
com.leomehlig.today,17,1710781008,1710781025,1710781025.411514,-18000,,
com.google.Chrome,1,1710781007,1710781008,1710781008.600296,-18000,,
com.microsoft.Word,3,1710781004,1710781007,1710781007.3946152,-18000,,
com.google.Chrome,59,1710780945,1710781004,1710781004.867522,-18000,,
com.leomehlig.today,26,1710780919,1710780945,1710780945.951191,-18000,,
com.google.Chrome,349,1710780570,1710780919,1710780919.9126859,-18000,,
com.google.Chrome,359,1710780015,1710780374,1710780374.183819,-18000,,
com.apple.news,2,1710779730,1710779732,1710779732.259345,-18000,EB445137-D7F5-57EC-87DA-1DB460D64046,"iPhone13,2"
com.apple.news,37,1710779678,1710779715,1710779715.677412,-18000,EB445137-D7F5-57EC-87DA-1DB460D64046,"iPhone13,2"
com.apple.news,162,1710779507,1710779669,1710779670.5866308,-18000,EB445137-D7F5-57EC-87DA-1DB460D64046,"iPhone13,2"
com.google.Chrome,540,1710779454,1710779994,1710779994.049176,-18000,,
com.apple.finder,36,1710779418,1710779454,1710779454.230829,-18000,,
com.microsoft.Word,1,1710779417,1710779418,1710779418.510919,-18000,,
com.google.Chrome,38,1710779379,1710779417,1710779417.201456,-18000,,
com.microsoft.Word,24,1710779355,1710779379,1710779379.276847,-18000,,
com.google.Chrome,602,1710778753,1710779355,1710779355.967751,-18000,,
com.leomehlig.today,77,1710778676,1710778753,1710778753.463732,-18000,,
com.apple.findmy,7,1710778569,1710778576,1710778576.881641,-18000,EB445137-D7F5-57EC-87DA-1DB460D64046,"iPhone13,2"
com.toyopagroup.picaboo,39,1710778528,1710778567,1710778567.274514,-18000,EB445137-D7F5-57EC-87DA-1DB460D64046,"iPhone13,2"
com.microsoft.Office.Outlook,16,1710778506,1710778522,1710778522.477392,-18000,EB445137-D7F5-57EC-87DA-1DB460D64046,"iPhone13,2"
com.strava.stravaride,19,1710778487,1710778506,1710778506.801886,-18000,EB445137-D7F5-57EC-87DA-1DB460D64046,"iPhone13,2"
com.apple.reminders,5,1710778475,1710778480,1710778480.592171,-18000,EB445137-D7F5-57EC-87DA-1DB460D64046,"iPhone13,2"
com.google.Chrome,432,1710778244,1710778676,1710778676.3273559,-18000,,
com.apple.iCal,37,1710778182,1710778219,1710778219.86764,-18000,,
com.google.Chrome,61,1710778121,1710778182,1710778183.029881,-18000,,
com.apple.finder,3,1710778103,1710778106,1710778107.068577,-18000,,
com.apple.systempreferences,10,1710778093,1710778103,1710778104.184794,-18000,,
com.google.Chrome,23,1710778066,1710778089,1710778089.452642,-18000,,
com.apple.reminders,119,1710777257,1710777376,1710777376.5368671,-18000,EB445137-D7F5-57EC-87DA-1DB460D64046,"iPhone13,2"
com.apple.InCallService,118,1710777139,1710777257,1710777257.3567019,-18000,EB445137-D7F5-57EC-87DA-1DB460D64046,"iPhone13,2"
com.apple.reminders,5,1710777134,1710777139,1710777139.4866018,-18000,EB445137-D7F5-57EC-87DA-1DB460D64046,"iPhone13,2"
com.google.chrome.ios,3,1710777127,1710777130,1710777130.420542,-18000,EB445137-D7F5-57EC-87DA-1DB460D64046,"iPhone13,2"
com.google.chrome.ios,19,1710776998,1710777017,1710777018.111316,-18000,EB445137-D7F5-57EC-87DA-1DB460D64046,"iPhone13,2"
edu.illinois.rokwire.ios,0,1710776809,1710776809,1710776809.945606,-18000,EB445137-D7F5-57EC-87DA-1DB460D64046,"iPhone13,2"
edu.illinois.rokwire.ios,3,1710776806,1710776809,1710776809.0935001,-18000,EB445137-D7F5-57EC-87DA-1DB460D64046,"iPhone13,2"
edu.illinois.rokwire.ios,15,1710776716,1710776731,1710776731.81312,-18000,EB445137-D7F5-57EC-87DA-1DB460D64046,"iPhone13,2"
edu.illinois.rokwire.ios,10,1710776696,1710776706,1710776706.2625442,-18000,EB445137-D7F5-57EC-87DA-1DB460D64046,"iPhone13,2"
edu.illinois.rokwire.ios,10,1710776185,1710776195,1710776195.425142,-18000,EB445137-D7F5-57EC-87DA-1DB460D64046,"iPhone13,2"
edu.illinois.rokwire.ios,10,1710775571,1710775581,1710775581.923166,-18000,EB445137-D7F5-57EC-87DA-1DB460D64046,"iPhone13,2"
edu.illinois.rokwire.ios,9,1710775407,1710775416,1710775417.000098,-18000,EB445137-D7F5-57EC-87DA-1DB460D64046,"iPhone13,2"
edu.illinois.rokwire.ios,10,1710774869,1710774879,1710774879.688324,-18000,EB445137-D7F5-57EC-87DA-1DB460D64046,"iPhone13,2"
edu.illinois.rokwire.ios,11,1710774759,1710774770,1710774770.503964,-18000,EB445137-D7F5-57EC-87DA-1DB460D64046,"iPhone13,2"
edu.illinois.rokwire.ios,25,1710774094,1710774119,1710774120.5655022,-18000,EB445137-D7F5-57EC-87DA-1DB460D64046,"iPhone13,2"
com.apple.PosterBoard,2,1710774091,1710774093,1710774093.413589,-18000,EB445137-D7F5-57EC-87DA-1DB460D64046,"iPhone13,2"
com.hulu.plus,1593,1710772070,1710773663,1710773663.4514709,-18000,EB445137-D7F5-57EC-87DA-1DB460D64046,"iPhone13,2"
edu.illinois.rokwire.ios,8,1710772049,1710772057,1710772058.0811648,-18000,EB445137-D7F5-57EC-87DA-1DB460D64046,"iPhone13,2"
edu.illinois.rokwire.ios,34,1710771856,1710771890,1710771890.4719892,-18000,EB445137-D7F5-57EC-87DA-1DB460D64046,"iPhone13,2"
com.apple.Health,32,1710771643,1710771675,1710771675.208859,-18000,EB445137-D7F5-57EC-87DA-1DB460D64046,"iPhone13,2"
com.google.Maps,6,1710771635,1710771641,1710771642.076499,-18000,EB445137-D7F5-57EC-87DA-1DB460D64046,"iPhone13,2"
com.google.Maps,6,1710771573,1710771579,1710771579.611743,-18000,EB445137-D7F5-57EC-87DA-1DB460D64046,"iPhone13,2"
com.google.Maps,29,1710771538,1710771567,1710771567.885886,-18000,EB445137-D7F5-57EC-87DA-1DB460D64046,"iPhone13,2"
com.apple.weather,2,1710771535,1710771537,1710771537.618208,-18000,EB445137-D7F5-57EC-87DA-1DB460D64046,"iPhone13,2"
com.apple.weather,6,1710771483,1710771489,1710771489.93539,-18000,EB445137-D7F5-57EC-87DA-1DB460D64046,"iPhone13,2"
com.apple.weather,9,1710771118,1710771127,1710771127.254122,-18000,EB445137-D7F5-57EC-87DA-1DB460D64046,"iPhone13,2"
com.apple.weather,4,1710771106,1710771110,1710771111.294169,-18000,EB445137-D7F5-57EC-87DA-1DB460D64046,"iPhone13,2"
com.apple.Health,5,1710771100,1710771105,1710771105.696626,-18000,EB445137-D7F5-57EC-87DA-1DB460D64046,"iPhone13,2"
com.apple.Health,16,1710771078,1710771094,1710771094.426163,-18000,EB445137-D7F5-57EC-87DA-1DB460D64046,"iPhone13,2"
com.toyopagroup.picaboo,48,1710771025,1710771073,1710771073.822835,-18000,EB445137-D7F5-57EC-87DA-1DB460D64046,"iPhone13,2"
com.microsoft.Office.Outlook,11,1710771014,1710771025,1710771025.797775,-18000,EB445137-D7F5-57EC-87DA-1DB460D64046,"iPhone13,2"
com.apple.mobiletimer,9,1710763307,1710763316,1710763316.891787,-18000,EB445137-D7F5-57EC-87DA-1DB460D64046,"iPhone13,2"
com.google.Chrome,709,1710703201,1710703910,1710703910.4258518,-18000,,
com.apple.finder,4,1710703181,1710703185,1710703185.527499,-18000,,
com.google.Chrome,3,1710703178,1710703181,1710703181.4317222,-18000,,
com.apple.finder,0,1710703178,1710703178,1710703178.896687,-18000,,
com.google.Chrome,59,1710703119,1710703178,1710703178.249121,-18000,,
com.google.Chrome,514,1710698294,1710698808,1710698808.669654,-18000,,
com.apple.iCal,3,1710698291,1710698294,1710698294.640918,-18000,,
com.apple.iCal,23,1710697701,1710697724,1710697724.465765,-18000,,
com.google.Chrome,2,1710697699,1710697701,1710697702.008564,-18000,,
com.google.Chrome,867,1710696791,1710697658,1710697658.483724,-18000,,
com.leomehlig.today,184,1710696607,1710696791,1710696791.911444,-18000,,
com.apple.iCal,8,1710696599,1710696607,1710696607.790084,-18000,,
com.leomehlig.today,21,1710696578,1710696599,1710696599.9490008,-18000,,
com.apple.iCal,3,1710696575,1710696578,1710696578.918674,-18000,,
com.apple.iCal,340,1710695819,1710696159,1710696159.701195,-18000,,
com.leomehlig.today,45,1710695774,1710695819,1710695819.5021172,-18000,,
com.google.Chrome,58,1710695716,1710695774,1710695774.4404159,-18000,,
com.google.Chrome,647,1710694840,1710695487,1710695487.0389829,-18000,,
com.google.Chrome,355,1710693179,1710693534,1710693534.43952,-18000,,
