app,usage,start_time,end_time,created_at,tz,device_id,device_model
com.apple.finder,3,1737158198,1737158201,1737158201.62847,-21600,,
com.apple.Terminal,5,1737158193,1737158198,1737158198.402812,-21600,,
com.apple.finder,1,1737158192,1737158193,1737158193.9941769,-21600,,
com.apple.Terminal,7,1737158185,1737158192,1737158192.4643521,-21600,,
com.apple.finder,9,1737158176,1737158185,1737158185.770504,-21600,,
com.google.Chrome,54,1737158122,1737158176,1737158176.778271,-21600,,
com.microsoft.onenote.mac,21,1737158101,1737158122,1737158122.717041,-21600,,
com.apple.Music,0,1737158101,1737158101,1737158101.6589189,-21600,,
com.google.android.studio,2,1737158099,1737158101,1737158101.1335402,-21600,,
com.apple.dt.Xcode,3,1737158096,1737158099,1737158100.067558,-21600,,
com.google.android.studio,5,1737158091,1737158096,1737158096.421377,-21600,,
com.apple.Music,14,1737158077,1737158091,1737158091.594599,-21600,,
com.google.android.studio,1,1737158076,1737158077,1737158077.153486,-21600,,
com.microsoft.onenote.mac,91,1737157985,1737158076,1737158076.45837,-21600,,
com.google.android.studio,155,1737157830,1737157985,1737157985.971828,-21600,,
com.apple.Music,5,1737157825,1737157830,1737157830.284511,-21600,,
com.google.android.studio,203,1737157622,1737157825,1737157825.891776,-21600,,
com.apple.Music,16,1737157606,1737157622,1737157622.107085,-21600,,
com.google.android.studio,115,1737157491,1737157606,1737157607.031477,-21600,,
com.google.Chrome,1,1737157490,1737157491,1737157491.194504,-21600,,
com.google.android.studio,2,1737157488,1737157490,1737157490.683594,-21600,,
com.google.Chrome,34,1737157454,1737157488,1737157488.275126,-21600,,
com.google.android.studio,3,1737157451,1737157454,1737157454.681909,-21600,,
com.google.Chrome,8,1737157443,1737157451,1737157451.881974,-21600,,
com.google.android.studio,8,1737157435,1737157443,1737157443.9155521,-21600,,
com.google.Chrome,3,1737157432,1737157435,1737157435.89041,-21600,,
com.google.android.studio,1,1737157431,1737157432,1737157432.493079,-21600,,
com.google.Chrome,47,1737157384,1737157431,1737157431.073215,-21600,,
com.google.android.studio,31,1737157353,1737157384,1737157384.7950249,-21600,,
com.google.Chrome,41,1737157312,1737157353,1737157353.426543,-21600,,
com.google.android.studio,518,1737156794,1737157312,1737157312.4716392,-21600,,
com.apple.Music,7,1737156787,1737156794,1737156794.283556,-21600,,
com.google.android.studio,14,1737156773,1737156787,1737156787.8179111,-21600,,
com.apple.Music,5,1737156768,1737156773,1737156773.352292,-21600,,
com.google.android.studio,147,1737156621,1737156768,1737156768.931082,-21600,,
com.apple.Music,5,1737156616,1737156621,1737156621.345176,-21600,,
com.google.android.studio,68,1737156548,1737156616,1737156616.1480808,-21600,,
com.apple.Music,85,1737156463,1737156548,1737156548.351511,-21600,,
com.google.android.studio,7,1737156456,1737156463,1737156463.979296,-21600,,
com.apple.Music,9,1737156447,1737156456,1737156456.505439,-21600,,
com.google.android.studio,98,1737156349,1737156447,1737156447.598075,-21600,,
com.microsoft.onenote.mac,9,1737156340,1737156349,1737156349.742198,-21600,,
com.google.android.studio,223,1737156117,1737156340,1737156340.7087111,-21600,,
com.apple.Music,7,1737156110,1737156117,1737156117.9107761,-21600,,
com.google.android.studio,132,1737155978,1737156110,1737156110.64038,-21600,,
com.apple.Music,6,1737155972,1737155978,1737155978.160608,-21600,,
com.google.android.studio,235,1737155737,1737155972,1737155972.1301122,-21600,,
com.google.Chrome,7,1737155730,1737155737,1737155737.2816281,-21600,,
com.google.android.studio,256,1737155474,1737155730,1737155730.773519,-21600,,
com.apple.Music,6,1737155468,1737155474,1737155474.9680529,-21600,,
com.google.android.studio,80,1737155388,1737155468,1737155468.445657,-21600,,
com.apple.Music,8,1737155380,1737155388,1737155388.575681,-21600,,
com.google.android.studio,214,1737155166,1737155380,1737155380.0703468,-21600,,
com.apple.Music,2,1737155164,1737155166,1737155166.670548,-21600,,
com.google.android.studio,531,1737154633,1737155164,1737155164.230638,-21600,,
com.apple.Music,20,1737154613,1737154633,1737154633.980688,-21600,,
com.google.android.studio,140,1737154473,1737154613,1737154613.216075,-21600,,
com.apple.Music,10,1737154463,1737154473,1737154473.597725,-21600,,
com.google.android.studio,290,1737154173,1737154463,1737154463.6671681,-21600,,
com.google.Chrome,28,1737154145,1737154173,1737154173.701888,-21600,,
com.google.android.studio,5,1737154140,1737154145,1737154145.625649,-21600,,
com.google.Chrome,1,1737154139,1737154140,1737154140.755718,-21600,,
com.google.android.studio,172,1737153967,1737154139,1737154139.248167,-21600,,
com.google.Chrome,4,1737153963,1737153967,1737153967.7653651,-21600,,
com.google.android.studio,2,1737153961,1737153963,1737153963.5568109,-21600,,
com.google.Chrome,9,1737153952,1737153961,1737153962.027736,-21600,,
com.google.android.studio,63,1737153889,1737153952,1737153952.59346,-21600,,
com.apple.Music,1,1737153888,1737153889,1737153889.926005,-21600,,
com.google.Chrome,15,1737153873,1737153888,1737153888.910923,-21600,,
com.apple.Music,1,1737153872,1737153873,1737153873.33073,-21600,,
com.google.android.studio,6,1737153866,1737153872,1737153872.482656,-21600,,
com.apple.Music,1,1737153865,1737153866,1737153866.488079,-21600,,
com.google.Chrome,14,1737153851,1737153865,1737153865.615581,-21600,,
com.apple.Music,5,1737153846,1737153851,1737153851.571877,-21600,,
com.google.android.studio,1,1737153845,1737153846,1737153846.712327,-21600,,
com.google.Chrome,3,1737153842,1737153845,1737153845.822875,-21600,,
com.apple.Music,0,1737153842,1737153842,1737153842.977474,-21600,,
com.google.android.studio,7,1737153835,1737153842,1737153842.067693,-21600,,
com.apple.Music,0,1737153835,1737153835,1737153836.0393162,-21600,,
com.google.Chrome,2,1737153833,1737153835,1737153835.170084,-21600,,
com.apple.Music,1,1737153832,1737153833,1737153833.7373319,-21600,,
com.google.android.studio,36,1737153796,1737153832,1737153832.485248,-21600,,
com.apple.Music,1,1737153795,1737153796,1737153797.0075989,-21600,,
com.google.android.studio,12,1737153783,1737153795,1737153795.907088,-21600,,
com.apple.Music,5,1737153778,1737153783,1737153783.626419,-21600,,
com.google.android.studio,25,1737153753,1737153778,1737153778.3944569,-21600,,
com.google.Chrome,4,1737153749,1737153753,1737153753.794709,-21600,,
com.google.android.studio,24,1737153725,1737153749,1737153749.781838,-21600,,
com.google.Chrome,17,1737153708,1737153725,1737153725.4068918,-21600,,
com.google.android.studio,79,1737153629,1737153708,1737153708.441484,-21600,,
com.google.Chrome,19,1737153610,1737153629,1737153629.615265,-21600,,
com.google.android.studio,1,1737153609,1737153610,1737153610.150465,-21600,,
com.apple.Music,4,1737153605,1737153609,1737153609.043297,-21600,,
com.google.Chrome,5,1737153600,1737153605,1737153605.070185,-21600,,
com.google.android.studio,119,1737153481,1737153600,1737153600.667838,-21600,,
com.google.Chrome,107,1737153374,1737153481,1737153481.672627,-21600,,
com.apple.Music,2,1737153372,1737153374,1737153374.82777,-21600,,
com.google.Chrome,44,1737153328,1737153372,1737153372.839676,-21600,,
com.google.android.studio,228,1737153100,1737153328,1737153328.1904058,-21600,,
com.apple.Music,8,1737153092,1737153100,1737153100.6359901,-21600,,
com.google.android.studio,296,1737152796,1737153092,1737153092.147778,-21600,,
com.apple.Music,32,1737152764,1737152796,1737152796.513423,-21600,,
com.google.android.studio,369,1737152395,1737152764,1737152764.608768,-21600,,
com.apple.Music,9,1737152386,1737152395,1737152396.008034,-21600,,
com.google.android.studio,64,1737152322,1737152386,1737152386.690384,-21600,,
com.apple.Music,1,1737152321,1737152322,1737152322.631325,-21600,,
com.google.Chrome,118,1737152203,1737152321,1737152321.3621058,-21600,,
com.apple.Music,1,1737152202,1737152203,1737152203.964,-21600,,
com.google.android.studio,7,1737152195,1737152202,1737152202.792556,-21600,,
com.apple.Music,1,1737152194,1737152195,1737152195.180153,-21600,,
com.google.Chrome,27,1737152167,1737152194,1737152194.530354,-21600,,
com.apple.Music,1,1737152166,1737152167,1737152167.089786,-21600,,
com.google.android.studio,35,1737152131,1737152166,1737152166.1379209,-21600,,
com.apple.Music,1,1737152130,1737152131,1737152132.0357308,-21600,,
com.google.Chrome,0,1737152130,1737152130,1737152130.965874,-21600,,
com.apple.Music,1,1737152129,1737152130,1737152130.183485,-21600,,
com.google.Chrome,6,1737152123,1737152129,1737152129.833112,-21600,,
com.apple.Music,0,1737152123,1737152123,1737152124.033546,-21600,,
com.google.android.studio,9,1737152114,1737152123,1737152123.101156,-21600,,
com.apple.Music,1,1737152113,1737152114,1737152114.9731112,-21600,,
com.google.Chrome,13,1737152100,1737152113,1737152114.030479,-21600,,
com.apple.Music,1,1737152099,1737152100,1737152100.7192888,-21600,,
com.google.android.studio,3,1737152096,1737152099,1737152099.283414,-21600,,
com.apple.Music,1,1737152095,1737152096,1737152096.767276,-21600,,
com.google.Chrome,10,1737152085,1737152095,1737152095.801682,-21600,,
com.apple.Music,10,1737152075,1737152085,1737152085.47135,-21600,,
com.google.Chrome,26,1737152049,1737152075,1737152075.1963902,-21600,,
com.google.android.studio,5,1737152044,1737152049,1737152049.565158,-21600,,
com.google.Chrome,8,1737152036,1737152044,1737152044.7360868,-21600,,
com.google.android.studio,19,1737152017,1737152036,1737152037.000619,-21600,,
com.google.Chrome,34,1737151983,1737152017,1737152017.077122,-21600,,
com.google.android.studio,166,1737151817,1737151983,1737151983.48201,-21600,,
com.apple.Music,4,1737151813,1737151817,1737151817.328456,-21600,,
com.apple.dt.Xcode,3,1737151810,1737151813,1737151813.110038,-21600,,
com.google.Chrome,0,1737151810,1737151810,1737151810.999045,-21600,,
com.google.android.studio,158,1737151652,1737151810,1737151810.2249289,-21600,,
com.google.Chrome,58,1737151594,1737151652,1737151652.9997811,-21600,,
com.google.android.studio,46,1737151548,1737151594,1737151594.335351,-21600,,
com.apple.dt.Xcode,1,1737151547,1737151548,1737151548.888729,-21600,,
com.apple.Music,11,1737151536,1737151547,1737151547.168143,-21600,,
com.apple.dt.Xcode,2,1737151534,1737151536,1737151536.173398,-21600,,
com.apple.Music,9,1737151525,1737151534,1737151534.093182,-21600,,
com.google.android.studio,73,1737151452,1737151525,1737151525.7299628,-21600,,
com.google.Chrome,2,1737151450,1737151452,1737151452.710346,-21600,,
com.google.android.studio,1,1737151449,1737151450,1737151450.251122,-21600,,
com.google.Chrome,13,1737151436,1737151449,1737151449.577327,-21600,,
com.google.android.studio,273,1737151163,1737151436,1737151436.267618,-21600,,
com.apple.Music,19,1737151144,1737151163,1737151163.418882,-21600,,
com.google.android.studio,81,1737151063,1737151144,1737151144.947414,-21600,,
com.google.Chrome,20,1737151043,1737151063,1737151063.959947,-21600,,
com.google.android.studio,167,1737150876,1737151043,1737151043.71595,-21600,,
com.google.Chrome,5,1737150871,1737150876,1737150877.042589,-21600,,
com.google.android.studio,11,1737150860,1737150871,1737150871.966538,-21600,,
com.google.Chrome,33,1737150827,1737150860,1737150860.142383,-21600,,
com.google.android.studio,536,1737150291,1737150827,1737150828.07309,-21600,,
com.apple.Music,4,1737150287,1737150291,1737150291.135851,-21600,,
com.google.android.studio,1,1737150286,1737150287,1737150287.740092,-21600,,
com.apple.Music,2,1737150284,1737150286,1737150286.15394,-21600,,
com.google.android.studio,62,1737150222,1737150284,1737150284.588757,-21600,,
com.apple.Music,47,1737150175,1737150222,1737150222.895465,-21600,,
com.google.android.studio,363,1737149812,1737150175,1737150176.022897,-21600,,
com.apple.Music,6,1737149806,1737149812,1737149812.2137132,-21600,,
com.google.android.studio,372,1737149434,1737149806,1737149806.590454,-21600,,
com.apple.dt.Xcode,23,1737149411,1737149434,1737149434.5717978,-21600,,
com.google.android.studio,53,1737149358,1737149411,1737149411.829193,-21600,,
com.apple.dt.Xcode,3,1737149355,1737149358,1737149358.3753738,-21600,,
com.google.android.studio,31,1737149324,1737149355,1737149355.222769,-21600,,
com.google.Chrome,18,1737149306,1737149324,1737149324.929178,-21600,,
com.google.android.studio,240,1737149052,1737149292,1737149293.0199099,-21600,,
com.apple.Music,9,1737149043,1737149052,1737149052.822478,-21600,,
com.google.android.studio,196,1737148847,1737149043,1737149044.040587,-21600,,
com.apple.Music,18,1737148829,1737148847,1737148847.21937,-21600,,
com.google.android.studio,459,1737148370,1737148829,1737148829.305393,-21600,,
com.apple.Music,22,1737148348,1737148370,1737148370.985086,-21600,,
com.google.android.studio,26,1737148322,1737148348,1737148348.934156,-21600,,
com.apple.Music,26,1737148296,1737148322,1737148322.218111,-21600,,
com.google.android.studio,132,1737148164,1737148296,1737148296.9160318,-21600,,
com.google.Chrome,36,1737148128,1737148164,1737148164.451024,-21600,,
com.google.android.studio,216,1737147912,1737148128,1737148128.8369908,-21600,,
com.google.Chrome,4,1737147908,1737147912,1737147912.738669,-21600,,
com.google.android.studio,19,1737147889,1737147908,1737147908.7053971,-21600,,
com.google.Chrome,73,1737147816,1737147889,1737147889.9603229,-21600,,
com.google.android.studio,380,1737147436,1737147816,1737147817.026478,-21600,,
com.apple.Music,6,1737147430,1737147436,1737147436.899417,-21600,,
com.google.android.studio,76,1737147354,1737147430,1737147430.807966,-21600,,
com.apple.Music,5,1737147349,1737147354,1737147354.863325,-21600,,
com.google.android.studio,69,1737147280,1737147349,1737147349.914676,-21600,,
com.apple.dt.Xcode,3,1737147277,1737147280,1737147280.962223,-21600,,
com.apple.Music,5,1737147272,1737147277,1737147277.574755,-21600,,
com.apple.dt.Xcode,1,1737147271,1737147272,1737147272.844812,-21600,,
com.google.android.studio,166,1737147105,1737147271,1737147271.9607701,-21600,,
com.apple.dt.Xcode,10,1737147095,1737147105,1737147105.340973,-21600,,
com.apple.Music,11,1737147084,1737147095,1737147095.656497,-21600,,
com.apple.dt.Xcode,1,1737147083,1737147084,1737147084.463655,-21600,,
com.google.android.studio,236,1737146847,1737147083,1737147083.566444,-21600,,
com.apple.dt.Xcode,1,1737146846,1737146847,1737146847.9432101,-21600,,
com.apple.Music,1,1737146845,1737146846,1737146846.3866,-21600,,
com.apple.dt.Xcode,0,1737146845,1737146845,1737146845.735292,-21600,,
com.apple.Music,6,1737146839,1737146845,1737146845.1476688,-21600,,
com.apple.dt.Xcode,1,1737146838,1737146839,1737146840.0025458,-21600,,
com.google.android.studio,50,1737146788,1737146838,1737146838.959471,-21600,,
com.apple.dt.Xcode,6,1737146782,1737146788,1737146788.1619349,-21600,,
com.google.android.studio,55,1737146727,1737146782,1737146782.363058,-21600,,
com.apple.dt.Xcode,2,1737146725,1737146727,1737146727.41099,-21600,,
com.google.android.studio,4,1737146721,1737146725,1737146725.7694778,-21600,,
com.apple.dt.Xcode,11,1737146710,1737146721,1737146721.7104979,-21600,,
com.google.android.studio,34,1737146676,1737146710,1737146710.519662,-21600,,
com.apple.Music,6,1737146670,1737146676,1737146676.366528,-21600,,
com.google.android.studio,145,1737146525,1737146670,1737146670.54768,-21600,,
com.apple.dt.Xcode,1,1737146524,1737146525,1737146525.5761008,-21600,,
com.google.android.studio,6,1737146518,1737146524,1737146524.220717,-21600,,
com.apple.dt.Xcode,2,1737146516,1737146518,1737146518.492258,-21600,,
com.google.android.studio,15,1737146501,1737146516,1737146517.002421,-21600,,
com.apple.dt.Xcode,16,1737146485,1737146501,1737146501.42009,-21600,,
com.google.android.studio,10,1737146475,1737146485,1737146485.631052,-21600,,
com.apple.dt.Xcode,0,1737146475,1737146475,1737146475.937577,-21600,,
com.google.android.studio,5,1737146470,1737146475,1737146475.0487242,-21600,,
com.apple.dt.Xcode,3,1737146467,1737146470,1737146470.306188,-21600,,
com.google.android.studio,11,1737146456,1737146467,1737146467.344736,-21600,,
com.apple.dt.Xcode,7,1737146449,1737146456,1737146456.4564152,-21600,,
com.apple.Music,12,1737146437,1737146449,1737146449.470784,-21600,,
com.apple.dt.Xcode,14,1737146423,1737146437,1737146437.5097609,-21600,,
com.google.android.studio,14,1737146409,1737146423,1737146423.455563,-21600,,
com.apple.dt.Xcode,2,1737146407,1737146409,1737146409.522902,-21600,,
com.google.android.studio,17,1737146390,1737146407,1737146408.044805,-21600,,
com.apple.dt.Xcode,12,1737146378,1737146390,1737146390.3019872,-21600,,
com.google.android.studio,112,1737146266,1737146378,1737146378.865288,-21600,,
com.apple.dt.Xcode,27,1737146239,1737146266,1737146266.527765,-21600,,
com.google.android.studio,65,1737146174,1737146239,1737146239.1449199,-21600,,
com.apple.Music,33,1737146141,1737146174,1737146174.694168,-21600,,
com.microsoft.onenote.mac,1,1737146140,1737146141,1737146141.512003,-21600,,
com.apple.Music,40,1737146100,1737146140,1737146140.482033,-21600,,
com.microsoft.onenote.mac,1,1737146099,1737146100,1737146100.09987,-21600,,
com.apple.Music,64,1737146035,1737146099,1737146099.710874,-21600,,
com.microsoft.onenote.mac,93,1737145942,1737146035,1737146035.594654,-21600,,
com.microsoft.onenote.mac,36,1737134182,1737134218,1737134218.985878,-21600,,
com.google.android.studio,264,1737133918,1737134182,1737134182.165828,-21600,,
com.google.Chrome,6,1737133912,1737133918,1737133918.383412,-21600,,
com.google.android.studio,36,1737133876,1737133912,1737133912.795371,-21600,,
com.google.Chrome,3,1737133873,1737133876,1737133876.833212,-21600,,
com.google.android.studio,62,1737133811,1737133873,1737133873.729702,-21600,,
com.google.Chrome,3,1737133808,1737133811,1737133811.155684,-21600,,
com.google.android.studio,2,1737133806,1737133808,1737133808.184692,-21600,,
com.google.Chrome,3,1737133803,1737133806,1737133807.018766,-21600,,
com.google.android.studio,6,1737133797,1737133803,1737133804.034144,-21600,,
com.google.Chrome,3,1737133794,1737133797,1737133797.89039,-21600,,
com.google.android.studio,8,1737133786,1737133794,1737133794.923789,-21600,,
com.google.Chrome,22,1737133764,1737133786,1737133786.221869,-21600,,
com.google.android.studio,2,1737133762,1737133764,1737133764.340324,-21600,,
com.google.Chrome,103,1737133659,1737133762,1737133762.5495648,-21600,,
com.google.android.studio,79,1737133580,1737133659,1737133659.878916,-21600,,
com.apple.dt.Xcode,1,1737133579,1737133580,1737133580.418045,-21600,,
com.google.android.studio,63,1737133516,1737133579,1737133579.287046,-21600,,
com.apple.dt.Xcode,4,1737133512,1737133516,1737133516.7218308,-21600,,
com.google.android.studio,72,1737133440,1737133512,1737133512.913666,-21600,,
com.apple.dt.Xcode,1,1737133439,1737133440,1737133440.7138271,-21600,,
com.google.android.studio,135,1737133304,1737133439,1737133439.31447,-21600,,
com.apple.dt.Xcode,6,1737133298,1737133304,1737133304.6355782,-21600,,
com.google.android.studio,20,1737133278,1737133298,1737133298.686623,-21600,,
com.apple.dt.Xcode,5,1737133273,1737133278,1737133279.0690541,-21600,,
com.apple.MobileSMS,5,1737133268,1737133273,1737133273.793953,-21600,,
com.apple.dt.Xcode,24,1737133244,1737133268,1737133269.0155501,-21600,,
com.google.android.studio,7,1737133237,1737133244,1737133244.749326,-21600,,
com.apple.dt.Xcode,1,1737133236,1737133237,1737133237.7962332,-21600,,
com.google.android.studio,15,1737133221,1737133236,1737133236.997768,-21600,,
com.apple.dt.Xcode,1,1737133220,1737133221,1737133221.730171,-21600,,
com.google.android.studio,1,1737133219,1737133220,1737133220.961419,-21600,,
com.apple.dt.Xcode,2,1737133217,1737133219,1737133219.1242561,-21600,,
com.google.android.studio,22,1737133195,1737133217,1737133217.135381,-21600,,
com.apple.dt.Xcode,5,1737133190,1737133195,1737133195.069783,-21600,,
com.google.android.studio,88,1737133102,1737133190,1737133190.349338,-21600,,
com.apple.dt.Xcode,3,1737133099,1737133102,1737133102.509074,-21600,,
com.google.android.studio,21,1737133078,1737133099,1737133099.564921,-21600,,
com.apple.dt.Xcode,1,1737133077,1737133078,1737133078.495748,-21600,,
com.google.android.studio,27,1737133050,1737133077,1737133077.211813,-21600,,
com.apple.dt.Xcode,84,1737132966,1737133050,1737133050.33441,-21600,,
com.google.android.studio,13,1737132953,1737132966,1737132966.2881742,-21600,,
com.apple.dt.Xcode,1,1737132952,1737132953,1737132953.96455,-21600,,
com.google.android.studio,2,1737132950,1737132952,1737132952.831594,-21600,,
com.apple.dt.Xcode,3,1737132947,1737132950,1737132950.568259,-21600,,
com.google.android.studio,2,1737132945,1737132947,1737132947.204171,-21600,,
com.apple.dt.Xcode,2,1737132943,1737132945,1737132945.0821671,-21600,,
com.google.android.studio,6,1737132937,1737132943,1737132943.8784719,-21600,,
com.apple.dt.Xcode,2,1737132935,1737132937,1737132937.3564072,-21600,,
com.google.android.studio,18,1737132917,1737132935,1737132935.7067928,-21600,,
com.apple.dt.Xcode,1,1737132916,1737132917,1737132917.5111089,-21600,,
com.google.android.studio,2,1737132914,1737132916,1737132916.517688,-21600,,
com.apple.dt.Xcode,1,1737132913,1737132914,1737132914.502655,-21600,,
com.google.android.studio,13,1737132900,1737132913,1737132913.330034,-21600,,
com.apple.dt.Xcode,1,1737132899,1737132900,1737132901.0320802,-21600,,
com.google.android.studio,11,1737132888,1737132899,1737132899.869916,-21600,,
com.apple.dt.Xcode,66,1737132822,1737132888,1737132888.99856,-21600,,
com.google.android.studio,71,1737132751,1737132822,1737132822.491812,-21600,,
com.apple.dt.Xcode,2,1737132749,1737132751,1737132751.127552,-21600,,
com.google.android.studio,13,1737132736,1737132749,1737132749.1219811,-21600,,
com.apple.dt.Xcode,2,1737132734,1737132736,1737132736.453696,-21600,,
com.google.android.studio,15,1737132719,1737132734,1737132734.240562,-21600,,
com.apple.dt.Xcode,2,1737132717,1737132719,1737132719.374485,-21600,,
com.google.android.studio,5,1737132712,1737132717,1737132717.0964499,-21600,,
com.apple.dt.Xcode,3,1737132709,1737132712,1737132712.654128,-21600,,
com.google.android.studio,1,1737132708,1737132709,1737132709.7975879,-21600,,
com.apple.dt.Xcode,4,1737132704,1737132708,1737132708.313641,-21600,,
com.google.android.studio,3,1737132701,1737132704,1737132704.3977752,-21600,,
com.apple.dt.Xcode,10,1737132691,1737132701,1737132701.412788,-21600,,
com.google.android.studio,2,1737132689,1737132691,1737132691.084324,-21600,,
com.apple.dt.Xcode,4,1737132685,1737132689,1737132689.605093,-21600,,
com.google.android.studio,7,1737132678,1737132685,1737132685.120394,-21600,,
com.apple.dt.Xcode,3,1737132675,1737132678,1737132678.236897,-21600,,
com.google.android.studio,9,1737132666,1737132675,1737132676.044158,-21600,,
com.apple.dt.Xcode,2,1737132664,1737132666,1737132666.735664,-21600,,
com.google.android.studio,5,1737132659,1737132664,1737132664.217658,-21600,,
com.apple.dt.Xcode,3,1737132656,1737132659,1737132659.114784,-21600,,
com.google.android.studio,9,1737132647,1737132656,1737132656.22614,-21600,,
com.apple.dt.Xcode,2,1737132645,1737132647,1737132647.5327759,-21600,,
com.google.android.studio,8,1737132637,1737132645,1737132645.461207,-21600,,
com.apple.dt.Xcode,2,1737132635,1737132637,1737132637.4909039,-21600,,
com.google.android.studio,23,1737132612,1737132635,1737132635.811792,-21600,,
com.apple.dt.Xcode,2,1737132610,1737132612,1737132612.473165,-21600,,
com.google.android.studio,3,1737132607,1737132610,1737132611.042453,-21600,,
com.apple.dt.Xcode,1,1737132606,1737132607,1737132607.31406,-21600,,
com.google.android.studio,6,1737132600,1737132606,1737132606.274075,-21600,,
com.apple.dt.Xcode,15,1737132585,1737132600,1737132600.549561,-21600,,
com.google.android.studio,20,1737132565,1737132585,1737132585.5741901,-21600,,
com.apple.dt.Xcode,1,1737132564,1737132565,1737132565.570979,-21600,,
com.google.android.studio,2,1737132562,1737132564,1737132564.6469169,-21600,,
com.apple.dt.Xcode,1,1737132561,1737132562,1737132563.0366879,-21600,,
com.google.android.studio,35,1737132526,1737132561,1737132561.855591,-21600,,
com.apple.dt.Xcode,2,1737132524,1737132526,1737132526.209896,-21600,,
com.google.android.studio,3,1737132521,1737132524,1737132524.164672,-21600,,
com.apple.dt.Xcode,1,1737132520,1737132521,1737132521.457031,-21600,,
com.google.android.studio,2,1737132518,1737132520,1737132520.531111,-21600,,
com.apple.dt.Xcode,1,1737132517,1737132518,1737132518.531142,-21600,,
com.google.android.studio,3,1737132514,1737132517,1737132517.69972,-21600,,
com.apple.dt.Xcode,2,1737132512,1737132514,1737132514.2256532,-21600,,
com.google.android.studio,6,1737132506,1737132512,1737132512.227007,-21600,,
com.apple.dt.Xcode,2,1737132504,1737132506,1737132507.0001822,-21600,,
com.google.android.studio,2,1737132502,1737132504,1737132504.603716,-21600,,
com.apple.dt.Xcode,2,1737132500,1737132502,1737132502.10598,-21600,,
com.google.android.studio,9,1737132491,1737132500,1737132500.842269,-21600,,
com.apple.dt.Xcode,3,1737132488,1737132491,1737132491.082365,-21600,,
com.google.android.studio,1,1737132487,1737132488,1737132488.9858031,-21600,,
com.apple.dt.Xcode,2,1737132485,1737132487,1737132487.155583,-21600,,
com.google.android.studio,4,1737132481,1737132485,1737132485.904066,-21600,,
com.apple.dt.Xcode,1,1737132480,1737132481,1737132481.660411,-21600,,
com.google.android.studio,8,1737132472,1737132480,1737132480.299213,-21600,,
com.apple.dt.Xcode,11,1737132461,1737132472,1737132472.574729,-21600,,
com.google.android.studio,14,1737132447,1737132461,1737132461.8717551,-21600,,
com.apple.dt.Xcode,3,1737132444,1737132447,1737132447.805396,-21600,,
com.google.android.studio,61,1737132383,1737132444,1737132444.104073,-21600,,
com.apple.dt.Xcode,1,1737132382,1737132383,1737132384.02712,-21600,,
com.google.android.studio,17,1737132365,1737132382,1737132382.661974,-21600,,
com.apple.dt.Xcode,1,1737132364,1737132365,1737132365.711348,-21600,,
com.google.android.studio,6,1737132358,1737132364,1737132364.1381211,-21600,,
com.apple.dt.Xcode,3,1737132355,1737132358,1737132358.4431648,-21600,,
com.google.android.studio,7,1737132348,1737132355,1737132355.965389,-21600,,
com.apple.dt.Xcode,0,1737132348,1737132348,1737132348.933574,-21600,,
com.google.android.studio,3,1737132345,1737132348,1737132348.1414828,-21600,,
com.apple.dt.Xcode,5,1737132340,1737132345,1737132345.511047,-21600,,
com.google.android.studio,2,1737132338,1737132340,1737132340.5567122,-21600,,
com.apple.dt.Xcode,2,1737132336,1737132338,1737132338.3343902,-21600,,
com.google.android.studio,4,1737132332,1737132336,1737132336.2416859,-21600,,
com.apple.dt.Xcode,216,1737132116,1737132332,1737132332.234925,-21600,,
com.google.android.studio,9,1737132107,1737132116,1737132117.041229,-21600,,
com.apple.dt.Xcode,2,1737132105,1737132107,1737132107.2831821,-21600,,
com.google.android.studio,4,1737132101,1737132105,1737132105.4749699,-21600,,
com.apple.dt.Xcode,3,1737132098,1737132101,1737132101.175008,-21600,,
com.google.android.studio,1,1737132097,1737132098,1737132098.066993,-21600,,
com.apple.dt.Xcode,1,1737132096,1737132097,1737132097.41272,-21600,,
com.google.android.studio,11,1737132085,1737132096,1737132096.232753,-21600,,
com.apple.dt.Xcode,3,1737132082,1737132085,1737132085.232084,-21600,,
com.google.android.studio,12,1737132070,1737132082,1737132082.32295,-21600,,
com.apple.dt.Xcode,1,1737132069,1737132070,1737132070.573755,-21600,,
com.google.android.studio,0,1737132069,1737132069,1737132069.9731321,-21600,,
com.apple.dt.Xcode,4,1737132065,1737132069,1737132069.5255818,-21600,,
com.google.android.studio,14,1737132051,1737132065,1737132065.287578,-21600,,
com.apple.dt.Xcode,2,1737132049,1737132051,1737132051.477583,-21600,,
com.google.android.studio,2,1737132047,1737132049,1737132049.8237,-21600,,
com.apple.dt.Xcode,3,1737132044,1737132047,1737132047.219946,-21600,,
com.google.android.studio,20,1737132024,1737132044,1737132044.847722,-21600,,
com.apple.dt.Xcode,1,1737132023,1737132024,1737132024.992354,-21600,,
com.google.android.studio,34,1737131989,1737132023,1737132023.223912,-21600,,
com.apple.dt.Xcode,4,1737131985,1737131989,1737131990.0050201,-21600,,
com.google.android.studio,64,1737131921,1737131985,1737131985.086432,-21600,,
com.apple.dt.Xcode,5,1737131916,1737131921,1737131921.943143,-21600,,
com.google.android.studio,7,1737131909,1737131916,1737131916.2716122,-21600,,
com.apple.dt.Xcode,2,1737131907,1737131909,1737131909.806474,-21600,,
com.google.android.studio,8,1737131899,1737131907,1737131907.453646,-21600,,
com.apple.dt.Xcode,8,1737131891,1737131899,1737131899.738708,-21600,,
com.google.android.studio,5,1737131886,1737131891,1737131891.227981,-21600,,
com.apple.dt.Xcode,3,1737131883,1737131886,1737131886.7114701,-21600,,
com.google.android.studio,5,1737131878,1737131883,1737131883.440758,-21600,,
com.apple.dt.Xcode,8,1737131870,1737131878,1737131878.214818,-21600,,
com.google.android.studio,2,1737131868,1737131870,1737131870.300582,-21600,,
com.apple.dt.Xcode,7,1737131861,1737131868,1737131868.4614081,-21600,,
com.google.android.studio,2,1737131859,1737131861,1737131861.912531,-21600,,
com.apple.dt.Xcode,4,1737131855,1737131859,1737131859.71734,-21600,,
com.google.android.studio,4,1737131851,1737131855,1737131855.1819801,-21600,,
com.apple.dt.Xcode,5,1737131846,1737131851,1737131851.957285,-21600,,
com.google.android.studio,10,1737131836,1737131846,1737131846.400947,-21600,,
com.apple.dt.Xcode,4,1737131832,1737131836,1737131836.038076,-21600,,
com.google.android.studio,51,1737131781,1737131832,1737131832.957487,-21600,,
com.apple.dt.Xcode,1,1737131780,1737131781,1737131781.7715049,-21600,,
com.google.android.studio,5,1737131775,1737131780,1737131780.178771,-21600,,
com.apple.dt.Xcode,2,1737131773,1737131775,1737131775.835253,-21600,,
com.google.android.studio,11,1737131762,1737131773,1737131773.9201589,-21600,,
com.apple.dt.Xcode,3,1737131759,1737131762,1737131762.5186992,-21600,,
com.google.android.studio,4,1737131755,1737131759,1737131759.778456,-21600,,
com.apple.dt.Xcode,3,1737131752,1737131755,1737131755.0633159,-21600,,
com.google.android.studio,9,1737131743,1737131752,1737131752.783711,-21600,,
com.apple.dt.Xcode,1,1737131742,1737131743,1737131743.400672,-21600,,
com.google.android.studio,36,1737131706,1737131742,1737131742.386036,-21600,,
com.apple.dt.Xcode,2,1737131704,1737131706,1737131706.4956222,-21600,,
com.google.android.studio,6,1737131698,1737131704,1737131704.271975,-21600,,
com.apple.dt.Xcode,4,1737131694,1737131698,1737131698.923778,-21600,,
com.google.android.studio,26,1737131668,1737131694,1737131694.65254,-21600,,
com.apple.dt.Xcode,1,1737131667,1737131668,1737131668.5285048,-21600,,
com.google.android.studio,4,1737131663,1737131667,1737131667.57956,-21600,,
com.apple.dt.Xcode,1,1737131662,1737131663,1737131663.8458462,-21600,,
com.google.android.studio,1,1737131661,1737131662,1737131662.973926,-21600,,
com.apple.dt.Xcode,3,1737131658,1737131661,1737131661.149437,-21600,,
com.google.android.studio,21,1737131637,1737131658,1737131658.985817,-21600,,
com.apple.dt.Xcode,3,1737131634,1737131637,1737131637.362615,-21600,,
com.google.android.studio,15,1737131619,1737131634,1737131634.4613562,-21600,,
com.apple.dt.Xcode,1,1737131618,1737131619,1737131620.049236,-21600,,
com.google.android.studio,4,1737131614,1737131618,1737131618.705431,-21600,,
com.apple.dt.Xcode,5,1737131609,1737131614,1737131614.1920362,-21600,,
com.google.android.studio,7,1737131602,1737131609,1737131609.92044,-21600,,
com.apple.dt.Xcode,2,1737131600,1737131602,1737131602.209327,-21600,,
com.google.android.studio,47,1737131553,1737131600,1737131600.740817,-21600,,
com.apple.dt.Xcode,20,1737131533,1737131553,1737131554.008904,-21600,,
com.google.android.studio,17,1737131516,1737131533,1737131533.55622,-21600,,
com.apple.dt.Xcode,15,1737131501,1737131516,1737131516.239686,-21600,,
com.google.android.studio,3,1737131498,1737131501,1737131501.053396,-21600,,
com.apple.dt.Xcode,1,1737131497,1737131498,1737131498.646741,-21600,,
com.google.android.studio,3,1737131494,1737131497,1737131497.616904,-21600,,
com.apple.dt.Xcode,3,1737131491,1737131494,1737131494.675353,-21600,,
com.google.android.studio,558,1737130933,1737131491,1737131492.048811,-21600,,
com.apple.dt.Xcode,6,1737130927,1737130933,1737130933.149612,-21600,,
com.google.android.studio,24,1737130903,1737130927,1737130927.649273,-21600,,
com.apple.dt.Xcode,1,1737130902,1737130903,1737130903.986479,-21600,,
com.google.android.studio,16,1737130886,1737130902,1737130902.416228,-21600,,
com.apple.dt.Xcode,28,1737130858,1737130886,1737130886.4863849,-21600,,
com.google.android.studio,49,1737130809,1737130858,1737130858.639317,-21600,,
com.google.Chrome,24,1737130785,1737130809,1737130809.957512,-21600,,
com.google.android.studio,455,1737130330,1737130785,1737130786.0278878,-21600,,
com.apple.dt.Xcode,2,1737130328,1737130330,1737130330.6173592,-21600,,
com.google.Chrome,6,1737130322,1737130328,1737130328.703522,-21600,,
com.apple.dt.Xcode,1,1737130321,1737130322,1737130322.848623,-21600,,
com.google.android.studio,6,1737130315,1737130321,1737130321.830867,-21600,,
com.apple.dt.Xcode,2,1737130313,1737130315,1737130315.37713,-21600,,
com.google.android.studio,1,1737130312,1737130313,1737130313.690465,-21600,,
com.apple.dt.Xcode,0,1737130312,1737130312,1737130312.943524,-21600,,
com.google.Chrome,37,1737130275,1737130312,1737130312.1446018,-21600,,
com.apple.dt.Xcode,2,1737130273,1737130275,1737130275.482214,-21600,,
com.google.android.studio,36,1737130237,1737130273,1737130273.525861,-21600,,
com.apple.calculator,82,1737130028,1737130110,1737130110.780694,-21600,,
com.google.android.studio,4,1737130024,1737130028,1737130028.1869779,-21600,,
com.apple.calculator,3,1737130021,1737130024,1737130024.524272,-21600,,
com.google.android.studio,112,1737129909,1737130021,1737130021.6232882,-21600,,
com.apple.dt.Xcode,3,1737129906,1737129909,1737129909.949796,-21600,,
com.google.android.studio,41,1737129865,1737129906,1737129906.106148,-21600,,
com.apple.dt.Xcode,32,1737129833,1737129865,1737129865.0803208,-21600,,
com.apple.dt.Xcode,304,1737128604,1737128908,1737128908.272789,-21600,,
com.google.android.studio,13,1737128591,1737128604,1737128606.1743898,-21600,,
com.google.Chrome,13,1737128578,1737128591,1737128592.857894,-21600,,
com.google.Chrome,347,1737082232,1737082579,1737082579.91649,-21600,,
com.google.Chrome,1028,1737081107,1737082135,1737082135.6802921,-21600,,
com.google.Chrome,839,1737080083,1737080922,1737080922.896261,-21600,,
com.apple.MobileSMS,6,1737080077,1737080083,1737080083.59467,-21600,,
com.google.Chrome,11,1737080066,1737080077,1737080077.742681,-21600,,
com.apple.MobileSMS,29,1737080037,1737080066,1737080066.90654,-21600,,
com.google.Chrome,1,1737080036,1737080037,1737080037.918014,-21600,,
com.apple.MobileSMS,3,1737080033,1737080036,1737080037.0126529,-21600,,
com.google.Chrome,355,1737079678,1737080033,1737080033.269155,-21600,,
com.microsoft.onenote.mac,134,1737079544,1737079678,1737079678.1420422,-21600,,
com.apple.finder,2,1737079542,1737079544,1737079544.670158,-21600,,
com.google.android.studio,404,1737079138,1737079542,1737079542.206141,-21600,,
com.microsoft.VSCode,31,1737079107,1737079138,1737079138.4741678,-21600,,
com.apple.finder,1,1737079106,1737079107,1737079107.764453,-21600,,
com.microsoft.VSCode,36,1737079070,1737079106,1737079106.095399,-21600,,
com.apple.finder,10,1737079060,1737079070,1737079070.314252,-21600,,
com.microsoft.VSCode,2,1737079058,1737079060,1737079060.949441,-21600,,
com.apple.finder,0,1737079058,1737079058,1737079058.850373,-21600,,
com.microsoft.VSCode,264,1737078794,1737079058,1737079058.4305038,-21600,,
com.apple.finder,1,1737078793,1737078794,1737078794.710963,-21600,,
com.google.Chrome,0,1737078793,1737078793,1737078794.003483,-21600,,
com.apple.finder,2,1737078791,1737078793,1737078793.0918431,-21600,,
com.microsoft.VSCode,14,1737078777,1737078791,1737078791.756829,-21600,,
com.apple.finder,43,1737078734,1737078777,1737078777.965252,-21600,,
com.microsoft.VSCode,0,1737078734,1737078734,1737078735.023133,-21600,,
com.google.Chrome,268,1737078466,1737078734,1737078734.195551,-21600,,
com.google.android.studio,1,1737078465,1737078466,1737078466.17172,-21600,,
com.google.Chrome,2,1737078463,1737078465,1737078465.470131,-21600,,
com.google.android.studio,1,1737078462,1737078463,1737078463.7340078,-21600,,
com.google.Chrome,4,1737078458,1737078462,1737078462.801618,-21600,,
com.google.android.studio,0,1737078458,1737078458,1737078458.597845,-21600,,
com.google.Chrome,16,1737078442,1737078458,1737078458.080999,-21600,,
com.google.android.studio,1,1737078441,1737078442,1737078442.935007,-21600,,
com.google.Chrome,3,1737078438,1737078441,1737078441.066544,-21600,,
com.google.android.studio,2,1737078436,1737078438,1737078438.818012,-21600,,
com.google.Chrome,2,1737078434,1737078436,1737078436.886872,-21600,,
com.google.android.studio,2,1737078432,1737078434,1737078434.973963,-21600,,
com.google.Chrome,7,1737078425,1737078432,1737078432.894786,-21600,,
com.google.android.studio,5,1737078420,1737078425,1737078425.915897,-21600,,
com.google.Chrome,28,1737078392,1737078420,1737078420.68113,-21600,,
com.google.android.studio,47,1737078345,1737078392,1737078392.447233,-21600,,
com.apple.finder,3,1737078342,1737078345,1737078345.1980538,-21600,,
com.google.Chrome,540,1737077802,1737078342,1737078342.351223,-21600,,
com.google.Chrome,346,1737077018,1737077364,1737077364.947109,-21600,,
com.google.android.studio,127,1737076891,1737077018,1737077018.86272,-21600,,
com.microsoft.onenote.mac,57,1737076834,1737076891,1737076891.319789,-21600,,
com.google.android.studio,1062,1737075772,1737076834,1737076834.85058,-21600,,
com.apple.finder,46,1737075726,1737075772,1737075772.727024,-21600,,
com.google.android.studio,11,1737075715,1737075726,1737075726.717423,-21600,,
com.apple.finder,63,1737075652,1737075715,1737075715.2457829,-21600,,
com.google.android.studio,3,1737075649,1737075652,1737075652.3247662,-21600,,
com.apple.finder,15,1737075634,1737075649,1737075649.2794452,-21600,,
com.google.android.studio,12,1737075622,1737075634,1737075634.452874,-21600,,
com.apple.finder,17,1737075605,1737075622,1737075622.079009,-21600,,
com.google.android.studio,1,1737075604,1737075605,1737075605.581372,-21600,,
com.apple.finder,13,1737075591,1737075604,1737075604.820456,-21600,,
com.apple.archiveutility,1,1737075590,1737075591,1737075591.065648,-21600,,
com.apple.finder,8,1737075582,1737075590,1737075590.211289,-21600,,
com.google.android.studio,1,1737075581,1737075582,1737075582.5733318,-21600,,
com.apple.finder,39,1737075542,1737075581,1737075581.9873052,-21600,,
com.google.android.studio,1,1737075541,1737075542,1737075542.1275659,-21600,,
com.apple.finder,26,1737075515,1737075541,1737075542.008936,-21600,,
com.google.android.studio,18,1737075497,1737075515,1737075515.166075,-21600,,
com.apple.finder,4,1737075493,1737075497,1737075497.710548,-21600,,
com.google.android.studio,1,1737075492,1737075493,1737075493.674416,-21600,,
com.apple.finder,2,1737075490,1737075492,1737075492.109247,-21600,,
com.google.android.studio,8,1737075482,1737075490,1737075490.507267,-21600,,
com.apple.finder,15,1737075467,1737075482,1737075482.1105828,-21600,,
com.google.android.studio,17,1737075450,1737075467,1737075467.6642299,-21600,,
com.apple.finder,3,1737075392,1737075395,1737075395.243612,-21600,,
com.google.android.studio,5,1737075387,1737075392,1737075392.4778662,-21600,,
com.apple.finder,8,1737075379,1737075387,1737075387.580441,-21600,,
com.google.android.studio,16,1737075363,1737075379,1737075380.083257,-21600,,
com.apple.finder,5,1737075358,1737075363,1737075363.492302,-21600,,
com.microsoft.VSCode,1,1737075357,1737075358,1737075358.5995212,-21600,,
com.apple.finder,10,1737075347,1737075357,1737075357.643437,-21600,,
com.google.android.studio,10,1737075337,1737075347,1737075347.230791,-21600,,
com.apple.finder,17,1737075320,1737075337,1737075337.482139,-21600,,
com.google.android.studio,10,1737075310,1737075320,1737075320.651438,-21600,,
com.apple.finder,11,1737075299,1737075310,1737075310.97866,-21600,,
com.google.android.studio,2,1737075297,1737075299,1737075299.783776,-21600,,
com.apple.finder,17,1737075280,1737075297,1737075297.535382,-21600,,
com.google.android.studio,16,1737075264,1737075280,1737075280.49683,-21600,,
com.apple.finder,10,1737075254,1737075264,1737075264.459134,-21600,,
com.microsoft.VSCode,2,1737075252,1737075254,1737075254.06317,-21600,,
com.google.android.studio,14,1737075238,1737075252,1737075252.6942558,-21600,,
com.microsoft.VSCode,3,1737075235,1737075238,1737075238.100776,-21600,,
com.google.android.studio,3,1737075232,1737075235,1737075235.135511,-21600,,
com.microsoft.VSCode,8,1737075224,1737075232,1737075232.559534,-21600,,
com.apple.finder,11,1737075213,1737075224,1737075225.054102,-21600,,
com.microsoft.VSCode,11,1737075202,1737075213,1737075213.822579,-21600,,
com.apple.finder,209,1737074993,1737075202,1737075202.8364549,-21600,,
com.apple.dt.Xcode,6,1737074987,1737074993,1737074993.69811,-21600,,
com.apple.finder,13,1737074974,1737074987,1737074987.78369,-21600,,
com.apple.dt.Xcode,14,1737074960,1737074974,1737074974.581212,-21600,,
com.apple.finder,4,1737074956,1737074960,1737074960.837338,-21600,,
com.google.Chrome,4,1737074952,1737074956,1737074956.46088,-21600,,
com.microsoft.VSCode,2,1737074950,1737074952,1737074952.381618,-21600,,
com.apple.finder,38,1737074912,1737074950,1737074950.801783,-21600,,
com.microsoft.VSCode,5,1737074907,1737074912,1737074912.759437,-21600,,
com.apple.finder,21,1737074886,1737074907,1737074907.372994,-21600,,
com.microsoft.VSCode,9,1737074877,1737074886,1737074886.236672,-21600,,
com.apple.finder,65,1737074812,1737074877,1737074877.9038281,-21600,,
com.microsoft.VSCode,3,1737074809,1737074812,1737074812.4268851,-21600,,
com.apple.finder,3,1737074806,1737074809,1737074810.0860682,-21600,,
com.microsoft.VSCode,2,1737074804,1737074806,1737074807.358468,-21600,,
com.apple.finder,3,1737074801,1737074804,1737074804.946512,-21600,,
com.microsoft.VSCode,95,1737074706,1737074801,1737074801.420356,-21600,,
com.google.Chrome,47,1737074659,1737074706,1737074706.923033,-21600,,
com.microsoft.VSCode,75,1737074584,1737074659,1737074659.5193439,-21600,,
com.apple.finder,33,1737074551,1737074584,1737074584.286501,-21600,,
com.google.android.studio,15,1737074536,1737074551,1737074551.504303,-21600,,
com.google.Chrome,49,1737074487,1737074536,1737074537.110712,-21600,,
com.google.android.studio,165,1737074322,1737074487,1737074487.767336,-21600,,
com.apple.finder,35,1737074287,1737074322,1737074322.133925,-21600,,
com.google.android.studio,1,1737074286,1737074287,1737074287.398604,-21600,,
com.apple.dt.Xcode,2,1737074284,1737074286,1737074286.288203,-21600,,
com.google.Chrome,43,1737074241,1737074284,1737074284.507581,-21600,,
com.google.android.studio,44,1737074197,1737074241,1737074241.552609,-21600,,
com.apple.dt.Xcode,4,1737074193,1737074197,1737074197.3361769,-21600,,
com.microsoft.onenote.mac,9,1737074184,1737074193,1737074193.475882,-21600,,
com.google.android.studio,94,1737074090,1737074184,1737074184.9401522,-21600,,
com.apple.dt.Xcode,5,1737074085,1737074090,1737074090.18041,-21600,,
com.google.android.studio,588,1737073497,1737074085,1737074085.364006,-21600,,
com.google.Chrome,1,1737073496,1737073497,1737073497.7328691,-21600,,
com.google.android.studio,7,1737073489,1737073496,1737073496.6973228,-21600,,
com.google.Chrome,7,1737073482,1737073489,1737073489.12355,-21600,,
com.google.android.studio,1,1737073481,1737073482,1737073482.298594,-21600,,
com.google.Chrome,7,1737073474,1737073481,1737073481.713233,-21600,,
com.google.android.studio,61,1737073413,1737073474,1737073474.750091,-21600,,
com.google.Chrome,17,1737073396,1737073413,1737073413.918661,-21600,,
com.google.android.studio,186,1737073210,1737073396,1737073398.8470058,-21600,,
com.apple.dt.Xcode,5,1737073205,1737073210,1737073210.1831799,-21600,,
com.google.android.studio,7,1737073198,1737073205,1737073205.144181,-21600,,
com.apple.dt.Xcode,5,1737073193,1737073198,1737073198.7142282,-21600,,
com.google.android.studio,10,1737073183,1737073193,1737073193.830513,-21600,,
com.apple.dt.Xcode,2,1737073181,1737073183,1737073183.9749389,-21600,,
com.google.android.studio,4,1737073177,1737073181,1737073181.7099972,-21600,,
com.apple.dt.Xcode,3,1737073174,1737073177,1737073178.02279,-21600,,
com.google.android.studio,11,1737073163,1737073174,1737073174.152668,-21600,,
com.apple.dt.Xcode,37,1737073126,1737073163,1737073163.451045,-21600,,
com.google.android.studio,132,1737072994,1737073126,1737073126.175978,-21600,,
com.microsoft.onenote.mac,31,1737072892,1737072923,1737072923.580332,-21600,,
com.microsoft.onenote.mac,315,1737070954,1737071269,1737071269.2273211,-21600,,
com.google.Chrome,447,1737070507,1737070954,1737070955.307742,-21600,,
com.microsoft.onenote.mac,206,1737070301,1737070507,1737070507.63581,-21600,,
com.google.Chrome,20,1737070281,1737070301,1737070301.39223,-21600,,
com.apple.dt.Xcode,4,1737070277,1737070281,1737070281.906341,-21600,,
com.google.android.studio,89,1737070188,1737070277,1737070277.3846312,-21600,,
com.apple.finder,2,1737070186,1737070188,1737070188.404008,-21600,,
com.apple.dt.Xcode,7,1737070179,1737070186,1737070186.849935,-21600,,
com.apple.finder,4,1737070175,1737070179,1737070179.630666,-21600,,
com.google.android.studio,61,1737070114,1737070175,1737070175.495813,-21600,,
com.google.Chrome,7,1737070107,1737070114,1737070114.444133,-21600,,
com.google.android.studio,26,1737070081,1737070107,1737070107.862469,-21600,,
com.microsoft.onenote.mac,3,1737070078,1737070081,1737070081.161376,-21600,,
com.google.android.studio,8,1737070068,1737070076,1737070076.912249,-21600,,
com.microsoft.onenote.mac,5,1737070063,1737070068,1737070068.152699,-21600,,
com.google.android.studio,188,1737069875,1737070063,1737070063.642443,-21600,,
com.microsoft.onenote.mac,8,1737069867,1737069875,1737069875.431777,-21600,,
com.google.android.studio,57,1737069810,1737069867,1737069867.60625,-21600,,
com.google.Chrome,17,1737069793,1737069810,1737069810.926964,-21600,,
com.google.android.studio,3,1737069790,1737069793,1737069793.4946861,-21600,,
com.google.Chrome,32,1737069758,1737069790,1737069790.355476,-21600,,
com.google.android.studio,348,1737069410,1737069758,1737069758.696218,-21600,,
com.google.Chrome,11,1737069399,1737069410,1737069410.844589,-21600,,
com.google.android.studio,9,1737069390,1737069399,1737069399.0852718,-21600,,
com.google.Chrome,19,1737069371,1737069390,1737069390.5660539,-21600,,
com.google.android.studio,11,1737069360,1737069371,1737069371.683945,-21600,,
com.google.Chrome,21,1737069339,1737069360,1737069360.1530051,-21600,,
com.google.android.studio,2,1737069337,1737069339,1737069339.1068811,-21600,,
com.google.Chrome,3,1737069334,1737069337,1737069337.711427,-21600,,
com.google.android.studio,15,1737069319,1737069334,1737069334.875358,-21600,,
com.google.Chrome,14,1737069305,1737069319,1737069319.441965,-21600,,
com.google.android.studio,118,1737069187,1737069305,1737069305.3579612,-21600,,
com.google.Chrome,132,1737069055,1737069187,1737069188.053813,-21600,,
com.google.android.studio,3,1737069052,1737069055,1737069055.800832,-21600,,
com.google.Chrome,8,1737069044,1737069052,1737069052.281244,-21600,,
com.google.android.studio,1,1737069043,1737069044,1737069044.4429688,-21600,,
com.google.Chrome,0,1737069043,1737069043,1737069043.981175,-21600,,
com.google.android.studio,2,1737069041,1737069043,1737069043.1566272,-21600,,
com.google.Chrome,11,1737069030,1737069041,1737069041.142021,-21600,,
com.google.android.studio,1,1737069029,1737069030,1737069030.5979118,-21600,,
com.google.Chrome,9,1737069020,1737069029,1737069029.721498,-21600,,
com.google.android.studio,121,1737068899,1737069020,1737069020.998235,-21600,,
com.google.Chrome,8,1737068891,1737068899,1737068899.047107,-21600,,
com.apple.finder,11,1737068880,1737068891,1737068891.380186,-21600,,
com.google.android.studio,1,1737068879,1737068880,1737068880.7324162,-21600,,
com.google.Chrome,4,1737068875,1737068879,1737068879.430201,-21600,,
com.google.android.studio,4,1737068871,1737068875,1737068875.462403,-21600,,
com.google.Chrome,18,1737068853,1737068871,1737068871.972427,-21600,,
com.google.android.studio,13,1737068840,1737068853,1737068853.187917,-21600,,
com.apple.finder,20,1737068820,1737068840,1737068840.191039,-21600,,
com.microsoft.onenote.mac,4,1737068816,1737068820,1737068820.83461,-21600,,
com.google.Chrome,30,1737068786,1737068816,1737068816.3981152,-21600,,
com.microsoft.onenote.mac,4,1737068782,1737068786,1737068786.545196,-21600,,
com.apple.finder,46,1737068736,1737068782,1737068782.568304,-21600,,
com.google.Chrome,15,1737068721,1737068736,1737068736.585505,-21600,,
com.google.android.studio,1,1737068720,1737068721,1737068721.703452,-21600,,
com.microsoft.onenote.mac,2,1737068718,1737068720,1737068720.610105,-21600,,
com.google.android.studio,5,1737068713,1737068718,1737068719.058398,-21600,,
com.google.Chrome,107,1737068606,1737068713,1737068713.854106,-21600,,
com.google.android.studio,3,1737068603,1737068606,1737068606.367379,-21600,,
com.google.Chrome,46,1737068557,1737068603,1737068603.177609,-21600,,
com.google.android.studio,7,1737068550,1737068557,1737068557.873242,-21600,,
com.google.Chrome,47,1737068503,1737068550,1737068550.98977,-21600,,
com.google.android.studio,18,1737068485,1737068503,1737068503.1963549,-21600,,
com.google.Chrome,20,1737068465,1737068485,1737068485.1096811,-21600,,
com.google.android.studio,18,1737068447,1737068465,1737068465.194254,-21600,,
com.microsoft.onenote.mac,3,1737068444,1737068447,1737068447.67657,-21600,,
com.google.android.studio,0,1737068444,1737068444,1737068444.954078,-21600,,
com.microsoft.onenote.mac,2,1737068442,1737068444,1737068444.468183,-21600,,
com.google.android.studio,21,1737068421,1737068442,1737068442.406713,-21600,,
com.microsoft.onenote.mac,2,1737068419,1737068421,1737068421.6321712,-21600,,
com.google.android.studio,4,1737068415,1737068419,1737068419.4352221,-21600,,
com.microsoft.onenote.mac,1,1737068414,1737068415,1737068415.268945,-21600,,
com.google.android.studio,5,1737068409,1737068414,1737068414.243371,-21600,,
com.microsoft.onenote.mac,1,1737068408,1737068409,1737068409.281837,-21600,,
com.google.android.studio,2,1737068406,1737068408,1737068408.795552,-21600,,
com.microsoft.onenote.mac,2,1737068404,1737068406,1737068406.478431,-21600,,
com.google.android.studio,3,1737068401,1737068404,1737068404.93909,-21600,,
com.microsoft.onenote.mac,28,1737068373,1737068401,1737068401.702392,-21600,,
com.google.android.studio,1,1737068372,1737068373,1737068373.594717,-21600,,
com.microsoft.onenote.mac,13,1737068359,1737068372,1737068372.7488918,-21600,,
com.google.android.studio,4,1737068355,1737068359,1737068359.274477,-21600,,
com.microsoft.onenote.mac,19,1737068336,1737068355,1737068355.404949,-21600,,
com.google.android.studio,1,1737068335,1737068336,1737068336.9564118,-21600,,
com.microsoft.onenote.mac,18,1737068317,1737068335,1737068335.314868,-21600,,
com.google.android.studio,365,1737067952,1737068317,1737068317.52336,-21600,,
com.microsoft.onenote.mac,5,1737067947,1737067952,1737067952.468371,-21600,,
com.google.android.studio,130,1737067817,1737067947,1737067947.622741,-21600,,
com.microsoft.onenote.mac,8,1737067809,1737067817,1737067817.254601,-21600,,
com.apple.dt.Xcode,11,1737067798,1737067809,1737067809.813801,-21600,,
com.microsoft.onenote.mac,50,1737067748,1737067798,1737067798.276638,-21600,,
com.google.android.studio,180,1737067568,1737067748,1737067748.805066,-21600,,
com.microsoft.onenote.mac,2,1737067566,1737067568,1737067568.9008431,-21600,,
com.google.android.studio,176,1737067390,1737067566,1737067566.398458,-21600,,
com.microsoft.onenote.mac,8,1737067382,1737067390,1737067391.0567021,-21600,,
com.apple.dt.Xcode,34,1737067348,1737067382,1737067382.072681,-21600,,
com.google.android.studio,152,1737067196,1737067348,1737067348.642447,-21600,,
com.apple.dt.Xcode,13,1737067183,1737067196,1737067196.5802999,-21600,,
com.microsoft.onenote.mac,6,1737067177,1737067183,1737067183.9084601,-21600,,
com.apple.dt.Xcode,3,1737067174,1737067177,1737067177.902905,-21600,,
com.microsoft.onenote.mac,10,1737067164,1737067174,1737067174.726474,-21600,,
com.google.android.studio,16,1737067148,1737067164,1737067165.04899,-21600,,
com.apple.dt.Xcode,11,1737067137,1737067148,1737067148.867093,-21600,,
com.google.android.studio,13,1737067124,1737067137,1737067137.073432,-21600,,
com.microsoft.onenote.mac,27,1737067097,1737067124,1737067124.9569201,-21600,,
com.apple.dt.Xcode,3,1737067094,1737067097,1737067097.29617,-21600,,
com.microsoft.onenote.mac,6,1737067088,1737067094,1737067094.277416,-21600,,
com.apple.dt.Xcode,3,1737067085,1737067088,1737067088.217917,-21600,,
com.microsoft.onenote.mac,2,1737067083,1737067085,1737067086.066292,-21600,,
com.google.android.studio,6,1737067077,1737067083,1737067083.758449,-21600,,
com.microsoft.onenote.mac,7,1737067070,1737067077,1737067077.512022,-21600,,
com.apple.dt.Xcode,3,1737067067,1737067070,1737067070.138795,-21600,,
com.microsoft.onenote.mac,5,1737067062,1737067067,1737067067.047251,-21600,,
com.apple.dt.Xcode,3,1737067059,1737067062,1737067062.688191,-21600,,
com.microsoft.onenote.mac,5,1737067054,1737067059,1737067059.627806,-21600,,
com.apple.dt.Xcode,3,1737067051,1737067054,1737067054.099275,-21600,,
com.google.android.studio,2,1737067049,1737067051,1737067051.203776,-21600,,
com.microsoft.onenote.mac,6,1737067043,1737067049,1737067049.342329,-21600,,
com.google.android.studio,1,1737067042,1737067043,1737067043.610067,-21600,,
com.apple.dt.Xcode,34,1737067008,1737067042,1737067042.232154,-21600,,
com.google.android.studio,4,1737067004,1737067008,1737067008.083576,-21600,,
com.apple.dt.Xcode,3,1737067001,1737067004,1737067004.5125,-21600,,
com.google.android.studio,1,1737067000,1737067001,1737067001.923145,-21600,,
com.microsoft.onenote.mac,16,1737066984,1737067000,1737067000.2496328,-21600,,
com.google.android.studio,12,1737066972,1737066984,1737066984.3786778,-21600,,
com.apple.dt.Xcode,17,1737066955,1737066972,1737066972.083232,-21600,,
com.google.android.studio,1,1737066954,1737066955,1737066955.946861,-21600,,
com.apple.dt.Xcode,9,1737066945,1737066954,1737066954.5389838,-21600,,
com.google.android.studio,6,1737066939,1737066945,1737066945.598964,-21600,,
com.apple.dt.Xcode,2,1737066937,1737066939,1737066939.4669662,-21600,,
com.google.android.studio,6,1737066931,1737066937,1737066937.3497891,-21600,,
com.apple.dt.Xcode,19,1737066912,1737066931,1737066931.9367828,-21600,,
com.google.android.studio,12,1737066900,1737066912,1737066912.523489,-21600,,
com.microsoft.onenote.mac,4,1737066896,1737066900,1737066900.9467878,-21600,,
com.google.android.studio,66,1737066830,1737066896,1737066896.1766891,-21600,,
com.microsoft.onenote.mac,7,1737066823,1737066830,1737066831.0226378,-21600,,
com.google.android.studio,2902,1737063921,1737066823,1737066823.2724628,-21600,,
com.apple.dt.Xcode,2,1737063919,1737063921,1737063921.366739,-21600,,
com.google.android.studio,1049,1737062870,1737063919,1737063919.333334,-21600,,
com.google.Chrome,16,1737062854,1737062870,1737062870.315024,-21600,,
com.google.android.studio,2099,1737060755,1737062854,1737062854.6744561,-21600,,
com.microsoft.onenote.mac,7,1737060748,1737060755,1737060755.191628,-21600,,
com.google.android.studio,221,1737060527,1737060748,1737060748.632602,-21600,,
com.google.Chrome,9,1737060518,1737060527,1737060527.496531,-21600,,
com.google.android.studio,5,1737060513,1737060518,1737060518.292031,-21600,,
com.google.Chrome,11,1737060502,1737060513,1737060513.259107,-21600,,
com.google.android.studio,12,1737060490,1737060502,1737060503.0203009,-21600,,
com.google.Chrome,5,1737060485,1737060490,1737060490.531126,-21600,,
com.google.android.studio,3,1737060482,1737060485,1737060485.252287,-21600,,
com.google.Chrome,35,1737060447,1737060482,1737060482.6741738,-21600,,
com.google.android.studio,4,1737060443,1737060447,1737060447.599236,-21600,,
com.google.Chrome,10,1737060433,1737060443,1737060443.804419,-21600,,
com.google.android.studio,3,1737060430,1737060433,1737060433.190511,-21600,,
com.google.Chrome,12,1737060418,1737060430,1737060430.094455,-21600,,
com.google.android.studio,84,1737060334,1737060418,1737060418.106734,-21600,,
com.google.Chrome,13,1737060321,1737060334,1737060334.459412,-21600,,
com.google.android.studio,215,1737060106,1737060321,1737060321.31292,-21600,,
com.google.Chrome,4,1737060102,1737060106,1737060106.2586231,-21600,,
com.google.android.studio,785,1737059317,1737060102,1737060102.491867,-21600,,
com.google.Chrome,9,1737059308,1737059317,1737059317.938463,-21600,,
com.google.android.studio,86,1737059222,1737059308,1737059308.989685,-21600,,
com.google.Chrome,16,1737059206,1737059222,1737059222.755745,-21600,,
com.google.android.studio,36,1737059170,1737059206,1737059206.951314,-21600,,
com.google.Chrome,17,1737059153,1737059170,1737059170.572019,-21600,,
com.google.android.studio,22,1737059131,1737059153,1737059153.8693252,-21600,,
com.microsoft.onenote.mac,5,1737059126,1737059131,1737059131.364172,-21600,,
com.google.Chrome,56,1737059070,1737059126,1737059126.2107239,-21600,,
com.microsoft.onenote.mac,10,1737059060,1737059070,1737059070.993504,-21600,,
com.google.Chrome,2,1737059058,1737059060,1737059060.389714,-21600,,
com.google.Chrome,14,1737057826,1737057840,1737057840.695428,-21600,,
com.microsoft.onenote.mac,2,1737057806,1737057808,1737057809.153219,-21600,,
com.microsoft.onenote.mac,335,1737000509,1737000844,1737000844.910935,-21600,,
com.google.Chrome,2,1737000507,1737000509,1737000510.230102,-21600,,
com.apple.iphonesimulator,1,1737000506,1737000507,1737000508.1689072,-21600,,
com.google.android.studio,85,1737000421,1737000506,1737000506.234314,-21600,,
com.apple.dt.Xcode,5,1737000416,1737000421,1737000421.7845678,-21600,,
com.apple.iphonesimulator,31,1737000385,1737000416,1737000416.993485,-21600,,
com.apple.dt.Xcode,80,1737000274,1737000354,1737000355.04703,-21600,,
com.google.android.studio,188,1737000086,1737000274,1737000274.688086,-21600,,
com.apple.dt.Xcode,23,1737000063,1737000086,1737000086.9084349,-21600,,
com.google.android.studio,778,1736999285,1737000063,1737000063.542598,-21600,,
com.google.Chrome,17,1736999268,1736999285,1736999285.68541,-21600,,
com.google.android.studio,312,1736998956,1736999268,1736999268.80707,-21600,,
com.google.Chrome,6,1736998950,1736998956,1736998956.5709429,-21600,,
com.google.android.studio,3,1736998947,1736998950,1736998950.365372,-21600,,
com.google.Chrome,41,1736998906,1736998947,1736998947.659548,-21600,,
com.google.android.studio,103,1736998803,1736998906,1736998906.2710981,-21600,,
com.google.Chrome,2,1736998801,1736998803,1736998803.8001761,-21600,,
com.google.android.studio,6,1736998795,1736998801,1736998801.593399,-21600,,
com.google.Chrome,7,1736998788,1736998795,1736998795.810555,-21600,,
com.google.android.studio,1,1736998787,1736998788,1736998788.970125,-21600,,
com.google.Chrome,1,1736998786,1736998787,1736998787.2533941,-21600,,
com.google.android.studio,3,1736998783,1736998786,1736998786.114203,-21600,,
com.google.Chrome,35,1736998748,1736998783,1736998783.946898,-21600,,
com.google.android.studio,6,1736998742,1736998748,1736998748.093622,-21600,,
com.google.Chrome,28,1736998714,1736998742,1736998742.592696,-21600,,
com.google.android.studio,359,1736998355,1736998714,1736998714.428838,-21600,,
com.apple.dt.Xcode,1,1736998354,1736998355,1736998355.768302,-21600,,
com.google.android.studio,4,1736998350,1736998354,1736998354.393486,-21600,,
com.apple.dt.Xcode,2,1736998348,1736998350,1736998350.3061619,-21600,,
com.google.android.studio,7,1736998341,1736998348,1736998348.696375,-21600,,
com.apple.dt.Xcode,11,1736998330,1736998341,1736998341.577044,-21600,,
com.google.android.studio,65,1736998265,1736998330,1736998330.9888558,-21600,,
com.apple.dt.Xcode,3,1736998262,1736998265,1736998265.4376922,-21600,,
com.google.android.studio,30,1736998232,1736998262,1736998262.715661,-21600,,
com.apple.dt.Xcode,2,1736998230,1736998232,1736998232.2359939,-21600,,
com.google.android.studio,2,1736998228,1736998230,1736998230.715157,-21600,,
com.apple.dt.Xcode,2,1736998226,1736998228,1736998228.58406,-21600,,
com.google.android.studio,6,1736998220,1736998226,1736998226.1855202,-21600,,
com.apple.dt.Xcode,3,1736998217,1736998220,1736998220.961309,-21600,,
com.google.android.studio,3,1736998214,1736998217,1736998217.865413,-21600,,
com.apple.dt.Xcode,2,1736998212,1736998214,1736998214.344596,-21600,,
com.google.android.studio,4,1736998208,1736998212,1736998212.9956589,-21600,,
com.apple.dt.Xcode,4,1736998204,1736998208,1736998208.751452,-21600,,
com.google.android.studio,14,1736998190,1736998204,1736998204.737436,-21600,,
com.apple.dt.Xcode,1,1736998189,1736998190,1736998190.5080261,-21600,,
com.google.android.studio,15,1736998174,1736998189,1736998189.313931,-21600,,
com.apple.dt.Xcode,17,1736998157,1736998174,1736998174.991256,-21600,,
com.google.android.studio,36,1736998121,1736998157,1736998157.044636,-21600,,
com.microsoft.onenote.mac,22,1736998099,1736998121,1736998121.813873,-21600,,
com.google.android.studio,397,1736997702,1736998099,1736998099.437386,-21600,,
com.google.Chrome,0,1736997702,1736997702,1736997702.7148929,-21600,,
com.google.android.studio,69,1736997633,1736997702,1736997702.203062,-21600,,
com.google.Chrome,1,1736997632,1736997633,1736997633.84813,-21600,,
com.google.android.studio,549,1736997083,1736997632,1736997632.9869518,-21600,,
com.google.Chrome,134,1736996949,1736997083,1736997083.1720638,-21600,,
com.google.Chrome,300,1736996203,1736996503,1736996503.997571,-21600,,
com.google.Chrome,778,1736995209,1736995987,1736995987.513009,-21600,,
com.google.Chrome,303,1736994835,1736995138,1736995138.323464,-21600,,
com.google.Chrome,723,1736993950,1736994673,1736994673.091761,-21600,,
com.google.Chrome,428,1736993435,1736993863,1736993864.0056381,-21600,,
com.google.Chrome,427,1736992979,1736993406,1736993406.035218,-21600,,
com.google.Chrome,300,1736992669,1736992969,1736992969.4105492,-21600,,
com.google.Chrome,596,1736991759,1736992355,1736992355.5306602,-21600,,
com.microsoft.onenote.mac,8,1736991751,1736991759,1736991759.304373,-21600,,
com.microsoft.onenote.mac,314,1736991418,1736991732,1736991732.2552462,-21600,,
com.google.android.studio,345,1736991073,1736991418,1736991418.3456268,-21600,,
com.google.Chrome,39,1736991034,1736991073,1736991073.270543,-21600,,
com.google.android.studio,1,1736991033,1736991034,1736991034.6351972,-21600,,
com.apple.dt.Xcode,28,1736991005,1736991033,1736991033.337187,-21600,,
com.google.android.studio,4,1736991001,1736991005,1736991005.6036901,-21600,,
com.google.Chrome,63,1736990938,1736991001,1736991001.4935598,-21600,,
com.google.android.studio,434,1736990504,1736990938,1736990938.938405,-21600,,
com.google.Chrome,3,1736990501,1736990504,1736990504.443777,-21600,,
com.google.android.studio,1824,1736988677,1736990501,1736990501.714038,-21600,,
com.apple.Music,41,1736988596,1736988637,1736988637.1365662,-21600,,
com.google.Chrome,113,1736988483,1736988596,1736988596.609036,-21600,,
com.google.Chrome,355,1736984351,1736984706,1736984707.193676,-21600,,
com.google.android.studio,9,1736984342,1736984351,1736984351.116168,-21600,,
com.google.Chrome,2,1736984340,1736984342,1736984343.262363,-21600,,
com.microsoft.onenote.mac,160,1736984180,1736984340,1736984342.84183,-21600,,
com.google.Chrome,4,1736984176,1736984180,1736984182.373664,-21600,,
com.google.android.studio,1101,1736983075,1736984176,1736984176.4293962,-21600,,
com.apple.dt.Xcode,1,1736983074,1736983075,1736983075.187666,-21600,,
com.google.Chrome,1,1736983073,1736983074,1736983074.1529899,-21600,,
com.apple.dt.Xcode,1,1736983072,1736983073,1736983073.756671,-21600,,
com.google.android.studio,1,1736983071,1736983072,1736983072.47564,-21600,,
com.apple.dt.Xcode,32,1736983039,1736983071,1736983071.104466,-21600,,
com.google.android.studio,124,1736982915,1736983039,1736983039.3219151,-21600,,
com.apple.dt.Xcode,8,1736982907,1736982915,1736982915.75066,-21600,,
com.google.Chrome,4,1736982903,1736982907,1736982907.2797399,-21600,,
com.apple.dt.Xcode,5,1736982898,1736982903,1736982903.7520552,-21600,,
com.google.Chrome,37,1736982861,1736982898,1736982898.8369532,-21600,,
com.apple.dt.Xcode,17,1736982844,1736982861,1736982861.6173902,-21600,,
com.google.android.studio,70,1736982774,1736982844,1736982844.4157162,-21600,,
com.apple.dt.Xcode,2,1736982772,1736982774,1736982774.5564408,-21600,,
com.google.android.studio,15,1736982757,1736982772,1736982772.202373,-21600,,
com.apple.dt.Xcode,6,1736982706,1736982712,1736982712.981847,-21600,,
com.google.android.studio,11,1736982695,1736982706,1736982706.9274611,-21600,,
com.google.android.studio,8,1736982257,1736982265,1736982266.304687,-21600,,
com.microsoft.onenote.mac,13,1736982244,1736982257,1736982257.7702951,-21600,,
com.google.android.studio,1,1736982243,1736982244,1736982244.649833,-21600,,
com.microsoft.onenote.mac,10,1736982233,1736982243,1736982243.235053,-21600,,
com.google.android.studio,16,1736982217,1736982233,1736982233.2501621,-21600,,
com.microsoft.onenote.mac,24,1736982193,1736982217,1736982217.118979,-21600,,
com.google.android.studio,17,1736982176,1736982193,1736982193.189773,-21600,,
com.apple.dt.Xcode,20,1736982156,1736982176,1736982176.8650389,-21600,,
com.google.android.studio,56,1736982100,1736982156,1736982156.8304482,-21600,,
com.apple.dt.Xcode,3,1736982097,1736982100,1736982101.250848,-21600,,
com.google.Chrome,6,1736982091,1736982097,1736982097.4935431,-21600,,
com.google.android.studio,179,1736981912,1736982091,1736982091.9045382,-21600,,
com.google.Chrome,5,1736981907,1736981912,1736981912.430646,-21600,,
com.google.android.studio,6,1736981901,1736981907,1736981907.8900862,-21600,,
com.apple.dt.Xcode,1,1736981900,1736981901,1736981901.937622,-21600,,
com.google.android.studio,108,1736981792,1736981900,1736981900.449362,-21600,,
com.google.Chrome,88,1736981704,1736981792,1736981792.253989,-21600,,
com.google.android.studio,6,1736981698,1736981704,1736981704.931396,-21600,,
com.google.Chrome,64,1736981634,1736981698,1736981699.062296,-21600,,
com.google.android.studio,227,1736981407,1736981634,1736981634.209509,-21600,,
com.google.Chrome,1,1736981406,1736981407,1736981407.267863,-21600,,
com.google.android.studio,674,1736980732,1736981406,1736981406.654519,-21600,,
com.google.Chrome,7,1736980725,1736980732,1736980732.781981,-21600,,
com.google.android.studio,3,1736980722,1736980725,1736980725.94906,-21600,,
com.google.Chrome,79,1736980643,1736980722,1736980722.5669,-21600,,
com.google.android.studio,7,1736980636,1736980643,1736980643.63765,-21600,,
com.google.Chrome,21,1736980615,1736980636,1736980636.245245,-21600,,
com.google.android.studio,43,1736980572,1736980615,1736980615.626523,-21600,,
com.google.Chrome,86,1736980486,1736980572,1736980572.349766,-21600,,
com.google.android.studio,55,1736980431,1736980486,1736980486.1744142,-21600,,
com.google.Chrome,43,1736980388,1736980431,1736980431.9886022,-21600,,
com.google.android.studio,53,1736980335,1736980388,1736980388.310234,-21600,,
com.google.Chrome,7,1736980328,1736980335,1736980335.5031738,-21600,,
com.google.android.studio,32,1736980296,1736980328,1736980328.209573,-21600,,
com.google.Chrome,8,1736980288,1736980296,1736980297.167388,-21600,,
com.google.android.studio,70,1736980218,1736980288,1736980288.444536,-21600,,
com.apple.dt.Xcode,6,1736980212,1736980218,1736980218.9433188,-21600,,
com.google.android.studio,27,1736980185,1736980212,1736980212.641901,-21600,,
com.apple.dt.Xcode,4,1736980181,1736980185,1736980185.434762,-21600,,
com.google.android.studio,10,1736980171,1736980181,1736980181.175647,-21600,,
com.apple.dt.Xcode,2,1736980169,1736980171,1736980171.250496,-21600,,
com.google.android.studio,13,1736980156,1736980169,1736980169.6482081,-21600,,
com.google.Chrome,23,1736980133,1736980156,1736980156.41671,-21600,,
com.google.android.studio,0,1736980133,1736980133,1736980133.973274,-21600,,
com.apple.dt.Xcode,2,1736980131,1736980133,1736980133.357269,-21600,,
com.google.android.studio,15,1736980116,1736980131,1736980131.9737911,-21600,,
com.apple.dt.Xcode,3,1736980113,1736980116,1736980116.362318,-21600,,
com.google.Chrome,108,1736980005,1736980113,1736980113.809708,-21600,,
com.apple.dt.Xcode,2,1736980003,1736980005,1736980005.9582481,-21600,,
com.google.Chrome,37,1736979966,1736980003,1736980003.186271,-21600,,
com.apple.dt.Xcode,2,1736979964,1736979966,1736979966.113278,-21600,,
com.google.Chrome,40,1736979924,1736979964,1736979964.904105,-21600,,
com.apple.dt.Xcode,30,1736979894,1736979924,1736979924.4930658,-21600,,
com.google.android.studio,55,1736979839,1736979894,1736979894.931044,-21600,,
com.google.Chrome,9,1736979830,1736979839,1736979839.787297,-21600,,
com.google.android.studio,403,1736979427,1736979830,1736979830.749387,-21600,,
com.google.Chrome,7,1736979420,1736979427,1736979427.6452699,-21600,,
com.google.android.studio,85,1736979335,1736979420,1736979420.6919599,-21600,,
com.google.Chrome,22,1736979313,1736979335,1736979335.5405378,-21600,,
com.google.android.studio,1,1736979312,1736979313,1736979313.7200089,-21600,,
com.google.Chrome,2,1736979310,1736979312,1736979312.192483,-21600,,
com.google.android.studio,24,1736979286,1736979310,1736979310.665946,-21600,,
com.google.Chrome,108,1736979178,1736979286,1736979286.301723,-21600,,
com.google.android.studio,67,1736979111,1736979178,1736979178.299981,-21600,,
com.apple.dt.Xcode,13,1736979098,1736979111,1736979111.664495,-21600,,
com.google.android.studio,2,1736979096,1736979098,1736979098.555428,-21600,,
com.apple.dt.Xcode,10,1736979086,1736979096,1736979096.659539,-21600,,
com.google.android.studio,142,1736978944,1736979086,1736979086.236244,-21600,,
com.google.Chrome,34,1736978910,1736978944,1736978944.3898869,-21600,,
com.google.android.studio,83,1736978827,1736978910,1736978910.10182,-21600,,
com.google.Chrome,37,1736978790,1736978827,1736978827.321284,-21600,,
com.google.android.studio,873,1736977917,1736978790,1736978790.487674,-21600,,
com.apple.dt.Xcode,3,1736977914,1736977917,1736977917.163951,-21600,,
com.google.android.studio,5,1736977909,1736977914,1736977914.409023,-21600,,
com.apple.dt.Xcode,2,1736977907,1736977909,1736977909.2666612,-21600,,
com.google.android.studio,5,1736977902,1736977907,1736977907.413584,-21600,,
com.apple.dt.Xcode,1,1736977901,1736977902,1736977902.516192,-21600,,
com.google.android.studio,8,1736977893,1736977901,1736977901.11875,-21600,,
com.apple.dt.Xcode,50,1736977843,1736977893,1736977893.7529469,-21600,,
com.google.android.studio,23,1736977820,1736977843,1736977843.555046,-21600,,
com.apple.dt.Xcode,21,1736977799,1736977820,1736977820.8639731,-21600,,
com.google.android.studio,51,1736977748,1736977799,1736977799.585288,-21600,,
com.apple.dt.Xcode,47,1736977701,1736977748,1736977748.457539,-21600,,
com.google.android.studio,129,1736977572,1736977701,1736977701.370173,-21600,,
com.apple.dt.Xcode,17,1736977555,1736977572,1736977572.667992,-21600,,
com.google.android.studio,169,1736977386,1736977555,1736977555.9939299,-21600,,
com.google.Chrome,5,1736977381,1736977386,1736977386.09408,-21600,,
com.google.android.studio,34,1736977347,1736977381,1736977381.235725,-21600,,
com.google.Chrome,2,1736977345,1736977347,1736977347.940522,-21600,,
com.google.android.studio,26,1736977319,1736977345,1736977345.9293718,-21600,,
com.google.Chrome,3,1736977316,1736977319,1736977319.242789,-21600,,
com.google.android.studio,9,1736977307,1736977316,1736977316.658622,-21600,,
com.google.Chrome,1,1736977306,1736977307,1736977307.992659,-21600,,
com.google.android.studio,2,1736977304,1736977306,1736977306.4939651,-21600,,
com.google.Chrome,12,1736977292,1736977304,1736977305.0295892,-21600,,
com.google.android.studio,4,1736977288,1736977292,1736977292.20547,-21600,,
com.google.Chrome,26,1736977262,1736977288,1736977288.79446,-21600,,
com.google.android.studio,1145,1736976117,1736977262,1736977262.315866,-21600,,
com.google.Chrome,3,1736976114,1736976117,1736976117.791943,-21600,,
com.google.android.studio,462,1736975652,1736976114,1736976114.241185,-21600,,
com.google.Chrome,1,1736975651,1736975652,1736975652.240327,-21600,,
com.google.android.studio,554,1736975097,1736975651,1736975651.612537,-21600,,
com.google.Chrome,12,1736975085,1736975097,1736975097.355516,-21600,,
com.google.android.studio,15,1736975070,1736975085,1736975085.83654,-21600,,
com.google.Chrome,7,1736975063,1736975070,1736975071.0242682,-21600,,
com.google.android.studio,0,1736975063,1736975063,1736975063.617578,-21600,,
com.google.Chrome,19,1736975044,1736975063,1736975063.227967,-21600,,
com.google.android.studio,13,1736975031,1736975044,1736975044.425972,-21600,,
com.google.Chrome,14,1736975017,1736975031,1736975031.642261,-21600,,
com.google.android.studio,263,1736974754,1736975017,1736975017.879662,-21600,,
com.google.Chrome,1,1736974753,1736974754,1736974754.915138,-21600,,
com.google.android.studio,66,1736974687,1736974753,1736974753.1547961,-21600,,
com.google.Chrome,1,1736974686,1736974687,1736974687.499673,-21600,,
com.google.android.studio,49,1736974637,1736974686,1736974686.65203,-21600,,
com.google.Chrome,45,1736974592,1736974637,1736974637.789599,-21600,,
com.google.android.studio,21,1736974571,1736974592,1736974592.570218,-21600,,
com.google.Chrome,110,1736974461,1736974571,1736974571.260851,-21600,,
com.google.android.studio,7,1736974454,1736974461,1736974461.88313,-21600,,
com.google.Chrome,2,1736974452,1736974454,1736974454.293038,-21600,,
com.google.android.studio,1,1736974451,1736974452,1736974452.982568,-21600,,
com.google.Chrome,2,1736974449,1736974451,1736974451.111827,-21600,,
com.google.android.studio,2,1736974447,1736974449,1736974450.083592,-21600,,
com.google.Chrome,5,1736974442,1736974447,1736974447.69038,-21600,,
com.google.android.studio,10,1736974432,1736974442,1736974443.118904,-21600,,
com.google.Chrome,159,1736974273,1736974432,1736974432.337259,-21600,,
com.google.android.studio,4,1736974269,1736974273,1736974274.118144,-21600,,
com.google.Chrome,63,1736974206,1736974269,1736974269.15197,-21600,,
com.google.android.studio,204,1736974002,1736974206,1736974207.1062598,-21600,,
com.apple.dt.Xcode,5,1736973997,1736974002,1736974002.9392018,-21600,,
com.google.android.studio,26,1736973971,1736973997,1736973997.548413,-21600,,
com.google.Chrome,1,1736973970,1736973971,1736973971.434588,-21600,,
com.google.android.studio,216,1736973754,1736973970,1736973970.907295,-21600,,
com.google.Chrome,1,1736973753,1736973754,1736973754.394154,-21600,,
com.google.android.studio,2,1736973751,1736973753,1736973753.200706,-21600,,
com.google.Chrome,1,1736973750,1736973751,1736973751.9657369,-21600,,
com.google.android.studio,11,1736973739,1736973750,1736973750.451994,-21600,,
com.google.Chrome,22,1736973717,1736973739,1736973740.018904,-21600,,
com.google.android.studio,579,1736973138,1736973717,1736973717.900649,-21600,,
com.google.Chrome,3,1736973135,1736973138,1736973138.7661319,-21600,,
com.google.android.studio,5,1736973130,1736973135,1736973135.748024,-21600,,
com.google.Chrome,2,1736973128,1736973130,1736973130.857977,-21600,,
com.google.android.studio,9,1736973119,1736973128,1736973128.280693,-21600,,
com.google.Chrome,77,1736973042,1736973119,1736973119.9106622,-21600,,
com.google.android.studio,2,1736973040,1736973042,1736973043.0156832,-21600,,
com.google.Chrome,4,1736973036,1736973040,1736973040.225815,-21600,,
com.google.android.studio,3,1736973033,1736973036,1736973036.7625751,-21600,,
com.google.Chrome,68,1736972965,1736973033,1736973033.273192,-21600,,
com.google.android.studio,23,1736972942,1736972965,1736972965.907855,-21600,,
com.google.Chrome,1,1736972941,1736972942,1736972942.674838,-21600,,
com.google.android.studio,5,1736972936,1736972941,1736972941.780428,-21600,,
com.google.Chrome,36,1736972900,1736972936,1736972936.304631,-21600,,
com.google.android.studio,2,1736972898,1736972900,1736972901.0583801,-21600,,
com.google.Chrome,3,1736972895,1736972898,1736972898.848342,-21600,,
com.google.android.studio,134,1736972761,1736972895,1736972895.214952,-21600,,
com.google.Chrome,12,1736972749,1736972761,1736972761.309479,-21600,,
com.google.android.studio,9,1736972740,1736972749,1736972750.093404,-21600,,
com.google.Chrome,2,1736972738,1736972740,1736972740.5391011,-21600,,
com.google.android.studio,38,1736972700,1736972738,1736972738.269378,-21600,,
com.google.Chrome,13,1736972687,1736972700,1736972700.274273,-21600,,
com.google.android.studio,90,1736972597,1736972687,1736972687.456007,-21600,,
com.google.Chrome,22,1736972575,1736972597,1736972597.968713,-21600,,
com.google.android.studio,289,1736972286,1736972575,1736972575.416215,-21600,,
com.apple.dt.Xcode,8,1736972278,1736972286,1736972286.3987389,-21600,,
com.google.android.studio,18,1736972260,1736972278,1736972278.6535249,-21600,,
com.apple.dt.Xcode,13,1736972247,1736972260,1736972260.7837229,-21600,,
com.google.android.studio,199,1736972048,1736972247,1736972247.9930282,-21600,,
com.apple.dt.Xcode,1,1736972047,1736972048,1736972048.7122731,-21600,,
com.google.Chrome,46,1736972001,1736972047,1736972047.230205,-21600,,
com.apple.dt.Xcode,22,1736971979,1736972001,1736972001.775113,-21600,,
com.google.android.studio,1,1736971978,1736971979,1736971979.829064,-21600,,
com.google.Chrome,3,1736971975,1736971978,1736971978.670116,-21600,,
com.google.android.studio,15,1736971960,1736971975,1736971975.94035,-21600,,
com.apple.dt.Xcode,4,1736971956,1736971960,1736971960.860083,-21600,,
com.google.Chrome,1,1736971955,1736971956,1736971956.319092,-21600,,
com.google.android.studio,19,1736971936,1736971955,1736971955.626513,-21600,,
com.google.Chrome,2,1736971934,1736971936,1736971936.422194,-21600,,
com.apple.dt.Xcode,20,1736971914,1736971934,1736971935.046169,-21600,,
com.google.Chrome,4,1736971910,1736971914,1736971914.6976972,-21600,,
com.google.android.studio,3,1736971907,1736971910,1736971911.018503,-21600,,
com.google.Chrome,15,1736971892,1736971907,1736971907.250243,-21600,,
com.google.android.studio,1,1736971891,1736971892,1736971892.239475,-21600,,
com.google.Chrome,0,1736971891,1736971891,1736971891.748491,-21600,,
com.google.android.studio,2,1736971889,1736971891,1736971891.395808,-21600,,
com.apple.dt.Xcode,1,1736971888,1736971889,1736971889.634428,-21600,,
com.google.Chrome,15,1736971873,1736971888,1736971888.3212938,-21600,,
com.apple.dt.Xcode,1,1736971872,1736971873,1736971873.777039,-21600,,
com.google.android.studio,6,1736971866,1736971872,1736971872.4285998,-21600,,
com.apple.dt.Xcode,1,1736971865,1736971866,1736971866.4143429,-21600,,
com.google.android.studio,15,1736971850,1736971865,1736971865.871083,-21600,,
com.apple.dt.Xcode,48,1736971802,1736971850,1736971850.9834418,-21600,,
com.google.android.studio,37,1736971765,1736971802,1736971802.634503,-21600,,
com.google.Chrome,3,1736971762,1736971765,1736971765.128906,-21600,,
com.google.android.studio,6,1736971756,1736971762,1736971763.037631,-21600,,
com.google.Chrome,10,1736971746,1736971756,1736971756.127768,-21600,,
com.google.android.studio,309,1736971437,1736971746,1736971746.427324,-21600,,
com.google.Chrome,1,1736971436,1736971437,1736971437.551311,-21600,,
com.google.android.studio,25,1736971411,1736971436,1736971436.125091,-21600,,
com.google.Chrome,6,1736971405,1736971411,1736971411.730163,-21600,,
com.google.android.studio,34,1736971371,1736971405,1736971406.0236912,-21600,,
com.google.Chrome,16,1736971355,1736971371,1736971371.3793201,-21600,,
com.google.android.studio,8,1736971347,1736971355,1736971355.8467898,-21600,,
com.google.Chrome,1,1736971346,1736971347,1736971347.598248,-21600,,
com.google.android.studio,4,1736971342,1736971346,1736971346.430213,-21600,,
com.google.Chrome,2,1736971340,1736971342,1736971342.5721312,-21600,,
com.google.android.studio,2,1736971338,1736971340,1736971340.616708,-21600,,
com.google.Chrome,7,1736971331,1736971338,1736971339.036151,-21600,,
com.google.android.studio,34,1736971297,1736971331,1736971331.142311,-21600,,
com.google.Chrome,7,1736971290,1736971297,1736971297.6945338,-21600,,
com.google.android.studio,2,1736971288,1736971290,1736971290.419286,-21600,,
com.google.Chrome,1,1736971287,1736971288,1736971288.33455,-21600,,
com.google.android.studio,1,1736971286,1736971287,1736971287.375267,-21600,,
com.google.Chrome,4,1736971282,1736971286,1736971286.190254,-21600,,
com.google.android.studio,1,1736971281,1736971282,1736971282.172145,-21600,,
com.google.Chrome,11,1736971270,1736971281,1736971281.432592,-21600,,
com.google.android.studio,13,1736971257,1736971270,1736971271.0448709,-21600,,
com.google.Chrome,4,1736971253,1736971257,1736971257.509869,-21600,,
com.google.android.studio,6,1736971247,1736971253,1736971253.535846,-21600,,
com.google.Chrome,12,1736971235,1736971247,1736971247.226877,-21600,,
com.google.android.studio,0,1736971235,1736971235,1736971235.781005,-21600,,
com.apple.finder,1,1736971055,1736971056,1736971056.7596931,-21600,,
com.google.android.studio,0,1736971055,1736971055,1736971056.695022,-21600,,
com.apple.finder,1,1736971054,1736971055,1736971055.053121,-21600,,
com.google.Chrome,2,1736971016,1736971018,1736971018.106139,-21600,,
com.google.android.studio,5,1736971011,1736971016,1736971017.0261211,-21600,,
com.google.Chrome,20,1736970991,1736971011,1736971011.4662728,-21600,,
com.google.android.studio,27,1736970964,1736970991,1736970991.205569,-21600,,
com.apple.finder,6,1736970958,1736970964,1736970964.4102368,-21600,,
com.google.android.studio,1,1736970957,1736970958,1736970958.2421231,-21600,,
com.apple.finder,4,1736970953,1736970957,1736970957.41271,-21600,,
com.ryansponzilli.DeepSkyCatalog,2,1736970793,1736970795,1736970795.7214022,-21600,EB445137-D7F5-57EC-87DA-1DB460D64046,"iPhone13,2"
com.google.Chrome,183,1736970770,1736970953,1736970953.962354,-21600,,
com.google.android.studio,25,1736970745,1736970770,1736970771.0510778,-21600,,
com.google.Chrome,11,1736970734,1736970745,1736970745.374783,-21600,,
com.google.android.studio,23,1736970711,1736970734,1736970734.603473,-21600,,
com.google.Chrome,5,1736970706,1736970711,1736970711.534256,-21600,,
com.google.android.studio,2,1736970704,1736970706,1736970706.658515,-21600,,
com.google.Chrome,6,1736970698,1736970704,1736970704.854006,-21600,,
com.google.android.studio,1,1736970697,1736970698,1736970698.2205172,-21600,,
com.google.Chrome,22,1736970675,1736970697,1736970697.2416449,-21600,,
com.google.android.studio,102,1736970573,1736970675,1736970675.447569,-21600,,
com.google.Chrome,2,1736970571,1736970573,1736970573.738337,-21600,,
com.google.android.studio,19,1736970552,1736970571,1736970571.2064052,-21600,,
com.google.Chrome,16,1736970536,1736970552,1736970552.123293,-21600,,
com.google.android.studio,83,1736970453,1736970536,1736970537.041018,-21600,,
com.apple.systempreferences,24,1736970429,1736970453,1736970453.8251739,-21600,,
com.google.android.studio,65,1736970354,1736970419,1736970419.256679,-21600,,
com.google.Chrome,5,1736970349,1736970354,1736970354.58616,-21600,,
com.google.android.studio,10,1736970339,1736970349,1736970349.536464,-21600,,
com.google.Chrome,5,1736970334,1736970339,1736970339.742062,-21600,,
com.google.android.studio,5,1736970329,1736970334,1736970334.5200691,-21600,,
com.google.Chrome,3,1736970326,1736970329,1736970329.8501291,-21600,,
com.google.android.studio,7,1736970319,1736970326,1736970326.939848,-21600,,
com.google.Chrome,27,1736970292,1736970319,1736970319.2592912,-21600,,
com.google.android.studio,4,1736970288,1736970292,1736970292.304703,-21600,,
com.google.Chrome,33,1736970255,1736970288,1736970288.9706612,-21600,,
com.google.android.studio,17,1736970238,1736970255,1736970255.230283,-21600,,
com.google.Chrome,3,1736970235,1736970238,1736970238.083195,-21600,,
com.google.android.studio,3,1736970232,1736970235,1736970235.7269568,-21600,,
com.google.Chrome,2,1736970230,1736970232,1736970232.509423,-21600,,
com.google.android.studio,1,1736970229,1736970230,1736970230.848438,-21600,,
com.google.Chrome,10,1736970219,1736970229,1736970229.234174,-21600,,
com.google.android.studio,153,1736970066,1736970219,1736970220.118826,-21600,,
com.google.Chrome,1,1736970065,1736970066,1736970066.406647,-21600,,
com.google.android.studio,0,1736970065,1736970065,1736970065.848875,-21600,,
com.google.Chrome,1,1736970064,1736970065,1736970065.229986,-21600,,
com.google.android.studio,0,1736970064,1736970064,1736970064.862426,-21600,,
com.google.Chrome,1,1736970063,1736970064,1736970064.519743,-21600,,
com.google.android.studio,8,1736970055,1736970063,1736970063.231035,-21600,,
com.google.Chrome,18,1736970037,1736970055,1736970055.3250852,-21600,,
com.google.android.studio,1,1736970036,1736970037,1736970038.073041,-21600,,
com.google.Chrome,21,1736970015,1736970036,1736970036.24896,-21600,,
com.google.android.studio,1,1736970014,1736970015,1736970015.622314,-21600,,
com.google.Chrome,4,1736970010,1736970014,1736970014.840849,-21600,,
com.ryansponzilli.DeepSkyCatalog,64,1736969775,1736969839,1736969839.1247392,-21600,EB445137-D7F5-57EC-87DA-1DB460D64046,"iPhone13,2"
com.apple.findmy,2,1736969772,1736969774,1736969775.205315,-21600,EB445137-D7F5-57EC-87DA-1DB460D64046,"iPhone13,2"
com.google.android.studio,260,1736969750,1736970010,1736970010.9865708,-21600,,
com.google.Chrome,3,1736969747,1736969750,1736969750.083575,-21600,,
com.google.android.studio,28,1736969719,1736969747,1736969747.352072,-21600,,
com.google.Chrome,10,1736969709,1736969719,1736969719.158936,-21600,,
com.google.android.studio,77,1736969632,1736969709,1736969709.309023,-21600,,
com.google.Chrome,4,1736969628,1736969632,1736969632.5299711,-21600,,
com.google.android.studio,27,1736969601,1736969628,1736969628.2090921,-21600,,
com.google.Chrome,5,1736969596,1736969601,1736969601.67665,-21600,,
com.google.android.studio,11,1736969585,1736969596,1736969596.6947598,-21600,,
com.google.Chrome,1,1736969584,1736969585,1736969585.194586,-21600,,
com.google.android.studio,138,1736969446,1736969584,1736969584.225957,-21600,,
com.google.Chrome,9,1736969437,1736969446,1736969446.703901,-21600,,
com.google.android.studio,24,1736969413,1736969437,1736969437.9306002,-21600,,
com.google.Chrome,3,1736969410,1736969413,1736969413.485207,-21600,,
com.google.android.studio,14,1736969396,1736969410,1736969410.926639,-21600,,
com.google.Chrome,5,1736969391,1736969396,1736969396.330056,-21600,,
com.google.android.studio,4,1736969387,1736969391,1736969391.507824,-21600,,
com.google.Chrome,3,1736969384,1736969387,1736969387.673192,-21600,,
com.google.android.studio,6,1736969378,1736969384,1736969384.3847919,-21600,,
com.google.Chrome,9,1736969369,1736969378,1736969378.681978,-21600,,
com.google.android.studio,7,1736969362,1736969369,1736969369.4141421,-21600,,
com.google.Chrome,4,1736969358,1736969362,1736969362.8425078,-21600,,
com.google.android.studio,1,1736969357,1736969358,1736969358.799804,-21600,,
com.google.Chrome,5,1736969352,1736969357,1736969357.797401,-21600,,
com.google.android.studio,6,1736969346,1736969352,1736969352.093847,-21600,,
com.google.Chrome,4,1736969342,1736969346,1736969346.346282,-21600,,
com.google.android.studio,12,1736969330,1736969342,1736969342.856968,-21600,,
com.google.Chrome,25,1736969305,1736969330,1736969330.283196,-21600,,
com.google.android.studio,4,1736969301,1736969305,1736969305.9035459,-21600,,
com.apple.findmy,42,1736969125,1736969167,1736969167.674876,-21600,EB445137-D7F5-57EC-87DA-1DB460D64046,"iPhone13,2"
com.microsoft.Office.Outlook,7,1736968725,1736968732,1736968732.986203,-21600,EB445137-D7F5-57EC-87DA-1DB460D64046,"iPhone13,2"
com.apple.findmy,2,1736968718,1736968720,1736968721.252938,-21600,EB445137-D7F5-57EC-87DA-1DB460D64046,"iPhone13,2"
com.apple.findmy,14,1736968450,1736968464,1736968464.461711,-21600,EB445137-D7F5-57EC-87DA-1DB460D64046,"iPhone13,2"
com.facebook.Facebook,42,1736968272,1736968314,1736968314.801389,-21600,EB445137-D7F5-57EC-87DA-1DB460D64046,"iPhone13,2"
com.apple.news,3,1736968260,1736968263,1736968263.847471,-21600,EB445137-D7F5-57EC-87DA-1DB460D64046,"iPhone13,2"
com.apple.news,25,1736967817,1736967842,1736967842.597917,-21600,EB445137-D7F5-57EC-87DA-1DB460D64046,"iPhone13,2"
com.apple.findmy,49,1736967485,1736967534,1736967534.455131,-21600,EB445137-D7F5-57EC-87DA-1DB460D64046,"iPhone13,2"
com.apple.news,1,1736967483,1736967484,1736967485.838871,-21600,EB445137-D7F5-57EC-87DA-1DB460D64046,"iPhone13,2"
com.apple.news,87,1736967341,1736967428,1736967429.120543,-21600,EB445137-D7F5-57EC-87DA-1DB460D64046,"iPhone13,2"
com.ryansponzilli.DeepSkyCatalog,2,1736967333,1736967335,1736967335.68992,-21600,EB445137-D7F5-57EC-87DA-1DB460D64046,"iPhone13,2"
com.ryansponzilli.DeepSkyCatalog,14,1736967060,1736967074,1736967074.403736,-21600,EB445137-D7F5-57EC-87DA-1DB460D64046,"iPhone13,2"
com.hammerandchisel.discord,8,1736966559,1736966567,1736966568.167521,-21600,EB445137-D7F5-57EC-87DA-1DB460D64046,"iPhone13,2"
com.apple.news,85,1736966404,1736966489,1736966489.887161,-21600,EB445137-D7F5-57EC-87DA-1DB460D64046,"iPhone13,2"
com.google.android.studio,499,1736965351,1736965850,1736965850.814599,-21600,,
com.google.Chrome,37,1736965314,1736965351,1736965351.091282,-21600,,
com.google.android.studio,80,1736965234,1736965314,1736965314.5157151,-21600,,
com.google.Chrome,300,1736964934,1736965234,1736965234.866008,-21600,,
com.microsoft.onenote.mac,3,1736964931,1736964934,1736964936.16873,-21600,,
com.google.android.studio,538,1736964393,1736964931,1736964931.847351,-21600,,
com.apple.finder,35,1736964323,1736964358,1736964358.0985332,-21600,,
com.google.Chrome,13,1736964310,1736964323,1736964323.17732,-21600,,
com.google.ios.youtube,603,1736963596,1736964199,1736964199.22571,-21600,EB445137-D7F5-57EC-87DA-1DB460D64046,"iPhone13,2"
com.google.ios.youtube,3,1736963561,1736963564,1736963564.8900108,-21600,EB445137-D7F5-57EC-87DA-1DB460D64046,"iPhone13,2"
com.google.ios.youtube,576,1736962443,1736963019,1736963019.259532,-21600,EB445137-D7F5-57EC-87DA-1DB460D64046,"iPhone13,2"
com.apple.findmy,11,1736962121,1736962132,1736962132.460507,-21600,EB445137-D7F5-57EC-87DA-1DB460D64046,"iPhone13,2"
com.google.ios.youtube,2,1736962119,1736962121,1736962121.3135362,-21600,EB445137-D7F5-57EC-87DA-1DB460D64046,"iPhone13,2"
com.google.ios.youtube,89,1736962024,1736962113,1736962114.179893,-21600,EB445137-D7F5-57EC-87DA-1DB460D64046,"iPhone13,2"
com.google.ios.youtube,26,1736961180,1736961206,1736961206.228893,-21600,EB445137-D7F5-57EC-87DA-1DB460D64046,"iPhone13,2"
com.google.ios.youtube,63,1736960641,1736960704,1736960704.661057,-21600,EB445137-D7F5-57EC-87DA-1DB460D64046,"iPhone13,2"
com.google.ios.youtube,96,1736960144,1736960240,1736960240.863234,-21600,EB445137-D7F5-57EC-87DA-1DB460D64046,"iPhone13,2"
com.google.ios.youtube,57,1736959899,1736959956,1736959957.145056,-21600,EB445137-D7F5-57EC-87DA-1DB460D64046,"iPhone13,2"
com.google.ios.youtube,62,1736959642,1736959704,1736959704.463725,-21600,EB445137-D7F5-57EC-87DA-1DB460D64046,"iPhone13,2"
com.apple.news,43,1736958474,1736958517,1736958517.569799,-21600,EB445137-D7F5-57EC-87DA-1DB460D64046,"iPhone13,2"
com.tinyspeck.chatlyio,20,1736956816,1736956836,1736956836.9908462,-21600,EB445137-D7F5-57EC-87DA-1DB460D64046,"iPhone13,2"
com.apple.news,131,1736956685,1736956816,1736956816.9799318,-21600,EB445137-D7F5-57EC-87DA-1DB460D64046,"iPhone13,2"
com.truebill.truebillnative,3,1736956668,1736956671,1736956671.034545,-21600,EB445137-D7F5-57EC-87DA-1DB460D64046,"iPhone13,2"
com.apple.CoreAuthUI,4,1736956395,1736956399,1736956399.687739,-21600,EB445137-D7F5-57EC-87DA-1DB460D64046,"iPhone13,2"
com.truebill.truebillnative,146,1736956392,1736956538,1736956538.157496,-21600,EB445137-D7F5-57EC-87DA-1DB460D64046,"iPhone13,2"
com.letterboxd.LetterboxdApp,44,1736953860,1736953904,1736953904.668367,-21600,EB445137-D7F5-57EC-87DA-1DB460D64046,"iPhone13,2"
com.letterboxd.LetterboxdApp,59,1736953778,1736953837,1736953837.881552,-21600,EB445137-D7F5-57EC-87DA-1DB460D64046,"iPhone13,2"
com.robinhood.release.Robinhood,78,1736953566,1736953644,1736953644.946706,-21600,EB445137-D7F5-57EC-87DA-1DB460D64046,"iPhone13,2"
com.apple.ScreenshotServicesService,4,1736953062,1736953066,1736953066.562025,-21600,EB445137-D7F5-57EC-87DA-1DB460D64046,"iPhone13,2"
com.apple.weather,159,1736952901,1736953060,1736953060.519298,-21600,EB445137-D7F5-57EC-87DA-1DB460D64046,"iPhone13,2"
com.microsoft.Office.Outlook,14,1736952862,1736952876,1736952876.4827971,-21600,EB445137-D7F5-57EC-87DA-1DB460D64046,"iPhone13,2"
com.facebook.Facebook,46,1736952811,1736952857,1736952857.341745,-21600,EB445137-D7F5-57EC-87DA-1DB460D64046,"iPhone13,2"
com.apple.Health,8,1736952797,1736952805,1736952805.647798,-21600,EB445137-D7F5-57EC-87DA-1DB460D64046,"iPhone13,2"
com.apple.Health,30,1736952428,1736952458,1736952458.677645,-21600,EB445137-D7F5-57EC-87DA-1DB460D64046,"iPhone13,2"
com.toyopagroup.picaboo,83,1736952341,1736952424,1736952424.922144,-21600,EB445137-D7F5-57EC-87DA-1DB460D64046,"iPhone13,2"
com.renpho.health,23,1736951467,1736951490,1736951490.944629,-21600,EB445137-D7F5-57EC-87DA-1DB460D64046,"iPhone13,2"
com.apple.CoreAuthUI,5,1736918596,1736918601,1736918601.4158711,-21600,EB445137-D7F5-57EC-87DA-1DB460D64046,"iPhone13,2"
com.apple.journal,640,1736918595,1736919235,1736919235.7180228,-21600,EB445137-D7F5-57EC-87DA-1DB460D64046,"iPhone13,2"
com.apple.Health,107,1736918464,1736918571,1736918571.1661181,-21600,EB445137-D7F5-57EC-87DA-1DB460D64046,"iPhone13,2"
com.goodreads.Goodreads,2,1736918240,1736918242,1736918242.947984,-21600,EB445137-D7F5-57EC-87DA-1DB460D64046,"iPhone13,2"
com.thestorygraph.thestorygraph,25,1736918215,1736918240,1736918240.385318,-21600,EB445137-D7F5-57EC-87DA-1DB460D64046,"iPhone13,2"
com.thestorygraph.thestorygraph,8,1736918186,1736918194,1736918195.206295,-21600,EB445137-D7F5-57EC-87DA-1DB460D64046,"iPhone13,2"
com.thestorygraph.thestorygraph,4,1736918182,1736918186,1736918186.657232,-21600,EB445137-D7F5-57EC-87DA-1DB460D64046,"iPhone13,2"
com.ally.MobileBanking,1,1736918180,1736918181,1736918181.708194,-21600,EB445137-D7F5-57EC-87DA-1DB460D64046,"iPhone13,2"
com.google.Chrome,307,1736917847,1736918154,1736918155.147856,-21600,,
com.google.android.studio,133,1736917714,1736917847,1736917847.65796,-21600,,
com.google.Chrome,57,1736917657,1736917714,1736917714.565919,-21600,,
com.google.android.studio,31,1736917626,1736917657,1736917657.600851,-21600,,
com.google.Chrome,31,1736917595,1736917626,1736917626.9860501,-21600,,
com.google.android.studio,62,1736917533,1736917595,1736917595.870901,-21600,,
com.apple.CoreAuthUI,19,1736917520,1736917539,1736917539.513708,-21600,EB445137-D7F5-57EC-87DA-1DB460D64046,"iPhone13,2"
com.ally.MobileBanking,173,1736917512,1736917685,1736917685.888814,-21600,EB445137-D7F5-57EC-87DA-1DB460D64046,"iPhone13,2"
com.apple.news,2,1736917503,1736917505,1736917505.469689,-21600,EB445137-D7F5-57EC-87DA-1DB460D64046,"iPhone13,2"
com.google.Chrome,37,1736917390,1736917427,1736917427.65939,-21600,,
com.google.android.studio,8,1736917382,1736917390,1736917390.755301,-21600,,
com.google.Chrome,283,1736917099,1736917382,1736917383.020245,-21600,,
com.google.android.studio,1,1736917098,1736917099,1736917099.827814,-21600,,
com.google.Chrome,13,1736917085,1736917098,1736917098.128155,-21600,,
com.google.android.studio,1,1736917084,1736917085,1736917085.864507,-21600,,
com.google.Chrome,18,1736917066,1736917084,1736917084.5134292,-21600,,
com.google.android.studio,18,1736917048,1736917066,1736917066.1566439,-21600,,
com.google.Chrome,37,1736917011,1736917048,1736917048.872433,-21600,,
com.google.android.studio,15,1736916996,1736917011,1736917011.199747,-21600,,
com.google.Chrome,21,1736916975,1736916996,1736916996.413686,-21600,,
com.google.android.studio,28,1736916947,1736916975,1736916975.890382,-21600,,
com.apple.news,58,1736916677,1736916735,1736916735.319769,-21600,EB445137-D7F5-57EC-87DA-1DB460D64046,"iPhone13,2"
com.google.Chrome,337,1736916610,1736916947,1736916947.939945,-21600,,
com.google.android.studio,4,1736916606,1736916610,1736916610.07864,-21600,,
com.google.Chrome,100,1736916506,1736916606,1736916606.325079,-21600,,
com.google.android.studio,1,1736916505,1736916506,1736916506.5564651,-21600,,
com.google.Chrome,14,1736916491,1736916505,1736916505.716975,-21600,,
com.google.android.studio,18,1736916473,1736916491,1736916491.352148,-21600,,
com.google.Chrome,126,1736916347,1736916473,1736916473.2153091,-21600,,
com.google.Chrome,611,1736910734,1736911345,1736911346.224399,-21600,,
com.google.Chrome,332,1736910010,1736910342,1736910342.9638538,-21600,,
com.google.Chrome,4,1736909425,1736909429,1736909429.624864,-21600,,
com.microsoft.onenote.mac,4,1736909421,1736909425,1736909425.275389,-21600,,
com.google.Chrome,4,1736909417,1736909421,1736909421.853537,-21600,,
com.microsoft.onenote.mac,39,1736909378,1736909417,1736909417.24023,-21600,,
com.google.android.studio,159,1736909219,1736909378,1736909378.827019,-21600,,
com.google.Chrome,2,1736909217,1736909219,1736909219.054383,-21600,,
com.apple.dt.Xcode,1,1736909216,1736909217,1736909218.0141978,-21600,,
com.microsoft.onenote.mac,10,1736909206,1736909216,1736909216.823209,-21600,,
com.google.android.studio,310,1736908896,1736909206,1736909206.644336,-21600,,
com.apple.dt.Xcode,3,1736908893,1736908896,1736908896.749302,-21600,,
com.google.android.studio,42,1736908851,1736908893,1736908893.8403912,-21600,,
com.apple.dt.Xcode,8,1736908843,1736908851,1736908852.032817,-21600,,
com.google.android.studio,6,1736908837,1736908843,1736908843.6343699,-21600,,
com.apple.dt.Xcode,4,1736908833,1736908837,1736908837.2790651,-21600,,
com.google.android.studio,7,1736908826,1736908833,1736908833.339768,-21600,,
com.apple.dt.Xcode,2,1736908824,1736908826,1736908826.314155,-21600,,
com.google.android.studio,2,1736908822,1736908824,1736908824.810408,-21600,,
com.apple.dt.Xcode,1,1736908821,1736908822,1736908822.579688,-21600,,
com.google.android.studio,1,1736908820,1736908821,1736908821.503535,-21600,,
com.apple.dt.Xcode,2,1736908818,1736908820,1736908820.577533,-21600,,
com.google.android.studio,1,1736908817,1736908818,1736908818.742547,-21600,,
com.apple.dt.Xcode,1,1736908816,1736908817,1736908817.769733,-21600,,
com.google.android.studio,2,1736908814,1736908816,1736908816.2694612,-21600,,
com.apple.dt.Xcode,9,1736908805,1736908814,1736908814.653343,-21600,,
com.google.android.studio,105,1736908700,1736908805,1736908805.754457,-21600,,
com.microsoft.onenote.mac,12,1736908688,1736908700,1736908700.1811008,-21600,,
com.google.android.studio,1833,1736906855,1736908688,1736908688.504482,-21600,,
com.google.Chrome,112,1736906743,1736906855,1736906855.484606,-21600,,
com.google.Chrome,496,1736906183,1736906679,1736906679.572891,-21600,,
com.google.Chrome,431,1736905568,1736905999,1736905999.981763,-21600,,
com.apple.news,11,1736905098,1736905109,1736905109.238725,-21600,EB445137-D7F5-57EC-87DA-1DB460D64046,"iPhone13,2"
com.apple.findmy,8,1736904847,1736904855,1736904855.4425302,-21600,EB445137-D7F5-57EC-87DA-1DB460D64046,"iPhone13,2"
com.ryansponzilli.DeepSkyCatalog,3,1736904843,1736904846,1736904846.1873832,-21600,EB445137-D7F5-57EC-87DA-1DB460D64046,"iPhone13,2"
com.google.Chrome,1284,1736904253,1736905537,1736905537.607661,-21600,,
com.google.android.studio,1197,1736903056,1736904253,1736904254.0916948,-21600,,
com.google.Chrome,54,1736903002,1736903056,1736903056.523037,-21600,,
com.google.android.studio,22,1736902980,1736903002,1736903002.359322,-21600,,
com.apple.dt.Xcode,8,1736902972,1736902980,1736902980.808845,-21600,,
com.google.android.studio,343,1736902629,1736902972,1736902972.2437139,-21600,,
com.apple.dt.Xcode,2,1736902627,1736902629,1736902629.093226,-21600,,
com.google.android.studio,7,1736902620,1736902627,1736902627.6471438,-21600,,
com.apple.dt.Xcode,2,1736902618,1736902620,1736902620.310571,-21600,,
com.google.android.studio,7,1736902611,1736902618,1736902618.084094,-21600,,
com.apple.dt.Xcode,1,1736902610,1736902611,1736902611.594429,-21600,,
com.google.android.studio,83,1736902527,1736902610,1736902610.391788,-21600,,
com.apple.dt.Xcode,1,1736902526,1736902527,1736902527.298831,-21600,,
com.google.android.studio,42,1736902484,1736902526,1736902526.8078542,-21600,,
com.apple.dt.Xcode,34,1736902450,1736902484,1736902484.513506,-21600,,
com.google.android.studio,36,1736902414,1736902450,1736902450.978997,-21600,,
com.google.Chrome,32,1736902382,1736902414,1736902414.344662,-21600,,
com.google.Chrome,300,1736902005,1736902305,1736902305.2654738,-21600,,
com.google.Chrome,465,1736901002,1736901467,1736901467.9398022,-21600,,
com.google.android.studio,186,1736900730,1736900916,1736900916.573144,-21600,,
com.ryansponzilli.DeepSkyCatalog,13,1736900713,1736900726,1736900726.4703941,-21600,EB445137-D7F5-57EC-87DA-1DB460D64046,"iPhone13,2"
com.microsoft.Office.Outlook,5,1736900707,1736900712,1736900712.9477239,-21600,EB445137-D7F5-57EC-87DA-1DB460D64046,"iPhone13,2"
com.apple.dt.Xcode,49,1736900681,1736900730,1736900730.949543,-21600,,
com.google.android.studio,30,1736900651,1736900681,1736900681.516924,-21600,,
com.google.android.studio,427,1736899364,1736899791,1736899791.941118,-21600,,
com.apple.dt.Xcode,2,1736899362,1736899364,1736899364.599993,-21600,,
com.google.android.studio,442,1736898920,1736899362,1736899362.76137,-21600,,
com.apple.dt.Xcode,20,1736898900,1736898920,1736898920.138681,-21600,,
com.google.android.studio,86,1736898814,1736898900,1736898900.710774,-21600,,
com.apple.dt.Xcode,11,1736898803,1736898814,1736898814.2147331,-21600,,
com.google.android.studio,5,1736898798,1736898803,1736898803.236611,-21600,,
com.apple.dt.Xcode,25,1736898773,1736898798,1736898798.6153421,-21600,,
com.google.android.studio,1,1736898772,1736898773,1736898773.929216,-21600,,
com.apple.dt.Xcode,12,1736898760,1736898772,1736898772.344105,-21600,,
com.google.android.studio,2,1736898758,1736898760,1736898760.177006,-21600,,
com.apple.dt.Xcode,2,1736898756,1736898758,1736898758.129826,-21600,,
com.google.android.studio,12,1736898744,1736898756,1736898756.113605,-21600,,
com.apple.dt.Xcode,3,1736898741,1736898744,1736898744.250164,-21600,,
com.google.android.studio,0,1736898741,1736898741,1736898741.622524,-21600,,
com.apple.dt.Xcode,5,1736898736,1736898741,1736898741.282858,-21600,,
com.google.android.studio,8,1736898728,1736898736,1736898736.345766,-21600,,
com.apple.dt.Xcode,11,1736898717,1736898728,1736898728.199771,-21600,,
com.google.android.studio,4,1736898713,1736898717,1736898717.144618,-21600,,
com.apple.dt.Xcode,5,1736898708,1736898713,1736898713.999557,-21600,,
com.google.android.studio,6,1736898702,1736898708,1736898708.563451,-21600,,
com.apple.dt.Xcode,3,1736898699,1736898702,1736898702.1944342,-21600,,
com.google.android.studio,11,1736898688,1736898699,1736898699.759927,-21600,,
com.apple.dt.Xcode,2,1736898686,1736898688,1736898688.411838,-21600,,
com.google.android.studio,19,1736898667,1736898686,1736898686.9305239,-21600,,
com.apple.dt.Xcode,5,1736898662,1736898667,1736898667.376651,-21600,,
com.google.android.studio,9,1736898653,1736898662,1736898662.0735822,-21600,,
com.apple.dt.Xcode,5,1736898648,1736898653,1736898653.5761971,-21600,,
com.google.android.studio,8,1736898640,1736898648,1736898648.486762,-21600,,
com.apple.dt.Xcode,1,1736898639,1736898640,1736898640.868785,-21600,,
com.google.android.studio,3,1736898636,1736898639,1736898639.601385,-21600,,
com.microsoft.onenote.mac,27,1736898609,1736898636,1736898636.78005,-21600,,
com.google.Chrome,4,1736898605,1736898609,1736898609.933064,-21600,,
com.microsoft.Office.Outlook,17,1736898586,1736898603,1736898603.977931,-21600,EB445137-D7F5-57EC-87DA-1DB460D64046,"iPhone13,2"
com.apple.findmy,0,1736898586,1736898586,1736898586.8349118,-21600,EB445137-D7F5-57EC-87DA-1DB460D64046,"iPhone13,2"
com.google.Chrome,381,1736898094,1736898475,1736898475.1799831,-21600,,
com.microsoft.onenote.mac,54,1736898040,1736898094,1736898095.050765,-21600,,
com.google.Chrome,6,1736898034,1736898040,1736898040.173658,-21600,,
com.google.android.studio,6,1736898028,1736898034,1736898034.957467,-21600,,
com.apple.dt.Xcode,1,1736898027,1736898028,1736898029.253169,-21600,,
com.apple.findmy,6,1736897945,1736897951,1736897951.5569859,-21600,EB445137-D7F5-57EC-87DA-1DB460D64046,"iPhone13,2"
com.apple.findmy,3,1736893976,1736893979,1736893980.196982,-21600,EB445137-D7F5-57EC-87DA-1DB460D64046,"iPhone13,2"
com.apple.weather,1,1736893973,1736893974,1736893974.85305,-21600,EB445137-D7F5-57EC-87DA-1DB460D64046,"iPhone13,2"
com.google.android.studio,4277,1736893750,1736898027,1736898027.405494,-21600,,
com.google.Chrome,7,1736893743,1736893750,1736893750.151122,-21600,,
com.google.android.studio,32,1736893711,1736893743,1736893743.1099539,-21600,,
com.google.Chrome,64,1736893647,1736893711,1736893711.35494,-21600,,
com.google.android.studio,127,1736893520,1736893647,1736893647.304957,-21600,,
com.google.Chrome,50,1736893470,1736893520,1736893520.604399,-21600,,
com.google.android.studio,19,1736893451,1736893470,1736893470.6817842,-21600,,
com.google.Chrome,2,1736893449,1736893451,1736893451.4934878,-21600,,
com.google.android.studio,11,1736893438,1736893449,1736893449.58549,-21600,,
com.google.Chrome,49,1736893389,1736893438,1736893438.6211019,-21600,,
com.google.android.studio,4,1736893385,1736893389,1736893389.966378,-21600,,
com.google.Chrome,47,1736893338,1736893385,1736893385.508281,-21600,,
com.google.android.studio,3,1736893335,1736893338,1736893339.006695,-21600,,
com.google.Chrome,8,1736893327,1736893335,1736893335.482017,-21600,,
com.google.android.studio,676,1736892651,1736893327,1736893327.282792,-21600,,
com.google.ios.youtube,831,1736891807,1736892638,1736892638.197281,-21600,EB445137-D7F5-57EC-87DA-1DB460D64046,"iPhone13,2"
com.google.android.studio,640,1736891453,1736892093,1736892093.371398,-21600,,
com.google.Chrome,33,1736891420,1736891453,1736891453.9150991,-21600,,
com.google.android.studio,9,1736891411,1736891420,1736891420.109878,-21600,,
com.google.Chrome,1,1736891410,1736891411,1736891411.99792,-21600,,
com.google.android.studio,1,1736891409,1736891410,1736891410.6832762,-21600,,
com.google.Chrome,39,1736891370,1736891409,1736891409.152075,-21600,,
com.google.android.studio,122,1736891248,1736891370,1736891370.926722,-21600,,
com.google.Chrome,67,1736891181,1736891248,1736891248.293772,-21600,,
com.google.android.studio,104,1736891077,1736891181,1736891181.726035,-21600,,
com.apple.dt.Xcode,2,1736891075,1736891077,1736891077.388458,-21600,,
com.google.android.studio,547,1736890528,1736891075,1736891075.782794,-21600,,
com.google.Chrome,1,1736890527,1736890528,1736890528.928012,-21600,,
com.google.android.studio,12,1736890515,1736890527,1736890527.8570662,-21600,,
com.google.Chrome,2,1736890513,1736890515,1736890515.559669,-21600,,
com.google.android.studio,44,1736890469,1736890513,1736890513.777977,-21600,,
com.google.Chrome,4,1736890465,1736890469,1736890470.033875,-21600,,
com.google.android.studio,4,1736890461,1736890465,1736890465.711088,-21600,,
com.google.Chrome,3,1736890458,1736890461,1736890461.613838,-21600,,
com.google.android.studio,5,1736890453,1736890458,1736890459.003546,-21600,,
com.google.Chrome,2,1736890451,1736890453,1736890453.7404819,-21600,,
com.google.android.studio,4,1736890447,1736890451,1736890451.6896849,-21600,,
com.google.Chrome,1,1736890446,1736890447,1736890448.276283,-21600,,
com.google.android.studio,2,1736890444,1736890446,1736890446.8027291,-21600,,
com.google.Chrome,38,1736890406,1736890444,1736890444.074858,-21600,,
com.google.android.studio,1290,1736889116,1736890406,1736890406.659786,-21600,,
com.apple.finder,2,1736889061,1736889063,1736889063.843638,-21600,,
com.google.android.studio,12,1736889049,1736889061,1736889061.154496,-21600,,
com.apple.finder,5,1736889044,1736889049,1736889049.4833422,-21600,,
com.microsoft.Office.Outlook,6,1736888802,1736888808,1736888808.228524,-21600,EB445137-D7F5-57EC-87DA-1DB460D64046,"iPhone13,2"
com.apple.findmy,2,1736888775,1736888777,1736888777.598617,-21600,EB445137-D7F5-57EC-87DA-1DB460D64046,"iPhone13,2"
com.apple.findmy,13,1736888591,1736888604,1736888605.361723,-21600,EB445137-D7F5-57EC-87DA-1DB460D64046,"iPhone13,2"
com.apple.Music,2,1736888589,1736888591,1736888591.604594,-21600,EB445137-D7F5-57EC-87DA-1DB460D64046,"iPhone13,2"
com.apple.finder,8,1736825009,1736825017,1736825017.166325,-21600,,
com.google.Chrome,12,1736824997,1736825009,1736825009.235832,-21600,,
com.microsoft.onenote.mac,4,1736824993,1736824997,1736824997.878221,-21600,,
com.google.android.studio,152,1736824841,1736824993,1736824993.646092,-21600,,
com.google.Chrome,433,1736824408,1736824841,1736824841.066314,-21600,,
com.google.Chrome,1252,1736822567,1736823819,1736823819.1430302,-21600,,
com.google.Chrome,994,1736821495,1736822489,1736822489.216563,-21600,,
com.google.Chrome,393,1736820661,1736821054,1736821054.1435509,-21600,,
com.google.Chrome,308,1736819655,1736819963,1736819963.2336102,-21600,,
com.google.Chrome,565,1736818366,1736818931,1736818931.4956,-21600,,
com.apple.MobileSMS,6,1736818360,1736818366,1736818366.405,-21600,,
com.google.Chrome,42,1736818318,1736818360,1736818360.14902,-21600,,
com.apple.MobileSMS,20,1736818298,1736818318,1736818318.7868419,-21600,,
com.google.Chrome,3,1736818295,1736818298,1736818298.226573,-21600,,
com.google.android.studio,3,1736818292,1736818295,1736818295.8866138,-21600,,
com.google.android.studio,503,1736816670,1736817173,1736817173.3252192,-21600,,
com.google.Chrome,19,1736816651,1736816670,1736816670.0581632,-21600,,
com.google.android.studio,253,1736816398,1736816651,1736816651.790298,-21600,,
com.google.Chrome,2,1736816396,1736816398,1736816398.526842,-21600,,
com.google.android.studio,6,1736816390,1736816396,1736816396.27676,-21600,,
com.google.Chrome,1,1736816389,1736816390,1736816390.859768,-21600,,
com.google.android.studio,6,1736816383,1736816389,1736816389.959303,-21600,,
com.google.Chrome,1,1736816382,1736816383,1736816383.9784389,-21600,,
com.google.android.studio,4,1736816378,1736816382,1736816382.597548,-21600,,
com.google.Chrome,2,1736816376,1736816378,1736816378.1630201,-21600,,
com.google.android.studio,6,1736816370,1736816376,1736816376.054904,-21600,,
com.google.Chrome,15,1736816355,1736816370,1736816370.5410461,-21600,,
com.google.android.studio,4,1736816351,1736816355,1736816355.414837,-21600,,
com.google.Chrome,0,1736816351,1736816351,1736816351.7355108,-21600,,
com.google.android.studio,2,1736816349,1736816351,1736816351.2273312,-21600,,
com.google.Chrome,7,1736816342,1736816349,1736816349.834816,-21600,,
com.google.android.studio,2,1736816340,1736816342,1736816342.591161,-21600,,
com.google.Chrome,13,1736816327,1736816340,1736816340.268052,-21600,,
com.google.android.studio,6,1736816321,1736816327,1736816327.548655,-21600,,
com.google.Chrome,14,1736816307,1736816321,1736816321.521774,-21600,,
com.google.android.studio,30,1736816277,1736816307,1736816307.456425,-21600,,
com.google.Chrome,4,1736816273,1736816277,1736816277.873014,-21600,,
com.google.android.studio,22,1736816251,1736816273,1736816273.579771,-21600,,
com.google.Chrome,0,1736816251,1736816251,1736816251.9958959,-21600,,
com.google.android.studio,1,1736816250,1736816251,1736816251.261217,-21600,,
com.google.Chrome,1,1736816249,1736816250,1736816250.3069692,-21600,,
com.google.android.studio,8,1736816241,1736816249,1736816249.3219662,-21600,,
com.google.Chrome,2,1736816239,1736816241,1736816241.9053311,-21600,,
com.google.android.studio,1,1736816238,1736816239,1736816239.597224,-21600,,
com.google.Chrome,17,1736816221,1736816238,1736816238.3949971,-21600,,
com.google.android.studio,105,1736816116,1736816221,1736816221.594492,-21600,,
com.apple.dt.Xcode,2,1736816114,1736816116,1736816116.3966532,-21600,,
com.google.android.studio,24,1736816090,1736816114,1736816114.135415,-21600,,
com.apple.dt.Xcode,1,1736816089,1736816090,1736816090.80928,-21600,,
com.google.android.studio,9,1736816080,1736816089,1736816089.226334,-21600,,
com.apple.dt.Xcode,1,1736816079,1736816080,1736816080.7708402,-21600,,
com.google.android.studio,35,1736816044,1736816079,1736816079.3811011,-21600,,
com.apple.dt.Xcode,1,1736816043,1736816044,1736816044.598628,-21600,,
com.google.android.studio,4,1736816039,1736816043,1736816043.135854,-21600,,
com.apple.dt.Xcode,1,1736816038,1736816039,1736816040.0055661,-21600,,
com.google.android.studio,2,1736816036,1736816038,1736816038.9643211,-21600,,
com.apple.dt.Xcode,5,1736816031,1736816036,1736816036.341265,-21600,,
com.google.android.studio,1,1736816030,1736816031,1736816031.6353478,-21600,,
com.apple.dt.Xcode,5,1736816025,1736816030,1736816030.433899,-21600,,
com.google.android.studio,7,1736816018,1736816025,1736816025.889559,-21600,,
com.apple.dt.Xcode,6,1736816012,1736816018,1736816018.0634131,-21600,,
com.google.android.studio,2,1736816010,1736816012,1736816012.9097118,-21600,,
com.apple.dt.Xcode,1,1736816009,1736816010,1736816010.659308,-21600,,
com.google.android.studio,113,1736815896,1736816009,1736816009.826953,-21600,,
com.apple.dt.Xcode,1,1736815895,1736815896,1736815896.838893,-21600,,
com.google.android.studio,26,1736815869,1736815895,1736815895.649499,-21600,,
com.apple.dt.Xcode,1,1736815868,1736815869,1736815870.033294,-21600,,
com.google.android.studio,220,1736815648,1736815868,1736815868.344051,-21600,,
com.apple.dt.Xcode,3,1736815645,1736815648,1736815648.230799,-21600,,
com.google.android.studio,40,1736815605,1736815645,1736815645.99692,-21600,,
com.apple.dt.Xcode,2,1736815603,1736815605,1736815605.803568,-21600,,
com.google.android.studio,7,1736815596,1736815603,1736815603.2609692,-21600,,
com.apple.dt.Xcode,1,1736815595,1736815596,1736815597.008803,-21600,,
com.google.android.studio,1,1736815594,1736815595,1736815595.9899511,-21600,,
com.apple.dt.Xcode,5,1736815589,1736815594,1736815595.0244,-21600,,
com.google.android.studio,2,1736815587,1736815589,1736815589.8035722,-21600,,
com.apple.dt.Xcode,15,1736815572,1736815587,1736815587.5401921,-21600,,
com.google.android.studio,587,1736814985,1736815572,1736815572.881279,-21600,,
com.apple.dt.Xcode,11,1736814974,1736814985,1736814985.393141,-21600,,
com.google.android.studio,13,1736814961,1736814974,1736814974.4380531,-21600,,
com.google.Chrome,27,1736814934,1736814961,1736814961.961028,-21600,,
com.google.android.studio,356,1736814578,1736814934,1736814934.4912848,-21600,,
com.google.Chrome,16,1736814562,1736814578,1736814578.942121,-21600,,
com.google.android.studio,8,1736814554,1736814562,1736814562.390746,-21600,,
com.google.Chrome,3,1736814551,1736814554,1736814554.702344,-21600,,
com.google.android.studio,35,1736814516,1736814551,1736814551.183766,-21600,,
com.google.Chrome,0,1736814516,1736814516,1736814516.5425491,-21600,,
com.google.android.studio,1,1736814515,1736814516,1736814516.148221,-21600,,
com.apple.dt.Xcode,1,1736814514,1736814515,1736814515.436747,-21600,,
com.google.Chrome,6,1736814508,1736814514,1736814514.357166,-21600,,
com.apple.dt.Xcode,1,1736814507,1736814508,1736814508.851891,-21600,,
com.google.android.studio,62,1736814445,1736814507,1736814507.468029,-21600,,
com.apple.dt.Xcode,20,1736814425,1736814445,1736814445.603222,-21600,,
com.google.Chrome,7,1736814418,1736814425,1736814425.7699552,-21600,,
com.google.Chrome,6,1736811930,1736811936,1736811936.5326219,-21600,,
com.apple.finder,10,1736811920,1736811930,1736811930.7992802,-21600,,
com.cisco.secureclient.gui,6,1736811914,1736811920,1736811921.0281239,-21600,,
com.apple.finder,1,1736811913,1736811914,1736811914.584344,-21600,,
com.apple.Terminal,87,1736811826,1736811913,1736811913.571404,-21600,,
com.apple.TextEdit,71,1736811755,1736811826,1736811826.869549,-21600,,
com.apple.Terminal,225,1736811530,1736811755,1736811755.354182,-21600,,
com.apple.TextEdit,2,1736811528,1736811530,1736811530.1896892,-21600,,
com.apple.iCal,3,1736811525,1736811528,1736811528.804048,-21600,,
com.apple.TextEdit,39,1736811486,1736811525,1736811525.7237659,-21600,,
com.apple.finder,2,1736811484,1736811486,1736811486.585462,-21600,,
com.apple.TextEdit,13,1736811471,1736811484,1736811484.890184,-21600,,
com.apple.finder,1,1736811470,1736811471,1736811471.402021,-21600,,
com.apple.Terminal,224,1736811246,1736811470,1736811470.9337401,-21600,,
com.google.Chrome,1,1736811245,1736811246,1736811246.948477,-21600,,
com.apple.Terminal,36,1736811209,1736811245,1736811245.6143699,-21600,,
com.google.Chrome,28,1736811181,1736811209,1736811209.048897,-21600,,
com.apple.Terminal,5,1736811176,1736811181,1736811181.10572,-21600,,
com.google.Chrome,3,1736811173,1736811176,1736811176.130764,-21600,,
com.apple.Terminal,102,1736811071,1736811173,1736811173.624083,-21600,,
com.cisco.secureclient.gui,4,1736811067,1736811071,1736811071.465125,-21600,,
com.apple.finder,5,1736811062,1736811067,1736811067.203963,-21600,,
com.cisco.secureclient.gui,2,1736811060,1736811062,1736811062.410458,-21600,,
com.apple.finder,10,1736811050,1736811060,1736811060.966433,-21600,,
com.cisco.secureclient.gui,23,1736811027,1736811050,1736811050.8276439,-21600,,
com.apple.finder,10,1736811017,1736811027,1736811027.6851401,-21600,,
com.microsoft.onenote.mac,4,1736811013,1736811017,1736811018.897519,-21600,,
com.google.android.studio,0,1736811013,1736811013,1736811014.038406,-21600,,
com.apple.dt.Xcode,1,1736811012,1736811013,1736811013.2299662,-21600,,
com.google.Chrome,7,1736811005,1736811012,1736811012.892456,-21600,,
com.microsoft.onenote.mac,12,1736810993,1736811005,1736811006.0421572,-21600,,
com.microsoft.onenote.mac,431,1736805802,1736806233,1736806233.617912,-21600,,
com.google.android.studio,89,1736805713,1736805802,1736805802.915268,-21600,,
com.apple.MobileSMS,8,1736805705,1736805713,1736805713.593956,-21600,,
com.google.android.studio,571,1736805134,1736805705,1736805705.6467052,-21600,,
com.apple.MobileSMS,10,1736805124,1736805134,1736805134.3881512,-21600,,
com.google.android.studio,23,1736805101,1736805124,1736805124.0958729,-21600,,
com.apple.MobileSMS,6,1736805095,1736805101,1736805101.583313,-21600,,
com.google.android.studio,366,1736804729,1736805095,1736805095.963653,-21600,,
com.apple.MobileSMS,8,1736804721,1736804729,1736804729.409824,-21600,,
com.google.android.studio,2,1736804719,1736804721,1736804721.617093,-21600,,
com.apple.MobileSMS,6,1736804713,1736804719,1736804719.257285,-21600,,
com.google.android.studio,427,1736804286,1736804713,1736804713.294184,-21600,,
com.google.Chrome,88,1736804198,1736804286,1736804286.489207,-21600,,
com.google.android.studio,846,1736803352,1736804198,1736804198.3034391,-21600,,
com.google.Chrome,3,1736803349,1736803352,1736803352.181386,-21600,,
com.google.android.studio,14,1736803335,1736803349,1736803349.403523,-21600,,
com.google.Chrome,20,1736803315,1736803335,1736803335.1898699,-21600,,
com.google.android.studio,61,1736803254,1736803315,1736803315.2709022,-21600,,
com.google.Chrome,57,1736803197,1736803254,1736803254.89133,-21600,,
com.google.android.studio,226,1736802971,1736803197,1736803197.922224,-21600,,
com.google.Chrome,49,1736802922,1736802971,1736802971.1188831,-21600,,
com.google.android.studio,526,1736802396,1736802922,1736802923.08248,-21600,,
com.apple.dt.Xcode,89,1736802307,1736802396,1736802396.710569,-21600,,
com.google.android.studio,299,1736802008,1736802307,1736802307.770687,-21600,,
com.google.Chrome,1,1736802007,1736802008,1736802008.3079271,-21600,,
com.google.android.studio,5,1736802002,1736802007,1736802007.233971,-21600,,
com.google.Chrome,2,1736802000,1736802002,1736802002.269349,-21600,,
com.google.android.studio,5,1736801995,1736802000,1736802000.92851,-21600,,
com.google.Chrome,1,1736801994,1736801995,1736801995.305134,-21600,,
com.google.android.studio,7,1736801987,1736801994,1736801994.722362,-21600,,
com.google.Chrome,77,1736801910,1736801987,1736801987.669301,-21600,,
com.google.android.studio,11,1736801899,1736801910,1736801910.062913,-21600,,
com.google.Chrome,8,1736801891,1736801899,1736801899.718483,-21600,,
com.google.android.studio,95,1736801796,1736801891,1736801891.792829,-21600,,
com.google.Chrome,1586,1736800158,1736801744,1736801744.832639,-21600,,
com.apple.Terminal,1,1736800157,1736800158,1736800158.251954,-21600,,
com.google.Chrome,3,1736800154,1736800157,1736800157.0569282,-21600,,
com.cisco.secureclient.gui,6,1736800148,1736800154,1736800155.0567951,-21600,,
com.apple.Terminal,9,1736800139,1736800148,1736800148.868366,-21600,,
com.cisco.secureclient.gui,1,1736800138,1736800139,1736800139.784575,-21600,,
com.apple.iCal,299,1736799839,1736800138,1736800138.882244,-21600,,
com.apple.findmy,53,1736799786,1736799839,1736799839.645437,-21600,,
com.apple.iCal,4,1736799782,1736799786,1736799786.490951,-21600,,
com.cisco.secureclient.gui,140,1736799642,1736799782,1736799782.294901,-21600,,
com.apple.Terminal,296,1736799346,1736799642,1736799642.6749039,-21600,,
com.google.Chrome,36,1736799310,1736799346,1736799346.788673,-21600,,
com.apple.Terminal,18,1736799292,1736799310,1736799310.266923,-21600,,
com.google.Chrome,16,1736799276,1736799292,1736799292.797915,-21600,,
com.apple.Terminal,16,1736799260,1736799276,1736799276.9853501,-21600,,
com.google.Chrome,4,1736799256,1736799260,1736799260.062185,-21600,,
com.apple.Terminal,12,1736799244,1736799256,1736799256.108111,-21600,,
com.google.Chrome,47,1736799197,1736799244,1736799244.493904,-21600,,
com.apple.Terminal,148,1736799049,1736799197,1736799197.238109,-21600,,
com.microsoft.Outlook,3,1736799046,1736799049,1736799049.9565902,-21600,,
com.cisco.secureclient.gui,40,1736799006,1736799046,1736799046.764641,-21600,,
com.google.Chrome,20,1736798986,1736799006,1736799006.140666,-21600,,
com.microsoft.Outlook,1,1736798985,1736798986,1736798986.139427,-21600,,
com.google.Chrome,12,1736798973,1736798985,1736798985.193898,-21600,,
com.microsoft.Outlook,2,1736798971,1736798973,1736798973.8512158,-21600,,
com.google.Chrome,6,1736798965,1736798971,1736798971.12003,-21600,,
com.microsoft.Outlook,12,1736798953,1736798965,1736798965.759088,-21600,,
com.google.Chrome,65,1736798888,1736798953,1736798953.7383351,-21600,,
com.microsoft.Outlook,17,1736798858,1736798875,1736798875.547079,-21600,,
com.google.Chrome,504,1736798354,1736798858,1736798858.636584,-21600,,
com.google.Chrome,357,1736780573,1736780930,1736780930.959968,-21600,,
com.google.Chrome,44,1736740476,1736740520,1736740521.050858,-21600,,
com.google.Chrome,301,1736739745,1736740046,1736740046.0899692,-21600,,
com.google.Chrome,1157,1736738453,1736739610,1736739610.843614,-21600,,
com.google.Chrome,836,1736737323,1736738159,1736738159.519088,-21600,,
com.google.Chrome,557,1736736557,1736737114,1736737114.3024812,-21600,,
com.google.Chrome,330,1736735885,1736736215,1736736215.2382832,-21600,,
com.google.Chrome,579,1736734072,1736734651,1736734651.838811,-21600,,
com.google.Chrome,375,1736733230,1736733605,1736733605.32585,-21600,,
com.google.Chrome,2425,1736729931,1736732356,1736732356.91791,-21600,,
com.google.Chrome,13,1736716053,1736716066,1736716066.06465,-21600,,
com.apple.news,39,1736716014,1736716053,1736716053.873001,-21600,,
com.google.Chrome,247,1736715767,1736716014,1736716014.741179,-21600,,
com.google.Chrome,623,1736715130,1736715753,1736715753.563346,-21600,,
com.google.Chrome,247,1736711561,1736711808,1736711808.554275,-21600,,
com.google.Chrome,7,1736710541,1736710548,1736710548.51335,-21600,,
com.microsoft.onenote.mac,17,1736710524,1736710541,1736710541.176868,-21600,,
com.google.android.studio,144,1736710380,1736710524,1736710525.053495,-21600,,
com.google.Chrome,61,1736710319,1736710380,1736710380.917252,-21600,,
com.google.android.studio,46,1736710273,1736710319,1736710319.612848,-21600,,
com.google.Chrome,43,1736710230,1736710273,1736710273.800648,-21600,,
com.google.android.studio,135,1736710095,1736710230,1736710230.0813189,-21600,,
com.google.Chrome,2252,1736707843,1736710095,1736710095.287068,-21600,,
com.google.Chrome,1118,1736706664,1736707782,1736707782.8655992,-21600,,
com.apple.finder,14,1736706650,1736706664,1736706664.726423,-21600,,
com.microsoft.Excel,263,1736706387,1736706650,1736706650.995335,-21600,,
com.apple.finder,16,1736706371,1736706387,1736706387.1165218,-21600,,
com.apple.iCal,26,1736706345,1736706371,1736706371.982417,-21600,,
com.leomehlig.today,104,1736706241,1736706345,1736706345.8923302,-21600,,
com.apple.iCal,5,1736706236,1736706241,1736706241.39558,-21600,,
com.leomehlig.today,3,1736706233,1736706236,1736706236.2732348,-21600,,
com.apple.iCal,6,1736706227,1736706233,1736706233.895253,-21600,,
com.google.Chrome,159,1736706068,1736706227,1736706228.012516,-21600,,
com.apple.iCal,23,1736706045,1736706068,1736706068.909158,-21600,,
com.google.Chrome,274,1736705771,1736706045,1736706046.018559,-21600,,
com.apple.iCal,34,1736705715,1736705749,1736705750.04359,-21600,,
com.google.Chrome,70,1736705645,1736705715,1736705715.207093,-21600,,
com.google.android.studio,18,1736705627,1736705645,1736705645.997941,-21600,,
com.google.android.studio,497,1736704377,1736704874,1736704874.845982,-21600,,
com.google.Chrome,1,1736704376,1736704377,1736704377.43696,-21600,,
com.google.android.studio,330,1736704046,1736704376,1736704376.874953,-21600,,
com.google.Chrome,28,1736704018,1736704046,1736704046.747414,-21600,,
com.google.android.studio,8,1736704010,1736704018,1736704018.703868,-21600,,
com.google.Chrome,1,1736704009,1736704010,1736704010.5806189,-21600,,
com.google.android.studio,8,1736704001,1736704009,1736704009.572329,-21600,,
com.google.Chrome,2,1736703999,1736704001,1736704001.610553,-21600,,
com.google.android.studio,10,1736703989,1736703999,1736703999.90096,-21600,,
com.google.Chrome,2,1736703987,1736703989,1736703989.999837,-21600,,
com.google.android.studio,6,1736703981,1736703987,1736703987.1531758,-21600,,
com.google.Chrome,0,1736703981,1736703981,1736703981.89682,-21600,,
com.google.android.studio,1,1736703980,1736703981,1736703981.0416942,-21600,,
com.google.Chrome,2,1736703978,1736703980,1736703980.700801,-21600,,
com.google.android.studio,1,1736703977,1736703978,1736703979.033458,-21600,,
com.google.Chrome,1,1736703976,1736703977,1736703977.5906591,-21600,,
com.google.android.studio,13,1736703963,1736703976,1736703976.498877,-21600,,
com.google.Chrome,1,1736703962,1736703963,1736703964.070516,-21600,,
com.google.android.studio,7,1736703955,1736703962,1736703962.066691,-21600,,
com.google.Chrome,2,1736703953,1736703955,1736703955.088272,-21600,,
com.google.android.studio,2,1736703951,1736703953,1736703953.834169,-21600,,
com.google.Chrome,3,1736703948,1736703951,1736703951.056359,-21600,,
com.google.android.studio,2,1736703946,1736703948,1736703948.9242868,-21600,,
com.google.Chrome,1,1736703945,1736703946,1736703946.441063,-21600,,
com.google.android.studio,2,1736703943,1736703945,1736703945.075145,-21600,,
com.google.Chrome,2,1736703941,1736703943,1736703943.716218,-21600,,
com.google.android.studio,52,1736703889,1736703941,1736703941.074646,-21600,,
com.google.Chrome,4,1736703885,1736703889,1736703889.772187,-21600,,
com.google.android.studio,4,1736703881,1736703885,1736703885.704247,-21600,,
com.google.Chrome,0,1736703881,1736703881,1736703881.81552,-21600,,
com.google.android.studio,9,1736703872,1736703881,1736703881.073725,-21600,,
com.google.Chrome,2,1736703870,1736703872,1736703872.436553,-21600,,
com.google.android.studio,3,1736703867,1736703870,1736703871.0230289,-21600,,
com.google.Chrome,1,1736703866,1736703867,1736703867.6156301,-21600,,
com.google.android.studio,6,1736703860,1736703866,1736703866.373184,-21600,,
com.google.Chrome,2,1736703858,1736703860,1736703860.5125961,-21600,,
com.google.android.studio,4,1736703854,1736703858,1736703858.831121,-21600,,
com.google.Chrome,1,1736703853,1736703854,1736703854.966632,-21600,,
com.google.android.studio,32,1736703821,1736703853,1736703853.185749,-21600,,
com.google.Chrome,0,1736703821,1736703821,1736703821.717798,-21600,,
com.google.android.studio,3,1736703818,1736703821,1736703821.0841131,-21600,,
com.google.Chrome,12,1736703806,1736703818,1736703818.2191439,-21600,,
com.google.android.studio,3,1736703803,1736703806,1736703806.43113,-21600,,
com.google.Chrome,2,1736703801,1736703803,1736703803.092668,-21600,,
com.google.android.studio,16,1736703785,1736703801,1736703801.129761,-21600,,
com.google.android.studio,300,1736703396,1736703696,1736703696.389307,-21600,,
com.google.Chrome,16,1736703380,1736703396,1736703396.421255,-21600,,
com.google.android.studio,31,1736703349,1736703380,1736703380.4013119,-21600,,
com.google.Chrome,90,1736703259,1736703349,1736703349.164068,-21600,,
com.google.android.studio,4,1736703255,1736703259,1736703259.181051,-21600,,
com.google.Chrome,35,1736703220,1736703255,1736703255.897887,-21600,,
com.google.android.studio,346,1736702874,1736703220,1736703220.921529,-21600,,
com.google.Chrome,10,1736702864,1736702874,1736702875.037147,-21600,,
com.google.android.studio,198,1736702666,1736702864,1736702864.430187,-21600,,
com.google.Chrome,1,1736702665,1736702666,1736702666.806126,-21600,,
com.google.android.studio,10,1736702655,1736702665,1736702665.3931,-21600,,
com.google.Chrome,13,1736702642,1736702655,1736702655.5257978,-21600,,
com.google.android.studio,39,1736702603,1736702642,1736702642.247946,-21600,,
com.google.Chrome,57,1736702546,1736702603,1736702603.884983,-21600,,
com.google.android.studio,195,1736702351,1736702546,1736702546.366784,-21600,,
com.google.Chrome,134,1736702217,1736702351,1736702351.165862,-21600,,
com.google.android.studio,1,1736702216,1736702217,1736702217.202145,-21600,,
com.google.android.studio,306,1736701607,1736701913,1736701913.5618172,-21600,,
com.apple.dt.Xcode,43,1736701564,1736701607,1736701607.5918288,-21600,,
com.google.android.studio,399,1736701165,1736701564,1736701564.658437,-21600,,
com.apple.dt.Xcode,56,1736701109,1736701165,1736701165.313696,-21600,,
com.google.android.studio,24,1736701085,1736701109,1736701109.3905768,-21600,,
com.apple.dt.Xcode,23,1736701062,1736701085,1736701085.467891,-21600,,
com.google.android.studio,3,1736701059,1736701062,1736701062.207876,-21600,,
com.apple.dt.Xcode,1,1736701058,1736701059,1736701059.3799338,-21600,,
com.google.android.studio,11,1736701047,1736701058,1736701058.136561,-21600,,
com.apple.dt.Xcode,22,1736701025,1736701047,1736701047.69973,-21600,,
com.google.android.studio,126,1736700899,1736701025,1736701025.770323,-21600,,
com.google.Chrome,2,1736700897,1736700899,1736700899.43592,-21600,,
com.apple.dt.Xcode,14,1736700883,1736700897,1736700897.0738459,-21600,,
com.google.Chrome,2,1736700881,1736700883,1736700883.102664,-21600,,
com.google.android.studio,7,1736700874,1736700881,1736700881.696834,-21600,,
com.apple.dt.Xcode,7,1736700867,1736700874,1736700874.195724,-21600,,
com.google.android.studio,69,1736700798,1736700867,1736700867.412863,-21600,,
com.apple.dt.Xcode,1,1736700797,1736700798,1736700798.9223151,-21600,,
com.google.android.studio,2,1736700795,1736700797,1736700797.4015179,-21600,,
com.apple.dt.Xcode,4,1736700791,1736700795,1736700795.252814,-21600,,
com.google.android.studio,1,1736700790,1736700791,1736700791.513197,-21600,,
com.apple.dt.Xcode,3,1736700787,1736700790,1736700790.758487,-21600,,
com.google.android.studio,6,1736700781,1736700787,1736700787.519983,-21600,,
com.apple.dt.Xcode,5,1736700776,1736700781,1736700781.546485,-21600,,
com.google.android.studio,98,1736700678,1736700776,1736700776.637251,-21600,,
com.google.Chrome,31,1736700647,1736700678,1736700678.618072,-21600,,
com.google.android.studio,330,1736700317,1736700647,1736700647.774664,-21600,,
com.apple.dt.Xcode,3,1736700314,1736700317,1736700317.283675,-21600,,
com.google.Chrome,4,1736700310,1736700314,1736700315.009445,-21600,,
com.apple.dt.Xcode,1,1736700309,1736700310,1736700310.132796,-21600,,
com.google.Chrome,5,1736700304,1736700309,1736700309.613425,-21600,,
com.apple.dt.Xcode,1,1736700303,1736700304,1736700304.8765001,-21600,,
com.google.android.studio,18,1736700285,1736700303,1736700303.439969,-21600,,
com.apple.dt.Xcode,4,1736700281,1736700285,1736700285.827887,-21600,,
com.google.android.studio,40,1736700241,1736700281,1736700282.026144,-21600,,
com.google.Chrome,64,1736700177,1736700241,1736700242.026494,-21600,,
com.google.android.studio,49,1736700128,1736700177,1736700177.637419,-21600,,
com.apple.dt.Xcode,0,1736700128,1736700128,1736700128.996453,-21600,,
com.google.android.studio,4,1736700124,1736700128,1736700128.3003612,-21600,,
com.apple.dt.Xcode,144,1736699980,1736700124,1736700124.50313,-21600,,
com.google.android.studio,103,1736699877,1736699980,1736699980.8681679,-21600,,
com.apple.dt.Xcode,37,1736699840,1736699877,1736699877.360929,-21600,,
com.google.android.studio,75,1736699765,1736699840,1736699840.7884722,-21600,,
com.microsoft.onenote.mac,10,1736699691,1736699701,1736699702.02642,-21600,,
com.microsoft.onenote.mac,45,1736653481,1736653526,1736653526.822094,-21600,,
com.microsoft.onenote.mac,171,1736634085,1736634256,1736634256.674139,-21600,,
com.apple.Photos,145,1736633940,1736634085,1736634085.1881971,-21600,,
com.microsoft.onenote.mac,9,1736633931,1736633940,1736633940.0639272,-21600,,
com.apple.Photos,18,1736633913,1736633931,1736633931.282063,-21600,,
com.microsoft.onenote.mac,173,1736633740,1736633913,1736633913.611016,-21600,,
com.google.Chrome,70,1736633670,1736633740,1736633740.28318,-21600,,
com.microsoft.onenote.mac,6,1736633572,1736633578,1736633579.5518122,-21600,,
com.microsoft.onenote.mac,142,1736629883,1736630025,1736630025.942497,-21600,,
com.google.Chrome,8,1736629875,1736629883,1736629883.379404,-21600,,
com.google.android.studio,505,1736629370,1736629875,1736629875.464912,-21600,,
com.apple.dt.Xcode,97,1736629273,1736629370,1736629370.779516,-21600,,
com.google.android.studio,985,1736628288,1736629273,1736629273.653971,-21600,,
com.google.Chrome,2,1736628286,1736628288,1736628288.1160588,-21600,,
com.google.android.studio,92,1736628194,1736628286,1736628287.001194,-21600,,
com.google.Chrome,3,1736628191,1736628194,1736628195.020843,-21600,,
com.google.android.studio,15,1736628176,1736628191,1736628191.7870111,-21600,,
com.google.Chrome,4,1736628172,1736628176,1736628176.121176,-21600,,
com.google.android.studio,3,1736628169,1736628172,1736628172.310659,-21600,,
com.google.Chrome,4,1736628165,1736628169,1736628169.930527,-21600,,
com.google.android.studio,5,1736628160,1736628165,1736628165.978578,-21600,,
com.google.Chrome,1,1736628159,1736628160,1736628160.282627,-21600,,
com.google.android.studio,3,1736628156,1736628159,1736628159.213721,-21600,,
com.google.Chrome,1,1736628155,1736628156,1736628156.2354121,-21600,,
com.google.android.studio,28,1736628127,1736628155,1736628155.1352181,-21600,,
com.google.Chrome,1,1736628126,1736628127,1736628127.321363,-21600,,
com.google.android.studio,3,1736628123,1736628126,1736628126.219118,-21600,,
com.google.Chrome,1,1736628122,1736628123,1736628124.051229,-21600,,
com.google.android.studio,5,1736628117,1736628122,1736628122.628286,-21600,,
com.google.Chrome,0,1736628117,1736628117,1736628117.953977,-21600,,
com.google.android.studio,7,1736628110,1736628117,1736628117.221898,-21600,,
com.google.Chrome,11,1736628099,1736628110,1736628110.811212,-21600,,
com.google.android.studio,7,1736628092,1736628099,1736628099.1826348,-21600,,
com.google.Chrome,7,1736628085,1736628092,1736628092.292665,-21600,,
com.google.android.studio,4,1736628081,1736628085,1736628085.248827,-21600,,
com.google.Chrome,19,1736628062,1736628081,1736628081.56104,-21600,,
com.google.android.studio,9,1736628053,1736628062,1736628062.674618,-21600,,
com.google.Chrome,48,1736628005,1736628053,1736628053.568367,-21600,,
com.google.android.studio,86,1736627919,1736628005,1736628005.36206,-21600,,
com.google.Chrome,13,1736627906,1736627919,1736627919.629819,-21600,,
com.google.android.studio,36,1736627870,1736627906,1736627906.589524,-21600,,
com.google.Chrome,3,1736627867,1736627870,1736627870.339288,-21600,,
com.google.android.studio,3,1736627864,1736627867,1736627867.805373,-21600,,
com.google.Chrome,1,1736627863,1736627864,1736627864.2329478,-21600,,
com.google.android.studio,36,1736627827,1736627863,1736627863.141082,-21600,,
com.google.Chrome,2,1736627825,1736627827,1736627827.314883,-21600,,
com.google.android.studio,62,1736627763,1736627825,1736627825.264355,-21600,,
com.google.Chrome,45,1736627718,1736627763,1736627763.404005,-21600,,
com.google.android.studio,296,1736627422,1736627718,1736627718.770473,-21600,,
com.google.Chrome,25,1736627397,1736627422,1736627422.197698,-21600,,
com.google.android.studio,14,1736627383,1736627397,1736627397.359617,-21600,,
com.google.Chrome,107,1736627276,1736627383,1736627383.748321,-21600,,
com.google.android.studio,466,1736626810,1736627276,1736627277.004125,-21600,,
com.apple.dt.Xcode,4,1736626806,1736626810,1736626810.710738,-21600,,
com.google.android.studio,52,1736626754,1736626806,1736626806.8494658,-21600,,
com.apple.dt.Xcode,8,1736626746,1736626754,1736626754.9277759,-21600,,
com.google.android.studio,203,1736626543,1736626746,1736626746.756147,-21600,,
com.google.Chrome,12,1736626531,1736626543,1736626543.600234,-21600,,
com.google.Chrome,519,1736625837,1736626356,1736626357.059012,-21600,,
com.google.android.studio,549,1736625288,1736625837,1736625837.685139,-21600,,
com.apple.dt.Xcode,5,1736625283,1736625288,1736625288.291751,-21600,,
com.google.android.studio,189,1736625094,1736625283,1736625283.996005,-21600,,
com.apple.dt.Xcode,74,1736625020,1736625094,1736625094.438143,-21600,,
com.google.android.studio,537,1736624483,1736625020,1736625021.039474,-21600,,
com.apple.dt.Xcode,6,1736624477,1736624483,1736624483.260818,-21600,,
com.google.android.studio,168,1736624309,1736624477,1736624477.223424,-21600,,
com.apple.dt.Xcode,32,1736624277,1736624309,1736624309.641138,-21600,,
com.google.android.studio,23,1736624254,1736624277,1736624277.282418,-21600,,
com.apple.dt.Xcode,4,1736624250,1736624254,1736624254.052978,-21600,,
com.google.android.studio,263,1736623987,1736624250,1736624250.392435,-21600,,
com.apple.dt.Xcode,1,1736623923,1736623924,1736623924.7942672,-21600,,
com.google.android.studio,78,1736623845,1736623923,1736623924.000719,-21600,,
com.apple.dt.Xcode,47,1736623798,1736623845,1736623845.492897,-21600,,
com.microsoft.onenote.mac,8,1736623790,1736623798,1736623798.882125,-21600,,
com.apple.Music,46,1736623744,1736623790,1736623790.6063728,-21600,,
com.google.Chrome,15,1736623729,1736623744,1736623744.786419,-21600,,
com.google.Chrome,1971,1736619966,1736621937,1736621937.8288078,-21600,,
com.apple.MobileSMS,30,1736617257,1736617287,1736617287.3141909,-21600,EB445137-D7F5-57EC-87DA-1DB460D64046,"iPhone13,2"
com.microsoft.Office.Outlook,7,1736614546,1736614553,1736614553.377058,-21600,EB445137-D7F5-57EC-87DA-1DB460D64046,"iPhone13,2"
com.apple.Health,32,1736614493,1736614525,1736614526.105091,-21600,EB445137-D7F5-57EC-87DA-1DB460D64046,"iPhone13,2"
com.apple.findmy,6,1736612867,1736612873,1736612873.993627,-21600,EB445137-D7F5-57EC-87DA-1DB460D64046,"iPhone13,2"
com.google.Chrome,1772,1736612705,1736614477,1736614477.6658459,-21600,,
com.apple.Music,33,1736612672,1736612705,1736612705.280771,-21600,,
com.google.Chrome,0,1736612672,1736612672,1736612672.974656,-21600,,
com.apple.Music,1,1736612671,1736612672,1736612672.195719,-21600,,
com.google.Chrome,33,1736612638,1736612671,1736612671.312038,-21600,,
com.apple.Music,294,1736612344,1736612638,1736612638.90584,-21600,,
com.apple.news,186,1736611468,1736611654,1736611654.664016,-21600,EB445137-D7F5-57EC-87DA-1DB460D64046,"iPhone13,2"
com.apple.Health,29,1736611417,1736611446,1736611446.9792042,-21600,EB445137-D7F5-57EC-87DA-1DB460D64046,"iPhone13,2"
com.letterboxd.LetterboxdApp,4,1736611410,1736611414,1736611414.314868,-21600,EB445137-D7F5-57EC-87DA-1DB460D64046,"iPhone13,2"
com.google.Chrome,2934,1736609410,1736612344,1736612344.3273048,-21600,,
com.google.Chrome,458,1736608806,1736609264,1736609264.370442,-21600,,
com.letterboxd.LetterboxdApp,110,1736608364,1736608474,1736608475.523946,-21600,EB445137-D7F5-57EC-87DA-1DB460D64046,"iPhone13,2"
com.apple.findmy,6,1736608358,1736608364,1736608364.5666718,-21600,EB445137-D7F5-57EC-87DA-1DB460D64046,"iPhone13,2"
com.google.ios.youtube,1369,1736606906,1736608275,1736608275.819557,-21600,EB445137-D7F5-57EC-87DA-1DB460D64046,"iPhone13,2"
com.google.ios.youtube,764,1736606142,1736606906,1736606906.899009,-21600,EB445137-D7F5-57EC-87DA-1DB460D64046,"iPhone13,2"
com.google.chrome.ios,296,1736605846,1736606142,1736606142.463276,-21600,EB445137-D7F5-57EC-87DA-1DB460D64046,"iPhone13,2"
com.google.ios.youtube,43,1736605803,1736605846,1736605846.812943,-21600,EB445137-D7F5-57EC-87DA-1DB460D64046,"iPhone13,2"
com.apple.mobiletimer,2,1736605801,1736605803,1736605803.558135,-21600,EB445137-D7F5-57EC-87DA-1DB460D64046,"iPhone13,2"
com.google.ios.youtube,164,1736605637,1736605801,1736605802.125877,-21600,EB445137-D7F5-57EC-87DA-1DB460D64046,"iPhone13,2"
com.apple.MobileSMS,61,1736605557,1736605618,1736605618.769211,-21600,EB445137-D7F5-57EC-87DA-1DB460D64046,"iPhone13,2"
com.apple.Health,48,1736605507,1736605555,1736605556.197688,-21600,EB445137-D7F5-57EC-87DA-1DB460D64046,"iPhone13,2"
com.renpho.health,5,1736605492,1736605497,1736605497.701685,-21600,EB445137-D7F5-57EC-87DA-1DB460D64046,"iPhone13,2"
com.renpho.health,47,1736605012,1736605059,1736605059.773113,-21600,EB445137-D7F5-57EC-87DA-1DB460D64046,"iPhone13,2"
com.thestorygraph.thestorygraph,91,1736573436,1736573527,1736573527.69434,-21600,EB445137-D7F5-57EC-87DA-1DB460D64046,"iPhone13,2"
com.letterboxd.LetterboxdApp,2,1736573434,1736573436,1736573436.835326,-21600,EB445137-D7F5-57EC-87DA-1DB460D64046,"iPhone13,2"
com.google.Chrome,212,1736570523,1736570735,1736570735.343157,-21600,,
com.google.Chrome,1191,1736569130,1736570321,1736570321.752511,-21600,,
com.letterboxd.LetterboxdApp,30,1736568428,1736568458,1736568459.246894,-21600,EB445137-D7F5-57EC-87DA-1DB460D64046,"iPhone13,2"
com.google.chrome.ios,2,1736568426,1736568428,1736568428.492568,-21600,EB445137-D7F5-57EC-87DA-1DB460D64046,"iPhone13,2"
com.google.chrome.ios,29,1736566378,1736566407,1736566408.011143,-21600,EB445137-D7F5-57EC-87DA-1DB460D64046,"iPhone13,2"
com.apple.findmy,8,1736563975,1736563983,1736563983.863488,-21600,EB445137-D7F5-57EC-87DA-1DB460D64046,"iPhone13,2"
com.letterboxd.LetterboxdApp,2,1736563972,1736563974,1736563975.155426,-21600,EB445137-D7F5-57EC-87DA-1DB460D64046,"iPhone13,2"
com.letterboxd.LetterboxdApp,16,1736562137,1736562153,1736562153.9748302,-21600,EB445137-D7F5-57EC-87DA-1DB460D64046,"iPhone13,2"
com.apple.news,2,1736562135,1736562137,1736562137.557492,-21600,EB445137-D7F5-57EC-87DA-1DB460D64046,"iPhone13,2"
com.apple.news,10,1736561939,1736561949,1736561949.619447,-21600,EB445137-D7F5-57EC-87DA-1DB460D64046,"iPhone13,2"
com.apple.news,25,1736561909,1736561934,1736561934.1079159,-21600,EB445137-D7F5-57EC-87DA-1DB460D64046,"iPhone13,2"
com.letterboxd.LetterboxdApp,17,1736561885,1736561902,1736561903.0199609,-21600,EB445137-D7F5-57EC-87DA-1DB460D64046,"iPhone13,2"
com.letterboxd.LetterboxdApp,92,1736561694,1736561786,1736561786.4387178,-21600,EB445137-D7F5-57EC-87DA-1DB460D64046,"iPhone13,2"
com.apple.findmy,2,1736561692,1736561694,1736561696.213471,-21600,EB445137-D7F5-57EC-87DA-1DB460D64046,"iPhone13,2"
com.apple.findmy,6,1736561366,1736561372,1736561372.85331,-21600,EB445137-D7F5-57EC-87DA-1DB460D64046,"iPhone13,2"
com.thestorygraph.thestorygraph,12,1736561354,1736561366,1736561366.772012,-21600,EB445137-D7F5-57EC-87DA-1DB460D64046,"iPhone13,2"
com.google.chrome.ios,1,1736561352,1736561353,1736561354.0185928,-21600,EB445137-D7F5-57EC-87DA-1DB460D64046,"iPhone13,2"
com.google.chrome.ios,4,1736560610,1736560614,1736560615.0565991,-21600,EB445137-D7F5-57EC-87DA-1DB460D64046,"iPhone13,2"
com.google.chrome.ios,107,1736559034,1736559141,1736559142.003665,-21600,EB445137-D7F5-57EC-87DA-1DB460D64046,"iPhone13,2"
com.apple.news,132,1736557445,1736557577,1736557577.103818,-21600,EB445137-D7F5-57EC-87DA-1DB460D64046,"iPhone13,2"
com.google.Chrome,226,1736557352,1736557578,1736557578.6311378,-21600,,
com.microsoft.onenote.mac,3,1736557349,1736557352,1736557352.70611,-21600,,
com.google.android.studio,282,1736557067,1736557349,1736557349.31212,-21600,,
com.apple.dt.Xcode,43,1736557024,1736557067,1736557067.3970919,-21600,,
com.google.android.studio,458,1736556566,1736557024,1736557024.538902,-21600,,
com.apple.dt.Xcode,4,1736556562,1736556566,1736556566.726511,-21600,,
com.apple.news,83,1736556259,1736556342,1736556342.825001,-21600,EB445137-D7F5-57EC-87DA-1DB460D64046,"iPhone13,2"
com.apple.news,70,1736556185,1736556255,1736556255.40387,-21600,EB445137-D7F5-57EC-87DA-1DB460D64046,"iPhone13,2"
com.apple.findmy,6,1736556169,1736556175,1736556175.830998,-21600,EB445137-D7F5-57EC-87DA-1DB460D64046,"iPhone13,2"
com.hammerandchisel.discord,7,1736556162,1736556169,1736556169.613889,-21600,EB445137-D7F5-57EC-87DA-1DB460D64046,"iPhone13,2"
com.google.android.studio,591,1736555971,1736556562,1736556562.820262,-21600,,
com.apple.dt.Xcode,13,1736555958,1736555971,1736555971.587415,-21600,,
com.google.android.studio,9,1736555949,1736555958,1736555958.2572432,-21600,,
com.apple.dt.Xcode,2,1736555947,1736555949,1736555949.9647532,-21600,,
com.google.android.studio,11,1736555936,1736555947,1736555947.481367,-21600,,
com.apple.dt.Xcode,1,1736555935,1736555936,1736555936.9211931,-21600,,
com.google.android.studio,329,1736555606,1736555935,1736555935.178563,-21600,,
com.apple.dt.Xcode,1,1736555605,1736555606,1736555606.5762038,-21600,,
com.google.android.studio,3,1736555602,1736555605,1736555605.1149402,-21600,,
com.apple.dt.Xcode,88,1736555514,1736555602,1736555602.45813,-21600,,
com.apple.weather,2,1736555183,1736555185,1736555185.463592,-21600,EB445137-D7F5-57EC-87DA-1DB460D64046,"iPhone13,2"
com.google.android.studio,335,1736555179,1736555514,1736555514.966778,-21600,,
com.microsoft.onenote.mac,1,1736555178,1736555179,1736555179.3607821,-21600,,
com.google.android.studio,55,1736555123,1736555178,1736555178.8102012,-21600,,
com.apple.weather,1,1736554926,1736554927,1736554927.980448,-21600,EB445137-D7F5-57EC-87DA-1DB460D64046,"iPhone13,2"
com.microsoft.onenote.mac,7,1736554899,1736554906,1736554906.308243,-21600,,
com.google.android.studio,18,1736554881,1736554899,1736554900.0560799,-21600,,
com.apple.dt.Xcode,3,1736554786,1736554789,1736554789.197813,-21600,,
com.microsoft.onenote.mac,6,1736554780,1736554786,1736554786.059201,-21600,,
com.apple.dt.Xcode,2,1736554778,1736554780,1736554780.157691,-21600,,
com.google.Chrome,2,1736554776,1736554778,1736554778.314275,-21600,,
com.google.android.studio,2,1736554774,1736554776,1736554776.987836,-21600,,
com.google.Chrome,1,1736554773,1736554774,1736554774.305069,-21600,,
com.google.android.studio,7,1736554766,1736554773,1736554773.444556,-21600,,
com.google.Chrome,33,1736554733,1736554766,1736554766.963317,-21600,,
com.google.android.studio,56,1736554677,1736554733,1736554733.458832,-21600,,
com.google.Chrome,67,1736554610,1736554677,1736554677.3779368,-21600,,
com.google.android.studio,3,1736554607,1736554610,1736554610.4281049,-21600,,
com.apple.dt.Xcode,8,1736554599,1736554607,1736554607.7613401,-21600,,
com.google.Chrome,3,1736554596,1736554599,1736554599.733103,-21600,,
com.microsoft.onenote.mac,6,1736554590,1736554596,1736554596.74212,-21600,,
com.google.android.studio,2,1736554588,1736554590,1736554590.207598,-21600,,
com.apple.Terminal,1,1736554587,1736554588,1736554588.869227,-21600,,
com.google.android.studio,86,1736554501,1736554587,1736554587.9800348,-21600,,
com.google.android.studio,556,1736552627,1736553183,1736553183.094198,-21600,,
com.apple.dt.Xcode,4,1736552623,1736552627,1736552627.225069,-21600,,
com.google.android.studio,26,1736552597,1736552623,1736552623.630611,-21600,,
com.apple.dt.Xcode,11,1736552586,1736552597,1736552597.584795,-21600,,
com.google.android.studio,79,1736552507,1736552586,1736552586.3921142,-21600,,
com.apple.dt.Xcode,5,1736552502,1736552507,1736552507.2058039,-21600,,
com.google.android.studio,2,1736552500,1736552502,1736552502.6892018,-21600,,
com.apple.dt.Xcode,15,1736552485,1736552500,1736552500.730938,-21600,,
com.google.android.studio,128,1736552357,1736552485,1736552485.402992,-21600,,
com.apple.news,287,1736552014,1736552301,1736552301.32393,-21600,EB445137-D7F5-57EC-87DA-1DB460D64046,"iPhone13,2"
com.google.ios.youtube,1216,1736550793,1736552009,1736552009.808886,-21600,EB445137-D7F5-57EC-87DA-1DB460D64046,"iPhone13,2"
com.apple.news,25,1736550747,1736550772,1736550772.313652,-21600,EB445137-D7F5-57EC-87DA-1DB460D64046,"iPhone13,2"
com.microsoft.Office.Outlook,18,1736550718,1736550736,1736550736.700326,-21600,EB445137-D7F5-57EC-87DA-1DB460D64046,"iPhone13,2"
com.apple.news,1,1736550717,1736550718,1736550719.029118,-21600,EB445137-D7F5-57EC-87DA-1DB460D64046,"iPhone13,2"
com.google.android.studio,377,1736550627,1736551004,1736551004.380734,-21600,,
com.google.Chrome,6,1736550621,1736550627,1736550627.281426,-21600,,
com.google.android.studio,2,1736550619,1736550621,1736550621.185612,-21600,,
com.google.Chrome,43,1736550576,1736550619,1736550619.205709,-21600,,
com.google.android.studio,24,1736550552,1736550576,1736550576.17184,-21600,,
com.google.Chrome,1,1736550551,1736550552,1736550552.526613,-21600,,
com.google.android.studio,45,1736550506,1736550551,1736550551.386372,-21600,,
com.google.Chrome,27,1736550479,1736550506,1736550506.8675141,-21600,,
com.google.android.studio,265,1736550214,1736550479,1736550479.521051,-21600,,
com.google.Chrome,3,1736550172,1736550175,1736550175.125049,-21600,,
com.apple.Terminal,12,1736550160,1736550172,1736550172.802341,-21600,,
com.google.Chrome,83,1736550077,1736550160,1736550160.157639,-21600,,
com.google.android.studio,42,1736550035,1736550077,1736550077.998415,-21600,,
com.google.Chrome,21,1736550014,1736550035,1736550035.240057,-21600,,
com.apple.Music,3,1736550011,1736550014,1736550014.605888,-21600,,
com.microsoft.onenote.mac,6,1736550005,1736550011,1736550011.402816,-21600,,
com.google.Chrome,12,1736549993,1736550005,1736550005.326884,-21600,,
com.google.android.studio,1,1736549992,1736549993,1736549993.7169828,-21600,,
com.google.Chrome,7,1736549985,1736549992,1736549992.358505,-21600,,
com.google.android.studio,38,1736549947,1736549985,1736549985.273752,-21600,,
com.google.Chrome,42,1736549850,1736549892,1736549892.0922031,-21600,,
com.google.android.studio,558,1736549292,1736549850,1736549850.849163,-21600,,
com.google.Chrome,84,1736549208,1736549292,1736549292.4762769,-21600,,
com.google.android.studio,83,1736549125,1736549208,1736549208.261832,-21600,,
com.google.Chrome,60,1736549065,1736549125,1736549125.340235,-21600,,
com.google.android.studio,12,1736549053,1736549065,1736549066.00662,-21600,,
com.google.Chrome,2,1736549051,1736549053,1736549053.642393,-21600,,
com.google.android.studio,4,1736549047,1736549051,1736549051.9594622,-21600,,
com.google.Chrome,42,1736549005,1736549047,1736549047.5586538,-21600,,
com.google.android.studio,300,1736548705,1736549005,1736549005.179071,-21600,,
com.google.Chrome,8,1736548697,1736548705,1736548705.9385982,-21600,,
com.google.android.studio,7,1736548690,1736548697,1736548697.313088,-21600,,
com.google.Chrome,6,1736548684,1736548690,1736548690.7761111,-21600,,
com.google.android.studio,147,1736548537,1736548684,1736548684.312613,-21600,,
com.apple.dt.Xcode,12,1736548525,1736548537,1736548538.0023289,-21600,,
com.google.android.studio,47,1736548478,1736548525,1736548525.341004,-21600,,
com.apple.dt.Xcode,14,1736548464,1736548478,1736548478.1611571,-21600,,
com.google.android.studio,114,1736548350,1736548464,1736548464.8930721,-21600,,
com.google.Chrome,39,1736548311,1736548350,1736548350.340578,-21600,,
com.google.android.studio,31,1736548280,1736548311,1736548311.307108,-21600,,
com.google.Chrome,40,1736548240,1736548280,1736548280.141632,-21600,,
com.google.android.studio,6,1736548234,1736548240,1736548240.289885,-21600,,
com.google.Chrome,2,1736548232,1736548234,1736548234.347827,-21600,,
com.google.android.studio,9,1736548223,1736548232,1736548232.799676,-21600,,
com.google.Chrome,66,1736548157,1736548223,1736548223.341711,-21600,,
com.google.android.studio,30,1736548127,1736548157,1736548157.7396789,-21600,,
com.google.Chrome,3,1736548124,1736548127,1736548127.375793,-21600,,
com.google.android.studio,3,1736548121,1736548124,1736548124.165308,-21600,,
com.google.Chrome,1,1736548120,1736548121,1736548121.5740418,-21600,,
com.google.android.studio,7,1736548113,1736548120,1736548120.610372,-21600,,
com.google.Chrome,4,1736548109,1736548113,1736548113.942878,-21600,,
com.google.android.studio,2,1736548107,1736548109,1736548109.545556,-21600,,
com.google.Chrome,2,1736548105,1736548107,1736548107.2407022,-21600,,
com.google.android.studio,8,1736548097,1736548105,1736548105.438802,-21600,,
com.google.Chrome,1,1736548096,1736548097,1736548097.970808,-21600,,
com.google.android.studio,2,1736548094,1736548096,1736548096.103306,-21600,,
com.google.Chrome,7,1736548087,1736548094,1736548094.360231,-21600,,
com.google.android.studio,2,1736548085,1736548087,1736548087.21595,-21600,,
com.google.Chrome,1,1736548084,1736548085,1736548085.6311522,-21600,,
com.google.android.studio,1,1736548083,1736548084,1736548084.695126,-21600,,
com.google.Chrome,2,1736548081,1736548083,1736548083.1700191,-21600,,
com.google.android.studio,21,1736548060,1736548081,1736548081.529715,-21600,,
com.google.Chrome,5,1736548055,1736548060,1736548060.9750319,-21600,,
com.google.android.studio,3,1736548052,1736548055,1736548055.6027288,-21600,,
com.google.Chrome,2,1736548050,1736548052,1736548052.339654,-21600,,
com.google.android.studio,3,1736548047,1736548050,1736548050.6549501,-21600,,
com.google.Chrome,3,1736548044,1736548047,1736548047.283379,-21600,,
com.google.android.studio,12,1736548032,1736548044,1736548044.921349,-21600,,
com.google.Chrome,2,1736548030,1736548032,1736548032.13663,-21600,,
com.google.android.studio,4,1736548026,1736548030,1736548030.424135,-21600,,
com.google.Chrome,14,1736548012,1736548026,1736548026.8768,-21600,,
com.google.android.studio,1,1736548011,1736548012,1736548012.828069,-21600,,
com.google.Chrome,1,1736548010,1736548011,1736548011.615119,-21600,,
com.google.android.studio,18,1736547992,1736548010,1736548010.276794,-21600,,
com.google.Chrome,2,1736547990,1736547992,1736547992.197021,-21600,,
com.google.android.studio,1,1736547989,1736547990,1736547990.750194,-21600,,
com.google.Chrome,1,1736547988,1736547989,1736547989.3560839,-21600,,
com.google.android.studio,6,1736547982,1736547988,1736547988.143091,-21600,,
com.google.Chrome,7,1736547975,1736547982,1736547982.743525,-21600,,
com.google.android.studio,8,1736547967,1736547975,1736547975.2827048,-21600,,
com.google.Chrome,2,1736547965,1736547967,1736547967.955653,-21600,,
com.google.android.studio,3,1736547962,1736547965,1736547965.602467,-21600,,
com.google.Chrome,2,1736547960,1736547962,1736547962.3422198,-21600,,
com.google.android.studio,6,1736547954,1736547960,1736547960.5782871,-21600,,
com.google.Chrome,3,1736547951,1736547954,1736547954.841319,-21600,,
com.google.android.studio,3,1736547948,1736547951,1736547951.18998,-21600,,
com.google.Chrome,2,1736547946,1736547948,1736547948.8174639,-21600,,
com.google.android.studio,4,1736547942,1736547946,1736547946.774456,-21600,,
com.google.Chrome,2,1736547940,1736547942,1736547942.888802,-21600,,
com.google.android.studio,2,1736547938,1736547940,1736547940.921507,-21600,,
com.google.Chrome,17,1736547921,1736547938,1736547938.857039,-21600,,
com.google.android.studio,6,1736547915,1736547921,1736547922.003458,-21600,,
com.apple.dt.Xcode,3,1736547912,1736547915,1736547915.528693,-21600,,
com.google.Chrome,86,1736547826,1736547912,1736547912.981318,-21600,,
com.apple.dt.Xcode,93,1736547733,1736547826,1736547826.392143,-21600,,
com.microsoft.onenote.mac,2,1736547731,1736547733,1736547733.45891,-21600,,
com.apple.news,213,1736547461,1736547674,1736547675.471818,-21600,EB445137-D7F5-57EC-87DA-1DB460D64046,"iPhone13,2"
com.microsoft.onenote.mac,434,1736547280,1736547714,1736547714.7922292,-21600,,
com.google.android.studio,111,1736547169,1736547280,1736547280.146702,-21600,,
com.microsoft.onenote.mac,9,1736547160,1736547169,1736547169.04774,-21600,,
com.google.android.studio,123,1736547037,1736547160,1736547160.080327,-21600,,
com.apple.dt.Xcode,5,1736547032,1736547037,1736547037.170455,-21600,,
com.google.android.studio,7,1736547025,1736547032,1736547032.8663778,-21600,,
com.apple.dt.Xcode,6,1736547019,1736547025,1736547025.45533,-21600,,
com.google.android.studio,206,1736546813,1736547019,1736547019.26894,-21600,,
com.apple.dt.Xcode,4,1736546809,1736546813,1736546813.29067,-21600,,
com.google.android.studio,88,1736546721,1736546809,1736546809.0460691,-21600,,
com.google.Chrome,6,1736546715,1736546721,1736546721.49073,-21600,,
com.google.android.studio,4,1736546711,1736546715,1736546715.87902,-21600,,
com.google.Chrome,1,1736546710,1736546711,1736546711.3156881,-21600,,
com.google.android.studio,6,1736546704,1736546710,1736546710.489136,-21600,,
com.google.Chrome,2,1736546702,1736546704,1736546704.9682631,-21600,,
com.google.android.studio,0,1736546702,1736546702,1736546702.757842,-21600,,
com.google.Chrome,1,1736546701,1736546702,1736546702.3559542,-21600,,
com.apple.Music,1,1736546700,1736546701,1736546701.878274,-21600,,
com.google.android.studio,1,1736546699,1736546700,1736546700.950495,-21600,,
com.apple.Music,2,1736546697,1736546699,1736546699.230425,-21600,,
com.google.Chrome,33,1736546664,1736546697,1736546697.587933,-21600,,
com.apple.Music,15,1736546649,1736546664,1736546664.2020988,-21600,,
com.google.android.studio,285,1736546364,1736546649,1736546649.8614202,-21600,,
com.apple.Music,32,1736546332,1736546364,1736546364.8810148,-21600,,
com.google.android.studio,65,1736546267,1736546332,1736546332.995428,-21600,,
com.apple.dt.Xcode,4,1736546263,1736546267,1736546267.7373781,-21600,,
com.google.android.studio,101,1736546162,1736546263,1736546263.384727,-21600,,
com.apple.Music,30,1736546132,1736546162,1736546162.773885,-21600,,
com.google.android.studio,32,1736546100,1736546132,1736546132.581317,-21600,,
com.apple.dt.Xcode,9,1736546091,1736546100,1736546100.1970382,-21600,,
com.google.android.studio,93,1736545998,1736546091,1736546091.539424,-21600,,
com.apple.dt.Xcode,3,1736545995,1736545998,1736545998.954163,-21600,,
com.google.android.studio,11,1736545984,1736545995,1736545995.334497,-21600,,
com.apple.dt.Xcode,2,1736545982,1736545984,1736545984.905618,-21600,,
com.google.android.studio,4,1736545978,1736545982,1736545982.529842,-21600,,
com.apple.dt.Xcode,1,1736545977,1736545978,1736545979.059407,-21600,,
com.google.android.studio,6,1736545971,1736545977,1736545977.934496,-21600,,
com.apple.dt.Xcode,1,1736545970,1736545971,1736545971.280643,-21600,,
com.google.android.studio,4,1736545966,1736545970,1736545970.134636,-21600,,
com.apple.dt.Xcode,2,1736545964,1736545966,1736545966.452981,-21600,,
com.google.android.studio,5,1736545959,1736545964,1736545964.339874,-21600,,
com.apple.dt.Xcode,2,1736545957,1736545959,1736545959.612218,-21600,,
com.google.android.studio,6,1736545951,1736545957,1736545957.61201,-21600,,
com.apple.dt.Xcode,1,1736545950,1736545951,1736545951.488972,-21600,,
com.google.android.studio,5,1736545945,1736545950,1736545950.539875,-21600,,
com.apple.dt.Xcode,3,1736545942,1736545945,1736545945.426142,-21600,,
com.google.android.studio,6,1736545936,1736545942,1736545942.686465,-21600,,
com.apple.dt.Xcode,2,1736545934,1736545936,1736545936.867286,-21600,,
com.google.android.studio,651,1736545283,1736545934,1736545934.532813,-21600,,
com.apple.dt.Xcode,28,1736545255,1736545283,1736545283.532703,-21600,,
com.google.android.studio,386,1736544869,1736545255,1736545255.75632,-21600,,
com.apple.dt.Xcode,5,1736544864,1736544869,1736544869.604058,-21600,,
com.google.android.studio,450,1736544414,1736544864,1736544864.152866,-21600,,
com.google.Chrome,1,1736544413,1736544414,1736544414.793023,-21600,,
com.google.android.studio,5,1736544408,1736544413,1736544413.683353,-21600,,
com.google.Chrome,27,1736544381,1736544408,1736544408.4879432,-21600,,
com.google.android.studio,170,1736544211,1736544381,1736544381.850093,-21600,,
com.apple.dt.Xcode,4,1736544207,1736544211,1736544211.0814881,-21600,,
com.google.android.studio,11,1736544196,1736544207,1736544207.126659,-21600,,
com.apple.dt.Xcode,1,1736544195,1736544196,1736544196.219322,-21600,,
com.google.android.studio,39,1736544156,1736544195,1736544195.2975311,-21600,,
com.apple.dt.Xcode,8,1736544148,1736544156,1736544157.009891,-21600,,
com.google.android.studio,2,1736544146,1736544148,1736544149.029817,-21600,,
com.apple.dt.Xcode,1,1736544145,1736544146,1736544147.036612,-21600,,
com.google.android.studio,33,1736544112,1736544145,1736544145.139627,-21600,,
com.apple.dt.Xcode,4,1736544108,1736544112,1736544112.1627378,-21600,,
com.google.android.studio,25,1736544083,1736544108,1736544109.076473,-21600,,
com.google.Chrome,23,1736543953,1736543976,1736543976.3732,-21600,,
com.google.android.studio,5,1736543948,1736543953,1736543953.8437638,-21600,,
com.apple.dt.Xcode,3,1736543945,1736543948,1736543948.4640698,-21600,,
com.google.android.studio,7,1736543938,1736543945,1736543945.616478,-21600,,
com.apple.dt.Xcode,3,1736543935,1736543938,1736543938.042897,-21600,,
com.google.android.studio,154,1736543781,1736543935,1736543935.523797,-21600,,
com.apple.dt.Xcode,11,1736543770,1736543781,1736543781.775512,-21600,,
com.google.android.studio,1,1736543769,1736543770,1736543770.905735,-21600,,
com.apple.MobileSMS,2,1736543719,1736543721,1736543721.329494,-21600,EB445137-D7F5-57EC-87DA-1DB460D64046,"iPhone13,2"
com.apple.dt.Xcode,112,1736543657,1736543769,1736543769.500673,-21600,,
com.microsoft.onenote.mac,19,1736543638,1736543657,1736543657.959795,-21600,,
com.google.Chrome,794,1736542844,1736543638,1736543638.701933,-21600,,
com.apple.MobileSMS,2,1736542837,1736542839,1736542839.4138908,-21600,EB445137-D7F5-57EC-87DA-1DB460D64046,"iPhone13,2"
com.apple.MobileSMS,28,1736542769,1736542797,1736542798.05234,-21600,EB445137-D7F5-57EC-87DA-1DB460D64046,"iPhone13,2"
com.google.Chrome,217,1736541707,1736541924,1736541924.748749,-21600,,
com.google.ios.youtube,555,1736541093,1736541648,1736541649.233591,-21600,EB445137-D7F5-57EC-87DA-1DB460D64046,"iPhone13,2"
com.apple.news,4,1736541087,1736541091,1736541091.463583,-21600,EB445137-D7F5-57EC-87DA-1DB460D64046,"iPhone13,2"
com.apple.news,272,1736539759,1736540031,1736540031.5994549,-21600,EB445137-D7F5-57EC-87DA-1DB460D64046,"iPhone13,2"
com.apple.weather,33,1736539360,1736539393,1736539393.9257069,-21600,EB445137-D7F5-57EC-87DA-1DB460D64046,"iPhone13,2"
com.apple.news,28,1736539331,1736539359,1736539359.543822,-21600,EB445137-D7F5-57EC-87DA-1DB460D64046,"iPhone13,2"
com.burbn.instagram,34,1736539286,1736539320,1736539320.26642,-21600,EB445137-D7F5-57EC-87DA-1DB460D64046,"iPhone13,2"
com.burbn.instagram,89,1736539080,1736539169,1736539169.628879,-21600,EB445137-D7F5-57EC-87DA-1DB460D64046,"iPhone13,2"
com.apple.MobileSMS,8,1736539070,1736539078,1736539078.778713,-21600,EB445137-D7F5-57EC-87DA-1DB460D64046,"iPhone13,2"
com.burbn.instagram,1,1736539068,1736539069,1736539069.668401,-21600,EB445137-D7F5-57EC-87DA-1DB460D64046,"iPhone13,2"
com.lafitness.lafitness,9,1736537007,1736537016,1736537016.466316,-21600,EB445137-D7F5-57EC-87DA-1DB460D64046,"iPhone13,2"
com.apple.news,1,1736537005,1736537006,1736537006.734688,-21600,EB445137-D7F5-57EC-87DA-1DB460D64046,"iPhone13,2"
com.apple.news,123,1736536448,1736536571,1736536572.09896,-21600,EB445137-D7F5-57EC-87DA-1DB460D64046,"iPhone13,2"
com.apple.weather,33,1736536412,1736536445,1736536445.3351789,-21600,EB445137-D7F5-57EC-87DA-1DB460D64046,"iPhone13,2"
com.google.chrome.ios,117,1736536256,1736536373,1736536373.497283,-21600,EB445137-D7F5-57EC-87DA-1DB460D64046,"iPhone13,2"
com.apple.findmy,9,1736536208,1736536217,1736536218.002984,-21600,EB445137-D7F5-57EC-87DA-1DB460D64046,"iPhone13,2"
com.hammerandchisel.discord,12,1736536196,1736536208,1736536208.7757668,-21600,EB445137-D7F5-57EC-87DA-1DB460D64046,"iPhone13,2"
com.google.chrome.ios,44,1736532420,1736532464,1736532464.817224,-21600,EB445137-D7F5-57EC-87DA-1DB460D64046,"iPhone13,2"
com.letterboxd.LetterboxdApp,112,1736531320,1736531432,1736531432.855688,-21600,EB445137-D7F5-57EC-87DA-1DB460D64046,"iPhone13,2"
com.apple.news,54,1736528454,1736528508,1736528508.628643,-21600,EB445137-D7F5-57EC-87DA-1DB460D64046,"iPhone13,2"
com.google.chrome.ios,2,1736528444,1736528446,1736528446.87589,-21600,EB445137-D7F5-57EC-87DA-1DB460D64046,"iPhone13,2"
com.apple.weather,7,1736528286,1736528293,1736528293.330909,-21600,EB445137-D7F5-57EC-87DA-1DB460D64046,"iPhone13,2"
com.google.chrome.ios,22,1736528070,1736528092,1736528092.254715,-21600,EB445137-D7F5-57EC-87DA-1DB460D64046,"iPhone13,2"
com.google.chrome.ios,42,1736527936,1736527978,1736527978.834333,-21600,EB445137-D7F5-57EC-87DA-1DB460D64046,"iPhone13,2"
com.google.chrome.ios,24,1736527622,1736527646,1736527646.8606071,-21600,EB445137-D7F5-57EC-87DA-1DB460D64046,"iPhone13,2"
com.google.chrome.ios,6,1736527316,1736527322,1736527322.1457891,-21600,EB445137-D7F5-57EC-87DA-1DB460D64046,"iPhone13,2"
com.google.chrome.ios,49,1736527267,1736527316,1736527316.2013268,-21600,EB445137-D7F5-57EC-87DA-1DB460D64046,"iPhone13,2"
com.apple.Health,14,1736525673,1736525687,1736525687.905871,-21600,EB445137-D7F5-57EC-87DA-1DB460D64046,"iPhone13,2"
com.apple.Health,6,1736525664,1736525670,1736525670.981014,-21600,EB445137-D7F5-57EC-87DA-1DB460D64046,"iPhone13,2"
com.amazon.Amazon,52,1736525069,1736525121,1736525121.931299,-21600,EB445137-D7F5-57EC-87DA-1DB460D64046,"iPhone13,2"
com.apple.findmy,2,1736525019,1736525021,1736525021.76214,-21600,EB445137-D7F5-57EC-87DA-1DB460D64046,"iPhone13,2"
com.apple.findmy,15,1736524337,1736524352,1736524352.978003,-21600,EB445137-D7F5-57EC-87DA-1DB460D64046,"iPhone13,2"
com.apple.CoreAuthUI,2,1736523232,1736523234,1736523234.831938,-21600,EB445137-D7F5-57EC-87DA-1DB460D64046,"iPhone13,2"
com.google.chrome.ios,147,1736523219,1736523366,1736523366.9996471,-21600,EB445137-D7F5-57EC-87DA-1DB460D64046,"iPhone13,2"
com.google.chrome.ios,39,1736523084,1736523123,1736523123.777576,-21600,EB445137-D7F5-57EC-87DA-1DB460D64046,"iPhone13,2"
com.apple.weather,1,1736523082,1736523083,1736523084.168319,-21600,EB445137-D7F5-57EC-87DA-1DB460D64046,"iPhone13,2"
com.apple.weather,4,1736522561,1736522565,1736522566.301764,-21600,EB445137-D7F5-57EC-87DA-1DB460D64046,"iPhone13,2"
com.apple.Health,1,1736522560,1736522561,1736522561.846344,-21600,EB445137-D7F5-57EC-87DA-1DB460D64046,"iPhone13,2"
com.apple.Health,18,1736522163,1736522181,1736522182.101993,-21600,EB445137-D7F5-57EC-87DA-1DB460D64046,"iPhone13,2"
com.apple.MobileSMS,45,1736522117,1736522162,1736522162.2894912,-21600,EB445137-D7F5-57EC-87DA-1DB460D64046,"iPhone13,2"
com.renpho.health,46,1736521936,1736521982,1736521982.903679,-21600,EB445137-D7F5-57EC-87DA-1DB460D64046,"iPhone13,2"
com.google.ios.youtube,1145,1736519531,1736520676,1736520676.66203,-21600,EB445137-D7F5-57EC-87DA-1DB460D64046,"iPhone13,2"
com.apple.mobilenotes,17,1736519505,1736519522,1736519522.3986611,-21600,EB445137-D7F5-57EC-87DA-1DB460D64046,"iPhone13,2"
com.apple.mobilenotes,5,1736519495,1736519500,1736519500.618926,-21600,EB445137-D7F5-57EC-87DA-1DB460D64046,"iPhone13,2"
com.apple.mobilenotes,85,1736487557,1736487642,1736487642.429302,-21600,EB445137-D7F5-57EC-87DA-1DB460D64046,"iPhone13,2"
com.apple.mobiletimer,1,1736487553,1736487554,1736487554.793107,-21600,EB445137-D7F5-57EC-87DA-1DB460D64046,"iPhone13,2"
com.apple.mobiletimer,9,1736487084,1736487093,1736487093.8830109,-21600,EB445137-D7F5-57EC-87DA-1DB460D64046,"iPhone13,2"
com.apple.CoreAuthUI,3,1736485963,1736485966,1736485966.467461,-21600,EB445137-D7F5-57EC-87DA-1DB460D64046,"iPhone13,2"
com.apple.journal,1089,1736485961,1736487050,1736487050.441574,-21600,EB445137-D7F5-57EC-87DA-1DB460D64046,"iPhone13,2"
com.apple.Health,46,1736485911,1736485957,1736485957.3271952,-21600,EB445137-D7F5-57EC-87DA-1DB460D64046,"iPhone13,2"
com.apple.Music,2,1736485908,1736485910,1736485910.546351,-21600,EB445137-D7F5-57EC-87DA-1DB460D64046,"iPhone13,2"
com.apple.Music,30,1736484761,1736484791,1736484792.035349,-21600,EB445137-D7F5-57EC-87DA-1DB460D64046,"iPhone13,2"
com.apple.Music,1,1736484760,1736484761,1736484761.176147,-21600,EB445137-D7F5-57EC-87DA-1DB460D64046,"iPhone13,2"
com.apple.Music,62,1736484134,1736484196,1736484196.80202,-21600,EB445137-D7F5-57EC-87DA-1DB460D64046,"iPhone13,2"
com.apple.Music,61,1736484018,1736484079,1736484079.275528,-21600,EB445137-D7F5-57EC-87DA-1DB460D64046,"iPhone13,2"
com.thestorygraph.thestorygraph,21,1736483975,1736483996,1736483996.114773,-21600,EB445137-D7F5-57EC-87DA-1DB460D64046,"iPhone13,2"
com.goodreads.Goodreads,28,1736483947,1736483975,1736483975.8724608,-21600,EB445137-D7F5-57EC-87DA-1DB460D64046,"iPhone13,2"
com.thestorygraph.thestorygraph,62,1736483884,1736483946,1736483947.036413,-21600,EB445137-D7F5-57EC-87DA-1DB460D64046,"iPhone13,2"
com.apple.weather,9,1736479653,1736479662,1736479662.6137738,-21600,EB445137-D7F5-57EC-87DA-1DB460D64046,"iPhone13,2"
com.apple.weather,3,1736479645,1736479648,1736479648.690452,-21600,EB445137-D7F5-57EC-87DA-1DB460D64046,"iPhone13,2"
com.apple.weather,1,1736479510,1736479511,1736479512.2375069,-21600,EB445137-D7F5-57EC-87DA-1DB460D64046,"iPhone13,2"
com.apple.news,133,1736479369,1736479502,1736479502.9027781,-21600,EB445137-D7F5-57EC-87DA-1DB460D64046,"iPhone13,2"
com.thestorygraph.thestorygraph,17,1736479337,1736479354,1736479354.294812,-21600,EB445137-D7F5-57EC-87DA-1DB460D64046,"iPhone13,2"
com.google.Chrome,913,1736475882,1736476795,1736476795.733584,-21600,,
com.google.android.studio,2,1736475519,1736475521,1736475521.7064018,-21600,,
com.google.Chrome,0,1736475519,1736475519,1736475519.814347,-21600,,
com.google.android.studio,29,1736475490,1736475519,1736475519.081572,-21600,,
com.microsoft.onenote.mac,65,1736475425,1736475490,1736475490.287216,-21600,,
com.google.Chrome,1,1736475424,1736475425,1736475425.6123981,-21600,,
com.apple.iphonesimulator,0,1736475424,1736475424,1736475425.007101,-21600,,
com.google.android.studio,1,1736475423,1736475424,1736475424.0759149,-21600,,
com.apple.dt.Xcode,7,1736475416,1736475423,1736475423.1712441,-21600,,
com.burbn.instagram,197,1736475096,1736475293,1736475293.9025111,-21600,EB445137-D7F5-57EC-87DA-1DB460D64046,"iPhone13,2"
com.google.android.studio,897,1736474519,1736475416,1736475416.7451591,-21600,,
com.apple.dt.Xcode,2,1736474517,1736474519,1736474519.863292,-21600,,
com.google.android.studio,18,1736474499,1736474517,1736474518.0052528,-21600,,
com.apple.dt.Xcode,2,1736474497,1736474499,1736474499.158607,-21600,,
com.google.android.studio,1,1736474496,1736474497,1736474497.816979,-21600,,
com.apple.dt.Xcode,2,1736474494,1736474496,1736474496.207726,-21600,,
com.google.android.studio,1,1736474493,1736474494,1736474494.775873,-21600,,
com.apple.dt.Xcode,2,1736474491,1736474493,1736474493.0819678,-21600,,
com.google.android.studio,1,1736474490,1736474491,1736474491.993775,-21600,,
com.apple.dt.Xcode,1,1736474489,1736474490,1736474490.2600489,-21600,,
com.google.android.studio,48,1736474441,1736474489,1736474489.1493459,-21600,,
com.apple.dt.Xcode,3,1736474438,1736474441,1736474441.429553,-21600,,
com.google.android.studio,31,1736474407,1736474438,1736474438.164936,-21600,,
com.apple.dt.Xcode,5,1736474402,1736474407,1736474407.256012,-21600,,
com.google.android.studio,31,1736474371,1736474402,1736474402.8890839,-21600,,
com.apple.dt.Xcode,2,1736474369,1736474371,1736474371.478777,-21600,,
com.google.android.studio,2,1736474367,1736474369,1736474369.0537581,-21600,,
com.apple.dt.Xcode,2,1736474365,1736474367,1736474367.951079,-21600,,
com.google.android.studio,46,1736474319,1736474365,1736474365.7782578,-21600,,
com.apple.dt.Xcode,9,1736474310,1736474319,1736474319.666628,-21600,,
com.google.android.studio,55,1736474255,1736474310,1736474310.158599,-21600,,
com.apple.dt.Xcode,6,1736474249,1736474255,1736474255.444985,-21600,,
com.google.android.studio,21,1736474228,1736474249,1736474249.613809,-21600,,
com.apple.dt.Xcode,23,1736474205,1736474228,1736474228.2393951,-21600,,
com.google.android.studio,331,1736473874,1736474205,1736474205.9100919,-21600,,
com.apple.dt.Xcode,2,1736473872,1736473874,1736473874.457077,-21600,,
com.google.android.studio,3,1736473869,1736473872,1736473872.865306,-21600,,
com.apple.dt.Xcode,2,1736473867,1736473869,1736473869.545135,-21600,,
com.google.android.studio,2,1736473865,1736473867,1736473867.595447,-21600,,
com.apple.dt.Xcode,14,1736473851,1736473865,1736473865.789159,-21600,,
com.google.android.studio,22,1736473829,1736473851,1736473851.630454,-21600,,
com.apple.dt.Xcode,4,1736473825,1736473829,1736473830.010812,-21600,,
com.google.android.studio,9,1736473816,1736473825,1736473825.499994,-21600,,
com.apple.dt.Xcode,0,1736473816,1736473816,1736473816.841734,-21600,,
com.google.android.studio,4,1736473812,1736473816,1736473816.069847,-21600,,
com.apple.dt.Xcode,2,1736473810,1736473812,1736473812.737391,-21600,,
com.google.android.studio,1,1736473809,1736473810,1736473810.906254,-21600,,
com.apple.dt.Xcode,35,1736473774,1736473809,1736473809.313132,-21600,,
com.google.android.studio,55,1736473719,1736473774,1736473775.000973,-21600,,
com.apple.dt.Xcode,1,1736473718,1736473719,1736473719.6063728,-21600,,
com.google.android.studio,43,1736473675,1736473718,1736473718.630122,-21600,,
com.apple.dt.Xcode,3,1736473672,1736473675,1736473675.780435,-21600,,
com.google.android.studio,88,1736473584,1736473672,1736473672.675428,-21600,,
com.apple.dt.Xcode,2,1736473582,1736473584,1736473584.3073812,-21600,,
com.google.android.studio,3,1736473579,1736473582,1736473582.330734,-21600,,
com.apple.dt.Xcode,15,1736473564,1736473579,1736473579.195194,-21600,,
com.google.android.studio,164,1736473400,1736473564,1736473565.0144339,-21600,,
com.apple.dt.Xcode,2,1736473398,1736473400,1736473400.127244,-21600,,
com.google.android.studio,8,1736473390,1736473398,1736473398.532646,-21600,,
com.apple.dt.Xcode,2,1736473388,1736473390,1736473390.966979,-21600,,
com.google.android.studio,6,1736473382,1736473388,1736473388.5633569,-21600,,
com.apple.dt.Xcode,2,1736473380,1736473382,1736473382.4479918,-21600,,
com.google.android.studio,11,1736473369,1736473380,1736473380.722518,-21600,,
com.apple.dt.Xcode,4,1736473365,1736473369,1736473369.319512,-21600,,
com.google.android.studio,130,1736473235,1736473365,1736473365.512831,-21600,,
com.apple.dt.Xcode,2,1736473233,1736473235,1736473235.977104,-21600,,
com.google.android.studio,8,1736473225,1736473233,1736473233.148732,-21600,,
com.apple.dt.Xcode,1,1736473224,1736473225,1736473225.7376719,-21600,,
com.google.android.studio,2,1736473222,1736473224,1736473224.812324,-21600,,
com.apple.dt.Xcode,6,1736473216,1736473222,1736473222.175719,-21600,,
com.google.android.studio,163,1736473053,1736473216,1736473216.325245,-21600,,
com.apple.iphonesimulator,1,1736473052,1736473053,1736473053.331403,-21600,,
com.apple.dt.Xcode,11,1736473041,1736473052,1736473052.4340858,-21600,,
com.apple.iphonesimulator,1,1736473040,1736473041,1736473041.3875751,-21600,,
com.google.android.studio,105,1736472935,1736473040,1736473040.462331,-21600,,
com.google.Chrome,1,1736472934,1736472935,1736472935.453129,-21600,,
com.google.android.studio,16,1736472918,1736472934,1736472934.629026,-21600,,
com.google.Chrome,1,1736472917,1736472918,1736472918.3132281,-21600,,
com.google.android.studio,106,1736472811,1736472917,1736472917.753223,-21600,,
com.google.Chrome,0,1736472811,1736472811,1736472811.9240088,-21600,,
com.google.android.studio,2,1736472809,1736472811,1736472811.1262832,-21600,,
com.google.Chrome,1,1736472808,1736472809,1736472809.835816,-21600,,
com.google.android.studio,5,1736472803,1736472808,1736472808.780458,-21600,,
com.google.Chrome,34,1736472769,1736472803,1736472803.827548,-21600,,
com.google.android.studio,84,1736472685,1736472769,1736472769.398419,-21600,,
com.google.Chrome,6,1736472679,1736472685,1736472685.301165,-21600,,
com.google.android.studio,2,1736472677,1736472679,1736472679.3491821,-21600,,
com.google.Chrome,1,1736472676,1736472677,1736472677.602617,-21600,,
com.google.android.studio,40,1736472636,1736472676,1736472676.5542989,-21600,,
com.google.Chrome,36,1736472600,1736472636,1736472636.63012,-21600,,
com.google.android.studio,153,1736472447,1736472600,1736472600.4569001,-21600,,
com.apple.iphonesimulator,2,1736472445,1736472447,1736472447.2385092,-21600,,
com.apple.dt.Xcode,2,1736472443,1736472445,1736472445.38567,-21600,,
com.google.android.studio,6,1736472437,1736472443,1736472443.306675,-21600,,
com.apple.dt.Xcode,2,1736472435,1736472437,1736472437.6576319,-21600,,
com.apple.iphonesimulator,14,1736472421,1736472435,1736472435.0518188,-21600,,
com.apple.dt.Xcode,3,1736472418,1736472421,1736472421.496589,-21600,,
com.apple.iphonesimulator,3,1736472415,1736472418,1736472418.186029,-21600,,
com.google.android.studio,144,1736472271,1736472415,1736472415.74079,-21600,,
com.microsoft.onenote.mac,1,1736472270,1736472271,1736472271.749991,-21600,,
com.apple.dt.Xcode,8,1736472262,1736472270,1736472270.330132,-21600,,
com.microsoft.onenote.mac,2,1736472260,1736472262,1736472262.437345,-21600,,
com.google.android.studio,138,1736472122,1736472260,1736472260.464645,-21600,,
com.microsoft.onenote.mac,8,1736472114,1736472122,1736472122.616786,-21600,,
com.google.android.studio,100,1736472014,1736472114,1736472114.799035,-21600,,
com.apple.dt.Xcode,18,1736471996,1736472014,1736472014.349709,-21600,,
com.apple.iphonesimulator,20,1736471976,1736471996,1736471996.2277079,-21600,,
com.apple.dt.Xcode,64,1736471912,1736471976,1736471976.0614328,-21600,,
com.google.android.studio,93,1736471819,1736471912,1736471912.2591848,-21600,,
com.apple.dt.Xcode,2,1736471817,1736471819,1736471819.690349,-21600,,
com.google.android.studio,5,1736471812,1736471817,1736471817.3809052,-21600,,
com.apple.dt.Xcode,2,1736471810,1736471812,1736471812.851242,-21600,,
com.google.android.studio,21,1736471789,1736471810,1736471810.268177,-21600,,
com.apple.dt.Xcode,31,1736471758,1736471789,1736471789.8791351,-21600,,
com.apple.iphonesimulator,55,1736471703,1736471758,1736471758.626473,-21600,,
com.apple.dt.Xcode,103,1736471600,1736471703,1736471703.565876,-21600,,
com.google.android.studio,23,1736471577,1736471600,1736471600.4219608,-21600,,
com.apple.dt.Xcode,4,1736471573,1736471577,1736471577.450649,-21600,,
com.google.android.studio,7,1736471566,1736471573,1736471573.761025,-21600,,
com.apple.dt.Xcode,298,1736471268,1736471566,1736471566.8081121,-21600,,
com.google.android.studio,21,1736471247,1736471268,1736471269.020307,-21600,,
com.apple.dt.Xcode,10,1736471237,1736471247,1736471247.547137,-21600,,
com.google.android.studio,555,1736470682,1736471237,1736471237.322747,-21600,,
com.apple.dt.Xcode,5,1736470677,1736470682,1736470682.821529,-21600,,
com.google.android.studio,6,1736470671,1736470677,1736470677.268417,-21600,,
com.apple.dt.Xcode,4,1736470667,1736470671,1736470671.316033,-21600,,
com.google.android.studio,17,1736470650,1736470667,1736470667.9531,-21600,,
com.apple.dt.Xcode,3,1736470647,1736470650,1736470650.0856009,-21600,,
com.google.android.studio,26,1736470621,1736470647,1736470647.649025,-21600,,
com.apple.dt.Xcode,41,1736470580,1736470621,1736470621.466107,-21600,,
com.google.android.studio,82,1736470498,1736470580,1736470580.351763,-21600,,
com.apple.dt.Xcode,3,1736470495,1736470498,1736470498.6857061,-21600,,
com.google.android.studio,99,1736470396,1736470495,1736470495.7223458,-21600,,
com.apple.dt.Xcode,2,1736470394,1736470396,1736470396.75169,-21600,,
com.google.android.studio,4,1736470390,1736470394,1736470394.140778,-21600,,
com.apple.dt.Xcode,33,1736470357,1736470390,1736470390.217782,-21600,,
com.google.android.studio,160,1736470197,1736470357,1736470357.8935251,-21600,,
com.apple.dt.Xcode,19,1736470178,1736470197,1736470197.930918,-21600,,
com.google.android.studio,2,1736470176,1736470178,1736470179.0270529,-21600,,
com.apple.dt.Xcode,4,1736470172,1736470176,1736470176.96715,-21600,,
com.google.android.studio,7,1736470165,1736470172,1736470172.0399861,-21600,,
com.apple.dt.Xcode,29,1736470136,1736470165,1736470166.007285,-21600,,
com.apple.iphonesimulator,44,1736470092,1736470136,1736470136.950192,-21600,,
com.google.ios.youtube,2,1736469941,1736469943,1736469943.237082,-21600,EB445137-D7F5-57EC-87DA-1DB460D64046,"iPhone13,2"
com.apple.dt.Xcode,291,1736469801,1736470092,1736470092.580935,-21600,,
com.apple.Music,70,1736469731,1736469801,1736469801.1569672,-21600,,
com.google.android.studio,216,1736469515,1736469731,1736469731.15834,-21600,,
com.microsoft.onenote.mac,3,1736469512,1736469515,1736469515.252355,-21600,,
com.google.ios.youtube,1054,1736468658,1736469712,1736469712.699579,-21600,EB445137-D7F5-57EC-87DA-1DB460D64046,"iPhone13,2"
com.apple.weather,25,1736467733,1736467758,1736467758.2992868,-21600,EB445137-D7F5-57EC-87DA-1DB460D64046,"iPhone13,2"
com.apple.news,57,1736467675,1736467732,1736467732.327975,-21600,EB445137-D7F5-57EC-87DA-1DB460D64046,"iPhone13,2"
com.apple.news,6,1736467284,1736467290,1736467290.706192,-21600,EB445137-D7F5-57EC-87DA-1DB460D64046,"iPhone13,2"
com.apple.news,38,1736467244,1736467282,1736467282.809752,-21600,EB445137-D7F5-57EC-87DA-1DB460D64046,"iPhone13,2"
com.apple.CoreAuthUI,1,1736467228,1736467229,1736467229.744365,-21600,EB445137-D7F5-57EC-87DA-1DB460D64046,"iPhone13,2"
com.robinhood.release.Robinhood,14,1736467224,1736467238,1736467238.765716,-21600,EB445137-D7F5-57EC-87DA-1DB460D64046,"iPhone13,2"
com.goodreads.Goodreads,4,1736467210,1736467214,1736467214.64041,-21600,EB445137-D7F5-57EC-87DA-1DB460D64046,"iPhone13,2"
com.goodreads.Goodreads,20,1736467019,1736467039,1736467039.936369,-21600,EB445137-D7F5-57EC-87DA-1DB460D64046,"iPhone13,2"
com.thestorygraph.thestorygraph,104,1736466913,1736467017,1736467017.458774,-21600,EB445137-D7F5-57EC-87DA-1DB460D64046,"iPhone13,2"
com.apple.findmy,2,1736466911,1736466913,1736466913.6409612,-21600,EB445137-D7F5-57EC-87DA-1DB460D64046,"iPhone13,2"
com.apple.findmy,5,1736466152,1736466157,1736466158.026608,-21600,EB445137-D7F5-57EC-87DA-1DB460D64046,"iPhone13,2"
com.microsoft.onenote.mac,342,1736465171,1736465513,1736465513.4332619,-21600,,
com.google.android.studio,57,1736465114,1736465171,1736465171.281028,-21600,,
com.hammerandchisel.discord,87,1736464937,1736465024,1736465024.8315182,-21600,EB445137-D7F5-57EC-87DA-1DB460D64046,"iPhone13,2"
com.instructure.icanvas,38,1736464898,1736464936,1736464936.6938682,-21600,EB445137-D7F5-57EC-87DA-1DB460D64046,"iPhone13,2"
com.microsoft.Office.Outlook,25,1736464872,1736464897,1736464897.150878,-21600,EB445137-D7F5-57EC-87DA-1DB460D64046,"iPhone13,2"
com.apple.findmy,28,1736464787,1736464815,1736464816.154454,-21600,EB445137-D7F5-57EC-87DA-1DB460D64046,"iPhone13,2"
com.apple.Health,47,1736464707,1736464754,1736464754.400495,-21600,EB445137-D7F5-57EC-87DA-1DB460D64046,"iPhone13,2"
com.apple.news,2,1736464703,1736464705,1736464705.3920522,-21600,EB445137-D7F5-57EC-87DA-1DB460D64046,"iPhone13,2"
com.google.android.studio,300,1736464675,1736464975,1736464975.736137,-21600,,
com.apple.dt.Xcode,11,1736464664,1736464675,1736464675.794502,-21600,,
com.google.android.studio,0,1736464664,1736464664,1736464664.899376,-21600,,
com.apple.dt.Xcode,29,1736464635,1736464664,1736464664.21152,-21600,,
com.google.android.studio,16,1736464619,1736464635,1736464635.8700209,-21600,,
com.apple.dt.Xcode,4,1736464615,1736464619,1736464619.694334,-21600,,
com.microsoft.onenote.mac,1,1736464614,1736464615,1736464615.823034,-21600,,
com.google.android.studio,10,1736464604,1736464614,1736464614.3924499,-21600,,
com.microsoft.onenote.mac,1,1736464603,1736464604,1736464604.863429,-21600,,
com.apple.dt.Xcode,77,1736464526,1736464603,1736464603.520138,-21600,,
com.microsoft.onenote.mac,36,1736464490,1736464526,1736464526.7125192,-21600,,
com.google.android.studio,63,1736464427,1736464490,1736464490.2040992,-21600,,
com.microsoft.onenote.mac,15,1736464412,1736464427,1736464427.43512,-21600,,
com.google.android.studio,100,1736464312,1736464412,1736464412.468666,-21600,,
com.apple.dt.Xcode,4,1736464308,1736464312,1736464312.175406,-21600,,
com.microsoft.onenote.mac,26,1736464282,1736464308,1736464308.525806,-21600,,
com.apple.dt.Xcode,42,1736464240,1736464282,1736464282.816577,-21600,,
com.google.android.studio,53,1736464187,1736464240,1736464240.589888,-21600,,
com.apple.dt.Xcode,5,1736464182,1736464187,1736464187.63385,-21600,,
com.google.android.studio,301,1736463881,1736464182,1736464183.1011338,-21600,,
com.apple.dt.Xcode,3,1736463878,1736463881,1736463881.0659618,-21600,,
com.google.android.studio,20,1736463858,1736463878,1736463878.117727,-21600,,
com.apple.dt.Xcode,9,1736463849,1736463858,1736463858.965672,-21600,,
com.google.android.studio,72,1736463777,1736463849,1736463849.994559,-21600,,
com.apple.dt.Xcode,3,1736463774,1736463777,1736463777.411998,-21600,,
com.google.Chrome,9,1736463765,1736463774,1736463774.397038,-21600,,
com.apple.dt.Xcode,1,1736463764,1736463765,1736463766.0643249,-21600,,
com.google.android.studio,46,1736463718,1736463764,1736463764.397596,-21600,,
com.apple.dt.Xcode,1,1736463717,1736463718,1736463718.8626552,-21600,,
com.google.Chrome,73,1736463644,1736463717,1736463717.324019,-21600,,
com.apple.dt.Xcode,3,1736463641,1736463644,1736463644.918335,-21600,,
com.google.android.studio,2,1736463639,1736463641,1736463641.724416,-21600,,
com.apple.dt.Xcode,52,1736463587,1736463639,1736463639.823653,-21600,,
com.google.android.studio,281,1736463306,1736463587,1736463587.557162,-21600,,
com.apple.dt.Xcode,3,1736463303,1736463306,1736463306.8307981,-21600,,
com.google.android.studio,81,1736463222,1736463303,1736463303.66349,-21600,,
com.apple.dt.Xcode,2,1736463220,1736463222,1736463222.464027,-21600,,
com.google.android.studio,9,1736463211,1736463220,1736463220.303381,-21600,,
com.apple.dt.Xcode,12,1736463199,1736463211,1736463211.732008,-21600,,
com.apple.iphonesimulator,19,1736463180,1736463199,1736463199.05264,-21600,,
com.apple.dt.Xcode,11,1736463169,1736463180,1736463180.3798609,-21600,,
com.apple.iphonesimulator,2,1736463167,1736463169,1736463169.5010052,-21600,,
com.apple.dt.Xcode,16,1736463151,1736463167,1736463167.735826,-21600,,
com.apple.iphonesimulator,16,1736463135,1736463151,1736463151.690901,-21600,,
com.apple.dt.Xcode,36,1736463099,1736463135,1736463136.065007,-21600,,
com.apple.iphonesimulator,3,1736463096,1736463099,1736463099.9231129,-21600,,
com.apple.dt.Xcode,94,1736463002,1736463096,1736463096.507798,-21600,,
com.google.Chrome,22,1736462980,1736463002,1736463002.88816,-21600,,
com.apple.dt.Xcode,275,1736462705,1736462980,1736462980.483572,-21600,,
com.apple.iphonesimulator,16,1736462689,1736462705,1736462706.276918,-21600,,
com.apple.dt.Xcode,9,1736462680,1736462689,1736462689.924923,-21600,,
com.google.android.studio,14,1736462666,1736462680,1736462681.175486,-21600,,
com.apple.dt.Xcode,16,1736462638,1736462654,1736462654.757591,-21600,,
com.google.android.studio,180,1736462365,1736462545,1736462546.0452518,-21600,,
com.apple.dt.Xcode,4,1736462361,1736462365,1736462365.5695028,-21600,,
com.google.android.studio,42,1736462319,1736462361,1736462361.597485,-21600,,
com.apple.dt.Xcode,2,1736462317,1736462319,1736462319.5497088,-21600,,
com.google.android.studio,99,1736462218,1736462317,1736462318.003242,-21600,,
com.apple.dt.Xcode,3,1736462215,1736462218,1736462218.544595,-21600,,
com.google.android.studio,2,1736462213,1736462215,1736462215.751492,-21600,,
com.apple.dt.Xcode,3,1736462210,1736462213,1736462213.4655871,-21600,,
com.google.android.studio,7,1736462203,1736462210,1736462210.67864,-21600,,
com.apple.dt.Xcode,11,1736462192,1736462203,1736462203.81104,-21600,,
com.google.android.studio,3,1736462189,1736462192,1736462192.246078,-21600,,
com.apple.dt.Xcode,11,1736462178,1736462189,1736462189.4861069,-21600,,
com.google.android.studio,120,1736462058,1736462178,1736462178.426602,-21600,,
com.apple.dt.Xcode,3,1736462055,1736462058,1736462058.2378268,-21600,,
com.google.android.studio,2,1736462053,1736462055,1736462055.773277,-21600,,
com.apple.dt.Xcode,9,1736462044,1736462053,1736462053.653246,-21600,,
com.google.android.studio,5,1736462039,1736462044,1736462044.5176392,-21600,,
com.apple.dt.Xcode,11,1736462028,1736462039,1736462039.5460649,-21600,,
com.google.Chrome,1,1736462027,1736462028,1736462028.3725429,-21600,,
com.apple.dt.Xcode,10,1736462017,1736462027,1736462027.511697,-21600,,
com.google.Chrome,1,1736462016,1736462017,1736462017.87991,-21600,,
com.google.android.studio,24,1736461992,1736462016,1736462016.739287,-21600,,
com.google.Chrome,1,1736461991,1736461992,1736461992.6142092,-21600,,
com.google.android.studio,6,1736461985,1736461991,1736461991.5780911,-21600,,
com.google.Chrome,2,1736461983,1736461985,1736461985.110668,-21600,,
com.google.android.studio,1,1736461982,1736461983,1736461983.600027,-21600,,
com.google.Chrome,5,1736461977,1736461982,1736461982.461018,-21600,,
com.google.android.studio,2,1736461975,1736461977,1736461977.4522061,-21600,,
com.google.Chrome,2,1736461973,1736461975,1736461975.680293,-21600,,
com.google.android.studio,3,1736461970,1736461973,1736461973.809966,-21600,,
com.google.Chrome,4,1736461966,1736461970,1736461970.9838428,-21600,,
com.google.android.studio,11,1736461955,1736461966,1736461966.200196,-21600,,
com.google.Chrome,1,1736461954,1736461955,1736461955.734612,-21600,,
com.google.android.studio,2,1736461952,1736461954,1736461954.3896,-21600,,
com.google.Chrome,19,1736461933,1736461952,1736461952.942762,-21600,,
com.google.android.studio,4,1736461929,1736461933,1736461933.758017,-21600,,
com.google.Chrome,4,1736461925,1736461929,1736461929.346085,-21600,,
com.google.android.studio,33,1736461892,1736461925,1736461926.0339022,-21600,,
com.apple.dt.Xcode,6,1736461886,1736461892,1736461892.496203,-21600,,
com.google.android.studio,47,1736461839,1736461886,1736461886.788059,-21600,,
com.apple.dt.Xcode,20,1736461819,1736461839,1736461839.089256,-21600,,
com.google.android.studio,23,1736461796,1736461819,1736461819.5991411,-21600,,
com.apple.dt.Xcode,4,1736461792,1736461796,1736461796.505168,-21600,,
com.google.android.studio,3,1736461789,1736461792,1736461792.748455,-21600,,
com.apple.dt.Xcode,2,1736461787,1736461789,1736461789.185172,-21600,,
com.google.android.studio,67,1736461720,1736461787,1736461787.9292588,-21600,,
com.apple.dt.Xcode,7,1736461713,1736461720,1736461721.011973,-21600,,
com.google.android.studio,4,1736461709,1736461713,1736461713.624053,-21600,,
com.apple.dt.Xcode,8,1736461701,1736461709,1736461709.3378181,-21600,,
com.google.android.studio,13,1736461688,1736461701,1736461701.504953,-21600,,
com.apple.dt.Xcode,6,1736461682,1736461688,1736461688.759282,-21600,,
com.google.android.studio,19,1736461663,1736461682,1736461682.561116,-21600,,
com.apple.dt.Xcode,32,1736461631,1736461663,1736461663.8540869,-21600,,
com.google.android.studio,13,1736461618,1736461631,1736461631.6141381,-21600,,
com.apple.dt.Xcode,15,1736461603,1736461618,1736461619.117553,-21600,,
com.google.android.studio,8,1736461595,1736461603,1736461603.432534,-21600,,
com.apple.dt.Xcode,9,1736461586,1736461595,1736461595.955151,-21600,,
com.google.android.studio,65,1736461521,1736461586,1736461586.913612,-21600,,
com.google.Chrome,17,1736461504,1736461521,1736461521.9199271,-21600,,
com.google.android.studio,50,1736461454,1736461504,1736461504.466016,-21600,,
com.google.Chrome,13,1736461284,1736461297,1736461297.4058251,-21600,,
com.google.android.studio,26,1736461258,1736461284,1736461284.090431,-21600,,
com.google.Chrome,2,1736461256,1736461258,1736461258.959882,-21600,,
com.google.android.studio,6,1736461250,1736461256,1736461257.009229,-21600,,
com.google.Chrome,14,1736461236,1736461250,1736461250.85081,-21600,,
com.google.android.studio,10,1736461226,1736461236,1736461236.4597049,-21600,,
com.google.Chrome,50,1736461176,1736461226,1736461226.539847,-21600,,
com.google.android.studio,25,1736461151,1736461176,1736461177.007959,-21600,,
com.google.Chrome,3,1736461148,1736461151,1736461151.699154,-21600,,
com.google.android.studio,1,1736461147,1736461148,1736461148.3853168,-21600,,
com.google.Chrome,10,1736461137,1736461147,1736461147.801457,-21600,,
com.google.android.studio,4,1736461133,1736461137,1736461137.834933,-21600,,
com.google.Chrome,1,1736461132,1736461133,1736461133.254315,-21600,,
com.google.android.studio,3,1736461129,1736461132,1736461132.254983,-21600,,
com.google.Chrome,1,1736461128,1736461129,1736461129.583451,-21600,,
com.google.android.studio,3,1736461125,1736461128,1736461128.414466,-21600,,
com.google.Chrome,1,1736461124,1736461125,1736461125.283586,-21600,,
com.google.android.studio,2,1736461122,1736461124,1736461124.3509312,-21600,,
com.google.Chrome,2,1736461120,1736461122,1736461122.285925,-21600,,
com.google.android.studio,1,1736461119,1736461120,1736461120.997827,-21600,,
com.google.Chrome,1,1736461118,1736461119,1736461119.593719,-21600,,
com.google.android.studio,6,1736461112,1736461118,1736461118.3739672,-21600,,
com.google.Chrome,7,1736461105,1736461112,1736461112.478888,-21600,,
com.google.android.studio,0,1736461105,1736461105,1736461105.9976559,-21600,,
com.google.Chrome,1,1736461104,1736461105,1736461105.679089,-21600,,
com.apple.dt.Xcode,0,1736461104,1736461104,1736461104.884979,-21600,,
com.google.android.studio,1,1736461103,1736461104,1736461104.147048,-21600,,
com.apple.dt.Xcode,1,1736461102,1736461103,1736461103.616544,-21600,,
com.google.Chrome,4,1736461098,1736461102,1736461102.052909,-21600,,
com.apple.dt.Xcode,2,1736461096,1736461098,1736461098.8898969,-21600,,
com.google.android.studio,7,1736461089,1736461096,1736461096.8495069,-21600,,
com.apple.dt.Xcode,19,1736461070,1736461089,1736461089.998007,-21600,,
com.google.android.studio,1,1736461069,1736461070,1736461070.209466,-21600,,
com.google.Chrome,11,1736461058,1736461069,1736461069.229065,-21600,,
com.google.android.studio,1,1736461057,1736461058,1736461058.81701,-21600,,
com.apple.dt.Xcode,1,1736461056,1736461057,1736461057.438184,-21600,,
com.google.android.studio,16,1736461040,1736461056,1736461056.621264,-21600,,
com.apple.dt.Xcode,5,1736461035,1736461040,1736461040.450406,-21600,,
com.google.android.studio,1,1736461034,1736461035,1736461035.1665359,-21600,,
com.google.Chrome,2,1736461032,1736461034,1736461034.171448,-21600,,
com.google.android.studio,11,1736461021,1736461032,1736461032.159171,-21600,,
com.google.Chrome,47,1736460974,1736461021,1736461021.8800879,-21600,,
com.google.android.studio,2,1736460972,1736460974,1736460974.2060552,-21600,,
com.apple.dt.Xcode,17,1736460955,1736460972,1736460972.261331,-21600,,
com.google.android.studio,161,1736460794,1736460955,1736460955.437578,-21600,,
com.apple.dt.Xcode,2,1736460792,1736460794,1736460794.419963,-21600,,
com.google.Chrome,91,1736460701,1736460792,1736460792.4084868,-21600,,
com.microsoft.onenote.mac,18,1736460683,1736460701,1736460702.010216,-21600,,
com.google.android.studio,28,1736460655,1736460683,1736460683.844017,-21600,,
com.apple.news,110,1736460498,1736460608,1736460608.564478,-21600,EB445137-D7F5-57EC-87DA-1DB460D64046,"iPhone13,2"
com.google.Gmail,2,1736460485,1736460487,1736460487.866973,-21600,EB445137-D7F5-57EC-87DA-1DB460D64046,"iPhone13,2"
com.apple.Music,0,1736460485,1736460485,1736460486.759413,-21600,EB445137-D7F5-57EC-87DA-1DB460D64046,"iPhone13,2"
com.apple.iCal,258,1736460397,1736460655,1736460655.709192,-21600,,
com.apple.finder,4,1736460393,1736460397,1736460397.877794,-21600,,
com.microsoft.VSCode,2,1736460391,1736460393,1736460393.1877918,-21600,,
com.google.Chrome,120,1736460271,1736460391,1736460391.099875,-21600,,
com.microsoft.VSCode,55,1736460216,1736460271,1736460271.262693,-21600,,
com.google.Chrome,42,1736460174,1736460216,1736460216.993211,-21600,,
com.microsoft.VSCode,141,1736460033,1736460174,1736460174.8207622,-21600,,
com.google.Chrome,589,1736459444,1736460033,1736460033.624218,-21600,,
com.apple.Music,56,1736457671,1736457727,1736457727.574255,-21600,EB445137-D7F5-57EC-87DA-1DB460D64046,"iPhone13,2"
com.apple.news,2,1736457668,1736457670,1736457670.075522,-21600,EB445137-D7F5-57EC-87DA-1DB460D64046,"iPhone13,2"
com.apple.news,13,1736457535,1736457548,1736457548.3442621,-21600,EB445137-D7F5-57EC-87DA-1DB460D64046,"iPhone13,2"
com.apple.MobileSMS,12,1736457507,1736457519,1736457519.6516252,-21600,EB445137-D7F5-57EC-87DA-1DB460D64046,"iPhone13,2"
com.apple.MobileSMS,4,1736457425,1736457429,1736457429.168215,-21600,EB445137-D7F5-57EC-87DA-1DB460D64046,"iPhone13,2"
com.apple.AppStore,16,1736457364,1736457380,1736457381.27064,-21600,EB445137-D7F5-57EC-87DA-1DB460D64046,"iPhone13,2"
com.goodreads.Goodreads,1,1736457358,1736457359,1736457359.5886269,-21600,EB445137-D7F5-57EC-87DA-1DB460D64046,"iPhone13,2"
com.goodreads.Goodreads,27,1736454724,1736454751,1736454751.247469,-21600,EB445137-D7F5-57EC-87DA-1DB460D64046,"iPhone13,2"
com.apple.findmy,6,1736454710,1736454716,1736454716.85793,-21600,EB445137-D7F5-57EC-87DA-1DB460D64046,"iPhone13,2"
com.hammerandchisel.discord,6,1736454703,1736454709,1736454709.425033,-21600,EB445137-D7F5-57EC-87DA-1DB460D64046,"iPhone13,2"
com.apple.news,0,1736454703,1736454703,1736454704.63391,-21600,EB445137-D7F5-57EC-87DA-1DB460D64046,"iPhone13,2"
com.apple.news,28,1736450366,1736450394,1736450394.530626,-21600,EB445137-D7F5-57EC-87DA-1DB460D64046,"iPhone13,2"
com.hammerandchisel.discord,11,1736450344,1736450355,1736450355.5517879,-21600,EB445137-D7F5-57EC-87DA-1DB460D64046,"iPhone13,2"
com.hammerandchisel.discord,12,1736450318,1736450330,1736450330.066576,-21600,EB445137-D7F5-57EC-87DA-1DB460D64046,"iPhone13,2"
com.facebook.Facebook,26,1736450289,1736450315,1736450315.678337,-21600,EB445137-D7F5-57EC-87DA-1DB460D64046,"iPhone13,2"
com.apple.MobileSMS,0,1736450289,1736450289,1736450289.993545,-21600,EB445137-D7F5-57EC-87DA-1DB460D64046,"iPhone13,2"
com.apple.MobileSMS,2,1736447963,1736447965,1736447965.63132,-21600,EB445137-D7F5-57EC-87DA-1DB460D64046,"iPhone13,2"
com.apple.MobileSMS,19,1736447624,1736447643,1736447643.2861528,-21600,EB445137-D7F5-57EC-87DA-1DB460D64046,"iPhone13,2"
com.apple.news,0,1736447624,1736447624,1736447625.418069,-21600,EB445137-D7F5-57EC-87DA-1DB460D64046,"iPhone13,2"
com.apple.news,40,1736446380,1736446420,1736446420.129663,-21600,EB445137-D7F5-57EC-87DA-1DB460D64046,"iPhone13,2"
com.tinyspeck.chatlyio,7,1736446357,1736446364,1736446364.046375,-21600,EB445137-D7F5-57EC-87DA-1DB460D64046,"iPhone13,2"
com.google.Gmail,0,1736446357,1736446357,1736446357.7945051,-21600,EB445137-D7F5-57EC-87DA-1DB460D64046,"iPhone13,2"
com.google.Gmail,17,1736446320,1736446337,1736446337.740026,-21600,EB445137-D7F5-57EC-87DA-1DB460D64046,"iPhone13,2"
com.google.Gmail,51,1736445977,1736446028,1736446028.9721498,-21600,EB445137-D7F5-57EC-87DA-1DB460D64046,"iPhone13,2"
com.google.Gmail,50,1736440628,1736440678,1736440678.587007,-21600,EB445137-D7F5-57EC-87DA-1DB460D64046,"iPhone13,2"
com.apple.Maps,5,1736440623,1736440628,1736440628.4526548,-21600,EB445137-D7F5-57EC-87DA-1DB460D64046,"iPhone13,2"
com.apple.Maps,83,1736439876,1736439959,1736439959.7527509,-21600,EB445137-D7F5-57EC-87DA-1DB460D64046,"iPhone13,2"
com.apple.Music,2,1736439874,1736439876,1736439876.189101,-21600,EB445137-D7F5-57EC-87DA-1DB460D64046,"iPhone13,2"
com.apple.Music,89,1736434362,1736434451,1736434451.6780028,-21600,EB445137-D7F5-57EC-87DA-1DB460D64046,"iPhone13,2"
com.apple.weather,2,1736434359,1736434361,1736434361.804455,-21600,EB445137-D7F5-57EC-87DA-1DB460D64046,"iPhone13,2"
com.apple.weather,2,1736433704,1736433706,1736433706.625627,-21600,EB445137-D7F5-57EC-87DA-1DB460D64046,"iPhone13,2"
com.renpho.health,1,1736433703,1736433704,1736433704.787959,-21600,EB445137-D7F5-57EC-87DA-1DB460D64046,"iPhone13,2"
com.renpho.health,61,1736433266,1736433327,1736433327.6564732,-21600,EB445137-D7F5-57EC-87DA-1DB460D64046,"iPhone13,2"
com.apple.mobiletimer,10,1736400806,1736400816,1736400816.2526999,-21600,EB445137-D7F5-57EC-87DA-1DB460D64046,"iPhone13,2"
com.apple.Health,52,1736400744,1736400796,1736400797.01772,-21600,EB445137-D7F5-57EC-87DA-1DB460D64046,"iPhone13,2"
com.thestorygraph.thestorygraph,155,1736400587,1736400742,1736400742.10318,-21600,EB445137-D7F5-57EC-87DA-1DB460D64046,"iPhone13,2"
com.apple.MobileSMS,21,1736399799,1736399820,1736399820.1060019,-21600,EB445137-D7F5-57EC-87DA-1DB460D64046,"iPhone13,2"
com.apple.MobileSMS,6,1736398049,1736398055,1736398056.1573281,-21600,EB445137-D7F5-57EC-87DA-1DB460D64046,"iPhone13,2"
com.apple.findmy,7,1736398042,1736398049,1736398050.0643911,-21600,EB445137-D7F5-57EC-87DA-1DB460D64046,"iPhone13,2"
com.apple.findmy,23,1736397697,1736397720,1736397720.6425328,-21600,EB445137-D7F5-57EC-87DA-1DB460D64046,"iPhone13,2"
com.apple.findmy,10,1736397514,1736397524,1736397524.727129,-21600,EB445137-D7F5-57EC-87DA-1DB460D64046,"iPhone13,2"
com.apple.MobileSMS,2,1736397507,1736397509,1736397509.661412,-21600,EB445137-D7F5-57EC-87DA-1DB460D64046,"iPhone13,2"
com.apple.MobileSMS,2,1736396485,1736396487,1736396487.9943361,-21600,EB445137-D7F5-57EC-87DA-1DB460D64046,"iPhone13,2"
com.apple.MobileSMS,2,1736396417,1736396419,1736396419.696599,-21600,EB445137-D7F5-57EC-87DA-1DB460D64046,"iPhone13,2"
com.apple.MobileSMS,15,1736396389,1736396404,1736396405.112325,-21600,EB445137-D7F5-57EC-87DA-1DB460D64046,"iPhone13,2"
com.apple.findmy,6,1736396383,1736396389,1736396389.793871,-21600,EB445137-D7F5-57EC-87DA-1DB460D64046,"iPhone13,2"
com.apple.MobileSMS,63,1736396320,1736396383,1736396383.471189,-21600,EB445137-D7F5-57EC-87DA-1DB460D64046,"iPhone13,2"
com.apple.findmy,21,1736396298,1736396319,1736396319.997851,-21600,EB445137-D7F5-57EC-87DA-1DB460D64046,"iPhone13,2"
com.apple.calculator,2,1736396296,1736396298,1736396298.1405292,-21600,EB445137-D7F5-57EC-87DA-1DB460D64046,"iPhone13,2"
com.apple.calculator,10,1736395699,1736395709,1736395710.09945,-21600,EB445137-D7F5-57EC-87DA-1DB460D64046,"iPhone13,2"
com.apple.CoreAuthUI,2,1736395686,1736395688,1736395688.056548,-21600,EB445137-D7F5-57EC-87DA-1DB460D64046,"iPhone13,2"
com.truebill.truebillnative,19,1736395680,1736395699,1736395699.8304949,-21600,EB445137-D7F5-57EC-87DA-1DB460D64046,"iPhone13,2"
com.letterboxd.LetterboxdApp,2,1736395676,1736395678,1736395678.114094,-21600,EB445137-D7F5-57EC-87DA-1DB460D64046,"iPhone13,2"
com.letterboxd.LetterboxdApp,32,1736395575,1736395607,1736395607.873159,-21600,EB445137-D7F5-57EC-87DA-1DB460D64046,"iPhone13,2"
com.apple.MobileSMS,2,1736395542,1736395544,1736395544.753124,-21600,EB445137-D7F5-57EC-87DA-1DB460D64046,"iPhone13,2"
com.apple.MobileSMS,6,1736393893,1736393899,1736393899.559836,-21600,EB445137-D7F5-57EC-87DA-1DB460D64046,"iPhone13,2"
com.amazon.Amazon,47,1736391567,1736391614,1736391615.139395,-21600,EB445137-D7F5-57EC-87DA-1DB460D64046,"iPhone13,2"
com.apple.findmy,2,1736391561,1736391563,1736391563.328769,-21600,EB445137-D7F5-57EC-87DA-1DB460D64046,"iPhone13,2"
com.apple.findmy,9,1736388702,1736388711,1736388711.529729,-21600,EB445137-D7F5-57EC-87DA-1DB460D64046,"iPhone13,2"
com.apple.MobileSMS,6,1736388695,1736388701,1736388701.1132,-21600,EB445137-D7F5-57EC-87DA-1DB460D64046,"iPhone13,2"
com.apple.MobileSMS,5,1736388686,1736388691,1736388691.88627,-21600,EB445137-D7F5-57EC-87DA-1DB460D64046,"iPhone13,2"
com.apple.findmy,3,1736388683,1736388686,1736388687.253858,-21600,EB445137-D7F5-57EC-87DA-1DB460D64046,"iPhone13,2"
com.apple.findmy,61,1736388556,1736388617,1736388617.5361161,-21600,EB445137-D7F5-57EC-87DA-1DB460D64046,"iPhone13,2"
com.apple.findmy,13,1736388248,1736388261,1736388261.730973,-21600,EB445137-D7F5-57EC-87DA-1DB460D64046,"iPhone13,2"
com.apple.findmy,5,1736387870,1736387875,1736387875.653839,-21600,EB445137-D7F5-57EC-87DA-1DB460D64046,"iPhone13,2"
com.google.Chrome,508,1736387809,1736388317,1736388317.557849,-21600,,
com.apple.findmy,13,1736387698,1736387711,1736387712.331722,-21600,EB445137-D7F5-57EC-87DA-1DB460D64046,"iPhone13,2"
com.apple.MobileSMS,2,1736387696,1736387698,1736387698.905314,-21600,EB445137-D7F5-57EC-87DA-1DB460D64046,"iPhone13,2"
com.google.ios.youtube,227,1736387468,1736387695,1736387695.707425,-21600,EB445137-D7F5-57EC-87DA-1DB460D64046,"iPhone13,2"
com.apple.MobileSMS,11,1736387457,1736387468,1736387468.1978111,-21600,EB445137-D7F5-57EC-87DA-1DB460D64046,"iPhone13,2"
com.google.ios.youtube,15,1736387442,1736387457,1736387457.6807141,-21600,EB445137-D7F5-57EC-87DA-1DB460D64046,"iPhone13,2"
com.apple.MobileSMS,122,1736387320,1736387442,1736387442.697802,-21600,EB445137-D7F5-57EC-87DA-1DB460D64046,"iPhone13,2"
com.google.ios.youtube,20,1736387300,1736387320,1736387320.909419,-21600,EB445137-D7F5-57EC-87DA-1DB460D64046,"iPhone13,2"
com.apple.MobileSMS,15,1736387285,1736387300,1736387300.549511,-21600,EB445137-D7F5-57EC-87DA-1DB460D64046,"iPhone13,2"
com.google.ios.youtube,60,1736387225,1736387285,1736387285.658152,-21600,EB445137-D7F5-57EC-87DA-1DB460D64046,"iPhone13,2"
com.apple.MobileSMS,4,1736387221,1736387225,1736387225.541192,-21600,EB445137-D7F5-57EC-87DA-1DB460D64046,"iPhone13,2"
com.apple.MobileSMS,107,1736387098,1736387205,1736387205.7052,-21600,EB445137-D7F5-57EC-87DA-1DB460D64046,"iPhone13,2"
com.hammerandchisel.discord,19,1736387079,1736387098,1736387098.8311071,-21600,EB445137-D7F5-57EC-87DA-1DB460D64046,"iPhone13,2"
com.google.ios.youtube,690,1736386379,1736387069,1736387069.5502892,-21600,EB445137-D7F5-57EC-87DA-1DB460D64046,"iPhone13,2"
com.apple.MobileSMS,3,1736386373,1736386376,1736386376.0984468,-21600,EB445137-D7F5-57EC-87DA-1DB460D64046,"iPhone13,2"
com.apple.MobileSMS,8,1736386030,1736386038,1736386038.866496,-21600,EB445137-D7F5-57EC-87DA-1DB460D64046,"iPhone13,2"
com.letterboxd.LetterboxdApp,197,1736385825,1736386022,1736386022.336999,-21600,EB445137-D7F5-57EC-87DA-1DB460D64046,"iPhone13,2"
com.apple.MobileSMS,5,1736385820,1736385825,1736385826.102306,-21600,EB445137-D7F5-57EC-87DA-1DB460D64046,"iPhone13,2"
com.letterboxd.LetterboxdApp,85,1736385735,1736385820,1736385820.611285,-21600,EB445137-D7F5-57EC-87DA-1DB460D64046,"iPhone13,2"
com.apple.MobileSMS,3,1736385731,1736385734,1736385734.466103,-21600,EB445137-D7F5-57EC-87DA-1DB460D64046,"iPhone13,2"
com.apple.MobileSMS,3,1736385553,1736385556,1736385556.2760348,-21600,EB445137-D7F5-57EC-87DA-1DB460D64046,"iPhone13,2"
com.apple.MobileSMS,65,1736385364,1736385429,1736385429.364747,-21600,EB445137-D7F5-57EC-87DA-1DB460D64046,"iPhone13,2"
com.apple.MobileSMS,40,1736385319,1736385359,1736385359.784651,-21600,EB445137-D7F5-57EC-87DA-1DB460D64046,"iPhone13,2"
com.letterboxd.LetterboxdApp,0,1736385319,1736385319,1736385320.587764,-21600,EB445137-D7F5-57EC-87DA-1DB460D64046,"iPhone13,2"
com.google.Chrome,39,1736382797,1736382836,1736382836.478389,-21600,,
com.apple.finder,2,1736382795,1736382797,1736382797.663091,-21600,,
com.letterboxd.LetterboxdApp,44,1736382793,1736382837,1736382838.800129,-21600,EB445137-D7F5-57EC-87DA-1DB460D64046,"iPhone13,2"
com.letterboxd.LetterboxdApp,3,1736381190,1736381193,1736381193.802868,-21600,EB445137-D7F5-57EC-87DA-1DB460D64046,"iPhone13,2"
com.apple.MobileSMS,2,1736381188,1736381190,1736381191.0094929,-21600,EB445137-D7F5-57EC-87DA-1DB460D64046,"iPhone13,2"
com.apple.MobileSMS,14,1736381131,1736381145,1736381146.4711719,-21600,EB445137-D7F5-57EC-87DA-1DB460D64046,"iPhone13,2"
com.letterboxd.LetterboxdApp,99,1736381031,1736381130,1736381130.333216,-21600,EB445137-D7F5-57EC-87DA-1DB460D64046,"iPhone13,2"
com.google.chrome.ios,10,1736381012,1736381022,1736381022.403719,-21600,EB445137-D7F5-57EC-87DA-1DB460D64046,"iPhone13,2"
com.google.chrome.ios,48,1736380945,1736380993,1736380994.1127439,-21600,EB445137-D7F5-57EC-87DA-1DB460D64046,"iPhone13,2"
com.google.chrome.ios,23,1736380910,1736380933,1736380934.446264,-21600,EB445137-D7F5-57EC-87DA-1DB460D64046,"iPhone13,2"
com.google.chrome.ios,12,1736380477,1736380489,1736380490.094867,-21600,EB445137-D7F5-57EC-87DA-1DB460D64046,"iPhone13,2"
com.google.chrome.ios,6,1736380377,1736380383,1736380383.7588081,-21600,EB445137-D7F5-57EC-87DA-1DB460D64046,"iPhone13,2"
com.google.chrome.ios,36,1736380332,1736380368,1736380368.606813,-21600,EB445137-D7F5-57EC-87DA-1DB460D64046,"iPhone13,2"
com.google.chrome.ios,77,1736380248,1736380325,1736380325.890621,-21600,EB445137-D7F5-57EC-87DA-1DB460D64046,"iPhone13,2"
com.google.Gmail,5,1736380243,1736380248,1736380248.6136808,-21600,EB445137-D7F5-57EC-87DA-1DB460D64046,"iPhone13,2"
com.letterboxd.LetterboxdApp,6,1736380237,1736380243,1736380243.4888759,-21600,EB445137-D7F5-57EC-87DA-1DB460D64046,"iPhone13,2"
com.google.Gmail,16,1736380221,1736380237,1736380238.1437402,-21600,EB445137-D7F5-57EC-87DA-1DB460D64046,"iPhone13,2"
com.google.chrome.ios,59,1736380162,1736380221,1736380221.58203,-21600,EB445137-D7F5-57EC-87DA-1DB460D64046,"iPhone13,2"
com.apple.findmy,14,1736380148,1736380162,1736380162.723166,-21600,EB445137-D7F5-57EC-87DA-1DB460D64046,"iPhone13,2"
com.google.chrome.ios,2,1736380146,1736380148,1736380148.3537102,-21600,EB445137-D7F5-57EC-87DA-1DB460D64046,"iPhone13,2"
com.google.Gmail,47,1736380099,1736380146,1736380146.648515,-21600,EB445137-D7F5-57EC-87DA-1DB460D64046,"iPhone13,2"
com.letterboxd.LetterboxdApp,64,1736380034,1736380098,1736380098.901201,-21600,EB445137-D7F5-57EC-87DA-1DB460D64046,"iPhone13,2"
com.google.chrome.ios,7,1736380026,1736380033,1736380033.637466,-21600,EB445137-D7F5-57EC-87DA-1DB460D64046,"iPhone13,2"
com.google.chrome.ios,30,1736379996,1736380026,1736380026.12254,-21600,EB445137-D7F5-57EC-87DA-1DB460D64046,"iPhone13,2"
com.letterboxd.LetterboxdApp,16,1736379750,1736379766,1736379767.5027509,-21600,EB445137-D7F5-57EC-87DA-1DB460D64046,"iPhone13,2"
com.apple.findmy,2,1736379748,1736379750,1736379750.994954,-21600,EB445137-D7F5-57EC-87DA-1DB460D64046,"iPhone13,2"
com.apple.finder,0,1736379725,1736379725,1736379726.0413818,-21600,,
com.electron.carta,21,1736379695,1736379716,1736379716.3933868,-21600,,
com.apple.findmy,11,1736379645,1736379656,1736379656.840894,-21600,EB445137-D7F5-57EC-87DA-1DB460D64046,"iPhone13,2"
com.apple.findmy,6,1736379638,1736379644,1736379645.734483,-21600,EB445137-D7F5-57EC-87DA-1DB460D64046,"iPhone13,2"
com.apple.MobileSMS,2,1736379635,1736379637,1736379637.4972901,-21600,EB445137-D7F5-57EC-87DA-1DB460D64046,"iPhone13,2"
com.google.Chrome,68,1736379627,1736379695,1736379695.6381621,-21600,,
com.leomehlig.today,4,1736379623,1736379627,1736379627.820794,-21600,,
com.google.Chrome,2,1736379621,1736379623,1736379623.824689,-21600,,
com.leomehlig.today,1,1736379620,1736379621,1736379621.238163,-21600,,
com.google.Chrome,21,1736379599,1736379620,1736379620.944191,-21600,,
com.google.android.studio,2,1736379597,1736379599,1736379599.6011019,-21600,,
com.google.Chrome,1,1736379596,1736379597,1736379597.889756,-21600,,
com.google.android.studio,157,1736379439,1736379596,1736379596.36165,-21600,,
com.apple.MobileSMS,7,1736379321,1736379328,1736379329.0086079,-21600,EB445137-D7F5-57EC-87DA-1DB460D64046,"iPhone13,2"
com.google.Chrome,143,1736379296,1736379439,1736379439.365561,-21600,,
com.microsoft.onenote.mac,27,1736379269,1736379296,1736379296.5920181,-21600,,
com.google.android.studio,1,1736379268,1736379269,1736379269.881579,-21600,,
com.microsoft.onenote.mac,21,1736379247,1736379268,1736379268.163885,-21600,,
com.google.android.studio,98,1736379149,1736379247,1736379247.5395741,-21600,,
com.microsoft.onenote.mac,2,1736379147,1736379149,1736379150.106937,-21600,,
com.google.android.studio,4,1736379143,1736379147,1736379147.337861,-21600,,
com.microsoft.onenote.mac,76,1736379067,1736379143,1736379143.824348,-21600,,
com.google.android.studio,197,1736378870,1736379067,1736379067.863795,-21600,,
com.google.Chrome,1,1736378869,1736378870,1736378870.987225,-21600,,
com.google.android.studio,44,1736378825,1736378869,1736378869.323137,-21600,,
com.google.Chrome,18,1736378807,1736378825,1736378825.271566,-21600,,
com.google.android.studio,335,1736378472,1736378807,1736378807.451287,-21600,,
com.google.Chrome,82,1736378390,1736378472,1736378472.786252,-21600,,
com.google.android.studio,64,1736378326,1736378390,1736378390.179614,-21600,,
com.google.Chrome,15,1736378311,1736378326,1736378326.971631,-21600,,
com.google.android.studio,30,1736378281,1736378311,1736378311.129303,-21600,,
com.google.Chrome,7,1736378274,1736378281,1736378281.857184,-21600,,
com.google.android.studio,1,1736378273,1736378274,1736378274.479969,-21600,,
com.google.Chrome,2,1736378271,1736378273,1736378273.259027,-21600,,
com.google.android.studio,13,1736378258,1736378271,1736378271.120991,-21600,,
com.google.Chrome,8,1736378250,1736378258,1736378258.211591,-21600,,
com.google.android.studio,6,1736378244,1736378250,1736378250.706071,-21600,,
com.google.Chrome,8,1736378236,1736378244,1736378244.9364362,-21600,,
com.google.android.studio,62,1736378174,1736378236,1736378236.640774,-21600,,
com.google.Chrome,12,1736378162,1736378174,1736378174.986901,-21600,,
com.google.android.studio,5,1736378157,1736378162,1736378162.3798609,-21600,,
com.google.Chrome,7,1736378150,1736378157,1736378157.430197,-21600,,
com.google.android.studio,10,1736378140,1736378150,1736378150.9389591,-21600,,
com.google.Chrome,3,1736378137,1736378140,1736378140.2244039,-21600,,
com.google.android.studio,1,1736378136,1736378137,1736378137.964047,-21600,,
com.google.Chrome,6,1736378130,1736378136,1736378136.242975,-21600,,
com.google.android.studio,28,1736378102,1736378130,1736378130.74231,-21600,,
com.google.Chrome,3,1736378099,1736378102,1736378102.111227,-21600,,
com.google.android.studio,49,1736378050,1736378099,1736378099.818728,-21600,,
com.google.Chrome,74,1736377976,1736378050,1736378050.715716,-21600,,
com.google.android.studio,160,1736377816,1736377976,1736377976.434565,-21600,,
com.google.Chrome,5,1736377811,1736377816,1736377816.333715,-21600,,
com.google.android.studio,199,1736377612,1736377811,1736377811.616272,-21600,,
com.google.Chrome,1,1736377611,1736377612,1736377612.774094,-21600,,
com.google.android.studio,5,1736377606,1736377611,1736377611.272853,-21600,,
com.google.Chrome,3,1736377603,1736377606,1736377606.9603171,-21600,,
com.google.android.studio,9,1736377594,1736377603,1736377603.514719,-21600,,
com.google.Chrome,3,1736377591,1736377594,1736377594.6681108,-21600,,
com.google.android.studio,1,1736377590,1736377591,1736377591.862082,-21600,,
com.google.Chrome,11,1736377579,1736377590,1736377590.678547,-21600,,
com.google.android.studio,4,1736377575,1736377579,1736377579.681655,-21600,,
com.google.Chrome,8,1736377567,1736377575,1736377575.4458919,-21600,,
com.google.android.studio,20,1736377547,1736377567,1736377567.1195688,-21600,,
com.google.Chrome,32,1736377515,1736377547,1736377547.609931,-21600,,
com.google.android.studio,63,1736377452,1736377515,1736377515.522753,-21600,,
com.google.Chrome,8,1736377444,1736377452,1736377452.29001,-21600,,
com.google.android.studio,2,1736377442,1736377444,1736377444.564138,-21600,,
com.google.Chrome,2,1736377440,1736377442,1736377442.4470801,-21600,,
com.google.android.studio,2,1736377438,1736377440,1736377441.007607,-21600,,
com.google.Chrome,2,1736377436,1736377438,1736377438.127464,-21600,,
com.google.android.studio,12,1736377424,1736377436,1736377436.6288261,-21600,,
com.google.Chrome,1,1736377423,1736377424,1736377424.610374,-21600,,
com.google.android.studio,16,1736377407,1736377423,1736377423.4687629,-21600,,
com.google.Chrome,8,1736377399,1736377407,1736377407.947336,-21600,,
com.apple.dt.Xcode,1,1736377398,1736377399,1736377399.127212,-21600,,
com.google.Chrome,29,1736377369,1736377398,1736377398.0778608,-21600,,
com.apple.dt.Xcode,1,1736377368,1736377369,1736377369.83707,-21600,,
com.google.android.studio,4,1736377364,1736377368,1736377368.441561,-21600,,
com.google.Chrome,2,1736377362,1736377364,1736377364.658212,-21600,,
com.apple.dt.Xcode,1,1736377361,1736377362,1736377362.1619968,-21600,,
com.google.Chrome,5,1736377356,1736377361,1736377361.157259,-21600,,
com.apple.dt.Xcode,1,1736377355,1736377356,1736377356.477637,-21600,,
com.google.android.studio,249,1736377106,1736377355,1736377355.717163,-21600,,
com.apple.dt.Xcode,46,1736377060,1736377106,1736377106.801167,-21600,,
com.google.android.studio,8,1736377052,1736377060,1736377060.505375,-21600,,
com.apple.dt.Xcode,26,1736377026,1736377052,1736377052.080118,-21600,,
com.google.android.studio,395,1736376631,1736377026,1736377026.740787,-21600,,
com.google.Chrome,7,1736376624,1736376631,1736376631.8936028,-21600,,
com.google.android.studio,268,1736376356,1736376624,1736376624.237062,-21600,,
com.google.Chrome,9,1736376347,1736376356,1736376356.2087631,-21600,,
com.google.android.studio,3,1736376344,1736376347,1736376347.411149,-21600,,
com.google.Chrome,47,1736376297,1736376344,1736376344.8453078,-21600,,
com.google.android.studio,15,1736376282,1736376297,1736376297.649025,-21600,,
com.google.Chrome,2,1736376280,1736376282,1736376282.636653,-21600,,
com.google.android.studio,101,1736376179,1736376280,1736376280.1432009,-21600,,
com.google.Chrome,86,1736376093,1736376179,1736376179.172031,-21600,,
com.google.android.studio,498,1736375595,1736376093,1736376093.31044,-21600,,
com.google.Chrome,5,1736375590,1736375595,1736375595.512562,-21600,,
com.google.android.studio,6,1736375584,1736375590,1736375590.2903152,-21600,,
com.google.Chrome,20,1736375564,1736375584,1736375584.243547,-21600,,
com.google.android.studio,92,1736375472,1736375564,1736375564.204671,-21600,,
com.google.Chrome,10,1736375462,1736375472,1736375472.715411,-21600,,
com.google.android.studio,67,1736375395,1736375462,1736375462.897843,-21600,,
com.google.Chrome,4,1736375391,1736375395,1736375395.4277601,-21600,,
com.google.android.studio,231,1736375160,1736375391,1736375391.113128,-21600,,
com.google.Chrome,24,1736375136,1736375160,1736375160.9152331,-21600,,
com.google.android.studio,160,1736374976,1736375136,1736375136.269033,-21600,,
com.google.Chrome,23,1736374953,1736374976,1736374976.0546331,-21600,,
com.google.android.studio,3,1736374950,1736374953,1736374953.878912,-21600,,
com.google.Chrome,15,1736374935,1736374950,1736374950.627743,-21600,,
com.google.android.studio,44,1736374891,1736374935,1736374935.3803248,-21600,,
com.google.Chrome,10,1736374881,1736374891,1736374891.5707269,-21600,,
com.google.android.studio,2,1736374879,1736374881,1736374881.251929,-21600,,
com.google.Chrome,10,1736374869,1736374879,1736374879.549316,-21600,,
com.google.android.studio,118,1736374751,1736374869,1736374869.731937,-21600,,
com.google.Chrome,36,1736374715,1736374751,1736374751.523477,-21600,,
com.google.android.studio,92,1736374623,1736374715,1736374715.9682322,-21600,,
com.google.Chrome,20,1736374603,1736374623,1736374623.499063,-21600,,
com.google.android.studio,598,1736374005,1736374603,1736374604.0623698,-21600,,
com.google.Chrome,3,1736374002,1736374005,1736374005.882842,-21600,,
com.google.android.studio,2,1736374000,1736374002,1736374002.832889,-21600,,
com.google.Chrome,13,1736373987,1736374000,1736374000.993927,-21600,,
com.google.android.studio,20,1736373967,1736373987,1736373987.3459,-21600,,
com.google.Chrome,16,1736373951,1736373967,1736373967.675438,-21600,,
com.google.android.studio,6,1736373945,1736373951,1736373951.214565,-21600,,
com.google.Chrome,7,1736373938,1736373945,1736373945.86129,-21600,,
com.google.android.studio,9,1736373929,1736373938,1736373938.927916,-21600,,
com.google.Chrome,14,1736373915,1736373929,1736373929.571075,-21600,,
com.google.android.studio,4,1736373911,1736373915,1736373915.219825,-21600,,
com.google.Chrome,1,1736373910,1736373911,1736373911.601733,-21600,,
com.google.android.studio,21,1736373889,1736373910,1736373911.042634,-21600,,
com.google.Chrome,1,1736373888,1736373889,1736373889.8053799,-21600,,
com.google.android.studio,4,1736373884,1736373888,1736373888.343854,-21600,,
com.google.Chrome,1,1736373883,1736373884,1736373884.615123,-21600,,
com.google.android.studio,134,1736373749,1736373883,1736373883.4080992,-21600,,
com.google.Chrome,1,1736373748,1736373749,1736373749.475327,-21600,,
com.apple.dt.Xcode,8,1736373740,1736373748,1736373748.044919,-21600,,
com.google.Chrome,1,1736373739,1736373740,1736373740.849545,-21600,,
com.google.android.studio,32,1736373707,1736373739,1736373739.5447478,-21600,,
com.google.Chrome,4,1736373703,1736373707,1736373707.1324449,-21600,,
com.google.android.studio,10,1736373693,1736373703,1736373703.637583,-21600,,
com.google.Chrome,4,1736373689,1736373693,1736373693.073964,-21600,,
com.google.android.studio,14,1736373675,1736373689,1736373689.4775681,-21600,,
com.google.Chrome,2,1736373673,1736373675,1736373675.4485831,-21600,,
com.google.android.studio,7,1736373666,1736373673,1736373673.6720781,-21600,,
com.google.Chrome,3,1736373663,1736373666,1736373666.2953591,-21600,,
com.google.android.studio,2,1736373661,1736373663,1736373663.1005769,-21600,,
com.google.Chrome,1,1736373660,1736373661,1736373661.127987,-21600,,
com.google.android.studio,2,1736373658,1736373660,1736373660.388495,-21600,,
com.google.Chrome,2,1736373656,1736373658,1736373658.9248781,-21600,,
com.google.android.studio,7,1736373649,1736373656,1736373656.374491,-21600,,
com.google.Chrome,8,1736373641,1736373649,1736373649.9528809,-21600,,
com.google.android.studio,0,1736373641,1736373641,1736373641.88057,-21600,,
com.google.Chrome,1,1736373640,1736373641,1736373641.525511,-21600,,
com.apple.dt.Xcode,1,1736373639,1736373640,1736373641.012378,-21600,,
com.google.android.studio,6,1736373633,1736373639,1736373639.7937279,-21600,,
com.apple.dt.Xcode,1,1736373632,1736373633,1736373633.597807,-21600,,
com.google.android.studio,9,1736373623,1736373632,1736373632.926158,-21600,,
com.apple.dt.Xcode,2,1736373621,1736373623,1736373623.409169,-21600,,
com.google.Chrome,3,1736373618,1736373621,1736373622.0155659,-21600,,
com.apple.dt.Xcode,0,1736373618,1736373618,1736373619.0250359,-21600,,
com.google.Chrome,17,1736373601,1736373618,1736373618.2435188,-21600,,
com.apple.dt.Xcode,1,1736373600,1736373601,1736373601.2738,-21600,,
com.google.android.studio,106,1736373494,1736373600,1736373600.2538671,-21600,,
com.apple.dt.Xcode,48,1736373446,1736373494,1736373494.673015,-21600,,
com.google.android.studio,75,1736373371,1736373446,1736373447.028091,-21600,,
com.google.Chrome,43,1736373328,1736373371,1736373371.868081,-21600,,
Astrospheric.Astrospheric,2,1736373197,1736373199,1736373200.150289,-21600,EB445137-D7F5-57EC-87DA-1DB460D64046,"iPhone13,2"
com.apple.findmy,2,1736373194,1736373196,1736373196.731583,-21600,EB445137-D7F5-57EC-87DA-1DB460D64046,"iPhone13,2"
com.google.android.studio,146,1736373182,1736373328,1736373330.200419,-21600,,
com.google.Chrome,16,1736373118,1736373134,1736373134.511204,-21600,,
com.apple.findmy,5,1736373097,1736373102,1736373102.49372,-21600,EB445137-D7F5-57EC-87DA-1DB460D64046,"iPhone13,2"
com.apple.news,409,1736372510,1736372919,1736372919.548235,-21600,EB445137-D7F5-57EC-87DA-1DB460D64046,"iPhone13,2"
com.letterboxd.LetterboxdApp,3,1736372494,1736372497,1736372497.9125118,-21600,EB445137-D7F5-57EC-87DA-1DB460D64046,"iPhone13,2"
com.letterboxd.LetterboxdApp,21,1736372437,1736372458,1736372458.790741,-21600,EB445137-D7F5-57EC-87DA-1DB460D64046,"iPhone13,2"
com.letterboxd.LetterboxdApp,83,1736370850,1736370933,1736370934.2847,-21600,EB445137-D7F5-57EC-87DA-1DB460D64046,"iPhone13,2"
com.google.Chrome,1876,1736370847,1736372723,1736372723.686882,-21600,,
com.google.Chrome,301,1736370259,1736370560,1736370560.8385282,-21600,,
com.google.Chrome,324,1736369501,1736369825,1736369825.1979399,-21600,,
com.letterboxd.LetterboxdApp,10,1736366707,1736366717,1736366717.733746,-21600,EB445137-D7F5-57EC-87DA-1DB460D64046,"iPhone13,2"
com.letterboxd.LetterboxdApp,243,1736366435,1736366678,1736366679.28237,-21600,EB445137-D7F5-57EC-87DA-1DB460D64046,"iPhone13,2"
com.thestorygraph.thestorygraph,2,1736366432,1736366434,1736366434.75177,-21600,EB445137-D7F5-57EC-87DA-1DB460D64046,"iPhone13,2"
com.apple.news,1,1736366429,1736366430,1736366430.8038712,-21600,EB445137-D7F5-57EC-87DA-1DB460D64046,"iPhone13,2"
com.apple.news,8,1736365842,1736365850,1736365851.186836,-21600,EB445137-D7F5-57EC-87DA-1DB460D64046,"iPhone13,2"
com.apple.news,64,1736365777,1736365841,1736365841.744648,-21600,EB445137-D7F5-57EC-87DA-1DB460D64046,"iPhone13,2"
com.apple.news,60,1736365608,1736365668,1736365668.8051739,-21600,EB445137-D7F5-57EC-87DA-1DB460D64046,"iPhone13,2"
com.letterboxd.LetterboxdApp,49,1736365436,1736365485,1736365485.459379,-21600,EB445137-D7F5-57EC-87DA-1DB460D64046,"iPhone13,2"
com.letterboxd.LetterboxdApp,19,1736365358,1736365377,1736365377.840764,-21600,EB445137-D7F5-57EC-87DA-1DB460D64046,"iPhone13,2"
com.google.Gmail,23,1736365335,1736365358,1736365358.453109,-21600,EB445137-D7F5-57EC-87DA-1DB460D64046,"iPhone13,2"
com.google.chrome.ios,31,1736365303,1736365334,1736365334.949163,-21600,EB445137-D7F5-57EC-87DA-1DB460D64046,"iPhone13,2"
com.letterboxd.LetterboxdApp,25,1736365278,1736365303,1736365303.975369,-21600,EB445137-D7F5-57EC-87DA-1DB460D64046,"iPhone13,2"
com.letterboxd.LetterboxdApp,10,1736364946,1736364956,1736364956.627616,-21600,EB445137-D7F5-57EC-87DA-1DB460D64046,"iPhone13,2"
com.letterboxd.LetterboxdApp,65,1736364880,1736364945,1736364945.750352,-21600,EB445137-D7F5-57EC-87DA-1DB460D64046,"iPhone13,2"
com.apple.findmy,14,1736364834,1736364848,1736364848.183953,-21600,EB445137-D7F5-57EC-87DA-1DB460D64046,"iPhone13,2"
com.apple.findmy,27,1736364736,1736364763,1736364764.081636,-21600,EB445137-D7F5-57EC-87DA-1DB460D64046,"iPhone13,2"
com.burbn.instagram,17,1736364181,1736364198,1736364198.6559172,-21600,EB445137-D7F5-57EC-87DA-1DB460D64046,"iPhone13,2"
com.google.chrome.ios,146,1736363885,1736364031,1736364031.7529202,-21600,EB445137-D7F5-57EC-87DA-1DB460D64046,"iPhone13,2"
com.letterboxd.LetterboxdApp,163,1736363540,1736363703,1736363703.152533,-21600,EB445137-D7F5-57EC-87DA-1DB460D64046,"iPhone13,2"
com.letterboxd.LetterboxdApp,87,1736362942,1736363029,1736363029.853755,-21600,EB445137-D7F5-57EC-87DA-1DB460D64046,"iPhone13,2"
com.toyopagroup.picaboo,27,1736362384,1736362411,1736362411.8467522,-21600,EB445137-D7F5-57EC-87DA-1DB460D64046,"iPhone13,2"
com.letterboxd.LetterboxdApp,0,1736362384,1736362384,1736362387.033613,-21600,EB445137-D7F5-57EC-87DA-1DB460D64046,"iPhone13,2"
com.letterboxd.LetterboxdApp,80,1736361600,1736361680,1736361681.334741,-21600,EB445137-D7F5-57EC-87DA-1DB460D64046,"iPhone13,2"
com.toyopagroup.picaboo,11,1736361589,1736361600,1736361600.144041,-21600,EB445137-D7F5-57EC-87DA-1DB460D64046,"iPhone13,2"
com.toyopagroup.picaboo,31,1736361540,1736361571,1736361571.943604,-21600,EB445137-D7F5-57EC-87DA-1DB460D64046,"iPhone13,2"
com.google.ios.youtube,2,1736361538,1736361540,1736361540.389009,-21600,EB445137-D7F5-57EC-87DA-1DB460D64046,"iPhone13,2"
com.google.ios.youtube,455,1736360837,1736361292,1736361293.284981,-21600,EB445137-D7F5-57EC-87DA-1DB460D64046,"iPhone13,2"
com.letterboxd.LetterboxdApp,11,1736360822,1736360833,1736360833.964097,-21600,EB445137-D7F5-57EC-87DA-1DB460D64046,"iPhone13,2"
com.google.chrome.ios,643,1736359663,1736360306,1736360306.6169338,-21600,EB445137-D7F5-57EC-87DA-1DB460D64046,"iPhone13,2"
com.google.chrome.ios,91,1736359425,1736359516,1736359516.315709,-21600,EB445137-D7F5-57EC-87DA-1DB460D64046,"iPhone13,2"
com.apple.calculator,8,1736359417,1736359425,1736359425.381007,-21600,EB445137-D7F5-57EC-87DA-1DB460D64046,"iPhone13,2"
com.google.chrome.ios,24,1736359393,1736359417,1736359417.967735,-21600,EB445137-D7F5-57EC-87DA-1DB460D64046,"iPhone13,2"
com.apple.calculator,8,1736359385,1736359393,1736359393.6978269,-21600,EB445137-D7F5-57EC-87DA-1DB460D64046,"iPhone13,2"
com.google.chrome.ios,8,1736359377,1736359385,1736359385.303049,-21600,EB445137-D7F5-57EC-87DA-1DB460D64046,"iPhone13,2"
com.apple.calculator,13,1736359364,1736359377,1736359377.437522,-21600,EB445137-D7F5-57EC-87DA-1DB460D64046,"iPhone13,2"
com.google.chrome.ios,8,1736359356,1736359364,1736359364.833818,-21600,EB445137-D7F5-57EC-87DA-1DB460D64046,"iPhone13,2"
com.apple.calculator,10,1736359346,1736359356,1736359356.980773,-21600,EB445137-D7F5-57EC-87DA-1DB460D64046,"iPhone13,2"
com.google.chrome.ios,134,1736359212,1736359346,1736359346.521737,-21600,EB445137-D7F5-57EC-87DA-1DB460D64046,"iPhone13,2"
com.letterboxd.LetterboxdApp,94,1736359118,1736359212,1736359212.811975,-21600,EB445137-D7F5-57EC-87DA-1DB460D64046,"iPhone13,2"
com.letterboxd.LetterboxdApp,123,1736358734,1736358857,1736358857.179885,-21600,EB445137-D7F5-57EC-87DA-1DB460D64046,"iPhone13,2"
com.google.chrome.ios,4,1736358730,1736358734,1736358734.406574,-21600,EB445137-D7F5-57EC-87DA-1DB460D64046,"iPhone13,2"
com.letterboxd.LetterboxdApp,49,1736358681,1736358730,1736358730.816159,-21600,EB445137-D7F5-57EC-87DA-1DB460D64046,"iPhone13,2"
com.apple.MobileSMS,12,1736356265,1736356277,1736356277.834179,-21600,EB445137-D7F5-57EC-87DA-1DB460D64046,"iPhone13,2"
com.apple.MobileSMS,10,1736355365,1736355375,1736355376.204077,-21600,EB445137-D7F5-57EC-87DA-1DB460D64046,"iPhone13,2"
com.google.chrome.ios,0,1736355365,1736355365,1736355366.0173712,-21600,EB445137-D7F5-57EC-87DA-1DB460D64046,"iPhone13,2"
com.google.chrome.ios,18,1736355228,1736355246,1736355246.6530209,-21600,EB445137-D7F5-57EC-87DA-1DB460D64046,"iPhone13,2"
Astrospheric.Astrospheric,47,1736354916,1736354963,1736354963.458416,-21600,EB445137-D7F5-57EC-87DA-1DB460D64046,"iPhone13,2"
com.apple.CoreAuthUI,2,1736354790,1736354792,1736354792.022406,-21600,EB445137-D7F5-57EC-87DA-1DB460D64046,"iPhone13,2"
com.truebill.truebillnative,110,1736354789,1736354899,1736354899.70246,-21600,EB445137-D7F5-57EC-87DA-1DB460D64046,"iPhone13,2"
com.apple.CoreAuthUI,10,1736354185,1736354195,1736354195.261935,-21600,EB445137-D7F5-57EC-87DA-1DB460D64046,"iPhone13,2"
com.truebill.truebillnative,198,1736354182,1736354380,1736354380.813363,-21600,EB445137-D7F5-57EC-87DA-1DB460D64046,"iPhone13,2"
com.apple.news,51,1736354123,1736354174,1736354174.60163,-21600,EB445137-D7F5-57EC-87DA-1DB460D64046,"iPhone13,2"
com.amazon.Amazon,107,1736353932,1736354039,1736354039.647684,-21600,EB445137-D7F5-57EC-87DA-1DB460D64046,"iPhone13,2"
com.amazon.Amazon,276,1736353121,1736353397,1736353397.720443,-21600,EB445137-D7F5-57EC-87DA-1DB460D64046,"iPhone13,2"
com.google.chrome.ios,25,1736353093,1736353118,1736353119.088331,-21600,EB445137-D7F5-57EC-87DA-1DB460D64046,"iPhone13,2"
com.apple.findmy,123,1736351601,1736351724,1736351724.656707,-21600,EB445137-D7F5-57EC-87DA-1DB460D64046,"iPhone13,2"
com.google.chrome.ios,98,1736351287,1736351385,1736351385.635375,-21600,EB445137-D7F5-57EC-87DA-1DB460D64046,"iPhone13,2"
com.apple.news,63,1736351171,1736351234,1736351234.1568341,-21600,EB445137-D7F5-57EC-87DA-1DB460D64046,"iPhone13,2"
com.letterboxd.LetterboxdApp,27,1736351016,1736351043,1736351043.719057,-21600,EB445137-D7F5-57EC-87DA-1DB460D64046,"iPhone13,2"
com.google.chrome.ios,26,1736350989,1736351015,1736351015.3181481,-21600,EB445137-D7F5-57EC-87DA-1DB460D64046,"iPhone13,2"
com.apple.Maps,263,1736350432,1736350695,1736350695.370091,-21600,EB445137-D7F5-57EC-87DA-1DB460D64046,"iPhone13,2"
com.facebook.Facebook,157,1736350188,1736350345,1736350345.600404,-21600,EB445137-D7F5-57EC-87DA-1DB460D64046,"iPhone13,2"
com.microsoft.Office.Outlook,39,1736350141,1736350180,1736350180.6662889,-21600,EB445137-D7F5-57EC-87DA-1DB460D64046,"iPhone13,2"
com.apple.Health,7,1736350087,1736350094,1736350097.09676,-21600,EB445137-D7F5-57EC-87DA-1DB460D64046,"iPhone13,2"
com.google.Chrome,46,1736350023,1736350069,1736350069.560464,-21600,,
com.apple.Health,18,1736348027,1736348045,1736348046.1931229,-21600,EB445137-D7F5-57EC-87DA-1DB460D64046,"iPhone13,2"
com.renpho.health,21,1736348005,1736348026,1736348026.6633348,-21600,EB445137-D7F5-57EC-87DA-1DB460D64046,"iPhone13,2"
com.thestorygraph.thestorygraph,25,1736314145,1736314170,1736314170.44889,-21600,EB445137-D7F5-57EC-87DA-1DB460D64046,"iPhone13,2"
com.apple.Health,18,1736314125,1736314143,1736314144.0835118,-21600,EB445137-D7F5-57EC-87DA-1DB460D64046,"iPhone13,2"
com.google.Chrome,424,1736311279,1736311703,1736311703.366129,-21600,,
com.apple.Music,25,1736311156,1736311181,1736311181.3342528,-21600,EB445137-D7F5-57EC-87DA-1DB460D64046,"iPhone13,2"
com.apple.Music,40,1736310148,1736310188,1736310189.122829,-21600,EB445137-D7F5-57EC-87DA-1DB460D64046,"iPhone13,2"
com.letterboxd.LetterboxdApp,23,1736309721,1736309744,1736309744.43321,-21600,EB445137-D7F5-57EC-87DA-1DB460D64046,"iPhone13,2"
com.google.chrome.ios,29,1736309692,1736309721,1736309721.378111,-21600,EB445137-D7F5-57EC-87DA-1DB460D64046,"iPhone13,2"
com.letterboxd.LetterboxdApp,222,1736309470,1736309692,1736309692.737702,-21600,EB445137-D7F5-57EC-87DA-1DB460D64046,"iPhone13,2"
com.google.chrome.ios,4,1736309466,1736309470,1736309470.417722,-21600,EB445137-D7F5-57EC-87DA-1DB460D64046,"iPhone13,2"
com.google.chrome.ios,18,1736306475,1736306493,1736306494.1445398,-21600,EB445137-D7F5-57EC-87DA-1DB460D64046,"iPhone13,2"
com.apple.findmy,2,1736306473,1736306475,1736306476.302837,-21600,EB445137-D7F5-57EC-87DA-1DB460D64046,"iPhone13,2"
com.apple.findmy,23,1736305951,1736305974,1736305975.0250669,-21600,EB445137-D7F5-57EC-87DA-1DB460D64046,"iPhone13,2"
com.apple.MobileSMS,2,1736305947,1736305949,1736305950.000091,-21600,EB445137-D7F5-57EC-87DA-1DB460D64046,"iPhone13,2"
com.apple.MobileSMS,6,1736304842,1736304848,1736304849.172028,-21600,EB445137-D7F5-57EC-87DA-1DB460D64046,"iPhone13,2"
com.apple.MobileSMS,24,1736304666,1736304690,1736304690.948814,-21600,EB445137-D7F5-57EC-87DA-1DB460D64046,"iPhone13,2"
com.letterboxd.LetterboxdApp,0,1736304666,1736304666,1736304667.565693,-21600,EB445137-D7F5-57EC-87DA-1DB460D64046,"iPhone13,2"
com.letterboxd.LetterboxdApp,19,1736302964,1736302983,1736302984.130837,-21600,EB445137-D7F5-57EC-87DA-1DB460D64046,"iPhone13,2"
com.letterboxd.LetterboxdApp,132,1736301637,1736301769,1736301770.3761082,-21600,EB445137-D7F5-57EC-87DA-1DB460D64046,"iPhone13,2"
com.toyopagroup.picaboo,20,1736301512,1736301532,1736301532.675061,-21600,EB445137-D7F5-57EC-87DA-1DB460D64046,"iPhone13,2"
com.burbn.instagram,10,1736301498,1736301508,1736301508.4268842,-21600,EB445137-D7F5-57EC-87DA-1DB460D64046,"iPhone13,2"
com.burbn.instagram,39,1736301458,1736301497,1736301497.361782,-21600,EB445137-D7F5-57EC-87DA-1DB460D64046,"iPhone13,2"
com.google.Chrome,926,1736299620,1736300546,1736300546.9082851,-21600,,
com.google.Chrome,528,1736299037,1736299565,1736299565.458177,-21600,,
com.google.Chrome,1065,1736297688,1736298753,1736298753.33817,-21600,,
com.leomehlig.today,22,1736297666,1736297688,1736297688.4737701,-21600,,
com.apple.iCal,19,1736297647,1736297666,1736297666.9580011,-21600,,
com.leomehlig.today,8,1736297639,1736297647,1736297648.066145,-21600,,
com.burbn.instagram,35,1736297291,1736297326,1736297326.325829,-21600,EB445137-D7F5-57EC-87DA-1DB460D64046,"iPhone13,2"
com.facebook.Facebook,43,1736297241,1736297284,1736297284.377236,-21600,EB445137-D7F5-57EC-87DA-1DB460D64046,"iPhone13,2"
com.apple.news,2,1736297211,1736297213,1736297213.9928389,-21600,EB445137-D7F5-57EC-87DA-1DB460D64046,"iPhone13,2"
com.apple.news,7,1736293888,1736293895,1736293895.875278,-21600,EB445137-D7F5-57EC-87DA-1DB460D64046,"iPhone13,2"
com.apple.Maps,9,1736293879,1736293888,1736293888.909751,-21600,EB445137-D7F5-57EC-87DA-1DB460D64046,"iPhone13,2"
com.apple.news,2,1736293877,1736293879,1736293879.996653,-21600,EB445137-D7F5-57EC-87DA-1DB460D64046,"iPhone13,2"
com.apple.news,324,1736293518,1736293842,1736293842.779423,-21600,EB445137-D7F5-57EC-87DA-1DB460D64046,"iPhone13,2"
com.apple.Maps,3,1736293515,1736293518,1736293518.924022,-21600,EB445137-D7F5-57EC-87DA-1DB460D64046,"iPhone13,2"
com.apple.news,825,1736292690,1736293515,1736293515.8869538,-21600,EB445137-D7F5-57EC-87DA-1DB460D64046,"iPhone13,2"
com.apple.Maps,15,1736292669,1736292684,1736292684.2687979,-21600,EB445137-D7F5-57EC-87DA-1DB460D64046,"iPhone13,2"
com.apple.Maps,2,1736292666,1736292668,1736292668.728626,-21600,EB445137-D7F5-57EC-87DA-1DB460D64046,"iPhone13,2"
com.apple.Maps,0,1736292663,1736292663,1736292664.411566,-21600,EB445137-D7F5-57EC-87DA-1DB460D64046,"iPhone13,2"
com.apple.Maps,27,1736291869,1736291896,1736291896.237668,-21600,EB445137-D7F5-57EC-87DA-1DB460D64046,"iPhone13,2"
com.supercell.magic,256,1736291579,1736291835,1736291835.597343,-21600,EB445137-D7F5-57EC-87DA-1DB460D64046,"iPhone13,2"
com.apple.MobileSMS,4,1736291574,1736291578,1736291578.229033,-21600,EB445137-D7F5-57EC-87DA-1DB460D64046,"iPhone13,2"
com.apple.MobileSMS,7,1736291428,1736291435,1736291435.161524,-21600,EB445137-D7F5-57EC-87DA-1DB460D64046,"iPhone13,2"
com.supercell.magic,0,1736291428,1736291428,1736291429.929366,-21600,EB445137-D7F5-57EC-87DA-1DB460D64046,"iPhone13,2"
com.apple.GameOverlayUI,7,1736291027,1736291034,1736291034.456893,-21600,EB445137-D7F5-57EC-87DA-1DB460D64046,"iPhone13,2"
com.apple.GameOverlayUI,4,1736291022,1736291026,1736291027.257335,-21600,EB445137-D7F5-57EC-87DA-1DB460D64046,"iPhone13,2"
com.supercell.magic,34,1736291006,1736291040,1736291040.9784598,-21600,EB445137-D7F5-57EC-87DA-1DB460D64046,"iPhone13,2"
com.apple.podcasts,5,1736290992,1736290997,1736290997.489606,-21600,EB445137-D7F5-57EC-87DA-1DB460D64046,"iPhone13,2"
com.apple.MobileSMS,16,1736290924,1736290940,1736290940.190331,-21600,EB445137-D7F5-57EC-87DA-1DB460D64046,"iPhone13,2"
com.apple.findmy,15,1736290909,1736290924,1736290924.410925,-21600,EB445137-D7F5-57EC-87DA-1DB460D64046,"iPhone13,2"
com.apple.MobileSMS,11,1736290898,1736290909,1736290909.1473088,-21600,EB445137-D7F5-57EC-87DA-1DB460D64046,"iPhone13,2"
com.google.chrome.ios,12,1736290886,1736290898,1736290898.519659,-21600,EB445137-D7F5-57EC-87DA-1DB460D64046,"iPhone13,2"
com.google.chrome.ios,18,1736290725,1736290743,1736290743.482363,-21600,EB445137-D7F5-57EC-87DA-1DB460D64046,"iPhone13,2"
com.google.chrome.ios,59,1736290623,1736290682,1736290683.049447,-21600,EB445137-D7F5-57EC-87DA-1DB460D64046,"iPhone13,2"
com.apple.Maps,1,1736290621,1736290622,1736290623.2096581,-21600,EB445137-D7F5-57EC-87DA-1DB460D64046,"iPhone13,2"
com.apple.Maps,71,1736289442,1736289513,1736289513.9112449,-21600,EB445137-D7F5-57EC-87DA-1DB460D64046,"iPhone13,2"
com.google.chrome.ios,2,1736289440,1736289442,1736289443.54325,-21600,EB445137-D7F5-57EC-87DA-1DB460D64046,"iPhone13,2"
com.google.chrome.ios,63,1736289286,1736289349,1736289350.183804,-21600,EB445137-D7F5-57EC-87DA-1DB460D64046,"iPhone13,2"
com.apple.Maps,1,1736289285,1736289286,1736289286.948484,-21600,EB445137-D7F5-57EC-87DA-1DB460D64046,"iPhone13,2"
com.apple.Maps,6,1736288683,1736288689,1736288689.6154618,-21600,EB445137-D7F5-57EC-87DA-1DB460D64046,"iPhone13,2"
com.apple.Maps,1,1736288682,1736288683,1736288683.574683,-21600,EB445137-D7F5-57EC-87DA-1DB460D64046,"iPhone13,2"
com.apple.Maps,24,1736288627,1736288651,1736288651.3772712,-21600,EB445137-D7F5-57EC-87DA-1DB460D64046,"iPhone13,2"
com.apple.Maps,13,1736288466,1736288479,1736288479.697132,-21600,EB445137-D7F5-57EC-87DA-1DB460D64046,"iPhone13,2"
com.apple.Maps,8,1736288316,1736288324,1736288324.721,-21600,EB445137-D7F5-57EC-87DA-1DB460D64046,"iPhone13,2"
com.apple.Maps,7,1736288181,1736288188,1736288188.8316898,-21600,EB445137-D7F5-57EC-87DA-1DB460D64046,"iPhone13,2"
com.apple.Maps,25,1736287697,1736287722,1736287722.488183,-21600,EB445137-D7F5-57EC-87DA-1DB460D64046,"iPhone13,2"
com.apple.Maps,15,1736287676,1736287691,1736287691.634383,-21600,EB445137-D7F5-57EC-87DA-1DB460D64046,"iPhone13,2"
com.apple.Maps,22,1736286471,1736286493,1736286493.747031,-21600,EB445137-D7F5-57EC-87DA-1DB460D64046,"iPhone13,2"
com.apple.PosterBoard,0,1736286154,1736286154,1736286155.19082,-21600,EB445137-D7F5-57EC-87DA-1DB460D64046,"iPhone13,2"
com.apple.Maps,12,1736286153,1736286165,1736286166.390039,-21600,EB445137-D7F5-57EC-87DA-1DB460D64046,"iPhone13,2"
com.apple.Maps,18,1736286113,1736286131,1736286132.031608,-21600,EB445137-D7F5-57EC-87DA-1DB460D64046,"iPhone13,2"
com.google.chrome.ios,8,1736286105,1736286113,1736286113.631089,-21600,EB445137-D7F5-57EC-87DA-1DB460D64046,"iPhone13,2"
com.google.chrome.ios,28,1736285616,1736285644,1736285645.442435,-21600,EB445137-D7F5-57EC-87DA-1DB460D64046,"iPhone13,2"
com.toyopagroup.picaboo,3,1736285613,1736285616,1736285616.3378692,-21600,EB445137-D7F5-57EC-87DA-1DB460D64046,"iPhone13,2"
com.toyopagroup.picaboo,10,1736285022,1736285032,1736285033.215601,-21600,EB445137-D7F5-57EC-87DA-1DB460D64046,"iPhone13,2"
com.apple.mobileslideshow,7,1736285000,1736285007,1736285007.7516851,-21600,EB445137-D7F5-57EC-87DA-1DB460D64046,"iPhone13,2"
com.toyopagroup.picaboo,27,1736284968,1736284995,1736284995.915916,-21600,EB445137-D7F5-57EC-87DA-1DB460D64046,"iPhone13,2"
com.apple.news,2,1736284964,1736284966,1736284966.163275,-21600,EB445137-D7F5-57EC-87DA-1DB460D64046,"iPhone13,2"
com.apple.news,1,1736283961,1736283962,1736283963.561514,-21600,EB445137-D7F5-57EC-87DA-1DB460D64046,"iPhone13,2"
com.microsoft.Office.Outlook,7,1736283941,1736283948,1736283948.442352,-21600,EB445137-D7F5-57EC-87DA-1DB460D64046,"iPhone13,2"
com.apple.MobileSMS,4,1736283014,1736283018,1736283018.905946,-21600,EB445137-D7F5-57EC-87DA-1DB460D64046,"iPhone13,2"
com.apple.MobileSMS,5,1736279428,1736279433,1736279433.7590442,-21600,EB445137-D7F5-57EC-87DA-1DB460D64046,"iPhone13,2"
com.apple.Maps,2,1736279426,1736279428,1736279428.2324991,-21600,EB445137-D7F5-57EC-87DA-1DB460D64046,"iPhone13,2"
com.apple.Maps,17,1736279405,1736279422,1736279423.0504742,-21600,EB445137-D7F5-57EC-87DA-1DB460D64046,"iPhone13,2"
com.apple.MobileSMS,3,1736279401,1736279404,1736279404.613303,-21600,EB445137-D7F5-57EC-87DA-1DB460D64046,"iPhone13,2"
com.apple.MobileSMS,4,1736279207,1736279211,1736279212.089639,-21600,EB445137-D7F5-57EC-87DA-1DB460D64046,"iPhone13,2"
com.apple.findmy,18,1736279189,1736279207,1736279207.780453,-21600,EB445137-D7F5-57EC-87DA-1DB460D64046,"iPhone13,2"
com.apple.MobileSMS,8,1736279181,1736279189,1736279189.883477,-21600,EB445137-D7F5-57EC-87DA-1DB460D64046,"iPhone13,2"
com.apple.MobileSMS,6,1736278893,1736278899,1736278900.115965,-21600,EB445137-D7F5-57EC-87DA-1DB460D64046,"iPhone13,2"
com.apple.findmy,5,1736278888,1736278893,1736278893.71883,-21600,EB445137-D7F5-57EC-87DA-1DB460D64046,"iPhone13,2"
com.apple.MobileAddressBook,18,1736278851,1736278869,1736278869.909628,-21600,EB445137-D7F5-57EC-87DA-1DB460D64046,"iPhone13,2"
com.apple.mobilephone,2,1736278847,1736278849,1736278849.053611,-21600,EB445137-D7F5-57EC-87DA-1DB460D64046,"iPhone13,2"
com.apple.findmy,2,1736278845,1736278847,1736278847.3713799,-21600,EB445137-D7F5-57EC-87DA-1DB460D64046,"iPhone13,2"
com.apple.findmy,9,1736278774,1736278783,1736278783.7672272,-21600,EB445137-D7F5-57EC-87DA-1DB460D64046,"iPhone13,2"
com.burbn.instagram,54,1736278713,1736278767,1736278767.471867,-21600,EB445137-D7F5-57EC-87DA-1DB460D64046,"iPhone13,2"
com.apple.findmy,2,1736278709,1736278711,1736278712.013534,-21600,EB445137-D7F5-57EC-87DA-1DB460D64046,"iPhone13,2"
com.apple.findmy,6,1736278662,1736278668,1736278668.246506,-21600,EB445137-D7F5-57EC-87DA-1DB460D64046,"iPhone13,2"
com.apple.MobileSMS,5,1736278657,1736278662,1736278663.385684,-21600,EB445137-D7F5-57EC-87DA-1DB460D64046,"iPhone13,2"
com.apple.MobileSMS,9,1736278194,1736278203,1736278203.221367,-21600,EB445137-D7F5-57EC-87DA-1DB460D64046,"iPhone13,2"
com.apple.findmy,10,1736278184,1736278194,1736278194.3708649,-21600,EB445137-D7F5-57EC-87DA-1DB460D64046,"iPhone13,2"
com.apple.MobileSMS,12,1736278172,1736278184,1736278185.0596452,-21600,EB445137-D7F5-57EC-87DA-1DB460D64046,"iPhone13,2"
com.apple.MobileSMS,4,1736277910,1736277914,1736277914.1627932,-21600,EB445137-D7F5-57EC-87DA-1DB460D64046,"iPhone13,2"
com.apple.findmy,7,1736277903,1736277910,1736277910.70122,-21600,EB445137-D7F5-57EC-87DA-1DB460D64046,"iPhone13,2"
com.apple.findmy,3,1736277849,1736277852,1736277852.866715,-21600,EB445137-D7F5-57EC-87DA-1DB460D64046,"iPhone13,2"
com.apple.MobileSMS,9,1736277840,1736277849,1736277849.9093041,-21600,EB445137-D7F5-57EC-87DA-1DB460D64046,"iPhone13,2"
com.apple.findmy,1,1736277839,1736277840,1736277840.932987,-21600,EB445137-D7F5-57EC-87DA-1DB460D64046,"iPhone13,2"
com.apple.findmy,40,1736277797,1736277837,1736277837.635164,-21600,EB445137-D7F5-57EC-87DA-1DB460D64046,"iPhone13,2"
com.apple.MobileSMS,15,1736277782,1736277797,1736277797.824106,-21600,EB445137-D7F5-57EC-87DA-1DB460D64046,"iPhone13,2"
com.apple.MobileSMS,6,1736277300,1736277306,1736277306.700006,-21600,EB445137-D7F5-57EC-87DA-1DB460D64046,"iPhone13,2"
com.apple.MobileSMS,22,1736277275,1736277297,1736277298.837915,-21600,EB445137-D7F5-57EC-87DA-1DB460D64046,"iPhone13,2"
com.google.chrome.ios,2,1736277273,1736277275,1736277275.44011,-21600,EB445137-D7F5-57EC-87DA-1DB460D64046,"iPhone13,2"
com.apple.InCallService,0,1736277273,1736277273,1736277273.804634,-21600,EB445137-D7F5-57EC-87DA-1DB460D64046,"iPhone13,2"
com.apple.InCallService,1,1736277245,1736277246,1736277246.8179622,-21600,EB445137-D7F5-57EC-87DA-1DB460D64046,"iPhone13,2"
com.google.chrome.ios,2,1736277243,1736277245,1736277245.749326,-21600,EB445137-D7F5-57EC-87DA-1DB460D64046,"iPhone13,2"
com.google.chrome.ios,14,1736276617,1736276631,1736276632.116943,-21600,EB445137-D7F5-57EC-87DA-1DB460D64046,"iPhone13,2"
com.google.chrome.ios,28,1736276566,1736276594,1736276595.365182,-21600,EB445137-D7F5-57EC-87DA-1DB460D64046,"iPhone13,2"
com.apple.MobileSMS,4,1736276501,1736276505,1736276505.2280211,-21600,EB445137-D7F5-57EC-87DA-1DB460D64046,"iPhone13,2"
com.apple.MobileSMS,15,1736275858,1736275873,1736275874.005378,-21600,EB445137-D7F5-57EC-87DA-1DB460D64046,"iPhone13,2"
com.apple.Maps,4,1736275854,1736275858,1736275858.499749,-21600,EB445137-D7F5-57EC-87DA-1DB460D64046,"iPhone13,2"
com.apple.Maps,22,1736275299,1736275321,1736275321.936081,-21600,EB445137-D7F5-57EC-87DA-1DB460D64046,"iPhone13,2"
com.apple.Maps,27,1736274115,1736274142,1736274142.262742,-21600,EB445137-D7F5-57EC-87DA-1DB460D64046,"iPhone13,2"
com.apple.Maps,12,1736274048,1736274060,1736274060.6683888,-21600,EB445137-D7F5-57EC-87DA-1DB460D64046,"iPhone13,2"
com.apple.Maps,12,1736272379,1736272391,1736272391.4218102,-21600,EB445137-D7F5-57EC-87DA-1DB460D64046,"iPhone13,2"
com.apple.MobileSMS,2,1736272377,1736272379,1736272379.1784291,-21600,EB445137-D7F5-57EC-87DA-1DB460D64046,"iPhone13,2"
com.apple.MobileSMS,5,1736271088,1736271093,1736271093.682549,-21600,EB445137-D7F5-57EC-87DA-1DB460D64046,"iPhone13,2"
com.apple.MobileSMS,37,1736270831,1736270868,1736270869.192697,-21600,EB445137-D7F5-57EC-87DA-1DB460D64046,"iPhone13,2"
com.apple.MobileSMS,21,1736270638,1736270659,1736270659.581386,-21600,EB445137-D7F5-57EC-87DA-1DB460D64046,"iPhone13,2"
com.apple.MobileSMS,2,1736268954,1736268956,1736268956.854113,-21600,EB445137-D7F5-57EC-87DA-1DB460D64046,"iPhone13,2"
com.apple.MobileSMS,2,1736268951,1736268953,1736268954.075111,-21600,EB445137-D7F5-57EC-87DA-1DB460D64046,"iPhone13,2"
com.apple.findmy,0,1736268951,1736268951,1736268952.526274,-21600,EB445137-D7F5-57EC-87DA-1DB460D64046,"iPhone13,2"
com.apple.findmy,10,1736267311,1736267321,1736267322.206707,-21600,EB445137-D7F5-57EC-87DA-1DB460D64046,"iPhone13,2"
com.google.chrome.ios,105,1736267205,1736267310,1736267310.85188,-21600,EB445137-D7F5-57EC-87DA-1DB460D64046,"iPhone13,2"
com.apple.findmy,8,1736267197,1736267205,1736267205.60359,-21600,EB445137-D7F5-57EC-87DA-1DB460D64046,"iPhone13,2"
com.apple.findmy,61,1736267132,1736267193,1736267193.305769,-21600,EB445137-D7F5-57EC-87DA-1DB460D64046,"iPhone13,2"
com.apple.MobileSMS,4,1736267079,1736267083,1736267083.529364,-21600,EB445137-D7F5-57EC-87DA-1DB460D64046,"iPhone13,2"
com.apple.MobileSMS,4,1736267075,1736267079,1736267079.037527,-21600,EB445137-D7F5-57EC-87DA-1DB460D64046,"iPhone13,2"
com.apple.findmy,6,1736267069,1736267075,1736267075.415907,-21600,EB445137-D7F5-57EC-87DA-1DB460D64046,"iPhone13,2"
com.apple.MobileSMS,4,1736267062,1736267066,1736267066.2692409,-21600,EB445137-D7F5-57EC-87DA-1DB460D64046,"iPhone13,2"
com.apple.mobilephone,5,1736267057,1736267062,1736267062.2127972,-21600,EB445137-D7F5-57EC-87DA-1DB460D64046,"iPhone13,2"
com.apple.MobileSMS,18,1736267038,1736267056,1736267057.022927,-21600,EB445137-D7F5-57EC-87DA-1DB460D64046,"iPhone13,2"
com.apple.findmy,0,1736267038,1736267038,1736267039.6503181,-21600,EB445137-D7F5-57EC-87DA-1DB460D64046,"iPhone13,2"
com.apple.findmy,6,1736266921,1736266927,1736266927.604985,-21600,EB445137-D7F5-57EC-87DA-1DB460D64046,"iPhone13,2"
com.letterboxd.LetterboxdApp,87,1736266834,1736266921,1736266921.6304479,-21600,EB445137-D7F5-57EC-87DA-1DB460D64046,"iPhone13,2"
com.apple.MobileSMS,2,1736266832,1736266834,1736266834.222845,-21600,EB445137-D7F5-57EC-87DA-1DB460D64046,"iPhone13,2"
com.letterboxd.LetterboxdApp,78,1736266754,1736266832,1736266832.58163,-21600,EB445137-D7F5-57EC-87DA-1DB460D64046,"iPhone13,2"
com.google.Gmail,17,1736266736,1736266753,1736266753.2667642,-21600,EB445137-D7F5-57EC-87DA-1DB460D64046,"iPhone13,2"
com.google.Gmail,19,1736266716,1736266735,1736266735.557203,-21600,EB445137-D7F5-57EC-87DA-1DB460D64046,"iPhone13,2"
com.google.chrome.ios,9,1736266707,1736266716,1736266716.70745,-21600,EB445137-D7F5-57EC-87DA-1DB460D64046,"iPhone13,2"
com.google.Gmail,21,1736266686,1736266707,1736266707.636664,-21600,EB445137-D7F5-57EC-87DA-1DB460D64046,"iPhone13,2"
com.letterboxd.LetterboxdApp,26,1736266659,1736266685,1736266685.544004,-21600,EB445137-D7F5-57EC-87DA-1DB460D64046,"iPhone13,2"
com.apple.findmy,11,1736266617,1736266628,1736266629.323833,-21600,EB445137-D7F5-57EC-87DA-1DB460D64046,"iPhone13,2"
com.apple.MobileSMS,34,1736266388,1736266422,1736266422.7043629,-21600,EB445137-D7F5-57EC-87DA-1DB460D64046,"iPhone13,2"
com.apple.findmy,6,1736266382,1736266388,1736266388.588705,-21600,EB445137-D7F5-57EC-87DA-1DB460D64046,"iPhone13,2"
com.leomehlig.today,21,1736266235,1736266256,1736266256.173423,-21600,,
com.apple.findmy,65,1736266225,1736266290,1736266291.205519,-21600,EB445137-D7F5-57EC-87DA-1DB460D64046,"iPhone13,2"
com.apple.MobileSMS,2,1736266223,1736266225,1736266227.256778,-21600,EB445137-D7F5-57EC-87DA-1DB460D64046,"iPhone13,2"
com.apple.iCal,92,1736266143,1736266235,1736266235.690682,-21600,,
com.leomehlig.today,19,1736266124,1736266143,1736266143.125204,-21600,,
com.apple.MobileSMS,58,1736266066,1736266124,1736266124.430897,-21600,,
com.apple.finder,36,1736266030,1736266066,1736266066.042197,-21600,,
com.google.Chrome,8,1736266022,1736266030,1736266030.5501919,-21600,,
com.apple.MobileSMS,36,1736265984,1736266020,1736266020.2959518,-21600,EB445137-D7F5-57EC-87DA-1DB460D64046,"iPhone13,2"
com.apple.MobileSMS,44,1736265978,1736266022,1736266022.565579,-21600,,
com.google.Chrome,136,1736265842,1736265978,1736265978.895313,-21600,,
com.apple.MobileSMS,23,1736265812,1736265835,1736265836.2993422,-21600,EB445137-D7F5-57EC-87DA-1DB460D64046,"iPhone13,2"
com.microsoft.Office.Outlook,51,1736265754,1736265805,1736265805.47158,-21600,EB445137-D7F5-57EC-87DA-1DB460D64046,"iPhone13,2"
com.apple.iCal,89,1736265753,1736265842,1736265842.837511,-21600,,
com.renpho.health,2,1736265357,1736265359,1736265359.635189,-21600,EB445137-D7F5-57EC-87DA-1DB460D64046,"iPhone13,2"
com.renpho.health,21,1736264620,1736264641,1736264641.262281,-21600,EB445137-D7F5-57EC-87DA-1DB460D64046,"iPhone13,2"
com.apple.MobileSMS,2,1736264618,1736264620,1736264620.2176728,-21600,EB445137-D7F5-57EC-87DA-1DB460D64046,"iPhone13,2"
com.apple.MobileSMS,6,1736264604,1736264610,1736264611.064085,-21600,EB445137-D7F5-57EC-87DA-1DB460D64046,"iPhone13,2"
com.apple.MobileSMS,32,1736264565,1736264597,1736264597.183241,-21600,EB445137-D7F5-57EC-87DA-1DB460D64046,"iPhone13,2"
com.apple.Health,53,1736262729,1736262782,1736262782.395516,-21600,EB445137-D7F5-57EC-87DA-1DB460D64046,"iPhone13,2"
com.google.ios.youtube,531,1736262195,1736262726,1736262726.5211291,-21600,EB445137-D7F5-57EC-87DA-1DB460D64046,"iPhone13,2"
com.google.ios.youtube,664,1736261173,1736261837,1736261837.5881848,-21600,EB445137-D7F5-57EC-87DA-1DB460D64046,"iPhone13,2"
com.apple.findmy,5,1736261121,1736261126,1736261127.053267,-21600,EB445137-D7F5-57EC-87DA-1DB460D64046,"iPhone13,2"
com.apple.mobiletimer,2,1736261118,1736261120,1736261120.6795511,-21600,EB445137-D7F5-57EC-87DA-1DB460D64046,"iPhone13,2"
com.apple.mobiletimer,16,1736228505,1736228521,1736228521.612756,-21600,EB445137-D7F5-57EC-87DA-1DB460D64046,"iPhone13,2"
com.apple.Music,2,1736228498,1736228500,1736228500.945869,-21600,EB445137-D7F5-57EC-87DA-1DB460D64046,"iPhone13,2"
com.apple.Music,96,1736227398,1736227494,1736227494.57682,-21600,EB445137-D7F5-57EC-87DA-1DB460D64046,"iPhone13,2"
com.goodreads.Goodreads,18,1736226881,1736226899,1736226899.9235802,-21600,EB445137-D7F5-57EC-87DA-1DB460D64046,"iPhone13,2"
com.thestorygraph.thestorygraph,207,1736226674,1736226881,1736226881.190961,-21600,EB445137-D7F5-57EC-87DA-1DB460D64046,"iPhone13,2"
com.apple.Health,21,1736226652,1736226673,1736226673.525377,-21600,EB445137-D7F5-57EC-87DA-1DB460D64046,"iPhone13,2"
com.apple.iCal,3,1736226635,1736226638,1736226638.401164,-21600,,
com.google.Chrome,283,1736226352,1736226635,1736226635.058052,-21600,,
com.apple.MobileSMS,4,1736226348,1736226352,1736226352.7914171,-21600,,
com.google.Chrome,303,1736226045,1736226348,1736226348.1843371,-21600,,
com.apple.iCal,20,1736226025,1736226045,1736226045.631077,-21600,,
com.google.Chrome,53,1736225972,1736226025,1736226025.22334,-21600,,
com.google.Chrome,335,1736225601,1736225936,1736225936.5937881,-21600,,
com.apple.news,159,1736211106,1736211265,1736211265.783874,-21600,EB445137-D7F5-57EC-87DA-1DB460D64046,"iPhone13,2"
com.apple.findmy,11,1736211022,1736211033,1736211034.1246948,-21600,EB445137-D7F5-57EC-87DA-1DB460D64046,"iPhone13,2"
com.hammerandchisel.discord,5,1736211013,1736211018,1736211018.4770942,-21600,EB445137-D7F5-57EC-87DA-1DB460D64046,"iPhone13,2"
com.apple.MobileSMS,0,1736211013,1736211013,1736211013.7298288,-21600,EB445137-D7F5-57EC-87DA-1DB460D64046,"iPhone13,2"
com.apple.MobileSMS,28,1736210110,1736210138,1736210138.2627249,-21600,EB445137-D7F5-57EC-87DA-1DB460D64046,"iPhone13,2"
com.apple.MobileSMS,8,1736209946,1736209954,1736209954.440583,-21600,EB445137-D7F5-57EC-87DA-1DB460D64046,"iPhone13,2"
com.apple.MobileSMS,18,1736209926,1736209944,1736209945.0371919,-21600,EB445137-D7F5-57EC-87DA-1DB460D64046,"iPhone13,2"
com.apple.MobileSMS,19,1736209799,1736209818,1736209818.674325,-21600,EB445137-D7F5-57EC-87DA-1DB460D64046,"iPhone13,2"
com.apple.MobileSMS,135,1736209561,1736209696,1736209696.87913,-21600,EB445137-D7F5-57EC-87DA-1DB460D64046,"iPhone13,2"
com.apple.weather,3,1736209558,1736209561,1736209561.456341,-21600,EB445137-D7F5-57EC-87DA-1DB460D64046,"iPhone13,2"
com.apple.weather,13,1736208072,1736208085,1736208085.568945,-21600,EB445137-D7F5-57EC-87DA-1DB460D64046,"iPhone13,2"
com.apple.MobileSMS,3,1736207648,1736207651,1736207651.6190162,-21600,EB445137-D7F5-57EC-87DA-1DB460D64046,"iPhone13,2"
com.apple.MobileSMS,6,1736207620,1736207626,1736207626.7197762,-21600,EB445137-D7F5-57EC-87DA-1DB460D64046,"iPhone13,2"
com.google.chrome.ios,126,1736207494,1736207620,1736207620.4940991,-21600,EB445137-D7F5-57EC-87DA-1DB460D64046,"iPhone13,2"
com.apple.findmy,13,1736207364,1736207377,1736207377.5683799,-21600,EB445137-D7F5-57EC-87DA-1DB460D64046,"iPhone13,2"
com.google.chrome.ios,123,1736207220,1736207343,1736207343.508426,-21600,EB445137-D7F5-57EC-87DA-1DB460D64046,"iPhone13,2"
com.hammerandchisel.discord,41,1736205792,1736205833,1736205833.486422,-21600,EB445137-D7F5-57EC-87DA-1DB460D64046,"iPhone13,2"
com.hammerandchisel.discord,37,1736205650,1736205687,1736205688.008905,-21600,EB445137-D7F5-57EC-87DA-1DB460D64046,"iPhone13,2"
com.google.ios.youtube,90,1736205559,1736205649,1736205649.557846,-21600,EB445137-D7F5-57EC-87DA-1DB460D64046,"iPhone13,2"
com.amazon.Amazon,2,1736205551,1736205553,1736205553.687769,-21600,EB445137-D7F5-57EC-87DA-1DB460D64046,"iPhone13,2"
com.amazon.Amazon,5,1736205101,1736205106,1736205106.400346,-21600,EB445137-D7F5-57EC-87DA-1DB460D64046,"iPhone13,2"
com.amazon.Amazon,15,1736204931,1736204946,1736204946.4208941,-21600,EB445137-D7F5-57EC-87DA-1DB460D64046,"iPhone13,2"
com.apple.findmy,14,1736204917,1736204931,1736204931.706905,-21600,EB445137-D7F5-57EC-87DA-1DB460D64046,"iPhone13,2"
com.amazon.Amazon,23,1736204816,1736204839,1736204840.161625,-21600,EB445137-D7F5-57EC-87DA-1DB460D64046,"iPhone13,2"
com.strava.stravaride,2,1736204814,1736204816,1736204816.769257,-21600,EB445137-D7F5-57EC-87DA-1DB460D64046,"iPhone13,2"
com.apple.findmy,27,1736204245,1736204272,1736204273.38693,-21600,EB445137-D7F5-57EC-87DA-1DB460D64046,"iPhone13,2"
com.google.Chrome,549,1736204224,1736204773,1736204773.207423,-21600,,
com.microsoft.Office.Outlook,5,1736204175,1736204180,1736204181.065412,-21600,EB445137-D7F5-57EC-87DA-1DB460D64046,"iPhone13,2"
com.apple.Health,126,1736204039,1736204165,1736204165.645647,-21600,EB445137-D7F5-57EC-87DA-1DB460D64046,"iPhone13,2"
com.apple.weather,6,1736204021,1736204027,1736204027.859551,-21600,EB445137-D7F5-57EC-87DA-1DB460D64046,"iPhone13,2"
Astrospheric.Astrospheric,15,1736204006,1736204021,1736204021.889326,-21600,EB445137-D7F5-57EC-87DA-1DB460D64046,"iPhone13,2"
com.google.Chrome,301,1736203787,1736204088,1736204088.7432709,-21600,,
com.microsoft.Office.Outlook,7,1736203341,1736203348,1736203348.179918,-21600,EB445137-D7F5-57EC-87DA-1DB460D64046,"iPhone13,2"
com.apple.CoreAuthUI,2,1736203214,1736203216,1736203216.773407,-21600,EB445137-D7F5-57EC-87DA-1DB460D64046,"iPhone13,2"
com.truebill.truebillnative,84,1736203211,1736203295,1736203295.071167,-21600,EB445137-D7F5-57EC-87DA-1DB460D64046,"iPhone13,2"
com.amazon.Amazon,5,1736203141,1736203146,1736203146.469651,-21600,EB445137-D7F5-57EC-87DA-1DB460D64046,"iPhone13,2"
com.amazon.Amazon,0,1736203141,1736203141,1736203142.972877,-21600,EB445137-D7F5-57EC-87DA-1DB460D64046,"iPhone13,2"
com.google.Chrome,357,1736202983,1736203340,1736203340.377573,-21600,,
com.amazon.Amazon,10,1736202953,1736202963,1736202963.8778071,-21600,EB445137-D7F5-57EC-87DA-1DB460D64046,"iPhone13,2"
com.amazon.Amazon,10,1736202939,1736202949,1736202949.746391,-21600,EB445137-D7F5-57EC-87DA-1DB460D64046,"iPhone13,2"
com.apple.findmy,2,1736202937,1736202939,1736202941.7467508,-21600,EB445137-D7F5-57EC-87DA-1DB460D64046,"iPhone13,2"
com.apple.findmy,11,1736202758,1736202769,1736202769.801132,-21600,EB445137-D7F5-57EC-87DA-1DB460D64046,"iPhone13,2"
com.letterboxd.LetterboxdApp,5,1736202753,1736202758,1736202758.00418,-21600,EB445137-D7F5-57EC-87DA-1DB460D64046,"iPhone13,2"
com.letterboxd.LetterboxdApp,32,1736202307,1736202339,1736202340.064838,-21600,EB445137-D7F5-57EC-87DA-1DB460D64046,"iPhone13,2"
com.amazon.Amazon,2,1736202302,1736202304,1736202304.427781,-21600,EB445137-D7F5-57EC-87DA-1DB460D64046,"iPhone13,2"
com.amazon.Amazon,13,1736201009,1736201022,1736201022.878149,-21600,EB445137-D7F5-57EC-87DA-1DB460D64046,"iPhone13,2"
com.hammerandchisel.discord,19,1736200830,1736200849,1736200849.9155889,-21600,EB445137-D7F5-57EC-87DA-1DB460D64046,"iPhone13,2"
com.apple.findmy,17,1736200625,1736200642,1736200642.738385,-21600,EB445137-D7F5-57EC-87DA-1DB460D64046,"iPhone13,2"
com.google.Chrome,1900,1736198916,1736200816,1736200816.314584,-21600,,
com.apple.findmy,9,1736198578,1736198587,1736198587.7172508,-21600,EB445137-D7F5-57EC-87DA-1DB460D64046,"iPhone13,2"
com.google.Chrome,480,1736198389,1736198869,1736198869.5436602,-21600,,
com.google.Chrome,318,1736197791,1736198109,1736198109.1683888,-21600,,
com.apple.findmy,7,1736197459,1736197466,1736197467.225549,-21600,EB445137-D7F5-57EC-87DA-1DB460D64046,"iPhone13,2"
com.google.Chrome,300,1736197445,1736197745,1736197745.95992,-21600,,
com.google.Chrome,300,1736197136,1736197436,1736197436.72295,-21600,,
com.google.Chrome,890,1736195892,1736196782,1736196782.709024,-21600,,
com.google.Chrome,540,1736194957,1736195497,1736195497.9276729,-21600,,
com.apple.finder,1,1736194956,1736194957,1736194959.045576,-21600,,
com.apple.news,2,1736194809,1736194811,1736194811.542121,-21600,EB445137-D7F5-57EC-87DA-1DB460D64046,"iPhone13,2"
com.google.ios.youtube,6,1736194802,1736194808,1736194808.294889,-21600,EB445137-D7F5-57EC-87DA-1DB460D64046,"iPhone13,2"
com.apple.news,32,1736194767,1736194799,1736194799.1707602,-21600,EB445137-D7F5-57EC-87DA-1DB460D64046,"iPhone13,2"
com.google.ios.youtube,3,1736194757,1736194760,1736194760.4931831,-21600,EB445137-D7F5-57EC-87DA-1DB460D64046,"iPhone13,2"
com.google.ios.youtube,527,1736194199,1736194726,1736194726.9794059,-21600,EB445137-D7F5-57EC-87DA-1DB460D64046,"iPhone13,2"
com.google.chrome.ios,15,1736194183,1736194198,1736194198.316629,-21600,EB445137-D7F5-57EC-87DA-1DB460D64046,"iPhone13,2"
com.google.chrome.ios,26,1736192614,1736192640,1736192640.38871,-21600,EB445137-D7F5-57EC-87DA-1DB460D64046,"iPhone13,2"
com.apple.finder,301,1736192471,1736192772,1736192772.5166059,-21600,,
com.apple.Passwords,1,1736192470,1736192471,1736192471.1971688,-21600,,
com.microsoft.VSCode,1,1736192469,1736192470,1736192470.8764749,-21600,,
com.apple.MobileSMS,0,1736192469,1736192469,1736192469.716413,-21600,,
com.microsoft.VSCode,7,1736192462,1736192469,1736192469.443152,-21600,,
com.google.Chrome,209,1736192253,1736192462,1736192462.320559,-21600,,
com.apple.mail,3,1736192250,1736192253,1736192253.3040729,-21600,,
com.google.Chrome,546,1736191704,1736192250,1736192250.9475899,-21600,,
com.microsoft.VSCode,28,1736191676,1736191704,1736191704.863226,-21600,,
com.google.Chrome,16,1736191660,1736191676,1736191676.376373,-21600,,
com.microsoft.VSCode,9,1736191651,1736191660,1736191660.7332401,-21600,,
com.google.Chrome,7,1736191644,1736191651,1736191651.470613,-21600,,
com.microsoft.VSCode,32,1736191612,1736191644,1736191644.751153,-21600,,
com.google.Chrome,24,1736191588,1736191612,1736191612.96352,-21600,,
com.microsoft.VSCode,15,1736191573,1736191588,1736191588.608458,-21600,,
com.google.Chrome,160,1736191413,1736191573,1736191573.16296,-21600,,
com.toyopagroup.picaboo,13,1736191180,1736191193,1736191193.792819,-21600,EB445137-D7F5-57EC-87DA-1DB460D64046,"iPhone13,2"
com.toyopagroup.picaboo,2,1736191178,1736191180,1736191180.270469,-21600,EB445137-D7F5-57EC-87DA-1DB460D64046,"iPhone13,2"
com.toyopagroup.picaboo,6,1736191155,1736191161,1736191162.124605,-21600,EB445137-D7F5-57EC-87DA-1DB460D64046,"iPhone13,2"
com.apple.MobileSMS,1,1736191154,1736191155,1736191156.013042,-21600,EB445137-D7F5-57EC-87DA-1DB460D64046,"iPhone13,2"
com.microsoft.VSCode,471,1736190942,1736191413,1736191413.7361279,-21600,,
com.google.Chrome,215,1736190727,1736190942,1736190942.664294,-21600,,
com.microsoft.VSCode,53,1736190674,1736190727,1736190727.116816,-21600,,
com.google.Chrome,1423,1736189251,1736190674,1736190674.262661,-21600,,
com.apple.MobileSMS,4,1736189247,1736189251,1736189251.1735559,-21600,,
com.google.Chrome,365,1736188882,1736189247,1736189247.5367808,-21600,,
com.microsoft.VSCode,257,1736188625,1736188882,1736188882.915967,-21600,,
com.google.Chrome,28,1736188597,1736188625,1736188625.5282521,-21600,,
com.microsoft.VSCode,106,1736188491,1736188597,1736188597.756516,-21600,,
com.apple.MobileSMS,5,1736188481,1736188486,1736188487.068157,-21600,EB445137-D7F5-57EC-87DA-1DB460D64046,"iPhone13,2"
com.apple.news,2,1736187368,1736187370,1736187370.793463,-21600,EB445137-D7F5-57EC-87DA-1DB460D64046,"iPhone13,2"
com.google.chrome.ios,7,1736185643,1736185650,1736185650.581141,-21600,EB445137-D7F5-57EC-87DA-1DB460D64046,"iPhone13,2"
com.google.Gmail,6,1736185637,1736185643,1736185643.449191,-21600,EB445137-D7F5-57EC-87DA-1DB460D64046,"iPhone13,2"
com.apple.MobileSMS,6,1736185619,1736185625,1736185626.257773,-21600,EB445137-D7F5-57EC-87DA-1DB460D64046,"iPhone13,2"
com.hammerandchisel.discord,8,1736185610,1736185618,1736185618.489105,-21600,EB445137-D7F5-57EC-87DA-1DB460D64046,"iPhone13,2"
com.hammerandchisel.discord,11,1736185568,1736185579,1736185579.431525,-21600,EB445137-D7F5-57EC-87DA-1DB460D64046,"iPhone13,2"
com.apple.MobileSMS,1,1736185567,1736185568,1736185568.488884,-21600,EB445137-D7F5-57EC-87DA-1DB460D64046,"iPhone13,2"
com.apple.MobileSMS,15,1736185382,1736185397,1736185398.480891,-21600,EB445137-D7F5-57EC-87DA-1DB460D64046,"iPhone13,2"
com.google.chrome.ios,3,1736185379,1736185382,1736185382.209354,-21600,EB445137-D7F5-57EC-87DA-1DB460D64046,"iPhone13,2"
com.apple.MobileSMS,6,1736185372,1736185378,1736185378.384656,-21600,EB445137-D7F5-57EC-87DA-1DB460D64046,"iPhone13,2"
com.apple.MobileSMS,20,1736184789,1736184809,1736184809.3572779,-21600,EB445137-D7F5-57EC-87DA-1DB460D64046,"iPhone13,2"
com.apple.MobileSMS,10,1736184663,1736184673,1736184673.6358871,-21600,EB445137-D7F5-57EC-87DA-1DB460D64046,"iPhone13,2"
com.apple.findmy,2,1736184661,1736184663,1736184664.1517138,-21600,EB445137-D7F5-57EC-87DA-1DB460D64046,"iPhone13,2"
com.microsoft.VSCode,366,1736184613,1736184979,1736184979.551697,-21600,,
com.google.Chrome,35,1736184578,1736184613,1736184613.55618,-21600,,
com.apple.findmy,13,1736184356,1736184369,1736184369.588311,-21600,EB445137-D7F5-57EC-87DA-1DB460D64046,"iPhone13,2"
com.apple.MobileSMS,4,1736184352,1736184356,1736184356.386044,-21600,EB445137-D7F5-57EC-87DA-1DB460D64046,"iPhone13,2"
com.microsoft.VSCode,313,1736184265,1736184578,1736184578.794732,-21600,,
com.google.Chrome,3,1736184262,1736184265,1736184265.417434,-21600,,
com.microsoft.VSCode,891,1736183371,1736184262,1736184262.534583,-21600,,
com.google.Chrome,26,1736183345,1736183371,1736183372.013383,-21600,,
com.microsoft.VSCode,703,1736182642,1736183345,1736183345.0771809,-21600,,
com.google.Chrome,3,1736182639,1736182642,1736182642.814038,-21600,,
com.microsoft.VSCode,310,1736182329,1736182639,1736182639.466008,-21600,,
com.google.Chrome,43,1736182286,1736182329,1736182329.644277,-21600,,
com.microsoft.VSCode,98,1736182188,1736182286,1736182286.3631968,-21600,,
com.google.Chrome,16,1736182172,1736182188,1736182188.81781,-21600,,
com.microsoft.VSCode,155,1736182017,1736182172,1736182172.618939,-21600,,
com.google.Chrome,179,1736181838,1736182017,1736182017.642891,-21600,,
com.microsoft.VSCode,106,1736181732,1736181838,1736181838.5355592,-21600,,
com.google.Chrome,1,1736181731,1736181732,1736181732.9868588,-21600,,
com.microsoft.VSCode,7,1736181724,1736181731,1736181731.681582,-21600,,
com.google.Chrome,1,1736181723,1736181724,1736181724.601138,-21600,,
com.microsoft.VSCode,2,1736181721,1736181723,1736181723.086649,-21600,,
com.google.Chrome,5,1736181716,1736181721,1736181721.438414,-21600,,
com.microsoft.VSCode,83,1736181633,1736181716,1736181716.132597,-21600,,
com.google.Chrome,20,1736181613,1736181633,1736181633.48693,-21600,,
com.microsoft.VSCode,27,1736181586,1736181613,1736181613.125421,-21600,,
com.google.Chrome,12,1736181574,1736181586,1736181586.826977,-21600,,
com.microsoft.VSCode,137,1736181437,1736181574,1736181574.2573519,-21600,,
com.google.Chrome,22,1736181415,1736181437,1736181437.1343942,-21600,,
com.microsoft.VSCode,17,1736181398,1736181415,1736181415.7833881,-21600,,
com.google.Chrome,4,1736181394,1736181398,1736181398.8903909,-21600,,
com.microsoft.VSCode,2,1736181392,1736181394,1736181394.2792091,-21600,,
com.google.Chrome,2,1736181390,1736181392,1736181392.378903,-21600,,
com.microsoft.VSCode,42,1736181348,1736181390,1736181390.735601,-21600,,
com.google.Chrome,410,1736180923,1736181333,1736181333.857811,-21600,,
com.apple.MobileSMS,45,1736180878,1736180923,1736180923.8817139,-21600,,
com.google.Chrome,21,1736180857,1736180878,1736180878.155737,-21600,,
com.apple.Passwords,9,1736180822,1736180831,1736180831.189523,-21600,,
com.google.Chrome,10,1736180812,1736180822,1736180822.1879249,-21600,,
com.apple.Passwords,8,1736180804,1736180812,1736180812.261815,-21600,,
com.google.Chrome,116,1736180688,1736180804,1736180804.7558,-21600,,
com.microsoft.VSCode,3,1736180685,1736180688,1736180688.9332108,-21600,,
com.apple.MobileSMS,2,1736180679,1736180681,1736180681.1084352,-21600,EB445137-D7F5-57EC-87DA-1DB460D64046,"iPhone13,2"
com.apple.news,14,1736180663,1736180677,1736180677.443661,-21600,EB445137-D7F5-57EC-87DA-1DB460D64046,"iPhone13,2"
com.apple.news,12,1736180650,1736180662,1736180662.5052009,-21600,EB445137-D7F5-57EC-87DA-1DB460D64046,"iPhone13,2"
com.apple.MobileSMS,4,1736180644,1736180648,1736180648.645822,-21600,EB445137-D7F5-57EC-87DA-1DB460D64046,"iPhone13,2"
com.apple.MobileSMS,44,1736180589,1736180633,1736180633.74301,-21600,EB445137-D7F5-57EC-87DA-1DB460D64046,"iPhone13,2"
com.renpho.health,9,1736180580,1736180589,1736180589.2799392,-21600,EB445137-D7F5-57EC-87DA-1DB460D64046,"iPhone13,2"
com.renpho.health,58,1736179749,1736179807,1736179807.5410151,-21600,EB445137-D7F5-57EC-87DA-1DB460D64046,"iPhone13,2"
com.google.ios.youtube,1722,1736176742,1736178464,1736178464.62606,-21600,EB445137-D7F5-57EC-87DA-1DB460D64046,"iPhone13,2"
com.apple.Health,10,1736176732,1736176742,1736176743.032727,-21600,EB445137-D7F5-57EC-87DA-1DB460D64046,"iPhone13,2"
com.google.ios.youtube,1,1736176731,1736176732,1736176735.323851,-21600,EB445137-D7F5-57EC-87DA-1DB460D64046,"iPhone13,2"
com.google.ios.youtube,4,1736176726,1736176730,1736176732.792407,-21600,EB445137-D7F5-57EC-87DA-1DB460D64046,"iPhone13,2"
com.apple.journal,130,1736141894,1736142024,1736142024.676233,-21600,EB445137-D7F5-57EC-87DA-1DB460D64046,"iPhone13,2"
com.apple.journal,1181,1736140695,1736141876,1736141876.22346,-21600,EB445137-D7F5-57EC-87DA-1DB460D64046,"iPhone13,2"
com.apple.CoreAuthUI,3,1736140311,1736140314,1736140314.9061608,-21600,EB445137-D7F5-57EC-87DA-1DB460D64046,"iPhone13,2"
com.apple.journal,384,1736140310,1736140694,1736140694.5539432,-21600,EB445137-D7F5-57EC-87DA-1DB460D64046,"iPhone13,2"
com.apple.Health,90,1736140216,1736140306,1736140306.7818952,-21600,EB445137-D7F5-57EC-87DA-1DB460D64046,"iPhone13,2"
com.apple.MobileSMS,20,1736139640,1736139660,1736139660.616292,-21600,EB445137-D7F5-57EC-87DA-1DB460D64046,"iPhone13,2"
com.goodreads.Goodreads,22,1736139618,1736139640,1736139640.371599,-21600,EB445137-D7F5-57EC-87DA-1DB460D64046,"iPhone13,2"
com.thestorygraph.thestorygraph,67,1736139551,1736139618,1736139618.234703,-21600,EB445137-D7F5-57EC-87DA-1DB460D64046,"iPhone13,2"
com.apple.MobileSMS,5,1736138986,1736138991,1736138991.851306,-21600,EB445137-D7F5-57EC-87DA-1DB460D64046,"iPhone13,2"
com.apple.MobileSMS,696,1736138210,1736138906,1736138906.303419,-21600,EB445137-D7F5-57EC-87DA-1DB460D64046,"iPhone13,2"
com.zhiliaoapp.musically,53,1736138157,1736138210,1736138210.453745,-21600,EB445137-D7F5-57EC-87DA-1DB460D64046,"iPhone13,2"
com.apple.MobileSMS,1,1736138156,1736138157,1736138157.650072,-21600,EB445137-D7F5-57EC-87DA-1DB460D64046,"iPhone13,2"
com.zhiliaoapp.musically,9,1736138147,1736138156,1736138156.318242,-21600,EB445137-D7F5-57EC-87DA-1DB460D64046,"iPhone13,2"
com.apple.MobileSMS,132,1736138015,1736138147,1736138147.796263,-21600,EB445137-D7F5-57EC-87DA-1DB460D64046,"iPhone13,2"
com.zhiliaoapp.musically,361,1736137650,1736138011,1736138011.278204,-21600,EB445137-D7F5-57EC-87DA-1DB460D64046,"iPhone13,2"
com.zhiliaoapp.musically,26,1736137622,1736137648,1736137648.984833,-21600,EB445137-D7F5-57EC-87DA-1DB460D64046,"iPhone13,2"
com.google.chrome.ios,5,1736137617,1736137622,1736137622.6120949,-21600,EB445137-D7F5-57EC-87DA-1DB460D64046,"iPhone13,2"
com.apple.MobileSMS,2,1736137615,1736137617,1736137617.458281,-21600,EB445137-D7F5-57EC-87DA-1DB460D64046,"iPhone13,2"
com.google.chrome.ios,10,1736137605,1736137615,1736137615.4490309,-21600,EB445137-D7F5-57EC-87DA-1DB460D64046,"iPhone13,2"
com.google.chrome.ios,38,1736137553,1736137591,1736137591.983381,-21600,EB445137-D7F5-57EC-87DA-1DB460D64046,"iPhone13,2"
com.apple.MobileSMS,1,1736137552,1736137553,1736137554.02267,-21600,EB445137-D7F5-57EC-87DA-1DB460D64046,"iPhone13,2"
com.google.chrome.ios,23,1736137529,1736137552,1736137552.536597,-21600,EB445137-D7F5-57EC-87DA-1DB460D64046,"iPhone13,2"
com.apple.MobileSMS,4,1736137525,1736137529,1736137535.786615,-21600,EB445137-D7F5-57EC-87DA-1DB460D64046,"iPhone13,2"
com.google.chrome.ios,0,1736137525,1736137525,1736137530.488195,-21600,EB445137-D7F5-57EC-87DA-1DB460D64046,"iPhone13,2"
com.microsoft.VSCode,4,1736134012,1736134016,1736134016.5373878,-21600,,
com.google.Chrome,188,1736133824,1736134012,1736134012.6347852,-21600,,
com.microsoft.VSCode,9,1736133815,1736133824,1736133824.9635859,-21600,,
com.google.Chrome,32,1736133783,1736133815,1736133815.422573,-21600,,
com.microsoft.VSCode,2,1736133781,1736133783,1736133783.070537,-21600,,
com.google.Chrome,3,1736133778,1736133781,1736133781.336828,-21600,,
com.microsoft.VSCode,96,1736133682,1736133778,1736133779.026645,-21600,,
com.google.Chrome,13,1736133669,1736133682,1736133682.146774,-21600,,
com.microsoft.VSCode,40,1736133629,1736133669,1736133669.089665,-21600,,
com.google.Chrome,6,1736133623,1736133629,1736133629.745549,-21600,,
com.microsoft.VSCode,81,1736133542,1736133623,1736133623.433058,-21600,,
com.google.Chrome,48,1736133494,1736133542,1736133542.2520452,-21600,,
com.microsoft.VSCode,39,1736133455,1736133494,1736133494.542091,-21600,,
com.google.Chrome,40,1736133415,1736133455,1736133455.375063,-21600,,
com.microsoft.VSCode,10,1736133405,1736133415,1736133415.830198,-21600,,
com.google.Chrome,6,1736133399,1736133405,1736133405.984554,-21600,,
com.microsoft.VSCode,2,1736133397,1736133399,1736133399.485448,-21600,,
com.google.Chrome,9,1736133388,1736133397,1736133397.845365,-21600,,
com.microsoft.VSCode,12,1736133376,1736133388,1736133388.849759,-21600,,
com.google.Chrome,20,1736133356,1736133376,1736133376.095269,-21600,,
com.microsoft.VSCode,31,1736133325,1736133356,1736133356.1749249,-21600,,
com.google.Chrome,5,1736133320,1736133325,1736133325.3914309,-21600,,
com.microsoft.VSCode,58,1736133262,1736133320,1736133320.6564732,-21600,,
com.google.Chrome,24,1736133238,1736133262,1736133262.89515,-21600,,
com.microsoft.VSCode,33,1736133205,1736133238,1736133238.973887,-21600,,
com.google.Chrome,71,1736133134,1736133205,1736133205.8394241,-21600,,
com.microsoft.VSCode,51,1736133083,1736133134,1736133134.1178741,-21600,,
com.google.Chrome,4,1736133079,1736133083,1736133083.88194,-21600,,
com.microsoft.VSCode,104,1736132975,1736133079,1736133080.0552058,-21600,,
com.google.Chrome,25,1736132950,1736132975,1736132975.764206,-21600,,
com.microsoft.VSCode,4,1736132946,1736132950,1736132950.7955952,-21600,,
com.google.Chrome,3,1736132943,1736132946,1736132946.302331,-21600,,
com.microsoft.VSCode,16,1736132927,1736132943,1736132943.7569342,-21600,,
com.google.Chrome,50,1736132877,1736132927,1736132927.6104488,-21600,,
com.microsoft.VSCode,17,1736132860,1736132877,1736132877.586983,-21600,,
com.google.Chrome,42,1736132818,1736132860,1736132861.019568,-21600,,
com.microsoft.VSCode,23,1736132795,1736132818,1736132818.0767,-21600,,
com.google.Chrome,21,1736132774,1736132795,1736132795.445915,-21600,,
com.microsoft.VSCode,225,1736132549,1736132774,1736132774.072468,-21600,,
com.google.Chrome,6,1736132543,1736132549,1736132549.382782,-21600,,
com.microsoft.VSCode,5,1736132538,1736132543,1736132543.223546,-21600,,
com.google.Chrome,12,1736132526,1736132538,1736132538.475632,-21600,,
com.microsoft.VSCode,175,1736132351,1736132526,1736132526.739115,-21600,,
com.google.Chrome,117,1736132234,1736132351,1736132351.275649,-21600,,
com.apple.finder,5,1736132229,1736132234,1736132234.139394,-21600,,
com.microsoft.VSCode,129,1736132100,1736132229,1736132230.024393,-21600,,
com.apple.finder,2,1736132098,1736132100,1736132100.075911,-21600,,
com.microsoft.VSCode,315,1736131783,1736132098,1736132099.0098228,-21600,,
com.apple.finder,2,1736131781,1736131783,1736131783.493682,-21600,,
com.google.Chrome,2,1736131779,1736131781,1736131781.446193,-21600,,
com.microsoft.VSCode,24,1736131755,1736131779,1736131779.791337,-21600,,
com.google.Chrome,31,1736131724,1736131755,1736131755.246175,-21600,,
com.microsoft.VSCode,345,1736131379,1736131724,1736131724.181433,-21600,,
com.google.Chrome,1,1736131378,1736131379,1736131379.4815059,-21600,,
com.microsoft.VSCode,214,1736131164,1736131378,1736131378.591068,-21600,,
com.google.Chrome,2,1736131162,1736131164,1736131164.202612,-21600,,
com.microsoft.VSCode,11,1736131151,1736131162,1736131162.9690862,-21600,,
com.google.Chrome,61,1736131090,1736131151,1736131151.589674,-21600,,
com.microsoft.VSCode,3,1736131087,1736131090,1736131090.937633,-21600,,
com.google.Chrome,6,1736131081,1736131087,1736131087.1255522,-21600,,
com.microsoft.VSCode,73,1736131008,1736131081,1736131081.630508,-21600,,
com.google.Chrome,1,1736131007,1736131008,1736131008.482885,-21600,,
com.microsoft.VSCode,46,1736130961,1736131007,1736131007.6188068,-21600,,
com.google.Chrome,1,1736130960,1736130961,1736130961.708791,-21600,,
com.microsoft.VSCode,29,1736130931,1736130960,1736130960.648793,-21600,,
com.google.Chrome,1,1736130930,1736130931,1736130931.968042,-21600,,
com.microsoft.VSCode,49,1736130881,1736130930,1736130931.242475,-21600,,
com.google.Chrome,1,1736130880,1736130881,1736130881.737053,-21600,,
com.microsoft.VSCode,152,1736130728,1736130880,1736130881.406663,-21600,,
com.google.Chrome,2,1736130726,1736130728,1736130728.213955,-21600,,
com.microsoft.VSCode,82,1736130644,1736130726,1736130726.8061109,-21600,,
com.google.Chrome,1,1736130643,1736130644,1736130644.7694001,-21600,,
com.microsoft.VSCode,75,1736130568,1736130643,1736130643.687901,-21600,,
com.google.Chrome,31,1736130537,1736130568,1736130568.7021909,-21600,,
com.microsoft.VSCode,154,1736130383,1736130537,1736130537.566616,-21600,,
com.google.Chrome,1,1736130382,1736130383,1736130383.683552,-21600,,
com.microsoft.VSCode,9,1736130373,1736130382,1736130382.50354,-21600,,
com.google.Chrome,112,1736130261,1736130373,1736130373.40491,-21600,,
com.microsoft.VSCode,5,1736130256,1736130261,1736130261.8465052,-21600,,
com.google.Chrome,14,1736130242,1736130256,1736130256.47572,-21600,,
com.microsoft.VSCode,44,1736130198,1736130242,1736130242.1129851,-21600,,
com.google.Chrome,2,1736130196,1736130198,1736130198.542266,-21600,,
com.microsoft.VSCode,19,1736130177,1736130196,1736130196.9919271,-21600,,
com.google.Chrome,28,1736130149,1736130177,1736130177.739783,-21600,,
com.microsoft.VSCode,37,1736130112,1736130149,1736130149.284142,-21600,,
com.google.Chrome,2,1736130110,1736130112,1736130112.3673759,-21600,,
com.microsoft.VSCode,17,1736130093,1736130110,1736130111.166376,-21600,,
com.google.Chrome,8,1736130085,1736130093,1736130093.080337,-21600,,
com.microsoft.VSCode,23,1736130062,1736130085,1736130085.782907,-21600,,
com.google.Chrome,2,1736130060,1736130062,1736130062.2889218,-21600,,
com.microsoft.VSCode,12,1736130048,1736130060,1736130061.0387092,-21600,,
com.google.Chrome,10,1736130038,1736130048,1736130048.237447,-21600,,
com.microsoft.VSCode,3,1736130035,1736130038,1736130038.686959,-21600,,
com.google.Chrome,1,1736130034,1736130035,1736130035.4676971,-21600,,
com.microsoft.VSCode,6,1736130028,1736130034,1736130034.406141,-21600,,
com.google.Chrome,1,1736130027,1736130028,1736130028.942364,-21600,,
com.microsoft.VSCode,2,1736130025,1736130027,1736130027.2720551,-21600,,
com.google.Chrome,7,1736130018,1736130025,1736130025.066078,-21600,,
com.microsoft.VSCode,4,1736130014,1736130018,1736130018.6706991,-21600,,
com.google.Chrome,20,1736129994,1736130014,1736130014.911494,-21600,,
com.microsoft.VSCode,19,1736129975,1736129994,1736129994.6446729,-21600,,
com.google.Chrome,40,1736129935,1736129975,1736129975.8252192,-21600,,
com.microsoft.VSCode,680,1736129255,1736129935,1736129935.304847,-21600,,
com.google.Chrome,182,1736129073,1736129255,1736129255.784117,-21600,,
com.microsoft.VSCode,617,1736128456,1736129073,1736129073.106464,-21600,,
com.google.Chrome,3,1736128453,1736128456,1736128456.2292318,-21600,,
com.microsoft.VSCode,49,1736128404,1736128453,1736128453.724874,-21600,,
com.google.Chrome,117,1736128287,1736128404,1736128404.128231,-21600,,
com.microsoft.VSCode,28,1736128259,1736128287,1736128287.0816069,-21600,,
com.google.Chrome,113,1736128146,1736128259,1736128259.179322,-21600,,
com.microsoft.VSCode,812,1736127334,1736128146,1736128146.4278898,-21600,,
com.google.Chrome,1,1736127333,1736127334,1736127335.031578,-21600,,
com.microsoft.VSCode,387,1736126946,1736127333,1736127334.467006,-21600,,
com.google.Chrome,2,1736126944,1736126946,1736126946.539875,-21600,,
com.microsoft.VSCode,328,1736126616,1736126944,1736126945.404834,-21600,,
com.google.Chrome,2,1736126614,1736126616,1736126616.447366,-21600,,
com.microsoft.VSCode,634,1736125980,1736126614,1736126614.886313,-21600,,
com.google.Chrome,3,1736125977,1736125980,1736125980.208391,-21600,,
com.microsoft.VSCode,80,1736125897,1736125977,1736125977.916559,-21600,,
com.google.Chrome,2,1736125895,1736125897,1736125897.60147,-21600,,
com.microsoft.VSCode,13,1736125882,1736125895,1736125895.303265,-21600,,
com.google.Chrome,3,1736125879,1736125882,1736125882.4048738,-21600,,
com.microsoft.VSCode,14,1736125865,1736125879,1736125879.5449982,-21600,,
com.google.Chrome,16,1736125849,1736125865,1736125865.296495,-21600,,
com.microsoft.VSCode,729,1736125120,1736125849,1736125849.587637,-21600,,
com.google.Chrome,1,1736125119,1736125120,1736125120.778249,-21600,,
com.microsoft.VSCode,1,1736125118,1736125119,1736125119.756299,-21600,,
com.google.Chrome,1,1736125117,1736125118,1736125118.5195131,-21600,,
com.microsoft.VSCode,1,1736125116,1736125117,1736125117.313365,-21600,,
com.google.Chrome,2,1736125114,1736125116,1736125116.424346,-21600,,
com.microsoft.VSCode,1,1736125113,1736125114,1736125114.4464378,-21600,,
com.google.Chrome,1,1736125112,1736125113,1736125113.6071072,-21600,,
com.microsoft.VSCode,1,1736125111,1736125112,1736125112.771603,-21600,,
com.google.Chrome,0,1736125111,1736125111,1736125111.914099,-21600,,
com.microsoft.VSCode,1,1736125110,1736125111,1736125111.252564,-21600,,
com.google.Chrome,1,1736125109,1736125110,1736125110.418431,-21600,,
com.microsoft.VSCode,40,1736125069,1736125109,1736125109.33495,-21600,,
com.google.Chrome,1,1736125068,1736125069,1736125069.942735,-21600,,
com.microsoft.VSCode,3,1736125065,1736125068,1736125068.870247,-21600,,
com.google.Chrome,12,1736125053,1736125065,1736125065.542661,-21600,,
com.microsoft.VSCode,29,1736125024,1736125053,1736125053.924196,-21600,,
com.google.Chrome,3,1736125021,1736125024,1736125024.644923,-21600,,
com.microsoft.VSCode,2,1736125019,1736125021,1736125021.64884,-21600,,
com.google.Chrome,0,1736125019,1736125019,1736125020.019208,-21600,,
com.microsoft.VSCode,4,1736125015,1736125019,1736125019.1682029,-21600,,
com.google.Chrome,10,1736125005,1736125015,1736125016.036762,-21600,,
com.microsoft.VSCode,25,1736124980,1736125005,1736125005.718189,-21600,,
com.google.Chrome,2,1736124978,1736124980,1736124980.602571,-21600,,
com.microsoft.VSCode,65,1736124913,1736124978,1736124978.8938332,-21600,,
com.google.Chrome,1,1736124912,1736124913,1736124913.5788121,-21600,,
com.microsoft.VSCode,7,1736124905,1736124912,1736124912.399253,-21600,,
com.google.Chrome,4,1736124901,1736124905,1736124905.506253,-21600,,
com.microsoft.VSCode,2,1736124899,1736124901,1736124901.253444,-21600,,
com.google.Chrome,1,1736124898,1736124899,1736124899.88478,-21600,,
com.microsoft.VSCode,1,1736124897,1736124898,1736124898.834367,-21600,,
com.google.Chrome,1,1736124896,1736124897,1736124897.623231,-21600,,
com.microsoft.VSCode,2,1736124894,1736124896,1736124896.2793798,-21600,,
com.google.Chrome,1,1736124893,1736124894,1736124894.7623591,-21600,,
com.microsoft.VSCode,2,1736124891,1736124893,1736124893.2186,-21600,,
com.google.Chrome,1,1736124890,1736124891,1736124891.419167,-21600,,
com.microsoft.VSCode,3,1736124887,1736124890,1736124890.218905,-21600,,
com.google.Chrome,17,1736124870,1736124887,1736124887.161696,-21600,,
com.microsoft.VSCode,25,1736124845,1736124870,1736124870.05926,-21600,,
com.google.Chrome,1,1736124844,1736124845,1736124845.708589,-21600,,
com.microsoft.VSCode,68,1736124776,1736124844,1736124844.940994,-21600,,
com.google.Chrome,1,1736124775,1736124776,1736124776.715069,-21600,,
com.microsoft.VSCode,3,1736124772,1736124775,1736124775.211901,-21600,,
com.google.Chrome,2,1736124770,1736124772,1736124772.857166,-21600,,
com.microsoft.VSCode,1,1736124769,1736124770,1736124770.806104,-21600,,
com.google.Chrome,1,1736124768,1736124769,1736124769.3355389,-21600,,
com.microsoft.VSCode,2,1736124766,1736124768,1736124768.086499,-21600,,
com.google.Chrome,1,1736124765,1736124766,1736124766.615931,-21600,,
com.microsoft.VSCode,1,1736124764,1736124765,1736124765.61183,-21600,,
com.google.Chrome,1,1736124763,1736124764,1736124764.377954,-21600,,
com.microsoft.VSCode,2,1736124761,1736124763,1736124763.6381059,-21600,,
com.google.Chrome,19,1736124742,1736124761,1736124761.840279,-21600,,
com.microsoft.VSCode,75,1736124667,1736124742,1736124742.455192,-21600,,
com.google.Chrome,1,1736124666,1736124667,1736124667.3796592,-21600,,
com.microsoft.VSCode,9,1736124657,1736124666,1736124666.592807,-21600,,
com.google.Chrome,1,1736124656,1736124657,1736124657.7351,-21600,,
com.microsoft.VSCode,98,1736124558,1736124656,1736124656.90767,-21600,,
com.google.Chrome,1,1736124557,1736124558,1736124558.778027,-21600,,
com.microsoft.VSCode,7,1736124550,1736124557,1736124558.008317,-21600,,
com.google.Chrome,125,1736124425,1736124550,1736124550.62329,-21600,,
com.microsoft.VSCode,21,1736124404,1736124425,1736124425.791737,-21600,,
com.google.Chrome,0,1736124404,1736124404,1736124404.5921679,-21600,,
com.microsoft.VSCode,4,1736124400,1736124404,1736124404.319151,-21600,,
com.google.Chrome,1,1736124399,1736124400,1736124400.12236,-21600,,
com.microsoft.VSCode,6,1736124393,1736124399,1736124399.2569041,-21600,,
com.google.Chrome,1,1736124392,1736124393,1736124393.72432,-21600,,
com.microsoft.VSCode,563,1736123829,1736124392,1736124392.814198,-21600,,
com.google.Chrome,333,1736123496,1736123829,1736123829.176219,-21600,,
com.google.Chrome,4,1736119201,1736119205,1736119205.789758,-21600,,
com.google.Chrome,699,1736118205,1736118904,1736118904.598798,-21600,,
com.google.Chrome,2540,1736115513,1736118053,1736118053.3471642,-21600,,
com.google.Chrome,65,1736108001,1736108066,1736108066.157121,-21600,,
com.google.Chrome,575,1736107421,1736107996,1736107996.4177651,-21600,,
com.google.Chrome,475,1736106898,1736107373,1736107373.3757749,-21600,,
com.google.Chrome,503,1736106091,1736106594,1736106594.662286,-21600,,
com.google.Chrome,912,1736105091,1736106003,1736106003.181192,-21600,,
com.apple.finder,4,1736105087,1736105091,1736105091.207504,-21600,,
com.google.Chrome,205,1736104882,1736105087,1736105087.6765761,-21600,,
com.apple.finder,27,1736104855,1736104882,1736104882.3066611,-21600,,
com.microsoft.rdc.macos,2,1736104853,1736104855,1736104855.079214,-21600,,
com.apple.finder,2,1736104851,1736104853,1736104853.524265,-21600,,
com.cisco.secureclient.gui,4,1736104847,1736104851,1736104852.2531428,-21600,,
com.electron.carta,2,1736104845,1736104847,1736104847.59229,-21600,,
com.cisco.secureclient.gui,4,1736104841,1736104845,1736104845.5590549,-21600,,
com.apple.Terminal,25,1736104816,1736104841,1736104841.984776,-21600,,
com.microsoft.VSCode,283,1736104533,1736104816,1736104816.8310761,-21600,,
com.apple.finder,9,1736104524,1736104533,1736104533.28167,-21600,,
com.apple.Terminal,16,1736104508,1736104524,1736104524.6476169,-21600,,
com.google.Chrome,46,1736104462,1736104508,1736104508.6917791,-21600,,
com.microsoft.rdc.macos,100,1736104362,1736104462,1736104462.846708,-21600,,
com.cisco.secureclient.gui,11,1736104351,1736104362,1736104362.5632858,-21600,,
com.microsoft.rdc.macos,36,1736104315,1736104351,1736104351.8252668,-21600,,
com.google.Chrome,303,1736104012,1736104315,1736104315.7355251,-21600,,
com.apple.Terminal,119,1736103893,1736104012,1736104014.206437,-21600,,
com.cisco.secureclient.gui,2,1736103891,1736103893,1736103893.2951279,-21600,,
com.apple.Terminal,109,1736103782,1736103891,1736103891.902117,-21600,,
com.apple.finder,3,1736103779,1736103782,1736103782.167643,-21600,,
com.apple.Terminal,36,1736103743,1736103779,1736103779.78204,-21600,,
com.microsoft.VSCode,173,1736103570,1736103743,1736103743.604795,-21600,,
com.apple.finder,12,1736103558,1736103570,1736103570.3176088,-21600,,
com.electron.carta,327,1736103231,1736103558,1736103558.753835,-21600,,
com.apple.finder,8,1736103223,1736103231,1736103231.184001,-21600,,
com.apple.Terminal,5,1736103218,1736103223,1736103223.2711,-21600,,
com.apple.finder,36,1736103182,1736103218,1736103218.1312199,-21600,,
com.apple.Terminal,71,1736103111,1736103182,1736103182.919514,-21600,,
com.apple.finder,1,1736103110,1736103111,1736103111.797014,-21600,,
com.apple.Terminal,18,1736103092,1736103110,1736103110.71075,-21600,,
com.google.Chrome,21,1736103071,1736103092,1736103092.9375029,-21600,,
com.apple.systempreferences,49,1736103022,1736103071,1736103071.640688,-21600,,
com.google.Chrome,50,1736102966,1736103016,1736103016.0923119,-21600,,
com.apple.Terminal,19,1736102947,1736102966,1736102966.3234491,-21600,,
com.apple.finder,6,1736102941,1736102947,1736102947.164195,-21600,,
com.apple.Terminal,25,1736102916,1736102941,1736102941.301773,-21600,,
com.apple.finder,3,1736102913,1736102916,1736102916.204805,-21600,,
com.apple.Terminal,124,1736102789,1736102913,1736102913.491221,-21600,,
com.apple.finder,7,1736102782,1736102789,1736102789.72037,-21600,,
com.apple.Terminal,148,1736102634,1736102782,1736102782.0834432,-21600,,
com.apple.finder,31,1736102603,1736102634,1736102634.9709182,-21600,,
com.cisco.secureclient.gui,28,1736102575,1736102603,1736102603.456427,-21600,,
com.apple.finder,2,1736102573,1736102575,1736102575.723619,-21600,,
com.cisco.secureclient.gui,18,1736102555,1736102573,1736102573.905871,-21600,,
com.electron.carta,15,1736102540,1736102555,1736102555.218472,-21600,,
com.leomehlig.today,9,1736102531,1736102540,1736102540.058111,-21600,,
com.google.Chrome,298,1736102233,1736102531,1736102531.8332062,-21600,,
com.google.Chrome,5650,1736095349,1736100999,1736101000.887517,-21600,,
com.google.Chrome,463,1736054968,1736055431,1736055431.440919,-21600,,
com.google.Chrome,375,1736052695,1736053070,1736053070.9893398,-21600,,
com.leomehlig.today,2,1736052693,1736052695,1736052695.576983,-21600,,
com.leomehlig.today,37,1736052642,1736052679,1736052679.730588,-21600,,
com.google.Chrome,407,1736052235,1736052642,1736052642.237091,-21600,,
com.google.Chrome,380,1736021367,1736021747,1736021747.8937058,-21600,,
com.leomehlig.today,3,1736021364,1736021367,1736021368.733891,-21600,,
com.leomehlig.today,26,1736016712,1736016738,1736016739.035115,-21600,,
com.google.Chrome,140,1736016572,1736016712,1736016712.125171,-21600,,
com.google.Chrome,382,1736015274,1736015656,1736015656.826776,-21600,,
com.leomehlig.today,6,1736015268,1736015274,1736015274.084337,-21600,,
com.leomehlig.today,0,1736015265,1736015265,1736015265.86415,-21600,,
com.leomehlig.today,312,1736014169,1736014481,1736014481.3931088,-21600,,
com.google.Chrome,16,1736014153,1736014169,1736014170.021704,-21600,,
com.microsoft.VSCode,508,1736013645,1736014153,1736014153.26959,-21600,,
com.google.Chrome,16,1736013629,1736013645,1736013645.5566258,-21600,,
com.microsoft.VSCode,423,1736013206,1736013629,1736013629.698658,-21600,,
com.google.Chrome,14,1736013192,1736013206,1736013206.163735,-21600,,
com.microsoft.VSCode,188,1736013004,1736013192,1736013192.5946388,-21600,,
com.google.Chrome,4,1736013000,1736013004,1736013004.9289808,-21600,,
com.microsoft.VSCode,1,1736012999,1736013000,1736013000.424516,-21600,,
com.google.Chrome,9,1736012990,1736012999,1736012999.576233,-21600,,
com.microsoft.VSCode,13,1736012977,1736012990,1736012990.042498,-21600,,
com.google.Chrome,24,1736012953,1736012977,1736012978.028599,-21600,,
com.microsoft.VSCode,26,1736012927,1736012953,1736012953.464069,-21600,,
com.microsoft.VSCode,747,1736010046,1736010793,1736010793.901891,-21600,,
com.google.Chrome,1,1736010045,1736010046,1736010046.894638,-21600,,
com.microsoft.VSCode,1188,1736008857,1736010045,1736010045.2656279,-21600,,
com.microsoft.VSCode,806,1735950466,1735951272,1735951272.5802479,-21600,,
com.google.Chrome,9,1735950457,1735950466,1735950466.305884,-21600,,
com.google.android.studio,8,1735950449,1735950457,1735950457.892395,-21600,,
com.google.android.studio,1661,1735943425,1735945086,1735945086.492368,-21600,,
com.apple.dt.Xcode,4,1735942766,1735942770,1735942770.771807,-21600,,
com.google.android.studio,64,1735942702,1735942766,1735942766.211734,-21600,,
com.apple.dt.Xcode,7,1735942695,1735942702,1735942702.537969,-21600,,
com.microsoft.onenote.mac,0,1735942695,1735942695,1735942695.915309,-21600,,
com.google.android.studio,3,1735942692,1735942695,1735942695.047635,-21600,,
com.microsoft.onenote.mac,1,1735942691,1735942692,1735942692.8497062,-21600,,
com.apple.dt.Xcode,6,1735942685,1735942691,1735942691.5939698,-21600,,
com.microsoft.onenote.mac,2,1735942683,1735942685,1735942685.121758,-21600,,
com.google.android.studio,190,1735942493,1735942683,1735942683.879706,-21600,,
com.microsoft.onenote.mac,5,1735942488,1735942493,1735942493.3740702,-21600,,
com.google.android.studio,20,1735942468,1735942488,1735942488.389127,-21600,,
com.apple.dt.Xcode,3,1735942465,1735942468,1735942468.176058,-21600,,
com.google.android.studio,4,1735942461,1735942465,1735942465.507961,-21600,,
com.apple.dt.Xcode,7,1735942454,1735942461,1735942461.4611459,-21600,,
com.google.android.studio,2,1735942452,1735942454,1735942454.698371,-21600,,
com.apple.dt.Xcode,5,1735942447,1735942452,1735942452.198649,-21600,,
com.google.android.studio,1,1735942446,1735942447,1735942447.4596949,-21600,,
com.apple.dt.Xcode,1,1735942445,1735942446,1735942446.331914,-21600,,
com.google.android.studio,27,1735942418,1735942445,1735942445.651206,-21600,,
com.apple.dt.Xcode,13,1735942405,1735942418,1735942418.763328,-21600,,
com.google.android.studio,22,1735942383,1735942405,1735942405.3530831,-21600,,
com.apple.dt.Xcode,1,1735942382,1735942383,1735942383.410386,-21600,,
com.google.android.studio,7,1735942375,1735942382,1735942382.240528,-21600,,
com.apple.dt.Xcode,5,1735942370,1735942375,1735942375.255818,-21600,,
com.google.android.studio,4,1735942366,1735942370,1735942370.299458,-21600,,
com.apple.dt.Xcode,4,1735942362,1735942366,1735942366.230856,-21600,,
com.google.android.studio,22,1735942340,1735942362,1735942362.2973828,-21600,,
com.apple.dt.Xcode,29,1735942311,1735942340,1735942340.469418,-21600,,
com.google.android.studio,19,1735942292,1735942311,1735942311.701813,-21600,,
com.apple.dt.Xcode,3,1735942289,1735942292,1735942292.07588,-21600,,
com.google.android.studio,5,1735942284,1735942289,1735942289.731221,-21600,,
com.apple.dt.Xcode,2,1735942282,1735942284,1735942284.072946,-21600,,
com.google.android.studio,2,1735942280,1735942282,1735942282.8036308,-21600,,
com.apple.dt.Xcode,2,1735942278,1735942280,1735942280.227907,-21600,,
com.google.android.studio,2,1735942276,1735942278,1735942278.192236,-21600,,
com.apple.dt.Xcode,2,1735942274,1735942276,1735942276.404581,-21600,,
com.google.android.studio,3,1735942271,1735942274,1735942274.697088,-21600,,
com.apple.dt.Xcode,1,1735942270,1735942271,1735942271.681601,-21600,,
com.google.android.studio,15,1735942255,1735942270,1735942270.33758,-21600,,
com.apple.dt.Xcode,1,1735942254,1735942255,1735942255.7770228,-21600,,
com.google.android.studio,3,1735942251,1735942254,1735942254.07006,-21600,,
com.apple.dt.Xcode,4,1735942247,1735942251,1735942251.586794,-21600,,
com.google.android.studio,242,1735942005,1735942247,1735942247.932661,-21600,,
com.apple.dt.Xcode,1,1735942004,1735942005,1735942005.866091,-21600,,
com.google.android.studio,6,1735941998,1735942004,1735942004.1257029,-21600,,
com.apple.dt.Xcode,43,1735941955,1735941998,1735941998.898931,-21600,,
com.google.android.studio,7,1735941948,1735941955,1735941955.1841478,-21600,,
com.apple.dt.Xcode,1,1735941947,1735941948,1735941948.433918,-21600,,
com.google.android.studio,4,1735941943,1735941947,1735941947.2785358,-21600,,
com.apple.dt.Xcode,1,1735941942,1735941943,1735941943.5683498,-21600,,
com.google.android.studio,5,1735941937,1735941942,1735941942.2635942,-21600,,
com.apple.dt.Xcode,1,1735941936,1735941937,1735941937.887753,-21600,,
com.google.android.studio,3,1735941933,1735941936,1735941936.5818648,-21600,,
com.apple.dt.Xcode,1,1735941932,1735941933,1735941933.179657,-21600,,
com.google.android.studio,14,1735941918,1735941932,1735941932.204855,-21600,,
com.apple.dt.Xcode,1,1735941917,1735941918,1735941918.643897,-21600,,
com.google.android.studio,4,1735941913,1735941917,1735941917.359329,-21600,,
com.apple.dt.Xcode,1,1735941912,1735941913,1735941913.807324,-21600,,
com.google.android.studio,3,1735941909,1735941912,1735941912.1064758,-21600,,
com.apple.dt.Xcode,1,1735941908,1735941909,1735941909.5623941,-21600,,
com.google.android.studio,4,1735941904,1735941908,1735941908.2105942,-21600,,
com.apple.dt.Xcode,2,1735941902,1735941904,1735941904.8595738,-21600,,
com.google.android.studio,3,1735941899,1735941902,1735941902.963634,-21600,,
com.apple.dt.Xcode,1,1735941898,1735941899,1735941899.75229,-21600,,
com.google.android.studio,2,1735941896,1735941898,1735941898.281633,-21600,,
com.apple.dt.Xcode,1,1735941895,1735941896,1735941896.320929,-21600,,
com.google.android.studio,14,1735941881,1735941895,1735941895.277954,-21600,,
com.apple.dt.Xcode,3,1735941878,1735941881,1735941881.069952,-21600,,
com.google.android.studio,6,1735941872,1735941878,1735941878.296476,-21600,,
com.apple.dt.Xcode,4,1735941868,1735941872,1735941872.1058779,-21600,,
com.google.android.studio,8,1735941860,1735941868,1735941868.228111,-21600,,
com.apple.dt.Xcode,1,1735941859,1735941860,1735941860.752307,-21600,,
com.google.android.studio,2,1735941857,1735941859,1735941859.622822,-21600,,
com.apple.dt.Xcode,4,1735941853,1735941857,1735941857.251899,-21600,,
com.google.android.studio,2,1735941851,1735941853,1735941853.538568,-21600,,
com.apple.dt.Xcode,2,1735941849,1735941851,1735941851.776667,-21600,,
com.google.android.studio,11,1735941838,1735941849,1735941849.163364,-21600,,
com.apple.dt.Xcode,1,1735941837,1735941838,1735941838.8022962,-21600,,
com.google.android.studio,7,1735941830,1735941837,1735941837.116139,-21600,,
com.apple.dt.Xcode,2,1735941828,1735941830,1735941831.0179749,-21600,,
com.google.android.studio,6,1735941822,1735941828,1735941828.862588,-21600,,
com.apple.dt.Xcode,1,1735941821,1735941822,1735941822.5156012,-21600,,
com.google.android.studio,1,1735941820,1735941821,1735941821.465085,-21600,,
com.apple.dt.Xcode,1,1735941819,1735941820,1735941820.5493279,-21600,,
com.google.android.studio,2,1735941817,1735941819,1735941819.486665,-21600,,
com.apple.dt.Xcode,1,1735941816,1735941817,1735941817.4911098,-21600,,
com.google.android.studio,7,1735941809,1735941816,1735941816.6677442,-21600,,
com.apple.dt.Xcode,5,1735941804,1735941809,1735941809.387035,-21600,,
com.google.android.studio,10,1735941794,1735941804,1735941804.93996,-21600,,
com.apple.dt.Xcode,1,1735941793,1735941794,1735941794.2231588,-21600,,
com.google.android.studio,7,1735941786,1735941793,1735941793.4393039,-21600,,
com.apple.dt.Xcode,3,1735941783,1735941786,1735941786.119041,-21600,,
com.google.android.studio,8,1735941775,1735941783,1735941783.143928,-21600,,
com.apple.dt.Xcode,1,1735941774,1735941775,1735941775.947783,-21600,,
com.google.android.studio,8,1735941766,1735941774,1735941774.79332,-21600,,
com.apple.dt.Xcode,2,1735941764,1735941766,1735941767.010188,-21600,,
com.google.android.studio,3,1735941761,1735941764,1735941764.508791,-21600,,
com.apple.dt.Xcode,2,1735941759,1735941761,1735941761.053968,-21600,,
com.google.android.studio,6,1735941753,1735941759,1735941759.9387941,-21600,,
com.apple.dt.Xcode,1,1735941752,1735941753,1735941753.621675,-21600,,
com.google.android.studio,23,1735941729,1735941752,1735941752.238867,-21600,,
com.apple.dt.Xcode,1,1735941728,1735941729,1735941729.8667312,-21600,,
com.google.android.studio,2,1735941726,1735941728,1735941728.973075,-21600,,
com.apple.dt.Xcode,2,1735941724,1735941726,1735941726.5345259,-21600,,
com.google.android.studio,6,1735941718,1735941724,1735941724.686441,-21600,,
com.apple.dt.Xcode,3,1735941715,1735941718,1735941718.988481,-21600,,
com.google.android.studio,4,1735941711,1735941715,1735941715.807312,-21600,,
com.apple.dt.Xcode,3,1735941708,1735941711,1735941711.866766,-21600,,
com.google.android.studio,1,1735941707,1735941708,1735941708.809032,-21600,,
com.apple.dt.Xcode,4,1735941703,1735941707,1735941707.2760282,-21600,,
com.google.android.studio,6,1735941697,1735941703,1735941703.5735579,-21600,,
com.apple.dt.Xcode,2,1735941695,1735941697,1735941697.050555,-21600,,
com.google.android.studio,24,1735941671,1735941695,1735941695.2663631,-21600,,
com.apple.dt.Xcode,2,1735941669,1735941671,1735941671.3607988,-21600,,
com.google.android.studio,2,1735941667,1735941669,1735941669.904526,-21600,,
com.apple.dt.Xcode,2,1735941665,1735941667,1735941667.327441,-21600,,
com.google.android.studio,14,1735941651,1735941665,1735941665.669739,-21600,,
com.apple.dt.Xcode,12,1735941639,1735941651,1735941651.84868,-21600,,
com.google.android.studio,11,1735941628,1735941639,1735941639.912271,-21600,,
com.apple.dt.Xcode,4,1735941624,1735941628,1735941628.51348,-21600,,
com.google.android.studio,6,1735941618,1735941624,1735941624.527245,-21600,,
com.apple.dt.Xcode,2,1735941616,1735941618,1735941618.641994,-21600,,
com.google.android.studio,5,1735941611,1735941616,1735941616.9129481,-21600,,
com.apple.dt.Xcode,1,1735941610,1735941611,1735941611.551966,-21600,,
com.google.android.studio,5,1735941605,1735941610,1735941610.1009011,-21600,,
com.apple.dt.Xcode,2,1735941603,1735941605,1735941605.095506,-21600,,
com.google.android.studio,5,1735941598,1735941603,1735941603.3230991,-21600,,
com.apple.dt.Xcode,3,1735941595,1735941598,1735941598.758212,-21600,,
com.google.android.studio,3,1735941592,1735941595,1735941595.782877,-21600,,
com.apple.dt.Xcode,2,1735941590,1735941592,1735941592.4930902,-21600,,
com.google.android.studio,16,1735941574,1735941590,1735941590.9530401,-21600,,
com.apple.dt.Xcode,6,1735941568,1735941574,1735941574.685169,-21600,,
com.google.android.studio,38,1735941530,1735941568,1735941568.085966,-21600,,
com.apple.dt.Xcode,2,1735941528,1735941530,1735941530.851654,-21600,,
com.google.android.studio,14,1735941514,1735941528,1735941528.652453,-21600,,
com.apple.dt.Xcode,2,1735941512,1735941514,1735941514.851253,-21600,,
com.google.android.studio,3,1735941509,1735941512,1735941512.153808,-21600,,
com.apple.dt.Xcode,2,1735941507,1735941509,1735941509.6913738,-21600,,
com.google.android.studio,14,1735941493,1735941507,1735941507.2364988,-21600,,
com.apple.dt.Xcode,5,1735941488,1735941493,1735941493.279148,-21600,,
com.google.android.studio,18,1735941470,1735941488,1735941488.10749,-21600,,
com.apple.dt.Xcode,21,1735941449,1735941470,1735941470.254856,-21600,,
com.google.android.studio,3,1735941446,1735941449,1735941449.425415,-21600,,
com.apple.dt.Xcode,3,1735941443,1735941446,1735941446.789968,-21600,,
com.google.android.studio,7,1735941436,1735941443,1735941443.969985,-21600,,
com.apple.dt.Xcode,8,1735941428,1735941436,1735941436.321861,-21600,,
com.google.android.studio,5,1735941423,1735941428,1735941428.492372,-21600,,
com.apple.dt.Xcode,12,1735941411,1735941423,1735941423.485392,-21600,,
com.google.android.studio,9,1735941402,1735941411,1735941411.194213,-21600,,
com.apple.dt.Xcode,9,1735941393,1735941402,1735941402.272443,-21600,,
com.google.android.studio,2,1735941391,1735941393,1735941394.042573,-21600,,
com.apple.dt.Xcode,1,1735941390,1735941391,1735941391.551557,-21600,,
com.google.android.studio,7,1735941383,1735941390,1735941390.577167,-21600,,
com.apple.dt.Xcode,9,1735941374,1735941383,1735941383.8451982,-21600,,
com.google.android.studio,1,1735941373,1735941374,1735941375.02009,-21600,,
com.apple.dt.Xcode,3,1735941370,1735941373,1735941373.546692,-21600,,
com.google.android.studio,6,1735941364,1735941370,1735941370.580589,-21600,,
com.apple.dt.Xcode,3,1735941361,1735941364,1735941364.2959862,-21600,,
com.google.android.studio,3,1735941358,1735941361,1735941361.985642,-21600,,
com.apple.dt.Xcode,7,1735941351,1735941358,1735941358.173565,-21600,,
com.google.android.studio,7,1735941344,1735941351,1735941351.8467832,-21600,,
com.apple.dt.Xcode,6,1735941338,1735941344,1735941344.42526,-21600,,
com.google.android.studio,18,1735941320,1735941338,1735941338.618806,-21600,,
com.apple.dt.Xcode,1,1735941319,1735941320,1735941320.346469,-21600,,
com.google.android.studio,28,1735941291,1735941319,1735941319.273938,-21600,,
com.apple.dt.Xcode,2,1735941289,1735941291,1735941291.921236,-21600,,
com.google.android.studio,11,1735941278,1735941289,1735941289.276349,-21600,,
com.apple.dt.Xcode,8,1735941270,1735941278,1735941278.192158,-21600,,
com.google.android.studio,6,1735941264,1735941270,1735941270.374971,-21600,,
com.apple.dt.Xcode,3,1735941261,1735941264,1735941264.152203,-21600,,
com.google.android.studio,7,1735941254,1735941261,1735941261.671375,-21600,,
com.apple.dt.Xcode,2,1735941252,1735941254,1735941254.0872169,-21600,,
com.google.android.studio,9,1735941243,1735941252,1735941252.838057,-21600,,
com.apple.dt.Xcode,1,1735941242,1735941243,1735941243.782843,-21600,,
com.google.android.studio,8,1735941234,1735941242,1735941242.106354,-21600,,
com.apple.dt.Xcode,5,1735941229,1735941234,1735941234.631973,-21600,,
com.google.android.studio,9,1735941220,1735941229,1735941229.80675,-21600,,
com.apple.dt.Xcode,3,1735941217,1735941220,1735941220.8621259,-21600,,
com.google.android.studio,10,1735941207,1735941217,1735941217.8799071,-21600,,
com.apple.dt.Xcode,2,1735941205,1735941207,1735941207.585486,-21600,,
com.google.android.studio,13,1735941192,1735941205,1735941205.965728,-21600,,
com.apple.dt.Xcode,3,1735941189,1735941192,1735941192.2633572,-21600,,
com.google.android.studio,10,1735941179,1735941189,1735941189.7972279,-21600,,
com.apple.dt.Xcode,2,1735941177,1735941179,1735941179.732627,-21600,,
com.google.android.studio,12,1735941165,1735941177,1735941177.172091,-21600,,
com.apple.dt.Xcode,2,1735941163,1735941165,1735941166.018207,-21600,,
com.google.android.studio,17,1735941146,1735941163,1735941163.791024,-21600,,
com.apple.dt.Xcode,2,1735941144,1735941146,1735941146.629078,-21600,,
com.google.android.studio,7,1735941137,1735941144,1735941144.92238,-21600,,
com.apple.dt.Xcode,3,1735941134,1735941137,1735941137.303626,-21600,,
com.google.android.studio,2,1735941132,1735941134,1735941134.555039,-21600,,
com.apple.dt.Xcode,2,1735941130,1735941132,1735941133.036844,-21600,,
com.google.android.studio,5,1735941125,1735941130,1735941130.6506128,-21600,,
com.apple.dt.Xcode,6,1735941119,1735941125,1735941125.265352,-21600,,
com.google.android.studio,3,1735941116,1735941119,1735941119.7830071,-21600,,
com.apple.dt.Xcode,2,1735941114,1735941116,1735941116.112162,-21600,,
com.google.android.studio,30,1735941084,1735941114,1735941114.846843,-21600,,
com.apple.dt.Xcode,1,1735941083,1735941084,1735941084.503087,-21600,,
com.google.android.studio,10,1735941073,1735941083,1735941083.405067,-21600,,
com.apple.dt.Xcode,1,1735941072,1735941073,1735941073.644654,-21600,,
com.google.android.studio,10,1735941062,1735941072,1735941072.293431,-21600,,
com.apple.dt.Xcode,1,1735941061,1735941062,1735941063.008913,-21600,,
com.google.android.studio,43,1735941018,1735941061,1735941061.722779,-21600,,
com.apple.dt.Xcode,5,1735941013,1735941018,1735941018.8567019,-21600,,
com.google.android.studio,9,1735941004,1735941013,1735941013.3298779,-21600,,
com.apple.dt.Xcode,2,1735941002,1735941004,1735941004.727912,-21600,,
com.google.android.studio,9,1735940993,1735941002,1735941002.982796,-21600,,
com.apple.dt.Xcode,17,1735940976,1735940993,1735940993.495504,-21600,,
com.google.android.studio,24,1735940952,1735940976,1735940976.768337,-21600,,
com.apple.dt.Xcode,18,1735940934,1735940952,1735940952.856491,-21600,,
com.google.android.studio,13,1735940921,1735940934,1735940934.139454,-21600,,
com.apple.dt.Xcode,3,1735940918,1735940921,1735940921.1919088,-21600,,
com.google.android.studio,19,1735940899,1735940918,1735940918.935429,-21600,,
com.apple.dt.Xcode,1,1735940898,1735940899,1735940899.082881,-21600,,
com.google.android.studio,2,1735940896,1735940898,1735940898.3466868,-21600,,
com.apple.dt.Xcode,1,1735940895,1735940896,1735940896.148541,-21600,,
com.google.android.studio,7,1735940888,1735940895,1735940895.3425798,-21600,,
com.apple.dt.Xcode,143,1735940745,1735940888,1735940888.556618,-21600,,
com.google.android.studio,3,1735940742,1735940745,1735940745.046593,-21600,,
com.apple.dt.Xcode,1,1735940741,1735940742,1735940742.23383,-21600,,
com.google.android.studio,2,1735940739,1735940741,1735940741.6045032,-21600,,
com.apple.dt.Xcode,2,1735940737,1735940739,1735940739.58701,-21600,,
com.google.android.studio,15,1735940722,1735940737,1735940737.750208,-21600,,
com.apple.dt.Xcode,1,1735940721,1735940722,1735940722.284317,-21600,,
com.google.android.studio,3,1735940718,1735940721,1735940721.093358,-21600,,
com.apple.dt.Xcode,1,1735940717,1735940718,1735940718.758947,-21600,,
com.google.android.studio,5,1735940712,1735940717,1735940717.501734,-21600,,
com.apple.dt.Xcode,1,1735940711,1735940712,1735940712.779605,-21600,,
com.google.android.studio,18,1735940693,1735940711,1735940711.546298,-21600,,
com.apple.dt.Xcode,1,1735940692,1735940693,1735940693.7076468,-21600,,
com.google.android.studio,3,1735940689,1735940692,1735940692.566719,-21600,,
com.apple.dt.Xcode,1,1735940688,1735940689,1735940689.5225658,-21600,,
com.google.android.studio,3,1735940685,1735940688,1735940688.595546,-21600,,
com.apple.dt.Xcode,14,1735940671,1735940685,1735940685.3151212,-21600,,
com.google.android.studio,6,1735940665,1735940671,1735940671.1755729,-21600,,
com.apple.dt.Xcode,3,1735940662,1735940665,1735940665.0554972,-21600,,
com.google.android.studio,3,1735940659,1735940662,1735940662.723618,-21600,,
com.apple.dt.Xcode,1,1735940658,1735940659,1735940659.9823132,-21600,,
com.google.android.studio,2,1735940656,1735940658,1735940658.7717838,-21600,,
com.apple.dt.Xcode,2,1735940654,1735940656,1735940656.740409,-21600,,
com.google.android.studio,2,1735940652,1735940654,1735940654.968563,-21600,,
com.apple.dt.Xcode,3,1735940649,1735940652,1735940652.493228,-21600,,
com.google.android.studio,4,1735940645,1735940649,1735940649.086131,-21600,,
com.apple.dt.Xcode,1,1735940644,1735940645,1735940645.903564,-21600,,
com.google.android.studio,10,1735940634,1735940644,1735940644.110268,-21600,,
com.apple.dt.Xcode,1,1735940633,1735940634,1735940635.048685,-21600,,
com.google.android.studio,11,1735940622,1735940633,1735940633.511537,-21600,,
com.apple.dt.Xcode,9,1735940613,1735940622,1735940622.7067618,-21600,,
com.google.android.studio,5,1735940608,1735940613,1735940613.646123,-21600,,
com.apple.dt.Xcode,1,1735940607,1735940608,1735940608.6776361,-21600,,
com.google.android.studio,2,1735940605,1735940607,1735940607.457075,-21600,,
com.apple.dt.Xcode,2,1735940603,1735940605,1735940605.571533,-21600,,
com.google.android.studio,3,1735940600,1735940603,1735940603.290689,-21600,,
com.apple.dt.Xcode,2,1735940598,1735940600,1735940600.833586,-21600,,
com.google.android.studio,7,1735940591,1735940598,1735940598.7988272,-21600,,
com.apple.dt.Xcode,1,1735940590,1735940591,1735940591.339895,-21600,,
com.google.android.studio,4,1735940586,1735940590,1735940590.542182,-21600,,
com.apple.dt.Xcode,1,1735940585,1735940586,1735940586.9293308,-21600,,
com.google.android.studio,2,1735940583,1735940585,1735940585.647801,-21600,,
com.apple.dt.Xcode,1,1735940582,1735940583,1735940583.529712,-21600,,
com.google.android.studio,4,1735940578,1735940582,1735940582.059747,-21600,,
com.apple.dt.Xcode,7,1735940571,1735940578,1735940578.304494,-21600,,
com.google.android.studio,2,1735940569,1735940571,1735940571.491595,-21600,,
com.apple.dt.Xcode,1,1735940568,1735940569,1735940569.082209,-21600,,
com.google.android.studio,0,1735940568,1735940568,1735940568.541647,-21600,,
com.apple.dt.Xcode,2,1735940566,1735940568,1735940568.2616348,-21600,,
com.google.android.studio,2,1735940564,1735940566,1735940566.982664,-21600,,
com.apple.dt.Xcode,2,1735940562,1735940564,1735940564.566097,-21600,,
com.google.android.studio,10,1735940552,1735940562,1735940562.4992142,-21600,,
com.apple.dt.Xcode,1,1735940551,1735940552,1735940552.707623,-21600,,
com.google.android.studio,6,1735940545,1735940551,1735940551.183649,-21600,,
com.apple.dt.Xcode,0,1735940545,1735940545,1735940545.877876,-21600,,
com.google.android.studio,10,1735940535,1735940545,1735940545.387543,-21600,,
com.apple.dt.Xcode,1,1735940534,1735940535,1735940535.330123,-21600,,
com.google.android.studio,3,1735940531,1735940534,1735940534.0402741,-21600,,
com.apple.dt.Xcode,2,1735940529,1735940531,1735940531.52297,-21600,,
com.google.android.studio,2,1735940527,1735940529,1735940529.605711,-21600,,
com.apple.dt.Xcode,1,1735940526,1735940527,1735940527.336833,-21600,,
com.google.android.studio,19,1735940507,1735940526,1735940526.345418,-21600,,
com.apple.dt.Xcode,1,1735940506,1735940507,1735940507.649868,-21600,,
com.google.android.studio,13,1735940493,1735940506,1735940506.139642,-21600,,
com.apple.dt.Xcode,2,1735940491,1735940493,1735940493.4341002,-21600,,
com.google.android.studio,2,1735940489,1735940491,1735940491.951188,-21600,,
com.apple.dt.Xcode,1,1735940488,1735940489,1735940489.439447,-21600,,
com.google.android.studio,5,1735940483,1735940488,1735940488.0612779,-21600,,
com.apple.dt.Xcode,1,1735940482,1735940483,1735940483.9070768,-21600,,
com.google.android.studio,3,1735940479,1735940482,1735940482.640883,-21600,,
com.apple.dt.Xcode,1,1735940478,1735940479,1735940479.7950501,-21600,,
com.google.android.studio,3,1735940475,1735940478,1735940478.553736,-21600,,
com.apple.dt.Xcode,1,1735940474,1735940475,1735940475.999882,-21600,,
com.google.android.studio,3,1735940471,1735940474,1735940474.634152,-21600,,
com.apple.dt.Xcode,1,1735940470,1735940471,1735940471.468131,-21600,,
com.google.android.studio,9,1735940461,1735940470,1735940470.211896,-21600,,
com.apple.dt.Xcode,4,1735940457,1735940461,1735940461.706537,-21600,,
com.google.Chrome,1,1735940456,1735940457,1735940457.8589458,-21600,,
com.google.android.studio,16,1735940440,1735940456,1735940456.789452,-21600,,
com.google.Chrome,1,1735940439,1735940440,1735940440.698065,-21600,,
com.apple.dt.Xcode,1,1735940438,1735940439,1735940439.16239,-21600,,
com.google.Chrome,3,1735940435,1735940438,1735940438.213027,-21600,,
com.apple.dt.Xcode,2,1735940433,1735940435,1735940435.077921,-21600,,
com.google.android.studio,90,1735940343,1735940433,1735940433.771404,-21600,,
com.apple.dt.Xcode,1,1735940342,1735940343,1735940344.020877,-21600,,
com.google.Chrome,23,1735940319,1735940342,1735940342.157784,-21600,,
com.apple.dt.Xcode,0,1735940319,1735940319,1735940319.986243,-21600,,
com.google.android.studio,55,1735940264,1735940319,1735940319.158844,-21600,,
com.apple.dt.Xcode,1,1735940263,1735940264,1735940265.0103312,-21600,,
com.google.android.studio,2,1735940261,1735940263,1735940263.688579,-21600,,
com.apple.dt.Xcode,1,1735940260,1735940261,1735940261.289418,-21600,,
com.google.android.studio,11,1735940249,1735940260,1735940260.510807,-21600,,
com.apple.dt.Xcode,1,1735940248,1735940249,1735940249.261613,-21600,,
com.google.android.studio,4,1735940244,1735940248,1735940248.57273,-21600,,
com.apple.dt.Xcode,1,1735940243,1735940244,1735940244.6405392,-21600,,
com.google.android.studio,4,1735940239,1735940243,1735940243.661525,-21600,,
com.apple.dt.Xcode,1,1735940238,1735940239,1735940239.589997,-21600,,
com.google.android.studio,6,1735940232,1735940238,1735940238.4823608,-21600,,
com.google.Chrome,8,1735940224,1735940232,1735940232.880437,-21600,,
com.google.android.studio,10,1735940214,1735940224,1735940224.114314,-21600,,
com.google.Chrome,9,1735940205,1735940214,1735940214.1121879,-21600,,
com.google.android.studio,2,1735940203,1735940205,1735940205.162012,-21600,,
com.apple.dt.Xcode,6,1735940197,1735940203,1735940203.731854,-21600,,
com.google.android.studio,2,1735940195,1735940197,1735940197.978598,-21600,,
com.google.Chrome,11,1735940184,1735940195,1735940195.676846,-21600,,
com.google.android.studio,22,1735940162,1735940184,1735940184.457059,-21600,,
com.apple.dt.Xcode,3,1735940159,1735940162,1735940162.640311,-21600,,
com.google.android.studio,5,1735940154,1735940159,1735940159.9318419,-21600,,
com.apple.dt.Xcode,4,1735940150,1735940154,1735940154.961559,-21600,,
com.google.android.studio,9,1735940141,1735940150,1735940150.505496,-21600,,
com.apple.dt.Xcode,1,1735940140,1735940141,1735940141.63147,-21600,,
com.google.android.studio,4,1735940136,1735940140,1735940140.245726,-21600,,
com.apple.dt.Xcode,1,1735940135,1735940136,1735940136.4579592,-21600,,
com.google.android.studio,5,1735940130,1735940135,1735940135.2569652,-21600,,
com.apple.dt.Xcode,1,1735940129,1735940130,1735940130.4721131,-21600,,
com.google.android.studio,2,1735940127,1735940129,1735940129.220468,-21600,,
com.apple.dt.Xcode,1,1735940126,1735940127,1735940127.669773,-21600,,
com.google.android.studio,2,1735940124,1735940126,1735940126.273272,-21600,,
com.apple.dt.Xcode,5,1735940119,1735940124,1735940124.87781,-21600,,
com.google.android.studio,15,1735940104,1735940119,1735940119.371341,-21600,,
com.apple.dt.Xcode,7,1735940097,1735940104,1735940104.760219,-21600,,
com.google.android.studio,5,1735940092,1735940097,1735940097.588723,-21600,,
com.apple.dt.Xcode,8,1735940084,1735940092,1735940092.5610561,-21600,,
com.google.android.studio,1,1735940083,1735940084,1735940084.395035,-21600,,
com.apple.dt.Xcode,11,1735940072,1735940083,1735940083.3031301,-21600,,
com.google.android.studio,2,1735940070,1735940072,1735940072.130281,-21600,,
com.apple.dt.Xcode,3,1735940067,1735940070,1735940070.91179,-21600,,
com.google.android.studio,1,1735940066,1735940067,1735940067.690847,-21600,,
com.leomehlig.today,42,1735940024,1735940066,1735940066.547378,-21600,,
com.google.android.studio,3,1735940021,1735940024,1735940024.330328,-21600,,
com.google.Chrome,1,1735940020,1735940021,1735940021.407292,-21600,,
com.google.android.studio,35,1735939985,1735940020,1735940020.6445189,-21600,,
com.google.Chrome,59,1735939926,1735939985,1735939985.44439,-21600,,
com.google.android.studio,36,1735939890,1735939926,1735939926.467634,-21600,,
com.apple.dt.Xcode,4,1735939886,1735939890,1735939890.336184,-21600,,
com.google.android.studio,22,1735939864,1735939886,1735939886.671031,-21600,,
com.apple.dt.Xcode,2,1735939862,1735939864,1735939864.324167,-21600,,
com.google.android.studio,2,1735939860,1735939862,1735939862.844913,-21600,,
com.apple.dt.Xcode,28,1735939832,1735939860,1735939860.1997042,-21600,,
com.google.android.studio,16,1735939816,1735939832,1735939832.503549,-21600,,
com.apple.dt.Xcode,8,1735939808,1735939816,1735939816.7702,-21600,,
com.google.android.studio,20,1735939788,1735939808,1735939808.089971,-21600,,
com.google.Chrome,9,1735939779,1735939788,1735939788.41999,-21600,,
com.google.Chrome,565,1735939159,1735939724,1735939724.961369,-21600,,
com.apple.iCal,36,1735939123,1735939159,1735939159.5310512,-21600,,
com.google.Chrome,760,1735938363,1735939123,1735939123.252393,-21600,,
com.google.android.studio,15,1735938348,1735938363,1735938363.5803208,-21600,,
com.google.android.studio,314,1735931692,1735932006,1735932006.422487,-21600,,
com.apple.dt.Xcode,24,1735931668,1735931692,1735931692.2038279,-21600,,
com.google.android.studio,8,1735931660,1735931668,1735931668.314018,-21600,,
com.microsoft.onenote.mac,10,1735931650,1735931660,1735931660.875761,-21600,,
com.google.Chrome,20,1735931630,1735931650,1735931650.949064,-21600,,
com.google.Chrome,402,1735924098,1735924500,1735924500.84748,-21600,,
com.leomehlig.today,27,1735924071,1735924098,1735924098.5683599,-21600,,
com.google.Chrome,2,1735924069,1735924071,1735924071.199469,-21600,,
com.apple.Music,6,1735924063,1735924069,1735924070.0642262,-21600,,
com.apple.Music,11,1735864653,1735864664,1735864665.1486049,-21600,,
com.google.Chrome,75,1735864578,1735864653,1735864653.868845,-21600,,
com.apple.Music,34,1735864544,1735864578,1735864578.8663259,-21600,,
com.google.Chrome,1,1735864543,1735864544,1735864545.000852,-21600,,
com.apple.Music,40,1735864503,1735864543,1735864543.42727,-21600,,
com.google.Chrome,142,1735864361,1735864503,1735864503.54031,-21600,,
com.apple.Music,27,1735864334,1735864361,1735864361.622642,-21600,,
com.google.Chrome,490,1735863844,1735864334,1735864334.7624621,-21600,,
com.apple.Music,3,1735863841,1735863844,1735863844.791504,-21600,,
com.google.Chrome,47,1735863794,1735863841,1735863841.2297401,-21600,,
com.apple.Music,19,1735863775,1735863794,1735863794.330138,-21600,,
com.google.Chrome,83,1735863692,1735863775,1735863775.977827,-21600,,
com.apple.iCal,37,1735863655,1735863692,1735863692.368974,-21600,,
com.apple.Music,1,1735863654,1735863655,1735863655.273938,-21600,,
com.microsoft.onenote.mac,11,1735863643,1735863654,1735863654.155612,-21600,,
com.apple.Music,1,1735863642,1735863643,1735863643.0519938,-21600,,
com.microsoft.VSCode,1,1735863641,1735863642,1735863642.726622,-21600,,
com.apple.Music,2,1735863639,1735863641,1735863641.263461,-21600,,
com.apple.Terminal,5,1735863634,1735863639,1735863639.805997,-21600,,
com.apple.Music,1,1735863633,1735863634,1735863634.718826,-21600,,
com.apple.MobileSMS,3,1735863630,1735863633,1735863633.2174978,-21600,,
com.apple.Music,23,1735863607,1735863630,1735863630.253623,-21600,,
com.apple.Music,338,1735863250,1735863588,1735863588.06536,-21600,,
com.apple.Music,244,1735859331,1735859575,1735859576.218641,-21600,,
com.google.Chrome,100,1735859231,1735859331,1735859331.906131,-21600,,
com.apple.finder,1,1735859230,1735859231,1735859231.3470678,-21600,,
com.apple.finder,353,1735858866,1735859219,1735859219.371962,-21600,,
com.microsoft.VSCode,31,1735858835,1735858866,1735858866.738381,-21600,,
com.apple.finder,25,1735858810,1735858835,1735858835.8822331,-21600,,
com.microsoft.VSCode,73,1735858737,1735858810,1735858810.6106281,-21600,,
com.apple.Music,13,1735858724,1735858737,1735858737.422286,-21600,,
com.apple.MobileSMS,66,1735858658,1735858724,1735858724.888332,-21600,,
com.apple.Music,5,1735858653,1735858658,1735858658.124858,-21600,,
com.microsoft.VSCode,621,1735858032,1735858653,1735858653.278166,-21600,,
com.apple.Music,43,1735857989,1735858032,1735858032.583772,-21600,,
com.microsoft.VSCode,355,1735857634,1735857989,1735857989.558203,-21600,,
com.apple.Music,29,1735857605,1735857634,1735857634.969818,-21600,,
com.microsoft.VSCode,36,1735857569,1735857605,1735857605.344561,-21600,,
com.apple.finder,10,1735857559,1735857569,1735857569.33464,-21600,,
com.microsoft.VSCode,0,1735857559,1735857559,1735857559.915173,-21600,,
com.apple.Music,1,1735857558,1735857559,1735857559.111403,-21600,,
com.microsoft.VSCode,30,1735857528,1735857558,1735857558.332715,-21600,,
com.apple.Music,4,1735857524,1735857528,1735857528.196707,-21600,,
com.microsoft.Excel,387,1735857137,1735857524,1735857524.815012,-21600,,
com.apple.Music,4,1735857133,1735857137,1735857137.394637,-21600,,
com.microsoft.Excel,756,1735856377,1735857133,1735857133.835856,-21600,,
com.apple.Music,3,1735856374,1735856377,1735856377.257327,-21600,,
com.microsoft.Excel,101,1735856273,1735856374,1735856374.940844,-21600,,
com.apple.finder,10,1735856138,1735856148,1735856148.970173,-21600,,
com.microsoft.Excel,7,1735856131,1735856138,1735856138.272788,-21600,,
com.google.Chrome,115,1735856016,1735856131,1735856131.0795,-21600,,
com.apple.Music,4,1735856012,1735856016,1735856016.350309,-21600,,
com.google.Chrome,333,1735855679,1735856012,1735856012.306948,-21600,,
com.apple.Music,6,1735855673,1735855679,1735855679.6292481,-21600,,
com.google.Chrome,1,1735855672,1735855673,1735855673.0528011,-21600,,
com.apple.Music,1,1735855671,1735855672,1735855672.661361,-21600,,
com.apple.finder,2,1735855669,1735855671,1735855671.7743878,-21600,,
com.google.Chrome,107,1735855562,1735855669,1735855669.554431,-21600,,
com.apple.finder,6,1735855556,1735855562,1735855562.498557,-21600,,
com.google.Chrome,84,1735855472,1735855556,1735855556.710429,-21600,,
com.apple.Music,2,1735855470,1735855472,1735855472.107264,-21600,,
com.google.Chrome,57,1735855413,1735855470,1735855470.7016358,-21600,,
com.apple.Music,76,1735855337,1735855413,1735855413.773196,-21600,,
com.google.Chrome,172,1735855165,1735855337,1735855337.092782,-21600,,
com.apple.Music,264,1735854901,1735855165,1735855165.107619,-21600,,
com.google.Chrome,23,1735854878,1735854901,1735854901.899057,-21600,,
com.microsoft.Excel,4,1735854874,1735854878,1735854878.127007,-21600,,
com.microsoft.Excel,2011,1735841046,1735843057,1735843057.1182299,-21600,,
com.apple.finder,22,1735841024,1735841046,1735841046.135844,-21600,,
com.google.Chrome,5,1735841019,1735841024,1735841024.898264,-21600,,
com.apple.finder,1,1735841018,1735841019,1735841020.003901,-21600,,
com.cisco.secureclient.gui,5,1735841013,1735841018,1735841018.9487529,-21600,,
com.apple.Terminal,8,1735841005,1735841013,1735841013.639982,-21600,,
com.cisco.secureclient.gui,6,1735840999,1735841005,1735841005.84741,-21600,,
software.pleiades.PixInsight,65,1735840934,1735840999,1735840999.257643,-21600,,
com.apple.finder,1,1735840933,1735840934,1735840934.579612,-21600,,
software.pleiades.PixInsight,2,1735840931,1735840933,1735840933.2208629,-21600,,
com.microsoft.rdc.macos,23,1735840908,1735840931,1735840931.611767,-21600,,
com.apple.finder,8,1735840900,1735840908,1735840908.183939,-21600,,
com.electron.carta,70,1735840830,1735840900,1735840900.948917,-21600,,
com.apple.finder,11,1735840819,1735840830,1735840830.074421,-21600,,
com.apple.Terminal,21,1735840798,1735840819,1735840819.7287688,-21600,,
com.google.Chrome,30,1735840768,1735840798,1735840798.477602,-21600,,
com.apple.Terminal,2,1735840766,1735840768,1735840768.125663,-21600,,
com.google.Chrome,37,1735840729,1735840766,1735840766.680587,-21600,,
com.apple.Terminal,10,1735840719,1735840729,1735840729.655116,-21600,,
com.google.Chrome,16,1735840703,1735840719,1735840719.6301122,-21600,,
com.apple.Terminal,66,1735840637,1735840703,1735840703.709076,-21600,,
com.microsoft.rdc.macos,5,1735840632,1735840637,1735840638.007821,-21600,,
com.apple.Terminal,3,1735840629,1735840632,1735840632.2498012,-21600,,
com.microsoft.rdc.macos,1,1735840628,1735840629,1735840629.800262,-21600,,
com.apple.Terminal,2,1735840626,1735840628,1735840628.5989661,-21600,,
com.microsoft.rdc.macos,1,1735840625,1735840626,1735840626.593728,-21600,,
com.apple.Terminal,3,1735840622,1735840625,1735840625.036559,-21600,,
com.microsoft.rdc.macos,1,1735840621,1735840622,1735840622.8170118,-21600,,
com.apple.Terminal,1,1735840620,1735840621,1735840621.337593,-21600,,
com.microsoft.rdc.macos,2,1735840618,1735840620,1735840620.0898008,-21600,,
com.apple.Terminal,1,1735840617,1735840618,1735840618.7487822,-21600,,
com.microsoft.rdc.macos,2,1735840615,1735840617,1735840617.129106,-21600,,
com.apple.Terminal,6,1735840609,1735840615,1735840615.4627252,-21600,,
com.microsoft.rdc.macos,9,1735840600,1735840609,1735840609.613167,-21600,,
com.apple.Terminal,9,1735840591,1735840600,1735840600.205579,-21600,,
com.microsoft.rdc.macos,4,1735840587,1735840591,1735840591.693244,-21600,,
com.apple.Terminal,13,1735840574,1735840587,1735840587.7013159,-21600,,
com.microsoft.rdc.macos,25,1735840549,1735840574,1735840574.178873,-21600,,
com.apple.Terminal,25,1735840524,1735840549,1735840549.9296389,-21600,,
com.microsoft.rdc.macos,10,1735840514,1735840524,1735840524.232955,-21600,,
com.apple.Terminal,8,1735840506,1735840514,1735840514.715852,-21600,,
com.microsoft.rdc.macos,9,1735840497,1735840506,1735840506.697146,-21600,,
com.apple.Terminal,23,1735840474,1735840497,1735840498.057101,-21600,,
com.microsoft.rdc.macos,2,1735840472,1735840474,1735840474.790082,-21600,,
com.apple.Terminal,8,1735840464,1735840472,1735840472.409944,-21600,,
com.microsoft.rdc.macos,8,1735840456,1735840464,1735840464.59058,-21600,,
com.apple.Terminal,26,1735840430,1735840456,1735840456.786993,-21600,,
com.microsoft.rdc.macos,254,1735840176,1735840430,1735840430.446402,-21600,,
com.leomehlig.today,15,1735840161,1735840176,1735840176.102628,-21600,,
com.cisco.secureclient.gui,37,1735840124,1735840161,1735840161.218132,-21600,,
com.leomehlig.today,8,1735840116,1735840124,1735840124.598384,-21600,,
com.leomehlig.today,65,1735838145,1735838210,1735838210.9509249,-21600,,
com.google.Chrome,28,1735838117,1735838145,1735838145.322166,-21600,,
com.google.Chrome,16,1735833878,1735833894,1735833894.451342,-21600,,
com.apple.finder,3,1735833875,1735833878,1735833878.2803578,-21600,,
com.electron.carta,5,1735833870,1735833875,1735833875.560093,-21600,,
com.apple.finder,7,1735833863,1735833870,1735833870.865625,-21600,,
com.electron.carta,36,1735833827,1735833863,1735833863.894336,-21600,,
com.apple.finder,24,1735833795,1735833819,1735833819.802927,-21600,,
com.google.Chrome,9,1735833786,1735833795,1735833795.49012,-21600,,
com.apple.finder,9,1735833777,1735833786,1735833786.253986,-21600,,
com.google.Chrome,18,1735833759,1735833777,1735833777.4076428,-21600,,
com.apple.Terminal,15,1735833744,1735833759,1735833759.057771,-21600,,
com.google.Chrome,13,1735833731,1735833744,1735833744.873897,-21600,,
com.apple.Terminal,2,1735833729,1735833731,1735833732.005542,-21600,,
com.google.Chrome,16,1735833713,1735833729,1735833729.333657,-21600,,
com.apple.Terminal,58,1735833655,1735833713,1735833713.744571,-21600,,
com.google.Chrome,90,1735833565,1735833655,1735833655.080089,-21600,,
com.apple.Preview,144,1735833421,1735833565,1735833565.4957318,-21600,,
com.apple.finder,10,1735833411,1735833421,1735833421.0725288,-21600,,
com.google.Chrome,17,1735833394,1735833411,1735833411.6832619,-21600,,
com.google.Chrome,807,1735764401,1735765208,1735765208.189238,-21600,,
com.google.Chrome,455,1735763618,1735764073,1735764073.516123,-21600,,
com.google.Chrome,464,1735762846,1735763310,1735763310.997229,-21600,,
com.google.Chrome,346,1735762400,1735762746,1735762746.071159,-21600,,
com.google.Chrome,303,1735762064,1735762367,1735762367.218124,-21600,,
com.google.Chrome,465,1735761243,1735761708,1735761708.126529,-21600,,
com.google.Chrome,386,1735760678,1735761064,1735761064.986267,-21600,,
com.google.Chrome,305,1735760125,1735760430,1735760430.2187052,-21600,,
com.google.Chrome,556,1735759430,1735759986,1735759986.065024,-21600,,
com.google.Chrome,43,1735755978,1735756021,1735756021.809435,-21600,,
com.google.Chrome,301,1735755654,1735755955,1735755955.693893,-21600,,
com.google.Chrome,716,1735754391,1735755107,1735755107.682962,-21600,,
com.apple.finder,3,1735754388,1735754391,1735754393.58165,-21600,,
com.apple.finder,338,1735751437,1735751775,1735751775.305632,-21600,,
com.cisco.secureclient.gui,11,1735751426,1735751437,1735751437.2071052,-21600,,
com.apple.finder,102,1735751324,1735751426,1735751426.8531451,-21600,,
com.apple.Terminal,131,1735751193,1735751324,1735751324.248157,-21600,,
com.apple.finder,3,1735751190,1735751193,1735751193.957078,-21600,,
com.cisco.secureclient.gui,31,1735751159,1735751190,1735751190.5086532,-21600,,
com.google.Chrome,90,1735751069,1735751159,1735751159.3891401,-21600,,
com.google.Chrome,1081,1735691147,1735692228,1735692228.828699,-21600,,
com.google.Chrome,10,1735690458,1735690468,1735690468.9440842,-21600,,
com.microsoft.onenote.mac,71,1735690387,1735690458,1735690458.4745,-21600,,
com.google.Chrome,557,1735689830,1735690387,1735690387.869904,-21600,,
com.google.Chrome,486,1735689206,1735689692,1735689692.832977,-21600,,
com.google.Chrome,1090,1735687917,1735689007,1735689007.7946072,-21600,,
com.google.Chrome,300,1735687614,1735687914,1735687914.833921,-21600,,
com.google.Chrome,302,1735687270,1735687572,1735687572.987251,-21600,,
com.google.Chrome,476,1735686700,1735687176,1735687176.804986,-21600,,
com.google.Chrome,17,1735686481,1735686498,1735686498.4709148,-21600,,
com.google.Chrome,934,1735685482,1735686416,1735686416.056439,-21600,,
com.google.Chrome,371,1735684860,1735685231,1735685231.8403,-21600,,
com.google.Chrome,450,1735684245,1735684695,1735684695.095172,-21600,,
com.google.Chrome,300,1735683917,1735684217,1735684217.8818932,-21600,,
com.google.Chrome,306,1735683605,1735683911,1735683911.8433728,-21600,,
com.google.Chrome,640,1735682888,1735683528,1735683528.940934,-21600,,
com.google.Chrome,383,1735681989,1735682372,1735682372.649891,-21600,,
com.leomehlig.today,3,1735681986,1735681989,1735681989.855592,-21600,,
com.apple.weather,4,1735673985,1735673989,1735673989.328195,-21600,EB445137-D7F5-57EC-87DA-1DB460D64046,"iPhone13,2"
com.apple.weather,7,1735673738,1735673745,1735673745.492049,-21600,EB445137-D7F5-57EC-87DA-1DB460D64046,"iPhone13,2"
com.facebook.Facebook,50,1735672039,1735672089,1735672089.804498,-21600,EB445137-D7F5-57EC-87DA-1DB460D64046,"iPhone13,2"
com.apple.mobileslideshow,2,1735672035,1735672037,1735672037.843503,-21600,EB445137-D7F5-57EC-87DA-1DB460D64046,"iPhone13,2"
com.hammerandchisel.discord,17,1735671204,1735671221,1735671221.226857,-21600,EB445137-D7F5-57EC-87DA-1DB460D64046,"iPhone13,2"
com.hammerandchisel.discord,58,1735668302,1735668360,1735668360.172653,-21600,EB445137-D7F5-57EC-87DA-1DB460D64046,"iPhone13,2"
com.apple.MobileSMS,2,1735668299,1735668301,1735668301.4977942,-21600,EB445137-D7F5-57EC-87DA-1DB460D64046,"iPhone13,2"
com.apple.MobileSMS,2,1735667433,1735667435,1735667435.816599,-21600,EB445137-D7F5-57EC-87DA-1DB460D64046,"iPhone13,2"
com.leomehlig.today,35,1735666333,1735666368,1735666368.737508,-21600,,
com.microsoft.onenote.mac,6,1735666327,1735666333,1735666333.356139,-21600,,
com.google.Chrome,48,1735666279,1735666327,1735666328.5943651,-21600,,
com.microsoft.onenote.mac,6,1735666273,1735666279,1735666279.353452,-21600,,
com.google.Chrome,6,1735666267,1735666273,1735666273.960009,-21600,,
com.microsoft.onenote.mac,2,1735666265,1735666267,1735666267.568169,-21600,,
com.google.Chrome,43,1735666222,1735666265,1735666265.613445,-21600,,
com.microsoft.onenote.mac,14,1735666208,1735666222,1735666222.748725,-21600,,
com.google.Chrome,118,1735666090,1735666208,1735666209.044571,-21600,,
com.microsoft.onenote.mac,1,1735666089,1735666090,1735666090.149506,-21600,,
com.google.Chrome,5,1735666084,1735666089,1735666089.050706,-21600,,
com.microsoft.onenote.mac,1,1735666083,1735666084,1735666084.429369,-21600,,
com.google.Chrome,2,1735666081,1735666083,1735666083.5375729,-21600,,
com.microsoft.onenote.mac,1,1735666080,1735666081,1735666081.9798698,-21600,,
com.google.Chrome,4,1735666076,1735666080,1735666080.8203921,-21600,,
com.microsoft.onenote.mac,2,1735666074,1735666076,1735666076.498425,-21600,,
com.google.Chrome,12,1735666062,1735666074,1735666074.966124,-21600,,
com.microsoft.onenote.mac,1,1735666061,1735666062,1735666062.94166,-21600,,
com.google.Chrome,17,1735666044,1735666061,1735666061.209367,-21600,,
com.microsoft.onenote.mac,5,1735666039,1735666044,1735666044.45828,-21600,,
com.google.Chrome,466,1735665573,1735666039,1735666039.793829,-21600,,
com.microsoft.onenote.mac,12,1735665561,1735665573,1735665573.3678908,-21600,,
com.google.Chrome,51,1735665510,1735665561,1735665561.0746799,-21600,,
com.microsoft.onenote.mac,11,1735665499,1735665510,1735665510.088282,-21600,,
com.google.Chrome,407,1735665092,1735665499,1735665499.202091,-21600,,
com.microsoft.onenote.mac,1,1735665091,1735665092,1735665092.586162,-21600,,
com.google.Chrome,4,1735665087,1735665091,1735665091.140232,-21600,,
com.microsoft.onenote.mac,20,1735665067,1735665087,1735665087.471232,-21600,,
com.google.Chrome,150,1735664917,1735665067,1735665067.143835,-21600,,
com.apple.MobileSMS,1,1735664916,1735664917,1735664917.220387,-21600,,
com.google.Chrome,19,1735664897,1735664916,1735664916.452229,-21600,,
com.apple.MobileSMS,11,1735664886,1735664897,1735664897.122201,-21600,,
com.google.Chrome,138,1735664748,1735664886,1735664886.65745,-21600,,
com.apple.MobileSMS,5,1735664743,1735664748,1735664748.700933,-21600,,
com.google.Chrome,5,1735664738,1735664743,1735664743.815596,-21600,,
com.apple.MobileSMS,57,1735664642,1735664699,1735664699.6486812,-21600,EB445137-D7F5-57EC-87DA-1DB460D64046,"iPhone13,2"
com.renpho.health,5,1735664637,1735664642,1735664643.320977,-21600,EB445137-D7F5-57EC-87DA-1DB460D64046,"iPhone13,2"
com.renpho.health,10,1735664594,1735664604,1735664604.8667111,-21600,EB445137-D7F5-57EC-87DA-1DB460D64046,"iPhone13,2"
com.renpho.health,10,1735664474,1735664484,1735664484.848561,-21600,EB445137-D7F5-57EC-87DA-1DB460D64046,"iPhone13,2"
com.renpho.health,10,1735664354,1735664364,1735664364.8474278,-21600,EB445137-D7F5-57EC-87DA-1DB460D64046,"iPhone13,2"
com.renpho.health,10,1735664341,1735664351,1735664351.446641,-21600,EB445137-D7F5-57EC-87DA-1DB460D64046,"iPhone13,2"
com.renpho.health,21,1735664078,1735664099,1735664099.226645,-21600,EB445137-D7F5-57EC-87DA-1DB460D64046,"iPhone13,2"
com.apple.MobileSMS,15,1735664017,1735664032,1735664032.3910189,-21600,EB445137-D7F5-57EC-87DA-1DB460D64046,"iPhone13,2"
com.apple.findmy,1,1735664016,1735664017,1735664017.0649428,-21600,EB445137-D7F5-57EC-87DA-1DB460D64046,"iPhone13,2"
com.google.ios.youtube,966,1735661931,1735662897,1735662897.650192,-21600,EB445137-D7F5-57EC-87DA-1DB460D64046,"iPhone13,2"
com.apple.MobileSMS,92,1735661809,1735661901,1735661901.1431289,-21600,EB445137-D7F5-57EC-87DA-1DB460D64046,"iPhone13,2"
com.apple.findmy,7,1735661801,1735661808,1735661809.295748,-21600,EB445137-D7F5-57EC-87DA-1DB460D64046,"iPhone13,2"
com.apple.Health,9,1735661791,1735661800,1735661800.115288,-21600,EB445137-D7F5-57EC-87DA-1DB460D64046,"iPhone13,2"
com.apple.Health,6,1735661778,1735661784,1735661784.7756329,-21600,EB445137-D7F5-57EC-87DA-1DB460D64046,"iPhone13,2"
com.apple.Health,12,1735661288,1735661300,1735661300.8437119,-21600,EB445137-D7F5-57EC-87DA-1DB460D64046,"iPhone13,2"
com.apple.Health,6,1735660679,1735660685,1735660685.240014,-21600,EB445137-D7F5-57EC-87DA-1DB460D64046,"iPhone13,2"
com.apple.Health,12,1735660206,1735660218,1735660218.0392752,-21600,EB445137-D7F5-57EC-87DA-1DB460D64046,"iPhone13,2"
com.apple.Health,71,1735660029,1735660100,1735660100.1445231,-21600,EB445137-D7F5-57EC-87DA-1DB460D64046,"iPhone13,2"
com.apple.journal,1952,1735624538,1735626490,1735626490.157974,-21600,EB445137-D7F5-57EC-87DA-1DB460D64046,"iPhone13,2"
com.apple.Health,63,1735624471,1735624534,1735624534.6191878,-21600,EB445137-D7F5-57EC-87DA-1DB460D64046,"iPhone13,2"
com.apple.Health,67,1735624402,1735624469,1735624469.692922,-21600,EB445137-D7F5-57EC-87DA-1DB460D64046,"iPhone13,2"
com.apple.Music,11,1735624386,1735624397,1735624397.480517,-21600,EB445137-D7F5-57EC-87DA-1DB460D64046,"iPhone13,2"
com.apple.Music,1,1735624339,1735624340,1735624340.618221,-21600,EB445137-D7F5-57EC-87DA-1DB460D64046,"iPhone13,2"
com.apple.Music,6,1735624095,1735624101,1735624101.78983,-21600,EB445137-D7F5-57EC-87DA-1DB460D64046,"iPhone13,2"
com.apple.Music,8,1735623369,1735623377,1735623377.058248,-21600,EB445137-D7F5-57EC-87DA-1DB460D64046,"iPhone13,2"
com.apple.Music,10,1735623096,1735623106,1735623106.4385371,-21600,EB445137-D7F5-57EC-87DA-1DB460D64046,"iPhone13,2"
com.apple.Music,11,1735623082,1735623093,1735623093.881402,-21600,EB445137-D7F5-57EC-87DA-1DB460D64046,"iPhone13,2"
com.apple.Music,12,1735623058,1735623070,1735623070.830836,-21600,EB445137-D7F5-57EC-87DA-1DB460D64046,"iPhone13,2"
com.apple.Music,218,1735622837,1735623055,1735623055.5395942,-21600,EB445137-D7F5-57EC-87DA-1DB460D64046,"iPhone13,2"
com.apple.findmy,20,1735622702,1735622722,1735622722.4233031,-21600,EB445137-D7F5-57EC-87DA-1DB460D64046,"iPhone13,2"
com.burbn.instagram,4,1735622544,1735622548,1735622548.8279982,-21600,EB445137-D7F5-57EC-87DA-1DB460D64046,"iPhone13,2"
com.burbn.instagram,10,1735621948,1735621958,1735621958.7436619,-21600,EB445137-D7F5-57EC-87DA-1DB460D64046,"iPhone13,2"
com.burbn.instagram,47,1735621892,1735621939,1735621939.77557,-21600,EB445137-D7F5-57EC-87DA-1DB460D64046,"iPhone13,2"
com.toyopagroup.picaboo,33,1735621843,1735621876,1735621876.656183,-21600,EB445137-D7F5-57EC-87DA-1DB460D64046,"iPhone13,2"
Astrospheric.Astrospheric,27,1735621573,1735621600,1735621601.303561,-21600,EB445137-D7F5-57EC-87DA-1DB460D64046,"iPhone13,2"
com.apple.findmy,21,1735621534,1735621555,1735621555.772358,-21600,EB445137-D7F5-57EC-87DA-1DB460D64046,"iPhone13,2"
com.google.ios.youtube,1,1735621530,1735621531,1735621531.193472,-21600,EB445137-D7F5-57EC-87DA-1DB460D64046,"iPhone13,2"
com.google.Maps,5,1735621520,1735621525,1735621525.204434,-21600,EB445137-D7F5-57EC-87DA-1DB460D64046,"iPhone13,2"
com.google.Maps,69,1735619014,1735619083,1735619083.652051,-21600,EB445137-D7F5-57EC-87DA-1DB460D64046,"iPhone13,2"
com.apple.mobilecal,3,1735619009,1735619012,1735619012.411261,-21600,EB445137-D7F5-57EC-87DA-1DB460D64046,"iPhone13,2"
com.apple.mobilecal,2,1735613316,1735613318,1735613318.9082499,-21600,EB445137-D7F5-57EC-87DA-1DB460D64046,"iPhone13,2"
com.apple.mobilecal,2,1735613283,1735613285,1735613285.559531,-21600,EB445137-D7F5-57EC-87DA-1DB460D64046,"iPhone13,2"
com.apple.mobilecal,1,1735613271,1735613272,1735613272.74305,-21600,EB445137-D7F5-57EC-87DA-1DB460D64046,"iPhone13,2"
com.apple.mobilecal,11,1735613192,1735613203,1735613203.790456,-21600,EB445137-D7F5-57EC-87DA-1DB460D64046,"iPhone13,2"
com.apple.mobilecal,9,1735613181,1735613190,1735613190.191567,-21600,EB445137-D7F5-57EC-87DA-1DB460D64046,"iPhone13,2"
com.apple.camera,0,1735613181,1735613181,1735613181.729496,-21600,EB445137-D7F5-57EC-87DA-1DB460D64046,"iPhone13,2"
com.apple.mobilecal,97,1735613056,1735613153,1735613154.0824819,-21600,EB445137-D7F5-57EC-87DA-1DB460D64046,"iPhone13,2"
com.toyopagroup.picaboo,3,1735613045,1735613048,1735613048.378207,-21600,EB445137-D7F5-57EC-87DA-1DB460D64046,"iPhone13,2"
com.toyopagroup.picaboo,7,1735612426,1735612433,1735612433.9090152,-21600,EB445137-D7F5-57EC-87DA-1DB460D64046,"iPhone13,2"
com.apple.Maps,5,1735612421,1735612426,1735612426.226408,-21600,EB445137-D7F5-57EC-87DA-1DB460D64046,"iPhone13,2"
com.apple.Maps,0,1735612410,1735612410,1735612410.8156629,-21600,EB445137-D7F5-57EC-87DA-1DB460D64046,"iPhone13,2"
com.apple.Maps,2,1735612407,1735612409,1735612409.5592499,-21600,EB445137-D7F5-57EC-87DA-1DB460D64046,"iPhone13,2"
com.apple.Maps,2,1735606634,1735606636,1735606636.1816158,-21600,EB445137-D7F5-57EC-87DA-1DB460D64046,"iPhone13,2"
com.apple.Maps,6,1735606573,1735606579,1735606579.1525369,-21600,EB445137-D7F5-57EC-87DA-1DB460D64046,"iPhone13,2"
com.apple.Maps,30,1735606535,1735606565,1735606565.923466,-21600,EB445137-D7F5-57EC-87DA-1DB460D64046,"iPhone13,2"
com.apple.Maps,2,1735605656,1735605658,1735605658.975595,-21600,EB445137-D7F5-57EC-87DA-1DB460D64046,"iPhone13,2"
com.apple.Maps,5,1735604759,1735604764,1735604764.31911,-21600,EB445137-D7F5-57EC-87DA-1DB460D64046,"iPhone13,2"
com.apple.Maps,3,1735604460,1735604463,1735604463.290691,-21600,EB445137-D7F5-57EC-87DA-1DB460D64046,"iPhone13,2"
com.apple.Maps,42,1735604260,1735604302,1735604303.223333,-21600,EB445137-D7F5-57EC-87DA-1DB460D64046,"iPhone13,2"
com.apple.Maps,4,1735603756,1735603760,1735603760.669258,-21600,EB445137-D7F5-57EC-87DA-1DB460D64046,"iPhone13,2"
com.apple.Maps,10,1735603732,1735603742,1735603742.437074,-21600,EB445137-D7F5-57EC-87DA-1DB460D64046,"iPhone13,2"
com.apple.Maps,28,1735603614,1735603642,1735603642.8154821,-21600,EB445137-D7F5-57EC-87DA-1DB460D64046,"iPhone13,2"
com.facebook.Facebook,110,1735601875,1735601985,1735601985.899195,-21600,EB445137-D7F5-57EC-87DA-1DB460D64046,"iPhone13,2"
com.burbn.instagram,103,1735601768,1735601871,1735601871.8655682,-21600,EB445137-D7F5-57EC-87DA-1DB460D64046,"iPhone13,2"
com.apple.mobilecal,12,1735601199,1735601211,1735601211.521821,-21600,EB445137-D7F5-57EC-87DA-1DB460D64046,"iPhone13,2"
com.apple.news,43,1735601148,1735601191,1735601191.2378302,-21600,EB445137-D7F5-57EC-87DA-1DB460D64046,"iPhone13,2"
com.apple.news,146,1735600901,1735601047,1735601047.3200579,-21600,EB445137-D7F5-57EC-87DA-1DB460D64046,"iPhone13,2"
com.apple.Maps,3,1735600895,1735600898,1735600899.037002,-21600,EB445137-D7F5-57EC-87DA-1DB460D64046,"iPhone13,2"
com.apple.Maps,3,1735600787,1735600790,1735600790.1521711,-21600,EB445137-D7F5-57EC-87DA-1DB460D64046,"iPhone13,2"
com.apple.Maps,19,1735600549,1735600568,1735600568.089047,-21600,EB445137-D7F5-57EC-87DA-1DB460D64046,"iPhone13,2"
com.apple.news,2,1735600547,1735600549,1735600549.092098,-21600,EB445137-D7F5-57EC-87DA-1DB460D64046,"iPhone13,2"
com.apple.news,92,1735600397,1735600489,1735600489.163526,-21600,EB445137-D7F5-57EC-87DA-1DB460D64046,"iPhone13,2"
com.apple.MobileSMS,17,1735597182,1735597199,1735597199.572726,-21600,EB445137-D7F5-57EC-87DA-1DB460D64046,"iPhone13,2"
com.strava.stravaride,7,1735597175,1735597182,1735597182.273433,-21600,EB445137-D7F5-57EC-87DA-1DB460D64046,"iPhone13,2"
com.tinyspeck.chatlyio,13,1735597160,1735597173,1735597173.1327949,-21600,EB445137-D7F5-57EC-87DA-1DB460D64046,"iPhone13,2"
com.goodreads.Goodreads,71,1735596881,1735596952,1735596952.8170938,-21600,EB445137-D7F5-57EC-87DA-1DB460D64046,"iPhone13,2"
com.apple.news,51,1735596503,1735596554,1735596554.185916,-21600,EB445137-D7F5-57EC-87DA-1DB460D64046,"iPhone13,2"
com.apple.weather,7,1735596484,1735596491,1735596491.6100159,-21600,EB445137-D7F5-57EC-87DA-1DB460D64046,"iPhone13,2"
com.apple.weather,6,1735595976,1735595982,1735595982.898998,-21600,EB445137-D7F5-57EC-87DA-1DB460D64046,"iPhone13,2"
com.apple.weather,9,1735595966,1735595975,1735595975.318634,-21600,EB445137-D7F5-57EC-87DA-1DB460D64046,"iPhone13,2"
com.thestorygraph.thestorygraph,1,1735595965,1735595966,1735595966.735595,-21600,EB445137-D7F5-57EC-87DA-1DB460D64046,"iPhone13,2"
com.google.Chrome,177,1735595501,1735595678,1735595678.698824,-21600,,
com.microsoft.onenote.mac,8,1735595493,1735595501,1735595501.428699,-21600,,
com.google.Chrome,52,1735595441,1735595493,1735595493.211814,-21600,,
com.microsoft.onenote.mac,1,1735595440,1735595441,1735595441.8016171,-21600,,
com.google.Chrome,2,1735595438,1735595440,1735595440.931622,-21600,,
com.microsoft.onenote.mac,2,1735595436,1735595438,1735595438.6038551,-21600,,
com.google.Chrome,1,1735595435,1735595436,1735595436.981458,-21600,,
com.microsoft.onenote.mac,1,1735595434,1735595435,1735595435.4104872,-21600,,
com.google.Chrome,3,1735595431,1735595434,1735595434.3252568,-21600,,
com.microsoft.onenote.mac,1,1735595430,1735595431,1735595431.8103662,-21600,,
com.google.Chrome,12,1735595418,1735595430,1735595430.806466,-21600,,
com.microsoft.onenote.mac,6,1735595412,1735595418,1735595418.317666,-21600,,
com.google.Chrome,39,1735595373,1735595412,1735595412.141101,-21600,,
com.microsoft.onenote.mac,6,1735595367,1735595373,1735595373.5079,-21600,,
com.google.Chrome,116,1735595251,1735595367,1735595367.744734,-21600,,
com.microsoft.onenote.mac,8,1735595243,1735595251,1735595251.345576,-21600,,
com.google.Chrome,21,1735595222,1735595243,1735595243.985835,-21600,,
com.microsoft.onenote.mac,5,1735595217,1735595222,1735595222.6194649,-21600,,
com.google.Chrome,13,1735595204,1735595217,1735595217.421825,-21600,,
com.microsoft.onenote.mac,2,1735595202,1735595204,1735595204.101022,-21600,,
com.google.Chrome,5,1735595197,1735595202,1735595202.300315,-21600,,
com.microsoft.onenote.mac,1,1735595196,1735595197,1735595197.583136,-21600,,
com.google.Chrome,4,1735595192,1735595196,1735595196.385885,-21600,,
com.microsoft.onenote.mac,2,1735595190,1735595192,1735595192.555019,-21600,,
com.google.Chrome,5,1735595185,1735595190,1735595190.7514482,-21600,,
com.microsoft.onenote.mac,5,1735595180,1735595185,1735595185.721191,-21600,,
com.google.Chrome,15,1735595165,1735595180,1735595180.1344662,-21600,,
com.microsoft.onenote.mac,2,1735595163,1735595165,1735595165.265709,-21600,,
com.google.Chrome,3,1735595160,1735595163,1735595163.19333,-21600,,
com.microsoft.onenote.mac,2,1735595158,1735595160,1735595160.439725,-21600,,
com.google.Chrome,11,1735595147,1735595158,1735595158.1506329,-21600,,
com.microsoft.onenote.mac,4,1735595143,1735595147,1735595147.090942,-21600,,
com.google.Chrome,23,1735595120,1735595143,1735595143.2636971,-21600,,
com.microsoft.onenote.mac,6,1735595114,1735595120,1735595120.549113,-21600,,
com.google.Chrome,4,1735595110,1735595114,1735595114.038111,-21600,,
com.microsoft.onenote.mac,1,1735595109,1735595110,1735595110.672046,-21600,,
com.google.Chrome,1,1735595108,1735595109,1735595109.490237,-21600,,
com.microsoft.onenote.mac,5,1735595103,1735595108,1735595108.6835299,-21600,,
com.google.Chrome,5,1735595098,1735595103,1735595103.547966,-21600,,
com.microsoft.onenote.mac,4,1735595094,1735595098,1735595098.7343001,-21600,,
com.google.Chrome,4,1735595090,1735595094,1735595094.93853,-21600,,
com.microsoft.onenote.mac,2,1735595088,1735595090,1735595090.847032,-21600,,
com.google.Chrome,5,1735595083,1735595088,1735595088.397087,-21600,,
com.microsoft.onenote.mac,2,1735595081,1735595083,1735595083.6324658,-21600,,
com.google.Chrome,2,1735595079,1735595081,1735595081.516635,-21600,,
com.microsoft.onenote.mac,8,1735595071,1735595079,1735595079.893733,-21600,,
com.google.Chrome,124,1735594947,1735595071,1735595071.989133,-21600,,
com.microsoft.onenote.mac,1,1735594946,1735594947,1735594947.339242,-21600,,
com.google.Chrome,14,1735594932,1735594946,1735594946.892957,-21600,,
com.microsoft.onenote.mac,19,1735594913,1735594932,1735594932.990164,-21600,,
com.google.Chrome,163,1735594750,1735594913,1735594913.477929,-21600,,
com.apple.MobileSMS,5,1735594745,1735594750,1735594752.050442,-21600,,
com.leomehlig.today,9,1735594736,1735594745,1735594745.499824,-21600,,
com.apple.finder,5,1735594731,1735594736,1735594736.878156,-21600,,
com.leomehlig.today,11,1735594720,1735594731,1735594731.852387,-21600,,
com.thestorygraph.thestorygraph,81,1735594629,1735594710,1735594710.409404,-21600,EB445137-D7F5-57EC-87DA-1DB460D64046,"iPhone13,2"
com.apple.MobileSMS,12,1735594616,1735594628,1735594628.887333,-21600,EB445137-D7F5-57EC-87DA-1DB460D64046,"iPhone13,2"
com.apple.MobileSMS,10,1735594593,1735594603,1735594603.4086251,-21600,EB445137-D7F5-57EC-87DA-1DB460D64046,"iPhone13,2"
com.apple.MobileSMS,5,1735591407,1735591412,1735591412.304642,-21600,EB445137-D7F5-57EC-87DA-1DB460D64046,"iPhone13,2"
com.apple.MobileSMS,19,1735591365,1735591384,1735591384.857126,-21600,EB445137-D7F5-57EC-87DA-1DB460D64046,"iPhone13,2"
com.apple.MobileSMS,135,1735591209,1735591344,1735591344.0886478,-21600,EB445137-D7F5-57EC-87DA-1DB460D64046,"iPhone13,2"
com.apple.MobileSMS,5,1735591180,1735591185,1735591185.2518702,-21600,EB445137-D7F5-57EC-87DA-1DB460D64046,"iPhone13,2"
com.leomehlig.today,271,1735591166,1735591437,1735591437.32936,-21600,,
com.apple.iCal,21,1735591145,1735591166,1735591166.5440102,-21600,,
com.apple.MobileSMS,2,1735591141,1735591143,1735591143.5773191,-21600,EB445137-D7F5-57EC-87DA-1DB460D64046,"iPhone13,2"
com.leomehlig.today,14,1735591131,1735591145,1735591145.374349,-21600,,
com.google.android.studio,174,1735590957,1735591131,1735591131.601656,-21600,,
com.apple.MobileSMS,3,1735590954,1735590957,1735590957.431076,-21600,,
com.google.android.studio,2,1735590952,1735590954,1735590954.695942,-21600,,
com.apple.iCal,2,1735590950,1735590952,1735590952.755441,-21600,,
com.google.android.studio,84,1735590866,1735590950,1735590950.972472,-21600,,
com.apple.iCal,1,1735590865,1735590866,1735590866.0783172,-21600,,
com.apple.MobileSMS,72,1735590793,1735590865,1735590865.2601461,-21600,,
com.apple.iCal,1,1735590792,1735590793,1735590793.3933492,-21600,,
com.apple.MobileSMS,23,1735590769,1735590792,1735590792.093676,-21600,,
com.apple.iCal,14,1735590755,1735590769,1735590770.0396938,-21600,,
com.apple.MobileSMS,12,1735590743,1735590755,1735590755.93448,-21600,,
com.google.android.studio,1,1735590742,1735590743,1735590743.48298,-21600,,
com.apple.MobileSMS,3,1735590739,1735590742,1735590743.04613,-21600,,
com.google.android.studio,3,1735590736,1735590739,1735590739.723826,-21600,,
com.apple.MobileSMS,1,1735590735,1735590736,1735590736.447723,-21600,,
com.google.android.studio,1,1735590734,1735590735,1735590735.394517,-21600,,
com.apple.MobileSMS,36,1735590698,1735590734,1735590734.697743,-21600,,
com.google.android.studio,12,1735590686,1735590698,1735590698.164258,-21600,,
com.apple.MobileSMS,31,1735590655,1735590686,1735590687.0199552,-21600,,
com.google.android.studio,9,1735590646,1735590655,1735590655.608151,-21600,,
com.apple.MobileSMS,4,1735590642,1735590646,1735590646.393914,-21600,,
com.google.android.studio,10,1735590632,1735590642,1735590642.863596,-21600,,
com.apple.MobileSMS,120,1735590512,1735590632,1735590632.422028,-21600,,
com.apple.MobileSMS,45,1735590451,1735590496,1735590497.09216,-21600,EB445137-D7F5-57EC-87DA-1DB460D64046,"iPhone13,2"
com.apple.Music,4,1735590447,1735590451,1735590452.2116652,-21600,EB445137-D7F5-57EC-87DA-1DB460D64046,"iPhone13,2"
com.google.android.studio,171,1735590341,1735590512,1735590512.431685,-21600,,
com.google.Chrome,52,1735590289,1735590341,1735590341.558259,-21600,,
com.google.android.studio,40,1735590249,1735590289,1735590289.182045,-21600,,
com.google.Chrome,74,1735590059,1735590133,1735590133.4228048,-21600,,
com.apple.Music,3,1735589988,1735589991,1735589991.2334862,-21600,EB445137-D7F5-57EC-87DA-1DB460D64046,"iPhone13,2"
com.google.android.studio,79,1735589980,1735590059,1735590059.912451,-21600,,
com.google.Chrome,43,1735589937,1735589980,1735589980.8412662,-21600,,
com.apple.Music,13,1735588624,1735588637,1735588637.371766,-21600,EB445137-D7F5-57EC-87DA-1DB460D64046,"iPhone13,2"
com.apple.Music,5,1735588488,1735588493,1735588493.628631,-21600,EB445137-D7F5-57EC-87DA-1DB460D64046,"iPhone13,2"
com.apple.MobileSMS,4,1735588478,1735588482,1735588482.752816,-21600,EB445137-D7F5-57EC-87DA-1DB460D64046,"iPhone13,2"
com.apple.MobileSMS,7,1735588327,1735588334,1735588334.939084,-21600,EB445137-D7F5-57EC-87DA-1DB460D64046,"iPhone13,2"
com.apple.Maps,2,1735588317,1735588319,1735588319.736017,-21600,EB445137-D7F5-57EC-87DA-1DB460D64046,"iPhone13,2"
com.apple.Maps,8,1735587783,1735587791,1735587791.781455,-21600,EB445137-D7F5-57EC-87DA-1DB460D64046,"iPhone13,2"
com.apple.Maps,35,1735587716,1735587751,1735587751.8789701,-21600,EB445137-D7F5-57EC-87DA-1DB460D64046,"iPhone13,2"
com.apple.news,1,1735587715,1735587716,1735587716.477287,-21600,EB445137-D7F5-57EC-87DA-1DB460D64046,"iPhone13,2"
com.apple.news,4,1735586307,1735586311,1735586311.169179,-21600,EB445137-D7F5-57EC-87DA-1DB460D64046,"iPhone13,2"
com.apple.camera,0,1735586307,1735586307,1735586308.044732,-21600,EB445137-D7F5-57EC-87DA-1DB460D64046,"iPhone13,2"
com.apple.news,33,1735586151,1735586184,1735586184.162051,-21600,EB445137-D7F5-57EC-87DA-1DB460D64046,"iPhone13,2"
com.apple.news,27,1735585793,1735585820,1735585820.6982841,-21600,EB445137-D7F5-57EC-87DA-1DB460D64046,"iPhone13,2"
com.apple.mobileslideshow,38,1735585747,1735585785,1735585785.400367,-21600,EB445137-D7F5-57EC-87DA-1DB460D64046,"iPhone13,2"
com.apple.news,6,1735585741,1735585747,1735585748.204953,-21600,EB445137-D7F5-57EC-87DA-1DB460D64046,"iPhone13,2"
com.apple.news,6,1735583831,1735583837,1735583837.211005,-21600,EB445137-D7F5-57EC-87DA-1DB460D64046,"iPhone13,2"
com.apple.news,52,1735583778,1735583830,1735583831.387927,-21600,EB445137-D7F5-57EC-87DA-1DB460D64046,"iPhone13,2"
com.apple.MobileSMS,14,1735581117,1735581131,1735581131.101297,-21600,EB445137-D7F5-57EC-87DA-1DB460D64046,"iPhone13,2"
com.apple.Maps,9,1735581108,1735581117,1735581117.8846831,-21600,EB445137-D7F5-57EC-87DA-1DB460D64046,"iPhone13,2"
com.apple.Maps,4,1735581007,1735581011,1735581011.203573,-21600,EB445137-D7F5-57EC-87DA-1DB460D64046,"iPhone13,2"
com.apple.Maps,21,1735580824,1735580845,1735580845.9473119,-21600,EB445137-D7F5-57EC-87DA-1DB460D64046,"iPhone13,2"
com.apple.Music,3,1735580821,1735580824,1735580824.742127,-21600,EB445137-D7F5-57EC-87DA-1DB460D64046,"iPhone13,2"
com.apple.Music,5,1735580759,1735580764,1735580764.942665,-21600,EB445137-D7F5-57EC-87DA-1DB460D64046,"iPhone13,2"
com.google.Chrome,4,1735579637,1735579641,1735579641.741825,-21600,,
com.apple.MobileSMS,22,1735579615,1735579637,1735579637.616415,-21600,,
com.google.android.studio,32,1735579583,1735579615,1735579615.4365668,-21600,,
com.google.Chrome,71,1735579512,1735579583,1735579583.391974,-21600,,
com.google.android.studio,163,1735579349,1735579512,1735579512.777174,-21600,,
com.google.Chrome,122,1735579227,1735579349,1735579349.491084,-21600,,
com.google.android.studio,149,1735579078,1735579227,1735579228.129164,-21600,,
com.google.Chrome,2,1735579076,1735579078,1735579078.353926,-21600,,
com.google.android.studio,23,1735579053,1735579076,1735579076.953899,-21600,,
com.google.Chrome,1,1735579052,1735579053,1735579053.7021499,-21600,,
com.google.android.studio,7,1735579045,1735579052,1735579052.5394921,-21600,,
com.google.Chrome,18,1735579027,1735579045,1735579045.576264,-21600,,
com.google.android.studio,93,1735578934,1735579027,1735579027.5027962,-21600,,
com.microsoft.onenote.mac,12,1735578922,1735578934,1735578934.1118011,-21600,,
com.google.android.studio,378,1735578544,1735578922,1735578922.2154012,-21600,,
com.google.Chrome,1,1735578543,1735578544,1735578544.126851,-21600,,
com.google.android.studio,156,1735578387,1735578543,1735578543.450757,-21600,,
com.google.Chrome,30,1735578357,1735578387,1735578387.410811,-21600,,
com.google.android.studio,20,1735578337,1735578357,1735578357.459728,-21600,,
com.google.Chrome,17,1735578320,1735578337,1735578338.00555,-21600,,
com.google.android.studio,42,1735578278,1735578320,1735578320.3415499,-21600,,
com.google.Chrome,61,1735578217,1735578278,1735578278.74373,-21600,,
com.google.android.studio,135,1735578082,1735578217,1735578217.189847,-21600,,
com.google.Chrome,67,1735577871,1735577938,1735577938.416085,-21600,,
com.google.android.studio,57,1735577814,1735577871,1735577871.3426461,-21600,,
com.apple.MobileSMS,2,1735577812,1735577814,1735577814.544939,-21600,,
com.google.android.studio,29,1735577783,1735577812,1735577812.9689898,-21600,,
com.apple.MobileSMS,15,1735577768,1735577783,1735577783.045436,-21600,,
com.google.android.studio,6,1735577762,1735577768,1735577768.9152489,-21600,,
com.apple.MobileSMS,26,1735577736,1735577762,1735577762.744141,-21600,,
com.leomehlig.today,61,1735577675,1735577736,1735577736.320785,-21600,,
com.apple.iCal,99,1735577576,1735577675,1735577675.546617,-21600,,
com.leomehlig.today,13,1735577563,1735577576,1735577576.130424,-21600,,
com.google.Chrome,2,1735577561,1735577563,1735577563.8477159,-21600,,
com.google.Chrome,24,1735532672,1735532696,1735532696.6240969,-21600,,
com.google.Chrome,315,1735532275,1735532590,1735532590.0950398,-21600,,
com.google.Chrome,922,1735531087,1735532009,1735532009.199944,-21600,,
com.google.Chrome,633,1735530362,1735530995,1735530995.1039162,-21600,,
com.apple.news,19,1735523227,1735523246,1735523246.9578562,-21600,EB445137-D7F5-57EC-87DA-1DB460D64046,"iPhone13,2"
com.apple.news,8,1735523211,1735523219,1735523220.3518271,-21600,EB445137-D7F5-57EC-87DA-1DB460D64046,"iPhone13,2"
com.apple.news,108,1735523100,1735523208,1735523208.936644,-21600,EB445137-D7F5-57EC-87DA-1DB460D64046,"iPhone13,2"
com.hammerandchisel.discord,4,1735523086,1735523090,1735523090.921479,-21600,EB445137-D7F5-57EC-87DA-1DB460D64046,"iPhone13,2"
com.hammerandchisel.discord,10,1735523076,1735523086,1735523086.642497,-21600,EB445137-D7F5-57EC-87DA-1DB460D64046,"iPhone13,2"
com.google.chrome.ios,2,1735523074,1735523076,1735523076.714404,-21600,EB445137-D7F5-57EC-87DA-1DB460D64046,"iPhone13,2"
com.google.chrome.ios,18,1735522475,1735522493,1735522494.0201678,-21600,EB445137-D7F5-57EC-87DA-1DB460D64046,"iPhone13,2"
com.apple.weather,3,1735522472,1735522475,1735522475.1829062,-21600,EB445137-D7F5-57EC-87DA-1DB460D64046,"iPhone13,2"
com.apple.weather,2,1735522214,1735522216,1735522216.851078,-21600,EB445137-D7F5-57EC-87DA-1DB460D64046,"iPhone13,2"
com.apple.weather,6,1735520415,1735520421,1735520422.1870499,-21600,EB445137-D7F5-57EC-87DA-1DB460D64046,"iPhone13,2"
com.apple.news,2,1735520412,1735520414,1735520415.229423,-21600,EB445137-D7F5-57EC-87DA-1DB460D64046,"iPhone13,2"
com.apple.news,2,1735520359,1735520361,1735520361.888887,-21600,EB445137-D7F5-57EC-87DA-1DB460D64046,"iPhone13,2"
com.apple.camera,1,1735520359,1735520360,1735520360.074295,-21600,EB445137-D7F5-57EC-87DA-1DB460D64046,"iPhone13,2"
com.apple.news,4,1735520352,1735520356,1735520356.457251,-21600,EB445137-D7F5-57EC-87DA-1DB460D64046,"iPhone13,2"
com.apple.news,8,1735519937,1735519945,1735519945.92072,-21600,EB445137-D7F5-57EC-87DA-1DB460D64046,"iPhone13,2"
com.apple.MobileSMS,4,1735519827,1735519831,1735519832.0900621,-21600,EB445137-D7F5-57EC-87DA-1DB460D64046,"iPhone13,2"
com.apple.MobileSMS,24,1735512098,1735512122,1735512122.497229,-21600,EB445137-D7F5-57EC-87DA-1DB460D64046,"iPhone13,2"
com.toyopagroup.picaboo,9,1735512086,1735512095,1735512096.287298,-21600,EB445137-D7F5-57EC-87DA-1DB460D64046,"iPhone13,2"
com.apple.news,14,1735511988,1735512002,1735512003.6758509,-21600,EB445137-D7F5-57EC-87DA-1DB460D64046,"iPhone13,2"
com.toyopagroup.picaboo,6,1735511977,1735511983,1735511984.1190329,-21600,EB445137-D7F5-57EC-87DA-1DB460D64046,"iPhone13,2"
com.google.Chrome,1444,1735507542,1735508986,1735508986.820722,-21600,,
com.google.Chrome,1478,1735506041,1735507519,1735507519.0859709,-21600,,
com.google.Chrome,306,1735505517,1735505823,1735505823.277853,-21600,,
com.google.Chrome,444,1735504866,1735505310,1735505310.208821,-21600,,
com.apple.MobileSMS,5,1735504383,1735504388,1735504388.563884,-21600,EB445137-D7F5-57EC-87DA-1DB460D64046,"iPhone13,2"
com.google.Chrome,338,1735504229,1735504567,1735504567.8943648,-21600,,
com.google.Chrome,1249,1735502976,1735504225,1735504225.588646,-21600,,
com.google.Chrome,751,1735502210,1735502961,1735502961.9220939,-21600,,
com.leomehlig.today,102,1735502108,1735502210,1735502210.273758,-21600,,
com.apple.finder,3,1735502105,1735502108,1735502108.894474,-21600,,
com.leomehlig.today,106,1735501999,1735502105,1735502105.694796,-21600,,
com.google.Chrome,4,1735501995,1735501999,1735502000.020473,-21600,,
com.apple.iCal,18,1735501977,1735501995,1735501995.7520251,-21600,,
com.apple.AppStore,40,1735501908,1735501948,1735501948.591572,-21600,EB445137-D7F5-57EC-87DA-1DB460D64046,"iPhone13,2"
com.thestorygraph.thestorygraph,155,1735501555,1735501710,1735501710.4604049,-21600,EB445137-D7F5-57EC-87DA-1DB460D64046,"iPhone13,2"
com.apple.MobileSMS,4,1735501548,1735501552,1735501552.683922,-21600,EB445137-D7F5-57EC-87DA-1DB460D64046,"iPhone13,2"
com.apple.MobileSMS,2,1735501337,1735501339,1735501339.460994,-21600,EB445137-D7F5-57EC-87DA-1DB460D64046,"iPhone13,2"
com.apple.MobileSMS,2,1735499204,1735499206,1735499206.846088,-21600,EB445137-D7F5-57EC-87DA-1DB460D64046,"iPhone13,2"
com.apple.MobileSMS,60,1735499140,1735499200,1735499200.8832831,-21600,EB445137-D7F5-57EC-87DA-1DB460D64046,"iPhone13,2"
com.apple.iCal,138,1735497432,1735497570,1735497570.590406,-21600,,
com.google.Chrome,547,1735496885,1735497432,1735497432.405096,-21600,,
com.meijer.mobile.Meijer,2,1735493840,1735493842,1735493842.638607,-21600,EB445137-D7F5-57EC-87DA-1DB460D64046,"iPhone13,2"
com.meijer.mobile.Meijer,3,1735493837,1735493840,1735493840.3138552,-21600,EB445137-D7F5-57EC-87DA-1DB460D64046,"iPhone13,2"
com.apple.camera,6,1735492896,1735492902,1735492903.3882341,-21600,EB445137-D7F5-57EC-87DA-1DB460D64046,"iPhone13,2"
com.meijer.mobile.Meijer,9,1735492893,1735492902,1735492903.530577,-21600,EB445137-D7F5-57EC-87DA-1DB460D64046,"iPhone13,2"
com.meijer.mobile.Meijer,3,1735492705,1735492708,1735492708.3126302,-21600,EB445137-D7F5-57EC-87DA-1DB460D64046,"iPhone13,2"
com.meijer.mobile.Meijer,67,1735492605,1735492672,1735492672.8278651,-21600,EB445137-D7F5-57EC-87DA-1DB460D64046,"iPhone13,2"
com.meijer.mobile.Meijer,70,1735492522,1735492592,1735492592.6609092,-21600,EB445137-D7F5-57EC-87DA-1DB460D64046,"iPhone13,2"
com.apple.AppStore,23,1735492499,1735492522,1735492522.741468,-21600,EB445137-D7F5-57EC-87DA-1DB460D64046,"iPhone13,2"
com.apple.Music,4,1735492487,1735492491,1735492491.05952,-21600,EB445137-D7F5-57EC-87DA-1DB460D64046,"iPhone13,2"
com.apple.Music,6,1735492156,1735492162,1735492162.599814,-21600,EB445137-D7F5-57EC-87DA-1DB460D64046,"iPhone13,2"
com.apple.findmy,3,1735492138,1735492141,1735492142.052619,-21600,EB445137-D7F5-57EC-87DA-1DB460D64046,"iPhone13,2"
com.apple.Music,3,1735492135,1735492138,1735492138.449538,-21600,EB445137-D7F5-57EC-87DA-1DB460D64046,"iPhone13,2"
com.lafitness.lafitness,1,1735492119,1735492120,1735492120.728616,-21600,EB445137-D7F5-57EC-87DA-1DB460D64046,"iPhone13,2"
com.lafitness.lafitness,6,1735491420,1735491426,1735491426.425139,-21600,EB445137-D7F5-57EC-87DA-1DB460D64046,"iPhone13,2"
com.lafitness.lafitness,34,1735491292,1735491326,1735491326.550365,-21600,EB445137-D7F5-57EC-87DA-1DB460D64046,"iPhone13,2"
com.apple.camera,15,1735491269,1735491284,1735491284.6186671,-21600,EB445137-D7F5-57EC-87DA-1DB460D64046,"iPhone13,2"
com.apple.Music,22,1735491266,1735491288,1735491288.770372,-21600,EB445137-D7F5-57EC-87DA-1DB460D64046,"iPhone13,2"
com.apple.Music,6,1735491146,1735491152,1735491152.806117,-21600,EB445137-D7F5-57EC-87DA-1DB460D64046,"iPhone13,2"
com.apple.Music,3,1735490798,1735490801,1735490801.3780398,-21600,EB445137-D7F5-57EC-87DA-1DB460D64046,"iPhone13,2"
com.apple.Music,6,1735490623,1735490629,1735490629.543435,-21600,EB445137-D7F5-57EC-87DA-1DB460D64046,"iPhone13,2"
com.apple.Music,16,1735490559,1735490575,1735490576.140236,-21600,EB445137-D7F5-57EC-87DA-1DB460D64046,"iPhone13,2"
com.apple.Health,92,1735490466,1735490558,1735490558.2761722,-21600,EB445137-D7F5-57EC-87DA-1DB460D64046,"iPhone13,2"
com.apple.findmy,7,1735490386,1735490393,1735490394.58045,-21600,EB445137-D7F5-57EC-87DA-1DB460D64046,"iPhone13,2"
com.apple.findmy,2,1735490383,1735490385,1735490386.1780891,-21600,EB445137-D7F5-57EC-87DA-1DB460D64046,"iPhone13,2"
com.renpho.health,3,1735490380,1735490383,1735490383.311929,-21600,EB445137-D7F5-57EC-87DA-1DB460D64046,"iPhone13,2"
com.renpho.health,80,1735488652,1735488732,1735488732.132946,-21600,EB445137-D7F5-57EC-87DA-1DB460D64046,"iPhone13,2"
com.apple.weather,2,1735488475,1735488477,1735488477.050492,-21600,EB445137-D7F5-57EC-87DA-1DB460D64046,"iPhone13,2"
com.google.ios.youtube,835,1735487639,1735488474,1735488475.43799,-21600,EB445137-D7F5-57EC-87DA-1DB460D64046,"iPhone13,2"
com.apple.findmy,2,1735487637,1735487639,1735487639.590215,-21600,EB445137-D7F5-57EC-87DA-1DB460D64046,"iPhone13,2"
com.apple.findmy,6,1735487611,1735487617,1735487617.713809,-21600,EB445137-D7F5-57EC-87DA-1DB460D64046,"iPhone13,2"
com.google.ios.youtube,1108,1735486436,1735487544,1735487545.045846,-21600,EB445137-D7F5-57EC-87DA-1DB460D64046,"iPhone13,2"
com.google.ios.youtube,914,1735485499,1735486413,1735486414.212405,-21600,EB445137-D7F5-57EC-87DA-1DB460D64046,"iPhone13,2"
com.google.Maps,65,1735485391,1735485456,1735485456.1304932,-21600,EB445137-D7F5-57EC-87DA-1DB460D64046,"iPhone13,2"
com.apple.findmy,9,1735485367,1735485376,1735485376.1950588,-21600,EB445137-D7F5-57EC-87DA-1DB460D64046,"iPhone13,2"
com.tinyspeck.chatlyio,8,1735485100,1735485108,1735485108.356173,-21600,EB445137-D7F5-57EC-87DA-1DB460D64046,"iPhone13,2"
com.apple.mobiletimer,14,1735485079,1735485093,1735485093.649782,-21600,EB445137-D7F5-57EC-87DA-1DB460D64046,"iPhone13,2"
com.apple.mobiletimer,24,1735483196,1735483220,1735483221.0153608,-21600,EB445137-D7F5-57EC-87DA-1DB460D64046,"iPhone13,2"
com.apple.mobiletimer,25,1735482601,1735482626,1735482626.1886759,-21600,EB445137-D7F5-57EC-87DA-1DB460D64046,"iPhone13,2"
com.apple.mobiletimer,13,1735450986,1735450999,1735450999.316609,-21600,EB445137-D7F5-57EC-87DA-1DB460D64046,"iPhone13,2"
com.apple.mobiletimer,6,1735450975,1735450981,1735450981.237566,-21600,EB445137-D7F5-57EC-87DA-1DB460D64046,"iPhone13,2"
com.apple.Health,17,1735450924,1735450941,1735450941.3728418,-21600,EB445137-D7F5-57EC-87DA-1DB460D64046,"iPhone13,2"
com.thestorygraph.thestorygraph,10,1735450254,1735450264,1735450264.097342,-21600,EB445137-D7F5-57EC-87DA-1DB460D64046,"iPhone13,2"
com.thestorygraph.thestorygraph,85,1735450169,1735450254,1735450254.117989,-21600,EB445137-D7F5-57EC-87DA-1DB460D64046,"iPhone13,2"
com.apple.Preferences,54,1735450114,1735450168,1735450168.611937,-21600,EB445137-D7F5-57EC-87DA-1DB460D64046,"iPhone13,2"
com.apple.Preferences,21,1735450092,1735450113,1735450113.914164,-21600,EB445137-D7F5-57EC-87DA-1DB460D64046,"iPhone13,2"
org.name.serializdmobile,10,1735450076,1735450086,1735450086.289159,-21600,EB445137-D7F5-57EC-87DA-1DB460D64046,"iPhone13,2"
org.name.serializdmobile,10,1735449754,1735449764,1735449764.067755,-21600,EB445137-D7F5-57EC-87DA-1DB460D64046,"iPhone13,2"
org.name.serializdmobile,13,1735449484,1735449497,1735449497.261631,-21600,EB445137-D7F5-57EC-87DA-1DB460D64046,"iPhone13,2"
org.name.serializdmobile,10,1735448041,1735448051,1735448051.759457,-21600,EB445137-D7F5-57EC-87DA-1DB460D64046,"iPhone13,2"
org.name.serializdmobile,4,1735447793,1735447797,1735447797.626569,-21600,EB445137-D7F5-57EC-87DA-1DB460D64046,"iPhone13,2"
org.name.serializdmobile,10,1735446601,1735446611,1735446611.883457,-21600,EB445137-D7F5-57EC-87DA-1DB460D64046,"iPhone13,2"
org.name.serializdmobile,10,1735445401,1735445411,1735445411.730997,-21600,EB445137-D7F5-57EC-87DA-1DB460D64046,"iPhone13,2"
com.google.Chrome,835,1735442689,1735443524,1735443524.5564818,-21600,,
com.apple.finder,4,1735442685,1735442689,1735442689.6164699,-21600,,
com.google.Chrome,6,1735442679,1735442685,1735442685.819843,-21600,,
org.name.serializdmobile,55,1735442609,1735442664,1735442664.801245,-21600,EB445137-D7F5-57EC-87DA-1DB460D64046,"iPhone13,2"
org.name.serializdmobile,93,1735442123,1735442216,1735442216.691834,-21600,EB445137-D7F5-57EC-87DA-1DB460D64046,"iPhone13,2"
com.microsoft.VSCode,678,1735442001,1735442679,1735442679.652123,-21600,,
com.google.Chrome,8,1735441993,1735442001,1735442001.741581,-21600,,
com.microsoft.VSCode,221,1735441772,1735441993,1735441993.5210009,-21600,,
com.google.Chrome,1,1735441771,1735441772,1735441772.838733,-21600,,
com.microsoft.VSCode,3,1735441768,1735441771,1735441772.002373,-21600,,
com.google.Chrome,2,1735441766,1735441768,1735441768.82194,-21600,,
com.microsoft.VSCode,5,1735441761,1735441766,1735441766.574656,-21600,,
com.google.Chrome,18,1735441743,1735441761,1735441761.808782,-21600,,
com.microsoft.VSCode,339,1735441404,1735441743,1735441743.539618,-21600,,
com.google.Chrome,2,1735441402,1735441404,1735441404.1793299,-21600,,
com.microsoft.VSCode,2,1735441400,1735441402,1735441403.007844,-21600,,
com.google.Chrome,1,1735441399,1735441400,1735441400.280724,-21600,,
com.microsoft.VSCode,2,1735441397,1735441399,1735441399.467507,-21600,,
com.google.Chrome,1,1735441396,1735441397,1735441397.426724,-21600,,
com.microsoft.VSCode,2,1735441394,1735441396,1735441396.247345,-21600,,
com.google.Chrome,2,1735441392,1735441394,1735441394.2617831,-21600,,
com.microsoft.VSCode,1,1735441391,1735441392,1735441392.641849,-21600,,
com.google.Chrome,2,1735441389,1735441391,1735441391.232858,-21600,,
com.microsoft.VSCode,12,1735441377,1735441389,1735441389.914583,-21600,,
com.google.Chrome,0,1735441377,1735441377,1735441377.587884,-21600,,
com.microsoft.VSCode,8,1735441369,1735441377,1735441377.053296,-21600,,
com.google.Chrome,12,1735441357,1735441369,1735441369.398882,-21600,,
com.microsoft.VSCode,6,1735441351,1735441357,1735441357.717674,-21600,,
com.google.Chrome,1,1735441350,1735441351,1735441351.763228,-21600,,
com.microsoft.VSCode,17,1735441333,1735441350,1735441350.320315,-21600,,
com.microsoft.onenote.mac,3,1735441330,1735441333,1735441333.276863,-21600,,
com.letterboxd.LetterboxdApp,144,1735441171,1735441315,1735441315.1372519,-21600,EB445137-D7F5-57EC-87DA-1DB460D64046,"iPhone13,2"
com.apple.AppStore,120,1735441038,1735441158,1735441158.097324,-21600,EB445137-D7F5-57EC-87DA-1DB460D64046,"iPhone13,2"
com.apple.Health,3,1735441034,1735441037,1735441037.888804,-21600,EB445137-D7F5-57EC-87DA-1DB460D64046,"iPhone13,2"
com.apple.iCal,11,1735440848,1735440859,1735440859.487148,-21600,,
com.microsoft.onenote.mac,90,1735440758,1735440848,1735440848.34322,-21600,,
com.apple.iCal,4,1735440754,1735440758,1735440758.1705852,-21600,,
com.apple.Health,184,1735440577,1735440761,1735440761.475924,-21600,EB445137-D7F5-57EC-87DA-1DB460D64046,"iPhone13,2"
com.apple.Health,70,1735440416,1735440486,1735440486.125216,-21600,EB445137-D7F5-57EC-87DA-1DB460D64046,"iPhone13,2"
com.microsoft.onenote.mac,409,1735440345,1735440754,1735440754.586343,-21600,,
com.apple.iCal,4,1735440341,1735440345,1735440345.7524729,-21600,,
com.microsoft.onenote.mac,3,1735440338,1735440341,1735440341.889653,-21600,,
com.apple.iCal,3,1735440335,1735440338,1735440338.294335,-21600,,
com.microsoft.onenote.mac,3,1735440332,1735440335,1735440335.11866,-21600,,
com.apple.iCal,6,1735440326,1735440332,1735440332.778362,-21600,,
com.microsoft.onenote.mac,0,1735440326,1735440326,1735440326.710884,-21600,,
com.apple.iCal,9,1735440317,1735440326,1735440326.2754269,-21600,,
com.microsoft.onenote.mac,5,1735440312,1735440317,1735440317.38326,-21600,,
com.apple.iCal,9,1735440303,1735440312,1735440312.928433,-21600,,
com.microsoft.onenote.mac,269,1735440034,1735440303,1735440303.3771858,-21600,,
com.google.Chrome,10,1735440024,1735440034,1735440034.489105,-21600,,
com.microsoft.onenote.mac,6,1735440018,1735440024,1735440024.872869,-21600,,
com.google.Chrome,54,1735439964,1735440018,1735440018.4207048,-21600,,
com.microsoft.onenote.mac,9,1735439955,1735439964,1735439964.759084,-21600,,
com.apple.calculator,23,1735439932,1735439955,1735439955.931954,-21600,,
com.microsoft.onenote.mac,4,1735439928,1735439932,1735439932.487896,-21600,,
com.apple.calculator,0,1735439928,1735439928,1735439928.834056,-21600,,
com.microsoft.onenote.mac,3,1735439925,1735439928,1735439928.085021,-21600,,
com.apple.calculator,6,1735439919,1735439925,1735439925.127615,-21600,,
com.microsoft.onenote.mac,16,1735439903,1735439919,1735439919.0677152,-21600,,
com.apple.calculator,9,1735439894,1735439903,1735439903.331536,-21600,,
com.microsoft.onenote.mac,4,1735439890,1735439894,1735439894.899438,-21600,,
com.apple.calculator,1,1735439889,1735439890,1735439890.918003,-21600,,
com.google.Chrome,8,1735439881,1735439889,1735439889.992447,-21600,,
com.apple.calculator,1,1735439880,1735439881,1735439881.434304,-21600,,
com.microsoft.onenote.mac,4,1735439876,1735439880,1735439880.3555,-21600,,
com.apple.calculator,2,1735439874,1735439876,1735439876.316952,-21600,,
com.microsoft.onenote.mac,3,1735439871,1735439874,1735439875.024018,-21600,,
com.apple.calculator,8,1735439863,1735439871,1735439871.276267,-21600,,
com.microsoft.onenote.mac,8,1735439855,1735439863,1735439863.722917,-21600,,
com.google.Chrome,3,1735439852,1735439855,1735439855.288696,-21600,,
com.microsoft.onenote.mac,1,1735439851,1735439852,1735439852.390451,-21600,,
com.google.Chrome,7,1735439844,1735439851,1735439851.568223,-21600,,
com.microsoft.onenote.mac,10,1735439834,1735439844,1735439844.95631,-21600,,
com.google.Chrome,8,1735439826,1735439834,1735439834.1947951,-21600,,
com.microsoft.onenote.mac,13,1735439813,1735439826,1735439826.448647,-21600,,
com.google.Chrome,45,1735439768,1735439813,1735439813.40877,-21600,,
com.apple.finder,14,1735439735,1735439749,1735439750.022634,-21600,,
com.thestorygraph.thestorygraph,30,1735439258,1735439288,1735439288.589808,-21600,EB445137-D7F5-57EC-87DA-1DB460D64046,"iPhone13,2"
com.apple.MobileSMS,6,1735439243,1735439249,1735439249.742562,-21600,EB445137-D7F5-57EC-87DA-1DB460D64046,"iPhone13,2"
com.apple.MobileSMS,4,1735438848,1735438852,1735438852.555914,-21600,EB445137-D7F5-57EC-87DA-1DB460D64046,"iPhone13,2"
com.apple.MobileSMS,2,1735436619,1735436621,1735436621.284305,-21600,EB445137-D7F5-57EC-87DA-1DB460D64046,"iPhone13,2"
com.apple.MobileSMS,83,1735436452,1735436535,1735436535.266375,-21600,EB445137-D7F5-57EC-87DA-1DB460D64046,"iPhone13,2"
com.apple.MobileSMS,363,1735436080,1735436443,1735436444.050767,-21600,EB445137-D7F5-57EC-87DA-1DB460D64046,"iPhone13,2"
com.letterboxd.LetterboxdApp,30,1735436050,1735436080,1735436080.735197,-21600,EB445137-D7F5-57EC-87DA-1DB460D64046,"iPhone13,2"
com.apple.MobileSMS,332,1735435714,1735436046,1735436047.1479201,-21600,EB445137-D7F5-57EC-87DA-1DB460D64046,"iPhone13,2"
com.apple.MobileSMS,51,1735435635,1735435686,1735435686.652154,-21600,EB445137-D7F5-57EC-87DA-1DB460D64046,"iPhone13,2"
com.apple.MobileSMS,3,1735435423,1735435426,1735435427.605795,-21600,EB445137-D7F5-57EC-87DA-1DB460D64046,"iPhone13,2"
com.hammerandchisel.discord,8,1735435413,1735435421,1735435422.121419,-21600,EB445137-D7F5-57EC-87DA-1DB460D64046,"iPhone13,2"
com.amazon.Amazon,8,1735435405,1735435413,1735435415.465249,-21600,EB445137-D7F5-57EC-87DA-1DB460D64046,"iPhone13,2"
com.amazon.Amazon,6,1735426996,1735427002,1735427002.954191,-21600,EB445137-D7F5-57EC-87DA-1DB460D64046,"iPhone13,2"
com.amazon.Amazon,13,1735426982,1735426995,1735426997.1148438,-21600,EB445137-D7F5-57EC-87DA-1DB460D64046,"iPhone13,2"
com.apple.Maps,2,1735426978,1735426980,1735426980.863313,-21600,EB445137-D7F5-57EC-87DA-1DB460D64046,"iPhone13,2"
com.apple.Maps,6,1735426909,1735426915,1735426915.4520159,-21600,EB445137-D7F5-57EC-87DA-1DB460D64046,"iPhone13,2"
com.apple.Maps,2,1735426903,1735426905,1735426905.218252,-21600,EB445137-D7F5-57EC-87DA-1DB460D64046,"iPhone13,2"
com.apple.camera,1,1735426903,1735426904,1735426904.446659,-21600,EB445137-D7F5-57EC-87DA-1DB460D64046,"iPhone13,2"
com.apple.Maps,7,1735426892,1735426899,1735426899.546462,-21600,EB445137-D7F5-57EC-87DA-1DB460D64046,"iPhone13,2"
com.apple.Maps,44,1735426733,1735426777,1735426777.917138,-21600,EB445137-D7F5-57EC-87DA-1DB460D64046,"iPhone13,2"
com.apple.camera,0,1735424856,1735424856,1735424856.532393,-21600,EB445137-D7F5-57EC-87DA-1DB460D64046,"iPhone13,2"
com.apple.camera,1,1735424759,1735424760,1735424760.480675,-21600,EB445137-D7F5-57EC-87DA-1DB460D64046,"iPhone13,2"
com.apple.camera,0,1735424759,1735424759,1735424759.9422631,-21600,EB445137-D7F5-57EC-87DA-1DB460D64046,"iPhone13,2"
com.apple.Maps,36,1735424720,1735424756,1735424756.5457249,-21600,EB445137-D7F5-57EC-87DA-1DB460D64046,"iPhone13,2"
com.hammerandchisel.discord,16,1735424703,1735424719,1735424719.471796,-21600,EB445137-D7F5-57EC-87DA-1DB460D64046,"iPhone13,2"
com.hammerandchisel.discord,10,1735424181,1735424191,1735424191.5312839,-21600,EB445137-D7F5-57EC-87DA-1DB460D64046,"iPhone13,2"
com.hammerandchisel.discord,10,1735424018,1735424028,1735424028.5758228,-21600,EB445137-D7F5-57EC-87DA-1DB460D64046,"iPhone13,2"
com.hammerandchisel.discord,10,1735424008,1735424018,1735424018.303666,-21600,EB445137-D7F5-57EC-87DA-1DB460D64046,"iPhone13,2"
com.hammerandchisel.discord,24,1735423981,1735424005,1735424006.003838,-21600,EB445137-D7F5-57EC-87DA-1DB460D64046,"iPhone13,2"
com.hammerandchisel.discord,10,1735423970,1735423980,1735423980.550134,-21600,EB445137-D7F5-57EC-87DA-1DB460D64046,"iPhone13,2"
com.hammerandchisel.discord,9,1735423960,1735423969,1735423969.989536,-21600,EB445137-D7F5-57EC-87DA-1DB460D64046,"iPhone13,2"
com.hammerandchisel.discord,10,1735423949,1735423959,1735423959.658406,-21600,EB445137-D7F5-57EC-87DA-1DB460D64046,"iPhone13,2"
com.hammerandchisel.discord,10,1735423939,1735423949,1735423949.143357,-21600,EB445137-D7F5-57EC-87DA-1DB460D64046,"iPhone13,2"
com.hammerandchisel.discord,10,1735423928,1735423938,1735423938.37396,-21600,EB445137-D7F5-57EC-87DA-1DB460D64046,"iPhone13,2"
com.hammerandchisel.discord,20,1735423907,1735423927,1735423927.825572,-21600,EB445137-D7F5-57EC-87DA-1DB460D64046,"iPhone13,2"
com.hammerandchisel.discord,10,1735423885,1735423895,1735423895.5526462,-21600,EB445137-D7F5-57EC-87DA-1DB460D64046,"iPhone13,2"
com.hammerandchisel.discord,10,1735423871,1735423881,1735423881.107832,-21600,EB445137-D7F5-57EC-87DA-1DB460D64046,"iPhone13,2"
com.hammerandchisel.discord,10,1735423821,1735423831,1735423831.6457028,-21600,EB445137-D7F5-57EC-87DA-1DB460D64046,"iPhone13,2"
com.hammerandchisel.discord,10,1735423800,1735423810,1735423810.350354,-21600,EB445137-D7F5-57EC-87DA-1DB460D64046,"iPhone13,2"
com.hammerandchisel.discord,2,1735423596,1735423598,1735423598.869643,-21600,EB445137-D7F5-57EC-87DA-1DB460D64046,"iPhone13,2"
com.apple.DocumentsApp,21,1735423575,1735423596,1735423596.851275,-21600,EB445137-D7F5-57EC-87DA-1DB460D64046,"iPhone13,2"
com.apple.weather,4,1735422904,1735422908,1735422908.304412,-21600,EB445137-D7F5-57EC-87DA-1DB460D64046,"iPhone13,2"
com.apple.weather,2,1735422633,1735422635,1735422635.77179,-21600,EB445137-D7F5-57EC-87DA-1DB460D64046,"iPhone13,2"
com.apple.weather,6,1735422339,1735422345,1735422345.924615,-21600,EB445137-D7F5-57EC-87DA-1DB460D64046,"iPhone13,2"
com.apple.weather,18,1735422281,1735422299,1735422300.181098,-21600,EB445137-D7F5-57EC-87DA-1DB460D64046,"iPhone13,2"
com.apple.weather,6,1735421784,1735421790,1735421790.773566,-21600,EB445137-D7F5-57EC-87DA-1DB460D64046,"iPhone13,2"
com.google.ios.youtube,2,1735421782,1735421784,1735421784.508984,-21600,EB445137-D7F5-57EC-87DA-1DB460D64046,"iPhone13,2"
com.apple.camera,1,1735421775,1735421776,1735421776.381576,-21600,EB445137-D7F5-57EC-87DA-1DB460D64046,"iPhone13,2"
com.apple.camera,2,1735421772,1735421774,1735421775.394042,-21600,EB445137-D7F5-57EC-87DA-1DB460D64046,"iPhone13,2"
com.google.ios.youtube,17,1735421759,1735421776,1735421776.38042,-21600,EB445137-D7F5-57EC-87DA-1DB460D64046,"iPhone13,2"
com.google.ios.youtube,201,1735421554,1735421755,1735421755.362675,-21600,EB445137-D7F5-57EC-87DA-1DB460D64046,"iPhone13,2"
com.letterboxd.LetterboxdApp,5,1735421545,1735421550,1735421550.8380451,-21600,EB445137-D7F5-57EC-87DA-1DB460D64046,"iPhone13,2"
com.apple.finder,27,1735421506,1735421533,1735421533.969012,-21600,,
com.google.Chrome,1,1735421505,1735421506,1735421506.86273,-21600,,
com.apple.finder,40,1735421465,1735421505,1735421505.527884,-21600,,
com.google.Chrome,8,1735421457,1735421465,1735421466.045721,-21600,,
com.google.android.studio,1,1735421456,1735421457,1735421457.381078,-21600,,
com.microsoft.onenote.mac,23,1735421433,1735421456,1735421456.469697,-21600,,
com.letterboxd.LetterboxdApp,56,1735421318,1735421374,1735421374.2727618,-21600,EB445137-D7F5-57EC-87DA-1DB460D64046,"iPhone13,2"
com.hammerandchisel.discord,7,1735421309,1735421316,1735421316.319402,-21600,EB445137-D7F5-57EC-87DA-1DB460D64046,"iPhone13,2"
com.google.Gmail,3,1735421305,1735421308,1735421308.883723,-21600,EB445137-D7F5-57EC-87DA-1DB460D64046,"iPhone13,2"
com.google.Gmail,6,1735421240,1735421246,1735421246.6009789,-21600,EB445137-D7F5-57EC-87DA-1DB460D64046,"iPhone13,2"
com.google.Gmail,2,1735421237,1735421239,1735421239.472683,-21600,EB445137-D7F5-57EC-87DA-1DB460D64046,"iPhone13,2"
com.google.Gmail,6,1735421209,1735421215,1735421215.839112,-21600,EB445137-D7F5-57EC-87DA-1DB460D64046,"iPhone13,2"
com.apple.camera,0,1735421209,1735421209,1735421209.577352,-21600,EB445137-D7F5-57EC-87DA-1DB460D64046,"iPhone13,2"
com.google.Gmail,9,1735421195,1735421204,1735421204.5025182,-21600,EB445137-D7F5-57EC-87DA-1DB460D64046,"iPhone13,2"
com.microsoft.onenote.mac,336,1735404893,1735405229,1735405229.1070151,-21600,,
com.google.android.studio,91,1735404802,1735404893,1735404893.298116,-21600,,
com.google.Chrome,9,1735404793,1735404802,1735404802.752742,-21600,,
com.google.android.studio,81,1735404712,1735404793,1735404793.103208,-21600,,
com.google.Chrome,36,1735404676,1735404712,1735404712.5152578,-21600,,
com.google.android.studio,103,1735404573,1735404676,1735404676.298104,-21600,,
com.google.Chrome,5,1735404568,1735404573,1735404573.5822759,-21600,,
com.google.android.studio,6,1735404562,1735404568,1735404568.822424,-21600,,
com.google.Chrome,2,1735404560,1735404562,1735404563.029311,-21600,,
com.google.android.studio,1,1735404559,1735404560,1735404561.004311,-21600,,
com.google.Chrome,1,1735404558,1735404559,1735404559.2962341,-21600,,
com.google.android.studio,10,1735404548,1735404558,1735404558.322813,-21600,,
com.google.Chrome,5,1735404543,1735404548,1735404548.7424479,-21600,,
com.google.android.studio,4,1735404539,1735404543,1735404543.1211262,-21600,,
com.google.Chrome,1,1735404538,1735404539,1735404539.436621,-21600,,
com.google.android.studio,3,1735404535,1735404538,1735404538.514515,-21600,,
com.google.Chrome,1,1735404534,1735404535,1735404536.00686,-21600,,
com.google.android.studio,1,1735404533,1735404534,1735404534.791699,-21600,,
com.google.Chrome,1,1735404532,1735404533,1735404533.216454,-21600,,
com.google.android.studio,8,1735404524,1735404532,1735404532.341568,-21600,,
com.google.Chrome,2,1735404522,1735404524,1735404524.1757889,-21600,,
com.google.android.studio,3,1735404519,1735404522,1735404522.6454449,-21600,,
com.google.Chrome,1,1735404518,1735404519,1735404519.631608,-21600,,
com.google.android.studio,6,1735404512,1735404518,1735404518.494331,-21600,,
com.google.Chrome,1,1735404511,1735404512,1735404512.299154,-21600,,
com.google.android.studio,4,1735404507,1735404511,1735404511.5128741,-21600,,
com.google.Chrome,1,1735404506,1735404507,1735404507.423667,-21600,,
com.google.android.studio,3,1735404503,1735404506,1735404506.574038,-21600,,
com.google.Chrome,1,1735404502,1735404503,1735404503.7260861,-21600,,
com.google.android.studio,3,1735404499,1735404502,1735404502.313621,-21600,,
com.google.Chrome,1,1735404498,1735404499,1735404499.560237,-21600,,
com.google.android.studio,8,1735404490,1735404498,1735404498.095038,-21600,,
com.google.Chrome,10,1735404480,1735404490,1735404490.358419,-21600,,
com.google.android.studio,90,1735404390,1735404480,1735404480.8631449,-21600,,
com.google.Chrome,1,1735404389,1735404390,1735404390.927956,-21600,,
com.google.android.studio,16,1735404373,1735404389,1735404389.31511,-21600,,
com.google.Chrome,68,1735404305,1735404373,1735404373.5615082,-21600,,
com.google.android.studio,7,1735404298,1735404305,1735404305.7812319,-21600,,
com.google.Chrome,1,1735404297,1735404298,1735404298.399524,-21600,,
com.google.android.studio,12,1735404285,1735404297,1735404297.292441,-21600,,
com.google.Chrome,66,1735404219,1735404285,1735404286.0436668,-21600,,
com.google.android.studio,1,1735404218,1735404219,1735404220.0303621,-21600,,
com.google.Chrome,10,1735404208,1735404218,1735404218.9779491,-21600,,
com.google.android.studio,29,1735404179,1735404208,1735404208.975913,-21600,,
com.google.Chrome,3,1735404176,1735404179,1735404179.620156,-21600,,
com.google.android.studio,4,1735404172,1735404176,1735404176.674048,-21600,,
com.google.Chrome,19,1735404153,1735404172,1735404172.940003,-21600,,
com.google.android.studio,11,1735404142,1735404153,1735404153.55688,-21600,,
com.google.Chrome,8,1735404134,1735404142,1735404142.465207,-21600,,
com.microsoft.onenote.mac,2,1735404132,1735404134,1735404134.4177399,-21600,,
com.google.android.studio,6,1735404126,1735404132,1735404132.668567,-21600,,
com.microsoft.onenote.mac,2,1735404124,1735404126,1735404126.183412,-21600,,
com.google.Chrome,23,1735404101,1735404124,1735404124.2815108,-21600,,
com.microsoft.onenote.mac,1,1735404100,1735404101,1735404101.90033,-21600,,
com.google.android.studio,18,1735404082,1735404100,1735404100.488441,-21600,,
com.microsoft.onenote.mac,3,1735404079,1735404082,1735404082.391474,-21600,,
com.google.android.studio,2,1735404077,1735404079,1735404079.047981,-21600,,
com.google.Chrome,5,1735404072,1735404077,1735404078.022893,-21600,,
com.google.android.studio,28,1735404044,1735404072,1735404072.1981711,-21600,,
com.google.Chrome,3,1735404041,1735404044,1735404044.663163,-21600,,
com.google.android.studio,1,1735404040,1735404041,1735404041.446696,-21600,,
com.google.Chrome,69,1735403971,1735404040,1735404040.983212,-21600,,
com.google.android.studio,37,1735403934,1735403971,1735403971.2106571,-21600,,
com.google.Chrome,39,1735403895,1735403934,1735403934.791932,-21600,,
com.google.android.studio,1,1735403894,1735403895,1735403895.995065,-21600,,
com.google.Chrome,20,1735403874,1735403894,1735403894.792317,-21600,,
com.google.android.studio,37,1735403837,1735403874,1735403874.174566,-21600,,
com.microsoft.onenote.mac,18,1735403819,1735403837,1735403837.555824,-21600,,
com.google.android.studio,31,1735403788,1735403819,1735403819.500345,-21600,,
com.microsoft.onenote.mac,14,1735403774,1735403788,1735403788.0767379,-21600,,
com.google.android.studio,17,1735403757,1735403774,1735403774.888489,-21600,,
com.apple.finder,47,1735403710,1735403757,1735403757.9155412,-21600,,
com.cisco.secureclient.gui,6,1735403704,1735403710,1735403710.9841971,-21600,,
com.google.Chrome,14,1735403690,1735403704,1735403704.6827679,-21600,,
com.apple.Terminal,204,1735403486,1735403690,1735403690.7324681,-21600,,
com.google.Chrome,6,1735403480,1735403486,1735403487.000148,-21600,,
com.apple.Terminal,82,1735403398,1735403480,1735403481.013832,-21600,,
com.google.Chrome,9,1735403389,1735403398,1735403398.564589,-21600,,
com.apple.Terminal,1,1735403388,1735403389,1735403389.108134,-21600,,
com.google.Chrome,39,1735403349,1735403388,1735403388.7582722,-21600,,
com.apple.Terminal,54,1735403295,1735403349,1735403349.633214,-21600,,
com.google.Chrome,21,1735403274,1735403295,1735403295.566656,-21600,,
com.apple.Terminal,18,1735403256,1735403274,1735403274.300004,-21600,,
com.google.Chrome,21,1735403235,1735403256,1735403256.291078,-21600,,
com.apple.Terminal,22,1735403213,1735403235,1735403235.486905,-21600,,
com.google.Chrome,14,1735403199,1735403213,1735403213.0997481,-21600,,
com.apple.Terminal,40,1735403159,1735403199,1735403199.527542,-21600,,
com.apple.finder,0,1735403159,1735403159,1735403159.833095,-21600,,
com.apple.Terminal,248,1735402911,1735403159,1735403159.2557359,-21600,,
com.apple.finder,6,1735402905,1735402911,1735402911.43677,-21600,,
com.cisco.secureclient.gui,29,1735402876,1735402905,1735402905.5793629,-21600,,
com.apple.finder,4,1735402872,1735402876,1735402877.012044,-21600,,
com.apple.finder,7,1735363514,1735363521,1735363521.373955,-21600,,
com.google.Chrome,156,1735363358,1735363514,1735363514.9314709,-21600,,
com.google.Chrome,7,1735353327,1735353334,1735353334.48425,-21600,,
com.apple.MobileSMS,1,1735353326,1735353327,1735353327.231242,-21600,,
com.google.Chrome,6,1735353320,1735353326,1735353326.462064,-21600,,
com.hnc.Discord,5,1735353315,1735353320,1735353321.364853,-21600,,
com.hnc.Discord,180,1735351637,1735351817,1735351817.634448,-21600,,
com.hnc.Discord,301,1735351334,1735351635,1735351635.1010962,-21600,,
com.hnc.Discord,487,1735350845,1735351332,1735351332.506269,-21600,,
com.hnc.Discord,301,1735350537,1735350838,1735350838.251254,-21600,,
com.hnc.Discord,300,1735350236,1735350536,1735350536.626416,-21600,,
com.google.Chrome,42,1735350194,1735350236,1735350236.638472,-21600,,
com.hnc.Discord,6,1735350188,1735350194,1735350194.941575,-21600,,
com.google.Chrome,94,1735350094,1735350188,1735350188.496214,-21600,,
com.hnc.Discord,5,1735350089,1735350094,1735350094.821711,-21600,,
com.google.Chrome,24,1735350065,1735350089,1735350089.626127,-21600,,
com.hnc.Discord,3,1735350062,1735350065,1735350065.2938728,-21600,,
com.google.Chrome,281,1735349781,1735350062,1735350062.240003,-21600,,
com.hnc.Discord,2,1735349779,1735349781,1735349781.871804,-21600,,
com.google.Chrome,143,1735349636,1735349779,1735349779.72207,-21600,,
com.hnc.Discord,2,1735349634,1735349636,1735349636.738415,-21600,,
com.google.Chrome,73,1735349561,1735349634,1735349634.33019,-21600,,
com.hnc.Discord,4,1735349557,1735349561,1735349561.558402,-21600,,
com.google.Chrome,67,1735349490,1735349557,1735349557.261602,-21600,,
com.hnc.Discord,1,1735349489,1735349490,1735349490.998693,-21600,,
com.google.Chrome,3,1735349486,1735349489,1735349489.75638,-21600,,
com.hnc.Discord,1,1735349485,1735349486,1735349486.5542998,-21600,,
com.google.Chrome,66,1735349419,1735349485,1735349485.32318,-21600,,
com.hnc.Discord,2,1735349417,1735349419,1735349419.3101501,-21600,,
com.google.Chrome,62,1735349355,1735349417,1735349417.673297,-21600,,
com.hnc.Discord,2,1735349353,1735349355,1735349355.579862,-21600,,
com.google.Chrome,37,1735349316,1735349353,1735349353.908928,-21600,,
com.hnc.Discord,2,1735349314,1735349316,1735349316.4364362,-21600,,
com.google.Chrome,37,1735349277,1735349314,1735349314.679132,-21600,,
com.hnc.Discord,1,1735349276,1735349277,1735349277.823405,-21600,,
com.google.Chrome,21,1735349255,1735349276,1735349276.289226,-21600,,
com.hnc.Discord,2,1735349253,1735349255,1735349255.703611,-21600,,
com.google.Chrome,36,1735349217,1735349253,1735349254.021761,-21600,,
com.hnc.Discord,1,1735349216,1735349217,1735349217.723082,-21600,,
com.google.Chrome,18,1735349198,1735349216,1735349216.249373,-21600,,
com.hnc.Discord,1,1735349197,1735349198,1735349198.894483,-21600,,
com.google.Chrome,32,1735349165,1735349197,1735349197.1588259,-21600,,
com.hnc.Discord,6,1735349159,1735349165,1735349165.4387522,-21600,,
com.google.Chrome,35,1735349124,1735349159,1735349159.486246,-21600,,
com.hnc.Discord,6,1735349118,1735349124,1735349124.350841,-21600,,
com.google.Chrome,146,1735348972,1735349118,1735349118.482833,-21600,,
com.hnc.Discord,4,1735348968,1735348972,1735348972.354992,-21600,,
com.google.Chrome,25,1735348943,1735348968,1735348968.360429,-21600,,
com.hnc.Discord,2,1735348941,1735348943,1735348943.193888,-21600,,
com.google.Chrome,14,1735348927,1735348941,1735348941.802166,-21600,,
com.hnc.Discord,3,1735348924,1735348927,1735348927.496313,-21600,,
com.google.Chrome,52,1735348872,1735348924,1735348924.677709,-21600,,
com.hnc.Discord,2,1735348870,1735348872,1735348872.310528,-21600,,
com.google.Chrome,2,1735348868,1735348870,1735348870.9631472,-21600,,
com.hnc.Discord,5,1735348863,1735348868,1735348868.501595,-21600,,
com.google.Chrome,477,1735348386,1735348863,1735348863.964046,-21600,,
com.apple.iCal,5,1735348381,1735348386,1735348386.926811,-21600,,
com.google.Chrome,345,1735348036,1735348381,1735348381.553932,-21600,,
com.apple.MobileSMS,2,1735348034,1735348036,1735348036.9741511,-21600,,
com.google.Chrome,38,1735347996,1735348034,1735348034.95432,-21600,,
com.apple.MobileSMS,10,1735347986,1735347996,1735347996.8211,-21600,,
com.google.Chrome,75,1735347911,1735347986,1735347986.819185,-21600,,
com.apple.MobileSMS,2,1735347909,1735347911,1735347911.203644,-21600,,
com.google.Chrome,24,1735347885,1735347909,1735347909.0739179,-21600,,
com.hnc.Discord,162,1735347723,1735347885,1735347885.438657,-21600,,
com.google.Chrome,2,1735347721,1735347723,1735347723.4857259,-21600,,
com.hnc.Discord,3,1735347718,1735347721,1735347721.960141,-21600,,
com.google.Chrome,1,1735347717,1735347718,1735347718.339488,-21600,,
com.hnc.Discord,1,1735347716,1735347717,1735347717.0990992,-21600,,
com.google.Chrome,2,1735347714,1735347716,1735347716.0643392,-21600,,
com.hnc.Discord,2,1735347712,1735347714,1735347715.0009022,-21600,,
com.google.Chrome,6,1735347706,1735347712,1735347712.977872,-21600,,
com.apple.MobileSMS,1,1735347705,1735347706,1735347706.8805609,-21600,,
com.google.Chrome,100,1735347605,1735347705,1735347705.8262281,-21600,,
com.apple.MobileSMS,6,1735347599,1735347605,1735347605.555646,-21600,,
com.google.Chrome,64,1735347535,1735347599,1735347599.0615659,-21600,,
com.apple.MobileSMS,35,1735347500,1735347535,1735347535.370899,-21600,,
com.apple.iCal,1,1735347499,1735347500,1735347500.887383,-21600,,
com.google.Chrome,273,1735347226,1735347499,1735347499.4490108,-21600,,
com.apple.MobileSMS,8,1735347218,1735347226,1735347226.512613,-21600,,
com.hnc.Discord,6,1735347212,1735347218,1735347218.114447,-21600,,
com.google.Chrome,223,1735346989,1735347212,1735347212.678831,-21600,,
com.apple.MobileSMS,4,1735346985,1735346989,1735346989.4961228,-21600,,
com.hnc.Discord,29,1735346956,1735346985,1735346985.06817,-21600,,
com.google.Chrome,5,1735346951,1735346956,1735346956.8899379,-21600,,
com.hnc.Discord,6,1735346945,1735346951,1735346951.505645,-21600,,
com.google.Chrome,5,1735346940,1735346945,1735346945.5200691,-21600,,
com.hnc.Discord,2,1735346938,1735346940,1735346940.4052129,-21600,,
com.apple.MobileSMS,27,1735346911,1735346938,1735346938.199969,-21600,,
com.google.Chrome,14,1735346897,1735346911,1735346911.9533439,-21600,,
com.apple.MobileSMS,5,1735346892,1735346897,1735346897.1352181,-21600,,
com.google.Chrome,21,1735346871,1735346892,1735346892.368151,-21600,,
com.apple.MobileSMS,4,1735346867,1735346871,1735346871.182485,-21600,,
com.google.Chrome,8,1735346859,1735346867,1735346867.8596501,-21600,,
com.apple.MobileSMS,2,1735346857,1735346859,1735346859.428156,-21600,,
com.google.Chrome,14,1735346843,1735346857,1735346857.212724,-21600,,
com.apple.MobileSMS,2,1735346841,1735346843,1735346843.505265,-21600,,
com.google.Chrome,4,1735346837,1735346841,1735346841.780661,-21600,,
com.apple.MobileSMS,18,1735346819,1735346837,1735346837.443604,-21600,,
com.google.Chrome,35,1735346784,1735346819,1735346819.945066,-21600,,
com.apple.MobileSMS,9,1735346775,1735346784,1735346784.182781,-21600,,
com.google.Chrome,35,1735346740,1735346775,1735346775.2897239,-21600,,
com.apple.iCal,13,1735346727,1735346740,1735346740.5420408,-21600,,
com.google.Chrome,26,1735346701,1735346727,1735346727.424988,-21600,,
com.apple.MobileSMS,12,1735346689,1735346701,1735346701.358681,-21600,,
com.google.Chrome,52,1735346637,1735346689,1735346689.870792,-21600,,
com.apple.MobileSMS,10,1735346627,1735346637,1735346637.1410708,-21600,,
com.google.Chrome,6,1735346621,1735346627,1735346627.205813,-21600,,
com.google.Chrome,577,1735345817,1735346394,1735346394.087401,-21600,,
com.google.Chrome,146,1735339688,1735339834,1735339834.2774901,-21600,,
com.leomehlig.today,5,1735339683,1735339688,1735339688.9185538,-21600,,
com.apple.MobileSMS,10,1735339673,1735339683,1735339683.591836,-21600,,
com.leomehlig.today,19,1735339654,1735339673,1735339673.64252,-21600,,
com.cisco.secureclient.gui,4,1735339650,1735339654,1735339654.247513,-21600,,
com.leomehlig.today,10,1735339640,1735339650,1735339650.9160771,-21600,,
com.cisco.secureclient.gui,30,1735339610,1735339640,1735339640.245827,-21600,,
com.microsoft.Outlook,2,1735339608,1735339610,1735339610.733231,-21600,,
com.cisco.secureclient.gui,296,1735339312,1735339608,1735339608.8222609,-21600,,
com.google.Chrome,114,1735339198,1735339312,1735339312.832076,-21600,,
com.google.Chrome,454,1735338731,1735339185,1735339185.2267709,-21600,,
com.google.Chrome,301,1735338325,1735338626,1735338626.403374,-21600,,
com.google.Chrome,755,1735337569,1735338324,1735338324.764042,-21600,,
com.leomehlig.today,11,1735337558,1735337569,1735337569.3966,-21600,,
com.google.Chrome,314,1735337244,1735337558,1735337558.1066608,-21600,,
com.google.Chrome,801,1735336195,1735336996,1735336996.7373018,-21600,,
com.google.Chrome,303,1735335786,1735336089,1735336089.827075,-21600,,
com.google.Chrome,587,1735334832,1735335419,1735335419.438694,-21600,,
com.google.Chrome,952,1735333879,1735334831,1735334831.571235,-21600,,
com.google.Chrome,606,1735333180,1735333786,1735333786.6497478,-21600,,
com.apple.iCal,12,1735333168,1735333180,1735333180.477622,-21600,,
com.leomehlig.today,148,1735333020,1735333168,1735333168.6694422,-21600,,
com.microsoft.Outlook,243,1735332777,1735333020,1735333020.8691912,-21600,,
com.leomehlig.today,224,1735332553,1735332777,1735332777.713224,-21600,,
com.apple.iCal,10,1735332543,1735332553,1735332553.427124,-21600,,
com.cisco.secureclient.gui,11,1735332532,1735332543,1735332543.487438,-21600,,
com.google.Chrome,93,1735332439,1735332532,1735332532.43254,-21600,,
com.apple.Terminal,9,1735332430,1735332439,1735332439.953078,-21600,,
us.zoom.xos,3,1735332427,1735332430,1735332430.964939,-21600,,
com.microsoft.rdc.macos,14,1735332413,1735332427,1735332427.226007,-21600,,
us.zoom.xos,137,1735332276,1735332413,1735332413.362606,-21600,,
com.apple.Terminal,87,1735332189,1735332276,1735332276.811424,-21600,,
com.microsoft.rdc.macos,18,1735332171,1735332189,1735332189.906423,-21600,,
com.apple.finder,34,1735332137,1735332171,1735332171.855104,-21600,,
com.apple.Terminal,36,1735332101,1735332137,1735332138.008597,-21600,,
com.microsoft.rdc.macos,14,1735332087,1735332101,1735332102.0140262,-21600,,
com.apple.Terminal,40,1735332047,1735332087,1735332087.324564,-21600,,
com.microsoft.rdc.macos,53,1735331994,1735332047,1735332047.914227,-21600,,
com.google.Chrome,13,1735331981,1735331994,1735331994.775855,-21600,,
com.microsoft.rdc.macos,221,1735331760,1735331981,1735331981.079679,-21600,,
com.google.Chrome,7,1735331753,1735331760,1735331760.865354,-21600,,
com.microsoft.rdc.macos,1094,1735330659,1735331753,1735331754.035328,-21600,,
com.google.Chrome,5,1735330654,1735330659,1735330659.24899,-21600,,
com.cisco.secureclient.gui,38,1735330616,1735330654,1735330654.28472,-21600,,
com.google.Chrome,32,1735330584,1735330616,1735330616.843161,-21600,,
com.apple.systempreferences,4,1735330581,1735330585,1735330585.753018,-21600,,
com.google.Chrome,103,1735330475,1735330578,1735330578.46208,-21600,,
us.zoom.xos,3,1735330472,1735330475,1735330475.816936,-21600,,
com.google.Chrome,6,1735330466,1735330472,1735330472.579424,-21600,,
us.zoom.xos,290,1735330176,1735330466,1735330466.9725718,-21600,,
com.google.Chrome,10,1735330166,1735330176,1735330176.154819,-21600,,
us.zoom.xos,2,1735330164,1735330166,1735330166.9868011,-21600,,
com.google.Chrome,143,1735330021,1735330164,1735330164.960895,-21600,,
us.zoom.xos,5,1735330016,1735330021,1735330022.016849,-21600,,
com.google.Chrome,10,1735330006,1735330016,1735330016.042337,-21600,,
us.zoom.xos,39,1735329967,1735330006,1735330006.57388,-21600,,
com.google.Chrome,1,1735329966,1735329967,1735329967.797532,-21600,,
us.zoom.xos,64,1735329902,1735329966,1735329966.074866,-21600,,
com.google.Chrome,2,1735329900,1735329902,1735329902.0455298,-21600,,
us.zoom.xos,10,1735329890,1735329900,1735329900.422071,-21600,,
com.google.Chrome,4,1735329886,1735329890,1735329890.225374,-21600,,
us.zoom.xos,3,1735329883,1735329886,1735329886.074839,-21600,,
com.google.Chrome,3,1735329880,1735329883,1735329883.1648412,-21600,,
us.zoom.xos,109,1735329771,1735329880,1735329880.752404,-21600,,
com.google.Chrome,10,1735329761,1735329771,1735329771.241318,-21600,,
us.zoom.xos,2,1735329759,1735329761,1735329761.207109,-21600,,
com.google.Chrome,6,1735329753,1735329759,1735329759.843951,-21600,,
us.zoom.xos,56,1735329697,1735329753,1735329753.689456,-21600,,
com.google.Chrome,1,1735329696,1735329697,1735329698.012618,-21600,,
us.zoom.xos,36,1735329660,1735329696,1735329696.498797,-21600,,
com.google.Chrome,6,1735329654,1735329660,1735329660.870027,-21600,,
us.zoom.xos,22,1735329632,1735329654,1735329654.749928,-21600,,
com.google.Chrome,3,1735329629,1735329632,1735329632.630157,-21600,,
us.zoom.xos,4,1735329625,1735329629,1735329629.130221,-21600,,
com.google.Chrome,8,1735329617,1735329625,1735329625.5969439,-21600,,
us.zoom.xos,17,1735329600,1735329617,1735329617.1964068,-21600,,
com.google.Chrome,1,1735329599,1735329600,1735329600.381541,-21600,,
us.zoom.xos,76,1735329523,1735329599,1735329599.109865,-21600,,
com.google.Chrome,4,1735329519,1735329523,1735329523.110158,-21600,,
us.zoom.xos,80,1735329439,1735329519,1735329519.4300961,-21600,,
com.google.Chrome,3,1735329436,1735329439,1735329439.893897,-21600,,
us.zoom.xos,16,1735329420,1735329436,1735329436.589313,-21600,,
com.google.Chrome,3,1735329417,1735329420,1735329420.833734,-21600,,
us.zoom.xos,6,1735329411,1735329417,1735329417.9804611,-21600,,
com.google.Chrome,0,1735329411,1735329411,1735329411.8037848,-21600,,
us.zoom.xos,5,1735329406,1735329411,1735329411.32219,-21600,,
com.google.Chrome,3,1735329403,1735329406,1735329406.2490711,-21600,,
us.zoom.xos,251,1735329152,1735329403,1735329403.7357612,-21600,,
com.google.Chrome,16,1735329136,1735329152,1735329152.814749,-21600,,
us.zoom.xos,2,1735329134,1735329136,1735329136.6175718,-21600,,
com.google.Chrome,1,1735329133,1735329134,1735329134.602981,-21600,,
us.zoom.xos,2,1735329131,1735329133,1735329133.5299969,-21600,,
com.google.Chrome,265,1735328866,1735329131,1735329131.875087,-21600,,
us.zoom.xos,5,1735328861,1735328866,1735328866.5810251,-21600,,
com.google.Chrome,10,1735328851,1735328861,1735328862.2726588,-21600,,
us.zoom.xos,12,1735328839,1735328851,1735328851.063684,-21600,,
com.google.Chrome,3,1735328836,1735328839,1735328840.0346122,-21600,,
us.zoom.xos,98,1735328738,1735328836,1735328836.47337,-21600,,
com.google.Chrome,3,1735328735,1735328738,1735328738.531271,-21600,,
us.zoom.xos,1,1735328734,1735328735,1735328736.013313,-21600,,
com.google.Chrome,7,1735328727,1735328734,1735328734.8682442,-21600,,
us.zoom.xos,1,1735328726,1735328727,1735328727.464919,-21600,,
com.google.Chrome,7,1735328719,1735328726,1735328726.192068,-21600,,
us.zoom.xos,19,1735328700,1735328719,1735328719.466742,-21600,,
com.google.Chrome,4,1735328696,1735328700,1735328700.598891,-21600,,
us.zoom.xos,91,1735328605,1735328696,1735328696.367206,-21600,,
com.google.Chrome,5,1735328600,1735328605,1735328605.597962,-21600,,
us.zoom.xos,73,1735328527,1735328600,1735328600.50565,-21600,,
com.google.Chrome,7,1735328520,1735328527,1735328527.9044151,-21600,,
us.zoom.xos,49,1735328471,1735328520,1735328520.640965,-21600,,
com.google.Chrome,5,1735328466,1735328471,1735328471.149729,-21600,,
us.zoom.xos,8,1735328458,1735328466,1735328466.746351,-21600,,
com.google.Chrome,5,1735328453,1735328458,1735328458.785626,-21600,,
us.zoom.xos,143,1735328310,1735328453,1735328453.801929,-21600,,
com.google.Chrome,1,1735328309,1735328310,1735328311.0188231,-21600,,
us.zoom.xos,1,1735328308,1735328309,1735328309.702946,-21600,,
com.google.Chrome,4,1735328304,1735328308,1735328308.073555,-21600,,
us.zoom.xos,46,1735328258,1735328304,1735328304.81266,-21600,,
com.google.Chrome,2,1735328256,1735328258,1735328258.7361178,-21600,,
us.zoom.xos,14,1735328242,1735328256,1735328256.780474,-21600,,
com.google.Chrome,3,1735328239,1735328242,1735328242.336626,-21600,,
us.zoom.xos,19,1735328220,1735328239,1735328239.5505009,-21600,,
com.google.Chrome,1,1735328219,1735328220,1735328220.469606,-21600,,
us.zoom.xos,4,1735328215,1735328219,1735328219.290872,-21600,,
com.google.Chrome,11,1735328204,1735328215,1735328215.155239,-21600,,
us.zoom.xos,4,1735328200,1735328204,1735328204.564425,-21600,,
com.google.Chrome,1,1735328199,1735328200,1735328200.246752,-21600,,
us.zoom.xos,1,1735328198,1735328199,1735328199.220005,-21600,,
us.zoom.xos,300,1735327889,1735328189,1735328189.744755,-21600,,
com.google.Chrome,5,1735327884,1735327889,1735327889.789082,-21600,,
us.zoom.xos,21,1735327863,1735327884,1735327884.149053,-21600,,
com.google.Chrome,2,1735327861,1735327863,1735327863.928248,-21600,,
us.zoom.xos,51,1735327810,1735327861,1735327861.833749,-21600,,
com.google.Chrome,13,1735327797,1735327810,1735327810.6646209,-21600,,
us.zoom.xos,5,1735327792,1735327797,1735327797.438905,-21600,,
com.google.Chrome,3,1735327789,1735327792,1735327792.263552,-21600,,
us.zoom.xos,124,1735327665,1735327789,1735327789.1618981,-21600,,
com.google.Chrome,1,1735327664,1735327665,1735327665.134173,-21600,,
us.zoom.xos,3,1735327661,1735327664,1735327664.18206,-21600,,
com.google.Chrome,3,1735327658,1735327661,1735327661.1758451,-21600,,
us.zoom.xos,46,1735327612,1735327658,1735327658.2903218,-21600,,
com.google.Chrome,4,1735327608,1735327612,1735327612.085284,-21600,,
us.zoom.xos,5,1735327603,1735327608,1735327608.5519881,-21600,,
com.google.Chrome,2,1735327601,1735327603,1735327603.6114159,-21600,,
us.zoom.xos,2,1735327599,1735327601,1735327601.14745,-21600,,
com.google.Chrome,4,1735327595,1735327599,1735327599.90429,-21600,,
us.zoom.xos,18,1735327577,1735327595,1735327595.626841,-21600,,
com.google.Chrome,9,1735327568,1735327577,1735327577.4551601,-21600,,
us.zoom.xos,24,1735327544,1735327568,1735327568.622556,-21600,,
com.google.Chrome,3,1735327541,1735327544,1735327544.833123,-21600,,
us.zoom.xos,149,1735327392,1735327541,1735327541.3679528,-21600,,
com.google.Chrome,12,1735327380,1735327392,1735327392.201552,-21600,,
us.zoom.xos,15,1735327365,1735327380,1735327381.0475311,-21600,,
com.google.Chrome,2,1735327363,1735327365,1735327365.322122,-21600,,
us.zoom.xos,36,1735327327,1735327363,1735327363.2642379,-21600,,
us.zoom.xos,300,1735327027,1735327327,1735327327.2486448,-21600,,
com.google.Chrome,9,1735327018,1735327027,1735327027.274127,-21600,,
us.zoom.xos,2,1735327016,1735327018,1735327018.4316912,-21600,,
com.google.Chrome,2,1735327014,1735327016,1735327016.6088738,-21600,,
us.zoom.xos,79,1735326935,1735327014,1735327014.935559,-21600,,
com.google.Chrome,8,1735326927,1735326935,1735326935.356865,-21600,,
us.zoom.xos,4,1735326923,1735326927,1735326927.608276,-21600,,
com.google.Chrome,0,1735326923,1735326923,1735326923.9411678,-21600,,
us.zoom.xos,1,1735326922,1735326923,1735326923.572015,-21600,,
com.google.Chrome,0,1735326922,1735326922,1735326922.9174771,-21600,,
us.zoom.xos,43,1735326879,1735326922,1735326922.2612581,-21600,,
com.google.Chrome,2,1735326877,1735326879,1735326880.0009751,-21600,,
us.zoom.xos,10,1735326867,1735326877,1735326877.886944,-21600,,
com.google.Chrome,3,1735326864,1735326867,1735326867.88978,-21600,,
us.zoom.xos,133,1735326731,1735326864,1735326864.689128,-21600,,
com.google.Chrome,2,1735326729,1735326731,1735326731.533637,-21600,,
us.zoom.xos,2,1735326727,1735326729,1735326729.4028192,-21600,,
com.google.Chrome,2,1735326725,1735326727,1735326727.4741101,-21600,,
us.zoom.xos,6,1735326719,1735326725,1735326725.1658301,-21600,,
com.google.Chrome,1,1735326718,1735326719,1735326719.3717499,-21600,,
us.zoom.xos,2,1735326716,1735326718,1735326718.075944,-21600,,
com.google.Chrome,14,1735326702,1735326716,1735326716.1939301,-21600,,
us.zoom.xos,1,1735326701,1735326702,1735326702.947733,-21600,,
com.google.Chrome,2,1735326699,1735326701,1735326701.169142,-21600,,
us.zoom.xos,0,1735326699,1735326699,1735326699.812992,-21600,,
us.zoom.xos,300,1735326280,1735326580,1735326580.017138,-21600,,
com.google.Chrome,12,1735326268,1735326280,1735326280.0378098,-21600,,
us.zoom.xos,37,1735326231,1735326268,1735326268.9974399,-21600,,
com.google.Chrome,2,1735326229,1735326231,1735326231.549405,-21600,,
us.zoom.xos,134,1735326095,1735326229,1735326229.3233051,-21600,,
com.google.Chrome,7,1735326088,1735326095,1735326095.290487,-21600,,
us.zoom.xos,29,1735326059,1735326088,1735326088.672624,-21600,,
com.google.Chrome,5,1735326054,1735326059,1735326059.311573,-21600,,
us.zoom.xos,15,1735326039,1735326054,1735326054.743761,-21600,,
com.google.Chrome,0,1735326039,1735326039,1735326039.555022,-21600,,
com.apple.installer,11,1735326028,1735326039,1735326039.192847,-21600,,
com.google.Chrome,3,1735326020,1735326023,1735326023.6827512,-21600,,
us.zoom.xos,10,1735326010,1735326020,1735326020.880155,-21600,,
com.google.Chrome,26,1735325984,1735326010,1735326010.1760402,-21600,,
com.google.Chrome,300,1735325608,1735325908,1735325908.566368,-21600,,
us.zoom.xos,18,1735325590,1735325608,1735325608.709786,-21600,,
com.google.Chrome,8,1735325582,1735325590,1735325590.569808,-21600,,
us.zoom.xos,14,1735325568,1735325582,1735325583.079248,-21600,,
com.google.Chrome,1,1735325567,1735325568,1735325568.383295,-21600,,
com.apple.installer,17,1735325550,1735325567,1735325567.638056,-21600,,
com.google.Chrome,2,1735325548,1735325550,1735325550.698001,-21600,,
us.zoom.xos,3,1735325545,1735325548,1735325548.5152879,-21600,,
com.google.Chrome,171,1735325374,1735325545,1735325545.5606031,-21600,,
com.google.Chrome,326,1735325046,1735325372,1735325372.192276,-21600,,
com.google.Chrome,338,1735324641,1735324979,1735324979.662008,-21600,,
com.google.Chrome,10,1735322317,1735322327,1735322327.815363,-21600,,
com.leomehlig.today,2,1735322315,1735322317,1735322317.154798,-21600,,
com.leomehlig.today,584,1735318526,1735319110,1735319110.625886,-21600,,
com.google.Chrome,1,1735318525,1735318526,1735318526.165604,-21600,,
com.leomehlig.today,3,1735318522,1735318525,1735318525.5315142,-21600,,
com.google.Chrome,272,1735318250,1735318522,1735318522.169663,-21600,,
com.google.Chrome,51,1735313255,1735313306,1735313306.5664968,-21600,,
com.google.Chrome,192,1735262677,1735262869,1735262869.646039,-21600,,
com.google.Chrome,557,1735248358,1735248915,1735248915.961679,-21600,,
com.apple.iCal,1,1735248357,1735248358,1735248358.727584,-21600,,
com.apple.iCal,300,1735245483,1735245783,1735245783.279511,-21600,,
com.apple.MobileSMS,6,1735245477,1735245483,1735245483.0324721,-21600,,
com.apple.iCal,65,1735245412,1735245477,1735245477.721243,-21600,,
com.google.Chrome,31,1735245381,1735245412,1735245412.160167,-21600,,
com.google.Chrome,8,1735232196,1735232204,1735232204.783646,-21600,,
com.microsoft.onenote.mac,0,1735232196,1735232196,1735232197.0568728,-21600,,
com.google.android.studio,40,1735232156,1735232196,1735232196.963023,-21600,,
com.microsoft.onenote.mac,29,1735232127,1735232156,1735232156.091933,-21600,,
com.google.Chrome,1,1735232126,1735232127,1735232127.79559,-21600,,
com.apple.dt.Xcode,2,1735232124,1735232126,1735232126.577699,-21600,,
com.google.android.studio,109,1735232015,1735232124,1735232124.865656,-21600,,
com.microsoft.onenote.mac,89,1735231926,1735232015,1735232015.4557428,-21600,,
com.google.android.studio,40,1735231886,1735231926,1735231926.171879,-21600,,
com.microsoft.onenote.mac,6,1735231880,1735231886,1735231886.941469,-21600,,
com.google.android.studio,453,1735231427,1735231880,1735231880.991333,-21600,,
com.apple.dt.Xcode,1,1735231426,1735231427,1735231427.865471,-21600,,
com.google.Chrome,29,1735231397,1735231426,1735231426.351781,-21600,,
com.apple.dt.Xcode,1,1735231396,1735231397,1735231397.820603,-21600,,
com.google.android.studio,109,1735231287,1735231396,1735231396.525286,-21600,,
com.apple.dt.Xcode,7,1735231280,1735231287,1735231287.698295,-21600,,
com.google.android.studio,80,1735231200,1735231280,1735231280.575686,-21600,,
com.google.Chrome,7,1735231193,1735231200,1735231200.421422,-21600,,
com.google.android.studio,1,1735231192,1735231193,1735231193.8016691,-21600,,
com.google.Chrome,9,1735231183,1735231192,1735231192.960921,-21600,,
com.google.android.studio,56,1735231127,1735231183,1735231183.762247,-21600,,
com.google.Chrome,28,1735231099,1735231127,1735231127.878526,-21600,,
com.google.android.studio,55,1735231044,1735231099,1735231099.473537,-21600,,
com.google.Chrome,14,1735231030,1735231044,1735231044.1525068,-21600,,
com.google.android.studio,36,1735230994,1735231030,1735231030.63784,-21600,,
com.google.Chrome,0,1735230994,1735230994,1735230994.784912,-21600,,
com.google.android.studio,1,1735230993,1735230994,1735230994.5107589,-21600,,
com.apple.dt.Xcode,2,1735230991,1735230993,1735230993.3979979,-21600,,
com.google.Chrome,26,1735230965,1735230991,1735230991.59131,-21600,,
com.apple.dt.Xcode,2,1735230963,1735230965,1735230965.221932,-21600,,
com.google.android.studio,34,1735230929,1735230963,1735230963.9222379,-21600,,
com.apple.dt.Xcode,1,1735230928,1735230929,1735230929.825358,-21600,,
com.google.Chrome,6,1735230922,1735230928,1735230928.6858401,-21600,,
com.apple.dt.Xcode,2,1735230920,1735230922,1735230922.285356,-21600,,
com.google.android.studio,2,1735230918,1735230920,1735230920.624835,-21600,,
com.google.Chrome,8,1735230910,1735230918,1735230918.374917,-21600,,
com.google.android.studio,9,1735230901,1735230910,1735230910.0605311,-21600,,
com.apple.dt.Xcode,2,1735230899,1735230901,1735230901.669619,-21600,,
com.google.Chrome,8,1735230891,1735230899,1735230899.810062,-21600,,
com.apple.dt.Xcode,1,1735230890,1735230891,1735230892.098995,-21600,,
com.google.android.studio,292,1735230598,1735230890,1735230890.522198,-21600,,
com.apple.dt.Xcode,27,1735230571,1735230598,1735230598.533489,-21600,,
com.google.android.studio,125,1735230446,1735230571,1735230571.391451,-21600,,
com.google.Chrome,1,1735230445,1735230446,1735230446.4458961,-21600,,
com.google.android.studio,4,1735230441,1735230445,1735230445.5140262,-21600,,
com.google.Chrome,2,1735230439,1735230441,1735230441.318303,-21600,,
com.google.android.studio,21,1735230418,1735230439,1735230439.538321,-21600,,
com.google.Chrome,2,1735230416,1735230418,1735230418.900268,-21600,,
com.google.android.studio,109,1735230307,1735230416,1735230416.253084,-21600,,
com.google.Chrome,7,1735230300,1735230307,1735230307.7006578,-21600,,
com.google.android.studio,19,1735230281,1735230300,1735230300.7696319,-21600,,
com.google.Chrome,22,1735230259,1735230281,1735230281.6743488,-21600,,
com.google.android.studio,1,1735230258,1735230259,1735230259.679919,-21600,,
com.google.Chrome,32,1735230226,1735230258,1735230258.9911551,-21600,,
com.google.android.studio,2,1735230224,1735230226,1735230226.286718,-21600,,
com.google.Chrome,20,1735230204,1735230224,1735230224.4567552,-21600,,
com.google.android.studio,4,1735230200,1735230204,1735230204.1067472,-21600,,
com.google.Chrome,56,1735230144,1735230200,1735230200.787286,-21600,,
com.google.android.studio,20,1735230124,1735230144,1735230144.597543,-21600,,
com.google.Chrome,30,1735230094,1735230124,1735230125.056261,-21600,,
com.google.android.studio,454,1735229640,1735230094,1735230094.844592,-21600,,
com.google.Chrome,42,1735229598,1735229640,1735229640.624016,-21600,,
com.google.android.studio,824,1735228774,1735229598,1735229598.8118892,-21600,,
com.microsoft.onenote.mac,3,1735228771,1735228774,1735228774.642731,-21600,,
com.google.android.studio,34,1735228737,1735228771,1735228771.490837,-21600,,
com.google.Chrome,74,1735228663,1735228737,1735228738.038835,-21600,,
com.apple.news,299,1735226150,1735226449,1735226449.7406511,-21600,EB445137-D7F5-57EC-87DA-1DB460D64046,"iPhone13,2"
com.apple.news,175,1735225808,1735225983,1735225983.654189,-21600,EB445137-D7F5-57EC-87DA-1DB460D64046,"iPhone13,2"
com.facebook.Facebook,120,1735225672,1735225792,1735225792.366833,-21600,EB445137-D7F5-57EC-87DA-1DB460D64046,"iPhone13,2"
com.apple.mobiletimer,7,1735225587,1735225594,1735225594.165362,-21600,EB445137-D7F5-57EC-87DA-1DB460D64046,"iPhone13,2"
com.apple.mobiletimer,3,1735225580,1735225583,1735225583.946079,-21600,EB445137-D7F5-57EC-87DA-1DB460D64046,"iPhone13,2"
com.google.ios.youtube,1,1735225576,1735225577,1735225577.733607,-21600,EB445137-D7F5-57EC-87DA-1DB460D64046,"iPhone13,2"
com.apple.camera,1,1735225537,1735225538,1735225538.7399058,-21600,EB445137-D7F5-57EC-87DA-1DB460D64046,"iPhone13,2"
com.apple.Health,16,1735194151,1735194167,1735194167.295223,-21600,EB445137-D7F5-57EC-87DA-1DB460D64046,"iPhone13,2"
com.apple.mobiletimer,8,1735194134,1735194142,1735194142.816009,-21600,EB445137-D7F5-57EC-87DA-1DB460D64046,"iPhone13,2"
com.apple.Health,40,1735194084,1735194124,1735194125.0494518,-21600,EB445137-D7F5-57EC-87DA-1DB460D64046,"iPhone13,2"
com.apple.journal,1130,1735192951,1735194081,1735194081.4596481,-21600,EB445137-D7F5-57EC-87DA-1DB460D64046,"iPhone13,2"
com.apple.camera,0,1735192881,1735192881,1735192881.985899,-21600,EB445137-D7F5-57EC-87DA-1DB460D64046,"iPhone13,2"
com.tinyspeck.chatlyio,12,1735192826,1735192838,1735192838.237109,-21600,EB445137-D7F5-57EC-87DA-1DB460D64046,"iPhone13,2"
com.thestorygraph.thestorygraph,3,1735192823,1735192826,1735192827.0256782,-21600,EB445137-D7F5-57EC-87DA-1DB460D64046,"iPhone13,2"
com.thestorygraph.thestorygraph,13,1735192704,1735192717,1735192717.771294,-21600,EB445137-D7F5-57EC-87DA-1DB460D64046,"iPhone13,2"
com.thestorygraph.thestorygraph,173,1735192523,1735192696,1735192697.147625,-21600,EB445137-D7F5-57EC-87DA-1DB460D64046,"iPhone13,2"
com.tinyspeck.chatlyio,40,1735186260,1735186300,1735186300.955247,-21600,EB445137-D7F5-57EC-87DA-1DB460D64046,"iPhone13,2"
com.apple.mobilecal,16,1735186242,1735186258,1735186258.663966,-21600,EB445137-D7F5-57EC-87DA-1DB460D64046,"iPhone13,2"
com.tinyspeck.chatlyio,85,1735186152,1735186237,1735186237.261009,-21600,EB445137-D7F5-57EC-87DA-1DB460D64046,"iPhone13,2"
com.google.Chrome,290,1735185389,1735185679,1735185679.818153,-21600,,
com.apple.news,193,1735182665,1735182858,1735182858.8484058,-21600,EB445137-D7F5-57EC-87DA-1DB460D64046,"iPhone13,2"
com.hammerandchisel.discord,101,1735182558,1735182659,1735182659.072454,-21600,EB445137-D7F5-57EC-87DA-1DB460D64046,"iPhone13,2"
com.toyopagroup.picaboo,33,1735182392,1735182425,1735182425.834095,-21600,EB445137-D7F5-57EC-87DA-1DB460D64046,"iPhone13,2"
com.google.chrome.ios,12,1735179591,1735179603,1735179603.407927,-21600,EB445137-D7F5-57EC-87DA-1DB460D64046,"iPhone13,2"
com.apple.findmy,6,1735179584,1735179590,1735179591.116854,-21600,EB445137-D7F5-57EC-87DA-1DB460D64046,"iPhone13,2"
Astrospheric.Astrospheric,17,1735179556,1735179573,1735179573.8909302,-21600,EB445137-D7F5-57EC-87DA-1DB460D64046,"iPhone13,2"
com.apple.weather,12,1735179543,1735179555,1735179555.6103091,-21600,EB445137-D7F5-57EC-87DA-1DB460D64046,"iPhone13,2"
com.google.Chrome,406,1735174612,1735175018,1735175018.6961498,-21600,,
com.google.Chrome,318,1735174218,1735174536,1735174536.504319,-21600,,
com.google.Chrome,512,1735173521,1735174033,1735174033.260256,-21600,,
com.apple.finder,3,1735173518,1735173521,1735173521.696059,-21600,,
com.apple.finder,29,1735173278,1735173307,1735173307.26682,-21600,,
com.google.Chrome,24,1735173254,1735173278,1735173278.271476,-21600,,
com.microsoft.VSCode,893,1735172361,1735173254,1735173254.8990269,-21600,,
com.google.Chrome,8,1735172353,1735172361,1735172361.3392801,-21600,,
com.microsoft.VSCode,18,1735172335,1735172353,1735172353.751618,-21600,,
com.google.Chrome,3,1735172332,1735172335,1735172335.863672,-21600,,
com.microsoft.VSCode,10,1735172322,1735172332,1735172332.931655,-21600,,
com.google.Chrome,8,1735172314,1735172322,1735172322.8082519,-21600,,
com.microsoft.VSCode,5,1735172309,1735172314,1735172314.5959501,-21600,,
com.google.Chrome,2,1735172307,1735172309,1735172309.1002889,-21600,,
com.microsoft.VSCode,5,1735172302,1735172307,1735172307.623283,-21600,,
com.google.Chrome,12,1735172290,1735172302,1735172302.145172,-21600,,
com.microsoft.VSCode,9,1735172281,1735172290,1735172290.458576,-21600,,
com.google.Chrome,50,1735172231,1735172281,1735172281.471469,-21600,,
com.apple.MobileSMS,12,1735171903,1735171915,1735171915.5851479,-21600,EB445137-D7F5-57EC-87DA-1DB460D64046,"iPhone13,2"
com.toyopagroup.picaboo,49,1735171853,1735171902,1735171902.313586,-21600,EB445137-D7F5-57EC-87DA-1DB460D64046,"iPhone13,2"
com.google.chrome.ios,6,1735171847,1735171853,1735171854.771621,-21600,EB445137-D7F5-57EC-87DA-1DB460D64046,"iPhone13,2"
com.microsoft.VSCode,393,1735171838,1735172231,1735172231.9623508,-21600,,
com.google.chrome.ios,18,1735170806,1735170824,1735170824.511497,-21600,EB445137-D7F5-57EC-87DA-1DB460D64046,"iPhone13,2"
com.google.chrome.ios,10,1735169897,1735169907,1735169907.2046351,-21600,EB445137-D7F5-57EC-87DA-1DB460D64046,"iPhone13,2"
com.apple.camera,12,1735166425,1735166437,1735166438.1167688,-21600,EB445137-D7F5-57EC-87DA-1DB460D64046,"iPhone13,2"
com.google.chrome.ios,13,1735166424,1735166437,1735166439.8211908,-21600,EB445137-D7F5-57EC-87DA-1DB460D64046,"iPhone13,2"
com.google.chrome.ios,39,1735164409,1735164448,1735164449.080471,-21600,EB445137-D7F5-57EC-87DA-1DB460D64046,"iPhone13,2"
com.google.chrome.ios,50,1735164350,1735164400,1735164400.165014,-21600,EB445137-D7F5-57EC-87DA-1DB460D64046,"iPhone13,2"
com.google.chrome.ios,5,1735164332,1735164337,1735164337.6906781,-21600,EB445137-D7F5-57EC-87DA-1DB460D64046,"iPhone13,2"
com.toyopagroup.picaboo,4,1735164328,1735164332,1735164332.305912,-21600,EB445137-D7F5-57EC-87DA-1DB460D64046,"iPhone13,2"
com.apple.findmy,4,1735164324,1735164328,1735164329.8588362,-21600,EB445137-D7F5-57EC-87DA-1DB460D64046,"iPhone13,2"
com.apple.findmy,9,1735160238,1735160247,1735160247.545672,-21600,EB445137-D7F5-57EC-87DA-1DB460D64046,"iPhone13,2"
com.apple.findmy,11,1735159614,1735159625,1735159625.298804,-21600,EB445137-D7F5-57EC-87DA-1DB460D64046,"iPhone13,2"
com.toyopagroup.picaboo,7,1735159605,1735159612,1735159612.959593,-21600,EB445137-D7F5-57EC-87DA-1DB460D64046,"iPhone13,2"
com.apple.findmy,38,1735158415,1735158453,1735158454.407623,-21600,EB445137-D7F5-57EC-87DA-1DB460D64046,"iPhone13,2"
com.apple.findmy,13,1735157953,1735157966,1735157967.1152349,-21600,EB445137-D7F5-57EC-87DA-1DB460D64046,"iPhone13,2"
com.apple.findmy,9,1735156833,1735156842,1735156842.3238769,-21600,EB445137-D7F5-57EC-87DA-1DB460D64046,"iPhone13,2"
com.apple.MobileSMS,10,1735156556,1735156566,1735156566.375304,-21600,EB445137-D7F5-57EC-87DA-1DB460D64046,"iPhone13,2"
com.truebill.truebillnative,4,1735156552,1735156556,1735156557.156776,-21600,EB445137-D7F5-57EC-87DA-1DB460D64046,"iPhone13,2"
com.truebill.truebillnative,10,1735156542,1735156552,1735156552.272857,-21600,EB445137-D7F5-57EC-87DA-1DB460D64046,"iPhone13,2"
com.microsoft.VSCode,106,1735156488,1735156594,1735156594.551743,-21600,,
com.google.Chrome,36,1735156452,1735156488,1735156488.104511,-21600,,
com.microsoft.VSCode,4,1735156448,1735156452,1735156452.1996999,-21600,,
com.google.Chrome,40,1735156408,1735156448,1735156448.735182,-21600,,
com.microsoft.VSCode,3,1735156405,1735156408,1735156408.1359801,-21600,,
com.google.Chrome,72,1735156333,1735156405,1735156405.322339,-21600,,
com.microsoft.VSCode,10,1735156323,1735156333,1735156333.6608992,-21600,,
com.google.Chrome,10,1735156313,1735156323,1735156323.279162,-21600,,
com.microsoft.VSCode,100,1735156213,1735156313,1735156313.485533,-21600,,
com.google.Chrome,33,1735156180,1735156213,1735156213.566556,-21600,,
com.microsoft.VSCode,114,1735156066,1735156180,1735156180.745976,-21600,,
com.google.Chrome,18,1735156048,1735156066,1735156066.281559,-21600,,
com.microsoft.VSCode,175,1735155873,1735156048,1735156048.406841,-21600,,
com.google.Chrome,16,1735155857,1735155873,1735155873.127063,-21600,,
com.microsoft.VSCode,6,1735155851,1735155857,1735155857.838619,-21600,,
com.google.Chrome,17,1735155834,1735155851,1735155851.438273,-21600,,
com.microsoft.VSCode,177,1735155657,1735155834,1735155834.782723,-21600,,
com.google.Chrome,65,1735155592,1735155657,1735155657.359895,-21600,,
com.microsoft.VSCode,1,1735155591,1735155592,1735155592.62457,-21600,,
com.google.Chrome,17,1735155574,1735155591,1735155591.564817,-21600,,
com.microsoft.VSCode,5,1735155569,1735155574,1735155574.514044,-21600,,
com.google.Chrome,17,1735155552,1735155569,1735155569.247129,-21600,,
com.microsoft.VSCode,10,1735155542,1735155552,1735155552.953706,-21600,,
com.google.Chrome,199,1735155343,1735155542,1735155542.309068,-21600,,
com.microsoft.VSCode,3,1735155340,1735155343,1735155344.015551,-21600,,
com.google.Chrome,42,1735155298,1735155340,1735155340.0646071,-21600,,
com.microsoft.VSCode,474,1735154824,1735155298,1735155298.50484,-21600,,
com.google.Chrome,18,1735154806,1735154824,1735154824.8189611,-21600,,
com.microsoft.VSCode,199,1735154607,1735154806,1735154806.7004352,-21600,,
com.google.Chrome,3,1735154604,1735154607,1735154607.806346,-21600,,
com.microsoft.VSCode,59,1735154545,1735154604,1735154604.225875,-21600,,
com.google.Chrome,2,1735154543,1735154545,1735154546.019349,-21600,,
com.microsoft.VSCode,5,1735154538,1735154543,1735154543.719729,-21600,,
com.google.Chrome,13,1735154525,1735154538,1735154538.941473,-21600,,
com.microsoft.VSCode,12,1735154513,1735154525,1735154525.163488,-21600,,
com.google.Chrome,1,1735154512,1735154513,1735154513.781656,-21600,,
com.microsoft.VSCode,24,1735154488,1735154512,1735154512.426126,-21600,,
com.google.Chrome,37,1735154451,1735154488,1735154488.472688,-21600,,
com.microsoft.VSCode,420,1735154031,1735154451,1735154451.8281322,-21600,,
com.truebill.truebillnative,6,1735153771,1735153777,1735153777.674151,-21600,EB445137-D7F5-57EC-87DA-1DB460D64046,"iPhone13,2"
com.truebill.truebillnative,37,1735153705,1735153742,1735153743.280117,-21600,EB445137-D7F5-57EC-87DA-1DB460D64046,"iPhone13,2"
com.tinyspeck.chatlyio,12,1735153687,1735153699,1735153699.180156,-21600,EB445137-D7F5-57EC-87DA-1DB460D64046,"iPhone13,2"
com.apple.news,1,1735153686,1735153687,1735153687.645294,-21600,EB445137-D7F5-57EC-87DA-1DB460D64046,"iPhone13,2"
org.name.serializdmobile,84,1735153599,1735153683,1735153683.164486,-21600,EB445137-D7F5-57EC-87DA-1DB460D64046,"iPhone13,2"
com.apple.MobileSMS,5,1735153579,1735153584,1735153584.773803,-21600,EB445137-D7F5-57EC-87DA-1DB460D64046,"iPhone13,2"
com.toyopagroup.picaboo,4,1735153572,1735153576,1735153576.842231,-21600,EB445137-D7F5-57EC-87DA-1DB460D64046,"iPhone13,2"
com.apple.MobileSMS,5,1735153083,1735153088,1735153088.1522079,-21600,EB445137-D7F5-57EC-87DA-1DB460D64046,"iPhone13,2"
com.toyopagroup.picaboo,15,1735152219,1735152234,1735152234.926402,-21600,EB445137-D7F5-57EC-87DA-1DB460D64046,"iPhone13,2"
com.apple.journal,3,1735152216,1735152219,1735152219.337451,-21600,EB445137-D7F5-57EC-87DA-1DB460D64046,"iPhone13,2"
com.apple.journal,2,1735151458,1735151460,1735151460.6374931,-21600,EB445137-D7F5-57EC-87DA-1DB460D64046,"iPhone13,2"
com.microsoft.VSCode,149,1735151309,1735151458,1735151458.784244,-21600,,
com.apple.finder,30,1735151279,1735151309,1735151309.6411319,-21600,,
com.apple.journal,8,1735151171,1735151179,1735151180.0582418,-21600,EB445137-D7F5-57EC-87DA-1DB460D64046,"iPhone13,2"
com.apple.journal,226,1735150923,1735151149,1735151149.472851,-21600,EB445137-D7F5-57EC-87DA-1DB460D64046,"iPhone13,2"
org.name.serializdmobile,3,1735150920,1735150923,1735150923.714874,-21600,EB445137-D7F5-57EC-87DA-1DB460D64046,"iPhone13,2"
com.apple.journal,17,1735150903,1735150920,1735150920.841011,-21600,EB445137-D7F5-57EC-87DA-1DB460D64046,"iPhone13,2"
org.name.serializdmobile,2,1735150897,1735150899,1735150899.369791,-21600,EB445137-D7F5-57EC-87DA-1DB460D64046,"iPhone13,2"
org.name.serializdmobile,55,1735150838,1735150893,1735150893.695005,-21600,EB445137-D7F5-57EC-87DA-1DB460D64046,"iPhone13,2"
com.microsoft.VSCode,478,1735150801,1735151279,1735151279.0529509,-21600,,
com.google.Chrome,12,1735150789,1735150801,1735150801.4483252,-21600,,
com.microsoft.VSCode,83,1735150706,1735150789,1735150789.075624,-21600,,
com.apple.finder,2,1735150704,1735150706,1735150706.711848,-21600,,
com.google.Chrome,5,1735150699,1735150704,1735150704.661484,-21600,,
com.apple.finder,1,1735150698,1735150699,1735150699.810995,-21600,,
org.name.serializdmobile,178,1735150551,1735150729,1735150730.053317,-21600,EB445137-D7F5-57EC-87DA-1DB460D64046,"iPhone13,2"
com.toyopagroup.picaboo,29,1735150514,1735150543,1735150543.908688,-21600,EB445137-D7F5-57EC-87DA-1DB460D64046,"iPhone13,2"
com.microsoft.VSCode,199,1735150499,1735150698,1735150698.246471,-21600,,
com.apple.finder,1,1735150498,1735150499,1735150499.8837929,-21600,,
com.google.Chrome,1,1735150497,1735150498,1735150498.667996,-21600,,
com.microsoft.VSCode,991,1735149506,1735150497,1735150497.496778,-21600,,
com.google.Chrome,3,1735149503,1735149506,1735149506.707962,-21600,,
com.microsoft.VSCode,5,1735149498,1735149503,1735149503.182294,-21600,,
com.google.Chrome,1,1735149497,1735149498,1735149498.794872,-21600,,
com.microsoft.VSCode,58,1735149439,1735149497,1735149497.5370998,-21600,,
com.google.Chrome,1,1735149438,1735149439,1735149439.525099,-21600,,
com.microsoft.VSCode,12,1735149426,1735149438,1735149438.572679,-21600,,
com.google.Chrome,2,1735149424,1735149426,1735149426.159251,-21600,,
com.microsoft.VSCode,46,1735149378,1735149424,1735149424.182527,-21600,,
com.google.Chrome,3,1735149375,1735149378,1735149378.3496761,-21600,,
com.microsoft.VSCode,12,1735149363,1735149375,1735149376.029,-21600,,
com.google.Chrome,26,1735149337,1735149363,1735149363.662195,-21600,,
com.microsoft.VSCode,168,1735149169,1735149337,1735149337.395226,-21600,,
com.google.Chrome,1,1735149168,1735149169,1735149169.444714,-21600,,
com.microsoft.VSCode,3,1735149165,1735149168,1735149168.3333402,-21600,,
com.google.Chrome,3,1735149162,1735149165,1735149165.075844,-21600,,
com.microsoft.VSCode,44,1735149118,1735149162,1735149162.982091,-21600,,
com.google.Chrome,4,1735149114,1735149118,1735149118.149602,-21600,,
com.microsoft.VSCode,179,1735148935,1735149114,1735149114.767206,-21600,,
com.google.Chrome,2,1735148933,1735148935,1735148935.3902469,-21600,,
com.microsoft.VSCode,22,1735148911,1735148933,1735148933.456042,-21600,,
com.google.Chrome,1,1735148910,1735148911,1735148911.484559,-21600,,
com.microsoft.VSCode,15,1735148895,1735148910,1735148910.305379,-21600,,
com.google.Chrome,3,1735148892,1735148895,1735148895.314214,-21600,,
com.microsoft.VSCode,3,1735148889,1735148892,1735148892.321531,-21600,,
com.google.Chrome,1,1735148888,1735148889,1735148889.966875,-21600,,
com.microsoft.VSCode,18,1735148870,1735148888,1735148888.866225,-21600,,
com.google.Chrome,10,1735148860,1735148870,1735148870.3518028,-21600,,
com.microsoft.VSCode,20,1735148840,1735148860,1735148860.533663,-21600,,
com.google.Chrome,18,1735148822,1735148840,1735148840.9689069,-21600,,
com.microsoft.VSCode,6,1735148816,1735148822,1735148822.386847,-21600,,
com.google.Chrome,5,1735148811,1735148816,1735148816.455789,-21600,,
com.microsoft.VSCode,1,1735148810,1735148811,1735148811.974288,-21600,,
com.google.Chrome,1,1735148809,1735148810,1735148810.3166761,-21600,,
com.microsoft.VSCode,31,1735148778,1735148809,1735148809.1685581,-21600,,
com.google.Chrome,1,1735148777,1735148778,1735148778.767796,-21600,,
com.microsoft.VSCode,16,1735148761,1735148777,1735148777.564821,-21600,,
com.google.Chrome,2,1735148759,1735148761,1735148761.066448,-21600,,
com.microsoft.VSCode,28,1735148731,1735148759,1735148759.50369,-21600,,
com.google.Chrome,1,1735148730,1735148731,1735148731.492848,-21600,,
com.microsoft.VSCode,9,1735148721,1735148730,1735148730.550439,-21600,,
com.google.Chrome,1,1735148720,1735148721,1735148721.6072268,-21600,,
com.microsoft.VSCode,1,1735148719,1735148720,1735148720.982246,-21600,,
com.google.Chrome,1,1735148718,1735148719,1735148719.951807,-21600,,
com.microsoft.VSCode,9,1735148709,1735148718,1735148718.9571428,-21600,,
com.google.Chrome,80,1735148629,1735148709,1735148709.6277308,-21600,,
com.facebook.Facebook,284,1735148335,1735148619,1735148619.444037,-21600,EB445137-D7F5-57EC-87DA-1DB460D64046,"iPhone13,2"
com.microsoft.VSCode,412,1735148217,1735148629,1735148629.14083,-21600,,
com.google.Chrome,411,1735147806,1735148217,1735148217.266605,-21600,,
com.toyopagroup.picaboo,19,1735146590,1735146609,1735146609.5687551,-21600,EB445137-D7F5-57EC-87DA-1DB460D64046,"iPhone13,2"
com.google.Chrome,137,1735144203,1735144340,1735144341.190243,-21600,,
com.apple.finder,3,1735144200,1735144203,1735144203.1840749,-21600,,
com.toyopagroup.picaboo,2,1735142713,1735142715,1735142715.9103742,-21600,EB445137-D7F5-57EC-87DA-1DB460D64046,"iPhone13,2"
com.apple.mobiletimer,2,1735142711,1735142713,1735142713.561806,-21600,EB445137-D7F5-57EC-87DA-1DB460D64046,"iPhone13,2"
com.toyopagroup.picaboo,15,1735142508,1735142523,1735142523.6221771,-21600,EB445137-D7F5-57EC-87DA-1DB460D64046,"iPhone13,2"
com.apple.mobiletimer,13,1735106869,1735106882,1735106882.5524611,-21600,EB445137-D7F5-57EC-87DA-1DB460D64046,"iPhone13,2"
com.apple.mobiletimer,13,1735106854,1735106867,1735106867.4313889,-21600,EB445137-D7F5-57EC-87DA-1DB460D64046,"iPhone13,2"
com.apple.mobiletimer,13,1735106798,1735106811,1735106811.371933,-21600,EB445137-D7F5-57EC-87DA-1DB460D64046,"iPhone13,2"
com.apple.mobiletimer,3,1735106792,1735106795,1735106795.5530481,-21600,EB445137-D7F5-57EC-87DA-1DB460D64046,"iPhone13,2"
com.apple.mobiletimer,17,1735106775,1735106792,1735106792.3538852,-21600,EB445137-D7F5-57EC-87DA-1DB460D64046,"iPhone13,2"
com.apple.Health,58,1735106580,1735106638,1735106639.075069,-21600,EB445137-D7F5-57EC-87DA-1DB460D64046,"iPhone13,2"
com.google.chrome.ios,56,1735104733,1735104789,1735104789.803335,-21600,EB445137-D7F5-57EC-87DA-1DB460D64046,"iPhone13,2"
com.apple.finder,7,1735104069,1735104076,1735104076.6904302,-21600,,
com.microsoft.VSCode,2,1735104067,1735104069,1735104069.4492931,-21600,,
com.google.Chrome,7,1735104060,1735104067,1735104067.599128,-21600,,
com.apple.iCal,41,1735104019,1735104060,1735104060.614429,-21600,,
com.google.Chrome,78,1735103941,1735104019,1735104019.3689508,-21600,,
com.google.Chrome,300,1735103559,1735103859,1735103859.82114,-21600,,
com.google.Chrome,320,1735103220,1735103540,1735103540.37205,-21600,,
com.google.Chrome,320,1735102595,1735102915,1735102915.281663,-21600,,
com.google.Chrome,390,1735102052,1735102442,1735102442.680809,-21600,,
com.microsoft.VSCode,17,1735102035,1735102052,1735102052.535795,-21600,,
com.apple.calculator,17,1735102013,1735102030,1735102030.943176,-21600,EB445137-D7F5-57EC-87DA-1DB460D64046,"iPhone13,2"
com.apple.calculator,17,1735101987,1735102004,1735102004.878263,-21600,EB445137-D7F5-57EC-87DA-1DB460D64046,"iPhone13,2"
com.truebill.truebillnative,29,1735101958,1735101987,1735101987.692424,-21600,EB445137-D7F5-57EC-87DA-1DB460D64046,"iPhone13,2"
com.apple.calculator,46,1735101912,1735101958,1735101958.935296,-21600,EB445137-D7F5-57EC-87DA-1DB460D64046,"iPhone13,2"
com.truebill.truebillnative,87,1735101823,1735101910,1735101911.010267,-21600,EB445137-D7F5-57EC-87DA-1DB460D64046,"iPhone13,2"
com.apple.calculator,21,1735101802,1735101823,1735101823.096159,-21600,EB445137-D7F5-57EC-87DA-1DB460D64046,"iPhone13,2"
com.truebill.truebillnative,7,1735101795,1735101802,1735101802.910779,-21600,EB445137-D7F5-57EC-87DA-1DB460D64046,"iPhone13,2"
com.apple.calculator,9,1735101786,1735101795,1735101795.9460611,-21600,EB445137-D7F5-57EC-87DA-1DB460D64046,"iPhone13,2"
com.truebill.truebillnative,98,1735101688,1735101786,1735101787.058008,-21600,EB445137-D7F5-57EC-87DA-1DB460D64046,"iPhone13,2"
com.microsoft.VSCode,303,1735101669,1735101972,1735101972.895512,-21600,,
com.apple.MobileSMS,8,1735101661,1735101669,1735101669.20513,-21600,,
com.microsoft.VSCode,325,1735101336,1735101661,1735101661.7864962,-21600,,
com.facebook.Facebook,612,1735100711,1735101323,1735101323.057763,-21600,EB445137-D7F5-57EC-87DA-1DB460D64046,"iPhone13,2"
com.apple.AppStore,4,1735100707,1735100711,1735100711.167371,-21600,EB445137-D7F5-57EC-87DA-1DB460D64046,"iPhone13,2"
com.facebook.Facebook,285,1735100422,1735100707,1735100708.107449,-21600,EB445137-D7F5-57EC-87DA-1DB460D64046,"iPhone13,2"
com.tinyspeck.chatlyio,12,1735100397,1735100409,1735100409.524901,-21600,EB445137-D7F5-57EC-87DA-1DB460D64046,"iPhone13,2"
com.wbd.stream,27,1735100356,1735100383,1735100383.968978,-21600,EB445137-D7F5-57EC-87DA-1DB460D64046,"iPhone13,2"
com.google.chrome.ios,79,1735100275,1735100354,1735100354.7583718,-21600,EB445137-D7F5-57EC-87DA-1DB460D64046,"iPhone13,2"
com.apple.findmy,6,1735090014,1735090020,1735090020.563755,-21600,EB445137-D7F5-57EC-87DA-1DB460D64046,"iPhone13,2"
com.apple.findmy,3,1735090010,1735090013,1735090014.212023,-21600,EB445137-D7F5-57EC-87DA-1DB460D64046,"iPhone13,2"
com.apple.findmy,3,1735084799,1735084802,1735084802.167337,-21600,EB445137-D7F5-57EC-87DA-1DB460D64046,"iPhone13,2"
com.apple.findmy,19,1735082761,1735082780,1735082781.783956,-21600,EB445137-D7F5-57EC-87DA-1DB460D64046,"iPhone13,2"
com.google.chrome.ios,190,1735081834,1735082024,1735082024.8412561,-21600,EB445137-D7F5-57EC-87DA-1DB460D64046,"iPhone13,2"
com.facebook.Facebook,52,1735081778,1735081830,1735081830.944676,-21600,EB445137-D7F5-57EC-87DA-1DB460D64046,"iPhone13,2"
com.apple.news,28,1735075913,1735075941,1735075941.995481,-21600,EB445137-D7F5-57EC-87DA-1DB460D64046,"iPhone13,2"
com.apple.MobileSMS,3,1735075679,1735075682,1735075682.692017,-21600,EB445137-D7F5-57EC-87DA-1DB460D64046,"iPhone13,2"
com.apple.camera,4,1735075497,1735075501,1735075501.747933,-21600,EB445137-D7F5-57EC-87DA-1DB460D64046,"iPhone13,2"
com.microsoft.VSCode,359,1735074812,1735075171,1735075171.229872,-21600,,
com.google.Chrome,1,1735074811,1735074812,1735074812.3621202,-21600,,
com.microsoft.VSCode,2,1735074809,1735074811,1735074811.3175092,-21600,,
com.google.Chrome,2,1735074807,1735074809,1735074809.8827639,-21600,,
com.microsoft.VSCode,10,1735074797,1735074807,1735074807.188245,-21600,,
com.google.Chrome,1,1735074796,1735074797,1735074797.328243,-21600,,
com.microsoft.VSCode,6,1735074790,1735074796,1735074796.605757,-21600,,
com.google.Chrome,3,1735074787,1735074790,1735074790.476711,-21600,,
com.microsoft.VSCode,7,1735074780,1735074787,1735074787.962774,-21600,,
com.google.Chrome,1,1735074779,1735074780,1735074780.225498,-21600,,
com.microsoft.VSCode,4,1735074775,1735074779,1735074779.209472,-21600,,
com.google.Chrome,0,1735074775,1735074775,1735074776.036694,-21600,,
com.microsoft.VSCode,3,1735074772,1735074775,1735074775.2509332,-21600,,
com.google.Chrome,59,1735074713,1735074772,1735074773.049562,-21600,,
com.microsoft.VSCode,169,1735074544,1735074713,1735074713.858666,-21600,,
com.google.Chrome,22,1735074522,1735074544,1735074544.491008,-21600,,
com.microsoft.VSCode,233,1735074289,1735074522,1735074522.866843,-21600,,
com.apple.Dictionary,0,1735074289,1735074289,1735074290.067632,-21600,,
com.microsoft.VSCode,317,1735073972,1735074289,1735074289.041734,-21600,,
com.google.Chrome,5,1735073967,1735073972,1735073972.9610891,-21600,,
com.microsoft.VSCode,101,1735073866,1735073967,1735073967.596859,-21600,,
com.google.Chrome,53,1735073813,1735073866,1735073866.8871431,-21600,,
com.microsoft.VSCode,636,1735073177,1735073813,1735073813.097306,-21600,,
com.google.Chrome,7,1735073170,1735073177,1735073177.876337,-21600,,
com.microsoft.VSCode,2,1735073168,1735073170,1735073170.766331,-21600,,
com.google.Chrome,5,1735073163,1735073168,1735073168.136699,-21600,,
com.microsoft.VSCode,205,1735072958,1735073163,1735073163.914192,-21600,,
com.google.Chrome,3,1735072955,1735072958,1735072958.4836268,-21600,,
com.microsoft.VSCode,7,1735072948,1735072955,1735072955.565002,-21600,,
com.google.Chrome,23,1735072925,1735072948,1735072948.7815762,-21600,,
com.microsoft.VSCode,343,1735072582,1735072925,1735072925.77929,-21600,,
com.google.Chrome,1,1735072581,1735072582,1735072582.628685,-21600,,
com.microsoft.VSCode,148,1735072433,1735072581,1735072581.61133,-21600,,
com.google.Chrome,7,1735072426,1735072433,1735072433.251872,-21600,,
com.microsoft.VSCode,13,1735072413,1735072426,1735072426.587309,-21600,,
com.google.ios.youtube,1846,1735070529,1735072375,1735072375.35533,-21600,EB445137-D7F5-57EC-87DA-1DB460D64046,"iPhone13,2"
com.google.ios.youtube,3,1735070420,1735070423,1735070423.778794,-21600,EB445137-D7F5-57EC-87DA-1DB460D64046,"iPhone13,2"
com.microsoft.VSCode,534,1735070184,1735070718,1735070718.8616729,-21600,,
com.google.Chrome,6,1735070178,1735070184,1735070184.434469,-21600,,
com.microsoft.VSCode,10,1735070168,1735070178,1735070178.53316,-21600,,
com.google.Chrome,1,1735070167,1735070168,1735070168.945253,-21600,,
com.microsoft.VSCode,27,1735070140,1735070167,1735070167.7475471,-21600,,
com.google.Chrome,2,1735070138,1735070140,1735070140.406064,-21600,,
com.microsoft.VSCode,5,1735070133,1735070138,1735070138.3318748,-21600,,
com.google.Chrome,1,1735070132,1735070133,1735070134.004951,-21600,,
com.microsoft.VSCode,6,1735070126,1735070132,1735070132.784667,-21600,,
com.google.Chrome,23,1735070103,1735070126,1735070126.950603,-21600,,
com.microsoft.VSCode,469,1735069634,1735070103,1735070103.969757,-21600,,
com.google.Chrome,60,1735069574,1735069634,1735069634.5107222,-21600,,
com.microsoft.VSCode,2,1735069572,1735069574,1735069574.42372,-21600,,
com.google.ios.youtube,113,1735069518,1735069631,1735069632.1958861,-21600,EB445137-D7F5-57EC-87DA-1DB460D64046,"iPhone13,2"
com.google.chrome.ios,44,1735069473,1735069517,1735069518.021515,-21600,EB445137-D7F5-57EC-87DA-1DB460D64046,"iPhone13,2"
com.google.ios.youtube,283,1735069190,1735069473,1735069474.43486,-21600,EB445137-D7F5-57EC-87DA-1DB460D64046,"iPhone13,2"
com.burbn.instagram,486,1735068702,1735069188,1735069188.979814,-21600,EB445137-D7F5-57EC-87DA-1DB460D64046,"iPhone13,2"
com.toyopagroup.picaboo,9,1735068690,1735068699,1735068699.765852,-21600,EB445137-D7F5-57EC-87DA-1DB460D64046,"iPhone13,2"
com.toyopagroup.picaboo,10,1735068628,1735068638,1735068638.933106,-21600,EB445137-D7F5-57EC-87DA-1DB460D64046,"iPhone13,2"
com.apple.news,6,1735068484,1735068490,1735068490.5089068,-21600,EB445137-D7F5-57EC-87DA-1DB460D64046,"iPhone13,2"
com.apple.news,1,1735068482,1735068483,1735068483.826705,-21600,EB445137-D7F5-57EC-87DA-1DB460D64046,"iPhone13,2"
com.microsoft.VSCode,306,1735068395,1735068701,1735068701.894176,-21600,,
com.google.Chrome,2,1735068393,1735068395,1735068395.3779101,-21600,,
com.microsoft.VSCode,1,1735068392,1735068393,1735068393.827815,-21600,,
com.google.Chrome,34,1735068358,1735068392,1735068392.4726372,-21600,,
com.microsoft.VSCode,107,1735068251,1735068358,1735068358.255361,-21600,,
com.google.Chrome,1,1735068250,1735068251,1735068251.610482,-21600,,
com.microsoft.VSCode,52,1735068198,1735068250,1735068250.094193,-21600,,
com.google.Chrome,8,1735068190,1735068198,1735068198.3610659,-21600,,
com.microsoft.VSCode,3,1735068187,1735068190,1735068190.6805859,-21600,,
com.google.Chrome,10,1735068177,1735068187,1735068187.873598,-21600,,
com.microsoft.VSCode,55,1735068122,1735068177,1735068177.4241018,-21600,,
com.google.Chrome,6,1735068116,1735068122,1735068122.8293781,-21600,,
com.microsoft.VSCode,9,1735068107,1735068116,1735068116.905575,-21600,,
com.google.Chrome,4,1735068103,1735068107,1735068107.557197,-21600,,
com.microsoft.VSCode,21,1735068082,1735068103,1735068103.1022549,-21600,,
com.google.Chrome,8,1735068074,1735068082,1735068082.279218,-21600,,
com.microsoft.VSCode,15,1735068059,1735068074,1735068074.977313,-21600,,
com.google.Chrome,2,1735068057,1735068059,1735068059.556244,-21600,,
com.microsoft.VSCode,7,1735068050,1735068057,1735068057.433404,-21600,,
com.google.Chrome,36,1735068014,1735068050,1735068050.197552,-21600,,
com.microsoft.VSCode,19,1735067995,1735068014,1735068014.2936502,-21600,,
com.google.Chrome,2,1735067993,1735067995,1735067995.490706,-21600,,
com.microsoft.VSCode,10,1735067983,1735067993,1735067993.120836,-21600,,
com.google.Chrome,48,1735067935,1735067983,1735067983.963125,-21600,,
com.microsoft.VSCode,69,1735067866,1735067935,1735067935.2421331,-21600,,
com.google.Chrome,18,1735067848,1735067866,1735067867.003471,-21600,,
com.microsoft.VSCode,2,1735067846,1735067848,1735067848.792907,-21600,,
com.google.Chrome,3,1735067843,1735067846,1735067846.6764178,-21600,,
com.microsoft.VSCode,48,1735067795,1735067843,1735067843.308525,-21600,,
com.google.Chrome,148,1735067647,1735067795,1735067795.5861769,-21600,,
com.google.Chrome,57,1735067590,1735067647,1735067647.8839722,-21600,,
com.google.Chrome,52,1735067538,1735067590,1735067590.4283838,-21600,,
com.microsoft.VSCode,28,1735067510,1735067538,1735067538.7637749,-21600,,
com.google.Chrome,3,1735067507,1735067510,1735067510.046344,-21600,,
com.microsoft.VSCode,11,1735067496,1735067507,1735067507.020237,-21600,,
com.google.Chrome,37,1735067459,1735067496,1735067496.381853,-21600,,
com.microsoft.VSCode,18,1735067441,1735067459,1735067459.081646,-21600,,
com.google.Chrome,7,1735067434,1735067441,1735067441.860835,-21600,,
com.microsoft.VSCode,48,1735067386,1735067434,1735067434.556464,-21600,,
com.google.Chrome,1,1735067385,1735067386,1735067386.12835,-21600,,
com.microsoft.VSCode,2,1735067383,1735067385,1735067385.744079,-21600,,
com.google.Chrome,4,1735067379,1735067383,1735067383.067936,-21600,,
com.google.Chrome,8,1735067371,1735067379,1735067379.1728492,-21600,,
com.google.Chrome,28,1735067343,1735067371,1735067371.459169,-21600,,
com.google.Chrome,3,1735067340,1735067343,1735067343.30658,-21600,,
com.microsoft.VSCode,4,1735067336,1735067340,1735067340.1740952,-21600,,
com.google.Chrome,5,1735067331,1735067336,1735067336.988316,-21600,,
com.microsoft.VSCode,43,1735067288,1735067331,1735067331.254951,-21600,,
com.google.Chrome,2,1735067286,1735067288,1735067288.318396,-21600,,
com.microsoft.VSCode,3,1735067283,1735067286,1735067286.8406649,-21600,,
com.google.Chrome,1,1735067282,1735067283,1735067283.777293,-21600,,
com.microsoft.VSCode,1,1735067281,1735067282,1735067282.812201,-21600,,
com.google.Chrome,1,1735067280,1735067281,1735067281.910414,-21600,,
com.microsoft.VSCode,1,1735067279,1735067280,1735067280.972301,-21600,,
com.google.Chrome,1,1735067278,1735067279,1735067279.5206199,-21600,,
com.microsoft.VSCode,1,1735067277,1735067278,1735067278.1443381,-21600,,
com.google.Chrome,1,1735067276,1735067277,1735067277.5952969,-21600,,
com.microsoft.VSCode,4,1735067272,1735067276,1735067276.661356,-21600,,
com.google.Chrome,52,1735067220,1735067272,1735067273.013902,-21600,,
com.microsoft.VSCode,27,1735067193,1735067220,1735067220.929275,-21600,,
com.google.Chrome,1,1735067192,1735067193,1735067193.4512172,-21600,,
com.microsoft.VSCode,4,1735067188,1735067192,1735067192.603416,-21600,,
com.google.Chrome,16,1735067172,1735067188,1735067188.072757,-21600,,
com.microsoft.VSCode,52,1735067120,1735067172,1735067172.793641,-21600,,
com.google.Chrome,4,1735067116,1735067120,1735067120.097402,-21600,,
com.microsoft.VSCode,3,1735067113,1735067116,1735067116.171787,-21600,,
com.google.Chrome,44,1735067069,1735067113,1735067113.639663,-21600,,
com.microsoft.VSCode,5,1735067064,1735067069,1735067070.034888,-21600,,
com.google.Chrome,13,1735067051,1735067064,1735067064.5040321,-21600,,
com.microsoft.VSCode,29,1735067022,1735067051,1735067052.008147,-21600,,
com.google.Chrome,2,1735067020,1735067022,1735067023.281388,-21600,,
com.microsoft.VSCode,4,1735067016,1735067020,1735067020.938514,-21600,,
com.google.Chrome,12,1735067004,1735067016,1735067017.001721,-21600,,
com.apple.Passwords,17,1735066987,1735067004,1735067004.870666,-21600,,
com.google.Chrome,11,1735066976,1735066987,1735066987.573312,-21600,,
com.microsoft.VSCode,1,1735066975,1735066976,1735066976.963118,-21600,,
com.google.Chrome,5,1735066970,1735066975,1735066975.282192,-21600,,
com.microsoft.VSCode,2,1735066968,1735066970,1735066970.326006,-21600,,
com.google.Chrome,14,1735066954,1735066968,1735066968.2449288,-21600,,
com.microsoft.VSCode,12,1735066942,1735066954,1735066955.7592359,-21600,,
com.apple.finder,3,1735066939,1735066942,1735066945.6853251,-21600,,
com.apple.systempreferences,18,1735066924,1735066942,1735066942.468779,-21600,,
com.apple.news,84,1735066806,1735066890,1735066890.625534,-21600,EB445137-D7F5-57EC-87DA-1DB460D64046,"iPhone13,2"
com.microsoft.VSCode,4,1735066676,1735066680,1735066680.564028,-21600,,
com.apple.finder,5,1735066671,1735066676,1735066676.341459,-21600,,
com.apple.news,160,1735066643,1735066803,1735066803.814496,-21600,EB445137-D7F5-57EC-87DA-1DB460D64046,"iPhone13,2"
com.microsoft.VSCode,39,1735066632,1735066671,1735066671.678358,-21600,,
com.apple.finder,5,1735066627,1735066632,1735066632.204238,-21600,,
com.microsoft.VSCode,16,1735066611,1735066627,1735066627.835082,-21600,,
com.apple.iCal,7,1735066604,1735066611,1735066611.9345531,-21600,,
com.microsoft.VSCode,30,1735066574,1735066604,1735066604.326395,-21600,,
com.google.Chrome,25,1735066549,1735066574,1735066574.519713,-21600,,
com.microsoft.VSCode,88,1735066461,1735066549,1735066549.510501,-21600,,
com.google.Chrome,1,1735066460,1735066461,1735066462.229218,-21600,,
com.microsoft.VSCode,38,1735066422,1735066460,1735066460.543608,-21600,,
com.apple.iCal,3,1735066419,1735066422,1735066422.296658,-21600,,
com.strava.stravaride,49,1735066368,1735066417,1735066417.700801,-21600,EB445137-D7F5-57EC-87DA-1DB460D64046,"iPhone13,2"
com.apple.Music,3,1735066365,1735066368,1735066368.171639,-21600,EB445137-D7F5-57EC-87DA-1DB460D64046,"iPhone13,2"
com.apple.Music,6,1735065974,1735065980,1735065980.5026588,-21600,EB445137-D7F5-57EC-87DA-1DB460D64046,"iPhone13,2"
com.apple.Music,7,1735064846,1735064853,1735064853.666827,-21600,EB445137-D7F5-57EC-87DA-1DB460D64046,"iPhone13,2"
com.apple.camera,373,1735059623,1735059996,1735059996.721632,-21600,EB445137-D7F5-57EC-87DA-1DB460D64046,"iPhone13,2"
com.apple.MobileSMS,7,1735057661,1735057668,1735057669.019244,-21600,EB445137-D7F5-57EC-87DA-1DB460D64046,"iPhone13,2"
com.apple.MobileSMS,3,1735057557,1735057560,1735057560.582197,-21600,EB445137-D7F5-57EC-87DA-1DB460D64046,"iPhone13,2"
com.apple.MobileSMS,10,1735056539,1735056549,1735056549.582036,-21600,EB445137-D7F5-57EC-87DA-1DB460D64046,"iPhone13,2"
com.apple.Music,3,1735056536,1735056539,1735056539.436254,-21600,EB445137-D7F5-57EC-87DA-1DB460D64046,"iPhone13,2"
com.apple.Music,11,1735056505,1735056516,1735056516.129067,-21600,EB445137-D7F5-57EC-87DA-1DB460D64046,"iPhone13,2"
com.apple.Music,6,1735056465,1735056471,1735056471.941561,-21600,EB445137-D7F5-57EC-87DA-1DB460D64046,"iPhone13,2"
com.apple.Music,14,1735056450,1735056464,1735056465.9723659,-21600,EB445137-D7F5-57EC-87DA-1DB460D64046,"iPhone13,2"
com.strava.stravaride,2,1735056448,1735056450,1735056451.517806,-21600,EB445137-D7F5-57EC-87DA-1DB460D64046,"iPhone13,2"
com.strava.stravaride,7,1735056392,1735056399,1735056399.971489,-21600,EB445137-D7F5-57EC-87DA-1DB460D64046,"iPhone13,2"
com.strava.stravaride,73,1735056178,1735056251,1735056251.878986,-21600,EB445137-D7F5-57EC-87DA-1DB460D64046,"iPhone13,2"
com.apple.camera,0,1735056142,1735056142,1735056142.7529569,-21600,EB445137-D7F5-57EC-87DA-1DB460D64046,"iPhone13,2"
com.apple.mobiletimer,18,1735047537,1735047555,1735047555.072958,-21600,EB445137-D7F5-57EC-87DA-1DB460D64046,"iPhone13,2"
com.apple.mobiletimer,10,1735047510,1735047520,1735047520.950614,-21600,EB445137-D7F5-57EC-87DA-1DB460D64046,"iPhone13,2"
com.apple.mobiletimer,10,1735047486,1735047496,1735047496.622274,-21600,EB445137-D7F5-57EC-87DA-1DB460D64046,"iPhone13,2"
com.apple.mobiletimer,56,1735047411,1735047467,1735047467.719769,-21600,EB445137-D7F5-57EC-87DA-1DB460D64046,"iPhone13,2"
com.apple.mobiletimer,11,1735047399,1735047410,1735047410.017566,-21600,EB445137-D7F5-57EC-87DA-1DB460D64046,"iPhone13,2"
com.apple.mobiletimer,26,1735047001,1735047027,1735047027.251054,-21600,EB445137-D7F5-57EC-87DA-1DB460D64046,"iPhone13,2"
com.apple.iCal,42,1735015859,1735015901,1735015901.363986,-21600,,
com.google.Chrome,67,1735015792,1735015859,1735015859.237869,-21600,,
com.google.Chrome,565,1735015211,1735015776,1735015776.054702,-21600,,
com.google.Chrome,333,1735014873,1735015206,1735015206.1072369,-21600,,
com.google.Chrome,305,1735014280,1735014585,1735014585.346085,-21600,,
com.google.Chrome,302,1735013719,1735014021,1735014021.668267,-21600,,
com.google.Chrome,301,1735013310,1735013611,1735013611.635017,-21600,,
com.google.Chrome,310,1735012995,1735013305,1735013305.212868,-21600,,
com.google.Chrome,489,1735012305,1735012794,1735012794.650744,-21600,,
com.apple.finder,93,1735012212,1735012305,1735012305.9503012,-21600,,
com.apple.systempreferences,60,1735012152,1735012212,1735012212.783895,-21600,,
com.apple.finder,97,1735012049,1735012146,1735012146.2488642,-21600,,
com.apple.Passwords,0,1735012049,1735012049,1735012050.0877938,-21600,,
com.microsoft.VSCode,535,1735011514,1735012049,1735012049.4335861,-21600,,
com.google.Chrome,4,1735011510,1735011514,1735011514.6867619,-21600,,
com.microsoft.VSCode,2,1735011508,1735011510,1735011510.090112,-21600,,
com.google.Chrome,4,1735011504,1735011508,1735011508.452924,-21600,,
com.microsoft.VSCode,8,1735011496,1735011504,1735011504.976915,-21600,,
com.google.Chrome,5,1735011491,1735011496,1735011496.30037,-21600,,
com.microsoft.VSCode,19,1735011472,1735011491,1735011491.826219,-21600,,
com.google.Chrome,4,1735011468,1735011472,1735011472.5843039,-21600,,
com.microsoft.VSCode,3,1735011465,1735011468,1735011468.273288,-21600,,
com.google.Chrome,4,1735011461,1735011465,1735011465.7354,-21600,,
com.microsoft.VSCode,18,1735011443,1735011461,1735011461.8174682,-21600,,
com.google.Chrome,7,1735011436,1735011443,1735011443.087086,-21600,,
com.microsoft.VSCode,10,1735011426,1735011436,1735011436.706684,-21600,,
com.google.Chrome,6,1735011420,1735011426,1735011426.380713,-21600,,
com.microsoft.VSCode,12,1735011408,1735011420,1735011420.663663,-21600,,
com.google.Chrome,6,1735011402,1735011408,1735011408.41851,-21600,,
com.microsoft.VSCode,15,1735011387,1735011402,1735011402.859805,-21600,,
com.google.Chrome,1,1735011386,1735011387,1735011387.427895,-21600,,
com.microsoft.VSCode,3,1735011383,1735011386,1735011386.091917,-21600,,
com.google.Chrome,5,1735011378,1735011383,1735011383.357671,-21600,,
com.microsoft.VSCode,11,1735011367,1735011378,1735011378.381369,-21600,,
com.google.Chrome,5,1735011362,1735011367,1735011367.914547,-21600,,
com.microsoft.VSCode,10,1735011352,1735011362,1735011362.2664928,-21600,,
com.google.Chrome,1,1735011351,1735011352,1735011352.540885,-21600,,
com.microsoft.VSCode,0,1735011351,1735011351,1735011351.637601,-21600,,
com.google.Chrome,6,1735011345,1735011351,1735011351.088176,-21600,,
com.microsoft.VSCode,8,1735011337,1735011345,1735011345.026093,-21600,,
com.google.Chrome,5,1735011332,1735011337,1735011337.814835,-21600,,
com.microsoft.VSCode,6,1735011326,1735011332,1735011332.04427,-21600,,
com.google.Chrome,1,1735011325,1735011326,1735011326.5865421,-21600,,
com.microsoft.VSCode,11,1735011314,1735011325,1735011325.60217,-21600,,
com.google.Chrome,5,1735011309,1735011314,1735011315.023958,-21600,,
com.microsoft.VSCode,5,1735011304,1735011309,1735011310.027132,-21600,,
com.google.Chrome,6,1735011298,1735011304,1735011304.897285,-21600,,
com.microsoft.VSCode,11,1735011287,1735011298,1735011298.3007421,-21600,,
com.google.Chrome,12,1735011275,1735011287,1735011287.0408978,-21600,,
com.microsoft.VSCode,28,1735011247,1735011275,1735011275.278535,-21600,,
com.google.Chrome,6,1735011241,1735011247,1735011247.976622,-21600,,
com.microsoft.VSCode,3,1735011238,1735011241,1735011241.895828,-21600,,
com.google.Chrome,1,1735011237,1735011238,1735011238.613226,-21600,,
com.microsoft.VSCode,3,1735011234,1735011237,1735011237.673019,-21600,,
com.google.Chrome,1,1735011233,1735011234,1735011234.8858361,-21600,,
com.microsoft.VSCode,5,1735011228,1735011233,1735011233.844913,-21600,,
com.google.Chrome,5,1735011223,1735011228,1735011228.842581,-21600,,
com.microsoft.VSCode,13,1735011210,1735011223,1735011223.158084,-21600,,
com.google.Chrome,8,1735011202,1735011210,1735011211.007951,-21600,,
com.microsoft.VSCode,85,1735011117,1735011202,1735011202.1601171,-21600,,
com.google.Chrome,2,1735011115,1735011117,1735011118.005599,-21600,,
com.microsoft.VSCode,2,1735011113,1735011115,1735011115.110621,-21600,,
com.microsoft.VSCode,325,1735009320,1735009645,1735009645.9539871,-21600,,
com.google.Chrome,7,1735009313,1735009320,1735009320.6838999,-21600,,
com.microsoft.VSCode,4,1735009309,1735009313,1735009313.771282,-21600,,
com.google.Chrome,1,1735009308,1735009309,1735009309.981394,-21600,,
com.microsoft.VSCode,31,1735009277,1735009308,1735009308.250839,-21600,,
com.google.Chrome,22,1735009255,1735009277,1735009277.4794421,-21600,,
com.microsoft.VSCode,84,1735009171,1735009255,1735009255.720001,-21600,,
com.google.Chrome,19,1735009152,1735009171,1735009171.76647,-21600,,
com.apple.Passwords,9,1735009143,1735009152,1735009152.504672,-21600,,
com.google.Chrome,4,1735009139,1735009143,1735009143.890465,-21600,,
com.microsoft.VSCode,13,1735009126,1735009139,1735009139.860753,-21600,,
com.google.Chrome,105,1735009021,1735009126,1735009127.026756,-21600,,
com.google.Chrome,1,1734990682,1734990683,1734990683.617454,-21600,,
com.microsoft.VSCode,64,1734990618,1734990682,1734990682.3581,-21600,,
com.google.Chrome,113,1734990505,1734990618,1734990618.343966,-21600,,
com.microsoft.VSCode,44,1734990461,1734990505,1734990505.452534,-21600,,
com.apple.finder,15,1734990446,1734990461,1734990461.390521,-21600,,
com.microsoft.VSCode,118,1734990328,1734990446,1734990446.1877332,-21600,,
com.apple.finder,10,1734990318,1734990328,1734990328.235079,-21600,,
com.microsoft.VSCode,114,1734990204,1734990318,1734990318.030188,-21600,,
com.google.Chrome,7,1734990197,1734990204,1734990204.188587,-21600,,
com.microsoft.VSCode,818,1734989379,1734990197,1734990197.732014,-21600,,
com.google.Chrome,30,1734989349,1734989379,1734989379.858614,-21600,,
com.google.Chrome,587,1734988572,1734989159,1734989159.492056,-21600,,
com.microsoft.VSCode,370,1734988202,1734988572,1734988572.6509352,-21600,,
com.google.Chrome,1,1734988201,1734988202,1734988202.3402,-21600,,
com.microsoft.VSCode,346,1734987855,1734988201,1734988201.460843,-21600,,
com.google.Chrome,26,1734987829,1734987855,1734987855.722069,-21600,,
com.microsoft.VSCode,12,1734987817,1734987829,1734987829.479218,-21600,,
com.google.Chrome,12,1734987805,1734987817,1734987818.009852,-21600,,
com.microsoft.VSCode,4,1734987801,1734987805,1734987805.8195028,-21600,,
com.google.Chrome,13,1734987788,1734987801,1734987801.866739,-21600,,
com.microsoft.VSCode,268,1734987520,1734987788,1734987789.0427861,-21600,,
com.google.Chrome,2,1734987518,1734987520,1734987520.273159,-21600,,
com.microsoft.VSCode,739,1734986779,1734987518,1734987518.758463,-21600,,
com.microsoft.VSCode,517,1734984702,1734985219,1734985219.129633,-21600,,
com.google.Chrome,3,1734984699,1734984702,1734984702.9855242,-21600,,
com.microsoft.VSCode,11,1734984688,1734984699,1734984699.781584,-21600,,
com.google.Chrome,2,1734984686,1734984688,1734984688.321329,-21600,,
com.microsoft.VSCode,3,1734984683,1734984686,1734984686.897305,-21600,,
com.google.Chrome,1,1734984682,1734984683,1734984683.677067,-21600,,
com.microsoft.VSCode,4,1734984678,1734984682,1734984682.172337,-21600,,
com.google.Chrome,7,1734984671,1734984678,1734984678.433126,-21600,,
com.microsoft.VSCode,32,1734984639,1734984671,1734984671.832025,-21600,,
com.google.Chrome,101,1734984538,1734984639,1734984639.2453341,-21600,,
com.microsoft.VSCode,1,1734984537,1734984538,1734984538.624745,-21600,,
com.google.Chrome,29,1734984508,1734984537,1734984537.728863,-21600,,
com.microsoft.VSCode,9,1734984499,1734984508,1734984508.723212,-21600,,
com.google.Chrome,8,1734984491,1734984499,1734984499.459521,-21600,,
com.microsoft.VSCode,4,1734984487,1734984491,1734984491.689589,-21600,,
com.google.Chrome,18,1734984469,1734984487,1734984487.6118078,-21600,,
com.microsoft.VSCode,14,1734984455,1734984469,1734984469.779269,-21600,,
com.google.Chrome,17,1734984438,1734984455,1734984455.1447349,-21600,,
com.google.Chrome,1,1734984437,1734984438,1734984438.724271,-21600,,
com.microsoft.VSCode,6,1734984431,1734984437,1734984437.563185,-21600,,
com.google.Chrome,12,1734984419,1734984431,1734984431.073128,-21600,,
com.microsoft.VSCode,63,1734984356,1734984419,1734984419.6506171,-21600,,
com.google.Chrome,0,1734984356,1734984356,1734984356.7483392,-21600,,
com.microsoft.VSCode,2,1734984354,1734984356,1734984356.334013,-21600,,
com.google.Chrome,30,1734984324,1734984354,1734984354.801986,-21600,,
com.microsoft.VSCode,57,1734984267,1734984324,1734984324.7335129,-21600,,
com.google.Chrome,6,1734984261,1734984267,1734984267.594315,-21600,,
com.microsoft.VSCode,15,1734984246,1734984261,1734984261.759691,-21600,,
com.google.Chrome,55,1734984191,1734984246,1734984246.047065,-21600,,
com.google.Chrome,23,1734984168,1734984191,1734984191.193069,-21600,,
com.google.Chrome,6,1734984162,1734984168,1734984168.533361,-21600,,
com.google.Chrome,4,1734984158,1734984162,1734984162.037051,-21600,,
com.microsoft.VSCode,35,1734984123,1734984158,1734984158.458869,-21600,,
com.google.Chrome,4,1734984119,1734984123,1734984123.5483851,-21600,,
com.microsoft.VSCode,6,1734984113,1734984119,1734984119.418068,-21600,,
com.google.Chrome,13,1734984100,1734984113,1734984113.3156,-21600,,
com.apple.Passwords,14,1734984086,1734984100,1734984100.109067,-21600,,
com.google.Chrome,13,1734984073,1734984086,1734984086.772243,-21600,,
com.microsoft.VSCode,130,1734983943,1734984073,1734984073.7253919,-21600,,
com.apple.Terminal,2,1734983941,1734983943,1734983943.168003,-21600,,
com.google.Chrome,5,1734983936,1734983941,1734983941.7400122,-21600,,
com.apple.Terminal,1,1734983935,1734983936,1734983936.5147629,-21600,,
com.microsoft.VSCode,10,1734983925,1734983935,1734983935.4267669,-21600,,
com.apple.Terminal,1,1734983924,1734983925,1734983925.8802729,-21600,,
com.google.Chrome,50,1734983874,1734983924,1734983924.1915832,-21600,,
com.apple.Terminal,1,1734983873,1734983874,1734983874.9700131,-21600,,
com.microsoft.VSCode,3,1734983870,1734983873,1734983873.710171,-21600,,
com.apple.Terminal,2,1734983868,1734983870,1734983870.0320969,-21600,,
com.google.Chrome,4,1734983864,1734983868,1734983868.2174249,-21600,,
com.apple.Terminal,3,1734983861,1734983864,1734983864.043244,-21600,,
com.microsoft.VSCode,76,1734983785,1734983861,1734983861.1943479,-21600,,
com.google.Chrome,0,1734983785,1734983785,1734983785.995844,-21600,,
com.microsoft.VSCode,11,1734983774,1734983785,1734983785.070735,-21600,,
com.google.Chrome,1,1734983773,1734983774,1734983774.7277389,-21600,,
com.microsoft.VSCode,42,1734983731,1734983773,1734983773.4777632,-21600,,
com.google.Chrome,1,1734983730,1734983731,1734983731.817311,-21600,,
com.microsoft.VSCode,33,1734983697,1734983730,1734983730.422144,-21600,,
com.google.Chrome,94,1734983603,1734983697,1734983697.650873,-21600,,
com.microsoft.VSCode,1,1734983602,1734983603,1734983603.388105,-21600,,
com.google.Chrome,18,1734983584,1734983602,1734983602.6318169,-21600,,
com.microsoft.VSCode,13,1734983571,1734983584,1734983584.169919,-21600,,
com.google.Chrome,2,1734983569,1734983571,1734983571.41769,-21600,,
com.microsoft.VSCode,2,1734983567,1734983569,1734983570.0363169,-21600,,
com.google.Chrome,5,1734983562,1734983567,1734983567.026589,-21600,,
com.microsoft.VSCode,9,1734983553,1734983562,1734983563.088882,-21600,,
com.google.Chrome,59,1734983494,1734983553,1734983553.9318972,-21600,,
com.microsoft.VSCode,98,1734983396,1734983494,1734983494.671338,-21600,,
com.google.Chrome,21,1734983375,1734983396,1734983396.683599,-21600,,
com.microsoft.VSCode,6,1734983369,1734983375,1734983375.314004,-21600,,
com.google.Chrome,2,1734983367,1734983369,1734983369.283782,-21600,,
com.microsoft.VSCode,2,1734983365,1734983367,1734983367.858594,-21600,,
com.google.Chrome,4,1734983361,1734983365,1734983365.809331,-21600,,
com.microsoft.VSCode,17,1734983344,1734983361,1734983361.815682,-21600,,
com.google.Chrome,35,1734983309,1734983344,1734983344.5744119,-21600,,
com.microsoft.VSCode,2,1734983307,1734983309,1734983309.048283,-21600,,
com.google.Chrome,1,1734983306,1734983307,1734983307.12656,-21600,,
com.microsoft.VSCode,20,1734983286,1734983306,1734983306.4011312,-21600,,
com.google.Chrome,3,1734983283,1734983286,1734983286.063587,-21600,,
com.microsoft.VSCode,8,1734983275,1734983283,1734983283.956087,-21600,,
com.google.Chrome,14,1734983261,1734983275,1734983275.1432052,-21600,,
com.microsoft.VSCode,10,1734983251,1734983261,1734983261.277487,-21600,,
com.google.Chrome,1,1734983250,1734983251,1734983251.354789,-21600,,
com.microsoft.VSCode,4,1734983246,1734983250,1734983250.270702,-21600,,
com.google.Chrome,1,1734983245,1734983246,1734983246.8449311,-21600,,
com.microsoft.VSCode,5,1734983240,1734983245,1734983245.62918,-21600,,
com.google.Chrome,3,1734983237,1734983240,1734983240.715626,-21600,,
com.microsoft.VSCode,6,1734983231,1734983237,1734983237.7658029,-21600,,
com.google.Chrome,10,1734983221,1734983231,1734983231.8729649,-21600,,
com.microsoft.VSCode,7,1734983214,1734983221,1734983221.239294,-21600,,
com.google.Chrome,19,1734983195,1734983214,1734983214.015654,-21600,,
com.microsoft.VSCode,98,1734983097,1734983195,1734983195.571087,-21600,,
com.google.Chrome,8,1734983089,1734983097,1734983097.4117188,-21600,,
com.microsoft.VSCode,145,1734982944,1734983089,1734983090.0058289,-21600,,
com.google.Chrome,2,1734982942,1734982944,1734982944.803899,-21600,,
com.microsoft.VSCode,0,1734982942,1734982942,1734982942.856065,-21600,,
com.google.Chrome,1,1734982941,1734982942,1734982942.348947,-21600,,
com.microsoft.VSCode,3,1734982938,1734982941,1734982941.41328,-21600,,
com.google.Chrome,2,1734982936,1734982938,1734982938.681689,-21600,,
com.microsoft.VSCode,9,1734982927,1734982936,1734982936.966981,-21600,,
com.google.Chrome,53,1734982874,1734982927,1734982927.2204099,-21600,,
com.microsoft.VSCode,199,1734982675,1734982874,1734982874.405912,-21600,,
com.google.Chrome,9,1734982666,1734982675,1734982675.6418529,-21600,,
com.microsoft.VSCode,53,1734982613,1734982666,1734982666.488332,-21600,,
com.google.Chrome,2,1734982611,1734982613,1734982613.89768,-21600,,
com.microsoft.VSCode,1,1734982610,1734982611,1734982611.73942,-21600,,
com.google.Chrome,6,1734982604,1734982610,1734982610.21734,-21600,,
com.microsoft.VSCode,46,1734982558,1734982604,1734982604.994553,-21600,,
com.google.Chrome,17,1734982541,1734982558,1734982558.904897,-21600,,
com.apple.Passwords,2,1734982539,1734982541,1734982541.990337,-21600,,
com.google.Chrome,7,1734982532,1734982539,1734982539.356746,-21600,,
com.apple.Passwords,11,1734982521,1734982532,1734982532.698265,-21600,,
com.google.Chrome,27,1734982494,1734982521,1734982521.545773,-21600,,
com.microsoft.VSCode,11,1734982483,1734982494,1734982494.829639,-21600,,
com.google.Chrome,3,1734982480,1734982483,1734982483.160269,-21600,,
com.microsoft.VSCode,2,1734982478,1734982480,1734982480.587286,-21600,,
com.google.Chrome,9,1734982469,1734982478,1734982478.6467,-21600,,
com.google.Chrome,3,1734982466,1734982469,1734982469.616805,-21600,,
com.google.Chrome,39,1734982427,1734982466,1734982466.7531781,-21600,,
com.microsoft.VSCode,8,1734982419,1734982427,1734982427.434678,-21600,,
com.google.Chrome,5,1734982414,1734982419,1734982419.9461231,-21600,,
com.microsoft.VSCode,5,1734982409,1734982414,1734982414.255772,-21600,,
com.google.Chrome,14,1734982395,1734982409,1734982409.474187,-21600,,
com.microsoft.VSCode,24,1734982371,1734982395,1734982395.709048,-21600,,
com.google.Chrome,16,1734982355,1734982371,1734982371.986115,-21600,,
com.microsoft.VSCode,6,1734982349,1734982355,1734982355.268364,-21600,,
com.google.Chrome,17,1734982332,1734982349,1734982349.329118,-21600,,
com.microsoft.VSCode,52,1734982280,1734982332,1734982332.2526212,-21600,,
com.google.Chrome,31,1734982249,1734982280,1734982280.4185529,-21600,,
com.microsoft.VSCode,9,1734982240,1734982249,1734982249.5816689,-21600,,
com.apple.Terminal,1,1734982239,1734982240,1734982240.333236,-21600,,
com.google.Chrome,14,1734982225,1734982239,1734982239.0359092,-21600,,
com.apple.Terminal,1,1734982224,1734982225,1734982225.435492,-21600,,
com.microsoft.VSCode,90,1734982134,1734982224,1734982224.15605,-21600,,
com.apple.Terminal,1,1734982133,1734982134,1734982134.484933,-21600,,
com.google.Chrome,21,1734982112,1734982133,1734982133.108398,-21600,,
com.apple.Terminal,1,1734982111,1734982112,1734982112.5865831,-21600,,
com.microsoft.VSCode,0,1734982111,1734982111,1734982111.755917,-21600,,
com.apple.Terminal,1,1734982110,1734982111,1734982111.204179,-21600,,
com.google.Chrome,12,1734982098,1734982110,1734982110.3171139,-21600,,
com.apple.Terminal,1,1734982097,1734982098,1734982098.287893,-21600,,
com.microsoft.VSCode,51,1734982046,1734982097,1734982097.240206,-21600,,
com.apple.Terminal,46,1734982000,1734982046,1734982047.060226,-21600,,
com.microsoft.VSCode,1,1734981999,1734982000,1734982000.664064,-21600,,
com.google.Chrome,1,1734981998,1734981999,1734982000.011321,-21600,,
com.microsoft.VSCode,65,1734981933,1734981998,1734981998.445312,-21600,,
com.google.Chrome,10,1734981923,1734981933,1734981933.768865,-21600,,
com.microsoft.VSCode,7,1734981916,1734981923,1734981924.004082,-21600,,
com.google.Chrome,34,1734981882,1734981916,1734981916.47086,-21600,,
com.microsoft.VSCode,78,1734981804,1734981882,1734981882.478397,-21600,,
com.google.Chrome,97,1734981707,1734981804,1734981804.2949948,-21600,,
com.apple.Terminal,29,1734981678,1734981707,1734981707.702209,-21600,,
com.google.Chrome,107,1734981571,1734981678,1734981678.978483,-21600,,
com.microsoft.VSCode,2,1734981569,1734981571,1734981571.20115,-21600,,
com.leomehlig.today,19,1734981550,1734981569,1734981569.9209762,-21600,,
com.leomehlig.today,342,1734975908,1734976250,1734976250.8205729,-21600,,
com.google.Chrome,572,1734975336,1734975908,1734975908.144885,-21600,,
com.apple.iCal,25,1734975311,1734975336,1734975336.242816,-21600,,
com.google.Chrome,95,1734975216,1734975311,1734975311.871408,-21600,,
com.apple.finder,3,1734975213,1734975216,1734975216.3011951,-21600,,
com.apple.Preview,1,1734975212,1734975213,1734975213.725528,-21600,,
com.google.Chrome,614,1734974598,1734975212,1734975212.6259751,-21600,,
com.apple.Preview,183,1734974415,1734974598,1734974598.9016562,-21600,,
com.google.Chrome,21,1734974394,1734974415,1734974415.347855,-21600,,
com.apple.Preview,2,1734974392,1734974394,1734974394.2468538,-21600,,
com.google.Chrome,4,1734974388,1734974392,1734974392.4938998,-21600,,
com.apple.Preview,5,1734974383,1734974388,1734974388.651867,-21600,,
com.google.Chrome,10,1734974373,1734974383,1734974383.6549559,-21600,,
com.apple.Preview,1,1734974372,1734974373,1734974373.440633,-21600,,
com.google.Chrome,1,1734974371,1734974372,1734974372.32287,-21600,,
com.apple.Preview,2,1734974369,1734974371,1734974371.372683,-21600,,
com.google.Chrome,8,1734974361,1734974369,1734974369.575158,-21600,,
com.apple.Preview,9,1734974352,1734974361,1734974361.3660378,-21600,,
com.google.Chrome,14,1734974338,1734974352,1734974352.183244,-21600,,
com.apple.Preview,2,1734974336,1734974338,1734974338.8776212,-21600,,
com.google.Chrome,5,1734974331,1734974336,1734974336.8223,-21600,,
com.apple.Preview,2,1734974329,1734974331,1734974331.452822,-21600,,
com.google.Chrome,18,1734974311,1734974329,1734974329.8407202,-21600,,
com.apple.Preview,51,1734974260,1734974311,1734974311.683157,-21600,,
com.apple.finder,2,1734974258,1734974260,1734974260.339282,-21600,,
com.google.Chrome,33,1734974225,1734974258,1734974258.295183,-21600,,
com.apple.Preview,437,1734973788,1734974225,1734974225.9179502,-21600,,
com.google.Chrome,16,1734973772,1734973788,1734973788.857185,-21600,,
com.apple.Preview,6,1734973766,1734973772,1734973772.720047,-21600,,
com.google.Chrome,4,1734973762,1734973766,1734973766.780105,-21600,,
com.apple.Preview,19,1734973743,1734973762,1734973762.38778,-21600,,
com.google.Chrome,39,1734973704,1734973743,1734973743.4072862,-21600,,
com.apple.Preview,6,1734973698,1734973704,1734973704.792264,-21600,,
com.google.Chrome,4,1734973694,1734973698,1734973698.186827,-21600,,
com.apple.Preview,1,1734973693,1734973694,1734973694.438552,-21600,,
com.google.Chrome,1,1734973692,1734973693,1734973693.846537,-21600,,
com.apple.Preview,1,1734973691,1734973692,1734973692.317545,-21600,,
com.google.Chrome,4,1734973687,1734973691,1734973691.095407,-21600,,
com.apple.Preview,2,1734973685,1734973687,1734973687.282998,-21600,,
com.google.Chrome,20,1734973665,1734973685,1734973685.987915,-21600,,
com.apple.Preview,6,1734973659,1734973665,1734973665.133676,-21600,,
com.google.Chrome,16,1734973643,1734973659,1734973659.959062,-21600,,
com.apple.Preview,4,1734973639,1734973643,1734973643.088183,-21600,,
com.google.Chrome,11,1734973628,1734973639,1734973639.195648,-21600,,
com.apple.Preview,94,1734973534,1734973628,1734973628.899477,-21600,,
com.apple.MobileSMS,5,1734973529,1734973534,1734973534.409826,-21600,,
com.google.Chrome,10,1734973519,1734973529,1734973529.527895,-21600,,
com.apple.MobileSMS,39,1734973480,1734973519,1734973519.748718,-21600,,
com.apple.Preview,202,1734973278,1734973480,1734973480.7634559,-21600,,
com.apple.finder,2,1734973276,1734973278,1734973278.984075,-21600,,
com.google.Chrome,401,1734972875,1734973276,1734973276.237629,-21600,,
com.leomehlig.today,12,1734972863,1734972875,1734972875.413194,-21600,,
com.leomehlig.today,32,1734970704,1734970736,1734970737.036999,-21600,,
com.google.Chrome,49,1734970655,1734970704,1734970704.981148,-21600,,
com.apple.Preview,690,1734969965,1734970655,1734970655.4970279,-21600,,
com.google.Chrome,35,1734969930,1734969965,1734969965.81815,-21600,,
com.apple.Preview,1,1734969929,1734969930,1734969930.4595509,-21600,,
com.google.Chrome,4,1734969925,1734969929,1734969929.450937,-21600,,
com.apple.Preview,12,1734969913,1734969925,1734969925.306664,-21600,,
com.google.Chrome,25,1734969888,1734969913,1734969913.623969,-21600,,
com.apple.Preview,1,1734969887,1734969888,1734969888.795605,-21600,,
com.google.Chrome,6,1734969881,1734969887,1734969887.719357,-21600,,
com.apple.Preview,19,1734969862,1734969881,1734969881.910798,-21600,,
com.google.Chrome,6,1734969856,1734969862,1734969862.5791621,-21600,,
com.apple.Preview,1,1734969855,1734969856,1734969856.7573462,-21600,,
com.google.Chrome,0,1734969855,1734969855,1734969856.0150762,-21600,,
com.apple.Preview,6,1734969849,1734969855,1734969855.2635841,-21600,,
com.google.Chrome,1,1734969848,1734969849,1734969849.9514189,-21600,,
com.apple.Preview,2,1734969846,1734969848,1734969848.424283,-21600,,
com.google.Chrome,7,1734969839,1734969846,1734969846.593153,-21600,,
com.apple.Preview,5,1734969834,1734969839,1734969839.4418411,-21600,,
com.google.Chrome,24,1734969810,1734969834,1734969834.2178411,-21600,,
com.apple.Preview,3,1734969807,1734969810,1734969811.011478,-21600,,
com.google.Chrome,2,1734969805,1734969807,1734969807.0807838,-21600,,
com.apple.Preview,11,1734969794,1734969805,1734969805.779202,-21600,,
com.google.Chrome,17,1734969777,1734969794,1734969794.367306,-21600,,
com.apple.Preview,1,1734969776,1734969777,1734969777.653088,-21600,,
com.google.Chrome,5,1734969771,1734969776,1734969776.1850882,-21600,,
com.apple.Preview,6,1734969765,1734969771,1734969771.666635,-21600,,
com.google.Chrome,3,1734969762,1734969765,1734969765.949973,-21600,,
com.apple.Preview,283,1734969479,1734969762,1734969762.802645,-21600,,
com.apple.finder,8,1734969471,1734969479,1734969479.9812012,-21600,,
com.google.Chrome,779,1734968692,1734969471,1734969471.331164,-21600,,
com.google.Chrome,300,1734968390,1734968690,1734968690.659902,-21600,,
com.google.Chrome,300,1734968088,1734968388,1734968388.372902,-21600,,
com.leomehlig.today,5,1734968083,1734968088,1734968088.394248,-21600,,
com.google.Chrome,94,1734967989,1734968083,1734968083.268907,-21600,,
com.apple.news,532,1734967429,1734967961,1734967961.299411,-21600,EB445137-D7F5-57EC-87DA-1DB460D64046,"iPhone13,2"
com.microsoft.Office.Outlook,55,1734967364,1734967419,1734967419.2998161,-21600,EB445137-D7F5-57EC-87DA-1DB460D64046,"iPhone13,2"
com.renpho.health,11,1734967350,1734967361,1734967361.041963,-21600,EB445137-D7F5-57EC-87DA-1DB460D64046,"iPhone13,2"
com.renpho.health,31,1734966762,1734966793,1734966793.588949,-21600,EB445137-D7F5-57EC-87DA-1DB460D64046,"iPhone13,2"
com.apple.MobileSMS,8,1734966736,1734966744,1734966744.087244,-21600,EB445137-D7F5-57EC-87DA-1DB460D64046,"iPhone13,2"
com.google.Gmail,5,1734964838,1734964843,1734964843.830408,-21600,EB445137-D7F5-57EC-87DA-1DB460D64046,"iPhone13,2"
com.apple.findmy,7,1734964824,1734964831,1734964832.008614,-21600,EB445137-D7F5-57EC-87DA-1DB460D64046,"iPhone13,2"
com.apple.Maps,13,1734933079,1734933092,1734933092.1838288,-21600,EB445137-D7F5-57EC-87DA-1DB460D64046,"iPhone13,2"
com.apple.Maps,3,1734933073,1734933076,1734933076.3881822,-21600,EB445137-D7F5-57EC-87DA-1DB460D64046,"iPhone13,2"
com.google.Chrome,4,1734932492,1734932496,1734932496.916192,-21600,,
com.apple.Maps,13,1734932443,1734932456,1734932456.203323,-21600,EB445137-D7F5-57EC-87DA-1DB460D64046,"iPhone13,2"
com.apple.Maps,3,1734932375,1734932378,1734932378.320102,-21600,EB445137-D7F5-57EC-87DA-1DB460D64046,"iPhone13,2"
com.apple.Maps,10,1734929458,1734929468,1734929468.937932,-21600,EB445137-D7F5-57EC-87DA-1DB460D64046,"iPhone13,2"
com.apple.Maps,14,1734928114,1734928128,1734928128.929795,-21600,EB445137-D7F5-57EC-87DA-1DB460D64046,"iPhone13,2"
com.apple.findmy,9,1734928102,1734928111,1734928111.2397652,-21600,EB445137-D7F5-57EC-87DA-1DB460D64046,"iPhone13,2"
com.apple.camera,5,1734928082,1734928087,1734928087.7340379,-21600,EB445137-D7F5-57EC-87DA-1DB460D64046,"iPhone13,2"
com.apple.findmy,7,1734928080,1734928087,1734928087.610832,-21600,EB445137-D7F5-57EC-87DA-1DB460D64046,"iPhone13,2"
com.apple.findmy,10,1734927333,1734927343,1734927343.222518,-21600,EB445137-D7F5-57EC-87DA-1DB460D64046,"iPhone13,2"
com.apple.findmy,2,1734927327,1734927329,1734927329.819623,-21600,EB445137-D7F5-57EC-87DA-1DB460D64046,"iPhone13,2"
com.apple.findmy,12,1734925491,1734925503,1734925503.295177,-21600,EB445137-D7F5-57EC-87DA-1DB460D64046,"iPhone13,2"
com.apple.findmy,4,1734925487,1734925491,1734925491.0539908,-21600,EB445137-D7F5-57EC-87DA-1DB460D64046,"iPhone13,2"
com.apple.findmy,5,1734925380,1734925385,1734925385.2002969,-21600,EB445137-D7F5-57EC-87DA-1DB460D64046,"iPhone13,2"
com.apple.findmy,17,1734925282,1734925299,1734925299.884438,-21600,EB445137-D7F5-57EC-87DA-1DB460D64046,"iPhone13,2"
com.apple.findmy,10,1734925271,1734925281,1734925281.553985,-21600,EB445137-D7F5-57EC-87DA-1DB460D64046,"iPhone13,2"
com.apple.findmy,5,1734923921,1734923926,1734923926.72176,-21600,EB445137-D7F5-57EC-87DA-1DB460D64046,"iPhone13,2"
com.apple.camera,0,1734923904,1734923904,1734923904.639657,-21600,EB445137-D7F5-57EC-87DA-1DB460D64046,"iPhone13,2"
com.apple.camera,0,1734923900,1734923900,1734923900.52463,-21600,EB445137-D7F5-57EC-87DA-1DB460D64046,"iPhone13,2"
com.apple.findmy,17,1734923895,1734923912,1734923912.910873,-21600,EB445137-D7F5-57EC-87DA-1DB460D64046,"iPhone13,2"
com.apple.findmy,23,1734923871,1734923894,1734923894.8389568,-21600,EB445137-D7F5-57EC-87DA-1DB460D64046,"iPhone13,2"
com.apple.findmy,3,1734923773,1734923776,1734923776.80441,-21600,EB445137-D7F5-57EC-87DA-1DB460D64046,"iPhone13,2"
com.apple.camera,0,1734923773,1734923773,1734923773.950903,-21600,EB445137-D7F5-57EC-87DA-1DB460D64046,"iPhone13,2"
com.google.Chrome,95,1734923768,1734923863,1734923863.539833,-21600,,
com.apple.findmy,104,1734923664,1734923768,1734923769.58112,-21600,EB445137-D7F5-57EC-87DA-1DB460D64046,"iPhone13,2"
com.apple.findmy,33,1734923556,1734923589,1734923589.9378018,-21600,EB445137-D7F5-57EC-87DA-1DB460D64046,"iPhone13,2"
com.google.Chrome,367,1734923249,1734923616,1734923616.2744389,-21600,,
com.google.Chrome,691,1734922508,1734923199,1734923199.2229838,-21600,,
com.wbd.stream,17,1734922364,1734922381,1734922381.801372,-21600,EB445137-D7F5-57EC-87DA-1DB460D64046,"iPhone13,2"
com.apple.news,318,1734922013,1734922331,1734922332.0340118,-21600,EB445137-D7F5-57EC-87DA-1DB460D64046,"iPhone13,2"
com.apple.findmy,9,1734921999,1734922008,1734922008.707279,-21600,EB445137-D7F5-57EC-87DA-1DB460D64046,"iPhone13,2"
com.google.Chrome,301,1734921404,1734921705,1734921705.33046,-21600,,
com.apple.findmy,7,1734921369,1734921376,1734921376.724983,-21600,EB445137-D7F5-57EC-87DA-1DB460D64046,"iPhone13,2"
com.apple.findmy,26,1734921291,1734921317,1734921317.997289,-21600,EB445137-D7F5-57EC-87DA-1DB460D64046,"iPhone13,2"
com.tinyspeck.chatlyio,8,1734920796,1734920804,1734920804.9263449,-21600,EB445137-D7F5-57EC-87DA-1DB460D64046,"iPhone13,2"
com.apple.findmy,7,1734920788,1734920795,1734920795.804031,-21600,EB445137-D7F5-57EC-87DA-1DB460D64046,"iPhone13,2"
com.google.Chrome,372,1734920255,1734920627,1734920627.9398088,-21600,,
com.apple.news,40,1734919740,1734919780,1734919780.520393,-21600,EB445137-D7F5-57EC-87DA-1DB460D64046,"iPhone13,2"
com.apple.Music,41,1734919692,1734919733,1734919733.430475,-21600,EB445137-D7F5-57EC-87DA-1DB460D64046,"iPhone13,2"
com.apple.findmy,3,1734919686,1734919689,1734919690.438015,-21600,EB445137-D7F5-57EC-87DA-1DB460D64046,"iPhone13,2"
com.apple.findmy,44,1734918985,1734919029,1734919030.855873,-21600,EB445137-D7F5-57EC-87DA-1DB460D64046,"iPhone13,2"
com.truebill.truebillnative,3,1734918981,1734918984,1734918985.393073,-21600,EB445137-D7F5-57EC-87DA-1DB460D64046,"iPhone13,2"
com.truebill.truebillnative,2,1734918604,1734918606,1734918606.628149,-21600,EB445137-D7F5-57EC-87DA-1DB460D64046,"iPhone13,2"
com.truebill.truebillnative,23,1734915633,1734915656,1734915656.9713268,-21600,EB445137-D7F5-57EC-87DA-1DB460D64046,"iPhone13,2"
com.instructure.icanvas,5,1734915607,1734915612,1734915612.6171122,-21600,EB445137-D7F5-57EC-87DA-1DB460D64046,"iPhone13,2"
com.instructure.icanvas,42,1734915506,1734915548,1734915548.335585,-21600,EB445137-D7F5-57EC-87DA-1DB460D64046,"iPhone13,2"
com.google.chrome.ios,8,1734915498,1734915506,1734915506.944308,-21600,EB445137-D7F5-57EC-87DA-1DB460D64046,"iPhone13,2"
com.google.Chrome,951,1734914305,1734915256,1734915256.813256,-21600,,
com.apple.MobileSMS,15,1734914290,1734914305,1734914305.700784,-21600,,
com.apple.findmy,8,1734914282,1734914290,1734914290.146637,-21600,,
com.apple.MobileSMS,4,1734914278,1734914282,1734914282.3817248,-21600,,
com.google.Chrome,39,1734914239,1734914278,1734914278.6709561,-21600,,
com.apple.MobileSMS,156,1734914083,1734914239,1734914239.654008,-21600,,
com.google.Chrome,5,1734914078,1734914083,1734914083.400272,-21600,,
com.google.Chrome,358,1734913640,1734913998,1734913998.971538,-21600,,
com.leomehlig.today,31,1734913609,1734913640,1734913640.405505,-21600,,
com.google.Chrome,195,1734913414,1734913609,1734913609.687463,-21600,,
com.apple.iCal,26,1734913388,1734913414,1734913414.109184,-21600,,
com.leomehlig.today,34,1734913354,1734913388,1734913388.454279,-21600,,
com.apple.iCal,88,1734913266,1734913354,1734913354.572175,-21600,,
com.leomehlig.today,2,1734913264,1734913266,1734913266.082489,-21600,,
com.google.Chrome,2,1734913262,1734913264,1734913264.580754,-21600,,
com.microsoft.VSCode,190,1734913072,1734913262,1734913263.191149,-21600,,
com.google.chrome.ios,2,1734911405,1734911407,1734911407.243637,-21600,EB445137-D7F5-57EC-87DA-1DB460D64046,"iPhone13,2"
com.google.chrome.ios,42,1734911024,1734911066,1734911066.781579,-21600,EB445137-D7F5-57EC-87DA-1DB460D64046,"iPhone13,2"
com.apple.mobileslideshow,1,1734911023,1734911024,1734911024.375039,-21600,EB445137-D7F5-57EC-87DA-1DB460D64046,"iPhone13,2"
com.apple.mobileslideshow,51,1734908323,1734908374,1734908375.805177,-21600,EB445137-D7F5-57EC-87DA-1DB460D64046,"iPhone13,2"
com.apple.camera,1,1734907779,1734907780,1734907780.58176,-21600,EB445137-D7F5-57EC-87DA-1DB460D64046,"iPhone13,2"
com.apple.camera,0,1734907776,1734907776,1734907776.8508868,-21600,EB445137-D7F5-57EC-87DA-1DB460D64046,"iPhone13,2"
com.toyopagroup.picaboo,13,1734907706,1734907719,1734907719.934853,-21600,EB445137-D7F5-57EC-87DA-1DB460D64046,"iPhone13,2"
com.apple.mobileslideshow,5,1734907701,1734907706,1734907706.700181,-21600,EB445137-D7F5-57EC-87DA-1DB460D64046,"iPhone13,2"
com.apple.mobileslideshow,1,1734907700,1734907701,1734907701.2237968,-21600,EB445137-D7F5-57EC-87DA-1DB460D64046,"iPhone13,2"
com.apple.mobileslideshow,3,1734907159,1734907162,1734907162.32507,-21600,EB445137-D7F5-57EC-87DA-1DB460D64046,"iPhone13,2"
com.apple.mobileslideshow,861,1734906291,1734907152,1734907153.737359,-21600,EB445137-D7F5-57EC-87DA-1DB460D64046,"iPhone13,2"
com.apple.mobileslideshow,29,1734905912,1734905941,1734905942.141337,-21600,EB445137-D7F5-57EC-87DA-1DB460D64046,"iPhone13,2"
com.toyopagroup.picaboo,5,1734902083,1734902088,1734902088.985476,-21600,EB445137-D7F5-57EC-87DA-1DB460D64046,"iPhone13,2"
com.goodreads.Goodreads,2,1734902081,1734902083,1734902083.8022962,-21600,EB445137-D7F5-57EC-87DA-1DB460D64046,"iPhone13,2"
com.goodreads.Goodreads,18,1734901840,1734901858,1734901859.0092611,-21600,EB445137-D7F5-57EC-87DA-1DB460D64046,"iPhone13,2"
com.thestorygraph.thestorygraph,2,1734901826,1734901828,1734901828.770972,-21600,EB445137-D7F5-57EC-87DA-1DB460D64046,"iPhone13,2"
com.thestorygraph.thestorygraph,62,1734901315,1734901377,1734901378.217956,-21600,EB445137-D7F5-57EC-87DA-1DB460D64046,"iPhone13,2"
com.apple.MobileSMS,4,1734901305,1734901309,1734901309.4798741,-21600,EB445137-D7F5-57EC-87DA-1DB460D64046,"iPhone13,2"
com.apple.MobileSMS,1,1734901205,1734901206,1734901206.824224,-21600,EB445137-D7F5-57EC-87DA-1DB460D64046,"iPhone13,2"
com.apple.MobileSMS,26,1734897642,1734897668,1734897668.341064,-21600,EB445137-D7F5-57EC-87DA-1DB460D64046,"iPhone13,2"
com.toyopagroup.picaboo,5,1734897633,1734897638,1734897638.924016,-21600,EB445137-D7F5-57EC-87DA-1DB460D64046,"iPhone13,2"
com.apple.MobileSMS,5,1734897627,1734897632,1734897632.024166,-21600,EB445137-D7F5-57EC-87DA-1DB460D64046,"iPhone13,2"
com.toyopagroup.picaboo,14,1734897613,1734897627,1734897627.6141229,-21600,EB445137-D7F5-57EC-87DA-1DB460D64046,"iPhone13,2"
com.apple.Music,3,1734897610,1734897613,1734897613.882924,-21600,EB445137-D7F5-57EC-87DA-1DB460D64046,"iPhone13,2"
com.apple.Music,8,1734892829,1734892837,1734892837.9639878,-21600,EB445137-D7F5-57EC-87DA-1DB460D64046,"iPhone13,2"
com.apple.Music,44,1734892741,1734892785,1734892786.112539,-21600,EB445137-D7F5-57EC-87DA-1DB460D64046,"iPhone13,2"
com.apple.musicrecognition,6,1734892735,1734892741,1734892742.192579,-21600,EB445137-D7F5-57EC-87DA-1DB460D64046,"iPhone13,2"
com.apple.MobileSMS,26,1734892520,1734892546,1734892546.253034,-21600,EB445137-D7F5-57EC-87DA-1DB460D64046,"iPhone13,2"
com.toyopagroup.picaboo,18,1734892491,1734892509,1734892510.080916,-21600,EB445137-D7F5-57EC-87DA-1DB460D64046,"iPhone13,2"
com.apple.MobileSMS,25,1734892463,1734892488,1734892488.527112,-21600,EB445137-D7F5-57EC-87DA-1DB460D64046,"iPhone13,2"
com.apple.Preferences,2,1734892461,1734892463,1734892464.1750379,-21600,EB445137-D7F5-57EC-87DA-1DB460D64046,"iPhone13,2"
com.microsoft.VSCode,393,1734891814,1734892207,1734892207.21949,-21600,,
com.apple.finder,17,1734891797,1734891814,1734891814.850659,-21600,,
com.microsoft.VSCode,49,1734891748,1734891797,1734891797.0265388,-21600,,
com.apple.finder,1,1734891747,1734891748,1734891748.226304,-21600,,
com.google.Chrome,49,1734891698,1734891747,1734891747.462281,-21600,,
com.apple.finder,2,1734891696,1734891698,1734891698.416636,-21600,,
com.microsoft.VSCode,78,1734891618,1734891696,1734891697.070962,-21600,,
com.apple.finder,68,1734891550,1734891618,1734891619.0110369,-21600,,
com.microsoft.VSCode,200,1734891350,1734891550,1734891551.0640059,-21600,,
com.leomehlig.today,9,1734891341,1734891350,1734891351.0436192,-21600,,
com.apple.Preferences,6,1734891334,1734891340,1734891340.91151,-21600,EB445137-D7F5-57EC-87DA-1DB460D64046,"iPhone13,2"
com.leomehlig.today,27,1734891295,1734891322,1734891322.0313911,-21600,,
com.google.Chrome,246,1734891049,1734891295,1734891295.4915419,-21600,,
com.microsoft.VSCode,1,1734891048,1734891049,1734891050.868095,-21600,,
com.google.Chrome,143,1734890905,1734891048,1734891048.425552,-21600,,
com.leomehlig.today,15,1734890890,1734890905,1734890905.852267,-21600,,
com.google.chrome.ios,48,1734890811,1734890859,1734890859.434268,-21600,EB445137-D7F5-57EC-87DA-1DB460D64046,"iPhone13,2"
com.wbd.stream,6,1734890804,1734890810,1734890810.913914,-21600,EB445137-D7F5-57EC-87DA-1DB460D64046,"iPhone13,2"
com.peacocktv.peacock,3,1734890801,1734890804,1734890804.869304,-21600,EB445137-D7F5-57EC-87DA-1DB460D64046,"iPhone13,2"
com.google.Gmail,78,1734890722,1734890800,1734890800.119128,-21600,EB445137-D7F5-57EC-87DA-1DB460D64046,"iPhone13,2"
com.google.chrome.ios,104,1734890615,1734890719,1734890720.10187,-21600,EB445137-D7F5-57EC-87DA-1DB460D64046,"iPhone13,2"
com.letterboxd.LetterboxdApp,30,1734890573,1734890603,1734890603.436901,-21600,EB445137-D7F5-57EC-87DA-1DB460D64046,"iPhone13,2"
com.wbd.stream,29,1734890542,1734890571,1734890571.52812,-21600,EB445137-D7F5-57EC-87DA-1DB460D64046,"iPhone13,2"
com.wbd.stream,17,1734890521,1734890538,1734890538.9798589,-21600,EB445137-D7F5-57EC-87DA-1DB460D64046,"iPhone13,2"
com.google.chrome.ios,62,1734890459,1734890521,1734890521.357943,-21600,EB445137-D7F5-57EC-87DA-1DB460D64046,"iPhone13,2"
com.wbd.stream,25,1734890433,1734890458,1734890458.9162369,-21600,EB445137-D7F5-57EC-87DA-1DB460D64046,"iPhone13,2"
com.strava.stravaride,151,1734890278,1734890429,1734890429.5601768,-21600,EB445137-D7F5-57EC-87DA-1DB460D64046,"iPhone13,2"
com.google.chrome.ios,24,1734890245,1734890269,1734890269.271562,-21600,EB445137-D7F5-57EC-87DA-1DB460D64046,"iPhone13,2"
com.apple.weather,1,1734890244,1734890245,1734890245.3480082,-21600,EB445137-D7F5-57EC-87DA-1DB460D64046,"iPhone13,2"
com.wbd.stream,7,1734890237,1734890244,1734890244.302671,-21600,EB445137-D7F5-57EC-87DA-1DB460D64046,"iPhone13,2"
com.wbd.stream,6,1734890228,1734890234,1734890234.344682,-21600,EB445137-D7F5-57EC-87DA-1DB460D64046,"iPhone13,2"
com.wbd.stream,6,1734890189,1734890195,1734890195.906413,-21600,EB445137-D7F5-57EC-87DA-1DB460D64046,"iPhone13,2"
com.letterboxd.LetterboxdApp,56,1734890133,1734890189,1734890189.793459,-21600,EB445137-D7F5-57EC-87DA-1DB460D64046,"iPhone13,2"
com.wbd.stream,61,1734890072,1734890133,1734890133.666185,-21600,EB445137-D7F5-57EC-87DA-1DB460D64046,"iPhone13,2"
com.letterboxd.LetterboxdApp,108,1734889933,1734890041,1734890042.118882,-21600,EB445137-D7F5-57EC-87DA-1DB460D64046,"iPhone13,2"
com.google.chrome.ios,460,1734889410,1734889870,1734889871.101229,-21600,EB445137-D7F5-57EC-87DA-1DB460D64046,"iPhone13,2"
com.apple.weather,1,1734889409,1734889410,1734889410.351901,-21600,EB445137-D7F5-57EC-87DA-1DB460D64046,"iPhone13,2"
com.goodreads.Goodreads,291,1734889117,1734889408,1734889408.8625169,-21600,EB445137-D7F5-57EC-87DA-1DB460D64046,"iPhone13,2"
com.apple.MobileSMS,3,1734889113,1734889116,1734889116.356937,-21600,EB445137-D7F5-57EC-87DA-1DB460D64046,"iPhone13,2"
com.apple.MobileSMS,3,1734888154,1734888157,1734888157.845522,-21600,EB445137-D7F5-57EC-87DA-1DB460D64046,"iPhone13,2"
com.leomehlig.today,40,1734888106,1734888146,1734888146.5077682,-21600,,
com.google.Chrome,761,1734887345,1734888106,1734888107.0482569,-21600,,
com.leomehlig.today,3,1734887342,1734887345,1734887345.1998692,-21600,,
com.apple.camera,2,1734887284,1734887286,1734887286.34617,-21600,EB445137-D7F5-57EC-87DA-1DB460D64046,"iPhone13,2"
com.apple.MobileSMS,14,1734887283,1734887297,1734887297.22715,-21600,EB445137-D7F5-57EC-87DA-1DB460D64046,"iPhone13,2"
com.apple.MobileSMS,4,1734887278,1734887282,1734887282.804531,-21600,EB445137-D7F5-57EC-87DA-1DB460D64046,"iPhone13,2"
com.google.ios.youtube,1380,1734885898,1734887278,1734887278.8111959,-21600,EB445137-D7F5-57EC-87DA-1DB460D64046,"iPhone13,2"
com.ally.MobileBanking,5,1734885885,1734885890,1734885890.174855,-21600,EB445137-D7F5-57EC-87DA-1DB460D64046,"iPhone13,2"
com.leomehlig.today,305,1734885858,1734886163,1734886163.549865,-21600,,
com.ally.MobileBanking,4,1734885853,1734885857,1734885857.305811,-21600,EB445137-D7F5-57EC-87DA-1DB460D64046,"iPhone13,2"
com.google.Chrome,7,1734885851,1734885858,1734885858.135587,-21600,,
com.apple.MobileSMS,3,1734885848,1734885851,1734885851.691165,-21600,,
com.google.Chrome,313,1734885535,1734885848,1734885848.138119,-21600,,
com.apple.Preview,237,1734885298,1734885535,1734885535.490758,-21600,,
com.apple.finder,6,1734885292,1734885298,1734885298.13023,-21600,,
com.google.Chrome,578,1734884714,1734885292,1734885292.423475,-21600,,
com.apple.MobileSMS,2,1734884712,1734884714,1734884714.82267,-21600,,
com.ally.MobileBanking,85,1734884487,1734884572,1734884572.691598,-21600,EB445137-D7F5-57EC-87DA-1DB460D64046,"iPhone13,2"
com.truebill.truebillnative,7,1734884480,1734884487,1734884487.725758,-21600,EB445137-D7F5-57EC-87DA-1DB460D64046,"iPhone13,2"
com.ally.MobileBanking,53,1734884427,1734884480,1734884480.3196611,-21600,EB445137-D7F5-57EC-87DA-1DB460D64046,"iPhone13,2"
com.truebill.truebillnative,6,1734884411,1734884417,1734884417.8499699,-21600,EB445137-D7F5-57EC-87DA-1DB460D64046,"iPhone13,2"
com.google.Chrome,339,1734884373,1734884712,1734884712.957123,-21600,,
com.truebill.truebillnative,95,1734884249,1734884344,1734884344.845305,-21600,EB445137-D7F5-57EC-87DA-1DB460D64046,"iPhone13,2"
com.apple.MobileSMS,5,1734884236,1734884241,1734884241.1476421,-21600,EB445137-D7F5-57EC-87DA-1DB460D64046,"iPhone13,2"
com.apple.MobileSMS,25,1734884207,1734884232,1734884232.648166,-21600,,
com.google.Chrome,90,1734884117,1734884207,1734884207.478053,-21600,,
com.apple.MobileSMS,18,1734884099,1734884117,1734884117.675013,-21600,,
com.apple.MobileSMS,3,1734883780,1734883783,1734883783.1668239,-21600,EB445137-D7F5-57EC-87DA-1DB460D64046,"iPhone13,2"
com.google.Chrome,695,1734883404,1734884099,1734884099.485849,-21600,,
com.leomehlig.today,44,1734883360,1734883404,1734883405.916425,-21600,,
com.google.Chrome,5,1734883355,1734883360,1734883360.7198238,-21600,,
com.apple.MobileSMS,0,1734883355,1734883355,1734883355.961993,-21600,,
com.google.Chrome,873,1734882482,1734883355,1734883355.485114,-21600,,
com.apple.MobileSMS,8,1734882454,1734882462,1734882462.201507,-21600,EB445137-D7F5-57EC-87DA-1DB460D64046,"iPhone13,2"
com.apple.MobileSMS,150,1734882184,1734882334,1734882334.2965,-21600,EB445137-D7F5-57EC-87DA-1DB460D64046,"iPhone13,2"
com.apple.MobileSMS,6,1734881994,1734882000,1734882000.453466,-21600,EB445137-D7F5-57EC-87DA-1DB460D64046,"iPhone13,2"
com.apple.MobileSMS,67,1734881920,1734881987,1734881987.3071718,-21600,EB445137-D7F5-57EC-87DA-1DB460D64046,"iPhone13,2"
com.apple.Health,6,1734881914,1734881920,1734881921.3862371,-21600,EB445137-D7F5-57EC-87DA-1DB460D64046,"iPhone13,2"
com.apple.Health,11,1734881899,1734881910,1734881910.748483,-21600,EB445137-D7F5-57EC-87DA-1DB460D64046,"iPhone13,2"
com.apple.Health,33,1734881660,1734881693,1734881694.801635,-21600,EB445137-D7F5-57EC-87DA-1DB460D64046,"iPhone13,2"
com.apple.findmy,17,1734881640,1734881657,1734881658.0017738,-21600,EB445137-D7F5-57EC-87DA-1DB460D64046,"iPhone13,2"
com.apple.MobileSMS,4,1734881631,1734881635,1734881635.357938,-21600,EB445137-D7F5-57EC-87DA-1DB460D64046,"iPhone13,2"
com.renpho.health,4,1734881627,1734881631,1734881631.90692,-21600,EB445137-D7F5-57EC-87DA-1DB460D64046,"iPhone13,2"
com.renpho.health,10,1734881555,1734881565,1734881565.573818,-21600,EB445137-D7F5-57EC-87DA-1DB460D64046,"iPhone13,2"
com.renpho.health,21,1734881521,1734881542,1734881542.410402,-21600,EB445137-D7F5-57EC-87DA-1DB460D64046,"iPhone13,2"
com.toyopagroup.picaboo,12,1734881508,1734881520,1734881521.137223,-21600,EB445137-D7F5-57EC-87DA-1DB460D64046,"iPhone13,2"
com.apple.MobileSMS,6,1734881502,1734881508,1734881508.8868709,-21600,EB445137-D7F5-57EC-87DA-1DB460D64046,"iPhone13,2"
com.apple.MobileSMS,18,1734881440,1734881458,1734881458.9984632,-21600,EB445137-D7F5-57EC-87DA-1DB460D64046,"iPhone13,2"
com.apple.MobileSMS,48,1734881099,1734881147,1734881147.972467,-21600,EB445137-D7F5-57EC-87DA-1DB460D64046,"iPhone13,2"
com.apple.camera,1,1734880967,1734880968,1734880968.158767,-21600,EB445137-D7F5-57EC-87DA-1DB460D64046,"iPhone13,2"
com.google.Chrome,80,1734847194,1734847274,1734847274.9982738,-21600,,
com.apple.MobileSMS,33,1734845168,1734845201,1734845201.706743,-21600,EB445137-D7F5-57EC-87DA-1DB460D64046,"iPhone13,2"
com.google.chrome.ios,31,1734845137,1734845168,1734845168.99138,-21600,EB445137-D7F5-57EC-87DA-1DB460D64046,"iPhone13,2"
com.apple.camera,287,1734844745,1734845032,1734845033.908934,-21600,EB445137-D7F5-57EC-87DA-1DB460D64046,"iPhone13,2"
com.apple.Music,6,1734844743,1734844749,1734844750.735645,-21600,EB445137-D7F5-57EC-87DA-1DB460D64046,"iPhone13,2"
com.apple.Music,5,1734844674,1734844679,1734844679.687996,-21600,EB445137-D7F5-57EC-87DA-1DB460D64046,"iPhone13,2"
com.apple.Music,13,1734844176,1734844189,1734844189.823704,-21600,EB445137-D7F5-57EC-87DA-1DB460D64046,"iPhone13,2"
com.apple.Music,3,1734844050,1734844053,1734844053.160945,-21600,EB445137-D7F5-57EC-87DA-1DB460D64046,"iPhone13,2"
com.apple.Music,10,1734844036,1734844046,1734844046.637835,-21600,EB445137-D7F5-57EC-87DA-1DB460D64046,"iPhone13,2"
com.apple.camera,0,1734844024,1734844024,1734844024.959033,-21600,EB445137-D7F5-57EC-87DA-1DB460D64046,"iPhone13,2"
com.apple.Music,7,1734844019,1734844026,1734844026.92694,-21600,EB445137-D7F5-57EC-87DA-1DB460D64046,"iPhone13,2"
com.apple.Music,724,1734842693,1734843417,1734843419.13485,-21600,EB445137-D7F5-57EC-87DA-1DB460D64046,"iPhone13,2"
com.toyopagroup.picaboo,3,1734842687,1734842690,1734842690.58335,-21600,EB445137-D7F5-57EC-87DA-1DB460D64046,"iPhone13,2"
com.toyopagroup.picaboo,6,1734838315,1734838321,1734838321.778678,-21600,EB445137-D7F5-57EC-87DA-1DB460D64046,"iPhone13,2"
com.toyopagroup.picaboo,21,1734838293,1734838314,1734838316.207368,-21600,EB445137-D7F5-57EC-87DA-1DB460D64046,"iPhone13,2"
com.apple.mobileslideshow,88,1734835887,1734835975,1734835975.35397,-21600,EB445137-D7F5-57EC-87DA-1DB460D64046,"iPhone13,2"
com.toyopagroup.picaboo,1,1734835885,1734835886,1734835886.9491038,-21600,EB445137-D7F5-57EC-87DA-1DB460D64046,"iPhone13,2"
com.toyopagroup.picaboo,27,1734835719,1734835746,1734835747.353241,-21600,EB445137-D7F5-57EC-87DA-1DB460D64046,"iPhone13,2"
com.instructure.icanvas,44,1734835675,1734835719,1734835719.615497,-21600,EB445137-D7F5-57EC-87DA-1DB460D64046,"iPhone13,2"
com.apple.MobileSMS,2,1734835671,1734835673,1734835673.412858,-21600,EB445137-D7F5-57EC-87DA-1DB460D64046,"iPhone13,2"
com.toyopagroup.picaboo,11,1734835657,1734835668,1734835668.909961,-21600,EB445137-D7F5-57EC-87DA-1DB460D64046,"iPhone13,2"
com.apple.findmy,3,1734835654,1734835657,1734835657.649098,-21600,EB445137-D7F5-57EC-87DA-1DB460D64046,"iPhone13,2"
com.apple.findmy,10,1734835643,1734835653,1734835653.4431381,-21600,EB445137-D7F5-57EC-87DA-1DB460D64046,"iPhone13,2"
com.apple.findmy,11,1734835343,1734835354,1734835354.805661,-21600,EB445137-D7F5-57EC-87DA-1DB460D64046,"iPhone13,2"
com.apple.findmy,29,1734835262,1734835291,1734835291.656458,-21600,EB445137-D7F5-57EC-87DA-1DB460D64046,"iPhone13,2"
com.apple.findmy,5,1734835104,1734835109,1734835110.014456,-21600,EB445137-D7F5-57EC-87DA-1DB460D64046,"iPhone13,2"
com.google.Chrome,84,1734835025,1734835109,1734835110.1467261,-21600,,
com.microsoft.VSCode,17,1734835008,1734835025,1734835025.105267,-21600,,
com.apple.findmy,2,1734834657,1734834659,1734834659.968066,-21600,EB445137-D7F5-57EC-87DA-1DB460D64046,"iPhone13,2"
com.apple.Maps,5,1734834652,1734834657,1734834657.907409,-21600,EB445137-D7F5-57EC-87DA-1DB460D64046,"iPhone13,2"
com.apple.findmy,9,1734834643,1734834652,1734834652.911161,-21600,EB445137-D7F5-57EC-87DA-1DB460D64046,"iPhone13,2"
com.google.Chrome,486,1734834522,1734835008,1734835009.020253,-21600,,
com.apple.MobileSMS,2,1734834520,1734834522,1734834522.1369472,-21600,,
com.google.Chrome,115,1734834405,1734834520,1734834520.0455241,-21600,,
com.apple.MobileSMS,30,1734834375,1734834405,1734834405.483604,-21600,,
com.google.Chrome,1,1734834374,1734834375,1734834375.275038,-21600,,
com.apple.MobileSMS,2,1734834372,1734834374,1734834374.351881,-21600,,
com.google.Chrome,14,1734834358,1734834372,1734834373.0229301,-21600,,
com.apple.MobileSMS,3,1734834355,1734834358,1734834358.2353148,-21600,,
com.google.Chrome,5,1734834350,1734834355,1734834355.698807,-21600,,
com.apple.MobileSMS,1,1734834349,1734834350,1734834351.024679,-21600,,
com.google.Chrome,5,1734834344,1734834349,1734834349.807743,-21600,,
com.apple.MobileSMS,1,1734834343,1734834344,1734834344.335504,-21600,,
com.google.Chrome,9,1734834334,1734834343,1734834343.308621,-21600,,
com.apple.MobileSMS,3,1734834331,1734834334,1734834334.832282,-21600,,
com.google.Chrome,17,1734834314,1734834331,1734834331.582303,-21600,,
com.apple.MobileSMS,28,1734834286,1734834314,1734834314.2239041,-21600,,
com.apple.findmy,13,1734834229,1734834242,1734834243.04819,-21600,EB445137-D7F5-57EC-87DA-1DB460D64046,"iPhone13,2"
com.google.Chrome,174,1734834112,1734834286,1734834286.927349,-21600,,
com.google.Chrome,305,1734833391,1734833696,1734833696.6311069,-21600,,
com.google.Chrome,470,1734832880,1734833350,1734833350.077413,-21600,,
com.apple.finder,1,1734832879,1734832880,1734832880.1930552,-21600,,
com.microsoft.VSCode,2,1734832877,1734832879,1734832879.206996,-21600,,
com.google.Chrome,23,1734832854,1734832877,1734832877.385682,-21600,,
com.microsoft.VSCode,14,1734832840,1734832854,1734832854.3208032,-21600,,
com.google.Chrome,96,1734832744,1734832840,1734832840.179335,-21600,,
com.microsoft.VSCode,16,1734832728,1734832744,1734832744.9242868,-21600,,
com.google.Chrome,6,1734832722,1734832728,1734832728.69681,-21600,,
com.microsoft.VSCode,7,1734832715,1734832722,1734832722.3446631,-21600,,
com.google.Chrome,8,1734832707,1734832715,1734832715.349234,-21600,,
com.microsoft.VSCode,6,1734832701,1734832707,1734832707.2783089,-21600,,
com.google.Chrome,34,1734832667,1734832701,1734832701.484767,-21600,,
com.microsoft.VSCode,19,1734832648,1734832667,1734832667.280915,-21600,,
com.google.Chrome,37,1734832611,1734832648,1734832648.7628179,-21600,,
com.microsoft.VSCode,181,1734832430,1734832611,1734832611.5053139,-21600,,
com.google.Chrome,2,1734832428,1734832430,1734832430.206814,-21600,,
com.microsoft.VSCode,1,1734832427,1734832428,1734832428.816833,-21600,,
com.google.Chrome,55,1734832372,1734832427,1734832427.465536,-21600,,
com.microsoft.VSCode,1,1734832371,1734832372,1734832372.317731,-21600,,
com.google.Chrome,37,1734832334,1734832371,1734832371.224654,-21600,,
com.microsoft.VSCode,1,1734832333,1734832334,1734832334.696389,-21600,,
com.google.Chrome,21,1734832312,1734832333,1734832333.374237,-21600,,
com.microsoft.VSCode,2,1734832310,1734832312,1734832312.1240978,-21600,,
com.google.Chrome,79,1734832231,1734832310,1734832310.7174668,-21600,,
com.microsoft.VSCode,4,1734832227,1734832231,1734832231.144806,-21600,,
com.google.Chrome,69,1734832158,1734832227,1734832227.97718,-21600,,
tv.trakt.trakt,8,1734832040,1734832048,1734832049.029233,-21600,EB445137-D7F5-57EC-87DA-1DB460D64046,"iPhone13,2"
com.microsoft.VSCode,141,1734832017,1734832158,1734832158.925884,-21600,,
com.google.Chrome,110,1734831907,1734832017,1734832017.729847,-21600,,
com.microsoft.VSCode,92,1734831815,1734831907,1734831908.0379,-21600,,
com.google.Chrome,1,1734831814,1734831815,1734831815.330823,-21600,,
com.microsoft.VSCode,2,1734831812,1734831814,1734831814.089205,-21600,,
com.google.Chrome,14,1734831798,1734831812,1734831812.3891501,-21600,,
com.microsoft.VSCode,43,1734831755,1734831798,1734831798.383188,-21600,,
com.google.Chrome,275,1734831480,1734831755,1734831755.191804,-21600,,
com.microsoft.VSCode,89,1734831391,1734831480,1734831480.109695,-21600,,
com.google.Chrome,6,1734831385,1734831391,1734831391.498811,-21600,,
com.microsoft.VSCode,2,1734831383,1734831385,1734831385.809123,-21600,,
com.google.Chrome,2,1734831381,1734831383,1734831384.003827,-21600,,
com.microsoft.VSCode,24,1734831357,1734831381,1734831381.56744,-21600,,
com.google.Chrome,20,1734831337,1734831357,1734831357.767264,-21600,,
com.microsoft.VSCode,82,1734831255,1734831337,1734831337.119454,-21600,,
com.google.Chrome,3,1734831252,1734831255,1734831255.595784,-21600,,
com.microsoft.VSCode,5,1734831247,1734831252,1734831252.283867,-21600,,
com.google.Chrome,4,1734831243,1734831247,1734831247.129246,-21600,,
com.microsoft.VSCode,16,1734831227,1734831243,1734831243.570405,-21600,,
com.google.Chrome,5,1734831222,1734831227,1734831228.016996,-21600,,
com.microsoft.VSCode,63,1734831159,1734831222,1734831222.573204,-21600,,
com.apple.finder,83,1734831076,1734831159,1734831159.231225,-21600,,
com.google.Chrome,3,1734831073,1734831076,1734831076.309154,-21600,,
com.apple.finder,4,1734831069,1734831073,1734831073.1287,-21600,,
com.google.Chrome,7,1734831062,1734831069,1734831069.7783961,-21600,,
com.apple.finder,19,1734831043,1734831062,1734831062.1367068,-21600,,
com.google.Chrome,3,1734831040,1734831043,1734831043.0871859,-21600,,
com.apple.iWork.Numbers,0,1734831040,1734831040,1734831040.937391,-21600,,
com.google.Chrome,74,1734830966,1734831040,1734831040.748132,-21600,,
tv.trakt.trakt,382,1734830641,1734831023,1734831023.741189,-21600,EB445137-D7F5-57EC-87DA-1DB460D64046,"iPhone13,2"
tv.trakt.trakt,5,1734830635,1734830640,1734830640.901946,-21600,EB445137-D7F5-57EC-87DA-1DB460D64046,"iPhone13,2"
tv.trakt.trakt,213,1734830386,1734830599,1734830600.4349608,-21600,EB445137-D7F5-57EC-87DA-1DB460D64046,"iPhone13,2"
tv.trakt.trakt,94,1734830233,1734830327,1734830328.0760422,-21600,EB445137-D7F5-57EC-87DA-1DB460D64046,"iPhone13,2"
tv.trakt.trakt,137,1734829946,1734830083,1734830084.21798,-21600,EB445137-D7F5-57EC-87DA-1DB460D64046,"iPhone13,2"
com.apple.AppStore,59,1734829887,1734829946,1734829946.7071009,-21600,EB445137-D7F5-57EC-87DA-1DB460D64046,"iPhone13,2"
com.google.Chrome,1250,1734829684,1734830934,1734830934.22268,-21600,,
com.apple.Passwords,4,1734829680,1734829684,1734829684.8590279,-21600,,
com.google.Chrome,331,1734829349,1734829680,1734829680.082813,-21600,,
com.apple.Safari,16,1734829333,1734829349,1734829349.906238,-21600,,
com.google.Chrome,123,1734829210,1734829333,1734829333.909837,-21600,,
com.apple.finder,1,1734829209,1734829210,1734829210.558587,-21600,,
com.tinyspeck.chatlyio,8,1734829133,1734829141,1734829141.468141,-21600,EB445137-D7F5-57EC-87DA-1DB460D64046,"iPhone13,2"
com.peacocktv.peacock,9,1734829124,1734829133,1734829134.069233,-21600,EB445137-D7F5-57EC-87DA-1DB460D64046,"iPhone13,2"
com.google.Chrome,89,1734829120,1734829209,1734829209.7656322,-21600,,
com.apple.finder,68,1734829052,1734829120,1734829120.181144,-21600,,
com.google.Chrome,213,1734828839,1734829052,1734829052.0885692,-21600,,
com.apple.finder,10,1734828829,1734828839,1734828839.402499,-21600,,
com.google.Chrome,4,1734828825,1734828829,1734828829.2431521,-21600,,
com.microsoft.VSCode,62,1734828763,1734828825,1734828825.21995,-21600,,
com.google.Chrome,7,1734828756,1734828763,1734828763.039283,-21600,,
com.microsoft.VSCode,162,1734828594,1734828756,1734828756.9540272,-21600,,
com.google.Chrome,0,1734828594,1734828594,1734828594.919966,-21600,,
com.apple.finder,1,1734828593,1734828594,1734828594.2894511,-21600,,
com.google.Chrome,3,1734828590,1734828593,1734828593.106519,-21600,,
com.apple.finder,1,1734828589,1734828590,1734828590.975967,-21600,,
com.microsoft.VSCode,68,1734828521,1734828589,1734828589.675873,-21600,,
com.apple.finder,36,1734828485,1734828521,1734828521.182849,-21600,,
com.apple.archiveutility,1,1734828484,1734828485,1734828485.189691,-21600,,
com.apple.finder,5,1734828479,1734828484,1734828484.824661,-21600,,
com.google.Chrome,20,1734828459,1734828479,1734828479.154738,-21600,,
com.microsoft.VSCode,1,1734828458,1734828459,1734828459.868175,-21600,,
com.google.Chrome,4,1734828454,1734828458,1734828459.035217,-21600,,
com.microsoft.VSCode,7,1734828447,1734828454,1734828454.107229,-21600,,
com.google.Chrome,6,1734828441,1734828447,1734828447.997064,-21600,,
com.microsoft.VSCode,67,1734828374,1734828441,1734828441.565155,-21600,,
com.google.Chrome,14,1734828360,1734828374,1734828374.727488,-21600,,
com.microsoft.VSCode,17,1734828343,1734828360,1734828360.459893,-21600,,
com.google.Chrome,8,1734828335,1734828343,1734828343.067161,-21600,,
com.microsoft.VSCode,0,1734828335,1734828335,1734828335.782135,-21600,,
com.google.Chrome,2,1734828333,1734828335,1734828335.107655,-21600,,
com.microsoft.VSCode,10,1734828323,1734828333,1734828333.32545,-21600,,
com.google.Chrome,4,1734828319,1734828323,1734828323.457639,-21600,,
com.microsoft.VSCode,15,1734828304,1734828319,1734828319.978374,-21600,,
com.peacocktv.peacock,156,1734828062,1734828218,1734828218.650634,-21600,EB445137-D7F5-57EC-87DA-1DB460D64046,"iPhone13,2"
com.apple.findmy,11,1734828046,1734828057,1734828057.308271,-21600,EB445137-D7F5-57EC-87DA-1DB460D64046,"iPhone13,2"
com.google.Chrome,394,1734827910,1734828304,1734828305.006682,-21600,,
com.apple.finder,22,1734827858,1734827880,1734827880.289915,-21600,,
com.google.Chrome,159,1734827699,1734827858,1734827858.081228,-21600,,
com.microsoft.VSCode,0,1734826943,1734826943,1734826943.7328892,-21600,,
com.google.Chrome,8,1734826935,1734826943,1734826943.1797218,-21600,,
com.microsoft.VSCode,6,1734826929,1734826935,1734826935.181202,-21600,,
com.google.Chrome,9,1734826920,1734826929,1734826929.951894,-21600,,
com.microsoft.VSCode,34,1734826886,1734826920,1734826920.587611,-21600,,
com.google.Chrome,203,1734826683,1734826886,1734826886.19453,-21600,,
com.microsoft.VSCode,60,1734826623,1734826683,1734826683.524881,-21600,,
com.google.Chrome,6,1734826617,1734826623,1734826623.718112,-21600,,
com.microsoft.VSCode,15,1734826602,1734826617,1734826617.6337008,-21600,,
com.google.Chrome,20,1734826582,1734826602,1734826602.555489,-21600,,
com.microsoft.VSCode,50,1734826532,1734826582,1734826582.211358,-21600,,
com.apple.finder,1,1734826531,1734826532,1734826532.304384,-21600,,
com.google.Chrome,3,1734826528,1734826531,1734826531.5122461,-21600,,
com.apple.finder,1,1734826527,1734826528,1734826528.867347,-21600,,
com.microsoft.VSCode,130,1734826397,1734826527,1734826527.886029,-21600,,
com.apple.finder,57,1734826340,1734826397,1734826397.626916,-21600,,
com.google.Chrome,5,1734826335,1734826340,1734826340.7771459,-21600,,
com.microsoft.VSCode,76,1734826259,1734826335,1734826335.9214501,-21600,,
com.google.Chrome,28,1734826231,1734826259,1734826259.651324,-21600,,
com.microsoft.VSCode,47,1734826184,1734826231,1734826231.7189078,-21600,,
com.google.Chrome,7,1734826177,1734826184,1734826184.885427,-21600,,
com.microsoft.VSCode,49,1734826128,1734826177,1734826177.877592,-21600,,
com.google.Chrome,25,1734826103,1734826128,1734826128.469448,-21600,,
com.microsoft.VSCode,2,1734826101,1734826103,1734826103.659302,-21600,,
com.google.Chrome,12,1734826089,1734826101,1734826101.630574,-21600,,
com.microsoft.VSCode,4,1734826085,1734826089,1734826089.5481172,-21600,,
com.google.Chrome,7,1734826078,1734826085,1734826085.769442,-21600,,
com.microsoft.VSCode,7,1734826071,1734826078,1734826078.526861,-21600,,
com.google.Chrome,41,1734826030,1734826071,1734826071.031172,-21600,,
com.microsoft.VSCode,139,1734825891,1734826030,1734826030.74654,-21600,,
com.apple.finder,202,1734825689,1734825891,1734825891.847779,-21600,,
com.google.Chrome,12,1734825677,1734825689,1734825689.89295,-21600,,
com.apple.findmy,12,1734822275,1734822287,1734822288.112881,-21600,EB445137-D7F5-57EC-87DA-1DB460D64046,"iPhone13,2"
com.apple.findmy,8,1734821758,1734821766,1734821767.2246242,-21600,EB445137-D7F5-57EC-87DA-1DB460D64046,"iPhone13,2"
com.google.Gmail,3,1734821754,1734821757,1734821758.998848,-21600,EB445137-D7F5-57EC-87DA-1DB460D64046,"iPhone13,2"
com.google.Chrome,18,1734821517,1734821535,1734821535.280249,-21600,,
com.apple.MobileSMS,8,1734821509,1734821517,1734821517.202423,-21600,,
com.google.Chrome,115,1734821394,1734821509,1734821509.126431,-21600,,
com.google.Chrome,521,1734820680,1734821201,1734821201.364222,-21600,,
com.apple.finder,147,1734820533,1734820680,1734820680.5998712,-21600,,
com.apple.archiveutility,1,1734820532,1734820533,1734820533.130029,-21600,,
com.apple.finder,16,1734820516,1734820532,1734820532.7557049,-21600,,
com.google.Gmail,6,1734820479,1734820485,1734820485.273415,-21600,EB445137-D7F5-57EC-87DA-1DB460D64046,"iPhone13,2"
com.google.Gmail,5,1734820292,1734820297,1734820297.7656798,-21600,EB445137-D7F5-57EC-87DA-1DB460D64046,"iPhone13,2"
com.google.Gmail,19,1734820221,1734820240,1734820240.841847,-21600,EB445137-D7F5-57EC-87DA-1DB460D64046,"iPhone13,2"
com.google.Chrome,421,1734820095,1734820516,1734820516.747558,-21600,,
com.apple.finder,26,1734820069,1734820095,1734820095.8156,-21600,,
com.google.Chrome,53,1734820016,1734820069,1734820070.0140529,-21600,,
com.apple.finder,5,1734820011,1734820016,1734820016.863552,-21600,,
com.google.Chrome,33,1734819978,1734820011,1734820011.064179,-21600,,
com.apple.finder,29,1734819949,1734819978,1734819978.052181,-21600,,
com.apple.archiveutility,1,1734819948,1734819949,1734819949.351657,-21600,,
com.apple.finder,3,1734819945,1734819948,1734819948.9604058,-21600,,
com.google.Chrome,392,1734819553,1734819945,1734819946.01913,-21600,,
com.apple.camera,1,1734819334,1734819335,1734819335.8181372,-21600,EB445137-D7F5-57EC-87DA-1DB460D64046,"iPhone13,2"
com.google.Chrome,654,1734818669,1734819323,1734819323.635549,-21600,,
com.burbn.instagram,32,1734818386,1734818418,1734818418.33184,-21600,EB445137-D7F5-57EC-87DA-1DB460D64046,"iPhone13,2"
com.apple.findmy,14,1734818372,1734818386,1734818387.1505919,-21600,EB445137-D7F5-57EC-87DA-1DB460D64046,"iPhone13,2"
com.burbn.instagram,2,1734818369,1734818371,1734818371.4506311,-21600,EB445137-D7F5-57EC-87DA-1DB460D64046,"iPhone13,2"
com.google.Chrome,309,1734817981,1734818290,1734818290.282466,-21600,,
com.apple.MobileSMS,74,1734817907,1734817981,1734817981.1986098,-21600,,
com.google.Chrome,806,1734817101,1734817907,1734817907.797946,-21600,,
com.leomehlig.today,10,1734817091,1734817101,1734817102.733626,-21600,,
com.apple.camera,0,1734816976,1734816976,1734816976.578517,-21600,EB445137-D7F5-57EC-87DA-1DB460D64046,"iPhone13,2"
com.google.ios.youtube,2365,1734814589,1734816954,1734816954.28848,-21600,EB445137-D7F5-57EC-87DA-1DB460D64046,"iPhone13,2"
com.leomehlig.today,117,1734814564,1734814681,1734814681.035156,-21600,,
com.apple.news,10,1734814530,1734814540,1734814540.89579,-21600,EB445137-D7F5-57EC-87DA-1DB460D64046,"iPhone13,2"
com.apple.news,8,1734814520,1734814528,1734814528.595617,-21600,EB445137-D7F5-57EC-87DA-1DB460D64046,"iPhone13,2"
com.apple.MobileSMS,33,1734814481,1734814514,1734814514.479042,-21600,EB445137-D7F5-57EC-87DA-1DB460D64046,"iPhone13,2"
com.apple.weather,8,1734814443,1734814451,1734814451.648458,-21600,EB445137-D7F5-57EC-87DA-1DB460D64046,"iPhone13,2"
com.apple.Preview,1191,1734813144,1734814335,1734814335.1548018,-21600,,
com.apple.finder,10,1734813134,1734813144,1734813144.0683951,-21600,,
com.leomehlig.today,5,1734813129,1734813134,1734813134.4154801,-21600,,
com.leomehlig.today,320,1734812226,1734812546,1734812546.067243,-21600,,
com.apple.finder,1,1734812225,1734812226,1734812226.905782,-21600,,
com.burbn.instagram,18,1734810927,1734810945,1734810945.72141,-21600,EB445137-D7F5-57EC-87DA-1DB460D64046,"iPhone13,2"
com.apple.mobileslideshow,3,1734810917,1734810920,1734810920.629651,-21600,EB445137-D7F5-57EC-87DA-1DB460D64046,"iPhone13,2"
com.apple.finder,305,1734810899,1734811204,1734811204.571212,-21600,,
com.apple.systempreferences,119,1734810780,1734810899,1734810899.861337,-21600,,
com.apple.finder,2,1734810772,1734810774,1734810774.749825,-21600,,
com.apple.Photos,161,1734810611,1734810772,1734810773.066711,-21600,,
com.leomehlig.today,53,1734810558,1734810611,1734810611.201717,-21600,,
com.apple.iCal,9,1734810549,1734810558,1734810558.485405,-21600,,
com.leomehlig.today,38,1734810511,1734810549,1734810549.922709,-21600,,
com.apple.mobileslideshow,86,1734810278,1734810364,1734810365.72499,-21600,EB445137-D7F5-57EC-87DA-1DB460D64046,"iPhone13,2"
com.apple.mobileslideshow,7,1734810262,1734810269,1734810269.487903,-21600,EB445137-D7F5-57EC-87DA-1DB460D64046,"iPhone13,2"
com.apple.camera,1,1734810262,1734810263,1734810263.464552,-21600,EB445137-D7F5-57EC-87DA-1DB460D64046,"iPhone13,2"
com.apple.mobileslideshow,774,1734809487,1734810261,1734810261.577783,-21600,EB445137-D7F5-57EC-87DA-1DB460D64046,"iPhone13,2"
com.peacocktv.peacock,1518,1734807912,1734809430,1734809430.906548,-21600,EB445137-D7F5-57EC-87DA-1DB460D64046,"iPhone13,2"
com.google.ios.youtube,966,1734806903,1734807869,1734807869.337789,-21600,EB445137-D7F5-57EC-87DA-1DB460D64046,"iPhone13,2"
com.apple.Music,88,1734806815,1734806903,1734806903.855464,-21600,EB445137-D7F5-57EC-87DA-1DB460D64046,"iPhone13,2"
com.google.ios.youtube,103,1734806710,1734806813,1734806813.755484,-21600,EB445137-D7F5-57EC-87DA-1DB460D64046,"iPhone13,2"
com.microsoft.Office.Outlook,3,1734806697,1734806700,1734806700.747005,-21600,EB445137-D7F5-57EC-87DA-1DB460D64046,"iPhone13,2"
com.hammerandchisel.discord,16,1734806679,1734806695,1734806695.651655,-21600,EB445137-D7F5-57EC-87DA-1DB460D64046,"iPhone13,2"
com.google.ios.youtube,1488,1734805187,1734806675,1734806675.591192,-21600,EB445137-D7F5-57EC-87DA-1DB460D64046,"iPhone13,2"
com.apple.news,64,1734803312,1734803376,1734803376.582022,-21600,EB445137-D7F5-57EC-87DA-1DB460D64046,"iPhone13,2"
com.burbn.instagram,117,1734803165,1734803282,1734803282.29055,-21600,EB445137-D7F5-57EC-87DA-1DB460D64046,"iPhone13,2"
com.apple.findmy,54,1734803104,1734803158,1734803158.5011091,-21600,EB445137-D7F5-57EC-87DA-1DB460D64046,"iPhone13,2"
com.leomehlig.today,62,1734803028,1734803090,1734803090.392416,-21600,,
com.apple.findmy,17,1734802654,1734802671,1734802671.553959,-21600,EB445137-D7F5-57EC-87DA-1DB460D64046,"iPhone13,2"
com.leomehlig.today,307,1734802302,1734802609,1734802609.243194,-21600,,
com.apple.finder,21,1734802281,1734802302,1734802303.035509,-21600,,
com.google.Chrome,11,1734802270,1734802281,1734802281.634419,-21600,,
com.microsoft.rdc.macos,13,1734802257,1734802270,1734802270.8618178,-21600,,
com.cisco.secureclient.gui,1,1734802256,1734802257,1734802257.915279,-21600,,
com.microsoft.rdc.macos,92,1734802164,1734802256,1734802256.329681,-21600,,
com.apple.Terminal,86,1734802078,1734802164,1734802164.506764,-21600,,
com.microsoft.rdc.macos,266,1734801812,1734802078,1734802078.9014149,-21600,,
com.google.Chrome,6,1734801806,1734801812,1734801812.505825,-21600,,
com.apple.Terminal,8,1734801798,1734801806,1734801806.926539,-21600,,
com.google.Chrome,11,1734801787,1734801798,1734801798.867146,-21600,,
com.apple.Terminal,93,1734801694,1734801787,1734801787.445909,-21600,,
com.google.Chrome,38,1734801656,1734801694,1734801694.841631,-21600,,
com.apple.Terminal,48,1734801608,1734801656,1734801656.804996,-21600,,
com.cisco.secureclient.gui,21,1734801587,1734801608,1734801608.3184419,-21600,,
com.apple.Terminal,68,1734801519,1734801587,1734801587.30777,-21600,,
com.cisco.secureclient.gui,4,1734801515,1734801519,1734801519.695613,-21600,,
com.apple.Terminal,58,1734801457,1734801515,1734801516.073159,-21600,,
com.google.Chrome,48,1734801409,1734801457,1734801457.604861,-21600,,
com.apple.Terminal,25,1734801384,1734801409,1734801409.146141,-21600,,
com.google.Chrome,41,1734801343,1734801384,1734801384.093161,-21600,,
com.cisco.secureclient.gui,4,1734801339,1734801343,1734801343.110152,-21600,,
com.google.Chrome,2,1734801337,1734801339,1734801339.890446,-21600,,
com.apple.AppStore,12,1734801325,1734801337,1734801337.836813,-21600,,
com.google.Chrome,29,1734801296,1734801325,1734801325.1349049,-21600,,
com.cisco.secureclient.gui,2,1734801294,1734801296,1734801296.983924,-21600,,
com.google.Chrome,180,1734801114,1734801294,1734801294.646888,-21600,,
com.microsoft.Outlook,78,1734801036,1734801114,1734801114.541339,-21600,,
com.google.Chrome,19,1734801017,1734801036,1734801036.477398,-21600,,
com.apple.Terminal,114,1734800903,1734801017,1734801017.570581,-21600,,
com.cisco.secureclient.gui,30,1734800873,1734800903,1734800903.730593,-21600,,
com.apple.Terminal,8,1734800865,1734800873,1734800873.810858,-21600,,
com.cisco.secureclient.gui,5,1734800860,1734800865,1734800865.793295,-21600,,
com.apple.Terminal,73,1734800787,1734800860,1734800860.769517,-21600,,
com.google.Chrome,2,1734800785,1734800787,1734800787.6729798,-21600,,
com.apple.Terminal,2,1734800783,1734800785,1734800785.699274,-21600,,
com.google.Chrome,61,1734800722,1734800783,1734800783.9648728,-21600,,
com.microsoft.rdc.macos,0,1734800722,1734800722,1734800722.691421,-21600,,
com.google.Chrome,6,1734800716,1734800722,1734800722.142036,-21600,,
com.microsoft.rdc.macos,18,1734800698,1734800716,1734800716.63524,-21600,,
com.google.Chrome,6,1734800692,1734800698,1734800698.149497,-21600,,
com.microsoft.rdc.macos,1,1734800691,1734800692,1734800692.062696,-21600,,
com.google.Chrome,17,1734800674,1734800691,1734800691.600124,-21600,,
com.microsoft.rdc.macos,10,1734800664,1734800674,1734800674.699761,-21600,,
com.google.Chrome,10,1734800654,1734800664,1734800664.725,-21600,,
com.apple.systempreferences,3,1734800651,1734800654,1734800654.197678,-21600,,
com.cisco.secureclient.gui,35,1734800616,1734800651,1734800651.110225,-21600,,
com.apple.systempreferences,30,1734800586,1734800616,1734800616.526603,-21600,,
com.apple.Terminal,14,1734800566,1734800580,1734800580.4677482,-21600,,
com.google.Chrome,27,1734800539,1734800566,1734800566.9385052,-21600,,
com.cisco.secureclient.gui,36,1734800503,1734800539,1734800539.9893699,-21600,,
com.google.Chrome,12,1734800491,1734800503,1734800503.4237661,-21600,,
com.microsoft.rdc.macos,27,1734800464,1734800491,1734800491.4999518,-21600,,
com.google.Chrome,11,1734800453,1734800464,1734800464.321751,-21600,,
com.microsoft.rdc.macos,28,1734800425,1734800453,1734800453.2806358,-21600,,
com.google.Chrome,22,1734800403,1734800425,1734800425.5353332,-21600,,
com.leomehlig.today,8,1734800395,1734800403,1734800403.560841,-21600,,
com.google.Chrome,3,1734800392,1734800395,1734800396.519782,-21600,,
com.apple.finder,96,1734800296,1734800392,1734800392.808309,-21600,,
com.cisco.secureclient.gui,71,1734800225,1734800296,1734800296.929017,-21600,,
com.apple.finder,17,1734800208,1734800225,1734800225.672179,-21600,,
com.google.Chrome,2,1734800161,1734800163,1734800164.031424,-21600,,
com.apple.installer,6,1734800155,1734800161,1734800161.988045,-21600,,
com.google.Chrome,1,1734800154,1734800155,1734800155.388169,-21600,,
com.apple.systempreferences,8,1734800146,1734800154,1734800154.154783,-21600,,
com.google.Chrome,22,1734800124,1734800146,1734800146.750581,-21600,,
com.apple.systempreferences,9,1734800115,1734800124,1734800124.55444,-21600,,
com.google.Chrome,8,1734800100,1734800108,1734800108.993166,-21600,,
com.apple.installer,13,1734800087,1734800100,1734800100.977956,-21600,,
com.google.Chrome,19,1734800057,1734800076,1734800076.038651,-21600,,
com.apple.finder,3,1734800054,1734800057,1734800057.132127,-21600,,
com.apple.installer,1,1734800053,1734800054,1734800054.676931,-21600,,
com.google.Chrome,8,1734800045,1734800053,1734800053.131384,-21600,,
com.apple.installer,1,1734800044,1734800045,1734800045.915055,-21600,,
com.apple.finder,12,1734800032,1734800044,1734800044.0426512,-21600,,
com.google.Chrome,37,1734799995,1734800032,1734800033.000088,-21600,,
com.leomehlig.today,43,1734799900,1734799943,1734799943.257465,-21600,,
com.google.Chrome,10,1734799890,1734799900,1734799900.395803,-21600,,
com.google.chrome.ios,19,1734798244,1734798263,1734798263.587548,-21600,EB445137-D7F5-57EC-87DA-1DB460D64046,"iPhone13,2"
com.apple.findmy,14,1734798203,1734798217,1734798218.010573,-21600,EB445137-D7F5-57EC-87DA-1DB460D64046,"iPhone13,2"
com.apple.findmy,11,1734796719,1734796730,1734796730.443849,-21600,EB445137-D7F5-57EC-87DA-1DB460D64046,"iPhone13,2"
com.apple.findmy,6,1734796712,1734796718,1734796718.5866761,-21600,EB445137-D7F5-57EC-87DA-1DB460D64046,"iPhone13,2"
com.google.Chrome,6,1734796039,1734796045,1734796045.702244,-21600,,
com.apple.Preview,4,1734796035,1734796039,1734796039.780623,-21600,,
com.tinyspeck.chatlyio,32,1734795998,1734796030,1734796030.579937,-21600,EB445137-D7F5-57EC-87DA-1DB460D64046,"iPhone13,2"
com.apple.printcenter,40,1734795995,1734796035,1734796035.857975,-21600,,
com.apple.systempreferences,13,1734795961,1734795974,1734795974.522996,-21600,,
com.apple.printcenter,78,1734795883,1734795961,1734795961.418181,-21600,,
com.apple.Preview,1,1734795882,1734795883,1734795883.523394,-21600,,
com.apple.printcenter,85,1734795795,1734795880,1734795880.143822,-21600,,
com.apple.Preview,2,1734795724,1734795726,1734795726.7070642,-21600,,
com.apple.printcenter,2,1734795710,1734795712,1734795712.8784652,-21600,,
com.apple.Image_Capture,5,1734795705,1734795710,1734795710.4397259,-21600,,
com.apple.printcenter,12,1734795693,1734795705,1734795705.264868,-21600,,
com.apple.printcenter,44,1734795539,1734795583,1734795583.784953,-21600,,
com.burbn.instagram,59,1734795307,1734795366,1734795366.112267,-21600,EB445137-D7F5-57EC-87DA-1DB460D64046,"iPhone13,2"
com.strava.stravaride,63,1734795240,1734795303,1734795303.180851,-21600,EB445137-D7F5-57EC-87DA-1DB460D64046,"iPhone13,2"
com.hammerandchisel.discord,10,1734795177,1734795187,1734795187.175786,-21600,EB445137-D7F5-57EC-87DA-1DB460D64046,"iPhone13,2"
com.apple.findmy,6,1734795139,1734795145,1734795145.930181,-21600,EB445137-D7F5-57EC-87DA-1DB460D64046,"iPhone13,2"
com.apple.printcenter,314,1734795081,1734795395,1734795395.340553,-21600,,
com.apple.Preview,9,1734795072,1734795081,1734795081.319166,-21600,,
com.apple.printcenter,4,1734795063,1734795067,1734795067.096684,-21600,,
com.apple.Preview,3,1734794869,1734794872,1734794872.683666,-21600,,
com.apple.finder,26,1734794832,1734794858,1734794858.468513,-21600,,
com.google.Chrome,104,1734794728,1734794832,1734794832.41045,-21600,,
com.apple.findmy,17,1734794671,1734794688,1734794688.6144872,-21600,EB445137-D7F5-57EC-87DA-1DB460D64046,"iPhone13,2"
com.renpho.health,6,1734794656,1734794662,1734794662.3420339,-21600,EB445137-D7F5-57EC-87DA-1DB460D64046,"iPhone13,2"
com.renpho.health,2,1734794650,1734794652,1734794653.000423,-21600,EB445137-D7F5-57EC-87DA-1DB460D64046,"iPhone13,2"
com.renpho.health,20,1734794572,1734794592,1734794592.905992,-21600,EB445137-D7F5-57EC-87DA-1DB460D64046,"iPhone13,2"
com.apple.camera,32,1734794476,1734794508,1734794509.54551,-21600,EB445137-D7F5-57EC-87DA-1DB460D64046,"iPhone13,2"
com.apple.findmy,23,1734794475,1734794498,1734794498.635864,-21600,EB445137-D7F5-57EC-87DA-1DB460D64046,"iPhone13,2"
com.apple.findmy,5,1734794460,1734794465,1734794465.984055,-21600,EB445137-D7F5-57EC-87DA-1DB460D64046,"iPhone13,2"
com.apple.findmy,10,1734794359,1734794369,1734794369.097148,-21600,EB445137-D7F5-57EC-87DA-1DB460D64046,"iPhone13,2"
com.apple.findmy,3,1734794349,1734794352,1734794352.5683641,-21600,EB445137-D7F5-57EC-87DA-1DB460D64046,"iPhone13,2"
com.apple.findmy,12,1734792982,1734792994,1734792994.3953462,-21600,EB445137-D7F5-57EC-87DA-1DB460D64046,"iPhone13,2"
com.apple.findmy,13,1734792964,1734792977,1734792978.626082,-21600,EB445137-D7F5-57EC-87DA-1DB460D64046,"iPhone13,2"
com.truebill.truebillnative,165,1734792789,1734792954,1734792954.96811,-21600,EB445137-D7F5-57EC-87DA-1DB460D64046,"iPhone13,2"
com.apple.Health,149,1734792613,1734792762,1734792762.779292,-21600,EB445137-D7F5-57EC-87DA-1DB460D64046,"iPhone13,2"
com.apple.news,789,1734791769,1734792558,1734792558.311624,-21600,EB445137-D7F5-57EC-87DA-1DB460D64046,"iPhone13,2"
com.apple.mobileslideshow,219,1734791471,1734791690,1734791690.647341,-21600,EB445137-D7F5-57EC-87DA-1DB460D64046,"iPhone13,2"
com.apple.mobiletimer,13,1734791440,1734791453,1734791453.5790281,-21600,EB445137-D7F5-57EC-87DA-1DB460D64046,"iPhone13,2"
com.apple.mobiletimer,25,1734791401,1734791426,1734791426.608313,-21600,EB445137-D7F5-57EC-87DA-1DB460D64046,"iPhone13,2"
com.apple.mobiletimer,14,1734758064,1734758078,1734758078.962214,-21600,EB445137-D7F5-57EC-87DA-1DB460D64046,"iPhone13,2"
com.apple.mobiletimer,4,1734758054,1734758058,1734758058.397005,-21600,EB445137-D7F5-57EC-87DA-1DB460D64046,"iPhone13,2"
com.apple.mobiletimer,18,1734758036,1734758054,1734758054.215351,-21600,EB445137-D7F5-57EC-87DA-1DB460D64046,"iPhone13,2"
com.clairmail.fth.client,50,1734757982,1734758032,1734758032.104127,-21600,EB445137-D7F5-57EC-87DA-1DB460D64046,"iPhone13,2"
com.apple.MobileSMS,19,1734757957,1734757976,1734757976.914474,-21600,EB445137-D7F5-57EC-87DA-1DB460D64046,"iPhone13,2"
com.clairmail.fth.client,27,1734757930,1734757957,1734757957.496076,-21600,EB445137-D7F5-57EC-87DA-1DB460D64046,"iPhone13,2"
com.apple.MobileSMS,3,1734757927,1734757930,1734757930.1070719,-21600,EB445137-D7F5-57EC-87DA-1DB460D64046,"iPhone13,2"
com.clairmail.fth.client,48,1734757879,1734757927,1734757928.023689,-21600,EB445137-D7F5-57EC-87DA-1DB460D64046,"iPhone13,2"
com.apple.MobileSMS,18,1734757856,1734757874,1734757874.548773,-21600,EB445137-D7F5-57EC-87DA-1DB460D64046,"iPhone13,2"
com.apple.journal,706,1734757149,1734757855,1734757855.604066,-21600,EB445137-D7F5-57EC-87DA-1DB460D64046,"iPhone13,2"
com.apple.mobileslideshow,19,1734757130,1734757149,1734757149.292183,-21600,EB445137-D7F5-57EC-87DA-1DB460D64046,"iPhone13,2"
com.apple.journal,261,1734756869,1734757130,1734757130.836382,-21600,EB445137-D7F5-57EC-87DA-1DB460D64046,"iPhone13,2"
com.apple.mobileslideshow,63,1734756806,1734756869,1734756869.731173,-21600,EB445137-D7F5-57EC-87DA-1DB460D64046,"iPhone13,2"
com.apple.journal,838,1734755965,1734756803,1734756803.70919,-21600,EB445137-D7F5-57EC-87DA-1DB460D64046,"iPhone13,2"
com.apple.journal,296,1734755668,1734755964,1734755964.559095,-21600,EB445137-D7F5-57EC-87DA-1DB460D64046,"iPhone13,2"
com.apple.news,144,1734755068,1734755212,1734755212.1383471,-21600,EB445137-D7F5-57EC-87DA-1DB460D64046,"iPhone13,2"
com.google.Chrome,541,1734754366,1734754907,1734754908.131176,-21600,,
com.toyopagroup.picaboo,45,1734753139,1734753184,1734753184.379712,-21600,EB445137-D7F5-57EC-87DA-1DB460D64046,"iPhone13,2"
com.burbn.instagram,103,1734753030,1734753133,1734753133.8827782,-21600,EB445137-D7F5-57EC-87DA-1DB460D64046,"iPhone13,2"
com.google.Chrome,1157,1734752745,1734753902,1734753902.48733,-21600,,
com.apple.finder,5,1734752740,1734752745,1734752745.505564,-21600,,
com.truebill.truebillnative,186,1734751985,1734752171,1734752171.626939,-21600,EB445137-D7F5-57EC-87DA-1DB460D64046,"iPhone13,2"
com.discoverfinancial.mobile,58,1734751921,1734751979,1734751979.8110719,-21600,EB445137-D7F5-57EC-87DA-1DB460D64046,"iPhone13,2"
com.microsoft.Office.Outlook,10,1734751909,1734751919,1734751919.803777,-21600,EB445137-D7F5-57EC-87DA-1DB460D64046,"iPhone13,2"
com.apple.Health,111,1734751793,1734751904,1734751904.191086,-21600,EB445137-D7F5-57EC-87DA-1DB460D64046,"iPhone13,2"
com.apple.reminders,5,1734751785,1734751790,1734751790.429511,-21600,EB445137-D7F5-57EC-87DA-1DB460D64046,"iPhone13,2"
com.apple.finder,301,1734751781,1734752082,1734752082.051643,-21600,,
com.apple.Terminal,6,1734751775,1734751781,1734751781.599638,-21600,,
com.apple.finder,5,1734751770,1734751775,1734751775.568784,-21600,,
com.apple.Terminal,29,1734751741,1734751770,1734751770.6129742,-21600,,
com.apple.finder,27,1734751714,1734751741,1734751741.4768791,-21600,,
com.google.Chrome,1098,1734750616,1734751714,1734751714.9021711,-21600,,
com.microsoft.Office.Outlook,1,1734750484,1734750485,1734750485.7669,-21600,EB445137-D7F5-57EC-87DA-1DB460D64046,"iPhone13,2"
com.microsoft.Office.Outlook,3,1734750198,1734750201,1734750201.833792,-21600,EB445137-D7F5-57EC-87DA-1DB460D64046,"iPhone13,2"
com.apple.mobileslideshow,517,1734749681,1734750198,1734750198.074335,-21600,EB445137-D7F5-57EC-87DA-1DB460D64046,"iPhone13,2"
com.apple.weather,3,1734749678,1734749681,1734749681.125365,-21600,EB445137-D7F5-57EC-87DA-1DB460D64046,"iPhone13,2"
com.apple.weather,6,1734749661,1734749667,1734749667.689342,-21600,EB445137-D7F5-57EC-87DA-1DB460D64046,"iPhone13,2"
com.apple.weather,5,1734749374,1734749379,1734749379.1938639,-21600,EB445137-D7F5-57EC-87DA-1DB460D64046,"iPhone13,2"
com.apple.weather,4,1734749185,1734749189,1734749189.367578,-21600,EB445137-D7F5-57EC-87DA-1DB460D64046,"iPhone13,2"
com.apple.weather,1,1734749183,1734749184,1734749184.608419,-21600,EB445137-D7F5-57EC-87DA-1DB460D64046,"iPhone13,2"
com.apple.weather,7,1734749024,1734749031,1734749031.157965,-21600,EB445137-D7F5-57EC-87DA-1DB460D64046,"iPhone13,2"
com.apple.weather,14,1734748756,1734748770,1734748770.9150438,-21600,EB445137-D7F5-57EC-87DA-1DB460D64046,"iPhone13,2"
com.apple.weather,6,1734747818,1734747824,1734747824.697411,-21600,EB445137-D7F5-57EC-87DA-1DB460D64046,"iPhone13,2"
com.apple.weather,3,1734747813,1734747816,1734747816.740512,-21600,EB445137-D7F5-57EC-87DA-1DB460D64046,"iPhone13,2"
com.apple.camera,0,1734747107,1734747107,1734747107.867962,-21600,EB445137-D7F5-57EC-87DA-1DB460D64046,"iPhone13,2"
com.apple.weather,9,1734747104,1734747113,1734747114.062436,-21600,EB445137-D7F5-57EC-87DA-1DB460D64046,"iPhone13,2"
com.apple.weather,3,1734747092,1734747095,1734747095.784289,-21600,EB445137-D7F5-57EC-87DA-1DB460D64046,"iPhone13,2"
com.apple.weather,3,1734747002,1734747005,1734747005.890038,-21600,EB445137-D7F5-57EC-87DA-1DB460D64046,"iPhone13,2"
com.apple.weather,38,1734746362,1734746400,1734746400.682722,-21600,EB445137-D7F5-57EC-87DA-1DB460D64046,"iPhone13,2"
com.apple.Maps,19,1734742394,1734742413,1734742413.3387132,-21600,EB445137-D7F5-57EC-87DA-1DB460D64046,"iPhone13,2"
com.apple.Maps,20,1734740604,1734740624,1734740624.390044,-21600,EB445137-D7F5-57EC-87DA-1DB460D64046,"iPhone13,2"

