app,usage,start_time,end_time,created_at,tz,device_id,device_model
com.apple.finder,3,1752110682,1752110685,1752110685.373122,-18000,,
com.apple.Terminal,1,1752110681,1752110682,1752110682.4487271,-18000,,
com.apple.finder,12,1752110669,1752110681,1752110681.224565,-18000,,
com.microsoft.VSCode,3,1752110666,1752110669,1752110669.29473,-18000,,
com.tableausoftware.tableaudesktop,86,1752110580,1752110666,1752110666.81916,-18000,,
com.microsoft.VSCode,2,1752110578,1752110580,1752110580.728071,-18000,,
com.tableausoftware.tableaudesktop,583,1752109995,1752110578,1752110578.1818829,-18000,,
com.microsoft.VSCode,54,1752109941,1752109995,1752109995.65169,-18000,,
com.apple.finder,6,1752109935,1752109941,1752109941.1139588,-18000,,
com.leomehlig.today,7,1752109928,1752109935,1752109935.855915,-18000,,
com.apple.Music,31,1752109897,1752109928,1752109929.04508,-18000,,
com.apple.Music,944,1752107360,1752108304,1752108304.449057,-18000,,
com.leomehlig.today,8,1752107352,1752107360,1752107360.4932199,-18000,,
com.google.Chrome,3,1752107349,1752107352,1752107352.604844,-18000,,
com.apple.Music,6,1752107343,1752107349,1752107349.868103,-18000,,
com.microsoft.VSCode,267,1752107076,1752107343,1752107344.163842,-18000,,
com.apple.Music,15,1752107061,1752107076,1752107076.7833462,-18000,,
com.microsoft.VSCode,741,1752106320,1752107061,1752107061.698647,-18000,,
com.apple.Music,28,1752106292,1752106320,1752106320.621529,-18000,,
com.microsoft.VSCode,2250,1752104042,1752106292,1752106292.759759,-18000,,
com.apple.Music,42,1752104000,1752104042,1752104042.8406239,-18000,,
com.google.Chrome,1,1752103999,1752104000,1752104000.538179,-18000,,
com.apple.Music,3,1752103996,1752103999,1752103999.153769,-18000,,
com.microsoft.VSCode,15,1752103981,1752103996,1752103996.593579,-18000,,
com.google.Chrome,13,1752103968,1752103981,1752103981.466253,-18000,,
com.apple.finder,4,1752103964,1752103968,1752103968.496222,-18000,,
com.google.Chrome,6,1752103958,1752103964,1752103964.3307772,-18000,,
com.google.Chrome,12,1752100620,1752100632,1752100632.18429,-18000,,
com.apple.finder,4,1752100616,1752100620,1752100620.9074202,-18000,,
com.apple.Notes,54,1752100562,1752100616,1752100616.3966951,-18000,,
com.apple.finder,19,1752100543,1752100562,1752100562.5071049,-18000,,
com.leomehlig.today,43,1752100500,1752100543,1752100543.398493,-18000,,
com.google.Chrome,288,1752100212,1752100500,1752100500.9393082,-18000,,
com.tableausoftware.tableaudesktop,2,1752100210,1752100212,1752100212.562378,-18000,,
com.google.Chrome,11,1752100199,1752100210,1752100210.177145,-18000,,
com.tableausoftware.tableaudesktop,25,1752100174,1752100199,1752100199.519761,-18000,,
com.google.Chrome,1,1752100173,1752100174,1752100174.0616012,-18000,,
com.tableausoftware.tableaudesktop,2,1752100171,1752100173,1752100173.311255,-18000,,
com.google.Chrome,6,1752100165,1752100171,1752100171.580346,-18000,,
com.tableausoftware.tableaudesktop,170,1752099995,1752100165,1752100165.4361339,-18000,,
com.google.Chrome,3,1752099992,1752099995,1752099995.445926,-18000,,
com.tableausoftware.tableaudesktop,15,1752099977,1752099992,1752099992.314548,-18000,,
com.tableausoftware.tableaudesktop,158,1752099819,1752099977,1752099977.057125,-18000,,
com.tableausoftware.tableaudesktop,2,1752099817,1752099819,1752099819.706924,-18000,,
com.tableausoftware.tableaudesktop,2,1752099815,1752099817,1752099817.302645,-18000,,
com.tableausoftware.tableaudesktop,145,1752099670,1752099815,1752099815.9678411,-18000,,
com.tableausoftware.tableaudesktop,204,1752099466,1752099670,1752099670.184198,-18000,,
com.tableausoftware.tableaudesktop,3,1752099463,1752099466,1752099466.2856522,-18000,,
com.tableausoftware.tableaudesktop,1,1752099462,1752099463,1752099463.803726,-18000,,
com.tableausoftware.tableaudesktop,42,1752099420,1752099462,1752099462.348279,-18000,,
com.leomehlig.today,7,1752099413,1752099420,1752099420.116932,-18000,,
com.tableausoftware.tableaudesktop,19,1752099394,1752099413,1752099413.0877628,-18000,,
com.tableausoftware.tableaudesktop,74,1752099320,1752099394,1752099394.455323,-18000,,
com.google.Chrome,20,1752099300,1752099320,1752099320.973382,-18000,,
com.tableausoftware.tableaudesktop,3,1752099297,1752099300,1752099300.964909,-18000,,
com.tableausoftware.tableaudesktop,5,1752099292,1752099297,1752099297.308332,-18000,,
com.google.Chrome,2,1752099290,1752099292,1752099292.979436,-18000,,
com.tableausoftware.tableaudesktop,3,1752099287,1752099290,1752099290.422631,-18000,,
com.tableausoftware.tableaudesktop,3,1752099284,1752099287,1752099287.9555922,-18000,,
com.tableausoftware.tableaudesktop,1,1752099283,1752099284,1752099284.966188,-18000,,
com.tableausoftware.tableaudesktop,144,1752099139,1752099283,1752099283.030573,-18000,,
com.tableausoftware.tableaudesktop,3,1752099084,1752099087,1752099087.1643162,-18000,,
com.tableausoftware.tableaudesktop,2,1752099082,1752099084,1752099084.925792,-18000,,
com.tableausoftware.tableaudesktop,6,1752099076,1752099082,1752099082.87393,-18000,,
com.google.Chrome,57,1752099019,1752099076,1752099076.283637,-18000,,
com.tableausoftware.tableaudesktop,175,1752098844,1752099019,1752099019.5394568,-18000,,
com.tableausoftware.tableaudesktop,6,1752098838,1752098844,1752098844.249249,-18000,,
com.google.Chrome,17,1752098821,1752098838,1752098838.93192,-18000,,
com.tableausoftware.tableaudesktop,32,1752098789,1752098821,1752098821.250006,-18000,,
com.google.Chrome,13,1752098776,1752098789,1752098789.4376369,-18000,,
com.tableausoftware.tableaudesktop,60,1752098716,1752098776,1752098776.359669,-18000,,
com.tableausoftware.tableaudesktop,143,1752098573,1752098716,1752098716.383681,-18000,,
com.tableausoftware.tableaudesktop,191,1752098382,1752098573,1752098573.101279,-18000,,
com.tableausoftware.tableaudesktop,174,1752098208,1752098382,1752098382.742494,-18000,,
com.tableausoftware.tableaudesktop,6,1752098202,1752098208,1752098208.314969,-18000,,
com.google.Chrome,124,1752098078,1752098202,1752098202.658783,-18000,,
com.tableausoftware.tableaudesktop,226,1752097852,1752098078,1752098078.079074,-18000,,
com.tableausoftware.tableaudesktop,136,1752097716,1752097852,1752097852.317389,-18000,,
com.tableausoftware.tableaudesktop,114,1752097602,1752097716,1752097716.734725,-18000,,
com.tableausoftware.tableaudesktop,227,1752097375,1752097602,1752097602.665935,-18000,,
com.tableausoftware.tableaudesktop,80,1752097295,1752097375,1752097375.628735,-18000,,
com.tableausoftware.tableaudesktop,3,1752097292,1752097295,1752097295.110042,-18000,,
com.tableausoftware.tableaudesktop,0,1752097292,1752097292,1752097292.388762,-18000,,
com.tableausoftware.tableaudesktop,9,1752097283,1752097292,1752097292.0789862,-18000,,
com.google.Chrome,94,1752097189,1752097283,1752097283.834676,-18000,,
com.tableausoftware.tableaudesktop,177,1752097012,1752097189,1752097189.429296,-18000,,
com.tableausoftware.tableaudesktop,125,1752096887,1752097012,1752097012.030768,-18000,,
com.tableausoftware.tableaudesktop,87,1752096800,1752096887,1752096887.365367,-18000,,
com.tableausoftware.tableaudesktop,3,1752096797,1752096800,1752096800.0429711,-18000,,
com.tableausoftware.tableaudesktop,1,1752096796,1752096797,1752096797.9644608,-18000,,
com.tableausoftware.tableaudesktop,146,1752096650,1752096796,1752096796.750207,-18000,,
com.tableausoftware.tableaudesktop,3,1752096647,1752096650,1752096650.153265,-18000,,
com.tableausoftware.tableaudesktop,2,1752096645,1752096647,1752096647.696031,-18000,,
com.tableausoftware.tableaudesktop,175,1752096470,1752096645,1752096645.206455,-18000,,
com.tableausoftware.tableaudesktop,3,1752096467,1752096470,1752096470.918696,-18000,,
com.tableausoftware.tableaudesktop,0,1752096467,1752096467,1752096467.4467611,-18000,,
com.tableausoftware.tableaudesktop,110,1752096357,1752096467,1752096467.397204,-18000,,
com.google.Chrome,6,1752096351,1752096357,1752096357.770125,-18000,,
com.tableausoftware.tableaudesktop,2,1752096349,1752096351,1752096351.552264,-18000,,
com.tableausoftware.tableaudesktop,2,1752096347,1752096349,1752096349.9470701,-18000,,
com.tableausoftware.tableaudesktop,3,1752096344,1752096347,1752096347.769347,-18000,,
com.tableausoftware.tableaudesktop,10,1752096334,1752096344,1752096344.462431,-18000,,
com.google.Chrome,128,1752096206,1752096334,1752096334.041897,-18000,,
com.tableausoftware.tableaudesktop,41,1752096165,1752096206,1752096206.601197,-18000,,
com.google.Chrome,3,1752096162,1752096165,1752096165.464937,-18000,,
com.tableausoftware.tableaudesktop,81,1752096081,1752096162,1752096162.6370249,-18000,,
com.tableausoftware.tableaudesktop,7,1752096074,1752096081,1752096081.167365,-18000,,
com.google.Chrome,7,1752096067,1752096074,1752096074.132536,-18000,,
com.tableausoftware.tableaudesktop,123,1752095944,1752096067,1752096067.460438,-18000,,
com.tableausoftware.tableaudesktop,141,1752095803,1752095944,1752095945.008528,-18000,,
com.tableausoftware.tableaudesktop,204,1752095599,1752095803,1752095803.9139419,-18000,,
com.google.Chrome,0,1752095599,1752095599,1752095599.676065,-18000,,
com.tableausoftware.tableaudesktop,22,1752095577,1752095599,1752095599.1926389,-18000,,
com.tableausoftware.tableaudesktop,180,1752095397,1752095577,1752095577.706835,-18000,,
com.tableausoftware.tableaudesktop,99,1752095298,1752095397,1752095397.85038,-18000,,
com.tableausoftware.tableaudesktop,151,1752095147,1752095298,1752095298.861304,-18000,,
com.google.Chrome,41,1752095106,1752095147,1752095147.929929,-18000,,
com.tableausoftware.tableaudesktop,35,1752095071,1752095106,1752095106.705936,-18000,,
com.tableausoftware.tableaudesktop,2,1752095069,1752095071,1752095071.9058042,-18000,,
com.tableausoftware.tableaudesktop,1,1752095068,1752095069,1752095069.519947,-18000,,
com.tableausoftware.tableaudesktop,75,1752094993,1752095068,1752095068.511363,-18000,,
com.google.Chrome,40,1752094953,1752094993,1752094993.9341168,-18000,,
com.tableausoftware.tableaudesktop,25,1752094928,1752094953,1752094953.942532,-18000,,
com.google.Chrome,3,1752094925,1752094928,1752094928.476056,-18000,,
com.tableausoftware.tableaudesktop,14,1752094911,1752094925,1752094925.837254,-18000,,
com.apple.finder,19,1752094892,1752094911,1752094911.6263099,-18000,,
com.google.Chrome,59,1752094833,1752094892,1752094892.6439362,-18000,,
us.zoom.xos,1,1752094832,1752094833,1752094833.4667869,-18000,,
com.google.Chrome,3,1752094829,1752094832,1752094832.63596,-18000,,
com.apple.Photos,4,1752094825,1752094829,1752094829.708056,-18000,,
com.google.Chrome,3,1752094822,1752094825,1752094825.911509,-18000,,
us.zoom.xos,2,1752094820,1752094822,1752094822.309747,-18000,,
com.leomehlig.today,1,1752094819,1752094820,1752094820.7042341,-18000,,
com.google.Chrome,8,1752094811,1752094819,1752094820.0152578,-18000,,
com.google.Chrome,482,1752094048,1752094530,1752094530.595673,-18000,,
com.leomehlig.today,2,1752094046,1752094048,1752094049.050735,-18000,,
com.leomehlig.today,301,1752092932,1752093233,1752093233.5080462,-18000,,
com.google.Chrome,259,1752092673,1752092932,1752092932.219845,-18000,,
com.leomehlig.today,72,1752092601,1752092673,1752092673.541338,-18000,,
com.google.Chrome,6,1752092595,1752092601,1752092601.3336349,-18000,,
com.apple.iCal,3,1752092592,1752092595,1752092595.632545,-18000,,
com.google.Chrome,4,1752092588,1752092592,1752092592.969761,-18000,,
com.microsoft.Outlook,54,1752092534,1752092588,1752092588.357739,-18000,,
com.google.Chrome,6,1752092528,1752092534,1752092534.668666,-18000,,
com.microsoft.Outlook,269,1752092259,1752092528,1752092528.215053,-18000,,
com.google.Chrome,54,1752092205,1752092259,1752092259.1462479,-18000,,
com.microsoft.Outlook,2,1752092203,1752092205,1752092205.22526,-18000,,
com.google.Chrome,12,1752092191,1752092203,1752092203.345017,-18000,,
com.apple.Notes,72,1752092109,1752092181,1752092181.267959,-18000,,
com.google.Chrome,6,1752092103,1752092109,1752092109.7250872,-18000,,
us.zoom.xos,21,1752092082,1752092103,1752092103.73525,-18000,,
com.google.Chrome,46,1752092036,1752092082,1752092082.753564,-18000,,
com.apple.iCal,30,1752092006,1752092036,1752092036.158344,-18000,,
com.google.Chrome,4,1752092002,1752092006,1752092006.104584,-18000,,
com.apple.iCal,59,1752091943,1752092002,1752092002.519103,-18000,,
com.google.Chrome,357,1752091586,1752091943,1752091943.686911,-18000,,
com.apple.Notes,11,1752091575,1752091586,1752091586.356375,-18000,,
com.google.Chrome,7,1752091568,1752091575,1752091575.2193441,-18000,,
com.apple.Notes,8,1752091560,1752091568,1752091569.03973,-18000,,
com.google.Chrome,10,1752091550,1752091560,1752091560.827996,-18000,,
com.apple.Notes,12,1752091538,1752091550,1752091550.6860862,-18000,,
com.google.Chrome,28,1752091510,1752091538,1752091539.1126928,-18000,,
us.zoom.xos,2,1752091508,1752091510,1752091510.210341,-18000,,
com.google.Chrome,209,1752091299,1752091508,1752091508.811191,-18000,,
us.zoom.xos,5,1752091294,1752091299,1752091299.193856,-18000,,
com.google.Chrome,35,1752091259,1752091294,1752091294.688047,-18000,,
us.zoom.xos,132,1752091127,1752091259,1752091259.408104,-18000,,
com.apple.Notes,3,1752091124,1752091127,1752091127.757053,-18000,,
us.zoom.xos,2,1752091122,1752091124,1752091125.011862,-18000,,
com.leomehlig.today,4,1752091118,1752091122,1752091122.901905,-18000,,
us.zoom.xos,21,1752091097,1752091118,1752091118.3391662,-18000,,
com.google.Chrome,1,1752091096,1752091097,1752091098.058,-18000,,
us.zoom.xos,1,1752091095,1752091096,1752091096.1626248,-18000,,
com.google.Chrome,106,1752090989,1752091095,1752091095.4944968,-18000,,
com.apple.finder,4,1752090985,1752090989,1752090989.591775,-18000,,
com.google.Chrome,234,1752090751,1752090985,1752090985.898812,-18000,,
com.apple.Notes,12,1752090739,1752090751,1752090752.0487761,-18000,,
com.google.Chrome,2,1752090737,1752090739,1752090739.075798,-18000,,
com.apple.Notes,5,1752090732,1752090737,1752090737.1519608,-18000,,
com.google.Chrome,3,1752090729,1752090732,1752090732.515232,-18000,,
com.apple.Notes,11,1752090718,1752090729,1752090729.348341,-18000,,
com.google.Chrome,5,1752090713,1752090718,1752090718.477186,-18000,,
com.apple.Notes,10,1752090703,1752090713,1752090713.386697,-18000,,
com.google.Chrome,1516,1752089187,1752090703,1752090703.1085382,-18000,,
com.google.Chrome,1572,1752087545,1752089117,1752089117.641654,-18000,,
com.apple.finder,12,1752087533,1752087545,1752087545.936732,-18000,,
com.google.Chrome,1355,1752086178,1752087533,1752087533.755563,-18000,,
com.apple.Music,1,1752086177,1752086178,1752086178.287016,-18000,,
com.google.Chrome,243,1752085934,1752086177,1752086177.421639,-18000,,
com.apple.Music,76,1752085858,1752085934,1752085934.482153,-18000,,
com.google.Chrome,232,1752085626,1752085858,1752085859.008467,-18000,,
com.apple.Notes,3,1752085623,1752085626,1752085626.137107,-18000,,
com.google.Chrome,47,1752085576,1752085623,1752085623.762562,-18000,,
com.apple.Notes,12,1752085564,1752085576,1752085576.52671,-18000,,
com.google.Chrome,77,1752085487,1752085564,1752085564.1279402,-18000,,
com.apple.Preview,5,1752085482,1752085487,1752085487.405888,-18000,,
com.apple.finder,13,1752085469,1752085482,1752085482.279128,-18000,,
com.google.Chrome,1328,1752084141,1752085469,1752085469.846694,-18000,,
com.apple.Music,100,1752084041,1752084141,1752084141.9643831,-18000,,
com.apple.finder,6,1752084035,1752084041,1752084041.0692139,-18000,,
com.leomehlig.today,48,1752083987,1752084035,1752084035.378777,-18000,,
com.apple.finder,3,1752083984,1752083987,1752083987.2364259,-18000,,
com.apple.finder,1,1752075721,1752075722,1752075722.8749552,-18000,,
com.apple.iCal,0,1752075721,1752075721,1752075721.88833,-18000,,
com.google.Chrome,34,1752075687,1752075721,1752075721.055979,-18000,,
com.apple.iCal,14,1752075673,1752075687,1752075687.681113,-18000,,
com.google.Chrome,880,1752074793,1752075673,1752075673.382932,-18000,,
com.google.Chrome,66,1752025276,1752025342,1752025342.852388,-18000,,
com.google.Chrome,876,1752023652,1752024528,1752024528.43617,-18000,,
com.google.Chrome,310,1752022984,1752023294,1752023294.213599,-18000,,
com.google.Chrome,300,1752022555,1752022855,1752022855.63905,-18000,,
com.google.Chrome,567,1752021751,1752022318,1752022319.013081,-18000,,
com.apple.finder,1,1752021750,1752021751,1752021751.482703,-18000,,
com.leomehlig.today,1,1752021749,1752021750,1752021750.258624,-18000,,
com.google.Chrome,751,1752020998,1752021749,1752021749.584835,-18000,,
com.leomehlig.today,38,1752020960,1752020998,1752020998.290883,-18000,,
com.apple.finder,1,1752020959,1752020960,1752020960.676084,-18000,,
com.apple.Passwords,1,1752020958,1752020959,1752020959.421836,-18000,,
com.apple.finder,0,1752020958,1752020958,1752020958.670621,-18000,,
com.tableausoftware.tableaudesktop,2,1752020956,1752020958,1752020958.502355,-18000,,
com.apple.finder,3,1752020953,1752020956,1752020956.3676481,-18000,,
com.tableausoftware.tableaudesktop,139,1752020814,1752020953,1752020953.830686,-18000,,
com.tableausoftware.tableaudesktop,3,1752020811,1752020814,1752020814.179796,-18000,,
com.apple.finder,2,1752020809,1752020811,1752020811.3034549,-18000,,
com.tableausoftware.tableaudesktop,221,1752020588,1752020809,1752020809.7827191,-18000,,
com.tableausoftware.tableaudesktop,3,1752020585,1752020588,1752020588.873857,-18000,,
com.apple.finder,1,1752020584,1752020585,1752020585.985259,-18000,,
com.tableausoftware.tableaudesktop,32,1752020552,1752020584,1752020584.7637439,-18000,,
com.google.Chrome,4,1752020548,1752020552,1752020552.5649571,-18000,,
com.tableausoftware.tableaudesktop,43,1752020505,1752020548,1752020548.845876,-18000,,
com.google.Chrome,16,1752020489,1752020505,1752020505.2124162,-18000,,
com.google.Chrome,305,1752019805,1752020110,1752020110.880176,-18000,,
com.tableausoftware.tableaudesktop,30,1752019775,1752019805,1752019805.817857,-18000,,
com.tableausoftware.tableaudesktop,3,1752019772,1752019775,1752019775.742003,-18000,,
com.apple.finder,1,1752019771,1752019772,1752019772.8075628,-18000,,
com.tableausoftware.tableaudesktop,97,1752019674,1752019771,1752019771.416951,-18000,,
com.google.Chrome,83,1752019591,1752019674,1752019674.128577,-18000,,
com.tableausoftware.tableaudesktop,32,1752019559,1752019591,1752019591.107592,-18000,,
com.tableausoftware.tableaudesktop,3,1752019556,1752019559,1752019559.90084,-18000,,
com.apple.finder,1,1752019555,1752019556,1752019557.0409489,-18000,,
com.google.Chrome,4,1752019551,1752019555,1752019555.771003,-18000,,
com.tableausoftware.tableaudesktop,111,1752019440,1752019551,1752019551.931545,-18000,,
com.google.Chrome,54,1752019386,1752019440,1752019440.904903,-18000,,
com.tableausoftware.tableaudesktop,5,1752019381,1752019386,1752019386.743617,-18000,,
com.tableausoftware.tableaudesktop,3,1752019378,1752019381,1752019381.682817,-18000,,
com.apple.finder,0,1752019378,1752019378,1752019378.849721,-18000,,
com.google.Chrome,1,1752019377,1752019378,1752019378.500976,-18000,,
com.tableausoftware.tableaudesktop,3,1752019374,1752019377,1752019377.896051,-18000,,
com.google.Chrome,2,1752019372,1752019374,1752019374.851375,-18000,,
com.tableausoftware.tableaudesktop,122,1752019250,1752019372,1752019372.360384,-18000,,
com.tableausoftware.tableaudesktop,3,1752019247,1752019250,1752019250.071463,-18000,,
com.apple.finder,1,1752019246,1752019247,1752019247.16997,-18000,,
com.tableausoftware.tableaudesktop,107,1752019139,1752019246,1752019246.019866,-18000,,
com.tableausoftware.tableaudesktop,3,1752019136,1752019139,1752019139.1315598,-18000,,
com.apple.finder,1,1752019135,1752019136,1752019136.2558389,-18000,,
com.tableausoftware.tableaudesktop,120,1752019015,1752019135,1752019135.3470411,-18000,,
com.tableausoftware.tableaudesktop,3,1752019012,1752019015,1752019015.7450051,-18000,,
com.apple.finder,5,1752019007,1752019012,1752019012.876789,-18000,,
com.tableausoftware.tableaudesktop,4,1752019003,1752019007,1752019007.68333,-18000,,
com.google.Chrome,209,1752018794,1752019003,1752019003.8676891,-18000,,
com.tableausoftware.tableaudesktop,293,1752018501,1752018794,1752018794.051048,-18000,,
com.tableausoftware.tableaudesktop,3,1752018498,1752018501,1752018501.4436069,-18000,,
com.apple.finder,1,1752018497,1752018498,1752018498.5146341,-18000,,
com.tableausoftware.tableaudesktop,225,1752018272,1752018497,1752018497.886831,-18000,,
com.tableausoftware.tableaudesktop,3,1752018269,1752018272,1752018272.0851579,-18000,,
com.apple.finder,1,1752018268,1752018269,1752018269.1725411,-18000,,
com.tableausoftware.tableaudesktop,130,1752018138,1752018268,1752018268.814828,-18000,,
com.tableausoftware.tableaudesktop,3,1752018135,1752018138,1752018138.160368,-18000,,
com.apple.finder,1,1752018134,1752018135,1752018135.3052611,-18000,,
com.google.Chrome,0,1752018134,1752018134,1752018134.547564,-18000,,
com.tableausoftware.tableaudesktop,17,1752018117,1752018134,1752018134.469512,-18000,,
com.google.Chrome,13,1752018104,1752018117,1752018117.073164,-18000,,
com.tableausoftware.tableaudesktop,3,1752018101,1752018104,1752018104.247507,-18000,,
com.google.Chrome,175,1752017926,1752018101,1752018101.380647,-18000,,
com.tableausoftware.tableaudesktop,157,1752017703,1752017860,1752017860.574144,-18000,,
com.tableausoftware.tableaudesktop,3,1752017700,1752017703,1752017703.098639,-18000,,
com.apple.finder,1,1752017699,1752017700,1752017700.246167,-18000,,
com.tableausoftware.tableaudesktop,134,1752017565,1752017699,1752017699.296092,-18000,,
com.google.Chrome,18,1752017547,1752017565,1752017565.761589,-18000,,
com.tableausoftware.tableaudesktop,48,1752017499,1752017547,1752017547.77695,-18000,,
com.google.Chrome,3,1752017496,1752017499,1752017499.4059448,-18000,,
com.tableausoftware.tableaudesktop,29,1752017467,1752017496,1752017496.578378,-18000,,
com.tableausoftware.tableaudesktop,3,1752017464,1752017467,1752017467.277631,-18000,,
com.apple.finder,1,1752017463,1752017464,1752017464.469197,-18000,,
com.tableausoftware.tableaudesktop,6,1752017457,1752017463,1752017463.7589211,-18000,,
com.google.Chrome,31,1752017426,1752017457,1752017457.761798,-18000,,
com.tableausoftware.tableaudesktop,156,1752017270,1752017426,1752017426.997647,-18000,,
com.tableausoftware.tableaudesktop,3,1752017267,1752017270,1752017270.869982,-18000,,
com.apple.finder,0,1752017267,1752017267,1752017267.921657,-18000,,
com.google.Chrome,0,1752017267,1752017267,1752017267.674127,-18000,,
com.tableausoftware.tableaudesktop,201,1752017066,1752017267,1752017267.5211449,-18000,,
com.google.Chrome,49,1752017017,1752017066,1752017066.3918009,-18000,,
com.tableausoftware.tableaudesktop,8,1752017009,1752017017,1752017017.677629,-18000,,
com.tableausoftware.tableaudesktop,3,1752017006,1752017009,1752017009.700906,-18000,,
com.apple.finder,16,1752016990,1752017006,1752017006.885328,-18000,,
com.tableausoftware.tableaudesktop,16,1752016974,1752016990,1752016990.353273,-18000,,
com.google.Chrome,7,1752016967,1752016974,1752016974.572249,-18000,,
com.leomehlig.today,0,1752016967,1752016967,1752016967.905782,-18000,,
com.google.Chrome,48,1752016919,1752016967,1752016967.2249079,-18000,,
com.leomehlig.today,2,1752016917,1752016919,1752016919.657413,-18000,,
com.apple.finder,6,1752016911,1752016917,1752016917.164218,-18000,,
com.apple.finder,319,1752013659,1752013978,1752013978.568636,-18000,,
com.leomehlig.today,26,1752013633,1752013659,1752013659.0697079,-18000,,
com.apple.finder,2,1752013631,1752013633,1752013633.4424539,-18000,,
com.apple.Music,1,1752013630,1752013631,1752013631.221039,-18000,,
com.apple.finder,2,1752013628,1752013630,1752013630.083428,-18000,,
com.apple.Notes,4,1752013624,1752013628,1752013628.528461,-18000,,
com.google.Chrome,5,1752013619,1752013624,1752013624.475574,-18000,,
com.microsoft.VSCode,15,1752013604,1752013619,1752013619.92208,-18000,,
com.google.Chrome,110,1752013494,1752013604,1752013604.688792,-18000,,
com.apple.finder,6,1752013488,1752013494,1752013494.484945,-18000,,
com.google.Chrome,16,1752013472,1752013488,1752013488.841923,-18000,,
com.microsoft.VSCode,19,1752013453,1752013472,1752013472.135756,-18000,,
com.google.Chrome,123,1752013330,1752013453,1752013453.534745,-18000,,
com.apple.finder,19,1752013311,1752013330,1752013330.36377,-18000,,
com.microsoft.VSCode,4,1752013307,1752013311,1752013311.2658548,-18000,,
com.google.Chrome,8,1752013299,1752013307,1752013307.396593,-18000,,
com.apple.finder,26,1752013273,1752013299,1752013299.499444,-18000,,
com.apple.Preview,7,1752013266,1752013273,1752013273.653839,-18000,,
com.apple.finder,4,1752013262,1752013266,1752013266.778429,-18000,,
com.apple.Preview,9,1752013253,1752013262,1752013262.3573499,-18000,,
com.apple.finder,2,1752013251,1752013253,1752013253.6582742,-18000,,
com.apple.Passwords,5,1752013246,1752013251,1752013251.538234,-18000,,
com.apple.Preview,21,1752013225,1752013246,1752013246.078685,-18000,,
com.apple.Passwords,9,1752013216,1752013225,1752013225.481231,-18000,,
com.apple.Preview,1,1752013215,1752013216,1752013216.527144,-18000,,
com.apple.Passwords,13,1752013202,1752013215,1752013215.1646,-18000,,
com.apple.Preview,19,1752013183,1752013202,1752013202.922686,-18000,,
com.apple.finder,17,1752013166,1752013183,1752013183.3379831,-18000,,
com.apple.Preview,9,1752013157,1752013166,1752013166.583391,-18000,,
com.apple.finder,31,1752013126,1752013157,1752013157.9931989,-18000,,
com.microsoft.VSCode,11,1752013115,1752013126,1752013126.477289,-18000,,
com.microsoft.VSCode,311,1752012776,1752013087,1752013087.348839,-18000,,
com.microsoft.VSCode,312,1752012189,1752012501,1752012501.0395489,-18000,,
com.google.Chrome,32,1752012157,1752012189,1752012189.8573189,-18000,,
com.apple.Notes,19,1752012119,1752012138,1752012138.124167,-18000,,
com.google.Chrome,13,1752012106,1752012119,1752012119.792403,-18000,,
com.microsoft.VSCode,51,1752012055,1752012106,1752012106.247151,-18000,,
com.apple.finder,14,1752012041,1752012055,1752012055.842222,-18000,,
com.apple.Music,25,1752012016,1752012041,1752012041.529457,-18000,,
com.google.Chrome,32,1752011984,1752012016,1752012016.080415,-18000,,
com.apple.Music,63,1752011921,1752011984,1752011984.958492,-18000,,
com.google.Chrome,89,1752011832,1752011921,1752011921.590761,-18000,,
com.apple.finder,26,1752011806,1752011832,1752011832.34564,-18000,,
com.google.Chrome,715,1752011091,1752011806,1752011806.502012,-18000,,
com.microsoft.VSCode,15,1752011076,1752011091,1752011091.50876,-18000,,
com.apple.finder,18,1752011058,1752011076,1752011076.525851,-18000,,
com.microsoft.VSCode,41,1752011017,1752011058,1752011058.537755,-18000,,
com.apple.finder,131,1752010886,1752011017,1752011017.402694,-18000,,
com.microsoft.VSCode,56,1752010830,1752010886,1752010886.397464,-18000,,
com.apple.finder,23,1752010807,1752010830,1752010830.356835,-18000,,
com.microsoft.VSCode,50,1752010757,1752010807,1752010807.115155,-18000,,
com.apple.Music,82,1752010675,1752010757,1752010757.4110131,-18000,,
com.microsoft.VSCode,0,1752010675,1752010675,1752010675.619133,-18000,,
com.google.Chrome,3,1752010672,1752010675,1752010675.18931,-18000,,
com.microsoft.VSCode,705,1752009967,1752010672,1752010672.791325,-18000,,
com.google.Chrome,4,1752009963,1752009967,1752009968.027547,-18000,,
com.microsoft.VSCode,9,1752009954,1752009963,1752009963.7954001,-18000,,
com.google.Chrome,5,1752009949,1752009954,1752009954.852612,-18000,,
com.microsoft.VSCode,528,1752009421,1752009949,1752009949.252815,-18000,,
com.leomehlig.today,3,1752009418,1752009421,1752009421.5549998,-18000,,
com.microsoft.VSCode,434,1752008984,1752009418,1752009418.40464,-18000,,
com.google.Chrome,1,1752008983,1752008984,1752008984.070189,-18000,,
com.microsoft.VSCode,983,1752008000,1752008983,1752008983.602284,-18000,,
com.google.Chrome,4,1752007996,1752008000,1752008000.5057359,-18000,,
com.microsoft.VSCode,21,1752007975,1752007996,1752007996.9276881,-18000,,
com.apple.finder,20,1752007955,1752007975,1752007975.879932,-18000,,
com.google.Chrome,10,1752007945,1752007955,1752007955.8386788,-18000,,
com.microsoft.VSCode,5,1752007940,1752007945,1752007945.227528,-18000,,
com.apple.finder,1,1752007939,1752007940,1752007940.892051,-18000,,
com.apple.Notes,3,1752007936,1752007939,1752007939.215802,-18000,,
com.apple.finder,7,1752007929,1752007936,1752007936.880518,-18000,,
com.google.Chrome,2,1752007927,1752007929,1752007929.380384,-18000,,
com.apple.Music,32,1752007895,1752007927,1752007927.732304,-18000,,
com.google.Chrome,24,1752007871,1752007895,1752007895.154605,-18000,,
com.electron.carta,3,1752007868,1752007871,1752007871.8221989,-18000,,
com.google.Chrome,12,1752007856,1752007868,1752007868.50206,-18000,,
com.electron.carta,202,1752007654,1752007856,1752007856.1724129,-18000,,
com.google.Chrome,2,1752007652,1752007654,1752007654.615069,-18000,,
com.electron.carta,2,1752007650,1752007652,1752007652.806126,-18000,,
com.jinzhenyu.ruler,1,1752007649,1752007650,1752007650.047365,-18000,,
com.electron.carta,38,1752007611,1752007649,1752007649.6503239,-18000,,
com.google.Chrome,63,1752007548,1752007611,1752007611.359467,-18000,,
com.electron.carta,35,1752007513,1752007548,1752007548.456987,-18000,,
com.google.Chrome,111,1752007402,1752007513,1752007513.6021051,-18000,,
com.electron.carta,68,1752007334,1752007402,1752007402.977817,-18000,,
com.jinzhenyu.ruler,2,1752007332,1752007334,1752007334.125301,-18000,,
com.electron.carta,5,1752007327,1752007332,1752007333.0013971,-18000,,
com.google.Chrome,15,1752007312,1752007327,1752007327.351369,-18000,,
com.apple.finder,11,1752007301,1752007312,1752007312.337994,-18000,,
com.electron.carta,26,1752007275,1752007301,1752007301.60327,-18000,,
com.jinzhenyu.ruler,2,1752007273,1752007275,1752007275.803811,-18000,,
com.electron.carta,12,1752007261,1752007273,1752007273.533599,-18000,,
com.jinzhenyu.ruler,1,1752007260,1752007261,1752007261.60142,-18000,,
com.electron.carta,6,1752007254,1752007260,1752007260.6864948,-18000,,
com.google.Chrome,23,1752007231,1752007254,1752007254.4031281,-18000,,
com.apple.finder,2,1752007229,1752007231,1752007231.565279,-18000,,
com.google.Chrome,138,1752007091,1752007229,1752007229.237915,-18000,,
com.apple.finder,298,1752006793,1752007091,1752007091.652395,-18000,,
com.google.Chrome,38,1752006755,1752006793,1752006793.761522,-18000,,
com.jinzhenyu.ruler,45,1752006710,1752006755,1752006755.3925838,-18000,,
com.electron.carta,2,1752006708,1752006710,1752006710.724555,-18000,,
com.jinzhenyu.ruler,8,1752006700,1752006708,1752006708.549844,-18000,,
com.electron.carta,2,1752006698,1752006700,1752006700.7351341,-18000,,
com.jinzhenyu.ruler,2,1752006696,1752006698,1752006698.778751,-18000,,
com.electron.carta,4,1752006692,1752006696,1752006696.645411,-18000,,
com.google.Chrome,2,1752006690,1752006692,1752006692.9820108,-18000,,
com.jinzhenyu.ruler,3,1752006687,1752006690,1752006690.9076529,-18000,,
com.google.Chrome,6,1752006681,1752006687,1752006687.624603,-18000,,
com.jinzhenyu.ruler,1,1752006680,1752006681,1752006681.60953,-18000,,
com.google.Chrome,2,1752006678,1752006680,1752006680.3773432,-18000,,
com.jinzhenyu.ruler,3,1752006675,1752006678,1752006678.32591,-18000,,
com.electron.carta,0,1752006675,1752006675,1752006675.645234,-18000,,
com.jinzhenyu.ruler,3,1752006672,1752006675,1752006675.060771,-18000,,
com.google.Chrome,34,1752006638,1752006672,1752006672.21977,-18000,,
com.apple.finder,9,1752006629,1752006638,1752006638.202824,-18000,,
com.google.Chrome,54,1752006575,1752006629,1752006629.129497,-18000,,
com.electron.carta,70,1752006505,1752006575,1752006575.5515609,-18000,,
com.google.Chrome,1,1752006504,1752006505,1752006505.066344,-18000,,
com.apple.finder,2,1752006502,1752006504,1752006504.1189508,-18000,,
com.google.Chrome,10,1752006492,1752006502,1752006502.813046,-18000,,
com.electron.carta,47,1752006445,1752006492,1752006492.309377,-18000,,
com.apple.finder,18,1752006427,1752006445,1752006445.7385712,-18000,,
com.electron.carta,82,1752006345,1752006427,1752006427.667772,-18000,,
com.google.Chrome,3,1752006334,1752006337,1752006337.872066,-18000,,
com.electron.carta,6,1752006328,1752006334,1752006334.5610151,-18000,,
com.google.Chrome,5,1752006323,1752006328,1752006329.0145822,-18000,,
com.microsoft.VSCode,4,1752006319,1752006323,1752006323.144433,-18000,,
com.google.Chrome,16,1752006303,1752006319,1752006319.7667131,-18000,,
com.microsoft.VSCode,37,1752006266,1752006303,1752006303.5991569,-18000,,
com.apple.Notes,7,1752006259,1752006266,1752006267.024168,-18000,,
com.microsoft.VSCode,6,1752006253,1752006259,1752006259.650316,-18000,,
com.google.Chrome,14,1752006239,1752006253,1752006253.694837,-18000,,
com.apple.Music,5,1752006234,1752006239,1752006239.628221,-18000,,
com.google.Chrome,233,1752006001,1752006234,1752006234.93682,-18000,,
com.electron.carta,20,1752005981,1752006001,1752006001.422806,-18000,,
com.google.Chrome,2,1752005979,1752005981,1752005981.138167,-18000,,
com.electron.carta,41,1752005938,1752005979,1752005979.314784,-18000,,
com.google.Chrome,6,1752005932,1752005938,1752005939.005374,-18000,,
com.electron.carta,61,1752005871,1752005932,1752005932.4462562,-18000,,
com.google.Chrome,65,1752005806,1752005871,1752005871.450976,-18000,,
com.electron.carta,99,1752005707,1752005806,1752005806.146253,-18000,,
com.google.Chrome,6,1752005701,1752005707,1752005707.102628,-18000,,
com.electron.carta,101,1752005600,1752005701,1752005701.535449,-18000,,
com.google.Chrome,8,1752005592,1752005600,1752005600.3161302,-18000,,
com.electron.carta,63,1752005529,1752005592,1752005592.9392009,-18000,,
com.apple.finder,8,1752005521,1752005529,1752005529.062982,-18000,,
com.electron.carta,52,1752005469,1752005521,1752005521.44167,-18000,,
com.google.Chrome,38,1752005431,1752005469,1752005469.5480409,-18000,,
com.apple.finder,22,1752005409,1752005431,1752005431.867527,-18000,,
com.electron.carta,96,1752005313,1752005409,1752005409.1557112,-18000,,
com.google.Chrome,8,1752005305,1752005313,1752005313.6807709,-18000,,
com.electron.carta,27,1752005278,1752005305,1752005305.120387,-18000,,
com.google.Chrome,6,1752005272,1752005278,1752005278.69424,-18000,,
com.apple.finder,3,1752005269,1752005272,1752005272.4096189,-18000,,
com.apple.Music,59,1752005210,1752005269,1752005269.9840379,-18000,,
com.apple.finder,2,1752005208,1752005210,1752005210.226371,-18000,,
com.leomehlig.today,2,1752005206,1752005208,1752005208.286823,-18000,,
com.google.Chrome,718,1752004488,1752005206,1752005206.629071,-18000,,
com.leomehlig.today,77,1752004411,1752004488,1752004488.1922932,-18000,,
com.google.Chrome,77,1752004334,1752004411,1752004411.570507,-18000,,
com.apple.finder,14,1752004320,1752004334,1752004335.0056329,-18000,,
com.apple.finder,2,1751988850,1751988852,1751988852.1931748,-18000,,
com.apple.systempreferences,9,1751988841,1751988850,1751988850.684983,-18000,,
com.google.Chrome,824,1751988011,1751988835,1751988835.282115,-18000,,
com.google.Chrome,3,1751943719,1751943722,1751943722.413373,-18000,,
com.apple.MobileSMS,1,1751943718,1751943719,1751943719.636338,-18000,,
com.google.Chrome,3064,1751940654,1751943718,1751943718.589655,-18000,,
com.apple.MobileSMS,2,1751940652,1751940654,1751940654.5312781,-18000,,
com.google.Chrome,24,1751940628,1751940652,1751940652.344469,-18000,,
com.apple.MobileSMS,27,1751940601,1751940628,1751940628.147361,-18000,,
com.google.Chrome,90,1751940511,1751940601,1751940601.7574492,-18000,,
com.apple.MobileSMS,17,1751940494,1751940511,1751940511.983916,-18000,,
com.google.Chrome,25,1751940469,1751940494,1751940494.056817,-18000,,
com.google.Chrome,477,1751939859,1751940336,1751940336.670312,-18000,,
com.google.Chrome,528,1751939248,1751939776,1751939776.79878,-18000,,
com.google.Chrome,758,1751938213,1751938971,1751938971.5462198,-18000,,
com.apple.MobileSMS,2,1751938211,1751938213,1751938213.087389,-18000,,
com.google.Chrome,5,1751938206,1751938211,1751938211.132753,-18000,,
com.apple.MobileSMS,18,1751938188,1751938206,1751938206.182265,-18000,,
com.google.Chrome,13,1751938175,1751938188,1751938188.2873468,-18000,,
com.google.Chrome,687,1751937450,1751938137,1751938137.7876601,-18000,,
com.apple.finder,2,1751937448,1751937450,1751937450.9905791,-18000,,
com.google.Chrome,19,1751937429,1751937448,1751937448.712932,-18000,,
com.google.Chrome,1,1751934487,1751934488,1751934489.1604729,-18000,,
com.google.Chrome,938,1751933527,1751934465,1751934465.972017,-18000,,
com.apple.finder,8,1751933519,1751933527,1751933528.380255,-18000,,
com.apple.finder,4,1751932927,1751932931,1751932931.020876,-18000,,
com.apple.Notes,67,1751932860,1751932927,1751932927.073968,-18000,,
com.apple.finder,2,1751932858,1751932860,1751932860.519905,-18000,,
com.apple.Music,84,1751932774,1751932858,1751932859.031036,-18000,,
com.leomehlig.today,14,1751932760,1751932774,1751932774.9620671,-18000,,
com.apple.Music,4,1751932756,1751932760,1751932760.734391,-18000,,
com.google.Chrome,22,1751932734,1751932756,1751932756.835952,-18000,,
com.apple.MobileSMS,3,1751932664,1751932667,1751932667.97011,-18000,,
com.google.Chrome,95,1751932569,1751932664,1751932664.3041658,-18000,,
com.electron.carta,16,1751932553,1751932569,1751932569.467633,-18000,,
com.google.Chrome,19,1751932534,1751932553,1751932553.663337,-18000,,
com.electron.carta,6,1751932528,1751932534,1751932534.8924298,-18000,,
com.google.Chrome,12,1751932516,1751932528,1751932528.8805819,-18000,,
com.electron.carta,8,1751932508,1751932516,1751932516.0393271,-18000,,
com.google.Chrome,37,1751932471,1751932508,1751932508.238764,-18000,,
com.electron.carta,31,1751932440,1751932471,1751932471.570492,-18000,,
com.google.Chrome,5,1751932435,1751932440,1751932440.02851,-18000,,
com.electron.carta,1,1751932434,1751932435,1751932435.38201,-18000,,
com.google.Chrome,219,1751932215,1751932434,1751932434.852291,-18000,,
com.electron.carta,62,1751932153,1751932215,1751932215.572843,-18000,,
com.google.Chrome,99,1751932054,1751932153,1751932153.163711,-18000,,
com.electron.carta,9,1751932045,1751932054,1751932054.5102792,-18000,,
com.google.Chrome,40,1751932005,1751932045,1751932045.741585,-18000,,
com.electron.carta,35,1751931970,1751932005,1751932005.4490519,-18000,,
com.google.Chrome,2,1751931968,1751931970,1751931970.830639,-18000,,
com.electron.carta,18,1751931950,1751931968,1751931968.745882,-18000,,
com.google.Chrome,3,1751931947,1751931950,1751931950.045123,-18000,,
com.apple.finder,3,1751931944,1751931947,1751931947.031026,-18000,,
com.electron.carta,11,1751931933,1751931944,1751931944.061394,-18000,,
com.apple.finder,13,1751931920,1751931933,1751931933.272887,-18000,,
com.electron.carta,2,1751931918,1751931920,1751931920.44319,-18000,,
com.google.Chrome,0,1751931918,1751931918,1751931918.677567,-18000,,
com.electron.carta,32,1751931886,1751931918,1751931918.405789,-18000,,
com.google.Chrome,6,1751931880,1751931886,1751931886.985402,-18000,,
com.apple.Music,14,1751931866,1751931880,1751931880.252911,-18000,,
com.google.Chrome,71,1751931795,1751931866,1751931866.230376,-18000,,
com.apple.finder,3,1751931792,1751931795,1751931795.1982121,-18000,,
com.google.Chrome,26,1751931766,1751931792,1751931792.574395,-18000,,
com.electron.carta,7,1751931759,1751931766,1751931766.772876,-18000,,
com.google.Chrome,37,1751931722,1751931759,1751931759.467403,-18000,,
com.apple.finder,15,1751931707,1751931722,1751931722.618062,-18000,,
com.electron.carta,70,1751931637,1751931707,1751931707.6921139,-18000,,
com.google.Chrome,47,1751931590,1751931637,1751931637.524554,-18000,,
com.electron.carta,5,1751931585,1751931590,1751931590.077584,-18000,,
com.google.Chrome,48,1751931537,1751931585,1751931585.259935,-18000,,
com.electron.carta,11,1751931526,1751931537,1751931537.8374128,-18000,,
com.google.Chrome,16,1751931510,1751931526,1751931526.214503,-18000,,
com.electron.carta,16,1751931494,1751931510,1751931510.567652,-18000,,
com.google.Chrome,40,1751931454,1751931494,1751931494.681025,-18000,,
com.electron.carta,8,1751931446,1751931454,1751931454.98457,-18000,,
com.google.Chrome,25,1751931421,1751931446,1751931447.007403,-18000,,
com.electron.carta,306,1751931115,1751931421,1751931421.485787,-18000,,
com.google.Chrome,48,1751931067,1751931115,1751931115.18011,-18000,,
com.apple.finder,2,1751931065,1751931067,1751931067.972621,-18000,,
com.google.Chrome,9,1751931056,1751931065,1751931065.463835,-18000,,
com.electron.carta,3,1751931053,1751931056,1751931056.8346648,-18000,,
com.google.Chrome,62,1751930991,1751931053,1751931053.159608,-18000,,
com.electron.carta,33,1751930958,1751930991,1751930991.9697251,-18000,,
com.apple.finder,15,1751930943,1751930958,1751930958.632283,-18000,,
com.electron.carta,46,1751930897,1751930943,1751930943.824829,-18000,,
com.google.Chrome,13,1751930884,1751930897,1751930897.5694962,-18000,,
com.electron.carta,7,1751930877,1751930884,1751930884.1214561,-18000,,
com.google.Chrome,13,1751930864,1751930877,1751930877.927634,-18000,,
com.electron.carta,51,1751930813,1751930864,1751930864.7692251,-18000,,
com.apple.Music,15,1751930798,1751930813,1751930813.313945,-18000,,
com.electron.carta,14,1751930784,1751930798,1751930798.299324,-18000,,
com.google.Chrome,61,1751930723,1751930784,1751930784.425005,-18000,,
com.apple.Notes,7,1751930716,1751930723,1751930723.286222,-18000,,
com.google.Chrome,53,1751930663,1751930716,1751930716.199627,-18000,,
com.electron.carta,22,1751930641,1751930663,1751930663.432249,-18000,,
com.google.Chrome,42,1751930599,1751930641,1751930641.399832,-18000,,
com.electron.carta,18,1751930581,1751930599,1751930599.500266,-18000,,
com.google.Chrome,79,1751930502,1751930581,1751930581.260079,-18000,,
com.apple.MobileSMS,47,1751930455,1751930502,1751930502.355125,-18000,,
com.google.Chrome,3,1751930452,1751930455,1751930455.710314,-18000,,
com.electron.carta,76,1751930376,1751930452,1751930452.6248631,-18000,,
com.google.Chrome,4,1751930372,1751930376,1751930376.505351,-18000,,
com.electron.carta,12,1751930360,1751930372,1751930372.475487,-18000,,
com.apple.finder,14,1751930346,1751930360,1751930360.810085,-18000,,
com.microsoft.VSCode,44,1751930302,1751930346,1751930346.058391,-18000,,
com.electron.carta,52,1751930250,1751930302,1751930302.217013,-18000,,
com.apple.finder,27,1751930223,1751930250,1751930250.162261,-18000,,
com.google.Chrome,3,1751930220,1751930223,1751930223.951235,-18000,,
com.electron.carta,31,1751930189,1751930220,1751930220.339221,-18000,,
com.google.Chrome,4,1751930185,1751930189,1751930189.1786752,-18000,,
com.electron.carta,13,1751930172,1751930185,1751930185.221535,-18000,,
com.google.Chrome,4,1751930168,1751930172,1751930172.584176,-18000,,
com.apple.finder,2,1751930166,1751930168,1751930168.643606,-18000,,
com.leomehlig.today,3,1751930163,1751930166,1751930166.8535671,-18000,,
com.apple.Music,84,1751930079,1751930163,1751930163.775912,-18000,,
com.leomehlig.today,24,1751930055,1751930079,1751930079.3314219,-18000,,
com.apple.Music,2,1751930053,1751930055,1751930055.220511,-18000,,
com.google.Chrome,26,1751930027,1751930053,1751930053.94912,-18000,,
com.google.Chrome,287,1751928128,1751928415,1751928415.218946,-18000,,
com.google.Chrome,1379,1751926187,1751927566,1751927566.174872,-18000,,
com.apple.iCal,308,1751925879,1751926187,1751926187.7702332,-18000,,
com.google.Chrome,149,1751925730,1751925879,1751925879.8821359,-18000,,
com.google.Chrome,639,1751925070,1751925709,1751925709.5363312,-18000,,
com.apple.MobileSMS,15,1751925055,1751925070,1751925070.8075871,-18000,,
com.google.Chrome,13,1751925042,1751925055,1751925055.4164371,-18000,,
com.apple.finder,3,1751925039,1751925042,1751925042.9023361,-18000,,
com.apple.finder,15,1751924596,1751924611,1751924611.0624561,-18000,,
com.tableausoftware.tableaudesktop,1,1751924595,1751924596,1751924596.940884,-18000,,
com.apple.finder,2,1751924593,1751924595,1751924595.23697,-18000,,
com.tableausoftware.tableaudesktop,4,1751924589,1751924593,1751924593.343855,-18000,,
com.google.Chrome,79,1751924510,1751924589,1751924590.769003,-18000,,
com.leomehlig.today,47,1751924463,1751924510,1751924510.956094,-18000,,
com.apple.iCal,17,1751924446,1751924463,1751924463.36117,-18000,,
com.leomehlig.today,8,1751924438,1751924446,1751924446.766036,-18000,,
com.apple.MobileSMS,12,1751924426,1751924438,1751924438.588934,-18000,,
com.leomehlig.today,3,1751924423,1751924426,1751924426.674951,-18000,,
com.apple.MobileSMS,9,1751924414,1751924423,1751924423.129971,-18000,,
com.leomehlig.today,3,1751924411,1751924414,1751924414.491037,-18000,,
com.apple.MobileSMS,13,1751924398,1751924411,1751924411.737074,-18000,,
com.leomehlig.today,22,1751924376,1751924398,1751924398.896741,-18000,,
com.apple.iCal,9,1751924367,1751924376,1751924376.43708,-18000,,
com.leomehlig.today,94,1751924273,1751924367,1751924367.294375,-18000,,
com.google.Chrome,187,1751924086,1751924273,1751924274.0401149,-18000,,
com.tableausoftware.tableaudesktop,200,1751923886,1751924086,1751924086.2511148,-18000,,
com.tableausoftware.tableaudesktop,3,1751923883,1751923886,1751923886.7228909,-18000,,
com.apple.finder,1,1751923882,1751923883,1751923883.884379,-18000,,
com.tableausoftware.tableaudesktop,194,1751923688,1751923882,1751923882.942548,-18000,,
com.tableausoftware.tableaudesktop,3,1751923685,1751923688,1751923688.3530111,-18000,,
com.apple.finder,1,1751923684,1751923685,1751923685.4023771,-18000,,
com.tableausoftware.tableaudesktop,3,1751923681,1751923684,1751923684.338871,-18000,,
com.google.Chrome,74,1751923607,1751923681,1751923682.0108042,-18000,,
com.tableausoftware.tableaudesktop,147,1751923460,1751923607,1751923607.52664,-18000,,
com.tableausoftware.tableaudesktop,3,1751923457,1751923460,1751923460.7488608,-18000,,
com.apple.finder,0,1751923457,1751923457,1751923457.898947,-18000,,
com.tableausoftware.tableaudesktop,163,1751923294,1751923457,1751923457.524092,-18000,,
com.google.Chrome,55,1751923239,1751923294,1751923294.7647,-18000,,
com.tableausoftware.tableaudesktop,8,1751923231,1751923239,1751923239.704263,-18000,,
com.tableausoftware.tableaudesktop,3,1751923228,1751923231,1751923231.553084,-18000,,
com.apple.finder,8,1751923220,1751923228,1751923228.776926,-18000,,
com.tableausoftware.tableaudesktop,3,1751923217,1751923220,1751923220.296852,-18000,,
com.google.Chrome,3,1751923214,1751923217,1751923217.722389,-18000,,
com.tableausoftware.tableaudesktop,166,1751923048,1751923214,1751923214.023802,-18000,,
com.google.Chrome,98,1751922950,1751923048,1751923048.825035,-18000,,
com.tableausoftware.tableaudesktop,7,1751922943,1751922950,1751922950.0708032,-18000,,
com.tableausoftware.tableaudesktop,3,1751922940,1751922943,1751922943.724597,-18000,,
com.apple.finder,3,1751922937,1751922940,1751922940.946793,-18000,,
com.tableausoftware.tableaudesktop,4,1751922933,1751922937,1751922937.4541202,-18000,,
com.google.Chrome,99,1751922834,1751922933,1751922933.786069,-18000,,
com.tableausoftware.tableaudesktop,398,1751922436,1751922834,1751922834.935777,-18000,,
com.google.Chrome,1,1751922435,1751922436,1751922436.170068,-18000,,
com.tableausoftware.tableaudesktop,61,1751922374,1751922435,1751922435.524194,-18000,,
com.tableausoftware.tableaudesktop,3,1751922371,1751922374,1751922374.49739,-18000,,
com.apple.finder,2,1751922369,1751922371,1751922371.5741591,-18000,,
com.google.Chrome,0,1751922369,1751922369,1751922369.831966,-18000,,
com.tableausoftware.tableaudesktop,286,1751922083,1751922369,1751922369.760899,-18000,,
com.google.Chrome,2,1751922081,1751922083,1751922083.466445,-18000,,
com.tableausoftware.tableaudesktop,12,1751922069,1751922081,1751922081.655129,-18000,,
com.microsoft.Outlook,87,1751921982,1751922069,1751922069.2109962,-18000,,
com.tableausoftware.tableaudesktop,6,1751921976,1751921982,1751921982.136341,-18000,,
com.tableausoftware.tableaudesktop,3,1751921973,1751921976,1751921976.7417002,-18000,,
com.apple.finder,1,1751921972,1751921973,1751921973.9309812,-18000,,
com.tableausoftware.tableaudesktop,2,1751921970,1751921972,1751921972.125232,-18000,,
com.google.Chrome,1,1751921969,1751921970,1751921970.453412,-18000,,
com.tableausoftware.tableaudesktop,3,1751921966,1751921969,1751921969.467974,-18000,,
com.google.Chrome,3,1751921963,1751921966,1751921966.633734,-18000,,
com.tableausoftware.tableaudesktop,144,1751921819,1751921963,1751921963.833551,-18000,,
com.google.Chrome,9,1751921810,1751921819,1751921819.664964,-18000,,
com.tableausoftware.tableaudesktop,2,1751921808,1751921810,1751921810.322235,-18000,,
com.google.Chrome,2,1751921806,1751921808,1751921808.95256,-18000,,
com.leomehlig.today,10,1751921796,1751921806,1751921806.729672,-18000,,
com.google.Chrome,3,1751921793,1751921796,1751921796.571844,-18000,,
com.tableausoftware.tableaudesktop,34,1751921759,1751921793,1751921793.7276402,-18000,,
com.tableausoftware.tableaudesktop,3,1751921756,1751921759,1751921759.388784,-18000,,
com.apple.finder,1,1751921755,1751921756,1751921756.649519,-18000,,
com.tableausoftware.tableaudesktop,203,1751921552,1751921755,1751921755.1322641,-18000,,
com.google.Chrome,41,1751921511,1751921552,1751921552.178366,-18000,,
com.tableausoftware.tableaudesktop,7,1751921504,1751921511,1751921511.895313,-18000,,
com.tableausoftware.tableaudesktop,3,1751921501,1751921504,1751921504.390874,-18000,,
com.apple.finder,0,1751921501,1751921501,1751921501.630724,-18000,,
com.google.Chrome,226,1751921275,1751921501,1751921501.3165488,-18000,,
com.apple.finder,10,1751921265,1751921275,1751921275.7822251,-18000,,
com.tableausoftware.tableaudesktop,13,1751921252,1751921265,1751921265.184238,-18000,,
com.google.Chrome,493,1751920759,1751921252,1751921252.138482,-18000,,
com.apple.finder,2,1751920735,1751920737,1751920737.8550138,-18000,,
com.apple.Music,7,1751920728,1751920735,1751920735.48329,-18000,,
com.google.Chrome,8,1751920720,1751920728,1751920728.702002,-18000,,
com.apple.Notes,22,1751920698,1751920720,1751920720.47506,-18000,,
com.google.Chrome,78,1751920620,1751920698,1751920698.556522,-18000,,
com.microsoft.VSCode,5,1751920606,1751920611,1751920611.789392,-18000,,
com.google.Chrome,3,1751920603,1751920606,1751920606.4777598,-18000,,
com.electron.carta,2,1751920601,1751920603,1751920603.774787,-18000,,
com.google.Chrome,115,1751920486,1751920601,1751920601.269212,-18000,,
com.electron.carta,2,1751920484,1751920486,1751920486.9163852,-18000,,
com.google.Chrome,37,1751920447,1751920484,1751920484.658414,-18000,,
com.apple.Notes,5,1751920442,1751920447,1751920447.086581,-18000,,
com.google.Chrome,36,1751920406,1751920442,1751920442.970375,-18000,,
com.electron.carta,22,1751920384,1751920406,1751920406.674539,-18000,,
com.google.Chrome,8,1751920376,1751920384,1751920384.772371,-18000,,
com.apple.Notes,4,1751920372,1751920376,1751920376.318506,-18000,,
com.google.Chrome,54,1751920318,1751920372,1751920372.78749,-18000,,
com.electron.carta,1,1751920317,1751920318,1751920318.172659,-18000,,
com.google.Chrome,38,1751920279,1751920317,1751920317.357431,-18000,,
com.apple.finder,6,1751920273,1751920279,1751920279.985841,-18000,,
com.google.Chrome,9,1751920264,1751920273,1751920273.2565851,-18000,,
com.electron.carta,60,1751920204,1751920264,1751920264.1438022,-18000,,
com.apple.finder,5,1751920199,1751920204,1751920204.1765819,-18000,,
com.electron.carta,26,1751920173,1751920199,1751920199.6626182,-18000,,
com.apple.finder,1,1751920172,1751920173,1751920173.488645,-18000,,
com.electron.carta,2,1751920170,1751920172,1751920172.353081,-18000,,
com.apple.finder,1,1751920169,1751920170,1751920170.106666,-18000,,
com.electron.carta,15,1751920154,1751920169,1751920169.166562,-18000,,
com.apple.finder,2,1751920152,1751920154,1751920154.035795,-18000,,
com.electron.carta,4,1751920148,1751920152,1751920152.9015121,-18000,,
com.apple.finder,10,1751920138,1751920148,1751920148.7009668,-18000,,
com.electron.carta,28,1751920110,1751920138,1751920138.8620281,-18000,,
com.google.Chrome,39,1751920071,1751920110,1751920110.3739219,-18000,,
com.electron.carta,1,1751920070,1751920071,1751920071.71493,-18000,,
com.apple.Notes,6,1751920064,1751920070,1751920070.472931,-18000,,
com.electron.carta,2,1751920062,1751920064,1751920064.253252,-18000,,
com.google.Chrome,20,1751920042,1751920062,1751920062.708994,-18000,,
com.electron.carta,7,1751920035,1751920042,1751920042.755647,-18000,,
com.google.Chrome,8,1751920027,1751920035,1751920036.019768,-18000,,
com.electron.carta,8,1751920019,1751920027,1751920027.947763,-18000,,
com.google.Chrome,14,1751920005,1751920019,1751920019.05359,-18000,,
com.electron.carta,8,1751919997,1751920005,1751920005.240675,-18000,,
com.google.Chrome,21,1751919976,1751919997,1751919997.973054,-18000,,
com.electron.carta,22,1751919954,1751919976,1751919976.385477,-18000,,
com.google.Chrome,18,1751919936,1751919954,1751919954.673692,-18000,,
com.electron.carta,21,1751919915,1751919936,1751919936.615876,-18000,,
com.google.Chrome,19,1751919896,1751919915,1751919915.434947,-18000,,
com.electron.carta,83,1751919813,1751919896,1751919896.724924,-18000,,
com.google.Chrome,97,1751919716,1751919813,1751919813.7746968,-18000,,
com.electron.carta,37,1751919679,1751919716,1751919716.460304,-18000,,
com.google.Chrome,67,1751919612,1751919679,1751919679.712013,-18000,,
com.apple.Music,5,1751919607,1751919612,1751919612.7567348,-18000,,
com.google.Chrome,102,1751919505,1751919607,1751919607.834353,-18000,,
com.electron.carta,2,1751919503,1751919505,1751919505.322962,-18000,,
com.google.Chrome,2,1751919501,1751919503,1751919503.423172,-18000,,
com.microsoft.VSCode,1,1751919500,1751919501,1751919501.8110518,-18000,,
com.apple.Music,3,1751919497,1751919500,1751919500.5449739,-18000,,
com.google.Chrome,73,1751919424,1751919497,1751919497.126648,-18000,,
com.apple.Notes,3,1751919421,1751919424,1751919424.5683231,-18000,,
com.google.Chrome,133,1751919288,1751919421,1751919421.174674,-18000,,
com.microsoft.VSCode,3,1751919285,1751919288,1751919288.5514522,-18000,,
com.google.Chrome,4,1751919281,1751919285,1751919285.424464,-18000,,
com.microsoft.VSCode,2,1751919279,1751919281,1751919281.709271,-18000,,
com.apple.Music,2,1751919277,1751919279,1751919279.710283,-18000,,
com.google.Chrome,21,1751919256,1751919277,1751919277.1774411,-18000,,
com.microsoft.VSCode,8,1751919248,1751919256,1751919256.080514,-18000,,
com.google.Chrome,1,1751919247,1751919248,1751919248.076661,-18000,,
com.apple.Music,10,1751919237,1751919247,1751919247.251715,-18000,,
com.google.Chrome,47,1751919190,1751919237,1751919237.966295,-18000,,
com.microsoft.VSCode,4,1751919186,1751919190,1751919190.208194,-18000,,
com.google.Chrome,80,1751919106,1751919186,1751919186.4462261,-18000,,
com.microsoft.VSCode,31,1751919075,1751919106,1751919106.697978,-18000,,
com.google.Chrome,25,1751919050,1751919075,1751919075.055066,-18000,,
com.microsoft.VSCode,101,1751918949,1751919050,1751919050.684126,-18000,,
com.google.Chrome,439,1751918510,1751918949,1751918949.547004,-18000,,
com.electron.carta,10,1751918500,1751918510,1751918510.072784,-18000,,
com.google.Chrome,7,1751918493,1751918500,1751918500.3941,-18000,,
com.electron.carta,30,1751918463,1751918493,1751918493.835818,-18000,,
com.google.Chrome,13,1751918450,1751918463,1751918463.273695,-18000,,
com.electron.carta,26,1751918424,1751918450,1751918450.9097881,-18000,,
com.google.Chrome,29,1751918395,1751918424,1751918424.550489,-18000,,
com.apple.finder,1,1751918394,1751918395,1751918395.48462,-18000,,
com.apple.Notes,6,1751918388,1751918394,1751918394.4678621,-18000,,
com.apple.finder,1,1751918387,1751918388,1751918388.780366,-18000,,
com.google.Chrome,7,1751918380,1751918387,1751918387.211327,-18000,,
com.electron.carta,13,1751918367,1751918380,1751918380.848047,-18000,,
com.google.Chrome,23,1751918344,1751918367,1751918367.272291,-18000,,
com.electron.carta,43,1751918301,1751918344,1751918344.646292,-18000,,
com.google.Chrome,8,1751918293,1751918301,1751918301.5859199,-18000,,
com.electron.carta,29,1751918264,1751918293,1751918293.468017,-18000,,
com.apple.finder,12,1751918252,1751918264,1751918264.609054,-18000,,
com.google.Chrome,8,1751918244,1751918252,1751918252.1635299,-18000,,
com.electron.carta,8,1751918236,1751918244,1751918244.977715,-18000,,
com.google.Chrome,25,1751918211,1751918236,1751918236.8128371,-18000,,
com.electron.carta,49,1751918162,1751918211,1751918211.29772,-18000,,
com.google.Chrome,214,1751917948,1751918162,1751918162.5069308,-18000,,
com.apple.Notes,9,1751917939,1751917948,1751917948.1427,-18000,,
com.google.Chrome,73,1751917866,1751917939,1751917939.190495,-18000,,
com.apple.Notes,6,1751917860,1751917866,1751917866.765336,-18000,,
com.google.Chrome,27,1751917833,1751917860,1751917860.645625,-18000,,
com.electron.carta,7,1751917826,1751917833,1751917833.696105,-18000,,
com.google.Chrome,58,1751917768,1751917826,1751917827.01668,-18000,,
com.electron.carta,13,1751917755,1751917768,1751917768.133713,-18000,,
com.google.Chrome,61,1751917694,1751917755,1751917755.424478,-18000,,
com.electron.carta,5,1751917689,1751917694,1751917694.4848619,-18000,,
com.google.Chrome,30,1751917659,1751917689,1751917689.35141,-18000,,
com.electron.carta,29,1751917630,1751917659,1751917659.120687,-18000,,
com.google.Chrome,7,1751917623,1751917630,1751917630.5863252,-18000,,
com.electron.carta,5,1751917618,1751917623,1751917623.260205,-18000,,
com.apple.Music,6,1751917612,1751917618,1751917618.273798,-18000,,
com.electron.carta,95,1751917517,1751917612,1751917612.884983,-18000,,
com.apple.Music,8,1751917509,1751917517,1751917517.639709,-18000,,
com.apple.findmy,7,1751917238,1751917245,1751917246.441135,-18000,EB445137-D7F5-57EC-87DA-1DB460D64046,"iPhone13,2"
com.apple.findmy,9,1751917190,1751917199,1751917201.696104,-18000,EB445137-D7F5-57EC-87DA-1DB460D64046,"iPhone13,2"
com.apple.news,185,1751917003,1751917188,1751917188.805152,-18000,EB445137-D7F5-57EC-87DA-1DB460D64046,"iPhone13,2"
com.apple.Music,326,1751916947,1751917273,1751917273.4183378,-18000,,
com.electron.carta,6,1751916941,1751916947,1751916947.605383,-18000,,
com.leomehlig.today,16,1751916925,1751916941,1751916941.088375,-18000,,
com.electron.carta,72,1751916853,1751916925,1751916925.844705,-18000,,
com.google.Chrome,55,1751916798,1751916853,1751916853.5279598,-18000,,
com.electron.carta,16,1751916782,1751916798,1751916798.458266,-18000,,
com.google.Chrome,152,1751916630,1751916782,1751916782.900502,-18000,,
com.electron.carta,13,1751916617,1751916630,1751916630.193159,-18000,,
com.google.Chrome,14,1751916603,1751916617,1751916617.5158691,-18000,,
com.electron.carta,1,1751916602,1751916603,1751916603.094483,-18000,,
com.apple.Music,2,1751916600,1751916602,1751916602.285605,-18000,,
com.electron.carta,2,1751916598,1751916600,1751916600.940129,-18000,,
com.apple.Music,0,1751916598,1751916598,1751916598.8051271,-18000,,
com.electron.carta,1,1751916597,1751916598,1751916598.498347,-18000,,
com.google.Chrome,37,1751916560,1751916597,1751916597.933104,-18000,,
com.electron.carta,17,1751916543,1751916560,1751916560.806234,-18000,,
com.google.Chrome,1,1751916542,1751916543,1751916543.66358,-18000,,
com.apple.Music,3,1751916539,1751916542,1751916542.567131,-18000,,
com.google.Chrome,43,1751916496,1751916539,1751916539.105733,-18000,,
com.electron.carta,7,1751916489,1751916496,1751916496.296989,-18000,,
com.google.Chrome,12,1751916477,1751916489,1751916489.862908,-18000,,
com.electron.carta,2,1751916475,1751916477,1751916478.010433,-18000,,
com.apple.Music,119,1751916356,1751916475,1751916475.583221,-18000,,
com.google.Chrome,46,1751916310,1751916356,1751916356.849616,-18000,,
com.electron.carta,115,1751916195,1751916310,1751916310.10074,-18000,,
com.apple.finder,3,1751916192,1751916195,1751916195.811164,-18000,,
com.electron.carta,11,1751916181,1751916192,1751916192.704249,-18000,,
com.apple.finder,14,1751916167,1751916181,1751916181.027554,-18000,,
com.electron.carta,30,1751916137,1751916167,1751916167.239001,-18000,,
com.apple.finder,7,1751916130,1751916137,1751916137.651573,-18000,,
com.google.Chrome,2,1751916128,1751916130,1751916130.474463,-18000,,
com.electron.carta,1,1751916127,1751916128,1751916128.60634,-18000,,
com.google.Chrome,94,1751916033,1751916127,1751916127.853765,-18000,,
com.apple.finder,22,1751916011,1751916033,1751916033.336962,-18000,,
com.google.Chrome,75,1751915936,1751916011,1751916011.100706,-18000,,
com.electron.carta,5,1751915931,1751915936,1751915936.756065,-18000,,
com.google.Chrome,39,1751915892,1751915931,1751915932.02791,-18000,,
com.electron.carta,15,1751915877,1751915892,1751915892.422987,-18000,,
com.google.Chrome,37,1751915840,1751915877,1751915877.13768,-18000,,
com.electron.carta,23,1751915817,1751915840,1751915840.462718,-18000,,
com.google.Chrome,13,1751915804,1751915817,1751915817.352316,-18000,,
com.electron.carta,44,1751915760,1751915804,1751915804.983292,-18000,,
com.google.Chrome,16,1751915744,1751915760,1751915760.634779,-18000,,
com.electron.carta,19,1751915725,1751915744,1751915744.55446,-18000,,
com.google.Chrome,153,1751915572,1751915725,1751915725.723347,-18000,,
com.electron.carta,43,1751915529,1751915572,1751915572.321353,-18000,,
com.apple.finder,3,1751915526,1751915529,1751915529.6960301,-18000,,
com.google.Chrome,6,1751915520,1751915526,1751915526.2966352,-18000,,
com.electron.carta,29,1751915491,1751915520,1751915520.1263309,-18000,,
com.apple.finder,7,1751915484,1751915491,1751915491.661567,-18000,,
com.electron.carta,37,1751915447,1751915484,1751915484.84283,-18000,,
com.google.Chrome,164,1751915283,1751915447,1751915447.892642,-18000,,
com.electron.carta,7,1751915276,1751915283,1751915283.750382,-18000,,
com.google.Chrome,14,1751915262,1751915276,1751915276.226332,-18000,,
com.electron.carta,13,1751915249,1751915262,1751915262.478893,-18000,,
com.google.Chrome,90,1751915159,1751915249,1751915250.034604,-18000,,
com.electron.carta,2,1751915157,1751915159,1751915159.4262161,-18000,,
com.apple.Notes,7,1751915150,1751915157,1751915158.024653,-18000,,
com.electron.carta,1,1751915149,1751915150,1751915150.202802,-18000,,
com.google.Chrome,10,1751915139,1751915149,1751915149.455245,-18000,,
com.electron.carta,8,1751915131,1751915139,1751915139.5698872,-18000,,
com.google.Chrome,5,1751915126,1751915131,1751915131.939954,-18000,,
com.apple.Notes,3,1751915123,1751915126,1751915126.884778,-18000,,
com.google.Chrome,29,1751915094,1751915123,1751915123.240802,-18000,,
com.apple.Notes,2,1751915092,1751915094,1751915094.556771,-18000,,
com.google.Chrome,19,1751915073,1751915092,1751915092.4965692,-18000,,
com.apple.Notes,4,1751915069,1751915073,1751915073.5899,-18000,,
com.google.Chrome,4,1751915065,1751915069,1751915069.6055,-18000,,
com.electron.carta,17,1751915048,1751915065,1751915065.3990932,-18000,,
com.google.Chrome,13,1751915035,1751915048,1751915048.733842,-18000,,
com.electron.carta,11,1751915024,1751915035,1751915035.6075392,-18000,,
com.google.Chrome,137,1751914887,1751915024,1751915024.438097,-18000,,
com.electron.carta,35,1751914852,1751914887,1751914887.5511498,-18000,,
com.apple.finder,2,1751914850,1751914852,1751914852.2171268,-18000,,
com.electron.carta,1,1751914849,1751914850,1751914850.8023639,-18000,,
com.apple.finder,2,1751914847,1751914849,1751914849.423511,-18000,,
com.electron.carta,5,1751914842,1751914847,1751914847.178763,-18000,,
com.apple.finder,2,1751914840,1751914842,1751914842.1778889,-18000,,
com.electron.carta,8,1751914832,1751914840,1751914841.002377,-18000,,
com.apple.finder,1,1751914831,1751914832,1751914832.613564,-18000,,
com.electron.carta,16,1751914815,1751914831,1751914831.339174,-18000,,
com.apple.finder,14,1751914801,1751914815,1751914815.170734,-18000,,
com.electron.carta,56,1751914745,1751914801,1751914801.903832,-18000,,
com.google.Chrome,156,1751914589,1751914745,1751914745.313901,-18000,,
com.apple.Music,1,1751914588,1751914589,1751914589.366619,-18000,,
com.apple.Notes,9,1751914579,1751914588,1751914588.7502499,-18000,,
com.apple.Music,2,1751914577,1751914579,1751914579.267115,-18000,,
com.google.Chrome,11,1751914566,1751914577,1751914577.672014,-18000,,
com.apple.Music,17,1751914549,1751914566,1751914566.301978,-18000,,
com.google.Chrome,41,1751914508,1751914549,1751914549.485839,-18000,,
com.apple.Notes,3,1751914505,1751914508,1751914508.1277552,-18000,,
com.google.Chrome,1,1751914504,1751914505,1751914505.644794,-18000,,
com.apple.Notes,1,1751914503,1751914504,1751914504.708324,-18000,,
com.google.Chrome,0,1751914503,1751914503,1751914503.891048,-18000,,
com.apple.Notes,19,1751914484,1751914503,1751914503.147073,-18000,,
com.google.Chrome,64,1751914420,1751914484,1751914484.541627,-18000,,
com.electron.carta,16,1751914404,1751914420,1751914420.4801621,-18000,,
com.google.Chrome,308,1751914096,1751914404,1751914404.962538,-18000,,
com.electron.carta,36,1751914060,1751914096,1751914096.889204,-18000,,
com.google.Chrome,37,1751914023,1751914060,1751914060.6093621,-18000,,
com.electron.carta,8,1751914015,1751914023,1751914023.281364,-18000,,
com.google.Chrome,42,1751913973,1751914015,1751914016.014106,-18000,,
com.electron.carta,13,1751913960,1751913973,1751913973.5940108,-18000,,
com.google.Chrome,11,1751913949,1751913960,1751913960.225686,-18000,,
com.electron.carta,8,1751913941,1751913949,1751913949.4501061,-18000,,
com.google.Chrome,1,1751913940,1751913941,1751913941.8764482,-18000,,
com.apple.finder,3,1751913937,1751913940,1751913940.3780751,-18000,,
com.google.Chrome,41,1751913896,1751913937,1751913937.9073539,-18000,,
com.electron.carta,28,1751913868,1751913896,1751913896.0658069,-18000,,
com.apple.finder,10,1751913858,1751913868,1751913868.418704,-18000,,
com.electron.carta,3,1751913855,1751913858,1751913858.665563,-18000,,
com.apple.finder,9,1751913846,1751913855,1751913856.012188,-18000,,
com.electron.carta,88,1751913758,1751913846,1751913846.061802,-18000,,
com.google.Chrome,74,1751913684,1751913758,1751913758.6523151,-18000,,
com.apple.finder,3,1751913681,1751913684,1751913684.071329,-18000,,
com.google.Chrome,107,1751913574,1751913681,1751913681.255487,-18000,,
com.electron.carta,111,1751913463,1751913574,1751913574.9770799,-18000,,
com.apple.finder,36,1751913427,1751913463,1751913463.48531,-18000,,
com.google.Chrome,16,1751913411,1751913427,1751913427.3204,-18000,,
com.electron.carta,16,1751913395,1751913411,1751913412.010037,-18000,,
com.apple.Music,100,1751913295,1751913395,1751913395.929671,-18000,,
com.electron.carta,40,1751913255,1751913295,1751913295.177733,-18000,,
com.google.Chrome,53,1751913202,1751913255,1751913255.6926,-18000,,
com.electron.carta,13,1751913189,1751913202,1751913202.904197,-18000,,
com.google.Chrome,9,1751913180,1751913189,1751913190.007544,-18000,,
com.apple.Notes,26,1751913154,1751913180,1751913180.5337071,-18000,,
com.google.Chrome,377,1751912777,1751913154,1751913154.579057,-18000,,
com.leomehlig.today,61,1751912716,1751912777,1751912777.2451181,-18000,,
com.google.Chrome,2,1751912714,1751912716,1751912716.913348,-18000,,
com.microsoft.Excel,1,1751912713,1751912714,1751912714.7557359,-18000,,
com.google.Chrome,8,1751912705,1751912713,1751912713.491338,-18000,,
com.apple.Notes,166,1751912539,1751912705,1751912705.423665,-18000,,
com.google.Chrome,2,1751912537,1751912539,1751912539.3869572,-18000,,
com.apple.Music,32,1751912498,1751912530,1751912530.998036,-18000,EB445137-D7F5-57EC-87DA-1DB460D64046,"iPhone13,2"
com.apple.Music,101,1751912436,1751912537,1751912537.457189,-18000,,
com.google.Chrome,3,1751912433,1751912436,1751912436.084358,-18000,,
com.apple.Music,84,1751912409,1751912493,1751912493.247486,-18000,EB445137-D7F5-57EC-87DA-1DB460D64046,"iPhone13,2"
com.apple.finder,61,1751912372,1751912433,1751912433.964521,-18000,,
com.doordash.dasher,162,1751911314,1751911476,1751911476.462775,-18000,EB445137-D7F5-57EC-87DA-1DB460D64046,"iPhone13,2"
com.doordash.dasher,495,1751910818,1751911313,1751911314.0868258,-18000,EB445137-D7F5-57EC-87DA-1DB460D64046,"iPhone13,2"
com.apple.Music,2,1751910816,1751910818,1751910818.531435,-18000,EB445137-D7F5-57EC-87DA-1DB460D64046,"iPhone13,2"
com.doordash.dasher,130,1751910686,1751910816,1751910816.208201,-18000,EB445137-D7F5-57EC-87DA-1DB460D64046,"iPhone13,2"
com.doordash.dasher,289,1751910394,1751910683,1751910683.207345,-18000,EB445137-D7F5-57EC-87DA-1DB460D64046,"iPhone13,2"
com.apple.Music,1,1751910393,1751910394,1751910395.0009542,-18000,EB445137-D7F5-57EC-87DA-1DB460D64046,"iPhone13,2"
com.apple.Music,17,1751910371,1751910388,1751910388.8807921,-18000,EB445137-D7F5-57EC-87DA-1DB460D64046,"iPhone13,2"
com.doordash.dasher,147,1751910224,1751910371,1751910371.608422,-18000,EB445137-D7F5-57EC-87DA-1DB460D64046,"iPhone13,2"
com.apple.podcasts,9,1751910212,1751910221,1751910221.429878,-18000,EB445137-D7F5-57EC-87DA-1DB460D64046,"iPhone13,2"
com.doordash.dasher,2,1751910208,1751910210,1751910210.600915,-18000,EB445137-D7F5-57EC-87DA-1DB460D64046,"iPhone13,2"
com.doordash.dasher,115,1751910092,1751910207,1751910207.9001179,-18000,EB445137-D7F5-57EC-87DA-1DB460D64046,"iPhone13,2"
com.doordash.dasher,509,1751909582,1751910091,1751910091.950969,-18000,EB445137-D7F5-57EC-87DA-1DB460D64046,"iPhone13,2"
com.doordash.dasher,85,1751909492,1751909577,1751909578.044283,-18000,EB445137-D7F5-57EC-87DA-1DB460D64046,"iPhone13,2"
com.doordash.dasher,395,1751909097,1751909492,1751909492.172751,-18000,EB445137-D7F5-57EC-87DA-1DB460D64046,"iPhone13,2"
com.doordash.dasher,56,1751909040,1751909096,1751909096.602957,-18000,EB445137-D7F5-57EC-87DA-1DB460D64046,"iPhone13,2"
com.doordash.dasher,150,1751908889,1751909039,1751909039.949034,-18000,EB445137-D7F5-57EC-87DA-1DB460D64046,"iPhone13,2"
com.doordash.dasher,286,1751908602,1751908888,1751908888.53595,-18000,EB445137-D7F5-57EC-87DA-1DB460D64046,"iPhone13,2"
com.apple.podcasts,3,1751908599,1751908602,1751908603.015707,-18000,EB445137-D7F5-57EC-87DA-1DB460D64046,"iPhone13,2"
com.doordash.dasher,1,1751908598,1751908599,1751908600.124861,-18000,EB445137-D7F5-57EC-87DA-1DB460D64046,"iPhone13,2"
com.doordash.dasher,36,1751908559,1751908595,1751908595.294605,-18000,EB445137-D7F5-57EC-87DA-1DB460D64046,"iPhone13,2"
Astrospheric.Astrospheric,32,1751908527,1751908559,1751908559.81045,-18000,EB445137-D7F5-57EC-87DA-1DB460D64046,"iPhone13,2"
com.apple.weather,26,1751908501,1751908527,1751908527.157547,-18000,EB445137-D7F5-57EC-87DA-1DB460D64046,"iPhone13,2"
com.doordash.dasher,23,1751908478,1751908501,1751908501.511383,-18000,EB445137-D7F5-57EC-87DA-1DB460D64046,"iPhone13,2"
com.apple.weather,85,1751908393,1751908478,1751908478.4778528,-18000,EB445137-D7F5-57EC-87DA-1DB460D64046,"iPhone13,2"
com.doordash.dasher,2,1751908390,1751908392,1751908392.205756,-18000,EB445137-D7F5-57EC-87DA-1DB460D64046,"iPhone13,2"
com.doordash.dasher,499,1751907889,1751908388,1751908388.426204,-18000,EB445137-D7F5-57EC-87DA-1DB460D64046,"iPhone13,2"
com.doordash.dasher,39,1751907848,1751907887,1751907887.687953,-18000,EB445137-D7F5-57EC-87DA-1DB460D64046,"iPhone13,2"
com.doordash.dasher,306,1751907538,1751907844,1751907844.9014812,-18000,EB445137-D7F5-57EC-87DA-1DB460D64046,"iPhone13,2"
com.doordash.dasher,2,1751907535,1751907537,1751907537.430227,-18000,EB445137-D7F5-57EC-87DA-1DB460D64046,"iPhone13,2"
com.doordash.dasher,143,1751907391,1751907534,1751907534.5483289,-18000,EB445137-D7F5-57EC-87DA-1DB460D64046,"iPhone13,2"
com.doordash.dasher,287,1751907103,1751907390,1751907390.998067,-18000,EB445137-D7F5-57EC-87DA-1DB460D64046,"iPhone13,2"
com.doordash.dasher,128,1751906974,1751907102,1751907102.166168,-18000,EB445137-D7F5-57EC-87DA-1DB460D64046,"iPhone13,2"
com.doordash.dasher,612,1751906357,1751906969,1751906969.6584349,-18000,EB445137-D7F5-57EC-87DA-1DB460D64046,"iPhone13,2"
com.doordash.dasher,438,1751905917,1751906355,1751906355.448629,-18000,EB445137-D7F5-57EC-87DA-1DB460D64046,"iPhone13,2"
com.doordash.dasher,10,1751905904,1751905914,1751905914.429347,-18000,EB445137-D7F5-57EC-87DA-1DB460D64046,"iPhone13,2"
com.google.chrome.ios,53,1751905851,1751905904,1751905904.612777,-18000,EB445137-D7F5-57EC-87DA-1DB460D64046,"iPhone13,2"
com.doordash.dasher,67,1751905784,1751905851,1751905851.868874,-18000,EB445137-D7F5-57EC-87DA-1DB460D64046,"iPhone13,2"
com.doordash.dasher,529,1751905254,1751905783,1751905783.554378,-18000,EB445137-D7F5-57EC-87DA-1DB460D64046,"iPhone13,2"
com.doordash.dasher,36,1751905216,1751905252,1751905252.244153,-18000,EB445137-D7F5-57EC-87DA-1DB460D64046,"iPhone13,2"
com.doordash.dasher,354,1751904859,1751905213,1751905213.176597,-18000,EB445137-D7F5-57EC-87DA-1DB460D64046,"iPhone13,2"
com.facebook.Facebook,29,1751904754,1751904783,1751904783.350225,-18000,EB445137-D7F5-57EC-87DA-1DB460D64046,"iPhone13,2"
com.doordash.dasher,9,1751904718,1751904727,1751904727.2250109,-18000,EB445137-D7F5-57EC-87DA-1DB460D64046,"iPhone13,2"
com.apple.news,36,1751904666,1751904702,1751904702.4366388,-18000,EB445137-D7F5-57EC-87DA-1DB460D64046,"iPhone13,2"
com.apple.CoreAuthUI,4,1751904611,1751904615,1751904615.4013472,-18000,EB445137-D7F5-57EC-87DA-1DB460D64046,"iPhone13,2"
com.truebill.truebillnative,56,1751904603,1751904659,1751904659.851244,-18000,EB445137-D7F5-57EC-87DA-1DB460D64046,"iPhone13,2"
com.doordash.dasher,13,1751904587,1751904600,1751904600.3304281,-18000,EB445137-D7F5-57EC-87DA-1DB460D64046,"iPhone13,2"
com.strava.stravaride,71,1751904507,1751904578,1751904578.283835,-18000,EB445137-D7F5-57EC-87DA-1DB460D64046,"iPhone13,2"
com.doordash.dasher,5,1751904491,1751904496,1751904496.205037,-18000,EB445137-D7F5-57EC-87DA-1DB460D64046,"iPhone13,2"
com.doordash.dasher,5,1751904482,1751904487,1751904487.891368,-18000,EB445137-D7F5-57EC-87DA-1DB460D64046,"iPhone13,2"
com.doordash.dasher,180,1751904294,1751904474,1751904474.31457,-18000,EB445137-D7F5-57EC-87DA-1DB460D64046,"iPhone13,2"
com.doordash.dasher,101,1751904191,1751904292,1751904292.872879,-18000,EB445137-D7F5-57EC-87DA-1DB460D64046,"iPhone13,2"
com.doordash.dasher,126,1751904064,1751904190,1751904190.415,-18000,EB445137-D7F5-57EC-87DA-1DB460D64046,"iPhone13,2"
com.doordash.dasher,335,1751903728,1751904063,1751904063.656024,-18000,EB445137-D7F5-57EC-87DA-1DB460D64046,"iPhone13,2"
com.doordash.dasher,79,1751903631,1751903710,1751903710.593552,-18000,EB445137-D7F5-57EC-87DA-1DB460D64046,"iPhone13,2"
com.doordash.dasher,1,1751903629,1751903630,1751903630.791175,-18000,EB445137-D7F5-57EC-87DA-1DB460D64046,"iPhone13,2"
com.doordash.dasher,104,1751903396,1751903500,1751903500.279416,-18000,EB445137-D7F5-57EC-87DA-1DB460D64046,"iPhone13,2"
com.apple.podcasts,23,1751903373,1751903396,1751903396.497263,-18000,EB445137-D7F5-57EC-87DA-1DB460D64046,"iPhone13,2"
com.doordash.dasher,3,1751903370,1751903373,1751903373.425188,-18000,EB445137-D7F5-57EC-87DA-1DB460D64046,"iPhone13,2"
com.doordash.dasher,21,1751903300,1751903321,1751903321.2452888,-18000,EB445137-D7F5-57EC-87DA-1DB460D64046,"iPhone13,2"
com.doordash.dasher,117,1751903133,1751903250,1751903251.1489549,-18000,EB445137-D7F5-57EC-87DA-1DB460D64046,"iPhone13,2"
com.apple.Health,15,1751899531,1751899546,1751899546.563755,-18000,EB445137-D7F5-57EC-87DA-1DB460D64046,"iPhone13,2"
com.renpho.health,0,1751899531,1751899531,1751899532.306402,-18000,EB445137-D7F5-57EC-87DA-1DB460D64046,"iPhone13,2"
com.renpho.health,18,1751898676,1751898694,1751898694.72035,-18000,EB445137-D7F5-57EC-87DA-1DB460D64046,"iPhone13,2"
com.apple.news,1097,1751897383,1751898480,1751898480.372828,-18000,EB445137-D7F5-57EC-87DA-1DB460D64046,"iPhone13,2"
com.apple.weather,3,1751897363,1751897366,1751897366.841042,-18000,EB445137-D7F5-57EC-87DA-1DB460D64046,"iPhone13,2"
com.apple.weather,61,1751896156,1751896217,1751896218.0684628,-18000,EB445137-D7F5-57EC-87DA-1DB460D64046,"iPhone13,2"
com.apple.Music,95,1751856789,1751856884,1751856884.87002,-18000,EB445137-D7F5-57EC-87DA-1DB460D64046,"iPhone13,2"
com.apple.finder,3,1751856682,1751856685,1751856685.691306,-18000,,
com.apple.Preview,306,1751856376,1751856682,1751856682.739497,-18000,,
com.apple.Notes,2,1751856374,1751856376,1751856376.183116,-18000,,
com.google.Chrome,594,1751855780,1751856374,1751856375.000533,-18000,,
com.google.Chrome,2951,1751847620,1751850571,1751850571.493721,-18000,,
com.apple.iCal,36,1751847584,1751847620,1751847620.216531,-18000,,
com.google.Chrome,3050,1751844534,1751847584,1751847584.7324061,-18000,,
com.apple.Notes,41,1751844493,1751844534,1751844534.937057,-18000,,
com.apple.Notes,22,1751841243,1751841265,1751841265.992783,-18000,,
com.apple.Preview,1,1751841242,1751841243,1751841243.4067268,-18000,,
com.google.Chrome,58,1751841184,1751841242,1751841242.528908,-18000,,
com.apple.Preview,3,1751841181,1751841184,1751841184.497189,-18000,,
com.google.Chrome,24,1751841157,1751841181,1751841181.678362,-18000,,
com.apple.Preview,12,1751841145,1751841157,1751841157.344976,-18000,,
com.google.Chrome,1,1751841144,1751841145,1751841145.400766,-18000,,
com.apple.Notes,11,1751841133,1751841144,1751841144.1552958,-18000,,
com.google.Chrome,4,1751841129,1751841133,1751841133.971586,-18000,,
com.apple.Preview,8,1751841121,1751841129,1751841129.8718839,-18000,,
com.google.Chrome,14,1751841107,1751841121,1751841121.89146,-18000,,
com.apple.Notes,11,1751841096,1751841107,1751841107.2152848,-18000,,
com.google.Chrome,4,1751841092,1751841096,1751841096.231697,-18000,,
com.apple.Notes,5,1751841087,1751841092,1751841092.986287,-18000,,
com.google.Chrome,5,1751841082,1751841087,1751841087.1386418,-18000,,
com.apple.Notes,14,1751841068,1751841082,1751841082.761807,-18000,,
com.google.Chrome,22,1751841046,1751841068,1751841068.117202,-18000,,
com.apple.Notes,5,1751841041,1751841046,1751841046.3305101,-18000,,
com.google.Chrome,847,1751840194,1751841041,1751841041.4025931,-18000,,
com.apple.Preview,13,1751840181,1751840194,1751840194.789552,-18000,,
com.google.Chrome,163,1751840018,1751840181,1751840181.9827728,-18000,,
com.apple.Preview,1,1751840017,1751840018,1751840018.76643,-18000,,
com.google.Chrome,2,1751840015,1751840017,1751840017.822398,-18000,,
com.apple.Preview,1,1751840014,1751840015,1751840015.875732,-18000,,
com.google.Chrome,87,1751839927,1751840014,1751840014.4137192,-18000,,
com.apple.Preview,109,1751839818,1751839927,1751839927.880293,-18000,,
com.apple.finder,4,1751839814,1751839818,1751839818.214632,-18000,,
com.google.Chrome,1,1751839813,1751839814,1751839814.933377,-18000,,
com.google.Chrome,2738,1751835176,1751837914,1751837915.092599,-18000,,
com.google.Chrome,1728,1751833179,1751834907,1751834907.153452,-18000,,
com.google.Chrome,1557,1751831435,1751832992,1751832992.555798,-18000,,
com.google.Chrome,6,1751827094,1751827100,1751827100.352117,-18000,,
com.leomehlig.today,22,1751827072,1751827094,1751827094.7122622,-18000,,
com.google.Chrome,212,1751826860,1751827072,1751827072.445942,-18000,,
com.leomehlig.today,10,1751826850,1751826860,1751826860.714248,-18000,,
com.apple.finder,10,1751826840,1751826850,1751826850.539114,-18000,,
com.google.Chrome,2,1751826838,1751826840,1751826840.384501,-18000,,
com.tableausoftware.tableaudesktop,92,1751826746,1751826838,1751826839.045929,-18000,,
com.google.Chrome,90,1751826656,1751826746,1751826746.9125261,-18000,,
com.tableausoftware.tableaudesktop,15,1751826641,1751826656,1751826656.672044,-18000,,
com.apple.finder,3,1751826638,1751826641,1751826641.367094,-18000,,
com.tableausoftware.tableaudesktop,76,1751826562,1751826638,1751826638.851383,-18000,,
com.apple.finder,8,1751826554,1751826562,1751826562.837673,-18000,,
com.tableausoftware.tableaudesktop,2,1751826552,1751826554,1751826554.2150412,-18000,,
com.apple.finder,1,1751826551,1751826552,1751826552.273922,-18000,,
com.tableausoftware.tableaudesktop,153,1751826398,1751826551,1751826551.9795961,-18000,,
com.google.Chrome,5,1751826393,1751826398,1751826398.176972,-18000,,
com.tableausoftware.tableaudesktop,15,1751826378,1751826393,1751826393.5185041,-18000,,
com.google.Chrome,1,1751826377,1751826378,1751826378.811759,-18000,,
com.tableausoftware.tableaudesktop,62,1751826315,1751826377,1751826377.423201,-18000,,
com.apple.finder,7,1751826308,1751826315,1751826315.10117,-18000,,
com.google.Chrome,2,1751826306,1751826308,1751826308.1025739,-18000,,
com.tableausoftware.tableaudesktop,160,1751826146,1751826306,1751826306.876673,-18000,,
com.tableausoftware.tableaudesktop,3,1751826143,1751826146,1751826146.2553082,-18000,,
com.tableausoftware.tableaudesktop,2,1751826141,1751826143,1751826143.903435,-18000,,
com.tableausoftware.tableaudesktop,281,1751825860,1751826141,1751826141.2570028,-18000,,
com.tableausoftware.tableaudesktop,73,1751825787,1751825860,1751825860.861517,-18000,,
com.google.Chrome,22,1751825765,1751825787,1751825787.5541081,-18000,,
com.tableausoftware.tableaudesktop,3,1751825762,1751825765,1751825765.534456,-18000,,
com.tableausoftware.tableaudesktop,2,1751825760,1751825762,1751825762.918091,-18000,,
com.tableausoftware.tableaudesktop,0,1751825760,1751825760,1751825760.237352,-18000,,
com.tableausoftware.tableaudesktop,8,1751825752,1751825760,1751825760.198056,-18000,,
com.google.Chrome,2,1751825750,1751825752,1751825752.965564,-18000,,
com.tableausoftware.tableaudesktop,137,1751825613,1751825750,1751825750.751237,-18000,,
com.tableausoftware.tableaudesktop,2,1751825611,1751825613,1751825613.863957,-18000,,
com.tableausoftware.tableaudesktop,2,1751825609,1751825611,1751825611.1102371,-18000,,
com.tableausoftware.tableaudesktop,184,1751825425,1751825609,1751825609.556652,-18000,,
com.google.Chrome,15,1751825410,1751825425,1751825425.395308,-18000,,
com.tableausoftware.tableaudesktop,12,1751825398,1751825410,1751825411.035489,-18000,,
com.google.Chrome,10,1751825388,1751825398,1751825398.538309,-18000,,
com.leomehlig.today,0,1751825388,1751825388,1751825388.963162,-18000,,
com.google.Chrome,1,1751825387,1751825388,1751825388.3188891,-18000,,
com.tableausoftware.tableaudesktop,3,1751825384,1751825387,1751825387.6573548,-18000,,
com.google.Chrome,2,1751825382,1751825384,1751825384.639598,-18000,,
com.tableausoftware.tableaudesktop,168,1751825214,1751825382,1751825382.453926,-18000,,
com.google.Chrome,3,1751825211,1751825214,1751825214.0676131,-18000,,
com.tableausoftware.tableaudesktop,21,1751825190,1751825211,1751825211.166908,-18000,,
com.google.Chrome,3,1751825187,1751825190,1751825190.84672,-18000,,
com.tableausoftware.tableaudesktop,1,1751825186,1751825187,1751825187.900173,-18000,,
com.tableausoftware.tableaudesktop,3,1751825183,1751825186,1751825186.1926332,-18000,,
com.tableausoftware.tableaudesktop,5,1751825178,1751825183,1751825183.265421,-18000,,
com.tableausoftware.tableaudesktop,9,1751825169,1751825178,1751825178.1115742,-18000,,
com.google.Chrome,2,1751825167,1751825169,1751825169.330216,-18000,,
com.tableausoftware.tableaudesktop,5,1751825162,1751825167,1751825167.698643,-18000,,
com.google.Chrome,123,1751825039,1751825162,1751825162.302033,-18000,,
com.tableausoftware.tableaudesktop,123,1751824916,1751825039,1751825039.687471,-18000,,
com.google.Chrome,10,1751824906,1751824916,1751824917.031946,-18000,,
com.tableausoftware.tableaudesktop,11,1751824895,1751824906,1751824906.453635,-18000,,
com.apple.finder,4,1751824891,1751824895,1751824895.5748549,-18000,,
com.google.Chrome,3,1751824888,1751824891,1751824891.163663,-18000,,
com.microsoft.Excel,5,1751824883,1751824888,1751824888.6639771,-18000,,
com.leomehlig.today,17,1751824866,1751824883,1751824883.919936,-18000,,
com.microsoft.Excel,0,1751824866,1751824866,1751824866.6941109,-18000,,
com.leomehlig.today,2,1751824864,1751824866,1751824866.329196,-18000,,
com.apple.finder,17,1751824847,1751824864,1751824864.760612,-18000,,
com.google.Chrome,1,1751824846,1751824847,1751824847.2763329,-18000,,
com.tableausoftware.tableaudesktop,133,1751824713,1751824846,1751824847.0213408,-18000,,
com.google.Chrome,24,1751824689,1751824713,1751824713.920135,-18000,,
com.tableausoftware.tableaudesktop,147,1751824542,1751824689,1751824689.5961199,-18000,,
com.google.Chrome,33,1751824509,1751824542,1751824542.6254458,-18000,,
com.tableausoftware.tableaudesktop,3,1751824506,1751824509,1751824509.929998,-18000,,
com.tableausoftware.tableaudesktop,5,1751824501,1751824506,1751824506.454698,-18000,,
com.tableausoftware.tableaudesktop,6,1751824495,1751824501,1751824501.401873,-18000,,
com.google.Chrome,7,1751824488,1751824495,1751824495.557746,-18000,,
com.tableausoftware.tableaudesktop,2,1751824486,1751824488,1751824488.522121,-18000,,
com.tableausoftware.tableaudesktop,11,1751824475,1751824486,1751824486.97127,-18000,,
com.google.Chrome,1,1751824474,1751824475,1751824475.204622,-18000,,
com.tableausoftware.tableaudesktop,19,1751824455,1751824474,1751824474.301175,-18000,,
com.google.Chrome,13,1751824442,1751824455,1751824455.130384,-18000,,
com.tableausoftware.tableaudesktop,404,1751824038,1751824442,1751824442.038158,-18000,,
com.google.Chrome,37,1751824001,1751824038,1751824038.506483,-18000,,
com.tableausoftware.tableaudesktop,50,1751823951,1751824001,1751824001.600941,-18000,,
com.google.Chrome,9,1751823942,1751823951,1751823951.0459929,-18000,,
com.tableausoftware.tableaudesktop,68,1751823874,1751823942,1751823942.490767,-18000,,
com.google.Chrome,5,1751823869,1751823874,1751823874.316577,-18000,,
com.tableausoftware.tableaudesktop,213,1751823656,1751823869,1751823869.6078238,-18000,,
com.google.Chrome,5,1751823651,1751823656,1751823656.42796,-18000,,
com.tableausoftware.tableaudesktop,3,1751823648,1751823651,1751823651.903028,-18000,,
com.google.Chrome,31,1751823617,1751823648,1751823648.9582849,-18000,,
com.tableausoftware.tableaudesktop,14,1751823603,1751823617,1751823617.0664,-18000,,
com.google.Chrome,19,1751823584,1751823603,1751823603.923595,-18000,,
com.tableausoftware.tableaudesktop,8,1751823576,1751823584,1751823584.314682,-18000,,
com.google.Chrome,10,1751823566,1751823576,1751823576.791354,-18000,,
com.tableausoftware.tableaudesktop,9,1751823557,1751823566,1751823566.9018211,-18000,,
com.google.Chrome,6,1751823551,1751823557,1751823557.153306,-18000,,
com.tableausoftware.tableaudesktop,43,1751823508,1751823551,1751823551.941335,-18000,,
com.google.Chrome,5,1751823503,1751823508,1751823508.867753,-18000,,
com.tableausoftware.tableaudesktop,6,1751823497,1751823503,1751823503.610239,-18000,,
com.apple.finder,6,1751823490,1751823496,1751823496.094455,-18000,,
com.apple.archiveutility,0,1751823490,1751823490,1751823490.7751632,-18000,,
com.apple.finder,6,1751823484,1751823490,1751823490.3002481,-18000,,
com.google.Chrome,14,1751823470,1751823484,1751823484.707354,-18000,,
com.tableausoftware.tableaudesktop,1,1751823469,1751823470,1751823470.983824,-18000,,
com.google.Chrome,169,1751823293,1751823462,1751823462.422883,-18000,,
com.tableausoftware.tableaudesktop,97,1751823196,1751823293,1751823293.764299,-18000,,
com.google.Chrome,13,1751823183,1751823196,1751823196.805763,-18000,,
com.leomehlig.today,24,1751823159,1751823183,1751823183.255579,-18000,,
com.google.Chrome,3,1751823156,1751823159,1751823159.236608,-18000,,
com.leomehlig.today,3,1751823153,1751823156,1751823156.434633,-18000,,
com.google.Chrome,3,1751823150,1751823153,1751823153.727416,-18000,,
com.tableausoftware.tableaudesktop,85,1751823065,1751823150,1751823150.575634,-18000,,
com.google.Chrome,34,1751823031,1751823065,1751823065.7806768,-18000,,
com.tableausoftware.tableaudesktop,62,1751822969,1751823031,1751823031.483447,-18000,,
com.apple.iCal,11,1751822958,1751822969,1751822969.621038,-18000,,
com.tableausoftware.tableaudesktop,12,1751822946,1751822958,1751822958.37464,-18000,,
com.apple.finder,6,1751822940,1751822946,1751822946.232101,-18000,,
com.apple.iCal,0,1751822940,1751822940,1751822940.442772,-18000,,
com.apple.finder,1,1751822939,1751822940,1751822940.136061,-18000,,
com.apple.Notes,0,1751822939,1751822939,1751822939.457835,-18000,,
com.apple.finder,5,1751822934,1751822939,1751822939.168473,-18000,,
com.apple.installer,5,1751822929,1751822934,1751822934.253735,-18000,,
com.google.Chrome,9,1751822920,1751822929,1751822929.765914,-18000,,
com.apple.systempreferences,12,1751822908,1751822920,1751822920.886222,-18000,,
com.google.Chrome,33,1751822868,1751822901,1751822901.098127,-18000,,
com.apple.installer,29,1751822839,1751822868,1751822868.092418,-18000,,
com.apple.finder,3,1751822826,1751822829,1751822830.011561,-18000,,
com.apple.installer,0,1751822826,1751822826,1751822826.740129,-18000,,
com.apple.finder,2,1751822824,1751822826,1751822826.507561,-18000,,
com.apple.installer,1,1751822823,1751822824,1751822824.9684129,-18000,,
com.apple.finder,22,1751822801,1751822823,1751822823.806963,-18000,,
com.google.Chrome,2,1751822799,1751822801,1751822801.4511409,-18000,,
com.apple.Preview,34,1751822765,1751822799,1751822800.0676088,-18000,,
com.google.Chrome,6,1751822759,1751822765,1751822765.631577,-18000,,
com.apple.Preview,21,1751822738,1751822759,1751822759.806951,-18000,,
com.google.Chrome,27,1751822711,1751822738,1751822738.089448,-18000,,
com.apple.Preview,115,1751822588,1751822703,1751822703.192363,-18000,,
com.apple.finder,19,1751822569,1751822588,1751822588.794657,-18000,,
com.google.Chrome,719,1751821850,1751822569,1751822569.7853642,-18000,,
com.apple.Notes,4,1751821846,1751821850,1751821850.836988,-18000,,
com.google.Chrome,5,1751821841,1751821846,1751821846.4419851,-18000,,
com.apple.Notes,2,1751821839,1751821841,1751821841.068918,-18000,,
com.google.Chrome,6,1751821833,1751821839,1751821839.152207,-18000,,
com.apple.Notes,1,1751821832,1751821833,1751821833.7628422,-18000,,
com.google.Chrome,11,1751821821,1751821832,1751821832.4847531,-18000,,
com.apple.Notes,1,1751821820,1751821821,1751821821.1106071,-18000,,
com.apple.iCal,1,1751821819,1751821820,1751821820.080837,-18000,,
com.google.Chrome,147,1751821672,1751821819,1751821819.087671,-18000,,
com.apple.iCal,62,1751821524,1751821586,1751821586.960403,-18000,,
com.apple.Notes,5,1751821519,1751821524,1751821524.193068,-18000,,
com.google.Chrome,135,1751821384,1751821519,1751821519.529347,-18000,,
com.apple.Notes,3,1751821381,1751821384,1751821384.227758,-18000,,
com.google.Chrome,1,1751821380,1751821381,1751821381.895333,-18000,,
com.apple.Notes,15,1751821365,1751821380,1751821380.8998861,-18000,,
com.google.Chrome,2,1751821363,1751821365,1751821365.44658,-18000,,
com.apple.Notes,8,1751821355,1751821363,1751821363.400007,-18000,,
com.google.Chrome,63,1751821292,1751821355,1751821355.93994,-18000,,
com.apple.Notes,6,1751821286,1751821292,1751821292.351266,-18000,,
com.google.Chrome,2,1751821284,1751821286,1751821286.376581,-18000,,
com.apple.Notes,1,1751821283,1751821284,1751821284.1104221,-18000,,
com.google.Chrome,4,1751821279,1751821283,1751821283.10836,-18000,,
com.apple.Notes,3,1751821276,1751821279,1751821279.350457,-18000,,
com.google.Chrome,2,1751821274,1751821276,1751821276.7047849,-18000,,
com.apple.Notes,13,1751821261,1751821274,1751821274.459564,-18000,,
com.google.Chrome,52,1751821209,1751821261,1751821261.463673,-18000,,
com.apple.Notes,5,1751821204,1751821209,1751821209.209045,-18000,,
com.google.Chrome,38,1751821166,1751821204,1751821204.331931,-18000,,
com.apple.Notes,5,1751821161,1751821166,1751821166.955738,-18000,,
com.google.Chrome,65,1751821096,1751821161,1751821161.1551828,-18000,,
com.apple.Notes,5,1751821091,1751821096,1751821096.5711842,-18000,,
com.google.Chrome,65,1751821026,1751821091,1751821091.749711,-18000,,
com.google.Chrome,36,1751820725,1751820761,1751820761.214561,-18000,,
com.microsoft.VSCode,193,1751820532,1751820725,1751820725.306755,-18000,,
com.google.Chrome,17,1751820515,1751820532,1751820532.885467,-18000,,
com.microsoft.VSCode,1,1751820514,1751820515,1751820515.082869,-18000,,
com.google.Chrome,48,1751820466,1751820514,1751820514.17767,-18000,,
com.microsoft.VSCode,110,1751820356,1751820466,1751820466.9579592,-18000,,
com.google.Chrome,59,1751820297,1751820356,1751820356.21311,-18000,,
com.microsoft.VSCode,1,1751820296,1751820297,1751820298.616282,-18000,,
com.google.Chrome,24,1751820272,1751820296,1751820296.656289,-18000,,
com.microsoft.VSCode,2,1751820270,1751820272,1751820272.498946,-18000,,
com.google.Chrome,63,1751820207,1751820270,1751820270.9635139,-18000,,
com.microsoft.VSCode,1,1751820206,1751820207,1751820207.676508,-18000,,
com.google.Chrome,59,1751820147,1751820206,1751820206.46909,-18000,,
com.microsoft.VSCode,88,1751820059,1751820147,1751820147.808556,-18000,,
com.google.Chrome,61,1751819998,1751820059,1751820059.5220618,-18000,,
com.microsoft.VSCode,1,1751819997,1751819998,1751819998.908391,-18000,,
com.google.Chrome,60,1751819937,1751819997,1751819997.5743089,-18000,,
com.microsoft.VSCode,2,1751819935,1751819937,1751819937.492165,-18000,,
com.google.Chrome,80,1751819855,1751819935,1751819935.671375,-18000,,
com.microsoft.VSCode,2,1751819853,1751819855,1751819855.736484,-18000,,
com.google.Chrome,44,1751819809,1751819853,1751819854.035151,-18000,,
com.microsoft.VSCode,2,1751819807,1751819809,1751819809.124121,-18000,,
com.google.Chrome,92,1751819715,1751819807,1751819807.4241362,-18000,,
com.microsoft.VSCode,2,1751819713,1751819715,1751819715.7745528,-18000,,
com.google.Chrome,69,1751819644,1751819713,1751819713.3251429,-18000,,
com.microsoft.VSCode,153,1751819491,1751819644,1751819644.0748801,-18000,,
com.google.Chrome,5,1751819486,1751819491,1751819491.906577,-18000,,
com.microsoft.VSCode,3,1751819483,1751819486,1751819486.117694,-18000,,
com.google.Chrome,54,1751819429,1751819483,1751819483.470412,-18000,,
com.microsoft.VSCode,140,1751819289,1751819429,1751819429.875088,-18000,,
com.google.Chrome,66,1751819223,1751819289,1751819289.554652,-18000,,
com.microsoft.VSCode,2,1751819221,1751819223,1751819224.413755,-18000,,
com.google.Chrome,16,1751819205,1751819221,1751819221.933049,-18000,,
com.microsoft.VSCode,2909,1751816296,1751819205,1751819211.043734,-18000,,
com.apple.finder,2,1751816294,1751816296,1751816296.334753,-18000,,
com.leomehlig.today,1,1751816293,1751816294,1751816294.197362,-18000,,
com.apple.finder,2,1751816291,1751816293,1751816293.733799,-18000,,
com.apple.finder,15,1751772591,1751772606,1751772606.75669,-18000,,
com.leomehlig.today,30,1751772561,1751772591,1751772591.619451,-18000,,
com.apple.finder,1,1751772560,1751772561,1751772561.813504,-18000,,
com.apple.iCal,178,1751772382,1751772560,1751772560.443589,-18000,,
com.google.Chrome,987,1751771395,1751772382,1751772382.197919,-18000,,
com.apple.iCal,1,1751771394,1751771395,1751771395.107188,-18000,,
com.google.Chrome,5,1751771389,1751771394,1751771394.3150659,-18000,,
com.apple.iCal,0,1751771389,1751771389,1751771389.748653,-18000,,
com.google.Chrome,1,1751771388,1751771389,1751771389.208875,-18000,,
com.apple.iCal,0,1751771388,1751771388,1751771388.479899,-18000,,
com.google.Chrome,5,1751771383,1751771388,1751771388.099588,-18000,,
com.apple.iCal,2,1751771381,1751771383,1751771383.764752,-18000,,
com.google.Chrome,15,1751771366,1751771381,1751771381.361089,-18000,,
com.apple.iCal,196,1751771170,1751771366,1751771366.077516,-18000,,
com.google.Chrome,2,1751771168,1751771170,1751771170.09968,-18000,,
com.apple.iCal,14,1751771154,1751771168,1751771168.457806,-18000,,
com.google.Chrome,13,1751771141,1751771154,1751771154.6017308,-18000,,
com.apple.iCal,23,1751771118,1751771141,1751771142.005707,-18000,,
com.google.Chrome,6,1751771112,1751771118,1751771118.890147,-18000,,
com.apple.iCal,0,1751771112,1751771112,1751771112.832977,-18000,,
com.google.Chrome,1,1751771111,1751771112,1751771112.348376,-18000,,
com.apple.iCal,1,1751771110,1751771111,1751771111.117408,-18000,,
com.google.Chrome,6,1751771104,1751771110,1751771110.8339329,-18000,,
com.apple.iCal,1,1751771103,1751771104,1751771104.498483,-18000,,
com.google.Chrome,5,1751771098,1751771103,1751771103.338152,-18000,,
com.apple.iCal,5,1751771093,1751771098,1751771098.550259,-18000,,
com.google.Chrome,1,1751771092,1751771093,1751771093.103652,-18000,,
com.apple.iCal,10,1751771082,1751771092,1751771092.678073,-18000,,
com.google.Chrome,2,1751771080,1751771082,1751771082.639566,-18000,,
com.apple.iCal,10,1751771070,1751771080,1751771080.4462829,-18000,,
com.google.Chrome,1,1751771069,1751771070,1751771070.652484,-18000,,
com.apple.iCal,1,1751771068,1751771069,1751771069.219738,-18000,,
com.google.Chrome,22,1751771046,1751771068,1751771068.1394339,-18000,,
com.apple.iCal,88,1751770958,1751771046,1751771046.138545,-18000,,
com.google.Chrome,36,1751770922,1751770958,1751770958.988415,-18000,,
com.google.Chrome,3935,1751766637,1751770572,1751770572.385644,-18000,,
com.google.Chrome,1269,1751765214,1751766483,1751766483.18174,-18000,,
com.google.Chrome,320,1751764581,1751764901,1751764901.080651,-18000,,
com.google.Chrome,4,1751751891,1751751895,1751751895.9976459,-18000,,
com.leomehlig.today,6,1751751885,1751751891,1751751891.736969,-18000,,
com.google.Chrome,44,1751751841,1751751885,1751751885.144702,-18000,,
com.google.Chrome,281,1751750722,1751751003,1751751003.8619962,-18000,,
com.google.Chrome,324,1751749564,1751749888,1751749888.923176,-18000,,
com.google.Chrome,353,1751747736,1751748089,1751748089.490874,-18000,,
com.google.Chrome,1212,1751746054,1751747266,1751747266.831873,-18000,,
com.apple.finder,4,1751746050,1751746054,1751746054.646298,-18000,,
com.google.Chrome,81,1751745969,1751746050,1751746051.524932,-18000,,
com.leomehlig.today,27,1751745927,1751745954,1751745954.819196,-18000,,
com.apple.Notes,0,1751745927,1751745927,1751745929.7207708,-18000,,
com.google.Chrome,4,1751745923,1751745927,1751745929.313642,-18000,,
com.electron.carta,3,1751745920,1751745923,1751745924.571333,-18000,,
com.electron.carta,34,1751739951,1751739985,1751739985.943124,-18000,,
com.electron.carta,94,1751739856,1751739950,1751739950.968256,-18000,,
com.google.Chrome,8,1751739848,1751739856,1751739856.3037171,-18000,,
com.leomehlig.today,43,1751739805,1751739848,1751739848.868027,-18000,,
com.google.Chrome,135,1751739670,1751739805,1751739805.798863,-18000,,
com.electron.carta,1,1751739669,1751739670,1751739670.690284,-18000,,
com.apple.finder,2,1751739667,1751739669,1751739670.005686,-18000,,
com.electron.carta,1,1751739666,1751739667,1751739668.000081,-18000,,
com.google.Chrome,12,1751739654,1751739666,1751739666.820776,-18000,,
com.electron.carta,6,1751739648,1751739654,1751739654.634104,-18000,,
com.apple.finder,18,1751739630,1751739648,1751739648.590084,-18000,,
com.google.Chrome,68,1751739562,1751739630,1751739630.0842938,-18000,,
com.electron.carta,13,1751739549,1751739562,1751739562.312887,-18000,,
com.google.Chrome,92,1751739457,1751739549,1751739549.3903651,-18000,,
com.electron.carta,112,1751739345,1751739457,1751739457.458767,-18000,,
com.google.Chrome,242,1751739103,1751739345,1751739346.0525532,-18000,,
com.electron.carta,1,1751739102,1751739103,1751739103.406204,-18000,,
com.google.Chrome,32,1751739070,1751739102,1751739102.4747128,-18000,,
com.electron.carta,3,1751739067,1751739070,1751739070.342245,-18000,,
com.google.Chrome,12,1751739055,1751739067,1751739067.571105,-18000,,
com.electron.carta,17,1751739038,1751739055,1751739055.328371,-18000,,
com.google.Chrome,101,1751738937,1751739038,1751739038.388313,-18000,,
com.electron.carta,16,1751738921,1751738937,1751738937.3899179,-18000,,
com.google.Chrome,45,1751738876,1751738921,1751738921.669478,-18000,,
com.electron.carta,27,1751738849,1751738876,1751738877.0146341,-18000,,
com.google.Chrome,279,1751738570,1751738849,1751738849.1040468,-18000,,
com.electron.carta,20,1751738550,1751738570,1751738570.064241,-18000,,
com.apple.finder,16,1751738534,1751738550,1751738550.709968,-18000,,
com.electron.carta,81,1751738453,1751738534,1751738534.595849,-18000,,
com.google.Chrome,85,1751738368,1751738453,1751738454.01199,-18000,,
com.electron.carta,45,1751738323,1751738368,1751738368.657449,-18000,,
com.apple.finder,2,1751738321,1751738323,1751738323.3475509,-18000,,
com.google.Chrome,4,1751738317,1751738321,1751738321.247795,-18000,,
com.electron.carta,9,1751738308,1751738317,1751738317.085483,-18000,,
com.google.Chrome,59,1751738249,1751738308,1751738308.789784,-18000,,
com.burbn.instagram,126,1751738022,1751738148,1751738148.614863,-18000,EB445137-D7F5-57EC-87DA-1DB460D64046,"iPhone13,2"
com.apple.findmy,9,1751738009,1751738018,1751738018.793458,-18000,EB445137-D7F5-57EC-87DA-1DB460D64046,"iPhone13,2"
com.apple.findmy,2,1751737998,1751738000,1751738001.288797,-18000,EB445137-D7F5-57EC-87DA-1DB460D64046,"iPhone13,2"
com.apple.Notes,272,1751737977,1751738249,1751738249.144247,-18000,,
com.apple.finder,18,1751737959,1751737977,1751737977.108365,-18000,,
com.apple.Passwords,1,1751737958,1751737959,1751737959.81047,-18000,,
com.google.Chrome,87,1751737871,1751737958,1751737958.436705,-18000,,
com.apple.findmy,13,1751737160,1751737173,1751737173.380502,-18000,EB445137-D7F5-57EC-87DA-1DB460D64046,"iPhone13,2"
com.google.Chrome,534,1751737115,1751737649,1751737649.8197289,-18000,,
com.google.Chrome,304,1751736774,1751737078,1751737078.433435,-18000,,
com.apple.findmy,5,1751735864,1751735869,1751735869.614541,-18000,EB445137-D7F5-57EC-87DA-1DB460D64046,"iPhone13,2"
com.google.chrome.ios,365,1751734075,1751734440,1751734440.577605,-18000,EB445137-D7F5-57EC-87DA-1DB460D64046,"iPhone13,2"
com.apple.news,5,1751734070,1751734075,1751734075.1842651,-18000,EB445137-D7F5-57EC-87DA-1DB460D64046,"iPhone13,2"
com.google.Chrome,4101,1751732520,1751736621,1751736621.474268,-18000,,
com.apple.news,323,1751732175,1751732498,1751732498.6454868,-18000,EB445137-D7F5-57EC-87DA-1DB460D64046,"iPhone13,2"
com.apple.Health,11,1751732157,1751732168,1751732168.937138,-18000,EB445137-D7F5-57EC-87DA-1DB460D64046,"iPhone13,2"
com.google.Gmail,65,1751732083,1751732148,1751732148.793087,-18000,EB445137-D7F5-57EC-87DA-1DB460D64046,"iPhone13,2"
com.apple.MobileSMS,96,1751731987,1751732083,1751732083.1570039,-18000,EB445137-D7F5-57EC-87DA-1DB460D64046,"iPhone13,2"
com.doordash.dasher,8,1751731974,1751731982,1751731982.910423,-18000,EB445137-D7F5-57EC-87DA-1DB460D64046,"iPhone13,2"
com.renpho.health,1,1751731973,1751731974,1751731974.7484112,-18000,EB445137-D7F5-57EC-87DA-1DB460D64046,"iPhone13,2"
com.renpho.health,30,1751731223,1751731253,1751731253.840239,-18000,EB445137-D7F5-57EC-87DA-1DB460D64046,"iPhone13,2"
com.apple.findmy,10,1751730358,1751730368,1751730370.0356212,-18000,EB445137-D7F5-57EC-87DA-1DB460D64046,"iPhone13,2"
com.apple.findmy,65,1751729441,1751729506,1751729507.883531,-18000,EB445137-D7F5-57EC-87DA-1DB460D64046,"iPhone13,2"
com.apple.findmy,16,1751729031,1751729047,1751729047.4364948,-18000,EB445137-D7F5-57EC-87DA-1DB460D64046,"iPhone13,2"
com.apple.mobiletimer,11,1751706598,1751706609,1751706609.582329,-18000,EB445137-D7F5-57EC-87DA-1DB460D64046,"iPhone13,2"
com.apple.Maps,4,1751706340,1751706344,1751706344.158358,-18000,EB445137-D7F5-57EC-87DA-1DB460D64046,"iPhone13,2"
com.apple.Maps,30,1751702524,1751702554,1751702554.8238459,-18000,EB445137-D7F5-57EC-87DA-1DB460D64046,"iPhone13,2"
com.apple.Maps,270,1751702176,1751702446,1751702446.8168712,-18000,EB445137-D7F5-57EC-87DA-1DB460D64046,"iPhone13,2"
com.apple.Maps,83,1751701818,1751701901,1751701902.031059,-18000,EB445137-D7F5-57EC-87DA-1DB460D64046,"iPhone13,2"
com.apple.Maps,28,1751701739,1751701767,1751701767.23574,-18000,EB445137-D7F5-57EC-87DA-1DB460D64046,"iPhone13,2"
com.apple.Maps,12,1751701704,1751701716,1751701717.079877,-18000,EB445137-D7F5-57EC-87DA-1DB460D64046,"iPhone13,2"
com.apple.mobileslideshow,2,1751701702,1751701704,1751701704.8570871,-18000,EB445137-D7F5-57EC-87DA-1DB460D64046,"iPhone13,2"
com.apple.mobileslideshow,3,1751701671,1751701674,1751701674.549114,-18000,EB445137-D7F5-57EC-87DA-1DB460D64046,"iPhone13,2"
com.apple.mobileslideshow,75,1751701590,1751701665,1751701665.8558002,-18000,EB445137-D7F5-57EC-87DA-1DB460D64046,"iPhone13,2"
com.apple.Maps,56,1751701531,1751701587,1751701587.2076879,-18000,EB445137-D7F5-57EC-87DA-1DB460D64046,"iPhone13,2"
com.apple.Maps,42,1751701461,1751701503,1751701504.228735,-18000,EB445137-D7F5-57EC-87DA-1DB460D64046,"iPhone13,2"
com.google.chrome.ios,5,1751701448,1751701453,1751701453.8899941,-18000,EB445137-D7F5-57EC-87DA-1DB460D64046,"iPhone13,2"
com.google.chrome.ios,2,1751700460,1751700462,1751700463.276283,-18000,EB445137-D7F5-57EC-87DA-1DB460D64046,"iPhone13,2"
com.google.chrome.ios,543,1751689571,1751690114,1751690114.2537742,-18000,EB445137-D7F5-57EC-87DA-1DB460D64046,"iPhone13,2"
com.apple.findmy,4,1751684679,1751684683,1751684683.826974,-18000,EB445137-D7F5-57EC-87DA-1DB460D64046,"iPhone13,2"
com.apple.findmy,6,1751684016,1751684022,1751684023.370945,-18000,EB445137-D7F5-57EC-87DA-1DB460D64046,"iPhone13,2"
com.apple.MobileSMS,21,1751677634,1751677655,1751677655.337971,-18000,EB445137-D7F5-57EC-87DA-1DB460D64046,"iPhone13,2"
com.apple.MobileSMS,1,1751677633,1751677634,1751677634.435017,-18000,EB445137-D7F5-57EC-87DA-1DB460D64046,"iPhone13,2"
com.apple.MobileSMS,34,1751677593,1751677627,1751677627.4695668,-18000,EB445137-D7F5-57EC-87DA-1DB460D64046,"iPhone13,2"
com.toyopagroup.picaboo,4,1751677588,1751677592,1751677592.471058,-18000,EB445137-D7F5-57EC-87DA-1DB460D64046,"iPhone13,2"
com.apple.MobileSMS,0,1751677588,1751677588,1751677588.851948,-18000,EB445137-D7F5-57EC-87DA-1DB460D64046,"iPhone13,2"
com.apple.MobileSMS,76,1751677494,1751677570,1751677570.5200381,-18000,EB445137-D7F5-57EC-87DA-1DB460D64046,"iPhone13,2"
com.toyopagroup.picaboo,0,1751677494,1751677494,1751677494.447835,-18000,EB445137-D7F5-57EC-87DA-1DB460D64046,"iPhone13,2"
com.toyopagroup.picaboo,8,1751677180,1751677188,1751677189.2316918,-18000,EB445137-D7F5-57EC-87DA-1DB460D64046,"iPhone13,2"
com.apple.MobileSMS,8,1751677172,1751677180,1751677180.378333,-18000,EB445137-D7F5-57EC-87DA-1DB460D64046,"iPhone13,2"
com.toyopagroup.picaboo,39,1751677133,1751677172,1751677172.889412,-18000,EB445137-D7F5-57EC-87DA-1DB460D64046,"iPhone13,2"
com.apple.Maps,9,1751677124,1751677133,1751677133.7861109,-18000,EB445137-D7F5-57EC-87DA-1DB460D64046,"iPhone13,2"
com.apple.Maps,73,1751677046,1751677119,1751677119.6993809,-18000,EB445137-D7F5-57EC-87DA-1DB460D64046,"iPhone13,2"
com.toyopagroup.picaboo,7,1751677004,1751677011,1751677011.335792,-18000,EB445137-D7F5-57EC-87DA-1DB460D64046,"iPhone13,2"
com.apple.MobileSMS,0,1751677004,1751677004,1751677004.6202831,-18000,EB445137-D7F5-57EC-87DA-1DB460D64046,"iPhone13,2"
com.apple.MobileSMS,2,1751677000,1751677002,1751677002.160913,-18000,EB445137-D7F5-57EC-87DA-1DB460D64046,"iPhone13,2"
com.apple.findmy,1,1751676999,1751677000,1751677000.110229,-18000,EB445137-D7F5-57EC-87DA-1DB460D64046,"iPhone13,2"
com.apple.findmy,43,1751676803,1751676846,1751676846.798356,-18000,EB445137-D7F5-57EC-87DA-1DB460D64046,"iPhone13,2"
com.apple.findmy,10,1751676624,1751676634,1751676635.009726,-18000,EB445137-D7F5-57EC-87DA-1DB460D64046,"iPhone13,2"
com.google.Chrome,126,1751676576,1751676702,1751676702.322888,-18000,,
com.apple.MobileSMS,33,1751676543,1751676576,1751676576.39607,-18000,,
com.google.Chrome,3,1751676540,1751676543,1751676543.5750442,-18000,,
com.apple.MobileSMS,36,1751676504,1751676540,1751676540.657827,-18000,,
com.apple.findmy,35,1751676494,1751676529,1751676530.022898,-18000,EB445137-D7F5-57EC-87DA-1DB460D64046,"iPhone13,2"
com.apple.MobileSMS,3,1751676491,1751676494,1751676494.676282,-18000,EB445137-D7F5-57EC-87DA-1DB460D64046,"iPhone13,2"
com.apple.MobileSMS,5,1751676329,1751676334,1751676334.331187,-18000,EB445137-D7F5-57EC-87DA-1DB460D64046,"iPhone13,2"
com.toyopagroup.picaboo,3,1751676316,1751676319,1751676319.819058,-18000,EB445137-D7F5-57EC-87DA-1DB460D64046,"iPhone13,2"
com.apple.MobileSMS,0,1751676316,1751676316,1751676316.790073,-18000,EB445137-D7F5-57EC-87DA-1DB460D64046,"iPhone13,2"
com.apple.MobileSMS,31,1751676284,1751676315,1751676315.35788,-18000,EB445137-D7F5-57EC-87DA-1DB460D64046,"iPhone13,2"
com.apple.Maps,32,1751676252,1751676284,1751676284.621527,-18000,EB445137-D7F5-57EC-87DA-1DB460D64046,"iPhone13,2"
com.apple.findmy,6,1751676246,1751676252,1751676254.342392,-18000,EB445137-D7F5-57EC-87DA-1DB460D64046,"iPhone13,2"
com.toyopagroup.picaboo,4,1751676242,1751676246,1751676246.745843,-18000,EB445137-D7F5-57EC-87DA-1DB460D64046,"iPhone13,2"
com.apple.findmy,0,1751676242,1751676242,1751676242.87992,-18000,EB445137-D7F5-57EC-87DA-1DB460D64046,"iPhone13,2"
com.apple.findmy,13,1751675253,1751675266,1751675267.124738,-18000,EB445137-D7F5-57EC-87DA-1DB460D64046,"iPhone13,2"
com.apple.news,1,1751675252,1751675253,1751675253.697888,-18000,EB445137-D7F5-57EC-87DA-1DB460D64046,"iPhone13,2"
com.google.Chrome,1467,1751675037,1751676504,1751676504.769758,-18000,,
com.apple.news,5,1751674127,1751674132,1751674132.696507,-18000,EB445137-D7F5-57EC-87DA-1DB460D64046,"iPhone13,2"
com.apple.news,20,1751674106,1751674126,1751674127.142527,-18000,EB445137-D7F5-57EC-87DA-1DB460D64046,"iPhone13,2"
com.apple.news,67,1751673910,1751673977,1751673977.686634,-18000,EB445137-D7F5-57EC-87DA-1DB460D64046,"iPhone13,2"
com.apple.weather,2,1751673907,1751673909,1751673909.791772,-18000,EB445137-D7F5-57EC-87DA-1DB460D64046,"iPhone13,2"
com.google.Chrome,1919,1751673095,1751675014,1751675014.205689,-18000,,
com.apple.weather,31,1751672140,1751672171,1751672171.492731,-18000,EB445137-D7F5-57EC-87DA-1DB460D64046,"iPhone13,2"
com.toyopagroup.picaboo,23,1751671686,1751671709,1751671709.940985,-18000,EB445137-D7F5-57EC-87DA-1DB460D64046,"iPhone13,2"
com.apple.CoreAuthUI,2,1751671482,1751671484,1751671484.714777,-18000,EB445137-D7F5-57EC-87DA-1DB460D64046,"iPhone13,2"
com.google.Chrome,1351,1751671477,1751672828,1751672828.066931,-18000,,
com.discoverfinancial.mobile,105,1751671470,1751671575,1751671575.187329,-18000,EB445137-D7F5-57EC-87DA-1DB460D64046,"iPhone13,2"
com.apple.MobileSMS,2,1751671462,1751671464,1751671464.773263,-18000,EB445137-D7F5-57EC-87DA-1DB460D64046,"iPhone13,2"
com.apple.MobileSMS,9,1751671331,1751671340,1751671341.070648,-18000,EB445137-D7F5-57EC-87DA-1DB460D64046,"iPhone13,2"
com.toyopagroup.picaboo,4,1751671326,1751671330,1751671330.4770079,-18000,EB445137-D7F5-57EC-87DA-1DB460D64046,"iPhone13,2"
com.apple.MobileSMS,10,1751671314,1751671324,1751671324.7965,-18000,EB445137-D7F5-57EC-87DA-1DB460D64046,"iPhone13,2"
com.apple.CoreAuthUI,2,1751671276,1751671278,1751671278.2173839,-18000,EB445137-D7F5-57EC-87DA-1DB460D64046,"iPhone13,2"
com.clairmail.fth.client,43,1751671270,1751671313,1751671313.821775,-18000,EB445137-D7F5-57EC-87DA-1DB460D64046,"iPhone13,2"
com.toyopagroup.picaboo,2,1751671264,1751671266,1751671268.894306,-18000,EB445137-D7F5-57EC-87DA-1DB460D64046,"iPhone13,2"
com.apple.Passwords,7,1751671180,1751671187,1751671187.22837,-18000,,
com.google.Chrome,56,1751671124,1751671180,1751671180.389861,-18000,,
com.toyopagroup.picaboo,78,1751670923,1751671001,1751671002.305131,-18000,EB445137-D7F5-57EC-87DA-1DB460D64046,"iPhone13,2"
com.toyopagroup.picaboo,70,1751670745,1751670815,1751670815.1214929,-18000,EB445137-D7F5-57EC-87DA-1DB460D64046,"iPhone13,2"
com.toyopagroup.picaboo,8,1751669786,1751669794,1751669794.429335,-18000,EB445137-D7F5-57EC-87DA-1DB460D64046,"iPhone13,2"
com.google.chrome.ios,175,1751669598,1751669773,1751669773.901465,-18000,EB445137-D7F5-57EC-87DA-1DB460D64046,"iPhone13,2"
com.google.chrome.ios,712,1751668761,1751669473,1751669473.7940578,-18000,EB445137-D7F5-57EC-87DA-1DB460D64046,"iPhone13,2"
com.toyopagroup.picaboo,2,1751668759,1751668761,1751668761.403199,-18000,EB445137-D7F5-57EC-87DA-1DB460D64046,"iPhone13,2"
com.toyopagroup.picaboo,98,1751668553,1751668651,1751668652.347529,-18000,EB445137-D7F5-57EC-87DA-1DB460D64046,"iPhone13,2"
com.apple.news,0,1751668553,1751668553,1751668554.535183,-18000,EB445137-D7F5-57EC-87DA-1DB460D64046,"iPhone13,2"
com.apple.news,747,1751667538,1751668285,1751668286.669374,-18000,EB445137-D7F5-57EC-87DA-1DB460D64046,"iPhone13,2"
com.thestorygraph.thestorygraph,10,1751667522,1751667532,1751667532.7217789,-18000,EB445137-D7F5-57EC-87DA-1DB460D64046,"iPhone13,2"
com.doordash.dasher,15,1751667502,1751667517,1751667517.855201,-18000,EB445137-D7F5-57EC-87DA-1DB460D64046,"iPhone13,2"
com.apple.calculator,7,1751667495,1751667502,1751667502.89194,-18000,EB445137-D7F5-57EC-87DA-1DB460D64046,"iPhone13,2"
com.doordash.dasher,13,1751667482,1751667495,1751667495.3234348,-18000,EB445137-D7F5-57EC-87DA-1DB460D64046,"iPhone13,2"
com.doordash.dasher,65,1751667416,1751667481,1751667481.074415,-18000,EB445137-D7F5-57EC-87DA-1DB460D64046,"iPhone13,2"
com.apple.weather,9,1751667243,1751667252,1751667252.785187,-18000,EB445137-D7F5-57EC-87DA-1DB460D64046,"iPhone13,2"
com.toyopagroup.picaboo,16,1751667227,1751667243,1751667243.9627619,-18000,EB445137-D7F5-57EC-87DA-1DB460D64046,"iPhone13,2"
com.truebill.truebillnative,2,1751667225,1751667227,1751667227.217974,-18000,EB445137-D7F5-57EC-87DA-1DB460D64046,"iPhone13,2"
com.google.Chrome,656,1751666727,1751667383,1751667383.679223,-18000,,
com.google.Chrome,687,1751665898,1751666585,1751666585.332084,-18000,,
com.google.Chrome,871,1751664823,1751665694,1751665694.621274,-18000,,
com.google.Chrome,300,1751664058,1751664358,1751664358.599926,-18000,,
com.google.Chrome,1162,1751662707,1751663869,1751663869.2850552,-18000,,
com.truebill.truebillnative,155,1751662533,1751662688,1751662688.902206,-18000,EB445137-D7F5-57EC-87DA-1DB460D64046,"iPhone13,2"
com.truebill.truebillnative,32,1751662322,1751662354,1751662355.0742822,-18000,EB445137-D7F5-57EC-87DA-1DB460D64046,"iPhone13,2"
com.apple.CoreAuthUI,2,1751662162,1751662164,1751662164.3768659,-18000,EB445137-D7F5-57EC-87DA-1DB460D64046,"iPhone13,2"
com.robinhood.release.Robinhood,119,1751662160,1751662279,1751662279.1907492,-18000,EB445137-D7F5-57EC-87DA-1DB460D64046,"iPhone13,2"
com.truebill.truebillnative,2,1751662157,1751662159,1751662159.872247,-18000,EB445137-D7F5-57EC-87DA-1DB460D64046,"iPhone13,2"
com.truebill.truebillnative,193,1751661862,1751662055,1751662055.802857,-18000,EB445137-D7F5-57EC-87DA-1DB460D64046,"iPhone13,2"
com.doordash.dasher,27,1751661835,1751661862,1751661862.347064,-18000,EB445137-D7F5-57EC-87DA-1DB460D64046,"iPhone13,2"
com.doordash.dasher,1,1751661834,1751661835,1751661835.37308,-18000,EB445137-D7F5-57EC-87DA-1DB460D64046,"iPhone13,2"
com.doordash.dasher,49,1751661783,1751661832,1751661833.182759,-18000,EB445137-D7F5-57EC-87DA-1DB460D64046,"iPhone13,2"
com.truebill.truebillnative,19,1751661763,1751661782,1751661782.2282372,-18000,EB445137-D7F5-57EC-87DA-1DB460D64046,"iPhone13,2"
com.apple.CoreAuthUI,3,1751661727,1751661730,1751661730.0279741,-18000,EB445137-D7F5-57EC-87DA-1DB460D64046,"iPhone13,2"
com.truebill.truebillnative,34,1751661726,1751661760,1751661760.5005221,-18000,EB445137-D7F5-57EC-87DA-1DB460D64046,"iPhone13,2"
com.truebill.truebillnative,2,1751661724,1751661726,1751661726.6923652,-18000,EB445137-D7F5-57EC-87DA-1DB460D64046,"iPhone13,2"
com.apple.CoreAuthUI,3,1751661356,1751661359,1751661359.431853,-18000,EB445137-D7F5-57EC-87DA-1DB460D64046,"iPhone13,2"
com.truebill.truebillnative,148,1751661347,1751661495,1751661495.204015,-18000,EB445137-D7F5-57EC-87DA-1DB460D64046,"iPhone13,2"
com.apple.finder,1,1751661227,1751661228,1751661228.835253,-18000,,
com.apple.finder,5,1751661187,1751661192,1751661192.162704,-18000,,
com.apple.Music,3,1751661184,1751661187,1751661187.212445,-18000,,
com.apple.finder,8,1751661176,1751661184,1751661184.3066359,-18000,,
com.apple.Notes,6,1751661170,1751661176,1751661176.297226,-18000,,
com.apple.finder,1,1751661169,1751661170,1751661170.681205,-18000,,
com.microsoft.VSCode,24,1751661145,1751661169,1751661169.569413,-18000,,
com.leomehlig.today,0,1751661145,1751661145,1751661145.892077,-18000,,
com.google.Chrome,46,1751661099,1751661145,1751661145.4951591,-18000,,
com.leomehlig.today,2,1751661084,1751661086,1751661086.838907,-18000,,
com.google.Chrome,250,1751660834,1751661084,1751661084.334262,-18000,,
com.microsoft.VSCode,157,1751660677,1751660834,1751660834.632786,-18000,,
com.apple.finder,5,1751660672,1751660677,1751660677.3004599,-18000,,
com.microsoft.VSCode,1,1751660671,1751660672,1751660672.4553409,-18000,,
com.apple.finder,3,1751660668,1751660671,1751660671.023353,-18000,,
com.microsoft.VSCode,0,1751660668,1751660668,1751660668.972633,-18000,,
com.apple.finder,15,1751660653,1751660668,1751660668.231866,-18000,,
com.google.Chrome,14,1751660639,1751660653,1751660653.604516,-18000,,
com.apple.finder,1,1751660638,1751660639,1751660639.490176,-18000,,
com.microsoft.VSCode,6,1751660632,1751660638,1751660638.721797,-18000,,
com.apple.finder,3,1751660629,1751660632,1751660632.421029,-18000,,
com.microsoft.VSCode,16,1751660613,1751660629,1751660629.762177,-18000,,
com.google.Chrome,2,1751660611,1751660613,1751660613.111594,-18000,,
com.microsoft.VSCode,112,1751660499,1751660611,1751660611.229928,-18000,,
com.google.Chrome,8,1751660491,1751660499,1751660499.0789762,-18000,,
com.microsoft.VSCode,80,1751660411,1751660491,1751660491.793808,-18000,,
com.google.Chrome,23,1751660388,1751660411,1751660411.989811,-18000,,
com.microsoft.VSCode,9,1751660379,1751660388,1751660388.129962,-18000,,
com.google.Chrome,18,1751660361,1751660379,1751660379.119415,-18000,,
com.microsoft.VSCode,50,1751660311,1751660361,1751660361.4467812,-18000,,
com.google.Chrome,19,1751660292,1751660311,1751660311.597126,-18000,,
com.microsoft.VSCode,11,1751660281,1751660292,1751660292.901582,-18000,,
com.google.Chrome,4,1751660277,1751660281,1751660281.600291,-18000,,
com.microsoft.VSCode,4,1751660273,1751660277,1751660277.721062,-18000,,
com.google.Chrome,12,1751660261,1751660273,1751660273.2554178,-18000,,
com.microsoft.VSCode,76,1751660185,1751660261,1751660261.796371,-18000,,
com.apple.finder,17,1751660168,1751660185,1751660185.638606,-18000,,
com.google.Chrome,32,1751660136,1751660168,1751660168.437423,-18000,,
com.apple.Notes,10,1751660126,1751660136,1751660136.983862,-18000,,
com.google.Chrome,172,1751659954,1751660126,1751660126.801096,-18000,,
com.apple.Notes,13,1751659941,1751659954,1751659954.0987449,-18000,,
com.google.Chrome,176,1751659765,1751659941,1751659941.871725,-18000,,
com.apple.Notes,6,1751659759,1751659765,1751659765.264761,-18000,,
com.google.Chrome,8,1751659751,1751659759,1751659759.220694,-18000,,
com.apple.Notes,9,1751659742,1751659751,1751659751.881593,-18000,,
com.google.Chrome,432,1751659310,1751659742,1751659742.241963,-18000,,
com.apple.Notes,10,1751659300,1751659310,1751659310.236106,-18000,,
com.google.Chrome,110,1751659190,1751659300,1751659300.9113789,-18000,,
com.apple.Notes,12,1751659178,1751659190,1751659190.552576,-18000,,
com.hammerandchisel.discord,109,1751658556,1751658665,1751658666.075685,-18000,EB445137-D7F5-57EC-87DA-1DB460D64046,"iPhone13,2"
com.google.Chrome,693,1751658485,1751659178,1751659178.926157,-18000,,
com.apple.Notes,20,1751658465,1751658485,1751658485.446265,-18000,,
com.google.Chrome,592,1751657873,1751658465,1751658465.518659,-18000,,
com.apple.Notes,45,1751657828,1751657873,1751657873.212136,-18000,,
com.apple.news,167,1751657461,1751657628,1751657628.404069,-18000,EB445137-D7F5-57EC-87DA-1DB460D64046,"iPhone13,2"
com.apple.Notes,317,1751657406,1751657723,1751657723.6049562,-18000,,
com.google.Chrome,19,1751657387,1751657406,1751657406.3003201,-18000,,
com.microsoft.VSCode,39,1751657348,1751657387,1751657387.7464318,-18000,,
com.google.Chrome,108,1751657240,1751657348,1751657348.5784302,-18000,,
com.apple.finder,11,1751657229,1751657240,1751657240.422442,-18000,,
com.apple.MobileSMS,66,1751656835,1751656901,1751656901.901279,-18000,EB445137-D7F5-57EC-87DA-1DB460D64046,"iPhone13,2"
com.apple.Health,2,1751656832,1751656834,1751656834.550219,-18000,EB445137-D7F5-57EC-87DA-1DB460D64046,"iPhone13,2"
com.google.Chrome,544,1751656685,1751657229,1751657229.139787,-18000,,
com.apple.finder,10,1751656675,1751656685,1751656685.283392,-18000,,
com.google.Chrome,61,1751656614,1751656675,1751656675.4653602,-18000,,
com.apple.finder,10,1751656604,1751656614,1751656614.917275,-18000,,
com.google.Chrome,3,1751656601,1751656604,1751656604.453652,-18000,,
com.apple.finder,13,1751656588,1751656601,1751656601.7367759,-18000,,
com.apple.Health,63,1751656371,1751656434,1751656435.37597,-18000,EB445137-D7F5-57EC-87DA-1DB460D64046,"iPhone13,2"
com.tier9digital.sundial,1,1751656370,1751656371,1751656371.780561,-18000,EB445137-D7F5-57EC-87DA-1DB460D64046,"iPhone13,2"
com.google.Chrome,622,1751655966,1751656588,1751656588.3808088,-18000,,
com.apple.finder,13,1751655953,1751655966,1751655966.243637,-18000,,
com.google.Chrome,63,1751655890,1751655953,1751655953.958725,-18000,,
com.apple.Music,86,1751655804,1751655890,1751655890.872113,-18000,,
com.google.Chrome,80,1751655724,1751655804,1751655804.077537,-18000,,
com.apple.finder,1,1751655723,1751655724,1751655724.623011,-18000,,
com.facebook.Facebook,143,1751655489,1751655632,1751655632.82535,-18000,EB445137-D7F5-57EC-87DA-1DB460D64046,"iPhone13,2"
com.strava.stravaride,2,1751655477,1751655479,1751655479.3494911,-18000,EB445137-D7F5-57EC-87DA-1DB460D64046,"iPhone13,2"
com.apple.CoreAuthUI,2,1751655465,1751655467,1751655467.347256,-18000,EB445137-D7F5-57EC-87DA-1DB460D64046,"iPhone13,2"
com.apple.CoreAuthUI,19,1751655446,1751655465,1751655465.161026,-18000,EB445137-D7F5-57EC-87DA-1DB460D64046,"iPhone13,2"
com.robinhood.release.Robinhood,41,1751655436,1751655477,1751655477.5479631,-18000,EB445137-D7F5-57EC-87DA-1DB460D64046,"iPhone13,2"
com.strava.stravaride,4,1751655422,1751655426,1751655426.567558,-18000,EB445137-D7F5-57EC-87DA-1DB460D64046,"iPhone13,2"
com.google.Chrome,434,1751655289,1751655723,1751655723.6529531,-18000,,
com.apple.finder,4,1751655285,1751655289,1751655289.169982,-18000,,
com.google.Chrome,2,1751655283,1751655285,1751655285.776402,-18000,,
com.apple.finder,13,1751655270,1751655283,1751655283.459649,-18000,,
com.google.Chrome,234,1751655036,1751655270,1751655270.262033,-18000,,
com.apple.finder,21,1751655015,1751655036,1751655036.457851,-18000,,
com.google.Chrome,104,1751654911,1751655015,1751655015.711415,-18000,,
com.microsoft.VSCode,2,1751654909,1751654911,1751654911.395426,-18000,,
com.google.Chrome,310,1751654599,1751654909,1751654909.795855,-18000,,
com.microsoft.VSCode,15,1751654584,1751654599,1751654599.405679,-18000,,
com.google.Chrome,2,1751654582,1751654584,1751654584.7432132,-18000,,
com.microsoft.VSCode,1,1751654581,1751654582,1751654582.863531,-18000,,
com.google.Chrome,2,1751654579,1751654581,1751654581.657174,-18000,,
com.microsoft.VSCode,1,1751654578,1751654579,1751654579.928278,-18000,,
com.google.Chrome,2,1751654576,1751654578,1751654579.044339,-18000,,
com.microsoft.VSCode,1,1751654575,1751654576,1751654576.723988,-18000,,
com.google.Chrome,5,1751654570,1751654575,1751654575.185007,-18000,,
com.microsoft.VSCode,16,1751654554,1751654570,1751654570.832296,-18000,,
com.google.Chrome,356,1751654198,1751654554,1751654554.377074,-18000,,
com.apple.Notes,22,1751654176,1751654198,1751654198.547601,-18000,,
com.google.Chrome,35,1751654141,1751654176,1751654176.628619,-18000,,
com.apple.Notes,5,1751654136,1751654141,1751654141.352237,-18000,,
com.leomehlig.today,19,1751654117,1751654136,1751654136.3511229,-18000,,
com.apple.iCal,26,1751654091,1751654117,1751654117.711073,-18000,,
com.leomehlig.today,19,1751654072,1751654091,1751654091.7256842,-18000,,
com.apple.Notes,29,1751654043,1751654072,1751654072.3250232,-18000,,
com.apple.MobileSMS,4,1751654039,1751654043,1751654043.753022,-18000,,
com.apple.Notes,3,1751654036,1751654039,1751654039.316543,-18000,,
com.google.Chrome,309,1751653727,1751654036,1751654036.559925,-18000,,
com.strava.stravaride,147,1751653578,1751653725,1751653726.382018,-18000,EB445137-D7F5-57EC-87DA-1DB460D64046,"iPhone13,2"
com.apple.MobileSMS,18,1751653322,1751653340,1751653340.278411,-18000,EB445137-D7F5-57EC-87DA-1DB460D64046,"iPhone13,2"
com.apple.MobileSMS,3,1751653319,1751653322,1751653322.2887769,-18000,EB445137-D7F5-57EC-87DA-1DB460D64046,"iPhone13,2"
com.apple.MobileSMS,15,1751650818,1751650833,1751650833.846764,-18000,EB445137-D7F5-57EC-87DA-1DB460D64046,"iPhone13,2"
com.apple.findmy,0,1751650818,1751650818,1751650819.933275,-18000,EB445137-D7F5-57EC-87DA-1DB460D64046,"iPhone13,2"
com.apple.findmy,7,1751646005,1751646012,1751646012.8268142,-18000,EB445137-D7F5-57EC-87DA-1DB460D64046,"iPhone13,2"
com.apple.MobileSMS,2,1751646003,1751646005,1751646005.911042,-18000,EB445137-D7F5-57EC-87DA-1DB460D64046,"iPhone13,2"
com.apple.MobileSMS,5,1751645983,1751645988,1751645988.6547642,-18000,EB445137-D7F5-57EC-87DA-1DB460D64046,"iPhone13,2"
com.strava.stravaride,258,1751645723,1751645981,1751645981.084382,-18000,EB445137-D7F5-57EC-87DA-1DB460D64046,"iPhone13,2"
com.apple.Fitness,6,1751645717,1751645723,1751645723.555649,-18000,EB445137-D7F5-57EC-87DA-1DB460D64046,"iPhone13,2"
com.strava.stravaride,40,1751645672,1751645712,1751645712.889344,-18000,EB445137-D7F5-57EC-87DA-1DB460D64046,"iPhone13,2"
com.apple.weather,5,1751645655,1751645660,1751645660.2846432,-18000,EB445137-D7F5-57EC-87DA-1DB460D64046,"iPhone13,2"
com.google.Chrome,1058,1751644968,1751646026,1751646026.5918288,-18000,,
com.apple.iCal,0,1751644968,1751644968,1751644968.8184261,-18000,,
com.google.Chrome,497,1751644471,1751644968,1751644968.118829,-18000,,
com.apple.iCal,1,1751644470,1751644471,1751644471.2698932,-18000,,
com.google.Chrome,13,1751644457,1751644470,1751644470.583881,-18000,,
com.apple.iCal,0,1751644457,1751644457,1751644458.0531259,-18000,,
com.google.Chrome,424,1751644033,1751644457,1751644457.3930821,-18000,,
com.apple.iCal,1,1751644032,1751644033,1751644033.726558,-18000,,
com.strava.stravaride,102,1751643918,1751644020,1751644021.1687288,-18000,EB445137-D7F5-57EC-87DA-1DB460D64046,"iPhone13,2"
com.truebill.truebillnative,1,1751643917,1751643918,1751643919.017468,-18000,EB445137-D7F5-57EC-87DA-1DB460D64046,"iPhone13,2"
com.google.Chrome,121,1751643911,1751644032,1751644032.9579802,-18000,,
com.apple.iCal,5,1751643528,1751643533,1751643533.282912,-18000,,
com.google.Chrome,3,1751643525,1751643528,1751643528.058604,-18000,,
com.apple.iCal,5,1751643520,1751643525,1751643525.86629,-18000,,
com.google.Chrome,4,1751643516,1751643520,1751643520.384386,-18000,,
com.apple.iCal,11,1751643505,1751643516,1751643516.152501,-18000,,
com.google.Chrome,20,1751643485,1751643505,1751643505.7706661,-18000,,
com.apple.iCal,7,1751643478,1751643485,1751643485.150723,-18000,,
com.google.Chrome,130,1751643348,1751643478,1751643478.24805,-18000,,
com.apple.iCal,8,1751643340,1751643348,1751643348.593472,-18000,,
com.google.Chrome,24,1751643316,1751643340,1751643340.3745341,-18000,,
com.apple.iCal,10,1751643306,1751643316,1751643316.920205,-18000,,
com.google.Chrome,23,1751643283,1751643306,1751643306.619879,-18000,,
com.apple.iCal,12,1751643271,1751643283,1751643283.450398,-18000,,
com.google.Chrome,9,1751643262,1751643271,1751643271.995575,-18000,,
com.apple.iCal,25,1751643237,1751643262,1751643262.160483,-18000,,
com.google.Chrome,48,1751643189,1751643237,1751643237.242673,-18000,,
com.apple.iCal,7,1751643182,1751643189,1751643189.490016,-18000,,
com.google.Chrome,49,1751643133,1751643182,1751643182.2985291,-18000,,
com.apple.iCal,21,1751643112,1751643133,1751643133.800702,-18000,,
com.apple.CoreAuthUI,2,1751643029,1751643031,1751643031.3460078,-18000,EB445137-D7F5-57EC-87DA-1DB460D64046,"iPhone13,2"
com.apple.CoreAuthUI,9,1751643007,1751643016,1751643016.657699,-18000,EB445137-D7F5-57EC-87DA-1DB460D64046,"iPhone13,2"
com.truebill.truebillnative,654,1751643006,1751643660,1751643661.197917,-18000,EB445137-D7F5-57EC-87DA-1DB460D64046,"iPhone13,2"
com.apple.findmy,1,1751643004,1751643005,1751643006.461355,-18000,EB445137-D7F5-57EC-87DA-1DB460D64046,"iPhone13,2"
com.google.Chrome,116,1751642996,1751643112,1751643112.311808,-18000,,
com.apple.findmy,9,1751642804,1751642813,1751642813.7430081,-18000,EB445137-D7F5-57EC-87DA-1DB460D64046,"iPhone13,2"
com.apple.MobileSMS,3,1751642800,1751642803,1751642803.431137,-18000,EB445137-D7F5-57EC-87DA-1DB460D64046,"iPhone13,2"
com.apple.MobileSMS,15,1751641477,1751641492,1751641492.080824,-18000,EB445137-D7F5-57EC-87DA-1DB460D64046,"iPhone13,2"
com.apple.weather,0,1751641477,1751641477,1751641478.318369,-18000,EB445137-D7F5-57EC-87DA-1DB460D64046,"iPhone13,2"
com.apple.weather,7,1751639631,1751639638,1751639638.617341,-18000,EB445137-D7F5-57EC-87DA-1DB460D64046,"iPhone13,2"
com.apple.mobilecal,2,1751639629,1751639631,1751639631.193146,-18000,EB445137-D7F5-57EC-87DA-1DB460D64046,"iPhone13,2"
com.apple.mobilecal,77,1751638647,1751638724,1751638724.772588,-18000,EB445137-D7F5-57EC-87DA-1DB460D64046,"iPhone13,2"
com.strava.stravaride,22,1751638073,1751638095,1751638095.8774629,-18000,EB445137-D7F5-57EC-87DA-1DB460D64046,"iPhone13,2"
com.apple.calculator,25,1751638048,1751638073,1751638073.223301,-18000,EB445137-D7F5-57EC-87DA-1DB460D64046,"iPhone13,2"
com.strava.stravaride,2,1751638046,1751638048,1751638048.101892,-18000,EB445137-D7F5-57EC-87DA-1DB460D64046,"iPhone13,2"
com.strava.stravaride,23,1751637914,1751637937,1751637937.359782,-18000,EB445137-D7F5-57EC-87DA-1DB460D64046,"iPhone13,2"
com.apple.calculator,2,1751637912,1751637914,1751637914.951237,-18000,EB445137-D7F5-57EC-87DA-1DB460D64046,"iPhone13,2"
com.apple.calculator,1,1751637869,1751637870,1751637871.035565,-18000,EB445137-D7F5-57EC-87DA-1DB460D64046,"iPhone13,2"
com.apple.calculator,7,1751637739,1751637746,1751637746.650694,-18000,EB445137-D7F5-57EC-87DA-1DB460D64046,"iPhone13,2"
com.apple.weather,2,1751637537,1751637539,1751637540.138269,-18000,EB445137-D7F5-57EC-87DA-1DB460D64046,"iPhone13,2"
com.strava.stravaride,22,1751637037,1751637059,1751637059.60779,-18000,EB445137-D7F5-57EC-87DA-1DB460D64046,"iPhone13,2"
com.google.Gmail,77,1751636960,1751637037,1751637037.452254,-18000,EB445137-D7F5-57EC-87DA-1DB460D64046,"iPhone13,2"
com.strava.stravaride,43,1751636915,1751636958,1751636958.745757,-18000,EB445137-D7F5-57EC-87DA-1DB460D64046,"iPhone13,2"
com.strava.stravaride,4,1751636905,1751636909,1751636909.860314,-18000,EB445137-D7F5-57EC-87DA-1DB460D64046,"iPhone13,2"
com.strava.stravaride,146,1751636678,1751636824,1751636825.1737928,-18000,EB445137-D7F5-57EC-87DA-1DB460D64046,"iPhone13,2"
com.apple.Fitness,36,1751636642,1751636678,1751636678.4227262,-18000,EB445137-D7F5-57EC-87DA-1DB460D64046,"iPhone13,2"
com.apple.MobileSMS,84,1751636558,1751636642,1751636642.8612719,-18000,EB445137-D7F5-57EC-87DA-1DB460D64046,"iPhone13,2"
com.apple.Fitness,62,1751636496,1751636558,1751636558.741376,-18000,EB445137-D7F5-57EC-87DA-1DB460D64046,"iPhone13,2"
com.apple.MobileSMS,3,1751636482,1751636485,1751636485.3732839,-18000,EB445137-D7F5-57EC-87DA-1DB460D64046,"iPhone13,2"
com.apple.MobileSMS,127,1751635830,1751635957,1751635957.803992,-18000,EB445137-D7F5-57EC-87DA-1DB460D64046,"iPhone13,2"
com.google.Gmail,34,1751635736,1751635770,1751635770.420351,-18000,EB445137-D7F5-57EC-87DA-1DB460D64046,"iPhone13,2"
com.apple.findmy,3,1751635733,1751635736,1751635736.618439,-18000,EB445137-D7F5-57EC-87DA-1DB460D64046,"iPhone13,2"
com.apple.findmy,24,1751633403,1751633427,1751633427.702765,-18000,EB445137-D7F5-57EC-87DA-1DB460D64046,"iPhone13,2"
com.apple.findmy,13,1751633002,1751633015,1751633016.173338,-18000,EB445137-D7F5-57EC-87DA-1DB460D64046,"iPhone13,2"
com.truebill.truebillnative,2,1751632999,1751633001,1751633001.859406,-18000,EB445137-D7F5-57EC-87DA-1DB460D64046,"iPhone13,2"
com.apple.Music,8,1751632269,1751632277,1751632278.071012,-18000,EB445137-D7F5-57EC-87DA-1DB460D64046,"iPhone13,2"
com.apple.musicrecognition,4,1751632265,1751632269,1751632269.5316591,-18000,EB445137-D7F5-57EC-87DA-1DB460D64046,"iPhone13,2"
com.google.Gmail,1,1751632264,1751632265,1751632267.49487,-18000,EB445137-D7F5-57EC-87DA-1DB460D64046,"iPhone13,2"
com.google.Gmail,14,1751631816,1751631830,1751631830.77159,-18000,EB445137-D7F5-57EC-87DA-1DB460D64046,"iPhone13,2"
com.apple.Maps,6,1751631810,1751631816,1751631817.02672,-18000,EB445137-D7F5-57EC-87DA-1DB460D64046,"iPhone13,2"
com.google.Maps,28,1751631782,1751631810,1751631810.7389011,-18000,EB445137-D7F5-57EC-87DA-1DB460D64046,"iPhone13,2"
com.apple.Maps,12,1751631765,1751631777,1751631777.301914,-18000,EB445137-D7F5-57EC-87DA-1DB460D64046,"iPhone13,2"
com.google.Gmail,20,1751631745,1751631765,1751631765.875556,-18000,EB445137-D7F5-57EC-87DA-1DB460D64046,"iPhone13,2"
com.apple.Maps,4,1751631741,1751631745,1751631745.676351,-18000,EB445137-D7F5-57EC-87DA-1DB460D64046,"iPhone13,2"
com.google.Gmail,17,1751631724,1751631741,1751631741.167325,-18000,EB445137-D7F5-57EC-87DA-1DB460D64046,"iPhone13,2"
com.apple.Maps,25,1751631699,1751631724,1751631724.177134,-18000,EB445137-D7F5-57EC-87DA-1DB460D64046,"iPhone13,2"
com.google.Gmail,43,1751631655,1751631698,1751631698.599894,-18000,EB445137-D7F5-57EC-87DA-1DB460D64046,"iPhone13,2"
com.apple.MobileSMS,2,1751631649,1751631651,1751631652.815065,-18000,EB445137-D7F5-57EC-87DA-1DB460D64046,"iPhone13,2"
com.apple.Health,0,1751631649,1751631649,1751631651.6876569,-18000,EB445137-D7F5-57EC-87DA-1DB460D64046,"iPhone13,2"
com.apple.Health,106,1751629760,1751629866,1751629866.673174,-18000,EB445137-D7F5-57EC-87DA-1DB460D64046,"iPhone13,2"
com.apple.weather,112,1751629640,1751629752,1751629752.696972,-18000,EB445137-D7F5-57EC-87DA-1DB460D64046,"iPhone13,2"
com.apple.MobileSMS,58,1751599749,1751599807,1751599807.429657,-18000,EB445137-D7F5-57EC-87DA-1DB460D64046,"iPhone13,2"
com.apple.mobilenotes,104,1751598778,1751598882,1751598882.217389,-18000,EB445137-D7F5-57EC-87DA-1DB460D64046,"iPhone13,2"
com.apple.Health,43,1751598698,1751598741,1751598741.207371,-18000,EB445137-D7F5-57EC-87DA-1DB460D64046,"iPhone13,2"
com.apple.MobileSMS,81,1751598613,1751598694,1751598694.442658,-18000,EB445137-D7F5-57EC-87DA-1DB460D64046,"iPhone13,2"
com.google.chrome.ios,27,1751598586,1751598613,1751598613.576932,-18000,EB445137-D7F5-57EC-87DA-1DB460D64046,"iPhone13,2"
com.apple.MobileSMS,10,1751598576,1751598586,1751598586.827424,-18000,EB445137-D7F5-57EC-87DA-1DB460D64046,"iPhone13,2"
com.toyopagroup.picaboo,0,1751598576,1751598576,1751598577.503187,-18000,EB445137-D7F5-57EC-87DA-1DB460D64046,"iPhone13,2"
com.google.Chrome,288,1751598164,1751598452,1751598453.127042,-18000,,
com.google.Chrome,303,1751597638,1751597941,1751597941.199014,-18000,,
com.google.Chrome,366,1751596519,1751596885,1751596885.181498,-18000,,
com.google.Chrome,336,1751595869,1751596205,1751596205.214079,-18000,,
com.toyopagroup.picaboo,4,1751595069,1751595073,1751595074.116179,-18000,EB445137-D7F5-57EC-87DA-1DB460D64046,"iPhone13,2"
com.google.Chrome,1005,1751594787,1751595792,1751595792.158071,-18000,,
com.toyopagroup.picaboo,125,1751594661,1751594786,1751594786.3118649,-18000,EB445137-D7F5-57EC-87DA-1DB460D64046,"iPhone13,2"
com.google.Chrome,1079,1751593536,1751594615,1751594615.650197,-18000,,
com.google.Chrome,309,1751593077,1751593386,1751593386.794057,-18000,,
com.google.Chrome,332,1751592683,1751593015,1751593015.524766,-18000,,
com.apple.finder,1,1751592682,1751592683,1751592683.647938,-18000,,
com.apple.iCal,57,1751592625,1751592682,1751592682.490933,-18000,,
com.google.Chrome,6,1751592619,1751592625,1751592625.108402,-18000,,
com.facebook.Facebook,3,1751592585,1751592588,1751592588.734353,-18000,EB445137-D7F5-57EC-87DA-1DB460D64046,"iPhone13,2"
com.facebook.Facebook,123,1751592056,1751592179,1751592180.100748,-18000,EB445137-D7F5-57EC-87DA-1DB460D64046,"iPhone13,2"
com.thestorygraph.thestorygraph,9,1751591985,1751591994,1751591995.00215,-18000,EB445137-D7F5-57EC-87DA-1DB460D64046,"iPhone13,2"
com.apple.Music,6,1751591976,1751591982,1751591982.0492082,-18000,EB445137-D7F5-57EC-87DA-1DB460D64046,"iPhone13,2"
com.apple.Music,41,1751591903,1751591944,1751591945.0988731,-18000,EB445137-D7F5-57EC-87DA-1DB460D64046,"iPhone13,2"
com.google.Chrome,59,1751591549,1751591608,1751591608.923912,-18000,,
com.apple.finder,10,1751591493,1751591503,1751591504.8194818,-18000,,
com.apple.mobiletimer,22,1751591346,1751591368,1751591368.672441,-18000,EB445137-D7F5-57EC-87DA-1DB460D64046,"iPhone13,2"
com.apple.MobileSMS,20,1751591322,1751591342,1751591342.420213,-18000,EB445137-D7F5-57EC-87DA-1DB460D64046,"iPhone13,2"
com.apple.news,7,1751591315,1751591322,1751591322.924852,-18000,EB445137-D7F5-57EC-87DA-1DB460D64046,"iPhone13,2"
com.apple.MobileSMS,4,1751591311,1751591315,1751591316.035023,-18000,EB445137-D7F5-57EC-87DA-1DB460D64046,"iPhone13,2"
com.apple.findmy,9,1751591294,1751591303,1751591303.973733,-18000,EB445137-D7F5-57EC-87DA-1DB460D64046,"iPhone13,2"
com.apple.MobileSMS,2,1751591292,1751591294,1751591294.954391,-18000,EB445137-D7F5-57EC-87DA-1DB460D64046,"iPhone13,2"
com.google.chrome.ios,16,1751591276,1751591292,1751591292.911154,-18000,EB445137-D7F5-57EC-87DA-1DB460D64046,"iPhone13,2"
com.apple.MobileSMS,25,1751591251,1751591276,1751591276.621619,-18000,EB445137-D7F5-57EC-87DA-1DB460D64046,"iPhone13,2"
com.google.chrome.ios,34,1751591217,1751591251,1751591251.518172,-18000,EB445137-D7F5-57EC-87DA-1DB460D64046,"iPhone13,2"
com.apple.MobileSMS,27,1751591190,1751591217,1751591217.337453,-18000,EB445137-D7F5-57EC-87DA-1DB460D64046,"iPhone13,2"
com.google.chrome.ios,13,1751591177,1751591190,1751591190.614935,-18000,EB445137-D7F5-57EC-87DA-1DB460D64046,"iPhone13,2"
com.apple.MobileSMS,21,1751591156,1751591177,1751591177.66149,-18000,EB445137-D7F5-57EC-87DA-1DB460D64046,"iPhone13,2"
com.google.chrome.ios,6,1751591150,1751591156,1751591156.7033482,-18000,EB445137-D7F5-57EC-87DA-1DB460D64046,"iPhone13,2"
com.apple.MobileSMS,4,1751591146,1751591150,1751591151.075772,-18000,EB445137-D7F5-57EC-87DA-1DB460D64046,"iPhone13,2"
com.google.chrome.ios,39,1751591107,1751591146,1751591146.989814,-18000,EB445137-D7F5-57EC-87DA-1DB460D64046,"iPhone13,2"
com.apple.MobileSMS,4,1751591103,1751591107,1751591107.9286098,-18000,EB445137-D7F5-57EC-87DA-1DB460D64046,"iPhone13,2"
com.google.chrome.ios,24,1751591079,1751591103,1751591103.901053,-18000,EB445137-D7F5-57EC-87DA-1DB460D64046,"iPhone13,2"
com.apple.MobileSMS,77,1751591002,1751591079,1751591079.94728,-18000,EB445137-D7F5-57EC-87DA-1DB460D64046,"iPhone13,2"
com.thestorygraph.thestorygraph,74,1751590928,1751591002,1751591002.155793,-18000,EB445137-D7F5-57EC-87DA-1DB460D64046,"iPhone13,2"
com.apple.MobileSMS,99,1751590829,1751590928,1751590928.259598,-18000,EB445137-D7F5-57EC-87DA-1DB460D64046,"iPhone13,2"
com.thestorygraph.thestorygraph,0,1751590829,1751590829,1751590829.759653,-18000,EB445137-D7F5-57EC-87DA-1DB460D64046,"iPhone13,2"
com.thestorygraph.thestorygraph,77,1751589760,1751589837,1751589837.6384292,-18000,EB445137-D7F5-57EC-87DA-1DB460D64046,"iPhone13,2"
com.google.Gmail,2,1751589756,1751589758,1751589758.558842,-18000,EB445137-D7F5-57EC-87DA-1DB460D64046,"iPhone13,2"
com.goodreads.Goodreads,16,1751589740,1751589756,1751589756.419277,-18000,EB445137-D7F5-57EC-87DA-1DB460D64046,"iPhone13,2"
com.google.Gmail,4,1751589732,1751589736,1751589736.052332,-18000,EB445137-D7F5-57EC-87DA-1DB460D64046,"iPhone13,2"
com.google.Gmail,34,1751588454,1751588488,1751588489.0273042,-18000,EB445137-D7F5-57EC-87DA-1DB460D64046,"iPhone13,2"
com.apple.finder,5,1751588396,1751588401,1751588401.7522202,-18000,,
com.leomehlig.today,1,1751588395,1751588396,1751588396.41643,-18000,,
com.google.Chrome,109,1751588286,1751588395,1751588395.19901,-18000,,
com.leomehlig.today,5,1751588265,1751588270,1751588270.466037,-18000,,
com.google.Chrome,2,1751588263,1751588265,1751588265.2944179,-18000,,
com.electron.carta,1,1751588262,1751588263,1751588263.547703,-18000,,
com.google.Chrome,2,1751588260,1751588262,1751588262.363575,-18000,,
com.microsoft.VSCode,20,1751588240,1751588260,1751588261.4682832,-18000,,
com.google.Chrome,2,1751588238,1751588240,1751588240.4287748,-18000,,
com.apple.Notes,38,1751588200,1751588238,1751588238.35798,-18000,,
com.google.Chrome,8,1751588192,1751588200,1751588200.600974,-18000,,
com.apple.Notes,18,1751588174,1751588192,1751588192.914369,-18000,,
com.google.Chrome,49,1751588125,1751588174,1751588174.770308,-18000,,
com.apple.Notes,34,1751588091,1751588125,1751588125.881854,-18000,,
com.google.Chrome,1,1751588090,1751588091,1751588091.510248,-18000,,
com.microsoft.VSCode,7,1751588083,1751588090,1751588090.063901,-18000,,
com.google.Chrome,63,1751588020,1751588083,1751588083.697209,-18000,,
com.microsoft.VSCode,466,1751587554,1751588020,1751588021.0196981,-18000,,
com.apple.finder,16,1751587538,1751587554,1751587554.2877269,-18000,,
com.google.Chrome,10,1751587528,1751587538,1751587538.607503,-18000,,
com.microsoft.VSCode,138,1751587390,1751587528,1751587528.1758552,-18000,,
com.leomehlig.today,50,1751587340,1751587390,1751587390.914033,-18000,,
com.apple.iCal,60,1751587280,1751587340,1751587340.173223,-18000,,
com.leomehlig.today,22,1751587258,1751587280,1751587280.859154,-18000,,
com.microsoft.VSCode,4,1751587254,1751587258,1751587258.713008,-18000,,
com.google.Chrome,11,1751587243,1751587254,1751587254.169599,-18000,,
com.apple.Notes,9,1751587234,1751587243,1751587243.874291,-18000,,
com.google.Chrome,20,1751587214,1751587234,1751587234.5518599,-18000,,
com.electron.carta,3,1751587211,1751587214,1751587214.409203,-18000,,
com.google.Chrome,45,1751587166,1751587211,1751587211.684458,-18000,,
com.electron.carta,7,1751587159,1751587166,1751587166.175987,-18000,,
com.google.Chrome,22,1751587137,1751587159,1751587159.688932,-18000,,
com.electron.carta,5,1751587132,1751587137,1751587137.722894,-18000,,
com.google.Chrome,51,1751587081,1751587132,1751587132.740861,-18000,,
com.electron.carta,67,1751587014,1751587081,1751587081.4158812,-18000,,
com.google.Chrome,53,1751586961,1751587014,1751587014.648565,-18000,,
com.electron.carta,13,1751586948,1751586961,1751586961.127497,-18000,,
com.google.Chrome,15,1751586933,1751586948,1751586948.040981,-18000,,
com.electron.carta,66,1751586867,1751586933,1751586933.172194,-18000,,
com.google.Chrome,77,1751586790,1751586867,1751586867.2404919,-18000,,
com.electron.carta,4,1751586786,1751586790,1751586790.819215,-18000,,
com.apple.finder,2,1751586784,1751586786,1751586786.477493,-18000,,
com.electron.carta,10,1751586774,1751586784,1751586784.939337,-18000,,
com.apple.finder,7,1751586767,1751586774,1751586774.2119598,-18000,,
com.electron.carta,42,1751586725,1751586767,1751586767.667717,-18000,,
com.google.Chrome,30,1751586695,1751586725,1751586725.9952688,-18000,,
com.apple.MobileSMS,20,1751586675,1751586695,1751586695.545145,-18000,,
com.google.Chrome,76,1751586599,1751586675,1751586675.3278499,-18000,,
com.apple.Notes,40,1751586559,1751586599,1751586599.5968719,-18000,,
com.google.Chrome,1,1751586558,1751586559,1751586560.018717,-18000,,
com.apple.Notes,22,1751586536,1751586558,1751586558.4822268,-18000,,
com.google.Chrome,646,1751585890,1751586536,1751586537.031395,-18000,,
com.apple.MobileSMS,81,1751585809,1751585890,1751585890.7959719,-18000,,
com.google.Chrome,3,1751585806,1751585809,1751585809.752534,-18000,,
com.apple.MobileSMS,25,1751585781,1751585806,1751585807.017715,-18000,,
com.google.Chrome,89,1751585692,1751585781,1751585781.603394,-18000,,
com.apple.Notes,0,1751585692,1751585692,1751585693.019805,-18000,,
com.google.Chrome,16,1751585676,1751585692,1751585692.5768871,-18000,,
com.apple.Notes,24,1751585652,1751585676,1751585676.286036,-18000,,
com.google.Chrome,230,1751585422,1751585652,1751585652.3190122,-18000,,
com.apple.Notes,14,1751585408,1751585422,1751585422.489181,-18000,,
com.google.Chrome,9,1751585399,1751585408,1751585408.594486,-18000,,
com.apple.Notes,61,1751585338,1751585399,1751585399.240134,-18000,,
com.google.Chrome,6,1751585332,1751585338,1751585338.317978,-18000,,
com.apple.Notes,6,1751585326,1751585332,1751585332.716209,-18000,,
com.google.Chrome,12,1751585314,1751585326,1751585326.352072,-18000,,
com.apple.Notes,1,1751585313,1751585314,1751585314.462497,-18000,,
com.google.Chrome,4,1751585309,1751585313,1751585313.117701,-18000,,
com.apple.Notes,7,1751585302,1751585309,1751585309.16756,-18000,,
com.google.Chrome,19,1751585283,1751585302,1751585302.544886,-18000,,
com.apple.Notes,5,1751585278,1751585283,1751585283.092629,-18000,,
com.google.Chrome,6,1751585272,1751585278,1751585278.884366,-18000,,
com.apple.Notes,1,1751585271,1751585272,1751585273.0368938,-18000,,
com.google.Chrome,36,1751585235,1751585271,1751585271.1620579,-18000,,
com.apple.Notes,4,1751585231,1751585235,1751585236.045724,-18000,,
com.google.Chrome,23,1751585208,1751585231,1751585231.917042,-18000,,
com.apple.Notes,2,1751585206,1751585208,1751585208.439913,-18000,,
com.google.Chrome,2,1751585204,1751585206,1751585206.7264261,-18000,,
com.apple.Notes,2,1751585202,1751585204,1751585204.2494369,-18000,,
com.google.Chrome,5,1751585197,1751585202,1751585202.305634,-18000,,
com.apple.Notes,2,1751585195,1751585197,1751585197.572886,-18000,,
com.google.Chrome,5,1751585190,1751585195,1751585195.9810429,-18000,,
com.apple.Notes,2,1751585188,1751585190,1751585190.283803,-18000,,
com.google.Chrome,19,1751585169,1751585188,1751585188.263592,-18000,,
com.apple.Notes,2,1751585167,1751585169,1751585169.6723251,-18000,,
com.google.Chrome,3,1751585164,1751585167,1751585167.943163,-18000,,
com.apple.Notes,4,1751585160,1751585164,1751585164.191936,-18000,,
com.google.Chrome,2,1751585158,1751585160,1751585160.075434,-18000,,
com.apple.Notes,1,1751585157,1751585158,1751585158.742645,-18000,,
com.google.Chrome,7,1751585150,1751585157,1751585157.140451,-18000,,
com.apple.Notes,621,1751584529,1751585150,1751585150.055488,-18000,,
com.google.Chrome,356,1751584173,1751584529,1751584529.665358,-18000,,
com.apple.Notes,2,1751584171,1751584173,1751584174.610991,-18000,,
com.google.Gmail,55,1751583963,1751584018,1751584018.785718,-18000,EB445137-D7F5-57EC-87DA-1DB460D64046,"iPhone13,2"
com.google.Gmail,53,1751583281,1751583334,1751583334.7203531,-18000,EB445137-D7F5-57EC-87DA-1DB460D64046,"iPhone13,2"
com.apple.MobileSMS,6,1751583115,1751583121,1751583121.413498,-18000,EB445137-D7F5-57EC-87DA-1DB460D64046,"iPhone13,2"
com.apple.MobileSMS,10,1751583003,1751583013,1751583013.320487,-18000,EB445137-D7F5-57EC-87DA-1DB460D64046,"iPhone13,2"
com.apple.Notes,300,1751582192,1751582492,1751582492.7347,-18000,,
com.leomehlig.today,3,1751582189,1751582192,1751582192.495,-18000,,
com.leomehlig.today,290,1751581887,1751582177,1751582177.651318,-18000,,
com.apple.weather,7,1751581825,1751581832,1751581832.9961529,-18000,EB445137-D7F5-57EC-87DA-1DB460D64046,"iPhone13,2"
com.apple.weather,41,1751581784,1751581825,1751581825.211032,-18000,EB445137-D7F5-57EC-87DA-1DB460D64046,"iPhone13,2"
com.apple.news,115,1751581669,1751581784,1751581784.215682,-18000,EB445137-D7F5-57EC-87DA-1DB460D64046,"iPhone13,2"
Astrospheric.Astrospheric,29,1751581632,1751581661,1751581661.492766,-18000,EB445137-D7F5-57EC-87DA-1DB460D64046,"iPhone13,2"
com.apple.Notes,305,1751581544,1751581849,1751581849.594689,-18000,,
com.google.Chrome,9,1751581535,1751581544,1751581544.670342,-18000,,
com.apple.Notes,4,1751581531,1751581535,1751581535.274411,-18000,,
com.google.Chrome,45,1751581486,1751581531,1751581531.1135678,-18000,,
com.apple.Notes,37,1751581449,1751581486,1751581486.754902,-18000,,
com.google.Chrome,59,1751581390,1751581449,1751581449.851695,-18000,,
com.apple.Notes,6,1751581384,1751581390,1751581391.009862,-18000,,
com.google.Chrome,37,1751581347,1751581384,1751581384.398319,-18000,,
com.apple.Notes,32,1751581315,1751581347,1751581347.5615668,-18000,,
com.google.Chrome,7,1751581308,1751581315,1751581315.647564,-18000,,
com.apple.Notes,2,1751581306,1751581308,1751581308.103569,-18000,,
com.google.Chrome,11,1751581295,1751581306,1751581306.1289902,-18000,,
com.apple.Notes,1,1751581294,1751581295,1751581295.706335,-18000,,
com.google.Chrome,20,1751581274,1751581294,1751581294.406987,-18000,,
com.apple.Notes,1,1751581273,1751581274,1751581274.974745,-18000,,
com.google.Chrome,21,1751581252,1751581273,1751581273.87425,-18000,,
com.apple.Notes,1,1751581251,1751581252,1751581253.042472,-18000,,
com.google.Chrome,34,1751581217,1751581251,1751581251.17093,-18000,,
com.apple.Notes,2,1751581215,1751581217,1751581217.79347,-18000,,
com.google.Chrome,19,1751581196,1751581215,1751581215.991558,-18000,,
com.apple.Notes,2,1751581194,1751581196,1751581196.922718,-18000,,
com.google.Chrome,1,1751581193,1751581194,1751581194.138286,-18000,,
com.apple.Notes,2,1751581191,1751581193,1751581193.112403,-18000,,
com.google.Chrome,23,1751581168,1751581191,1751581191.423795,-18000,,
com.apple.Notes,17,1751581151,1751581168,1751581168.794307,-18000,,
com.google.Chrome,19,1751581132,1751581151,1751581151.561954,-18000,,
com.apple.Notes,6,1751581126,1751581132,1751581132.532154,-18000,,
com.google.Chrome,3,1751581123,1751581126,1751581126.300796,-18000,,
com.apple.Notes,44,1751581079,1751581123,1751581123.953135,-18000,,
com.google.Chrome,8,1751581071,1751581079,1751581079.980511,-18000,,
com.apple.Notes,10,1751581061,1751581071,1751581071.575062,-18000,,
com.google.Chrome,14,1751581047,1751581061,1751581061.367969,-18000,,
com.apple.Notes,5,1751581042,1751581047,1751581047.070236,-18000,,
com.google.Chrome,3,1751581039,1751581042,1751581042.919738,-18000,,
com.apple.Notes,2,1751581037,1751581039,1751581039.9687948,-18000,,
com.google.Chrome,7,1751581030,1751581037,1751581037.414309,-18000,,
com.apple.Notes,4,1751581026,1751581030,1751581030.558567,-18000,,
com.google.Chrome,18,1751581008,1751581026,1751581026.909271,-18000,,
com.apple.Notes,67,1751580941,1751581008,1751581008.894773,-18000,,
com.electron.carta,107,1751580834,1751580941,1751580941.696209,-18000,,
com.apple.Notes,122,1751580712,1751580834,1751580834.3616729,-18000,,
com.electron.carta,10,1751580702,1751580712,1751580712.763212,-18000,,
com.apple.Notes,203,1751580499,1751580702,1751580702.062572,-18000,,
com.electron.carta,8,1751580491,1751580499,1751580499.795285,-18000,,
com.apple.Notes,18,1751580473,1751580491,1751580491.4954538,-18000,,
com.electron.carta,76,1751580397,1751580473,1751580473.831936,-18000,,
com.apple.Notes,195,1751580202,1751580397,1751580397.453742,-18000,,
com.google.Chrome,8,1751580194,1751580202,1751580202.947773,-18000,,
com.apple.Notes,14,1751580180,1751580194,1751580194.942731,-18000,,
com.electron.carta,5,1751580175,1751580180,1751580180.238278,-18000,,
com.apple.Notes,32,1751580143,1751580175,1751580175.853879,-18000,,
com.electron.carta,75,1751580068,1751580143,1751580143.624984,-18000,,
com.apple.Notes,98,1751579970,1751580068,1751580068.162187,-18000,,
com.electron.carta,342,1751579628,1751579970,1751579970.416586,-18000,,
com.apple.Notes,4,1751579624,1751579628,1751579628.555815,-18000,,
com.google.Chrome,10,1751579614,1751579624,1751579624.515108,-18000,,
com.apple.Notes,2,1751579612,1751579614,1751579614.602003,-18000,,
com.google.Chrome,39,1751579573,1751579612,1751579612.732555,-18000,,
com.apple.Notes,0,1751579573,1751579573,1751579573.733645,-18000,,
com.google.Chrome,8,1751579565,1751579573,1751579573.228648,-18000,,
com.apple.Notes,54,1751579511,1751579565,1751579565.7318869,-18000,,
com.google.Chrome,12,1751579499,1751579511,1751579511.7694669,-18000,,
com.apple.Notes,1,1751579498,1751579499,1751579499.675364,-18000,,
com.google.Chrome,5,1751579493,1751579498,1751579498.260343,-18000,,
com.apple.Notes,5,1751579488,1751579493,1751579493.231997,-18000,,
com.google.Chrome,63,1751579425,1751579488,1751579488.100504,-18000,,
com.apple.Notes,10,1751579415,1751579425,1751579425.6655722,-18000,,
com.google.Chrome,5,1751579410,1751579415,1751579415.53475,-18000,,
com.apple.Notes,1,1751579409,1751579410,1751579410.755766,-18000,,
com.google.Chrome,24,1751579385,1751579409,1751579409.74551,-18000,,
com.apple.Notes,2,1751579383,1751579385,1751579385.390064,-18000,,
com.google.Chrome,80,1751579303,1751579383,1751579383.5959191,-18000,,
com.apple.Notes,2,1751579301,1751579303,1751579303.500633,-18000,,
com.google.Chrome,13,1751579288,1751579301,1751579301.896795,-18000,,
com.apple.Notes,2,1751579286,1751579288,1751579288.925353,-18000,,
com.google.Chrome,59,1751579227,1751579286,1751579286.084964,-18000,,
com.apple.Notes,1,1751579226,1751579227,1751579227.958147,-18000,,
com.google.Chrome,9,1751579217,1751579226,1751579226.3916512,-18000,,
com.apple.Notes,41,1751579176,1751579217,1751579217.591965,-18000,,
com.google.Chrome,55,1751579121,1751579176,1751579176.689283,-18000,,
com.apple.Notes,26,1751579095,1751579121,1751579121.8288941,-18000,,
com.google.Chrome,149,1751578946,1751579095,1751579095.664989,-18000,,
com.electron.carta,47,1751578899,1751578946,1751578946.623053,-18000,,
com.apple.finder,5,1751578894,1751578899,1751578899.059864,-18000,,
com.electron.carta,33,1751578861,1751578894,1751578894.6337628,-18000,,
com.google.Chrome,4,1751578857,1751578861,1751578861.3595061,-18000,,
com.electron.carta,49,1751578808,1751578857,1751578857.3329759,-18000,,
com.apple.finder,7,1751578801,1751578808,1751578808.44576,-18000,,
com.electron.carta,108,1751578693,1751578801,1751578801.172015,-18000,,
com.google.Chrome,85,1751578608,1751578693,1751578693.354844,-18000,,
com.electron.carta,30,1751578578,1751578608,1751578608.429755,-18000,,
com.google.Chrome,19,1751578559,1751578578,1751578578.827455,-18000,,
com.electron.carta,28,1751578531,1751578559,1751578559.347177,-18000,,
com.google.Chrome,16,1751578515,1751578531,1751578531.1188369,-18000,,
com.electron.carta,9,1751578506,1751578515,1751578515.747658,-18000,,
com.google.Chrome,11,1751578495,1751578506,1751578506.711522,-18000,,
com.electron.carta,7,1751578488,1751578495,1751578495.7291598,-18000,,
com.apple.finder,4,1751578484,1751578488,1751578489.0168,-18000,,
com.electron.carta,37,1751578447,1751578484,1751578485.0117931,-18000,,
com.apple.finder,10,1751578437,1751578447,1751578447.744337,-18000,,
com.electron.carta,4,1751578433,1751578437,1751578437.866722,-18000,,
com.google.Chrome,109,1751578324,1751578433,1751578433.9507852,-18000,,
com.electron.carta,50,1751578274,1751578324,1751578324.296727,-18000,,
com.apple.finder,1,1751578273,1751578274,1751578274.63945,-18000,,
com.electron.carta,7,1751578266,1751578273,1751578273.570997,-18000,,
com.apple.finder,1,1751578265,1751578266,1751578266.630038,-18000,,
com.electron.carta,1,1751578264,1751578265,1751578265.360743,-18000,,
com.apple.finder,2,1751578262,1751578264,1751578264.408478,-18000,,
com.electron.carta,2,1751578260,1751578262,1751578262.5826201,-18000,,
com.apple.finder,18,1751578242,1751578260,1751578261.020776,-18000,,
com.electron.carta,15,1751578227,1751578242,1751578242.073971,-18000,,
com.google.Chrome,122,1751578105,1751578227,1751578227.2062302,-18000,,
com.electron.carta,15,1751578090,1751578105,1751578105.315216,-18000,,
com.google.Chrome,7,1751578083,1751578090,1751578090.825611,-18000,,
com.electron.carta,14,1751578069,1751578083,1751578083.52444,-18000,,
com.google.Chrome,65,1751578004,1751578069,1751578069.530702,-18000,,
com.electron.carta,20,1751577984,1751578004,1751578005.0194302,-18000,,
com.google.Chrome,32,1751577952,1751577984,1751577984.724036,-18000,,
com.electron.carta,5,1751577947,1751577952,1751577952.705402,-18000,,
com.google.Chrome,11,1751577936,1751577947,1751577947.103372,-18000,,
com.apple.finder,5,1751577931,1751577936,1751577936.2165089,-18000,,
com.google.Chrome,1,1751577930,1751577931,1751577931.50137,-18000,,
com.electron.carta,35,1751577895,1751577930,1751577930.387455,-18000,,
com.google.Chrome,10,1751577885,1751577895,1751577895.964373,-18000,,
com.electron.carta,26,1751577859,1751577885,1751577885.8504739,-18000,,
com.apple.finder,1,1751577858,1751577859,1751577859.9524698,-18000,,
com.electron.carta,0,1751577858,1751577858,1751577858.845499,-18000,,
com.apple.finder,6,1751577852,1751577858,1751577858.276911,-18000,,
com.electron.carta,19,1751577833,1751577852,1751577852.380656,-18000,,
com.apple.findmy,13,1751577820,1751577833,1751577833.479968,-18000,,
com.electron.carta,43,1751577777,1751577820,1751577820.617883,-18000,,
com.google.Chrome,40,1751577737,1751577777,1751577777.700799,-18000,,
com.electron.carta,8,1751577729,1751577737,1751577737.422128,-18000,,
com.google.Chrome,61,1751577668,1751577729,1751577729.277034,-18000,,
com.apple.finder,16,1751577652,1751577668,1751577668.770293,-18000,,
com.electron.carta,19,1751577633,1751577652,1751577652.66945,-18000,,
com.google.Chrome,83,1751577550,1751577633,1751577633.54103,-18000,,
com.electron.carta,95,1751577455,1751577550,1751577550.27534,-18000,,
com.apple.finder,1,1751577454,1751577455,1751577455.981031,-18000,,
com.electron.carta,3,1751577451,1751577454,1751577454.304605,-18000,,
com.apple.finder,7,1751577444,1751577451,1751577451.922192,-18000,,
com.electron.carta,18,1751577426,1751577444,1751577444.304462,-18000,,
com.google.Chrome,135,1751577291,1751577426,1751577426.4882212,-18000,,
com.electron.carta,39,1751577252,1751577291,1751577291.978773,-18000,,
com.google.Chrome,5,1751577247,1751577252,1751577252.8797212,-18000,,
com.electron.carta,14,1751577233,1751577247,1751577247.399425,-18000,,
com.google.Chrome,6,1751577227,1751577233,1751577233.224874,-18000,,
com.electron.carta,38,1751577189,1751577227,1751577227.33919,-18000,,
com.apple.finder,17,1751577172,1751577189,1751577190.0060701,-18000,,
com.google.Chrome,75,1751577097,1751577172,1751577172.933037,-18000,,
com.electron.carta,39,1751577058,1751577097,1751577097.2106361,-18000,,
com.google.Chrome,39,1751577019,1751577058,1751577058.743163,-18000,,
com.electron.carta,40,1751576979,1751577019,1751577019.311647,-18000,,
com.apple.finder,5,1751576974,1751576979,1751576979.847091,-18000,,
com.electron.carta,10,1751576964,1751576974,1751576974.5472322,-18000,,
com.google.Chrome,5,1751576959,1751576964,1751576965.144553,-18000,,
com.apple.finder,300,1751576659,1751576959,1751576959.205326,-18000,,
com.electron.carta,5,1751576654,1751576659,1751576659.808179,-18000,,
com.apple.findmy,3,1751576651,1751576654,1751576654.590878,-18000,,
com.electron.carta,73,1751576578,1751576651,1751576651.585997,-18000,,
com.google.Chrome,11,1751576567,1751576578,1751576578.974047,-18000,,
com.electron.carta,2,1751576565,1751576567,1751576567.845715,-18000,,
com.google.Chrome,3,1751576562,1751576565,1751576565.381273,-18000,,
com.apple.Notes,8,1751576554,1751576562,1751576562.7423902,-18000,,
com.google.Chrome,44,1751576510,1751576554,1751576554.8382301,-18000,,
com.google.Chrome,678,1751575068,1751575746,1751575746.2681088,-18000,,
com.leomehlig.today,104,1751574964,1751575068,1751575069.641813,-18000,,
com.google.Chrome,11,1751574953,1751574964,1751574964.953362,-18000,,
com.apple.news,419,1751574372,1751574791,1751574791.513104,-18000,EB445137-D7F5-57EC-87DA-1DB460D64046,"iPhone13,2"
com.google.Gmail,21,1751574340,1751574361,1751574361.1081681,-18000,EB445137-D7F5-57EC-87DA-1DB460D64046,"iPhone13,2"
com.apple.CoreAuthUI,3,1751573931,1751573934,1751573934.756742,-18000,EB445137-D7F5-57EC-87DA-1DB460D64046,"iPhone13,2"
com.robinhood.release.Robinhood,142,1751573925,1751574067,1751574067.090814,-18000,EB445137-D7F5-57EC-87DA-1DB460D64046,"iPhone13,2"
com.apple.CoreAuthUI,5,1751573919,1751573924,1751573924.406004,-18000,EB445137-D7F5-57EC-87DA-1DB460D64046,"iPhone13,2"
com.apple.CoreAuthUI,3,1751573113,1751573116,1751573116.416901,-18000,EB445137-D7F5-57EC-87DA-1DB460D64046,"iPhone13,2"
com.truebill.truebillnative,811,1751573108,1751573919,1751573919.3808088,-18000,EB445137-D7F5-57EC-87DA-1DB460D64046,"iPhone13,2"
com.amazon.Amazon,55,1751573019,1751573074,1751573074.571183,-18000,EB445137-D7F5-57EC-87DA-1DB460D64046,"iPhone13,2"
com.apple.news,824,1751572113,1751572937,1751572937.288903,-18000,EB445137-D7F5-57EC-87DA-1DB460D64046,"iPhone13,2"
com.strava.stravaride,16,1751572092,1751572108,1751572108.253514,-18000,EB445137-D7F5-57EC-87DA-1DB460D64046,"iPhone13,2"
com.google.Chrome,417,1751571863,1751572280,1751572280.4488149,-18000,,
com.google.Chrome,700,1751571159,1751571859,1751571859.3838649,-18000,,
com.google.Chrome,562,1751570501,1751571063,1751571063.939053,-18000,,
com.strava.stravaride,37,1751570033,1751570070,1751570070.5632071,-18000,EB445137-D7F5-57EC-87DA-1DB460D64046,"iPhone13,2"
com.apple.MobileSMS,0,1751570033,1751570033,1751570034.4935231,-18000,EB445137-D7F5-57EC-87DA-1DB460D64046,"iPhone13,2"
com.google.Chrome,2176,1751568202,1751570378,1751570378.5180259,-18000,,
com.leomehlig.today,87,1751568115,1751568202,1751568202.544575,-18000,,
com.apple.finder,3,1751568112,1751568115,1751568115.4983559,-18000,,
com.apple.MobileSMS,88,1751565647,1751565735,1751565735.370487,-18000,EB445137-D7F5-57EC-87DA-1DB460D64046,"iPhone13,2"
com.apple.podcasts,2,1751565645,1751565647,1751565647.816368,-18000,EB445137-D7F5-57EC-87DA-1DB460D64046,"iPhone13,2"
com.apple.podcasts,3,1751565268,1751565271,1751565271.7334661,-18000,EB445137-D7F5-57EC-87DA-1DB460D64046,"iPhone13,2"
com.doordash.dasher,22,1751564913,1751564935,1751564935.743084,-18000,EB445137-D7F5-57EC-87DA-1DB460D64046,"iPhone13,2"
com.apple.Maps,1,1751564912,1751564913,1751564913.863805,-18000,EB445137-D7F5-57EC-87DA-1DB460D64046,"iPhone13,2"
com.apple.Maps,12,1751564895,1751564907,1751564907.9957008,-18000,EB445137-D7F5-57EC-87DA-1DB460D64046,"iPhone13,2"
com.apple.MobileSMS,26,1751564869,1751564895,1751564895.1211538,-18000,EB445137-D7F5-57EC-87DA-1DB460D64046,"iPhone13,2"
com.doordash.dasher,35,1751564812,1751564847,1751564847.8773642,-18000,EB445137-D7F5-57EC-87DA-1DB460D64046,"iPhone13,2"
com.doordash.dasher,97,1751564685,1751564782,1751564782.011561,-18000,EB445137-D7F5-57EC-87DA-1DB460D64046,"iPhone13,2"
com.doordash.dasher,360,1751564278,1751564638,1751564638.986623,-18000,EB445137-D7F5-57EC-87DA-1DB460D64046,"iPhone13,2"
com.apple.MobileSMS,2,1751564276,1751564278,1751564278.405555,-18000,EB445137-D7F5-57EC-87DA-1DB460D64046,"iPhone13,2"
com.apple.MobileSMS,77,1751564146,1751564223,1751564223.402375,-18000,EB445137-D7F5-57EC-87DA-1DB460D64046,"iPhone13,2"
com.doordash.dasher,15,1751564131,1751564146,1751564146.736682,-18000,EB445137-D7F5-57EC-87DA-1DB460D64046,"iPhone13,2"
com.apple.podcasts,6,1751564125,1751564131,1751564131.8517919,-18000,EB445137-D7F5-57EC-87DA-1DB460D64046,"iPhone13,2"
com.doordash.dasher,2,1751564123,1751564125,1751564125.822784,-18000,EB445137-D7F5-57EC-87DA-1DB460D64046,"iPhone13,2"
com.doordash.dasher,1023,1751563096,1751564119,1751564119.214555,-18000,EB445137-D7F5-57EC-87DA-1DB460D64046,"iPhone13,2"
com.doordash.dasher,607,1751562447,1751563054,1751563054.410375,-18000,EB445137-D7F5-57EC-87DA-1DB460D64046,"iPhone13,2"
com.doordash.dasher,105,1751562283,1751562388,1751562389.158362,-18000,EB445137-D7F5-57EC-87DA-1DB460D64046,"iPhone13,2"
com.doordash.dasher,452,1751561750,1751562202,1751562203.0321941,-18000,EB445137-D7F5-57EC-87DA-1DB460D64046,"iPhone13,2"
com.doordash.dasher,154,1751561430,1751561584,1751561585.2293591,-18000,EB445137-D7F5-57EC-87DA-1DB460D64046,"iPhone13,2"
com.letterboxd.LetterboxdApp,5,1751561425,1751561430,1751561430.1511111,-18000,EB445137-D7F5-57EC-87DA-1DB460D64046,"iPhone13,2"
com.letterboxd.LetterboxdApp,76,1751561282,1751561358,1751561358.453384,-18000,EB445137-D7F5-57EC-87DA-1DB460D64046,"iPhone13,2"
com.google.chrome.ios,41,1751561237,1751561278,1751561278.919735,-18000,EB445137-D7F5-57EC-87DA-1DB460D64046,"iPhone13,2"
com.apple.podcasts,2,1751561235,1751561237,1751561237.6830668,-18000,EB445137-D7F5-57EC-87DA-1DB460D64046,"iPhone13,2"
com.apple.podcasts,64,1751560634,1751560698,1751560698.648824,-18000,EB445137-D7F5-57EC-87DA-1DB460D64046,"iPhone13,2"
com.apple.Music,6,1751560627,1751560633,1751560634.04957,-18000,EB445137-D7F5-57EC-87DA-1DB460D64046,"iPhone13,2"
com.apple.news,1,1751560626,1751560627,1751560627.258652,-18000,EB445137-D7F5-57EC-87DA-1DB460D64046,"iPhone13,2"
com.apple.news,196,1751560427,1751560623,1751560623.918696,-18000,EB445137-D7F5-57EC-87DA-1DB460D64046,"iPhone13,2"
com.doordash.dasher,6,1751560416,1751560422,1751560422.405395,-18000,EB445137-D7F5-57EC-87DA-1DB460D64046,"iPhone13,2"
com.apple.Maps,3,1751560413,1751560416,1751560416.798852,-18000,EB445137-D7F5-57EC-87DA-1DB460D64046,"iPhone13,2"
com.apple.Maps,256,1751559964,1751560220,1751560220.909814,-18000,EB445137-D7F5-57EC-87DA-1DB460D64046,"iPhone13,2"
com.doordash.dasher,13,1751559951,1751559964,1751559964.616607,-18000,EB445137-D7F5-57EC-87DA-1DB460D64046,"iPhone13,2"
com.apple.Maps,78,1751559873,1751559951,1751559951.998036,-18000,EB445137-D7F5-57EC-87DA-1DB460D64046,"iPhone13,2"
com.doordash.dasher,852,1751559021,1751559873,1751559874.092452,-18000,EB445137-D7F5-57EC-87DA-1DB460D64046,"iPhone13,2"
com.doordash.dasher,226,1751558794,1751559020,1751559020.38856,-18000,EB445137-D7F5-57EC-87DA-1DB460D64046,"iPhone13,2"
com.doordash.dasher,412,1751558374,1751558786,1751558786.661322,-18000,EB445137-D7F5-57EC-87DA-1DB460D64046,"iPhone13,2"
com.doordash.dasher,269,1751558104,1751558373,1751558373.285171,-18000,EB445137-D7F5-57EC-87DA-1DB460D64046,"iPhone13,2"
com.doordash.dasher,110,1751557956,1751558066,1751558066.3371491,-18000,EB445137-D7F5-57EC-87DA-1DB460D64046,"iPhone13,2"
com.apple.MobileSMS,42,1751557913,1751557955,1751557955.251254,-18000,EB445137-D7F5-57EC-87DA-1DB460D64046,"iPhone13,2"
com.apple.MobileSMS,12,1751557901,1751557913,1751557913.318918,-18000,EB445137-D7F5-57EC-87DA-1DB460D64046,"iPhone13,2"
com.google.chrome.ios,87,1751557814,1751557901,1751557902.336263,-18000,EB445137-D7F5-57EC-87DA-1DB460D64046,"iPhone13,2"
com.apple.MobileSMS,4,1751557810,1751557814,1751557814.490889,-18000,EB445137-D7F5-57EC-87DA-1DB460D64046,"iPhone13,2"
com.facebook.Facebook,189,1751557615,1751557804,1751557805.09472,-18000,EB445137-D7F5-57EC-87DA-1DB460D64046,"iPhone13,2"
com.apple.MobileSMS,5,1751557610,1751557615,1751557615.077046,-18000,EB445137-D7F5-57EC-87DA-1DB460D64046,"iPhone13,2"
com.apple.Health,36,1751557561,1751557597,1751557597.3661761,-18000,EB445137-D7F5-57EC-87DA-1DB460D64046,"iPhone13,2"
com.apple.MobileSMS,2,1751557559,1751557561,1751557561.200266,-18000,EB445137-D7F5-57EC-87DA-1DB460D64046,"iPhone13,2"
com.strava.stravaride,127,1751557430,1751557557,1751557557.6036701,-18000,EB445137-D7F5-57EC-87DA-1DB460D64046,"iPhone13,2"
com.doordash.dasher,90,1751557336,1751557426,1751557426.317667,-18000,EB445137-D7F5-57EC-87DA-1DB460D64046,"iPhone13,2"
com.doordash.dasher,369,1751556966,1751557335,1751557335.70686,-18000,EB445137-D7F5-57EC-87DA-1DB460D64046,"iPhone13,2"
com.apple.podcasts,21,1751556945,1751556966,1751556966.218066,-18000,EB445137-D7F5-57EC-87DA-1DB460D64046,"iPhone13,2"
com.doordash.dasher,4,1751556929,1751556933,1751556933.871511,-18000,EB445137-D7F5-57EC-87DA-1DB460D64046,"iPhone13,2"
com.doordash.dasher,8,1751556646,1751556654,1751556654.929991,-18000,EB445137-D7F5-57EC-87DA-1DB460D64046,"iPhone13,2"
com.doordash.dasher,21,1751556434,1751556455,1751556456.2794251,-18000,EB445137-D7F5-57EC-87DA-1DB460D64046,"iPhone13,2"
com.toyopagroup.picaboo,26,1751551842,1751551868,1751551868.20678,-18000,EB445137-D7F5-57EC-87DA-1DB460D64046,"iPhone13,2"
com.apple.weather,1,1751551841,1751551842,1751551842.870647,-18000,EB445137-D7F5-57EC-87DA-1DB460D64046,"iPhone13,2"
com.apple.finder,2,1751551151,1751551153,1751551153.899051,-18000,,
com.microsoft.rdc.macos,107,1751551044,1751551151,1751551151.840621,-18000,,
com.apple.finder,2,1751551042,1751551044,1751551049.690902,-18000,,
com.apple.weather,1,1751550952,1751550953,1751550953.987671,-18000,EB445137-D7F5-57EC-87DA-1DB460D64046,"iPhone13,2"
com.renpho.health,2,1751550950,1751550952,1751550952.106607,-18000,EB445137-D7F5-57EC-87DA-1DB460D64046,"iPhone13,2"
com.apple.finder,7,1751550933,1751550940,1751550940.3170571,-18000,,
com.microsoft.rdc.macos,110,1751550823,1751550933,1751550933.733577,-18000,,
com.microsoft.rdc.macos,61,1751550431,1751550492,1751550492.912601,-18000,,
com.renpho.health,41,1751550274,1751550315,1751550315.8854651,-18000,EB445137-D7F5-57EC-87DA-1DB460D64046,"iPhone13,2"
com.microsoft.rdc.macos,223,1751550114,1751550337,1751550337.762095,-18000,,
com.apple.finder,9,1751550105,1751550114,1751550114.934445,-18000,,
com.apple.news,426,1751549477,1751549903,1751549903.75148,-18000,EB445137-D7F5-57EC-87DA-1DB460D64046,"iPhone13,2"
com.apple.mobiletimer,1,1751549407,1751549408,1751549408.3191571,-18000,EB445137-D7F5-57EC-87DA-1DB460D64046,"iPhone13,2"
com.apple.Health,24,1751517176,1751517200,1751517200.740628,-18000,EB445137-D7F5-57EC-87DA-1DB460D64046,"iPhone13,2"
com.apple.compass,0,1751517176,1751517176,1751517177.8009958,-18000,EB445137-D7F5-57EC-87DA-1DB460D64046,"iPhone13,2"
com.apple.finder,2,1751517117,1751517119,1751517119.63888,-18000,,
com.microsoft.rdc.macos,109,1751517008,1751517117,1751517117.061296,-18000,,
com.apple.finder,6,1751517002,1751517008,1751517009.04282,-18000,,
com.google.Chrome,1146,1751515856,1751517002,1751517003.007876,-18000,,
com.google.Chrome,391,1751515243,1751515634,1751515634.129317,-18000,,
com.google.Chrome,313,1751514498,1751514811,1751514811.068934,-18000,,
com.microsoft.onenote.mac,281,1751514217,1751514498,1751514498.4764462,-18000,,
com.google.Chrome,39,1751514178,1751514217,1751514217.604434,-18000,,
com.apple.finder,107,1751514071,1751514178,1751514178.332824,-18000,,
com.leomehlig.today,3,1751514068,1751514071,1751514071.38604,-18000,,
com.microsoft.rdc.macos,392,1751513676,1751514068,1751514068.69925,-18000,,
com.google.Chrome,1046,1751512630,1751513676,1751513676.5716472,-18000,,
com.microsoft.rdc.macos,123,1751512507,1751512630,1751512630.706458,-18000,,
com.leomehlig.today,29,1751512459,1751512488,1751512488.2517672,-18000,,
com.microsoft.rdc.macos,6,1751512453,1751512459,1751512459.6124701,-18000,,
com.apple.compass,246,1751510195,1751510441,1751510441.767261,-18000,EB445137-D7F5-57EC-87DA-1DB460D64046,"iPhone13,2"
com.t11.celeste,2,1751510193,1751510195,1751510195.728335,-18000,EB445137-D7F5-57EC-87DA-1DB460D64046,"iPhone13,2"
com.t11.celeste,29,1751510163,1751510192,1751510192.373506,-18000,EB445137-D7F5-57EC-87DA-1DB460D64046,"iPhone13,2"
com.t11.celeste,14,1751510141,1751510155,1751510155.631922,-18000,EB445137-D7F5-57EC-87DA-1DB460D64046,"iPhone13,2"
com.apple.compass,2,1751510139,1751510141,1751510141.992338,-18000,EB445137-D7F5-57EC-87DA-1DB460D64046,"iPhone13,2"
com.microsoft.rdc.macos,2230,1751510099,1751512329,1751512329.3410568,-18000,,
com.google.Chrome,8,1751510024,1751510032,1751510032.705337,-18000,,
com.apple.compass,15,1751509376,1751509391,1751509391.546256,-18000,EB445137-D7F5-57EC-87DA-1DB460D64046,"iPhone13,2"
com.t11.celeste,2,1751509368,1751509370,1751509370.495621,-18000,EB445137-D7F5-57EC-87DA-1DB460D64046,"iPhone13,2"
com.t11.celeste,8,1751509234,1751509242,1751509242.494798,-18000,EB445137-D7F5-57EC-87DA-1DB460D64046,"iPhone13,2"
com.t11.celeste,23,1751509198,1751509221,1751509222.078672,-18000,EB445137-D7F5-57EC-87DA-1DB460D64046,"iPhone13,2"
com.apple.Music,2,1751509194,1751509196,1751509196.502884,-18000,EB445137-D7F5-57EC-87DA-1DB460D64046,"iPhone13,2"
com.google.Chrome,82,1751508511,1751508593,1751508593.5226269,-18000,,
com.google.Chrome,1467,1751506980,1751508447,1751508447.403616,-18000,,
com.leomehlig.today,10,1751506970,1751506980,1751506981.497263,-18000,,
com.apple.finder,4,1751506966,1751506970,1751506970.47578,-18000,,
com.apple.Music,11,1751505284,1751505295,1751505295.6472502,-18000,EB445137-D7F5-57EC-87DA-1DB460D64046,"iPhone13,2"
Astrospheric.Astrospheric,64,1751505009,1751505073,1751505073.6108022,-18000,EB445137-D7F5-57EC-87DA-1DB460D64046,"iPhone13,2"
com.google.Gmail,5,1751503797,1751503802,1751503802.5874438,-18000,EB445137-D7F5-57EC-87DA-1DB460D64046,"iPhone13,2"
com.toyopagroup.picaboo,32,1751503757,1751503789,1751503790.084439,-18000,EB445137-D7F5-57EC-87DA-1DB460D64046,"iPhone13,2"
Astrospheric.Astrospheric,13,1751497259,1751497272,1751497272.122694,-18000,EB445137-D7F5-57EC-87DA-1DB460D64046,"iPhone13,2"
com.apple.Maps,3,1751497253,1751497256,1751497257.1206279,-18000,EB445137-D7F5-57EC-87DA-1DB460D64046,"iPhone13,2"
com.apple.finder,36,1751497242,1751497278,1751497278.3371038,-18000,,
com.apple.MobileSMS,4,1751497238,1751497242,1751497242.404937,-18000,,
com.apple.finder,3,1751497235,1751497238,1751497238.151758,-18000,,
com.leomehlig.today,3,1751497232,1751497235,1751497235.465067,-18000,,
com.apple.Music,1,1751497231,1751497232,1751497232.531475,-18000,,
com.google.Chrome,56,1751497175,1751497231,1751497232.40466,-18000,,
com.leomehlig.today,2,1751497173,1751497175,1751497175.22702,-18000,,
com.google.Chrome,8,1751497165,1751497173,1751497173.851198,-18000,,
com.electron.carta,3,1751497147,1751497150,1751497150.467064,-18000,,
com.google.Chrome,3,1751497144,1751497147,1751497147.622123,-18000,,
com.apple.Notes,121,1751497023,1751497144,1751497144.31854,-18000,,
com.google.Chrome,100,1751496923,1751497023,1751497023.579678,-18000,,
com.electron.carta,16,1751496907,1751496923,1751496923.4002562,-18000,,
com.apple.finder,20,1751496887,1751496907,1751496907.335966,-18000,,
com.electron.carta,207,1751496680,1751496887,1751496887.5404859,-18000,,
com.google.Chrome,13,1751496667,1751496680,1751496680.7805219,-18000,,
com.electron.carta,79,1751496588,1751496667,1751496667.278466,-18000,,
com.google.Chrome,5,1751496583,1751496588,1751496588.11503,-18000,,
com.apple.Music,36,1751496547,1751496583,1751496583.58056,-18000,,
com.electron.carta,85,1751496462,1751496547,1751496547.3585172,-18000,,
com.google.Chrome,12,1751496450,1751496462,1751496462.2297359,-18000,,
com.electron.carta,6,1751496444,1751496450,1751496450.4323711,-18000,,
com.google.Chrome,29,1751496415,1751496444,1751496444.21963,-18000,,
com.electron.carta,20,1751496395,1751496415,1751496415.927273,-18000,,
com.google.Chrome,8,1751496387,1751496395,1751496395.981714,-18000,,
com.electron.carta,16,1751496371,1751496387,1751496387.835308,-18000,,
com.google.Chrome,6,1751496365,1751496371,1751496371.078243,-18000,,
com.electron.carta,10,1751496355,1751496365,1751496365.529731,-18000,,
com.google.Chrome,28,1751496327,1751496355,1751496355.979059,-18000,,
com.electron.carta,112,1751496215,1751496327,1751496327.472364,-18000,,
com.google.Chrome,1,1751496214,1751496215,1751496215.800593,-18000,,
com.leomehlig.today,10,1751496204,1751496214,1751496214.2651129,-18000,,
com.apple.iCal,90,1751496114,1751496204,1751496204.2595692,-18000,,
com.leomehlig.today,2,1751496112,1751496114,1751496114.783216,-18000,,
com.apple.findmy,18,1751496094,1751496112,1751496112.1541529,-18000,,
com.leomehlig.today,31,1751496063,1751496094,1751496094.316629,-18000,,
com.google.Chrome,42,1751496021,1751496063,1751496063.388979,-18000,,
com.electron.carta,19,1751496002,1751496021,1751496021.359023,-18000,,
com.google.Chrome,61,1751495941,1751496002,1751496002.157816,-18000,,
com.electron.carta,12,1751495929,1751495941,1751495941.268825,-18000,,
com.google.Chrome,9,1751495920,1751495929,1751495929.14169,-18000,,
com.electron.carta,10,1751495910,1751495920,1751495920.18252,-18000,,
com.apple.finder,1,1751495909,1751495910,1751495910.4261742,-18000,,
com.electron.carta,4,1751495905,1751495909,1751495909.980638,-18000,,
com.apple.finder,0,1751495905,1751495905,1751495905.887179,-18000,,
com.electron.carta,2,1751495903,1751495905,1751495905.137665,-18000,,
com.apple.finder,6,1751495897,1751495903,1751495903.419989,-18000,,
com.google.Chrome,1,1751495896,1751495897,1751495897.270937,-18000,,
com.electron.carta,5,1751495891,1751495896,1751495896.721469,-18000,,
com.google.Chrome,38,1751495853,1751495891,1751495891.4968991,-18000,,
com.electron.carta,26,1751495827,1751495853,1751495853.635978,-18000,,
com.apple.finder,2,1751495825,1751495827,1751495827.353127,-18000,,
com.electron.carta,0,1751495825,1751495825,1751495826.000622,-18000,,
com.apple.finder,1,1751495824,1751495825,1751495825.288106,-18000,,
com.electron.carta,18,1751495806,1751495824,1751495824.259879,-18000,,
com.apple.finder,2,1751495804,1751495806,1751495806.049864,-18000,,
com.electron.carta,1,1751495803,1751495804,1751495804.6406,-18000,,
com.apple.finder,1,1751495802,1751495803,1751495803.67409,-18000,,
com.electron.carta,8,1751495794,1751495802,1751495802.5764508,-18000,,
com.apple.finder,1,1751495793,1751495794,1751495794.739444,-18000,,
com.electron.carta,4,1751495789,1751495793,1751495793.1905289,-18000,,
com.apple.finder,4,1751495785,1751495789,1751495789.590759,-18000,,
com.electron.carta,1,1751495784,1751495785,1751495786.00462,-18000,,
com.apple.finder,2,1751495782,1751495784,1751495784.17681,-18000,,
com.electron.carta,14,1751495768,1751495782,1751495782.932369,-18000,,
com.apple.finder,2,1751495766,1751495768,1751495768.498262,-18000,,
com.electron.carta,8,1751495758,1751495766,1751495766.21519,-18000,,
com.apple.finder,3,1751495755,1751495758,1751495758.759492,-18000,,
com.electron.carta,3,1751495752,1751495755,1751495755.353039,-18000,,
com.apple.finder,1,1751495751,1751495752,1751495752.2610102,-18000,,
com.electron.carta,1,1751495750,1751495751,1751495751.641526,-18000,,
com.apple.finder,11,1751495739,1751495750,1751495750.794855,-18000,,
com.electron.carta,39,1751495700,1751495739,1751495739.796255,-18000,,
com.google.Chrome,62,1751495638,1751495700,1751495700.545372,-18000,,
com.electron.carta,102,1751495536,1751495638,1751495638.0244122,-18000,,
com.google.Chrome,17,1751495519,1751495536,1751495536.690383,-18000,,
com.electron.carta,11,1751495508,1751495519,1751495519.941122,-18000,,
com.google.Chrome,17,1751495491,1751495508,1751495508.493007,-18000,,
com.electron.carta,105,1751495386,1751495491,1751495491.89779,-18000,,
com.apple.finder,29,1751495357,1751495386,1751495386.874083,-18000,,
com.google.Chrome,44,1751495313,1751495357,1751495357.800411,-18000,,
com.apple.Notes,103,1751495210,1751495313,1751495313.188383,-18000,,
com.google.Chrome,20,1751495190,1751495210,1751495210.140456,-18000,,
com.apple.finder,8,1751495182,1751495190,1751495190.953703,-18000,,
com.electron.carta,1,1751495181,1751495182,1751495182.662939,-18000,,
com.apple.finder,24,1751495157,1751495181,1751495181.9044409,-18000,,
com.google.Chrome,87,1751495070,1751495157,1751495157.7794409,-18000,,
com.electron.carta,14,1751495056,1751495070,1751495070.83994,-18000,,
com.google.Chrome,38,1751495018,1751495056,1751495056.782144,-18000,,
com.electron.carta,4,1751495014,1751495018,1751495018.060089,-18000,,
com.google.Chrome,27,1751494987,1751495014,1751495014.659981,-18000,,
com.electron.carta,7,1751494980,1751494987,1751494987.851799,-18000,,
com.google.Chrome,8,1751494972,1751494980,1751494980.052126,-18000,,
com.electron.carta,37,1751494935,1751494972,1751494972.281342,-18000,,
com.google.Chrome,4,1751494931,1751494935,1751494935.967976,-18000,,
com.electron.carta,50,1751494881,1751494931,1751494931.2807422,-18000,,
com.google.Chrome,53,1751494828,1751494881,1751494881.788964,-18000,,
com.electron.carta,5,1751494823,1751494828,1751494828.295326,-18000,,
com.google.Chrome,22,1751494801,1751494823,1751494823.746968,-18000,,
com.electron.carta,10,1751494791,1751494801,1751494801.827951,-18000,,
com.google.Chrome,5,1751494786,1751494791,1751494791.5568209,-18000,,
com.electron.carta,3,1751494783,1751494786,1751494786.242224,-18000,,
com.google.Chrome,19,1751494764,1751494783,1751494783.30469,-18000,,
com.electron.carta,110,1751494654,1751494764,1751494764.186187,-18000,,
com.google.Chrome,86,1751494568,1751494654,1751494654.972684,-18000,,
com.electron.carta,8,1751494560,1751494568,1751494568.764914,-18000,,
com.google.Chrome,9,1751494551,1751494560,1751494560.128892,-18000,,
com.electron.carta,11,1751494540,1751494551,1751494551.657511,-18000,,
com.google.Chrome,32,1751494508,1751494540,1751494540.087665,-18000,,
com.electron.carta,63,1751494445,1751494508,1751494508.841527,-18000,,
com.google.Chrome,56,1751494389,1751494445,1751494445.910345,-18000,,
com.electron.carta,10,1751494379,1751494389,1751494389.314333,-18000,,
com.google.Chrome,36,1751494343,1751494379,1751494379.520347,-18000,,
com.electron.carta,55,1751494288,1751494343,1751494343.3475862,-18000,,
com.google.Chrome,234,1751494054,1751494288,1751494288.378862,-18000,,
com.electron.carta,15,1751494039,1751494054,1751494054.3044538,-18000,,
com.apple.finder,2,1751494037,1751494039,1751494039.964635,-18000,,
com.google.Chrome,1,1751494036,1751494037,1751494037.4046102,-18000,,
com.electron.carta,13,1751494023,1751494036,1751494036.4369931,-18000,,
com.apple.finder,33,1751493990,1751494023,1751494023.638679,-18000,,
com.electron.carta,33,1751493957,1751493990,1751493990.305743,-18000,,
com.google.Chrome,3,1751493954,1751493957,1751493957.288434,-18000,,
com.apple.finder,3,1751493951,1751493954,1751493954.5359058,-18000,,
com.microsoft.VSCode,49,1751493902,1751493951,1751493951.883105,-18000,,
com.apple.finder,124,1751493778,1751493902,1751493902.3671541,-18000,,
com.microsoft.VSCode,3,1751493775,1751493778,1751493778.04018,-18000,,
com.apple.finder,5,1751493770,1751493775,1751493775.04815,-18000,,
com.microsoft.VSCode,16,1751493754,1751493770,1751493770.4437451,-18000,,
com.electron.carta,5,1751493749,1751493754,1751493754.391477,-18000,,
com.apple.finder,4,1751493745,1751493749,1751493749.734443,-18000,,
com.electron.carta,17,1751493728,1751493745,1751493745.927813,-18000,,
com.microsoft.VSCode,21,1751493707,1751493728,1751493729.008391,-18000,,
com.apple.finder,31,1751493676,1751493707,1751493707.1209269,-18000,,
com.microsoft.VSCode,37,1751493639,1751493676,1751493676.0420752,-18000,,
com.apple.finder,16,1751493623,1751493639,1751493639.616343,-18000,,
com.microsoft.VSCode,88,1751493535,1751493623,1751493623.650484,-18000,,
com.apple.finder,1,1751493534,1751493535,1751493535.8765821,-18000,,
com.microsoft.VSCode,6,1751493528,1751493534,1751493534.113333,-18000,,
com.apple.finder,19,1751493509,1751493528,1751493528.43359,-18000,,
com.microsoft.VSCode,0,1751493509,1751493509,1751493509.9631019,-18000,,
com.apple.finder,8,1751493501,1751493509,1751493509.3310409,-18000,,
com.google.Chrome,247,1751493254,1751493501,1751493501.623918,-18000,,
com.apple.Music,85,1751493169,1751493254,1751493254.682084,-18000,,
com.google.Chrome,2,1751493167,1751493169,1751493169.84553,-18000,,
com.electron.carta,50,1751493117,1751493167,1751493167.112148,-18000,,
com.google.Chrome,204,1751492913,1751493117,1751493117.889919,-18000,,
com.electron.carta,23,1751492890,1751492913,1751492913.518612,-18000,,
com.google.Chrome,5,1751492885,1751492890,1751492890.363286,-18000,,
com.electron.carta,12,1751492873,1751492885,1751492885.1284719,-18000,,
com.google.Chrome,2,1751492871,1751492873,1751492873.534738,-18000,,
com.electron.carta,14,1751492857,1751492871,1751492871.7762032,-18000,,
com.google.Chrome,6,1751492851,1751492857,1751492858.0066938,-18000,,
com.electron.carta,10,1751492841,1751492851,1751492851.876834,-18000,,
com.google.Chrome,3,1751492838,1751492841,1751492841.863805,-18000,,
com.electron.carta,29,1751492809,1751492838,1751492839.021213,-18000,,
com.google.Chrome,1,1751492808,1751492809,1751492809.751525,-18000,,
com.electron.carta,49,1751492759,1751492808,1751492808.450273,-18000,,
com.google.Chrome,1,1751492758,1751492759,1751492759.74816,-18000,,
com.electron.carta,73,1751492685,1751492758,1751492758.43904,-18000,,
com.google.Chrome,1,1751492684,1751492685,1751492685.828804,-18000,,
com.electron.carta,59,1751492625,1751492684,1751492684.654861,-18000,,
com.google.Chrome,1,1751492624,1751492625,1751492625.512425,-18000,,
com.electron.carta,45,1751492579,1751492624,1751492624.398354,-18000,,
com.google.Chrome,1,1751492578,1751492579,1751492579.354687,-18000,,
com.electron.carta,23,1751492555,1751492578,1751492578.229981,-18000,,
com.google.Chrome,8,1751492547,1751492555,1751492555.738075,-18000,,
com.electron.carta,24,1751492523,1751492547,1751492547.474482,-18000,,
com.google.Chrome,10,1751492513,1751492523,1751492523.483945,-18000,,
com.electron.carta,30,1751492483,1751492513,1751492513.146052,-18000,,
com.google.Chrome,203,1751492280,1751492483,1751492483.7459788,-18000,,
com.electron.carta,5,1751492275,1751492280,1751492280.495233,-18000,,
com.google.Chrome,24,1751492251,1751492275,1751492275.234617,-18000,,
com.electron.carta,4,1751492247,1751492251,1751492251.62397,-18000,,
com.google.Chrome,45,1751492202,1751492247,1751492248.083363,-18000,,
com.apple.finder,21,1751492181,1751492202,1751492202.152808,-18000,,
com.electron.carta,5,1751492176,1751492181,1751492181.618825,-18000,,
com.apple.finder,9,1751492167,1751492176,1751492176.7273111,-18000,,
com.electron.carta,20,1751492147,1751492167,1751492167.9140859,-18000,,
com.apple.finder,67,1751492080,1751492147,1751492147.619893,-18000,,
com.google.Chrome,52,1751492028,1751492080,1751492080.100456,-18000,,
com.electron.carta,85,1751491943,1751492028,1751492028.849828,-18000,,
com.google.Chrome,19,1751491924,1751491943,1751491944.006809,-18000,,
com.electron.carta,14,1751491910,1751491924,1751491924.663783,-18000,,
com.leomehlig.today,0,1751491910,1751491910,1751491910.872285,-18000,,
com.electron.carta,8,1751491902,1751491910,1751491910.319841,-18000,,
com.leomehlig.today,34,1751491868,1751491902,1751491902.657876,-18000,,
com.google.Chrome,9,1751491859,1751491868,1751491868.440377,-18000,,
com.google.Chrome,211,1751491240,1751491451,1751491451.530995,-18000,,
com.google.Chrome,809,1751489402,1751490211,1751490211.113625,-18000,,
com.google.Chrome,322,1751488813,1751489135,1751489135.9536638,-18000,,
com.google.Chrome,304,1751488257,1751488561,1751488561.66103,-18000,,
com.google.Chrome,1536,1751486603,1751488139,1751488139.8797321,-18000,,
com.apple.finder,5,1751486598,1751486603,1751486603.603959,-18000,,
com.google.Chrome,4,1751486594,1751486598,1751486598.772883,-18000,,
com.apple.finder,4,1751486590,1751486594,1751486594.162255,-18000,,
com.google.Chrome,11,1751486579,1751486590,1751486590.2424932,-18000,,
com.apple.finder,8,1751486571,1751486579,1751486579.714076,-18000,,
com.leomehlig.today,8,1751486563,1751486571,1751486571.4600291,-18000,,
com.apple.Maps,284,1751486038,1751486322,1751486322.367656,-18000,EB445137-D7F5-57EC-87DA-1DB460D64046,"iPhone13,2"
com.apple.Maps,34,1751485720,1751485754,1751485754.616764,-18000,EB445137-D7F5-57EC-87DA-1DB460D64046,"iPhone13,2"
com.amazon.Amazon,16,1751485698,1751485714,1751485714.192313,-18000,EB445137-D7F5-57EC-87DA-1DB460D64046,"iPhone13,2"
com.google.chrome.ios,49,1751485631,1751485680,1751485680.993421,-18000,EB445137-D7F5-57EC-87DA-1DB460D64046,"iPhone13,2"
com.letterboxd.LetterboxdApp,96,1751485535,1751485631,1751485631.6041741,-18000,EB445137-D7F5-57EC-87DA-1DB460D64046,"iPhone13,2"
com.strava.stravaride,305,1751485221,1751485526,1751485526.3648582,-18000,EB445137-D7F5-57EC-87DA-1DB460D64046,"iPhone13,2"
com.leomehlig.today,305,1751485155,1751485460,1751485460.9187589,-18000,,
com.google.Chrome,70,1751485085,1751485155,1751485155.12446,-18000,,
com.electron.carta,9,1751485076,1751485085,1751485085.6445398,-18000,,
com.google.Chrome,31,1751485045,1751485076,1751485076.781798,-18000,,
com.electron.carta,12,1751485033,1751485045,1751485045.932436,-18000,,
com.google.Chrome,55,1751484978,1751485033,1751485033.5437012,-18000,,
com.electron.carta,137,1751484841,1751484978,1751484978.6985111,-18000,,
com.apple.finder,7,1751484834,1751484841,1751484841.1786041,-18000,,
com.electron.carta,14,1751484820,1751484834,1751484834.523117,-18000,,
com.google.Chrome,37,1751484783,1751484820,1751484820.592609,-18000,,
com.electron.carta,135,1751484648,1751484783,1751484783.144599,-18000,,
com.apple.finder,11,1751484637,1751484648,1751484648.8140569,-18000,,
com.electron.carta,44,1751484593,1751484637,1751484637.90854,-18000,,
com.google.Chrome,133,1751484460,1751484593,1751484593.2640638,-18000,,
com.electron.carta,17,1751484443,1751484460,1751484460.904696,-18000,,
com.google.Chrome,41,1751484402,1751484443,1751484443.694161,-18000,,
com.electron.carta,6,1751484396,1751484402,1751484402.083047,-18000,,
com.google.Chrome,46,1751484350,1751484396,1751484396.5138059,-18000,,
com.electron.carta,26,1751484324,1751484350,1751484350.274558,-18000,,
com.google.Chrome,7,1751484317,1751484324,1751484324.898363,-18000,,
com.electron.carta,6,1751484311,1751484317,1751484317.743875,-18000,,
com.google.Chrome,64,1751484247,1751484311,1751484311.5398479,-18000,,
com.electron.carta,12,1751484235,1751484247,1751484247.555904,-18000,,
com.apple.finder,1,1751484234,1751484235,1751484235.318941,-18000,,
com.google.Chrome,6,1751484228,1751484234,1751484234.8280149,-18000,,
com.apple.finder,8,1751484220,1751484228,1751484228.534183,-18000,,
com.electron.carta,1,1751484219,1751484220,1751484220.5276551,-18000,,
com.google.Chrome,16,1751484203,1751484219,1751484219.792078,-18000,,
com.electron.carta,19,1751484184,1751484203,1751484203.4252,-18000,,
com.google.Chrome,25,1751484159,1751484184,1751484184.6798801,-18000,,
com.electron.carta,126,1751484033,1751484159,1751484159.529904,-18000,,
com.apple.finder,1,1751484032,1751484033,1751484033.098675,-18000,,
com.electron.carta,7,1751484025,1751484032,1751484032.125359,-18000,,
com.apple.finder,7,1751484018,1751484025,1751484025.560622,-18000,,
com.electron.carta,1,1751484017,1751484018,1751484018.869896,-18000,,
com.apple.finder,2,1751484015,1751484017,1751484017.9492621,-18000,,
com.electron.carta,46,1751483969,1751484015,1751484015.693342,-18000,,
com.apple.finder,7,1751483962,1751483969,1751483969.402096,-18000,,
com.google.Chrome,99,1751483863,1751483962,1751483962.672925,-18000,,
com.apple.finder,13,1751483850,1751483863,1751483863.080297,-18000,,
com.electron.carta,15,1751483835,1751483850,1751483850.9959059,-18000,,
com.google.Chrome,63,1751483772,1751483835,1751483835.423696,-18000,,
com.apple.MobileSMS,21,1751483751,1751483772,1751483772.680863,-18000,,
com.google.Chrome,2,1751483749,1751483751,1751483751.5951371,-18000,,
com.electron.carta,2,1751483747,1751483749,1751483749.842392,-18000,,
com.google.Chrome,61,1751483686,1751483747,1751483747.901926,-18000,,
com.electron.carta,43,1751483643,1751483686,1751483686.7177858,-18000,,
com.google.Chrome,103,1751483540,1751483643,1751483643.5726151,-18000,,
com.electron.carta,10,1751483530,1751483540,1751483540.508507,-18000,,
com.google.Chrome,6,1751483524,1751483530,1751483530.482996,-18000,,
com.electron.carta,16,1751483508,1751483524,1751483524.796772,-18000,,
com.google.Chrome,14,1751483494,1751483508,1751483508.346726,-18000,,
com.electron.carta,3,1751483491,1751483494,1751483494.7407188,-18000,,
com.google.Chrome,25,1751483466,1751483491,1751483491.752595,-18000,,
com.apple.finder,5,1751483461,1751483466,1751483466.804589,-18000,,
com.electron.carta,18,1751483443,1751483461,1751483461.8083239,-18000,,
com.apple.finder,7,1751483436,1751483443,1751483443.664106,-18000,,
com.electron.carta,71,1751483365,1751483436,1751483436.919446,-18000,,
com.apple.finder,35,1751483330,1751483365,1751483365.050107,-18000,,
com.google.Chrome,30,1751483300,1751483330,1751483330.3547611,-18000,,
com.electron.carta,109,1751483191,1751483300,1751483300.926836,-18000,,
com.google.Chrome,17,1751483174,1751483191,1751483191.234354,-18000,,
com.electron.carta,5,1751483169,1751483174,1751483174.446344,-18000,,
com.apple.finder,4,1751483165,1751483169,1751483169.586084,-18000,,
com.leomehlig.today,0,1751483165,1751483165,1751483166.273569,-18000,,
com.google.Chrome,13,1751483152,1751483165,1751483165.589999,-18000,,
com.apple.MobileSMS,25,1751483127,1751483152,1751483152.132427,-18000,,
com.google.Chrome,107,1751483020,1751483127,1751483127.778331,-18000,,
com.leomehlig.today,3,1751481647,1751481650,1751481650.694714,-18000,,
com.apple.iCal,0,1751481647,1751481647,1751481647.82009,-18000,,
com.leomehlig.today,14,1751481633,1751481647,1751481647.082135,-18000,,
com.microsoft.onenote.mac,8,1751481625,1751481633,1751481633.826376,-18000,,
com.leomehlig.today,58,1751481567,1751481625,1751481625.189424,-18000,,
com.apple.iCal,3,1751481564,1751481567,1751481568.329979,-18000,,
com.apple.news,179,1751481221,1751481400,1751481401.077592,-18000,EB445137-D7F5-57EC-87DA-1DB460D64046,"iPhone13,2"
com.apple.news,445,1751480753,1751481198,1751481198.450729,-18000,EB445137-D7F5-57EC-87DA-1DB460D64046,"iPhone13,2"
com.doordash.dasher,480,1751478479,1751478959,1751478960.003955,-18000,EB445137-D7F5-57EC-87DA-1DB460D64046,"iPhone13,2"
com.doordash.dasher,65,1751478413,1751478478,1751478478.59113,-18000,EB445137-D7F5-57EC-87DA-1DB460D64046,"iPhone13,2"
com.doordash.dasher,84,1751478298,1751478382,1751478383.234267,-18000,EB445137-D7F5-57EC-87DA-1DB460D64046,"iPhone13,2"
com.apple.Maps,22,1751478276,1751478298,1751478298.696785,-18000,EB445137-D7F5-57EC-87DA-1DB460D64046,"iPhone13,2"
com.doordash.dasher,322,1751477954,1751478276,1751478277.571625,-18000,EB445137-D7F5-57EC-87DA-1DB460D64046,"iPhone13,2"
com.apple.podcasts,42,1751477912,1751477954,1751477954.800064,-18000,EB445137-D7F5-57EC-87DA-1DB460D64046,"iPhone13,2"
com.doordash.dasher,166,1751477746,1751477912,1751477912.243602,-18000,EB445137-D7F5-57EC-87DA-1DB460D64046,"iPhone13,2"
com.doordash.dasher,733,1751477012,1751477745,1751477745.6543279,-18000,EB445137-D7F5-57EC-87DA-1DB460D64046,"iPhone13,2"
com.apple.podcasts,7,1751477005,1751477012,1751477012.582292,-18000,EB445137-D7F5-57EC-87DA-1DB460D64046,"iPhone13,2"
com.doordash.dasher,0,1751477005,1751477005,1751477005.955442,-18000,EB445137-D7F5-57EC-87DA-1DB460D64046,"iPhone13,2"
com.doordash.dasher,588,1751476412,1751477000,1751477000.982034,-18000,EB445137-D7F5-57EC-87DA-1DB460D64046,"iPhone13,2"
com.amazon.Amazon,60,1751476349,1751476409,1751476410.0782719,-18000,EB445137-D7F5-57EC-87DA-1DB460D64046,"iPhone13,2"
com.amazon.Amazon,8,1751476340,1751476348,1751476355.6204991,-18000,EB445137-D7F5-57EC-87DA-1DB460D64046,"iPhone13,2"
com.apple.mobileslideshow,11,1751476263,1751476274,1751476274.991988,-18000,EB445137-D7F5-57EC-87DA-1DB460D64046,"iPhone13,2"
com.burbn.instagram,53,1751476206,1751476259,1751476259.485117,-18000,EB445137-D7F5-57EC-87DA-1DB460D64046,"iPhone13,2"
com.apple.news,99,1751476088,1751476187,1751476187.311446,-18000,EB445137-D7F5-57EC-87DA-1DB460D64046,"iPhone13,2"
com.doordash.dasher,3,1751476085,1751476088,1751476088.199086,-18000,EB445137-D7F5-57EC-87DA-1DB460D64046,"iPhone13,2"
com.apple.news,146,1751475939,1751476085,1751476085.891505,-18000,EB445137-D7F5-57EC-87DA-1DB460D64046,"iPhone13,2"
com.doordash.dasher,12,1751475927,1751475939,1751475939.982829,-18000,EB445137-D7F5-57EC-87DA-1DB460D64046,"iPhone13,2"
com.apple.news,23,1751475904,1751475927,1751475927.7009668,-18000,EB445137-D7F5-57EC-87DA-1DB460D64046,"iPhone13,2"
com.doordash.dasher,2,1751475902,1751475904,1751475904.2074308,-18000,EB445137-D7F5-57EC-87DA-1DB460D64046,"iPhone13,2"
com.doordash.dasher,16,1751475886,1751475902,1751475902.5929441,-18000,EB445137-D7F5-57EC-87DA-1DB460D64046,"iPhone13,2"
com.apple.news,5,1751475881,1751475886,1751475886.850287,-18000,EB445137-D7F5-57EC-87DA-1DB460D64046,"iPhone13,2"
com.doordash.dasher,8,1751475863,1751475871,1751475871.840497,-18000,EB445137-D7F5-57EC-87DA-1DB460D64046,"iPhone13,2"
com.doordash.dasher,734,1751475004,1751475738,1751475739.224924,-18000,EB445137-D7F5-57EC-87DA-1DB460D64046,"iPhone13,2"
com.apple.podcasts,9,1751474995,1751475004,1751475004.287844,-18000,EB445137-D7F5-57EC-87DA-1DB460D64046,"iPhone13,2"
com.doordash.dasher,1,1751474994,1751474995,1751474996.040479,-18000,EB445137-D7F5-57EC-87DA-1DB460D64046,"iPhone13,2"
com.doordash.dasher,2,1751474990,1751474992,1751474992.5754719,-18000,EB445137-D7F5-57EC-87DA-1DB460D64046,"iPhone13,2"
com.doordash.dasher,115,1751474874,1751474989,1751474989.8081388,-18000,EB445137-D7F5-57EC-87DA-1DB460D64046,"iPhone13,2"
com.doordash.dasher,1129,1751473743,1751474872,1751474873.209841,-18000,EB445137-D7F5-57EC-87DA-1DB460D64046,"iPhone13,2"
com.doordash.dasher,135,1751473608,1751473743,1751473743.4357948,-18000,EB445137-D7F5-57EC-87DA-1DB460D64046,"iPhone13,2"
com.doordash.dasher,188,1751473419,1751473607,1751473607.844424,-18000,EB445137-D7F5-57EC-87DA-1DB460D64046,"iPhone13,2"
com.doordash.dasher,61,1751473357,1751473418,1751473419.122709,-18000,EB445137-D7F5-57EC-87DA-1DB460D64046,"iPhone13,2"
com.doordash.dasher,84,1751473272,1751473356,1751473356.941411,-18000,EB445137-D7F5-57EC-87DA-1DB460D64046,"iPhone13,2"
com.doordash.dasher,489,1751472783,1751473272,1751473272.6433048,-18000,EB445137-D7F5-57EC-87DA-1DB460D64046,"iPhone13,2"
com.doordash.dasher,2,1751472780,1751472782,1751472782.7353249,-18000,EB445137-D7F5-57EC-87DA-1DB460D64046,"iPhone13,2"
com.apple.Health,30,1751472750,1751472780,1751472780.238023,-18000,EB445137-D7F5-57EC-87DA-1DB460D64046,"iPhone13,2"
com.doordash.dasher,2,1751472748,1751472750,1751472750.770016,-18000,EB445137-D7F5-57EC-87DA-1DB460D64046,"iPhone13,2"
com.doordash.dasher,39,1751472706,1751472745,1751472745.980904,-18000,EB445137-D7F5-57EC-87DA-1DB460D64046,"iPhone13,2"
com.apple.Health,10,1751472696,1751472706,1751472706.155889,-18000,EB445137-D7F5-57EC-87DA-1DB460D64046,"iPhone13,2"
com.strava.stravaride,54,1751472633,1751472687,1751472687.133378,-18000,EB445137-D7F5-57EC-87DA-1DB460D64046,"iPhone13,2"
com.doordash.dasher,61,1751472572,1751472633,1751472633.712751,-18000,EB445137-D7F5-57EC-87DA-1DB460D64046,"iPhone13,2"
com.strava.stravaride,1,1751472571,1751472572,1751472572.99733,-18000,EB445137-D7F5-57EC-87DA-1DB460D64046,"iPhone13,2"
com.strava.stravaride,33,1751472442,1751472475,1751472475.24443,-18000,EB445137-D7F5-57EC-87DA-1DB460D64046,"iPhone13,2"
com.doordash.dasher,12,1751472430,1751472442,1751472442.870967,-18000,EB445137-D7F5-57EC-87DA-1DB460D64046,"iPhone13,2"
com.strava.stravaride,63,1751472367,1751472430,1751472430.649049,-18000,EB445137-D7F5-57EC-87DA-1DB460D64046,"iPhone13,2"
com.doordash.dasher,411,1751471956,1751472367,1751472367.2078571,-18000,EB445137-D7F5-57EC-87DA-1DB460D64046,"iPhone13,2"
com.apple.podcasts,14,1751471942,1751471956,1751471956.7680411,-18000,EB445137-D7F5-57EC-87DA-1DB460D64046,"iPhone13,2"
com.apple.Music,1,1751471941,1751471942,1751471942.923089,-18000,EB445137-D7F5-57EC-87DA-1DB460D64046,"iPhone13,2"
com.doordash.dasher,2,1751471939,1751471941,1751471941.3975081,-18000,EB445137-D7F5-57EC-87DA-1DB460D64046,"iPhone13,2"
com.doordash.dasher,289,1751471526,1751471815,1751471816.0782108,-18000,EB445137-D7F5-57EC-87DA-1DB460D64046,"iPhone13,2"
com.doordash.dasher,14,1751471237,1751471251,1751471252.0006762,-18000,EB445137-D7F5-57EC-87DA-1DB460D64046,"iPhone13,2"
com.tinyspeck.chatlyio,18,1751465851,1751465869,1751465870.013955,-18000,EB445137-D7F5-57EC-87DA-1DB460D64046,"iPhone13,2"
com.apple.weather,2,1751465847,1751465849,1751465849.384238,-18000,EB445137-D7F5-57EC-87DA-1DB460D64046,"iPhone13,2"
com.apple.weather,94,1751465538,1751465632,1751465632.735492,-18000,EB445137-D7F5-57EC-87DA-1DB460D64046,"iPhone13,2"
com.renpho.health,32,1751465506,1751465538,1751465538.646834,-18000,EB445137-D7F5-57EC-87DA-1DB460D64046,"iPhone13,2"
com.apple.news,671,1751464707,1751465378,1751465378.592376,-18000,EB445137-D7F5-57EC-87DA-1DB460D64046,"iPhone13,2"
com.apple.news,328,1751463432,1751463760,1751463760.165086,-18000,EB445137-D7F5-57EC-87DA-1DB460D64046,"iPhone13,2"
com.apple.news,62,1751463213,1751463275,1751463275.5955439,-18000,EB445137-D7F5-57EC-87DA-1DB460D64046,"iPhone13,2"
com.apple.Health,56,1751463138,1751463194,1751463194.5956159,-18000,EB445137-D7F5-57EC-87DA-1DB460D64046,"iPhone13,2"
com.apple.mobiletimer,6,1751463099,1751463105,1751463105.289904,-18000,EB445137-D7F5-57EC-87DA-1DB460D64046,"iPhone13,2"
com.apple.mobiletimer,0,1751463098,1751463098,1751463099.305966,-18000,EB445137-D7F5-57EC-87DA-1DB460D64046,"iPhone13,2"
com.apple.mobiletimer,12,1751429397,1751429409,1751429409.7041612,-18000,EB445137-D7F5-57EC-87DA-1DB460D64046,"iPhone13,2"
com.thestorygraph.thestorygraph,46,1751429280,1751429326,1751429326.713881,-18000,EB445137-D7F5-57EC-87DA-1DB460D64046,"iPhone13,2"
com.apple.MobileAddressBook,264,1751426104,1751426368,1751426368.572717,-18000,EB445137-D7F5-57EC-87DA-1DB460D64046,"iPhone13,2"
com.apple.MobileAddressBook,35,1751426068,1751426103,1751426103.581094,-18000,EB445137-D7F5-57EC-87DA-1DB460D64046,"iPhone13,2"
com.apple.iCal,316,1751426040,1751426356,1751426356.160575,-18000,,
com.apple.CoreAuthUI,2,1751425742,1751425744,1751425744.6825628,-18000,EB445137-D7F5-57EC-87DA-1DB460D64046,"iPhone13,2"
com.apple.journal,168,1751425741,1751425909,1751425910.322682,-18000,EB445137-D7F5-57EC-87DA-1DB460D64046,"iPhone13,2"
com.microsoft.onenote.mac,314,1751425726,1751426040,1751426040.1822,-18000,,
com.apple.Photos,25,1751425701,1751425726,1751425726.152503,-18000,,
com.microsoft.onenote.mac,1,1751425700,1751425701,1751425702.00308,-18000,,
com.apple.Photos,15,1751425685,1751425700,1751425700.288497,-18000,,
com.apple.CoreAuthUI,4,1751425563,1751425567,1751425567.711981,-18000,EB445137-D7F5-57EC-87DA-1DB460D64046,"iPhone13,2"
com.apple.journal,70,1751425562,1751425632,1751425632.286685,-18000,EB445137-D7F5-57EC-87DA-1DB460D64046,"iPhone13,2"
com.apple.PosterBoard,0,1751425560,1751425560,1751425560.94593,-18000,EB445137-D7F5-57EC-87DA-1DB460D64046,"iPhone13,2"
com.apple.mobileslideshow,3,1751425559,1751425562,1751425562.51291,-18000,EB445137-D7F5-57EC-87DA-1DB460D64046,"iPhone13,2"
com.microsoft.onenote.mac,140,1751425545,1751425685,1751425685.548699,-18000,,
com.apple.iCal,9,1751425536,1751425545,1751425545.647598,-18000,,
com.microsoft.onenote.mac,331,1751425205,1751425536,1751425536.346126,-18000,,
com.apple.mobileslideshow,179,1751425021,1751425200,1751425200.818608,-18000,EB445137-D7F5-57EC-87DA-1DB460D64046,"iPhone13,2"
com.google.Chrome,188,1751425017,1751425205,1751425205.1568642,-18000,,
com.apple.finder,17,1751425000,1751425017,1751425017.462599,-18000,,
com.microsoft.rdc.macos,3,1751424997,1751425000,1751425000.4991999,-18000,,
com.apple.weather,8,1751423863,1751423871,1751423871.843164,-18000,EB445137-D7F5-57EC-87DA-1DB460D64046,"iPhone13,2"
com.apple.compass,2,1751423861,1751423863,1751423863.651425,-18000,EB445137-D7F5-57EC-87DA-1DB460D64046,"iPhone13,2"
com.apple.compass,16,1751423537,1751423553,1751423553.6269078,-18000,EB445137-D7F5-57EC-87DA-1DB460D64046,"iPhone13,2"
com.t11.celeste,2,1751423523,1751423525,1751423525.592519,-18000,EB445137-D7F5-57EC-87DA-1DB460D64046,"iPhone13,2"
com.t11.celeste,10,1751423261,1751423271,1751423271.564534,-18000,EB445137-D7F5-57EC-87DA-1DB460D64046,"iPhone13,2"
com.t11.celeste,58,1751423174,1751423232,1751423232.748467,-18000,EB445137-D7F5-57EC-87DA-1DB460D64046,"iPhone13,2"
com.apple.Music,1,1751423163,1751423164,1751423165.0265188,-18000,EB445137-D7F5-57EC-87DA-1DB460D64046,"iPhone13,2"
com.apple.Music,19,1751422713,1751422732,1751422732.667918,-18000,EB445137-D7F5-57EC-87DA-1DB460D64046,"iPhone13,2"
com.microsoft.rdc.macos,589,1751421679,1751422268,1751422269.085051,-18000,,
com.google.Chrome,84,1751421595,1751421679,1751421679.2324471,-18000,,
com.microsoft.onenote.mac,19,1751421576,1751421595,1751421595.1183171,-18000,,
org.stellarium.Stellarium,5,1751421571,1751421576,1751421576.2656798,-18000,,
org.stellarium.Stellarium,313,1751421243,1751421556,1751421556.785935,-18000,,
com.apple.Music,30,1751421205,1751421235,1751421235.817522,-18000,EB445137-D7F5-57EC-87DA-1DB460D64046,"iPhone13,2"
com.ryansponzilli.DeepSkyCatalog,2,1751421203,1751421205,1751421205.616193,-18000,EB445137-D7F5-57EC-87DA-1DB460D64046,"iPhone13,2"
com.google.Chrome,641,1751420602,1751421243,1751421243.302518,-18000,,
com.ryansponzilli.DeepSkyCatalog,52,1751420472,1751420524,1751420524.471765,-18000,EB445137-D7F5-57EC-87DA-1DB460D64046,"iPhone13,2"
com.ryansponzilli.DeepSkyCatalog,59,1751420394,1751420453,1751420453.874495,-18000,EB445137-D7F5-57EC-87DA-1DB460D64046,"iPhone13,2"
com.apple.Music,5,1751420386,1751420391,1751420391.855465,-18000,EB445137-D7F5-57EC-87DA-1DB460D64046,"iPhone13,2"
org.stellarium.Stellarium,226,1751420376,1751420602,1751420602.6650991,-18000,,
com.google.Chrome,2,1751420374,1751420376,1751420377.032557,-18000,,
com.apple.Music,73,1751420261,1751420334,1751420334.449368,-18000,EB445137-D7F5-57EC-87DA-1DB460D64046,"iPhone13,2"
com.microsoft.rdc.macos,147,1751420227,1751420374,1751420374.396584,-18000,,
com.google.Chrome,49,1751420178,1751420227,1751420227.518259,-18000,,
com.microsoft.rdc.macos,24,1751420154,1751420178,1751420178.325045,-18000,,
com.google.Chrome,58,1751420096,1751420154,1751420154.53342,-18000,,
com.microsoft.rdc.macos,93,1751420003,1751420096,1751420096.7463741,-18000,,
com.google.Chrome,48,1751419955,1751420003,1751420003.260435,-18000,,
com.microsoft.rdc.macos,81,1751419874,1751419955,1751419955.5727959,-18000,,
com.google.Chrome,2,1751419872,1751419874,1751419874.956684,-18000,,
com.apple.Music,49,1751419769,1751419818,1751419818.532593,-18000,EB445137-D7F5-57EC-87DA-1DB460D64046,"iPhone13,2"
com.apple.Maps,2,1751419767,1751419769,1751419769.8425012,-18000,EB445137-D7F5-57EC-87DA-1DB460D64046,"iPhone13,2"
com.apple.Maps,8,1751418403,1751418411,1751418411.9555159,-18000,EB445137-D7F5-57EC-87DA-1DB460D64046,"iPhone13,2"
com.apple.Music,2,1751418401,1751418403,1751418403.604671,-18000,EB445137-D7F5-57EC-87DA-1DB460D64046,"iPhone13,2"
com.apple.Music,56,1751417854,1751417910,1751417910.2724528,-18000,EB445137-D7F5-57EC-87DA-1DB460D64046,"iPhone13,2"
com.apple.findmy,3,1751417624,1751417627,1751417627.4712338,-18000,EB445137-D7F5-57EC-87DA-1DB460D64046,"iPhone13,2"
com.apple.findmy,2,1751417621,1751417623,1751417624.91192,-18000,EB445137-D7F5-57EC-87DA-1DB460D64046,"iPhone13,2"
com.apple.findmy,7,1751416136,1751416143,1751416143.761785,-18000,EB445137-D7F5-57EC-87DA-1DB460D64046,"iPhone13,2"
com.tier9digital.sundial,2,1751416134,1751416136,1751416136.928259,-18000,EB445137-D7F5-57EC-87DA-1DB460D64046,"iPhone13,2"
com.tier9digital.sundial,24,1751415985,1751416009,1751416009.777683,-18000,EB445137-D7F5-57EC-87DA-1DB460D64046,"iPhone13,2"
com.tier9digital.sundial,23,1751415959,1751415982,1751415982.7587981,-18000,EB445137-D7F5-57EC-87DA-1DB460D64046,"iPhone13,2"
com.toyopagroup.picaboo,11,1751415845,1751415856,1751415856.993699,-18000,EB445137-D7F5-57EC-87DA-1DB460D64046,"iPhone13,2"
com.google.Chrome,1,1751415760,1751415761,1751415762.1071792,-18000,,
com.google.Chrome,3,1751415757,1751415760,1751415761.001336,-18000,,
com.apple.Music,3,1751415623,1751415626,1751415626.386255,-18000,,
com.google.Chrome,95,1751415528,1751415623,1751415623.032418,-18000,,
com.leomehlig.today,55,1751415473,1751415528,1751415528.372859,-18000,,
com.google.Chrome,2,1751415471,1751415473,1751415473.801766,-18000,,
com.apple.Notes,13,1751415458,1751415471,1751415471.6340132,-18000,,
com.google.Chrome,8,1751415450,1751415458,1751415458.036385,-18000,,
com.electron.carta,3,1751415447,1751415450,1751415450.998976,-18000,,
com.google.Chrome,139,1751415308,1751415447,1751415447.974496,-18000,,
com.apple.Music,6,1751415302,1751415308,1751415308.381854,-18000,,
com.google.Chrome,15,1751415287,1751415302,1751415302.0958362,-18000,,
com.electron.carta,27,1751415260,1751415287,1751415287.57902,-18000,,
com.google.Chrome,19,1751415241,1751415260,1751415260.932553,-18000,,
com.electron.carta,36,1751415205,1751415241,1751415241.858269,-18000,,
com.google.Chrome,22,1751415183,1751415205,1751415205.3563461,-18000,,
com.electron.carta,42,1751415141,1751415183,1751415183.808065,-18000,,
com.google.Chrome,42,1751415099,1751415141,1751415141.435368,-18000,,
com.electron.carta,8,1751415091,1751415099,1751415099.389761,-18000,,
com.google.Chrome,204,1751414887,1751415091,1751415091.54126,-18000,,
com.electron.carta,44,1751414843,1751414887,1751414887.512728,-18000,,
com.google.Chrome,29,1751414814,1751414843,1751414843.886687,-18000,,
com.electron.carta,8,1751414806,1751414814,1751414814.192153,-18000,,
com.google.Chrome,39,1751414767,1751414806,1751414806.6867142,-18000,,
com.electron.carta,8,1751414759,1751414767,1751414767.644047,-18000,,
com.google.Chrome,55,1751414704,1751414759,1751414759.5674028,-18000,,
com.electron.carta,35,1751414669,1751414704,1751414704.112325,-18000,,
com.google.Chrome,4,1751414665,1751414669,1751414669.116751,-18000,,
com.electron.carta,22,1751414643,1751414665,1751414665.629624,-18000,,
com.google.Chrome,2,1751414641,1751414643,1751414643.962675,-18000,,
com.electron.carta,7,1751414634,1751414641,1751414641.729879,-18000,,
com.doordash.dasher,89,1751414466,1751414555,1751414555.603184,-18000,EB445137-D7F5-57EC-87DA-1DB460D64046,"iPhone13,2"
com.google.Sheets,52,1751414412,1751414464,1751414464.4732199,-18000,EB445137-D7F5-57EC-87DA-1DB460D64046,"iPhone13,2"
com.apple.CoreAuthUI,2,1751414394,1751414396,1751414396.622735,-18000,EB445137-D7F5-57EC-87DA-1DB460D64046,"iPhone13,2"
com.clairmail.fth.client,18,1751414391,1751414409,1751414409.436058,-18000,EB445137-D7F5-57EC-87DA-1DB460D64046,"iPhone13,2"
Astrospheric.Astrospheric,35,1751414339,1751414374,1751414374.7166839,-18000,EB445137-D7F5-57EC-87DA-1DB460D64046,"iPhone13,2"
com.apple.AppStore,20,1751414307,1751414327,1751414327.5034552,-18000,EB445137-D7F5-57EC-87DA-1DB460D64046,"iPhone13,2"
com.electron.carta,346,1751414216,1751414562,1751414562.421938,-18000,,
com.google.Chrome,89,1751414127,1751414216,1751414216.639374,-18000,,
com.electron.carta,7,1751414120,1751414127,1751414127.755577,-18000,,
com.google.Chrome,15,1751414105,1751414120,1751414120.325502,-18000,,
com.electron.carta,13,1751414092,1751414105,1751414105.393487,-18000,,
com.apple.finder,12,1751414080,1751414092,1751414093.002893,-18000,,
com.electron.carta,8,1751414072,1751414080,1751414080.207642,-18000,,
com.google.Chrome,20,1751414052,1751414072,1751414072.599833,-18000,,
com.electron.carta,19,1751414033,1751414052,1751414052.3099709,-18000,,
com.google.Chrome,62,1751413971,1751414033,1751414033.959062,-18000,,
com.electron.carta,34,1751413937,1751413971,1751413971.5906072,-18000,,
com.google.Chrome,5,1751413932,1751413937,1751413937.633987,-18000,,
com.electron.carta,5,1751413927,1751413932,1751413932.684616,-18000,,
com.apple.finder,54,1751413873,1751413927,1751413928.03145,-18000,,
com.electron.carta,19,1751413854,1751413873,1751413873.722996,-18000,,
com.google.Chrome,25,1751413829,1751413854,1751413854.645111,-18000,,
com.electron.carta,12,1751413817,1751413829,1751413829.406196,-18000,,
com.google.Chrome,4,1751413813,1751413817,1751413817.9636369,-18000,,
com.electron.carta,16,1751413797,1751413813,1751413813.70874,-18000,,
com.apple.finder,1,1751413796,1751413797,1751413797.637408,-18000,,
com.electron.carta,4,1751413792,1751413796,1751413796.3340092,-18000,,
com.apple.finder,2,1751413790,1751413792,1751413792.471195,-18000,,
com.electron.carta,3,1751413787,1751413790,1751413790.87119,-18000,,
com.apple.finder,1,1751413786,1751413787,1751413787.273257,-18000,,
com.electron.carta,2,1751413784,1751413786,1751413786.329998,-18000,,
com.apple.finder,1,1751413783,1751413784,1751413784.356619,-18000,,
com.electron.carta,2,1751413781,1751413783,1751413783.1410089,-18000,,
com.apple.finder,1,1751413780,1751413781,1751413781.400907,-18000,,
com.electron.carta,5,1751413775,1751413780,1751413780.488138,-18000,,
com.apple.finder,2,1751413773,1751413775,1751413775.611113,-18000,,
com.electron.carta,58,1751413715,1751413773,1751413773.246505,-18000,,
com.apple.finder,2,1751413713,1751413715,1751413715.083202,-18000,,
com.electron.carta,1,1751413712,1751413713,1751413713.277839,-18000,,
com.apple.finder,2,1751413710,1751413712,1751413712.253618,-18000,,
com.electron.carta,1,1751413709,1751413710,1751413710.983008,-18000,,
com.apple.finder,1,1751413708,1751413709,1751413709.315134,-18000,,
com.electron.carta,1,1751413707,1751413708,1751413708.360619,-18000,,
com.apple.finder,1,1751413706,1751413707,1751413707.542521,-18000,,
com.electron.carta,0,1751413706,1751413706,1751413706.578654,-18000,,
com.apple.finder,1,1751413705,1751413706,1751413706.147976,-18000,,
com.google.Chrome,2,1751413703,1751413705,1751413705.016433,-18000,,
com.electron.carta,1,1751413702,1751413703,1751413703.446192,-18000,,
com.google.Chrome,2,1751413700,1751413702,1751413702.7204561,-18000,,
com.apple.finder,1,1751413699,1751413700,1751413700.124537,-18000,,
com.google.Chrome,20,1751413679,1751413699,1751413699.317,-18000,,
com.electron.carta,16,1751413663,1751413679,1751413679.858834,-18000,,
com.apple.finder,4,1751413659,1751413663,1751413663.838937,-18000,,
com.google.Chrome,46,1751413613,1751413659,1751413659.942333,-18000,,
com.apple.finder,11,1751413602,1751413613,1751413613.427614,-18000,,
com.google.Chrome,13,1751413589,1751413602,1751413602.11148,-18000,,
com.apple.finder,19,1751413570,1751413589,1751413589.863111,-18000,,
com.electron.carta,7,1751413563,1751413570,1751413570.2502642,-18000,,
com.google.Chrome,50,1751413513,1751413563,1751413563.277135,-18000,,
com.leomehlig.today,49,1751413464,1751413513,1751413513.838484,-18000,,
com.google.Chrome,46,1751413418,1751413464,1751413464.16711,-18000,,
com.electron.carta,70,1751413348,1751413418,1751413418.6395059,-18000,,
com.google.Chrome,43,1751413305,1751413348,1751413348.197221,-18000,,
com.electron.carta,46,1751413259,1751413305,1751413305.836499,-18000,,
com.google.Chrome,116,1751413143,1751413259,1751413259.8642159,-18000,,
com.electron.carta,48,1751413095,1751413143,1751413143.926385,-18000,,
com.google.Chrome,31,1751413064,1751413095,1751413095.105623,-18000,,
com.electron.carta,17,1751413047,1751413064,1751413064.840317,-18000,,
com.google.Chrome,4,1751413043,1751413047,1751413047.325306,-18000,,
Astrospheric.Astrospheric,100,1751412935,1751413035,1751413035.9536672,-18000,EB445137-D7F5-57EC-87DA-1DB460D64046,"iPhone13,2"
com.electron.carta,141,1751412902,1751413043,1751413043.283742,-18000,,
com.google.Chrome,4,1751412898,1751412902,1751412902.929745,-18000,,
com.electron.carta,46,1751412852,1751412898,1751412898.8975182,-18000,,
com.google.Chrome,8,1751412844,1751412852,1751412852.4448981,-18000,,
com.electron.carta,0,1751412844,1751412844,1751412844.881675,-18000,,
com.apple.Music,27,1751412817,1751412844,1751412844.107466,-18000,,
com.electron.carta,39,1751412778,1751412817,1751412817.3197808,-18000,,
com.google.Chrome,85,1751412693,1751412778,1751412778.78527,-18000,,
com.electron.carta,18,1751412675,1751412693,1751412693.602494,-18000,,
com.google.Chrome,41,1751412634,1751412675,1751412675.231725,-18000,,
com.electron.carta,8,1751412626,1751412634,1751412634.5520859,-18000,,
com.google.Chrome,18,1751412608,1751412626,1751412626.816661,-18000,,
com.electron.carta,19,1751412589,1751412608,1751412608.791609,-18000,,
com.google.Chrome,57,1751412532,1751412589,1751412589.0639749,-18000,,
com.electron.carta,42,1751412490,1751412532,1751412532.6471338,-18000,,
com.google.Chrome,39,1751412451,1751412490,1751412490.0697079,-18000,,
com.electron.carta,35,1751412416,1751412451,1751412451.769607,-18000,,
com.ryansponzilli.DeepSkyCatalog,1,1751412383,1751412384,1751412384.855016,-18000,EB445137-D7F5-57EC-87DA-1DB460D64046,"iPhone13,2"
com.google.Chrome,44,1751412372,1751412416,1751412416.9755101,-18000,,
com.ryansponzilli.DeepSkyCatalog,119,1751412251,1751412370,1751412370.59335,-18000,EB445137-D7F5-57EC-87DA-1DB460D64046,"iPhone13,2"
Astrospheric.Astrospheric,20,1751412231,1751412251,1751412251.120459,-18000,EB445137-D7F5-57EC-87DA-1DB460D64046,"iPhone13,2"
com.google.chrome.ios,2,1751412227,1751412229,1751412229.55204,-18000,EB445137-D7F5-57EC-87DA-1DB460D64046,"iPhone13,2"
com.electron.carta,150,1751412222,1751412372,1751412372.37682,-18000,,
com.google.Chrome,39,1751412183,1751412222,1751412222.416506,-18000,,
com.electron.carta,74,1751412109,1751412183,1751412183.394012,-18000,,
com.google.Chrome,54,1751412055,1751412109,1751412109.065775,-18000,,
com.electron.carta,19,1751412036,1751412055,1751412055.0883842,-18000,,
com.google.Chrome,15,1751412021,1751412036,1751412036.701171,-18000,,
com.electron.carta,53,1751411968,1751412021,1751412021.504143,-18000,,
com.google.Chrome,10,1751411958,1751411968,1751411968.780283,-18000,,
com.apple.Music,39,1751411919,1751411958,1751411958.6621299,-18000,,
com.google.Chrome,85,1751411834,1751411919,1751411919.1146011,-18000,,
com.electron.carta,10,1751411824,1751411834,1751411834.540376,-18000,,
com.google.chrome.ios,277,1751410498,1751410775,1751410775.487949,-18000,EB445137-D7F5-57EC-87DA-1DB460D64046,"iPhone13,2"
com.apple.news,987,1751409510,1751410497,1751410497.610285,-18000,EB445137-D7F5-57EC-87DA-1DB460D64046,"iPhone13,2"
com.electron.carta,310,1751409477,1751409787,1751409787.232043,-18000,,
com.apple.findmy,7,1751409356,1751409363,1751409364.8198218,-18000,EB445137-D7F5-57EC-87DA-1DB460D64046,"iPhone13,2"
com.truebill.truebillnative,1,1751409355,1751409356,1751409357.635054,-18000,EB445137-D7F5-57EC-87DA-1DB460D64046,"iPhone13,2"
com.google.Chrome,208,1751409269,1751409477,1751409477.579468,-18000,,
com.apple.Maps,12,1751409257,1751409269,1751409269.993503,-18000,,
com.apple.CoreAuthUI,2,1751409193,1751409195,1751409195.586549,-18000,EB445137-D7F5-57EC-87DA-1DB460D64046,"iPhone13,2"
com.truebill.truebillnative,62,1751409188,1751409250,1751409250.284153,-18000,EB445137-D7F5-57EC-87DA-1DB460D64046,"iPhone13,2"
com.clairmail.fth.client,9,1751409178,1751409187,1751409187.991768,-18000,EB445137-D7F5-57EC-87DA-1DB460D64046,"iPhone13,2"
com.apple.CoreAuthUI,2,1751409128,1751409130,1751409130.36052,-18000,EB445137-D7F5-57EC-87DA-1DB460D64046,"iPhone13,2"
com.clairmail.fth.client,48,1751409122,1751409170,1751409171.130019,-18000,EB445137-D7F5-57EC-87DA-1DB460D64046,"iPhone13,2"
com.toyopagroup.picaboo,34,1751409083,1751409117,1751409117.233622,-18000,EB445137-D7F5-57EC-87DA-1DB460D64046,"iPhone13,2"
com.google.Chrome,262,1751408995,1751409257,1751409257.063188,-18000,,
com.electron.carta,9,1751408623,1751408632,1751408632.2460809,-18000,,
com.apple.finder,2,1751408621,1751408623,1751408623.700564,-18000,,
com.electron.carta,3,1751408618,1751408621,1751408621.210973,-18000,,
com.apple.finder,4,1751408614,1751408618,1751408618.8050508,-18000,,
com.electron.carta,56,1751408558,1751408614,1751408614.442184,-18000,,
com.google.Chrome,38,1751408520,1751408558,1751408558.61488,-18000,,
com.electron.carta,9,1751408511,1751408520,1751408520.0731192,-18000,,
com.google.Chrome,157,1751408354,1751408511,1751408511.73893,-18000,,
com.electron.carta,9,1751408345,1751408354,1751408354.39542,-18000,,
com.google.Chrome,6,1751408339,1751408345,1751408345.1602979,-18000,,
com.electron.carta,32,1751408307,1751408339,1751408339.292235,-18000,,
com.google.Chrome,60,1751408247,1751408307,1751408307.779314,-18000,,
com.electron.carta,48,1751408199,1751408247,1751408247.833152,-18000,,
com.apple.finder,12,1751408187,1751408199,1751408199.806346,-18000,,
com.electron.carta,101,1751408086,1751408187,1751408187.4847488,-18000,,
com.google.Chrome,15,1751408071,1751408086,1751408086.399469,-18000,,
com.electron.carta,8,1751408063,1751408071,1751408071.190433,-18000,,
com.google.Chrome,9,1751408054,1751408063,1751408063.2795072,-18000,,
com.electron.carta,21,1751408033,1751408054,1751408054.177836,-18000,,
com.google.Chrome,88,1751407945,1751408033,1751408033.805047,-18000,,
com.electron.carta,9,1751407936,1751407945,1751407945.982142,-18000,,
com.apple.finder,1,1751407935,1751407936,1751407936.693493,-18000,,
com.electron.carta,1,1751407934,1751407935,1751407935.816403,-18000,,
com.apple.finder,2,1751407932,1751407934,1751407934.6394238,-18000,,
com.electron.carta,1,1751407931,1751407932,1751407932.137517,-18000,,
com.apple.finder,1,1751407930,1751407931,1751407931.675754,-18000,,
com.electron.carta,1,1751407929,1751407930,1751407930.460259,-18000,,
com.apple.finder,1,1751407928,1751407929,1751407929.67222,-18000,,
com.electron.carta,0,1751407928,1751407928,1751407928.9308891,-18000,,
com.apple.finder,1,1751407927,1751407928,1751407928.0665112,-18000,,
com.electron.carta,2,1751407925,1751407927,1751407927.3620381,-18000,,
com.apple.finder,1,1751407924,1751407925,1751407925.71713,-18000,,
com.electron.carta,3,1751407921,1751407924,1751407924.847225,-18000,,
com.apple.finder,1,1751407920,1751407921,1751407921.430506,-18000,,
com.electron.carta,11,1751407909,1751407920,1751407920.122065,-18000,,
com.apple.finder,28,1751407881,1751407909,1751407909.133062,-18000,,
com.google.Chrome,8,1751407873,1751407881,1751407881.156581,-18000,,
com.leomehlig.today,74,1751407799,1751407873,1751407874.032826,-18000,,
com.google.Chrome,35,1751407764,1751407799,1751407799.7783952,-18000,,
com.electron.carta,80,1751407684,1751407764,1751407764.971603,-18000,,
com.google.Chrome,11,1751407673,1751407684,1751407684.672842,-18000,,
com.electron.carta,36,1751407637,1751407673,1751407673.496784,-18000,,
com.google.Chrome,57,1751407580,1751407637,1751407637.8887749,-18000,,
com.electron.carta,120,1751407460,1751407580,1751407581.0768418,-18000,,
com.google.Chrome,41,1751407419,1751407460,1751407460.5922918,-18000,,
com.electron.carta,37,1751407382,1751407419,1751407419.834728,-18000,,
com.google.Chrome,314,1751407068,1751407382,1751407382.308154,-18000,,
com.electron.carta,9,1751407059,1751407068,1751407069.007112,-18000,,
com.google.Chrome,43,1751407016,1751407059,1751407059.4681191,-18000,,
com.electron.carta,19,1751406997,1751407016,1751407016.112383,-18000,,
com.google.Chrome,20,1751406977,1751406997,1751406997.337696,-18000,,
com.electron.carta,6,1751406971,1751406977,1751406977.8070369,-18000,,
com.google.Chrome,104,1751406867,1751406971,1751406971.555516,-18000,,
com.electron.carta,46,1751406821,1751406867,1751406867.3557348,-18000,,
com.google.Chrome,99,1751406722,1751406821,1751406821.1924338,-18000,,
com.electron.carta,40,1751406682,1751406722,1751406722.515809,-18000,,
com.google.Chrome,17,1751406665,1751406682,1751406683.025171,-18000,,
com.electron.carta,1,1751406664,1751406665,1751406665.6753979,-18000,,
com.google.Chrome,2,1751406662,1751406664,1751406664.1420488,-18000,,
com.apple.finder,2,1751406660,1751406662,1751406662.812337,-18000,,
com.google.Chrome,75,1751406585,1751406660,1751406660.403884,-18000,,
com.electron.carta,2,1751406583,1751406585,1751406585.648069,-18000,,
com.apple.finder,4,1751406579,1751406583,1751406583.543036,-18000,,
com.electron.carta,20,1751406559,1751406579,1751406579.992347,-18000,,
com.google.Chrome,10,1751406549,1751406559,1751406559.208421,-18000,,
com.electron.carta,84,1751406465,1751406549,1751406549.914466,-18000,,
com.google.Chrome,156,1751406309,1751406465,1751406465.527844,-18000,,
com.apple.finder,55,1751406254,1751406309,1751406309.847145,-18000,,
com.electron.carta,182,1751406072,1751406254,1751406254.088772,-18000,,
com.apple.finder,9,1751406063,1751406072,1751406072.375399,-18000,,
com.google.Chrome,3,1751406060,1751406063,1751406063.4266229,-18000,,
com.apple.Notes,22,1751405684,1751405706,1751405706.174222,-18000,,
com.apple.iCal,2,1751405682,1751405684,1751405684.2554321,-18000,,
com.google.Chrome,400,1751405282,1751405682,1751405682.868712,-18000,,
com.apple.iCal,40,1751405242,1751405282,1751405282.565937,-18000,,
com.google.Chrome,1,1751405241,1751405242,1751405242.806896,-18000,,
com.apple.iCal,4,1751405237,1751405241,1751405241.358623,-18000,,
com.google.Chrome,177,1751405060,1751405237,1751405237.133088,-18000,,
com.apple.iCal,228,1751404820,1751405048,1751405048.5273762,-18000,,
com.apple.Notes,7,1751404813,1751404820,1751404820.636839,-18000,,
com.google.Chrome,14,1751404799,1751404813,1751404813.359095,-18000,,
com.google.Chrome,384,1751403389,1751403773,1751403773.833036,-18000,,
com.apple.CoreAuthUI,2,1751402926,1751402928,1751402928.068661,-18000,EB445137-D7F5-57EC-87DA-1DB460D64046,"iPhone13,2"
com.apple.journal,133,1751402924,1751403057,1751403057.5951428,-18000,EB445137-D7F5-57EC-87DA-1DB460D64046,"iPhone13,2"
com.apple.news,2,1751402919,1751402921,1751402921.4082541,-18000,EB445137-D7F5-57EC-87DA-1DB460D64046,"iPhone13,2"
com.apple.news,112,1751402780,1751402892,1751402892.462659,-18000,EB445137-D7F5-57EC-87DA-1DB460D64046,"iPhone13,2"
com.apple.news,103,1751402670,1751402773,1751402773.646109,-18000,EB445137-D7F5-57EC-87DA-1DB460D64046,"iPhone13,2"
com.apple.Music,22,1751402378,1751402400,1751402400.4847,-18000,EB445137-D7F5-57EC-87DA-1DB460D64046,"iPhone13,2"
com.apple.MobileSMS,3,1751402335,1751402338,1751402338.559708,-18000,EB445137-D7F5-57EC-87DA-1DB460D64046,"iPhone13,2"
com.apple.weather,13,1751401539,1751401552,1751401553.590283,-18000,EB445137-D7F5-57EC-87DA-1DB460D64046,"iPhone13,2"
com.apple.Music,2,1751401537,1751401539,1751401540.289592,-18000,EB445137-D7F5-57EC-87DA-1DB460D64046,"iPhone13,2"
com.apple.Music,29,1751394586,1751394615,1751394616.1290169,-18000,EB445137-D7F5-57EC-87DA-1DB460D64046,"iPhone13,2"
com.apple.Maps,1,1751394585,1751394586,1751394587.3753738,-18000,EB445137-D7F5-57EC-87DA-1DB460D64046,"iPhone13,2"
com.apple.Maps,866,1751393066,1751393932,1751393932.929113,-18000,EB445137-D7F5-57EC-87DA-1DB460D64046,"iPhone13,2"
com.apple.Maps,566,1751392499,1751393065,1751393065.6718612,-18000,EB445137-D7F5-57EC-87DA-1DB460D64046,"iPhone13,2"
com.apple.Maps,82,1751392416,1751392498,1751392498.211875,-18000,EB445137-D7F5-57EC-87DA-1DB460D64046,"iPhone13,2"
com.doordash.dasher,706,1751391706,1751392412,1751392413.4092898,-18000,EB445137-D7F5-57EC-87DA-1DB460D64046,"iPhone13,2"
com.doordash.dasher,311,1751391394,1751391705,1751391706.15854,-18000,EB445137-D7F5-57EC-87DA-1DB460D64046,"iPhone13,2"
com.doordash.dasher,56,1751391335,1751391391,1751391391.831408,-18000,EB445137-D7F5-57EC-87DA-1DB460D64046,"iPhone13,2"
com.doordash.dasher,96,1751391237,1751391333,1751391334.2814012,-18000,EB445137-D7F5-57EC-87DA-1DB460D64046,"iPhone13,2"
com.doordash.dasher,148,1751391081,1751391229,1751391229.611065,-18000,EB445137-D7F5-57EC-87DA-1DB460D64046,"iPhone13,2"
com.doordash.dasher,56,1751391018,1751391074,1751391075.179202,-18000,EB445137-D7F5-57EC-87DA-1DB460D64046,"iPhone13,2"
com.doordash.dasher,33,1751390977,1751391010,1751391011.179157,-18000,EB445137-D7F5-57EC-87DA-1DB460D64046,"iPhone13,2"
com.doordash.dasher,39,1751390930,1751390969,1751390970.150914,-18000,EB445137-D7F5-57EC-87DA-1DB460D64046,"iPhone13,2"
com.apple.news,160,1751390770,1751390930,1751390930.997021,-18000,EB445137-D7F5-57EC-87DA-1DB460D64046,"iPhone13,2"
com.doordash.dasher,3,1751390767,1751390770,1751390770.430952,-18000,EB445137-D7F5-57EC-87DA-1DB460D64046,"iPhone13,2"
com.apple.news,105,1751390662,1751390767,1751390767.329474,-18000,EB445137-D7F5-57EC-87DA-1DB460D64046,"iPhone13,2"
com.doordash.dasher,13,1751390649,1751390662,1751390662.3202639,-18000,EB445137-D7F5-57EC-87DA-1DB460D64046,"iPhone13,2"
com.apple.news,68,1751390581,1751390649,1751390649.4025989,-18000,EB445137-D7F5-57EC-87DA-1DB460D64046,"iPhone13,2"
com.doordash.dasher,276,1751390301,1751390577,1751390577.815875,-18000,EB445137-D7F5-57EC-87DA-1DB460D64046,"iPhone13,2"
gov.nps.mobileapp,123,1751390171,1751390294,1751390294.390032,-18000,EB445137-D7F5-57EC-87DA-1DB460D64046,"iPhone13,2"
com.apple.Preferences,56,1751390108,1751390164,1751390165.008101,-18000,EB445137-D7F5-57EC-87DA-1DB460D64046,"iPhone13,2"
com.apple.podcasts,48,1751390058,1751390106,1751390106.343288,-18000,EB445137-D7F5-57EC-87DA-1DB460D64046,"iPhone13,2"
com.apple.Preferences,112,1751389946,1751390058,1751390058.890452,-18000,EB445137-D7F5-57EC-87DA-1DB460D64046,"iPhone13,2"
com.truebill.truebillnative,2,1751389930,1751389932,1751389932.7962298,-18000,EB445137-D7F5-57EC-87DA-1DB460D64046,"iPhone13,2"
com.doordash.dasher,7,1751389920,1751389927,1751389927.941249,-18000,EB445137-D7F5-57EC-87DA-1DB460D64046,"iPhone13,2"
com.doordash.dasher,331,1751389588,1751389919,1751389919.485878,-18000,EB445137-D7F5-57EC-87DA-1DB460D64046,"iPhone13,2"
com.doordash.dasher,35,1751389546,1751389581,1751389581.796243,-18000,EB445137-D7F5-57EC-87DA-1DB460D64046,"iPhone13,2"
com.doordash.dasher,33,1751389477,1751389510,1751389510.349952,-18000,EB445137-D7F5-57EC-87DA-1DB460D64046,"iPhone13,2"
com.doordash.dasher,301,1751389171,1751389472,1751389472.4799562,-18000,EB445137-D7F5-57EC-87DA-1DB460D64046,"iPhone13,2"
com.doordash.dasher,41,1751389130,1751389171,1751389171.1169338,-18000,EB445137-D7F5-57EC-87DA-1DB460D64046,"iPhone13,2"
com.doordash.dasher,31,1751389048,1751389079,1751389079.145436,-18000,EB445137-D7F5-57EC-87DA-1DB460D64046,"iPhone13,2"
com.doordash.dasher,31,1751389009,1751389040,1751389040.5977569,-18000,EB445137-D7F5-57EC-87DA-1DB460D64046,"iPhone13,2"
com.doordash.dasher,40,1751388949,1751388989,1751388989.511601,-18000,EB445137-D7F5-57EC-87DA-1DB460D64046,"iPhone13,2"
com.doordash.dasher,102,1751388832,1751388934,1751388934.7155209,-18000,EB445137-D7F5-57EC-87DA-1DB460D64046,"iPhone13,2"
com.google.chrome.ios,168,1751388663,1751388831,1751388831.740302,-18000,EB445137-D7F5-57EC-87DA-1DB460D64046,"iPhone13,2"
com.doordash.dasher,4,1751388658,1751388662,1751388663.0272012,-18000,EB445137-D7F5-57EC-87DA-1DB460D64046,"iPhone13,2"
com.apple.Health,62,1751388596,1751388658,1751388658.663786,-18000,EB445137-D7F5-57EC-87DA-1DB460D64046,"iPhone13,2"
com.strava.stravaride,85,1751388509,1751388594,1751388594.307951,-18000,EB445137-D7F5-57EC-87DA-1DB460D64046,"iPhone13,2"
com.doordash.dasher,25,1751388482,1751388507,1751388507.359034,-18000,EB445137-D7F5-57EC-87DA-1DB460D64046,"iPhone13,2"
com.apple.Health,49,1751388411,1751388460,1751388460.438606,-18000,EB445137-D7F5-57EC-87DA-1DB460D64046,"iPhone13,2"
com.doordash.dasher,0,1751388411,1751388411,1751388411.841819,-18000,EB445137-D7F5-57EC-87DA-1DB460D64046,"iPhone13,2"
com.doordash.dasher,65,1751388342,1751388407,1751388407.39749,-18000,EB445137-D7F5-57EC-87DA-1DB460D64046,"iPhone13,2"
com.doordash.dasher,447,1751387895,1751388342,1751388342.2357101,-18000,EB445137-D7F5-57EC-87DA-1DB460D64046,"iPhone13,2"
com.doordash.dasher,50,1751387844,1751387894,1751387894.9622622,-18000,EB445137-D7F5-57EC-87DA-1DB460D64046,"iPhone13,2"
com.doordash.dasher,579,1751387260,1751387839,1751387839.3421202,-18000,EB445137-D7F5-57EC-87DA-1DB460D64046,"iPhone13,2"
com.doordash.dasher,70,1751387189,1751387259,1751387259.76998,-18000,EB445137-D7F5-57EC-87DA-1DB460D64046,"iPhone13,2"
com.doordash.dasher,38,1751387138,1751387176,1751387177.38919,-18000,EB445137-D7F5-57EC-87DA-1DB460D64046,"iPhone13,2"
com.doordash.dasher,142,1751386995,1751387137,1751387137.219265,-18000,EB445137-D7F5-57EC-87DA-1DB460D64046,"iPhone13,2"
com.doordash.dasher,191,1751386803,1751386994,1751386994.680388,-18000,EB445137-D7F5-57EC-87DA-1DB460D64046,"iPhone13,2"
com.apple.podcasts,37,1751386766,1751386803,1751386803.320033,-18000,EB445137-D7F5-57EC-87DA-1DB460D64046,"iPhone13,2"
com.doordash.dasher,5,1751386758,1751386763,1751386763.8016,-18000,EB445137-D7F5-57EC-87DA-1DB460D64046,"iPhone13,2"
com.doordash.dasher,11,1751386584,1751386595,1751386596.171836,-18000,EB445137-D7F5-57EC-87DA-1DB460D64046,"iPhone13,2"
com.apple.CoreAuthUI,2,1751386507,1751386509,1751386509.708869,-18000,EB445137-D7F5-57EC-87DA-1DB460D64046,"iPhone13,2"
com.truebill.truebillnative,79,1751386501,1751386580,1751386580.203834,-18000,EB445137-D7F5-57EC-87DA-1DB460D64046,"iPhone13,2"
com.doordash.dasher,185,1751386308,1751386493,1751386493.838944,-18000,EB445137-D7F5-57EC-87DA-1DB460D64046,"iPhone13,2"
com.google.Chrome,1211,1751385385,1751386596,1751386596.4350219,-18000,,
com.apple.Notes,40,1751385345,1751385385,1751385385.4838529,-18000,,
com.google.Chrome,10,1751385335,1751385345,1751385345.246323,-18000,,
com.apple.Notes,29,1751385306,1751385335,1751385335.34554,-18000,,
com.google.Chrome,191,1751385115,1751385306,1751385306.084192,-18000,,
com.apple.finder,4,1751385111,1751385115,1751385115.7629929,-18000,,
com.doordash.dasher,1234,1751385070,1751386304,1751386304.887064,-18000,EB445137-D7F5-57EC-87DA-1DB460D64046,"iPhone13,2"
com.renpho.health,45,1751379430,1751379475,1751379475.716301,-18000,EB445137-D7F5-57EC-87DA-1DB460D64046,"iPhone13,2"
com.strava.stravaride,2,1751379427,1751379429,1751379429.7536159,-18000,EB445137-D7F5-57EC-87DA-1DB460D64046,"iPhone13,2"
com.strava.stravaride,155,1751379095,1751379250,1751379251.7358441,-18000,EB445137-D7F5-57EC-87DA-1DB460D64046,"iPhone13,2"
com.apple.Health,32,1751379012,1751379044,1751379044.488686,-18000,EB445137-D7F5-57EC-87DA-1DB460D64046,"iPhone13,2"
com.mcdonalds.gma,52,1751378947,1751378999,1751378999.708082,-18000,EB445137-D7F5-57EC-87DA-1DB460D64046,"iPhone13,2"
com.mcdonalds.gma,46,1751378900,1751378946,1751378946.433837,-18000,EB445137-D7F5-57EC-87DA-1DB460D64046,"iPhone13,2"
com.apple.Preferences,7,1751378893,1751378900,1751378900.397471,-18000,EB445137-D7F5-57EC-87DA-1DB460D64046,"iPhone13,2"
com.mcdonalds.gma,45,1751378848,1751378893,1751378893.213598,-18000,EB445137-D7F5-57EC-87DA-1DB460D64046,"iPhone13,2"
com.strava.stravaride,152,1751378663,1751378815,1751378815.640449,-18000,EB445137-D7F5-57EC-87DA-1DB460D64046,"iPhone13,2"
com.strava.stravaride,266,1751378397,1751378663,1751378663.527597,-18000,EB445137-D7F5-57EC-87DA-1DB460D64046,"iPhone13,2"
com.apple.weather,77,1751378317,1751378394,1751378394.0913548,-18000,EB445137-D7F5-57EC-87DA-1DB460D64046,"iPhone13,2"
com.apple.mobilecal,11,1751378264,1751378275,1751378276.016753,-18000,EB445137-D7F5-57EC-87DA-1DB460D64046,"iPhone13,2"
com.apple.weather,22,1751376696,1751376718,1751376718.866039,-18000,EB445137-D7F5-57EC-87DA-1DB460D64046,"iPhone13,2"
com.apple.mobiletimer,2,1751376690,1751376692,1751376692.540453,-18000,EB445137-D7F5-57EC-87DA-1DB460D64046,"iPhone13,2"
com.apple.mobiletimer,1,1751376665,1751376666,1751376667.1865768,-18000,EB445137-D7F5-57EC-87DA-1DB460D64046,"iPhone13,2"
com.apple.mobiletimer,7,1751346753,1751346760,1751346760.505324,-18000,EB445137-D7F5-57EC-87DA-1DB460D64046,"iPhone13,2"
com.apple.Music,3,1751346750,1751346753,1751346753.8794231,-18000,EB445137-D7F5-57EC-87DA-1DB460D64046,"iPhone13,2"
com.apple.finder,2,1751345920,1751345922,1751345922.984674,-18000,,
com.apple.Notes,0,1751345920,1751345920,1751345920.950479,-18000,,
com.leomehlig.today,1,1751345919,1751345920,1751345920.323666,-18000,,
com.apple.Music,0,1751345919,1751345919,1751345920.003556,-18000,,
com.google.Chrome,2,1751345917,1751345919,1751345919.189769,-18000,,
com.apple.MobileSMS,2,1751345915,1751345917,1751345917.8970718,-18000,,
com.google.Chrome,390,1751345525,1751345915,1751345915.582572,-18000,,
com.apple.MobileSMS,2,1751345523,1751345525,1751345525.369934,-18000,,
com.google.Chrome,2,1751345521,1751345523,1751345523.462008,-18000,,
com.apple.MobileSMS,3,1751345518,1751345521,1751345521.9114199,-18000,,
com.apple.Music,37,1751345481,1751345518,1751345518.9176311,-18000,,
com.apple.MobileSMS,6,1751345475,1751345481,1751345481.2773662,-18000,,
com.apple.Music,1,1751345474,1751345475,1751345475.289671,-18000,,
com.google.Chrome,454,1751345020,1751345474,1751345474.588338,-18000,,
com.google.Chrome,664,1751344312,1751344976,1751344976.609291,-18000,,
com.apple.MobileSMS,3,1751344309,1751344312,1751344312.919625,-18000,,
com.google.Chrome,519,1751343790,1751344309,1751344309.655554,-18000,,
com.apple.MobileSMS,2,1751343788,1751343790,1751343790.5219522,-18000,,
com.google.Chrome,63,1751343725,1751343788,1751343788.78181,-18000,,
com.apple.MobileSMS,20,1751343705,1751343725,1751343725.361724,-18000,,
com.google.Chrome,9,1751343696,1751343705,1751343705.540845,-18000,,
com.apple.MobileSMS,3,1751343693,1751343696,1751343696.866241,-18000,,
com.google.Chrome,553,1751343140,1751343693,1751343693.6393661,-18000,,
com.apple.Music,2,1751342699,1751342701,1751342701.988442,-18000,EB445137-D7F5-57EC-87DA-1DB460D64046,"iPhone13,2"
com.apple.Music,18,1751342274,1751342292,1751342293.359463,-18000,EB445137-D7F5-57EC-87DA-1DB460D64046,"iPhone13,2"
com.apple.Music,194,1751341242,1751341436,1751341436.978479,-18000,EB445137-D7F5-57EC-87DA-1DB460D64046,"iPhone13,2"
com.mcdonalds.gma,2,1751341234,1751341236,1751341236.59428,-18000,EB445137-D7F5-57EC-87DA-1DB460D64046,"iPhone13,2"
com.mcdonalds.gma,51,1751340276,1751340327,1751340328.0870361,-18000,EB445137-D7F5-57EC-87DA-1DB460D64046,"iPhone13,2"
com.mcdonalds.gma,3,1751340257,1751340260,1751340260.3194718,-18000,EB445137-D7F5-57EC-87DA-1DB460D64046,"iPhone13,2"
com.apple.PassbookUIService,7,1751340131,1751340138,1751340138.878726,-18000,EB445137-D7F5-57EC-87DA-1DB460D64046,"iPhone13,2"
com.mcdonalds.gma,183,1751340030,1751340213,1751340214.0079842,-18000,EB445137-D7F5-57EC-87DA-1DB460D64046,"iPhone13,2"
com.mcdonalds.gma,4,1751338735,1751338739,1751338739.892045,-18000,EB445137-D7F5-57EC-87DA-1DB460D64046,"iPhone13,2"
com.mcdonalds.gma,76,1751338657,1751338733,1751338733.489919,-18000,EB445137-D7F5-57EC-87DA-1DB460D64046,"iPhone13,2"
com.apple.Preferences,8,1751338649,1751338657,1751338658.027497,-18000,EB445137-D7F5-57EC-87DA-1DB460D64046,"iPhone13,2"
com.apple.AuthKitUIService,10,1751338577,1751338587,1751338587.514834,-18000,EB445137-D7F5-57EC-87DA-1DB460D64046,"iPhone13,2"
com.mcdonalds.gma,109,1751338540,1751338649,1751338650.1039839,-18000,EB445137-D7F5-57EC-87DA-1DB460D64046,"iPhone13,2"
com.mcdonalds.gma,28,1751338501,1751338529,1751338529.154299,-18000,EB445137-D7F5-57EC-87DA-1DB460D64046,"iPhone13,2"
com.apple.AppStore,53,1751338448,1751338501,1751338501.971538,-18000,EB445137-D7F5-57EC-87DA-1DB460D64046,"iPhone13,2"
com.apple.MobileSMS,2,1751338439,1751338441,1751338441.232139,-18000,EB445137-D7F5-57EC-87DA-1DB460D64046,"iPhone13,2"
com.apple.MobileSMS,74,1751337734,1751337808,1751337808.530778,-18000,EB445137-D7F5-57EC-87DA-1DB460D64046,"iPhone13,2"
com.toyopagroup.picaboo,3,1751332295,1751332298,1751332298.6690788,-18000,EB445137-D7F5-57EC-87DA-1DB460D64046,"iPhone13,2"
com.toyopagroup.picaboo,56,1751332188,1751332244,1751332245.006108,-18000,EB445137-D7F5-57EC-87DA-1DB460D64046,"iPhone13,2"
com.apple.findmy,2,1751332184,1751332186,1751332186.786459,-18000,EB445137-D7F5-57EC-87DA-1DB460D64046,"iPhone13,2"
com.apple.findmy,8,1751329550,1751329558,1751329558.717722,-18000,EB445137-D7F5-57EC-87DA-1DB460D64046,"iPhone13,2"
com.apple.findmy,81,1751329330,1751329411,1751329411.724978,-18000,EB445137-D7F5-57EC-87DA-1DB460D64046,"iPhone13,2"
com.apple.MobileSMS,2,1751329328,1751329330,1751329330.410244,-18000,EB445137-D7F5-57EC-87DA-1DB460D64046,"iPhone13,2"
com.apple.MobileSMS,8,1751329019,1751329027,1751329027.3562799,-18000,EB445137-D7F5-57EC-87DA-1DB460D64046,"iPhone13,2"
com.google.Chrome,524,1751328903,1751329427,1751329428.03263,-18000,,
com.apple.MobileSMS,9,1751327478,1751327487,1751327487.866044,-18000,EB445137-D7F5-57EC-87DA-1DB460D64046,"iPhone13,2"
com.apple.MobileSMS,22,1751327218,1751327240,1751327240.8151932,-18000,EB445137-D7F5-57EC-87DA-1DB460D64046,"iPhone13,2"
com.toyopagroup.picaboo,5,1751327213,1751327218,1751327218.710882,-18000,EB445137-D7F5-57EC-87DA-1DB460D64046,"iPhone13,2"
com.google.Chrome,1903,1751326709,1751328612,1751328612.659041,-18000,,
com.toyopagroup.picaboo,10,1751326696,1751326706,1751326707.917395,-18000,EB445137-D7F5-57EC-87DA-1DB460D64046,"iPhone13,2"
com.apple.MobileSMS,2,1751326694,1751326696,1751326696.744254,-18000,EB445137-D7F5-57EC-87DA-1DB460D64046,"iPhone13,2"
com.leomehlig.today,73,1751326636,1751326709,1751326709.897479,-18000,,
com.google.Chrome,105,1751326531,1751326636,1751326636.384445,-18000,,
com.apple.Notes,21,1751326510,1751326531,1751326532.0025802,-18000,,
com.google.Chrome,208,1751326302,1751326510,1751326510.757199,-18000,,
com.apple.Notes,11,1751326291,1751326302,1751326302.528606,-18000,,
com.google.Chrome,6,1751326285,1751326291,1751326291.620641,-18000,,
com.apple.MobileSMS,14,1751326189,1751326203,1751326203.993137,-18000,EB445137-D7F5-57EC-87DA-1DB460D64046,"iPhone13,2"
com.toyopagroup.picaboo,13,1751326174,1751326187,1751326187.749701,-18000,EB445137-D7F5-57EC-87DA-1DB460D64046,"iPhone13,2"
com.apple.mobilecal,1,1751326173,1751326174,1751326174.07216,-18000,EB445137-D7F5-57EC-87DA-1DB460D64046,"iPhone13,2"
com.apple.mobilecal,37,1751326040,1751326077,1751326077.554068,-18000,EB445137-D7F5-57EC-87DA-1DB460D64046,"iPhone13,2"
com.amazon.Amazon,173,1751324492,1751324665,1751324665.769713,-18000,EB445137-D7F5-57EC-87DA-1DB460D64046,"iPhone13,2"
com.google.chrome.ios,46,1751324446,1751324492,1751324492.734606,-18000,EB445137-D7F5-57EC-87DA-1DB460D64046,"iPhone13,2"
com.amazon.Amazon,79,1751324367,1751324446,1751324446.923722,-18000,EB445137-D7F5-57EC-87DA-1DB460D64046,"iPhone13,2"
com.letterboxd.LetterboxdApp,63,1751324281,1751324344,1751324344.255117,-18000,EB445137-D7F5-57EC-87DA-1DB460D64046,"iPhone13,2"
com.toyopagroup.picaboo,61,1751324200,1751324261,1751324262.009779,-18000,EB445137-D7F5-57EC-87DA-1DB460D64046,"iPhone13,2"
com.google.Chrome,766,1751323296,1751324062,1751324062.523875,-18000,,
com.apple.finder,2,1751323294,1751323296,1751323296.843338,-18000,,
com.apple.MobileSMS,17,1751323150,1751323167,1751323168.102507,-18000,EB445137-D7F5-57EC-87DA-1DB460D64046,"iPhone13,2"
com.apple.findmy,7,1751323140,1751323147,1751323147.243257,-18000,EB445137-D7F5-57EC-87DA-1DB460D64046,"iPhone13,2"
com.apple.MobileSMS,24,1751323114,1751323138,1751323138.2935538,-18000,EB445137-D7F5-57EC-87DA-1DB460D64046,"iPhone13,2"
com.doordash.dasher,27,1751323087,1751323114,1751323114.987097,-18000,EB445137-D7F5-57EC-87DA-1DB460D64046,"iPhone13,2"
com.apple.weather,33,1751323054,1751323087,1751323087.752439,-18000,EB445137-D7F5-57EC-87DA-1DB460D64046,"iPhone13,2"
com.apple.MobileSMS,7,1751323047,1751323054,1751323054.442583,-18000,EB445137-D7F5-57EC-87DA-1DB460D64046,"iPhone13,2"
com.leomehlig.today,103,1751322944,1751323047,1751323047.205861,-18000,EB445137-D7F5-57EC-87DA-1DB460D64046,"iPhone13,2"
com.apple.mobilecal,11,1751322929,1751322940,1751322941.008006,-18000,EB445137-D7F5-57EC-87DA-1DB460D64046,"iPhone13,2"
com.apple.Fitness,2,1751322927,1751322929,1751322929.361649,-18000,EB445137-D7F5-57EC-87DA-1DB460D64046,"iPhone13,2"
com.apple.MobileSMS,4,1751322923,1751322927,1751322927.778411,-18000,EB445137-D7F5-57EC-87DA-1DB460D64046,"iPhone13,2"
com.apple.Fitness,0,1751322922,1751322922,1751322923.147358,-18000,EB445137-D7F5-57EC-87DA-1DB460D64046,"iPhone13,2"
com.apple.mobilecal,42,1751322880,1751322922,1751322922.1410189,-18000,EB445137-D7F5-57EC-87DA-1DB460D64046,"iPhone13,2"
com.strava.stravaride,2,1751322874,1751322876,1751322876.680286,-18000,EB445137-D7F5-57EC-87DA-1DB460D64046,"iPhone13,2"
com.strava.stravaride,29,1751322831,1751322860,1751322861.000731,-18000,EB445137-D7F5-57EC-87DA-1DB460D64046,"iPhone13,2"
com.strava.stravaride,15,1751322815,1751322830,1751322830.797039,-18000,EB445137-D7F5-57EC-87DA-1DB460D64046,"iPhone13,2"
com.apple.finder,8,1751322686,1751322694,1751322694.6955318,-18000,,
com.apple.iCal,2,1751322684,1751322686,1751322686.3651261,-18000,,
com.apple.finder,1,1751322683,1751322684,1751322684.60953,-18000,,
cc.arduino.IDE2,1,1751322682,1751322683,1751322683.26845,-18000,,
com.google.Chrome,8,1751322674,1751322682,1751322682.6079612,-18000,,
com.apple.MobileSMS,10,1751322664,1751322674,1751322674.344215,-18000,,
com.google.Chrome,33,1751322631,1751322664,1751322664.595129,-18000,,
com.apple.MobileSMS,7,1751322624,1751322631,1751322631.734776,-18000,,
com.google.Chrome,5,1751322619,1751322624,1751322624.6805491,-18000,,
com.apple.findmy,2,1751322617,1751322619,1751322619.2401528,-18000,,
com.apple.weather,7,1751320923,1751320930,1751320930.9844851,-18000,EB445137-D7F5-57EC-87DA-1DB460D64046,"iPhone13,2"
com.apple.findmy,13,1751320483,1751320496,1751320497.3084679,-18000,,
com.google.Chrome,3,1751320480,1751320483,1751320483.600645,-18000,,
com.google.Chrome,430,1751319131,1751319561,1751319561.999819,-18000,,
com.apple.CoreAuthUI,3,1751318979,1751318982,1751318982.8391,-18000,EB445137-D7F5-57EC-87DA-1DB460D64046,"iPhone13,2"
com.truebill.truebillnative,26,1751318975,1751319001,1751319001.996427,-18000,EB445137-D7F5-57EC-87DA-1DB460D64046,"iPhone13,2"
com.google.Chrome,337,1751316306,1751316643,1751316643.2311258,-18000,,
com.google.Chrome,302,1751314763,1751315065,1751315065.4826999,-18000,,
com.google.Chrome,578,1751314170,1751314748,1751314748.310907,-18000,,
com.google.Chrome,1186,1751312456,1751313642,1751313642.051029,-18000,,
com.google.Chrome,1047,1751310969,1751312016,1751312016.397015,-18000,,
cc.arduino.IDE2,83,1751310886,1751310969,1751310969.269814,-18000,,
com.apple.finder,4,1751310882,1751310886,1751310886.4416819,-18000,,
cc.arduino.IDE2,5,1751310877,1751310882,1751310882.997458,-18000,,
com.apple.finder,15,1751310862,1751310877,1751310877.6452951,-18000,,
cc.arduino.IDE2,41,1751310821,1751310862,1751310862.805486,-18000,,
com.apple.finder,2,1751310819,1751310821,1751310821.237516,-18000,,
com.google.Chrome,126,1751310693,1751310819,1751310819.14884,-18000,,
com.apple.iCal,1,1751310692,1751310693,1751310694.061822,-18000,,
com.google.chrome.ios,4,1751310679,1751310683,1751310683.264085,-18000,EB445137-D7F5-57EC-87DA-1DB460D64046,"iPhone13,2"
com.google.chrome.ios,22,1751310592,1751310614,1751310614.556882,-18000,EB445137-D7F5-57EC-87DA-1DB460D64046,"iPhone13,2"
com.apple.finder,210,1751310482,1751310692,1751310692.11994,-18000,,
cc.arduino.IDE2,8,1751310474,1751310482,1751310482.842846,-18000,,
com.apple.finder,10,1751310464,1751310474,1751310474.199395,-18000,,
cc.arduino.IDE2,1,1751310463,1751310464,1751310465.134019,-18000,,
com.google.Chrome,4,1751310412,1751310416,1751310416.58218,-18000,,
com.google.chrome.ios,55,1751310346,1751310401,1751310402.030827,-18000,EB445137-D7F5-57EC-87DA-1DB460D64046,"iPhone13,2"
com.apple.Maps,2,1751310344,1751310346,1751310346.584337,-18000,EB445137-D7F5-57EC-87DA-1DB460D64046,"iPhone13,2"
com.apple.Maps,5,1751309929,1751309934,1751309934.958107,-18000,EB445137-D7F5-57EC-87DA-1DB460D64046,"iPhone13,2"
com.apple.podcasts,2,1751309927,1751309929,1751309930.031878,-18000,EB445137-D7F5-57EC-87DA-1DB460D64046,"iPhone13,2"
com.apple.podcasts,2,1751309832,1751309834,1751309834.392057,-18000,EB445137-D7F5-57EC-87DA-1DB460D64046,"iPhone13,2"
com.apple.podcasts,31,1751309752,1751309783,1751309784.091502,-18000,EB445137-D7F5-57EC-87DA-1DB460D64046,"iPhone13,2"
com.apple.Maps,9,1751309743,1751309752,1751309752.792056,-18000,EB445137-D7F5-57EC-87DA-1DB460D64046,"iPhone13,2"
com.apple.podcasts,17,1751309726,1751309743,1751309743.913372,-18000,EB445137-D7F5-57EC-87DA-1DB460D64046,"iPhone13,2"
com.apple.news,135,1751309586,1751309721,1751309722.015765,-18000,EB445137-D7F5-57EC-87DA-1DB460D64046,"iPhone13,2"
com.apple.MobileSMS,105,1751309474,1751309579,1751309579.0648232,-18000,EB445137-D7F5-57EC-87DA-1DB460D64046,"iPhone13,2"
com.apple.Maps,53,1751309421,1751309474,1751309474.210099,-18000,EB445137-D7F5-57EC-87DA-1DB460D64046,"iPhone13,2"
com.apple.MobileSMS,51,1751309370,1751309421,1751309421.649564,-18000,EB445137-D7F5-57EC-87DA-1DB460D64046,"iPhone13,2"
com.apple.Maps,20,1751309350,1751309370,1751309370.212062,-18000,EB445137-D7F5-57EC-87DA-1DB460D64046,"iPhone13,2"
com.apple.MobileSMS,53,1751309297,1751309350,1751309350.954321,-18000,EB445137-D7F5-57EC-87DA-1DB460D64046,"iPhone13,2"
com.apple.Maps,33,1751309264,1751309297,1751309297.952662,-18000,EB445137-D7F5-57EC-87DA-1DB460D64046,"iPhone13,2"
com.apple.MobileSMS,101,1751309163,1751309264,1751309264.693033,-18000,EB445137-D7F5-57EC-87DA-1DB460D64046,"iPhone13,2"
com.apple.findmy,7,1751309156,1751309163,1751309163.263489,-18000,EB445137-D7F5-57EC-87DA-1DB460D64046,"iPhone13,2"
com.apple.MobileSMS,65,1751309091,1751309156,1751309156.432561,-18000,EB445137-D7F5-57EC-87DA-1DB460D64046,"iPhone13,2"
com.apple.findmy,10,1751309081,1751309091,1751309091.42208,-18000,EB445137-D7F5-57EC-87DA-1DB460D64046,"iPhone13,2"
com.apple.MobileSMS,22,1751309058,1751309080,1751309080.471081,-18000,EB445137-D7F5-57EC-87DA-1DB460D64046,"iPhone13,2"
com.apple.findmy,5,1751309053,1751309058,1751309059.997418,-18000,EB445137-D7F5-57EC-87DA-1DB460D64046,"iPhone13,2"
com.apple.MobileSMS,1,1751309051,1751309052,1751309053.2753701,-18000,EB445137-D7F5-57EC-87DA-1DB460D64046,"iPhone13,2"
com.doordash.dasher,2,1751309049,1751309051,1751309051.721297,-18000,EB445137-D7F5-57EC-87DA-1DB460D64046,"iPhone13,2"
com.doordash.dasher,31,1751308630,1751308661,1751308662.0525231,-18000,EB445137-D7F5-57EC-87DA-1DB460D64046,"iPhone13,2"
com.apple.MobileSMS,4,1751308624,1751308628,1751308628.462502,-18000,EB445137-D7F5-57EC-87DA-1DB460D64046,"iPhone13,2"
com.apple.MobileSMS,10,1751308605,1751308615,1751308615.7187939,-18000,EB445137-D7F5-57EC-87DA-1DB460D64046,"iPhone13,2"
com.doordash.dasher,41,1751308557,1751308598,1751308598.310938,-18000,EB445137-D7F5-57EC-87DA-1DB460D64046,"iPhone13,2"
com.doordash.dasher,104,1751308451,1751308555,1751308555.364419,-18000,EB445137-D7F5-57EC-87DA-1DB460D64046,"iPhone13,2"
com.doordash.dasher,57,1751308377,1751308434,1751308434.505821,-18000,EB445137-D7F5-57EC-87DA-1DB460D64046,"iPhone13,2"
com.doordash.dasher,260,1751308114,1751308374,1751308375.140874,-18000,EB445137-D7F5-57EC-87DA-1DB460D64046,"iPhone13,2"
com.doordash.dasher,77,1751308036,1751308113,1751308113.085748,-18000,EB445137-D7F5-57EC-87DA-1DB460D64046,"iPhone13,2"
com.doordash.dasher,728,1751307192,1751307920,1751307920.682736,-18000,EB445137-D7F5-57EC-87DA-1DB460D64046,"iPhone13,2"
com.doordash.dasher,43,1751307146,1751307189,1751307190.2045522,-18000,EB445137-D7F5-57EC-87DA-1DB460D64046,"iPhone13,2"
com.doordash.dasher,440,1751306704,1751307144,1751307144.753429,-18000,EB445137-D7F5-57EC-87DA-1DB460D64046,"iPhone13,2"
com.doordash.dasher,88,1751306605,1751306693,1751306693.448746,-18000,EB445137-D7F5-57EC-87DA-1DB460D64046,"iPhone13,2"
com.doordash.dasher,95,1751306504,1751306599,1751306599.784234,-18000,EB445137-D7F5-57EC-87DA-1DB460D64046,"iPhone13,2"
com.doordash.dasher,43,1751306420,1751306463,1751306463.817246,-18000,EB445137-D7F5-57EC-87DA-1DB460D64046,"iPhone13,2"
com.doordash.dasher,31,1751306206,1751306237,1751306238.207536,-18000,EB445137-D7F5-57EC-87DA-1DB460D64046,"iPhone13,2"
com.doordash.dasher,20,1751306185,1751306205,1751306205.913272,-18000,EB445137-D7F5-57EC-87DA-1DB460D64046,"iPhone13,2"
com.doordash.dasher,105,1751306080,1751306185,1751306186.377644,-18000,EB445137-D7F5-57EC-87DA-1DB460D64046,"iPhone13,2"
com.doordash.dasher,143,1751305916,1751306059,1751306059.931758,-18000,EB445137-D7F5-57EC-87DA-1DB460D64046,"iPhone13,2"
com.doordash.dasher,241,1751305667,1751305908,1751305908.848709,-18000,EB445137-D7F5-57EC-87DA-1DB460D64046,"iPhone13,2"
com.doordash.dasher,405,1751305259,1751305664,1751305665.381537,-18000,EB445137-D7F5-57EC-87DA-1DB460D64046,"iPhone13,2"
com.google.chrome.ios,304,1751304955,1751305259,1751305259.444293,-18000,EB445137-D7F5-57EC-87DA-1DB460D64046,"iPhone13,2"
com.doordash.dasher,1,1751304954,1751304955,1751304955.861793,-18000,EB445137-D7F5-57EC-87DA-1DB460D64046,"iPhone13,2"
com.doordash.dasher,290,1751304350,1751304640,1751304640.507207,-18000,EB445137-D7F5-57EC-87DA-1DB460D64046,"iPhone13,2"
com.doordash.dasher,1,1751304325,1751304326,1751304327.0097718,-18000,EB445137-D7F5-57EC-87DA-1DB460D64046,"iPhone13,2"
com.doordash.dasher,166,1751304155,1751304321,1751304321.6448421,-18000,EB445137-D7F5-57EC-87DA-1DB460D64046,"iPhone13,2"
com.apple.podcasts,31,1751304124,1751304155,1751304155.124868,-18000,EB445137-D7F5-57EC-87DA-1DB460D64046,"iPhone13,2"
com.doordash.dasher,327,1751303797,1751304124,1751304124.29016,-18000,EB445137-D7F5-57EC-87DA-1DB460D64046,"iPhone13,2"
com.apple.news,35,1751303761,1751303796,1751303796.8948932,-18000,EB445137-D7F5-57EC-87DA-1DB460D64046,"iPhone13,2"
com.doordash.dasher,30,1751303729,1751303759,1751303759.8069649,-18000,EB445137-D7F5-57EC-87DA-1DB460D64046,"iPhone13,2"
com.apple.podcasts,13,1751303715,1751303728,1751303728.398981,-18000,EB445137-D7F5-57EC-87DA-1DB460D64046,"iPhone13,2"
com.google.chrome.ios,68,1751303647,1751303715,1751303715.4229832,-18000,EB445137-D7F5-57EC-87DA-1DB460D64046,"iPhone13,2"
com.apple.podcasts,23,1751303624,1751303647,1751303647.7161698,-18000,EB445137-D7F5-57EC-87DA-1DB460D64046,"iPhone13,2"
com.apple.MobileSMS,5,1751303606,1751303611,1751303611.213985,-18000,EB445137-D7F5-57EC-87DA-1DB460D64046,"iPhone13,2"
com.doordash.dasher,5,1751303593,1751303598,1751303598.266999,-18000,EB445137-D7F5-57EC-87DA-1DB460D64046,"iPhone13,2"
com.doordash.dasher,28,1751303565,1751303593,1751303593.361156,-18000,EB445137-D7F5-57EC-87DA-1DB460D64046,"iPhone13,2"
com.doordash.dasher,93,1751303469,1751303562,1751303562.3467422,-18000,EB445137-D7F5-57EC-87DA-1DB460D64046,"iPhone13,2"
com.doordash.dasher,80,1751303387,1751303467,1751303467.422636,-18000,EB445137-D7F5-57EC-87DA-1DB460D64046,"iPhone13,2"
com.doordash.dasher,482,1751302903,1751303385,1751303385.772287,-18000,EB445137-D7F5-57EC-87DA-1DB460D64046,"iPhone13,2"
com.apple.MobileSMS,18,1751302885,1751302903,1751302903.075032,-18000,EB445137-D7F5-57EC-87DA-1DB460D64046,"iPhone13,2"
com.doordash.dasher,0,1751302885,1751302885,1751302885.956289,-18000,EB445137-D7F5-57EC-87DA-1DB460D64046,"iPhone13,2"
com.doordash.dasher,16,1751302864,1751302880,1751302880.520697,-18000,EB445137-D7F5-57EC-87DA-1DB460D64046,"iPhone13,2"
com.doordash.dasher,65,1751302797,1751302862,1751302862.3021312,-18000,EB445137-D7F5-57EC-87DA-1DB460D64046,"iPhone13,2"
com.apple.MobileSMS,0,1751302797,1751302797,1751302797.41605,-18000,EB445137-D7F5-57EC-87DA-1DB460D64046,"iPhone13,2"
com.apple.MobileSMS,51,1751302719,1751302770,1751302770.479519,-18000,EB445137-D7F5-57EC-87DA-1DB460D64046,"iPhone13,2"
com.doordash.dasher,0,1751302719,1751302719,1751302719.706845,-18000,EB445137-D7F5-57EC-87DA-1DB460D64046,"iPhone13,2"
com.doordash.dasher,41,1751302678,1751302719,1751302719.168182,-18000,EB445137-D7F5-57EC-87DA-1DB460D64046,"iPhone13,2"
com.doordash.dasher,45,1751302623,1751302668,1751302669.3661299,-18000,EB445137-D7F5-57EC-87DA-1DB460D64046,"iPhone13,2"
com.doordash.dasher,271,1751302351,1751302622,1751302623.1108189,-18000,EB445137-D7F5-57EC-87DA-1DB460D64046,"iPhone13,2"
com.doordash.dasher,60,1751302290,1751302350,1751302350.208902,-18000,EB445137-D7F5-57EC-87DA-1DB460D64046,"iPhone13,2"
com.doordash.dasher,73,1751302216,1751302289,1751302290.117665,-18000,EB445137-D7F5-57EC-87DA-1DB460D64046,"iPhone13,2"
com.doordash.dasher,42,1751302169,1751302211,1751302211.555511,-18000,EB445137-D7F5-57EC-87DA-1DB460D64046,"iPhone13,2"
com.doordash.dasher,92,1751302076,1751302168,1751302168.846332,-18000,EB445137-D7F5-57EC-87DA-1DB460D64046,"iPhone13,2"
com.doordash.dasher,1,1751302074,1751302075,1751302075.6370459,-18000,EB445137-D7F5-57EC-87DA-1DB460D64046,"iPhone13,2"
com.doordash.dasher,44,1751302020,1751302064,1751302064.280744,-18000,EB445137-D7F5-57EC-87DA-1DB460D64046,"iPhone13,2"
com.doordash.dasher,151,1751301868,1751302019,1751302019.2895842,-18000,EB445137-D7F5-57EC-87DA-1DB460D64046,"iPhone13,2"
com.doordash.dasher,59,1751301808,1751301867,1751301867.599541,-18000,EB445137-D7F5-57EC-87DA-1DB460D64046,"iPhone13,2"
com.doordash.dasher,541,1751301262,1751301803,1751301803.890827,-18000,EB445137-D7F5-57EC-87DA-1DB460D64046,"iPhone13,2"
com.doordash.dasher,337,1751300924,1751301261,1751301261.326731,-18000,EB445137-D7F5-57EC-87DA-1DB460D64046,"iPhone13,2"
com.apple.MobileSMS,13,1751300911,1751300924,1751300924.576369,-18000,EB445137-D7F5-57EC-87DA-1DB460D64046,"iPhone13,2"
com.apple.mobilecal,5,1751300905,1751300910,1751300910.4666948,-18000,EB445137-D7F5-57EC-87DA-1DB460D64046,"iPhone13,2"
com.doordash.dasher,2,1751300898,1751300900,1751300900.484383,-18000,EB445137-D7F5-57EC-87DA-1DB460D64046,"iPhone13,2"
com.doordash.dasher,57,1751300834,1751300891,1751300892.130832,-18000,EB445137-D7F5-57EC-87DA-1DB460D64046,"iPhone13,2"
com.doordash.dasher,70,1751300693,1751300763,1751300763.497941,-18000,EB445137-D7F5-57EC-87DA-1DB460D64046,"iPhone13,2"
com.doordash.dasher,82,1751300465,1751300547,1751300547.9054232,-18000,EB445137-D7F5-57EC-87DA-1DB460D64046,"iPhone13,2"
com.doordash.dasher,54,1751300198,1751300252,1751300252.9249558,-18000,EB445137-D7F5-57EC-87DA-1DB460D64046,"iPhone13,2"
com.doordash.dasher,457,1751299681,1751300138,1751300139.126764,-18000,EB445137-D7F5-57EC-87DA-1DB460D64046,"iPhone13,2"
com.doordash.dasher,55,1751299625,1751299680,1751299681.152482,-18000,EB445137-D7F5-57EC-87DA-1DB460D64046,"iPhone13,2"
com.doordash.dasher,55,1751299396,1751299451,1751299452.0037541,-18000,EB445137-D7F5-57EC-87DA-1DB460D64046,"iPhone13,2"
com.doordash.dasher,106,1751299276,1751299382,1751299382.829483,-18000,EB445137-D7F5-57EC-87DA-1DB460D64046,"iPhone13,2"
com.truebill.truebillnative,39,1751299237,1751299276,1751299276.179731,-18000,EB445137-D7F5-57EC-87DA-1DB460D64046,"iPhone13,2"
com.doordash.dasher,15,1751299222,1751299237,1751299237.5640059,-18000,EB445137-D7F5-57EC-87DA-1DB460D64046,"iPhone13,2"
com.truebill.truebillnative,138,1751299084,1751299222,1751299223.053643,-18000,EB445137-D7F5-57EC-87DA-1DB460D64046,"iPhone13,2"
com.apple.calculator,14,1751299070,1751299084,1751299084.981657,-18000,EB445137-D7F5-57EC-87DA-1DB460D64046,"iPhone13,2"
com.apple.MobileSMS,8,1751299062,1751299070,1751299070.394975,-18000,EB445137-D7F5-57EC-87DA-1DB460D64046,"iPhone13,2"
com.apple.CoreAuthUI,1,1751298998,1751298999,1751298999.9982328,-18000,EB445137-D7F5-57EC-87DA-1DB460D64046,"iPhone13,2"
com.truebill.truebillnative,73,1751298989,1751299062,1751299062.310458,-18000,EB445137-D7F5-57EC-87DA-1DB460D64046,"iPhone13,2"
com.google.chrome.ios,13,1751298930,1751298943,1751298943.9763222,-18000,EB445137-D7F5-57EC-87DA-1DB460D64046,"iPhone13,2"
com.google.chrome.ios,86,1751298843,1751298929,1751298929.6998749,-18000,EB445137-D7F5-57EC-87DA-1DB460D64046,"iPhone13,2"
com.google.chrome.ios,26,1751298816,1751298842,1751298843.067172,-18000,EB445137-D7F5-57EC-87DA-1DB460D64046,"iPhone13,2"
com.strava.stravaride,34,1751298782,1751298816,1751298816.160863,-18000,EB445137-D7F5-57EC-87DA-1DB460D64046,"iPhone13,2"
com.doordash.dasher,11,1751298765,1751298776,1751298776.9347482,-18000,EB445137-D7F5-57EC-87DA-1DB460D64046,"iPhone13,2"
com.microsoft.Office.Outlook,76,1751298666,1751298742,1751298742.347488,-18000,EB445137-D7F5-57EC-87DA-1DB460D64046,"iPhone13,2"
com.doordash.dasher,5,1751298661,1751298666,1751298666.233282,-18000,EB445137-D7F5-57EC-87DA-1DB460D64046,"iPhone13,2"
com.doordash.dasher,202,1751298456,1751298658,1751298658.534941,-18000,EB445137-D7F5-57EC-87DA-1DB460D64046,"iPhone13,2"
com.doordash.dasher,15,1751298407,1751298422,1751298422.454191,-18000,EB445137-D7F5-57EC-87DA-1DB460D64046,"iPhone13,2"
com.doordash.dasher,522,1751297878,1751298400,1751298401.13041,-18000,EB445137-D7F5-57EC-87DA-1DB460D64046,"iPhone13,2"
com.doordash.dasher,116,1751297760,1751297876,1751297876.686891,-18000,EB445137-D7F5-57EC-87DA-1DB460D64046,"iPhone13,2"
com.apple.podcasts,1,1751297759,1751297760,1751297760.430132,-18000,EB445137-D7F5-57EC-87DA-1DB460D64046,"iPhone13,2"
com.apple.PosterBoard,0,1751297759,1751297759,1751297760.073652,-18000,EB445137-D7F5-57EC-87DA-1DB460D64046,"iPhone13,2"
com.apple.podcasts,159,1751297446,1751297605,1751297605.113244,-18000,EB445137-D7F5-57EC-87DA-1DB460D64046,"iPhone13,2"
com.doordash.dasher,25,1751297415,1751297440,1751297440.525135,-18000,EB445137-D7F5-57EC-87DA-1DB460D64046,"iPhone13,2"
com.apple.MobileSMS,8,1751296991,1751296999,1751296999.4441462,-18000,EB445137-D7F5-57EC-87DA-1DB460D64046,"iPhone13,2"
com.apple.Maps,0,1751296991,1751296991,1751296991.34462,-18000,EB445137-D7F5-57EC-87DA-1DB460D64046,"iPhone13,2"
com.apple.Maps,110,1751296879,1751296989,1751296990.038955,-18000,EB445137-D7F5-57EC-87DA-1DB460D64046,"iPhone13,2"
com.apple.MobileSMS,39,1751296837,1751296876,1751296876.4724689,-18000,EB445137-D7F5-57EC-87DA-1DB460D64046,"iPhone13,2"
com.doordash.dasher,0,1751296837,1751296837,1751296837.356617,-18000,EB445137-D7F5-57EC-87DA-1DB460D64046,"iPhone13,2"
com.doordash.dasher,55,1751295643,1751295698,1751295699.2258902,-18000,EB445137-D7F5-57EC-87DA-1DB460D64046,"iPhone13,2"
com.strava.stravaride,3,1751295640,1751295643,1751295643.4597201,-18000,EB445137-D7F5-57EC-87DA-1DB460D64046,"iPhone13,2"
com.strava.stravaride,89,1751294151,1751294240,1751294241.236096,-18000,EB445137-D7F5-57EC-87DA-1DB460D64046,"iPhone13,2"
com.apple.reminders,5,1751294141,1751294146,1751294146.598878,-18000,EB445137-D7F5-57EC-87DA-1DB460D64046,"iPhone13,2"
com.apple.weather,53,1751291547,1751291600,1751291600.267682,-18000,EB445137-D7F5-57EC-87DA-1DB460D64046,"iPhone13,2"
com.apple.Health,51,1751290280,1751290331,1751290331.526047,-18000,EB445137-D7F5-57EC-87DA-1DB460D64046,"iPhone13,2"
com.microsoft.onenote,172,1751290097,1751290269,1751290269.7699552,-18000,EB445137-D7F5-57EC-87DA-1DB460D64046,"iPhone13,2"
com.apple.mobilecal,2,1751290095,1751290097,1751290097.378169,-18000,EB445137-D7F5-57EC-87DA-1DB460D64046,"iPhone13,2"
com.microsoft.onenote,50,1751290045,1751290095,1751290095.6918259,-18000,EB445137-D7F5-57EC-87DA-1DB460D64046,"iPhone13,2"
com.apple.mobilecal,6,1751290039,1751290045,1751290045.3750792,-18000,EB445137-D7F5-57EC-87DA-1DB460D64046,"iPhone13,2"
com.apple.CoreAuthUI,2,1751290020,1751290022,1751290022.240397,-18000,EB445137-D7F5-57EC-87DA-1DB460D64046,"iPhone13,2"
com.microsoft.onenote,24,1751290012,1751290036,1751290036.580065,-18000,EB445137-D7F5-57EC-87DA-1DB460D64046,"iPhone13,2"
com.apple.Health,172,1751289836,1751290008,1751290008.933826,-18000,EB445137-D7F5-57EC-87DA-1DB460D64046,"iPhone13,2"
com.apple.news,411,1751288858,1751289269,1751289269.366465,-18000,EB445137-D7F5-57EC-87DA-1DB460D64046,"iPhone13,2"
com.apple.Health,17,1751288802,1751288819,1751288819.057139,-18000,EB445137-D7F5-57EC-87DA-1DB460D64046,"iPhone13,2"
com.renpho.health,3,1751288796,1751288799,1751288799.955416,-18000,EB445137-D7F5-57EC-87DA-1DB460D64046,"iPhone13,2"
com.renpho.health,32,1751288679,1751288711,1751288711.758764,-18000,EB445137-D7F5-57EC-87DA-1DB460D64046,"iPhone13,2"
com.apple.mobiletimer,2,1751288671,1751288673,1751288673.4301028,-18000,EB445137-D7F5-57EC-87DA-1DB460D64046,"iPhone13,2"
com.apple.mobiletimer,16,1751254670,1751254686,1751254687.1413941,-18000,EB445137-D7F5-57EC-87DA-1DB460D64046,"iPhone13,2"
com.apple.journal,0,1751254670,1751254670,1751254670.938683,-18000,EB445137-D7F5-57EC-87DA-1DB460D64046,"iPhone13,2"
com.apple.journal,1223,1751253445,1751254668,1751254668.580988,-18000,EB445137-D7F5-57EC-87DA-1DB460D64046,"iPhone13,2"
com.apple.journal,673,1751252756,1751253429,1751253429.608214,-18000,EB445137-D7F5-57EC-87DA-1DB460D64046,"iPhone13,2"
com.apple.MobileSMS,3,1751252753,1751252756,1751252756.516574,-18000,EB445137-D7F5-57EC-87DA-1DB460D64046,"iPhone13,2"
com.apple.journal,58,1751252695,1751252753,1751252753.46494,-18000,EB445137-D7F5-57EC-87DA-1DB460D64046,"iPhone13,2"
com.apple.MobileSMS,29,1751252666,1751252695,1751252695.350656,-18000,EB445137-D7F5-57EC-87DA-1DB460D64046,"iPhone13,2"
com.apple.CoreAuthUI,2,1751252569,1751252571,1751252571.209698,-18000,EB445137-D7F5-57EC-87DA-1DB460D64046,"iPhone13,2"
com.apple.journal,98,1751252568,1751252666,1751252667.0559602,-18000,EB445137-D7F5-57EC-87DA-1DB460D64046,"iPhone13,2"
com.apple.CoreAuthUI,2,1751252539,1751252541,1751252541.586282,-18000,EB445137-D7F5-57EC-87DA-1DB460D64046,"iPhone13,2"
com.apple.Passwords,3,1751252538,1751252541,1751252541.458603,-18000,EB445137-D7F5-57EC-87DA-1DB460D64046,"iPhone13,2"
com.apple.CoreAuthUI,1,1751251242,1751251243,1751251243.8895679,-18000,EB445137-D7F5-57EC-87DA-1DB460D64046,"iPhone13,2"
com.apple.Passwords,60,1751251241,1751251301,1751251301.90783,-18000,EB445137-D7F5-57EC-87DA-1DB460D64046,"iPhone13,2"
com.apple.weather,14,1751250742,1751250756,1751250756.200701,-18000,EB445137-D7F5-57EC-87DA-1DB460D64046,"iPhone13,2"
com.apple.CoreAuthUI,1,1751250741,1751250742,1751250742.4345279,-18000,EB445137-D7F5-57EC-87DA-1DB460D64046,"iPhone13,2"
com.apple.Passwords,2,1751250740,1751250742,1751250742.431361,-18000,EB445137-D7F5-57EC-87DA-1DB460D64046,"iPhone13,2"
com.apple.CoreAuthUI,2,1751250329,1751250331,1751250331.7189689,-18000,EB445137-D7F5-57EC-87DA-1DB460D64046,"iPhone13,2"
com.apple.Passwords,54,1751250327,1751250381,1751250381.413142,-18000,EB445137-D7F5-57EC-87DA-1DB460D64046,"iPhone13,2"
com.google.Chrome,3,1751249875,1751249878,1751249879.007316,-18000,,
com.apple.MobileSMS,3,1751249872,1751249875,1751249875.764772,-18000,,
com.apple.Music,1,1751249871,1751249872,1751249873.001359,-18000,,
com.google.Chrome,381,1751249490,1751249871,1751249871.825886,-18000,,
com.apple.Music,11,1751249479,1751249490,1751249491.017243,-18000,,
com.google.Chrome,52,1751249427,1751249479,1751249479.680857,-18000,,
com.apple.Music,44,1751249383,1751249427,1751249427.43805,-18000,,
com.google.Chrome,1167,1751248216,1751249383,1751249383.906672,-18000,,
com.apple.MobileSMS,35,1751247626,1751247661,1751247661.5358372,-18000,EB445137-D7F5-57EC-87DA-1DB460D64046,"iPhone13,2"
com.apple.findmy,7,1751247598,1751247605,1751247605.288701,-18000,EB445137-D7F5-57EC-87DA-1DB460D64046,"iPhone13,2"
com.apple.weather,32,1751247565,1751247597,1751247597.496103,-18000,EB445137-D7F5-57EC-87DA-1DB460D64046,"iPhone13,2"
com.apple.news,2,1751247563,1751247565,1751247566.0285258,-18000,EB445137-D7F5-57EC-87DA-1DB460D64046,"iPhone13,2"
com.google.Chrome,2449,1751245766,1751248215,1751248215.4413052,-18000,,
com.apple.Music,55,1751245711,1751245766,1751245766.3104439,-18000,,
com.google.Chrome,2047,1751243664,1751245711,1751245711.221308,-18000,,
com.google.Chrome,300,1751242632,1751242932,1751242932.957025,-18000,,
com.apple.news,47,1751242613,1751242660,1751242660.439848,-18000,EB445137-D7F5-57EC-87DA-1DB460D64046,"iPhone13,2"
com.apple.Maps,0,1751242613,1751242613,1751242613.9620728,-18000,EB445137-D7F5-57EC-87DA-1DB460D64046,"iPhone13,2"
com.apple.Maps,32,1751242555,1751242587,1751242588.02629,-18000,EB445137-D7F5-57EC-87DA-1DB460D64046,"iPhone13,2"
com.google.Gmail,169,1751242386,1751242555,1751242555.088932,-18000,EB445137-D7F5-57EC-87DA-1DB460D64046,"iPhone13,2"
com.google.Chrome,316,1751241515,1751241831,1751241831.022886,-18000,,
com.strava.stravaride,208,1751241099,1751241307,1751241308.270969,-18000,EB445137-D7F5-57EC-87DA-1DB460D64046,"iPhone13,2"
com.apple.Health,124,1751240964,1751241088,1751241088.924572,-18000,EB445137-D7F5-57EC-87DA-1DB460D64046,"iPhone13,2"
net.kortina.labs.Venmo,0,1751240964,1751240964,1751240965.006115,-18000,EB445137-D7F5-57EC-87DA-1DB460D64046,"iPhone13,2"
net.kortina.labs.Venmo,3,1751240961,1751240964,1751240964.410114,-18000,EB445137-D7F5-57EC-87DA-1DB460D64046,"iPhone13,2"
net.kortina.labs.Venmo,63,1751240883,1751240946,1751240946.59337,-18000,EB445137-D7F5-57EC-87DA-1DB460D64046,"iPhone13,2"
com.google.Gmail,2,1751240842,1751240844,1751240845.202153,-18000,EB445137-D7F5-57EC-87DA-1DB460D64046,"iPhone13,2"
com.google.Chrome,538,1751240711,1751241249,1751241249.3227592,-18000,,
com.apple.mobileslideshow,145,1751240426,1751240571,1751240571.483535,-18000,EB445137-D7F5-57EC-87DA-1DB460D64046,"iPhone13,2"
com.apple.MobileSMS,31,1751240395,1751240426,1751240427.047493,-18000,EB445137-D7F5-57EC-87DA-1DB460D64046,"iPhone13,2"
com.apple.news,0,1751240395,1751240395,1751240395.9229789,-18000,EB445137-D7F5-57EC-87DA-1DB460D64046,"iPhone13,2"
com.google.Chrome,569,1751238753,1751239322,1751239322.880055,-18000,,
com.apple.MobileSMS,9,1751238744,1751238753,1751238753.626507,-18000,,
com.google.Chrome,685,1751238059,1751238744,1751238744.7348719,-18000,,
com.google.Chrome,1417,1751236183,1751237600,1751237600.976645,-18000,,
com.google.Chrome,421,1751235735,1751236156,1751236156.306223,-18000,,
com.apple.news,173,1751235683,1751235856,1751235856.414546,-18000,EB445137-D7F5-57EC-87DA-1DB460D64046,"iPhone13,2"
com.google.Chrome,625,1751234717,1751235342,1751235342.741219,-18000,,
com.apple.Maps,18,1751234699,1751234717,1751234717.531985,-18000,,
com.google.Chrome,58,1751234641,1751234699,1751234699.441997,-18000,,
com.clairmail.fth.client,40,1751233969,1751234009,1751234009.064893,-18000,EB445137-D7F5-57EC-87DA-1DB460D64046,"iPhone13,2"
com.apple.MobileSMS,1,1751233968,1751233969,1751233969.947685,-18000,EB445137-D7F5-57EC-87DA-1DB460D64046,"iPhone13,2"
com.apple.CoreAuthUI,2,1751233917,1751233919,1751233919.647929,-18000,EB445137-D7F5-57EC-87DA-1DB460D64046,"iPhone13,2"
com.clairmail.fth.client,56,1751233912,1751233968,1751233968.114392,-18000,EB445137-D7F5-57EC-87DA-1DB460D64046,"iPhone13,2"
com.apple.MobileSMS,3,1751233905,1751233908,1751233908.483419,-18000,EB445137-D7F5-57EC-87DA-1DB460D64046,"iPhone13,2"
com.apple.MobileSMS,28,1751233806,1751233834,1751233834.9924989,-18000,EB445137-D7F5-57EC-87DA-1DB460D64046,"iPhone13,2"
com.apple.MobileSMS,21,1751233777,1751233798,1751233798.694052,-18000,EB445137-D7F5-57EC-87DA-1DB460D64046,"iPhone13,2"
com.apple.MobileSMS,99,1751233663,1751233762,1751233762.697648,-18000,EB445137-D7F5-57EC-87DA-1DB460D64046,"iPhone13,2"
com.apple.mobileslideshow,15,1751233648,1751233663,1751233663.931429,-18000,EB445137-D7F5-57EC-87DA-1DB460D64046,"iPhone13,2"
com.apple.MobileSMS,55,1751233590,1751233645,1751233645.412879,-18000,EB445137-D7F5-57EC-87DA-1DB460D64046,"iPhone13,2"
com.apple.MobileSMS,250,1751233340,1751233590,1751233590.219645,-18000,EB445137-D7F5-57EC-87DA-1DB460D64046,"iPhone13,2"
com.google.Sheets,2,1751233338,1751233340,1751233340.493861,-18000,EB445137-D7F5-57EC-87DA-1DB460D64046,"iPhone13,2"
com.apple.MobileSMS,134,1751233204,1751233338,1751233338.403516,-18000,EB445137-D7F5-57EC-87DA-1DB460D64046,"iPhone13,2"
com.google.Sheets,88,1751233116,1751233204,1751233204.298366,-18000,EB445137-D7F5-57EC-87DA-1DB460D64046,"iPhone13,2"
com.apple.Preferences,36,1751230944,1751230980,1751230980.137343,-18000,EB445137-D7F5-57EC-87DA-1DB460D64046,"iPhone13,2"
com.google.Sheets,0,1751230944,1751230944,1751230944.766674,-18000,EB445137-D7F5-57EC-87DA-1DB460D64046,"iPhone13,2"
com.google.Sheets,18,1751230641,1751230659,1751230660.349934,-18000,EB445137-D7F5-57EC-87DA-1DB460D64046,"iPhone13,2"
com.apple.MobileSMS,2,1751230639,1751230641,1751230641.554823,-18000,EB445137-D7F5-57EC-87DA-1DB460D64046,"iPhone13,2"
com.apple.MobileSMS,8,1751216399,1751216407,1751216407.1792831,-18000,EB445137-D7F5-57EC-87DA-1DB460D64046,"iPhone13,2"
com.apple.findmy,9,1751216388,1751216397,1751216397.875229,-18000,EB445137-D7F5-57EC-87DA-1DB460D64046,"iPhone13,2"
com.google.Sheets,152,1751215917,1751216069,1751216069.80358,-18000,EB445137-D7F5-57EC-87DA-1DB460D64046,"iPhone13,2"
com.apple.mobilenotes,2,1751215912,1751215914,1751215914.5280042,-18000,EB445137-D7F5-57EC-87DA-1DB460D64046,"iPhone13,2"
com.apple.mobilenotes,5,1751215905,1751215910,1751215910.542533,-18000,EB445137-D7F5-57EC-87DA-1DB460D64046,"iPhone13,2"
com.apple.mobilenotes,74,1751215716,1751215790,1751215790.801326,-18000,EB445137-D7F5-57EC-87DA-1DB460D64046,"iPhone13,2"
com.apple.Maps,35,1751215424,1751215459,1751215459.295445,-18000,EB445137-D7F5-57EC-87DA-1DB460D64046,"iPhone13,2"
com.apple.Maps,92,1751215291,1751215383,1751215383.879856,-18000,EB445137-D7F5-57EC-87DA-1DB460D64046,"iPhone13,2"
com.google.Gmail,2,1751215288,1751215290,1751215290.280056,-18000,EB445137-D7F5-57EC-87DA-1DB460D64046,"iPhone13,2"
com.google.Gmail,30,1751214625,1751214655,1751214655.383068,-18000,EB445137-D7F5-57EC-87DA-1DB460D64046,"iPhone13,2"
com.google.Gmail,20,1751214604,1751214624,1751214624.124792,-18000,EB445137-D7F5-57EC-87DA-1DB460D64046,"iPhone13,2"
com.apple.Maps,1,1751214594,1751214595,1751214597.0412369,-18000,EB445137-D7F5-57EC-87DA-1DB460D64046,"iPhone13,2"
com.apple.camera,0,1751214594,1751214594,1751214596.470782,-18000,EB445137-D7F5-57EC-87DA-1DB460D64046,"iPhone13,2"
com.apple.Maps,9,1751201018,1751201027,1751201027.2826118,-18000,EB445137-D7F5-57EC-87DA-1DB460D64046,"iPhone13,2"
com.apple.Maps,13,1751200981,1751200994,1751200994.806834,-18000,EB445137-D7F5-57EC-87DA-1DB460D64046,"iPhone13,2"
com.apple.Maps,8,1751200781,1751200789,1751200790.0349932,-18000,EB445137-D7F5-57EC-87DA-1DB460D64046,"iPhone13,2"
com.apple.Maps,15,1751200452,1751200467,1751200467.636437,-18000,EB445137-D7F5-57EC-87DA-1DB460D64046,"iPhone13,2"
com.apple.Maps,13,1751199931,1751199944,1751199944.9965959,-18000,EB445137-D7F5-57EC-87DA-1DB460D64046,"iPhone13,2"
com.apple.Maps,5,1751198555,1751198560,1751198560.88698,-18000,EB445137-D7F5-57EC-87DA-1DB460D64046,"iPhone13,2"
com.apple.Maps,37,1751198473,1751198510,1751198510.253444,-18000,EB445137-D7F5-57EC-87DA-1DB460D64046,"iPhone13,2"
com.apple.Maps,19,1751198082,1751198101,1751198101.6553721,-18000,EB445137-D7F5-57EC-87DA-1DB460D64046,"iPhone13,2"
com.toyopagroup.picaboo,10,1751197493,1751197503,1751197503.678663,-18000,EB445137-D7F5-57EC-87DA-1DB460D64046,"iPhone13,2"
com.google.chrome.ios,45,1751196919,1751196964,1751196964.2321382,-18000,EB445137-D7F5-57EC-87DA-1DB460D64046,"iPhone13,2"
com.apple.Health,25,1751196726,1751196751,1751196751.25595,-18000,EB445137-D7F5-57EC-87DA-1DB460D64046,"iPhone13,2"
com.supercell.magic,161,1751195502,1751195663,1751195664.610693,-18000,EB445137-D7F5-57EC-87DA-1DB460D64046,"iPhone13,2"
com.google.chrome.ios,3,1751195497,1751195500,1751195500.461462,-18000,EB445137-D7F5-57EC-87DA-1DB460D64046,"iPhone13,2"
com.google.chrome.ios,16,1751195376,1751195392,1751195392.663198,-18000,EB445137-D7F5-57EC-87DA-1DB460D64046,"iPhone13,2"
com.google.chrome.ios,96,1751195183,1751195279,1751195279.456629,-18000,EB445137-D7F5-57EC-87DA-1DB460D64046,"iPhone13,2"
com.apple.MobileSMS,13,1751167370,1751167383,1751167383.542324,-18000,EB445137-D7F5-57EC-87DA-1DB460D64046,"iPhone13,2"
com.apple.MobileSMS,107,1751167128,1751167235,1751167235.904169,-18000,EB445137-D7F5-57EC-87DA-1DB460D64046,"iPhone13,2"
com.apple.Maps,9,1751155209,1751155218,1751155218.94099,-18000,EB445137-D7F5-57EC-87DA-1DB460D64046,"iPhone13,2"
com.apple.Maps,15,1751155028,1751155043,1751155043.8432589,-18000,EB445137-D7F5-57EC-87DA-1DB460D64046,"iPhone13,2"
com.apple.Maps,28,1751154894,1751154922,1751154923.099231,-18000,EB445137-D7F5-57EC-87DA-1DB460D64046,"iPhone13,2"
com.toyopagroup.picaboo,3,1751151196,1751151199,1751151199.5948849,-18000,EB445137-D7F5-57EC-87DA-1DB460D64046,"iPhone13,2"
com.apple.mobiletimer,0,1751151196,1751151196,1751151196.889408,-18000,EB445137-D7F5-57EC-87DA-1DB460D64046,"iPhone13,2"
com.apple.mobiletimer,15,1751150263,1751150278,1751150278.555227,-18000,EB445137-D7F5-57EC-87DA-1DB460D64046,"iPhone13,2"
com.apple.calculator,1,1751150253,1751150254,1751150254.5611072,-18000,EB445137-D7F5-57EC-87DA-1DB460D64046,"iPhone13,2"
com.apple.mobileslideshow,101,1751149965,1751150066,1751150066.8720121,-18000,EB445137-D7F5-57EC-87DA-1DB460D64046,"iPhone13,2"
com.apple.MobileSMS,2,1751149963,1751149965,1751149965.771272,-18000,EB445137-D7F5-57EC-87DA-1DB460D64046,"iPhone13,2"
com.apple.MobileSMS,62,1751149897,1751149959,1751149959.1072989,-18000,EB445137-D7F5-57EC-87DA-1DB460D64046,"iPhone13,2"
com.apple.Maps,13,1751149884,1751149897,1751149898.019911,-18000,EB445137-D7F5-57EC-87DA-1DB460D64046,"iPhone13,2"
com.apple.Maps,29,1751140273,1751140302,1751140303.030109,-18000,EB445137-D7F5-57EC-87DA-1DB460D64046,"iPhone13,2"
com.google.Gmail,3,1751140270,1751140273,1751140273.125478,-18000,EB445137-D7F5-57EC-87DA-1DB460D64046,"iPhone13,2"
com.google.Gmail,8,1751140018,1751140026,1751140027.070609,-18000,EB445137-D7F5-57EC-87DA-1DB460D64046,"iPhone13,2"
com.google.Gmail,72,1751139935,1751140007,1751140007.310472,-18000,EB445137-D7F5-57EC-87DA-1DB460D64046,"iPhone13,2"
com.apple.Maps,17,1751139916,1751139933,1751139933.521708,-18000,EB445137-D7F5-57EC-87DA-1DB460D64046,"iPhone13,2"
com.apple.Maps,450,1751139407,1751139857,1751139857.6652222,-18000,EB445137-D7F5-57EC-87DA-1DB460D64046,"iPhone13,2"
com.apple.Maps,9,1751138486,1751138495,1751138495.609021,-18000,EB445137-D7F5-57EC-87DA-1DB460D64046,"iPhone13,2"
com.apple.Maps,13,1751138049,1751138062,1751138062.293694,-18000,EB445137-D7F5-57EC-87DA-1DB460D64046,"iPhone13,2"
com.apple.Maps,50,1751137477,1751137527,1751137527.576254,-18000,EB445137-D7F5-57EC-87DA-1DB460D64046,"iPhone13,2"
com.apple.Maps,49,1751136902,1751136951,1751136952.024293,-18000,EB445137-D7F5-57EC-87DA-1DB460D64046,"iPhone13,2"
com.apple.Maps,8,1751135610,1751135618,1751135618.706706,-18000,EB445137-D7F5-57EC-87DA-1DB460D64046,"iPhone13,2"
com.apple.Maps,5,1751135200,1751135205,1751135205.4720469,-18000,EB445137-D7F5-57EC-87DA-1DB460D64046,"iPhone13,2"
com.apple.Maps,12,1751134863,1751134875,1751134875.291556,-18000,EB445137-D7F5-57EC-87DA-1DB460D64046,"iPhone13,2"
com.apple.Maps,15,1751134643,1751134658,1751134658.1780028,-18000,EB445137-D7F5-57EC-87DA-1DB460D64046,"iPhone13,2"
com.apple.Maps,15,1751134184,1751134199,1751134199.7107139,-18000,EB445137-D7F5-57EC-87DA-1DB460D64046,"iPhone13,2"
com.apple.Maps,7,1751133923,1751133930,1751133930.3082829,-18000,EB445137-D7F5-57EC-87DA-1DB460D64046,"iPhone13,2"
com.apple.Maps,2,1751133919,1751133921,1751133922.107172,-18000,EB445137-D7F5-57EC-87DA-1DB460D64046,"iPhone13,2"
com.apple.Maps,52,1751133854,1751133906,1751133906.638277,-18000,EB445137-D7F5-57EC-87DA-1DB460D64046,"iPhone13,2"
com.letterboxd.LetterboxdApp,2,1751133852,1751133854,1751133854.494454,-18000,EB445137-D7F5-57EC-87DA-1DB460D64046,"iPhone13,2"
com.letterboxd.LetterboxdApp,162,1751133046,1751133208,1751133208.4753199,-18000,EB445137-D7F5-57EC-87DA-1DB460D64046,"iPhone13,2"
com.apple.Maps,79,1751130868,1751130947,1751130947.225977,-18000,EB445137-D7F5-57EC-87DA-1DB460D64046,"iPhone13,2"
com.apple.Maps,67,1751130783,1751130850,1751130850.769589,-18000,EB445137-D7F5-57EC-87DA-1DB460D64046,"iPhone13,2"
com.apple.Maps,26,1751130434,1751130460,1751130460.250231,-18000,EB445137-D7F5-57EC-87DA-1DB460D64046,"iPhone13,2"
com.google.chrome.ios,2,1751130431,1751130433,1751130433.567651,-18000,EB445137-D7F5-57EC-87DA-1DB460D64046,"iPhone13,2"
com.google.chrome.ios,32,1751128548,1751128580,1751128580.8026838,-18000,EB445137-D7F5-57EC-87DA-1DB460D64046,"iPhone13,2"
com.google.chrome.ios,42,1751127811,1751127853,1751127853.297985,-18000,EB445137-D7F5-57EC-87DA-1DB460D64046,"iPhone13,2"
com.apple.MobileSMS,2,1751127809,1751127811,1751127811.661964,-18000,EB445137-D7F5-57EC-87DA-1DB460D64046,"iPhone13,2"
com.apple.MobileSMS,13,1751126993,1751127006,1751127006.370692,-18000,EB445137-D7F5-57EC-87DA-1DB460D64046,"iPhone13,2"
com.apple.MobileSMS,17,1751126954,1751126971,1751126971.7059178,-18000,EB445137-D7F5-57EC-87DA-1DB460D64046,"iPhone13,2"
com.toyopagroup.picaboo,3,1751126951,1751126954,1751126955.05901,-18000,EB445137-D7F5-57EC-87DA-1DB460D64046,"iPhone13,2"
com.apple.MobileSMS,0,1751126951,1751126951,1751126951.480324,-18000,EB445137-D7F5-57EC-87DA-1DB460D64046,"iPhone13,2"
com.apple.MobileSMS,16,1751126933,1751126949,1751126949.997106,-18000,EB445137-D7F5-57EC-87DA-1DB460D64046,"iPhone13,2"
com.google.chrome.ios,83,1751126149,1751126232,1751126232.8347092,-18000,EB445137-D7F5-57EC-87DA-1DB460D64046,"iPhone13,2"
com.google.Gmail,71,1751125950,1751126021,1751126021.274152,-18000,EB445137-D7F5-57EC-87DA-1DB460D64046,"iPhone13,2"
com.toyopagroup.picaboo,13,1751125557,1751125570,1751125570.6706781,-18000,EB445137-D7F5-57EC-87DA-1DB460D64046,"iPhone13,2"
com.apple.MobileSMS,2,1751125552,1751125554,1751125554.794486,-18000,EB445137-D7F5-57EC-87DA-1DB460D64046,"iPhone13,2"
com.apple.weather,0,1751125552,1751125552,1751125553.236281,-18000,EB445137-D7F5-57EC-87DA-1DB460D64046,"iPhone13,2"
com.apple.weather,4,1751124229,1751124233,1751124233.818036,-18000,EB445137-D7F5-57EC-87DA-1DB460D64046,"iPhone13,2"
com.apple.weather,13,1751124214,1751124227,1751124228.222719,-18000,EB445137-D7F5-57EC-87DA-1DB460D64046,"iPhone13,2"
com.google.chrome.ios,3,1751124211,1751124214,1751124214.318198,-18000,EB445137-D7F5-57EC-87DA-1DB460D64046,"iPhone13,2"
com.apple.MobileSMS,2,1751124209,1751124211,1751124211.845222,-18000,EB445137-D7F5-57EC-87DA-1DB460D64046,"iPhone13,2"
com.apple.MobileSMS,64,1751117981,1751118045,1751118046.188889,-18000,EB445137-D7F5-57EC-87DA-1DB460D64046,"iPhone13,2"
com.apple.MobileSMS,6,1751117450,1751117456,1751117456.398748,-18000,EB445137-D7F5-57EC-87DA-1DB460D64046,"iPhone13,2"
com.apple.news,216,1751115902,1751116118,1751116118.305599,-18000,EB445137-D7F5-57EC-87DA-1DB460D64046,"iPhone13,2"
com.apple.Health,10,1751115888,1751115898,1751115898.719199,-18000,EB445137-D7F5-57EC-87DA-1DB460D64046,"iPhone13,2"
com.apple.MobileSMS,4,1751115815,1751115819,1751115819.1479511,-18000,EB445137-D7F5-57EC-87DA-1DB460D64046,"iPhone13,2"
com.apple.MobileSMS,8,1751115779,1751115787,1751115787.504961,-18000,EB445137-D7F5-57EC-87DA-1DB460D64046,"iPhone13,2"
com.apple.MobileSMS,111,1751115658,1751115769,1751115769.429618,-18000,EB445137-D7F5-57EC-87DA-1DB460D64046,"iPhone13,2"
com.apple.MobileSMS,27,1751115628,1751115655,1751115655.1599889,-18000,EB445137-D7F5-57EC-87DA-1DB460D64046,"iPhone13,2"
com.apple.mobiletimer,1,1751115627,1751115628,1751115628.590689,-18000,EB445137-D7F5-57EC-87DA-1DB460D64046,"iPhone13,2"
com.apple.mobiletimer,3,1751088162,1751088165,1751088165.3232179,-18000,EB445137-D7F5-57EC-87DA-1DB460D64046,"iPhone13,2"
com.apple.mobiletimer,6,1751088155,1751088161,1751088161.186802,-18000,EB445137-D7F5-57EC-87DA-1DB460D64046,"iPhone13,2"
com.apple.weather,2,1751088153,1751088155,1751088155.535851,-18000,EB445137-D7F5-57EC-87DA-1DB460D64046,"iPhone13,2"
com.apple.weather,7,1751087828,1751087835,1751087835.22266,-18000,EB445137-D7F5-57EC-87DA-1DB460D64046,"iPhone13,2"
com.apple.reminders,29,1751087781,1751087810,1751087810.770249,-18000,EB445137-D7F5-57EC-87DA-1DB460D64046,"iPhone13,2"
com.apple.Health,24,1751087684,1751087708,1751087708.589359,-18000,EB445137-D7F5-57EC-87DA-1DB460D64046,"iPhone13,2"
com.strava.stravaride,23,1751087656,1751087679,1751087679.961101,-18000,EB445137-D7F5-57EC-87DA-1DB460D64046,"iPhone13,2"
com.apple.Music,0,1751087656,1751087656,1751087657.357524,-18000,EB445137-D7F5-57EC-87DA-1DB460D64046,"iPhone13,2"
com.apple.Music,4,1751086941,1751086945,1751086945.9624949,-18000,EB445137-D7F5-57EC-87DA-1DB460D64046,"iPhone13,2"
com.apple.Music,5,1751085423,1751085428,1751085428.814589,-18000,EB445137-D7F5-57EC-87DA-1DB460D64046,"iPhone13,2"
com.instacart.shopper,2,1751085421,1751085423,1751085423.1239328,-18000,EB445137-D7F5-57EC-87DA-1DB460D64046,"iPhone13,2"
com.instacart.shopper,41,1751085206,1751085247,1751085247.922528,-18000,EB445137-D7F5-57EC-87DA-1DB460D64046,"iPhone13,2"
com.apple.Music,1,1751085199,1751085200,1751085200.679066,-18000,EB445137-D7F5-57EC-87DA-1DB460D64046,"iPhone13,2"
com.apple.Music,52,1751084774,1751084826,1751084826.813906,-18000,EB445137-D7F5-57EC-87DA-1DB460D64046,"iPhone13,2"
com.apple.Music,218,1751084419,1751084637,1751084637.491543,-18000,EB445137-D7F5-57EC-87DA-1DB460D64046,"iPhone13,2"
com.apple.Music,50,1751084164,1751084214,1751084214.5471048,-18000,EB445137-D7F5-57EC-87DA-1DB460D64046,"iPhone13,2"
com.apple.Music,28,1751083967,1751083995,1751083995.9452848,-18000,EB445137-D7F5-57EC-87DA-1DB460D64046,"iPhone13,2"
com.apple.Music,1,1751083959,1751083960,1751083961.2728028,-18000,EB445137-D7F5-57EC-87DA-1DB460D64046,"iPhone13,2"
com.apple.Music,18,1751079987,1751080005,1751080005.86416,-18000,EB445137-D7F5-57EC-87DA-1DB460D64046,"iPhone13,2"
com.apple.findmy,0,1751079987,1751079987,1751079989.008164,-18000,EB445137-D7F5-57EC-87DA-1DB460D64046,"iPhone13,2"
com.apple.findmy,5,1751079793,1751079798,1751079799.092408,-18000,EB445137-D7F5-57EC-87DA-1DB460D64046,"iPhone13,2"
com.apple.MobileSMS,2,1751079791,1751079793,1751079793.22992,-18000,EB445137-D7F5-57EC-87DA-1DB460D64046,"iPhone13,2"
com.apple.MobileSMS,153,1751079615,1751079768,1751079768.926938,-18000,EB445137-D7F5-57EC-87DA-1DB460D64046,"iPhone13,2"
com.apple.Maps,0,1751079615,1751079615,1751079616.539321,-18000,EB445137-D7F5-57EC-87DA-1DB460D64046,"iPhone13,2"
com.apple.Maps,31,1751079556,1751079587,1751079588.8480182,-18000,EB445137-D7F5-57EC-87DA-1DB460D64046,"iPhone13,2"
com.apple.MobileSMS,44,1751079452,1751079496,1751079496.277063,-18000,EB445137-D7F5-57EC-87DA-1DB460D64046,"iPhone13,2"
com.doordash.dasher,0,1751079452,1751079452,1751079452.616593,-18000,EB445137-D7F5-57EC-87DA-1DB460D64046,"iPhone13,2"
com.google.Chrome,2943,1751076825,1751079768,1751079768.711608,-18000,,
com.google.Chrome,533,1751076030,1751076563,1751076563.8650398,-18000,,
com.doordash.dasher,60,1751075360,1751075420,1751075420.81265,-18000,EB445137-D7F5-57EC-87DA-1DB460D64046,"iPhone13,2"
com.apple.findmy,4,1751075292,1751075296,1751075296.692698,-18000,EB445137-D7F5-57EC-87DA-1DB460D64046,"iPhone13,2"
com.apple.calculator,42,1751074747,1751074789,1751074789.425631,-18000,EB445137-D7F5-57EC-87DA-1DB460D64046,"iPhone13,2"
com.apple.CoreAuthUI,4,1751074703,1751074707,1751074707.370883,-18000,EB445137-D7F5-57EC-87DA-1DB460D64046,"iPhone13,2"
com.truebill.truebillnative,41,1751074702,1751074743,1751074743.89121,-18000,EB445137-D7F5-57EC-87DA-1DB460D64046,"iPhone13,2"
com.apple.CoreAuthUI,2,1751074255,1751074257,1751074257.090096,-18000,EB445137-D7F5-57EC-87DA-1DB460D64046,"iPhone13,2"
com.apple.CoreAuthUI,2,1751074240,1751074242,1751074242.113357,-18000,EB445137-D7F5-57EC-87DA-1DB460D64046,"iPhone13,2"
com.truebill.truebillnative,77,1751074236,1751074313,1751074314.02731,-18000,EB445137-D7F5-57EC-87DA-1DB460D64046,"iPhone13,2"
com.strava.stravaride,4,1751074212,1751074216,1751074216.496032,-18000,EB445137-D7F5-57EC-87DA-1DB460D64046,"iPhone13,2"
com.apple.findmy,5,1751074206,1751074211,1751074211.369158,-18000,EB445137-D7F5-57EC-87DA-1DB460D64046,"iPhone13,2"
com.apple.Music,1,1751074205,1751074206,1751074206.89846,-18000,EB445137-D7F5-57EC-87DA-1DB460D64046,"iPhone13,2"
com.apple.Music,7,1751073770,1751073777,1751073778.382368,-18000,EB445137-D7F5-57EC-87DA-1DB460D64046,"iPhone13,2"
com.apple.musicrecognition,3,1751073767,1751073770,1751073770.215903,-18000,EB445137-D7F5-57EC-87DA-1DB460D64046,"iPhone13,2"
com.google.chrome.ios,159,1751073416,1751073575,1751073575.16751,-18000,EB445137-D7F5-57EC-87DA-1DB460D64046,"iPhone13,2"
com.apple.MobileSMS,2,1751073207,1751073209,1751073209.4975839,-18000,EB445137-D7F5-57EC-87DA-1DB460D64046,"iPhone13,2"
com.apple.MobileSMS,3,1751072509,1751072512,1751072512.3739572,-18000,EB445137-D7F5-57EC-87DA-1DB460D64046,"iPhone13,2"
com.apple.MobileSMS,2,1751072507,1751072509,1751072509.7199888,-18000,EB445137-D7F5-57EC-87DA-1DB460D64046,"iPhone13,2"
com.apple.MobileSMS,30,1751072469,1751072499,1751072500.0184,-18000,EB445137-D7F5-57EC-87DA-1DB460D64046,"iPhone13,2"
com.apple.findmy,6,1751072463,1751072469,1751072469.654768,-18000,EB445137-D7F5-57EC-87DA-1DB460D64046,"iPhone13,2"
com.apple.news,2,1751072461,1751072463,1751072463.714982,-18000,EB445137-D7F5-57EC-87DA-1DB460D64046,"iPhone13,2"
com.apple.news,54,1751072126,1751072180,1751072181.519452,-18000,EB445137-D7F5-57EC-87DA-1DB460D64046,"iPhone13,2"
com.apple.findmy,19,1751071646,1751071665,1751071665.023412,-18000,EB445137-D7F5-57EC-87DA-1DB460D64046,"iPhone13,2"
com.apple.Maps,3,1751071642,1751071645,1751071645.071436,-18000,EB445137-D7F5-57EC-87DA-1DB460D64046,"iPhone13,2"
com.apple.Maps,42,1751071592,1751071634,1751071634.576147,-18000,EB445137-D7F5-57EC-87DA-1DB460D64046,"iPhone13,2"
com.google.chrome.ios,6,1751071586,1751071592,1751071592.409102,-18000,EB445137-D7F5-57EC-87DA-1DB460D64046,"iPhone13,2"
com.google.chrome.ios,57,1751070976,1751071033,1751071033.799406,-18000,EB445137-D7F5-57EC-87DA-1DB460D64046,"iPhone13,2"
com.strava.stravaride,14,1751070954,1751070968,1751070968.712966,-18000,EB445137-D7F5-57EC-87DA-1DB460D64046,"iPhone13,2"
com.google.chrome.ios,6,1751070943,1751070949,1751070949.4130502,-18000,EB445137-D7F5-57EC-87DA-1DB460D64046,"iPhone13,2"
com.google.chrome.ios,199,1751070736,1751070935,1751070935.43437,-18000,EB445137-D7F5-57EC-87DA-1DB460D64046,"iPhone13,2"
com.apple.MobileSMS,3,1751070733,1751070736,1751070736.184864,-18000,EB445137-D7F5-57EC-87DA-1DB460D64046,"iPhone13,2"
com.apple.MobileSMS,49,1751070660,1751070709,1751070709.668148,-18000,EB445137-D7F5-57EC-87DA-1DB460D64046,"iPhone13,2"
com.apple.MobileSMS,70,1751070474,1751070544,1751070544.281828,-18000,EB445137-D7F5-57EC-87DA-1DB460D64046,"iPhone13,2"
com.apple.MobileSMS,2,1751070472,1751070474,1751070474.7213202,-18000,EB445137-D7F5-57EC-87DA-1DB460D64046,"iPhone13,2"
com.apple.MobileSMS,2,1751070316,1751070318,1751070319.200475,-18000,EB445137-D7F5-57EC-87DA-1DB460D64046,"iPhone13,2"
com.google.Chrome,6,1751070294,1751070300,1751070300.285037,-18000,,
com.google.Chrome,1142,1751069148,1751070290,1751070290.3191,-18000,,
com.apple.ScreenshotServicesService,4,1751068184,1751068188,1751068188.85574,-18000,EB445137-D7F5-57EC-87DA-1DB460D64046,"iPhone13,2"
com.google.chrome.ios,100,1751068147,1751068247,1751068253.554175,-18000,EB445137-D7F5-57EC-87DA-1DB460D64046,"iPhone13,2"
com.apple.Maps,172,1751067973,1751068145,1751068146.067945,-18000,EB445137-D7F5-57EC-87DA-1DB460D64046,"iPhone13,2"
com.google.chrome.ios,196,1751067777,1751067973,1751067973.568726,-18000,EB445137-D7F5-57EC-87DA-1DB460D64046,"iPhone13,2"
com.apple.Maps,23,1751067754,1751067777,1751067777.4476,-18000,EB445137-D7F5-57EC-87DA-1DB460D64046,"iPhone13,2"
com.strava.stravaride,38,1751067716,1751067754,1751067754.434093,-18000,EB445137-D7F5-57EC-87DA-1DB460D64046,"iPhone13,2"
com.letterboxd.LetterboxdApp,1,1751067715,1751067716,1751067716.903583,-18000,EB445137-D7F5-57EC-87DA-1DB460D64046,"iPhone13,2"
com.letterboxd.LetterboxdApp,84,1751067305,1751067389,1751067389.20807,-18000,EB445137-D7F5-57EC-87DA-1DB460D64046,"iPhone13,2"
com.letterboxd.LetterboxdApp,78,1751066359,1751066437,1751066437.3243499,-18000,EB445137-D7F5-57EC-87DA-1DB460D64046,"iPhone13,2"
com.apple.MobileSMS,6,1751066352,1751066358,1751066358.747164,-18000,EB445137-D7F5-57EC-87DA-1DB460D64046,"iPhone13,2"
com.apple.MobileSMS,15,1751065810,1751065825,1751065825.747539,-18000,EB445137-D7F5-57EC-87DA-1DB460D64046,"iPhone13,2"
com.microsoft.onenote,1,1751065809,1751065810,1751065811.168112,-18000,EB445137-D7F5-57EC-87DA-1DB460D64046,"iPhone13,2"
com.google.Chrome,1433,1751063332,1751064765,1751064765.162035,-18000,,
com.apple.finder,6,1751063326,1751063332,1751063332.14656,-18000,,
com.microsoft.onenote,3,1751062953,1751062956,1751062956.277629,-18000,EB445137-D7F5-57EC-87DA-1DB460D64046,"iPhone13,2"
com.microsoft.onenote,54,1751062894,1751062948,1751062948.833293,-18000,EB445137-D7F5-57EC-87DA-1DB460D64046,"iPhone13,2"
com.microsoft.onenote,24,1751062858,1751062882,1751062883.05056,-18000,EB445137-D7F5-57EC-87DA-1DB460D64046,"iPhone13,2"
com.apple.weather,6,1751062844,1751062850,1751062850.777789,-18000,EB445137-D7F5-57EC-87DA-1DB460D64046,"iPhone13,2"
com.apple.weather,20,1751062792,1751062812,1751062812.559572,-18000,EB445137-D7F5-57EC-87DA-1DB460D64046,"iPhone13,2"
com.apple.findmy,1,1751062791,1751062792,1751062794.387282,-18000,EB445137-D7F5-57EC-87DA-1DB460D64046,"iPhone13,2"
com.apple.finder,3,1751062265,1751062268,1751062268.919683,-18000,,
com.microsoft.VSCode,10,1751062255,1751062265,1751062265.746845,-18000,,
com.apple.finder,1,1751062254,1751062255,1751062255.6829882,-18000,,
com.apple.Notes,0,1751062254,1751062254,1751062254.8383222,-18000,,
com.apple.finder,3,1751062251,1751062254,1751062254.1619968,-18000,,
com.leomehlig.today,0,1751062251,1751062251,1751062251.804815,-18000,,
com.google.Chrome,29,1751062222,1751062251,1751062251.4258451,-18000,,
com.leomehlig.today,43,1751062167,1751062210,1751062210.238319,-18000,,
com.google.Chrome,9,1751062158,1751062167,1751062167.955751,-18000,,
com.apple.Preview,14,1751062144,1751062158,1751062158.711141,-18000,,
com.apple.finder,10,1751062134,1751062144,1751062144.209684,-18000,,
com.google.Chrome,36,1751062098,1751062134,1751062134.290127,-18000,,
com.apple.Notes,5,1751062093,1751062098,1751062098.672523,-18000,,
com.apple.findmy,63,1751062037,1751062100,1751062100.726767,-18000,EB445137-D7F5-57EC-87DA-1DB460D64046,"iPhone13,2"
com.apple.MobileSMS,2,1751062035,1751062037,1751062038.381328,-18000,EB445137-D7F5-57EC-87DA-1DB460D64046,"iPhone13,2"
com.google.Chrome,225,1751061868,1751062093,1751062093.09864,-18000,,
com.microsoft.VSCode,1,1751061867,1751061868,1751061868.613552,-18000,,
com.apple.Notes,8,1751061859,1751061867,1751061867.243198,-18000,,
com.google.Chrome,234,1751061625,1751061859,1751061859.6186209,-18000,,
com.microsoft.VSCode,25,1751061600,1751061625,1751061625.754472,-18000,,
com.google.Chrome,14,1751061586,1751061600,1751061600.791791,-18000,,
com.microsoft.VSCode,203,1751061383,1751061586,1751061586.4812,-18000,,
com.google.Chrome,6,1751061377,1751061383,1751061383.619029,-18000,,
com.microsoft.VSCode,211,1751061166,1751061377,1751061377.8850489,-18000,,
com.google.Chrome,8,1751061158,1751061166,1751061166.7837,-18000,,
com.microsoft.VSCode,2,1751061156,1751061158,1751061158.954689,-18000,,
com.apple.Notes,1,1751061155,1751061156,1751061156.242783,-18000,,
com.microsoft.VSCode,657,1751060498,1751061155,1751061155.5493522,-18000,,
com.apple.Notes,0,1751060498,1751060498,1751060498.56493,-18000,,
com.microsoft.VSCode,1,1751060497,1751060498,1751060498.235923,-18000,,
com.apple.Notes,5,1751060492,1751060497,1751060497.511201,-18000,,
com.microsoft.VSCode,2,1751060490,1751060492,1751060492.028063,-18000,,
com.apple.Notes,0,1751060490,1751060490,1751060490.591243,-18000,,
com.microsoft.VSCode,1,1751060489,1751060490,1751060490.345969,-18000,,
com.google.Chrome,1343,1751059146,1751060489,1751060489.892252,-18000,,
com.apple.Notes,37,1751059109,1751059146,1751059146.6244822,-18000,,
com.apple.MobileSMS,38,1751059057,1751059095,1751059095.82797,-18000,EB445137-D7F5-57EC-87DA-1DB460D64046,"iPhone13,2"
com.google.Chrome,58,1751059051,1751059109,1751059109.131865,-18000,,
com.apple.MobileSMS,12,1751057078,1751057090,1751057091.016906,-18000,EB445137-D7F5-57EC-87DA-1DB460D64046,"iPhone13,2"
com.apple.MobileSMS,7,1751057036,1751057043,1751057043.6597772,-18000,EB445137-D7F5-57EC-87DA-1DB460D64046,"iPhone13,2"
com.apple.MobileSMS,9,1751056996,1751057005,1751057006.160468,-18000,EB445137-D7F5-57EC-87DA-1DB460D64046,"iPhone13,2"
com.apple.MobileSMS,2,1751056838,1751056840,1751056840.392611,-18000,EB445137-D7F5-57EC-87DA-1DB460D64046,"iPhone13,2"
com.apple.MobileSMS,3,1751056830,1751056833,1751056833.4633842,-18000,EB445137-D7F5-57EC-87DA-1DB460D64046,"iPhone13,2"
com.apple.MobileSMS,27,1751056794,1751056821,1751056821.807303,-18000,EB445137-D7F5-57EC-87DA-1DB460D64046,"iPhone13,2"
com.google.Chrome,1815,1751056725,1751058540,1751058540.0633678,-18000,,
com.apple.MobileSMS,6,1751056620,1751056626,1751056626.466301,-18000,EB445137-D7F5-57EC-87DA-1DB460D64046,"iPhone13,2"
com.apple.MobileSMS,4,1751055923,1751055927,1751055927.793052,-18000,EB445137-D7F5-57EC-87DA-1DB460D64046,"iPhone13,2"
com.apple.MobileSMS,3,1751055524,1751055527,1751055527.599732,-18000,EB445137-D7F5-57EC-87DA-1DB460D64046,"iPhone13,2"
com.apple.MobileSMS,8,1751055439,1751055447,1751055447.666815,-18000,EB445137-D7F5-57EC-87DA-1DB460D64046,"iPhone13,2"
com.google.Chrome,944,1751055432,1751056376,1751056376.677392,-18000,,
com.apple.MobileSMS,61,1751055215,1751055276,1751055276.0749478,-18000,EB445137-D7F5-57EC-87DA-1DB460D64046,"iPhone13,2"
com.apple.MobileSMS,9,1751054875,1751054884,1751054884.825825,-18000,EB445137-D7F5-57EC-87DA-1DB460D64046,"iPhone13,2"
com.apple.mobilenotes,0,1751054875,1751054875,1751054875.420649,-18000,EB445137-D7F5-57EC-87DA-1DB460D64046,"iPhone13,2"
com.apple.mobilenotes,3,1751054796,1751054799,1751054799.708152,-18000,EB445137-D7F5-57EC-87DA-1DB460D64046,"iPhone13,2"
com.apple.mobilenotes,125,1751054630,1751054755,1751054755.870619,-18000,EB445137-D7F5-57EC-87DA-1DB460D64046,"iPhone13,2"
com.apple.mobilenotes,72,1751054517,1751054589,1751054590.1179729,-18000,EB445137-D7F5-57EC-87DA-1DB460D64046,"iPhone13,2"
com.apple.MobileSMS,36,1751054480,1751054516,1751054516.748121,-18000,EB445137-D7F5-57EC-87DA-1DB460D64046,"iPhone13,2"
com.apple.MobileSMS,18,1751054449,1751054467,1751054467.6047611,-18000,EB445137-D7F5-57EC-87DA-1DB460D64046,"iPhone13,2"
com.apple.MobileSMS,59,1751054389,1751054448,1751054449.1308331,-18000,EB445137-D7F5-57EC-87DA-1DB460D64046,"iPhone13,2"
com.apple.MobileSMS,24,1751054154,1751054178,1751054178.625968,-18000,EB445137-D7F5-57EC-87DA-1DB460D64046,"iPhone13,2"
com.apple.mobilenotes,1,1751054153,1751054154,1751054155.124597,-18000,EB445137-D7F5-57EC-87DA-1DB460D64046,"iPhone13,2"
com.apple.mobilenotes,17,1751051940,1751051957,1751051958.1519709,-18000,EB445137-D7F5-57EC-87DA-1DB460D64046,"iPhone13,2"
com.apple.mobilenotes,7,1751051583,1751051590,1751051591.065497,-18000,EB445137-D7F5-57EC-87DA-1DB460D64046,"iPhone13,2"
com.apple.findmy,1,1751051582,1751051583,1751051584.0288858,-18000,EB445137-D7F5-57EC-87DA-1DB460D64046,"iPhone13,2"
com.apple.findmy,4,1751051454,1751051458,1751051458.868021,-18000,EB445137-D7F5-57EC-87DA-1DB460D64046,"iPhone13,2"
com.apple.mobilenotes,2,1751051452,1751051454,1751051454.488013,-18000,EB445137-D7F5-57EC-87DA-1DB460D64046,"iPhone13,2"
com.apple.mobilenotes,32,1751051296,1751051328,1751051328.462611,-18000,EB445137-D7F5-57EC-87DA-1DB460D64046,"iPhone13,2"
com.google.chrome.ios,2,1751051293,1751051295,1751051297.065803,-18000,EB445137-D7F5-57EC-87DA-1DB460D64046,"iPhone13,2"
com.google.chrome.ios,104,1751050216,1751050320,1751050321.071711,-18000,EB445137-D7F5-57EC-87DA-1DB460D64046,"iPhone13,2"
com.apple.news,2,1751050213,1751050215,1751050216.092011,-18000,EB445137-D7F5-57EC-87DA-1DB460D64046,"iPhone13,2"
com.apple.news,17,1751047623,1751047640,1751047641.1479878,-18000,EB445137-D7F5-57EC-87DA-1DB460D64046,"iPhone13,2"
com.apple.GameOverlayUI,9,1751047521,1751047530,1751047530.56643,-18000,EB445137-D7F5-57EC-87DA-1DB460D64046,"iPhone13,2"
com.apple.news,149,1751047472,1751047621,1751047621.598094,-18000,EB445137-D7F5-57EC-87DA-1DB460D64046,"iPhone13,2"
com.doordash.dasher,5,1751047411,1751047416,1751047418.360067,-18000,EB445137-D7F5-57EC-87DA-1DB460D64046,"iPhone13,2"
com.doordash.dasher,276,1751046580,1751046856,1751046856.966562,-18000,EB445137-D7F5-57EC-87DA-1DB460D64046,"iPhone13,2"
com.apple.findmy,11,1751046569,1751046580,1751046580.8093538,-18000,EB445137-D7F5-57EC-87DA-1DB460D64046,"iPhone13,2"
com.doordash.dasher,32,1751046537,1751046569,1751046569.8091578,-18000,EB445137-D7F5-57EC-87DA-1DB460D64046,"iPhone13,2"
com.apple.weather,49,1751046488,1751046537,1751046537.2467709,-18000,EB445137-D7F5-57EC-87DA-1DB460D64046,"iPhone13,2"
com.apple.news,239,1751046249,1751046488,1751046488.289603,-18000,EB445137-D7F5-57EC-87DA-1DB460D64046,"iPhone13,2"
com.google.chrome.ios,48,1751046200,1751046248,1751046248.573992,-18000,EB445137-D7F5-57EC-87DA-1DB460D64046,"iPhone13,2"
com.apple.podcasts,51,1751046149,1751046200,1751046200.242583,-18000,EB445137-D7F5-57EC-87DA-1DB460D64046,"iPhone13,2"
com.doordash.dasher,120,1751046029,1751046149,1751046149.97438,-18000,EB445137-D7F5-57EC-87DA-1DB460D64046,"iPhone13,2"
com.google.chrome.ios,56,1751045970,1751046026,1751046026.5067081,-18000,EB445137-D7F5-57EC-87DA-1DB460D64046,"iPhone13,2"
com.apple.Maps,2,1751045968,1751045970,1751045970.806057,-18000,EB445137-D7F5-57EC-87DA-1DB460D64046,"iPhone13,2"
com.google.chrome.ios,79,1751045889,1751045968,1751045968.7038789,-18000,EB445137-D7F5-57EC-87DA-1DB460D64046,"iPhone13,2"
com.apple.Maps,7,1751045882,1751045889,1751045889.9792728,-18000,EB445137-D7F5-57EC-87DA-1DB460D64046,"iPhone13,2"
com.google.chrome.ios,90,1751045792,1751045882,1751045882.767251,-18000,EB445137-D7F5-57EC-87DA-1DB460D64046,"iPhone13,2"
com.apple.Maps,9,1751045783,1751045792,1751045792.085145,-18000,EB445137-D7F5-57EC-87DA-1DB460D64046,"iPhone13,2"
com.doordash.dasher,25,1751045758,1751045783,1751045783.963902,-18000,EB445137-D7F5-57EC-87DA-1DB460D64046,"iPhone13,2"
com.doordash.dasher,7,1751045750,1751045757,1751045757.756956,-18000,EB445137-D7F5-57EC-87DA-1DB460D64046,"iPhone13,2"
com.apple.Maps,179,1751045571,1751045750,1751045750.822062,-18000,EB445137-D7F5-57EC-87DA-1DB460D64046,"iPhone13,2"
com.google.chrome.ios,29,1751045542,1751045571,1751045571.6180391,-18000,EB445137-D7F5-57EC-87DA-1DB460D64046,"iPhone13,2"
com.doordash.dasher,6,1751045536,1751045542,1751045542.49232,-18000,EB445137-D7F5-57EC-87DA-1DB460D64046,"iPhone13,2"
com.google.chrome.ios,67,1751045469,1751045536,1751045536.907072,-18000,EB445137-D7F5-57EC-87DA-1DB460D64046,"iPhone13,2"
com.apple.Maps,22,1751045447,1751045469,1751045469.686054,-18000,EB445137-D7F5-57EC-87DA-1DB460D64046,"iPhone13,2"
com.google.chrome.ios,86,1751045361,1751045447,1751045447.4003658,-18000,EB445137-D7F5-57EC-87DA-1DB460D64046,"iPhone13,2"
com.apple.Maps,45,1751045316,1751045361,1751045361.957097,-18000,EB445137-D7F5-57EC-87DA-1DB460D64046,"iPhone13,2"
com.google.chrome.ios,175,1751045141,1751045316,1751045316.565279,-18000,EB445137-D7F5-57EC-87DA-1DB460D64046,"iPhone13,2"
com.apple.Maps,29,1751045112,1751045141,1751045142.0128999,-18000,EB445137-D7F5-57EC-87DA-1DB460D64046,"iPhone13,2"
com.google.chrome.ios,7,1751045105,1751045112,1751045113.887288,-18000,EB445137-D7F5-57EC-87DA-1DB460D64046,"iPhone13,2"
com.doordash.dasher,12,1751045093,1751045105,1751045105.1777282,-18000,EB445137-D7F5-57EC-87DA-1DB460D64046,"iPhone13,2"
com.doordash.dasher,108,1751044985,1751045093,1751045093.2760181,-18000,EB445137-D7F5-57EC-87DA-1DB460D64046,"iPhone13,2"
com.doordash.dasher,171,1751044813,1751044984,1751044984.187408,-18000,EB445137-D7F5-57EC-87DA-1DB460D64046,"iPhone13,2"
com.doordash.dasher,519,1751044293,1751044812,1751044812.97291,-18000,EB445137-D7F5-57EC-87DA-1DB460D64046,"iPhone13,2"
com.doordash.dasher,714,1751043578,1751044292,1751044292.962004,-18000,EB445137-D7F5-57EC-87DA-1DB460D64046,"iPhone13,2"
com.apple.podcasts,14,1751043564,1751043578,1751043578.8824902,-18000,EB445137-D7F5-57EC-87DA-1DB460D64046,"iPhone13,2"
com.doordash.dasher,113,1751043451,1751043564,1751043564.544275,-18000,EB445137-D7F5-57EC-87DA-1DB460D64046,"iPhone13,2"
com.doordash.dasher,26,1751043420,1751043446,1751043446.7633228,-18000,EB445137-D7F5-57EC-87DA-1DB460D64046,"iPhone13,2"
com.doordash.dasher,93,1751043318,1751043411,1751043411.628222,-18000,EB445137-D7F5-57EC-87DA-1DB460D64046,"iPhone13,2"
com.doordash.dasher,1,1751043317,1751043318,1751043318.255018,-18000,EB445137-D7F5-57EC-87DA-1DB460D64046,"iPhone13,2"
com.doordash.dasher,458,1751042827,1751043285,1751043285.9070249,-18000,EB445137-D7F5-57EC-87DA-1DB460D64046,"iPhone13,2"
com.doordash.dasher,16,1751042809,1751042825,1751042826.1371288,-18000,EB445137-D7F5-57EC-87DA-1DB460D64046,"iPhone13,2"
com.google.chrome.ios,2,1751042807,1751042809,1751042809.701009,-18000,EB445137-D7F5-57EC-87DA-1DB460D64046,"iPhone13,2"
com.apple.Maps,7,1751042800,1751042807,1751042807.5449991,-18000,EB445137-D7F5-57EC-87DA-1DB460D64046,"iPhone13,2"
com.google.chrome.ios,98,1751042702,1751042800,1751042801.1268702,-18000,EB445137-D7F5-57EC-87DA-1DB460D64046,"iPhone13,2"
com.apple.Maps,44,1751042658,1751042702,1751042702.670755,-18000,EB445137-D7F5-57EC-87DA-1DB460D64046,"iPhone13,2"
com.apple.weather,34,1751042624,1751042658,1751042658.352143,-18000,EB445137-D7F5-57EC-87DA-1DB460D64046,"iPhone13,2"
com.apple.Maps,5,1751042619,1751042624,1751042624.323063,-18000,EB445137-D7F5-57EC-87DA-1DB460D64046,"iPhone13,2"
com.google.chrome.ios,162,1751042457,1751042619,1751042619.3414989,-18000,EB445137-D7F5-57EC-87DA-1DB460D64046,"iPhone13,2"
com.doordash.dasher,2,1751042454,1751042456,1751042457.0898352,-18000,EB445137-D7F5-57EC-87DA-1DB460D64046,"iPhone13,2"
com.doordash.dasher,4,1751042450,1751042454,1751042454.745852,-18000,EB445137-D7F5-57EC-87DA-1DB460D64046,"iPhone13,2"
com.strava.stravaride,95,1751042347,1751042442,1751042442.218948,-18000,EB445137-D7F5-57EC-87DA-1DB460D64046,"iPhone13,2"
com.apple.MobileSMS,23,1751042279,1751042302,1751042302.271529,-18000,EB445137-D7F5-57EC-87DA-1DB460D64046,"iPhone13,2"
com.doordash.dasher,0,1751042279,1751042279,1751042279.896527,-18000,EB445137-D7F5-57EC-87DA-1DB460D64046,"iPhone13,2"
com.doordash.dasher,185,1751042091,1751042276,1751042276.646947,-18000,EB445137-D7F5-57EC-87DA-1DB460D64046,"iPhone13,2"
com.doordash.dasher,321,1751041767,1751042088,1751042088.4512691,-18000,EB445137-D7F5-57EC-87DA-1DB460D64046,"iPhone13,2"
com.doordash.dasher,43,1751041723,1751041766,1751041766.11896,-18000,EB445137-D7F5-57EC-87DA-1DB460D64046,"iPhone13,2"
com.doordash.dasher,335,1751041387,1751041722,1751041723.037101,-18000,EB445137-D7F5-57EC-87DA-1DB460D64046,"iPhone13,2"
com.doordash.dasher,195,1751041191,1751041386,1751041386.6095371,-18000,EB445137-D7F5-57EC-87DA-1DB460D64046,"iPhone13,2"
com.apple.MobileSMS,0,1751041191,1751041191,1751041192.730886,-18000,EB445137-D7F5-57EC-87DA-1DB460D64046,"iPhone13,2"
com.apple.MobileSMS,3,1751041188,1751041191,1751041191.210188,-18000,EB445137-D7F5-57EC-87DA-1DB460D64046,"iPhone13,2"
com.apple.podcasts,0,1751041188,1751041188,1751041188.735663,-18000,EB445137-D7F5-57EC-87DA-1DB460D64046,"iPhone13,2"
com.apple.MusicUIService,3,1751040779,1751040782,1751040782.441667,-18000,EB445137-D7F5-57EC-87DA-1DB460D64046,"iPhone13,2"
com.apple.podcasts,99,1751040762,1751040861,1751040861.2309241,-18000,EB445137-D7F5-57EC-87DA-1DB460D64046,"iPhone13,2"
com.apple.MobileSMS,9,1751040753,1751040762,1751040762.451972,-18000,EB445137-D7F5-57EC-87DA-1DB460D64046,"iPhone13,2"
com.apple.podcasts,36,1751040717,1751040753,1751040753.183632,-18000,EB445137-D7F5-57EC-87DA-1DB460D64046,"iPhone13,2"
com.doordash.dasher,24,1751040693,1751040717,1751040717.568826,-18000,EB445137-D7F5-57EC-87DA-1DB460D64046,"iPhone13,2"
com.apple.mobilephone,2,1751040691,1751040693,1751040693.484161,-18000,EB445137-D7F5-57EC-87DA-1DB460D64046,"iPhone13,2"
com.apple.mobilephone,0,1751040590,1751040590,1751040591.0677838,-18000,EB445137-D7F5-57EC-87DA-1DB460D64046,"iPhone13,2"
com.apple.MobileSMS,81,1751040501,1751040582,1751040582.451921,-18000,EB445137-D7F5-57EC-87DA-1DB460D64046,"iPhone13,2"
com.doordash.dasher,17,1751039826,1751039843,1751039844.764576,-18000,EB445137-D7F5-57EC-87DA-1DB460D64046,"iPhone13,2"
com.apple.news,102,1751035053,1751035155,1751035155.653588,-18000,EB445137-D7F5-57EC-87DA-1DB460D64046,"iPhone13,2"
com.apple.news,2,1751035047,1751035049,1751035050.018507,-18000,EB445137-D7F5-57EC-87DA-1DB460D64046,"iPhone13,2"
com.apple.news,88,1751034297,1751034385,1751034385.7081308,-18000,EB445137-D7F5-57EC-87DA-1DB460D64046,"iPhone13,2"
com.strava.stravaride,72,1751034218,1751034290,1751034290.9500608,-18000,EB445137-D7F5-57EC-87DA-1DB460D64046,"iPhone13,2"
com.apple.Health,11,1751034206,1751034217,1751034217.134227,-18000,EB445137-D7F5-57EC-87DA-1DB460D64046,"iPhone13,2"
com.strava.stravaride,89,1751034084,1751034173,1751034173.572761,-18000,EB445137-D7F5-57EC-87DA-1DB460D64046,"iPhone13,2"
com.renpho.health,2,1751034081,1751034083,1751034083.513901,-18000,EB445137-D7F5-57EC-87DA-1DB460D64046,"iPhone13,2"
com.google.Chrome,1069,1751032833,1751033902,1751033902.7077,-18000,,
com.apple.weather,8,1751032825,1751032833,1751032833.106436,-18000,,
com.google.Chrome,161,1751032664,1751032825,1751032825.123592,-18000,,
com.google.Chrome,369,1751031535,1751031904,1751031904.517838,-18000,,
com.renpho.health,61,1751031405,1751031466,1751031466.774356,-18000,EB445137-D7F5-57EC-87DA-1DB460D64046,"iPhone13,2"
com.apple.news,5,1751031399,1751031404,1751031404.342555,-18000,EB445137-D7F5-57EC-87DA-1DB460D64046,"iPhone13,2"
com.apple.news,83,1751031094,1751031177,1751031177.519448,-18000,EB445137-D7F5-57EC-87DA-1DB460D64046,"iPhone13,2"
com.apple.CoreAuthUI,2,1750998007,1750998009,1750998009.319975,-18000,EB445137-D7F5-57EC-87DA-1DB460D64046,"iPhone13,2"
com.apple.journal,672,1750998006,1750998678,1750998678.4376311,-18000,EB445137-D7F5-57EC-87DA-1DB460D64046,"iPhone13,2"
com.apple.Health,20,1750997985,1750998005,1750998005.669554,-18000,EB445137-D7F5-57EC-87DA-1DB460D64046,"iPhone13,2"
com.goodreads.Goodreads,20,1750997640,1750997660,1750997660.971336,-18000,EB445137-D7F5-57EC-87DA-1DB460D64046,"iPhone13,2"
com.thestorygraph.thestorygraph,86,1750997554,1750997640,1750997640.4015598,-18000,EB445137-D7F5-57EC-87DA-1DB460D64046,"iPhone13,2"
com.apple.findmy,4,1750995489,1750995493,1750995494.234937,-18000,EB445137-D7F5-57EC-87DA-1DB460D64046,"iPhone13,2"
com.google.Chrome,62,1750995097,1750995159,1750995159.12785,-18000,,
com.google.Chrome,484,1750994584,1750995068,1750995068.15256,-18000,,
com.google.Chrome,609,1750993206,1750993815,1750993816.0072699,-18000,,
com.google.Chrome,709,1750991385,1750992094,1750992094.994175,-18000,,
com.strava.stravaride,54,1750991298,1750991352,1750991352.2453198,-18000,EB445137-D7F5-57EC-87DA-1DB460D64046,"iPhone13,2"
com.letterboxd.LetterboxdApp,90,1750991020,1750991110,1750991110.891911,-18000,EB445137-D7F5-57EC-87DA-1DB460D64046,"iPhone13,2"
com.apple.weather,3,1750990988,1750990991,1750990991.627806,-18000,EB445137-D7F5-57EC-87DA-1DB460D64046,"iPhone13,2"
com.apple.weather,156,1750990781,1750990937,1750990937.458716,-18000,EB445137-D7F5-57EC-87DA-1DB460D64046,"iPhone13,2"
com.google.Chrome,417,1750990687,1750991104,1750991104.9570851,-18000,,
com.google.Chrome,517,1750989835,1750990352,1750990352.950217,-18000,,
com.apple.MobileSMS,5,1750989682,1750989687,1750989687.993412,-18000,EB445137-D7F5-57EC-87DA-1DB460D64046,"iPhone13,2"
com.apple.Music,0,1750989682,1750989682,1750989683.399482,-18000,EB445137-D7F5-57EC-87DA-1DB460D64046,"iPhone13,2"
com.apple.Music,66,1750989087,1750989153,1750989154.002625,-18000,EB445137-D7F5-57EC-87DA-1DB460D64046,"iPhone13,2"
com.apple.findmy,6,1750988873,1750988879,1750988880.24845,-18000,EB445137-D7F5-57EC-87DA-1DB460D64046,"iPhone13,2"
com.apple.mobilenotes,2,1750988871,1750988873,1750988873.541857,-18000,EB445137-D7F5-57EC-87DA-1DB460D64046,"iPhone13,2"
com.apple.mobilenotes,1,1750988863,1750988864,1750988864.933255,-18000,EB445137-D7F5-57EC-87DA-1DB460D64046,"iPhone13,2"
com.google.Chrome,330,1750988736,1750989066,1750989066.900795,-18000,,
com.apple.finder,129,1750988607,1750988736,1750988736.310135,-18000,,
com.leomehlig.today,19,1750988588,1750988607,1750988607.6871262,-18000,,
com.google.Chrome,20,1750988568,1750988588,1750988588.6029658,-18000,,
com.leomehlig.today,8,1750988549,1750988557,1750988557.140058,-18000,,
com.google.Chrome,4,1750988545,1750988549,1750988549.417046,-18000,,
com.microsoft.VSCode,4,1750988541,1750988545,1750988545.7699208,-18000,,
com.apple.MobileSMS,47,1750988494,1750988541,1750988541.719523,-18000,,
com.microsoft.VSCode,1,1750988493,1750988494,1750988494.713454,-18000,,
com.google.Chrome,18,1750988475,1750988493,1750988493.178896,-18000,,
com.microsoft.VSCode,3,1750988472,1750988475,1750988475.418953,-18000,,
com.apple.MobileSMS,7,1750988465,1750988472,1750988472.98083,-18000,,
com.microsoft.VSCode,52,1750988413,1750988465,1750988465.207728,-18000,,
com.apple.Notes,1,1750988412,1750988413,1750988414.160626,-18000,,
com.google.Chrome,82,1750988330,1750988412,1750988413.9656959,-18000,,
com.apple.Notes,8,1750988322,1750988330,1750988330.1930141,-18000,,
com.google.Chrome,51,1750988271,1750988322,1750988322.119575,-18000,,
com.apple.Notes,16,1750988255,1750988271,1750988271.869272,-18000,,
com.google.Chrome,20,1750988235,1750988255,1750988255.88888,-18000,,
com.microsoft.VSCode,1,1750988093,1750988094,1750988095.0228,-18000,,
com.apple.Notes,1,1750988092,1750988093,1750988093.6438231,-18000,,
com.google.Chrome,18,1750988074,1750988092,1750988092.765471,-18000,,
com.apple.Notes,1,1750988073,1750988074,1750988074.7765489,-18000,,
com.microsoft.VSCode,1,1750988072,1750988073,1750988073.783646,-18000,,
com.google.Chrome,280,1750987792,1750988072,1750988072.959396,-18000,,
com.microsoft.VSCode,13,1750987779,1750987792,1750987792.239664,-18000,,
com.google.Chrome,54,1750987725,1750987779,1750987779.591016,-18000,,
com.microsoft.VSCode,1,1750987724,1750987725,1750987725.254527,-18000,,
com.google.Chrome,202,1750987522,1750987724,1750987724.8255758,-18000,,
com.microsoft.VSCode,21,1750987501,1750987522,1750987522.899922,-18000,,
com.google.Chrome,15,1750987486,1750987501,1750987501.624498,-18000,,
com.microsoft.VSCode,991,1750986495,1750987486,1750987486.372861,-18000,,
com.google.Chrome,6,1750986489,1750986495,1750986495.8732,-18000,,
com.microsoft.VSCode,659,1750985830,1750986489,1750986489.4896421,-18000,,
com.apple.Notes,2,1750985828,1750985830,1750985830.8236089,-18000,,
com.microsoft.VSCode,119,1750985709,1750985828,1750985828.995288,-18000,,
com.apple.Notes,6,1750985703,1750985709,1750985709.859868,-18000,,
com.microsoft.VSCode,52,1750985651,1750985703,1750985703.537315,-18000,,
com.apple.Notes,2,1750985649,1750985651,1750985651.735929,-18000,,
com.microsoft.VSCode,18,1750985631,1750985649,1750985650.02072,-18000,,
com.apple.Notes,2,1750985629,1750985631,1750985631.400508,-18000,,
com.microsoft.VSCode,1,1750985628,1750985629,1750985629.143701,-18000,,
com.apple.Notes,1,1750985627,1750985628,1750985628.316442,-18000,,
com.microsoft.VSCode,1,1750985626,1750985627,1750985627.203481,-18000,,
com.google.Chrome,1,1750985625,1750985626,1750985626.7680302,-18000,,
com.microsoft.VSCode,106,1750985519,1750985625,1750985625.9816852,-18000,,
com.google.Chrome,2,1750985517,1750985519,1750985519.9790812,-18000,,
com.apple.Notes,0,1750985517,1750985517,1750985518.096281,-18000,,
com.google.Chrome,1,1750985516,1750985517,1750985517.154655,-18000,,
com.apple.Notes,5,1750985511,1750985516,1750985516.392469,-18000,,
com.google.Chrome,2,1750985509,1750985511,1750985511.148809,-18000,,
com.apple.Notes,1,1750985508,1750985509,1750985509.520033,-18000,,
com.microsoft.VSCode,52,1750985456,1750985508,1750985508.660188,-18000,,
com.apple.Notes,87,1750985369,1750985456,1750985456.092835,-18000,,
com.microsoft.VSCode,1,1750985368,1750985369,1750985369.8509212,-18000,,
com.apple.Notes,8,1750985360,1750985368,1750985368.9976358,-18000,,
com.microsoft.VSCode,4,1750985356,1750985360,1750985360.853763,-18000,,
com.apple.Notes,10,1750985346,1750985356,1750985356.237628,-18000,,
com.microsoft.VSCode,35,1750985311,1750985346,1750985346.356638,-18000,,
com.apple.Notes,3,1750985308,1750985311,1750985311.1078281,-18000,,
com.microsoft.VSCode,1,1750985307,1750985308,1750985308.999187,-18000,,
com.apple.Notes,2,1750985305,1750985307,1750985307.9761891,-18000,,
com.microsoft.VSCode,6,1750985299,1750985305,1750985305.216474,-18000,,
com.apple.Notes,10,1750985289,1750985299,1750985300.018166,-18000,,
com.microsoft.VSCode,3,1750985286,1750985289,1750985289.860744,-18000,,
com.google.Chrome,2,1750985284,1750985286,1750985287.302388,-18000,,
com.microsoft.VSCode,1523,1750983761,1750985284,1750985285.087908,-18000,,
com.google.Chrome,11,1750983750,1750983761,1750983761.165046,-18000,,
com.microsoft.VSCode,70,1750983680,1750983750,1750983750.1249042,-18000,,
com.google.Chrome,2,1750983678,1750983680,1750983680.7540321,-18000,,
com.microsoft.VSCode,53,1750983625,1750983678,1750983678.256833,-18000,,
com.google.Chrome,3,1750983622,1750983625,1750983625.238411,-18000,,
com.microsoft.VSCode,60,1750983562,1750983622,1750983622.549577,-18000,,
com.google.Chrome,1,1750983561,1750983562,1750983562.415615,-18000,,
com.microsoft.VSCode,6,1750983555,1750983561,1750983561.883414,-18000,,
com.google.Chrome,3,1750983552,1750983555,1750983555.1439018,-18000,,
com.microsoft.VSCode,53,1750983499,1750983552,1750983552.691128,-18000,,
com.google.Chrome,4,1750983495,1750983499,1750983499.566623,-18000,,
com.microsoft.VSCode,1,1750983494,1750983495,1750983495.278007,-18000,,
com.google.Chrome,2,1750983492,1750983494,1750983494.867055,-18000,,
com.microsoft.VSCode,3,1750983489,1750983492,1750983492.558898,-18000,,
com.google.Chrome,8,1750983481,1750983489,1750983490.0570002,-18000,,
com.microsoft.VSCode,32,1750983449,1750983481,1750983481.930013,-18000,,
com.google.Chrome,1,1750983448,1750983449,1750983449.781604,-18000,,
com.microsoft.VSCode,37,1750983411,1750983448,1750983449.04674,-18000,,
com.google.Chrome,2,1750983409,1750983411,1750983411.718632,-18000,,
com.microsoft.VSCode,16,1750983393,1750983409,1750983409.66184,-18000,,
com.google.Chrome,2,1750983391,1750983393,1750983393.445665,-18000,,
com.microsoft.VSCode,15,1750983376,1750983391,1750983392.028126,-18000,,
com.google.Chrome,1,1750983375,1750983376,1750983376.310035,-18000,,
com.microsoft.VSCode,2,1750983373,1750983375,1750983375.2805328,-18000,,
com.google.Chrome,2,1750983371,1750983373,1750983373.2109299,-18000,,
com.microsoft.VSCode,2,1750983369,1750983371,1750983371.680218,-18000,,
com.google.Chrome,7,1750983362,1750983369,1750983369.318852,-18000,,
com.microsoft.VSCode,26,1750983336,1750983362,1750983362.080188,-18000,,
com.google.Chrome,1,1750983335,1750983336,1750983336.93618,-18000,,
com.microsoft.VSCode,40,1750983295,1750983335,1750983335.897788,-18000,,
com.google.Chrome,11,1750983284,1750983295,1750983295.581428,-18000,,
com.microsoft.VSCode,71,1750983213,1750983284,1750983284.622437,-18000,,
com.google.Chrome,5,1750983208,1750983213,1750983213.555272,-18000,,
com.apple.Preview,35,1750983173,1750983208,1750983208.8578,-18000,,
com.apple.finder,15,1750983158,1750983173,1750983173.752925,-18000,,
com.google.Chrome,2,1750983156,1750983158,1750983158.241029,-18000,,
com.microsoft.VSCode,64,1750983092,1750983156,1750983156.8771281,-18000,,
com.apple.Notes,0,1750983092,1750983092,1750983092.964686,-18000,,
com.microsoft.VSCode,45,1750983047,1750983092,1750983092.1649861,-18000,,
com.apple.Notes,9,1750983038,1750983047,1750983047.400934,-18000,,
com.microsoft.VSCode,21,1750983017,1750983038,1750983038.9059858,-18000,,
com.apple.Notes,17,1750983000,1750983017,1750983017.851138,-18000,,
com.microsoft.VSCode,0,1750983000,1750983000,1750983000.676095,-18000,,
com.apple.Notes,3,1750982997,1750983000,1750983000.120163,-18000,,
com.microsoft.VSCode,3,1750982994,1750982997,1750982997.9465199,-18000,,
com.apple.Notes,4,1750982990,1750982994,1750982995.046859,-18000,,
com.microsoft.VSCode,5,1750982985,1750982990,1750982990.919034,-18000,,
com.google.Chrome,1,1750982984,1750982985,1750982985.5443568,-18000,,
com.microsoft.VSCode,1,1750982983,1750982984,1750982984.194291,-18000,,
com.apple.Notes,1,1750982982,1750982983,1750982983.605616,-18000,,
com.microsoft.VSCode,16,1750982966,1750982982,1750982982.4430199,-18000,,
com.apple.Notes,28,1750982938,1750982966,1750982966.4213371,-18000,,
com.microsoft.VSCode,1,1750982937,1750982938,1750982938.3351831,-18000,,
com.google.Chrome,2,1750982935,1750982937,1750982937.514655,-18000,,
com.microsoft.VSCode,293,1750982642,1750982935,1750982935.8667002,-18000,,
com.apple.Notes,1,1750982641,1750982642,1750982642.170977,-18000,,
com.microsoft.VSCode,390,1750982251,1750982641,1750982641.3721151,-18000,,
com.apple.Notes,3,1750982248,1750982251,1750982251.664088,-18000,,
com.google.Chrome,47,1750982201,1750982248,1750982248.441016,-18000,,
com.apple.Notes,284,1750981917,1750982201,1750982201.2258658,-18000,,
com.microsoft.VSCode,3,1750981914,1750981917,1750981917.811717,-18000,,
com.apple.Notes,32,1750981882,1750981914,1750981914.337047,-18000,,
com.microsoft.VSCode,69,1750981813,1750981882,1750981882.376009,-18000,,
com.apple.Notes,44,1750981769,1750981813,1750981813.3698559,-18000,,
com.google.Chrome,106,1750981663,1750981769,1750981769.543641,-18000,,
com.apple.weather,51,1750981612,1750981663,1750981663.638696,-18000,,
com.google.Chrome,13,1750981599,1750981612,1750981612.303051,-18000,,
com.apple.Notes,126,1750981473,1750981599,1750981600.0330892,-18000,,
com.google.Chrome,46,1750981427,1750981473,1750981473.559437,-18000,,
com.apple.Notes,105,1750981322,1750981427,1750981427.385284,-18000,,
com.google.Chrome,7,1750981315,1750981322,1750981322.311397,-18000,,
com.apple.Notes,13,1750981302,1750981315,1750981315.247556,-18000,,
com.microsoft.VSCode,7,1750981295,1750981302,1750981303.0530682,-18000,,
com.apple.Notes,7,1750981288,1750981295,1750981295.4633641,-18000,,
com.microsoft.VSCode,1,1750981287,1750981288,1750981288.636366,-18000,,
com.apple.Notes,1,1750981286,1750981287,1750981287.445828,-18000,,
com.microsoft.VSCode,1,1750981285,1750981286,1750981286.378714,-18000,,
com.apple.Notes,6,1750981279,1750981285,1750981285.4874392,-18000,,
com.microsoft.VSCode,40,1750981239,1750981279,1750981279.817381,-18000,,
com.apple.Notes,3,1750981236,1750981239,1750981239.142302,-18000,,
com.microsoft.VSCode,35,1750981201,1750981236,1750981236.3349252,-18000,,
com.apple.Notes,4,1750981197,1750981201,1750981201.724921,-18000,,
com.microsoft.VSCode,1,1750981196,1750981197,1750981198.002038,-18000,,
com.apple.Notes,5,1750981191,1750981196,1750981196.9176679,-18000,,
com.microsoft.VSCode,6,1750981185,1750981191,1750981191.164571,-18000,,
com.apple.Notes,8,1750981177,1750981185,1750981185.986815,-18000,,
com.microsoft.VSCode,2,1750981175,1750981177,1750981177.974134,-18000,,
com.apple.Notes,5,1750981170,1750981175,1750981175.4540272,-18000,,
com.microsoft.VSCode,2,1750981168,1750981170,1750981170.0393739,-18000,,
com.apple.Notes,6,1750981162,1750981168,1750981168.742776,-18000,,
com.microsoft.VSCode,7,1750981155,1750981162,1750981162.480308,-18000,,
com.apple.Notes,8,1750981147,1750981155,1750981155.1323218,-18000,,
com.microsoft.VSCode,2,1750981145,1750981147,1750981147.640804,-18000,,
com.apple.Notes,3,1750981142,1750981145,1750981145.458057,-18000,,
com.microsoft.VSCode,1,1750981141,1750981142,1750981142.698662,-18000,,
com.apple.Notes,3,1750981138,1750981141,1750981142.0014381,-18000,,
com.microsoft.VSCode,2,1750981136,1750981138,1750981138.9321718,-18000,,
com.apple.Notes,6,1750981130,1750981136,1750981136.214062,-18000,,
com.microsoft.VSCode,14,1750981116,1750981130,1750981130.320384,-18000,,
com.apple.Notes,1,1750981115,1750981116,1750981116.798629,-18000,,
com.microsoft.VSCode,83,1750981032,1750981115,1750981115.80718,-18000,,
com.apple.Notes,8,1750981024,1750981032,1750981032.255487,-18000,,
com.google.Chrome,146,1750980878,1750981024,1750981024.059428,-18000,,
com.apple.Notes,32,1750980846,1750980878,1750980878.5127568,-18000,,
com.google.Chrome,658,1750980188,1750980846,1750980846.170775,-18000,,
com.google.Chrome,552,1750977142,1750977694,1750977694.7395449,-18000,,
com.leomehlig.today,55,1750977087,1750977142,1750977142.2611198,-18000,,
com.google.Chrome,20,1750977067,1750977087,1750977088.033535,-18000,,
com.leomehlig.today,97,1750976970,1750977067,1750977067.451258,-18000,,
com.google.Chrome,4,1750976966,1750976970,1750976970.190953,-18000,,
com.apple.finder,8,1750976958,1750976966,1750976967.0416842,-18000,,
com.apple.mobilenotes,16,1750976774,1750976790,1750976790.271061,-18000,EB445137-D7F5-57EC-87DA-1DB460D64046,"iPhone13,2"
com.apple.news,254,1750976519,1750976773,1750976773.448121,-18000,EB445137-D7F5-57EC-87DA-1DB460D64046,"iPhone13,2"
com.apple.MobileSMS,4,1750976511,1750976515,1750976515.525537,-18000,EB445137-D7F5-57EC-87DA-1DB460D64046,"iPhone13,2"
com.apple.findmy,16,1750976495,1750976511,1750976512.111377,-18000,EB445137-D7F5-57EC-87DA-1DB460D64046,"iPhone13,2"
com.apple.CoreAuthUI,2,1750976491,1750976493,1750976493.466717,-18000,EB445137-D7F5-57EC-87DA-1DB460D64046,"iPhone13,2"
com.apple.MobileSMS,2,1750976484,1750976486,1750976486.730888,-18000,EB445137-D7F5-57EC-87DA-1DB460D64046,"iPhone13,2"
com.apple.MobileSMS,57,1750976419,1750976476,1750976476.689779,-18000,EB445137-D7F5-57EC-87DA-1DB460D64046,"iPhone13,2"
com.apple.MobileSMS,8,1750974842,1750974850,1750974850.2727718,-18000,EB445137-D7F5-57EC-87DA-1DB460D64046,"iPhone13,2"
com.apple.Music,23,1750974819,1750974842,1750974842.3989,-18000,EB445137-D7F5-57EC-87DA-1DB460D64046,"iPhone13,2"
com.apple.MobileSMS,2,1750974817,1750974819,1750974819.743177,-18000,EB445137-D7F5-57EC-87DA-1DB460D64046,"iPhone13,2"
com.apple.Music,7,1750974810,1750974817,1750974817.574712,-18000,EB445137-D7F5-57EC-87DA-1DB460D64046,"iPhone13,2"
com.apple.MobileSMS,43,1750974761,1750974804,1750974804.346915,-18000,EB445137-D7F5-57EC-87DA-1DB460D64046,"iPhone13,2"
com.doordash.dasher,3,1750964290,1750964293,1750964294.0409951,-18000,EB445137-D7F5-57EC-87DA-1DB460D64046,"iPhone13,2"
com.apple.Music,2,1750964288,1750964290,1750964290.20743,-18000,EB445137-D7F5-57EC-87DA-1DB460D64046,"iPhone13,2"
com.apple.Music,83,1750964034,1750964117,1750964118.108228,-18000,EB445137-D7F5-57EC-87DA-1DB460D64046,"iPhone13,2"
com.apple.Maps,8,1750964018,1750964026,1750964026.132321,-18000,EB445137-D7F5-57EC-87DA-1DB460D64046,"iPhone13,2"
com.apple.Maps,19,1750963972,1750963991,1750963991.725327,-18000,EB445137-D7F5-57EC-87DA-1DB460D64046,"iPhone13,2"
com.apple.podcasts,2,1750963970,1750963972,1750963972.1930351,-18000,EB445137-D7F5-57EC-87DA-1DB460D64046,"iPhone13,2"
com.apple.podcasts,65,1750962113,1750962178,1750962179.3012009,-18000,EB445137-D7F5-57EC-87DA-1DB460D64046,"iPhone13,2"
com.strava.stravaride,4,1750962109,1750962113,1750962113.79008,-18000,EB445137-D7F5-57EC-87DA-1DB460D64046,"iPhone13,2"
com.strava.stravaride,26,1750961545,1750961571,1750961571.2809792,-18000,EB445137-D7F5-57EC-87DA-1DB460D64046,"iPhone13,2"
com.apple.news,198,1750961344,1750961542,1750961542.910668,-18000,EB445137-D7F5-57EC-87DA-1DB460D64046,"iPhone13,2"
com.truebill.truebillnative,1,1750961339,1750961340,1750961340.8988209,-18000,EB445137-D7F5-57EC-87DA-1DB460D64046,"iPhone13,2"
com.doordash.dasher,16,1750961319,1750961335,1750961335.882135,-18000,EB445137-D7F5-57EC-87DA-1DB460D64046,"iPhone13,2"
com.apple.MobileSMS,9,1750961298,1750961307,1750961307.78552,-18000,EB445137-D7F5-57EC-87DA-1DB460D64046,"iPhone13,2"
com.apple.finder,2,1750961273,1750961275,1750961276.101263,-18000,,
com.apple.Notes,0,1750961273,1750961273,1750961273.637876,-18000,,
com.google.Chrome,131,1750961142,1750961273,1750961273.286097,-18000,,
com.apple.Notes,3,1750961139,1750961142,1750961142.412528,-18000,,
com.google.Chrome,2,1750961137,1750961139,1750961139.4790711,-18000,,
com.apple.Notes,6,1750961131,1750961137,1750961137.340189,-18000,,
com.google.Chrome,29,1750961102,1750961131,1750961131.738106,-18000,,
com.apple.Notes,1,1750961101,1750961102,1750961102.9397058,-18000,,
com.microsoft.onenote.mac,19,1750961082,1750961101,1750961101.350862,-18000,,
com.apple.Notes,15,1750961067,1750961082,1750961082.5931292,-18000,,
com.apple.MobileSMS,28,1750961039,1750961067,1750961067.28621,-18000,,
com.apple.Notes,74,1750960965,1750961039,1750961039.636437,-18000,,
com.google.Chrome,60,1750960905,1750960965,1750960965.477119,-18000,,
com.apple.Notes,40,1750960865,1750960905,1750960905.603022,-18000,,
com.google.Chrome,0,1750960865,1750960865,1750960865.883719,-18000,,
com.apple.Notes,24,1750960841,1750960865,1750960865.162315,-18000,,
com.google.Chrome,21,1750960820,1750960841,1750960841.0507178,-18000,,
com.apple.Notes,4,1750960816,1750960820,1750960820.125208,-18000,,
com.google.Chrome,20,1750960796,1750960816,1750960816.6722832,-18000,,
com.apple.Notes,5,1750960791,1750960796,1750960796.741178,-18000,,
com.google.Chrome,2,1750960789,1750960791,1750960791.4727879,-18000,,
com.apple.Notes,4,1750960785,1750960789,1750960790.0138988,-18000,,
com.google.Chrome,9,1750960776,1750960785,1750960785.0409389,-18000,,
com.apple.Notes,12,1750960764,1750960776,1750960776.3153439,-18000,,
com.google.Chrome,39,1750960725,1750960764,1750960764.700467,-18000,,
com.apple.Notes,5,1750960720,1750960725,1750960725.1518211,-18000,,
com.google.Chrome,2,1750960718,1750960720,1750960720.628107,-18000,,
com.apple.Notes,2,1750960716,1750960718,1750960718.499524,-18000,,
com.google.Chrome,5,1750960711,1750960716,1750960716.9754639,-18000,,
com.apple.Notes,4,1750960707,1750960711,1750960711.450887,-18000,,
com.google.Chrome,3,1750960704,1750960707,1750960707.5350862,-18000,,
com.apple.Notes,4,1750960700,1750960704,1750960704.842205,-18000,,
com.google.Chrome,1,1750960699,1750960700,1750960700.9072251,-18000,,
com.apple.Notes,5,1750960694,1750960699,1750960699.680551,-18000,,
com.google.Chrome,163,1750960531,1750960694,1750960694.210607,-18000,,
com.apple.Notes,18,1750960513,1750960531,1750960531.251638,-18000,,
com.google.Chrome,21,1750960492,1750960513,1750960513.5071669,-18000,,
com.apple.MobileSMS,5,1750959381,1750959386,1750959386.6184258,-18000,EB445137-D7F5-57EC-87DA-1DB460D64046,"iPhone13,2"
com.apple.MobileSMS,129,1750959245,1750959374,1750959374.063002,-18000,EB445137-D7F5-57EC-87DA-1DB460D64046,"iPhone13,2"
com.apple.MobileSMS,5,1750959232,1750959237,1750959237.941283,-18000,EB445137-D7F5-57EC-87DA-1DB460D64046,"iPhone13,2"
com.google.chrome.ios,99,1750959133,1750959232,1750959232.4706368,-18000,EB445137-D7F5-57EC-87DA-1DB460D64046,"iPhone13,2"
com.apple.MobileSMS,25,1750959108,1750959133,1750959133.29115,-18000,EB445137-D7F5-57EC-87DA-1DB460D64046,"iPhone13,2"
com.apple.weather,22,1750959086,1750959108,1750959108.384211,-18000,EB445137-D7F5-57EC-87DA-1DB460D64046,"iPhone13,2"
com.apple.MobileSMS,6,1750959080,1750959086,1750959086.3688312,-18000,EB445137-D7F5-57EC-87DA-1DB460D64046,"iPhone13,2"
com.apple.MobileSMS,101,1750958961,1750959062,1750959062.418637,-18000,EB445137-D7F5-57EC-87DA-1DB460D64046,"iPhone13,2"
com.apple.MobileSMS,23,1750958869,1750958892,1750958892.384892,-18000,EB445137-D7F5-57EC-87DA-1DB460D64046,"iPhone13,2"
com.apple.MobileSMS,17,1750958831,1750958848,1750958849.009426,-18000,EB445137-D7F5-57EC-87DA-1DB460D64046,"iPhone13,2"
com.apple.MobileSMS,4,1750958791,1750958795,1750958795.514522,-18000,EB445137-D7F5-57EC-87DA-1DB460D64046,"iPhone13,2"
com.apple.MobileSMS,106,1750958561,1750958667,1750958667.2645888,-18000,EB445137-D7F5-57EC-87DA-1DB460D64046,"iPhone13,2"
com.doordash.dasher,163,1750958398,1750958561,1750958561.471931,-18000,EB445137-D7F5-57EC-87DA-1DB460D64046,"iPhone13,2"
com.google.chrome.ios,9,1750958389,1750958398,1750958398.197007,-18000,EB445137-D7F5-57EC-87DA-1DB460D64046,"iPhone13,2"
com.doordash.dasher,28,1750958361,1750958389,1750958390.292305,-18000,EB445137-D7F5-57EC-87DA-1DB460D64046,"iPhone13,2"
com.doordash.dasher,2,1750958358,1750958360,1750958360.113799,-18000,EB445137-D7F5-57EC-87DA-1DB460D64046,"iPhone13,2"
com.apple.MobileSMS,529,1750957829,1750958358,1750958358.496376,-18000,EB445137-D7F5-57EC-87DA-1DB460D64046,"iPhone13,2"
com.google.chrome.ios,85,1750957744,1750957829,1750957830.0960732,-18000,EB445137-D7F5-57EC-87DA-1DB460D64046,"iPhone13,2"
com.doordash.dasher,2,1750957742,1750957744,1750957744.615629,-18000,EB445137-D7F5-57EC-87DA-1DB460D64046,"iPhone13,2"
com.google.chrome.ios,14,1750957728,1750957742,1750957742.562762,-18000,EB445137-D7F5-57EC-87DA-1DB460D64046,"iPhone13,2"
com.apple.MobileSMS,6,1750957722,1750957728,1750957728.9139462,-18000,EB445137-D7F5-57EC-87DA-1DB460D64046,"iPhone13,2"
com.google.chrome.ios,2,1750957720,1750957722,1750957722.289407,-18000,EB445137-D7F5-57EC-87DA-1DB460D64046,"iPhone13,2"
com.apple.MobileSMS,71,1750957649,1750957720,1750957720.683157,-18000,EB445137-D7F5-57EC-87DA-1DB460D64046,"iPhone13,2"
com.doordash.dasher,357,1750957257,1750957614,1750957615.063823,-18000,EB445137-D7F5-57EC-87DA-1DB460D64046,"iPhone13,2"
com.doordash.dasher,294,1750956944,1750957238,1750957238.262632,-18000,EB445137-D7F5-57EC-87DA-1DB460D64046,"iPhone13,2"
com.doordash.dasher,47,1750956893,1750956940,1750956940.530439,-18000,EB445137-D7F5-57EC-87DA-1DB460D64046,"iPhone13,2"
com.apple.podcasts,7,1750956886,1750956893,1750956893.926852,-18000,EB445137-D7F5-57EC-87DA-1DB460D64046,"iPhone13,2"
com.doordash.dasher,190,1750956696,1750956886,1750956886.211718,-18000,EB445137-D7F5-57EC-87DA-1DB460D64046,"iPhone13,2"
com.doordash.dasher,3,1750956692,1750956695,1750956695.991818,-18000,EB445137-D7F5-57EC-87DA-1DB460D64046,"iPhone13,2"
com.doordash.dasher,22,1750956624,1750956646,1750956646.697078,-18000,EB445137-D7F5-57EC-87DA-1DB460D64046,"iPhone13,2"
com.google.chrome.ios,78,1750956546,1750956624,1750956624.752938,-18000,EB445137-D7F5-57EC-87DA-1DB460D64046,"iPhone13,2"
com.doordash.dasher,118,1750956428,1750956546,1750956546.857534,-18000,EB445137-D7F5-57EC-87DA-1DB460D64046,"iPhone13,2"
com.google.chrome.ios,52,1750956376,1750956428,1750956429.558103,-18000,EB445137-D7F5-57EC-87DA-1DB460D64046,"iPhone13,2"
com.doordash.dasher,643,1750955733,1750956376,1750956376.3678122,-18000,EB445137-D7F5-57EC-87DA-1DB460D64046,"iPhone13,2"
com.apple.MobileSMS,31,1750955702,1750955733,1750955733.392991,-18000,EB445137-D7F5-57EC-87DA-1DB460D64046,"iPhone13,2"
com.doordash.dasher,3,1750955699,1750955702,1750955702.790544,-18000,EB445137-D7F5-57EC-87DA-1DB460D64046,"iPhone13,2"
com.apple.MobileSMS,2,1750955697,1750955699,1750955699.36868,-18000,EB445137-D7F5-57EC-87DA-1DB460D64046,"iPhone13,2"
com.apple.MobileSMS,26,1750955669,1750955695,1750955696.0885649,-18000,EB445137-D7F5-57EC-87DA-1DB460D64046,"iPhone13,2"
com.doordash.dasher,574,1750955095,1750955669,1750955669.826875,-18000,EB445137-D7F5-57EC-87DA-1DB460D64046,"iPhone13,2"
com.apple.podcasts,3,1750955092,1750955095,1750955095.6800408,-18000,EB445137-D7F5-57EC-87DA-1DB460D64046,"iPhone13,2"
com.doordash.dasher,92,1750955000,1750955092,1750955092.159844,-18000,EB445137-D7F5-57EC-87DA-1DB460D64046,"iPhone13,2"
com.google.chrome.ios,52,1750954948,1750955000,1750955000.667575,-18000,EB445137-D7F5-57EC-87DA-1DB460D64046,"iPhone13,2"
com.letterboxd.LetterboxdApp,10,1750954938,1750954948,1750954948.2224941,-18000,EB445137-D7F5-57EC-87DA-1DB460D64046,"iPhone13,2"
com.doordash.dasher,2,1750954925,1750954927,1750954928.0124822,-18000,EB445137-D7F5-57EC-87DA-1DB460D64046,"iPhone13,2"
com.doordash.dasher,371,1750954547,1750954918,1750954918.6179209,-18000,EB445137-D7F5-57EC-87DA-1DB460D64046,"iPhone13,2"
com.apple.podcasts,70,1750954477,1750954547,1750954547.27558,-18000,EB445137-D7F5-57EC-87DA-1DB460D64046,"iPhone13,2"
com.doordash.dasher,31,1750954446,1750954477,1750954477.3711848,-18000,EB445137-D7F5-57EC-87DA-1DB460D64046,"iPhone13,2"
com.apple.weather,50,1750954116,1750954166,1750954166.476345,-18000,EB445137-D7F5-57EC-87DA-1DB460D64046,"iPhone13,2"
com.strava.stravaride,63,1750954047,1750954110,1750954110.21565,-18000,EB445137-D7F5-57EC-87DA-1DB460D64046,"iPhone13,2"
com.apple.mobilenotes,3,1750954042,1750954045,1750954045.475106,-18000,EB445137-D7F5-57EC-87DA-1DB460D64046,"iPhone13,2"
com.apple.mobilenotes,28,1750954014,1750954042,1750954042.1680331,-18000,EB445137-D7F5-57EC-87DA-1DB460D64046,"iPhone13,2"
com.doordash.dasher,12,1750953441,1750953453,1750953453.5236359,-18000,EB445137-D7F5-57EC-87DA-1DB460D64046,"iPhone13,2"
com.apple.weather,44,1750949794,1750949838,1750949838.203302,-18000,EB445137-D7F5-57EC-87DA-1DB460D64046,"iPhone13,2"
com.apple.MobileSMS,3,1750949789,1750949792,1750949792.441777,-18000,EB445137-D7F5-57EC-87DA-1DB460D64046,"iPhone13,2"
com.apple.Health,14,1750949772,1750949786,1750949786.7364712,-18000,EB445137-D7F5-57EC-87DA-1DB460D64046,"iPhone13,2"
com.apple.weather,44,1750949121,1750949165,1750949165.4504771,-18000,EB445137-D7F5-57EC-87DA-1DB460D64046,"iPhone13,2"
com.apple.MobileSMS,1,1750949119,1750949120,1750949121.1273398,-18000,EB445137-D7F5-57EC-87DA-1DB460D64046,"iPhone13,2"
com.apple.MobileSMS,17,1750948852,1750948869,1750948869.087297,-18000,EB445137-D7F5-57EC-87DA-1DB460D64046,"iPhone13,2"
com.apple.MobileSMS,61,1750948775,1750948836,1750948836.912263,-18000,EB445137-D7F5-57EC-87DA-1DB460D64046,"iPhone13,2"
com.apple.MobileSMS,143,1750948628,1750948771,1750948771.383432,-18000,EB445137-D7F5-57EC-87DA-1DB460D64046,"iPhone13,2"
com.google.Chrome,9,1750948536,1750948545,1750948546.116442,-18000,,
com.google.Chrome,300,1750948158,1750948458,1750948458.895225,-18000,,
com.google.Chrome,1217,1750946747,1750947964,1750947964.8366761,-18000,,
com.google.Chrome,372,1750945935,1750946307,1750946307.821306,-18000,,
com.google.Chrome,1292,1750944335,1750945627,1750945627.177412,-18000,,
com.apple.news,1,1750944334,1750944335,1750944338.2251248,-18000,,
com.apple.Music,6,1750944328,1750944334,1750944334.530055,-18000,,
com.apple.news,54,1750914303,1750914357,1750914357.3619308,-18000,EB445137-D7F5-57EC-87DA-1DB460D64046,"iPhone13,2"
com.apple.news,97,1750913779,1750913876,1750913876.1889539,-18000,EB445137-D7F5-57EC-87DA-1DB460D64046,"iPhone13,2"
com.apple.news,48,1750913524,1750913572,1750913572.760878,-18000,EB445137-D7F5-57EC-87DA-1DB460D64046,"iPhone13,2"
com.apple.weather,16,1750913487,1750913503,1750913503.258088,-18000,EB445137-D7F5-57EC-87DA-1DB460D64046,"iPhone13,2"
com.apple.weather,41,1750913324,1750913365,1750913365.1068602,-18000,EB445137-D7F5-57EC-87DA-1DB460D64046,"iPhone13,2"
com.hammerandchisel.discord,15,1750913061,1750913076,1750913076.3291678,-18000,EB445137-D7F5-57EC-87DA-1DB460D64046,"iPhone13,2"
com.google.Gmail,29,1750913025,1750913054,1750913054.747816,-18000,EB445137-D7F5-57EC-87DA-1DB460D64046,"iPhone13,2"
com.apple.Health,88,1750912836,1750912924,1750912924.254858,-18000,EB445137-D7F5-57EC-87DA-1DB460D64046,"iPhone13,2"
com.apple.findmy,41,1750912736,1750912777,1750912777.222402,-18000,EB445137-D7F5-57EC-87DA-1DB460D64046,"iPhone13,2"
com.apple.findmy,44,1750912637,1750912681,1750912681.5674791,-18000,EB445137-D7F5-57EC-87DA-1DB460D64046,"iPhone13,2"
com.apple.PassbookUIService,1,1750912355,1750912356,1750912356.9460979,-18000,EB445137-D7F5-57EC-87DA-1DB460D64046,"iPhone13,2"
com.apple.findmy,54,1750912299,1750912353,1750912353.300016,-18000,EB445137-D7F5-57EC-87DA-1DB460D64046,"iPhone13,2"
com.apple.Music,572,1750912207,1750912779,1750912780.3359032,-18000,,
com.apple.news,4,1750912203,1750912207,1750912207.1877952,-18000,,
com.apple.Music,4,1750912199,1750912203,1750912204.000504,-18000,,
com.apple.findmy,6,1750912103,1750912109,1750912109.4235291,-18000,EB445137-D7F5-57EC-87DA-1DB460D64046,"iPhone13,2"
com.apple.news,115,1750912084,1750912199,1750912199.509184,-18000,,
com.google.Chrome,131,1750911953,1750912084,1750912084.370369,-18000,,
com.apple.Music,56,1750911897,1750911953,1750911953.337877,-18000,,
com.apple.finder,3,1750911894,1750911897,1750911897.3226662,-18000,,
com.apple.Notes,1,1750911893,1750911894,1750911894.624294,-18000,,
com.apple.finder,1,1750911892,1750911893,1750911893.691204,-18000,,
com.apple.iCal,1,1750911891,1750911892,1750911892.550336,-18000,,
com.apple.finder,3,1750911888,1750911891,1750911891.59653,-18000,,
com.microsoft.Outlook,5,1750911883,1750911888,1750911888.119018,-18000,,
com.apple.findmy,5,1750911861,1750911866,1750911866.187068,-18000,EB445137-D7F5-57EC-87DA-1DB460D64046,"iPhone13,2"
com.microsoft.Outlook,6,1750911346,1750911352,1750911352.18224,-18000,,
com.apple.finder,7,1750911339,1750911346,1750911346.502767,-18000,,
com.apple.Music,47,1750911292,1750911339,1750911339.8086638,-18000,,
com.google.Chrome,47,1750911245,1750911292,1750911292.860224,-18000,,
com.apple.findmy,13,1750910995,1750911008,1750911008.054313,-18000,EB445137-D7F5-57EC-87DA-1DB460D64046,"iPhone13,2"
com.apple.Music,438,1750910807,1750911245,1750911245.5572162,-18000,,
com.apple.findmy,7,1750910669,1750910676,1750910676.278053,-18000,EB445137-D7F5-57EC-87DA-1DB460D64046,"iPhone13,2"
com.letterboxd.LetterboxdApp,2,1750910667,1750910669,1750910669.840534,-18000,EB445137-D7F5-57EC-87DA-1DB460D64046,"iPhone13,2"
com.letterboxd.LetterboxdApp,47,1750910415,1750910462,1750910462.6649241,-18000,EB445137-D7F5-57EC-87DA-1DB460D64046,"iPhone13,2"
com.apple.findmy,6,1750910227,1750910233,1750910233.656217,-18000,EB445137-D7F5-57EC-87DA-1DB460D64046,"iPhone13,2"
com.apple.findmy,10,1750909927,1750909937,1750909937.375953,-18000,EB445137-D7F5-57EC-87DA-1DB460D64046,"iPhone13,2"
com.apple.findmy,6,1750909845,1750909851,1750909851.6042418,-18000,EB445137-D7F5-57EC-87DA-1DB460D64046,"iPhone13,2"
com.google.Chrome,1035,1750909772,1750910807,1750910808.0018039,-18000,,
com.letterboxd.LetterboxdApp,4,1750909763,1750909767,1750909767.228761,-18000,EB445137-D7F5-57EC-87DA-1DB460D64046,"iPhone13,2"
com.letterboxd.LetterboxdApp,137,1750909230,1750909367,1750909368.051795,-18000,EB445137-D7F5-57EC-87DA-1DB460D64046,"iPhone13,2"
com.apple.findmy,13,1750909215,1750909228,1750909228.7052112,-18000,EB445137-D7F5-57EC-87DA-1DB460D64046,"iPhone13,2"
com.apple.mobilephone,5,1750909207,1750909212,1750909212.989461,-18000,EB445137-D7F5-57EC-87DA-1DB460D64046,"iPhone13,2"
com.apple.mobilephone,1,1750907839,1750907840,1750907840.682135,-18000,EB445137-D7F5-57EC-87DA-1DB460D64046,"iPhone13,2"
com.apple.findmy,24,1750907815,1750907839,1750907839.603156,-18000,EB445137-D7F5-57EC-87DA-1DB460D64046,"iPhone13,2"
com.apple.findmy,10,1750907282,1750907292,1750907292.828474,-18000,EB445137-D7F5-57EC-87DA-1DB460D64046,"iPhone13,2"
com.apple.findmy,12,1750907270,1750907282,1750907282.1881309,-18000,EB445137-D7F5-57EC-87DA-1DB460D64046,"iPhone13,2"
com.letterboxd.LetterboxdApp,2,1750907268,1750907270,1750907270.541071,-18000,EB445137-D7F5-57EC-87DA-1DB460D64046,"iPhone13,2"
com.letterboxd.LetterboxdApp,27,1750907233,1750907260,1750907260.782311,-18000,EB445137-D7F5-57EC-87DA-1DB460D64046,"iPhone13,2"
com.letterboxd.LetterboxdApp,77,1750905440,1750905517,1750905517.219698,-18000,EB445137-D7F5-57EC-87DA-1DB460D64046,"iPhone13,2"
com.letterboxd.LetterboxdApp,80,1750905358,1750905438,1750905438.579164,-18000,EB445137-D7F5-57EC-87DA-1DB460D64046,"iPhone13,2"
com.google.chrome.ios,2,1750905356,1750905358,1750905363.660684,-18000,EB445137-D7F5-57EC-87DA-1DB460D64046,"iPhone13,2"
com.apple.findmy,2,1750905354,1750905356,1750905362.870486,-18000,EB445137-D7F5-57EC-87DA-1DB460D64046,"iPhone13,2"
com.google.Chrome,385,1750902041,1750902426,1750902426.59213,-18000,,
com.google.Chrome,102,1750901814,1750901916,1750901916.364177,-18000,,
com.apple.findmy,65,1750901797,1750901862,1750901862.28367,-18000,EB445137-D7F5-57EC-87DA-1DB460D64046,"iPhone13,2"
com.apple.news,215,1750901249,1750901464,1750901464.538247,-18000,EB445137-D7F5-57EC-87DA-1DB460D64046,"iPhone13,2"
com.apple.MobileSMS,48,1750901196,1750901244,1750901244.502502,-18000,EB445137-D7F5-57EC-87DA-1DB460D64046,"iPhone13,2"
com.apple.news,15,1750901181,1750901196,1750901196.6846042,-18000,EB445137-D7F5-57EC-87DA-1DB460D64046,"iPhone13,2"
com.apple.MobileSMS,2,1750901175,1750901177,1750901177.905241,-18000,EB445137-D7F5-57EC-87DA-1DB460D64046,"iPhone13,2"
com.letterboxd.LetterboxdApp,18,1750901157,1750901175,1750901175.958683,-18000,EB445137-D7F5-57EC-87DA-1DB460D64046,"iPhone13,2"
com.apple.MobileSMS,3,1750901154,1750901157,1750901157.871632,-18000,EB445137-D7F5-57EC-87DA-1DB460D64046,"iPhone13,2"
com.letterboxd.LetterboxdApp,19,1750901135,1750901154,1750901154.425345,-18000,EB445137-D7F5-57EC-87DA-1DB460D64046,"iPhone13,2"
com.apple.MobileSMS,231,1750900904,1750901135,1750901135.084019,-18000,EB445137-D7F5-57EC-87DA-1DB460D64046,"iPhone13,2"
com.letterboxd.LetterboxdApp,0,1750900904,1750900904,1750900904.501262,-18000,EB445137-D7F5-57EC-87DA-1DB460D64046,"iPhone13,2"
com.letterboxd.LetterboxdApp,26,1750900866,1750900892,1750900892.8439689,-18000,EB445137-D7F5-57EC-87DA-1DB460D64046,"iPhone13,2"
com.apple.news,1,1750900864,1750900865,1750900866.838156,-18000,EB445137-D7F5-57EC-87DA-1DB460D64046,"iPhone13,2"
com.google.Chrome,705,1750900454,1750901159,1750901159.9583669,-18000,,
com.apple.MobileSMS,65,1750900389,1750900454,1750900454.526802,-18000,,
com.google.Chrome,182,1750900207,1750900389,1750900389.246809,-18000,,
com.apple.MobileSMS,152,1750900055,1750900207,1750900207.50808,-18000,,
com.google.Chrome,1430,1750898625,1750900055,1750900055.968113,-18000,,
com.leomehlig.today,18,1750898607,1750898625,1750898625.6520061,-18000,,
com.google.Chrome,4,1750898603,1750898607,1750898608.0655022,-18000,,
com.microsoft.Word,2,1750898601,1750898603,1750898603.4089808,-18000,,
com.google.Chrome,654,1750897947,1750898601,1750898601.613789,-18000,,
com.apple.news,12,1750897437,1750897449,1750897449.6488461,-18000,EB445137-D7F5-57EC-87DA-1DB460D64046,"iPhone13,2"
com.apple.CoreAuthUI,3,1750897427,1750897430,1750897430.443918,-18000,EB445137-D7F5-57EC-87DA-1DB460D64046,"iPhone13,2"
com.truebill.truebillnative,6,1750897426,1750897432,1750897432.730541,-18000,EB445137-D7F5-57EC-87DA-1DB460D64046,"iPhone13,2"
com.google.Chrome,383,1750897384,1750897767,1750897767.814199,-18000,,
com.microsoft.Word,247,1750897137,1750897384,1750897384.5973248,-18000,,
com.google.Chrome,18,1750897119,1750897137,1750897137.773032,-18000,,
com.microsoft.Word,327,1750896792,1750897119,1750897119.321104,-18000,,
com.google.Chrome,132,1750896660,1750896792,1750896792.5550041,-18000,,
com.microsoft.Word,9,1750896639,1750896648,1750896648.777694,-18000,,
com.apple.finder,15,1750896624,1750896639,1750896639.254775,-18000,,
com.google.Chrome,189,1750896435,1750896624,1750896624.8347821,-18000,,
com.microsoft.Outlook,28,1750896407,1750896435,1750896435.087627,-18000,,
com.google.Chrome,27,1750896380,1750896407,1750896407.3489819,-18000,,
com.microsoft.Outlook,41,1750896339,1750896380,1750896380.221833,-18000,,
com.google.Chrome,2,1750896337,1750896339,1750896339.973999,-18000,,
com.microsoft.Outlook,4,1750896333,1750896337,1750896337.810947,-18000,,
com.truebill.truebillnative,126,1750895572,1750895698,1750895698.940892,-18000,EB445137-D7F5-57EC-87DA-1DB460D64046,"iPhone13,2"
com.google.Chrome,783,1750895550,1750896333,1750896333.958126,-18000,,
com.apple.iCal,38,1750895512,1750895550,1750895550.227716,-18000,,
com.google.Chrome,102,1750895410,1750895512,1750895512.2807488,-18000,,
com.apple.CoreAuthUI,2,1750895382,1750895384,1750895384.1203961,-18000,EB445137-D7F5-57EC-87DA-1DB460D64046,"iPhone13,2"
com.truebill.truebillnative,172,1750895377,1750895549,1750895549.4463959,-18000,EB445137-D7F5-57EC-87DA-1DB460D64046,"iPhone13,2"
com.apple.Notes,64,1750895346,1750895410,1750895410.75695,-18000,,
com.microsoft.VSCode,120,1750895226,1750895346,1750895346.929312,-18000,,
com.google.Chrome,112,1750895114,1750895226,1750895226.786562,-18000,,
com.apple.MobileSMS,5,1750893755,1750893760,1750893760.085462,-18000,EB445137-D7F5-57EC-87DA-1DB460D64046,"iPhone13,2"
com.apple.findmy,0,1750893755,1750893755,1750893756.212565,-18000,EB445137-D7F5-57EC-87DA-1DB460D64046,"iPhone13,2"
com.apple.findmy,10,1750893398,1750893408,1750893408.124587,-18000,EB445137-D7F5-57EC-87DA-1DB460D64046,"iPhone13,2"
com.apple.mobileslideshow,2,1750892100,1750892102,1750892102.735332,-18000,EB445137-D7F5-57EC-87DA-1DB460D64046,"iPhone13,2"
com.apple.mobileslideshow,59,1750891639,1750891698,1750891698.354056,-18000,EB445137-D7F5-57EC-87DA-1DB460D64046,"iPhone13,2"
com.apple.findmy,2,1750891635,1750891637,1750891637.576524,-18000,EB445137-D7F5-57EC-87DA-1DB460D64046,"iPhone13,2"
com.google.Chrome,5,1750891312,1750891317,1750891317.690162,-18000,,
com.apple.findmy,9,1750890801,1750890810,1750890811.11672,-18000,EB445137-D7F5-57EC-87DA-1DB460D64046,"iPhone13,2"
com.microsoft.VSCode,1080,1750890232,1750891312,1750891312.633673,-18000,,
com.google.Chrome,4,1750890228,1750890232,1750890232.59023,-18000,,
com.microsoft.VSCode,10,1750890218,1750890228,1750890228.872339,-18000,,
com.google.Chrome,54,1750890164,1750890218,1750890218.4110398,-18000,,
com.microsoft.VSCode,71,1750890093,1750890164,1750890164.287657,-18000,,
com.google.Chrome,6,1750890087,1750890093,1750890093.031684,-18000,,
com.microsoft.VSCode,75,1750890012,1750890087,1750890087.637244,-18000,,
com.google.Chrome,43,1750889969,1750890012,1750890012.9846911,-18000,,
com.microsoft.VSCode,9,1750889960,1750889969,1750889969.2398272,-18000,,
com.google.Chrome,6,1750889954,1750889960,1750889960.4603581,-18000,,
com.microsoft.VSCode,1,1750889953,1750889954,1750889954.274077,-18000,,
com.google.Chrome,1,1750889952,1750889953,1750889953.483752,-18000,,
com.microsoft.VSCode,10,1750889942,1750889952,1750889952.224258,-18000,,
com.google.Chrome,19,1750889923,1750889942,1750889942.1061358,-18000,,
com.microsoft.VSCode,66,1750889857,1750889923,1750889923.8344688,-18000,,
com.google.Chrome,16,1750889841,1750889857,1750889857.8059049,-18000,,
com.microsoft.VSCode,1005,1750888836,1750889841,1750889841.868126,-18000,,
com.google.Chrome,57,1750888779,1750888836,1750888836.671318,-18000,,
com.doordash.dasher,9,1750888750,1750888759,1750888759.1125631,-18000,EB445137-D7F5-57EC-87DA-1DB460D64046,"iPhone13,2"
com.apple.weather,14,1750888600,1750888614,1750888614.394671,-18000,EB445137-D7F5-57EC-87DA-1DB460D64046,"iPhone13,2"
Astrospheric.Astrospheric,9,1750888590,1750888599,1750888599.646755,-18000,EB445137-D7F5-57EC-87DA-1DB460D64046,"iPhone13,2"
com.tier9digital.sundial,2,1750888581,1750888583,1750888583.219459,-18000,EB445137-D7F5-57EC-87DA-1DB460D64046,"iPhone13,2"
com.google.chrome.ios,181,1750888400,1750888581,1750888581.316815,-18000,EB445137-D7F5-57EC-87DA-1DB460D64046,"iPhone13,2"
com.letterboxd.LetterboxdApp,3,1750888395,1750888398,1750888398.76292,-18000,EB445137-D7F5-57EC-87DA-1DB460D64046,"iPhone13,2"
com.google.Chrome,682,1750887676,1750888358,1750888358.6893358,-18000,,
com.letterboxd.LetterboxdApp,22,1750887654,1750887676,1750887676.776,-18000,EB445137-D7F5-57EC-87DA-1DB460D64046,"iPhone13,2"
com.doordash.dasher,45,1750887024,1750887069,1750887069.955137,-18000,EB445137-D7F5-57EC-87DA-1DB460D64046,"iPhone13,2"
com.letterboxd.LetterboxdApp,2,1750887022,1750887024,1750887024.094307,-18000,EB445137-D7F5-57EC-87DA-1DB460D64046,"iPhone13,2"
com.google.Chrome,356,1750887017,1750887373,1750887373.901886,-18000,,
com.google.Chrome,569,1750886227,1750886796,1750886797.006239,-18000,,
com.letterboxd.LetterboxdApp,20,1750885459,1750885479,1750885479.61197,-18000,EB445137-D7F5-57EC-87DA-1DB460D64046,"iPhone13,2"
com.apple.Health,1,1750885458,1750885459,1750885459.7919989,-18000,EB445137-D7F5-57EC-87DA-1DB460D64046,"iPhone13,2"
com.google.Chrome,300,1750885452,1750885752,1750885752.798986,-18000,,
com.google.Chrome,382,1750884463,1750884845,1750884845.92506,-18000,,
com.microsoft.VSCode,965,1750883498,1750884463,1750884463.675236,-18000,,
com.google.Chrome,124,1750883374,1750883498,1750883498.826902,-18000,,
com.apple.finder,3,1750883360,1750883363,1750883363.135748,-18000,,
com.leomehlig.today,2,1750883358,1750883360,1750883360.388308,-18000,,
com.microsoft.VSCode,5,1750883353,1750883358,1750883358.640938,-18000,,
com.google.Chrome,12,1750883341,1750883353,1750883353.713807,-18000,,
com.leomehlig.today,26,1750883315,1750883341,1750883341.5833669,-18000,,
com.google.Chrome,3,1750883312,1750883315,1750883315.220768,-18000,,
com.apple.Notes,52,1750883260,1750883312,1750883312.953518,-18000,,
com.google.Chrome,145,1750883115,1750883260,1750883260.457576,-18000,,
com.apple.Notes,3,1750883112,1750883115,1750883115.2987452,-18000,,
com.google.Chrome,213,1750882899,1750883112,1750883112.3426208,-18000,,
com.apple.Notes,1,1750882898,1750882899,1750882899.490581,-18000,,
com.microsoft.VSCode,5,1750882893,1750882898,1750882898.719788,-18000,,
com.apple.Notes,0,1750882893,1750882893,1750882893.8835778,-18000,,
com.microsoft.VSCode,3,1750882890,1750882893,1750882893.205865,-18000,,
com.google.Chrome,27,1750882863,1750882890,1750882890.5149999,-18000,,
com.microsoft.VSCode,1,1750882862,1750882863,1750882863.4107099,-18000,,
com.google.Chrome,5,1750882857,1750882862,1750882862.2184072,-18000,,
com.microsoft.VSCode,69,1750882788,1750882857,1750882857.831822,-18000,,
com.google.Chrome,3,1750882785,1750882788,1750882788.290633,-18000,,
com.microsoft.VSCode,28,1750882757,1750882785,1750882785.9267812,-18000,,
com.google.Chrome,20,1750882737,1750882757,1750882757.571758,-18000,,
com.microsoft.VSCode,5,1750882732,1750882737,1750882737.221503,-18000,,
com.google.Chrome,45,1750882687,1750882732,1750882732.27184,-18000,,
com.microsoft.VSCode,2,1750882685,1750882687,1750882687.993356,-18000,,
com.google.Chrome,2,1750882683,1750882685,1750882685.270148,-18000,,
com.microsoft.VSCode,8,1750882675,1750882683,1750882683.138198,-18000,,
com.google.Chrome,1,1750882674,1750882675,1750882675.402569,-18000,,
com.microsoft.VSCode,142,1750882532,1750882674,1750882674.8253841,-18000,,
com.google.Chrome,11,1750882521,1750882532,1750882532.792166,-18000,,
com.microsoft.VSCode,7,1750882514,1750882521,1750882521.495774,-18000,,
com.google.Chrome,10,1750882504,1750882514,1750882514.125663,-18000,,
com.microsoft.VSCode,4,1750882500,1750882504,1750882504.090225,-18000,,
com.google.Chrome,5,1750882495,1750882500,1750882500.271353,-18000,,
com.microsoft.VSCode,7,1750882488,1750882495,1750882495.393501,-18000,,
com.google.Chrome,4,1750882484,1750882488,1750882488.385035,-18000,,
com.microsoft.VSCode,4,1750882480,1750882484,1750882484.8844008,-18000,,
com.google.Chrome,7,1750882473,1750882480,1750882480.633963,-18000,,
com.microsoft.VSCode,20,1750882453,1750882473,1750882473.129899,-18000,,
com.google.Chrome,3,1750882450,1750882453,1750882453.302362,-18000,,
com.apple.Notes,15,1750882435,1750882450,1750882450.4491801,-18000,,
com.google.Chrome,260,1750882175,1750882435,1750882435.526115,-18000,,
us.zoom.xos,14,1750882161,1750882175,1750882175.725982,-18000,,
com.google.Chrome,8,1750882153,1750882161,1750882161.04598,-18000,,
us.zoom.xos,8,1750882145,1750882153,1750882153.512151,-18000,,
com.google.Chrome,17,1750882128,1750882145,1750882145.0941958,-18000,,
us.zoom.xos,22,1750882106,1750882128,1750882128.303339,-18000,,
com.google.Chrome,34,1750882072,1750882106,1750882106.5624819,-18000,,
com.apple.finder,0,1750882072,1750882072,1750882072.754436,-18000,,
com.google.Chrome,22,1750882050,1750882072,1750882072.1190062,-18000,,
com.apple.finder,0,1750882050,1750882050,1750882050.895823,-18000,,
us.zoom.xos,1,1750882049,1750882050,1750882050.0876842,-18000,,
com.apple.finder,3,1750882046,1750882049,1750882049.182825,-18000,,
com.google.Chrome,20,1750882026,1750882046,1750882046.549602,-18000,,
com.apple.finder,15,1750882011,1750882026,1750882026.504242,-18000,,
com.google.Chrome,10,1750882001,1750882011,1750882011.95837,-18000,,
us.zoom.xos,9,1750881992,1750882001,1750882001.928288,-18000,,
com.google.Chrome,2,1750881990,1750881992,1750881993.027944,-18000,,
us.zoom.xos,4,1750881986,1750881990,1750881990.265327,-18000,,
com.google.Chrome,25,1750881961,1750881986,1750881986.92915,-18000,,
us.zoom.xos,6,1750881955,1750881961,1750881961.549346,-18000,,
com.google.Chrome,3,1750881952,1750881955,1750881955.8310819,-18000,,
us.zoom.xos,7,1750881945,1750881952,1750881952.3299341,-18000,,
com.google.Chrome,11,1750881934,1750881945,1750881945.832793,-18000,,
us.zoom.xos,9,1750881925,1750881934,1750881934.718351,-18000,,
com.google.Chrome,7,1750881918,1750881925,1750881925.43125,-18000,,
us.zoom.xos,5,1750881913,1750881918,1750881918.964858,-18000,,
com.google.Chrome,19,1750881894,1750881913,1750881913.22007,-18000,,
us.zoom.xos,13,1750881881,1750881894,1750881894.4706922,-18000,,
com.google.Chrome,13,1750881868,1750881881,1750881881.179043,-18000,,
us.zoom.xos,1,1750881867,1750881868,1750881868.037363,-18000,,
com.google.Chrome,15,1750881852,1750881867,1750881867.157536,-18000,,
us.zoom.xos,4,1750881848,1750881852,1750881852.605396,-18000,,
com.google.Chrome,32,1750881816,1750881848,1750881848.814938,-18000,,
us.zoom.xos,1,1750881815,1750881816,1750881816.066174,-18000,,
com.google.Chrome,17,1750881798,1750881815,1750881815.504428,-18000,,
us.zoom.xos,1,1750881797,1750881798,1750881798.221233,-18000,,
com.google.Chrome,26,1750881771,1750881797,1750881797.567432,-18000,,
us.zoom.xos,1,1750881770,1750881771,1750881771.380567,-18000,,
com.google.Chrome,18,1750881752,1750881770,1750881770.3644,-18000,,
us.zoom.xos,1,1750881751,1750881752,1750881752.77053,-18000,,
com.google.Chrome,29,1750881722,1750881751,1750881751.433491,-18000,,
com.apple.Health,24,1750881683,1750881707,1750881708.102773,-18000,EB445137-D7F5-57EC-87DA-1DB460D64046,"iPhone13,2"
us.zoom.xos,80,1750881642,1750881722,1750881722.573076,-18000,,
com.google.Chrome,5,1750881637,1750881642,1750881642.952096,-18000,,
us.zoom.xos,10,1750881627,1750881637,1750881637.74958,-18000,,
com.google.Chrome,4,1750881623,1750881627,1750881627.3476481,-18000,,
us.zoom.xos,271,1750881352,1750881623,1750881623.5061688,-18000,,
com.google.Chrome,12,1750881340,1750881352,1750881352.110011,-18000,,
com.apple.Notes,30,1750881310,1750881340,1750881340.4854531,-18000,,
com.google.Chrome,341,1750880969,1750881310,1750881310.9150891,-18000,,
com.apple.finder,15,1750880954,1750880969,1750880969.689673,-18000,,
com.google.Chrome,27,1750880927,1750880954,1750880954.456063,-18000,,
com.apple.finder,12,1750880915,1750880927,1750880927.351984,-18000,,
com.google.Chrome,31,1750880884,1750880915,1750880915.32919,-18000,,
com.apple.finder,4,1750880880,1750880884,1750880884.7796159,-18000,,
com.google.Chrome,25,1750880855,1750880880,1750880880.836824,-18000,,
com.apple.finder,15,1750880840,1750880855,1750880855.387721,-18000,,
com.google.Chrome,29,1750880811,1750880840,1750880840.88197,-18000,,
com.apple.finder,12,1750880799,1750880811,1750880811.2456279,-18000,,
com.google.Chrome,23,1750880776,1750880799,1750880799.953943,-18000,,
com.apple.finder,1,1750880775,1750880776,1750880776.369759,-18000,,
com.apple.Notes,10,1750880765,1750880775,1750880775.637103,-18000,,
com.apple.finder,33,1750880732,1750880765,1750880765.486874,-18000,,
com.google.Chrome,27,1750880705,1750880732,1750880732.790741,-18000,,
com.apple.finder,6,1750880699,1750880705,1750880705.369679,-18000,,
com.google.Chrome,14,1750880685,1750880699,1750880699.123049,-18000,,
com.apple.finder,7,1750880678,1750880685,1750880685.1358662,-18000,,
com.google.Chrome,34,1750880644,1750880678,1750880678.905733,-18000,,
com.apple.finder,8,1750880636,1750880644,1750880644.72979,-18000,,
com.google.Chrome,2,1750880634,1750880636,1750880636.126101,-18000,,
com.apple.finder,2,1750880632,1750880634,1750880634.262141,-18000,,
com.google.Chrome,1,1750880631,1750880632,1750880632.193439,-18000,,
com.apple.Notes,18,1750880613,1750880631,1750880631.074012,-18000,,
com.google.Chrome,26,1750880587,1750880613,1750880613.172669,-18000,,
com.apple.finder,8,1750880579,1750880587,1750880587.8532019,-18000,,
com.google.Chrome,27,1750880552,1750880579,1750880579.170467,-18000,,
com.apple.finder,7,1750880545,1750880552,1750880552.5729542,-18000,,
com.google.Chrome,20,1750880525,1750880545,1750880545.762202,-18000,,
com.apple.finder,2,1750880523,1750880525,1750880525.9626532,-18000,,
com.google.Chrome,36,1750880487,1750880523,1750880523.4108372,-18000,,
com.apple.finder,4,1750880483,1750880487,1750880487.721222,-18000,,
com.google.Chrome,102,1750880381,1750880483,1750880483.1414871,-18000,,
com.apple.finder,42,1750880339,1750880381,1750880381.228705,-18000,,
com.google.Chrome,56,1750880283,1750880339,1750880339.744132,-18000,,
com.apple.finder,3,1750880280,1750880283,1750880283.737433,-18000,,
com.google.Chrome,43,1750880237,1750880280,1750880280.782017,-18000,,
com.apple.finder,22,1750880215,1750880237,1750880237.1804519,-18000,,
com.apple.findmy,37,1750880118,1750880155,1750880155.886442,-18000,EB445137-D7F5-57EC-87DA-1DB460D64046,"iPhone13,2"
com.apple.weather,9,1750880091,1750880100,1750880101.158828,-18000,EB445137-D7F5-57EC-87DA-1DB460D64046,"iPhone13,2"
com.google.Chrome,149,1750880066,1750880215,1750880215.19352,-18000,,
com.apple.finder,1,1750880065,1750880066,1750880066.9489388,-18000,,
com.google.Chrome,36,1750880029,1750880065,1750880065.574799,-18000,,
com.apple.finder,1,1750880028,1750880029,1750880029.96519,-18000,,
com.google.Chrome,56,1750879972,1750880028,1750880028.132443,-18000,,
com.apple.finder,3,1750879969,1750879972,1750879972.3012319,-18000,,
com.google.Chrome,93,1750879876,1750879969,1750879969.7861772,-18000,,
com.apple.finder,11,1750879865,1750879876,1750879876.8327498,-18000,,
com.google.Chrome,43,1750879822,1750879865,1750879865.931931,-18000,,
com.apple.finder,4,1750879818,1750879822,1750879822.589011,-18000,,
com.google.Chrome,30,1750879788,1750879818,1750879818.3882551,-18000,,
com.apple.finder,4,1750879784,1750879788,1750879788.574739,-18000,,
com.google.Chrome,84,1750879700,1750879784,1750879784.563575,-18000,,
com.apple.finder,4,1750879696,1750879700,1750879700.0718489,-18000,,
com.google.Chrome,41,1750879655,1750879696,1750879696.121923,-18000,,
com.apple.finder,1,1750879654,1750879655,1750879655.876529,-18000,,
com.google.Chrome,81,1750879573,1750879654,1750879654.171973,-18000,,
com.apple.finder,7,1750879566,1750879573,1750879573.694728,-18000,,
com.google.Chrome,34,1750879532,1750879566,1750879567.0323339,-18000,,
com.apple.finder,5,1750879527,1750879532,1750879532.595611,-18000,,
com.google.Chrome,24,1750879503,1750879527,1750879527.1163568,-18000,,
com.apple.finder,5,1750879498,1750879503,1750879503.087414,-18000,,
com.google.Chrome,3,1750879495,1750879498,1750879498.194845,-18000,,
com.apple.finder,17,1750879478,1750879495,1750879495.596179,-18000,,
com.google.Chrome,6,1750879472,1750879478,1750879478.628072,-18000,,
com.apple.Notes,38,1750879434,1750879472,1750879472.127966,-18000,,
com.goodreads.Goodreads,39,1750879228,1750879267,1750879267.4747372,-18000,EB445137-D7F5-57EC-87DA-1DB460D64046,"iPhone13,2"
com.apple.MobileSMS,3,1750879201,1750879204,1750879204.81547,-18000,EB445137-D7F5-57EC-87DA-1DB460D64046,"iPhone13,2"
com.google.Chrome,285,1750879149,1750879434,1750879435.03952,-18000,,
com.apple.Notes,13,1750879136,1750879149,1750879149.712764,-18000,,
com.google.Chrome,577,1750878559,1750879136,1750879136.410105,-18000,,
com.apple.finder,21,1750878538,1750878559,1750878559.986196,-18000,,
com.google.Chrome,174,1750878364,1750878538,1750878538.955597,-18000,,
com.apple.Notes,1,1750878363,1750878364,1750878364.682061,-18000,,
com.google.Chrome,5,1750878358,1750878363,1750878363.319165,-18000,,
com.apple.Notes,2,1750878356,1750878358,1750878358.266197,-18000,,
com.google.Chrome,9,1750878347,1750878356,1750878356.44382,-18000,,
com.apple.Notes,2,1750878345,1750878347,1750878347.802705,-18000,,
com.google.Chrome,3,1750878342,1750878345,1750878345.410643,-18000,,
com.apple.Notes,1,1750878341,1750878342,1750878342.708156,-18000,,
com.google.Chrome,9,1750878332,1750878341,1750878341.140458,-18000,,
com.apple.Notes,5,1750878327,1750878332,1750878332.710771,-18000,,
com.google.Chrome,4,1750878323,1750878327,1750878327.770688,-18000,,
com.apple.Notes,8,1750878315,1750878323,1750878323.382792,-18000,,
com.google.Chrome,4,1750878311,1750878315,1750878315.2412848,-18000,,
com.apple.Notes,2,1750878309,1750878311,1750878312.000603,-18000,,
com.google.Chrome,4,1750878305,1750878309,1750878309.7119122,-18000,,
com.apple.Notes,6,1750878299,1750878305,1750878305.28295,-18000,,
com.google.Chrome,32,1750878267,1750878299,1750878299.648065,-18000,,
com.apple.Notes,4,1750878263,1750878267,1750878267.741008,-18000,,
com.google.Chrome,1,1750878262,1750878263,1750878263.749271,-18000,,
com.apple.Notes,12,1750878250,1750878262,1750878262.2786732,-18000,,
com.google.Chrome,2,1750878248,1750878250,1750878250.538517,-18000,,
com.apple.Notes,10,1750878238,1750878248,1750878248.1969662,-18000,,
com.google.Chrome,32,1750878206,1750878238,1750878238.341686,-18000,,
com.apple.Notes,2,1750878204,1750878206,1750878206.351243,-18000,,
com.google.Chrome,1,1750878203,1750878204,1750878204.549391,-18000,,
com.apple.Notes,5,1750878198,1750878203,1750878203.390923,-18000,,
com.google.Chrome,985,1750877213,1750878198,1750878198.4239678,-18000,,
com.apple.Notes,6,1750877207,1750877213,1750877213.4770699,-18000,,
com.apple.finder,4,1750877203,1750877207,1750877207.218978,-18000,,
com.leomehlig.today,42,1750877161,1750877203,1750877203.528281,-18000,,
com.strava.stravaride,92,1750876661,1750876753,1750876753.982784,-18000,EB445137-D7F5-57EC-87DA-1DB460D64046,"iPhone13,2"
com.apple.MobileSMS,23,1750876426,1750876449,1750876449.621746,-18000,EB445137-D7F5-57EC-87DA-1DB460D64046,"iPhone13,2"
com.apple.news,1,1750876425,1750876426,1750876426.680155,-18000,EB445137-D7F5-57EC-87DA-1DB460D64046,"iPhone13,2"
com.apple.news,337,1750876068,1750876405,1750876405.923204,-18000,EB445137-D7F5-57EC-87DA-1DB460D64046,"iPhone13,2"
com.apple.MobileSMS,2,1750876066,1750876068,1750876068.712964,-18000,EB445137-D7F5-57EC-87DA-1DB460D64046,"iPhone13,2"
com.apple.news,197,1750875851,1750876048,1750876048.332022,-18000,EB445137-D7F5-57EC-87DA-1DB460D64046,"iPhone13,2"
com.tinyspeck.chatlyio,10,1750875431,1750875441,1750875441.694292,-18000,EB445137-D7F5-57EC-87DA-1DB460D64046,"iPhone13,2"
com.strava.stravaride,101,1750875319,1750875420,1750875420.367031,-18000,EB445137-D7F5-57EC-87DA-1DB460D64046,"iPhone13,2"
com.doordash.dasher,29,1750875288,1750875317,1750875317.273093,-18000,EB445137-D7F5-57EC-87DA-1DB460D64046,"iPhone13,2"
com.doordash.dasher,463,1750874688,1750875151,1750875151.977205,-18000,EB445137-D7F5-57EC-87DA-1DB460D64046,"iPhone13,2"
com.apple.InCallService,20,1750874668,1750874688,1750874688.452709,-18000,EB445137-D7F5-57EC-87DA-1DB460D64046,"iPhone13,2"
com.apple.BusinessChatViewService,1,1750874666,1750874667,1750874667.99713,-18000,EB445137-D7F5-57EC-87DA-1DB460D64046,"iPhone13,2"
com.doordash.dasher,766,1750873902,1750874668,1750874668.892418,-18000,EB445137-D7F5-57EC-87DA-1DB460D64046,"iPhone13,2"
com.apple.podcasts,17,1750873885,1750873902,1750873902.309246,-18000,EB445137-D7F5-57EC-87DA-1DB460D64046,"iPhone13,2"
com.doordash.dasher,1407,1750872478,1750873885,1750873885.3638492,-18000,EB445137-D7F5-57EC-87DA-1DB460D64046,"iPhone13,2"
com.apple.news,2,1750872476,1750872478,1750872478.340784,-18000,EB445137-D7F5-57EC-87DA-1DB460D64046,"iPhone13,2"
com.apple.news,191,1750872269,1750872460,1750872460.9449558,-18000,EB445137-D7F5-57EC-87DA-1DB460D64046,"iPhone13,2"
com.apple.weather,26,1750872162,1750872188,1750872188.833959,-18000,EB445137-D7F5-57EC-87DA-1DB460D64046,"iPhone13,2"
com.doordash.dasher,2,1750872160,1750872162,1750872162.289532,-18000,EB445137-D7F5-57EC-87DA-1DB460D64046,"iPhone13,2"
com.doordash.dasher,74,1750872076,1750872150,1750872150.705264,-18000,EB445137-D7F5-57EC-87DA-1DB460D64046,"iPhone13,2"
com.doordash.dasher,1505,1750870565,1750872070,1750872071.051151,-18000,EB445137-D7F5-57EC-87DA-1DB460D64046,"iPhone13,2"
com.apple.podcasts,17,1750870548,1750870565,1750870565.623172,-18000,EB445137-D7F5-57EC-87DA-1DB460D64046,"iPhone13,2"
com.doordash.dasher,626,1750869922,1750870548,1750870548.66749,-18000,EB445137-D7F5-57EC-87DA-1DB460D64046,"iPhone13,2"
com.doordash.dasher,1201,1750868377,1750869578,1750869578.874371,-18000,EB445137-D7F5-57EC-87DA-1DB460D64046,"iPhone13,2"
com.apple.podcasts,47,1750868330,1750868377,1750868377.886455,-18000,EB445137-D7F5-57EC-87DA-1DB460D64046,"iPhone13,2"
com.doordash.dasher,42,1750868288,1750868330,1750868331.3762631,-18000,EB445137-D7F5-57EC-87DA-1DB460D64046,"iPhone13,2"
com.doordash.dasher,63,1750868223,1750868286,1750868286.290488,-18000,EB445137-D7F5-57EC-87DA-1DB460D64046,"iPhone13,2"
com.doordash.dasher,2,1750868072,1750868074,1750868075.314738,-18000,EB445137-D7F5-57EC-87DA-1DB460D64046,"iPhone13,2"
com.doordash.dasher,10,1750868020,1750868030,1750868030.739462,-18000,EB445137-D7F5-57EC-87DA-1DB460D64046,"iPhone13,2"
com.openai.chat,51,1750867967,1750868018,1750868018.8306,-18000,EB445137-D7F5-57EC-87DA-1DB460D64046,"iPhone13,2"
com.doordash.dasher,17,1750867950,1750867967,1750867967.287736,-18000,EB445137-D7F5-57EC-87DA-1DB460D64046,"iPhone13,2"
com.openai.chat,27,1750867923,1750867950,1750867950.118083,-18000,EB445137-D7F5-57EC-87DA-1DB460D64046,"iPhone13,2"
com.doordash.dasher,16,1750867901,1750867917,1750867917.392421,-18000,EB445137-D7F5-57EC-87DA-1DB460D64046,"iPhone13,2"
com.doordash.dasher,7,1750867893,1750867900,1750867900.343014,-18000,EB445137-D7F5-57EC-87DA-1DB460D64046,"iPhone13,2"
com.apple.weather,55,1750867835,1750867890,1750867890.899514,-18000,EB445137-D7F5-57EC-87DA-1DB460D64046,"iPhone13,2"
com.doordash.dasher,3,1750867824,1750867827,1750867827.461172,-18000,EB445137-D7F5-57EC-87DA-1DB460D64046,"iPhone13,2"
com.apple.podcasts,1,1750867810,1750867811,1750867811.9983969,-18000,EB445137-D7F5-57EC-87DA-1DB460D64046,"iPhone13,2"
com.apple.podcasts,66,1750867586,1750867652,1750867652.962712,-18000,EB445137-D7F5-57EC-87DA-1DB460D64046,"iPhone13,2"
com.doordash.dasher,0,1750867586,1750867586,1750867586.843954,-18000,EB445137-D7F5-57EC-87DA-1DB460D64046,"iPhone13,2"
com.doordash.dasher,53,1750867404,1750867457,1750867457.603712,-18000,EB445137-D7F5-57EC-87DA-1DB460D64046,"iPhone13,2"
com.doordash.dasher,21,1750867153,1750867174,1750867174.8148432,-18000,EB445137-D7F5-57EC-87DA-1DB460D64046,"iPhone13,2"
com.leomehlig.today,38,1750867134,1750867172,1750867173.1304111,-18000,,
com.google.Chrome,90,1750867044,1750867134,1750867135.170969,-18000,,
com.apple.iCal,59,1750866985,1750867044,1750867044.355431,-18000,,
com.google.Chrome,10,1750866975,1750866985,1750866985.101589,-18000,,
com.apple.iCal,53,1750866922,1750866975,1750866975.973339,-18000,,
com.google.Chrome,4,1750866918,1750866922,1750866922.346792,-18000,,
com.apple.iCal,23,1750866895,1750866918,1750866918.499848,-18000,,
com.google.Chrome,3,1750866892,1750866895,1750866895.509273,-18000,,
com.apple.iCal,46,1750866846,1750866892,1750866892.774733,-18000,,
com.google.Chrome,41,1750866805,1750866846,1750866846.992322,-18000,,
com.apple.iCal,5,1750866800,1750866805,1750866805.925579,-18000,,
com.google.Chrome,40,1750866760,1750866800,1750866800.1625,-18000,,
com.apple.iCal,11,1750866749,1750866760,1750866760.063072,-18000,,
com.google.Chrome,2,1750866747,1750866749,1750866749.343379,-18000,,
com.apple.iCal,19,1750866728,1750866747,1750866747.4744601,-18000,,
com.google.Chrome,20,1750866708,1750866728,1750866728.0545511,-18000,,
com.apple.iCal,4,1750866704,1750866708,1750866708.7510881,-18000,,
com.google.Chrome,3,1750866701,1750866704,1750866704.810458,-18000,,
com.apple.iCal,4,1750866697,1750866701,1750866701.071598,-18000,,
com.google.Chrome,1,1750866696,1750866697,1750866697.969569,-18000,,
com.apple.iCal,8,1750866688,1750866696,1750866696.288023,-18000,,
com.google.Chrome,28,1750866660,1750866688,1750866688.416363,-18000,,
com.apple.iCal,10,1750866650,1750866660,1750866660.102841,-18000,,
com.google.Chrome,59,1750866591,1750866650,1750866650.154762,-18000,,
com.apple.iCal,2,1750866589,1750866591,1750866591.536243,-18000,,
com.google.Chrome,48,1750866541,1750866589,1750866589.8603601,-18000,,
com.apple.iCal,1,1750866540,1750866541,1750866541.466109,-18000,,
com.google.Chrome,2,1750866538,1750866540,1750866540.453654,-18000,,
com.apple.iCal,3,1750866535,1750866538,1750866538.779467,-18000,,
com.google.Chrome,4,1750866531,1750866535,1750866535.7998729,-18000,,
com.apple.iCal,3,1750866528,1750866531,1750866531.278911,-18000,,
com.google.Chrome,2,1750866526,1750866528,1750866528.152848,-18000,,
com.apple.iCal,31,1750866495,1750866526,1750866526.882695,-18000,,
com.google.Chrome,177,1750866318,1750866495,1750866495.694247,-18000,,
com.doordash.dasher,47,1750866243,1750866290,1750866291.401908,-18000,EB445137-D7F5-57EC-87DA-1DB460D64046,"iPhone13,2"
com.apple.findmy,8,1750861569,1750861577,1750861577.9727821,-18000,EB445137-D7F5-57EC-87DA-1DB460D64046,"iPhone13,2"
com.strava.stravaride,2,1750861567,1750861569,1750861569.31369,-18000,EB445137-D7F5-57EC-87DA-1DB460D64046,"iPhone13,2"
com.strava.stravaride,1,1750861542,1750861543,1750861543.889027,-18000,EB445137-D7F5-57EC-87DA-1DB460D64046,"iPhone13,2"
com.strava.stravaride,346,1750861191,1750861537,1750861537.830923,-18000,EB445137-D7F5-57EC-87DA-1DB460D64046,"iPhone13,2"
com.renpho.health,18,1750860932,1750860950,1750860950.017065,-18000,EB445137-D7F5-57EC-87DA-1DB460D64046,"iPhone13,2"
com.apple.findmy,2,1750860930,1750860932,1750860933.2945108,-18000,EB445137-D7F5-57EC-87DA-1DB460D64046,"iPhone13,2"
com.apple.findmy,30,1750860824,1750860854,1750860854.883514,-18000,EB445137-D7F5-57EC-87DA-1DB460D64046,"iPhone13,2"
com.apple.findmy,21,1750860799,1750860820,1750860820.8514628,-18000,EB445137-D7F5-57EC-87DA-1DB460D64046,"iPhone13,2"
com.apple.weather,11,1750860575,1750860586,1750860586.3430228,-18000,EB445137-D7F5-57EC-87DA-1DB460D64046,"iPhone13,2"
com.apple.news,1,1750860574,1750860575,1750860576.042304,-18000,EB445137-D7F5-57EC-87DA-1DB460D64046,"iPhone13,2"
com.apple.news,517,1750860043,1750860560,1750860560.857592,-18000,EB445137-D7F5-57EC-87DA-1DB460D64046,"iPhone13,2"
com.apple.Health,13,1750860026,1750860039,1750860040.0025768,-18000,EB445137-D7F5-57EC-87DA-1DB460D64046,"iPhone13,2"
com.apple.findmy,12,1750860010,1750860022,1750860022.5183182,-18000,EB445137-D7F5-57EC-87DA-1DB460D64046,"iPhone13,2"
com.apple.findmy,73,1750859930,1750860003,1750860003.74841,-18000,EB445137-D7F5-57EC-87DA-1DB460D64046,"iPhone13,2"
com.apple.findmy,14,1750859103,1750859117,1750859117.749104,-18000,EB445137-D7F5-57EC-87DA-1DB460D64046,"iPhone13,2"
com.apple.news,44,1750856769,1750856813,1750856813.2973418,-18000,EB445137-D7F5-57EC-87DA-1DB460D64046,"iPhone13,2"
com.apple.mobiletimer,1,1750856759,1750856760,1750856760.774267,-18000,EB445137-D7F5-57EC-87DA-1DB460D64046,"iPhone13,2"
com.apple.mobiletimer,3,1750856653,1750856656,1750856656.26431,-18000,EB445137-D7F5-57EC-87DA-1DB460D64046,"iPhone13,2"
com.apple.findmy,8,1750827864,1750827872,1750827872.0408149,-18000,EB445137-D7F5-57EC-87DA-1DB460D64046,"iPhone13,2"
com.apple.findmy,6,1750827452,1750827458,1750827459.142626,-18000,EB445137-D7F5-57EC-87DA-1DB460D64046,"iPhone13,2"
com.apple.findmy,7,1750824992,1750824999,1750824999.982386,-18000,EB445137-D7F5-57EC-87DA-1DB460D64046,"iPhone13,2"
com.apple.findmy,6,1750824688,1750824694,1750824694.8516068,-18000,EB445137-D7F5-57EC-87DA-1DB460D64046,"iPhone13,2"
com.apple.findmy,9,1750824465,1750824474,1750824474.459472,-18000,EB445137-D7F5-57EC-87DA-1DB460D64046,"iPhone13,2"
com.apple.findmy,14,1750824291,1750824305,1750824305.791177,-18000,EB445137-D7F5-57EC-87DA-1DB460D64046,"iPhone13,2"
com.apple.mobiletimer,8,1750824033,1750824041,1750824041.1578112,-18000,EB445137-D7F5-57EC-87DA-1DB460D64046,"iPhone13,2"
com.apple.findmy,18,1750824015,1750824033,1750824033.1802092,-18000,EB445137-D7F5-57EC-87DA-1DB460D64046,"iPhone13,2"
com.apple.CoreAuthUI,3,1750821742,1750821745,1750821745.385707,-18000,EB445137-D7F5-57EC-87DA-1DB460D64046,"iPhone13,2"
com.apple.journal,2265,1750821741,1750824006,1750824006.174224,-18000,EB445137-D7F5-57EC-87DA-1DB460D64046,"iPhone13,2"
com.apple.news,97,1750821640,1750821737,1750821737.6833801,-18000,EB445137-D7F5-57EC-87DA-1DB460D64046,"iPhone13,2"
com.apple.findmy,15,1750821620,1750821635,1750821636.769078,-18000,EB445137-D7F5-57EC-87DA-1DB460D64046,"iPhone13,2"
com.letterboxd.LetterboxdApp,2,1750821618,1750821620,1750821624.30339,-18000,EB445137-D7F5-57EC-87DA-1DB460D64046,"iPhone13,2"
com.google.Chrome,572,1750820480,1750821052,1750821052.4511828,-18000,,
com.apple.iCal,159,1750820321,1750820480,1750820480.084638,-18000,,
com.google.Chrome,9,1750820312,1750820321,1750820321.893417,-18000,,
com.apple.iCal,139,1750820173,1750820312,1750820313.450296,-18000,,
com.apple.finder,9,1750820164,1750820173,1750820173.2956629,-18000,,
com.apple.Photos,98,1750820066,1750820164,1750820164.787463,-18000,,
com.letterboxd.LetterboxdApp,46,1750819972,1750820018,1750820018.433796,-18000,EB445137-D7F5-57EC-87DA-1DB460D64046,"iPhone13,2"
com.apple.weather,1,1750819971,1750819972,1750819972.8747602,-18000,EB445137-D7F5-57EC-87DA-1DB460D64046,"iPhone13,2"
com.apple.weather,7,1750819926,1750819933,1750819933.132432,-18000,EB445137-D7F5-57EC-87DA-1DB460D64046,"iPhone13,2"
com.letterboxd.LetterboxdApp,1,1750819924,1750819925,1750819926.037283,-18000,EB445137-D7F5-57EC-87DA-1DB460D64046,"iPhone13,2"
com.letterboxd.LetterboxdApp,2,1750819911,1750819913,1750819913.3490748,-18000,EB445137-D7F5-57EC-87DA-1DB460D64046,"iPhone13,2"
com.letterboxd.LetterboxdApp,32,1750819799,1750819831,1750819831.91413,-18000,EB445137-D7F5-57EC-87DA-1DB460D64046,"iPhone13,2"
com.apple.Health,31,1750819768,1750819799,1750819799.689739,-18000,EB445137-D7F5-57EC-87DA-1DB460D64046,"iPhone13,2"
com.google.Chrome,335,1750819731,1750820066,1750820066.254992,-18000,,
com.google.Chrome,588,1750819030,1750819618,1750819618.491241,-18000,,
com.google.Chrome,302,1750818703,1750819005,1750819005.2832851,-18000,,
com.apple.Health,50,1750818499,1750818549,1750818549.7444758,-18000,EB445137-D7F5-57EC-87DA-1DB460D64046,"iPhone13,2"
com.letterboxd.LetterboxdApp,2,1750818496,1750818498,1750818499.0306978,-18000,EB445137-D7F5-57EC-87DA-1DB460D64046,"iPhone13,2"
com.google.Chrome,729,1750817152,1750817881,1750817881.386069,-18000,,
com.google.Chrome,308,1750816759,1750817067,1750817067.670917,-18000,,
com.google.Chrome,300,1750816318,1750816618,1750816619.016306,-18000,,
com.google.Chrome,354,1750815739,1750816093,1750816093.974581,-18000,,
com.google.Chrome,608,1750814838,1750815446,1750815446.103561,-18000,,
com.google.Chrome,499,1750813263,1750813762,1750813762.192038,-18000,,
com.google.Chrome,471,1750811985,1750812456,1750812456.3508859,-18000,,
com.apple.finder,1,1750811984,1750811985,1750811987.465723,-18000,,
com.letterboxd.LetterboxdApp,198,1750811961,1750812159,1750812160.333119,-18000,EB445137-D7F5-57EC-87DA-1DB460D64046,"iPhone13,2"
com.apple.news,257,1750811702,1750811959,1750811959.606538,-18000,EB445137-D7F5-57EC-87DA-1DB460D64046,"iPhone13,2"
com.strava.stravaride,5,1750811695,1750811700,1750811700.901091,-18000,EB445137-D7F5-57EC-87DA-1DB460D64046,"iPhone13,2"
com.apple.finder,5,1750811680,1750811685,1750811685.979022,-18000,,
com.apple.Notes,39,1750811641,1750811680,1750811680.1017709,-18000,,
com.apple.finder,4,1750811637,1750811641,1750811641.323762,-18000,,
com.leomehlig.today,7,1750811630,1750811637,1750811637.787839,-18000,,
com.apple.weather,2,1750811606,1750811608,1750811608.353877,-18000,EB445137-D7F5-57EC-87DA-1DB460D64046,"iPhone13,2"
com.apple.finder,30,1750811600,1750811630,1750811630.736469,-18000,,
com.microsoft.VSCode,6,1750811594,1750811600,1750811600.30148,-18000,,
com.apple.Notes,1,1750811593,1750811594,1750811594.902163,-18000,,
com.leomehlig.today,1,1750811592,1750811593,1750811593.469922,-18000,,
com.google.Chrome,51,1750811541,1750811592,1750811593.058553,-18000,,
com.leomehlig.today,5,1750811526,1750811531,1750811531.710713,-18000,,
com.google.Chrome,38,1750811488,1750811526,1750811526.404447,-18000,,
com.apple.Notes,33,1750811455,1750811488,1750811488.38872,-18000,,
com.google.Chrome,74,1750811381,1750811455,1750811455.150614,-18000,,
com.microsoft.VSCode,8,1750811373,1750811381,1750811381.897423,-18000,,
com.google.Chrome,9,1750811364,1750811373,1750811373.300585,-18000,,
com.microsoft.VSCode,1,1750811363,1750811364,1750811364.105969,-18000,,
com.google.Chrome,25,1750811338,1750811363,1750811363.7931871,-18000,,
com.microsoft.VSCode,8,1750811330,1750811338,1750811338.340088,-18000,,
com.google.Chrome,12,1750811318,1750811330,1750811330.4257522,-18000,,
com.microsoft.VSCode,1,1750811317,1750811318,1750811318.948607,-18000,,
com.google.Chrome,4,1750811313,1750811317,1750811317.991883,-18000,,
com.microsoft.VSCode,8,1750811305,1750811313,1750811313.188314,-18000,,
com.google.Chrome,7,1750811298,1750811305,1750811305.9844599,-18000,,
com.apple.finder,6,1750811292,1750811298,1750811298.474232,-18000,,
com.google.Chrome,3,1750811289,1750811292,1750811292.269425,-18000,,
com.apple.finder,3,1750811286,1750811289,1750811289.7754521,-18000,,
com.google.Chrome,56,1750811230,1750811286,1750811286.324198,-18000,,
com.microsoft.VSCode,2,1750811228,1750811230,1750811230.982599,-18000,,
com.google.Chrome,23,1750811205,1750811228,1750811228.73226,-18000,,
com.microsoft.VSCode,5,1750811200,1750811205,1750811205.704344,-18000,,
com.google.Chrome,40,1750811160,1750811200,1750811200.0884051,-18000,,
com.microsoft.VSCode,6,1750811154,1750811160,1750811160.771144,-18000,,
com.google.Chrome,10,1750811144,1750811154,1750811154.309946,-18000,,
com.microsoft.VSCode,2,1750811142,1750811144,1750811144.828089,-18000,,
com.google.Chrome,4,1750811138,1750811142,1750811142.2039208,-18000,,
com.microsoft.VSCode,12,1750811126,1750811138,1750811138.3689032,-18000,,
com.google.Chrome,121,1750811005,1750811126,1750811126.519919,-18000,,
com.apple.finder,3,1750811002,1750811005,1750811005.121167,-18000,,
com.google.Chrome,38,1750810964,1750811002,1750811002.325258,-18000,,
com.apple.finder,11,1750810953,1750810964,1750810964.519587,-18000,,
com.google.Chrome,10,1750810943,1750810953,1750810953.146642,-18000,,
com.apple.finder,4,1750810939,1750810943,1750810943.695998,-18000,,
com.google.Chrome,82,1750810857,1750810939,1750810939.407384,-18000,,
com.apple.finder,6,1750810851,1750810857,1750810857.8575659,-18000,,
com.google.Chrome,7,1750810844,1750810851,1750810851.665555,-18000,,
com.apple.finder,1,1750810843,1750810844,1750810844.6627312,-18000,,
com.google.Chrome,37,1750810806,1750810843,1750810843.413343,-18000,,
com.apple.finder,16,1750810790,1750810806,1750810806.866538,-18000,,
com.google.Chrome,20,1750810770,1750810790,1750810790.210575,-18000,,
com.microsoft.VSCode,7,1750810763,1750810770,1750810770.216011,-18000,,
com.google.Chrome,33,1750810730,1750810763,1750810763.9086199,-18000,,
com.microsoft.VSCode,26,1750810704,1750810730,1750810730.9856339,-18000,,
com.google.Chrome,26,1750810678,1750810704,1750810705.035499,-18000,,
com.apple.Notes,0,1750810678,1750810678,1750810679.066214,-18000,,
com.google.Chrome,47,1750810631,1750810678,1750810678.418254,-18000,,
com.apple.Notes,8,1750810623,1750810631,1750810631.800078,-18000,,
com.google.Chrome,32,1750810591,1750810623,1750810623.4966788,-18000,,
com.apple.Notes,6,1750810585,1750810591,1750810591.2185888,-18000,,
com.google.Chrome,9,1750810576,1750810585,1750810585.6788712,-18000,,
com.apple.Notes,9,1750810567,1750810576,1750810576.456918,-18000,,
com.google.Chrome,7,1750810560,1750810567,1750810567.626668,-18000,,
com.apple.Notes,5,1750810555,1750810560,1750810560.5932941,-18000,,
com.google.Chrome,7,1750810548,1750810555,1750810555.818671,-18000,,
com.apple.Notes,3,1750810545,1750810548,1750810548.231297,-18000,,
com.google.Chrome,9,1750810536,1750810545,1750810545.3220801,-18000,,
com.apple.Notes,27,1750810509,1750810536,1750810536.65246,-18000,,
com.google.Chrome,16,1750810493,1750810509,1750810509.112488,-18000,,
com.apple.finder,1,1750810492,1750810493,1750810493.05165,-18000,,
com.google.Chrome,2,1750810490,1750810492,1750810492.4100199,-18000,,
com.apple.finder,3,1750810487,1750810490,1750810490.5791779,-18000,,
com.google.Chrome,106,1750810381,1750810487,1750810487.409744,-18000,,
com.apple.finder,1,1750810380,1750810381,1750810381.924183,-18000,,
com.google.Chrome,17,1750810363,1750810380,1750810380.064604,-18000,,
com.apple.finder,9,1750810354,1750810363,1750810363.5639992,-18000,,
com.microsoft.VSCode,1,1750810353,1750810354,1750810354.505653,-18000,,
com.google.Chrome,3,1750810350,1750810353,1750810353.501528,-18000,,
com.microsoft.VSCode,1,1750810349,1750810350,1750810350.6126409,-18000,,
com.google.Chrome,39,1750810310,1750810349,1750810349.794162,-18000,,
com.microsoft.VSCode,5,1750810305,1750810310,1750810310.168116,-18000,,
com.google.Chrome,1,1750810304,1750810305,1750810305.412685,-18000,,
com.microsoft.VSCode,2,1750810302,1750810304,1750810304.4045382,-18000,,
com.apple.finder,1,1750810301,1750810302,1750810302.558913,-18000,,
com.google.Chrome,65,1750810236,1750810301,1750810301.164897,-18000,,
com.apple.finder,6,1750810230,1750810236,1750810236.145012,-18000,,
com.google.Chrome,73,1750810157,1750810230,1750810230.5930119,-18000,,
com.apple.finder,1,1750810156,1750810157,1750810157.242022,-18000,,
com.google.Chrome,4,1750810152,1750810156,1750810156.797601,-18000,,
com.apple.finder,1,1750810151,1750810152,1750810152.900903,-18000,,
com.google.Chrome,2,1750810149,1750810151,1750810152.030535,-18000,,
com.apple.finder,13,1750810136,1750810149,1750810149.1617641,-18000,,
com.google.Chrome,46,1750810090,1750810136,1750810136.3466702,-18000,,
com.apple.finder,1,1750810089,1750810090,1750810090.469479,-18000,,
com.google.Chrome,25,1750810064,1750810089,1750810089.2662601,-18000,,
com.apple.finder,2,1750810062,1750810064,1750810064.367053,-18000,,
com.google.Chrome,3,1750810059,1750810062,1750810062.35913,-18000,,
com.apple.finder,5,1750810054,1750810059,1750810059.209919,-18000,,
com.google.Chrome,2,1750810052,1750810054,1750810054.2877722,-18000,,
com.apple.finder,2,1750810050,1750810052,1750810052.3498569,-18000,,
com.google.Chrome,4,1750810046,1750810050,1750810050.550578,-18000,,
com.apple.finder,15,1750810031,1750810046,1750810046.305317,-18000,,
com.apple.weather,54,1750809948,1750810002,1750810002.108022,-18000,EB445137-D7F5-57EC-87DA-1DB460D64046,"iPhone13,2"
com.google.Chrome,90,1750809941,1750810031,1750810031.710332,-18000,,
com.leomehlig.today,133,1750809808,1750809941,1750809941.820317,-18000,,
com.google.Chrome,45,1750809763,1750809808,1750809808.775527,-18000,,
com.microsoft.VSCode,3,1750809760,1750809763,1750809763.809727,-18000,,
com.google.Chrome,62,1750809698,1750809760,1750809760.215059,-18000,,
com.apple.finder,4,1750809694,1750809698,1750809698.3010612,-18000,,
com.google.Chrome,10,1750809684,1750809694,1750809694.5634851,-18000,,
com.apple.finder,1,1750809683,1750809684,1750809684.272397,-18000,,
com.google.Chrome,2,1750809681,1750809683,1750809683.191716,-18000,,
com.apple.finder,1,1750809680,1750809681,1750809681.42801,-18000,,
com.google.Chrome,13,1750809667,1750809680,1750809680.5484571,-18000,,
com.apple.finder,3,1750809664,1750809667,1750809667.993486,-18000,,
com.google.Chrome,21,1750809643,1750809664,1750809664.572609,-18000,,
com.apple.finder,2,1750809641,1750809643,1750809643.39677,-18000,,
com.google.Chrome,43,1750809598,1750809641,1750809641.894785,-18000,,
com.apple.finder,7,1750809591,1750809598,1750809598.7265558,-18000,,
com.google.Chrome,20,1750809571,1750809591,1750809591.576561,-18000,,
com.apple.finder,11,1750809560,1750809571,1750809571.857912,-18000,,
com.google.Chrome,27,1750809533,1750809560,1750809560.428067,-18000,,
com.apple.finder,4,1750809529,1750809533,1750809533.990545,-18000,,
com.google.Chrome,22,1750809507,1750809529,1750809529.641073,-18000,,
com.apple.finder,9,1750809498,1750809507,1750809507.850596,-18000,,
com.google.Chrome,26,1750809472,1750809498,1750809498.5461612,-18000,,
com.apple.finder,1,1750809471,1750809472,1750809472.686672,-18000,,
com.google.Chrome,1,1750809470,1750809471,1750809471.836127,-18000,,
com.apple.finder,1,1750809469,1750809470,1750809471.0003638,-18000,,
com.google.Chrome,1,1750809468,1750809469,1750809469.886989,-18000,,
com.apple.finder,15,1750809453,1750809468,1750809468.868206,-18000,,
com.google.Chrome,42,1750809411,1750809453,1750809453.561379,-18000,,
com.microsoft.VSCode,16,1750809395,1750809411,1750809411.365659,-18000,,
com.google.Chrome,29,1750809366,1750809395,1750809395.567037,-18000,,
com.apple.Notes,4,1750809362,1750809366,1750809366.104855,-18000,,
com.google.Chrome,1,1750809361,1750809362,1750809362.212733,-18000,,
com.apple.Notes,27,1750809334,1750809361,1750809361.288591,-18000,,
com.google.Chrome,38,1750809296,1750809334,1750809334.909821,-18000,,
com.apple.finder,2,1750809294,1750809296,1750809296.690857,-18000,,
com.google.Chrome,24,1750809270,1750809294,1750809294.3551931,-18000,,
com.apple.finder,1,1750809269,1750809270,1750809270.8410501,-18000,,
com.google.Chrome,19,1750809250,1750809269,1750809269.434479,-18000,,
com.apple.finder,2,1750809248,1750809250,1750809251.0352821,-18000,,
com.google.Chrome,117,1750809131,1750809248,1750809248.168929,-18000,,
com.apple.finder,2,1750809129,1750809131,1750809131.299793,-18000,,
com.google.Chrome,15,1750809114,1750809129,1750809129.529479,-18000,,
com.apple.finder,3,1750809111,1750809114,1750809114.192699,-18000,,
com.google.Chrome,7,1750809104,1750809111,1750809111.682514,-18000,,
com.apple.finder,2,1750809102,1750809104,1750809104.386712,-18000,,
com.google.Chrome,2,1750809100,1750809102,1750809102.5737162,-18000,,
com.apple.finder,2,1750809098,1750809100,1750809100.7519321,-18000,,
com.google.Chrome,4,1750809094,1750809098,1750809098.808669,-18000,,
com.apple.finder,4,1750809090,1750809094,1750809094.173421,-18000,,
com.google.Chrome,12,1750809078,1750809090,1750809090.822608,-18000,,
com.apple.finder,1,1750809077,1750809078,1750809078.174959,-18000,,
com.google.Chrome,10,1750809067,1750809077,1750809077.055748,-18000,,
com.apple.finder,2,1750809065,1750809067,1750809067.55708,-18000,,
com.google.Chrome,6,1750809059,1750809065,1750809065.682729,-18000,,
com.apple.finder,2,1750809057,1750809059,1750809059.8010569,-18000,,
com.google.Chrome,6,1750809051,1750809057,1750809057.288218,-18000,,
com.apple.finder,30,1750809021,1750809051,1750809051.919602,-18000,,
com.google.Chrome,31,1750808990,1750809021,1750809021.614437,-18000,,
com.microsoft.VSCode,3,1750808987,1750808990,1750808990.89085,-18000,,
com.google.Chrome,7,1750808980,1750808987,1750808987.752166,-18000,,
com.microsoft.VSCode,39,1750808941,1750808980,1750808980.611865,-18000,,
com.google.Chrome,46,1750808895,1750808941,1750808941.7656798,-18000,,
com.apple.Notes,27,1750808868,1750808895,1750808895.487753,-18000,,
com.google.Chrome,60,1750808808,1750808868,1750808868.0859241,-18000,,
com.microsoft.VSCode,59,1750808749,1750808808,1750808809.0660691,-18000,,
com.google.Chrome,7,1750808742,1750808749,1750808749.0714931,-18000,,
com.apple.Notes,12,1750808730,1750808742,1750808742.3271642,-18000,,
com.apple.weather,1,1750808461,1750808462,1750808462.76159,-18000,EB445137-D7F5-57EC-87DA-1DB460D64046,"iPhone13,2"
com.strava.stravaride,82,1750808379,1750808461,1750808461.654142,-18000,EB445137-D7F5-57EC-87DA-1DB460D64046,"iPhone13,2"
com.google.Chrome,658,1750808072,1750808730,1750808730.527694,-18000,,
com.apple.finder,14,1750808058,1750808072,1750808072.473,-18000,,
com.google.Chrome,14,1750808044,1750808058,1750808058.594729,-18000,,
com.microsoft.VSCode,23,1750808021,1750808044,1750808044.622674,-18000,,
com.google.Chrome,134,1750807887,1750808021,1750808021.26122,-18000,,
com.microsoft.VSCode,10,1750807877,1750807887,1750807887.788927,-18000,,
com.google.Chrome,286,1750807591,1750807877,1750807877.5420299,-18000,,
com.microsoft.VSCode,64,1750807527,1750807591,1750807591.933775,-18000,,
com.microsoft.VSCode,322,1750806427,1750806749,1750806749.3874059,-18000,,
com.google.Chrome,2,1750806425,1750806427,1750806427.251764,-18000,,
com.microsoft.VSCode,3,1750806422,1750806425,1750806425.914537,-18000,,
com.google.Chrome,8,1750806414,1750806422,1750806422.534562,-18000,,
com.microsoft.VSCode,8,1750806406,1750806414,1750806414.493159,-18000,,
com.google.Chrome,3,1750806403,1750806406,1750806406.6032372,-18000,,
com.microsoft.VSCode,4,1750806399,1750806403,1750806403.872459,-18000,,
com.google.Chrome,10,1750806389,1750806399,1750806399.857696,-18000,,
com.microsoft.VSCode,247,1750806142,1750806389,1750806389.436666,-18000,,
com.google.Chrome,35,1750806107,1750806142,1750806142.174242,-18000,,
com.microsoft.VSCode,2,1750806105,1750806107,1750806107.156393,-18000,,
com.google.Chrome,65,1750806040,1750806105,1750806105.940141,-18000,,
com.microsoft.VSCode,7,1750806033,1750806040,1750806040.539349,-18000,,
com.google.Chrome,81,1750805952,1750806033,1750806033.46105,-18000,,
com.microsoft.VSCode,56,1750805896,1750805952,1750805952.0846539,-18000,,
com.google.Chrome,47,1750805849,1750805896,1750805896.3890228,-18000,,
com.microsoft.VSCode,3,1750805846,1750805849,1750805849.045757,-18000,,
com.google.Chrome,55,1750805791,1750805846,1750805846.448986,-18000,,
com.microsoft.VSCode,2,1750805789,1750805791,1750805791.473212,-18000,,
com.google.Chrome,83,1750805706,1750805789,1750805789.914717,-18000,,
com.microsoft.VSCode,71,1750805635,1750805706,1750805706.399199,-18000,,
com.google.Chrome,92,1750805543,1750805635,1750805635.2427921,-18000,,
com.microsoft.VSCode,1,1750805542,1750805543,1750805543.462179,-18000,,
com.google.Chrome,30,1750805512,1750805542,1750805542.948573,-18000,,
com.microsoft.VSCode,1,1750805511,1750805512,1750805512.586894,-18000,,
com.google.Chrome,61,1750805450,1750805511,1750805511.2491999,-18000,,
com.microsoft.VSCode,1,1750805449,1750805450,1750805450.351017,-18000,,
com.google.Chrome,65,1750805384,1750805449,1750805449.585832,-18000,,
com.microsoft.VSCode,27,1750805357,1750805384,1750805384.876344,-18000,,
com.google.Chrome,3,1750805354,1750805357,1750805357.557204,-18000,,
com.microsoft.VSCode,7,1750805347,1750805354,1750805354.74341,-18000,,
com.google.Chrome,60,1750805287,1750805347,1750805347.28154,-18000,,
com.microsoft.VSCode,2,1750805285,1750805287,1750805287.371094,-18000,,
com.google.Chrome,38,1750805247,1750805285,1750805285.583426,-18000,,
com.microsoft.VSCode,1,1750805246,1750805247,1750805247.9375792,-18000,,
com.google.Chrome,16,1750805230,1750805246,1750805246.8268461,-18000,,
com.microsoft.VSCode,3,1750805227,1750805230,1750805230.2010012,-18000,,
com.google.Chrome,23,1750805204,1750805227,1750805227.588413,-18000,,
com.microsoft.VSCode,1,1750805203,1750805204,1750805205.013169,-18000,,
com.google.Chrome,92,1750805111,1750805203,1750805203.847508,-18000,,
com.microsoft.VSCode,184,1750804927,1750805111,1750805111.304179,-18000,,
com.google.Chrome,275,1750804652,1750804927,1750804927.710726,-18000,,
com.microsoft.VSCode,67,1750804585,1750804652,1750804652.776534,-18000,,
com.apple.finder,3,1750804582,1750804585,1750804585.888202,-18000,,
com.apple.Preview,15,1750804567,1750804582,1750804582.11126,-18000,,
com.apple.finder,3,1750804564,1750804567,1750804567.137969,-18000,,
com.apple.Preview,6,1750804558,1750804564,1750804564.4848409,-18000,,
com.apple.finder,0,1750804558,1750804558,1750804559.04075,-18000,,
com.apple.Preview,5,1750804553,1750804558,1750804558.8059711,-18000,,
com.apple.finder,13,1750804540,1750804553,1750804553.1832929,-18000,,
com.microsoft.VSCode,2,1750804538,1750804540,1750804540.4559112,-18000,,
com.apple.finder,3,1750804535,1750804538,1750804538.480579,-18000,,
com.microsoft.VSCode,11,1750804524,1750804535,1750804535.1337209,-18000,,
com.google.Chrome,7,1750804517,1750804524,1750804524.439254,-18000,,
com.microsoft.VSCode,1,1750804516,1750804517,1750804517.7961102,-18000,,
com.google.Chrome,57,1750804459,1750804516,1750804516.452023,-18000,,
com.microsoft.VSCode,0,1750804459,1750804459,1750804460.0108151,-18000,,
com.google.Chrome,106,1750804353,1750804459,1750804459.263967,-18000,,
com.microsoft.VSCode,134,1750804219,1750804353,1750804353.455888,-18000,,
com.google.Chrome,38,1750804181,1750804219,1750804220.0156732,-18000,,
com.microsoft.VSCode,7,1750804174,1750804181,1750804181.20699,-18000,,
com.google.Chrome,34,1750804140,1750804174,1750804174.956681,-18000,,
com.microsoft.VSCode,1,1750804139,1750804140,1750804141.01925,-18000,,
com.google.Chrome,64,1750804075,1750804139,1750804139.447713,-18000,,
com.apple.news,166,1750803866,1750804032,1750804032.7465,-18000,EB445137-D7F5-57EC-87DA-1DB460D64046,"iPhone13,2"
com.microsoft.VSCode,1276,1750802799,1750804075,1750804075.8954968,-18000,,
com.apple.finder,3,1750802796,1750802799,1750802799.036407,-18000,,
com.leomehlig.today,8,1750802788,1750802796,1750802796.811389,-18000,,
com.apple.finder,1,1750802787,1750802788,1750802788.4195251,-18000,,
com.leomehlig.today,264,1750802523,1750802787,1750802787.27326,-18000,,
com.apple.Passwords,1,1750802522,1750802523,1750802523.90454,-18000,,
com.apple.iCal,7,1750802515,1750802522,1750802522.258368,-18000,,
com.apple.keychainaccess,1,1750802514,1750802515,1750802515.9730392,-18000,,
com.google.Chrome,66,1750802448,1750802514,1750802514.161977,-18000,,
com.google.Chrome,728,1750801673,1750802401,1750802401.58358,-18000,,
com.google.Chrome,108,1750801383,1750801491,1750801491.211664,-18000,,
com.apple.keychainaccess,3,1750801380,1750801383,1750801383.952591,-18000,,
com.google.Chrome,2,1750801378,1750801380,1750801380.537222,-18000,,
com.apple.keychainaccess,2,1750801376,1750801378,1750801378.832294,-18000,,
com.google.Chrome,46,1750801318,1750801364,1750801364.255701,-18000,,
com.apple.iCal,4,1750801314,1750801318,1750801318.73802,-18000,,
com.google.Chrome,54,1750801260,1750801314,1750801314.464047,-18000,,
com.apple.Passwords,3,1750801257,1750801260,1750801260.487455,-18000,,
com.google.Chrome,10,1750801247,1750801257,1750801257.919211,-18000,,
com.apple.Passwords,21,1750801226,1750801247,1750801247.22082,-18000,,
com.google.Chrome,230,1750800996,1750801226,1750801226.399544,-18000,,
com.leomehlig.today,2,1750800994,1750800996,1750800997.548157,-18000,,
com.apple.MobileSMS,105,1750800772,1750800877,1750800878.364501,-18000,EB445137-D7F5-57EC-87DA-1DB460D64046,"iPhone13,2"
com.apple.MobileSMS,103,1750800621,1750800724,1750800724.217238,-18000,EB445137-D7F5-57EC-87DA-1DB460D64046,"iPhone13,2"
com.apple.MobileSMS,21,1750799917,1750799938,1750799938.6786199,-18000,EB445137-D7F5-57EC-87DA-1DB460D64046,"iPhone13,2"
com.apple.findmy,1,1750799916,1750799917,1750799917.92116,-18000,EB445137-D7F5-57EC-87DA-1DB460D64046,"iPhone13,2"
com.apple.findmy,6,1750799682,1750799688,1750799689.317418,-18000,EB445137-D7F5-57EC-87DA-1DB460D64046,"iPhone13,2"
com.google.chrome.ios,1,1750799681,1750799682,1750799682.955508,-18000,EB445137-D7F5-57EC-87DA-1DB460D64046,"iPhone13,2"
com.google.chrome.ios,26,1750799486,1750799512,1750799512.2923589,-18000,EB445137-D7F5-57EC-87DA-1DB460D64046,"iPhone13,2"
com.apple.findmy,2,1750799484,1750799486,1750799487.177628,-18000,EB445137-D7F5-57EC-87DA-1DB460D64046,"iPhone13,2"
com.apple.findmy,16,1750799234,1750799250,1750799251.1542978,-18000,EB445137-D7F5-57EC-87DA-1DB460D64046,"iPhone13,2"
com.apple.findmy,36,1750798491,1750798527,1750798527.740615,-18000,EB445137-D7F5-57EC-87DA-1DB460D64046,"iPhone13,2"
com.strava.stravaride,24,1750797948,1750797972,1750797973.017339,-18000,EB445137-D7F5-57EC-87DA-1DB460D64046,"iPhone13,2"
com.clairmail.fth.client,1,1750797947,1750797948,1750797948.673567,-18000,EB445137-D7F5-57EC-87DA-1DB460D64046,"iPhone13,2"
com.apple.CoreAuthUI,4,1750797453,1750797457,1750797457.108191,-18000,EB445137-D7F5-57EC-87DA-1DB460D64046,"iPhone13,2"
com.clairmail.fth.client,24,1750797446,1750797470,1750797470.399627,-18000,EB445137-D7F5-57EC-87DA-1DB460D64046,"iPhone13,2"
com.apple.podcasts,1,1750797442,1750797443,1750797444.550014,-18000,EB445137-D7F5-57EC-87DA-1DB460D64046,"iPhone13,2"
com.apple.podcasts,10,1750796612,1750796622,1750796623.1179461,-18000,EB445137-D7F5-57EC-87DA-1DB460D64046,"iPhone13,2"
com.apple.podcasts,13,1750794435,1750794448,1750794449.155554,-18000,EB445137-D7F5-57EC-87DA-1DB460D64046,"iPhone13,2"
com.apple.podcasts,33,1750792166,1750792199,1750792200.175486,-18000,EB445137-D7F5-57EC-87DA-1DB460D64046,"iPhone13,2"
com.doordash.dasher,30,1750788996,1750789026,1750789026.17175,-18000,EB445137-D7F5-57EC-87DA-1DB460D64046,"iPhone13,2"
com.apple.news,125,1750788868,1750788993,1750788993.975013,-18000,EB445137-D7F5-57EC-87DA-1DB460D64046,"iPhone13,2"
com.doordash.dasher,6,1750788862,1750788868,1750788868.6309872,-18000,EB445137-D7F5-57EC-87DA-1DB460D64046,"iPhone13,2"
com.apple.news,161,1750788701,1750788862,1750788862.695359,-18000,EB445137-D7F5-57EC-87DA-1DB460D64046,"iPhone13,2"
com.doordash.dasher,3,1750788682,1750788685,1750788685.4204159,-18000,EB445137-D7F5-57EC-87DA-1DB460D64046,"iPhone13,2"
com.apple.MobileSMS,6,1750788668,1750788674,1750788674.1376228,-18000,EB445137-D7F5-57EC-87DA-1DB460D64046,"iPhone13,2"
com.apple.findmy,21,1750788612,1750788633,1750788633.671204,-18000,EB445137-D7F5-57EC-87DA-1DB460D64046,"iPhone13,2"
com.doordash.dasher,14,1750788598,1750788612,1750788612.52268,-18000,EB445137-D7F5-57EC-87DA-1DB460D64046,"iPhone13,2"
com.apple.MobileSMS,20,1750788578,1750788598,1750788598.557656,-18000,EB445137-D7F5-57EC-87DA-1DB460D64046,"iPhone13,2"
com.apple.MobileSMS,40,1750788531,1750788571,1750788571.840231,-18000,EB445137-D7F5-57EC-87DA-1DB460D64046,"iPhone13,2"
com.doordash.dasher,49,1750788463,1750788512,1750788512.129144,-18000,EB445137-D7F5-57EC-87DA-1DB460D64046,"iPhone13,2"
com.apple.weather,43,1750788416,1750788459,1750788459.721916,-18000,EB445137-D7F5-57EC-87DA-1DB460D64046,"iPhone13,2"
com.apple.news,172,1750788243,1750788415,1750788415.286042,-18000,EB445137-D7F5-57EC-87DA-1DB460D64046,"iPhone13,2"
com.apple.MobileSMS,22,1750788220,1750788242,1750788242.159258,-18000,EB445137-D7F5-57EC-87DA-1DB460D64046,"iPhone13,2"
com.apple.CoreAuthUI,2,1750788040,1750788042,1750788043.011046,-18000,EB445137-D7F5-57EC-87DA-1DB460D64046,"iPhone13,2"
com.truebill.truebillnative,185,1750788035,1750788220,1750788220.861596,-18000,EB445137-D7F5-57EC-87DA-1DB460D64046,"iPhone13,2"
com.apple.weather,26,1750788001,1750788027,1750788027.822614,-18000,EB445137-D7F5-57EC-87DA-1DB460D64046,"iPhone13,2"
com.apple.MobileSMS,3,1750787992,1750787995,1750787995.154748,-18000,EB445137-D7F5-57EC-87DA-1DB460D64046,"iPhone13,2"
com.doordash.dasher,68,1750787922,1750787990,1750787990.177716,-18000,EB445137-D7F5-57EC-87DA-1DB460D64046,"iPhone13,2"
com.doordash.dasher,989,1750786719,1750787708,1750787708.867763,-18000,EB445137-D7F5-57EC-87DA-1DB460D64046,"iPhone13,2"
com.apple.weather,16,1750786703,1750786719,1750786719.16797,-18000,EB445137-D7F5-57EC-87DA-1DB460D64046,"iPhone13,2"
com.doordash.dasher,635,1750786068,1750786703,1750786704.194763,-18000,EB445137-D7F5-57EC-87DA-1DB460D64046,"iPhone13,2"
com.doordash.dasher,1714,1750784228,1750785942,1750785943.006197,-18000,EB445137-D7F5-57EC-87DA-1DB460D64046,"iPhone13,2"
com.apple.news,8,1750784220,1750784228,1750784228.435941,-18000,EB445137-D7F5-57EC-87DA-1DB460D64046,"iPhone13,2"
com.strava.stravaride,64,1750784154,1750784218,1750784218.7750401,-18000,EB445137-D7F5-57EC-87DA-1DB460D64046,"iPhone13,2"
com.doordash.dasher,156,1750783997,1750784153,1750784153.77179,-18000,EB445137-D7F5-57EC-87DA-1DB460D64046,"iPhone13,2"
com.doordash.dasher,15,1750783980,1750783995,1750783995.2275372,-18000,EB445137-D7F5-57EC-87DA-1DB460D64046,"iPhone13,2"
com.apple.MobileSMS,196,1750783784,1750783980,1750783980.739717,-18000,EB445137-D7F5-57EC-87DA-1DB460D64046,"iPhone13,2"
com.doordash.dasher,55,1750783729,1750783784,1750783784.179967,-18000,EB445137-D7F5-57EC-87DA-1DB460D64046,"iPhone13,2"
com.apple.MobileSMS,46,1750783683,1750783729,1750783729.6886868,-18000,EB445137-D7F5-57EC-87DA-1DB460D64046,"iPhone13,2"
com.doordash.dasher,187,1750783496,1750783683,1750783683.9028401,-18000,EB445137-D7F5-57EC-87DA-1DB460D64046,"iPhone13,2"
com.apple.MobileSMS,77,1750783419,1750783496,1750783496.751882,-18000,EB445137-D7F5-57EC-87DA-1DB460D64046,"iPhone13,2"
com.doordash.dasher,341,1750783078,1750783419,1750783419.9833488,-18000,EB445137-D7F5-57EC-87DA-1DB460D64046,"iPhone13,2"
com.doordash.dasher,1018,1750782042,1750783060,1750783060.812995,-18000,EB445137-D7F5-57EC-87DA-1DB460D64046,"iPhone13,2"
com.apple.weather,37,1750782005,1750782042,1750782042.181532,-18000,EB445137-D7F5-57EC-87DA-1DB460D64046,"iPhone13,2"
com.apple.news,21,1750781977,1750781998,1750781999.055026,-18000,EB445137-D7F5-57EC-87DA-1DB460D64046,"iPhone13,2"
com.doordash.dasher,393,1750781523,1750781916,1750781916.1309109,-18000,EB445137-D7F5-57EC-87DA-1DB460D64046,"iPhone13,2"
com.doordash.dasher,14,1750781343,1750781357,1750781358.004674,-18000,EB445137-D7F5-57EC-87DA-1DB460D64046,"iPhone13,2"
com.doordash.dasher,62,1750781076,1750781138,1750781138.374418,-18000,EB445137-D7F5-57EC-87DA-1DB460D64046,"iPhone13,2"
com.apple.MobileSMS,5,1750779907,1750779912,1750779912.0578861,-18000,EB445137-D7F5-57EC-87DA-1DB460D64046,"iPhone13,2"
com.doordash.dasher,17,1750779880,1750779897,1750779897.514964,-18000,EB445137-D7F5-57EC-87DA-1DB460D64046,"iPhone13,2"
com.apple.news,149,1750777115,1750777264,1750777264.493861,-18000,EB445137-D7F5-57EC-87DA-1DB460D64046,"iPhone13,2"
com.doordash.dasher,13,1750776734,1750776747,1750776747.350745,-18000,EB445137-D7F5-57EC-87DA-1DB460D64046,"iPhone13,2"
com.apple.news,283,1750776432,1750776715,1750776715.380225,-18000,EB445137-D7F5-57EC-87DA-1DB460D64046,"iPhone13,2"
com.apple.MobileSMS,3,1750776424,1750776427,1750776427.481674,-18000,EB445137-D7F5-57EC-87DA-1DB460D64046,"iPhone13,2"
com.apple.MobileSMS,33,1750776382,1750776415,1750776415.054521,-18000,EB445137-D7F5-57EC-87DA-1DB460D64046,"iPhone13,2"
com.strava.stravaride,8,1750776356,1750776364,1750776364.414216,-18000,EB445137-D7F5-57EC-87DA-1DB460D64046,"iPhone13,2"
com.strava.stravaride,2,1750776348,1750776350,1750776350.5297198,-18000,EB445137-D7F5-57EC-87DA-1DB460D64046,"iPhone13,2"
com.strava.stravaride,185,1750775701,1750775886,1750775886.162208,-18000,EB445137-D7F5-57EC-87DA-1DB460D64046,"iPhone13,2"
com.apple.weather,2,1750775689,1750775691,1750775691.534152,-18000,EB445137-D7F5-57EC-87DA-1DB460D64046,"iPhone13,2"
com.apple.weather,13,1750775103,1750775116,1750775116.6578832,-18000,EB445137-D7F5-57EC-87DA-1DB460D64046,"iPhone13,2"
com.letterboxd.LetterboxdApp,38,1750774847,1750774885,1750774885.423537,-18000,EB445137-D7F5-57EC-87DA-1DB460D64046,"iPhone13,2"
com.apple.news,941,1750772744,1750773685,1750773685.120967,-18000,EB445137-D7F5-57EC-87DA-1DB460D64046,"iPhone13,2"
com.apple.Health,113,1750772611,1750772724,1750772724.726458,-18000,EB445137-D7F5-57EC-87DA-1DB460D64046,"iPhone13,2"
com.apple.weather,69,1750772540,1750772609,1750772609.228136,-18000,EB445137-D7F5-57EC-87DA-1DB460D64046,"iPhone13,2"
com.apple.weather,42,1750772472,1750772514,1750772514.9424539,-18000,EB445137-D7F5-57EC-87DA-1DB460D64046,"iPhone13,2"
com.renpho.health,2,1750772453,1750772455,1750772455.0963821,-18000,EB445137-D7F5-57EC-87DA-1DB460D64046,"iPhone13,2"
com.renpho.health,46,1750772400,1750772446,1750772446.124428,-18000,EB445137-D7F5-57EC-87DA-1DB460D64046,"iPhone13,2"
com.apple.news,13,1750771367,1750771380,1750771380.317688,-18000,EB445137-D7F5-57EC-87DA-1DB460D64046,"iPhone13,2"
com.apple.news,98,1750770437,1750770535,1750770535.835242,-18000,EB445137-D7F5-57EC-87DA-1DB460D64046,"iPhone13,2"
com.tier9digital.sundial,2,1750770429,1750770431,1750770431.806509,-18000,EB445137-D7F5-57EC-87DA-1DB460D64046,"iPhone13,2"
com.apple.Health,46,1750738217,1750738263,1750738263.208889,-18000,EB445137-D7F5-57EC-87DA-1DB460D64046,"iPhone13,2"
com.leomehlig.today,297,1750737843,1750738140,1750738140.322398,-18000,,
com.apple.finder,106,1750737737,1750737843,1750737843.533822,-18000,,
com.google.Chrome,213,1750737524,1750737737,1750737737.663608,-18000,,
com.apple.Preview,253,1750737119,1750737372,1750737372.448709,-18000,,
com.apple.finder,8,1750737111,1750737119,1750737119.430856,-18000,,
com.google.Chrome,2,1750737109,1750737111,1750737111.40805,-18000,,
com.apple.finder,2,1750737107,1750737109,1750737109.717183,-18000,,
com.google.Chrome,2,1750737105,1750737107,1750737107.574322,-18000,,
com.apple.finder,5,1750737100,1750737105,1750737106.0143762,-18000,,
com.google.Chrome,216,1750736884,1750737100,1750737100.17372,-18000,,
com.apple.finder,13,1750736871,1750736884,1750736884.729949,-18000,,
com.google.Chrome,26,1750736845,1750736871,1750736871.464322,-18000,,
com.apple.MobileSMS,99,1750736746,1750736845,1750736845.549047,-18000,,
com.google.Chrome,215,1750736531,1750736746,1750736746.095875,-18000,,
com.apple.MobileSMS,5,1750736526,1750736531,1750736532.071795,-18000,,
com.google.Chrome,5,1750736521,1750736526,1750736526.51282,-18000,,
com.google.Chrome,878,1750735481,1750736359,1750736359.545373,-18000,,
com.apple.weather,5,1750734862,1750734867,1750734867.9560509,-18000,EB445137-D7F5-57EC-87DA-1DB460D64046,"iPhone13,2"
com.apple.weather,24,1750734826,1750734850,1750734850.468426,-18000,EB445137-D7F5-57EC-87DA-1DB460D64046,"iPhone13,2"
com.apple.news,115,1750734710,1750734825,1750734825.695016,-18000,EB445137-D7F5-57EC-87DA-1DB460D64046,"iPhone13,2"
com.apple.MobileSMS,2,1750734704,1750734706,1750734706.966563,-18000,EB445137-D7F5-57EC-87DA-1DB460D64046,"iPhone13,2"
com.apple.findmy,0,1750734704,1750734704,1750734705.713385,-18000,EB445137-D7F5-57EC-87DA-1DB460D64046,"iPhone13,2"
com.google.Chrome,249,1750734603,1750734852,1750734852.4815269,-18000,,
com.google.Chrome,302,1750733816,1750734118,1750734118.5339398,-18000,,
com.google.Chrome,336,1750733235,1750733571,1750733571.426035,-18000,,
com.google.Chrome,502,1750732230,1750732732,1750732732.3754148,-18000,,
com.google.Chrome,383,1750731592,1750731975,1750731976.014412,-18000,,
com.google.Chrome,437,1750731085,1750731522,1750731522.298235,-18000,,
com.google.Chrome,331,1750730469,1750730800,1750730800.660417,-18000,,
com.apple.findmy,6,1750730445,1750730451,1750730451.7689772,-18000,EB445137-D7F5-57EC-87DA-1DB460D64046,"iPhone13,2"
com.apple.news,6,1750730438,1750730444,1750730444.671949,-18000,EB445137-D7F5-57EC-87DA-1DB460D64046,"iPhone13,2"
com.google.Chrome,304,1750729963,1750730267,1750730267.215479,-18000,,
com.apple.news,16,1750729478,1750729494,1750729494.972207,-18000,EB445137-D7F5-57EC-87DA-1DB460D64046,"iPhone13,2"
com.google.Chrome,419,1750729177,1750729596,1750729596.820284,-18000,,
com.google.Chrome,315,1750728843,1750729158,1750729158.940102,-18000,,
com.google.Chrome,303,1750728217,1750728520,1750728520.799341,-18000,,
com.google.Chrome,682,1750727143,1750727825,1750727825.7679238,-18000,,
com.google.Chrome,310,1750726817,1750727127,1750727127.575572,-18000,,
com.google.Chrome,508,1750726297,1750726805,1750726805.160991,-18000,,
com.facebook.Facebook,320,1750725194,1750725514,1750725514.1567159,-18000,EB445137-D7F5-57EC-87DA-1DB460D64046,"iPhone13,2"
com.google.Chrome,1046,1750725158,1750726204,1750726204.362015,-18000,,
com.apple.MobileSMS,7,1750724936,1750724943,1750724943.93081,-18000,EB445137-D7F5-57EC-87DA-1DB460D64046,"iPhone13,2"
com.apple.weather,10,1750724926,1750724936,1750724936.430859,-18000,EB445137-D7F5-57EC-87DA-1DB460D64046,"iPhone13,2"
com.apple.MobileSMS,48,1750724878,1750724926,1750724926.626812,-18000,EB445137-D7F5-57EC-87DA-1DB460D64046,"iPhone13,2"
com.apple.weather,34,1750724844,1750724878,1750724878.804738,-18000,EB445137-D7F5-57EC-87DA-1DB460D64046,"iPhone13,2"
com.apple.findmy,4,1750724840,1750724844,1750724846.7117329,-18000,EB445137-D7F5-57EC-87DA-1DB460D64046,"iPhone13,2"
com.letterboxd.LetterboxdApp,2,1750724838,1750724840,1750724840.710719,-18000,EB445137-D7F5-57EC-87DA-1DB460D64046,"iPhone13,2"
com.letterboxd.LetterboxdApp,23,1750724814,1750724837,1750724837.8695521,-18000,EB445137-D7F5-57EC-87DA-1DB460D64046,"iPhone13,2"
com.letterboxd.LetterboxdApp,126,1750724676,1750724802,1750724803.091171,-18000,EB445137-D7F5-57EC-87DA-1DB460D64046,"iPhone13,2"
com.google.Chrome,194,1750724642,1750724836,1750724836.108869,-18000,,
com.letterboxd.LetterboxdApp,172,1750724449,1750724621,1750724621.859189,-18000,EB445137-D7F5-57EC-87DA-1DB460D64046,"iPhone13,2"
com.apple.news,14,1750724405,1750724419,1750724420.0849829,-18000,EB445137-D7F5-57EC-87DA-1DB460D64046,"iPhone13,2"
com.microsoft.VSCode,1192,1750723095,1750724287,1750724288.590835,-18000,,
com.google.Chrome,1,1750723094,1750723095,1750723095.533584,-18000,,
com.microsoft.VSCode,538,1750722556,1750723094,1750723094.632551,-18000,,
com.google.Chrome,8,1750722548,1750722556,1750722556.94936,-18000,,
com.microsoft.VSCode,37,1750722511,1750722548,1750722548.212683,-18000,,
com.apple.news,10,1750722501,1750722511,1750722511.109348,-18000,,
com.microsoft.VSCode,238,1750722263,1750722501,1750722501.197819,-18000,,
com.google.Chrome,56,1750722207,1750722263,1750722263.0705109,-18000,,
com.microsoft.VSCode,1,1750722206,1750722207,1750722207.467771,-18000,,
com.google.Chrome,10,1750722196,1750722206,1750722206.3331652,-18000,,
com.microsoft.VSCode,321,1750721875,1750722196,1750722196.853473,-18000,,
com.google.Chrome,16,1750721859,1750721875,1750721875.559434,-18000,,
com.microsoft.VSCode,92,1750721767,1750721859,1750721859.575001,-18000,,
com.google.Chrome,63,1750721704,1750721767,1750721767.6120481,-18000,,
com.microsoft.VSCode,434,1750721270,1750721704,1750721704.651108,-18000,,
com.google.Chrome,11,1750721259,1750721270,1750721270.74228,-18000,,
com.microsoft.VSCode,2,1750721257,1750721259,1750721259.1419291,-18000,,
com.google.Chrome,25,1750721232,1750721257,1750721257.5473719,-18000,,
com.microsoft.VSCode,182,1750721050,1750721232,1750721232.662008,-18000,,
com.google.Chrome,63,1750720987,1750721050,1750721050.576647,-18000,,
com.microsoft.VSCode,6,1750720981,1750720987,1750720989.122315,-18000,,
com.google.Chrome,1,1750720980,1750720981,1750720983.798176,-18000,,
com.microsoft.VSCode,117,1750720863,1750720980,1750720980.860262,-18000,,
com.google.Chrome,56,1750720807,1750720863,1750720864.013929,-18000,,
com.microsoft.VSCode,10,1750720797,1750720807,1750720808.25529,-18000,,
com.google.Chrome,4,1750720793,1750720797,1750720797.572805,-18000,,
com.microsoft.VSCode,1,1750720785,1750720786,1750720788.8611898,-18000,,
com.google.Chrome,7,1750720778,1750720785,1750720787.7827768,-18000,,
com.microsoft.VSCode,1,1750720777,1750720778,1750720784.382433,-18000,,
com.apple.MobileSMS,11,1750720766,1750720777,1750720780.120744,-18000,,
com.microsoft.VSCode,680,1750720086,1750720766,1750720766.582209,-18000,,
com.microsoft.VSCode,127,1750718673,1750718800,1750718800.75065,-18000,,
com.google.Chrome,28,1750718645,1750718673,1750718673.513689,-18000,,
com.microsoft.VSCode,7,1750718638,1750718645,1750718645.806449,-18000,,
com.google.Chrome,10,1750718628,1750718638,1750718638.360398,-18000,,
com.microsoft.VSCode,226,1750718402,1750718628,1750718628.268993,-18000,,
com.microsoft.VSCode,9,1750718356,1750718365,1750718365.172844,-18000,,
com.apple.news,306,1750717689,1750717995,1750717996.094105,-18000,EB445137-D7F5-57EC-87DA-1DB460D64046,"iPhone13,2"
com.strava.stravaride,12,1750717674,1750717686,1750717686.4143782,-18000,EB445137-D7F5-57EC-87DA-1DB460D64046,"iPhone13,2"
com.microsoft.VSCode,465,1750717504,1750717969,1750717969.725384,-18000,,
com.google.Chrome,28,1750717476,1750717504,1750717504.857517,-18000,,
com.microsoft.VSCode,14,1750717462,1750717476,1750717476.32793,-18000,,
com.google.Chrome,8,1750717454,1750717462,1750717462.7202458,-18000,,
com.microsoft.VSCode,291,1750717163,1750717454,1750717454.698591,-18000,,
com.apple.finder,3,1750717160,1750717163,1750717163.392971,-18000,,
com.leomehlig.today,3,1750717157,1750717160,1750717161.005947,-18000,,
com.strava.stravaride,51,1750717096,1750717147,1750717147.4497352,-18000,EB445137-D7F5-57EC-87DA-1DB460D64046,"iPhone13,2"
com.truebill.truebillnative,2,1750712319,1750712321,1750712321.393938,-18000,EB445137-D7F5-57EC-87DA-1DB460D64046,"iPhone13,2"
com.apple.CoreAuthUI,2,1750712191,1750712193,1750712193.234542,-18000,EB445137-D7F5-57EC-87DA-1DB460D64046,"iPhone13,2"
com.truebill.truebillnative,134,1750712184,1750712318,1750712318.483396,-18000,EB445137-D7F5-57EC-87DA-1DB460D64046,"iPhone13,2"
com.apple.MobileSMS,3,1750712166,1750712169,1750712169.744976,-18000,EB445137-D7F5-57EC-87DA-1DB460D64046,"iPhone13,2"
com.apple.weather,7,1750712158,1750712165,1750712165.450814,-18000,EB445137-D7F5-57EC-87DA-1DB460D64046,"iPhone13,2"
com.microsoft.Office.Outlook,12,1750712144,1750712156,1750712156.713317,-18000,EB445137-D7F5-57EC-87DA-1DB460D64046,"iPhone13,2"
com.google.Gmail,81,1750712061,1750712142,1750712143.108489,-18000,EB445137-D7F5-57EC-87DA-1DB460D64046,"iPhone13,2"
com.leomehlig.today,3,1750712033,1750712036,1750712036.612306,-18000,,
com.apple.finder,2,1750712031,1750712033,1750712033.105648,-18000,,
com.apple.Music,1,1750712030,1750712031,1750712031.318075,-18000,,
com.microsoft.VSCode,97,1750711933,1750712030,1750712030.328648,-18000,,
com.google.Chrome,29,1750711904,1750711933,1750711933.390764,-18000,,
com.apple.Notes,36,1750711856,1750711892,1750711892.443569,-18000,,
com.google.Chrome,502,1750711354,1750711856,1750711856.819711,-18000,,
com.microsoft.VSCode,244,1750711110,1750711354,1750711354.985914,-18000,,
com.apple.Music,3,1750711107,1750711110,1750711110.2719932,-18000,,
com.google.Chrome,255,1750710852,1750711107,1750711107.802524,-18000,,
com.apple.Music,2,1750710850,1750710852,1750710852.2040992,-18000,,
com.google.Chrome,232,1750710618,1750710850,1750710850.464153,-18000,,
com.apple.Music,73,1750710545,1750710618,1750710618.723639,-18000,,
com.google.Chrome,80,1750710465,1750710545,1750710545.9238172,-18000,,
com.apple.finder,125,1750710340,1750710465,1750710465.117537,-18000,,
com.microsoft.VSCode,2,1750710338,1750710340,1750710340.980819,-18000,,
com.google.Chrome,235,1750710103,1750710338,1750710338.229274,-18000,,
com.apple.news,5,1750710098,1750710103,1750710103.5790439,-18000,,
com.google.Chrome,163,1750709935,1750710098,1750710098.034692,-18000,,
com.microsoft.VSCode,5,1750709930,1750709935,1750709935.873131,-18000,,
com.google.Chrome,202,1750709728,1750709930,1750709930.2714062,-18000,,
com.apple.Notes,14,1750709714,1750709728,1750709728.8438292,-18000,,
com.apple.finder,48,1750709666,1750709714,1750709714.254871,-18000,,
com.microsoft.VSCode,79,1750709587,1750709666,1750709666.338428,-18000,,
com.google.Chrome,18,1750709569,1750709587,1750709587.5961409,-18000,,
com.microsoft.VSCode,47,1750709522,1750709569,1750709569.300427,-18000,,
com.google.Chrome,7,1750709515,1750709522,1750709522.367585,-18000,,
com.microsoft.VSCode,21,1750709494,1750709515,1750709515.901692,-18000,,
com.google.Chrome,111,1750709383,1750709494,1750709494.133292,-18000,,
com.microsoft.VSCode,34,1750709270,1750709304,1750709304.254163,-18000,,
com.apple.news,186,1750709084,1750709270,1750709270.8302221,-18000,,
com.microsoft.VSCode,3,1750709081,1750709084,1750709084.7338982,-18000,,
com.apple.finder,9,1750709072,1750709081,1750709081.14167,-18000,,
com.google.Chrome,574,1750708498,1750709072,1750709072.202501,-18000,,
com.leomehlig.today,51,1750708447,1750708498,1750708498.327052,-18000,,
com.google.Chrome,78,1750708369,1750708447,1750708447.304566,-18000,,
com.apple.finder,15,1750708354,1750708369,1750708369.9821029,-18000,,
com.google.Chrome,121,1750708233,1750708354,1750708354.236515,-18000,,
com.apple.news,129,1750708104,1750708233,1750708234.026847,-18000,,
com.google.Chrome,78,1750708026,1750708104,1750708105.023744,-18000,,
com.apple.finder,5,1750708021,1750708026,1750708026.881908,-18000,,
com.google.Chrome,1,1750708020,1750708021,1750708021.1998801,-18000,,
com.apple.finder,2,1750708018,1750708020,1750708020.19923,-18000,,
com.google.Chrome,53,1750707965,1750708018,1750708018.366496,-18000,,
com.apple.finder,5,1750707960,1750707965,1750707965.880935,-18000,,
com.google.Chrome,31,1750707929,1750707960,1750707960.609976,-18000,,
com.apple.finder,8,1750707921,1750707929,1750707929.85215,-18000,,
com.google.Chrome,262,1750707659,1750707921,1750707921.371819,-18000,,
com.apple.finder,9,1750707650,1750707659,1750707659.41039,-18000,,
com.google.Chrome,4,1750707646,1750707650,1750707650.970269,-18000,,
com.apple.finder,7,1750707639,1750707646,1750707646.067028,-18000,,
com.google.Chrome,5,1750707634,1750707639,1750707639.920886,-18000,,
com.apple.finder,45,1750707589,1750707634,1750707634.115224,-18000,,
com.google.Chrome,2,1750707587,1750707589,1750707589.578804,-18000,,
com.apple.finder,11,1750707576,1750707587,1750707587.151361,-18000,,
com.google.Chrome,4,1750707572,1750707576,1750707576.05285,-18000,,
com.apple.Music,6,1750707566,1750707572,1750707572.904141,-18000,,
com.apple.finder,3,1750707563,1750707566,1750707566.848536,-18000,,
com.google.Chrome,65,1750707498,1750707563,1750707563.6268969,-18000,,
com.apple.finder,3,1750707495,1750707498,1750707498.179867,-18000,,
com.google.Chrome,49,1750707446,1750707495,1750707495.126164,-18000,,
com.apple.finder,12,1750707434,1750707446,1750707446.331342,-18000,,
com.google.Chrome,48,1750707386,1750707434,1750707434.138078,-18000,,
com.apple.finder,10,1750707376,1750707386,1750707386.060059,-18000,,
com.google.Chrome,105,1750707271,1750707376,1750707376.545126,-18000,,
com.apple.finder,10,1750707261,1750707271,1750707271.191193,-18000,,
com.google.Chrome,20,1750707241,1750707261,1750707261.9542341,-18000,,
com.apple.Music,3,1750707238,1750707241,1750707241.308735,-18000,,
com.google.Chrome,1,1750707237,1750707238,1750707238.365004,-18000,,
com.apple.Music,6,1750707231,1750707237,1750707237.717344,-18000,,
com.google.Chrome,199,1750707032,1750707231,1750707231.5908551,-18000,,
com.apple.finder,18,1750707014,1750707032,1750707032.7851682,-18000,,
com.google.Chrome,170,1750706844,1750707014,1750707014.916543,-18000,,
com.apple.finder,7,1750706837,1750706844,1750706844.254642,-18000,,
com.google.Chrome,54,1750706783,1750706837,1750706837.379002,-18000,,
com.apple.Music,36,1750706747,1750706783,1750706783.120163,-18000,,
com.google.Chrome,1,1750706746,1750706747,1750706747.667762,-18000,,
com.apple.Music,1,1750706745,1750706746,1750706746.9060678,-18000,,
com.google.Chrome,5,1750706740,1750706745,1750706745.6348062,-18000,,
com.apple.Music,98,1750706642,1750706740,1750706740.993722,-18000,,
com.doordash.dasher,25,1750706495,1750706520,1750706520.701531,-18000,EB445137-D7F5-57EC-87DA-1DB460D64046,"iPhone13,2"
com.google.Chrome,204,1750706438,1750706642,1750706642.746458,-18000,,
com.apple.finder,12,1750706426,1750706438,1750706439.006751,-18000,,
com.google.Chrome,129,1750706297,1750706426,1750706426.697846,-18000,,
com.apple.finder,0,1750706297,1750706297,1750706297.894065,-18000,,
com.google.Chrome,16,1750706281,1750706297,1750706297.08428,-18000,,
com.apple.finder,1,1750706280,1750706281,1750706281.803,-18000,,
com.google.Chrome,43,1750706237,1750706280,1750706280.4420319,-18000,,
com.apple.finder,11,1750706226,1750706237,1750706237.087646,-18000,,
com.google.Chrome,173,1750706053,1750706226,1750706226.223366,-18000,,
com.apple.finder,1,1750706052,1750706053,1750706053.628453,-18000,,
com.google.Chrome,2,1750706050,1750706052,1750706052.327211,-18000,,
com.apple.finder,1,1750706049,1750706050,1750706050.865745,-18000,,
com.google.Chrome,4,1750706045,1750706049,1750706049.511513,-18000,,
com.apple.finder,6,1750706039,1750706045,1750706045.5882158,-18000,,
com.google.Chrome,4,1750706035,1750706039,1750706039.049572,-18000,,
com.apple.finder,2,1750706033,1750706035,1750706035.6618419,-18000,,
com.google.Chrome,1,1750706032,1750706033,1750706033.7347631,-18000,,
com.apple.finder,3,1750706029,1750706032,1750706032.1181002,-18000,,
com.google.Chrome,11,1750706018,1750706029,1750706029.898217,-18000,,
com.apple.finder,1,1750706017,1750706018,1750706018.111954,-18000,,
com.google.Chrome,6,1750706011,1750706017,1750706017.509093,-18000,,
com.apple.finder,4,1750706007,1750706011,1750706011.3911738,-18000,,
com.google.Chrome,51,1750705956,1750706007,1750706007.953464,-18000,,
com.apple.finder,5,1750705951,1750705956,1750705956.578572,-18000,,
com.google.Chrome,48,1750705903,1750705951,1750705951.3137798,-18000,,
com.apple.finder,3,1750705900,1750705903,1750705903.135788,-18000,,
com.google.Chrome,13,1750705887,1750705900,1750705900.666061,-18000,,
com.apple.finder,3,1750705884,1750705887,1750705887.440789,-18000,,
com.google.Chrome,18,1750705866,1750705884,1750705884.2502131,-18000,,
com.apple.finder,2,1750705864,1750705866,1750705866.628039,-18000,,
com.google.Chrome,4,1750705860,1750705864,1750705864.131206,-18000,,
com.apple.finder,4,1750705856,1750705860,1750705860.937107,-18000,,
com.google.Chrome,1,1750705855,1750705856,1750705856.6933389,-18000,,
com.apple.finder,1,1750705854,1750705855,1750705855.085188,-18000,,
com.google.Chrome,24,1750705830,1750705854,1750705854.10583,-18000,,
com.apple.finder,16,1750705814,1750705830,1750705830.795923,-18000,,
com.google.Chrome,7,1750705807,1750705814,1750705814.801206,-18000,,
com.apple.finder,7,1750705800,1750705807,1750705807.9008489,-18000,,
com.google.Chrome,55,1750705745,1750705800,1750705800.340617,-18000,,
com.apple.finder,2,1750705743,1750705745,1750705745.04663,-18000,,
com.google.Chrome,5,1750705738,1750705743,1750705743.0578609,-18000,,
com.apple.finder,6,1750705732,1750705738,1750705738.971307,-18000,,
com.google.Chrome,6,1750705726,1750705732,1750705732.993281,-18000,,
com.apple.finder,2,1750705724,1750705726,1750705726.264903,-18000,,
com.google.Chrome,3,1750705721,1750705724,1750705724.207787,-18000,,
com.apple.finder,0,1750705721,1750705721,1750705722.0131512,-18000,,
com.google.Chrome,2,1750705719,1750705721,1750705721.341681,-18000,,
com.apple.finder,3,1750705716,1750705719,1750705719.472481,-18000,,
com.google.Chrome,17,1750705699,1750705716,1750705716.17595,-18000,,
com.apple.finder,5,1750705694,1750705699,1750705699.8688688,-18000,,
com.google.Chrome,6,1750705688,1750705694,1750705694.17725,-18000,,
com.apple.finder,3,1750705685,1750705688,1750705688.353273,-18000,,
com.google.Chrome,2,1750705683,1750705685,1750705685.6374788,-18000,,
com.apple.finder,2,1750705681,1750705683,1750705683.242402,-18000,,
com.google.Chrome,3,1750705678,1750705681,1750705681.610371,-18000,,
com.apple.finder,2,1750705676,1750705678,1750705678.802762,-18000,,
com.google.Chrome,2,1750705674,1750705676,1750705676.752048,-18000,,
com.apple.finder,1,1750705673,1750705674,1750705674.0858831,-18000,,
com.google.Chrome,9,1750705664,1750705673,1750705673.447084,-18000,,
com.apple.finder,8,1750705656,1750705664,1750705664.974458,-18000,,
com.google.Chrome,63,1750705593,1750705656,1750705656.3383389,-18000,,
com.apple.finder,6,1750705587,1750705593,1750705593.852752,-18000,,
com.google.Chrome,25,1750705562,1750705587,1750705587.547678,-18000,,
com.apple.finder,23,1750705539,1750705562,1750705562.205131,-18000,,
com.google.Chrome,83,1750705456,1750705539,1750705539.402615,-18000,,
com.apple.Notes,3,1750705453,1750705456,1750705456.496089,-18000,,
com.apple.news,57,1750705396,1750705453,1750705453.109964,-18000,,
com.apple.Notes,50,1750705346,1750705396,1750705396.792848,-18000,,
com.google.Chrome,59,1750705287,1750705346,1750705346.948884,-18000,,
com.microsoft.VSCode,700,1750704587,1750705287,1750705288.2800279,-18000,,
com.google.Chrome,6,1750704581,1750704587,1750704587.643924,-18000,,
com.microsoft.VSCode,1,1750704580,1750704581,1750704581.1237612,-18000,,
com.google.Chrome,4,1750704576,1750704580,1750704580.4104528,-18000,,
com.microsoft.VSCode,1,1750704575,1750704576,1750704576.5435119,-18000,,
com.google.Chrome,10,1750704565,1750704575,1750704575.09709,-18000,,
com.microsoft.VSCode,11,1750704554,1750704565,1750704565.104443,-18000,,
com.google.Chrome,15,1750704539,1750704554,1750704555.051312,-18000,,
com.microsoft.VSCode,1140,1750703399,1750704539,1750704539.3639832,-18000,,
com.google.Chrome,20,1750703379,1750703399,1750703399.802476,-18000,,
com.microsoft.VSCode,58,1750703321,1750703379,1750703379.602913,-18000,,
com.google.Chrome,3,1750703318,1750703321,1750703321.628947,-18000,,
com.microsoft.VSCode,13,1750703305,1750703318,1750703318.8795419,-18000,,
com.google.Chrome,1,1750703304,1750703305,1750703305.380945,-18000,,
com.microsoft.VSCode,21,1750703283,1750703304,1750703304.168347,-18000,,
com.google.Chrome,54,1750703229,1750703283,1750703283.445323,-18000,,
com.microsoft.VSCode,7,1750703222,1750703229,1750703229.392961,-18000,,
com.google.Chrome,2,1750703220,1750703222,1750703222.1950521,-18000,,
com.microsoft.VSCode,33,1750703187,1750703220,1750703220.784703,-18000,,
com.google.Chrome,3,1750703184,1750703187,1750703187.9541922,-18000,,
com.microsoft.VSCode,1,1750703183,1750703184,1750703184.872807,-18000,,
com.google.Chrome,3,1750703180,1750703183,1750703183.999083,-18000,,
com.microsoft.VSCode,12,1750703168,1750703180,1750703180.717217,-18000,,
com.google.Chrome,2,1750703166,1750703168,1750703168.623385,-18000,,
com.microsoft.VSCode,4,1750703162,1750703166,1750703166.7412682,-18000,,
com.google.Chrome,2,1750703160,1750703162,1750703162.692599,-18000,,
com.microsoft.VSCode,25,1750703135,1750703160,1750703160.925138,-18000,,
com.google.Chrome,3,1750703132,1750703135,1750703136.002377,-18000,,
com.apple.finder,1,1750703131,1750703132,1750703132.7138438,-18000,,
com.microsoft.VSCode,11,1750703120,1750703131,1750703131.476583,-18000,,
com.apple.finder,4,1750703116,1750703120,1750703120.193019,-18000,,
com.google.Chrome,13,1750703103,1750703116,1750703116.619461,-18000,,
com.apple.finder,1,1750703102,1750703103,1750703103.979443,-18000,,
com.microsoft.VSCode,57,1750703045,1750703102,1750703102.710291,-18000,,
com.google.Chrome,19,1750703026,1750703045,1750703045.783568,-18000,,
com.microsoft.VSCode,16,1750703010,1750703026,1750703026.724498,-18000,,
com.google.Chrome,1,1750703009,1750703010,1750703011.002575,-18000,,
com.microsoft.VSCode,5,1750703004,1750703009,1750703009.9312592,-18000,,
com.google.Chrome,60,1750702944,1750703004,1750703004.760036,-18000,,
com.microsoft.VSCode,286,1750702658,1750702944,1750702945.94808,-18000,,
com.google.Chrome,13,1750702645,1750702658,1750702658.6834002,-18000,,
com.apple.news,25,1750702090,1750702115,1750702115.989475,-18000,EB445137-D7F5-57EC-87DA-1DB460D64046,"iPhone13,2"
com.doordash.dasher,0,1750702090,1750702090,1750702090.5663671,-18000,EB445137-D7F5-57EC-87DA-1DB460D64046,"iPhone13,2"
com.doordash.dasher,227,1750701299,1750701526,1750701527.064375,-18000,EB445137-D7F5-57EC-87DA-1DB460D64046,"iPhone13,2"
com.doordash.dasher,616,1750700670,1750701286,1750701286.164845,-18000,EB445137-D7F5-57EC-87DA-1DB460D64046,"iPhone13,2"
com.doordash.dasher,39,1750700626,1750700665,1750700665.695581,-18000,EB445137-D7F5-57EC-87DA-1DB460D64046,"iPhone13,2"
com.doordash.dasher,113,1750700290,1750700403,1750700403.930807,-18000,EB445137-D7F5-57EC-87DA-1DB460D64046,"iPhone13,2"
com.doordash.dasher,5,1750700159,1750700164,1750700164.9627461,-18000,EB445137-D7F5-57EC-87DA-1DB460D64046,"iPhone13,2"
com.apple.news,128,1750700030,1750700158,1750700159.0284991,-18000,EB445137-D7F5-57EC-87DA-1DB460D64046,"iPhone13,2"
com.doordash.dasher,16,1750700014,1750700030,1750700030.6025882,-18000,EB445137-D7F5-57EC-87DA-1DB460D64046,"iPhone13,2"
com.apple.news,33,1750699981,1750700014,1750700015.085929,-18000,EB445137-D7F5-57EC-87DA-1DB460D64046,"iPhone13,2"
com.doordash.dasher,31,1750699950,1750699981,1750699981.237066,-18000,EB445137-D7F5-57EC-87DA-1DB460D64046,"iPhone13,2"
com.apple.MobileSMS,8,1750699942,1750699950,1750699950.6814752,-18000,EB445137-D7F5-57EC-87DA-1DB460D64046,"iPhone13,2"
com.doordash.dasher,5,1750699937,1750699942,1750699942.600398,-18000,EB445137-D7F5-57EC-87DA-1DB460D64046,"iPhone13,2"
com.apple.news,17,1750699920,1750699937,1750699937.743855,-18000,EB445137-D7F5-57EC-87DA-1DB460D64046,"iPhone13,2"
com.apple.MobileSMS,3,1750699917,1750699920,1750699920.902118,-18000,EB445137-D7F5-57EC-87DA-1DB460D64046,"iPhone13,2"
com.apple.news,0,1750699917,1750699917,1750699917.947227,-18000,EB445137-D7F5-57EC-87DA-1DB460D64046,"iPhone13,2"
com.apple.news,6,1750699910,1750699916,1750699916.493188,-18000,EB445137-D7F5-57EC-87DA-1DB460D64046,"iPhone13,2"
com.doordash.dasher,68,1750699842,1750699910,1750699911.051569,-18000,EB445137-D7F5-57EC-87DA-1DB460D64046,"iPhone13,2"
com.apple.news,33,1750699809,1750699842,1750699842.618747,-18000,EB445137-D7F5-57EC-87DA-1DB460D64046,"iPhone13,2"
com.doordash.dasher,630,1750699155,1750699785,1750699785.4709048,-18000,EB445137-D7F5-57EC-87DA-1DB460D64046,"iPhone13,2"
com.apple.Maps,15,1750699140,1750699155,1750699155.298586,-18000,EB445137-D7F5-57EC-87DA-1DB460D64046,"iPhone13,2"
com.doordash.dasher,395,1750698745,1750699140,1750699140.829413,-18000,EB445137-D7F5-57EC-87DA-1DB460D64046,"iPhone13,2"
com.doordash.dasher,38,1750698701,1750698739,1750698739.104533,-18000,EB445137-D7F5-57EC-87DA-1DB460D64046,"iPhone13,2"
com.doordash.dasher,31,1750698365,1750698396,1750698396.599685,-18000,EB445137-D7F5-57EC-87DA-1DB460D64046,"iPhone13,2"
com.doordash.dasher,819,1750697472,1750698291,1750698291.272306,-18000,EB445137-D7F5-57EC-87DA-1DB460D64046,"iPhone13,2"
com.apple.MobileSMS,3,1750697469,1750697472,1750697472.4720368,-18000,EB445137-D7F5-57EC-87DA-1DB460D64046,"iPhone13,2"
com.doordash.dasher,1968,1750695500,1750697468,1750697468.585281,-18000,EB445137-D7F5-57EC-87DA-1DB460D64046,"iPhone13,2"
com.doordash.dasher,1786,1750693656,1750695442,1750695442.9011989,-18000,EB445137-D7F5-57EC-87DA-1DB460D64046,"iPhone13,2"
com.apple.MobileSMS,112,1750693544,1750693656,1750693656.911032,-18000,EB445137-D7F5-57EC-87DA-1DB460D64046,"iPhone13,2"
com.doordash.dasher,2,1750693542,1750693544,1750693544.8848372,-18000,EB445137-D7F5-57EC-87DA-1DB460D64046,"iPhone13,2"
com.apple.MobileSMS,5,1750693537,1750693542,1750693542.1954021,-18000,EB445137-D7F5-57EC-87DA-1DB460D64046,"iPhone13,2"
com.apple.findmy,24,1750693112,1750693136,1750693136.6152759,-18000,EB445137-D7F5-57EC-87DA-1DB460D64046,"iPhone13,2"
com.apple.weather,69,1750693043,1750693112,1750693112.255467,-18000,EB445137-D7F5-57EC-87DA-1DB460D64046,"iPhone13,2"
com.strava.stravaride,52,1750692912,1750692964,1750692964.718927,-18000,EB445137-D7F5-57EC-87DA-1DB460D64046,"iPhone13,2"
com.doordash.dasher,34,1750692878,1750692912,1750692912.699883,-18000,EB445137-D7F5-57EC-87DA-1DB460D64046,"iPhone13,2"
com.doordash.dasher,3,1750692849,1750692852,1750692852.499425,-18000,EB445137-D7F5-57EC-87DA-1DB460D64046,"iPhone13,2"
com.doordash.dasher,16,1750692676,1750692692,1750692692.243269,-18000,EB445137-D7F5-57EC-87DA-1DB460D64046,"iPhone13,2"
com.letterboxd.LetterboxdApp,40,1750692362,1750692402,1750692402.7697492,-18000,EB445137-D7F5-57EC-87DA-1DB460D64046,"iPhone13,2"
com.apple.weather,18,1750689817,1750689835,1750689835.5754561,-18000,EB445137-D7F5-57EC-87DA-1DB460D64046,"iPhone13,2"
com.apple.news,18,1750689798,1750689816,1750689816.411293,-18000,EB445137-D7F5-57EC-87DA-1DB460D64046,"iPhone13,2"
com.apple.weather,1,1750689789,1750689790,1750689790.819664,-18000,EB445137-D7F5-57EC-87DA-1DB460D64046,"iPhone13,2"
com.apple.weather,75,1750689571,1750689646,1750689646.263116,-18000,EB445137-D7F5-57EC-87DA-1DB460D64046,"iPhone13,2"
com.apple.weather,323,1750688729,1750689052,1750689052.633368,-18000,EB445137-D7F5-57EC-87DA-1DB460D64046,"iPhone13,2"
com.apple.weather,69,1750686617,1750686686,1750686686.8108358,-18000,EB445137-D7F5-57EC-87DA-1DB460D64046,"iPhone13,2"
com.apple.mobiletimer,14,1750683682,1750683696,1750683696.578928,-18000,EB445137-D7F5-57EC-87DA-1DB460D64046,"iPhone13,2"
com.apple.weather,27,1750683652,1750683679,1750683679.3362598,-18000,EB445137-D7F5-57EC-87DA-1DB460D64046,"iPhone13,2"
com.apple.mobiletimer,1,1750683651,1750683652,1750683652.882113,-18000,EB445137-D7F5-57EC-87DA-1DB460D64046,"iPhone13,2"
com.apple.mobiletimer,3,1750683607,1750683610,1750683610.277843,-18000,EB445137-D7F5-57EC-87DA-1DB460D64046,"iPhone13,2"
com.apple.mobiletimer,14,1750683151,1750683165,1750683165.4827762,-18000,EB445137-D7F5-57EC-87DA-1DB460D64046,"iPhone13,2"
com.apple.weather,9,1750683126,1750683135,1750683135.175426,-18000,EB445137-D7F5-57EC-87DA-1DB460D64046,"iPhone13,2"
com.apple.Health,65,1750683054,1750683119,1750683119.607452,-18000,EB445137-D7F5-57EC-87DA-1DB460D64046,"iPhone13,2"
com.apple.news,196,1750682853,1750683049,1750683049.855033,-18000,EB445137-D7F5-57EC-87DA-1DB460D64046,"iPhone13,2"
com.apple.news,484,1750682365,1750682849,1750682849.2556992,-18000,EB445137-D7F5-57EC-87DA-1DB460D64046,"iPhone13,2"
com.apple.mobiletimer,8,1750682357,1750682365,1750682365.536169,-18000,EB445137-D7F5-57EC-87DA-1DB460D64046,"iPhone13,2"
com.apple.news,236,1750682121,1750682357,1750682357.8152962,-18000,EB445137-D7F5-57EC-87DA-1DB460D64046,"iPhone13,2"
com.apple.weather,41,1750682079,1750682120,1750682120.340859,-18000,EB445137-D7F5-57EC-87DA-1DB460D64046,"iPhone13,2"
com.apple.news,20,1750682057,1750682077,1750682077.77335,-18000,EB445137-D7F5-57EC-87DA-1DB460D64046,"iPhone13,2"
com.apple.weather,10,1750682040,1750682050,1750682050.780925,-18000,EB445137-D7F5-57EC-87DA-1DB460D64046,"iPhone13,2"
com.apple.findmy,5,1750655167,1750655172,1750655172.672319,-18000,EB445137-D7F5-57EC-87DA-1DB460D64046,"iPhone13,2"
com.apple.Maps,3,1750655164,1750655167,1750655167.753577,-18000,EB445137-D7F5-57EC-87DA-1DB460D64046,"iPhone13,2"
com.apple.mobiletimer,2,1750655162,1750655164,1750655164.578432,-18000,EB445137-D7F5-57EC-87DA-1DB460D64046,"iPhone13,2"
com.apple.mobiletimer,7,1750654635,1750654642,1750654642.6411262,-18000,EB445137-D7F5-57EC-87DA-1DB460D64046,"iPhone13,2"
com.apple.Maps,3,1750654632,1750654635,1750654635.2987971,-18000,EB445137-D7F5-57EC-87DA-1DB460D64046,"iPhone13,2"
com.apple.Maps,61,1750654516,1750654577,1750654577.62986,-18000,EB445137-D7F5-57EC-87DA-1DB460D64046,"iPhone13,2"
com.apple.findmy,9,1750654507,1750654516,1750654516.797134,-18000,EB445137-D7F5-57EC-87DA-1DB460D64046,"iPhone13,2"
com.apple.Health,50,1750654298,1750654348,1750654348.229068,-18000,EB445137-D7F5-57EC-87DA-1DB460D64046,"iPhone13,2"
com.apple.CoreAuthUI,2,1750653369,1750653371,1750653371.1719031,-18000,EB445137-D7F5-57EC-87DA-1DB460D64046,"iPhone13,2"
com.apple.journal,929,1750653368,1750654297,1750654297.671238,-18000,EB445137-D7F5-57EC-87DA-1DB460D64046,"iPhone13,2"
com.apple.findmy,9,1750653355,1750653364,1750653364.627719,-18000,EB445137-D7F5-57EC-87DA-1DB460D64046,"iPhone13,2"
com.google.Chrome,581,1750652712,1750653293,1750653293.4012089,-18000,,
com.apple.weather,4,1750652463,1750652467,1750652467.810316,-18000,EB445137-D7F5-57EC-87DA-1DB460D64046,"iPhone13,2"
com.letterboxd.LetterboxdApp,97,1750652360,1750652457,1750652457.139159,-18000,EB445137-D7F5-57EC-87DA-1DB460D64046,"iPhone13,2"
com.apple.news,112,1750652246,1750652358,1750652358.172826,-18000,EB445137-D7F5-57EC-87DA-1DB460D64046,"iPhone13,2"
com.google.chrome.ios,3,1750652237,1750652240,1750652240.89451,-18000,EB445137-D7F5-57EC-87DA-1DB460D64046,"iPhone13,2"
com.google.chrome.ios,58,1750650597,1750650655,1750650656.045226,-18000,EB445137-D7F5-57EC-87DA-1DB460D64046,"iPhone13,2"
com.apple.findmy,9,1750649099,1750649108,1750649108.504857,-18000,EB445137-D7F5-57EC-87DA-1DB460D64046,"iPhone13,2"
com.apple.news,12,1750649063,1750649075,1750649075.320832,-18000,EB445137-D7F5-57EC-87DA-1DB460D64046,"iPhone13,2"
com.apple.news,389,1750647308,1750647697,1750647698.009863,-18000,EB445137-D7F5-57EC-87DA-1DB460D64046,"iPhone13,2"
com.apple.news,8,1750646495,1750646503,1750646503.688231,-18000,EB445137-D7F5-57EC-87DA-1DB460D64046,"iPhone13,2"
com.apple.news,288,1750645685,1750645973,1750645973.595375,-18000,EB445137-D7F5-57EC-87DA-1DB460D64046,"iPhone13,2"
com.google.chrome.ios,0,1750645685,1750645685,1750645686.24678,-18000,EB445137-D7F5-57EC-87DA-1DB460D64046,"iPhone13,2"
com.google.chrome.ios,45,1750644966,1750645011,1750645011.507794,-18000,EB445137-D7F5-57EC-87DA-1DB460D64046,"iPhone13,2"
com.apple.news,2,1750644964,1750644966,1750644966.5071301,-18000,EB445137-D7F5-57EC-87DA-1DB460D64046,"iPhone13,2"
com.apple.news,72,1750643194,1750643266,1750643266.2237868,-18000,EB445137-D7F5-57EC-87DA-1DB460D64046,"iPhone13,2"
com.apple.Passwords,1,1750643193,1750643194,1750643194.4461908,-18000,EB445137-D7F5-57EC-87DA-1DB460D64046,"iPhone13,2"
com.apple.CoreAuthUI,1,1750643040,1750643041,1750643041.8173552,-18000,EB445137-D7F5-57EC-87DA-1DB460D64046,"iPhone13,2"
com.apple.Passwords,102,1750643038,1750643140,1750643140.6084008,-18000,EB445137-D7F5-57EC-87DA-1DB460D64046,"iPhone13,2"
com.apple.Preferences,17,1750643019,1750643036,1750643036.217417,-18000,EB445137-D7F5-57EC-87DA-1DB460D64046,"iPhone13,2"
com.google.chrome.ios,76,1750642839,1750642915,1750642916.007232,-18000,EB445137-D7F5-57EC-87DA-1DB460D64046,"iPhone13,2"
com.google.chrome.ios,197,1750642565,1750642762,1750642762.238584,-18000,EB445137-D7F5-57EC-87DA-1DB460D64046,"iPhone13,2"
Astrospheric.Astrospheric,9,1750642474,1750642483,1750642483.212343,-18000,EB445137-D7F5-57EC-87DA-1DB460D64046,"iPhone13,2"
com.apple.findmy,3,1750642467,1750642470,1750642470.866348,-18000,EB445137-D7F5-57EC-87DA-1DB460D64046,"iPhone13,2"
com.apple.findmy,7,1750642310,1750642317,1750642318.467379,-18000,EB445137-D7F5-57EC-87DA-1DB460D64046,"iPhone13,2"
com.apple.news,10,1750642299,1750642309,1750642309.521121,-18000,EB445137-D7F5-57EC-87DA-1DB460D64046,"iPhone13,2"
com.apple.news,2,1750642293,1750642295,1750642295.756579,-18000,EB445137-D7F5-57EC-87DA-1DB460D64046,"iPhone13,2"
com.google.Chrome,524,1750641591,1750642115,1750642115.517013,-18000,,
com.apple.news,64,1750641353,1750641417,1750641417.977961,-18000,EB445137-D7F5-57EC-87DA-1DB460D64046,"iPhone13,2"
com.letterboxd.LetterboxdApp,0,1750641353,1750641353,1750641354.8754392,-18000,EB445137-D7F5-57EC-87DA-1DB460D64046,"iPhone13,2"
com.google.Chrome,9,1750641277,1750641286,1750641286.261483,-18000,,
com.apple.MobileSMS,1,1750641276,1750641277,1750641277.6002731,-18000,,
com.google.Chrome,199,1750641077,1750641276,1750641276.593015,-18000,,
com.apple.findmy,28,1750641049,1750641077,1750641077.530673,-18000,,
com.google.Chrome,375,1750640674,1750641049,1750641049.028216,-18000,,
com.google.Chrome,340,1750639977,1750640317,1750640317.8061008,-18000,,
com.google.Chrome,404,1750638812,1750639216,1750639216.919759,-18000,,
com.google.Chrome,314,1750638494,1750638808,1750638809.009192,-18000,,
com.letterboxd.LetterboxdApp,82,1750637553,1750637635,1750637636.237949,-18000,EB445137-D7F5-57EC-87DA-1DB460D64046,"iPhone13,2"
com.google.Chrome,898,1750637501,1750638399,1750638399.939671,-18000,,
com.letterboxd.LetterboxdApp,81,1750637334,1750637415,1750637415.226674,-18000,EB445137-D7F5-57EC-87DA-1DB460D64046,"iPhone13,2"
com.apple.news,1,1750637333,1750637334,1750637334.471122,-18000,EB445137-D7F5-57EC-87DA-1DB460D64046,"iPhone13,2"
com.apple.news,12,1750637086,1750637098,1750637098.66801,-18000,EB445137-D7F5-57EC-87DA-1DB460D64046,"iPhone13,2"
com.apple.findmy,0,1750637086,1750637086,1750637087.4738421,-18000,EB445137-D7F5-57EC-87DA-1DB460D64046,"iPhone13,2"
com.apple.findmy,6,1750636046,1750636052,1750636053.0798678,-18000,EB445137-D7F5-57EC-87DA-1DB460D64046,"iPhone13,2"
com.apple.news,2,1750636043,1750636045,1750636045.231269,-18000,EB445137-D7F5-57EC-87DA-1DB460D64046,"iPhone13,2"
com.apple.news,15,1750635607,1750635622,1750635622.467164,-18000,EB445137-D7F5-57EC-87DA-1DB460D64046,"iPhone13,2"
com.google.Chrome,1428,1750634605,1750636033,1750636033.5244598,-18000,,
com.google.Chrome,1074,1750633455,1750634529,1750634529.412373,-18000,,
com.apple.news,87,1750633181,1750633268,1750633268.772871,-18000,EB445137-D7F5-57EC-87DA-1DB460D64046,"iPhone13,2"
com.strava.stravaride,30,1750633125,1750633155,1750633155.175887,-18000,EB445137-D7F5-57EC-87DA-1DB460D64046,"iPhone13,2"
com.doordash.dasher,73,1750633023,1750633096,1750633096.5915232,-18000,EB445137-D7F5-57EC-87DA-1DB460D64046,"iPhone13,2"
com.toyopagroup.picaboo,3,1750633013,1750633016,1750633016.910501,-18000,EB445137-D7F5-57EC-87DA-1DB460D64046,"iPhone13,2"
com.google.chrome.ios,2,1750633006,1750633008,1750633008.994009,-18000,EB445137-D7F5-57EC-87DA-1DB460D64046,"iPhone13,2"
Astrospheric.Astrospheric,34,1750632972,1750633006,1750633006.945325,-18000,EB445137-D7F5-57EC-87DA-1DB460D64046,"iPhone13,2"
com.apple.news,2,1750632967,1750632969,1750632969.574034,-18000,EB445137-D7F5-57EC-87DA-1DB460D64046,"iPhone13,2"
com.google.Chrome,526,1750632742,1750633268,1750633269.110042,-18000,,
com.google.Chrome,524,1750632201,1750632725,1750632725.766259,-18000,,
com.apple.news,240,1750632187,1750632427,1750632427.9805012,-18000,EB445137-D7F5-57EC-87DA-1DB460D64046,"iPhone13,2"
com.google.Chrome,328,1750631269,1750631597,1750631597.700455,-18000,,
com.google.Chrome,617,1750630644,1750631261,1750631261.019218,-18000,,
com.google.Chrome,1645,1750628004,1750629649,1750629649.3939981,-18000,,
com.toyopagroup.picaboo,8,1750627965,1750627973,1750627973.4752898,-18000,EB445137-D7F5-57EC-87DA-1DB460D64046,"iPhone13,2"
com.apple.news,0,1750627965,1750627965,1750627966.051241,-18000,EB445137-D7F5-57EC-87DA-1DB460D64046,"iPhone13,2"
com.apple.news,60,1750625988,1750626048,1750626048.366537,-18000,EB445137-D7F5-57EC-87DA-1DB460D64046,"iPhone13,2"
com.apple.news,33,1750625917,1750625950,1750625950.9371328,-18000,EB445137-D7F5-57EC-87DA-1DB460D64046,"iPhone13,2"
com.apple.weather,59,1750625821,1750625880,1750625880.267846,-18000,EB445137-D7F5-57EC-87DA-1DB460D64046,"iPhone13,2"
com.apple.news,24,1750625794,1750625818,1750625818.863702,-18000,EB445137-D7F5-57EC-87DA-1DB460D64046,"iPhone13,2"
com.apple.news,12,1750625714,1750625726,1750625726.707408,-18000,EB445137-D7F5-57EC-87DA-1DB460D64046,"iPhone13,2"
com.apple.MobileSMS,48,1750625658,1750625706,1750625706.038964,-18000,EB445137-D7F5-57EC-87DA-1DB460D64046,"iPhone13,2"
com.apple.MobileSMS,12,1750625642,1750625654,1750625654.9157748,-18000,EB445137-D7F5-57EC-87DA-1DB460D64046,"iPhone13,2"
com.google.chrome.ios,3,1750625639,1750625642,1750625643.10443,-18000,EB445137-D7F5-57EC-87DA-1DB460D64046,"iPhone13,2"
com.google.chrome.ios,2,1750625634,1750625636,1750625636.249583,-18000,EB445137-D7F5-57EC-87DA-1DB460D64046,"iPhone13,2"
com.apple.MobileSMS,25,1750625608,1750625633,1750625633.071847,-18000,EB445137-D7F5-57EC-87DA-1DB460D64046,"iPhone13,2"
com.apple.MobileSMS,24,1750625573,1750625597,1750625597.037036,-18000,EB445137-D7F5-57EC-87DA-1DB460D64046,"iPhone13,2"
com.apple.MobileSMS,13,1750625549,1750625562,1750625562.714347,-18000,EB445137-D7F5-57EC-87DA-1DB460D64046,"iPhone13,2"
com.apple.MobileSMS,62,1750625486,1750625548,1750625548.4820108,-18000,EB445137-D7F5-57EC-87DA-1DB460D64046,"iPhone13,2"
com.apple.MobileSMS,26,1750625442,1750625468,1750625468.8541389,-18000,EB445137-D7F5-57EC-87DA-1DB460D64046,"iPhone13,2"
com.apple.MobileSMS,100,1750625338,1750625438,1750625439.058878,-18000,EB445137-D7F5-57EC-87DA-1DB460D64046,"iPhone13,2"
com.apple.MobileSMS,52,1750625216,1750625268,1750625268.987051,-18000,EB445137-D7F5-57EC-87DA-1DB460D64046,"iPhone13,2"
com.apple.weather,19,1750625197,1750625216,1750625216.35901,-18000,EB445137-D7F5-57EC-87DA-1DB460D64046,"iPhone13,2"
com.toyopagroup.picaboo,14,1750625183,1750625197,1750625197.36466,-18000,EB445137-D7F5-57EC-87DA-1DB460D64046,"iPhone13,2"
com.toyopagroup.picaboo,17,1750624047,1750624064,1750624064.290412,-18000,EB445137-D7F5-57EC-87DA-1DB460D64046,"iPhone13,2"
com.apple.news,140,1750623883,1750624023,1750624023.727579,-18000,EB445137-D7F5-57EC-87DA-1DB460D64046,"iPhone13,2"
com.apple.PosterBoard,0,1750620816,1750620816,1750620816.5471768,-18000,EB445137-D7F5-57EC-87DA-1DB460D64046,"iPhone13,2"
com.apple.news,183,1750619305,1750619488,1750619488.412817,-18000,EB445137-D7F5-57EC-87DA-1DB460D64046,"iPhone13,2"
com.apple.MobileSMS,16,1750619285,1750619301,1750619301.91782,-18000,EB445137-D7F5-57EC-87DA-1DB460D64046,"iPhone13,2"
com.apple.MobileSMS,32,1750619249,1750619281,1750619281.159593,-18000,EB445137-D7F5-57EC-87DA-1DB460D64046,"iPhone13,2"
com.google.chrome.ios,615,1750618631,1750619246,1750619246.8104858,-18000,EB445137-D7F5-57EC-87DA-1DB460D64046,"iPhone13,2"
com.apple.GameOverlayUI,7,1750618436,1750618443,1750618443.214006,-18000,EB445137-D7F5-57EC-87DA-1DB460D64046,"iPhone13,2"
com.apple.news,200,1750618431,1750618631,1750618631.139435,-18000,EB445137-D7F5-57EC-87DA-1DB460D64046,"iPhone13,2"
com.strava.stravaride,92,1750615827,1750615919,1750615919.509015,-18000,EB445137-D7F5-57EC-87DA-1DB460D64046,"iPhone13,2"
com.apple.weather,52,1750615770,1750615822,1750615823.14187,-18000,EB445137-D7F5-57EC-87DA-1DB460D64046,"iPhone13,2"
com.apple.news,38,1750615729,1750615767,1750615767.246873,-18000,EB445137-D7F5-57EC-87DA-1DB460D64046,"iPhone13,2"
com.toyopagroup.picaboo,1,1750615721,1750615722,1750615723.174696,-18000,EB445137-D7F5-57EC-87DA-1DB460D64046,"iPhone13,2"
com.toyopagroup.picaboo,16,1750615539,1750615555,1750615556.105979,-18000,EB445137-D7F5-57EC-87DA-1DB460D64046,"iPhone13,2"
com.letterboxd.LetterboxdApp,90,1750615395,1750615485,1750615485.7365952,-18000,EB445137-D7F5-57EC-87DA-1DB460D64046,"iPhone13,2"
com.apple.CoreAuthUI,2,1750615390,1750615392,1750615392.299708,-18000,EB445137-D7F5-57EC-87DA-1DB460D64046,"iPhone13,2"
com.google.chrome.ios,26,1750615363,1750615389,1750615389.115082,-18000,EB445137-D7F5-57EC-87DA-1DB460D64046,"iPhone13,2"
com.truebill.truebillnative,2,1750615361,1750615363,1750615363.1338081,-18000,EB445137-D7F5-57EC-87DA-1DB460D64046,"iPhone13,2"
com.apple.news,110,1750615251,1750615361,1750615361.335,-18000,EB445137-D7F5-57EC-87DA-1DB460D64046,"iPhone13,2"
com.microsoft.Office.Outlook,19,1750615225,1750615244,1750615244.166143,-18000,EB445137-D7F5-57EC-87DA-1DB460D64046,"iPhone13,2"
com.google.Chrome,1144,1750614042,1750615186,1750615186.23741,-18000,,
com.apple.MobileSMS,40,1750614002,1750614042,1750614042.41473,-18000,,
com.google.Chrome,1313,1750612689,1750614002,1750614002.7125568,-18000,,
com.apple.news,31,1750610912,1750610943,1750610943.147798,-18000,EB445137-D7F5-57EC-87DA-1DB460D64046,"iPhone13,2"
com.apple.news,738,1750610110,1750610848,1750610849.1717591,-18000,EB445137-D7F5-57EC-87DA-1DB460D64046,"iPhone13,2"
com.apple.news,254,1750609350,1750609604,1750609604.6838179,-18000,EB445137-D7F5-57EC-87DA-1DB460D64046,"iPhone13,2"
com.apple.news,209,1750608563,1750608772,1750608773.109308,-18000,EB445137-D7F5-57EC-87DA-1DB460D64046,"iPhone13,2"
com.apple.news,214,1750607995,1750608209,1750608210.171519,-18000,EB445137-D7F5-57EC-87DA-1DB460D64046,"iPhone13,2"
com.apple.weather,4,1750607987,1750607991,1750607991.3121262,-18000,EB445137-D7F5-57EC-87DA-1DB460D64046,"iPhone13,2"
com.apple.weather,1,1750607736,1750607737,1750607737.183504,-18000,EB445137-D7F5-57EC-87DA-1DB460D64046,"iPhone13,2"
com.letterboxd.LetterboxdApp,275,1750607446,1750607721,1750607721.6610742,-18000,EB445137-D7F5-57EC-87DA-1DB460D64046,"iPhone13,2"
com.apple.CoreAuthUI,2,1750607437,1750607439,1750607439.2700028,-18000,EB445137-D7F5-57EC-87DA-1DB460D64046,"iPhone13,2"
com.google.chrome.ios,151,1750607273,1750607424,1750607424.959159,-18000,EB445137-D7F5-57EC-87DA-1DB460D64046,"iPhone13,2"
com.apple.news,173,1750607099,1750607272,1750607272.35189,-18000,EB445137-D7F5-57EC-87DA-1DB460D64046,"iPhone13,2"
com.apple.news,3,1750606220,1750606223,1750606223.814262,-18000,EB445137-D7F5-57EC-87DA-1DB460D64046,"iPhone13,2"
com.apple.news,11,1750606209,1750606220,1750606220.295858,-18000,EB445137-D7F5-57EC-87DA-1DB460D64046,"iPhone13,2"
com.letterboxd.LetterboxdApp,35,1750605341,1750605376,1750605376.226881,-18000,EB445137-D7F5-57EC-87DA-1DB460D64046,"iPhone13,2"
com.strava.stravaride,60,1750605279,1750605339,1750605339.5402288,-18000,EB445137-D7F5-57EC-87DA-1DB460D64046,"iPhone13,2"
com.apple.Health,17,1750605246,1750605263,1750605263.76509,-18000,EB445137-D7F5-57EC-87DA-1DB460D64046,"iPhone13,2"
com.apple.findmy,0,1750605246,1750605246,1750605246.488687,-18000,EB445137-D7F5-57EC-87DA-1DB460D64046,"iPhone13,2"
com.apple.findmy,17,1750604719,1750604736,1750604736.854175,-18000,EB445137-D7F5-57EC-87DA-1DB460D64046,"iPhone13,2"
com.apple.weather,182,1750604527,1750604709,1750604709.381546,-18000,EB445137-D7F5-57EC-87DA-1DB460D64046,"iPhone13,2"
com.renpho.health,27,1750604487,1750604514,1750604514.2220988,-18000,EB445137-D7F5-57EC-87DA-1DB460D64046,"iPhone13,2"
com.apple.news,1,1750604485,1750604486,1750604487.3523211,-18000,EB445137-D7F5-57EC-87DA-1DB460D64046,"iPhone13,2"
com.apple.news,231,1750600967,1750601198,1750601198.549953,-18000,EB445137-D7F5-57EC-87DA-1DB460D64046,"iPhone13,2"
com.apple.news,4,1750600960,1750600964,1750600964.790454,-18000,EB445137-D7F5-57EC-87DA-1DB460D64046,"iPhone13,2"
com.apple.news,359,1750599530,1750599889,1750599889.858006,-18000,EB445137-D7F5-57EC-87DA-1DB460D64046,"iPhone13,2"
com.apple.weather,14,1750599278,1750599292,1750599292.725699,-18000,EB445137-D7F5-57EC-87DA-1DB460D64046,"iPhone13,2"
com.apple.mobiletimer,3,1750599274,1750599277,1750599277.421849,-18000,EB445137-D7F5-57EC-87DA-1DB460D64046,"iPhone13,2"
com.apple.mobiletimer,28,1750597651,1750597679,1750597679.8195438,-18000,EB445137-D7F5-57EC-87DA-1DB460D64046,"iPhone13,2"
com.apple.journal,150,1750567325,1750567475,1750567475.53618,-18000,EB445137-D7F5-57EC-87DA-1DB460D64046,"iPhone13,2"
com.letterboxd.LetterboxdApp,12,1750567313,1750567325,1750567325.078511,-18000,EB445137-D7F5-57EC-87DA-1DB460D64046,"iPhone13,2"
com.apple.journal,673,1750566640,1750567313,1750567313.8555388,-18000,EB445137-D7F5-57EC-87DA-1DB460D64046,"iPhone13,2"
com.apple.CoreAuthUI,5,1750566640,1750566645,1750566645.264831,-18000,EB445137-D7F5-57EC-87DA-1DB460D64046,"iPhone13,2"
com.apple.Health,81,1750566558,1750566639,1750566639.111737,-18000,EB445137-D7F5-57EC-87DA-1DB460D64046,"iPhone13,2"
com.apple.mobiletimer,40,1750566510,1750566550,1750566550.15141,-18000,EB445137-D7F5-57EC-87DA-1DB460D64046,"iPhone13,2"
com.letterboxd.LetterboxdApp,422,1750566088,1750566510,1750566510.547715,-18000,EB445137-D7F5-57EC-87DA-1DB460D64046,"iPhone13,2"
com.google.Chrome,5,1750565873,1750565878,1750565878.9434218,-18000,,
com.apple.news,1,1750565872,1750565873,1750565873.779554,-18000,,
com.google.Chrome,794,1750565078,1750565872,1750565872.690023,-18000,,
com.apple.news,234,1750564417,1750564651,1750564651.8677402,-18000,EB445137-D7F5-57EC-87DA-1DB460D64046,"iPhone13,2"
com.google.Chrome,321,1750564057,1750564378,1750564378.391951,-18000,,
com.google.Chrome,1046,1750563004,1750564050,1750564050.5649328,-18000,,
com.google.Chrome,330,1750562633,1750562963,1750562963.870204,-18000,,
com.apple.news,107,1750561936,1750562043,1750562043.585113,-18000,EB445137-D7F5-57EC-87DA-1DB460D64046,"iPhone13,2"
com.google.Chrome,1110,1750561292,1750562402,1750562402.115459,-18000,,
com.google.Chrome,421,1750560313,1750560734,1750560734.81174,-18000,,
com.apple.news,8,1750560305,1750560313,1750560313.140589,-18000,,
com.google.Chrome,2,1750560303,1750560305,1750560305.169691,-18000,,
com.google.Chrome,513,1750559587,1750560100,1750560100.969064,-18000,,
com.apple.news,7,1750559580,1750559587,1750559587.305375,-18000,,
com.google.Chrome,262,1750559318,1750559580,1750559580.452126,-18000,,
com.apple.news,5,1750559313,1750559318,1750559318.309422,-18000,,
com.google.Chrome,2,1750559311,1750559313,1750559313.741191,-18000,,
com.google.Chrome,541,1750558731,1750559272,1750559273.00072,-18000,,
com.apple.news,13,1750558718,1750558731,1750558731.723652,-18000,,
com.google.Chrome,296,1750558422,1750558718,1750558718.109748,-18000,,
com.apple.news,14,1750558408,1750558422,1750558422.073055,-18000,,
com.google.Chrome,80,1750558328,1750558408,1750558408.3941221,-18000,,
com.apple.news,22,1750558306,1750558328,1750558328.662925,-18000,,
com.google.Chrome,176,1750558130,1750558306,1750558306.478993,-18000,,
com.apple.news,48,1750558082,1750558130,1750558130.3547769,-18000,,
com.google.Chrome,9,1750558073,1750558082,1750558082.040896,-18000,,
com.apple.news,29,1750558044,1750558073,1750558073.383864,-18000,,
com.google.Chrome,25,1750558019,1750558044,1750558044.750793,-18000,,
com.apple.news,26,1750557993,1750558019,1750558019.4787822,-18000,,
com.google.Chrome,35,1750557958,1750557993,1750557993.8082361,-18000,,
com.apple.news,9,1750557949,1750557958,1750557958.726124,-18000,,
com.google.Chrome,7,1750557942,1750557949,1750557950.024606,-18000,,
com.apple.news,10,1750557932,1750557942,1750557942.940888,-18000,,
com.google.Chrome,106,1750557826,1750557932,1750557932.608218,-18000,,
com.apple.news,2,1750557824,1750557826,1750557826.122196,-18000,,
com.google.Chrome,16,1750557808,1750557824,1750557824.550849,-18000,,
com.apple.news,10,1750557798,1750557808,1750557808.480324,-18000,,
com.google.Chrome,130,1750557668,1750557798,1750557798.957274,-18000,,
com.apple.news,8,1750557660,1750557668,1750557668.4914088,-18000,,
com.google.Chrome,940,1750556720,1750557660,1750557660.4939198,-18000,,
com.apple.news,3,1750556717,1750556720,1750556720.686821,-18000,,
com.google.Chrome,119,1750556598,1750556717,1750556717.678343,-18000,,
com.apple.news,124,1750556474,1750556598,1750556598.741946,-18000,,
com.google.Chrome,8,1750556466,1750556474,1750556474.8895721,-18000,,
com.google.Chrome,309,1750555844,1750556153,1750556153.82182,-18000,,
com.apple.news,4,1750555840,1750555844,1750555844.248986,-18000,,
com.google.Chrome,301,1750555539,1750555840,1750555840.227757,-18000,,
com.google.Chrome,361,1750555153,1750555514,1750555514.664897,-18000,,
com.google.Chrome,300,1750554452,1750554752,1750554753.019422,-18000,,
com.apple.news,4,1750554448,1750554452,1750554453.016031,-18000,,
com.google.Chrome,456,1750553992,1750554448,1750554448.9609752,-18000,,
com.apple.news,5,1750553987,1750553992,1750553992.408298,-18000,,
com.google.Chrome,2,1750553985,1750553987,1750553987.076974,-18000,,
com.apple.news,14,1750553971,1750553985,1750553985.104858,-18000,,
com.google.Chrome,346,1750553625,1750553971,1750553971.195984,-18000,,
com.apple.news,9,1750553616,1750553625,1750553625.4794888,-18000,,
com.google.Chrome,518,1750553098,1750553616,1750553616.206166,-18000,,
com.apple.news,3,1750553095,1750553098,1750553098.452293,-18000,,
com.google.Chrome,111,1750552984,1750553095,1750553095.786858,-18000,,
com.apple.news,20,1750552964,1750552984,1750552984.10784,-18000,,
com.google.Chrome,179,1750552785,1750552964,1750552964.983315,-18000,,
com.apple.news,9,1750552776,1750552785,1750552785.849454,-18000,,
com.google.Chrome,22,1750552754,1750552776,1750552776.5017781,-18000,,
com.apple.news,8,1750552746,1750552754,1750552754.47148,-18000,,
com.google.Chrome,69,1750552677,1750552746,1750552746.734626,-18000,,
com.apple.news,49,1750552628,1750552677,1750552677.050932,-18000,,
com.google.Chrome,259,1750552369,1750552628,1750552628.2833881,-18000,,
com.google.Chrome,575,1750551475,1750552050,1750552050.523299,-18000,,
com.apple.MobileSMS,6,1750551469,1750551475,1750551475.798614,-18000,,
com.google.Chrome,5,1750551464,1750551469,1750551469.529407,-18000,,
com.google.Chrome,666,1750550708,1750551374,1750551374.663186,-18000,,
com.apple.finder,1,1750550707,1750550708,1750550709.18487,-18000,,
com.apple.Photos,2,1750550705,1750550707,1750550707.912561,-18000,,
com.apple.news,132,1750550418,1750550550,1750550551.085491,-18000,EB445137-D7F5-57EC-87DA-1DB460D64046,"iPhone13,2"
com.skyjos.fileexplorer,2,1750550416,1750550418,1750550418.537745,-18000,EB445137-D7F5-57EC-87DA-1DB460D64046,"iPhone13,2"
com.apple.Photos,208,1750549785,1750549993,1750549993.6669269,-18000,,
com.apple.finder,9,1750549776,1750549785,1750549785.356398,-18000,,
com.apple.Photos,1,1750549775,1750549776,1750549777.142511,-18000,,
com.apple.finder,10,1750549765,1750549775,1750549776.028415,-18000,,
com.leomehlig.today,2,1750549763,1750549765,1750549766.007124,-18000,,
com.google.Chrome,4,1750549759,1750549763,1750549763.451933,-18000,,
com.skyjos.fileexplorer,41,1750549667,1750549708,1750549708.655853,-18000,EB445137-D7F5-57EC-87DA-1DB460D64046,"iPhone13,2"
com.apple.news,2,1750549643,1750549645,1750549645.873588,-18000,EB445137-D7F5-57EC-87DA-1DB460D64046,"iPhone13,2"
com.apple.news,68,1750549318,1750549386,1750549386.418336,-18000,EB445137-D7F5-57EC-87DA-1DB460D64046,"iPhone13,2"
com.apple.MobileSMS,2,1750549314,1750549316,1750549316.535598,-18000,EB445137-D7F5-57EC-87DA-1DB460D64046,"iPhone13,2"
com.facebook.Facebook,0,1750549314,1750549314,1750549314.774706,-18000,EB445137-D7F5-57EC-87DA-1DB460D64046,"iPhone13,2"
com.facebook.Facebook,24,1750547872,1750547896,1750547897.135814,-18000,EB445137-D7F5-57EC-87DA-1DB460D64046,"iPhone13,2"
com.google.Chrome,534,1750547858,1750548392,1750548393.039454,-18000,,
com.apple.PeopleViewService,14,1750547855,1750547869,1750547869.4513211,-18000,EB445137-D7F5-57EC-87DA-1DB460D64046,"iPhone13,2"
com.toyopagroup.picaboo,18,1750547835,1750547853,1750547853.756702,-18000,EB445137-D7F5-57EC-87DA-1DB460D64046,"iPhone13,2"
com.apple.iCal,134,1750547724,1750547858,1750547858.2250118,-18000,,
com.leomehlig.today,28,1750547696,1750547724,1750547724.3961248,-18000,,
com.microsoft.VSCode,3,1750547693,1750547696,1750547696.9400291,-18000,,
com.google.Chrome,69,1750547624,1750547693,1750547694.040674,-18000,,
com.apple.Notes,36,1750547559,1750547595,1750547595.7159991,-18000,,
com.google.Chrome,1,1750547558,1750547559,1750547559.276753,-18000,,
com.apple.Notes,18,1750547540,1750547558,1750547558.11026,-18000,,
com.google.Chrome,1300,1750546240,1750547540,1750547540.284306,-18000,,
com.microsoft.VSCode,1,1750546239,1750546240,1750546240.5704808,-18000,,
com.apple.Notes,2,1750546237,1750546239,1750546239.234539,-18000,,
com.google.Chrome,171,1750546066,1750546237,1750546237.941163,-18000,,
com.microsoft.VSCode,215,1750545851,1750546066,1750546067.0591888,-18000,,
com.google.Chrome,8,1750545843,1750545851,1750545851.845588,-18000,,
com.leomehlig.today,12,1750545831,1750545843,1750545843.978744,-18000,,
com.google.Chrome,733,1750545098,1750545831,1750545831.9525928,-18000,,
com.apple.Notes,6,1750545092,1750545098,1750545098.2699618,-18000,,
com.apple.finder,6,1750545086,1750545092,1750545092.833521,-18000,,
com.google.Chrome,31,1750545055,1750545086,1750545086.7588181,-18000,,
com.apple.finder,19,1750545036,1750545055,1750545055.473438,-18000,,
com.google.Chrome,8,1750545028,1750545036,1750545036.486507,-18000,,
com.microsoft.VSCode,35,1750544993,1750545028,1750545028.76656,-18000,,
com.microsoft.VSCode,300,1750544259,1750544559,1750544559.834002,-18000,,
com.leomehlig.today,46,1750544213,1750544259,1750544259.742365,-18000,,
com.microsoft.VSCode,148,1750544065,1750544213,1750544213.5652661,-18000,,
com.google.Chrome,7,1750544058,1750544065,1750544065.904632,-18000,,
com.apple.CoreAuthUI,11,1750543962,1750543973,1750543973.6015968,-18000,EB445137-D7F5-57EC-87DA-1DB460D64046,"iPhone13,2"
com.clairmail.fth.client,79,1750543958,1750544037,1750544037.3599849,-18000,EB445137-D7F5-57EC-87DA-1DB460D64046,"iPhone13,2"
com.apple.CoreAuthUI,1,1750543785,1750543786,1750543786.766697,-18000,EB445137-D7F5-57EC-87DA-1DB460D64046,"iPhone13,2"
com.truebill.truebillnative,175,1750543781,1750543956,1750543956.873524,-18000,EB445137-D7F5-57EC-87DA-1DB460D64046,"iPhone13,2"
com.microsoft.VSCode,285,1750543773,1750544058,1750544058.599306,-18000,,
com.apple.MobileSMS,2,1750543771,1750543773,1750543773.9945102,-18000,,
com.microsoft.VSCode,5,1750543766,1750543771,1750543771.8047261,-18000,,
com.apple.MobileSMS,13,1750543753,1750543766,1750543766.502472,-18000,,
com.microsoft.VSCode,2,1750543751,1750543753,1750543753.115749,-18000,,
com.apple.MobileSMS,6,1750543745,1750543751,1750543751.242813,-18000,,
com.microsoft.VSCode,222,1750543523,1750543745,1750543745.433074,-18000,,
com.google.Chrome,1,1750543522,1750543523,1750543523.6739058,-18000,,
com.microsoft.VSCode,62,1750543460,1750543522,1750543522.758389,-18000,,
com.google.Chrome,13,1750543447,1750543460,1750543460.912335,-18000,,
com.apple.Notes,1,1750543446,1750543447,1750543447.756176,-18000,,
com.microsoft.VSCode,6,1750543440,1750543446,1750543446.569028,-18000,,
com.google.Chrome,2,1750543438,1750543440,1750543440.887048,-18000,,
com.microsoft.VSCode,1,1750543437,1750543438,1750543438.5052872,-18000,,
com.google.Chrome,1,1750543436,1750543437,1750543437.468302,-18000,,
com.microsoft.VSCode,3,1750543433,1750543436,1750543436.13667,-18000,,
com.google.Chrome,4,1750543429,1750543433,1750543433.697826,-18000,,
com.microsoft.VSCode,5,1750543424,1750543429,1750543429.8826818,-18000,,
com.google.Chrome,1,1750543423,1750543424,1750543424.998602,-18000,,
com.microsoft.VSCode,4,1750543419,1750543423,1750543423.2907848,-18000,,
com.google.Chrome,4,1750543415,1750543419,1750543419.230606,-18000,,
com.facebook.Facebook,387,1750543129,1750543516,1750543516.125778,-18000,EB445137-D7F5-57EC-87DA-1DB460D64046,"iPhone13,2"
Astrospheric.Astrospheric,67,1750543060,1750543127,1750543127.559441,-18000,EB445137-D7F5-57EC-87DA-1DB460D64046,"iPhone13,2"
com.apple.weather,60,1750542999,1750543059,1750543059.216284,-18000,EB445137-D7F5-57EC-87DA-1DB460D64046,"iPhone13,2"
com.apple.news,23,1750542975,1750542998,1750542998.81876,-18000,EB445137-D7F5-57EC-87DA-1DB460D64046,"iPhone13,2"
com.letterboxd.LetterboxdApp,0,1750542975,1750542975,1750542978.102614,-18000,EB445137-D7F5-57EC-87DA-1DB460D64046,"iPhone13,2"
com.microsoft.VSCode,672,1750542743,1750543415,1750543415.158483,-18000,,
com.google.Chrome,10,1750542733,1750542743,1750542743.483695,-18000,,
com.microsoft.VSCode,97,1750542636,1750542733,1750542733.8819342,-18000,,
com.google.Chrome,16,1750542620,1750542636,1750542636.501467,-18000,,
com.apple.Notes,1,1750542619,1750542620,1750542620.798345,-18000,,
com.google.Chrome,5,1750542614,1750542619,1750542619.589899,-18000,,
com.apple.Notes,0,1750542614,1750542614,1750542614.5204458,-18000,,
com.google.Chrome,21,1750542593,1750542614,1750542614.087048,-18000,,
com.apple.Notes,8,1750542585,1750542593,1750542593.69765,-18000,,
com.google.Chrome,13,1750542572,1750542585,1750542585.715419,-18000,,
com.microsoft.VSCode,16,1750542556,1750542572,1750542572.469585,-18000,,
com.apple.Notes,1,1750542555,1750542556,1750542556.524671,-18000,,
com.google.Chrome,18,1750542537,1750542555,1750542556.152969,-18000,,
com.apple.finder,8,1750542529,1750542537,1750542537.329558,-18000,,
com.apple.MobileSMS,21,1750540918,1750540939,1750540939.841648,-18000,EB445137-D7F5-57EC-87DA-1DB460D64046,"iPhone13,2"
com.google.chrome.ios,95,1750540822,1750540917,1750540918.443541,-18000,EB445137-D7F5-57EC-87DA-1DB460D64046,"iPhone13,2"
com.apple.MobileSMS,2,1750540820,1750540822,1750540822.279755,-18000,EB445137-D7F5-57EC-87DA-1DB460D64046,"iPhone13,2"
com.apple.AppStore,59,1750537278,1750537337,1750537338.054716,-18000,EB445137-D7F5-57EC-87DA-1DB460D64046,"iPhone13,2"
com.strava.stravaride,190,1750537028,1750537218,1750537218.5580912,-18000,EB445137-D7F5-57EC-87DA-1DB460D64046,"iPhone13,2"
com.apple.news,993,1750535960,1750536953,1750536954.001426,-18000,EB445137-D7F5-57EC-87DA-1DB460D64046,"iPhone13,2"
com.apple.mobilecal,2,1750535648,1750535650,1750535650.971581,-18000,EB445137-D7F5-57EC-87DA-1DB460D64046,"iPhone13,2"
com.apple.mobilecal,107,1750535164,1750535271,1750535271.142268,-18000,EB445137-D7F5-57EC-87DA-1DB460D64046,"iPhone13,2"
com.apple.Maps,1,1750535163,1750535164,1750535164.564417,-18000,EB445137-D7F5-57EC-87DA-1DB460D64046,"iPhone13,2"
com.apple.MobileSMS,2,1750535150,1750535152,1750535152.521793,-18000,EB445137-D7F5-57EC-87DA-1DB460D64046,"iPhone13,2"
com.apple.MobileSMS,8,1750535129,1750535137,1750535137.548209,-18000,EB445137-D7F5-57EC-87DA-1DB460D64046,"iPhone13,2"
com.apple.weather,0,1750535129,1750535129,1750535130.357198,-18000,EB445137-D7F5-57EC-87DA-1DB460D64046,"iPhone13,2"
com.apple.weather,14,1750534013,1750534027,1750534027.747473,-18000,EB445137-D7F5-57EC-87DA-1DB460D64046,"iPhone13,2"
com.apple.news,1,1750534012,1750534013,1750534013.286104,-18000,EB445137-D7F5-57EC-87DA-1DB460D64046,"iPhone13,2"
com.apple.news,33,1750533902,1750533935,1750533935.419735,-18000,EB445137-D7F5-57EC-87DA-1DB460D64046,"iPhone13,2"
com.apple.news,50,1750532750,1750532800,1750532800.197289,-18000,EB445137-D7F5-57EC-87DA-1DB460D64046,"iPhone13,2"
com.apple.findmy,2,1750532748,1750532750,1750532751.219281,-18000,EB445137-D7F5-57EC-87DA-1DB460D64046,"iPhone13,2"
com.apple.findmy,5,1750531691,1750531696,1750531697.2576342,-18000,EB445137-D7F5-57EC-87DA-1DB460D64046,"iPhone13,2"
com.apple.MobileSMS,42,1750531643,1750531685,1750531685.875509,-18000,EB445137-D7F5-57EC-87DA-1DB460D64046,"iPhone13,2"
com.apple.MobileSMS,21,1750531606,1750531627,1750531627.932743,-18000,EB445137-D7F5-57EC-87DA-1DB460D64046,"iPhone13,2"
com.apple.CoreAuthUI,1,1750531600,1750531601,1750531601.899918,-18000,EB445137-D7F5-57EC-87DA-1DB460D64046,"iPhone13,2"
com.clairmail.fth.client,9,1750531597,1750531606,1750531606.18379,-18000,EB445137-D7F5-57EC-87DA-1DB460D64046,"iPhone13,2"
com.apple.MobileSMS,2,1750531587,1750531589,1750531589.765043,-18000,EB445137-D7F5-57EC-87DA-1DB460D64046,"iPhone13,2"
com.apple.MobileSMS,101,1750531486,1750531587,1750531587.597218,-18000,EB445137-D7F5-57EC-87DA-1DB460D64046,"iPhone13,2"
com.apple.findmy,2,1750531326,1750531328,1750531329.178148,-18000,EB445137-D7F5-57EC-87DA-1DB460D64046,"iPhone13,2"
com.apple.findmy,9,1750530711,1750530720,1750530721.856614,-18000,EB445137-D7F5-57EC-87DA-1DB460D64046,"iPhone13,2"
com.apple.Music,3,1750530708,1750530711,1750530711.222332,-18000,EB445137-D7F5-57EC-87DA-1DB460D64046,"iPhone13,2"
com.apple.Music,134,1750524817,1750524951,1750524951.954255,-18000,EB445137-D7F5-57EC-87DA-1DB460D64046,"iPhone13,2"
com.apple.podcasts,2,1750524812,1750524814,1750524814.95437,-18000,EB445137-D7F5-57EC-87DA-1DB460D64046,"iPhone13,2"
com.apple.podcasts,69,1750520806,1750520875,1750520875.399364,-18000,EB445137-D7F5-57EC-87DA-1DB460D64046,"iPhone13,2"
com.apple.podcasts,55,1750519974,1750520029,1750520029.646169,-18000,EB445137-D7F5-57EC-87DA-1DB460D64046,"iPhone13,2"
com.apple.calculator,2,1750519968,1750519970,1750519970.177668,-18000,EB445137-D7F5-57EC-87DA-1DB460D64046,"iPhone13,2"
com.apple.calculator,19,1750519349,1750519368,1750519368.8067079,-18000,EB445137-D7F5-57EC-87DA-1DB460D64046,"iPhone13,2"
com.truebill.truebillnative,7,1750519342,1750519349,1750519349.3706632,-18000,EB445137-D7F5-57EC-87DA-1DB460D64046,"iPhone13,2"
com.apple.calculator,31,1750519311,1750519342,1750519342.620338,-18000,EB445137-D7F5-57EC-87DA-1DB460D64046,"iPhone13,2"
com.truebill.truebillnative,3,1750519308,1750519311,1750519311.7534819,-18000,EB445137-D7F5-57EC-87DA-1DB460D64046,"iPhone13,2"
com.apple.calculator,2,1750519306,1750519308,1750519308.474539,-18000,EB445137-D7F5-57EC-87DA-1DB460D64046,"iPhone13,2"
com.truebill.truebillnative,10,1750519296,1750519306,1750519306.90063,-18000,EB445137-D7F5-57EC-87DA-1DB460D64046,"iPhone13,2"
com.apple.calculator,3,1750519293,1750519296,1750519296.44439,-18000,EB445137-D7F5-57EC-87DA-1DB460D64046,"iPhone13,2"
com.apple.CoreAuthUI,1,1750519272,1750519273,1750519273.8264952,-18000,EB445137-D7F5-57EC-87DA-1DB460D64046,"iPhone13,2"
com.truebill.truebillnative,25,1750519268,1750519293,1750519293.560832,-18000,EB445137-D7F5-57EC-87DA-1DB460D64046,"iPhone13,2"
com.apple.news,2,1750519265,1750519267,1750519267.074419,-18000,EB445137-D7F5-57EC-87DA-1DB460D64046,"iPhone13,2"
com.apple.news,31,1750519201,1750519232,1750519232.912597,-18000,EB445137-D7F5-57EC-87DA-1DB460D64046,"iPhone13,2"
com.apple.news,35,1750519091,1750519126,1750519126.836757,-18000,EB445137-D7F5-57EC-87DA-1DB460D64046,"iPhone13,2"
com.facebook.Facebook,311,1750515705,1750516016,1750516016.120829,-18000,EB445137-D7F5-57EC-87DA-1DB460D64046,"iPhone13,2"
com.apple.Health,14,1750515672,1750515686,1750515686.479916,-18000,EB445137-D7F5-57EC-87DA-1DB460D64046,"iPhone13,2"
com.google.chrome.ios,232,1750483039,1750483271,1750483271.302908,-18000,EB445137-D7F5-57EC-87DA-1DB460D64046,"iPhone13,2"
com.apple.news,1,1750483038,1750483039,1750483039.96342,-18000,EB445137-D7F5-57EC-87DA-1DB460D64046,"iPhone13,2"
com.apple.news,163,1750480640,1750480803,1750480804.105832,-18000,EB445137-D7F5-57EC-87DA-1DB460D64046,"iPhone13,2"
com.apple.weather,6,1750480634,1750480640,1750480640.959513,-18000,EB445137-D7F5-57EC-87DA-1DB460D64046,"iPhone13,2"
com.apple.news,101,1750480533,1750480634,1750480634.951441,-18000,EB445137-D7F5-57EC-87DA-1DB460D64046,"iPhone13,2"
com.apple.news,146,1750476420,1750476566,1750476566.737722,-18000,EB445137-D7F5-57EC-87DA-1DB460D64046,"iPhone13,2"
com.apple.news,52,1750472450,1750472502,1750472503.0078769,-18000,EB445137-D7F5-57EC-87DA-1DB460D64046,"iPhone13,2"
com.letterboxd.LetterboxdApp,3,1750472435,1750472438,1750472438.558996,-18000,EB445137-D7F5-57EC-87DA-1DB460D64046,"iPhone13,2"
com.letterboxd.LetterboxdApp,62,1750466398,1750466460,1750466460.400481,-18000,EB445137-D7F5-57EC-87DA-1DB460D64046,"iPhone13,2"
com.google.chrome.ios,48,1750466347,1750466395,1750466395.6574159,-18000,EB445137-D7F5-57EC-87DA-1DB460D64046,"iPhone13,2"
com.apple.news,2,1750466344,1750466346,1750466346.676039,-18000,EB445137-D7F5-57EC-87DA-1DB460D64046,"iPhone13,2"
com.apple.news,218,1750465219,1750465437,1750465437.4971972,-18000,EB445137-D7F5-57EC-87DA-1DB460D64046,"iPhone13,2"
com.apple.news,316,1750464894,1750465210,1750465211.196034,-18000,EB445137-D7F5-57EC-87DA-1DB460D64046,"iPhone13,2"
com.google.chrome.ios,2,1750464892,1750464894,1750464894.768746,-18000,EB445137-D7F5-57EC-87DA-1DB460D64046,"iPhone13,2"
com.google.chrome.ios,18,1750464845,1750464863,1750464863.7489681,-18000,EB445137-D7F5-57EC-87DA-1DB460D64046,"iPhone13,2"
com.apple.news,3,1750464842,1750464845,1750464845.731964,-18000,EB445137-D7F5-57EC-87DA-1DB460D64046,"iPhone13,2"
com.google.chrome.ios,24,1750464818,1750464842,1750464842.251651,-18000,EB445137-D7F5-57EC-87DA-1DB460D64046,"iPhone13,2"
com.apple.news,242,1750464576,1750464818,1750464819.3357182,-18000,EB445137-D7F5-57EC-87DA-1DB460D64046,"iPhone13,2"
com.apple.news,52,1750464413,1750464465,1750464465.088139,-18000,EB445137-D7F5-57EC-87DA-1DB460D64046,"iPhone13,2"
com.apple.news,508,1750463868,1750464376,1750464376.941684,-18000,EB445137-D7F5-57EC-87DA-1DB460D64046,"iPhone13,2"
com.apple.Maps,1,1750463867,1750463868,1750463868.618057,-18000,EB445137-D7F5-57EC-87DA-1DB460D64046,"iPhone13,2"
com.apple.Maps,10,1750461561,1750461571,1750461571.2357678,-18000,EB445137-D7F5-57EC-87DA-1DB460D64046,"iPhone13,2"
com.google.chrome.ios,5,1750461556,1750461561,1750461561.082323,-18000,EB445137-D7F5-57EC-87DA-1DB460D64046,"iPhone13,2"
com.google.chrome.ios,122,1750461008,1750461130,1750461130.87024,-18000,EB445137-D7F5-57EC-87DA-1DB460D64046,"iPhone13,2"
com.google.chrome.ios,22,1750460542,1750460564,1750460564.316473,-18000,EB445137-D7F5-57EC-87DA-1DB460D64046,"iPhone13,2"
com.google.chrome.ios,6,1750460528,1750460534,1750460535.013737,-18000,EB445137-D7F5-57EC-87DA-1DB460D64046,"iPhone13,2"
com.google.chrome.ios,290,1750460204,1750460494,1750460495.227981,-18000,EB445137-D7F5-57EC-87DA-1DB460D64046,"iPhone13,2"
com.google.chrome.ios,31,1750460173,1750460204,1750460204.874922,-18000,EB445137-D7F5-57EC-87DA-1DB460D64046,"iPhone13,2"
com.apple.MobileSMS,2,1750460171,1750460173,1750460174.0323281,-18000,EB445137-D7F5-57EC-87DA-1DB460D64046,"iPhone13,2"
com.apple.MobileSMS,8,1750457028,1750457036,1750457036.3358788,-18000,EB445137-D7F5-57EC-87DA-1DB460D64046,"iPhone13,2"
com.apple.MobileSMS,29,1750454267,1750454296,1750454296.680685,-18000,EB445137-D7F5-57EC-87DA-1DB460D64046,"iPhone13,2"
com.apple.news,3,1750449774,1750449777,1750449777.748177,-18000,EB445137-D7F5-57EC-87DA-1DB460D64046,"iPhone13,2"
com.apple.news,132,1750449073,1750449205,1750449205.952935,-18000,EB445137-D7F5-57EC-87DA-1DB460D64046,"iPhone13,2"
com.apple.news,16,1750447822,1750447838,1750447838.686269,-18000,EB445137-D7F5-57EC-87DA-1DB460D64046,"iPhone13,2"
com.google.chrome.ios,2,1750445300,1750445302,1750445302.381736,-18000,EB445137-D7F5-57EC-87DA-1DB460D64046,"iPhone13,2"
com.google.chrome.ios,44,1750442957,1750443001,1750443001.899914,-18000,EB445137-D7F5-57EC-87DA-1DB460D64046,"iPhone13,2"
com.apple.weather,2,1750442955,1750442957,1750442957.4050841,-18000,EB445137-D7F5-57EC-87DA-1DB460D64046,"iPhone13,2"
com.apple.weather,24,1750440116,1750440140,1750440140.587187,-18000,EB445137-D7F5-57EC-87DA-1DB460D64046,"iPhone13,2"
com.google.chrome.ios,1,1750440115,1750440116,1750440116.4390202,-18000,EB445137-D7F5-57EC-87DA-1DB460D64046,"iPhone13,2"
com.google.chrome.ios,3,1750438689,1750438692,1750438692.889061,-18000,EB445137-D7F5-57EC-87DA-1DB460D64046,"iPhone13,2"
com.google.chrome.ios,66,1750437418,1750437484,1750437485.058744,-18000,EB445137-D7F5-57EC-87DA-1DB460D64046,"iPhone13,2"
com.apple.news,317,1750433945,1750434262,1750434262.8281798,-18000,EB445137-D7F5-57EC-87DA-1DB460D64046,"iPhone13,2"
com.apple.weather,8,1750433937,1750433945,1750433945.311956,-18000,EB445137-D7F5-57EC-87DA-1DB460D64046,"iPhone13,2"
com.apple.news,345,1750433592,1750433937,1750433937.421396,-18000,EB445137-D7F5-57EC-87DA-1DB460D64046,"iPhone13,2"
com.google.chrome.ios,72,1750433520,1750433592,1750433592.287109,-18000,EB445137-D7F5-57EC-87DA-1DB460D64046,"iPhone13,2"
com.apple.news,16,1750433504,1750433520,1750433520.390645,-18000,EB445137-D7F5-57EC-87DA-1DB460D64046,"iPhone13,2"
com.google.chrome.ios,93,1750433411,1750433504,1750433504.575804,-18000,EB445137-D7F5-57EC-87DA-1DB460D64046,"iPhone13,2"
com.apple.news,782,1750432628,1750433410,1750433410.9696732,-18000,EB445137-D7F5-57EC-87DA-1DB460D64046,"iPhone13,2"
com.apple.Maps,4,1750432621,1750432625,1750432625.513037,-18000,EB445137-D7F5-57EC-87DA-1DB460D64046,"iPhone13,2"
com.apple.Maps,66,1750432407,1750432473,1750432473.3097591,-18000,EB445137-D7F5-57EC-87DA-1DB460D64046,"iPhone13,2"
com.google.chrome.ios,2,1750432405,1750432407,1750432407.448755,-18000,EB445137-D7F5-57EC-87DA-1DB460D64046,"iPhone13,2"
com.google.chrome.ios,29,1750432368,1750432397,1750432397.764762,-18000,EB445137-D7F5-57EC-87DA-1DB460D64046,"iPhone13,2"
com.apple.news,457,1750428720,1750429177,1750429177.753047,-18000,EB445137-D7F5-57EC-87DA-1DB460D64046,"iPhone13,2"
com.apple.news,470,1750428224,1750428694,1750428694.900199,-18000,EB445137-D7F5-57EC-87DA-1DB460D64046,"iPhone13,2"
com.apple.mobiletimer,3,1750428209,1750428212,1750428212.2266269,-18000,EB445137-D7F5-57EC-87DA-1DB460D64046,"iPhone13,2"
com.apple.mobiletimer,2,1750428199,1750428201,1750428201.287889,-18000,EB445137-D7F5-57EC-87DA-1DB460D64046,"iPhone13,2"
com.apple.mobiletimer,8,1750424426,1750424434,1750424434.2763581,-18000,EB445137-D7F5-57EC-87DA-1DB460D64046,"iPhone13,2"
com.apple.mobiletimer,8,1750423753,1750423761,1750423761.51897,-18000,EB445137-D7F5-57EC-87DA-1DB460D64046,"iPhone13,2"
com.apple.Music,27,1750401642,1750401669,1750401669.665637,-18000,EB445137-D7F5-57EC-87DA-1DB460D64046,"iPhone13,2"
com.apple.Music,32,1750401346,1750401378,1750401378.17728,-18000,EB445137-D7F5-57EC-87DA-1DB460D64046,"iPhone13,2"
com.apple.Music,11,1750401237,1750401248,1750401248.3151069,-18000,EB445137-D7F5-57EC-87DA-1DB460D64046,"iPhone13,2"
com.apple.news,2,1750401235,1750401237,1750401237.616972,-18000,EB445137-D7F5-57EC-87DA-1DB460D64046,"iPhone13,2"
com.apple.news,111,1750400866,1750400977,1750400977.985219,-18000,EB445137-D7F5-57EC-87DA-1DB460D64046,"iPhone13,2"
com.apple.MobileSMS,13,1750400831,1750400844,1750400844.326486,-18000,EB445137-D7F5-57EC-87DA-1DB460D64046,"iPhone13,2"
com.apple.Music,2,1750400826,1750400828,1750400828.451414,-18000,EB445137-D7F5-57EC-87DA-1DB460D64046,"iPhone13,2"
com.apple.Music,111,1750400713,1750400824,1750400824.246813,-18000,EB445137-D7F5-57EC-87DA-1DB460D64046,"iPhone13,2"
com.apple.news,2,1750400711,1750400713,1750400713.8523479,-18000,EB445137-D7F5-57EC-87DA-1DB460D64046,"iPhone13,2"
com.apple.news,34,1750400515,1750400549,1750400549.990783,-18000,EB445137-D7F5-57EC-87DA-1DB460D64046,"iPhone13,2"
com.apple.Music,0,1750400515,1750400515,1750400515.7252312,-18000,EB445137-D7F5-57EC-87DA-1DB460D64046,"iPhone13,2"
com.apple.Music,133,1750400361,1750400494,1750400494.6770391,-18000,EB445137-D7F5-57EC-87DA-1DB460D64046,"iPhone13,2"
com.apple.news,7,1750400354,1750400361,1750400362.010943,-18000,EB445137-D7F5-57EC-87DA-1DB460D64046,"iPhone13,2"
com.apple.Music,0,1750400354,1750400354,1750400355.882308,-18000,EB445137-D7F5-57EC-87DA-1DB460D64046,"iPhone13,2"
com.apple.Music,231,1750399472,1750399703,1750399703.734071,-18000,EB445137-D7F5-57EC-87DA-1DB460D64046,"iPhone13,2"
com.apple.Preferences,20,1750399450,1750399470,1750399470.279749,-18000,EB445137-D7F5-57EC-87DA-1DB460D64046,"iPhone13,2"
com.apple.Maps,6,1750399444,1750399450,1750399450.390543,-18000,EB445137-D7F5-57EC-87DA-1DB460D64046,"iPhone13,2"
com.apple.Maps,74,1750393833,1750393907,1750393907.845923,-18000,EB445137-D7F5-57EC-87DA-1DB460D64046,"iPhone13,2"
com.google.chrome.ios,1,1750393832,1750393833,1750393833.785536,-18000,EB445137-D7F5-57EC-87DA-1DB460D64046,"iPhone13,2"
com.google.chrome.ios,3,1750393817,1750393820,1750393820.2462711,-18000,EB445137-D7F5-57EC-87DA-1DB460D64046,"iPhone13,2"
com.apple.finder,4,1750368914,1750368918,1750368918.187079,-18000,,
com.apple.Music,100,1750368814,1750368914,1750368914.471477,-18000,,
com.apple.finder,4,1750368810,1750368814,1750368814.159852,-18000,,
com.apple.finder,74,1750368730,1750368804,1750368804.349566,-18000,,
com.apple.finder,2,1750368721,1750368723,1750368723.619009,-18000,,
com.leomehlig.today,3,1750368718,1750368721,1750368721.89218,-18000,,
com.google.Chrome,3,1750368715,1750368718,1750368718.3487759,-18000,,
com.apple.MobileSMS,1,1750368714,1750368715,1750368715.798804,-18000,,
com.google.Chrome,41,1750368673,1750368714,1750368714.656989,-18000,,
com.apple.MobileSMS,1,1750368672,1750368673,1750368673.63993,-18000,,
com.apple.Notes,3,1750368669,1750368672,1750368672.249946,-18000,,
com.apple.MobileSMS,5,1750368664,1750368669,1750368669.1647801,-18000,,
com.apple.Notes,1,1750368663,1750368664,1750368664.792175,-18000,,
com.apple.MobileSMS,7,1750368656,1750368663,1750368663.6326041,-18000,,
com.apple.Notes,1,1750368655,1750368656,1750368656.81602,-18000,,
com.google.Chrome,2,1750368653,1750368655,1750368655.608135,-18000,,
com.apple.finder,3,1750368650,1750368653,1750368653.2309952,-18000,,
com.microsoft.VSCode,19,1750368631,1750368650,1750368650.550719,-18000,,
com.apple.finder,2,1750368629,1750368631,1750368631.370071,-18000,,
com.google.Chrome,30,1750368599,1750368629,1750368630.004335,-18000,,
com.apple.finder,2,1750368597,1750368599,1750368599.5758681,-18000,,
com.google.Chrome,8,1750368589,1750368597,1750368597.963115,-18000,,
com.microsoft.VSCode,137,1750368452,1750368589,1750368589.5981069,-18000,,
com.google.Chrome,2,1750368450,1750368452,1750368452.1435928,-18000,,
com.microsoft.VSCode,2,1750368448,1750368450,1750368450.937693,-18000,,
com.google.Chrome,1,1750368447,1750368448,1750368448.787756,-18000,,
com.microsoft.VSCode,1,1750368446,1750368447,1750368448.0311089,-18000,,
com.google.Chrome,1,1750368445,1750368446,1750368446.545895,-18000,,
com.microsoft.VSCode,3,1750368442,1750368445,1750368445.3986459,-18000,,
com.google.Chrome,1,1750368441,1750368442,1750368442.33852,-18000,,
com.microsoft.VSCode,3,1750368438,1750368441,1750368441.5022712,-18000,,
com.google.Chrome,1,1750368437,1750368438,1750368438.365921,-18000,,
com.microsoft.VSCode,3,1750368434,1750368437,1750368437.312309,-18000,,
com.google.Chrome,1,1750368433,1750368434,1750368434.912341,-18000,,
com.microsoft.VSCode,0,1750368433,1750368433,1750368434.043995,-18000,,
com.google.Chrome,2,1750368431,1750368433,1750368433.274955,-18000,,
com.microsoft.VSCode,7,1750368424,1750368431,1750368431.867794,-18000,,
com.google.Chrome,1,1750368423,1750368424,1750368424.393085,-18000,,
com.microsoft.VSCode,2,1750368421,1750368423,1750368423.555632,-18000,,
com.google.Chrome,1,1750368420,1750368421,1750368421.738641,-18000,,
com.microsoft.VSCode,2,1750368418,1750368420,1750368420.56727,-18000,,
com.google.Chrome,1,1750368417,1750368418,1750368418.6448169,-18000,,
com.microsoft.VSCode,2,1750368415,1750368417,1750368417.8728971,-18000,,
com.google.Chrome,0,1750368415,1750368415,1750368415.9275641,-18000,,
com.microsoft.VSCode,4,1750368411,1750368415,1750368415.175591,-18000,,
com.google.Chrome,1,1750368410,1750368411,1750368412.015219,-18000,,
com.microsoft.VSCode,5,1750368405,1750368410,1750368411.078794,-18000,,
com.google.Chrome,1,1750368404,1750368405,1750368405.387872,-18000,,
com.microsoft.VSCode,3,1750368401,1750368404,1750368404.3482928,-18000,,
com.google.Chrome,1,1750368400,1750368401,1750368401.596902,-18000,,
com.microsoft.VSCode,3,1750368397,1750368400,1750368400.621438,-18000,,
com.google.Chrome,1,1750368396,1750368397,1750368398.0162,-18000,,
com.microsoft.VSCode,4,1750368392,1750368396,1750368396.727857,-18000,,
com.google.Chrome,1,1750368391,1750368392,1750368392.688489,-18000,,
com.microsoft.VSCode,8,1750368383,1750368391,1750368391.52565,-18000,,
com.google.Chrome,1,1750368382,1750368383,1750368383.550479,-18000,,
com.microsoft.VSCode,1,1750368381,1750368382,1750368382.43005,-18000,,
com.google.Chrome,1,1750368380,1750368381,1750368381.352419,-18000,,
com.microsoft.VSCode,3,1750368377,1750368380,1750368380.3885388,-18000,,
com.google.Chrome,1,1750368376,1750368377,1750368377.525744,-18000,,
com.microsoft.VSCode,5,1750368371,1750368376,1750368376.554714,-18000,,
com.google.Chrome,1,1750368370,1750368371,1750368371.922754,-18000,,
com.microsoft.VSCode,3,1750368367,1750368370,1750368370.976084,-18000,,
com.google.Chrome,4,1750368363,1750368367,1750368367.194037,-18000,,
com.microsoft.VSCode,6,1750368357,1750368363,1750368363.508105,-18000,,
com.google.Chrome,1,1750368356,1750368357,1750368357.846571,-18000,,
com.microsoft.VSCode,2,1750368354,1750368356,1750368356.8612862,-18000,,
com.google.Chrome,1,1750368353,1750368354,1750368354.4723759,-18000,,
com.microsoft.VSCode,4,1750368349,1750368353,1750368353.442223,-18000,,
com.google.Chrome,1,1750368348,1750368349,1750368349.940878,-18000,,
com.microsoft.VSCode,3,1750368345,1750368348,1750368348.9604359,-18000,,
com.google.Chrome,1,1750368344,1750368345,1750368345.6020842,-18000,,
com.microsoft.VSCode,5,1750368339,1750368344,1750368344.3732939,-18000,,
com.google.Chrome,3,1750368336,1750368339,1750368339.61426,-18000,,
com.microsoft.VSCode,6,1750368330,1750368336,1750368336.542347,-18000,,
com.google.Chrome,1,1750368329,1750368330,1750368330.727371,-18000,,
com.microsoft.VSCode,4,1750368325,1750368329,1750368329.9922528,-18000,,
com.google.Chrome,0,1750368325,1750368325,1750368326.0755749,-18000,,
com.microsoft.VSCode,4,1750368321,1750368325,1750368325.296932,-18000,,
com.google.Chrome,0,1750368321,1750368321,1750368321.995943,-18000,,
com.microsoft.VSCode,1,1750368320,1750368321,1750368321.358362,-18000,,
com.google.Chrome,1,1750368319,1750368320,1750368320.398426,-18000,,
com.microsoft.VSCode,3,1750368316,1750368319,1750368319.420113,-18000,,
com.google.Chrome,2,1750368314,1750368316,1750368316.262909,-18000,,
com.microsoft.VSCode,6,1750368308,1750368314,1750368314.774904,-18000,,
com.google.Chrome,2,1750368306,1750368308,1750368308.183631,-18000,,
com.microsoft.VSCode,6,1750368300,1750368306,1750368306.702121,-18000,,
com.google.Chrome,8,1750368292,1750368300,1750368300.906601,-18000,,
com.microsoft.VSCode,39,1750368253,1750368292,1750368292.9047651,-18000,,
com.google.Chrome,5,1750368248,1750368253,1750368253.1812968,-18000,,
com.microsoft.VSCode,13,1750368235,1750368248,1750368248.565668,-18000,,
com.apple.Notes,1,1750368234,1750368235,1750368235.096129,-18000,,
com.microsoft.VSCode,34,1750368200,1750368234,1750368234.188493,-18000,,
com.apple.Notes,2,1750368198,1750368200,1750368200.8588219,-18000,,
com.microsoft.VSCode,15,1750368183,1750368198,1750368198.807112,-18000,,
com.apple.Notes,2,1750368181,1750368183,1750368183.429302,-18000,,
com.microsoft.VSCode,15,1750368166,1750368181,1750368181.538157,-18000,,
com.apple.Notes,3,1750368163,1750368166,1750368166.30252,-18000,,
com.microsoft.VSCode,59,1750368104,1750368163,1750368163.671735,-18000,,
com.apple.Notes,6,1750368098,1750368104,1750368104.371552,-18000,,
com.microsoft.VSCode,45,1750368053,1750368098,1750368098.8499742,-18000,,
com.apple.Notes,1,1750368052,1750368053,1750368053.9090571,-18000,,
com.microsoft.VSCode,6,1750368046,1750368052,1750368052.339388,-18000,,
com.apple.Notes,7,1750368039,1750368046,1750368046.698072,-18000,,
com.microsoft.VSCode,30,1750368009,1750368039,1750368039.575657,-18000,,
com.apple.MobileSMS,7,1750368002,1750368009,1750368009.6765962,-18000,,
com.microsoft.VSCode,56,1750367946,1750368002,1750368002.902612,-18000,,
com.google.Chrome,36,1750367910,1750367946,1750367946.809896,-18000,,
com.microsoft.VSCode,667,1750367221,1750367888,1750367888.702904,-18000,,
com.apple.Notes,7,1750367214,1750367221,1750367221.902847,-18000,,
com.google.Chrome,7,1750367207,1750367214,1750367214.624228,-18000,,
com.apple.Notes,5,1750367202,1750367207,1750367207.838069,-18000,,
com.google.Chrome,6,1750367196,1750367202,1750367202.6143022,-18000,,
com.apple.Notes,16,1750367180,1750367196,1750367196.661061,-18000,,
com.google.Chrome,1,1750367179,1750367180,1750367180.518735,-18000,,
com.apple.Notes,1,1750367178,1750367179,1750367180.053654,-18000,,
com.google.Chrome,16,1750367162,1750367178,1750367178.254291,-18000,,
com.apple.Notes,130,1750367032,1750367162,1750367163.075592,-18000,,
com.apple.iCal,9,1750367023,1750367032,1750367032.905435,-18000,,
com.apple.Notes,2,1750367021,1750367023,1750367023.988663,-18000,,
com.leomehlig.today,63,1750366958,1750367021,1750367021.694793,-18000,,
com.apple.Notes,1,1750366957,1750366958,1750366958.955258,-18000,,
com.google.Chrome,2,1750366955,1750366957,1750366957.816753,-18000,,
com.microsoft.VSCode,79,1750366876,1750366955,1750366955.325726,-18000,,
com.google.Chrome,16,1750366860,1750366876,1750366876.255604,-18000,,
com.microsoft.VSCode,2,1750366858,1750366860,1750366860.868212,-18000,,
com.google.Chrome,23,1750366835,1750366858,1750366858.853125,-18000,,
com.apple.finder,2,1750366833,1750366835,1750366835.932849,-18000,,
com.apple.news,193,1750310299,1750310492,1750310492.9110742,-18000,EB445137-D7F5-57EC-87DA-1DB460D64046,"iPhone13,2"
com.goodreads.Goodreads,14,1750307755,1750307769,1750307769.595367,-18000,EB445137-D7F5-57EC-87DA-1DB460D64046,"iPhone13,2"
com.thestorygraph.thestorygraph,132,1750307623,1750307755,1750307755.182658,-18000,EB445137-D7F5-57EC-87DA-1DB460D64046,"iPhone13,2"
com.apple.Health,66,1750306870,1750306936,1750306936.7224631,-18000,EB445137-D7F5-57EC-87DA-1DB460D64046,"iPhone13,2"
com.apple.mobiletimer,28,1750306839,1750306867,1750306867.078702,-18000,EB445137-D7F5-57EC-87DA-1DB460D64046,"iPhone13,2"
com.apple.finder,1,1750306287,1750306288,1750306288.701432,-18000,,
com.leomehlig.today,22,1750306265,1750306287,1750306287.238699,-18000,,
com.apple.news,18,1750302131,1750302149,1750302149.9514399,-18000,EB445137-D7F5-57EC-87DA-1DB460D64046,"iPhone13,2"
com.thestorygraph.thestorygraph,7,1750302036,1750302043,1750302044.0075688,-18000,EB445137-D7F5-57EC-87DA-1DB460D64046,"iPhone13,2"
com.google.Chrome,5607,1750300658,1750306265,1750306265.938654,-18000,,
com.thestorygraph.thestorygraph,13,1750300611,1750300624,1750300625.177294,-18000,EB445137-D7F5-57EC-87DA-1DB460D64046,"iPhone13,2"
com.google.Chrome,1503,1750295553,1750297056,1750297056.776222,-18000,,
com.apple.MobileSMS,7,1750295546,1750295553,1750295553.662156,-18000,,
com.google.Chrome,1452,1750294094,1750295546,1750295546.9310598,-18000,,
com.apple.finder,6,1750294088,1750294094,1750294094.6548471,-18000,,
com.apple.news,151,1750293528,1750293679,1750293679.9170032,-18000,EB445137-D7F5-57EC-87DA-1DB460D64046,"iPhone13,2"
com.apple.findmy,22,1750293493,1750293515,1750293515.133184,-18000,EB445137-D7F5-57EC-87DA-1DB460D64046,"iPhone13,2"
com.doordash.dasher,3,1750293490,1750293493,1750293493.789984,-18000,EB445137-D7F5-57EC-87DA-1DB460D64046,"iPhone13,2"
com.apple.finder,3,1750293280,1750293283,1750293283.189146,-18000,,
com.apple.Notes,0,1750293280,1750293280,1750293281.0047,-18000,,
com.apple.finder,1,1750293279,1750293280,1750293280.223696,-18000,,
com.leomehlig.today,15,1750293264,1750293279,1750293279.492216,-18000,,
com.google.Chrome,118,1750293146,1750293264,1750293264.504215,-18000,,
com.apple.finder,4,1750293142,1750293146,1750293146.228317,-18000,,
com.google.Chrome,29,1750293113,1750293142,1750293142.419148,-18000,,
com.apple.finder,17,1750293096,1750293113,1750293114.023597,-18000,,
com.google.Chrome,154,1750292942,1750293096,1750293096.375227,-18000,,
com.apple.finder,15,1750292927,1750292942,1750292942.531632,-18000,,
com.google.Chrome,90,1750292837,1750292927,1750292927.500043,-18000,,
com.leomehlig.today,2,1750292835,1750292837,1750292837.088825,-18000,,
com.doordash.dasher,15,1750292778,1750292793,1750292793.859466,-18000,EB445137-D7F5-57EC-87DA-1DB460D64046,"iPhone13,2"
com.apple.MobileSMS,27,1750292711,1750292738,1750292738.971674,-18000,EB445137-D7F5-57EC-87DA-1DB460D64046,"iPhone13,2"
com.doordash.dasher,6,1750292582,1750292588,1750292588.411011,-18000,EB445137-D7F5-57EC-87DA-1DB460D64046,"iPhone13,2"
com.google.chrome.ios,3,1750292578,1750292581,1750292581.779189,-18000,EB445137-D7F5-57EC-87DA-1DB460D64046,"iPhone13,2"
com.microsoft.VSCode,263,1750292572,1750292835,1750292835.866646,-18000,,
com.google.Chrome,56,1750292516,1750292572,1750292572.1716452,-18000,,
com.leomehlig.today,5,1750292502,1750292507,1750292507.2344232,-18000,,
com.google.Chrome,3,1750292499,1750292502,1750292502.731471,-18000,,
com.microsoft.VSCode,102,1750292397,1750292499,1750292499.736098,-18000,,
com.google.Chrome,195,1750292202,1750292397,1750292397.8632689,-18000,,
com.microsoft.VSCode,17,1750292185,1750292202,1750292202.1373758,-18000,,
com.google.Chrome,309,1750291876,1750292185,1750292185.228529,-18000,,
com.google.chrome.ios,1,1750291866,1750291867,1750291868.0456328,-18000,EB445137-D7F5-57EC-87DA-1DB460D64046,"iPhone13,2"
com.apple.findmy,11,1750291846,1750291857,1750291858.041644,-18000,EB445137-D7F5-57EC-87DA-1DB460D64046,"iPhone13,2"
com.doordash.dasher,3,1750291840,1750291843,1750291844.11588,-18000,EB445137-D7F5-57EC-87DA-1DB460D64046,"iPhone13,2"
com.microsoft.VSCode,159,1750291717,1750291876,1750291876.1691341,-18000,,
com.google.Chrome,85,1750291632,1750291717,1750291717.152286,-18000,,
com.microsoft.VSCode,2,1750291630,1750291632,1750291632.5914679,-18000,,
com.google.Chrome,157,1750291473,1750291630,1750291630.77676,-18000,,
com.microsoft.VSCode,1,1750291472,1750291473,1750291473.796715,-18000,,
com.google.Chrome,384,1750291088,1750291472,1750291472.437376,-18000,,
com.apple.weather,4,1750291069,1750291073,1750291073.586827,-18000,EB445137-D7F5-57EC-87DA-1DB460D64046,"iPhone13,2"
com.doordash.dasher,9,1750291060,1750291069,1750291069.843153,-18000,EB445137-D7F5-57EC-87DA-1DB460D64046,"iPhone13,2"
com.strava.stravaride,7,1750291052,1750291059,1750291059.866575,-18000,EB445137-D7F5-57EC-87DA-1DB460D64046,"iPhone13,2"
com.apple.Maps,0,1750291052,1750291052,1750291054.1918411,-18000,EB445137-D7F5-57EC-87DA-1DB460D64046,"iPhone13,2"
com.apple.Maps,138,1750290712,1750290850,1750290850.8593578,-18000,EB445137-D7F5-57EC-87DA-1DB460D64046,"iPhone13,2"
com.apple.news,631,1750290080,1750290711,1750290711.687242,-18000,EB445137-D7F5-57EC-87DA-1DB460D64046,"iPhone13,2"
com.doordash.dasher,9,1750290069,1750290078,1750290078.0761971,-18000,EB445137-D7F5-57EC-87DA-1DB460D64046,"iPhone13,2"
com.microsoft.VSCode,1237,1750289851,1750291088,1750291088.3421578,-18000,,
com.google.Chrome,8,1750289843,1750289851,1750289851.962484,-18000,,
com.microsoft.VSCode,384,1750289459,1750289843,1750289843.808679,-18000,,
com.google.Chrome,14,1750289445,1750289459,1750289459.231343,-18000,,
com.microsoft.VSCode,57,1750289388,1750289445,1750289445.71349,-18000,,
com.apple.Notes,11,1750289377,1750289388,1750289389.002614,-18000,,
com.apple.finder,3,1750289374,1750289377,1750289377.872015,-18000,,
com.leomehlig.today,27,1750289347,1750289374,1750289374.592118,-18000,,
com.google.Chrome,9,1750289338,1750289347,1750289347.89719,-18000,,
com.doordash.dasher,8,1750289316,1750289324,1750289324.91389,-18000,EB445137-D7F5-57EC-87DA-1DB460D64046,"iPhone13,2"
Astrospheric.Astrospheric,28,1750289257,1750289285,1750289285.2032108,-18000,EB445137-D7F5-57EC-87DA-1DB460D64046,"iPhone13,2"
com.doordash.dasher,29,1750289227,1750289256,1750289256.182228,-18000,EB445137-D7F5-57EC-87DA-1DB460D64046,"iPhone13,2"
com.doordash.dasher,57,1750289170,1750289227,1750289227.564719,-18000,EB445137-D7F5-57EC-87DA-1DB460D64046,"iPhone13,2"
com.doordash.dasher,35,1750289082,1750289117,1750289117.401616,-18000,EB445137-D7F5-57EC-87DA-1DB460D64046,"iPhone13,2"
com.robinhood.release.Robinhood,1,1750289081,1750289082,1750289082.7799711,-18000,EB445137-D7F5-57EC-87DA-1DB460D64046,"iPhone13,2"
com.doordash.dasher,63,1750289017,1750289080,1750289080.074065,-18000,EB445137-D7F5-57EC-87DA-1DB460D64046,"iPhone13,2"
com.letterboxd.LetterboxdApp,141,1750288876,1750289017,1750289017.436856,-18000,EB445137-D7F5-57EC-87DA-1DB460D64046,"iPhone13,2"
com.apple.news,109,1750288766,1750288875,1750288875.34232,-18000,EB445137-D7F5-57EC-87DA-1DB460D64046,"iPhone13,2"
com.apple.findmy,7,1750288755,1750288762,1750288762.995121,-18000,EB445137-D7F5-57EC-87DA-1DB460D64046,"iPhone13,2"
com.doordash.dasher,3,1750288750,1750288753,1750288753.345031,-18000,EB445137-D7F5-57EC-87DA-1DB460D64046,"iPhone13,2"
com.doordash.dasher,10,1750288731,1750288741,1750288741.726798,-18000,EB445137-D7F5-57EC-87DA-1DB460D64046,"iPhone13,2"
com.apple.MobileSMS,5,1750288725,1750288730,1750288730.931046,-18000,EB445137-D7F5-57EC-87DA-1DB460D64046,"iPhone13,2"
com.apple.MobileSMS,4,1750288007,1750288011,1750288011.6185899,-18000,EB445137-D7F5-57EC-87DA-1DB460D64046,"iPhone13,2"
com.apple.MobileSMS,28,1750287937,1750287965,1750287965.9922109,-18000,EB445137-D7F5-57EC-87DA-1DB460D64046,"iPhone13,2"
com.apple.MobileSMS,11,1750287818,1750287829,1750287829.9871259,-18000,EB445137-D7F5-57EC-87DA-1DB460D64046,"iPhone13,2"
com.apple.CoreAuthUI,12,1750287663,1750287675,1750287675.958307,-18000,EB445137-D7F5-57EC-87DA-1DB460D64046,"iPhone13,2"
com.truebill.truebillnative,29,1750287658,1750287687,1750287687.882286,-18000,EB445137-D7F5-57EC-87DA-1DB460D64046,"iPhone13,2"
com.apple.weather,5,1750287641,1750287646,1750287646.477252,-18000,EB445137-D7F5-57EC-87DA-1DB460D64046,"iPhone13,2"
com.apple.weather,25,1750287463,1750287488,1750287488.865675,-18000,EB445137-D7F5-57EC-87DA-1DB460D64046,"iPhone13,2"
com.apple.MobileSMS,1,1750287462,1750287463,1750287463.921739,-18000,EB445137-D7F5-57EC-87DA-1DB460D64046,"iPhone13,2"
com.google.Chrome,93,1750286955,1750287048,1750287048.5686069,-18000,,
com.leomehlig.today,14,1750286929,1750286943,1750286943.9622889,-18000,,
com.apple.finder,3,1750286926,1750286929,1750286929.984375,-18000,,
com.microsoft.VSCode,2,1750286924,1750286926,1750286926.6397119,-18000,,
com.google.Chrome,12,1750286912,1750286924,1750286924.457098,-18000,,
com.apple.Notes,283,1750286629,1750286912,1750286912.4879441,-18000,,
com.google.Chrome,70,1750286559,1750286629,1750286629.846154,-18000,,
com.microsoft.VSCode,965,1750285594,1750286559,1750286559.7138271,-18000,,
com.google.Chrome,21,1750285573,1750285594,1750285594.709444,-18000,,
com.apple.MobileSMS,6,1750284906,1750284912,1750284913.094868,-18000,EB445137-D7F5-57EC-87DA-1DB460D64046,"iPhone13,2"
com.apple.MobileSMS,82,1750284797,1750284879,1750284880.030144,-18000,EB445137-D7F5-57EC-87DA-1DB460D64046,"iPhone13,2"
com.apple.MobileSMS,22,1750284377,1750284399,1750284400.0903711,-18000,EB445137-D7F5-57EC-87DA-1DB460D64046,"iPhone13,2"
com.apple.MobileSMS,4,1750284309,1750284313,1750284313.15642,-18000,EB445137-D7F5-57EC-87DA-1DB460D64046,"iPhone13,2"
com.apple.weather,45,1750284263,1750284308,1750284308.825511,-18000,EB445137-D7F5-57EC-87DA-1DB460D64046,"iPhone13,2"
com.apple.MobileSMS,153,1750284089,1750284242,1750284242.5451899,-18000,EB445137-D7F5-57EC-87DA-1DB460D64046,"iPhone13,2"
com.strava.stravaride,20,1750284069,1750284089,1750284089.255261,-18000,EB445137-D7F5-57EC-87DA-1DB460D64046,"iPhone13,2"
com.apple.findmy,0,1750284069,1750284069,1750284070.681256,-18000,EB445137-D7F5-57EC-87DA-1DB460D64046,"iPhone13,2"
com.microsoft.VSCode,2299,1750283274,1750285573,1750285573.685523,-18000,,
com.google.Chrome,8,1750283266,1750283274,1750283274.085441,-18000,,
com.microsoft.VSCode,22,1750283244,1750283266,1750283266.3000832,-18000,,
com.google.Chrome,1,1750283243,1750283244,1750283244.17248,-18000,,
com.microsoft.VSCode,1,1750283242,1750283243,1750283243.6932821,-18000,,
com.google.Chrome,34,1750283208,1750283242,1750283242.793258,-18000,,
com.microsoft.VSCode,7,1750283201,1750283208,1750283209.052244,-18000,,
com.google.Chrome,12,1750283189,1750283201,1750283201.9641008,-18000,,
com.microsoft.VSCode,4,1750283185,1750283189,1750283189.3269138,-18000,,
com.google.Chrome,42,1750283143,1750283185,1750283185.390708,-18000,,
com.microsoft.VSCode,51,1750283092,1750283143,1750283143.7850928,-18000,,
com.google.Chrome,1,1750283091,1750283092,1750283092.860568,-18000,,
com.microsoft.VSCode,12,1750283079,1750283091,1750283091.9129581,-18000,,
com.google.Chrome,2,1750283077,1750283079,1750283079.868493,-18000,,
com.microsoft.VSCode,32,1750283045,1750283077,1750283077.469938,-18000,,
com.google.Chrome,27,1750283018,1750283045,1750283045.796081,-18000,,
com.microsoft.VSCode,19,1750282999,1750283018,1750283018.543664,-18000,,
com.google.Chrome,1,1750282998,1750282999,1750282999.069618,-18000,,
com.microsoft.VSCode,9,1750282989,1750282998,1750282998.1159549,-18000,,
com.google.Chrome,1,1750282988,1750282989,1750282989.323248,-18000,,
com.microsoft.VSCode,1,1750282987,1750282988,1750282988.382175,-18000,,
com.google.Chrome,17,1750282970,1750282987,1750282987.191627,-18000,,
com.microsoft.VSCode,248,1750282722,1750282970,1750282970.814729,-18000,,
com.apple.finder,25,1750282697,1750282722,1750282722.3418698,-18000,,
com.microsoft.VSCode,77,1750282620,1750282697,1750282697.461844,-18000,,
com.google.Chrome,0,1750282620,1750282620,1750282620.5985088,-18000,,
com.microsoft.VSCode,44,1750282576,1750282620,1750282620.051111,-18000,,
com.google.Chrome,37,1750282539,1750282576,1750282576.461296,-18000,,
com.microsoft.VSCode,2,1750282537,1750282539,1750282539.804531,-18000,,
com.google.Chrome,15,1750282522,1750282537,1750282537.6055598,-18000,,
com.microsoft.VSCode,161,1750282361,1750282522,1750282522.136077,-18000,,
com.google.Chrome,22,1750282339,1750282361,1750282361.492094,-18000,,
com.apple.findmy,10,1750281952,1750281962,1750281962.981347,-18000,EB445137-D7F5-57EC-87DA-1DB460D64046,"iPhone13,2"
com.microsoft.VSCode,393,1750281946,1750282339,1750282339.818389,-18000,,
com.toyopagroup.picaboo,5,1750281941,1750281946,1750281946.301543,-18000,EB445137-D7F5-57EC-87DA-1DB460D64046,"iPhone13,2"
com.apple.findmy,0,1750281941,1750281941,1750281942.7617621,-18000,EB445137-D7F5-57EC-87DA-1DB460D64046,"iPhone13,2"
com.apple.findmy,35,1750281905,1750281940,1750281940.4793038,-18000,EB445137-D7F5-57EC-87DA-1DB460D64046,"iPhone13,2"
com.toyopagroup.picaboo,29,1750281875,1750281904,1750281904.8169699,-18000,EB445137-D7F5-57EC-87DA-1DB460D64046,"iPhone13,2"
com.apple.MobileSMS,11,1750281864,1750281875,1750281875.464058,-18000,EB445137-D7F5-57EC-87DA-1DB460D64046,"iPhone13,2"
com.toyopagroup.picaboo,70,1750281794,1750281864,1750281864.4478579,-18000,EB445137-D7F5-57EC-87DA-1DB460D64046,"iPhone13,2"
com.apple.findmy,2,1750281792,1750281794,1750281794.1775231,-18000,EB445137-D7F5-57EC-87DA-1DB460D64046,"iPhone13,2"
com.apple.findmy,8,1750281754,1750281762,1750281762.926117,-18000,EB445137-D7F5-57EC-87DA-1DB460D64046,"iPhone13,2"
com.microsoft.VSCode,529,1750281414,1750281943,1750281943.595632,-18000,,
com.google.Chrome,593,1750280821,1750281414,1750281414.877544,-18000,,
com.apple.findmy,108,1750280610,1750280718,1750280718.4462829,-18000,EB445137-D7F5-57EC-87DA-1DB460D64046,"iPhone13,2"
com.burbn.instagram,441,1750279963,1750280404,1750280404.5404592,-18000,EB445137-D7F5-57EC-87DA-1DB460D64046,"iPhone13,2"
com.apple.Maps,90,1750279873,1750279963,1750279963.165143,-18000,EB445137-D7F5-57EC-87DA-1DB460D64046,"iPhone13,2"
com.burbn.instagram,793,1750279076,1750279869,1750279869.710696,-18000,EB445137-D7F5-57EC-87DA-1DB460D64046,"iPhone13,2"
com.strava.stravaride,74,1750278998,1750279072,1750279072.734414,-18000,EB445137-D7F5-57EC-87DA-1DB460D64046,"iPhone13,2"
com.apple.weather,37,1750278947,1750278984,1750278984.5181642,-18000,EB445137-D7F5-57EC-87DA-1DB460D64046,"iPhone13,2"
com.apple.news,175,1750278771,1750278946,1750278946.776844,-18000,EB445137-D7F5-57EC-87DA-1DB460D64046,"iPhone13,2"
com.microsoft.Office.Outlook,15,1750278739,1750278754,1750278754.155597,-18000,EB445137-D7F5-57EC-87DA-1DB460D64046,"iPhone13,2"
com.google.Chrome,523,1750278495,1750279018,1750279018.2829251,-18000,,
com.apple.iCal,48,1750278447,1750278495,1750278495.981734,-18000,,
com.leomehlig.today,15,1750278432,1750278447,1750278447.766021,-18000,,
com.apple.finder,1,1750278431,1750278432,1750278432.714437,-18000,,
com.microsoft.VSCode,7,1750278424,1750278431,1750278431.481565,-18000,,
com.apple.finder,2,1750278422,1750278424,1750278424.9973369,-18000,,
com.apple.Preview,1,1750278421,1750278422,1750278422.5613198,-18000,,
com.apple.Notes,1,1750278420,1750278421,1750278421.074187,-18000,,
com.google.Chrome,14,1750278406,1750278420,1750278420.596714,-18000,,
us.zoom.xos,0,1750278406,1750278406,1750278407.152355,-18000,,
com.google.Chrome,11,1750278395,1750278406,1750278406.090376,-18000,,
us.zoom.xos,11,1750278384,1750278395,1750278395.311388,-18000,,
com.google.Chrome,114,1750278270,1750278384,1750278384.946878,-18000,,
com.apple.Notes,5,1750278265,1750278270,1750278270.204897,-18000,,
com.google.Chrome,942,1750277323,1750278265,1750278265.644366,-18000,,
com.apple.Preview,44,1750277279,1750277323,1750277323.419693,-18000,,
com.apple.finder,7,1750277272,1750277279,1750277279.530209,-18000,,
com.google.Chrome,31,1750277241,1750277272,1750277272.531909,-18000,,
com.apple.Preview,58,1750277183,1750277241,1750277241.544259,-18000,,
us.zoom.xos,2,1750277181,1750277183,1750277183.931884,-18000,,
com.apple.Preview,36,1750277137,1750277173,1750277173.24161,-18000,,
com.apple.finder,2,1750277135,1750277137,1750277137.76769,-18000,,
com.apple.Preview,1,1750277134,1750277135,1750277135.677201,-18000,,
com.apple.finder,9,1750277125,1750277134,1750277134.171809,-18000,,
us.zoom.xos,8,1750277117,1750277125,1750277125.0533252,-18000,,
com.google.Chrome,23,1750277094,1750277117,1750277117.3206902,-18000,,
us.zoom.xos,1,1750277093,1750277094,1750277094.863309,-18000,,
com.google.Chrome,81,1750277012,1750277093,1750277093.907819,-18000,,
us.zoom.xos,6,1750277006,1750277012,1750277012.070452,-18000,,
com.google.Chrome,13,1750276993,1750277006,1750277007.01651,-18000,,
us.zoom.xos,1,1750276992,1750276993,1750276993.5637999,-18000,,
com.google.Chrome,12,1750276980,1750276992,1750276992.27107,-18000,,
us.zoom.xos,1,1750276979,1750276980,1750276980.85281,-18000,,
com.google.Chrome,36,1750276943,1750276979,1750276979.863853,-18000,,
us.zoom.xos,1,1750276942,1750276943,1750276943.293436,-18000,,
com.google.Chrome,27,1750276915,1750276942,1750276942.5040278,-18000,,
us.zoom.xos,1,1750276914,1750276915,1750276915.328785,-18000,,
com.google.Chrome,3,1750276911,1750276914,1750276914.3889241,-18000,,
us.zoom.xos,7,1750276904,1750276911,1750276911.099747,-18000,,
com.google.Chrome,27,1750276877,1750276904,1750276904.798909,-18000,,
us.zoom.xos,13,1750276864,1750276877,1750276877.560872,-18000,,
com.google.Chrome,2,1750276862,1750276864,1750276864.208432,-18000,,
us.zoom.xos,25,1750276837,1750276862,1750276862.969489,-18000,,
com.google.Chrome,2,1750276835,1750276837,1750276837.547765,-18000,,
us.zoom.xos,1,1750276834,1750276835,1750276835.815491,-18000,,
com.google.Chrome,7,1750276827,1750276834,1750276834.536869,-18000,,
com.apple.Notes,20,1750276807,1750276827,1750276828.065798,-18000,,
com.google.Chrome,17,1750276790,1750276807,1750276807.107671,-18000,,
com.apple.news,122,1750276516,1750276638,1750276638.706172,-18000,EB445137-D7F5-57EC-87DA-1DB460D64046,"iPhone13,2"
com.google.Chrome,314,1750276403,1750276717,1750276717.736052,-18000,,
com.microsoft.VSCode,7,1750276396,1750276403,1750276403.132549,-18000,,
com.google.Chrome,8,1750276388,1750276396,1750276396.5841289,-18000,,
com.microsoft.VSCode,12,1750276376,1750276388,1750276388.433295,-18000,,
com.google.Chrome,3,1750276373,1750276376,1750276376.5931292,-18000,,
com.microsoft.VSCode,6,1750276367,1750276373,1750276373.8417149,-18000,,
com.google.Chrome,3,1750276364,1750276367,1750276368.0494251,-18000,,
com.microsoft.VSCode,6,1750276358,1750276364,1750276364.254784,-18000,,
com.google.Chrome,22,1750276336,1750276358,1750276358.727355,-18000,,
com.microsoft.VSCode,10,1750276326,1750276336,1750276336.192233,-18000,,
com.google.Chrome,8,1750276318,1750276326,1750276326.376347,-18000,,
com.microsoft.VSCode,4,1750276314,1750276318,1750276318.824315,-18000,,
com.google.Chrome,0,1750276314,1750276314,1750276315.054792,-18000,,
com.microsoft.VSCode,5,1750276309,1750276314,1750276314.3602018,-18000,,
com.google.Chrome,1,1750276308,1750276309,1750276309.712147,-18000,,
com.microsoft.VSCode,5,1750276303,1750276308,1750276308.604306,-18000,,
com.google.Chrome,4,1750276299,1750276303,1750276303.394518,-18000,,
com.microsoft.VSCode,11,1750276288,1750276299,1750276299.5191731,-18000,,
com.google.Chrome,3,1750276285,1750276288,1750276288.507338,-18000,,
com.microsoft.VSCode,1,1750276284,1750276285,1750276285.988079,-18000,,
com.google.Chrome,23,1750276261,1750276284,1750276285.014977,-18000,,
com.microsoft.VSCode,6,1750276255,1750276261,1750276261.8269439,-18000,,
com.google.Chrome,21,1750276234,1750276255,1750276255.560719,-18000,,
com.microsoft.VSCode,12,1750276222,1750276234,1750276234.584472,-18000,,
com.google.Chrome,18,1750276204,1750276222,1750276222.5795488,-18000,,
com.microsoft.VSCode,198,1750276006,1750276204,1750276205.033782,-18000,,
com.leomehlig.today,1,1750276005,1750276006,1750276006.9924688,-18000,,
com.google.Chrome,2,1750276003,1750276005,1750276006.057832,-18000,,
com.microsoft.VSCode,38,1750275965,1750276003,1750276003.398419,-18000,,
com.google.Chrome,17,1750275948,1750275965,1750275965.322465,-18000,,
com.microsoft.VSCode,28,1750275920,1750275948,1750275948.512693,-18000,,
com.google.Chrome,21,1750275899,1750275920,1750275920.747829,-18000,,
com.microsoft.VSCode,290,1750275609,1750275899,1750275899.199342,-18000,,
com.google.Chrome,37,1750275572,1750275609,1750275609.280096,-18000,,
com.microsoft.VSCode,4,1750275568,1750275572,1750275572.58494,-18000,,
com.google.Chrome,157,1750275411,1750275568,1750275568.1458812,-18000,,
com.apple.MobileSMS,5,1750274270,1750274275,1750274275.314733,-18000,EB445137-D7F5-57EC-87DA-1DB460D64046,"iPhone13,2"
com.microsoft.VSCode,1184,1750274227,1750275411,1750275411.349335,-18000,,
com.google.Chrome,33,1750274194,1750274227,1750274227.268289,-18000,,
com.leomehlig.today,19,1750274164,1750274183,1750274183.387089,-18000,,
com.google.Chrome,3,1750274161,1750274164,1750274164.528728,-18000,,
com.apple.Preview,200,1750273961,1750274161,1750274161.372562,-18000,,
com.google.Chrome,27,1750273934,1750273961,1750273961.678338,-18000,,
com.apple.Preview,15,1750273919,1750273934,1750273934.2857919,-18000,,
com.apple.Notes,11,1750273908,1750273919,1750273919.202826,-18000,,
com.apple.Preview,30,1750273878,1750273908,1750273908.575182,-18000,,
com.apple.finder,3,1750273875,1750273878,1750273878.748577,-18000,,
com.apple.Preview,220,1750273655,1750273875,1750273875.351449,-18000,,
com.google.Chrome,49,1750273606,1750273655,1750273655.949703,-18000,,
com.apple.Preview,18,1750273588,1750273606,1750273606.712162,-18000,,
com.apple.finder,12,1750273576,1750273588,1750273588.854069,-18000,,
com.google.Chrome,20,1750273556,1750273576,1750273577.010302,-18000,,
com.apple.Notes,16,1750273540,1750273556,1750273556.6675348,-18000,,
com.google.Chrome,335,1750273205,1750273540,1750273540.423161,-18000,,
com.apple.MobileSMS,6,1750273199,1750273205,1750273205.378799,-18000,,
com.google.Chrome,654,1750272545,1750273199,1750273199.833342,-18000,,
com.apple.Notes,3,1750272542,1750272545,1750272545.6053991,-18000,,
com.google.Chrome,1,1750272541,1750272542,1750272542.6788979,-18000,,
com.apple.Notes,17,1750272524,1750272541,1750272541.804706,-18000,,
com.google.Chrome,10,1750272514,1750272524,1750272524.8621678,-18000,,
com.apple.Notes,15,1750272499,1750272514,1750272514.134235,-18000,,
com.google.Chrome,20,1750272479,1750272499,1750272499.466572,-18000,,
com.apple.Notes,18,1750272461,1750272479,1750272479.180489,-18000,,
com.google.Chrome,524,1750271937,1750272461,1750272461.240895,-18000,,
com.microsoft.VSCode,8,1750271929,1750271937,1750271937.821516,-18000,,
com.google.Chrome,315,1750271614,1750271929,1750271929.697544,-18000,,
com.apple.Notes,22,1750271592,1750271614,1750271614.154614,-18000,,
com.google.Chrome,5,1750271587,1750271592,1750271592.332498,-18000,,
com.apple.finder,1,1750271586,1750271587,1750271587.368744,-18000,,
com.leomehlig.today,1,1750271585,1750271586,1750271586.17283,-18000,,
com.google.Chrome,17,1750271568,1750271585,1750271585.426651,-18000,,
com.apple.MobileSMS,33,1750271517,1750271550,1750271550.721854,-18000,EB445137-D7F5-57EC-87DA-1DB460D64046,"iPhone13,2"
com.google.Gmail,5,1750271495,1750271500,1750271500.544934,-18000,EB445137-D7F5-57EC-87DA-1DB460D64046,"iPhone13,2"
com.microsoft.VSCode,245,1750271323,1750271568,1750271568.626101,-18000,,
com.google.Chrome,11,1750271312,1750271323,1750271323.676567,-18000,,
com.microsoft.VSCode,2,1750271310,1750271312,1750271312.533603,-18000,,
com.google.Chrome,3,1750271307,1750271310,1750271310.5191479,-18000,,
com.microsoft.VSCode,33,1750271274,1750271307,1750271307.45877,-18000,,
com.google.Chrome,4,1750271270,1750271274,1750271274.7439132,-18000,,
com.microsoft.VSCode,52,1750271218,1750271270,1750271270.141175,-18000,,
com.google.Chrome,2,1750271216,1750271218,1750271218.105274,-18000,,
com.microsoft.VSCode,3,1750271213,1750271216,1750271216.291049,-18000,,
com.google.Chrome,12,1750271201,1750271213,1750271214.0015512,-18000,,
com.microsoft.VSCode,87,1750271114,1750271201,1750271201.123129,-18000,,
com.google.Chrome,17,1750271097,1750271114,1750271114.981498,-18000,,
com.microsoft.VSCode,13,1750271084,1750271097,1750271098.0133371,-18000,,
com.google.Chrome,44,1750271040,1750271084,1750271084.2631001,-18000,,
com.microsoft.VSCode,106,1750270934,1750271040,1750271040.562473,-18000,,
com.google.Chrome,4,1750270930,1750270934,1750270934.833502,-18000,,
com.microsoft.VSCode,7,1750270923,1750270930,1750270930.9218612,-18000,,
com.google.Chrome,7,1750270916,1750270923,1750270924.0066562,-18000,,
com.microsoft.VSCode,29,1750270887,1750270916,1750270916.8141708,-18000,,
com.google.Chrome,0,1750270887,1750270887,1750270887.925427,-18000,,
com.microsoft.VSCode,9,1750270878,1750270887,1750270887.22468,-18000,,
com.google.Chrome,5,1750270873,1750270878,1750270878.643512,-18000,,
com.microsoft.VSCode,2,1750270871,1750270873,1750270873.0611858,-18000,,
com.google.Chrome,2,1750270869,1750270871,1750270871.940413,-18000,,
com.microsoft.VSCode,5,1750270864,1750270869,1750270869.046211,-18000,,
com.google.Chrome,39,1750270825,1750270864,1750270865.026541,-18000,,
com.microsoft.VSCode,11,1750270814,1750270825,1750270825.3476,-18000,,
com.apple.finder,13,1750270801,1750270814,1750270814.216494,-18000,,
com.microsoft.VSCode,43,1750270758,1750270801,1750270801.983396,-18000,,
com.apple.finder,10,1750270748,1750270758,1750270758.38888,-18000,,
com.google.Chrome,35,1750270713,1750270748,1750270748.4399,-18000,,
com.leomehlig.today,40,1750270673,1750270713,1750270713.885587,-18000,,
com.google.Chrome,4,1750270669,1750270673,1750270674.451665,-18000,,
com.apple.finder,30,1750270639,1750270669,1750270669.700818,-18000,,
com.doordash.dasher,200,1750269829,1750270029,1750270030.0615811,-18000,EB445137-D7F5-57EC-87DA-1DB460D64046,"iPhone13,2"
com.apple.weather,68,1750269757,1750269825,1750269825.620904,-18000,EB445137-D7F5-57EC-87DA-1DB460D64046,"iPhone13,2"
com.apple.news,214,1750269542,1750269756,1750269756.854714,-18000,EB445137-D7F5-57EC-87DA-1DB460D64046,"iPhone13,2"
com.doordash.dasher,3,1750269539,1750269542,1750269542.177548,-18000,EB445137-D7F5-57EC-87DA-1DB460D64046,"iPhone13,2"
com.apple.news,173,1750269366,1750269539,1750269539.2244182,-18000,EB445137-D7F5-57EC-87DA-1DB460D64046,"iPhone13,2"
com.doordash.dasher,56,1750269292,1750269348,1750269348.187782,-18000,EB445137-D7F5-57EC-87DA-1DB460D64046,"iPhone13,2"
com.doordash.dasher,4,1750269286,1750269290,1750269290.093219,-18000,EB445137-D7F5-57EC-87DA-1DB460D64046,"iPhone13,2"
com.apple.CoreAuthUI,2,1750269020,1750269022,1750269022.352579,-18000,EB445137-D7F5-57EC-87DA-1DB460D64046,"iPhone13,2"
com.truebill.truebillnative,272,1750269014,1750269286,1750269286.2211518,-18000,EB445137-D7F5-57EC-87DA-1DB460D64046,"iPhone13,2"
com.doordash.dasher,5,1750269006,1750269011,1750269011.980743,-18000,EB445137-D7F5-57EC-87DA-1DB460D64046,"iPhone13,2"
com.apple.CoreAuthUI,1,1750268987,1750268988,1750268989.007629,-18000,EB445137-D7F5-57EC-87DA-1DB460D64046,"iPhone13,2"
com.robinhood.release.Robinhood,23,1750268982,1750269005,1750269005.2828732,-18000,EB445137-D7F5-57EC-87DA-1DB460D64046,"iPhone13,2"
com.strava.stravaride,152,1750268826,1750268978,1750268978.614995,-18000,EB445137-D7F5-57EC-87DA-1DB460D64046,"iPhone13,2"
com.microsoft.Office.Outlook,16,1750268796,1750268812,1750268812.188304,-18000,EB445137-D7F5-57EC-87DA-1DB460D64046,"iPhone13,2"
com.doordash.dasher,118,1750268676,1750268794,1750268794.9717422,-18000,EB445137-D7F5-57EC-87DA-1DB460D64046,"iPhone13,2"
com.doordash.dasher,313,1750268359,1750268672,1750268672.665591,-18000,EB445137-D7F5-57EC-87DA-1DB460D64046,"iPhone13,2"
com.doordash.dasher,4,1750268354,1750268358,1750268358.5288281,-18000,EB445137-D7F5-57EC-87DA-1DB460D64046,"iPhone13,2"
com.doordash.dasher,790,1750267539,1750268329,1750268330.171128,-18000,EB445137-D7F5-57EC-87DA-1DB460D64046,"iPhone13,2"
com.apple.news,118,1750267421,1750267539,1750267539.628448,-18000,EB445137-D7F5-57EC-87DA-1DB460D64046,"iPhone13,2"
com.doordash.dasher,5,1750267416,1750267421,1750267421.480603,-18000,EB445137-D7F5-57EC-87DA-1DB460D64046,"iPhone13,2"
com.apple.news,19,1750267397,1750267416,1750267416.705308,-18000,EB445137-D7F5-57EC-87DA-1DB460D64046,"iPhone13,2"
com.doordash.dasher,21,1750267373,1750267394,1750267394.79901,-18000,EB445137-D7F5-57EC-87DA-1DB460D64046,"iPhone13,2"
com.apple.news,91,1750267282,1750267373,1750267373.136061,-18000,EB445137-D7F5-57EC-87DA-1DB460D64046,"iPhone13,2"
com.doordash.dasher,733,1750266546,1750267279,1750267279.511698,-18000,EB445137-D7F5-57EC-87DA-1DB460D64046,"iPhone13,2"
com.doordash.dasher,81,1750266425,1750266506,1750266507.2553492,-18000,EB445137-D7F5-57EC-87DA-1DB460D64046,"iPhone13,2"
com.apple.MobileSMS,20,1750266393,1750266413,1750266413.6916509,-18000,EB445137-D7F5-57EC-87DA-1DB460D64046,"iPhone13,2"
com.doordash.dasher,0,1750266393,1750266393,1750266394.449698,-18000,EB445137-D7F5-57EC-87DA-1DB460D64046,"iPhone13,2"
com.doordash.dasher,576,1750265509,1750266085,1750266085.7669082,-18000,EB445137-D7F5-57EC-87DA-1DB460D64046,"iPhone13,2"
com.strava.stravaride,27,1750265482,1750265509,1750265509.873642,-18000,EB445137-D7F5-57EC-87DA-1DB460D64046,"iPhone13,2"
com.doordash.dasher,644,1750264838,1750265482,1750265482.833263,-18000,EB445137-D7F5-57EC-87DA-1DB460D64046,"iPhone13,2"
com.doordash.dasher,166,1750264641,1750264807,1750264808.056683,-18000,EB445137-D7F5-57EC-87DA-1DB460D64046,"iPhone13,2"
com.doordash.dasher,463,1750264166,1750264629,1750264629.5372791,-18000,EB445137-D7F5-57EC-87DA-1DB460D64046,"iPhone13,2"
com.tinyspeck.chatlyio,5,1750264156,1750264161,1750264161.623989,-18000,EB445137-D7F5-57EC-87DA-1DB460D64046,"iPhone13,2"
com.tinyspeck.chatlyio,10,1750264145,1750264155,1750264155.987448,-18000,EB445137-D7F5-57EC-87DA-1DB460D64046,"iPhone13,2"
com.tinyspeck.chatlyio,35,1750264108,1750264143,1750264144.0508142,-18000,EB445137-D7F5-57EC-87DA-1DB460D64046,"iPhone13,2"
com.doordash.dasher,2,1750264106,1750264108,1750264108.221342,-18000,EB445137-D7F5-57EC-87DA-1DB460D64046,"iPhone13,2"
com.doordash.dasher,5,1750264101,1750264106,1750264106.291377,-18000,EB445137-D7F5-57EC-87DA-1DB460D64046,"iPhone13,2"
com.tinyspeck.chatlyio,31,1750264069,1750264100,1750264100.2954001,-18000,EB445137-D7F5-57EC-87DA-1DB460D64046,"iPhone13,2"
com.tinyspeck.chatlyio,10,1750264059,1750264069,1750264069.4037662,-18000,EB445137-D7F5-57EC-87DA-1DB460D64046,"iPhone13,2"
com.apple.Health,29,1750264026,1750264055,1750264055.294973,-18000,EB445137-D7F5-57EC-87DA-1DB460D64046,"iPhone13,2"
com.doordash.dasher,0,1750264026,1750264026,1750264027.398536,-18000,EB445137-D7F5-57EC-87DA-1DB460D64046,"iPhone13,2"
com.doordash.dasher,165,1750263746,1750263911,1750263911.7849278,-18000,EB445137-D7F5-57EC-87DA-1DB460D64046,"iPhone13,2"
com.apple.weather,0,1750263746,1750263746,1750263747.320277,-18000,EB445137-D7F5-57EC-87DA-1DB460D64046,"iPhone13,2"
com.apple.weather,15,1750257436,1750257451,1750257452.0361109,-18000,EB445137-D7F5-57EC-87DA-1DB460D64046,"iPhone13,2"
com.renpho.health,25,1750257348,1750257373,1750257373.6522179,-18000,EB445137-D7F5-57EC-87DA-1DB460D64046,"iPhone13,2"
com.apple.weather,3,1750257345,1750257348,1750257348.179369,-18000,EB445137-D7F5-57EC-87DA-1DB460D64046,"iPhone13,2"
com.apple.weather,16,1750257208,1750257224,1750257224.598274,-18000,EB445137-D7F5-57EC-87DA-1DB460D64046,"iPhone13,2"
com.doordash.dasher,9,1750257195,1750257204,1750257204.54629,-18000,EB445137-D7F5-57EC-87DA-1DB460D64046,"iPhone13,2"
com.apple.weather,1,1750257194,1750257195,1750257195.650651,-18000,EB445137-D7F5-57EC-87DA-1DB460D64046,"iPhone13,2"
com.apple.weather,354,1750255948,1750256302,1750256302.700633,-18000,EB445137-D7F5-57EC-87DA-1DB460D64046,"iPhone13,2"
com.apple.news,369,1750223490,1750223859,1750223859.2011518,-18000,EB445137-D7F5-57EC-87DA-1DB460D64046,"iPhone13,2"
com.apple.Maps,283,1750221549,1750221832,1750221832.635489,-18000,EB445137-D7F5-57EC-87DA-1DB460D64046,"iPhone13,2"
com.apple.Health,49,1750221031,1750221080,1750221080.0719562,-18000,EB445137-D7F5-57EC-87DA-1DB460D64046,"iPhone13,2"
com.apple.finder,1,1750220974,1750220975,1750220975.806271,-18000,,
com.leomehlig.today,1,1750220973,1750220974,1750220974.4485888,-18000,,
com.google.Chrome,10,1750220963,1750220973,1750220973.5377002,-18000,,
com.apple.Notes,54,1750220909,1750220963,1750220963.699397,-18000,,
com.google.Chrome,635,1750220274,1750220909,1750220909.9577398,-18000,,
com.apple.finder,13,1750220261,1750220274,1750220274.5109491,-18000,,
com.google.Chrome,27,1750220234,1750220261,1750220261.416325,-18000,,
com.apple.Notes,462,1750219772,1750220234,1750220235.0068378,-18000,,
com.google.Chrome,4,1750219768,1750219772,1750219772.4263802,-18000,,
com.leomehlig.today,6,1750219762,1750219768,1750219768.198955,-18000,,
com.google.Chrome,1199,1750218563,1750219762,1750219763.174221,-18000,,
com.google.Chrome,1068,1750217404,1750218472,1750218472.3264031,-18000,,
com.google.Chrome,347,1750216667,1750217014,1750217014.898669,-18000,,
com.google.Chrome,1596,1750214729,1750216325,1750216325.4043288,-18000,,
com.leomehlig.today,4,1750214725,1750214729,1750214730.013747,-18000,,
com.apple.iCal,173,1750214552,1750214725,1750214725.428555,-18000,,
com.leomehlig.today,60,1750214492,1750214552,1750214552.907817,-18000,,
com.google.Chrome,44,1750214448,1750214492,1750214492.11642,-18000,,
com.leomehlig.today,6,1750214442,1750214448,1750214448.272202,-18000,,
com.apple.iCal,9,1750214433,1750214442,1750214442.1987262,-18000,,
com.google.Chrome,6,1750214427,1750214433,1750214433.103451,-18000,,
com.apple.MobileSMS,9,1750214418,1750214427,1750214427.124376,-18000,,
com.google.Chrome,186,1750214232,1750214418,1750214418.340856,-18000,,
com.apple.MobileSMS,80,1750208460,1750208540,1750208540.618185,-18000,EB445137-D7F5-57EC-87DA-1DB460D64046,"iPhone13,2"
com.apple.mobilecal,0,1750208460,1750208460,1750208460.253039,-18000,EB445137-D7F5-57EC-87DA-1DB460D64046,"iPhone13,2"
com.apple.mobilecal,71,1750208387,1750208458,1750208458.997181,-18000,EB445137-D7F5-57EC-87DA-1DB460D64046,"iPhone13,2"
com.apple.mobilecal,2,1750208384,1750208386,1750208386.5468931,-18000,EB445137-D7F5-57EC-87DA-1DB460D64046,"iPhone13,2"
com.apple.mobilecal,2,1750208369,1750208371,1750208372.097157,-18000,EB445137-D7F5-57EC-87DA-1DB460D64046,"iPhone13,2"
com.doordash.dasher,14,1750208345,1750208359,1750208359.796483,-18000,EB445137-D7F5-57EC-87DA-1DB460D64046,"iPhone13,2"
com.apple.MobileSMS,22,1750208323,1750208345,1750208345.54074,-18000,EB445137-D7F5-57EC-87DA-1DB460D64046,"iPhone13,2"
com.apple.mobilecal,11,1750208312,1750208323,1750208323.249792,-18000,EB445137-D7F5-57EC-87DA-1DB460D64046,"iPhone13,2"
com.apple.MobileSMS,7,1750208304,1750208311,1750208311.913722,-18000,EB445137-D7F5-57EC-87DA-1DB460D64046,"iPhone13,2"
com.apple.MobileSMS,182,1750208118,1750208300,1750208300.699139,-18000,EB445137-D7F5-57EC-87DA-1DB460D64046,"iPhone13,2"
com.apple.news,47,1750208071,1750208118,1750208118.586024,-18000,EB445137-D7F5-57EC-87DA-1DB460D64046,"iPhone13,2"
com.apple.MobileSMS,5,1750208062,1750208067,1750208067.519576,-18000,EB445137-D7F5-57EC-87DA-1DB460D64046,"iPhone13,2"
com.apple.mobilecal,25,1750208037,1750208062,1750208062.120827,-18000,EB445137-D7F5-57EC-87DA-1DB460D64046,"iPhone13,2"
com.apple.MobileSMS,8,1750208028,1750208036,1750208036.755964,-18000,EB445137-D7F5-57EC-87DA-1DB460D64046,"iPhone13,2"
com.apple.MobileSMS,179,1750207837,1750208016,1750208017.001307,-18000,EB445137-D7F5-57EC-87DA-1DB460D64046,"iPhone13,2"
com.apple.MobileSMS,209,1750207627,1750207836,1750207836.3131518,-18000,EB445137-D7F5-57EC-87DA-1DB460D64046,"iPhone13,2"
com.apple.news,22,1750207605,1750207627,1750207627.88081,-18000,EB445137-D7F5-57EC-87DA-1DB460D64046,"iPhone13,2"
com.letterboxd.LetterboxdApp,4,1750207601,1750207605,1750207605.236114,-18000,EB445137-D7F5-57EC-87DA-1DB460D64046,"iPhone13,2"
com.doordash.dasher,1,1750207600,1750207601,1750207601.971614,-18000,EB445137-D7F5-57EC-87DA-1DB460D64046,"iPhone13,2"
com.apple.MobileSMS,11,1750207589,1750207600,1750207600.85753,-18000,EB445137-D7F5-57EC-87DA-1DB460D64046,"iPhone13,2"
com.apple.news,25,1750207564,1750207589,1750207589.599432,-18000,EB445137-D7F5-57EC-87DA-1DB460D64046,"iPhone13,2"
com.apple.MobileSMS,17,1750207547,1750207564,1750207564.303508,-18000,EB445137-D7F5-57EC-87DA-1DB460D64046,"iPhone13,2"
com.apple.news,18,1750207529,1750207547,1750207547.990514,-18000,EB445137-D7F5-57EC-87DA-1DB460D64046,"iPhone13,2"
com.apple.MobileSMS,12,1750207517,1750207529,1750207529.98494,-18000,EB445137-D7F5-57EC-87DA-1DB460D64046,"iPhone13,2"
com.apple.MobileSMS,19,1750207497,1750207516,1750207516.705132,-18000,EB445137-D7F5-57EC-87DA-1DB460D64046,"iPhone13,2"
com.apple.news,9,1750207488,1750207497,1750207497.372171,-18000,EB445137-D7F5-57EC-87DA-1DB460D64046,"iPhone13,2"
com.apple.MobileSMS,4,1750207484,1750207488,1750207488.4643831,-18000,EB445137-D7F5-57EC-87DA-1DB460D64046,"iPhone13,2"
com.apple.news,1,1750207483,1750207484,1750207485.0242,-18000,EB445137-D7F5-57EC-87DA-1DB460D64046,"iPhone13,2"
com.apple.MobileSMS,53,1750207430,1750207483,1750207483.4751291,-18000,EB445137-D7F5-57EC-87DA-1DB460D64046,"iPhone13,2"
com.apple.news,18,1750207412,1750207430,1750207430.484339,-18000,EB445137-D7F5-57EC-87DA-1DB460D64046,"iPhone13,2"
com.apple.MobileSMS,58,1750207354,1750207412,1750207412.2654328,-18000,EB445137-D7F5-57EC-87DA-1DB460D64046,"iPhone13,2"
com.apple.news,75,1750207279,1750207354,1750207355.0155149,-18000,EB445137-D7F5-57EC-87DA-1DB460D64046,"iPhone13,2"
com.apple.MobileSMS,2,1750207238,1750207240,1750207240.6089392,-18000,EB445137-D7F5-57EC-87DA-1DB460D64046,"iPhone13,2"
com.doordash.dasher,11,1750207227,1750207238,1750207238.785924,-18000,EB445137-D7F5-57EC-87DA-1DB460D64046,"iPhone13,2"
com.apple.news,23,1750207202,1750207225,1750207225.937965,-18000,EB445137-D7F5-57EC-87DA-1DB460D64046,"iPhone13,2"
com.apple.MobileSMS,635,1750206564,1750207199,1750207199.380186,-18000,EB445137-D7F5-57EC-87DA-1DB460D64046,"iPhone13,2"
com.apple.news,25,1750206539,1750206564,1750206564.712995,-18000,EB445137-D7F5-57EC-87DA-1DB460D64046,"iPhone13,2"
com.apple.MobileSMS,52,1750206485,1750206537,1750206537.484618,-18000,EB445137-D7F5-57EC-87DA-1DB460D64046,"iPhone13,2"
com.apple.news,19,1750206466,1750206485,1750206485.58534,-18000,EB445137-D7F5-57EC-87DA-1DB460D64046,"iPhone13,2"
com.apple.MobileSMS,23,1750206439,1750206462,1750206462.382968,-18000,EB445137-D7F5-57EC-87DA-1DB460D64046,"iPhone13,2"
com.apple.MobileSMS,89,1750206342,1750206431,1750206431.2577,-18000,EB445137-D7F5-57EC-87DA-1DB460D64046,"iPhone13,2"
com.apple.MobileSMS,99,1750206241,1750206340,1750206340.2088299,-18000,EB445137-D7F5-57EC-87DA-1DB460D64046,"iPhone13,2"
com.apple.MobileSMS,6,1750206235,1750206241,1750206241.225724,-18000,EB445137-D7F5-57EC-87DA-1DB460D64046,"iPhone13,2"
com.apple.MobileSMS,77,1750206152,1750206229,1750206229.577941,-18000,EB445137-D7F5-57EC-87DA-1DB460D64046,"iPhone13,2"
com.letterboxd.LetterboxdApp,210,1750205939,1750206149,1750206149.91994,-18000,EB445137-D7F5-57EC-87DA-1DB460D64046,"iPhone13,2"
com.doordash.dasher,95,1750205841,1750205936,1750205936.7006922,-18000,EB445137-D7F5-57EC-87DA-1DB460D64046,"iPhone13,2"
com.apple.MobileSMS,5,1750205812,1750205817,1750205817.77699,-18000,EB445137-D7F5-57EC-87DA-1DB460D64046,"iPhone13,2"
com.apple.MobileSMS,19,1750205684,1750205703,1750205704.21894,-18000,EB445137-D7F5-57EC-87DA-1DB460D64046,"iPhone13,2"
com.apple.findmy,11,1750205669,1750205680,1750205680.839251,-18000,EB445137-D7F5-57EC-87DA-1DB460D64046,"iPhone13,2"
com.apple.news,10,1750205658,1750205668,1750205668.496193,-18000,EB445137-D7F5-57EC-87DA-1DB460D64046,"iPhone13,2"
com.apple.news,3,1750205652,1750205655,1750205655.473617,-18000,EB445137-D7F5-57EC-87DA-1DB460D64046,"iPhone13,2"
com.apple.weather,65,1750205587,1750205652,1750205652.351603,-18000,EB445137-D7F5-57EC-87DA-1DB460D64046,"iPhone13,2"
com.strava.stravaride,65,1750205521,1750205586,1750205586.208271,-18000,EB445137-D7F5-57EC-87DA-1DB460D64046,"iPhone13,2"
com.apple.Health,10,1750205124,1750205134,1750205134.177415,-18000,EB445137-D7F5-57EC-87DA-1DB460D64046,"iPhone13,2"
com.apple.findmy,2,1750205117,1750205119,1750205120.041776,-18000,EB445137-D7F5-57EC-87DA-1DB460D64046,"iPhone13,2"
com.apple.findmy,16,1750205099,1750205115,1750205115.990779,-18000,EB445137-D7F5-57EC-87DA-1DB460D64046,"iPhone13,2"
com.apple.weather,9,1750205090,1750205099,1750205099.078679,-18000,EB445137-D7F5-57EC-87DA-1DB460D64046,"iPhone13,2"
com.truebill.truebillnative,2,1750205088,1750205090,1750205090.5556011,-18000,EB445137-D7F5-57EC-87DA-1DB460D64046,"iPhone13,2"
com.apple.CoreAuthUI,2,1750204912,1750204914,1750204914.569979,-18000,EB445137-D7F5-57EC-87DA-1DB460D64046,"iPhone13,2"
com.truebill.truebillnative,152,1750204909,1750205061,1750205061.320113,-18000,EB445137-D7F5-57EC-87DA-1DB460D64046,"iPhone13,2"
Astrospheric.Astrospheric,12,1750204886,1750204898,1750204898.198441,-18000,EB445137-D7F5-57EC-87DA-1DB460D64046,"iPhone13,2"
com.doordash.dasher,65,1750204821,1750204886,1750204886.257568,-18000,EB445137-D7F5-57EC-87DA-1DB460D64046,"iPhone13,2"
Astrospheric.Astrospheric,5,1750204814,1750204819,1750204819.578954,-18000,EB445137-D7F5-57EC-87DA-1DB460D64046,"iPhone13,2"
com.apple.news,3,1750204751,1750204754,1750204754.811173,-18000,EB445137-D7F5-57EC-87DA-1DB460D64046,"iPhone13,2"
com.google.Chrome,25,1750204595,1750204620,1750204620.299508,-18000,,
com.leomehlig.today,2,1750204593,1750204595,1750204597.03379,-18000,,
com.apple.news,393,1750203756,1750204149,1750204149.090724,-18000,EB445137-D7F5-57EC-87DA-1DB460D64046,"iPhone13,2"
com.apple.CoreAuthUI,1,1750203753,1750203754,1750203754.4960651,-18000,EB445137-D7F5-57EC-87DA-1DB460D64046,"iPhone13,2"
com.apple.Passwords,2,1750203752,1750203754,1750203754.495429,-18000,EB445137-D7F5-57EC-87DA-1DB460D64046,"iPhone13,2"
com.apple.CoreAuthUI,2,1750203507,1750203509,1750203509.039235,-18000,EB445137-D7F5-57EC-87DA-1DB460D64046,"iPhone13,2"
com.apple.Passwords,85,1750203505,1750203590,1750203590.22837,-18000,EB445137-D7F5-57EC-87DA-1DB460D64046,"iPhone13,2"
com.apple.news,3,1750203494,1750203497,1750203497.4218102,-18000,EB445137-D7F5-57EC-87DA-1DB460D64046,"iPhone13,2"
com.apple.news,144,1750203294,1750203438,1750203439.020996,-18000,EB445137-D7F5-57EC-87DA-1DB460D64046,"iPhone13,2"
com.leomehlig.today,6,1750202990,1750202996,1750202996.827302,-18000,,
com.google.Chrome,4,1750202986,1750202990,1750202990.4934769,-18000,,
com.apple.Notes,7,1750202979,1750202986,1750202986.359151,-18000,,
com.toyopagroup.picaboo,21,1750202101,1750202122,1750202122.551789,-18000,EB445137-D7F5-57EC-87DA-1DB460D64046,"iPhone13,2"
com.apple.Notes,307,1750201174,1750201481,1750201481.14639,-18000,,
com.google.Chrome,8,1750201166,1750201174,1750201174.402828,-18000,,
com.apple.Notes,12,1750201154,1750201166,1750201166.140204,-18000,,
com.google.Chrome,23,1750201131,1750201154,1750201154.559761,-18000,,
com.apple.Notes,8,1750201123,1750201131,1750201131.226248,-18000,,
com.google.Chrome,8,1750201115,1750201123,1750201123.204774,-18000,,
com.apple.Notes,34,1750201081,1750201115,1750201115.0436559,-18000,,
com.google.Chrome,57,1750201024,1750201081,1750201081.1234388,-18000,,
com.leomehlig.today,4,1750201008,1750201012,1750201012.813283,-18000,,
com.google.Chrome,678,1750200330,1750201008,1750201008.661368,-18000,,
com.leomehlig.today,6,1750200324,1750200330,1750200330.357815,-18000,,
com.google.Chrome,267,1750200057,1750200324,1750200324.5133061,-18000,,
com.apple.Notes,47,1750200010,1750200057,1750200057.923675,-18000,,
com.google.Chrome,5,1750200005,1750200010,1750200010.266895,-18000,,
com.apple.Notes,2,1750200003,1750200005,1750200005.231595,-18000,,
com.google.Chrome,18,1750199985,1750200003,1750200003.18238,-18000,,
com.apple.Notes,20,1750199965,1750199985,1750199985.226227,-18000,,
com.google.Chrome,3,1750199962,1750199965,1750199965.284822,-18000,,
com.apple.Notes,6,1750199956,1750199962,1750199962.355485,-18000,,
com.google.Chrome,158,1750199798,1750199956,1750199956.235774,-18000,,
com.apple.Notes,33,1750199765,1750199798,1750199798.247431,-18000,,
com.google.Chrome,2454,1750197311,1750199765,1750199765.9650111,-18000,,
com.apple.finder,1,1750197310,1750197311,1750197311.748229,-18000,,
com.google.Chrome,2282,1750195028,1750197310,1750197310.966404,-18000,,
com.apple.finder,36,1750194992,1750195028,1750195028.378518,-18000,,
com.google.Chrome,12,1750194980,1750194992,1750194992.799818,-18000,,
com.apple.finder,19,1750194961,1750194980,1750194980.245785,-18000,,
com.google.Chrome,143,1750194818,1750194961,1750194961.8369799,-18000,,
com.google.Chrome,305,1750193653,1750193958,1750193959.162003,-18000,,
com.strava.stravaride,49,1750189525,1750189574,1750189574.1320171,-18000,EB445137-D7F5-57EC-87DA-1DB460D64046,"iPhone13,2"
com.toyopagroup.picaboo,26,1750189492,1750189518,1750189518.3460479,-18000,EB445137-D7F5-57EC-87DA-1DB460D64046,"iPhone13,2"
com.apple.findmy,5,1750189484,1750189489,1750189489.6555018,-18000,EB445137-D7F5-57EC-87DA-1DB460D64046,"iPhone13,2"
com.apple.findmy,2,1750187748,1750187750,1750187751.326532,-18000,EB445137-D7F5-57EC-87DA-1DB460D64046,"iPhone13,2"
com.apple.findmy,8,1750186965,1750186973,1750186974.3219728,-18000,EB445137-D7F5-57EC-87DA-1DB460D64046,"iPhone13,2"
com.leomehlig.today,92,1750186240,1750186332,1750186332.3724608,-18000,EB445137-D7F5-57EC-87DA-1DB460D64046,"iPhone13,2"
com.apple.findmy,23,1750186210,1750186233,1750186233.447269,-18000,EB445137-D7F5-57EC-87DA-1DB460D64046,"iPhone13,2"
com.apple.findmy,5,1750186034,1750186039,1750186039.361273,-18000,EB445137-D7F5-57EC-87DA-1DB460D64046,"iPhone13,2"
com.apple.MobileSMS,3,1750186030,1750186033,1750186033.314454,-18000,EB445137-D7F5-57EC-87DA-1DB460D64046,"iPhone13,2"
com.apple.findmy,0,1750186030,1750186030,1750186030.9852772,-18000,EB445137-D7F5-57EC-87DA-1DB460D64046,"iPhone13,2"
com.google.Chrome,499,1750185114,1750185613,1750185613.718672,-18000,,
com.apple.findmy,61,1750185012,1750185073,1750185073.537836,-18000,EB445137-D7F5-57EC-87DA-1DB460D64046,"iPhone13,2"
com.toyopagroup.picaboo,3,1750184879,1750184882,1750184882.055085,-18000,EB445137-D7F5-57EC-87DA-1DB460D64046,"iPhone13,2"
com.apple.MobileSMS,9,1750184845,1750184854,1750184854.3603492,-18000,EB445137-D7F5-57EC-87DA-1DB460D64046,"iPhone13,2"
com.apple.MobileSMS,3,1750184842,1750184845,1750184845.41326,-18000,EB445137-D7F5-57EC-87DA-1DB460D64046,"iPhone13,2"
Astrospheric.Astrospheric,34,1750184807,1750184841,1750184841.6021051,-18000,EB445137-D7F5-57EC-87DA-1DB460D64046,"iPhone13,2"
com.apple.findmy,3,1750184781,1750184784,1750184784.1740808,-18000,EB445137-D7F5-57EC-87DA-1DB460D64046,"iPhone13,2"
com.apple.findmy,16,1750184763,1750184779,1750184779.017626,-18000,EB445137-D7F5-57EC-87DA-1DB460D64046,"iPhone13,2"
com.toyopagroup.picaboo,18,1750184730,1750184748,1750184748.791951,-18000,EB445137-D7F5-57EC-87DA-1DB460D64046,"iPhone13,2"
com.toyopagroup.picaboo,99,1750184630,1750184729,1750184729.92667,-18000,EB445137-D7F5-57EC-87DA-1DB460D64046,"iPhone13,2"
com.apple.MobileSMS,3,1750184626,1750184629,1750184629.260912,-18000,EB445137-D7F5-57EC-87DA-1DB460D64046,"iPhone13,2"
com.apple.MobileSMS,27,1750184547,1750184574,1750184574.221467,-18000,EB445137-D7F5-57EC-87DA-1DB460D64046,"iPhone13,2"
com.apple.MobileSMS,244,1750184278,1750184522,1750184522.528832,-18000,EB445137-D7F5-57EC-87DA-1DB460D64046,"iPhone13,2"
com.apple.findmy,50,1750184219,1750184269,1750184269.575189,-18000,EB445137-D7F5-57EC-87DA-1DB460D64046,"iPhone13,2"
com.apple.MobileSMS,2,1750184217,1750184219,1750184219.363332,-18000,EB445137-D7F5-57EC-87DA-1DB460D64046,"iPhone13,2"
com.apple.MobileSMS,4,1750183863,1750183867,1750183867.5991101,-18000,EB445137-D7F5-57EC-87DA-1DB460D64046,"iPhone13,2"
com.apple.findmy,20,1750183842,1750183862,1750183862.147396,-18000,EB445137-D7F5-57EC-87DA-1DB460D64046,"iPhone13,2"
com.doordash.dasher,930,1750182318,1750183248,1750183248.107576,-18000,EB445137-D7F5-57EC-87DA-1DB460D64046,"iPhone13,2"
com.doordash.dasher,73,1750182225,1750182298,1750182298.83061,-18000,EB445137-D7F5-57EC-87DA-1DB460D64046,"iPhone13,2"
com.apple.MobileSMS,3,1750182222,1750182225,1750182225.13836,-18000,EB445137-D7F5-57EC-87DA-1DB460D64046,"iPhone13,2"
com.apple.MobileSMS,19,1750181972,1750181991,1750181991.238455,-18000,EB445137-D7F5-57EC-87DA-1DB460D64046,"iPhone13,2"
com.doordash.dasher,1,1750181971,1750181972,1750181972.9356198,-18000,EB445137-D7F5-57EC-87DA-1DB460D64046,"iPhone13,2"
com.doordash.dasher,1,1750181823,1750181824,1750181825.154283,-18000,EB445137-D7F5-57EC-87DA-1DB460D64046,"iPhone13,2"
com.apple.Health,124,1750181694,1750181818,1750181818.830988,-18000,EB445137-D7F5-57EC-87DA-1DB460D64046,"iPhone13,2"
com.doordash.dasher,255,1750181431,1750181686,1750181686.410674,-18000,EB445137-D7F5-57EC-87DA-1DB460D64046,"iPhone13,2"
com.doordash.dasher,1,1750181430,1750181431,1750181431.2022429,-18000,EB445137-D7F5-57EC-87DA-1DB460D64046,"iPhone13,2"
com.doordash.dasher,814,1750180465,1750181279,1750181280.100768,-18000,EB445137-D7F5-57EC-87DA-1DB460D64046,"iPhone13,2"
com.doordash.dasher,7,1750180420,1750180427,1750180428.08293,-18000,EB445137-D7F5-57EC-87DA-1DB460D64046,"iPhone13,2"
com.apple.CoreAuthUI,2,1750180402,1750180404,1750180404.484324,-18000,EB445137-D7F5-57EC-87DA-1DB460D64046,"iPhone13,2"
com.truebill.truebillnative,25,1750180395,1750180420,1750180420.247647,-18000,EB445137-D7F5-57EC-87DA-1DB460D64046,"iPhone13,2"
com.apple.Health,10,1750180374,1750180384,1750180384.183167,-18000,EB445137-D7F5-57EC-87DA-1DB460D64046,"iPhone13,2"
com.apple.MobileSMS,11,1750180360,1750180371,1750180371.643938,-18000,EB445137-D7F5-57EC-87DA-1DB460D64046,"iPhone13,2"
com.apple.MobileSMS,99,1750180260,1750180359,1750180359.5034862,-18000,EB445137-D7F5-57EC-87DA-1DB460D64046,"iPhone13,2"
com.doordash.dasher,960,1750179298,1750180258,1750180258.462523,-18000,EB445137-D7F5-57EC-87DA-1DB460D64046,"iPhone13,2"
com.doordash.dasher,69,1750179204,1750179273,1750179273.7350779,-18000,EB445137-D7F5-57EC-87DA-1DB460D64046,"iPhone13,2"
com.apple.news,235,1750178969,1750179204,1750179204.908562,-18000,EB445137-D7F5-57EC-87DA-1DB460D64046,"iPhone13,2"
com.doordash.dasher,2,1750178954,1750178956,1750178956.478703,-18000,EB445137-D7F5-57EC-87DA-1DB460D64046,"iPhone13,2"
com.doordash.dasher,1427,1750177525,1750178952,1750178952.719122,-18000,EB445137-D7F5-57EC-87DA-1DB460D64046,"iPhone13,2"
com.doordash.dasher,57,1750177451,1750177508,1750177509.0794,-18000,EB445137-D7F5-57EC-87DA-1DB460D64046,"iPhone13,2"
com.doordash.dasher,919,1750176502,1750177421,1750177421.604816,-18000,EB445137-D7F5-57EC-87DA-1DB460D64046,"iPhone13,2"
com.doordash.dasher,121,1750176380,1750176501,1750176501.566915,-18000,EB445137-D7F5-57EC-87DA-1DB460D64046,"iPhone13,2"
com.apple.MobileSMS,30,1750176350,1750176380,1750176380.316783,-18000,EB445137-D7F5-57EC-87DA-1DB460D64046,"iPhone13,2"
com.doordash.dasher,21,1750176329,1750176350,1750176350.713111,-18000,EB445137-D7F5-57EC-87DA-1DB460D64046,"iPhone13,2"
com.apple.MobileSMS,165,1750176164,1750176329,1750176329.665728,-18000,EB445137-D7F5-57EC-87DA-1DB460D64046,"iPhone13,2"
com.apple.mobilecal,5,1750176159,1750176164,1750176164.682024,-18000,EB445137-D7F5-57EC-87DA-1DB460D64046,"iPhone13,2"
com.apple.MobileSMS,37,1750176121,1750176158,1750176158.280923,-18000,EB445137-D7F5-57EC-87DA-1DB460D64046,"iPhone13,2"
com.apple.news,114,1750176007,1750176121,1750176121.5507479,-18000,EB445137-D7F5-57EC-87DA-1DB460D64046,"iPhone13,2"
com.doordash.dasher,6,1750175999,1750176005,1750176005.711142,-18000,EB445137-D7F5-57EC-87DA-1DB460D64046,"iPhone13,2"
com.apple.MobileSMS,8,1750175986,1750175994,1750175994.9384742,-18000,EB445137-D7F5-57EC-87DA-1DB460D64046,"iPhone13,2"
com.apple.MobileSMS,112,1750175873,1750175985,1750175985.638545,-18000,EB445137-D7F5-57EC-87DA-1DB460D64046,"iPhone13,2"
com.toyopagroup.picaboo,25,1750175848,1750175873,1750175874.043757,-18000,EB445137-D7F5-57EC-87DA-1DB460D64046,"iPhone13,2"
com.apple.MobileSMS,72,1750175773,1750175845,1750175845.886917,-18000,EB445137-D7F5-57EC-87DA-1DB460D64046,"iPhone13,2"
com.strava.stravaride,68,1750175705,1750175773,1750175773.80778,-18000,EB445137-D7F5-57EC-87DA-1DB460D64046,"iPhone13,2"
com.doordash.dasher,5,1750175697,1750175702,1750175702.4080172,-18000,EB445137-D7F5-57EC-87DA-1DB460D64046,"iPhone13,2"
com.doordash.dasher,497,1750175199,1750175696,1750175696.333644,-18000,EB445137-D7F5-57EC-87DA-1DB460D64046,"iPhone13,2"
com.google.Chrome,6,1750174844,1750174850,1750174850.234961,-18000,,
com.doordash.dasher,316,1750174822,1750175138,1750175138.363927,-18000,EB445137-D7F5-57EC-87DA-1DB460D64046,"iPhone13,2"
com.apple.iCal,143,1750174701,1750174844,1750174844.9279032,-18000,,
com.doordash.dasher,78,1750174656,1750174734,1750174734.203668,-18000,EB445137-D7F5-57EC-87DA-1DB460D64046,"iPhone13,2"
com.apple.MobileSMS,66,1750174584,1750174650,1750174650.434527,-18000,EB445137-D7F5-57EC-87DA-1DB460D64046,"iPhone13,2"
com.google.Chrome,180,1750174521,1750174701,1750174701.7682781,-18000,,
com.apple.MobileSMS,82,1750174496,1750174578,1750174578.3836222,-18000,EB445137-D7F5-57EC-87DA-1DB460D64046,"iPhone13,2"
com.renpho.health,0,1750174496,1750174496,1750174498.725949,-18000,EB445137-D7F5-57EC-87DA-1DB460D64046,"iPhone13,2"
com.renpho.health,58,1750169615,1750169673,1750169673.382658,-18000,EB445137-D7F5-57EC-87DA-1DB460D64046,"iPhone13,2"
com.apple.mobiletimer,17,1750136688,1750136705,1750136706.052072,-18000,EB445137-D7F5-57EC-87DA-1DB460D64046,"iPhone13,2"
com.apple.news,342,1750136336,1750136678,1750136678.6066499,-18000,EB445137-D7F5-57EC-87DA-1DB460D64046,"iPhone13,2"
com.apple.journal,1517,1750134808,1750136325,1750136325.976922,-18000,EB445137-D7F5-57EC-87DA-1DB460D64046,"iPhone13,2"
com.apple.CoreAuthUI,3,1750134628,1750134631,1750134631.1879911,-18000,EB445137-D7F5-57EC-87DA-1DB460D64046,"iPhone13,2"
com.apple.journal,180,1750134627,1750134807,1750134807.1750011,-18000,EB445137-D7F5-57EC-87DA-1DB460D64046,"iPhone13,2"
com.thestorygraph.thestorygraph,36,1750134586,1750134622,1750134622.364221,-18000,EB445137-D7F5-57EC-87DA-1DB460D64046,"iPhone13,2"
com.thestorygraph.thestorygraph,71,1750134512,1750134583,1750134584.014971,-18000,EB445137-D7F5-57EC-87DA-1DB460D64046,"iPhone13,2"
com.apple.Health,135,1750134345,1750134480,1750134480.453006,-18000,EB445137-D7F5-57EC-87DA-1DB460D64046,"iPhone13,2"
com.google.Chrome,1033,1750130659,1750131692,1750131693.047505,-18000,,
com.leomehlig.today,2,1750130657,1750130659,1750130661.7372432,-18000,,
com.leomehlig.today,14,1750125797,1750125811,1750125811.096342,-18000,,
com.apple.finder,2,1750125795,1750125797,1750125797.709456,-18000,,
com.apple.iCal,4,1750125791,1750125795,1750125795.907967,-18000,,
com.apple.Passwords,1,1750125790,1750125791,1750125791.883624,-18000,,
com.google.Chrome,257,1750125533,1750125790,1750125791.698268,-18000,,
com.apple.Passwords,8,1750125525,1750125533,1750125533.2405849,-18000,,
com.google.Chrome,88,1750125437,1750125525,1750125525.770983,-18000,,
com.apple.iCal,1,1750125259,1750125260,1750125260.911008,-18000,,
com.google.Chrome,9,1750125250,1750125259,1750125259.2355409,-18000,,
com.apple.iCal,9,1750125241,1750125250,1750125250.603671,-18000,,
com.google.Chrome,96,1750125145,1750125241,1750125241.6193209,-18000,,
com.apple.iCal,4,1750125141,1750125145,1750125145.8487458,-18000,,
com.google.Chrome,4,1750125137,1750125141,1750125141.338578,-18000,,
com.apple.iCal,7,1750125130,1750125137,1750125137.90441,-18000,,
com.google.Chrome,127,1750125003,1750125130,1750125130.080894,-18000,,
com.apple.finder,1,1750124948,1750124949,1750124949.69312,-18000,,
com.leomehlig.today,5,1750124943,1750124948,1750124948.828943,-18000,,
com.apple.finder,2,1750124941,1750124943,1750124943.434758,-18000,,
com.apple.Terminal,15,1750124926,1750124941,1750124941.611031,-18000,,
com.apple.finder,3,1750124923,1750124926,1750124926.0861769,-18000,,
com.apple.Terminal,11,1750124912,1750124923,1750124923.768503,-18000,,
com.apple.finder,4,1750124908,1750124912,1750124912.7634192,-18000,,
com.apple.Terminal,1,1750124907,1750124908,1750124908.270697,-18000,,
com.apple.finder,19,1750124888,1750124907,1750124907.2849731,-18000,,
com.apple.Notes,5,1750124883,1750124888,1750124888.530381,-18000,,
com.microsoft.VSCode,6,1750124877,1750124883,1750124884.0511398,-18000,,
com.google.Chrome,286,1750124591,1750124877,1750124877.34481,-18000,,
com.microsoft.VSCode,34,1750124557,1750124591,1750124591.159138,-18000,,
com.google.Chrome,10,1750124547,1750124557,1750124557.914356,-18000,,
com.microsoft.VSCode,2,1750124545,1750124547,1750124547.2300491,-18000,,
com.google.Chrome,2,1750124543,1750124545,1750124545.746731,-18000,,
com.microsoft.VSCode,2,1750124541,1750124543,1750124543.517205,-18000,,
com.google.Chrome,6,1750124535,1750124541,1750124541.8558788,-18000,,
com.microsoft.VSCode,5,1750124530,1750124535,1750124535.451377,-18000,,
com.google.Chrome,39,1750124491,1750124530,1750124530.185979,-18000,,
com.microsoft.VSCode,4,1750124487,1750124491,1750124491.544183,-18000,,
com.google.Chrome,3,1750124484,1750124487,1750124487.7860699,-18000,,
com.microsoft.VSCode,4,1750124480,1750124484,1750124484.4283872,-18000,,
com.google.Chrome,336,1750124144,1750124480,1750124480.260685,-18000,,
com.microsoft.VSCode,1,1750124143,1750124144,1750124144.274338,-18000,,
com.google.Chrome,129,1750124014,1750124143,1750124143.6307058,-18000,,
com.microsoft.VSCode,1,1750124013,1750124014,1750124014.0446,-18000,,
com.google.Chrome,309,1750123704,1750124013,1750124013.378542,-18000,,
com.microsoft.VSCode,3,1750123701,1750123704,1750123704.168586,-18000,,
com.google.Chrome,240,1750123461,1750123701,1750123701.1476011,-18000,,
com.microsoft.VSCode,1,1750123460,1750123461,1750123461.72861,-18000,,
com.apple.Notes,0,1750123460,1750123460,1750123460.988562,-18000,,
com.microsoft.VSCode,2,1750123458,1750123460,1750123460.074679,-18000,,
com.google.Chrome,52,1750123406,1750123458,1750123458.385988,-18000,,
com.microsoft.VSCode,2,1750123404,1750123406,1750123406.760693,-18000,,
com.google.Chrome,10,1750123394,1750123404,1750123405.034079,-18000,,
com.microsoft.VSCode,1,1750123393,1750123394,1750123394.447277,-18000,,
com.google.Chrome,12,1750123381,1750123393,1750123393.555855,-18000,,
com.microsoft.VSCode,17,1750123364,1750123381,1750123381.9224272,-18000,,
com.google.Chrome,347,1750123017,1750123364,1750123364.525269,-18000,,
com.google.Chrome,380,1750122627,1750123007,1750123007.653953,-18000,,
com.microsoft.VSCode,3,1750122624,1750122627,1750122627.5963879,-18000,,
com.google.Chrome,169,1750122455,1750122624,1750122624.082907,-18000,,
com.microsoft.VSCode,25,1750122430,1750122455,1750122455.1069288,-18000,,
com.google.Chrome,15,1750122415,1750122430,1750122430.492518,-18000,,
com.microsoft.VSCode,21,1750122394,1750122415,1750122415.1301022,-18000,,
com.google.Chrome,101,1750122293,1750122394,1750122394.262827,-18000,,
com.microsoft.VSCode,5,1750122288,1750122293,1750122293.678751,-18000,,
com.google.Chrome,3,1750122285,1750122288,1750122289.007901,-18000,,
com.microsoft.VSCode,4,1750122281,1750122285,1750122285.713772,-18000,,
com.google.Chrome,46,1750122235,1750122281,1750122281.932697,-18000,,
com.microsoft.VSCode,2,1750122233,1750122235,1750122235.607846,-18000,,
com.google.Chrome,96,1750122137,1750122233,1750122233.395639,-18000,,
com.microsoft.VSCode,1,1750122136,1750122137,1750122137.773528,-18000,,
com.google.Chrome,8,1750122128,1750122136,1750122136.298223,-18000,,
com.microsoft.VSCode,1,1750122127,1750122128,1750122128.864087,-18000,,
com.google.Chrome,1,1750122126,1750122127,1750122127.899368,-18000,,
com.microsoft.VSCode,1,1750122125,1750122126,1750122126.624758,-18000,,
com.google.Chrome,7,1750122118,1750122125,1750122125.231363,-18000,,
com.microsoft.VSCode,13,1750122105,1750122118,1750122118.6902962,-18000,,
com.google.Chrome,86,1750122019,1750122105,1750122105.119996,-18000,,
com.microsoft.VSCode,172,1750121847,1750122019,1750122019.655683,-18000,,
com.google.Chrome,36,1750121811,1750121847,1750121847.586739,-18000,,
com.microsoft.VSCode,352,1750121459,1750121811,1750121811.747338,-18000,,
com.google.Chrome,36,1750121423,1750121459,1750121459.639202,-18000,,
com.microsoft.VSCode,383,1750121040,1750121423,1750121423.890804,-18000,,
com.google.Chrome,2,1750121038,1750121040,1750121041.032594,-18000,,
com.microsoft.VSCode,6,1750121032,1750121038,1750121038.4597712,-18000,,
com.google.Chrome,2,1750121030,1750121032,1750121032.876573,-18000,,
com.microsoft.VSCode,7,1750121023,1750121030,1750121030.403343,-18000,,
com.google.Chrome,3,1750121020,1750121023,1750121023.655848,-18000,,
com.microsoft.VSCode,19,1750121001,1750121020,1750121020.514849,-18000,,
com.google.Chrome,6,1750120995,1750121001,1750121001.217012,-18000,,
com.microsoft.VSCode,25,1750120970,1750120995,1750120995.8711128,-18000,,
com.google.Chrome,3,1750120967,1750120970,1750120970.383899,-18000,,
com.microsoft.VSCode,0,1750120967,1750120967,1750120967.842176,-18000,,
com.google.Chrome,3,1750120964,1750120967,1750120967.40956,-18000,,
com.microsoft.VSCode,18,1750120946,1750120964,1750120964.7974238,-18000,,
com.google.Chrome,11,1750120935,1750120946,1750120946.523563,-18000,,
com.microsoft.VSCode,184,1750120751,1750120935,1750120935.5794291,-18000,,
com.apple.Notes,11,1750120740,1750120751,1750120751.316261,-18000,,
com.microsoft.VSCode,4,1750120736,1750120740,1750120740.1948318,-18000,,
com.apple.Notes,1,1750120735,1750120736,1750120736.509572,-18000,,
com.microsoft.VSCode,19,1750120716,1750120735,1750120735.6964312,-18000,,
com.apple.Notes,4,1750120712,1750120716,1750120717.024517,-18000,,
com.microsoft.VSCode,54,1750120658,1750120712,1750120712.349494,-18000,,
com.apple.Notes,157,1750120501,1750120658,1750120658.558501,-18000,,
com.microsoft.VSCode,1,1750120500,1750120501,1750120501.673119,-18000,,
com.apple.Notes,7,1750120493,1750120500,1750120500.9547,-18000,,
com.microsoft.VSCode,7,1750120486,1750120493,1750120493.798497,-18000,,
com.apple.Notes,3,1750120483,1750120486,1750120486.58408,-18000,,
com.microsoft.VSCode,3,1750120480,1750120483,1750120483.5068789,-18000,,
com.apple.Notes,12,1750120468,1750120480,1750120480.972003,-18000,,
com.microsoft.VSCode,11,1750120457,1750120468,1750120468.635511,-18000,,
com.apple.Notes,10,1750120447,1750120457,1750120457.303646,-18000,,
com.microsoft.VSCode,4,1750120443,1750120447,1750120447.944624,-18000,,
com.apple.Notes,2,1750120441,1750120443,1750120443.6396232,-18000,,
com.microsoft.VSCode,9,1750120432,1750120441,1750120441.4253058,-18000,,
com.apple.Notes,2,1750120430,1750120432,1750120432.665406,-18000,,
com.microsoft.VSCode,5,1750120425,1750120430,1750120430.494618,-18000,,
com.apple.Notes,45,1750120380,1750120425,1750120425.742875,-18000,,
com.google.Chrome,28,1750120352,1750120380,1750120380.084625,-18000,,
com.apple.Notes,6,1750120346,1750120352,1750120352.18419,-18000,,
com.microsoft.VSCode,54,1750120292,1750120346,1750120346.557744,-18000,,
com.apple.Notes,11,1750120281,1750120292,1750120292.2550201,-18000,,
com.google.Chrome,1226,1750119055,1750120281,1750120281.509004,-18000,,
com.apple.Notes,5,1750119050,1750119055,1750119056.8236,-18000,,
com.apple.finder,1,1750119049,1750119050,1750119050.7898831,-18000,,
com.leomehlig.today,4,1750119045,1750119049,1750119049.5196,-18000,,
com.apple.iCal,2,1750119043,1750119045,1750119045.34204,-18000,,
com.google.Chrome,7,1750119036,1750119043,1750119044.460617,-18000,,
com.google.Chrome,948,1750117074,1750118022,1750118022.567555,-18000,,
com.google.Chrome,451,1750115828,1750116279,1750116279.062718,-18000,,
com.apple.iCal,69,1750115759,1750115828,1750115828.148715,-18000,,
com.leomehlig.today,152,1750115607,1750115759,1750115759.9310389,-18000,,
com.apple.iCal,35,1750115572,1750115607,1750115607.673207,-18000,,
com.leomehlig.today,99,1750115473,1750115572,1750115572.027893,-18000,,
com.google.Chrome,2,1750115471,1750115473,1750115473.517342,-18000,,
com.google.Chrome,312,1750111397,1750111709,1750111709.440226,-18000,,
com.apple.WebSheet,8,1750035802,1750035810,1750035811.028535,-25200,EB445137-D7F5-57EC-87DA-1DB460D64046,"iPhone13,2"
com.toyopagroup.picaboo,6,1750034648,1750034654,1750034655.112925,-25200,EB445137-D7F5-57EC-87DA-1DB460D64046,"iPhone13,2"
com.google.chrome.ios,69,1750033743,1750033812,1750033812.652767,-25200,EB445137-D7F5-57EC-87DA-1DB460D64046,"iPhone13,2"
com.google.chrome.ios,274,1750032580,1750032854,1750032854.943245,-25200,EB445137-D7F5-57EC-87DA-1DB460D64046,"iPhone13,2"
com.clairmail.fth.client,1,1750032579,1750032580,1750032580.753406,-25200,EB445137-D7F5-57EC-87DA-1DB460D64046,"iPhone13,2"
com.clairmail.fth.client,0,1750032578,1750032578,1750032578.763198,-25200,EB445137-D7F5-57EC-87DA-1DB460D64046,"iPhone13,2"
com.apple.CoreAuthUI,2,1750032008,1750032010,1750032010.7120671,-25200,EB445137-D7F5-57EC-87DA-1DB460D64046,"iPhone13,2"
com.clairmail.fth.client,131,1750032004,1750032135,1750032135.95182,-25200,EB445137-D7F5-57EC-87DA-1DB460D64046,"iPhone13,2"
com.apple.calculator,2,1750031994,1750031996,1750031996.334522,-25200,EB445137-D7F5-57EC-87DA-1DB460D64046,"iPhone13,2"
com.apple.calculator,36,1750031570,1750031606,1750031606.453815,-25200,EB445137-D7F5-57EC-87DA-1DB460D64046,"iPhone13,2"
com.apple.Music,4,1750031348,1750031352,1750031352.420333,-25200,EB445137-D7F5-57EC-87DA-1DB460D64046,"iPhone13,2"
com.apple.Music,43,1750029062,1750029105,1750029105.1507459,-25200,EB445137-D7F5-57EC-87DA-1DB460D64046,"iPhone13,2"
com.clairmail.fth.client,2,1750029046,1750029048,1750029048.028058,-25200,EB445137-D7F5-57EC-87DA-1DB460D64046,"iPhone13,2"
com.apple.CoreAuthUI,2,1750029026,1750029028,1750029028.487242,-25200,EB445137-D7F5-57EC-87DA-1DB460D64046,"iPhone13,2"
com.clairmail.fth.client,24,1750029019,1750029043,1750029043.657734,-25200,EB445137-D7F5-57EC-87DA-1DB460D64046,"iPhone13,2"
com.apple.calculator,2,1750029015,1750029017,1750029017.210384,-25200,EB445137-D7F5-57EC-87DA-1DB460D64046,"iPhone13,2"
com.apple.calculator,5,1750029010,1750029015,1750029015.620451,-25200,EB445137-D7F5-57EC-87DA-1DB460D64046,"iPhone13,2"
com.apple.calculator,20,1750028300,1750028320,1750028321.066705,-25200,EB445137-D7F5-57EC-87DA-1DB460D64046,"iPhone13,2"
com.google.Gmail,37,1750028263,1750028300,1750028300.659277,-25200,EB445137-D7F5-57EC-87DA-1DB460D64046,"iPhone13,2"
com.toyopagroup.picaboo,12,1750028062,1750028074,1750028075.056268,-25200,EB445137-D7F5-57EC-87DA-1DB460D64046,"iPhone13,2"
com.google.chrome.ios,72,1750027983,1750028055,1750028055.856316,-25200,EB445137-D7F5-57EC-87DA-1DB460D64046,"iPhone13,2"
com.apple.MobileSMS,25,1750027680,1750027705,1750027705.253264,-25200,EB445137-D7F5-57EC-87DA-1DB460D64046,"iPhone13,2"
com.apple.mobilecal,0,1750027680,1750027680,1750027680.371315,-25200,EB445137-D7F5-57EC-87DA-1DB460D64046,"iPhone13,2"
com.apple.mobilecal,17,1750024945,1750024962,1750024962.564291,-25200,EB445137-D7F5-57EC-87DA-1DB460D64046,"iPhone13,2"
com.apple.mobilecal,31,1750024776,1750024807,1750024807.349424,-25200,EB445137-D7F5-57EC-87DA-1DB460D64046,"iPhone13,2"
com.apple.Maps,3,1750024770,1750024773,1750024774.885758,-25200,EB445137-D7F5-57EC-87DA-1DB460D64046,"iPhone13,2"
com.google.chrome.ios,138,1750024590,1750024728,1750024728.9308681,-25200,EB445137-D7F5-57EC-87DA-1DB460D64046,"iPhone13,2"
com.apple.MobileSMS,15,1750024537,1750024552,1750024552.810718,-25200,EB445137-D7F5-57EC-87DA-1DB460D64046,"iPhone13,2"
com.google.chrome.ios,0,1750024537,1750024537,1750024537.986779,-25200,EB445137-D7F5-57EC-87DA-1DB460D64046,"iPhone13,2"
com.google.chrome.ios,274,1750024209,1750024483,1750024483.186133,-25200,EB445137-D7F5-57EC-87DA-1DB460D64046,"iPhone13,2"
com.google.chrome.ios,70,1750024115,1750024185,1750024185.450611,-25200,EB445137-D7F5-57EC-87DA-1DB460D64046,"iPhone13,2"
com.apple.Maps,2,1750024113,1750024115,1750024115.471107,-25200,EB445137-D7F5-57EC-87DA-1DB460D64046,"iPhone13,2"
com.apple.Maps,61,1750024006,1750024067,1750024067.238387,-25200,EB445137-D7F5-57EC-87DA-1DB460D64046,"iPhone13,2"
com.toyopagroup.picaboo,2,1750023764,1750023766,1750023766.2819362,-25200,EB445137-D7F5-57EC-87DA-1DB460D64046,"iPhone13,2"
com.toyopagroup.picaboo,5,1750023366,1750023371,1750023371.8472009,-25200,EB445137-D7F5-57EC-87DA-1DB460D64046,"iPhone13,2"
com.toyopagroup.picaboo,8,1750023041,1750023049,1750023049.391211,-25200,EB445137-D7F5-57EC-87DA-1DB460D64046,"iPhone13,2"
com.toyopagroup.picaboo,59,1750022916,1750022975,1750022977.585787,-25200,EB445137-D7F5-57EC-87DA-1DB460D64046,"iPhone13,2"
com.apple.Maps,2,1750022912,1750022914,1750022914.3764439,-25200,EB445137-D7F5-57EC-87DA-1DB460D64046,"iPhone13,2"
com.apple.Maps,13,1750022630,1750022643,1750022643.706166,-25200,EB445137-D7F5-57EC-87DA-1DB460D64046,"iPhone13,2"
com.netflix.Netflix,1,1750022628,1750022629,1750022629.84699,-25200,EB445137-D7F5-57EC-87DA-1DB460D64046,"iPhone13,2"
com.netflix.Netflix,17,1750022504,1750022521,1750022521.516028,-25200,EB445137-D7F5-57EC-87DA-1DB460D64046,"iPhone13,2"
com.apple.news,2,1750022493,1750022495,1750022495.531098,-25200,EB445137-D7F5-57EC-87DA-1DB460D64046,"iPhone13,2"
com.apple.news,21,1750021986,1750022007,1750022008.0987902,-25200,EB445137-D7F5-57EC-87DA-1DB460D64046,"iPhone13,2"
com.apple.CoreAuthUI,7,1750021918,1750021925,1750021925.172279,-25200,EB445137-D7F5-57EC-87DA-1DB460D64046,"iPhone13,2"
com.truebill.truebillnative,69,1750021913,1750021982,1750021982.404547,-25200,EB445137-D7F5-57EC-87DA-1DB460D64046,"iPhone13,2"
com.apple.MobileSMS,65,1750021843,1750021908,1750021908.239088,-25200,EB445137-D7F5-57EC-87DA-1DB460D64046,"iPhone13,2"
com.apple.Maps,0,1750021843,1750021843,1750021844.624031,-25200,EB445137-D7F5-57EC-87DA-1DB460D64046,"iPhone13,2"
com.apple.Maps,10,1750021746,1750021756,1750021757.071464,-25200,EB445137-D7F5-57EC-87DA-1DB460D64046,"iPhone13,2"
com.toyopagroup.picaboo,2,1750021744,1750021746,1750021746.4908319,-25200,EB445137-D7F5-57EC-87DA-1DB460D64046,"iPhone13,2"
com.toyopagroup.picaboo,29,1750021325,1750021354,1750021355.379977,-25200,EB445137-D7F5-57EC-87DA-1DB460D64046,"iPhone13,2"
com.apple.Maps,2,1750021321,1750021323,1750021323.0705519,-25200,EB445137-D7F5-57EC-87DA-1DB460D64046,"iPhone13,2"
com.apple.Maps,16,1750017153,1750017169,1750017169.217874,-25200,EB445137-D7F5-57EC-87DA-1DB460D64046,"iPhone13,2"
com.apple.mobilecal,7,1750016923,1750016930,1750016930.543109,-25200,EB445137-D7F5-57EC-87DA-1DB460D64046,"iPhone13,2"
com.apple.Maps,2,1750016918,1750016920,1750016920.083482,-25200,EB445137-D7F5-57EC-87DA-1DB460D64046,"iPhone13,2"
com.apple.Maps,161,1750016467,1750016628,1750016628.7397718,-25200,EB445137-D7F5-57EC-87DA-1DB460D64046,"iPhone13,2"
com.apple.Maps,12,1750016339,1750016351,1750016352.209243,-25200,EB445137-D7F5-57EC-87DA-1DB460D64046,"iPhone13,2"
com.apple.Maps,2,1750016336,1750016338,1750016338.8291512,-25200,EB445137-D7F5-57EC-87DA-1DB460D64046,"iPhone13,2"
com.apple.Maps,1,1750016330,1750016331,1750016331.8617911,-25200,EB445137-D7F5-57EC-87DA-1DB460D64046,"iPhone13,2"
com.apple.Maps,30,1750015762,1750015792,1750015792.881901,-25200,EB445137-D7F5-57EC-87DA-1DB460D64046,"iPhone13,2"
com.apple.Maps,247,1750015110,1750015357,1750015357.49924,-25200,EB445137-D7F5-57EC-87DA-1DB460D64046,"iPhone13,2"
com.apple.Maps,290,1750014760,1750015050,1750015050.694223,-25200,EB445137-D7F5-57EC-87DA-1DB460D64046,"iPhone13,2"
com.netflix.Netflix,11,1750014749,1750014760,1750014760.177925,-25200,EB445137-D7F5-57EC-87DA-1DB460D64046,"iPhone13,2"
com.netflix.Netflix,18,1750014417,1750014435,1750014435.5138931,-25200,EB445137-D7F5-57EC-87DA-1DB460D64046,"iPhone13,2"
com.apple.Preferences,13,1750014404,1750014417,1750014417.402461,-25200,EB445137-D7F5-57EC-87DA-1DB460D64046,"iPhone13,2"
com.netflix.Netflix,200,1750014203,1750014403,1750014403.573858,-25200,EB445137-D7F5-57EC-87DA-1DB460D64046,"iPhone13,2"
com.apple.Maps,3,1750014198,1750014201,1750014201.503403,-25200,EB445137-D7F5-57EC-87DA-1DB460D64046,"iPhone13,2"
com.apple.Maps,87,1750013375,1750013462,1750013462.4829612,-25200,EB445137-D7F5-57EC-87DA-1DB460D64046,"iPhone13,2"
com.apple.PosterBoard,0,1750013375,1750013375,1750013377.213863,-25200,EB445137-D7F5-57EC-87DA-1DB460D64046,"iPhone13,2"
com.apple.Maps,67,1750012932,1750012999,1750012999.716426,-25200,EB445137-D7F5-57EC-87DA-1DB460D64046,"iPhone13,2"
com.apple.Music,1,1750012931,1750012932,1750012932.6490011,-25200,EB445137-D7F5-57EC-87DA-1DB460D64046,"iPhone13,2"
com.apple.Music,29,1750012402,1750012431,1750012431.794138,-25200,EB445137-D7F5-57EC-87DA-1DB460D64046,"iPhone13,2"
com.apple.mobilephone,5,1750012390,1750012395,1750012395.948756,-25200,EB445137-D7F5-57EC-87DA-1DB460D64046,"iPhone13,2"
com.apple.weather,2,1750012387,1750012389,1750012389.7795038,-25200,EB445137-D7F5-57EC-87DA-1DB460D64046,"iPhone13,2"
com.apple.weather,36,1750010669,1750010705,1750010705.8225079,-25200,EB445137-D7F5-57EC-87DA-1DB460D64046,"iPhone13,2"
com.apple.Music,1,1750010668,1750010669,1750010669.466051,-25200,EB445137-D7F5-57EC-87DA-1DB460D64046,"iPhone13,2"
com.apple.Music,81,1750008909,1750008990,1750008990.425374,-25200,EB445137-D7F5-57EC-87DA-1DB460D64046,"iPhone13,2"
com.apple.Music,32,1750008480,1750008512,1750008512.661387,-25200,EB445137-D7F5-57EC-87DA-1DB460D64046,"iPhone13,2"
com.apple.Music,83,1750008169,1750008252,1750008252.914273,-25200,EB445137-D7F5-57EC-87DA-1DB460D64046,"iPhone13,2"
com.apple.Music,47,1750008105,1750008152,1750008152.138002,-25200,EB445137-D7F5-57EC-87DA-1DB460D64046,"iPhone13,2"
com.apple.Music,41,1750007764,1750007805,1750007805.0274181,-25200,EB445137-D7F5-57EC-87DA-1DB460D64046,"iPhone13,2"
com.apple.Music,4,1750007561,1750007565,1750007565.822128,-25200,EB445137-D7F5-57EC-87DA-1DB460D64046,"iPhone13,2"
com.apple.Music,27,1750007006,1750007033,1750007033.075059,-25200,EB445137-D7F5-57EC-87DA-1DB460D64046,"iPhone13,2"
com.apple.Music,7,1750006496,1750006503,1750006503.534799,-25200,EB445137-D7F5-57EC-87DA-1DB460D64046,"iPhone13,2"
com.apple.Music,10,1750006322,1750006332,1750006332.32301,-25200,EB445137-D7F5-57EC-87DA-1DB460D64046,"iPhone13,2"
com.apple.findmy,29,1750006028,1750006057,1750006057.875515,-25200,EB445137-D7F5-57EC-87DA-1DB460D64046,"iPhone13,2"
com.apple.MobileSMS,2,1750006021,1750006023,1750006023.5766392,-25200,EB445137-D7F5-57EC-87DA-1DB460D64046,"iPhone13,2"
com.apple.MobileSMS,29,1750005981,1750006010,1750006010.335711,-25200,EB445137-D7F5-57EC-87DA-1DB460D64046,"iPhone13,2"
com.apple.Music,1,1750005980,1750005981,1750005982.1076632,-25200,EB445137-D7F5-57EC-87DA-1DB460D64046,"iPhone13,2"
com.apple.Music,7,1750005266,1750005273,1750005273.147318,-25200,EB445137-D7F5-57EC-87DA-1DB460D64046,"iPhone13,2"
com.apple.Music,7,1750005006,1750005013,1750005013.345433,-25200,EB445137-D7F5-57EC-87DA-1DB460D64046,"iPhone13,2"
com.apple.Music,4,1750004872,1750004876,1750004876.797549,-25200,EB445137-D7F5-57EC-87DA-1DB460D64046,"iPhone13,2"
com.apple.Music,10,1750004858,1750004868,1750004868.2656531,-25200,EB445137-D7F5-57EC-87DA-1DB460D64046,"iPhone13,2"
com.apple.Music,48,1750004686,1750004734,1750004734.1231608,-25200,EB445137-D7F5-57EC-87DA-1DB460D64046,"iPhone13,2"
com.apple.Music,17,1750004273,1750004290,1750004290.760701,-25200,EB445137-D7F5-57EC-87DA-1DB460D64046,"iPhone13,2"
com.apple.Maps,2,1750004271,1750004273,1750004273.105157,-25200,EB445137-D7F5-57EC-87DA-1DB460D64046,"iPhone13,2"
com.apple.Maps,139,1750003903,1750004042,1750004042.751214,-25200,EB445137-D7F5-57EC-87DA-1DB460D64046,"iPhone13,2"
com.apple.Music,1,1750003901,1750003902,1750003902.8643,-25200,EB445137-D7F5-57EC-87DA-1DB460D64046,"iPhone13,2"
com.apple.Music,57,1750003633,1750003690,1750003690.3301802,-25200,EB445137-D7F5-57EC-87DA-1DB460D64046,"iPhone13,2"
com.apple.news,45,1750003511,1750003556,1750003556.7323809,-25200,EB445137-D7F5-57EC-87DA-1DB460D64046,"iPhone13,2"
com.apple.news,259,1750003251,1750003510,1750003510.422656,-25200,EB445137-D7F5-57EC-87DA-1DB460D64046,"iPhone13,2"
com.toyopagroup.picaboo,1,1750003249,1750003250,1750003250.944686,-25200,EB445137-D7F5-57EC-87DA-1DB460D64046,"iPhone13,2"
com.toyopagroup.picaboo,8,1750003219,1750003227,1750003227.299203,-25200,EB445137-D7F5-57EC-87DA-1DB460D64046,"iPhone13,2"
com.apple.MobileSMS,140,1750003077,1750003217,1750003217.189386,-25200,EB445137-D7F5-57EC-87DA-1DB460D64046,"iPhone13,2"
com.apple.mobilecal,53,1749999385,1749999438,1749999438.05108,-25200,EB445137-D7F5-57EC-87DA-1DB460D64046,"iPhone13,2"
com.google.chrome.ios,14,1749999371,1749999385,1749999385.4785419,-25200,EB445137-D7F5-57EC-87DA-1DB460D64046,"iPhone13,2"
com.apple.mobilecal,13,1749999358,1749999371,1749999371.2088041,-25200,EB445137-D7F5-57EC-87DA-1DB460D64046,"iPhone13,2"
com.google.chrome.ios,9,1749999340,1749999349,1749999349.96033,-25200,EB445137-D7F5-57EC-87DA-1DB460D64046,"iPhone13,2"
com.google.Gmail,11,1749999328,1749999339,1749999339.700351,-25200,EB445137-D7F5-57EC-87DA-1DB460D64046,"iPhone13,2"
com.google.chrome.ios,0,1749999328,1749999328,1749999329.117063,-25200,EB445137-D7F5-57EC-87DA-1DB460D64046,"iPhone13,2"
com.google.chrome.ios,345,1749998982,1749999327,1749999327.2471972,-25200,EB445137-D7F5-57EC-87DA-1DB460D64046,"iPhone13,2"
com.google.chrome.ios,71,1749998911,1749998982,1749998982.293377,-25200,EB445137-D7F5-57EC-87DA-1DB460D64046,"iPhone13,2"
com.apple.CoreAuthUI,3,1749998889,1749998892,1749998892.381387,-25200,EB445137-D7F5-57EC-87DA-1DB460D64046,"iPhone13,2"
com.truebill.truebillnative,24,1749998887,1749998911,1749998911.488213,-25200,EB445137-D7F5-57EC-87DA-1DB460D64046,"iPhone13,2"
Astrospheric.Astrospheric,91,1749998781,1749998872,1749998872.149286,-25200,EB445137-D7F5-57EC-87DA-1DB460D64046,"iPhone13,2"
com.apple.weather,51,1749998726,1749998777,1749998777.882515,-25200,EB445137-D7F5-57EC-87DA-1DB460D64046,"iPhone13,2"
com.toyopagroup.picaboo,26,1749998699,1749998725,1749998725.730495,-25200,EB445137-D7F5-57EC-87DA-1DB460D64046,"iPhone13,2"
com.apple.news,315,1749998072,1749998387,1749998387.54738,-25200,EB445137-D7F5-57EC-87DA-1DB460D64046,"iPhone13,2"
com.toyopagroup.picaboo,51,1749997998,1749998049,1749998049.086083,-25200,EB445137-D7F5-57EC-87DA-1DB460D64046,"iPhone13,2"
com.apple.mobileslideshow,174,1749997821,1749997995,1749997995.591763,-25200,EB445137-D7F5-57EC-87DA-1DB460D64046,"iPhone13,2"
com.apple.MobileSMS,26,1749997645,1749997671,1749997671.4314198,-25200,EB445137-D7F5-57EC-87DA-1DB460D64046,"iPhone13,2"
com.toyopagroup.picaboo,13,1749997632,1749997645,1749997645.3110209,-25200,EB445137-D7F5-57EC-87DA-1DB460D64046,"iPhone13,2"
com.apple.weather,1,1749997631,1749997632,1749997632.784021,-25200,EB445137-D7F5-57EC-87DA-1DB460D64046,"iPhone13,2"
com.apple.weather,2,1749997627,1749997629,1749997629.760775,-25200,EB445137-D7F5-57EC-87DA-1DB460D64046,"iPhone13,2"
com.apple.weather,3,1749995366,1749995369,1749995369.689207,-25200,EB445137-D7F5-57EC-87DA-1DB460D64046,"iPhone13,2"
com.markhambly.APOD,2,1749995364,1749995366,1749995366.208928,-25200,EB445137-D7F5-57EC-87DA-1DB460D64046,"iPhone13,2"
com.strava.stravaride,15,1749995345,1749995360,1749995360.302809,-25200,EB445137-D7F5-57EC-87DA-1DB460D64046,"iPhone13,2"
com.apple.MobileSMS,1,1749995344,1749995345,1749995345.658345,-25200,EB445137-D7F5-57EC-87DA-1DB460D64046,"iPhone13,2"
com.google.Chrome,311,1749858155,1749858466,1749858466.8485022,-25200,,
com.google.Chrome,368,1749851481,1749851849,1749851849.5780602,-25200,,
com.apple.finder,15,1749851466,1749851481,1749851481.3842812,-25200,,
com.google.Chrome,806,1749850660,1749851466,1749851466.8802428,-25200,,
com.apple.Notes,1,1749850659,1749850660,1749850660.5056581,-25200,,
com.google.Chrome,29,1749850630,1749850659,1749850659.955852,-25200,,
com.apple.Notes,6,1749850624,1749850630,1749850630.982215,-25200,,
com.google.Chrome,6,1749850618,1749850624,1749850624.5987,-25200,,
com.apple.finder,6,1749850612,1749850618,1749850618.1857271,-25200,,
com.google.Chrome,199,1749850413,1749850612,1749850612.118895,-25200,,
com.t11.celeste,50,1749787207,1749787257,1749787257.4452739,-25200,EB445137-D7F5-57EC-87DA-1DB460D64046,"iPhone13,2"
com.t11.celeste,15,1749787191,1749787206,1749787206.959216,-25200,EB445137-D7F5-57EC-87DA-1DB460D64046,"iPhone13,2"
com.t11.celeste,27,1749787097,1749787124,1749787124.268884,-25200,EB445137-D7F5-57EC-87DA-1DB460D64046,"iPhone13,2"
com.t11.celeste,15,1749787004,1749787019,1749787019.968004,-25200,EB445137-D7F5-57EC-87DA-1DB460D64046,"iPhone13,2"
com.t11.celeste,13,1749786988,1749787001,1749787001.625757,-25200,EB445137-D7F5-57EC-87DA-1DB460D64046,"iPhone13,2"
com.t11.celeste,38,1749786815,1749786853,1749786853.4636579,-25200,EB445137-D7F5-57EC-87DA-1DB460D64046,"iPhone13,2"
com.tier9digital.sundial,1,1749786788,1749786789,1749786789.903335,-25200,EB445137-D7F5-57EC-87DA-1DB460D64046,"iPhone13,2"
com.tier9digital.sundial,8,1749786637,1749786645,1749786645.598796,-25200,EB445137-D7F5-57EC-87DA-1DB460D64046,"iPhone13,2"
com.apple.Fitness,2,1749786629,1749786631,1749786631.268059,-25200,EB445137-D7F5-57EC-87DA-1DB460D64046,"iPhone13,2"
com.apple.mobiletimer,3,1749785824,1749785827,1749785827.43768,-25200,EB445137-D7F5-57EC-87DA-1DB460D64046,"iPhone13,2"
com.apple.mobiletimer,62,1749784230,1749784292,1749784292.9968739,-25200,EB445137-D7F5-57EC-87DA-1DB460D64046,"iPhone13,2"
com.google.chrome.ios,1,1749784229,1749784230,1749784230.871554,-25200,EB445137-D7F5-57EC-87DA-1DB460D64046,"iPhone13,2"
com.google.chrome.ios,61,1749783660,1749783721,1749783721.873008,-25200,EB445137-D7F5-57EC-87DA-1DB460D64046,"iPhone13,2"
com.apple.mobiletimer,1,1749783659,1749783660,1749783660.7053928,-25200,EB445137-D7F5-57EC-87DA-1DB460D64046,"iPhone13,2"
com.apple.mobiletimer,50,1749783557,1749783607,1749783607.1627378,-25200,EB445137-D7F5-57EC-87DA-1DB460D64046,"iPhone13,2"
com.google.chrome.ios,825,1749782674,1749783499,1749783499.100127,-25200,EB445137-D7F5-57EC-87DA-1DB460D64046,"iPhone13,2"
com.apple.Maps,110,1749781962,1749782072,1749782072.2643862,-25200,EB445137-D7F5-57EC-87DA-1DB460D64046,"iPhone13,2"
com.apple.news,90,1749781772,1749781862,1749781862.688375,-25200,EB445137-D7F5-57EC-87DA-1DB460D64046,"iPhone13,2"
com.apple.mobileslideshow,28,1749781739,1749781767,1749781767.879319,-25200,EB445137-D7F5-57EC-87DA-1DB460D64046,"iPhone13,2"
com.apple.Maps,0,1749781739,1749781739,1749781739.948504,-25200,EB445137-D7F5-57EC-87DA-1DB460D64046,"iPhone13,2"
com.apple.Maps,124,1749781055,1749781179,1749781179.236927,-25200,EB445137-D7F5-57EC-87DA-1DB460D64046,"iPhone13,2"
com.apple.Maps,401,1749779393,1749779794,1749779794.5165749,-25200,EB445137-D7F5-57EC-87DA-1DB460D64046,"iPhone13,2"
com.apple.mobileslideshow,10,1749779245,1749779255,1749779255.047927,-25200,EB445137-D7F5-57EC-87DA-1DB460D64046,"iPhone13,2"
com.myfitnesspal.mfp,0,1749779245,1749779245,1749779250.970173,-25200,EB445137-D7F5-57EC-87DA-1DB460D64046,"iPhone13,2"
com.apple.AuthenticationServicesUI,6,1749776768,1749776774,1749776774.1890922,-25200,EB445137-D7F5-57EC-87DA-1DB460D64046,"iPhone13,2"
com.myfitnesspal.mfp,107,1749776758,1749776865,1749776866.118484,-25200,EB445137-D7F5-57EC-87DA-1DB460D64046,"iPhone13,2"
com.apple.PassbookUIService,4,1749776733,1749776737,1749776737.5771499,-25200,EB445137-D7F5-57EC-87DA-1DB460D64046,"iPhone13,2"
com.apple.MobileSMS,3,1749776723,1749776726,1749776726.619201,-25200,EB445137-D7F5-57EC-87DA-1DB460D64046,"iPhone13,2"
com.apple.MobileSMS,25,1749775936,1749775961,1749775961.64026,-25200,EB445137-D7F5-57EC-87DA-1DB460D64046,"iPhone13,2"
com.apple.MobileSMS,242,1749775683,1749775925,1749775925.9311938,-25200,EB445137-D7F5-57EC-87DA-1DB460D64046,"iPhone13,2"
com.apple.mobileslideshow,123,1749775560,1749775683,1749775683.879843,-25200,EB445137-D7F5-57EC-87DA-1DB460D64046,"iPhone13,2"
com.strava.stravaride,56,1749775503,1749775559,1749775560.034649,-25200,EB445137-D7F5-57EC-87DA-1DB460D64046,"iPhone13,2"
com.apple.mobileslideshow,146,1749775355,1749775501,1749775501.690387,-25200,EB445137-D7F5-57EC-87DA-1DB460D64046,"iPhone13,2"
com.strava.stravaride,167,1749769067,1749769234,1749769234.713441,-25200,EB445137-D7F5-57EC-87DA-1DB460D64046,"iPhone13,2"
com.apple.Maps,317,1749768640,1749768957,1749768958.167557,-25200,EB445137-D7F5-57EC-87DA-1DB460D64046,"iPhone13,2"
com.alltrails.AllTrails,59,1749768581,1749768640,1749768640.6308079,-25200,EB445137-D7F5-57EC-87DA-1DB460D64046,"iPhone13,2"
com.apple.Maps,11,1749768570,1749768581,1749768581.138515,-25200,EB445137-D7F5-57EC-87DA-1DB460D64046,"iPhone13,2"
com.alltrails.AllTrails,43,1749768527,1749768570,1749768570.5957398,-25200,EB445137-D7F5-57EC-87DA-1DB460D64046,"iPhone13,2"
com.apple.Maps,174,1749768347,1749768521,1749768521.825712,-25200,EB445137-D7F5-57EC-87DA-1DB460D64046,"iPhone13,2"
com.strava.stravaride,539,1749767765,1749768304,1749768304.9864988,-25200,EB445137-D7F5-57EC-87DA-1DB460D64046,"iPhone13,2"
com.toyopagroup.picaboo,15,1749767736,1749767751,1749767751.3595119,-25200,EB445137-D7F5-57EC-87DA-1DB460D64046,"iPhone13,2"
com.toyopagroup.picaboo,25,1749766437,1749766462,1749766462.7177138,-25200,EB445137-D7F5-57EC-87DA-1DB460D64046,"iPhone13,2"
com.toyopagroup.picaboo,77,1749765428,1749765505,1749765505.494792,-25200,EB445137-D7F5-57EC-87DA-1DB460D64046,"iPhone13,2"
com.apple.mobileslideshow,17,1749765411,1749765428,1749765428.867681,-25200,EB445137-D7F5-57EC-87DA-1DB460D64046,"iPhone13,2"
com.toyopagroup.picaboo,3,1749765408,1749765411,1749765411.916932,-25200,EB445137-D7F5-57EC-87DA-1DB460D64046,"iPhone13,2"
com.apple.mobileslideshow,62,1749765342,1749765404,1749765404.940759,-25200,EB445137-D7F5-57EC-87DA-1DB460D64046,"iPhone13,2"
com.google.Gmail,2,1749765340,1749765342,1749765342.0277681,-25200,EB445137-D7F5-57EC-87DA-1DB460D64046,"iPhone13,2"
com.google.Gmail,24,1749765209,1749765233,1749765233.184638,-25200,EB445137-D7F5-57EC-87DA-1DB460D64046,"iPhone13,2"
com.apple.Maps,1,1749765208,1749765209,1749765209.5540771,-25200,EB445137-D7F5-57EC-87DA-1DB460D64046,"iPhone13,2"
com.apple.Maps,14,1749761272,1749761286,1749761286.138393,-25200,EB445137-D7F5-57EC-87DA-1DB460D64046,"iPhone13,2"
com.google.chrome.ios,2,1749761269,1749761271,1749761271.5765362,-25200,EB445137-D7F5-57EC-87DA-1DB460D64046,"iPhone13,2"
com.google.chrome.ios,95,1749760376,1749760471,1749760471.1947389,-25200,EB445137-D7F5-57EC-87DA-1DB460D64046,"iPhone13,2"
com.apple.Maps,9,1749760367,1749760376,1749760376.625348,-25200,EB445137-D7F5-57EC-87DA-1DB460D64046,"iPhone13,2"
com.apple.Maps,3,1749760205,1749760208,1749760208.336308,-25200,EB445137-D7F5-57EC-87DA-1DB460D64046,"iPhone13,2"
com.google.chrome.ios,2,1749760203,1749760205,1749760205.748606,-25200,EB445137-D7F5-57EC-87DA-1DB460D64046,"iPhone13,2"
com.google.chrome.ios,40,1749760118,1749760158,1749760158.646373,-25200,EB445137-D7F5-57EC-87DA-1DB460D64046,"iPhone13,2"
com.google.chrome.ios,91,1749759510,1749759601,1749759601.16587,-25200,EB445137-D7F5-57EC-87DA-1DB460D64046,"iPhone13,2"
com.apple.Maps,29,1749757795,1749757824,1749757824.990755,-25200,EB445137-D7F5-57EC-87DA-1DB460D64046,"iPhone13,2"
com.apple.mobilenotes,110,1749757685,1749757795,1749757795.1047668,-25200,EB445137-D7F5-57EC-87DA-1DB460D64046,"iPhone13,2"
com.apple.Maps,166,1749757493,1749757659,1749757659.243957,-25200,EB445137-D7F5-57EC-87DA-1DB460D64046,"iPhone13,2"
com.alltrails.AllTrails,101,1749757392,1749757493,1749757493.130847,-25200,EB445137-D7F5-57EC-87DA-1DB460D64046,"iPhone13,2"
com.apple.Maps,49,1749757342,1749757391,1749757391.605767,-25200,EB445137-D7F5-57EC-87DA-1DB460D64046,"iPhone13,2"
com.apple.Maps,54,1749756633,1749756687,1749756687.823248,-25200,EB445137-D7F5-57EC-87DA-1DB460D64046,"iPhone13,2"
com.google.chrome.ios,3,1749756630,1749756633,1749756633.965924,-25200,EB445137-D7F5-57EC-87DA-1DB460D64046,"iPhone13,2"
com.google.chrome.ios,157,1749756440,1749756597,1749756597.553811,-25200,EB445137-D7F5-57EC-87DA-1DB460D64046,"iPhone13,2"
com.google.chrome.ios,145,1749755949,1749756094,1749756094.9863338,-25200,EB445137-D7F5-57EC-87DA-1DB460D64046,"iPhone13,2"
com.apple.Music,10,1749755939,1749755949,1749755949.69999,-25200,EB445137-D7F5-57EC-87DA-1DB460D64046,"iPhone13,2"
com.apple.musicrecognition,5,1749755934,1749755939,1749755940.0286732,-25200,EB445137-D7F5-57EC-87DA-1DB460D64046,"iPhone13,2"
com.google.chrome.ios,119,1749755815,1749755934,1749755934.76882,-25200,EB445137-D7F5-57EC-87DA-1DB460D64046,"iPhone13,2"
com.apple.Maps,90,1749755725,1749755815,1749755815.200259,-25200,EB445137-D7F5-57EC-87DA-1DB460D64046,"iPhone13,2"
com.google.chrome.ios,291,1749755433,1749755724,1749755724.782792,-25200,EB445137-D7F5-57EC-87DA-1DB460D64046,"iPhone13,2"
com.apple.mobileslideshow,4,1749755425,1749755429,1749755429.352308,-25200,EB445137-D7F5-57EC-87DA-1DB460D64046,"iPhone13,2"
com.apple.mobileslideshow,3,1749753651,1749753654,1749753654.848077,-25200,EB445137-D7F5-57EC-87DA-1DB460D64046,"iPhone13,2"
com.apple.mobileslideshow,20,1749753536,1749753556,1749753556.577301,-25200,EB445137-D7F5-57EC-87DA-1DB460D64046,"iPhone13,2"
com.apple.mobileslideshow,28,1749753505,1749753533,1749753533.363927,-25200,EB445137-D7F5-57EC-87DA-1DB460D64046,"iPhone13,2"
com.apple.Fitness,53,1749751382,1749751435,1749751435.301283,-25200,EB445137-D7F5-57EC-87DA-1DB460D64046,"iPhone13,2"
com.apple.Fitness,31,1749751320,1749751351,1749751351.812418,-25200,EB445137-D7F5-57EC-87DA-1DB460D64046,"iPhone13,2"
com.apple.MobileSMS,2,1749751318,1749751320,1749751320.524004,-25200,EB445137-D7F5-57EC-87DA-1DB460D64046,"iPhone13,2"
com.apple.MobileSMS,4,1749748715,1749748719,1749748719.2521272,-25200,EB445137-D7F5-57EC-87DA-1DB460D64046,"iPhone13,2"
com.apple.Maps,30,1749748682,1749748712,1749748712.219252,-25200,EB445137-D7F5-57EC-87DA-1DB460D64046,"iPhone13,2"
com.apple.Maps,26,1749748654,1749748680,1749748680.618493,-25200,EB445137-D7F5-57EC-87DA-1DB460D64046,"iPhone13,2"
com.apple.Maps,31,1749748620,1749748651,1749748652.044426,-25200,EB445137-D7F5-57EC-87DA-1DB460D64046,"iPhone13,2"
com.google.chrome.ios,32,1749748588,1749748620,1749748620.535606,-25200,EB445137-D7F5-57EC-87DA-1DB460D64046,"iPhone13,2"
com.apple.Maps,21,1749748567,1749748588,1749748588.857789,-25200,EB445137-D7F5-57EC-87DA-1DB460D64046,"iPhone13,2"
com.apple.Maps,5,1749748101,1749748106,1749748106.7957191,-25200,EB445137-D7F5-57EC-87DA-1DB460D64046,"iPhone13,2"
com.apple.Maps,2,1749747917,1749747919,1749747919.637397,-25200,EB445137-D7F5-57EC-87DA-1DB460D64046,"iPhone13,2"
com.apple.Maps,12,1749747875,1749747887,1749747887.408766,-25200,EB445137-D7F5-57EC-87DA-1DB460D64046,"iPhone13,2"
com.apple.Maps,51,1749747807,1749747858,1749747858.22927,-25200,EB445137-D7F5-57EC-87DA-1DB460D64046,"iPhone13,2"
com.apple.Maps,40,1749747664,1749747704,1749747704.3995519,-25200,EB445137-D7F5-57EC-87DA-1DB460D64046,"iPhone13,2"
com.apple.Maps,76,1749747560,1749747636,1749747636.526814,-25200,EB445137-D7F5-57EC-87DA-1DB460D64046,"iPhone13,2"
com.apple.Maps,18,1749747419,1749747437,1749747438.0537992,-25200,EB445137-D7F5-57EC-87DA-1DB460D64046,"iPhone13,2"
com.apple.Maps,24,1749747371,1749747395,1749747395.653008,-25200,EB445137-D7F5-57EC-87DA-1DB460D64046,"iPhone13,2"
com.apple.Maps,40,1749747329,1749747369,1749747369.5103688,-25200,EB445137-D7F5-57EC-87DA-1DB460D64046,"iPhone13,2"
com.apple.Maps,8,1749747264,1749747272,1749747272.2989678,-25200,EB445137-D7F5-57EC-87DA-1DB460D64046,"iPhone13,2"
com.apple.Maps,3,1749747220,1749747223,1749747223.258419,-25200,EB445137-D7F5-57EC-87DA-1DB460D64046,"iPhone13,2"
com.apple.Maps,6,1749747049,1749747055,1749747055.167228,-25200,EB445137-D7F5-57EC-87DA-1DB460D64046,"iPhone13,2"
com.apple.Maps,4,1749746365,1749746369,1749746369.525694,-25200,EB445137-D7F5-57EC-87DA-1DB460D64046,"iPhone13,2"
com.apple.Maps,5,1749746212,1749746217,1749746217.868218,-25200,EB445137-D7F5-57EC-87DA-1DB460D64046,"iPhone13,2"
com.apple.Maps,24,1749745980,1749746004,1749746004.414825,-25200,EB445137-D7F5-57EC-87DA-1DB460D64046,"iPhone13,2"
com.apple.Maps,6,1749745896,1749745902,1749745902.630916,-25200,EB445137-D7F5-57EC-87DA-1DB460D64046,"iPhone13,2"
com.apple.Maps,31,1749745859,1749745890,1749745890.504801,-25200,EB445137-D7F5-57EC-87DA-1DB460D64046,"iPhone13,2"
com.apple.Maps,5,1749745784,1749745789,1749745789.1175451,-25200,EB445137-D7F5-57EC-87DA-1DB460D64046,"iPhone13,2"
com.apple.Maps,176,1749745599,1749745775,1749745775.702989,-25200,EB445137-D7F5-57EC-87DA-1DB460D64046,"iPhone13,2"
com.apple.weather,2,1749745597,1749745599,1749745599.917465,-25200,EB445137-D7F5-57EC-87DA-1DB460D64046,"iPhone13,2"
com.apple.weather,10,1749745575,1749745585,1749745585.693727,-25200,EB445137-D7F5-57EC-87DA-1DB460D64046,"iPhone13,2"
com.apple.Maps,1,1749745574,1749745575,1749745576.058179,-25200,EB445137-D7F5-57EC-87DA-1DB460D64046,"iPhone13,2"
com.apple.Maps,391,1749745127,1749745518,1749745518.2653499,-25200,EB445137-D7F5-57EC-87DA-1DB460D64046,"iPhone13,2"
com.apple.Maps,91,1749745022,1749745113,1749745113.092252,-25200,EB445137-D7F5-57EC-87DA-1DB460D64046,"iPhone13,2"
com.apple.Maps,14,1749744550,1749744564,1749744564.151178,-25200,EB445137-D7F5-57EC-87DA-1DB460D64046,"iPhone13,2"
com.apple.Maps,35,1749744206,1749744241,1749744241.161621,-25200,EB445137-D7F5-57EC-87DA-1DB460D64046,"iPhone13,2"
com.apple.Maps,55,1749743918,1749743973,1749743973.083263,-25200,EB445137-D7F5-57EC-87DA-1DB460D64046,"iPhone13,2"
com.apple.Maps,1,1749742810,1749742811,1749742811.432125,-25200,EB445137-D7F5-57EC-87DA-1DB460D64046,"iPhone13,2"
com.apple.Maps,274,1749742502,1749742776,1749742776.191142,-25200,EB445137-D7F5-57EC-87DA-1DB460D64046,"iPhone13,2"
com.apple.Maps,173,1749742266,1749742439,1749742439.713861,-25200,EB445137-D7F5-57EC-87DA-1DB460D64046,"iPhone13,2"
com.apple.Maps,115,1749742140,1749742255,1749742255.8642,-25200,EB445137-D7F5-57EC-87DA-1DB460D64046,"iPhone13,2"
com.apple.weather,3,1749742137,1749742140,1749742141.021781,-25200,EB445137-D7F5-57EC-87DA-1DB460D64046,"iPhone13,2"
com.apple.weather,45,1749740701,1749740746,1749740746.9761539,-25200,EB445137-D7F5-57EC-87DA-1DB460D64046,"iPhone13,2"
com.apple.Maps,2,1749740699,1749740701,1749740703.080358,-25200,EB445137-D7F5-57EC-87DA-1DB460D64046,"iPhone13,2"
com.apple.Maps,160,1749740278,1749740438,1749740438.461806,-25200,EB445137-D7F5-57EC-87DA-1DB460D64046,"iPhone13,2"
com.apple.Maps,8,1749740243,1749740251,1749740251.691585,-25200,EB445137-D7F5-57EC-87DA-1DB460D64046,"iPhone13,2"
com.apple.mobilenotes,2,1749740241,1749740243,1749740243.536669,-25200,EB445137-D7F5-57EC-87DA-1DB460D64046,"iPhone13,2"
com.apple.mobilenotes,47,1749739794,1749739841,1749739841.568769,-25200,EB445137-D7F5-57EC-87DA-1DB460D64046,"iPhone13,2"
com.apple.Maps,2,1749739790,1749739792,1749739793.00721,-25200,EB445137-D7F5-57EC-87DA-1DB460D64046,"iPhone13,2"
com.apple.Maps,13,1749739715,1749739728,1749739728.7830238,-25200,EB445137-D7F5-57EC-87DA-1DB460D64046,"iPhone13,2"
com.apple.Maps,55,1749739576,1749739631,1749739631.2638679,-25200,EB445137-D7F5-57EC-87DA-1DB460D64046,"iPhone13,2"
com.google.chrome.ios,28,1749739548,1749739576,1749739576.639917,-25200,EB445137-D7F5-57EC-87DA-1DB460D64046,"iPhone13,2"
com.apple.Maps,255,1749739293,1749739548,1749739548.411,-25200,EB445137-D7F5-57EC-87DA-1DB460D64046,"iPhone13,2"
com.google.chrome.ios,16,1749739277,1749739293,1749739293.156117,-25200,EB445137-D7F5-57EC-87DA-1DB460D64046,"iPhone13,2"
com.apple.Maps,77,1749739200,1749739277,1749739277.410485,-25200,EB445137-D7F5-57EC-87DA-1DB460D64046,"iPhone13,2"
com.alltrails.AllTrails,55,1749739145,1749739200,1749739200.7636418,-25200,EB445137-D7F5-57EC-87DA-1DB460D64046,"iPhone13,2"
com.google.chrome.ios,29,1749739116,1749739145,1749739145.17938,-25200,EB445137-D7F5-57EC-87DA-1DB460D64046,"iPhone13,2"
com.alltrails.AllTrails,5,1749739111,1749739116,1749739116.849804,-25200,EB445137-D7F5-57EC-87DA-1DB460D64046,"iPhone13,2"
com.google.chrome.ios,3,1749739108,1749739111,1749739111.8867478,-25200,EB445137-D7F5-57EC-87DA-1DB460D64046,"iPhone13,2"
com.alltrails.AllTrails,152,1749738956,1749739108,1749739108.215612,-25200,EB445137-D7F5-57EC-87DA-1DB460D64046,"iPhone13,2"
com.google.chrome.ios,52,1749738904,1749738956,1749738956.7293649,-25200,EB445137-D7F5-57EC-87DA-1DB460D64046,"iPhone13,2"
com.alltrails.AllTrails,153,1749738751,1749738904,1749738904.549294,-25200,EB445137-D7F5-57EC-87DA-1DB460D64046,"iPhone13,2"
com.google.chrome.ios,4,1749738746,1749738750,1749738750.519912,-25200,EB445137-D7F5-57EC-87DA-1DB460D64046,"iPhone13,2"
com.google.chrome.ios,323,1749738421,1749738744,1749738744.2912421,-25200,EB445137-D7F5-57EC-87DA-1DB460D64046,"iPhone13,2"
com.apple.Maps,42,1749738379,1749738421,1749738421.793603,-25200,EB445137-D7F5-57EC-87DA-1DB460D64046,"iPhone13,2"
com.apple.Maps,120,1749738253,1749738373,1749738373.1546931,-25200,EB445137-D7F5-57EC-87DA-1DB460D64046,"iPhone13,2"
com.apple.Maps,14,1749736771,1749736785,1749736785.429977,-25200,EB445137-D7F5-57EC-87DA-1DB460D64046,"iPhone13,2"
com.apple.CoreAuthUI,2,1749736562,1749736564,1749736564.25893,-25200,EB445137-D7F5-57EC-87DA-1DB460D64046,"iPhone13,2"
com.apple.journal,19,1749736561,1749736580,1749736580.96541,-25200,EB445137-D7F5-57EC-87DA-1DB460D64046,"iPhone13,2"
com.apple.Maps,42,1749736026,1749736068,1749736068.7287412,-25200,EB445137-D7F5-57EC-87DA-1DB460D64046,"iPhone13,2"
com.apple.CoreAuthUI,1,1749734633,1749734634,1749734634.841084,-25200,EB445137-D7F5-57EC-87DA-1DB460D64046,"iPhone13,2"
com.truebill.truebillnative,144,1749734631,1749734775,1749734775.6607652,-25200,EB445137-D7F5-57EC-87DA-1DB460D64046,"iPhone13,2"
com.strava.stravaride,45,1749734583,1749734628,1749734628.746892,-25200,EB445137-D7F5-57EC-87DA-1DB460D64046,"iPhone13,2"
com.apple.Health,141,1749734414,1749734555,1749734555.9803128,-25200,EB445137-D7F5-57EC-87DA-1DB460D64046,"iPhone13,2"
com.apple.Health,14,1749734269,1749734283,1749734284.1101708,-25200,EB445137-D7F5-57EC-87DA-1DB460D64046,"iPhone13,2"
com.apple.news,0,1749734269,1749734269,1749734270.831346,-25200,EB445137-D7F5-57EC-87DA-1DB460D64046,"iPhone13,2"
com.apple.news,126,1749733341,1749733467,1749733467.811707,-25200,EB445137-D7F5-57EC-87DA-1DB460D64046,"iPhone13,2"
com.apple.Health,46,1749706020,1749706066,1749706066.66847,-25200,EB445137-D7F5-57EC-87DA-1DB460D64046,"iPhone13,2"
com.apple.CoreAuthUI,1,1749704122,1749704123,1749704123.804214,-25200,EB445137-D7F5-57EC-87DA-1DB460D64046,"iPhone13,2"
com.apple.journal,1895,1749704121,1749706016,1749706016.387364,-25200,EB445137-D7F5-57EC-87DA-1DB460D64046,"iPhone13,2"
com.thestorygraph.thestorygraph,40,1749704080,1749704120,1749704120.2908611,-25200,EB445137-D7F5-57EC-87DA-1DB460D64046,"iPhone13,2"
com.apple.mobileslideshow,100,1749701599,1749701699,1749701699.2756848,-25200,EB445137-D7F5-57EC-87DA-1DB460D64046,"iPhone13,2"
com.strava.stravaride,22,1749697217,1749697239,1749697239.251353,-25200,EB445137-D7F5-57EC-87DA-1DB460D64046,"iPhone13,2"
com.apple.news,1,1749697216,1749697217,1749697217.554642,-25200,EB445137-D7F5-57EC-87DA-1DB460D64046,"iPhone13,2"
com.apple.news,1226,1749695683,1749696909,1749696909.986845,-25200,EB445137-D7F5-57EC-87DA-1DB460D64046,"iPhone13,2"
com.google.chrome.ios,263,1749695416,1749695679,1749695679.2246032,-25200,EB445137-D7F5-57EC-87DA-1DB460D64046,"iPhone13,2"
com.apple.Maps,285,1749693586,1749693871,1749693871.746364,-25200,EB445137-D7F5-57EC-87DA-1DB460D64046,"iPhone13,2"
com.google.chrome.ios,74,1749693512,1749693586,1749693586.143975,-25200,EB445137-D7F5-57EC-87DA-1DB460D64046,"iPhone13,2"
com.apple.Maps,115,1749693397,1749693512,1749693512.09415,-25200,EB445137-D7F5-57EC-87DA-1DB460D64046,"iPhone13,2"
com.apple.Maps,11,1749693303,1749693314,1749693314.7806702,-25200,EB445137-D7F5-57EC-87DA-1DB460D64046,"iPhone13,2"
com.google.chrome.ios,113,1749693190,1749693303,1749693303.271401,-25200,EB445137-D7F5-57EC-87DA-1DB460D64046,"iPhone13,2"
com.apple.Maps,98,1749693092,1749693190,1749693190.920278,-25200,EB445137-D7F5-57EC-87DA-1DB460D64046,"iPhone13,2"
com.apple.Maps,189,1749690204,1749690393,1749690394.2575788,-25200,EB445137-D7F5-57EC-87DA-1DB460D64046,"iPhone13,2"
com.apple.Maps,8,1749690071,1749690079,1749690079.279903,-25200,EB445137-D7F5-57EC-87DA-1DB460D64046,"iPhone13,2"
com.apple.Maps,13,1749690038,1749690051,1749690052.138338,-25200,EB445137-D7F5-57EC-87DA-1DB460D64046,"iPhone13,2"
com.apple.Maps,21,1749688333,1749688354,1749688354.625025,-25200,EB445137-D7F5-57EC-87DA-1DB460D64046,"iPhone13,2"
com.apple.weather,2,1749688331,1749688333,1749688333.411078,-25200,EB445137-D7F5-57EC-87DA-1DB460D64046,"iPhone13,2"
com.apple.weather,8,1749687809,1749687817,1749687817.604879,-25200,EB445137-D7F5-57EC-87DA-1DB460D64046,"iPhone13,2"
com.apple.Maps,2,1749687807,1749687809,1749687809.167341,-25200,EB445137-D7F5-57EC-87DA-1DB460D64046,"iPhone13,2"
com.apple.Maps,14,1749687625,1749687639,1749687639.9728742,-25200,EB445137-D7F5-57EC-87DA-1DB460D64046,"iPhone13,2"
com.google.chrome.ios,24,1749687601,1749687625,1749687625.733392,-25200,EB445137-D7F5-57EC-87DA-1DB460D64046,"iPhone13,2"
com.apple.Maps,7,1749687592,1749687599,1749687599.6207662,-25200,EB445137-D7F5-57EC-87DA-1DB460D64046,"iPhone13,2"
com.apple.Maps,38,1749686046,1749686084,1749686084.184969,-25200,EB445137-D7F5-57EC-87DA-1DB460D64046,"iPhone13,2"
com.apple.weather,2,1749686044,1749686046,1749686046.287061,-25200,EB445137-D7F5-57EC-87DA-1DB460D64046,"iPhone13,2"
com.apple.weather,31,1749685365,1749685396,1749685396.735209,-25200,EB445137-D7F5-57EC-87DA-1DB460D64046,"iPhone13,2"
com.apple.Maps,2,1749685363,1749685365,1749685365.2907882,-25200,EB445137-D7F5-57EC-87DA-1DB460D64046,"iPhone13,2"
com.apple.Maps,13,1749685304,1749685317,1749685317.470725,-25200,EB445137-D7F5-57EC-87DA-1DB460D64046,"iPhone13,2"
com.apple.Maps,9,1749685281,1749685290,1749685291.085666,-25200,EB445137-D7F5-57EC-87DA-1DB460D64046,"iPhone13,2"
com.apple.Maps,45,1749685222,1749685267,1749685267.1809921,-25200,EB445137-D7F5-57EC-87DA-1DB460D64046,"iPhone13,2"
com.apple.podcasts,1,1749682652,1749682653,1749682654.075525,-25200,EB445137-D7F5-57EC-87DA-1DB460D64046,"iPhone13,2"
com.apple.podcasts,89,1749682400,1749682489,1749682489.7907882,-25200,EB445137-D7F5-57EC-87DA-1DB460D64046,"iPhone13,2"
com.google.chrome.ios,90,1749681241,1749681331,1749681331.1059952,-25200,EB445137-D7F5-57EC-87DA-1DB460D64046,"iPhone13,2"
com.apple.Maps,2,1749681239,1749681241,1749681241.905863,-25200,EB445137-D7F5-57EC-87DA-1DB460D64046,"iPhone13,2"
com.apple.Maps,77,1749681087,1749681164,1749681164.3799539,-25200,EB445137-D7F5-57EC-87DA-1DB460D64046,"iPhone13,2"
com.google.chrome.ios,178,1749680908,1749681086,1749681087.164038,-25200,EB445137-D7F5-57EC-87DA-1DB460D64046,"iPhone13,2"
com.google.chrome.ios,130,1749680748,1749680878,1749680879.040571,-25200,EB445137-D7F5-57EC-87DA-1DB460D64046,"iPhone13,2"
com.google.chrome.ios,16,1749680720,1749680736,1749680736.7500892,-25200,EB445137-D7F5-57EC-87DA-1DB460D64046,"iPhone13,2"
com.apple.mobileslideshow,40,1749679738,1749679778,1749679778.701391,-25200,EB445137-D7F5-57EC-87DA-1DB460D64046,"iPhone13,2"
com.google.chrome.ios,1,1749679737,1749679738,1749679738.7389278,-25200,EB445137-D7F5-57EC-87DA-1DB460D64046,"iPhone13,2"
com.google.chrome.ios,276,1749678814,1749679090,1749679090.5946422,-25200,EB445137-D7F5-57EC-87DA-1DB460D64046,"iPhone13,2"
com.apple.Maps,20,1749678794,1749678814,1749678814.7397962,-25200,EB445137-D7F5-57EC-87DA-1DB460D64046,"iPhone13,2"
com.google.chrome.ios,257,1749678537,1749678794,1749678794.38491,-25200,EB445137-D7F5-57EC-87DA-1DB460D64046,"iPhone13,2"
com.apple.Maps,25,1749678512,1749678537,1749678538.015589,-25200,EB445137-D7F5-57EC-87DA-1DB460D64046,"iPhone13,2"
com.google.chrome.ios,514,1749677998,1749678512,1749678512.8914518,-25200,EB445137-D7F5-57EC-87DA-1DB460D64046,"iPhone13,2"
com.apple.Maps,144,1749677854,1749677998,1749677998.763736,-25200,EB445137-D7F5-57EC-87DA-1DB460D64046,"iPhone13,2"
com.google.chrome.ios,8,1749677845,1749677853,1749677853.604903,-25200,EB445137-D7F5-57EC-87DA-1DB460D64046,"iPhone13,2"
com.google.chrome.ios,146,1749677507,1749677653,1749677653.719967,-25200,EB445137-D7F5-57EC-87DA-1DB460D64046,"iPhone13,2"
com.apple.mobileslideshow,1,1749677504,1749677505,1749677505.681545,-25200,EB445137-D7F5-57EC-87DA-1DB460D64046,"iPhone13,2"
com.apple.mobileslideshow,143,1749677287,1749677430,1749677430.8152409,-25200,EB445137-D7F5-57EC-87DA-1DB460D64046,"iPhone13,2"
com.apple.MobileSMS,10,1749677238,1749677248,1749677248.05106,-25200,EB445137-D7F5-57EC-87DA-1DB460D64046,"iPhone13,2"
com.apple.mobilecal,14,1749677224,1749677238,1749677238.455709,-25200,EB445137-D7F5-57EC-87DA-1DB460D64046,"iPhone13,2"
com.apple.mobileslideshow,0,1749677217,1749677217,1749677218.112228,-25200,EB445137-D7F5-57EC-87DA-1DB460D64046,"iPhone13,2"
com.apple.mobileslideshow,11,1749677167,1749677178,1749677178.6993241,-25200,EB445137-D7F5-57EC-87DA-1DB460D64046,"iPhone13,2"
com.apple.MobileSMS,63,1749677102,1749677165,1749677165.182929,-25200,EB445137-D7F5-57EC-87DA-1DB460D64046,"iPhone13,2"
com.apple.mobilecal,10,1749677092,1749677102,1749677104.9766002,-25200,EB445137-D7F5-57EC-87DA-1DB460D64046,"iPhone13,2"
com.apple.MobileSMS,13,1749677079,1749677092,1749677092.711791,-25200,EB445137-D7F5-57EC-87DA-1DB460D64046,"iPhone13,2"
com.alltrails.AllTrails,141,1749676938,1749677079,1749677079.072606,-25200,EB445137-D7F5-57EC-87DA-1DB460D64046,"iPhone13,2"
com.apple.MobileSMS,3,1749676935,1749676938,1749676938.620295,-25200,EB445137-D7F5-57EC-87DA-1DB460D64046,"iPhone13,2"
com.apple.mobilecal,1,1749676934,1749676935,1749676935.9573832,-25200,EB445137-D7F5-57EC-87DA-1DB460D64046,"iPhone13,2"
com.apple.MobileSMS,1,1749676933,1749676934,1749676935.017091,-25200,EB445137-D7F5-57EC-87DA-1DB460D64046,"iPhone13,2"
com.apple.Maps,6,1749676927,1749676933,1749676933.290601,-25200,EB445137-D7F5-57EC-87DA-1DB460D64046,"iPhone13,2"
com.apple.mobilecal,9,1749676918,1749676927,1749676927.4951138,-25200,EB445137-D7F5-57EC-87DA-1DB460D64046,"iPhone13,2"
com.apple.MobileSMS,39,1749676879,1749676918,1749676918.626981,-25200,EB445137-D7F5-57EC-87DA-1DB460D64046,"iPhone13,2"
com.apple.mobilecal,28,1749676850,1749676878,1749676878.849062,-25200,EB445137-D7F5-57EC-87DA-1DB460D64046,"iPhone13,2"
com.alltrails.AllTrails,74,1749676770,1749676844,1749676845.086783,-25200,EB445137-D7F5-57EC-87DA-1DB460D64046,"iPhone13,2"
com.apple.Maps,85,1749676685,1749676770,1749676770.6068668,-25200,EB445137-D7F5-57EC-87DA-1DB460D64046,"iPhone13,2"
com.apple.Health,73,1749676593,1749676666,1749676666.139498,-25200,EB445137-D7F5-57EC-87DA-1DB460D64046,"iPhone13,2"
com.apple.Fitness,70,1749676522,1749676592,1749676592.5807118,-25200,EB445137-D7F5-57EC-87DA-1DB460D64046,"iPhone13,2"
com.alltrails.AllTrails,193,1749676323,1749676516,1749676516.329145,-25200,EB445137-D7F5-57EC-87DA-1DB460D64046,"iPhone13,2"
com.apple.PassbookUIService,4,1749676308,1749676312,1749676313.038238,-25200,EB445137-D7F5-57EC-87DA-1DB460D64046,"iPhone13,2"
com.google.chrome.ios,61,1749676262,1749676323,1749676323.246244,-25200,EB445137-D7F5-57EC-87DA-1DB460D64046,"iPhone13,2"
com.apple.Maps,261,1749676001,1749676262,1749676262.31187,-25200,EB445137-D7F5-57EC-87DA-1DB460D64046,"iPhone13,2"
com.google.chrome.ios,8,1749675993,1749676001,1749676001.380837,-25200,EB445137-D7F5-57EC-87DA-1DB460D64046,"iPhone13,2"
com.google.chrome.ios,75,1749672989,1749673064,1749673065.111875,-25200,EB445137-D7F5-57EC-87DA-1DB460D64046,"iPhone13,2"
com.google.chrome.ios,6,1749668317,1749668323,1749668323.31212,-25200,EB445137-D7F5-57EC-87DA-1DB460D64046,"iPhone13,2"
com.google.chrome.ios,7,1749667782,1749667789,1749667789.562228,-25200,EB445137-D7F5-57EC-87DA-1DB460D64046,"iPhone13,2"
com.google.chrome.ios,16,1749667754,1749667770,1749667770.131538,-25200,EB445137-D7F5-57EC-87DA-1DB460D64046,"iPhone13,2"
com.apple.MobileSMS,2,1749667752,1749667754,1749667754.1796498,-25200,EB445137-D7F5-57EC-87DA-1DB460D64046,"iPhone13,2"
com.apple.MobileSMS,9,1749665665,1749665674,1749665674.666019,-25200,EB445137-D7F5-57EC-87DA-1DB460D64046,"iPhone13,2"
com.apple.findmy,0,1749665665,1749665665,1749665666.584505,-25200,EB445137-D7F5-57EC-87DA-1DB460D64046,"iPhone13,2"
com.apple.findmy,12,1749665592,1749665604,1749665604.37219,-25200,EB445137-D7F5-57EC-87DA-1DB460D64046,"iPhone13,2"
com.apple.Maps,31,1749663875,1749663906,1749663906.634251,-25200,EB445137-D7F5-57EC-87DA-1DB460D64046,"iPhone13,2"
com.google.chrome.ios,133,1749663388,1749663521,1749663521.52965,-25200,EB445137-D7F5-57EC-87DA-1DB460D64046,"iPhone13,2"
com.apple.Maps,48,1749663340,1749663388,1749663388.310954,-25200,EB445137-D7F5-57EC-87DA-1DB460D64046,"iPhone13,2"
com.google.chrome.ios,12,1749663328,1749663340,1749663340.09549,-25200,EB445137-D7F5-57EC-87DA-1DB460D64046,"iPhone13,2"
com.apple.news,812,1749662515,1749663327,1749663327.121805,-25200,EB445137-D7F5-57EC-87DA-1DB460D64046,"iPhone13,2"
com.apple.mobileslideshow,15,1749662497,1749662512,1749662512.835497,-25200,EB445137-D7F5-57EC-87DA-1DB460D64046,"iPhone13,2"
com.apple.mobileslideshow,2,1749662490,1749662492,1749662493.237104,-25200,EB445137-D7F5-57EC-87DA-1DB460D64046,"iPhone13,2"
com.apple.Maps,366,1749662123,1749662489,1749662489.804755,-25200,EB445137-D7F5-57EC-87DA-1DB460D64046,"iPhone13,2"
com.apple.mobileslideshow,146,1749661974,1749662120,1749662120.764272,-25200,EB445137-D7F5-57EC-87DA-1DB460D64046,"iPhone13,2"
com.toyopagroup.picaboo,12,1749661956,1749661968,1749661968.328186,-25200,EB445137-D7F5-57EC-87DA-1DB460D64046,"iPhone13,2"
com.toyopagroup.picaboo,43,1749660500,1749660543,1749660543.8284569,-25200,EB445137-D7F5-57EC-87DA-1DB460D64046,"iPhone13,2"
com.google.chrome.ios,1,1749660499,1749660500,1749660500.380505,-25200,EB445137-D7F5-57EC-87DA-1DB460D64046,"iPhone13,2"
com.google.chrome.ios,66,1749659848,1749659914,1749659914.809526,-25200,EB445137-D7F5-57EC-87DA-1DB460D64046,"iPhone13,2"
com.google.chrome.ios,106,1749659653,1749659759,1749659759.387043,-25200,EB445137-D7F5-57EC-87DA-1DB460D64046,"iPhone13,2"
com.strava.stravaride,78,1749659057,1749659135,1749659135.598206,-25200,EB445137-D7F5-57EC-87DA-1DB460D64046,"iPhone13,2"
com.apple.weather,10,1749659046,1749659056,1749659056.495043,-25200,EB445137-D7F5-57EC-87DA-1DB460D64046,"iPhone13,2"
com.strava.stravaride,31,1749659014,1749659045,1749659045.9017081,-25200,EB445137-D7F5-57EC-87DA-1DB460D64046,"iPhone13,2"
com.apple.Fitness,3,1749659011,1749659014,1749659014.091191,-25200,EB445137-D7F5-57EC-87DA-1DB460D64046,"iPhone13,2"
com.apple.Fitness,31,1749658807,1749658838,1749658838.124792,-25200,EB445137-D7F5-57EC-87DA-1DB460D64046,"iPhone13,2"
com.apple.Maps,1,1749658407,1749658408,1749658408.422889,-25200,EB445137-D7F5-57EC-87DA-1DB460D64046,"iPhone13,2"
com.apple.Maps,3,1749657826,1749657829,1749657830.090434,-25200,EB445137-D7F5-57EC-87DA-1DB460D64046,"iPhone13,2"
com.apple.Maps,1,1749657825,1749657826,1749657826.619009,-25200,EB445137-D7F5-57EC-87DA-1DB460D64046,"iPhone13,2"
com.apple.Maps,32,1749657613,1749657645,1749657645.6618261,-25200,EB445137-D7F5-57EC-87DA-1DB460D64046,"iPhone13,2"
com.apple.Maps,29,1749657450,1749657479,1749657479.210516,-25200,EB445137-D7F5-57EC-87DA-1DB460D64046,"iPhone13,2"
com.apple.Maps,17,1749657280,1749657297,1749657297.8911772,-25200,EB445137-D7F5-57EC-87DA-1DB460D64046,"iPhone13,2"
com.apple.Maps,5,1749656873,1749656878,1749656878.111844,-25200,EB445137-D7F5-57EC-87DA-1DB460D64046,"iPhone13,2"
com.apple.Maps,5,1749656712,1749656717,1749656717.291506,-25200,EB445137-D7F5-57EC-87DA-1DB460D64046,"iPhone13,2"
com.apple.Maps,5,1749656596,1749656601,1749656601.540254,-25200,EB445137-D7F5-57EC-87DA-1DB460D64046,"iPhone13,2"
com.apple.Maps,18,1749656525,1749656543,1749656543.650056,-25200,EB445137-D7F5-57EC-87DA-1DB460D64046,"iPhone13,2"
com.apple.Maps,10,1749656101,1749656111,1749656111.3288898,-25200,EB445137-D7F5-57EC-87DA-1DB460D64046,"iPhone13,2"
com.apple.Maps,11,1749656017,1749656028,1749656028.218507,-25200,EB445137-D7F5-57EC-87DA-1DB460D64046,"iPhone13,2"
com.apple.Maps,12,1749655819,1749655831,1749655831.167171,-25200,EB445137-D7F5-57EC-87DA-1DB460D64046,"iPhone13,2"
com.apple.Maps,50,1749655688,1749655738,1749655738.257873,-25200,EB445137-D7F5-57EC-87DA-1DB460D64046,"iPhone13,2"
com.apple.Maps,24,1749655652,1749655676,1749655676.110059,-25200,EB445137-D7F5-57EC-87DA-1DB460D64046,"iPhone13,2"
com.apple.Maps,9,1749655419,1749655428,1749655428.236042,-25200,EB445137-D7F5-57EC-87DA-1DB460D64046,"iPhone13,2"
com.apple.Maps,63,1749654989,1749655052,1749655052.9522228,-25200,EB445137-D7F5-57EC-87DA-1DB460D64046,"iPhone13,2"
com.apple.Maps,7,1749654888,1749654895,1749654895.764826,-25200,EB445137-D7F5-57EC-87DA-1DB460D64046,"iPhone13,2"
com.apple.Maps,7,1749654789,1749654796,1749654796.276554,-25200,EB445137-D7F5-57EC-87DA-1DB460D64046,"iPhone13,2"
com.apple.Maps,10,1749654659,1749654669,1749654669.413439,-25200,EB445137-D7F5-57EC-87DA-1DB460D64046,"iPhone13,2"
com.apple.Maps,6,1749654405,1749654411,1749654411.286417,-25200,EB445137-D7F5-57EC-87DA-1DB460D64046,"iPhone13,2"
com.apple.Maps,19,1749654326,1749654345,1749654345.7064152,-25200,EB445137-D7F5-57EC-87DA-1DB460D64046,"iPhone13,2"
com.apple.Maps,7,1749654074,1749654081,1749654081.4155421,-25200,EB445137-D7F5-57EC-87DA-1DB460D64046,"iPhone13,2"
com.apple.Maps,70,1749653975,1749654045,1749654045.214328,-25200,EB445137-D7F5-57EC-87DA-1DB460D64046,"iPhone13,2"
com.apple.Maps,133,1749653841,1749653974,1749653974.419869,-25200,EB445137-D7F5-57EC-87DA-1DB460D64046,"iPhone13,2"
com.apple.Maps,66,1749652617,1749652683,1749652684.004163,-25200,EB445137-D7F5-57EC-87DA-1DB460D64046,"iPhone13,2"
com.apple.Maps,106,1749652222,1749652328,1749652328.933986,-25200,EB445137-D7F5-57EC-87DA-1DB460D64046,"iPhone13,2"
com.apple.Maps,37,1749652047,1749652084,1749652084.927172,-25200,EB445137-D7F5-57EC-87DA-1DB460D64046,"iPhone13,2"
com.apple.Maps,17,1749651993,1749652010,1749652010.4950728,-25200,EB445137-D7F5-57EC-87DA-1DB460D64046,"iPhone13,2"
com.apple.Maps,67,1749651906,1749651973,1749651973.559875,-25200,EB445137-D7F5-57EC-87DA-1DB460D64046,"iPhone13,2"
com.apple.Maps,22,1749651821,1749651843,1749651843.740895,-25200,EB445137-D7F5-57EC-87DA-1DB460D64046,"iPhone13,2"
com.apple.Maps,3,1749651756,1749651759,1749651760.039359,-25200,EB445137-D7F5-57EC-87DA-1DB460D64046,"iPhone13,2"
com.apple.Maps,28,1749651378,1749651406,1749651406.726253,-25200,EB445137-D7F5-57EC-87DA-1DB460D64046,"iPhone13,2"
com.apple.Maps,12,1749651042,1749651054,1749651054.806442,-25200,EB445137-D7F5-57EC-87DA-1DB460D64046,"iPhone13,2"
com.apple.Maps,5,1749650851,1749650856,1749650856.459305,-25200,EB445137-D7F5-57EC-87DA-1DB460D64046,"iPhone13,2"
com.apple.Maps,8,1749650798,1749650806,1749650806.530641,-25200,EB445137-D7F5-57EC-87DA-1DB460D64046,"iPhone13,2"
com.apple.Maps,6,1749650595,1749650601,1749650601.7535849,-25200,EB445137-D7F5-57EC-87DA-1DB460D64046,"iPhone13,2"
com.apple.Maps,6,1749650426,1749650432,1749650432.772346,-25200,EB445137-D7F5-57EC-87DA-1DB460D64046,"iPhone13,2"
com.apple.Maps,22,1749650399,1749650421,1749650421.131112,-25200,EB445137-D7F5-57EC-87DA-1DB460D64046,"iPhone13,2"
com.apple.Maps,18,1749650350,1749650368,1749650368.513499,-25200,EB445137-D7F5-57EC-87DA-1DB460D64046,"iPhone13,2"
com.apple.Maps,11,1749650214,1749650225,1749650225.870399,-25200,EB445137-D7F5-57EC-87DA-1DB460D64046,"iPhone13,2"
com.apple.Maps,6,1749650076,1749650082,1749650082.31686,-25200,EB445137-D7F5-57EC-87DA-1DB460D64046,"iPhone13,2"
com.apple.Maps,68,1749649934,1749650002,1749650002.597451,-25200,EB445137-D7F5-57EC-87DA-1DB460D64046,"iPhone13,2"
com.apple.Maps,30,1749649892,1749649922,1749649922.140894,-25200,EB445137-D7F5-57EC-87DA-1DB460D64046,"iPhone13,2"
com.apple.Maps,105,1749649729,1749649834,1749649834.57404,-25200,EB445137-D7F5-57EC-87DA-1DB460D64046,"iPhone13,2"
com.apple.Maps,9,1749649605,1749649614,1749649614.1239228,-25200,EB445137-D7F5-57EC-87DA-1DB460D64046,"iPhone13,2"
com.apple.Maps,37,1749649247,1749649284,1749649285.0358992,-25200,EB445137-D7F5-57EC-87DA-1DB460D64046,"iPhone13,2"
com.apple.Maps,176,1749648057,1749648233,1749648233.2275,-25200,EB445137-D7F5-57EC-87DA-1DB460D64046,"iPhone13,2"
com.apple.weather,68,1749647948,1749648016,1749648016.948348,-25200,EB445137-D7F5-57EC-87DA-1DB460D64046,"iPhone13,2"
com.apple.news,3,1749647945,1749647948,1749647948.468237,-25200,EB445137-D7F5-57EC-87DA-1DB460D64046,"iPhone13,2"
com.apple.weather,28,1749647917,1749647945,1749647945.6137772,-25200,EB445137-D7F5-57EC-87DA-1DB460D64046,"iPhone13,2"
com.apple.Maps,65,1749647852,1749647917,1749647917.157696,-25200,EB445137-D7F5-57EC-87DA-1DB460D64046,"iPhone13,2"
com.apple.mobiletimer,4,1749646948,1749646952,1749646952.1103048,-25200,EB445137-D7F5-57EC-87DA-1DB460D64046,"iPhone13,2"
com.apple.mobiletimer,17,1749619590,1749619607,1749619607.7252722,-25200,EB445137-D7F5-57EC-87DA-1DB460D64046,"iPhone13,2"
com.apple.journal,2,1749619588,1749619590,1749619591.027065,-25200,EB445137-D7F5-57EC-87DA-1DB460D64046,"iPhone13,2"
com.apple.journal,374,1749619213,1749619587,1749619587.158206,-25200,EB445137-D7F5-57EC-87DA-1DB460D64046,"iPhone13,2"
com.apple.Maps,12,1749619201,1749619213,1749619213.4935741,-25200,EB445137-D7F5-57EC-87DA-1DB460D64046,"iPhone13,2"
com.apple.CoreAuthUI,4,1749618676,1749618680,1749618680.9271321,-25200,EB445137-D7F5-57EC-87DA-1DB460D64046,"iPhone13,2"
com.apple.journal,523,1749618675,1749619198,1749619198.7023149,-25200,EB445137-D7F5-57EC-87DA-1DB460D64046,"iPhone13,2"
com.apple.Health,48,1749618625,1749618673,1749618673.494903,-25200,EB445137-D7F5-57EC-87DA-1DB460D64046,"iPhone13,2"
com.thestorygraph.thestorygraph,18,1749618457,1749618475,1749618475.930101,-25200,EB445137-D7F5-57EC-87DA-1DB460D64046,"iPhone13,2"
com.google.Chrome,6,1749616138,1749616144,1749616144.485795,-25200,,
com.apple.iCal,14,1749616124,1749616138,1749616138.0863562,-25200,,
com.google.Chrome,816,1749615308,1749616124,1749616124.457695,-25200,,
com.apple.Maps,5,1749615303,1749615308,1749615308.95464,-25200,,
com.google.Chrome,27,1749615276,1749615303,1749615303.844668,-25200,,
com.apple.mobileslideshow,63,1749613599,1749613662,1749613662.469182,-25200,EB445137-D7F5-57EC-87DA-1DB460D64046,"iPhone13,2"
com.apple.Maps,0,1749613599,1749613599,1749613599.986326,-25200,EB445137-D7F5-57EC-87DA-1DB460D64046,"iPhone13,2"
com.apple.Maps,7,1749612914,1749612921,1749612921.754607,-25200,EB445137-D7F5-57EC-87DA-1DB460D64046,"iPhone13,2"
com.apple.Maps,35,1749609302,1749609337,1749609337.218072,-25200,EB445137-D7F5-57EC-87DA-1DB460D64046,"iPhone13,2"
com.apple.weather,1,1749609301,1749609302,1749609302.9123049,-25200,EB445137-D7F5-57EC-87DA-1DB460D64046,"iPhone13,2"
com.google.Chrome,242,1749608209,1749608451,1749608451.513171,-25200,,
