app,usage,start_time,end_time,created_at,tz,device_id,device_model
com.apple.finder,5,1715395021,1715395026,1715395026.95404,-18000,,
com.apple.Terminal,1,1715395020,1715395021,1715395021.812295,-18000,,
com.apple.finder,28,1715394992,1715395020,1715395020.180674,-18000,,
com.google.Chrome,92,1715394900,1715394992,1715394992.9979281,-18000,,
com.apple.finder,75,1715394825,1715394900,1715394900.8095798,-18000,,
com.apple.iCal,53,1715394772,1715394825,1715394825.887496,-18000,,
com.apple.finder,2,1715394770,1715394772,1715394772.499275,-18000,,
com.google.Chrome,29,1715394741,1715394770,1715394770.563583,-18000,,
com.google.Chrome,333,1715393632,1715393965,1715393965.4651752,-18000,,
com.google.Chrome,802,1715392815,1715393617,1715393618.2557812,-18000,,
com.google.Chrome,301,1715392213,1715392514,1715392514.833286,-18000,,
com.google.Chrome,725,1715391211,1715391936,1715391936.189227,-18000,,
com.microsoft.onenote.mac,24,1715391187,1715391211,1715391211.981248,-18000,,
com.google.Chrome,54,1715391133,1715391187,1715391187.238095,-18000,,
com.google.Chrome,258,1715389448,1715389706,1715389706.787935,-18000,,
com.google.Chrome,77,1715370085,1715370162,1715370162.972256,-18000,,
com.apple.finder,3,1715370052,1715370055,1715370055.0702229,-18000,,
com.apple.finder,112,1715369797,1715369909,1715369909.944662,-18000,,
com.google.Chrome,1794,1715368003,1715369797,1715369797.564292,-18000,,
com.google.Chrome,516,1715367380,1715367896,1715367896.2626638,-18000,,
com.apple.iCal,14,1715367366,1715367380,1715367380.148025,-18000,,
com.google.Chrome,1,1715367365,1715367366,1715367366.840656,-18000,,
com.apple.iCal,4,1715367361,1715367365,1715367365.124294,-18000,,
com.google.Chrome,58,1715367303,1715367361,1715367361.311156,-18000,,
com.google.Chrome,421,1715365402,1715365823,1715365823.120916,-18000,,
com.google.Chrome,497,1715364824,1715365321,1715365321.2863178,-18000,,
com.google.Chrome,9,1715349089,1715349098,1715349098.885865,-18000,,
com.apple.Preview,1,1715349088,1715349089,1715349089.45091,-18000,,
com.apple.Notes,53,1715349035,1715349088,1715349088.482662,-18000,,
com.apple.Preview,2,1715349033,1715349035,1715349035.2191548,-18000,,
com.google.Chrome,35,1715348998,1715349033,1715349033.9681911,-18000,,
com.apple.Preview,6,1715348992,1715348998,1715348998.2548351,-18000,,
com.apple.Notes,6,1715348986,1715348992,1715348992.339659,-18000,,
com.apple.Preview,3,1715348983,1715348986,1715348986.182852,-18000,,
com.apple.Notes,4,1715348979,1715348983,1715348983.914554,-18000,,
com.apple.Preview,2,1715348977,1715348979,1715348979.646178,-18000,,
com.apple.Notes,4,1715348973,1715348977,1715348978.033675,-18000,,
com.apple.Preview,3,1715348970,1715348973,1715348973.169108,-18000,,
com.apple.Notes,2,1715348968,1715348970,1715348970.465914,-18000,,
com.apple.Preview,2,1715348966,1715348968,1715348968.370323,-18000,,
com.apple.Notes,4,1715348962,1715348966,1715348966.221165,-18000,,
com.apple.Preview,1,1715348961,1715348962,1715348962.370887,-18000,,
com.apple.Notes,2,1715348959,1715348961,1715348961.144362,-18000,,
com.apple.Preview,3,1715348956,1715348959,1715348959.517031,-18000,,
com.apple.Notes,2,1715348954,1715348956,1715348956.778842,-18000,,
com.apple.Preview,4,1715348950,1715348954,1715348954.912644,-18000,,
com.apple.Notes,3,1715348947,1715348950,1715348950.783142,-18000,,
com.apple.Preview,7,1715348940,1715348947,1715348947.02613,-18000,,
com.apple.Notes,7,1715348933,1715348940,1715348940.095687,-18000,,
com.apple.Preview,1,1715348932,1715348933,1715348933.27242,-18000,,
com.apple.Notes,10,1715348922,1715348932,1715348932.23371,-18000,,
com.apple.Preview,3,1715348919,1715348922,1715348922.4101,-18000,,
com.google.Chrome,13,1715348906,1715348919,1715348919.138556,-18000,,
com.apple.Preview,24,1715348882,1715348906,1715348906.66708,-18000,,
com.apple.finder,3,1715348879,1715348882,1715348882.3068151,-18000,,
com.google.Chrome,29,1715348850,1715348879,1715348879.295988,-18000,,
com.google.Chrome,47,1715309874,1715309921,1715309921.552042,-18000,,
com.google.Chrome,639,1715308846,1715309485,1715309485.5299,-18000,,
com.google.Chrome,327,1715308057,1715308384,1715308384.989376,-18000,,
com.google.Chrome,1047,1715306864,1715307911,1715307911.2961202,-18000,,
com.google.Chrome,603,1715306185,1715306788,1715306788.869141,-18000,,
com.google.Chrome,1575,1715304390,1715305965,1715305965.1691542,-18000,,
com.google.Chrome,389,1715303336,1715303725,1715303725.907745,-18000,,
com.google.Chrome,202,1715302894,1715303096,1715303096.63098,-18000,,
com.google.Chrome,319,1715302494,1715302813,1715302813.306613,-18000,,
com.google.Chrome,310,1715302079,1715302389,1715302389.1446261,-18000,,
com.google.Chrome,603,1715301399,1715302002,1715302002.135535,-18000,,
com.google.Chrome,785,1715287661,1715288446,1715288446.9759111,-18000,,
com.google.Chrome,683,1715286770,1715287453,1715287453.884897,-18000,,
com.google.Chrome,162,1715226903,1715227065,1715227065.894052,-18000,,
com.google.Chrome,912,1715225384,1715226296,1715226296.9892778,-18000,,
com.google.Chrome,525,1715224486,1715225011,1715225011.6220222,-18000,,
com.apple.finder,4,1715224482,1715224486,1715224486.048091,-18000,,
com.leomehlig.today,48,1715224434,1715224482,1715224483.002193,-18000,,
com.apple.iCal,5,1715224429,1715224434,1715224434.979208,-18000,,
com.leomehlig.today,3,1715224426,1715224429,1715224429.423079,-18000,,
com.leomehlig.today,21,1715210008,1715210029,1715210029.8475308,-18000,,
com.apple.finder,1,1715210007,1715210008,1715210008.4071422,-18000,,
com.google.Chrome,508,1715209499,1715210007,1715210007.290281,-18000,,
com.google.Chrome,107,1715205573,1715205680,1715205681.091985,-18000,,
com.google.Chrome,413,1715205031,1715205444,1715205444.167299,-18000,,
com.google.Chrome,2364,1715202648,1715205012,1715205012.521699,-18000,,
com.google.Chrome,834,1715201533,1715202367,1715202367.683713,-18000,,
com.google.Chrome,302,1715200914,1715201216,1715201216.157305,-18000,,
com.google.Chrome,423,1715200252,1715200675,1715200675.564602,-18000,,
com.apple.finder,0,1715200252,1715200252,1715200252.794077,-18000,,
com.apple.Notes,3,1715200249,1715200252,1715200252.146563,-18000,,
com.leomehlig.today,23,1715200226,1715200249,1715200249.841741,-18000,,
com.leomehlig.today,23,1715194583,1715194606,1715194606.9064832,-18000,,
com.apple.Preview,2,1715194581,1715194583,1715194583.855191,-18000,,
com.google.Chrome,76,1715194505,1715194581,1715194581.250907,-18000,,
com.apple.Preview,15,1715194490,1715194505,1715194506.012679,-18000,,
com.google.Chrome,77,1715194413,1715194490,1715194490.202684,-18000,,
com.apple.Preview,7,1715194406,1715194413,1715194413.877902,-18000,,
com.google.Chrome,3,1715194403,1715194406,1715194406.237946,-18000,,
com.apple.Preview,1,1715194402,1715194403,1715194404.019582,-18000,,
com.google.Chrome,2,1715194400,1715194402,1715194402.42466,-18000,,
com.apple.Preview,9,1715194391,1715194400,1715194400.093807,-18000,,
com.google.Chrome,16,1715194375,1715194391,1715194391.641989,-18000,,
com.apple.Preview,4,1715194371,1715194375,1715194375.679452,-18000,,
com.google.Chrome,5,1715194366,1715194371,1715194371.2454681,-18000,,
com.apple.Preview,17,1715194349,1715194366,1715194366.709631,-18000,,
com.google.Chrome,1,1715194348,1715194349,1715194349.591423,-18000,,
com.apple.Preview,7,1715194341,1715194348,1715194348.312097,-18000,,
com.google.Chrome,1,1715194340,1715194341,1715194341.550314,-18000,,
com.apple.Preview,5,1715194335,1715194340,1715194340.20233,-18000,,
com.google.Chrome,2,1715194333,1715194335,1715194335.644648,-18000,,
com.apple.Preview,7,1715194326,1715194333,1715194333.690366,-18000,,
com.google.Chrome,1,1715194325,1715194326,1715194326.602026,-18000,,
com.apple.Preview,1,1715194324,1715194325,1715194325.905737,-18000,,
com.google.Chrome,1,1715194323,1715194324,1715194324.958856,-18000,,
com.apple.Preview,2,1715194321,1715194323,1715194323.9095569,-18000,,
com.google.Chrome,2,1715194319,1715194321,1715194321.167136,-18000,,
com.apple.Preview,2,1715194317,1715194319,1715194319.8570461,-18000,,
com.google.Chrome,6,1715194311,1715194317,1715194317.059547,-18000,,
com.apple.Preview,5,1715194306,1715194311,1715194311.747422,-18000,,
com.google.Chrome,13,1715194293,1715194306,1715194306.1047401,-18000,,
com.apple.Preview,8,1715194285,1715194293,1715194293.106839,-18000,,
com.google.Chrome,16,1715194269,1715194285,1715194285.85926,-18000,,
com.apple.Preview,11,1715194258,1715194269,1715194269.832581,-18000,,
com.google.Chrome,10,1715194248,1715194258,1715194258.330574,-18000,,
com.apple.Preview,3,1715194245,1715194248,1715194248.6517658,-18000,,
com.google.Chrome,26,1715194219,1715194245,1715194245.766171,-18000,,
com.apple.Preview,1,1715194218,1715194219,1715194219.648819,-18000,,
com.google.Chrome,5,1715194213,1715194218,1715194218.2082329,-18000,,
com.apple.Preview,6,1715194207,1715194213,1715194213.416152,-18000,,
com.google.Chrome,13,1715194194,1715194207,1715194207.5518708,-18000,,
com.apple.Preview,8,1715194186,1715194194,1715194194.066585,-18000,,
com.google.Chrome,45,1715194141,1715194186,1715194186.6254811,-18000,,
com.apple.Preview,24,1715194117,1715194141,1715194141.098814,-18000,,
com.google.Chrome,4,1715194113,1715194117,1715194117.923224,-18000,,
com.apple.Preview,64,1715194049,1715194113,1715194113.712624,-18000,,
com.google.Chrome,13,1715194036,1715194049,1715194049.673398,-18000,,
com.apple.Preview,7,1715194029,1715194036,1715194036.128989,-18000,,
com.google.Chrome,2,1715194027,1715194029,1715194030.0056849,-18000,,
com.apple.Preview,1,1715194026,1715194027,1715194027.892307,-18000,,
com.google.Chrome,3,1715194023,1715194026,1715194026.723712,-18000,,
com.apple.Preview,8,1715194015,1715194023,1715194023.066987,-18000,,
com.google.Chrome,4,1715194011,1715194015,1715194015.09238,-18000,,
com.apple.Preview,2,1715194009,1715194011,1715194012.0142379,-18000,,
com.google.Chrome,4,1715194005,1715194009,1715194009.869316,-18000,,
com.apple.Preview,10,1715193995,1715194005,1715194005.767229,-18000,,
com.google.Chrome,12,1715193983,1715193995,1715193995.792694,-18000,,
com.apple.Preview,1,1715193982,1715193983,1715193983.991504,-18000,,
com.google.Chrome,6,1715193976,1715193982,1715193982.5209951,-18000,,
com.apple.Preview,3,1715193973,1715193976,1715193977.0235891,-18000,,
com.google.Chrome,2,1715193971,1715193973,1715193973.759184,-18000,,
com.apple.Preview,3,1715193968,1715193971,1715193971.079582,-18000,,
com.google.Chrome,1,1715193967,1715193968,1715193968.215136,-18000,,
com.apple.Preview,10,1715193957,1715193967,1715193967.5290499,-18000,,
com.google.Chrome,46,1715193911,1715193957,1715193957.796496,-18000,,
com.apple.Preview,8,1715193903,1715193911,1715193911.395533,-18000,,
com.google.Chrome,18,1715193885,1715193903,1715193903.369035,-18000,,
com.apple.Preview,6,1715193879,1715193885,1715193885.7624989,-18000,,
com.google.Chrome,42,1715193837,1715193879,1715193879.462276,-18000,,
com.apple.Preview,6,1715193831,1715193837,1715193837.897838,-18000,,
com.google.Chrome,4,1715193827,1715193831,1715193831.846154,-18000,,
com.apple.Preview,21,1715193806,1715193827,1715193827.070174,-18000,,
com.google.Chrome,46,1715193760,1715193806,1715193806.691804,-18000,,
com.apple.Preview,9,1715193751,1715193760,1715193760.5381122,-18000,,
com.google.Chrome,93,1715193658,1715193751,1715193751.7233372,-18000,,
com.apple.Preview,20,1715193638,1715193658,1715193658.470757,-18000,,
com.google.Chrome,60,1715193578,1715193638,1715193638.106065,-18000,,
com.apple.Preview,14,1715193564,1715193578,1715193578.0654259,-18000,,
com.google.Chrome,2,1715193562,1715193564,1715193564.962661,-18000,,
com.apple.Preview,27,1715193535,1715193562,1715193562.151104,-18000,,
com.google.Chrome,41,1715193494,1715193535,1715193535.7312121,-18000,,
com.apple.Preview,4,1715193490,1715193494,1715193494.465519,-18000,,
com.google.Chrome,39,1715193451,1715193490,1715193490.5191379,-18000,,
com.apple.Preview,9,1715193442,1715193451,1715193451.470656,-18000,,
com.google.Chrome,57,1715193385,1715193442,1715193442.282876,-18000,,
com.apple.Preview,5,1715193380,1715193385,1715193385.452756,-18000,,
com.google.Chrome,53,1715193327,1715193380,1715193380.496247,-18000,,
com.apple.Preview,5,1715193322,1715193327,1715193327.112609,-18000,,
com.google.Chrome,76,1715193246,1715193322,1715193322.8224912,-18000,,
com.apple.Preview,7,1715193239,1715193246,1715193246.2781138,-18000,,
com.google.Chrome,58,1715193181,1715193239,1715193239.827187,-18000,,
com.apple.Preview,29,1715193152,1715193181,1715193181.614071,-18000,,
com.google.Chrome,5,1715193147,1715193152,1715193152.843844,-18000,,
com.apple.Preview,5,1715193142,1715193147,1715193147.9301581,-18000,,
com.google.Chrome,22,1715193120,1715193142,1715193142.4739342,-18000,,
com.apple.Preview,12,1715193108,1715193120,1715193120.061909,-18000,,
com.google.Chrome,7,1715193101,1715193108,1715193108.4029078,-18000,,
com.apple.Preview,11,1715193090,1715193101,1715193101.708426,-18000,,
com.google.Chrome,91,1715192999,1715193090,1715193090.147922,-18000,,
com.apple.Preview,6,1715192993,1715192999,1715192999.968637,-18000,,
com.google.Chrome,1,1715192992,1715192993,1715192993.9743109,-18000,,
com.apple.Preview,4,1715192988,1715192992,1715192992.398407,-18000,,
com.google.Chrome,58,1715192930,1715192988,1715192988.361227,-18000,,
com.apple.Preview,7,1715192923,1715192930,1715192930.1903849,-18000,,
com.google.Chrome,2,1715192921,1715192923,1715192923.3077822,-18000,,
com.apple.Preview,8,1715192913,1715192921,1715192921.577471,-18000,,
com.google.Chrome,40,1715192873,1715192913,1715192913.852518,-18000,,
com.apple.Preview,2,1715192871,1715192873,1715192873.467401,-18000,,
com.google.Chrome,22,1715192849,1715192871,1715192871.8418388,-18000,,
com.apple.Preview,2,1715192847,1715192849,1715192849.081074,-18000,,
com.google.Chrome,0,1715192847,1715192847,1715192847.796217,-18000,,
com.apple.Preview,1,1715192846,1715192847,1715192847.137011,-18000,,
com.google.Chrome,2,1715192844,1715192846,1715192846.3668551,-18000,,
com.apple.Preview,7,1715192837,1715192844,1715192844.681627,-18000,,
com.google.Chrome,26,1715192811,1715192837,1715192837.259001,-18000,,
com.apple.Preview,11,1715192800,1715192811,1715192811.331258,-18000,,
com.google.Chrome,48,1715192752,1715192800,1715192800.518265,-18000,,
com.apple.Preview,6,1715192746,1715192752,1715192752.910182,-18000,,
com.google.Chrome,82,1715192664,1715192746,1715192746.485841,-18000,,
com.google.Chrome,307,1715191770,1715192077,1715192077.0884252,-18000,,
com.apple.Preview,10,1715191760,1715191770,1715191770.528737,-18000,,
com.google.Chrome,57,1715191703,1715191760,1715191760.726223,-18000,,
com.apple.Preview,23,1715191680,1715191703,1715191703.3589659,-18000,,
com.google.Chrome,21,1715191659,1715191680,1715191680.4545789,-18000,,
com.apple.Preview,8,1715191651,1715191659,1715191659.567991,-18000,,
com.google.Chrome,17,1715191634,1715191651,1715191651.322969,-18000,,
com.apple.Preview,17,1715191617,1715191634,1715191634.107487,-18000,,
com.google.Chrome,84,1715191533,1715191617,1715191617.768546,-18000,,
com.apple.Preview,15,1715191518,1715191533,1715191533.7492409,-18000,,
com.google.Chrome,5,1715191513,1715191518,1715191518.961482,-18000,,
com.apple.Preview,25,1715191488,1715191513,1715191513.973201,-18000,,
com.google.Chrome,1,1715191487,1715191488,1715191488.3313642,-18000,,
com.apple.Preview,1,1715191486,1715191487,1715191487.308311,-18000,,
com.google.Chrome,21,1715191465,1715191486,1715191486.480892,-18000,,
com.apple.Preview,1,1715191464,1715191465,1715191465.4040709,-18000,,
com.google.Chrome,7,1715191457,1715191464,1715191464.261135,-18000,,
com.apple.Preview,36,1715191421,1715191457,1715191457.2470798,-18000,,
com.google.Chrome,30,1715191391,1715191421,1715191421.455472,-18000,,
com.apple.Preview,51,1715191340,1715191391,1715191391.723449,-18000,,
com.google.Chrome,13,1715191327,1715191340,1715191340.888212,-18000,,
com.apple.Preview,19,1715191308,1715191327,1715191327.6248698,-18000,,
com.google.Chrome,0,1715191308,1715191308,1715191308.479506,-18000,,
com.apple.Preview,1,1715191307,1715191308,1715191308.1214252,-18000,,
com.leomehlig.today,2,1715191305,1715191307,1715191307.126683,-18000,,
com.google.Chrome,6,1715191299,1715191305,1715191305.8567529,-18000,,
com.leomehlig.today,0,1715191299,1715191299,1715191299.91698,-18000,,
com.apple.Preview,13,1715191286,1715191299,1715191299.2076402,-18000,,
com.leomehlig.today,1,1715191285,1715191286,1715191286.2326899,-18000,,
com.google.Chrome,39,1715191246,1715191285,1715191285.3877602,-18000,,
com.leomehlig.today,7,1715191239,1715191246,1715191246.191287,-18000,,
com.google.Chrome,36,1715191203,1715191239,1715191239.679562,-18000,,
com.apple.Preview,8,1715191195,1715191203,1715191203.6589022,-18000,,
com.google.Chrome,6,1715191189,1715191195,1715191195.5606852,-18000,,
com.apple.Preview,21,1715191168,1715191189,1715191189.379467,-18000,,
com.google.Chrome,13,1715191155,1715191168,1715191168.833054,-18000,,
com.apple.Preview,7,1715191148,1715191155,1715191155.066125,-18000,,
com.google.Chrome,10,1715191138,1715191148,1715191148.815527,-18000,,
com.apple.Preview,1,1715191137,1715191138,1715191138.44097,-18000,,
com.google.Chrome,4,1715191133,1715191137,1715191137.468612,-18000,,
com.apple.Preview,12,1715191121,1715191133,1715191133.126226,-18000,,
com.google.Chrome,13,1715191108,1715191121,1715191121.552263,-18000,,
com.apple.Preview,25,1715191083,1715191108,1715191108.399123,-18000,,
com.google.Chrome,2,1715191081,1715191083,1715191083.851948,-18000,,
com.apple.Preview,22,1715191059,1715191081,1715191081.598757,-18000,,
com.google.Chrome,86,1715190973,1715191059,1715191059.246603,-18000,,
com.apple.Preview,14,1715190959,1715190973,1715190973.964964,-18000,,
com.google.Chrome,23,1715190936,1715190959,1715190959.435193,-18000,,
com.apple.Preview,1,1715190935,1715190936,1715190936.206527,-18000,,
com.google.Chrome,1,1715190934,1715190935,1715190935.324847,-18000,,
com.apple.Preview,18,1715190916,1715190934,1715190934.538796,-18000,,
com.google.Chrome,9,1715190907,1715190916,1715190916.074884,-18000,,
com.apple.Preview,16,1715190891,1715190907,1715190907.756341,-18000,,
com.google.Chrome,146,1715190745,1715190891,1715190891.857914,-18000,,
com.apple.Preview,10,1715190735,1715190745,1715190746.003882,-18000,,
com.google.Chrome,3,1715190732,1715190735,1715190735.801337,-18000,,
com.apple.Preview,11,1715190721,1715190732,1715190732.3041239,-18000,,
com.google.Chrome,6,1715190715,1715190721,1715190721.598764,-18000,,
com.apple.Preview,27,1715190688,1715190715,1715190715.333226,-18000,,
com.google.Chrome,28,1715190660,1715190688,1715190688.252285,-18000,,
com.apple.Preview,22,1715190638,1715190660,1715190661.0333881,-18000,,
com.google.Chrome,11,1715190627,1715190638,1715190638.1220741,-18000,,
com.apple.Preview,1,1715190626,1715190627,1715190627.853998,-18000,,
com.google.Chrome,3,1715190623,1715190626,1715190626.13312,-18000,,
com.apple.Preview,10,1715190613,1715190623,1715190623.7099462,-18000,,
com.google.Chrome,4,1715190609,1715190613,1715190613.1210542,-18000,,
com.apple.Preview,12,1715190597,1715190609,1715190609.10224,-18000,,
com.google.Chrome,7,1715190590,1715190597,1715190597.78068,-18000,,
com.apple.Preview,12,1715190578,1715190590,1715190590.693018,-18000,,
com.google.Chrome,2,1715190576,1715190578,1715190578.058617,-18000,,
com.apple.Preview,23,1715190553,1715190576,1715190576.153172,-18000,,
com.google.Chrome,2,1715190551,1715190553,1715190553.522877,-18000,,
com.apple.Preview,8,1715190543,1715190551,1715190551.810258,-18000,,
com.google.Chrome,90,1715190453,1715190543,1715190543.422512,-18000,,
com.apple.Preview,5,1715190448,1715190453,1715190453.189193,-18000,,
com.google.Chrome,7,1715190441,1715190448,1715190448.1109638,-18000,,
com.apple.Preview,15,1715190426,1715190441,1715190441.294589,-18000,,
com.google.Chrome,3,1715190423,1715190426,1715190426.39552,-18000,,
com.apple.Preview,30,1715190393,1715190423,1715190423.4223971,-18000,,
com.google.Chrome,10,1715190383,1715190393,1715190393.0835428,-18000,,
com.apple.Preview,16,1715190367,1715190383,1715190383.04127,-18000,,
com.google.Chrome,1,1715190366,1715190367,1715190367.1453009,-18000,,
com.apple.Preview,7,1715190359,1715190366,1715190366.235626,-18000,,
com.google.Chrome,3,1715190356,1715190359,1715190359.529372,-18000,,
com.apple.Preview,12,1715190344,1715190356,1715190356.923098,-18000,,
com.google.Chrome,6,1715190338,1715190344,1715190344.6148028,-18000,,
com.apple.Preview,6,1715190332,1715190338,1715190338.330987,-18000,,
com.google.Chrome,45,1715190287,1715190332,1715190332.6338382,-18000,,
com.apple.Preview,28,1715190259,1715190287,1715190287.64979,-18000,,
com.google.Chrome,8,1715190251,1715190259,1715190259.73074,-18000,,
com.apple.Preview,19,1715190232,1715190251,1715190251.402134,-18000,,
com.google.Chrome,4,1715190228,1715190232,1715190232.553014,-18000,,
com.apple.Preview,7,1715190221,1715190228,1715190228.6275868,-18000,,
com.google.Chrome,6,1715190215,1715190221,1715190221.673695,-18000,,
com.apple.Preview,34,1715190181,1715190215,1715190215.238647,-18000,,
com.google.Chrome,4,1715190177,1715190181,1715190181.4332352,-18000,,
com.apple.Preview,17,1715190160,1715190177,1715190177.103197,-18000,,
com.google.Chrome,21,1715190139,1715190160,1715190160.560934,-18000,,
com.apple.Preview,20,1715190119,1715190139,1715190139.554593,-18000,,
com.google.Chrome,10,1715190109,1715190119,1715190119.8806071,-18000,,
com.apple.Preview,8,1715190101,1715190109,1715190109.962656,-18000,,
com.google.Chrome,1,1715190100,1715190101,1715190101.482806,-18000,,
com.apple.Preview,3,1715190097,1715190100,1715190100.2606611,-18000,,
com.google.Chrome,10,1715190087,1715190097,1715190097.066791,-18000,,
com.apple.Preview,21,1715190066,1715190087,1715190087.475178,-18000,,
com.google.Chrome,13,1715190053,1715190066,1715190066.123372,-18000,,
com.apple.Preview,21,1715190032,1715190053,1715190053.908052,-18000,,
com.google.Chrome,6,1715190026,1715190032,1715190032.413673,-18000,,
com.apple.Preview,25,1715190001,1715190026,1715190026.7858639,-18000,,
com.google.Chrome,2,1715189999,1715190001,1715190001.623524,-18000,,
com.apple.Preview,28,1715189971,1715189999,1715189999.210168,-18000,,
com.google.Chrome,1,1715189970,1715189971,1715189971.6333551,-18000,,
com.apple.Preview,8,1715189962,1715189970,1715189970.3786201,-18000,,
com.google.Chrome,3,1715189959,1715189962,1715189962.065459,-18000,,
com.apple.Preview,5,1715189954,1715189959,1715189959.8334022,-18000,,
com.google.Chrome,42,1715189912,1715189954,1715189954.8831081,-18000,,
com.apple.Preview,9,1715189903,1715189912,1715189912.50101,-18000,,
com.google.Chrome,2,1715189901,1715189903,1715189903.267564,-18000,,
com.apple.Preview,8,1715189893,1715189901,1715189901.866395,-18000,,
com.google.Chrome,3,1715189890,1715189893,1715189893.60573,-18000,,
com.apple.Preview,6,1715189884,1715189890,1715189890.9576402,-18000,,
com.google.Chrome,9,1715189875,1715189884,1715189884.980607,-18000,,
com.apple.Preview,5,1715189870,1715189875,1715189875.716456,-18000,,
com.google.Chrome,3,1715189867,1715189870,1715189870.837012,-18000,,
com.apple.Preview,11,1715189856,1715189867,1715189867.310423,-18000,,
com.google.Chrome,57,1715189799,1715189856,1715189856.933257,-18000,,
com.apple.Preview,2,1715189797,1715189799,1715189799.2452621,-18000,,
com.google.Chrome,2,1715189795,1715189797,1715189797.244498,-18000,,
com.apple.Preview,16,1715189779,1715189795,1715189795.439815,-18000,,
com.google.Chrome,13,1715189766,1715189779,1715189779.2836099,-18000,,
com.apple.Preview,3,1715189763,1715189766,1715189766.151507,-18000,,
com.google.Chrome,5,1715189758,1715189763,1715189763.464107,-18000,,
com.apple.Preview,3,1715189755,1715189758,1715189758.0751848,-18000,,
com.google.Chrome,2,1715189753,1715189755,1715189755.643892,-18000,,
com.apple.Preview,2,1715189751,1715189753,1715189753.2403789,-18000,,
com.google.Chrome,2,1715189749,1715189751,1715189751.096211,-18000,,
com.apple.Preview,15,1715189734,1715189749,1715189749.4171882,-18000,,
com.google.Chrome,45,1715189689,1715189734,1715189734.888035,-18000,,
com.apple.Preview,20,1715189669,1715189689,1715189689.108041,-18000,,
com.google.Chrome,6,1715189663,1715189669,1715189669.484488,-18000,,
com.apple.Preview,7,1715189656,1715189663,1715189663.483571,-18000,,
com.google.Chrome,21,1715189635,1715189656,1715189656.77125,-18000,,
com.apple.Preview,16,1715189619,1715189635,1715189635.191462,-18000,,
com.google.Chrome,4,1715189615,1715189619,1715189619.968646,-18000,,
com.apple.Preview,1,1715189614,1715189615,1715189615.494473,-18000,,
com.apple.finder,3,1715189611,1715189614,1715189614.393866,-18000,,
com.apple.Preview,2,1715189609,1715189611,1715189612.0963612,-18000,,
com.apple.finder,5,1715189604,1715189609,1715189609.384628,-18000,,
com.google.Chrome,51,1715189553,1715189604,1715189604.530235,-18000,,
com.leomehlig.today,13,1715189530,1715189543,1715189543.2523851,-18000,,
com.google.Chrome,165,1715189365,1715189530,1715189530.1610641,-18000,,
com.google.Chrome,5,1715179475,1715179480,1715179480.783523,-18000,,
com.microsoft.Outlook,62,1715179413,1715179475,1715179476.134819,-18000,,
com.google.Chrome,14,1715179399,1715179413,1715179413.682395,-18000,,
com.leomehlig.today,2,1715179397,1715179399,1715179400.2459068,-18000,,
com.leomehlig.today,12,1715176278,1715176290,1715176290.3676682,-18000,,
com.google.Chrome,2,1715176276,1715176278,1715176278.526695,-18000,,
com.google.Chrome,5,1715174833,1715174838,1715174838.6304832,-18000,,
com.leomehlig.today,13,1715174820,1715174833,1715174833.180361,-18000,,
com.google.Chrome,2,1715174818,1715174820,1715174820.391317,-18000,,
com.apple.systempreferences,71,1715174747,1715174818,1715174818.975805,-18000,,
com.google.Chrome,31,1715174708,1715174739,1715174739.3891969,-18000,,
com.apple.MobileSMS,2,1715174706,1715174708,1715174708.974611,-18000,,
com.google.Chrome,6,1715174700,1715174706,1715174706.197857,-18000,,
com.leomehlig.today,2,1715174698,1715174700,1715174700.978323,-18000,,
com.leomehlig.today,11,1715139211,1715139222,1715139222.112062,-18000,,
com.google.Chrome,204,1715139007,1715139211,1715139211.0541449,-18000,,
com.google.Chrome,472,1715137695,1715138167,1715138167.1006532,-18000,,
com.leomehlig.today,11,1715137684,1715137695,1715137695.382131,-18000,,
com.leomehlig.today,1,1715137188,1715137189,1715137189.9535089,-18000,,
com.apple.iCal,44,1715137144,1715137188,1715137188.0828152,-18000,,
com.google.Chrome,4,1715137140,1715137144,1715137144.551343,-18000,,
com.leomehlig.today,36,1715137104,1715137140,1715137140.5815659,-18000,,
com.google.Chrome,79,1715137025,1715137104,1715137104.4944348,-18000,,
com.google.Chrome,315,1715136156,1715136471,1715136471.7171578,-18000,,
com.google.Chrome,455,1715135614,1715136069,1715136069.8579779,-18000,,
com.apple.MobileSMS,3,1715135611,1715135614,1715135614.583473,-18000,,
com.google.Chrome,2,1715135609,1715135611,1715135611.9976292,-18000,,
com.google.Chrome,6,1715129952,1715129958,1715129958.897328,-18000,,
com.google.Chrome,304,1715129257,1715129561,1715129561.75315,-18000,,
com.google.Chrome,708,1715127666,1715128374,1715128374.659347,-18000,,
com.google.Chrome,308,1715127105,1715127413,1715127413.784049,-18000,,
com.google.Chrome,302,1715126772,1715127074,1715127074.51613,-18000,,
com.google.Chrome,617,1715125903,1715126520,1715126520.097198,-18000,,
com.google.Chrome,310,1715124555,1715124865,1715124865.126885,-18000,,
com.google.Chrome,300,1715122784,1715123084,1715123084.536675,-18000,,
com.google.Chrome,470,1715122150,1715122620,1715122620.7367811,-18000,,
com.google.Chrome,241,1715121323,1715121564,1715121564.966577,-18000,,
com.leomehlig.today,32,1715121291,1715121323,1715121323.630841,-18000,,
com.google.Chrome,543,1715120748,1715121291,1715121291.548098,-18000,,
com.leomehlig.today,24,1715120724,1715120748,1715120748.4690142,-18000,,
com.google.Chrome,102,1715120622,1715120724,1715120724.525739,-18000,,
com.apple.Notes,2,1715120620,1715120622,1715120622.9929729,-18000,,
com.leomehlig.today,2,1715120618,1715120620,1715120620.258112,-18000,,
com.leomehlig.today,41,1715118224,1715118265,1715118265.935072,-18000,,
com.google.Chrome,374,1715117850,1715118224,1715118224.400371,-18000,,
com.leomehlig.today,44,1715117806,1715117850,1715117850.141192,-18000,,
com.google.Chrome,1209,1715116597,1715117806,1715117807.083935,-18000,,
com.leomehlig.today,4,1715116593,1715116597,1715116597.7818499,-18000,,
com.google.Chrome,1882,1715114711,1715116593,1715116593.1467009,-18000,,
com.leomehlig.today,58,1715114653,1715114711,1715114711.26386,-18000,,
com.google.Chrome,51,1715114602,1715114653,1715114653.8196058,-18000,,
com.apple.Notes,17,1715114585,1715114602,1715114602.8663158,-18000,,
com.google.Chrome,61,1715114524,1715114585,1715114585.177408,-18000,,
com.google.Chrome,158,1715113572,1715113730,1715113730.5222092,-18000,,
com.google.Chrome,300,1715113092,1715113392,1715113392.450664,-18000,,
com.google.Chrome,688,1715112296,1715112984,1715112984.321356,-18000,,
com.google.Chrome,490,1715110795,1715111285,1715111285.0898519,-18000,,
com.google.Chrome,350,1715109527,1715109877,1715109877.27878,-18000,,
com.leomehlig.today,5,1715109522,1715109527,1715109527.476059,-18000,,
com.microsoft.Outlook,4,1715109518,1715109522,1715109522.901144,-18000,,
com.microsoft.Outlook,16,1715102474,1715102490,1715102491.1274219,-18000,,
com.google.Chrome,751,1715101723,1715102474,1715102474.7720919,-18000,,
com.google.Chrome,714,1715100160,1715100874,1715100874.347327,-18000,,
com.google.Chrome,1216,1715098788,1715100004,1715100004.669324,-18000,,
com.leomehlig.today,372,1715098416,1715098788,1715098788.215553,-18000,,
com.google.Chrome,106,1715098310,1715098416,1715098416.7160501,-18000,,
com.leomehlig.today,10,1715098300,1715098310,1715098310.67225,-18000,,
com.google.Chrome,11,1715098289,1715098300,1715098300.668536,-18000,,
com.leomehlig.today,1,1715098288,1715098289,1715098289.318355,-18000,,
com.apple.finder,0,1715098288,1715098288,1715098288.7780318,-18000,,
com.leomehlig.today,1,1715098287,1715098288,1715098288.251678,-18000,,
com.google.Chrome,126,1715098161,1715098287,1715098287.347728,-18000,,
com.leomehlig.today,0,1715098161,1715098161,1715098161.606632,-18000,,
com.google.Chrome,95,1715098066,1715098161,1715098161.1885839,-18000,,
com.leomehlig.today,1,1715098065,1715098066,1715098066.1181688,-18000,,
com.google.Chrome,154,1715097911,1715098065,1715098065.3767319,-18000,,
com.leomehlig.today,1,1715097910,1715097911,1715097911.101495,-18000,,
com.google.Chrome,260,1715097650,1715097910,1715097910.304142,-18000,,
com.leomehlig.today,33,1715097617,1715097650,1715097650.901958,-18000,,
com.google.Chrome,1,1715097616,1715097617,1715097617.970638,-18000,,
com.google.Chrome,143,1715095683,1715095826,1715095826.810878,-18000,,
com.apple.finder,2,1715095681,1715095683,1715095683.284395,-18000,,
com.google.Chrome,135,1715095546,1715095681,1715095681.6867719,-18000,,
com.leomehlig.today,8,1715095538,1715095546,1715095546.251052,-18000,,
com.google.Chrome,103,1715095435,1715095538,1715095538.1346822,-18000,,
com.apple.finder,0,1715095435,1715095435,1715095435.669766,-18000,,
com.google.Chrome,5,1715095430,1715095435,1715095435.149334,-18000,,
com.apple.finder,1,1715095429,1715095430,1715095430.166225,-18000,,
com.google.Chrome,14,1715095415,1715095429,1715095429.0773048,-18000,,
com.apple.finder,2,1715095413,1715095415,1715095415.4776149,-18000,,
com.google.Chrome,62,1715095351,1715095413,1715095413.502126,-18000,,
com.apple.finder,12,1715095339,1715095351,1715095351.8174438,-18000,,
com.google.Chrome,12,1715095327,1715095339,1715095339.1299372,-18000,,
com.microsoft.Outlook,16,1715095311,1715095327,1715095327.445543,-18000,,
com.google.Chrome,36,1715095275,1715095311,1715095311.476468,-18000,,
com.apple.MobileSMS,4,1715095257,1715095261,1715095261.706727,-18000,,
com.google.Chrome,1,1715095256,1715095257,1715095257.70157,-18000,,
com.apple.finder,4,1715095252,1715095256,1715095256.428738,-18000,,
com.microsoft.Outlook,114,1715095138,1715095252,1715095252.4433799,-18000,,
com.apple.finder,25,1715095113,1715095138,1715095138.228949,-18000,,
com.microsoft.Outlook,34,1715095079,1715095113,1715095114.019314,-18000,,
com.leomehlig.today,15,1715095064,1715095079,1715095079.623691,-18000,,
com.apple.iCal,21,1715095043,1715095064,1715095064.305053,-18000,,
com.leomehlig.today,5,1715095038,1715095043,1715095043.1302938,-18000,,
com.microsoft.Outlook,3,1715095035,1715095038,1715095038.993095,-18000,,
com.google.Chrome,13,1715095022,1715095035,1715095035.3984551,-18000,,
com.google.Chrome,42,1715049523,1715049565,1715049565.09802,-18000,,
com.google.Chrome,606,1715048572,1715049178,1715049178.0320349,-18000,,
com.google.Chrome,540,1715048020,1715048560,1715048560.82624,-18000,,
com.google.Chrome,413,1715047315,1715047728,1715047728.755826,-18000,,
com.google.Chrome,668,1715046635,1715047303,1715047303.8844562,-18000,,
com.google.Chrome,3,1715032051,1715032054,1715032054.51236,-18000,,
com.microsoft.Outlook,142,1715031909,1715032051,1715032051.981402,-18000,,
com.google.Chrome,3,1715031906,1715031909,1715031909.31968,-18000,,
com.microsoft.Outlook,1,1715031905,1715031906,1715031906.6708941,-18000,,
com.google.Chrome,4,1715031901,1715031905,1715031905.535047,-18000,,
com.microsoft.Outlook,1,1715031900,1715031901,1715031902.021848,-18000,,
com.google.Chrome,1,1715031899,1715031900,1715031900.311583,-18000,,
com.microsoft.Outlook,4,1715031895,1715031899,1715031899.301986,-18000,,
com.google.Chrome,1,1715031894,1715031895,1715031895.678272,-18000,,
com.microsoft.Outlook,4,1715031890,1715031894,1715031894.14649,-18000,,
com.google.Chrome,1,1715031889,1715031890,1715031890.649477,-18000,,
com.microsoft.Outlook,3,1715031886,1715031889,1715031889.157205,-18000,,
com.google.Chrome,5,1715031881,1715031886,1715031887.02665,-18000,,
com.microsoft.Outlook,8,1715031873,1715031881,1715031881.119389,-18000,,
com.google.Chrome,2,1715031871,1715031873,1715031873.212784,-18000,,
com.microsoft.Outlook,4,1715031867,1715031871,1715031871.571531,-18000,,
com.google.Chrome,2,1715031865,1715031867,1715031867.511095,-18000,,
com.microsoft.Outlook,5,1715031860,1715031865,1715031865.15441,-18000,,
com.google.Chrome,1,1715031859,1715031860,1715031860.804528,-18000,,
com.microsoft.Outlook,7,1715031852,1715031859,1715031859.31922,-18000,,
com.google.Chrome,1,1715031851,1715031852,1715031852.247648,-18000,,
com.leomehlig.today,1,1715031850,1715031851,1715031851.471006,-18000,,
com.google.Chrome,2,1715031848,1715031850,1715031850.1603432,-18000,,
com.leomehlig.today,2,1715031846,1715031848,1715031848.94255,-18000,,
com.microsoft.Outlook,0,1715031846,1715031846,1715031847.052824,-18000,,
com.google.Chrome,1,1715031845,1715031846,1715031846.231673,-18000,,
com.microsoft.Outlook,3,1715031842,1715031845,1715031845.5921469,-18000,,
com.google.Chrome,37,1715031805,1715031842,1715031842.9632878,-18000,,
com.microsoft.Outlook,13,1715031792,1715031805,1715031805.238092,-18000,,
com.google.Chrome,30,1715031762,1715031792,1715031792.176093,-18000,,
com.microsoft.Outlook,27,1715031735,1715031762,1715031762.592583,-18000,,
com.google.Chrome,2,1715031733,1715031735,1715031735.6770802,-18000,,
com.google.Chrome,1,1715031730,1715031731,1715031731.9808931,-18000,,
com.google.Chrome,11,1715031681,1715031692,1715031692.584046,-18000,,
com.leomehlig.today,37,1715031644,1715031681,1715031681.8002338,-18000,,
com.google.Chrome,594,1715031050,1715031644,1715031644.29249,-18000,,
com.leomehlig.today,31,1715031019,1715031050,1715031050.057374,-18000,,
com.google.Chrome,134,1715030885,1715031019,1715031019.239451,-18000,,
com.leomehlig.today,5,1715029869,1715029874,1715029874.280696,-18000,,
com.google.Chrome,42,1715029827,1715029869,1715029869.803101,-18000,,
com.leomehlig.today,1,1715029826,1715029827,1715029827.854481,-18000,,
com.google.Chrome,1384,1715028442,1715029826,1715029826.680392,-18000,,
com.microsoft.Outlook,82,1715028360,1715028442,1715028442.57346,-18000,,
com.google.Chrome,19,1715028341,1715028360,1715028360.40806,-18000,,
com.microsoft.Outlook,235,1715028098,1715028333,1715028333.144459,-18000,,
com.google.Chrome,20,1715028078,1715028098,1715028098.185461,-18000,,
com.microsoft.Outlook,38,1715028040,1715028078,1715028078.647923,-18000,,
com.google.Chrome,13,1715028027,1715028040,1715028040.4421902,-18000,,
com.leomehlig.today,27,1715028000,1715028027,1715028028.4247332,-18000,,
com.google.Chrome,10,1715027990,1715028000,1715028000.370492,-18000,,
com.google.Chrome,65,1715017388,1715017453,1715017453.07506,-18000,,
com.apple.Notes,1,1715017374,1715017375,1715017375.938962,-18000,,
com.google.Chrome,118,1715017256,1715017374,1715017374.484736,-18000,,
com.leomehlig.today,8,1715017248,1715017256,1715017256.719511,-18000,,
com.google.Chrome,432,1715016816,1715017248,1715017248.631494,-18000,,
com.leomehlig.today,64,1715016752,1715016816,1715016816.743678,-18000,,
com.apple.Notes,22,1715016730,1715016752,1715016752.179713,-18000,,
com.google.Chrome,717,1715016013,1715016730,1715016730.645191,-18000,,
com.leomehlig.today,2,1715016011,1715016013,1715016013.802297,-18000,,
com.google.Chrome,724,1715015287,1715016011,1715016011.0833411,-18000,,
com.leomehlig.today,14,1715015273,1715015287,1715015287.569973,-18000,,
com.google.Chrome,1,1715015272,1715015273,1715015273.672958,-18000,,
com.apple.Notes,7,1715015265,1715015272,1715015272.401404,-18000,,
com.google.Chrome,2,1715015263,1715015265,1715015265.432565,-18000,,
com.leomehlig.today,15,1715015248,1715015263,1715015263.62783,-18000,,
com.google.Chrome,86,1715015162,1715015248,1715015248.521652,-18000,,
com.leomehlig.today,1,1715015161,1715015162,1715015162.504014,-18000,,
com.google.Chrome,894,1715014267,1715015161,1715015161.171039,-18000,,
com.apple.Notes,9,1715014258,1715014267,1715014267.077646,-18000,,
com.google.Chrome,773,1715013485,1715014258,1715014258.8630261,-18000,,
com.leomehlig.today,28,1715013457,1715013485,1715013485.197952,-18000,,
com.google.Chrome,1257,1715012200,1715013457,1715013457.198793,-18000,,
com.apple.Notes,2,1715012198,1715012200,1715012200.091333,-18000,,
com.google.Chrome,144,1715012054,1715012198,1715012198.809562,-18000,,
com.apple.Notes,61,1715011993,1715012054,1715012054.913539,-18000,,
com.google.Chrome,321,1715011672,1715011993,1715011993.1649818,-18000,,
com.leomehlig.today,58,1715011614,1715011672,1715011672.615969,-18000,,
com.google.Chrome,2,1715011612,1715011614,1715011614.275898,-18000,,
com.google.Chrome,1,1715008205,1715008206,1715008206.448452,-18000,,
com.apple.MobileSMS,5,1715008200,1715008205,1715008205.085874,-18000,,
com.google.Chrome,21,1715008179,1715008200,1715008200.7153192,-18000,,
com.leomehlig.today,59,1715008120,1715008179,1715008179.511606,-18000,,
com.microsoft.Outlook,17,1715008103,1715008120,1715008121.063713,-18000,,
com.leomehlig.today,100,1715008003,1715008103,1715008103.946806,-18000,,
com.google.Chrome,4,1715007999,1715008003,1715008003.59637,-18000,,
com.microsoft.Outlook,91,1715007908,1715007999,1715007999.946387,-18000,,
com.google.Chrome,22,1715007886,1715007908,1715007908.156443,-18000,,
com.leomehlig.today,17,1715007869,1715007886,1715007886.7714372,-18000,,
com.google.Chrome,32,1715007837,1715007869,1715007869.059904,-18000,,
com.leomehlig.today,142,1715007681,1715007823,1715007824.254219,-18000,,
com.leomehlig.today,311,1715007159,1715007470,1715007470.418692,-18000,,
com.leomehlig.today,315,1715006621,1715006936,1715006936.9355102,-18000,,
com.leomehlig.today,311,1715005176,1715005487,1715005487.9193711,-18000,,
com.leomehlig.today,301,1715003050,1715003351,1715003351.132498,-18000,,
com.leomehlig.today,389,1715002660,1715003049,1715003049.4741511,-18000,,
com.google.Chrome,9,1715002651,1715002660,1715002660.223239,-18000,,
com.google.Chrome,625,1714964854,1714965479,1714965479.883692,-18000,,
com.google.Chrome,478,1714963963,1714964441,1714964441.678051,-18000,,
com.google.Chrome,332,1714963506,1714963838,1714963838.100192,-18000,,
com.google.Chrome,541,1714962633,1714963174,1714963174.765802,-18000,,
com.google.Chrome,2063,1714942176,1714944239,1714944239.736495,-18000,,
com.leomehlig.today,1,1714942175,1714942176,1714942176.8739262,-18000,,
com.apple.MobileSMS,3,1714942172,1714942175,1714942175.331312,-18000,,
com.leomehlig.today,2,1714942170,1714942172,1714942173.031894,-18000,,
com.apple.MobileSMS,3,1714942167,1714942170,1714942170.6319141,-18000,,
com.leomehlig.today,7,1714942160,1714942167,1714942167.065351,-18000,,
com.leomehlig.today,24,1714940703,1714940727,1714940727.861803,-18000,,
com.apple.Preview,289,1714940414,1714940703,1714940703.592204,-18000,,
com.apple.Preview,1078,1714938948,1714940026,1714940026.805159,-18000,,
com.apple.Preview,474,1714938270,1714938744,1714938744.635291,-18000,,
com.apple.finder,2,1714938268,1714938270,1714938270.725218,-18000,,
com.apple.Preview,393,1714937875,1714938268,1714938268.5185199,-18000,,
com.apple.finder,2,1714937873,1714937875,1714937875.835781,-18000,,
com.apple.Preview,40,1714937833,1714937873,1714937873.085319,-18000,,
com.apple.finder,288,1714937545,1714937833,1714937833.710948,-18000,,
com.google.Chrome,10,1714937535,1714937545,1714937545.6460462,-18000,,
com.leomehlig.today,8,1714937527,1714937535,1714937535.5329661,-18000,,
com.leomehlig.today,30,1714932781,1714932811,1714932811.528312,-18000,,
com.google.Chrome,7,1714932774,1714932781,1714932781.726499,-18000,,
com.leomehlig.today,13,1714932761,1714932774,1714932774.7115688,-18000,,
com.google.Chrome,16,1714932745,1714932761,1714932761.158389,-18000,,
com.leomehlig.today,12,1714932733,1714932745,1714932745.589777,-18000,,
com.google.Chrome,5,1714932728,1714932733,1714932733.1569471,-18000,,
com.leomehlig.today,2,1714932726,1714932728,1714932728.064853,-18000,,
com.google.Chrome,1,1714932725,1714932726,1714932726.592505,-18000,,
com.leomehlig.today,5,1714932720,1714932725,1714932725.719091,-18000,,
com.google.Chrome,9,1714932711,1714932720,1714932720.063144,-18000,,
com.leomehlig.today,10,1714932701,1714932711,1714932711.566076,-18000,,
com.google.Chrome,109,1714932592,1714932701,1714932701.3730922,-18000,,
com.leomehlig.today,26,1714932566,1714932592,1714932592.308631,-18000,,
com.google.Chrome,234,1714932332,1714932566,1714932566.230351,-18000,,
com.leomehlig.today,10,1714932322,1714932332,1714932332.769607,-18000,,
com.google.Chrome,24,1714932298,1714932322,1714932322.174646,-18000,,
com.leomehlig.today,4,1714932294,1714932298,1714932299.004133,-18000,,
com.google.Chrome,2787,1714929507,1714932294,1714932294.491761,-18000,,
com.leomehlig.today,2,1714929490,1714929492,1714929492.7708359,-18000,,
com.leomehlig.today,6,1714929012,1714929018,1714929018.730531,-18000,,
com.google.Chrome,2,1714929010,1714929012,1714929012.453022,-18000,,
com.leomehlig.today,0,1714929010,1714929010,1714929010.849546,-18000,,
com.apple.Notes,6,1714929004,1714929010,1714929010.501806,-18000,,
com.google.Chrome,3531,1714925473,1714929004,1714929004.882252,-18000,,
com.leomehlig.today,43,1714925430,1714925473,1714925474.0725,-18000,,
com.leomehlig.today,2,1714923807,1714923809,1714923809.6950831,-18000,,
com.leomehlig.today,87,1714923718,1714923805,1714923805.577946,-18000,,
com.google.Chrome,16,1714923702,1714923718,1714923718.12494,-18000,,
com.leomehlig.today,14,1714923688,1714923702,1714923702.477247,-18000,,
com.google.Chrome,276,1714923412,1714923688,1714923688.527985,-18000,,
com.apple.MobileSMS,686,1714922726,1714923412,1714923412.143052,-18000,,
com.apple.Photos,48,1714922678,1714922726,1714922726.400776,-18000,,
com.apple.MobileSMS,6,1714922672,1714922678,1714922678.3306599,-18000,,
com.apple.Photos,13,1714922659,1714922672,1714922672.549035,-18000,,
com.apple.MobileSMS,4,1714922655,1714922659,1714922659.069013,-18000,,
com.apple.Photos,1,1714922654,1714922655,1714922655.243608,-18000,,
com.apple.MobileSMS,1,1714922653,1714922654,1714922654.393826,-18000,,
com.apple.Photos,5,1714922648,1714922653,1714922653.337353,-18000,,
com.apple.MobileSMS,7,1714922641,1714922648,1714922648.792397,-18000,,
com.apple.Photos,158,1714922483,1714922641,1714922641.560307,-18000,,
com.google.Chrome,67,1714922416,1714922483,1714922483.129693,-18000,,
com.apple.Notes,1,1714922415,1714922416,1714922416.943794,-18000,,
com.apple.Preview,2,1714922413,1714922415,1714922415.506067,-18000,,
com.google.Chrome,2,1714922411,1714922413,1714922413.0573812,-18000,,
com.apple.Notes,1,1714922410,1714922411,1714922411.9176002,-18000,,
com.google.Chrome,1779,1714920631,1714922410,1714922410.1181521,-18000,,
com.apple.Preview,28,1714920603,1714920631,1714920631.663827,-18000,,
com.apple.finder,3,1714920600,1714920603,1714920603.334172,-18000,,
com.google.Chrome,646,1714919954,1714920600,1714920600.622353,-18000,,
com.leomehlig.today,2,1714919952,1714919954,1714919954.936298,-18000,,
com.leomehlig.today,320,1714919449,1714919769,1714919769.264849,-18000,,
com.google.Chrome,25,1714919424,1714919449,1714919449.8888102,-18000,,
com.apple.Notes,24,1714919400,1714919424,1714919424.474533,-18000,,
com.google.Chrome,2,1714919398,1714919400,1714919400.240045,-18000,,
com.apple.Notes,1,1714919397,1714919398,1714919398.925683,-18000,,
com.google.Chrome,1,1714919396,1714919397,1714919397.83835,-18000,,
com.apple.Notes,1,1714919395,1714919396,1714919396.8243508,-18000,,
com.google.Chrome,768,1714918627,1714919395,1714919395.399904,-18000,,
com.apple.Notes,3,1714918624,1714918627,1714918627.784065,-18000,,
com.google.Chrome,427,1714918197,1714918624,1714918624.321227,-18000,,
com.apple.Notes,2,1714918195,1714918197,1714918197.633322,-18000,,
com.apple.iCal,242,1714917953,1714918195,1714918195.153638,-18000,,
com.apple.MobileSMS,19,1714917934,1714917953,1714917953.754391,-18000,,
com.google.Chrome,278,1714917656,1714917934,1714917934.631483,-18000,,
com.apple.Notes,2,1714917654,1714917656,1714917656.7894092,-18000,,
com.google.Chrome,22,1714917632,1714917654,1714917654.03791,-18000,,
com.apple.Notes,7,1714917590,1714917597,1714917598.029681,-18000,,
com.leomehlig.today,14,1714917576,1714917590,1714917591.007299,-18000,,
com.apple.finder,3,1714917573,1714917576,1714917576.769332,-18000,,
com.apple.Photos,20,1714917553,1714917573,1714917573.292656,-18000,,
com.google.Chrome,5,1714917548,1714917553,1714917553.441399,-18000,,
com.google.Chrome,4,1714877222,1714877226,1714877226.6082401,-18000,,
com.apple.MobileSMS,7,1714877215,1714877222,1714877222.365634,-18000,,
com.google.Chrome,424,1714876791,1714877215,1714877215.206624,-18000,,
com.google.Chrome,505,1714876062,1714876567,1714876567.822269,-18000,,
com.google.Chrome,839,1714875103,1714875942,1714875942.646843,-18000,,
com.google.Chrome,327,1714874725,1714875052,1714875052.621797,-18000,,
com.google.Chrome,476,1714874218,1714874694,1714874694.738117,-18000,,
com.google.Chrome,360,1714873586,1714873946,1714873946.961158,-18000,,
com.google.Chrome,474,1714872797,1714873271,1714873271.109984,-18000,,
com.google.Chrome,295,1714871522,1714871817,1714871817.607079,-18000,,
com.leomehlig.today,97,1714871319,1714871416,1714871417.011903,-18000,,
com.apple.Notes,5,1714871314,1714871319,1714871319.732677,-18000,,
com.google.Chrome,8,1714871306,1714871314,1714871314.9770799,-18000,,
com.microsoft.Outlook,87,1714871219,1714871306,1714871306.8850632,-18000,,
com.google.Chrome,7,1714871212,1714871219,1714871219.8027492,-18000,,
com.microsoft.Outlook,45,1714871167,1714871212,1714871212.7834349,-18000,,
com.google.Chrome,8,1714871159,1714871167,1714871167.284467,-18000,,
com.microsoft.Outlook,13,1714871146,1714871159,1714871159.3949099,-18000,,
com.leomehlig.today,23,1714871123,1714871146,1714871146.9671159,-18000,,
com.google.Chrome,1366,1714869757,1714871123,1714871123.246732,-18000,,
com.leomehlig.today,26,1714869731,1714869757,1714869757.669965,-18000,,
com.google.Chrome,490,1714869241,1714869731,1714869731.979327,-18000,,
com.apple.Notes,2,1714869239,1714869241,1714869241.241852,-18000,,
com.google.Chrome,857,1714868382,1714869239,1714869239.7542748,-18000,,
com.apple.Notes,6,1714868376,1714868382,1714868382.538107,-18000,,
com.google.Chrome,132,1714868244,1714868376,1714868376.5701451,-18000,,
com.google.Chrome,892,1714867320,1714868212,1714868212.172751,-18000,,
com.google.Chrome,300,1714866991,1714867291,1714867291.1017241,-18000,,
com.google.Chrome,1158,1714865817,1714866975,1714866975.6220222,-18000,,
com.apple.Notes,4,1714865813,1714865817,1714865817.122738,-18000,,
com.google.Chrome,7,1714865806,1714865813,1714865813.363696,-18000,,
com.apple.Notes,6,1714865789,1714865795,1714865795.53106,-18000,,
com.google.Chrome,431,1714865358,1714865789,1714865789.566382,-18000,,
com.apple.Notes,47,1714865311,1714865358,1714865358.3289099,-18000,,
com.google.Chrome,12,1714865299,1714865311,1714865311.391653,-18000,,
com.google.Chrome,212,1714860403,1714860615,1714860615.4086618,-18000,,
com.apple.Notes,3,1714860400,1714860403,1714860403.555637,-18000,,
com.apple.Notes,2,1714860107,1714860109,1714860110.1476731,-18000,,
com.google.Chrome,1684,1714858423,1714860107,1714860107.681865,-18000,,
com.google.Chrome,479,1714857847,1714858326,1714858326.89693,-18000,,
com.google.Chrome,332,1714857430,1714857762,1714857762.637618,-18000,,
com.google.Chrome,401,1714857009,1714857410,1714857410.248744,-18000,,
com.google.Chrome,1878,1714854996,1714856874,1714856874.222182,-18000,,
com.leomehlig.today,30,1714854966,1714854996,1714854996.2823992,-18000,,
com.google.Chrome,7,1714854959,1714854966,1714854966.620713,-18000,,
com.leomehlig.today,7,1714854952,1714854959,1714854959.577767,-18000,,
com.google.Chrome,11,1714854941,1714854952,1714854952.6468391,-18000,,
com.google.Chrome,4,1714839965,1714839969,1714839969.656046,-18000,,
com.apple.MobileSMS,74,1714839891,1714839965,1714839966.0271301,-18000,,
com.google.Chrome,682,1714839209,1714839891,1714839891.643544,-18000,,
com.apple.Notes,4,1714839205,1714839209,1714839209.742482,-18000,,
com.google.Chrome,25,1714839180,1714839205,1714839205.4048781,-18000,,
com.apple.Notes,9,1714839171,1714839180,1714839180.912212,-18000,,
com.google.Chrome,436,1714838735,1714839171,1714839171.845837,-18000,,
com.leomehlig.today,36,1714838699,1714838735,1714838735.053287,-18000,,
com.google.Chrome,10,1714838689,1714838699,1714838699.364002,-18000,,
com.google.Chrome,336,1714838139,1714838475,1714838475.878279,-18000,,
com.apple.Notes,16,1714838123,1714838139,1714838139.4702559,-18000,,
com.google.Chrome,563,1714837560,1714838123,1714838123.540176,-18000,,
com.leomehlig.today,20,1714837540,1714837560,1714837560.166153,-18000,,
com.google.Chrome,783,1714836757,1714837540,1714837540.7173119,-18000,,
com.apple.Notes,3,1714836754,1714836757,1714836757.372593,-18000,,
com.google.Chrome,817,1714835937,1714836754,1714836755.003979,-18000,,
com.apple.Notes,3,1714835934,1714835937,1714835937.3512878,-18000,,
com.google.Chrome,4,1714835930,1714835934,1714835934.5641851,-18000,,
com.apple.Notes,2,1714835928,1714835930,1714835930.67337,-18000,,
com.apple.MobileSMS,1,1714835927,1714835928,1714835928.866924,-18000,,
com.google.Chrome,6,1714835921,1714835927,1714835927.9298,-18000,,
com.apple.MobileSMS,84,1714835837,1714835921,1714835921.16308,-18000,,
com.google.Chrome,6,1714835831,1714835837,1714835837.184097,-18000,,
com.apple.Notes,1,1714835830,1714835831,1714835831.831143,-18000,,
com.google.Chrome,9,1714835821,1714835830,1714835830.47843,-18000,,
com.apple.Notes,2,1714835807,1714835809,1714835809.732349,-18000,,
com.google.Chrome,1,1714835806,1714835807,1714835807.736661,-18000,,
com.apple.Notes,1,1714835805,1714835806,1714835806.594853,-18000,,
com.google.Chrome,1281,1714834524,1714835805,1714835805.4496531,-18000,,
com.apple.Notes,5,1714834519,1714834524,1714834524.631545,-18000,,
com.google.Chrome,63,1714834456,1714834519,1714834519.851682,-18000,,
com.apple.iCal,5,1714834451,1714834456,1714834456.52653,-18000,,
com.google.Chrome,21,1714834430,1714834451,1714834451.503306,-18000,,
com.apple.iCal,586,1714833844,1714834430,1714834430.978909,-18000,,
com.google.Chrome,902,1714832942,1714833844,1714833844.789832,-18000,,
com.apple.Notes,2,1714832940,1714832942,1714832942.110157,-18000,,
com.google.Chrome,623,1714832317,1714832940,1714832940.620271,-18000,,
com.apple.Notes,8,1714832309,1714832317,1714832317.133854,-18000,,
com.google.Chrome,3,1714832306,1714832309,1714832309.666317,-18000,,
com.apple.Notes,1,1714832305,1714832306,1714832306.9109302,-18000,,
com.google.Chrome,1,1714832304,1714832305,1714832306.014423,-18000,,
com.apple.Notes,2,1714832302,1714832304,1714832304.154803,-18000,,
com.google.Chrome,1,1714832301,1714832302,1714832302.464423,-18000,,
com.apple.Notes,3,1714832288,1714832291,1714832291.5698729,-18000,,
com.google.Chrome,8,1714832280,1714832288,1714832288.596218,-18000,,
com.apple.Notes,2,1714832278,1714832280,1714832280.6544461,-18000,,
com.google.Chrome,2,1714832276,1714832278,1714832278.599091,-18000,,
com.apple.Notes,1,1714832275,1714832276,1714832276.858393,-18000,,
com.google.Chrome,2,1714832273,1714832275,1714832275.317853,-18000,,
com.apple.Notes,1,1714832272,1714832273,1714832273.91696,-18000,,
com.google.Chrome,4,1714832268,1714832272,1714832272.614238,-18000,,
com.apple.Notes,1,1714832257,1714832258,1714832258.598281,-18000,,
com.google.Chrome,1,1714832256,1714832257,1714832257.367979,-18000,,
com.apple.Notes,4,1714832252,1714832256,1714832256.4672508,-18000,,
com.leomehlig.today,2,1714832250,1714832252,1714832252.930798,-18000,,
com.apple.Notes,5,1714832245,1714832250,1714832250.855149,-18000,,
com.leomehlig.today,26,1714832219,1714832245,1714832245.883147,-18000,,
com.apple.MobileSMS,3,1714832216,1714832219,1714832219.687255,-18000,,
com.leomehlig.today,1,1714832215,1714832216,1714832216.808238,-18000,,
com.google.Chrome,6,1714832209,1714832215,1714832215.622438,-18000,,
com.apple.Health,11,1714796350,1714796361,1714796361.5907931,-18000,EB445137-D7F5-57EC-87DA-1DB460D64046,"iPhone13,2"
com.moodle.moodlemobile,3,1714795911,1714795914,1714795914.420424,-18000,EB445137-D7F5-57EC-87DA-1DB460D64046,"iPhone13,2"
com.letterboxd.LetterboxdApp,12,1714795899,1714795911,1714795911.831249,-18000,EB445137-D7F5-57EC-87DA-1DB460D64046,"iPhone13,2"
com.letterboxd.LetterboxdApp,17,1714794726,1714794743,1714794743.170463,-18000,EB445137-D7F5-57EC-87DA-1DB460D64046,"iPhone13,2"
com.google.chrome.ios,3,1714794720,1714794723,1714794723.2174768,-18000,EB445137-D7F5-57EC-87DA-1DB460D64046,"iPhone13,2"
com.burbn.instagram,158,1714792860,1714793018,1714793018.377701,-18000,EB445137-D7F5-57EC-87DA-1DB460D64046,"iPhone13,2"
com.toyopagroup.picaboo,7,1714792843,1714792850,1714792850.0664492,-18000,EB445137-D7F5-57EC-87DA-1DB460D64046,"iPhone13,2"
com.leomehlig.today,21,1714791720,1714791741,1714791741.1919951,-18000,EB445137-D7F5-57EC-87DA-1DB460D64046,"iPhone13,2"
com.toyopagroup.picaboo,6,1714791701,1714791707,1714791707.914854,-18000,EB445137-D7F5-57EC-87DA-1DB460D64046,"iPhone13,2"
com.google.Chrome,269,1714788133,1714788402,1714788402.690534,-18000,,
com.google.Chrome,91,1714787890,1714787981,1714787982.104545,-18000,,
com.apple.MobileSMS,2,1714787888,1714787890,1714787890.549934,-18000,,
com.apple.MobileSMS,71,1714786182,1714786253,1714786253.423489,-18000,,
com.google.Chrome,146,1714786036,1714786182,1714786182.2272182,-18000,,
com.apple.MobileSMS,16,1714786020,1714786036,1714786036.16637,-18000,,
com.google.Chrome,1,1714786019,1714786020,1714786020.90116,-18000,,
com.apple.finder,1,1714786018,1714786019,1714786019.535816,-18000,,
com.google.Chrome,42,1714785976,1714786018,1714786018.90505,-18000,,
com.google.Chrome,697,1714785176,1714785873,1714785873.642328,-18000,,
com.google.Chrome,39,1714784975,1714785014,1714785015.13707,-18000,,
com.apple.MobileSMS,5,1714784970,1714784975,1714784975.349128,-18000,,
com.google.Chrome,205,1714784765,1714784970,1714784970.086855,-18000,,
com.apple.MobileSMS,2,1714784763,1714784765,1714784765.893568,-18000,,
com.google.Chrome,15,1714784748,1714784763,1714784763.52696,-18000,,
com.apple.MobileSMS,0,1714784748,1714784748,1714784748.894212,-18000,,
com.google.Chrome,13,1714784735,1714784748,1714784748.049076,-18000,,
com.apple.MobileSMS,2,1714784733,1714784735,1714784735.035294,-18000,,
com.google.Chrome,5,1714784728,1714784733,1714784733.960295,-18000,,
com.apple.MobileSMS,2,1714784726,1714784728,1714784728.450577,-18000,,
com.google.Chrome,4,1714784722,1714784726,1714784726.3384671,-18000,,
com.apple.MobileSMS,8,1714784714,1714784722,1714784722.652529,-18000,,
com.google.Chrome,2,1714784712,1714784714,1714784714.295223,-18000,,
com.apple.MobileSMS,9,1714784703,1714784712,1714784712.28053,-18000,,
com.google.Chrome,748,1714783955,1714784703,1714784703.744592,-18000,,
com.google.Chrome,779,1714783076,1714783855,1714783855.5475988,-18000,,
com.google.Chrome,1188,1714781869,1714783057,1714783057.9407868,-18000,,
com.google.Chrome,448,1714781348,1714781796,1714781796.151191,-18000,,
com.apple.Health,20,1714781304,1714781324,1714781325.014647,-18000,EB445137-D7F5-57EC-87DA-1DB460D64046,"iPhone13,2"
edu.illinois.rokwire.ios,2,1714781299,1714781301,1714781301.4712029,-18000,EB445137-D7F5-57EC-87DA-1DB460D64046,"iPhone13,2"
edu.illinois.rokwire.ios,3,1714781022,1714781025,1714781025.5847569,-18000,EB445137-D7F5-57EC-87DA-1DB460D64046,"iPhone13,2"
edu.illinois.rokwire.ios,6,1714780709,1714780715,1714780715.4494019,-18000,EB445137-D7F5-57EC-87DA-1DB460D64046,"iPhone13,2"
edu.illinois.rokwire.ios,8,1714780680,1714780688,1714780688.054255,-18000,EB445137-D7F5-57EC-87DA-1DB460D64046,"iPhone13,2"
com.google.Chrome,2,1714780666,1714780668,1714780668.708463,-18000,,
com.google.Chrome,4,1714780662,1714780666,1714780666.4377398,-18000,,
com.apple.finder,1,1714780661,1714780662,1714780662.3759952,-18000,,
com.apple.Notes,1,1714780660,1714780661,1714780661.9792662,-18000,,
com.leomehlig.today,72,1714780588,1714780660,1714780660.389044,-18000,,
com.apple.Notes,7,1714780581,1714780588,1714780589.036144,-18000,,
com.google.Chrome,158,1714780423,1714780581,1714780582.099288,-18000,,
com.leomehlig.today,25,1714780398,1714780423,1714780423.2823339,-18000,,
com.google.Chrome,954,1714779444,1714780398,1714780398.885847,-18000,,
com.leomehlig.today,31,1714779413,1714779444,1714779444.497209,-18000,,
com.google.Chrome,647,1714778766,1714779413,1714779413.822223,-18000,,
com.apple.Notes,4,1714778762,1714778766,1714778766.377744,-18000,,
com.google.Chrome,1316,1714777446,1714778762,1714778762.715955,-18000,,
com.apple.Notes,3,1714777443,1714777446,1714777446.120874,-18000,,
com.google.Chrome,183,1714777260,1714777443,1714777443.074095,-18000,,
com.apple.Notes,1,1714776615,1714776616,1714776616.676145,-18000,,
com.google.Chrome,2,1714776613,1714776615,1714776615.139293,-18000,,
com.apple.Notes,22,1714776591,1714776613,1714776613.642445,-18000,,
com.google.Chrome,1,1714776590,1714776591,1714776591.071728,-18000,,
com.apple.Notes,1,1714776589,1714776590,1714776590.373894,-18000,,
com.google.Chrome,197,1714776392,1714776589,1714776589.1258569,-18000,,
com.apple.Notes,1,1714776391,1714776392,1714776393.0096822,-18000,,
com.google.Chrome,6,1714776385,1714776391,1714776391.951757,-18000,,
com.apple.Notes,0,1714776374,1714776374,1714776374.683617,-18000,,
com.google.Chrome,1,1714776373,1714776374,1714776374.08922,-18000,,
com.apple.Notes,7,1714776366,1714776373,1714776373.738597,-18000,,
com.leomehlig.today,1,1714776365,1714776366,1714776366.9845471,-18000,,
com.google.Chrome,2,1714776363,1714776365,1714776365.29035,-18000,,
com.leomehlig.today,3,1714776360,1714776363,1714776364.032712,-18000,,
com.google.Chrome,1,1714776359,1714776360,1714776360.943511,-18000,,
com.leomehlig.today,5,1714776354,1714776359,1714776359.802103,-18000,,
com.google.Chrome,4,1714776350,1714776354,1714776354.620389,-18000,,
com.toyopagroup.picaboo,5,1714774842,1714774847,1714774848.120908,-18000,EB445137-D7F5-57EC-87DA-1DB460D64046,"iPhone13,2"
com.apple.AppStore,43,1714773532,1714773575,1714773575.824218,-18000,EB445137-D7F5-57EC-87DA-1DB460D64046,"iPhone13,2"
com.google.Chrome,194,1714773505,1714773699,1714773699.77627,-18000,,
com.leomehlig.today,9,1714773496,1714773505,1714773505.601128,-18000,,
com.google.Chrome,4,1714773492,1714773496,1714773496.326364,-18000,,
com.apple.finder,8,1714773484,1714773492,1714773492.0813432,-18000,,
com.apple.finder,1,1714773270,1714773271,1714773271.955323,-18000,,
com.apple.Photos,1,1714773269,1714773270,1714773270.710356,-18000,,
com.google.Chrome,1,1714773268,1714773269,1714773269.9538488,-18000,,
com.apple.MobileSMS,1,1714773267,1714773268,1714773268.614178,-18000,,
com.toyopagroup.picaboo,13,1714773243,1714773256,1714773256.190386,-18000,EB445137-D7F5-57EC-87DA-1DB460D64046,"iPhone13,2"
com.letterboxd.LetterboxdApp,96,1714773146,1714773242,1714773242.640171,-18000,EB445137-D7F5-57EC-87DA-1DB460D64046,"iPhone13,2"
com.google.Chrome,662,1714772605,1714773267,1714773267.651593,-18000,,
com.google.Chrome,300,1714772236,1714772536,1714772536.80007,-18000,,
com.google.Chrome,459,1714771666,1714772125,1714772125.4958649,-18000,,
com.google.Chrome,303,1714771192,1714771495,1714771495.550998,-18000,,
com.facebook.Facebook,125,1714771079,1714771204,1714771204.957597,-18000,EB445137-D7F5-57EC-87DA-1DB460D64046,"iPhone13,2"
com.google.Chrome,400,1714770691,1714771091,1714771091.223627,-18000,,
com.google.Chrome,301,1714770378,1714770679,1714770679.016932,-18000,,
com.toyopagroup.picaboo,6,1714769982,1714769988,1714769988.4510689,-18000,EB445137-D7F5-57EC-87DA-1DB460D64046,"iPhone13,2"
com.google.Chrome,670,1714769639,1714770309,1714770309.527569,-18000,,
com.apple.MobileSMS,19,1714769620,1714769639,1714769639.201092,-18000,,
com.google.Chrome,434,1714769186,1714769620,1714769620.545483,-18000,,
com.apple.MobileSMS,19,1714769167,1714769186,1714769186.68502,-18000,,
com.google.Chrome,12,1714769155,1714769167,1714769167.581476,-18000,,
com.apple.MobileSMS,6,1714769149,1714769155,1714769155.564783,-18000,,
com.google.Chrome,1,1714769148,1714769149,1714769149.385062,-18000,,
com.apple.MobileSMS,24,1714769124,1714769148,1714769148.897701,-18000,,
com.google.Chrome,14,1714769110,1714769124,1714769124.955775,-18000,,
com.apple.MobileSMS,8,1714769102,1714769110,1714769110.4849072,-18000,,
com.google.Chrome,12,1714769090,1714769102,1714769102.255557,-18000,,
com.apple.MobileSMS,2,1714769088,1714769090,1714769090.747057,-18000,,
com.google.Chrome,15,1714769073,1714769088,1714769088.569553,-18000,,
com.apple.MobileSMS,26,1714769047,1714769073,1714769073.448946,-18000,,
com.apple.finder,61,1714768986,1714769047,1714769047.439383,-18000,,
com.apple.camera,22,1714768920,1714768942,1714768942.516465,-18000,EB445137-D7F5-57EC-87DA-1DB460D64046,"iPhone13,2"
com.google.Chrome,481,1714768505,1714768986,1714768986.970969,-18000,,
com.apple.Photos,7,1714768498,1714768505,1714768505.920566,-18000,,
com.google.Chrome,189,1714768309,1714768498,1714768498.667323,-18000,,
com.apple.Photos,2,1714768307,1714768309,1714768309.952708,-18000,,
com.google.Chrome,421,1714767886,1714768307,1714768307.494565,-18000,,
com.apple.Photos,1,1714767885,1714767886,1714767887.002434,-18000,,
com.google.Chrome,1,1714767884,1714767885,1714767885.728205,-18000,,
com.apple.Photos,1,1714767883,1714767884,1714767884.9940438,-18000,,
com.google.Chrome,1,1714767882,1714767883,1714767883.610938,-18000,,
com.apple.Photos,3,1714767879,1714767882,1714767882.353035,-18000,,
com.google.Chrome,1,1714767878,1714767879,1714767879.8991609,-18000,,
com.apple.Photos,2,1714767876,1714767878,1714767878.260007,-18000,,
com.google.Chrome,4,1714767872,1714767876,1714767876.375235,-18000,,
com.apple.Photos,1,1714767871,1714767872,1714767872.263352,-18000,,
com.google.Chrome,4,1714767867,1714767871,1714767871.3573341,-18000,,
com.apple.Photos,2,1714767865,1714767867,1714767867.307147,-18000,,
com.google.Chrome,1,1714767864,1714767865,1714767865.9622478,-18000,,
com.apple.Photos,1,1714767863,1714767864,1714767864.734561,-18000,,
com.google.Chrome,1,1714767862,1714767863,1714767863.561837,-18000,,
com.apple.Photos,4,1714767858,1714767862,1714767862.526576,-18000,,
com.google.Chrome,2,1714767856,1714767858,1714767858.9392881,-18000,,
com.apple.Photos,1,1714767855,1714767856,1714767856.316091,-18000,,
com.google.Chrome,3,1714767852,1714767855,1714767855.038527,-18000,,
com.apple.Photos,0,1714767852,1714767852,1714767852.976018,-18000,,
com.google.Chrome,3,1714767849,1714767852,1714767852.145186,-18000,,
com.apple.Photos,1,1714767848,1714767849,1714767849.355881,-18000,,
com.google.Chrome,1,1714767847,1714767848,1714767848.444124,-18000,,
com.apple.Photos,29,1714767818,1714767847,1714767847.56757,-18000,,
com.google.Chrome,39,1714767779,1714767818,1714767818.483598,-18000,,
com.google.Chrome,441,1714767321,1714767762,1714767762.720526,-18000,,
com.apple.Preview,4,1714767317,1714767321,1714767321.60365,-18000,,
com.apple.Preview,40,1714767154,1714767194,1714767194.072812,-18000,,
com.apple.finder,5,1714767149,1714767154,1714767154.409806,-18000,,
com.google.Chrome,296,1714766853,1714767149,1714767149.99336,-18000,,
com.apple.mobileslideshow,30,1714766782,1714766812,1714766812.2191129,-18000,EB445137-D7F5-57EC-87DA-1DB460D64046,"iPhone13,2"
com.hammerandchisel.discord,62,1714766720,1714766782,1714766782.7895598,-18000,EB445137-D7F5-57EC-87DA-1DB460D64046,"iPhone13,2"
com.google.chrome.ios,48,1714766671,1714766719,1714766719.9143128,-18000,EB445137-D7F5-57EC-87DA-1DB460D64046,"iPhone13,2"
com.apple.mobileslideshow,30,1714766641,1714766671,1714766671.288275,-18000,EB445137-D7F5-57EC-87DA-1DB460D64046,"iPhone13,2"
com.apple.MobileSMS,8,1714766630,1714766638,1714766638.407817,-18000,EB445137-D7F5-57EC-87DA-1DB460D64046,"iPhone13,2"
com.google.chrome.ios,582,1714766047,1714766629,1714766629.833642,-18000,EB445137-D7F5-57EC-87DA-1DB460D64046,"iPhone13,2"
com.truebill.truebillnative,82,1714765736,1714765818,1714765818.599782,-18000,EB445137-D7F5-57EC-87DA-1DB460D64046,"iPhone13,2"
com.google.chrome.ios,70,1714765400,1714765470,1714765470.914153,-18000,EB445137-D7F5-57EC-87DA-1DB460D64046,"iPhone13,2"
com.facebook.Facebook,10,1714764760,1714764770,1714764771.393592,-18000,EB445137-D7F5-57EC-87DA-1DB460D64046,"iPhone13,2"
com.google.Gmail,13,1714764731,1714764744,1714764744.7564402,-18000,EB445137-D7F5-57EC-87DA-1DB460D64046,"iPhone13,2"
com.apple.news,7,1714764724,1714764731,1714764732.367574,-18000,EB445137-D7F5-57EC-87DA-1DB460D64046,"iPhone13,2"
com.google.Chrome,310,1714764288,1714764598,1714764598.886703,-18000,,
com.apple.finder,2,1714764286,1714764288,1714764288.765616,-18000,,
com.leomehlig.today,82,1714764204,1714764286,1714764286.3749042,-18000,,
com.google.Chrome,2,1714764202,1714764204,1714764204.792489,-18000,,
com.apple.news,6,1714763730,1714763736,1714763736.421348,-18000,EB445137-D7F5-57EC-87DA-1DB460D64046,"iPhone13,2"
com.apple.news,6,1714763710,1714763716,1714763716.6007009,-18000,EB445137-D7F5-57EC-87DA-1DB460D64046,"iPhone13,2"
com.apple.news,8,1714763701,1714763709,1714763709.5692081,-18000,EB445137-D7F5-57EC-87DA-1DB460D64046,"iPhone13,2"
com.apple.news,5,1714763100,1714763105,1714763105.253529,-18000,EB445137-D7F5-57EC-87DA-1DB460D64046,"iPhone13,2"
com.google.Chrome,57,1714762926,1714762983,1714762983.0191522,-18000,,
com.leomehlig.today,73,1714762853,1714762926,1714762926.362169,-18000,,
com.google.Chrome,1473,1714761380,1714762853,1714762853.0694351,-18000,,
com.leomehlig.today,6,1714761256,1714761262,1714761263.447348,-18000,,
com.apple.finder,4,1714761252,1714761256,1714761256.144644,-18000,,
com.apple.news,6,1714761221,1714761227,1714761227.4088511,-18000,EB445137-D7F5-57EC-87DA-1DB460D64046,"iPhone13,2"
com.apple.news,6,1714760583,1714760589,1714760589.4339008,-18000,EB445137-D7F5-57EC-87DA-1DB460D64046,"iPhone13,2"
com.apple.news,138,1714760099,1714760237,1714760237.7196488,-18000,EB445137-D7F5-57EC-87DA-1DB460D64046,"iPhone13,2"
com.apple.news,3,1714760096,1714760099,1714760099.7043262,-18000,EB445137-D7F5-57EC-87DA-1DB460D64046,"iPhone13,2"
com.microsoft.Office.Outlook,15,1714760071,1714760086,1714760086.550476,-18000,EB445137-D7F5-57EC-87DA-1DB460D64046,"iPhone13,2"
com.apple.MobileSMS,10,1714760060,1714760070,1714760070.217519,-18000,EB445137-D7F5-57EC-87DA-1DB460D64046,"iPhone13,2"
com.apple.MobileSMS,3,1714757284,1714757287,1714757287.2203898,-18000,EB445137-D7F5-57EC-87DA-1DB460D64046,"iPhone13,2"
com.toyopagroup.picaboo,4,1714757280,1714757284,1714757284.465868,-18000,EB445137-D7F5-57EC-87DA-1DB460D64046,"iPhone13,2"
com.apple.finder,7,1714757253,1714757260,1714757260.224757,-18000,,
com.apple.MobileSMS,15,1714757238,1714757253,1714757253.052246,-18000,,
com.apple.finder,3,1714757235,1714757238,1714757238.029653,-18000,,
com.apple.MobileSMS,3,1714757232,1714757235,1714757235.246377,-18000,,
com.apple.finder,16,1714757216,1714757232,1714757232.416366,-18000,,
com.leomehlig.today,11,1714757205,1714757216,1714757216.256829,-18000,,
com.toyopagroup.picaboo,9,1714757085,1714757094,1714757094.2380729,-18000,EB445137-D7F5-57EC-87DA-1DB460D64046,"iPhone13,2"
com.toyopagroup.picaboo,6,1714756696,1714756702,1714756702.438313,-18000,EB445137-D7F5-57EC-87DA-1DB460D64046,"iPhone13,2"
com.toyopagroup.picaboo,44,1714756622,1714756666,1714756666.564976,-18000,EB445137-D7F5-57EC-87DA-1DB460D64046,"iPhone13,2"
edu.illinois.rokwire.ios,37,1714756585,1714756622,1714756622.557653,-18000,EB445137-D7F5-57EC-87DA-1DB460D64046,"iPhone13,2"
com.toyopagroup.picaboo,3,1714756582,1714756585,1714756585.85431,-18000,EB445137-D7F5-57EC-87DA-1DB460D64046,"iPhone13,2"
com.toyopagroup.picaboo,21,1714756549,1714756570,1714756570.973703,-18000,EB445137-D7F5-57EC-87DA-1DB460D64046,"iPhone13,2"
com.apple.findmy,12,1714756040,1714756052,1714756052.911934,-18000,EB445137-D7F5-57EC-87DA-1DB460D64046,"iPhone13,2"
com.google.Maps,3,1714756037,1714756040,1714756040.654008,-18000,EB445137-D7F5-57EC-87DA-1DB460D64046,"iPhone13,2"
com.google.Maps,1,1714756031,1714756032,1714756032.990017,-18000,EB445137-D7F5-57EC-87DA-1DB460D64046,"iPhone13,2"
com.google.Maps,6,1714755813,1714755819,1714755819.8446689,-18000,EB445137-D7F5-57EC-87DA-1DB460D64046,"iPhone13,2"
com.google.Maps,1,1714755811,1714755812,1714755812.9957771,-18000,EB445137-D7F5-57EC-87DA-1DB460D64046,"iPhone13,2"
com.apple.InCallService,159,1714755652,1714755811,1714755811.886963,-18000,EB445137-D7F5-57EC-87DA-1DB460D64046,"iPhone13,2"
com.google.Maps,104,1714755548,1714755652,1714755652.1659222,-18000,EB445137-D7F5-57EC-87DA-1DB460D64046,"iPhone13,2"
com.apple.InCallService,17,1714755531,1714755548,1714755549.245627,-18000,EB445137-D7F5-57EC-87DA-1DB460D64046,"iPhone13,2"
com.google.Maps,24,1714755507,1714755531,1714755531.741323,-18000,EB445137-D7F5-57EC-87DA-1DB460D64046,"iPhone13,2"
com.apple.InCallService,171,1714755335,1714755506,1714755506.257016,-18000,EB445137-D7F5-57EC-87DA-1DB460D64046,"iPhone13,2"
com.apple.weather,14,1714755321,1714755335,1714755335.618854,-18000,EB445137-D7F5-57EC-87DA-1DB460D64046,"iPhone13,2"
com.apple.InCallService,56,1714755265,1714755321,1714755321.72385,-18000,EB445137-D7F5-57EC-87DA-1DB460D64046,"iPhone13,2"
com.apple.MobileSMS,142,1714755123,1714755265,1714755265.191287,-18000,EB445137-D7F5-57EC-87DA-1DB460D64046,"iPhone13,2"
com.apple.InCallService,2,1714755121,1714755123,1714755124.502996,-18000,EB445137-D7F5-57EC-87DA-1DB460D64046,"iPhone13,2"
com.apple.InCallService,0,1714754465,1714754465,1714754466.408704,-18000,EB445137-D7F5-57EC-87DA-1DB460D64046,"iPhone13,2"
com.apple.MobileSMS,11,1714754454,1714754465,1714754466.3768039,-18000,EB445137-D7F5-57EC-87DA-1DB460D64046,"iPhone13,2"
com.apple.findmy,13,1714754441,1714754454,1714754456.325962,-18000,EB445137-D7F5-57EC-87DA-1DB460D64046,"iPhone13,2"
com.instructure.icanvas,33,1714754407,1714754440,1714754441.0096421,-18000,EB445137-D7F5-57EC-87DA-1DB460D64046,"iPhone13,2"
edu.illinois.rokwire.ios,15,1714754392,1714754407,1714754408.053277,-18000,EB445137-D7F5-57EC-87DA-1DB460D64046,"iPhone13,2"
com.apple.camera,1,1714754342,1714754343,1714754343.42715,-18000,EB445137-D7F5-57EC-87DA-1DB460D64046,"iPhone13,2"
edu.illinois.rokwire.ios,9,1714754340,1714754349,1714754349.43919,-18000,EB445137-D7F5-57EC-87DA-1DB460D64046,"iPhone13,2"
edu.illinois.rokwire.ios,6,1714754326,1714754332,1714754332.484376,-18000,EB445137-D7F5-57EC-87DA-1DB460D64046,"iPhone13,2"
com.leomehlig.today,103,1714754192,1714754295,1714754295.895959,-18000,,
com.google.Chrome,861,1714753331,1714754192,1714754192.472333,-18000,,
com.apple.Notes,3,1714753328,1714753331,1714753331.804796,-18000,,
com.google.Chrome,3,1714753325,1714753328,1714753328.380595,-18000,,
com.leomehlig.today,2,1714753323,1714753325,1714753325.170207,-18000,,
com.google.Chrome,317,1714753006,1714753323,1714753324.015645,-18000,,
com.apple.Preview,67,1714752939,1714753006,1714753006.066028,-18000,,
com.google.Chrome,46,1714752893,1714752939,1714752939.745296,-18000,,
com.leomehlig.today,1,1714752892,1714752893,1714752893.4959831,-18000,,
com.google.Chrome,2,1714752890,1714752892,1714752892.226502,-18000,,
com.apple.Notes,2,1714752888,1714752890,1714752890.974572,-18000,,
com.apple.Preview,128,1714752760,1714752888,1714752888.406726,-18000,,
com.apple.Notes,1,1714752759,1714752760,1714752760.2531,-18000,,
com.google.Chrome,355,1714752404,1714752759,1714752759.585486,-18000,,
com.leomehlig.today,4,1714752400,1714752404,1714752404.15336,-18000,,
com.google.Chrome,157,1714752243,1714752400,1714752400.791596,-18000,,
com.apple.Preview,95,1714752148,1714752243,1714752243.754854,-18000,,
com.google.Chrome,4,1714752144,1714752148,1714752148.209299,-18000,,
com.apple.Preview,163,1714751981,1714752144,1714752144.671536,-18000,,
com.google.Chrome,287,1714751694,1714751981,1714751982.023875,-18000,,
com.leomehlig.today,3,1714751691,1714751694,1714751694.4472961,-18000,,
com.google.Chrome,5,1714751686,1714751691,1714751691.96615,-18000,,
com.hnc.Discord,34,1714751652,1714751686,1714751686.522561,-18000,,
com.google.Chrome,20,1714751632,1714751652,1714751652.71286,-18000,,
com.hnc.Discord,22,1714751610,1714751632,1714751632.384027,-18000,,
com.leomehlig.today,1,1714751609,1714751610,1714751610.755811,-18000,,
com.hnc.Discord,7,1714751602,1714751609,1714751609.19501,-18000,,
com.google.Chrome,795,1714750807,1714751602,1714751602.399862,-18000,,
com.apple.Notes,2,1714750805,1714750807,1714750807.967585,-18000,,
com.google.Chrome,2,1714750803,1714750805,1714750805.781094,-18000,,
com.apple.Notes,2,1714750801,1714750803,1714750803.174911,-18000,,
com.google.Chrome,1011,1714749790,1714750801,1714750801.2706552,-18000,,
com.apple.Notes,26,1714749764,1714749790,1714749790.066999,-18000,,
com.google.Chrome,138,1714749626,1714749764,1714749764.8674169,-18000,,
com.apple.Notes,3,1714749623,1714749626,1714749626.325002,-18000,,
com.apple.Preview,1,1714749622,1714749623,1714749623.6439152,-18000,,
com.google.Chrome,168,1714749454,1714749622,1714749622.1070309,-18000,,
com.apple.Preview,142,1714749312,1714749454,1714749454.5559149,-18000,,
com.google.Chrome,185,1714749127,1714749312,1714749312.33269,-18000,,
com.apple.Preview,157,1714748970,1714749127,1714749127.6584759,-18000,,
com.google.Chrome,194,1714748776,1714748970,1714748970.809978,-18000,,
com.leomehlig.today,2,1714748774,1714748776,1714748776.640471,-18000,,
com.google.Chrome,601,1714748173,1714748774,1714748774.925259,-18000,,
com.apple.Notes,1,1714748172,1714748173,1714748173.961286,-18000,,
com.google.Chrome,8,1714748164,1714748172,1714748172.4718761,-18000,,
com.apple.Preview,362,1714747802,1714748164,1714748164.517744,-18000,,
com.apple.finder,5,1714747797,1714747802,1714747802.871964,-18000,,
com.google.Chrome,10,1714747787,1714747797,1714747797.886225,-18000,,
com.apple.finder,2,1714747785,1714747787,1714747787.9928188,-18000,,
com.google.Chrome,664,1714747121,1714747785,1714747785.846652,-18000,,
com.apple.Notes,8,1714747113,1714747121,1714747121.161024,-18000,,
com.google.Chrome,5,1714747108,1714747113,1714747113.7658958,-18000,,
com.apple.Notes,9,1714747088,1714747097,1714747097.537848,-18000,,
com.apple.Preview,0,1714747088,1714747088,1714747088.83469,-18000,,
com.leomehlig.today,2,1714747086,1714747088,1714747088.1149669,-18000,,
com.apple.Notes,9,1714747077,1714747086,1714747086.133957,-18000,,
com.leomehlig.today,33,1714747044,1714747077,1714747077.899117,-18000,,
com.apple.Preview,24,1714747020,1714747044,1714747044.287074,-18000,,
com.leomehlig.today,3,1714747017,1714747020,1714747020.10878,-18000,,
com.google.Chrome,7,1714747010,1714747017,1714747017.9969559,-18000,,
edu.illinois.rokwire.ios,22,1714746216,1714746238,1714746239.044286,-18000,EB445137-D7F5-57EC-87DA-1DB460D64046,"iPhone13,2"
com.microsoft.Office.Outlook,10,1714746186,1714746196,1714746196.536227,-18000,EB445137-D7F5-57EC-87DA-1DB460D64046,"iPhone13,2"
com.apple.MobileSMS,3,1714746181,1714746184,1714746184.797693,-18000,EB445137-D7F5-57EC-87DA-1DB460D64046,"iPhone13,2"
com.apple.Health,12,1714746167,1714746179,1714746180.046702,-18000,EB445137-D7F5-57EC-87DA-1DB460D64046,"iPhone13,2"
edu.illinois.rokwire.ios,2,1714746165,1714746167,1714746167.940062,-18000,EB445137-D7F5-57EC-87DA-1DB460D64046,"iPhone13,2"
com.google.Chrome,187,1714746135,1714746322,1714746322.526991,-18000,,
com.apple.finder,15,1714746120,1714746135,1714746135.567522,-18000,,
com.google.Chrome,114,1714746006,1714746120,1714746120.223376,-18000,,
com.apple.finder,2,1714745993,1714745995,1714745995.1615062,-18000,,
com.google.Chrome,6,1714745979,1714745985,1714745994.828611,-18000,,
com.apple.finder,7,1714745972,1714745979,1714745992.8691921,-18000,,
edu.illinois.rokwire.ios,15,1714745922,1714745937,1714745937.889347,-18000,EB445137-D7F5-57EC-87DA-1DB460D64046,"iPhone13,2"
edu.illinois.rokwire.ios,104,1714745808,1714745912,1714745912.172789,-18000,EB445137-D7F5-57EC-87DA-1DB460D64046,"iPhone13,2"
com.apple.weather,2,1714745806,1714745808,1714745808.3013492,-18000,EB445137-D7F5-57EC-87DA-1DB460D64046,"iPhone13,2"
com.apple.weather,9,1714745554,1714745563,1714745563.334804,-18000,EB445137-D7F5-57EC-87DA-1DB460D64046,"iPhone13,2"
com.apple.Health,0,1714745356,1714745356,1714745356.7641258,-18000,EB445137-D7F5-57EC-87DA-1DB460D64046,"iPhone13,2"
com.apple.Health,2,1714745353,1714745355,1714745355.81549,-18000,EB445137-D7F5-57EC-87DA-1DB460D64046,"iPhone13,2"
com.apple.Health,9,1714743442,1714743451,1714743451.420186,-18000,EB445137-D7F5-57EC-87DA-1DB460D64046,"iPhone13,2"
com.apple.Health,5,1714743434,1714743439,1714743439.290642,-18000,EB445137-D7F5-57EC-87DA-1DB460D64046,"iPhone13,2"
com.apple.Health,6,1714743428,1714743434,1714743434.304597,-18000,EB445137-D7F5-57EC-87DA-1DB460D64046,"iPhone13,2"
com.apple.Health,8,1714742262,1714742270,1714742270.326445,-18000,EB445137-D7F5-57EC-87DA-1DB460D64046,"iPhone13,2"
com.apple.Health,18,1714741842,1714741860,1714741860.507111,-18000,EB445137-D7F5-57EC-87DA-1DB460D64046,"iPhone13,2"
com.apple.podcasts,4,1714741835,1714741839,1714741839.195086,-18000,EB445137-D7F5-57EC-87DA-1DB460D64046,"iPhone13,2"
com.apple.podcasts,67,1714740227,1714740294,1714740294.048454,-18000,EB445137-D7F5-57EC-87DA-1DB460D64046,"iPhone13,2"
com.apple.podcasts,8,1714740212,1714740220,1714740220.08806,-18000,EB445137-D7F5-57EC-87DA-1DB460D64046,"iPhone13,2"
com.apple.podcasts,9,1714740202,1714740211,1714740211.232564,-18000,EB445137-D7F5-57EC-87DA-1DB460D64046,"iPhone13,2"
com.apple.podcasts,11,1714740111,1714740122,1714740122.8920379,-18000,EB445137-D7F5-57EC-87DA-1DB460D64046,"iPhone13,2"
com.apple.weather,4,1714740088,1714740092,1714740093.072843,-18000,EB445137-D7F5-57EC-87DA-1DB460D64046,"iPhone13,2"
com.apple.weather,6,1714739855,1714739861,1714739861.1795468,-18000,EB445137-D7F5-57EC-87DA-1DB460D64046,"iPhone13,2"
com.apple.weather,6,1714739848,1714739854,1714739854.739778,-18000,EB445137-D7F5-57EC-87DA-1DB460D64046,"iPhone13,2"
com.thestorygraph.thestorygraph,5,1714620600,1714620605,1714620605.330492,-18000,EB445137-D7F5-57EC-87DA-1DB460D64046,"iPhone13,2"
com.thestorygraph.thestorygraph,18,1714620582,1714620600,1714620600.140244,-18000,EB445137-D7F5-57EC-87DA-1DB460D64046,"iPhone13,2"
com.toyopagroup.picaboo,20,1714614916,1714614936,1714614936.215594,-18000,EB445137-D7F5-57EC-87DA-1DB460D64046,"iPhone13,2"
edu.illinois.rokwire.ios,4,1714614906,1714614910,1714614910.668534,-18000,EB445137-D7F5-57EC-87DA-1DB460D64046,"iPhone13,2"
edu.illinois.rokwire.ios,3,1714613273,1714613276,1714613276.1724272,-18000,EB445137-D7F5-57EC-87DA-1DB460D64046,"iPhone13,2"
edu.illinois.rokwire.ios,6,1714612897,1714612903,1714612903.6964269,-18000,EB445137-D7F5-57EC-87DA-1DB460D64046,"iPhone13,2"
edu.illinois.rokwire.ios,23,1714612872,1714612895,1714612896.174602,-18000,EB445137-D7F5-57EC-87DA-1DB460D64046,"iPhone13,2"
com.hammerandchisel.discord,11,1714611526,1714611537,1714611537.0208101,-18000,EB445137-D7F5-57EC-87DA-1DB460D64046,"iPhone13,2"
com.microsoft.Office.Outlook,11,1714611461,1714611472,1714611472.4526649,-18000,EB445137-D7F5-57EC-87DA-1DB460D64046,"iPhone13,2"
com.microsoft.Office.Outlook,2,1714611354,1714611356,1714611356.2177129,-18000,EB445137-D7F5-57EC-87DA-1DB460D64046,"iPhone13,2"
com.microsoft.Office.Outlook,12,1714611338,1714611350,1714611350.978482,-18000,EB445137-D7F5-57EC-87DA-1DB460D64046,"iPhone13,2"
com.microsoft.Office.Outlook,3,1714610409,1714610412,1714610412.7120938,-18000,EB445137-D7F5-57EC-87DA-1DB460D64046,"iPhone13,2"
com.apple.MobileSMS,5,1714610400,1714610405,1714610405.5357661,-18000,EB445137-D7F5-57EC-87DA-1DB460D64046,"iPhone13,2"
com.apple.MobileSMS,14,1714608780,1714608794,1714608794.146484,-18000,EB445137-D7F5-57EC-87DA-1DB460D64046,"iPhone13,2"
com.intsig.CamScannerLite,247,1714606399,1714606646,1714606646.364068,-18000,EB445137-D7F5-57EC-87DA-1DB460D64046,"iPhone13,2"
com.intsig.CamScannerLite,1,1714606389,1714606390,1714606390.873198,-18000,EB445137-D7F5-57EC-87DA-1DB460D64046,"iPhone13,2"
com.microsoft.Office.Outlook,9,1714606376,1714606385,1714606385.604896,-18000,EB445137-D7F5-57EC-87DA-1DB460D64046,"iPhone13,2"
com.apple.MobileSMS,2,1714606374,1714606376,1714606377.055469,-18000,EB445137-D7F5-57EC-87DA-1DB460D64046,"iPhone13,2"
com.apple.MobileSMS,7,1714598922,1714598929,1714598929.392408,-18000,EB445137-D7F5-57EC-87DA-1DB460D64046,"iPhone13,2"
com.apple.MobileSMS,6,1714598906,1714598912,1714598912.850204,-18000,EB445137-D7F5-57EC-87DA-1DB460D64046,"iPhone13,2"
com.apple.MobileSMS,18,1714598870,1714598888,1714598888.24328,-18000,EB445137-D7F5-57EC-87DA-1DB460D64046,"iPhone13,2"
com.apple.MobileSMS,2,1714598840,1714598842,1714598842.767643,-18000,EB445137-D7F5-57EC-87DA-1DB460D64046,"iPhone13,2"
com.apple.MobileSMS,7,1714598832,1714598839,1714598839.4760509,-18000,EB445137-D7F5-57EC-87DA-1DB460D64046,"iPhone13,2"
com.apple.news,140,1714598380,1714598520,1714598520.325088,-18000,EB445137-D7F5-57EC-87DA-1DB460D64046,"iPhone13,2"
com.apple.Music,4,1714598363,1714598367,1714598367.496325,-18000,EB445137-D7F5-57EC-87DA-1DB460D64046,"iPhone13,2"
com.apple.Music,5,1714597959,1714597964,1714597964.9283261,-18000,EB445137-D7F5-57EC-87DA-1DB460D64046,"iPhone13,2"
com.apple.Music,18,1714597364,1714597382,1714597382.81496,-18000,EB445137-D7F5-57EC-87DA-1DB460D64046,"iPhone13,2"
com.microsoft.Office.Outlook,7,1714597356,1714597363,1714597363.95246,-18000,EB445137-D7F5-57EC-87DA-1DB460D64046,"iPhone13,2"
com.apple.mobiletimer,4,1714597352,1714597356,1714597356.8528972,-18000,EB445137-D7F5-57EC-87DA-1DB460D64046,"iPhone13,2"
com.apple.mobiletimer,2,1714597234,1714597236,1714597236.518194,-18000,EB445137-D7F5-57EC-87DA-1DB460D64046,"iPhone13,2"
com.apple.mobiletimer,14,1714595073,1714595087,1714595087.563515,-18000,EB445137-D7F5-57EC-87DA-1DB460D64046,"iPhone13,2"
com.apple.news,149,1714588220,1714588369,1714588369.524364,-18000,EB445137-D7F5-57EC-87DA-1DB460D64046,"iPhone13,2"
com.burbn.instagram,364,1714587707,1714588071,1714588071.529261,-18000,EB445137-D7F5-57EC-87DA-1DB460D64046,"iPhone13,2"
com.hammerandchisel.discord,15,1714587669,1714587684,1714587684.6903028,-18000,EB445137-D7F5-57EC-87DA-1DB460D64046,"iPhone13,2"
com.google.ios.youtube,90,1714587193,1714587283,1714587283.3450909,-18000,EB445137-D7F5-57EC-87DA-1DB460D64046,"iPhone13,2"
com.apple.weather,17,1714587146,1714587163,1714587163.375472,-18000,EB445137-D7F5-57EC-87DA-1DB460D64046,"iPhone13,2"
com.instructure.icanvas,57,1714586904,1714586961,1714586961.9990458,-18000,EB445137-D7F5-57EC-87DA-1DB460D64046,"iPhone13,2"
com.letterboxd.LetterboxdApp,34,1714586840,1714586874,1714586874.49044,-18000,EB445137-D7F5-57EC-87DA-1DB460D64046,"iPhone13,2"
com.apple.news,287,1714586386,1714586673,1714586673.599508,-18000,EB445137-D7F5-57EC-87DA-1DB460D64046,"iPhone13,2"
com.facebook.Facebook,84,1714586029,1714586113,1714586113.717346,-18000,EB445137-D7F5-57EC-87DA-1DB460D64046,"iPhone13,2"
com.google.chrome.ios,19,1714585992,1714586011,1714586011.721941,-18000,EB445137-D7F5-57EC-87DA-1DB460D64046,"iPhone13,2"
edu.illinois.rokwire.ios,14,1714585513,1714585527,1714585527.371286,-18000,EB445137-D7F5-57EC-87DA-1DB460D64046,"iPhone13,2"
edu.illinois.rokwire.ios,8,1714585414,1714585422,1714585422.369419,-18000,EB445137-D7F5-57EC-87DA-1DB460D64046,"iPhone13,2"
edu.illinois.rokwire.ios,3,1714585404,1714585407,1714585407.948636,-18000,EB445137-D7F5-57EC-87DA-1DB460D64046,"iPhone13,2"
edu.illinois.rokwire.ios,35,1714584419,1714584454,1714584454.133657,-18000,EB445137-D7F5-57EC-87DA-1DB460D64046,"iPhone13,2"
com.apple.MobileSMS,62,1714584337,1714584399,1714584399.9669251,-18000,EB445137-D7F5-57EC-87DA-1DB460D64046,"iPhone13,2"
com.apple.MobileSMS,4,1714584199,1714584203,1714584203.12467,-18000,EB445137-D7F5-57EC-87DA-1DB460D64046,"iPhone13,2"
com.apple.MobileSMS,16,1714584179,1714584195,1714584195.614497,-18000,EB445137-D7F5-57EC-87DA-1DB460D64046,"iPhone13,2"
com.apple.MobileSMS,2,1714583420,1714583422,1714583422.41768,-18000,EB445137-D7F5-57EC-87DA-1DB460D64046,"iPhone13,2"
com.apple.InCallService,553,1714582867,1714583420,1714583420.287503,-18000,EB445137-D7F5-57EC-87DA-1DB460D64046,"iPhone13,2"
com.apple.InCallService,2,1714582415,1714582417,1714582417.079228,-18000,EB445137-D7F5-57EC-87DA-1DB460D64046,"iPhone13,2"
com.apple.MobileSMS,14,1714582401,1714582415,1714582415.85005,-18000,EB445137-D7F5-57EC-87DA-1DB460D64046,"iPhone13,2"
com.apple.findmy,12,1714582389,1714582401,1714582401.4907122,-18000,EB445137-D7F5-57EC-87DA-1DB460D64046,"iPhone13,2"
com.apple.findmy,8,1714582237,1714582245,1714582245.018633,-18000,EB445137-D7F5-57EC-87DA-1DB460D64046,"iPhone13,2"
com.truebill.truebillnative,5,1714582024,1714582029,1714582029.489155,-18000,EB445137-D7F5-57EC-87DA-1DB460D64046,"iPhone13,2"
com.hammerandchisel.discord,3,1714582002,1714582005,1714582005.179786,-18000,EB445137-D7F5-57EC-87DA-1DB460D64046,"iPhone13,2"
com.hammerandchisel.discord,47,1714581317,1714581364,1714581364.397701,-18000,EB445137-D7F5-57EC-87DA-1DB460D64046,"iPhone13,2"
com.apple.Health,9,1714581286,1714581295,1714581295.2892761,-18000,EB445137-D7F5-57EC-87DA-1DB460D64046,"iPhone13,2"
com.apple.Health,29,1714578826,1714578855,1714578855.0991611,-18000,EB445137-D7F5-57EC-87DA-1DB460D64046,"iPhone13,2"
com.google.chrome.ios,3,1714578822,1714578825,1714578825.585906,-18000,EB445137-D7F5-57EC-87DA-1DB460D64046,"iPhone13,2"
com.google.chrome.ios,10,1714578423,1714578433,1714578433.220189,-18000,EB445137-D7F5-57EC-87DA-1DB460D64046,"iPhone13,2"
com.apple.news,86,1714577374,1714577460,1714577460.702526,-18000,EB445137-D7F5-57EC-87DA-1DB460D64046,"iPhone13,2"
edu.illinois.rokwire.ios,4,1714577356,1714577360,1714577360.476325,-18000,EB445137-D7F5-57EC-87DA-1DB460D64046,"iPhone13,2"
edu.illinois.rokwire.ios,84,1714577248,1714577332,1714577332.499436,-18000,EB445137-D7F5-57EC-87DA-1DB460D64046,"iPhone13,2"
com.apple.findmy,12,1714575472,1714575484,1714575484.5805578,-18000,EB445137-D7F5-57EC-87DA-1DB460D64046,"iPhone13,2"
com.google.chrome.ios,7,1714575457,1714575464,1714575464.328662,-18000,EB445137-D7F5-57EC-87DA-1DB460D64046,"iPhone13,2"
com.google.chrome.ios,3,1714573310,1714573313,1714573313.167592,-18000,EB445137-D7F5-57EC-87DA-1DB460D64046,"iPhone13,2"
com.google.chrome.ios,6,1714572652,1714572658,1714572658.7971702,-18000,EB445137-D7F5-57EC-87DA-1DB460D64046,"iPhone13,2"
com.google.chrome.ios,6,1714572634,1714572640,1714572640.666744,-18000,EB445137-D7F5-57EC-87DA-1DB460D64046,"iPhone13,2"
com.google.chrome.ios,391,1714572234,1714572625,1714572625.7592502,-18000,EB445137-D7F5-57EC-87DA-1DB460D64046,"iPhone13,2"
com.google.chrome.ios,6,1714572043,1714572049,1714572049.16613,-18000,EB445137-D7F5-57EC-87DA-1DB460D64046,"iPhone13,2"
com.google.chrome.ios,109,1714571925,1714572034,1714572036.003998,-18000,EB445137-D7F5-57EC-87DA-1DB460D64046,"iPhone13,2"
com.apple.weather,3,1714571889,1714571892,1714571892.0689611,-18000,EB445137-D7F5-57EC-87DA-1DB460D64046,"iPhone13,2"
com.apple.weather,10,1714571593,1714571603,1714571603.577108,-18000,EB445137-D7F5-57EC-87DA-1DB460D64046,"iPhone13,2"
com.apple.weather,5,1714571420,1714571425,1714571425.5627599,-18000,EB445137-D7F5-57EC-87DA-1DB460D64046,"iPhone13,2"
com.apple.MobileSMS,1,1714571419,1714571420,1714571420.6382709,-18000,EB445137-D7F5-57EC-87DA-1DB460D64046,"iPhone13,2"
com.hammerandchisel.discord,16,1714571329,1714571345,1714571345.08921,-18000,EB445137-D7F5-57EC-87DA-1DB460D64046,"iPhone13,2"
com.microsoft.Office.Outlook,63,1714571251,1714571314,1714571314.624336,-18000,EB445137-D7F5-57EC-87DA-1DB460D64046,"iPhone13,2"
com.apple.Health,65,1714571186,1714571251,1714571251.925138,-18000,EB445137-D7F5-57EC-87DA-1DB460D64046,"iPhone13,2"
com.moodle.moodlemobile,39,1714570286,1714570325,1714570325.01863,-18000,EB445137-D7F5-57EC-87DA-1DB460D64046,"iPhone13,2"
com.apple.findmy,9,1714518274,1714518283,1714518283.269281,-18000,EB445137-D7F5-57EC-87DA-1DB460D64046,"iPhone13,2"
edu.illinois.rokwire.ios,2,1714518271,1714518273,1714518273.770282,-18000,EB445137-D7F5-57EC-87DA-1DB460D64046,"iPhone13,2"
edu.illinois.rokwire.ios,16,1714518247,1714518263,1714518263.6794,-18000,EB445137-D7F5-57EC-87DA-1DB460D64046,"iPhone13,2"
edu.illinois.rokwire.ios,16,1714516046,1714516062,1714516062.042773,-18000,EB445137-D7F5-57EC-87DA-1DB460D64046,"iPhone13,2"
com.microsoft.Office.Outlook,3,1714516043,1714516046,1714516046.446033,-18000,EB445137-D7F5-57EC-87DA-1DB460D64046,"iPhone13,2"
com.microsoft.Office.Outlook,23,1714515946,1714515969,1714515969.081387,-18000,EB445137-D7F5-57EC-87DA-1DB460D64046,"iPhone13,2"
com.hulu.plus,2,1714515944,1714515946,1714515947.01862,-18000,EB445137-D7F5-57EC-87DA-1DB460D64046,"iPhone13,2"
com.hulu.plus,6,1714515920,1714515926,1714515926.561986,-18000,EB445137-D7F5-57EC-87DA-1DB460D64046,"iPhone13,2"
com.hulu.plus,1,1714515916,1714515917,1714515917.964706,-18000,EB445137-D7F5-57EC-87DA-1DB460D64046,"iPhone13,2"
com.hulu.plus,2,1714515911,1714515913,1714515913.126042,-18000,EB445137-D7F5-57EC-87DA-1DB460D64046,"iPhone13,2"
com.hulu.plus,2,1714515894,1714515896,1714515896.43366,-18000,EB445137-D7F5-57EC-87DA-1DB460D64046,"iPhone13,2"
com.hulu.plus,1132,1714514756,1714515888,1714515888.8653212,-18000,EB445137-D7F5-57EC-87DA-1DB460D64046,"iPhone13,2"
com.apple.MobileSMS,7,1714514723,1714514730,1714514730.455951,-18000,EB445137-D7F5-57EC-87DA-1DB460D64046,"iPhone13,2"
com.thestorygraph.thestorygraph,19,1714514530,1714514549,1714514549.764658,-18000,EB445137-D7F5-57EC-87DA-1DB460D64046,"iPhone13,2"
com.apple.calculator,6,1714514522,1714514528,1714514528.578053,-18000,EB445137-D7F5-57EC-87DA-1DB460D64046,"iPhone13,2"
com.apple.camera,5,1714509127,1714509132,1714509132.333349,-18000,EB445137-D7F5-57EC-87DA-1DB460D64046,"iPhone13,2"
com.apple.camera,7,1714508287,1714508294,1714508294.473664,-18000,EB445137-D7F5-57EC-87DA-1DB460D64046,"iPhone13,2"
com.apple.podcasts,20,1714508259,1714508279,1714508279.653961,-18000,EB445137-D7F5-57EC-87DA-1DB460D64046,"iPhone13,2"
com.apple.MobileSMS,3,1714508253,1714508256,1714508256.9975228,-18000,EB445137-D7F5-57EC-87DA-1DB460D64046,"iPhone13,2"
edu.illinois.rokwire.ios,4,1714508249,1714508253,1714508253.616273,-18000,EB445137-D7F5-57EC-87DA-1DB460D64046,"iPhone13,2"
edu.illinois.rokwire.ios,35,1714507218,1714507253,1714507253.946371,-18000,EB445137-D7F5-57EC-87DA-1DB460D64046,"iPhone13,2"
com.microsoft.Office.Outlook,4,1714506820,1714506824,1714506824.774118,-18000,EB445137-D7F5-57EC-87DA-1DB460D64046,"iPhone13,2"
com.toyopagroup.picaboo,78,1714506740,1714506818,1714506818.854233,-18000,EB445137-D7F5-57EC-87DA-1DB460D64046,"iPhone13,2"
com.toyopagroup.picaboo,14,1714503869,1714503883,1714503883.7793431,-18000,EB445137-D7F5-57EC-87DA-1DB460D64046,"iPhone13,2"
com.toyopagroup.picaboo,12,1714503470,1714503482,1714503482.676027,-18000,EB445137-D7F5-57EC-87DA-1DB460D64046,"iPhone13,2"
com.apple.news,111,1714501865,1714501976,1714501976.5794802,-18000,EB445137-D7F5-57EC-87DA-1DB460D64046,"iPhone13,2"
com.hammerandchisel.discord,136,1714501578,1714501714,1714501714.2357159,-18000,EB445137-D7F5-57EC-87DA-1DB460D64046,"iPhone13,2"
com.microsoft.Office.Outlook,16,1714501560,1714501576,1714501576.328621,-18000,EB445137-D7F5-57EC-87DA-1DB460D64046,"iPhone13,2"
com.microsoft.Office.Outlook,4,1714501554,1714501558,1714501558.407201,-18000,EB445137-D7F5-57EC-87DA-1DB460D64046,"iPhone13,2"
com.instructure.icanvas,9,1714501474,1714501483,1714501483.312265,-18000,EB445137-D7F5-57EC-87DA-1DB460D64046,"iPhone13,2"
com.instructure.icanvas,6,1714501436,1714501442,1714501442.308017,-18000,EB445137-D7F5-57EC-87DA-1DB460D64046,"iPhone13,2"
com.instructure.icanvas,38,1714500871,1714500909,1714500909.052717,-18000,EB445137-D7F5-57EC-87DA-1DB460D64046,"iPhone13,2"
com.apple.weather,6,1714500865,1714500871,1714500871.780354,-18000,EB445137-D7F5-57EC-87DA-1DB460D64046,"iPhone13,2"
com.apple.weather,32,1714498706,1714498738,1714498738.976912,-18000,EB445137-D7F5-57EC-87DA-1DB460D64046,"iPhone13,2"
com.apple.camera,0,1714498655,1714498655,1714498655.3780231,-18000,EB445137-D7F5-57EC-87DA-1DB460D64046,"iPhone13,2"
com.apple.weather,29,1714498654,1714498683,1714498683.521089,-18000,EB445137-D7F5-57EC-87DA-1DB460D64046,"iPhone13,2"
com.apple.weather,11,1714498567,1714498578,1714498578.840111,-18000,EB445137-D7F5-57EC-87DA-1DB460D64046,"iPhone13,2"
com.microsoft.Office.Outlook,3,1714498564,1714498567,1714498567.087589,-18000,EB445137-D7F5-57EC-87DA-1DB460D64046,"iPhone13,2"
com.microsoft.Office.Outlook,6,1714497887,1714497893,1714497893.94551,-18000,EB445137-D7F5-57EC-87DA-1DB460D64046,"iPhone13,2"
com.microsoft.Office.Outlook,20,1714497862,1714497882,1714497882.1461868,-18000,EB445137-D7F5-57EC-87DA-1DB460D64046,"iPhone13,2"
com.microsoft.Office.Outlook,72,1714497646,1714497718,1714497718.2668471,-18000,EB445137-D7F5-57EC-87DA-1DB460D64046,"iPhone13,2"
com.apple.camera,1,1714496569,1714496570,1714496570.2217631,-18000,EB445137-D7F5-57EC-87DA-1DB460D64046,"iPhone13,2"
edu.illinois.rokwire.ios,3,1714496390,1714496393,1714496395.1578522,-18000,EB445137-D7F5-57EC-87DA-1DB460D64046,"iPhone13,2"
edu.illinois.rokwire.ios,4,1714496259,1714496263,1714496263.49264,-18000,EB445137-D7F5-57EC-87DA-1DB460D64046,"iPhone13,2"
edu.illinois.rokwire.ios,10,1714490938,1714490948,1714490948.584981,-18000,EB445137-D7F5-57EC-87DA-1DB460D64046,"iPhone13,2"
edu.illinois.rokwire.ios,22,1714489615,1714489637,1714489637.147976,-18000,EB445137-D7F5-57EC-87DA-1DB460D64046,"iPhone13,2"
com.apple.news,185,1714486658,1714486843,1714486843.882277,-18000,EB445137-D7F5-57EC-87DA-1DB460D64046,"iPhone13,2"
com.microsoft.Office.Outlook,9,1714486628,1714486637,1714486637.183981,-18000,EB445137-D7F5-57EC-87DA-1DB460D64046,"iPhone13,2"
Astrospheric.Astrospheric,9,1714486618,1714486627,1714486627.106451,-18000,EB445137-D7F5-57EC-87DA-1DB460D64046,"iPhone13,2"
Astrospheric.Astrospheric,2,1714486388,1714486390,1714486390.7433438,-18000,EB445137-D7F5-57EC-87DA-1DB460D64046,"iPhone13,2"
Astrospheric.Astrospheric,16,1714486101,1714486117,1714486117.252739,-18000,EB445137-D7F5-57EC-87DA-1DB460D64046,"iPhone13,2"
com.apple.Health,37,1714486023,1714486060,1714486060.052133,-18000,EB445137-D7F5-57EC-87DA-1DB460D64046,"iPhone13,2"
com.apple.Maps,23,1714484621,1714484644,1714484644.2011762,-18000,EB445137-D7F5-57EC-87DA-1DB460D64046,"iPhone13,2"
com.apple.podcasts,5,1714482598,1714482603,1714482603.607439,-18000,EB445137-D7F5-57EC-87DA-1DB460D64046,"iPhone13,2"
com.apple.podcasts,18,1714482562,1714482580,1714482580.5837898,-18000,EB445137-D7F5-57EC-87DA-1DB460D64046,"iPhone13,2"
com.apple.podcasts,19,1714482495,1714482514,1714482514.516974,-18000,EB445137-D7F5-57EC-87DA-1DB460D64046,"iPhone13,2"
com.apple.weather,16,1714482336,1714482352,1714482353.040299,-18000,EB445137-D7F5-57EC-87DA-1DB460D64046,"iPhone13,2"
com.facebook.Facebook,230,1714426475,1714426705,1714426705.2344232,-18000,EB445137-D7F5-57EC-87DA-1DB460D64046,"iPhone13,2"
com.toyopagroup.picaboo,75,1714426398,1714426473,1714426473.849654,-18000,EB445137-D7F5-57EC-87DA-1DB460D64046,"iPhone13,2"
com.apple.MobileSMS,3,1714426394,1714426397,1714426397.189169,-18000,EB445137-D7F5-57EC-87DA-1DB460D64046,"iPhone13,2"
com.apple.MobileSMS,3,1714425935,1714425938,1714425938.962614,-18000,EB445137-D7F5-57EC-87DA-1DB460D64046,"iPhone13,2"
com.instructure.icanvas,10,1714425073,1714425083,1714425083.708828,-18000,EB445137-D7F5-57EC-87DA-1DB460D64046,"iPhone13,2"
com.apple.calculator,4,1714422109,1714422113,1714422113.207156,-18000,EB445137-D7F5-57EC-87DA-1DB460D64046,"iPhone13,2"
com.apple.Health,3,1714422106,1714422109,1714422109.1896071,-18000,EB445137-D7F5-57EC-87DA-1DB460D64046,"iPhone13,2"
com.apple.Health,13,1714421422,1714421435,1714421435.560752,-18000,EB445137-D7F5-57EC-87DA-1DB460D64046,"iPhone13,2"
edu.illinois.rokwire.ios,55,1714421361,1714421416,1714421416.194756,-18000,EB445137-D7F5-57EC-87DA-1DB460D64046,"iPhone13,2"
edu.illinois.rokwire.ios,1,1714420971,1714420972,1714420972.991724,-18000,EB445137-D7F5-57EC-87DA-1DB460D64046,"iPhone13,2"
edu.illinois.rokwire.ios,5,1714420757,1714420762,1714420762.330614,-18000,EB445137-D7F5-57EC-87DA-1DB460D64046,"iPhone13,2"
edu.illinois.rokwire.ios,14,1714420480,1714420494,1714420495.170058,-18000,EB445137-D7F5-57EC-87DA-1DB460D64046,"iPhone13,2"
com.leomehlig.today,25,1714419380,1714419405,1714419405.582901,-18000,EB445137-D7F5-57EC-87DA-1DB460D64046,"iPhone13,2"
com.apple.mobilecal,11,1714419366,1714419377,1714419377.167496,-18000,EB445137-D7F5-57EC-87DA-1DB460D64046,"iPhone13,2"
com.apple.Notes,3,1714417189,1714417192,1714417193.0860438,-18000,,
com.google.Chrome,2,1714417187,1714417189,1714417189.8528209,-18000,,
com.apple.Notes,9,1714417178,1714417187,1714417187.213746,-18000,,
com.google.Chrome,5,1714417173,1714417178,1714417178.948306,-18000,,
com.apple.Notes,7,1714417166,1714417173,1714417173.682032,-18000,,
com.google.Chrome,1,1714417165,1714417166,1714417166.842624,-18000,,
com.apple.Notes,4,1714417161,1714417165,1714417165.136194,-18000,,
com.google.Chrome,5,1714417156,1714417161,1714417161.680249,-18000,,
com.apple.Notes,9,1714417147,1714417156,1714417156.072747,-18000,,
com.google.Chrome,2,1714417145,1714417147,1714417147.4424,-18000,,
com.apple.Notes,8,1714417137,1714417145,1714417145.466268,-18000,,
com.google.Chrome,1,1714417136,1714417137,1714417137.4969049,-18000,,
com.apple.Notes,4,1714417132,1714417136,1714417136.461945,-18000,,
com.google.Chrome,1,1714417131,1714417132,1714417132.3841,-18000,,
com.apple.Notes,4,1714417127,1714417131,1714417131.402437,-18000,,
com.google.Chrome,11,1714417116,1714417127,1714417127.8708491,-18000,,
com.apple.Notes,18,1714417098,1714417116,1714417116.894706,-18000,,
com.google.Chrome,7,1714417091,1714417098,1714417098.931423,-18000,,
com.apple.Notes,1,1714417090,1714417091,1714417091.724688,-18000,,
com.google.Chrome,3,1714417087,1714417090,1714417090.245905,-18000,,
com.apple.Notes,10,1714417077,1714417087,1714417087.8258219,-18000,,
com.google.Chrome,16,1714417061,1714417077,1714417077.753299,-18000,,
com.apple.Notes,5,1714417056,1714417061,1714417061.427535,-18000,,
com.google.Chrome,11,1714417045,1714417056,1714417056.342608,-18000,,
com.apple.Notes,6,1714417039,1714417045,1714417046.043802,-18000,,
com.google.Chrome,4,1714417035,1714417039,1714417039.638154,-18000,,
com.apple.Notes,4,1714417031,1714417035,1714417035.7298641,-18000,,
com.google.Chrome,2,1714417029,1714417031,1714417031.210423,-18000,,
com.apple.Notes,1,1714417028,1714417029,1714417029.954605,-18000,,
com.google.Chrome,1,1714417027,1714417028,1714417028.49056,-18000,,
com.apple.Notes,8,1714417019,1714417027,1714417027.376833,-18000,,
com.google.Chrome,1,1714417018,1714417019,1714417019.843535,-18000,,
com.apple.Notes,4,1714417014,1714417018,1714417018.909154,-18000,,
com.google.Chrome,3,1714417011,1714417014,1714417014.775049,-18000,,
com.apple.Notes,4,1714417007,1714417011,1714417011.491327,-18000,,
com.google.Chrome,1,1714417006,1714417007,1714417007.092739,-18000,,
com.apple.Notes,4,1714417002,1714417006,1714417006.352934,-18000,,
com.google.Chrome,1,1714417001,1714417002,1714417002.9789538,-18000,,
com.apple.Notes,8,1714416993,1714417001,1714417001.4821138,-18000,,
com.google.Chrome,2,1714416991,1714416993,1714416993.1029348,-18000,,
com.apple.Notes,1,1714416990,1714416991,1714416991.968172,-18000,,
com.google.Chrome,2,1714416988,1714416990,1714416990.085499,-18000,,
com.apple.Notes,5,1714416983,1714416988,1714416988.415601,-18000,,
com.google.Chrome,1,1714416982,1714416983,1714416984.019164,-18000,,
com.apple.Notes,6,1714416976,1714416982,1714416982.908205,-18000,,
com.google.Chrome,2,1714416974,1714416976,1714416976.889652,-18000,,
com.apple.Notes,20,1714416954,1714416974,1714416974.2760792,-18000,,
com.google.Chrome,6,1714416948,1714416954,1714416954.4948359,-18000,,
com.apple.Notes,3,1714416945,1714416948,1714416948.499864,-18000,,
com.google.Chrome,3,1714416942,1714416945,1714416945.956953,-18000,,
com.apple.Notes,5,1714416937,1714416942,1714416942.735077,-18000,,
com.google.Chrome,29,1714416908,1714416937,1714416937.65068,-18000,,
com.apple.Notes,11,1714416897,1714416908,1714416909.050652,-18000,,
com.google.Chrome,0,1714416897,1714416897,1714416897.8910131,-18000,,
com.apple.Notes,2,1714416895,1714416897,1714416897.323364,-18000,,
com.google.Chrome,5,1714416890,1714416895,1714416896.0193648,-18000,,
com.apple.Notes,16,1714416874,1714416890,1714416890.861412,-18000,,
com.google.Chrome,73,1714416801,1714416874,1714416874.754461,-18000,,
com.apple.Notes,4,1714416797,1714416801,1714416801.513811,-18000,,
com.google.Chrome,1,1714416796,1714416797,1714416797.2645469,-18000,,
com.apple.Notes,7,1714416789,1714416796,1714416796.683792,-18000,,
com.google.Chrome,1,1714416788,1714416789,1714416789.523456,-18000,,
com.apple.Notes,3,1714416785,1714416788,1714416788.8203201,-18000,,
com.google.Chrome,4,1714416781,1714416785,1714416785.471572,-18000,,
com.apple.Notes,13,1714416768,1714416781,1714416781.875825,-18000,,
com.google.Chrome,26,1714416742,1714416768,1714416768.90302,-18000,,
com.toyopagroup.picaboo,4,1714416392,1714416396,1714416396.3384418,-18000,EB445137-D7F5-57EC-87DA-1DB460D64046,"iPhone13,2"
com.toyopagroup.picaboo,12,1714415131,1714415143,1714415143.251151,-18000,EB445137-D7F5-57EC-87DA-1DB460D64046,"iPhone13,2"
com.apple.MobileSMS,25,1714415104,1714415129,1714415129.361116,-18000,EB445137-D7F5-57EC-87DA-1DB460D64046,"iPhone13,2"
com.apple.MobileSMS,12,1714413909,1714413921,1714413921.29001,-18000,EB445137-D7F5-57EC-87DA-1DB460D64046,"iPhone13,2"
com.toyopagroup.picaboo,64,1714413702,1714413766,1714413767.0389462,-18000,EB445137-D7F5-57EC-87DA-1DB460D64046,"iPhone13,2"
com.apple.Music,8,1714413693,1714413701,1714413701.324182,-18000,EB445137-D7F5-57EC-87DA-1DB460D64046,"iPhone13,2"
com.apple.MobileSMS,7,1714413686,1714413693,1714413693.414705,-18000,EB445137-D7F5-57EC-87DA-1DB460D64046,"iPhone13,2"
com.apple.MobileSMS,16,1714413627,1714413643,1714413643.457428,-18000,EB445137-D7F5-57EC-87DA-1DB460D64046,"iPhone13,2"
com.apple.MobileSMS,187,1714413375,1714413562,1714413562.908427,-18000,EB445137-D7F5-57EC-87DA-1DB460D64046,"iPhone13,2"
com.toyopagroup.picaboo,2,1714413373,1714413375,1714413375.569643,-18000,EB445137-D7F5-57EC-87DA-1DB460D64046,"iPhone13,2"
com.toyopagroup.picaboo,23,1714413299,1714413322,1714413322.7615929,-18000,EB445137-D7F5-57EC-87DA-1DB460D64046,"iPhone13,2"
com.apple.MobileSMS,7,1714413292,1714413299,1714413299.3377361,-18000,EB445137-D7F5-57EC-87DA-1DB460D64046,"iPhone13,2"
com.apple.MobileSMS,27,1714413217,1714413244,1714413244.362272,-18000,EB445137-D7F5-57EC-87DA-1DB460D64046,"iPhone13,2"
com.apple.MobileSMS,5,1714412975,1714412980,1714412980.179946,-18000,EB445137-D7F5-57EC-87DA-1DB460D64046,"iPhone13,2"
com.apple.MobileSMS,1,1714412930,1714412931,1714412931.466125,-18000,EB445137-D7F5-57EC-87DA-1DB460D64046,"iPhone13,2"
com.apple.MobileSMS,4,1714412854,1714412858,1714412858.365341,-18000,EB445137-D7F5-57EC-87DA-1DB460D64046,"iPhone13,2"
com.apple.MobileSMS,6,1714412840,1714412846,1714412846.210252,-18000,EB445137-D7F5-57EC-87DA-1DB460D64046,"iPhone13,2"
com.apple.MobileSMS,31,1714412669,1714412700,1714412700.762869,-18000,EB445137-D7F5-57EC-87DA-1DB460D64046,"iPhone13,2"
com.apple.MobileSMS,5,1714412637,1714412642,1714412642.0749369,-18000,EB445137-D7F5-57EC-87DA-1DB460D64046,"iPhone13,2"
com.microsoft.Office.Outlook,3,1714412633,1714412636,1714412636.203377,-18000,EB445137-D7F5-57EC-87DA-1DB460D64046,"iPhone13,2"
com.microsoft.Office.Outlook,2,1714412394,1714412396,1714412396.017387,-18000,EB445137-D7F5-57EC-87DA-1DB460D64046,"iPhone13,2"
com.microsoft.Office.Outlook,114,1714412264,1714412378,1714412378.736867,-18000,EB445137-D7F5-57EC-87DA-1DB460D64046,"iPhone13,2"
com.apple.MobileSMS,7,1714412256,1714412263,1714412263.277097,-18000,EB445137-D7F5-57EC-87DA-1DB460D64046,"iPhone13,2"
com.apple.MobileSMS,36,1714412175,1714412211,1714412211.1596742,-18000,EB445137-D7F5-57EC-87DA-1DB460D64046,"iPhone13,2"
com.apple.Music,2,1714412173,1714412175,1714412175.7625751,-18000,EB445137-D7F5-57EC-87DA-1DB460D64046,"iPhone13,2"
com.apple.Music,6,1714412124,1714412130,1714412130.600514,-18000,EB445137-D7F5-57EC-87DA-1DB460D64046,"iPhone13,2"
com.apple.Music,3,1714410596,1714410599,1714410599.995532,-18000,EB445137-D7F5-57EC-87DA-1DB460D64046,"iPhone13,2"
com.apple.Music,1,1714410460,1714410461,1714410461.705863,-18000,EB445137-D7F5-57EC-87DA-1DB460D64046,"iPhone13,2"
com.apple.Music,2,1714410114,1714410116,1714410116.800653,-18000,EB445137-D7F5-57EC-87DA-1DB460D64046,"iPhone13,2"
com.apple.Music,9,1714409494,1714409503,1714409503.955144,-18000,EB445137-D7F5-57EC-87DA-1DB460D64046,"iPhone13,2"
com.toyopagroup.picaboo,4,1714409411,1714409415,1714409415.6379151,-18000,EB445137-D7F5-57EC-87DA-1DB460D64046,"iPhone13,2"
edu.illinois.rokwire.ios,4,1714409365,1714409369,1714409369.820657,-18000,EB445137-D7F5-57EC-87DA-1DB460D64046,"iPhone13,2"
edu.illinois.rokwire.ios,74,1714408118,1714408192,1714408192.561446,-18000,EB445137-D7F5-57EC-87DA-1DB460D64046,"iPhone13,2"
com.thestorygraph.thestorygraph,3,1714407496,1714407499,1714407499.477485,-18000,EB445137-D7F5-57EC-87DA-1DB460D64046,"iPhone13,2"
com.google.chrome.ios,16,1714407480,1714407496,1714407496.321756,-18000,EB445137-D7F5-57EC-87DA-1DB460D64046,"iPhone13,2"
com.thestorygraph.thestorygraph,44,1714407436,1714407480,1714407480.857034,-18000,EB445137-D7F5-57EC-87DA-1DB460D64046,"iPhone13,2"
com.apple.Health,59,1714407128,1714407187,1714407188.074152,-18000,EB445137-D7F5-57EC-87DA-1DB460D64046,"iPhone13,2"
com.microsoft.Office.Outlook,2,1714407126,1714407128,1714407128.687062,-18000,EB445137-D7F5-57EC-87DA-1DB460D64046,"iPhone13,2"
com.microsoft.Office.Outlook,6,1714407016,1714407022,1714407022.0707831,-18000,EB445137-D7F5-57EC-87DA-1DB460D64046,"iPhone13,2"
com.microsoft.Office.Outlook,2,1714407012,1714407014,1714407014.940973,-18000,EB445137-D7F5-57EC-87DA-1DB460D64046,"iPhone13,2"
com.google.Chrome,2,1714407008,1714407010,1714407010.7316298,-18000,,
com.apple.Notes,16,1714406992,1714407008,1714407008.567518,-18000,,
com.google.Chrome,1,1714406991,1714406992,1714406992.459827,-18000,,
com.apple.Notes,9,1714406982,1714406991,1714406991.723635,-18000,,
com.google.Chrome,1,1714406981,1714406982,1714406982.2920141,-18000,,
com.apple.Notes,6,1714406975,1714406981,1714406981.74443,-18000,,
com.google.Chrome,1,1714406974,1714406975,1714406975.2183561,-18000,,
com.apple.Notes,4,1714406970,1714406974,1714406974.299366,-18000,,
com.google.Chrome,1,1714406969,1714406970,1714406970.538136,-18000,,
com.apple.Notes,3,1714406966,1714406969,1714406969.706783,-18000,,
com.google.Chrome,4,1714406962,1714406966,1714406966.095772,-18000,,
com.apple.Notes,4,1714406958,1714406962,1714406962.3079162,-18000,,
com.google.Chrome,10,1714406948,1714406958,1714406958.637218,-18000,,
com.apple.Notes,7,1714406941,1714406948,1714406948.318794,-18000,,
com.google.Chrome,1,1714406940,1714406941,1714406941.839158,-18000,,
com.apple.Notes,6,1714406934,1714406940,1714406940.127898,-18000,,
com.google.Chrome,2,1714406932,1714406934,1714406934.274612,-18000,,
com.apple.Notes,8,1714406924,1714406932,1714406932.2301211,-18000,,
com.google.Chrome,8,1714406916,1714406924,1714406924.540947,-18000,,
com.apple.Notes,6,1714406910,1714406916,1714406917.089559,-18000,,
com.google.Chrome,12,1714406898,1714406910,1714406910.9544039,-18000,,
com.apple.Notes,8,1714406890,1714406898,1714406898.7810678,-18000,,
com.google.Chrome,5,1714406885,1714406890,1714406890.870658,-18000,,
com.apple.Notes,4,1714406881,1714406885,1714406886.089056,-18000,,
com.google.Chrome,12,1714406869,1714406881,1714406881.806555,-18000,,
com.apple.Notes,5,1714406864,1714406869,1714406869.305822,-18000,,
com.google.Chrome,6,1714406858,1714406864,1714406864.691937,-18000,,
com.apple.Notes,2,1714406856,1714406858,1714406858.5527492,-18000,,
com.google.Chrome,22,1714406834,1714406856,1714406856.93363,-18000,,
com.apple.Notes,10,1714406824,1714406834,1714406834.568572,-18000,,
com.google.Chrome,5,1714406819,1714406824,1714406825.0567598,-18000,,
com.apple.Notes,20,1714406799,1714406819,1714406819.474934,-18000,,
com.google.Chrome,1,1714406798,1714406799,1714406799.6713939,-18000,,
com.apple.Notes,7,1714406791,1714406798,1714406798.9987822,-18000,,
com.google.Chrome,1,1714406790,1714406791,1714406791.279979,-18000,,
com.apple.Notes,3,1714406787,1714406790,1714406790.4692512,-18000,,
com.google.Chrome,0,1714406787,1714406787,1714406787.9830232,-18000,,
com.apple.Notes,2,1714406785,1714406787,1714406787.229054,-18000,,
com.google.Chrome,2,1714406783,1714406785,1714406785.153547,-18000,,
com.apple.Notes,7,1714406776,1714406783,1714406783.456387,-18000,,
com.google.Chrome,2,1714406774,1714406776,1714406776.092741,-18000,,
com.apple.Notes,7,1714406767,1714406774,1714406775.0511088,-18000,,
com.google.Chrome,5,1714406762,1714406767,1714406767.136508,-18000,,
com.apple.Notes,8,1714406754,1714406762,1714406762.117312,-18000,,
com.google.Chrome,1,1714406753,1714406754,1714406755.076132,-18000,,
com.apple.Notes,5,1714406748,1714406753,1714406753.2302651,-18000,,
com.google.Chrome,1,1714406747,1714406748,1714406749.018347,-18000,,
com.apple.Notes,6,1714406741,1714406747,1714406747.516566,-18000,,
com.google.Chrome,5,1714406736,1714406741,1714406741.5249472,-18000,,
com.apple.Notes,5,1714406731,1714406736,1714406736.838345,-18000,,
com.google.Chrome,1,1714406730,1714406731,1714406731.223392,-18000,,
com.apple.Notes,3,1714406727,1714406730,1714406730.377336,-18000,,
com.google.Chrome,1,1714406726,1714406727,1714406727.142585,-18000,,
com.apple.Notes,2,1714406724,1714406726,1714406726.2969332,-18000,,
com.google.Chrome,2,1714406722,1714406724,1714406724.0956922,-18000,,
com.apple.Notes,2,1714406720,1714406722,1714406722.735897,-18000,,
com.google.Chrome,1,1714406719,1714406720,1714406720.244627,-18000,,
com.apple.Notes,5,1714406714,1714406719,1714406719.5160499,-18000,,
com.google.Chrome,1,1714406713,1714406714,1714406714.4902449,-18000,,
com.apple.Notes,4,1714406709,1714406713,1714406713.265037,-18000,,
com.google.Chrome,1,1714406708,1714406709,1714406709.920975,-18000,,
com.apple.Notes,3,1714406705,1714406708,1714406709.034882,-18000,,
com.google.Chrome,1,1714406704,1714406705,1714406705.449534,-18000,,
com.apple.Notes,3,1714406701,1714406704,1714406704.783849,-18000,,
com.google.Chrome,3,1714406698,1714406701,1714406701.290584,-18000,,
com.apple.Notes,5,1714406693,1714406698,1714406699.074692,-18000,,
com.google.Chrome,1,1714406692,1714406693,1714406693.62822,-18000,,
com.apple.Notes,3,1714406689,1714406692,1714406692.716017,-18000,,
com.google.Chrome,2,1714406687,1714406689,1714406689.521546,-18000,,
com.apple.Notes,13,1714406674,1714406687,1714406687.595773,-18000,,
com.google.Chrome,2,1714406672,1714406674,1714406674.0982661,-18000,,
com.apple.Notes,5,1714406667,1714406672,1714406673.0092,-18000,,
com.google.Chrome,11,1714406656,1714406667,1714406667.747446,-18000,,
com.apple.Notes,1,1714406655,1714406656,1714406656.27353,-18000,,
com.google.Chrome,2,1714406653,1714406655,1714406655.365953,-18000,,
com.apple.Notes,7,1714406646,1714406653,1714406653.261781,-18000,,
com.google.Chrome,1,1714406645,1714406646,1714406646.155158,-18000,,
com.apple.Notes,4,1714406641,1714406645,1714406645.3600512,-18000,,
com.google.Chrome,2,1714406639,1714406641,1714406641.459846,-18000,,
com.apple.Notes,2,1714406637,1714406639,1714406640.066982,-18000,,
com.google.Chrome,1,1714406636,1714406637,1714406637.2430968,-18000,,
com.apple.Notes,5,1714406631,1714406636,1714406636.2140431,-18000,,
com.google.Chrome,2,1714406629,1714406631,1714406631.7677689,-18000,,
com.apple.Notes,11,1714406618,1714406629,1714406629.597519,-18000,,
com.google.Chrome,5,1714406613,1714406618,1714406618.116502,-18000,,
com.apple.Notes,7,1714406606,1714406613,1714406613.688127,-18000,,
com.google.Chrome,2,1714406604,1714406606,1714406606.127101,-18000,,
com.apple.Notes,1,1714406603,1714406604,1714406604.577231,-18000,,
com.google.Chrome,2,1714406601,1714406603,1714406603.321255,-18000,,
com.apple.Notes,2,1714406599,1714406601,1714406601.951654,-18000,,
com.google.Chrome,1,1714406598,1714406599,1714406599.458555,-18000,,
com.apple.Notes,3,1714406595,1714406598,1714406598.7361999,-18000,,
com.google.Chrome,1,1714406594,1714406595,1714406595.6899118,-18000,,
com.apple.Notes,8,1714406586,1714406594,1714406594.417525,-18000,,
com.google.Chrome,1,1714406585,1714406586,1714406586.4680119,-18000,,
com.apple.Notes,1,1714406584,1714406585,1714406585.1712332,-18000,,
com.google.Chrome,13,1714406571,1714406584,1714406584.274883,-18000,,
com.apple.Notes,21,1714406550,1714406571,1714406571.492311,-18000,,
com.google.Chrome,5,1714406545,1714406550,1714406550.485221,-18000,,
com.apple.Notes,5,1714406540,1714406545,1714406546.004766,-18000,,
com.google.Chrome,1,1714406539,1714406540,1714406540.463512,-18000,,
com.apple.Notes,5,1714406534,1714406539,1714406539.621574,-18000,,
com.google.Chrome,1,1714406533,1714406534,1714406534.552164,-18000,,
com.apple.Notes,7,1714406526,1714406533,1714406533.712204,-18000,,
com.google.Chrome,2,1714406524,1714406526,1714406526.472583,-18000,,
com.apple.Notes,7,1714406517,1714406524,1714406524.836813,-18000,,
com.google.Chrome,1,1714406516,1714406517,1714406517.858294,-18000,,
com.apple.Notes,4,1714406512,1714406516,1714406517.07275,-18000,,
com.google.Chrome,0,1714406512,1714406512,1714406512.870988,-18000,,
com.apple.Notes,6,1714406506,1714406512,1714406512.106205,-18000,,
com.google.Chrome,8,1714406498,1714406506,1714406506.3919702,-18000,,
com.apple.Notes,10,1714406488,1714406498,1714406499.090839,-18000,,
com.google.Chrome,6,1714406482,1714406488,1714406488.918746,-18000,,
com.apple.Notes,4,1714406478,1714406482,1714406482.322273,-18000,,
com.google.Chrome,1,1714406477,1714406478,1714406478.3554912,-18000,,
com.apple.Notes,4,1714406473,1714406477,1714406477.644359,-18000,,
com.google.Chrome,1,1714406472,1714406473,1714406473.888318,-18000,,
com.apple.Notes,1,1714406471,1714406472,1714406472.895553,-18000,,
com.google.Chrome,1,1714406470,1714406471,1714406471.343611,-18000,,
com.apple.Notes,12,1714406458,1714406470,1714406470.0884151,-18000,,
com.google.Chrome,11,1714406447,1714406458,1714406458.525121,-18000,,
com.apple.Notes,10,1714406437,1714406447,1714406447.717588,-18000,,
com.google.Chrome,0,1714406437,1714406437,1714406438.0331821,-18000,,
com.apple.Notes,4,1714406433,1714406437,1714406437.3565469,-18000,,
com.google.Chrome,3,1714406430,1714406433,1714406433.695702,-18000,,
com.apple.Notes,6,1714406424,1714406430,1714406430.2584538,-18000,,
com.google.Chrome,2,1714406422,1714406424,1714406424.785913,-18000,,
com.apple.Notes,8,1714406414,1714406422,1714406422.808223,-18000,,
com.google.Chrome,1,1714406413,1714406414,1714406414.201369,-18000,,
com.apple.Notes,4,1714406409,1714406413,1714406413.095001,-18000,,
com.google.Chrome,5,1714406404,1714406409,1714406409.341385,-18000,,
com.apple.Notes,9,1714406395,1714406404,1714406404.452754,-18000,,
com.google.Chrome,5,1714406390,1714406395,1714406395.771388,-18000,,
com.apple.Notes,1,1714406389,1714406390,1714406390.744597,-18000,,
com.google.Chrome,2,1714406387,1714406389,1714406389.29016,-18000,,
com.apple.Notes,4,1714406383,1714406387,1714406387.514796,-18000,,
com.google.Chrome,2,1714406381,1714406383,1714406383.192842,-18000,,
com.apple.Notes,7,1714406374,1714406381,1714406381.644846,-18000,,
com.google.Chrome,2,1714406372,1714406374,1714406374.218306,-18000,,
com.apple.Notes,6,1714406366,1714406372,1714406372.9261708,-18000,,
com.google.Chrome,7,1714406359,1714406366,1714406366.593785,-18000,,
com.apple.Notes,14,1714406345,1714406359,1714406359.6419,-18000,,
com.google.Chrome,1,1714406344,1714406345,1714406345.726118,-18000,,
com.apple.Notes,1,1714406343,1714406344,1714406345.025161,-18000,,
com.google.Chrome,5,1714406338,1714406343,1714406343.5377278,-18000,,
com.apple.Notes,3,1714406335,1714406338,1714406338.867371,-18000,,
com.google.Chrome,148,1714406187,1714406335,1714406335.283644,-18000,,
com.microsoft.Office.Outlook,61,1714406171,1714406232,1714406232.211934,-18000,EB445137-D7F5-57EC-87DA-1DB460D64046,"iPhone13,2"
com.microsoft.Office.Outlook,20,1714405379,1714405399,1714405399.785167,-18000,EB445137-D7F5-57EC-87DA-1DB460D64046,"iPhone13,2"
com.apple.weather,8,1714405371,1714405379,1714405379.238276,-18000,EB445137-D7F5-57EC-87DA-1DB460D64046,"iPhone13,2"
com.apple.weather,6,1714405297,1714405303,1714405303.2679958,-18000,EB445137-D7F5-57EC-87DA-1DB460D64046,"iPhone13,2"
com.apple.weather,4,1714405291,1714405295,1714405295.906764,-18000,EB445137-D7F5-57EC-87DA-1DB460D64046,"iPhone13,2"
com.apple.weather,4,1714405287,1714405291,1714405291.485609,-18000,EB445137-D7F5-57EC-87DA-1DB460D64046,"iPhone13,2"
com.apple.weather,9,1714405128,1714405137,1714405137.742168,-18000,EB445137-D7F5-57EC-87DA-1DB460D64046,"iPhone13,2"
com.apple.weather,7,1714404533,1714404540,1714404540.3773332,-18000,EB445137-D7F5-57EC-87DA-1DB460D64046,"iPhone13,2"
com.apple.weather,2,1714404530,1714404532,1714404532.025626,-18000,EB445137-D7F5-57EC-87DA-1DB460D64046,"iPhone13,2"
com.apple.weather,10,1714404439,1714404449,1714404449.374123,-18000,EB445137-D7F5-57EC-87DA-1DB460D64046,"iPhone13,2"
com.apple.weather,11,1714404411,1714404422,1714404422.608533,-18000,EB445137-D7F5-57EC-87DA-1DB460D64046,"iPhone13,2"
com.google.Chrome,11,1714404352,1714404363,1714404363.23159,-18000,,
com.apple.Notes,4,1714404348,1714404352,1714404352.143574,-18000,,
com.google.Chrome,2,1714404346,1714404348,1714404348.375578,-18000,,
com.apple.Notes,6,1714404340,1714404346,1714404346.2246761,-18000,,
com.google.Chrome,1,1714404339,1714404340,1714404340.459817,-18000,,
com.apple.Notes,5,1714404334,1714404339,1714404339.519345,-18000,,
com.google.Chrome,6,1714404328,1714404334,1714404334.081686,-18000,,
com.apple.Notes,8,1714404320,1714404328,1714404328.9833012,-18000,,
com.google.Chrome,7,1714404313,1714404320,1714404320.351222,-18000,,
com.apple.Notes,7,1714404306,1714404313,1714404313.530363,-18000,,
com.google.Chrome,0,1714404306,1714404306,1714404306.837013,-18000,,
com.apple.Notes,6,1714404300,1714404306,1714404306.065292,-18000,,
com.google.Chrome,4,1714404296,1714404300,1714404300.690393,-18000,,
com.apple.Notes,7,1714404289,1714404296,1714404296.831656,-18000,,
com.google.Chrome,1,1714404288,1714404289,1714404289.42563,-18000,,
com.apple.Notes,5,1714404283,1714404288,1714404288.329204,-18000,,
com.google.Chrome,2,1714404281,1714404283,1714404284.066755,-18000,,
com.apple.Notes,7,1714404274,1714404281,1714404281.955713,-18000,,
com.google.Chrome,1,1714404273,1714404274,1714404274.968326,-18000,,
com.apple.Notes,5,1714404268,1714404273,1714404273.112805,-18000,,
com.google.Chrome,2,1714404266,1714404268,1714404268.2225661,-18000,,
com.apple.Notes,5,1714404261,1714404266,1714404266.54314,-18000,,
com.google.Chrome,2,1714404259,1714404261,1714404261.733412,-18000,,
com.apple.Notes,3,1714404256,1714404259,1714404259.608716,-18000,,
com.google.Chrome,2,1714404254,1714404256,1714404256.394511,-18000,,
com.apple.Notes,7,1714404247,1714404254,1714404254.748561,-18000,,
com.google.Chrome,3,1714404244,1714404247,1714404247.3529592,-18000,,
com.apple.Notes,5,1714404239,1714404244,1714404244.672322,-18000,,
com.google.Chrome,2,1714404237,1714404239,1714404239.671739,-18000,,
com.apple.Notes,12,1714404225,1714404237,1714404237.592911,-18000,,
com.google.Chrome,5,1714404220,1714404225,1714404225.090682,-18000,,
com.apple.Notes,12,1714404208,1714404220,1714404220.595156,-18000,,
com.google.Chrome,0,1714404208,1714404208,1714404209.03285,-18000,,
com.apple.Notes,3,1714404205,1714404208,1714404208.183928,-18000,,
com.google.Chrome,19,1714404186,1714404205,1714404205.276132,-18000,,
com.apple.Notes,11,1714404175,1714404186,1714404186.3328671,-18000,,
com.google.Chrome,1,1714404174,1714404175,1714404175.986165,-18000,,
com.apple.Notes,11,1714404163,1714404174,1714404174.253334,-18000,,
com.google.Chrome,6,1714404157,1714404163,1714404163.259227,-18000,,
com.apple.Notes,9,1714404148,1714404157,1714404157.948703,-18000,,
com.google.Chrome,1,1714404147,1714404148,1714404148.3408852,-18000,,
com.apple.Notes,6,1714404141,1714404147,1714404147.566774,-18000,,
com.google.Chrome,1,1714404140,1714404141,1714404141.1295428,-18000,,
com.apple.Notes,4,1714404136,1714404140,1714404140.330261,-18000,,
com.google.Chrome,2,1714404134,1714404136,1714404136.594242,-18000,,
com.apple.Notes,8,1714404126,1714404134,1714404134.666379,-18000,,
com.google.Chrome,2,1714404124,1714404126,1714404126.091147,-18000,,
com.apple.Notes,3,1714404121,1714404124,1714404124.776266,-18000,,
com.google.Chrome,1,1714404120,1714404121,1714404122.024558,-18000,,
com.apple.Notes,1,1714404119,1714404120,1714404120.7824059,-18000,,
com.google.Chrome,2,1714404117,1714404119,1714404119.162521,-18000,,
com.apple.Notes,2,1714404115,1714404117,1714404117.974945,-18000,,
com.google.Chrome,2,1714404113,1714404115,1714404116.066064,-18000,,
com.apple.Notes,6,1714404107,1714404113,1714404113.541645,-18000,,
com.google.Chrome,1,1714404106,1714404107,1714404107.66765,-18000,,
com.apple.Notes,4,1714404102,1714404106,1714404106.589581,-18000,,
com.google.Chrome,1,1714404101,1714404102,1714404102.111699,-18000,,
com.apple.Notes,3,1714404098,1714404101,1714404101.184904,-18000,,
com.google.Chrome,5,1714404093,1714404098,1714404098.3201308,-18000,,
com.apple.Notes,12,1714404081,1714404093,1714404093.768857,-18000,,
com.google.Chrome,3,1714404078,1714404081,1714404081.2017841,-18000,,
com.apple.Notes,1,1714404077,1714404078,1714404078.683039,-18000,,
com.google.Chrome,4,1714404073,1714404077,1714404077.578681,-18000,,
com.apple.Notes,1,1714404072,1714404073,1714404073.7549062,-18000,,
com.google.Chrome,19,1714404053,1714404072,1714404072.090114,-18000,,
com.apple.Notes,10,1714404043,1714404053,1714404053.4380798,-18000,,
com.google.Chrome,4,1714404039,1714404043,1714404043.779465,-18000,,
com.leomehlig.today,17,1714404009,1714404026,1714404027.749673,-18000,,
com.microsoft.VSCode,4,1714404005,1714404009,1714404009.080843,-18000,,
com.leomehlig.today,69,1714403936,1714404005,1714404005.913275,-18000,,
com.google.Chrome,96,1714403840,1714403936,1714403936.9229012,-18000,,
com.leomehlig.today,8,1714403830,1714403838,1714403838.188815,-18000,,
com.google.Chrome,352,1714403478,1714403830,1714403830.852119,-18000,,
com.microsoft.VSCode,15,1714403463,1714403478,1714403478.885951,-18000,,
com.google.Chrome,34,1714403429,1714403463,1714403463.8632898,-18000,,
com.microsoft.VSCode,80,1714403349,1714403429,1714403429.552271,-18000,,
com.google.Chrome,592,1714402757,1714403349,1714403349.4400768,-18000,,
com.leomehlig.today,1,1714402756,1714402757,1714402757.398119,-18000,,
com.google.Chrome,911,1714401845,1714402756,1714402756.301361,-18000,,
com.leomehlig.today,13,1714401832,1714401845,1714401845.899191,-18000,,
com.apple.finder,2,1714401830,1714401832,1714401832.5373921,-18000,,
com.apple.MobileSMS,3,1714401804,1714401807,1714401807.388142,-18000,EB445137-D7F5-57EC-87DA-1DB460D64046,"iPhone13,2"
com.toyopagroup.picaboo,35,1714401765,1714401800,1714401800.511271,-18000,EB445137-D7F5-57EC-87DA-1DB460D64046,"iPhone13,2"
com.apple.camera,6,1714401644,1714401650,1714401651.353253,-18000,EB445137-D7F5-57EC-87DA-1DB460D64046,"iPhone13,2"
com.apple.podcasts,2,1714401469,1714401471,1714401471.927415,-18000,EB445137-D7F5-57EC-87DA-1DB460D64046,"iPhone13,2"
com.apple.Health,11,1714401458,1714401469,1714401470.087924,-18000,EB445137-D7F5-57EC-87DA-1DB460D64046,"iPhone13,2"
com.apple.Health,5,1714399748,1714399753,1714399753.091253,-18000,EB445137-D7F5-57EC-87DA-1DB460D64046,"iPhone13,2"
com.apple.Health,19,1714399687,1714399706,1714399706.51335,-18000,EB445137-D7F5-57EC-87DA-1DB460D64046,"iPhone13,2"
com.apple.camera,15,1714398008,1714398023,1714398023.431824,-18000,EB445137-D7F5-57EC-87DA-1DB460D64046,"iPhone13,2"
com.letterboxd.LetterboxdApp,30,1714397337,1714397367,1714397367.886788,-18000,EB445137-D7F5-57EC-87DA-1DB460D64046,"iPhone13,2"
com.apple.podcasts,5,1714396922,1714396927,1714396927.99775,-18000,EB445137-D7F5-57EC-87DA-1DB460D64046,"iPhone13,2"
com.apple.weather,1,1714396921,1714396922,1714396923.527477,-18000,EB445137-D7F5-57EC-87DA-1DB460D64046,"iPhone13,2"
com.apple.weather,9,1714396070,1714396079,1714396079.8719091,-18000,EB445137-D7F5-57EC-87DA-1DB460D64046,"iPhone13,2"
com.apple.weather,1,1714396065,1714396066,1714396066.628742,-18000,EB445137-D7F5-57EC-87DA-1DB460D64046,"iPhone13,2"
com.apple.weather,8,1714396024,1714396032,1714396032.358928,-18000,EB445137-D7F5-57EC-87DA-1DB460D64046,"iPhone13,2"
com.apple.weather,18,1714396005,1714396023,1714396023.7669082,-18000,EB445137-D7F5-57EC-87DA-1DB460D64046,"iPhone13,2"
com.apple.podcasts,16,1714395989,1714396005,1714396005.884709,-18000,EB445137-D7F5-57EC-87DA-1DB460D64046,"iPhone13,2"
com.apple.Health,11,1714395968,1714395979,1714395979.676361,-18000,EB445137-D7F5-57EC-87DA-1DB460D64046,"iPhone13,2"
com.apple.weather,5,1714395950,1714395955,1714395955.592318,-18000,EB445137-D7F5-57EC-87DA-1DB460D64046,"iPhone13,2"
com.apple.weather,8,1714395748,1714395756,1714395756.6460981,-18000,EB445137-D7F5-57EC-87DA-1DB460D64046,"iPhone13,2"
com.apple.weather,18,1714395689,1714395707,1714395708.000826,-18000,EB445137-D7F5-57EC-87DA-1DB460D64046,"iPhone13,2"
com.apple.Health,29,1714362557,1714362586,1714362586.953721,-18000,EB445137-D7F5-57EC-87DA-1DB460D64046,"iPhone13,2"
com.moodle.moodlemobile,9,1714362545,1714362554,1714362554.8554192,-18000,EB445137-D7F5-57EC-87DA-1DB460D64046,"iPhone13,2"
com.microsoft.Office.Outlook,13,1714362532,1714362545,1714362545.94349,-18000,EB445137-D7F5-57EC-87DA-1DB460D64046,"iPhone13,2"
com.moodle.moodlemobile,20,1714362512,1714362532,1714362532.9318318,-18000,EB445137-D7F5-57EC-87DA-1DB460D64046,"iPhone13,2"
com.microsoft.Office.Outlook,39,1714362471,1714362510,1714362510.08286,-18000,EB445137-D7F5-57EC-87DA-1DB460D64046,"iPhone13,2"
com.thestorygraph.thestorygraph,19,1714362451,1714362470,1714362470.213831,-18000,EB445137-D7F5-57EC-87DA-1DB460D64046,"iPhone13,2"
com.apple.finder,5,1714360088,1714360093,1714360093.944782,-18000,,
com.apple.Preview,2,1714360086,1714360088,1714360088.89332,-18000,,
com.leomehlig.today,73,1714360013,1714360086,1714360086.874326,-18000,,
com.apple.Preview,25,1714359988,1714360013,1714360013.817346,-18000,,
com.leomehlig.today,1,1714359987,1714359988,1714359988.807899,-18000,,
com.google.Chrome,521,1714359466,1714359987,1714359987.70782,-18000,,
com.google.Chrome,597,1714358460,1714359057,1714359057.142492,-18000,,
com.google.Chrome,452,1714357082,1714357534,1714357534.436049,-18000,,
com.leomehlig.today,30,1714357052,1714357082,1714357082.511495,-18000,,
com.microsoft.Office.Outlook,46,1714356489,1714356535,1714356535.078751,-18000,EB445137-D7F5-57EC-87DA-1DB460D64046,"iPhone13,2"
com.apple.Fitness,51,1714354723,1714354774,1714354774.982785,-18000,EB445137-D7F5-57EC-87DA-1DB460D64046,"iPhone13,2"
us.parkmobile.ParkMobile,3,1714354712,1714354715,1714354715.559476,-18000,EB445137-D7F5-57EC-87DA-1DB460D64046,"iPhone13,2"
us.parkmobile.ParkMobile,6,1714353146,1714353152,1714353152.135104,-18000,EB445137-D7F5-57EC-87DA-1DB460D64046,"iPhone13,2"
us.parkmobile.ParkMobile,6,1714352193,1714352199,1714352199.909977,-18000,EB445137-D7F5-57EC-87DA-1DB460D64046,"iPhone13,2"
us.parkmobile.ParkMobile,19,1714352146,1714352165,1714352165.496475,-18000,EB445137-D7F5-57EC-87DA-1DB460D64046,"iPhone13,2"
com.tinyspeck.chatlyio,42,1714351748,1714351790,1714351790.133144,-18000,EB445137-D7F5-57EC-87DA-1DB460D64046,"iPhone13,2"
com.apple.mobileslideshow,192,1714351550,1714351742,1714351742.977448,-18000,EB445137-D7F5-57EC-87DA-1DB460D64046,"iPhone13,2"
com.apple.Music,3,1714351545,1714351548,1714351548.098948,-18000,EB445137-D7F5-57EC-87DA-1DB460D64046,"iPhone13,2"
com.apple.Music,7,1714351461,1714351468,1714351468.97055,-18000,EB445137-D7F5-57EC-87DA-1DB460D64046,"iPhone13,2"
edu.illinois.rokwire.ios,22,1714351368,1714351390,1714351390.348404,-18000,EB445137-D7F5-57EC-87DA-1DB460D64046,"iPhone13,2"
com.apple.MobileSMS,3,1714351345,1714351348,1714351349.0162811,-18000,EB445137-D7F5-57EC-87DA-1DB460D64046,"iPhone13,2"
com.apple.MobileSMS,18,1714351028,1714351046,1714351046.646898,-18000,EB445137-D7F5-57EC-87DA-1DB460D64046,"iPhone13,2"
com.toyopagroup.picaboo,8,1714351003,1714351011,1714351011.4829059,-18000,EB445137-D7F5-57EC-87DA-1DB460D64046,"iPhone13,2"
com.apple.Music,3,1714351000,1714351003,1714351003.610029,-18000,EB445137-D7F5-57EC-87DA-1DB460D64046,"iPhone13,2"
com.apple.Music,7,1714350901,1714350908,1714350908.237716,-18000,EB445137-D7F5-57EC-87DA-1DB460D64046,"iPhone13,2"
com.apple.Music,108,1714350737,1714350845,1714350845.0792599,-18000,EB445137-D7F5-57EC-87DA-1DB460D64046,"iPhone13,2"
com.toyopagroup.picaboo,4,1714350271,1714350275,1714350275.909193,-18000,EB445137-D7F5-57EC-87DA-1DB460D64046,"iPhone13,2"
com.toyopagroup.picaboo,79,1714350132,1714350211,1714350211.666738,-18000,EB445137-D7F5-57EC-87DA-1DB460D64046,"iPhone13,2"
com.toyopagroup.picaboo,25,1714350103,1714350128,1714350128.055644,-18000,EB445137-D7F5-57EC-87DA-1DB460D64046,"iPhone13,2"
com.apple.weather,4,1714350099,1714350103,1714350103.702852,-18000,EB445137-D7F5-57EC-87DA-1DB460D64046,"iPhone13,2"
com.apple.weather,29,1714350024,1714350053,1714350053.39635,-18000,EB445137-D7F5-57EC-87DA-1DB460D64046,"iPhone13,2"
com.leomehlig.today,49,1714349970,1714350019,1714350019.312743,-18000,,
com.leomehlig.today,109,1714349526,1714349635,1714349635.9974918,-18000,,
com.google.Chrome,19,1714349507,1714349526,1714349527.049051,-18000,,
com.leomehlig.today,6,1714349501,1714349507,1714349507.119903,-18000,,
com.google.Chrome,83,1714349418,1714349501,1714349502.090554,-18000,,
com.apple.Preview,8,1714349410,1714349418,1714349418.310173,-18000,,
com.google.Chrome,8,1714349402,1714349410,1714349410.444456,-18000,,
com.apple.Preview,7,1714349395,1714349402,1714349402.434453,-18000,,
com.google.Chrome,3,1714349392,1714349395,1714349395.7520409,-18000,,
com.apple.Preview,7,1714349385,1714349392,1714349392.4101791,-18000,,
com.google.Chrome,10,1714349375,1714349385,1714349385.1985989,-18000,,
com.apple.Preview,8,1714349367,1714349375,1714349375.720547,-18000,,
com.google.Chrome,18,1714349349,1714349367,1714349367.217579,-18000,,
com.apple.Preview,15,1714349334,1714349349,1714349349.3280358,-18000,,
com.google.Chrome,30,1714349304,1714349334,1714349334.5587811,-18000,,
com.apple.Preview,9,1714349295,1714349304,1714349304.885644,-18000,,
com.google.Chrome,6,1714349289,1714349295,1714349295.790677,-18000,,
com.apple.Preview,15,1714349274,1714349289,1714349289.4194221,-18000,,
com.google.Chrome,47,1714349227,1714349274,1714349274.559258,-18000,,
com.apple.Preview,7,1714349220,1714349227,1714349227.614223,-18000,,
com.google.Chrome,2,1714349218,1714349220,1714349220.132117,-18000,,
com.apple.Preview,1,1714349217,1714349218,1714349218.545116,-18000,,
com.google.Chrome,3,1714349214,1714349217,1714349217.164705,-18000,,
com.apple.Preview,24,1714349190,1714349214,1714349214.075764,-18000,,
com.google.Chrome,2,1714349188,1714349190,1714349190.278811,-18000,,
com.apple.Preview,15,1714349173,1714349188,1714349188.543445,-18000,,
com.google.Chrome,62,1714349111,1714349173,1714349173.763039,-18000,,
com.apple.Preview,7,1714349104,1714349111,1714349111.211163,-18000,,
com.google.Chrome,15,1714349089,1714349104,1714349104.837127,-18000,,
com.apple.Preview,2,1714349087,1714349089,1714349089.795745,-18000,,
com.google.Chrome,0,1714349087,1714349087,1714349087.85537,-18000,,
com.apple.Preview,18,1714349069,1714349087,1714349087.036906,-18000,,
com.google.Chrome,7,1714349062,1714349069,1714349069.7787008,-18000,,
com.apple.Preview,11,1714349051,1714349062,1714349062.524705,-18000,,
edu.illinois.rokwire.ios,4,1714349015,1714349019,1714349019.290235,-18000,EB445137-D7F5-57EC-87DA-1DB460D64046,"iPhone13,2"
edu.illinois.rokwire.ios,11,1714349002,1714349013,1714349013.050846,-18000,EB445137-D7F5-57EC-87DA-1DB460D64046,"iPhone13,2"
com.google.Chrome,75,1714348976,1714349051,1714349051.9076018,-18000,,
com.apple.finder,2,1714348963,1714348965,1714348965.5751,-18000,,
com.apple.Preview,1,1714348962,1714348963,1714348963.6900392,-18000,,
com.apple.finder,2,1714348960,1714348962,1714348962.50577,-18000,,
com.google.Chrome,18,1714348942,1714348960,1714348960.341114,-18000,,
com.leomehlig.today,18,1714348924,1714348942,1714348943.295057,-18000,,
com.google.Chrome,47,1714348877,1714348924,1714348924.248811,-18000,,
com.apple.Preview,2062,1714346518,1714348580,1714348581.031931,-18000,,
com.google.Chrome,36,1714346482,1714346518,1714346518.990542,-18000,,
com.apple.Preview,794,1714345688,1714346482,1714346482.615731,-18000,,
com.google.Chrome,14,1714345674,1714345688,1714345688.767645,-18000,,
com.apple.Preview,33,1714345625,1714345658,1714345658.97118,-18000,,
com.apple.finder,3,1714345622,1714345625,1714345625.138085,-18000,,
com.leomehlig.today,4,1714345618,1714345622,1714345622.739133,-18000,,
com.apple.finder,2,1714345616,1714345618,1714345619.040563,-18000,,
com.leomehlig.today,18,1714345598,1714345616,1714345616.976826,-18000,,
edu.illinois.rokwire.ios,18,1714343119,1714343137,1714343137.1747441,-18000,EB445137-D7F5-57EC-87DA-1DB460D64046,"iPhone13,2"
com.thestorygraph.thestorygraph,31,1714342985,1714343016,1714343016.941101,-18000,EB445137-D7F5-57EC-87DA-1DB460D64046,"iPhone13,2"
com.apple.calculator,4,1714342978,1714342982,1714342982.514936,-18000,EB445137-D7F5-57EC-87DA-1DB460D64046,"iPhone13,2"
com.apple.MobileSMS,4,1714342950,1714342954,1714342954.718814,-18000,EB445137-D7F5-57EC-87DA-1DB460D64046,"iPhone13,2"
com.robinhood.release.Robinhood,15,1714337648,1714337663,1714337663.6709452,-18000,EB445137-D7F5-57EC-87DA-1DB460D64046,"iPhone13,2"
com.muscleforlife.Stacked,39,1714337605,1714337644,1714337644.1538281,-18000,EB445137-D7F5-57EC-87DA-1DB460D64046,"iPhone13,2"
com.burbn.instagram,121,1714337447,1714337568,1714337568.7275581,-18000,EB445137-D7F5-57EC-87DA-1DB460D64046,"iPhone13,2"
com.apple.MobileSMS,30,1714337395,1714337425,1714337425.458982,-18000,EB445137-D7F5-57EC-87DA-1DB460D64046,"iPhone13,2"
com.microsoft.Office.Outlook,6,1714337387,1714337393,1714337393.475838,-18000,EB445137-D7F5-57EC-87DA-1DB460D64046,"iPhone13,2"
com.apple.MobileSMS,4,1714337143,1714337147,1714337147.278754,-18000,EB445137-D7F5-57EC-87DA-1DB460D64046,"iPhone13,2"
com.apple.MobileSMS,25,1714337097,1714337122,1714337122.033224,-18000,EB445137-D7F5-57EC-87DA-1DB460D64046,"iPhone13,2"
com.hammerandchisel.discord,3,1714337094,1714337097,1714337097.7232342,-18000,EB445137-D7F5-57EC-87DA-1DB460D64046,"iPhone13,2"
com.hammerandchisel.discord,226,1714336771,1714336997,1714336997.175736,-18000,EB445137-D7F5-57EC-87DA-1DB460D64046,"iPhone13,2"
com.apple.camera,2,1714336767,1714336769,1714336769.926838,-18000,EB445137-D7F5-57EC-87DA-1DB460D64046,"iPhone13,2"
com.hammerandchisel.discord,4,1714336357,1714336361,1714336361.154105,-18000,EB445137-D7F5-57EC-87DA-1DB460D64046,"iPhone13,2"
com.hammerandchisel.discord,4,1714336258,1714336262,1714336262.9960818,-18000,EB445137-D7F5-57EC-87DA-1DB460D64046,"iPhone13,2"
com.hammerandchisel.discord,28,1714336230,1714336258,1714336258.5332599,-18000,EB445137-D7F5-57EC-87DA-1DB460D64046,"iPhone13,2"
edu.illinois.rokwire.ios,2,1714336228,1714336230,1714336230.904238,-18000,EB445137-D7F5-57EC-87DA-1DB460D64046,"iPhone13,2"
edu.illinois.rokwire.ios,2,1714336211,1714336213,1714336213.765081,-18000,EB445137-D7F5-57EC-87DA-1DB460D64046,"iPhone13,2"
edu.illinois.rokwire.ios,41,1714336119,1714336160,1714336160.864921,-18000,EB445137-D7F5-57EC-87DA-1DB460D64046,"iPhone13,2"
com.apple.Music,3,1714336113,1714336116,1714336116.445739,-18000,EB445137-D7F5-57EC-87DA-1DB460D64046,"iPhone13,2"
com.apple.Music,29,1714336060,1714336089,1714336089.3330941,-18000,EB445137-D7F5-57EC-87DA-1DB460D64046,"iPhone13,2"
com.apple.camera,4,1714336030,1714336034,1714336034.966768,-18000,EB445137-D7F5-57EC-87DA-1DB460D64046,"iPhone13,2"
com.apple.Music,8,1714336026,1714336034,1714336034.96531,-18000,EB445137-D7F5-57EC-87DA-1DB460D64046,"iPhone13,2"
com.apple.Music,2,1714335923,1714335925,1714335925.6063352,-18000,EB445137-D7F5-57EC-87DA-1DB460D64046,"iPhone13,2"
com.apple.Music,1,1714335921,1714335922,1714335922.22724,-18000,EB445137-D7F5-57EC-87DA-1DB460D64046,"iPhone13,2"
com.apple.Music,1,1714335777,1714335778,1714335778.761547,-18000,EB445137-D7F5-57EC-87DA-1DB460D64046,"iPhone13,2"
com.apple.Music,5,1714335772,1714335777,1714335777.059956,-18000,EB445137-D7F5-57EC-87DA-1DB460D64046,"iPhone13,2"
com.leomehlig.today,2,1714335713,1714335715,1714335715.328095,-18000,,
com.google.Chrome,2,1714335711,1714335713,1714335713.077783,-18000,,
com.leomehlig.today,0,1714335711,1714335711,1714335711.8583832,-18000,,
com.apple.Notes,2,1714335709,1714335711,1714335711.169119,-18000,,
com.leomehlig.today,70,1714335639,1714335709,1714335709.549244,-18000,,
com.google.Chrome,178,1714335461,1714335639,1714335639.1145039,-18000,,
com.leomehlig.today,34,1714335427,1714335461,1714335461.549096,-18000,,
com.google.Chrome,7,1714335420,1714335427,1714335427.689435,-18000,,
com.apple.Preview,64,1714335356,1714335420,1714335420.4037051,-18000,,
com.google.Chrome,23,1714335333,1714335356,1714335356.297151,-18000,,
com.apple.Preview,409,1714334924,1714335333,1714335333.1590672,-18000,,
com.apple.findmy,9,1714334787,1714334796,1714334796.2506552,-18000,EB445137-D7F5-57EC-87DA-1DB460D64046,"iPhone13,2"
com.google.Chrome,993,1714333931,1714334924,1714334924.1337562,-18000,,
com.hnc.Discord,30,1714333901,1714333931,1714333931.250411,-18000,,
com.google.Chrome,18,1714333883,1714333901,1714333901.043995,-18000,,
com.apple.Preview,27,1714333856,1714333883,1714333884.050818,-18000,,
com.google.Chrome,2,1714333854,1714333856,1714333856.525753,-18000,,
com.apple.Preview,260,1714333594,1714333854,1714333855.0864701,-18000,,
com.google.Chrome,9,1714333585,1714333594,1714333594.335806,-18000,,
com.apple.Preview,159,1714333426,1714333585,1714333585.655857,-18000,,
com.hammerandchisel.discord,6,1714333355,1714333361,1714333361.881134,-18000,EB445137-D7F5-57EC-87DA-1DB460D64046,"iPhone13,2"
com.google.Chrome,956,1714332470,1714333426,1714333426.525459,-18000,,
com.leomehlig.today,16,1714332454,1714332470,1714332470.784944,-18000,,
com.google.Chrome,205,1714332249,1714332454,1714332454.1186209,-18000,,
com.apple.Preview,214,1714332035,1714332249,1714332250.008745,-18000,,
com.apple.Preview,301,1714331733,1714332034,1714332034.024403,-18000,,
com.apple.Preview,302,1714331429,1714331731,1714331731.3143811,-18000,,
com.google.Chrome,2,1714331427,1714331429,1714331429.210743,-18000,,
com.apple.Preview,10,1714331417,1714331427,1714331427.201624,-18000,,
com.hammerandchisel.discord,79,1714331333,1714331412,1714331412.043155,-18000,EB445137-D7F5-57EC-87DA-1DB460D64046,"iPhone13,2"
com.apple.Music,17,1714331315,1714331332,1714331332.9461489,-18000,EB445137-D7F5-57EC-87DA-1DB460D64046,"iPhone13,2"
com.google.Chrome,137,1714331280,1714331417,1714331417.5118198,-18000,,
com.apple.Preview,29,1714331251,1714331280,1714331280.789274,-18000,,
com.apple.Music,6,1714331167,1714331173,1714331173.334937,-18000,EB445137-D7F5-57EC-87DA-1DB460D64046,"iPhone13,2"
com.apple.Music,9,1714331108,1714331117,1714331117.724401,-18000,EB445137-D7F5-57EC-87DA-1DB460D64046,"iPhone13,2"
com.apple.Music,7,1714331024,1714331031,1714331031.02192,-18000,EB445137-D7F5-57EC-87DA-1DB460D64046,"iPhone13,2"
com.apple.Music,9,1714330912,1714330921,1714330921.135114,-18000,EB445137-D7F5-57EC-87DA-1DB460D64046,"iPhone13,2"
com.apple.Preview,876,1714330354,1714331230,1714331230.9538178,-18000,,
com.google.Chrome,4,1714330350,1714330354,1714330354.839188,-18000,,
com.apple.Preview,11,1714330339,1714330350,1714330350.430385,-18000,,
com.google.Chrome,0,1714330339,1714330339,1714330340.0288072,-18000,,
com.apple.Preview,12,1714330327,1714330339,1714330339.168642,-18000,,
com.google.Chrome,5,1714330322,1714330327,1714330328.0202389,-18000,,
com.apple.Preview,14,1714330308,1714330322,1714330322.683281,-18000,,
com.google.Chrome,2,1714330306,1714330308,1714330308.900826,-18000,,
com.apple.Preview,4,1714330302,1714330306,1714330306.569782,-18000,,
com.google.Chrome,2,1714330300,1714330302,1714330302.449901,-18000,,
com.apple.Preview,5,1714330295,1714330300,1714330301.038574,-18000,,
com.google.Chrome,1,1714330294,1714330295,1714330295.086015,-18000,,
com.apple.Preview,2,1714330292,1714330294,1714330294.8500118,-18000,,
com.google.Chrome,5,1714330287,1714330292,1714330292.2129889,-18000,,
com.apple.Preview,1,1714330286,1714330287,1714330287.87844,-18000,,
com.google.Chrome,3,1714330283,1714330286,1714330286.7623348,-18000,,
com.apple.Preview,171,1714330112,1714330283,1714330283.5019321,-18000,,
com.leomehlig.today,12,1714330100,1714330112,1714330112.817272,-18000,,
com.apple.Music,11,1714329858,1714329869,1714329869.418159,-18000,EB445137-D7F5-57EC-87DA-1DB460D64046,"iPhone13,2"
com.apple.Preview,258,1714329842,1714330100,1714330100.687653,-18000,,
com.google.Chrome,18,1714329824,1714329842,1714329842.8976479,-18000,,
com.apple.Music,8,1714329565,1714329573,1714329573.15487,-18000,EB445137-D7F5-57EC-87DA-1DB460D64046,"iPhone13,2"
com.apple.Preview,324,1714329500,1714329824,1714329824.4544492,-18000,,
com.google.Chrome,4,1714329496,1714329500,1714329500.235007,-18000,,
com.apple.Music,8,1714329247,1714329255,1714329255.59746,-18000,EB445137-D7F5-57EC-87DA-1DB460D64046,"iPhone13,2"
com.apple.Preview,263,1714329233,1714329496,1714329496.274662,-18000,,
com.apple.Music,9,1714329202,1714329211,1714329211.6341891,-18000,EB445137-D7F5-57EC-87DA-1DB460D64046,"iPhone13,2"
com.google.Chrome,37,1714329196,1714329233,1714329233.205433,-18000,,
com.apple.Preview,2,1714329194,1714329196,1714329196.066786,-18000,,
com.google.Chrome,3,1714329191,1714329194,1714329194.971343,-18000,,
com.apple.Preview,100,1714329091,1714329191,1714329192.081949,-18000,,
com.apple.Music,22,1714328672,1714328694,1714328694.030023,-18000,EB445137-D7F5-57EC-87DA-1DB460D64046,"iPhone13,2"
com.tmsoft.WhiteNoiseLite,5,1714328665,1714328670,1714328670.957573,-18000,EB445137-D7F5-57EC-87DA-1DB460D64046,"iPhone13,2"
com.apple.Preview,427,1714328662,1714329089,1714329089.507039,-18000,,
com.google.Chrome,2,1714328660,1714328662,1714328662.754219,-18000,,
com.apple.Preview,107,1714328553,1714328660,1714328660.5711741,-18000,,
com.google.Chrome,5,1714328548,1714328553,1714328553.612879,-18000,,
com.apple.Preview,1,1714328547,1714328548,1714328548.8278198,-18000,,
com.google.Chrome,1,1714328546,1714328547,1714328547.194045,-18000,,
com.apple.Preview,1,1714328545,1714328546,1714328546.3169122,-18000,,
com.apple.finder,1,1714328544,1714328545,1714328545.468526,-18000,,
com.google.Chrome,4,1714328540,1714328544,1714328544.2758632,-18000,,
com.apple.finder,13,1714328527,1714328540,1714328540.33785,-18000,,
com.apple.Preview,0,1714328527,1714328527,1714328528.051702,-18000,,
com.apple.finder,4,1714328523,1714328527,1714328527.346262,-18000,,
com.google.Chrome,35,1714328488,1714328523,1714328523.961434,-18000,,
com.google.Chrome,3,1714327477,1714327480,1714327480.553488,-18000,,
com.leomehlig.today,1,1714327476,1714327477,1714327477.8181071,-18000,,
com.google.Chrome,12,1714327464,1714327476,1714327476.6789331,-18000,,
com.leomehlig.today,23,1714327441,1714327464,1714327464.600209,-18000,,
com.google.Chrome,115,1714327326,1714327441,1714327441.642528,-18000,,
com.leomehlig.today,63,1714327263,1714327326,1714327326.595138,-18000,,
com.google.Chrome,3,1714327260,1714327263,1714327263.604078,-18000,,
com.apple.finder,1,1714327259,1714327260,1714327260.905324,-18000,,
com.apple.Preview,1,1714327258,1714327259,1714327260.0859442,-18000,,
com.leomehlig.today,12,1714327246,1714327258,1714327259.019881,-18000,,
com.apple.Preview,6,1714327240,1714327246,1714327246.375822,-18000,,
com.apple.MobileSMS,4,1714327236,1714327240,1714327240.5613809,-18000,,
com.tmsoft.WhiteNoiseLite,9,1714323921,1714323930,1714323930.016454,-18000,EB445137-D7F5-57EC-87DA-1DB460D64046,"iPhone13,2"
com.apple.Preview,3359,1714323877,1714327236,1714327236.741653,-18000,,
com.apple.finder,9,1714323868,1714323877,1714323877.286386,-18000,,
com.google.Chrome,598,1714323270,1714323868,1714323868.915359,-18000,,
com.leomehlig.today,25,1714323245,1714323270,1714323270.874542,-18000,,
com.google.Gmail,9,1714322992,1714323001,1714323001.829962,-18000,EB445137-D7F5-57EC-87DA-1DB460D64046,"iPhone13,2"
com.apple.Health,5,1714322987,1714322992,1714322992.174165,-18000,EB445137-D7F5-57EC-87DA-1DB460D64046,"iPhone13,2"
com.apple.Health,7,1714322971,1714322978,1714322978.508379,-18000,EB445137-D7F5-57EC-87DA-1DB460D64046,"iPhone13,2"
com.apple.Health,5,1714322965,1714322970,1714322970.302785,-18000,EB445137-D7F5-57EC-87DA-1DB460D64046,"iPhone13,2"
com.apple.Health,27,1714321866,1714321893,1714321893.359782,-18000,EB445137-D7F5-57EC-87DA-1DB460D64046,"iPhone13,2"
com.microsoft.Office.Outlook,3,1714321863,1714321866,1714321866.638245,-18000,EB445137-D7F5-57EC-87DA-1DB460D64046,"iPhone13,2"
com.microsoft.Office.Outlook,3,1714321770,1714321773,1714321773.329867,-18000,EB445137-D7F5-57EC-87DA-1DB460D64046,"iPhone13,2"
com.microsoft.Office.Outlook,2,1714321725,1714321727,1714321727.613214,-18000,EB445137-D7F5-57EC-87DA-1DB460D64046,"iPhone13,2"
com.leomehlig.today,33,1714321690,1714321723,1714321723.949826,-18000,,
com.google.Chrome,7,1714321683,1714321690,1714321690.725613,-18000,,
com.apple.Notes,58,1714321625,1714321683,1714321683.980423,-18000,,
com.google.Chrome,11,1714321614,1714321625,1714321625.150687,-18000,,
com.apple.Notes,8,1714321606,1714321614,1714321614.45913,-18000,,
com.google.Chrome,15,1714321591,1714321606,1714321606.845365,-18000,,
com.apple.Notes,9,1714321582,1714321591,1714321591.668879,-18000,,
com.google.Chrome,2,1714321580,1714321582,1714321582.2166839,-18000,,
com.apple.Notes,8,1714321572,1714321580,1714321580.698872,-18000,,
com.google.Chrome,2,1714321570,1714321572,1714321572.867721,-18000,,
com.apple.Notes,2,1714321568,1714321570,1714321570.929697,-18000,,
com.google.Chrome,2,1714321566,1714321568,1714321568.306402,-18000,,
com.apple.Notes,3,1714321563,1714321566,1714321566.6433458,-18000,,
com.google.Chrome,1,1714321562,1714321563,1714321563.0606508,-18000,,
com.apple.Notes,3,1714321559,1714321562,1714321562.3620992,-18000,,
com.google.Chrome,1,1714321558,1714321559,1714321559.877859,-18000,,
com.apple.Notes,7,1714321551,1714321558,1714321558.28503,-18000,,
com.google.Chrome,1,1714321550,1714321551,1714321552.041384,-18000,,
com.apple.Notes,5,1714321545,1714321550,1714321550.8333158,-18000,,
com.google.Chrome,1,1714321544,1714321545,1714321545.552398,-18000,,
com.apple.Notes,5,1714321539,1714321544,1714321544.284116,-18000,,
com.google.Chrome,9,1714321530,1714321539,1714321539.620298,-18000,,
com.apple.Notes,3,1714321527,1714321530,1714321530.2809649,-18000,,
com.google.Chrome,2,1714321525,1714321527,1714321527.3440418,-18000,,
com.apple.Notes,3,1714321522,1714321525,1714321525.0674682,-18000,,
com.google.Chrome,0,1714321522,1714321522,1714321522.875947,-18000,,
com.apple.Notes,7,1714321515,1714321522,1714321522.355799,-18000,,
com.google.Chrome,1,1714321514,1714321515,1714321515.40282,-18000,,
com.apple.Notes,2,1714321512,1714321514,1714321514.641578,-18000,,
com.google.Chrome,1,1714321511,1714321512,1714321512.677411,-18000,,
com.apple.Notes,8,1714321503,1714321511,1714321511.592902,-18000,,
com.google.Chrome,2,1714321501,1714321503,1714321503.563085,-18000,,
com.apple.Notes,7,1714321494,1714321501,1714321501.370692,-18000,,
com.google.Chrome,6,1714321488,1714321494,1714321494.477613,-18000,,
com.apple.Notes,9,1714321479,1714321488,1714321488.961844,-18000,,
com.google.Chrome,5,1714321474,1714321479,1714321479.217849,-18000,,
com.apple.Notes,8,1714321466,1714321474,1714321474.124782,-18000,,
com.google.Chrome,1,1714321465,1714321466,1714321466.6877499,-18000,,
com.apple.Notes,4,1714321461,1714321465,1714321465.304905,-18000,,
com.google.Chrome,1,1714321460,1714321461,1714321461.692478,-18000,,
com.apple.Notes,4,1714321456,1714321460,1714321460.510889,-18000,,
com.google.Chrome,1,1714321455,1714321456,1714321456.992703,-18000,,
com.apple.Notes,3,1714321452,1714321455,1714321455.9837232,-18000,,
com.google.Chrome,1,1714321451,1714321452,1714321452.318562,-18000,,
com.apple.Notes,4,1714321447,1714321451,1714321451.366205,-18000,,
com.google.Chrome,1,1714321446,1714321447,1714321448.057527,-18000,,
com.apple.Notes,4,1714321442,1714321446,1714321446.729754,-18000,,
com.google.Chrome,1,1714321441,1714321442,1714321442.380461,-18000,,
com.apple.Notes,3,1714321438,1714321441,1714321441.809732,-18000,,
com.google.Chrome,0,1714321438,1714321438,1714321439.025257,-18000,,
com.apple.Notes,1,1714321437,1714321438,1714321438.278688,-18000,,
com.google.Chrome,1,1714321436,1714321437,1714321437.973969,-18000,,
com.apple.Notes,2,1714321434,1714321436,1714321436.888618,-18000,,
com.google.Chrome,2,1714321432,1714321434,1714321434.82824,-18000,,
com.apple.Notes,6,1714321426,1714321432,1714321432.924911,-18000,,
com.google.Chrome,5,1714321421,1714321426,1714321426.462453,-18000,,
com.apple.Notes,1,1714321420,1714321421,1714321421.828641,-18000,,
com.google.Chrome,3,1714321417,1714321420,1714321420.938174,-18000,,
com.apple.Notes,23,1714321394,1714321417,1714321417.194288,-18000,,
com.google.Chrome,7,1714321387,1714321394,1714321394.40307,-18000,,
com.apple.Notes,6,1714321381,1714321387,1714321387.983949,-18000,,
com.google.Chrome,3,1714321378,1714321381,1714321381.770637,-18000,,
com.apple.Notes,1,1714321377,1714321378,1714321378.852117,-18000,,
com.google.Chrome,2,1714321375,1714321377,1714321377.942727,-18000,,
com.apple.Notes,12,1714321363,1714321375,1714321375.993495,-18000,,
com.google.Chrome,6,1714321357,1714321363,1714321363.509665,-18000,,
com.apple.Notes,1,1714321356,1714321357,1714321357.545761,-18000,,
com.google.Chrome,4,1714321352,1714321356,1714321356.390151,-18000,,
com.apple.Notes,3,1714321349,1714321352,1714321353.0209842,-18000,,
com.google.Chrome,11,1714321338,1714321349,1714321349.218111,-18000,,
com.apple.Notes,26,1714321312,1714321338,1714321338.164556,-18000,,
com.google.Chrome,1,1714321311,1714321312,1714321312.913794,-18000,,
com.apple.Notes,2,1714321309,1714321311,1714321311.809849,-18000,,
com.google.Chrome,6,1714321303,1714321309,1714321309.5654259,-18000,,
com.apple.Notes,6,1714321297,1714321303,1714321303.844386,-18000,,
com.google.Chrome,3,1714321294,1714321297,1714321297.74249,-18000,,
com.apple.Notes,4,1714321290,1714321294,1714321294.415143,-18000,,
com.google.Chrome,8,1714321282,1714321290,1714321290.821538,-18000,,
com.apple.Notes,2,1714321280,1714321282,1714321282.39151,-18000,,
com.google.Chrome,15,1714321265,1714321280,1714321281.053382,-18000,,
com.apple.Notes,2,1714321263,1714321265,1714321265.965098,-18000,,
com.google.Chrome,3,1714321260,1714321263,1714321263.545682,-18000,,
com.apple.Notes,51,1714321209,1714321260,1714321260.314052,-18000,,
com.google.Chrome,5,1714321204,1714321209,1714321209.170048,-18000,,
com.apple.Notes,1,1714321203,1714321204,1714321204.653044,-18000,,
com.google.Chrome,8,1714321195,1714321203,1714321203.332343,-18000,,
com.apple.Notes,3,1714321192,1714321195,1714321195.993108,-18000,,
com.google.Chrome,10,1714321182,1714321192,1714321192.865505,-18000,,
com.apple.Notes,12,1714321170,1714321182,1714321182.689872,-18000,,
com.google.Chrome,8,1714321162,1714321170,1714321170.133965,-18000,,
com.apple.Notes,15,1714321147,1714321162,1714321162.846983,-18000,,
com.google.Chrome,11,1714321136,1714321147,1714321147.583673,-18000,,
com.apple.Notes,10,1714321126,1714321136,1714321136.4548988,-18000,,
com.google.Chrome,27,1714321099,1714321126,1714321126.9922051,-18000,,
com.apple.Notes,1,1714321098,1714321099,1714321099.906156,-18000,,
com.google.Chrome,6,1714321092,1714321098,1714321099.004538,-18000,,
com.apple.Notes,3,1714321089,1714321092,1714321093.047385,-18000,,
com.google.Chrome,3,1714321086,1714321089,1714321089.494454,-18000,,
com.apple.Notes,7,1714321079,1714321086,1714321086.701688,-18000,,
com.google.Chrome,14,1714321065,1714321079,1714321079.771064,-18000,,
com.apple.Notes,13,1714321052,1714321065,1714321065.30125,-18000,,
com.google.Chrome,18,1714321034,1714321052,1714321052.156579,-18000,,
com.apple.Notes,5,1714321029,1714321034,1714321034.840746,-18000,,
com.google.Chrome,2,1714321027,1714321029,1714321029.292445,-18000,,
com.apple.Notes,5,1714321022,1714321027,1714321027.761112,-18000,,
com.google.Chrome,35,1714320987,1714321022,1714321022.487753,-18000,,
com.apple.Notes,7,1714320980,1714320987,1714320987.948158,-18000,,
com.google.Chrome,16,1714320964,1714320980,1714320980.386064,-18000,,
com.apple.Notes,8,1714320956,1714320964,1714320964.591932,-18000,,
com.google.Chrome,38,1714320918,1714320956,1714320957.066781,-18000,,
com.apple.Notes,2,1714320916,1714320918,1714320918.319586,-18000,,
com.google.Chrome,7,1714320909,1714320916,1714320916.542109,-18000,,
com.apple.Notes,2,1714320907,1714320909,1714320909.854086,-18000,,
com.google.Chrome,1,1714320906,1714320907,1714320907.385212,-18000,,
com.apple.Notes,15,1714320891,1714320906,1714320906.1832108,-18000,,
com.google.Chrome,13,1714320878,1714320891,1714320891.412242,-18000,,
com.apple.Notes,1,1714320877,1714320878,1714320878.919646,-18000,,
com.google.Chrome,13,1714320864,1714320877,1714320877.0876698,-18000,,
com.apple.Notes,3,1714320861,1714320864,1714320864.244741,-18000,,
com.google.Chrome,60,1714320801,1714320861,1714320861.747746,-18000,,
com.apple.Notes,1,1714320800,1714320801,1714320801.693071,-18000,,
com.google.Chrome,1,1714320799,1714320800,1714320800.596655,-18000,,
com.apple.Notes,3,1714320796,1714320799,1714320799.818799,-18000,,
com.google.Chrome,14,1714320782,1714320796,1714320796.320998,-18000,,
com.apple.Notes,2,1714320780,1714320782,1714320782.317276,-18000,,
com.google.Chrome,5,1714320775,1714320780,1714320780.560467,-18000,,
com.apple.Notes,9,1714320766,1714320775,1714320775.4117808,-18000,,
com.google.Chrome,7,1714320759,1714320766,1714320766.497662,-18000,,
com.apple.Notes,2,1714320757,1714320759,1714320759.255817,-18000,,
com.google.Chrome,50,1714320707,1714320757,1714320757.849735,-18000,,
com.leomehlig.today,1,1714320706,1714320707,1714320707.358696,-18000,,
com.google.Chrome,15,1714320691,1714320706,1714320706.36057,-18000,,
com.apple.Notes,2,1714320689,1714320691,1714320691.963482,-18000,,
com.google.Chrome,6,1714320683,1714320689,1714320689.679936,-18000,,
com.apple.Notes,5,1714320678,1714320683,1714320683.463951,-18000,,
com.google.Chrome,6,1714320672,1714320678,1714320678.154324,-18000,,
com.apple.Notes,2,1714320670,1714320672,1714320672.2949572,-18000,,
com.google.Chrome,5,1714320665,1714320670,1714320670.495218,-18000,,
com.apple.Notes,8,1714320657,1714320665,1714320665.152326,-18000,,
com.google.Chrome,2,1714320655,1714320657,1714320657.534617,-18000,,
com.apple.Notes,3,1714320652,1714320655,1714320655.759628,-18000,,
com.google.Chrome,10,1714320642,1714320652,1714320652.8415189,-18000,,
com.apple.Notes,3,1714320639,1714320642,1714320642.791019,-18000,,
com.google.Chrome,3,1714320636,1714320639,1714320639.40064,-18000,,
com.apple.Notes,2,1714320634,1714320636,1714320636.874758,-18000,,
com.google.Chrome,6,1714320628,1714320634,1714320634.914867,-18000,,
com.apple.Notes,5,1714320623,1714320628,1714320628.702279,-18000,,
com.google.Chrome,15,1714320608,1714320623,1714320623.52733,-18000,,
com.apple.Notes,12,1714320596,1714320608,1714320609.008277,-18000,,
com.google.Chrome,14,1714320582,1714320596,1714320596.237037,-18000,,
com.apple.Notes,9,1714320573,1714320582,1714320583.0565438,-18000,,
com.google.Chrome,22,1714320551,1714320573,1714320573.799916,-18000,,
com.apple.Notes,8,1714320543,1714320551,1714320551.17176,-18000,,
com.google.Chrome,1,1714320542,1714320543,1714320543.717027,-18000,,
com.apple.Notes,2,1714320540,1714320542,1714320542.164952,-18000,,
com.google.Chrome,1,1714320539,1714320540,1714320540.344047,-18000,,
com.apple.Notes,3,1714320536,1714320539,1714320539.0764499,-18000,,
com.google.Chrome,2,1714320534,1714320536,1714320536.5238209,-18000,,
com.apple.Notes,1,1714320533,1714320534,1714320534.10362,-18000,,
com.google.Chrome,7,1714320526,1714320533,1714320533.141172,-18000,,
com.apple.Notes,2,1714320524,1714320526,1714320526.928807,-18000,,
com.google.Chrome,1,1714320523,1714320524,1714320524.133858,-18000,,
com.apple.Notes,5,1714320518,1714320523,1714320523.1927671,-18000,,
com.google.Chrome,2,1714320516,1714320518,1714320518.196851,-18000,,
com.apple.Notes,6,1714320510,1714320516,1714320517.048465,-18000,,
com.google.Chrome,7,1714320503,1714320510,1714320510.556394,-18000,,
com.apple.Notes,59,1714320444,1714320503,1714320503.494529,-18000,,
com.google.Chrome,61,1714320383,1714320444,1714320444.6709971,-18000,,
com.apple.Notes,8,1714320375,1714320383,1714320383.924652,-18000,,
com.google.Chrome,1,1714320374,1714320375,1714320375.8994331,-18000,,
com.apple.Notes,4,1714320370,1714320374,1714320374.9936981,-18000,,
com.google.Chrome,1,1714320369,1714320370,1714320370.676327,-18000,,
com.apple.Notes,5,1714320364,1714320369,1714320369.708909,-18000,,
com.google.Chrome,4,1714320360,1714320364,1714320364.9492989,-18000,,
com.apple.Notes,7,1714320353,1714320360,1714320360.816086,-18000,,
com.google.Chrome,4,1714320349,1714320353,1714320353.521363,-18000,,
com.apple.Notes,1,1714320348,1714320349,1714320349.915327,-18000,,
com.google.Chrome,1,1714320347,1714320348,1714320348.298205,-18000,,
com.apple.Notes,8,1714320339,1714320347,1714320347.13196,-18000,,
com.google.Chrome,2,1714320337,1714320339,1714320339.671362,-18000,,
com.apple.Notes,4,1714320333,1714320337,1714320338.066941,-18000,,
com.google.Chrome,1,1714320332,1714320333,1714320333.73399,-18000,,
com.apple.Notes,6,1714320326,1714320332,1714320332.7500448,-18000,,
com.google.Chrome,2,1714320324,1714320326,1714320326.387247,-18000,,
com.apple.Notes,10,1714320314,1714320324,1714320324.984395,-18000,,
com.google.Chrome,2,1714320312,1714320314,1714320314.267564,-18000,,
com.apple.Notes,9,1714320303,1714320312,1714320312.263891,-18000,,
com.google.Chrome,9,1714320294,1714320303,1714320303.157323,-18000,,
com.apple.Notes,12,1714320282,1714320294,1714320294.644089,-18000,,
com.google.Chrome,1,1714320281,1714320282,1714320282.737887,-18000,,
com.apple.Notes,4,1714320277,1714320281,1714320281.9473019,-18000,,
com.google.Chrome,1,1714320276,1714320277,1714320277.9279718,-18000,,
com.apple.Notes,2,1714320274,1714320276,1714320276.4634042,-18000,,
com.google.Chrome,0,1714320274,1714320274,1714320275.047319,-18000,,
com.apple.Notes,3,1714320271,1714320274,1714320274.398042,-18000,,
com.google.Chrome,1,1714320270,1714320271,1714320271.586864,-18000,,
com.apple.Notes,1,1714320269,1714320270,1714320271.017672,-18000,,
com.google.Chrome,1,1714320268,1714320269,1714320269.469686,-18000,,
com.apple.Notes,2,1714320266,1714320268,1714320268.5369291,-18000,,
com.google.Chrome,2,1714320264,1714320266,1714320266.16711,-18000,,
com.apple.Notes,7,1714320257,1714320264,1714320264.995843,-18000,,
com.google.Chrome,1,1714320256,1714320257,1714320257.741329,-18000,,
com.apple.Notes,6,1714320250,1714320256,1714320256.0886002,-18000,,
com.google.Chrome,2,1714320248,1714320250,1714320250.259252,-18000,,
com.apple.Notes,10,1714320238,1714320248,1714320249.058375,-18000,,
com.google.Chrome,3,1714320235,1714320238,1714320238.3912802,-18000,,
com.apple.Notes,6,1714320229,1714320235,1714320235.9410338,-18000,,
com.google.Chrome,1,1714320228,1714320229,1714320229.548623,-18000,,
com.apple.Notes,11,1714320217,1714320228,1714320228.153866,-18000,,
com.google.Chrome,9,1714320208,1714320217,1714320217.702553,-18000,,
com.apple.Notes,24,1714320184,1714320208,1714320208.900867,-18000,,
com.google.Chrome,1,1714320183,1714320184,1714320184.295405,-18000,,
com.apple.Notes,6,1714320177,1714320183,1714320183.20765,-18000,,
com.google.Chrome,2,1714320175,1714320177,1714320177.921742,-18000,,
com.apple.Notes,6,1714320169,1714320175,1714320175.616084,-18000,,
com.google.Chrome,1,1714320168,1714320169,1714320169.687055,-18000,,
com.apple.Notes,2,1714320166,1714320168,1714320168.362945,-18000,,
com.google.Chrome,1,1714320165,1714320166,1714320166.662725,-18000,,
com.apple.Notes,3,1714320162,1714320165,1714320165.725359,-18000,,
com.google.Chrome,1,1714320161,1714320162,1714320162.6632838,-18000,,
com.apple.Notes,2,1714320159,1714320161,1714320161.888777,-18000,,
com.google.Chrome,2,1714320157,1714320159,1714320160.0481749,-18000,,
com.apple.Notes,6,1714320151,1714320157,1714320157.1493921,-18000,,
com.google.Chrome,1,1714320150,1714320151,1714320151.5845141,-18000,,
com.apple.Notes,2,1714320148,1714320150,1714320151.024987,-18000,,
com.google.Chrome,0,1714320148,1714320148,1714320148.933371,-18000,,
com.apple.Notes,5,1714320143,1714320148,1714320148.224829,-18000,,
com.google.Chrome,1,1714320142,1714320143,1714320143.742569,-18000,,
com.apple.Notes,3,1714320139,1714320142,1714320142.468854,-18000,,
com.google.Chrome,14,1714320125,1714320139,1714320139.0910969,-18000,,
com.apple.Notes,14,1714320111,1714320125,1714320125.2116199,-18000,,
com.google.Chrome,4,1714320107,1714320111,1714320111.7012959,-18000,,
com.apple.Notes,4,1714320103,1714320107,1714320107.810217,-18000,,
com.google.Chrome,0,1714320103,1714320103,1714320103.784543,-18000,,
com.apple.Notes,4,1714320099,1714320103,1714320103.1621861,-18000,,
com.google.Chrome,4,1714320095,1714320099,1714320099.536806,-18000,,
com.apple.Notes,5,1714320090,1714320095,1714320095.791585,-18000,,
com.google.Chrome,1,1714320089,1714320090,1714320091.056364,-18000,,
com.apple.Notes,5,1714320084,1714320089,1714320089.838007,-18000,,
com.google.Chrome,1,1714320083,1714320084,1714320084.49387,-18000,,
com.apple.Notes,1,1714320082,1714320083,1714320083.8651462,-18000,,
com.google.Chrome,1,1714320081,1714320082,1714320082.19739,-18000,,
com.apple.Notes,2,1714320079,1714320081,1714320081.291734,-18000,,
com.google.Chrome,5,1714320074,1714320079,1714320079.520958,-18000,,
com.apple.Notes,7,1714320067,1714320074,1714320074.278199,-18000,,
com.google.Chrome,5,1714320062,1714320067,1714320067.5724092,-18000,,
com.apple.Notes,3,1714320059,1714320062,1714320062.6750178,-18000,,
com.google.Chrome,1,1714320058,1714320059,1714320059.369,-18000,,
com.apple.Notes,6,1714320052,1714320058,1714320058.155068,-18000,,
com.google.Chrome,13,1714320039,1714320052,1714320052.123001,-18000,,
com.apple.Notes,2,1714320037,1714320039,1714320039.504438,-18000,,
com.google.Chrome,1,1714320036,1714320037,1714320037.082605,-18000,,
com.apple.Notes,1,1714320035,1714320036,1714320036.613235,-18000,,
com.google.Chrome,1,1714320034,1714320035,1714320035.056301,-18000,,
com.apple.Notes,3,1714320031,1714320034,1714320034.2585201,-18000,,
com.google.Chrome,1,1714320030,1714320031,1714320031.3741589,-18000,,
com.apple.Notes,2,1714320028,1714320030,1714320030.838503,-18000,,
com.google.Chrome,5,1714320023,1714320028,1714320028.475624,-18000,,
com.apple.Notes,8,1714320015,1714320023,1714320024.182039,-18000,,
com.google.Chrome,6,1714320009,1714320015,1714320015.283648,-18000,,
com.apple.Notes,16,1714319993,1714320009,1714320009.311506,-18000,,
com.google.Chrome,12,1714319981,1714319993,1714319993.961843,-18000,,
com.apple.Notes,37,1714319944,1714319981,1714319981.1348839,-18000,,
com.google.Chrome,1,1714319943,1714319944,1714319944.2540321,-18000,,
com.apple.Notes,2,1714319941,1714319943,1714319943.445967,-18000,,
com.google.Chrome,1,1714319940,1714319941,1714319941.424014,-18000,,
com.apple.Notes,6,1714319934,1714319940,1714319940.7146559,-18000,,
com.google.Chrome,2,1714319932,1714319934,1714319934.1295872,-18000,,
com.apple.Notes,3,1714319929,1714319932,1714319932.740044,-18000,,
com.google.Chrome,4,1714319925,1714319929,1714319929.8379931,-18000,,
com.apple.Notes,6,1714319919,1714319925,1714319925.1997418,-18000,,
com.google.Chrome,1,1714319918,1714319919,1714319919.5825171,-18000,,
com.apple.Notes,4,1714319914,1714319918,1714319918.496263,-18000,,
com.google.Chrome,2,1714319912,1714319914,1714319914.5997992,-18000,,
com.apple.Notes,4,1714319908,1714319912,1714319912.526427,-18000,,
com.google.Chrome,1,1714319907,1714319908,1714319908.7837439,-18000,,
com.apple.Notes,5,1714319902,1714319907,1714319907.4343262,-18000,,
com.google.Chrome,2,1714319900,1714319902,1714319902.768375,-18000,,
com.apple.Notes,3,1714319897,1714319900,1714319900.298613,-18000,,
com.google.Chrome,1,1714319896,1714319897,1714319897.420144,-18000,,
com.apple.Notes,8,1714319888,1714319896,1714319896.235355,-18000,,
com.google.Chrome,2,1714319886,1714319888,1714319888.537303,-18000,,
com.apple.Notes,14,1714319872,1714319886,1714319886.679935,-18000,,
com.google.Chrome,17,1714319855,1714319872,1714319872.174035,-18000,,
com.apple.Notes,2,1714319853,1714319855,1714319855.6722069,-18000,,
com.google.Chrome,1,1714319852,1714319853,1714319853.430779,-18000,,
com.apple.Notes,2,1714319850,1714319852,1714319852.826847,-18000,,
com.google.Chrome,2,1714319848,1714319850,1714319850.242801,-18000,,
com.apple.Notes,3,1714319845,1714319848,1714319848.312799,-18000,,
com.google.Chrome,1,1714319844,1714319845,1714319845.963495,-18000,,
com.apple.Notes,17,1714319827,1714319844,1714319844.743741,-18000,,
com.google.Chrome,1,1714319826,1714319827,1714319828.01011,-18000,,
com.apple.Notes,4,1714319822,1714319826,1714319826.671418,-18000,,
com.google.Chrome,1,1714319821,1714319822,1714319822.303122,-18000,,
com.apple.Notes,12,1714319809,1714319821,1714319821.252458,-18000,,
com.google.Chrome,2,1714319807,1714319809,1714319809.215561,-18000,,
com.apple.Notes,2,1714319805,1714319807,1714319807.686833,-18000,,
com.google.Chrome,1,1714319804,1714319805,1714319805.861675,-18000,,
com.apple.Notes,2,1714319802,1714319804,1714319804.839791,-18000,,
com.google.Chrome,2,1714319800,1714319802,1714319802.137982,-18000,,
com.apple.Notes,8,1714319792,1714319800,1714319800.940706,-18000,,
com.google.Chrome,15,1714319777,1714319792,1714319792.900439,-18000,,
com.apple.Notes,2,1714319775,1714319777,1714319777.411951,-18000,,
com.google.Chrome,4,1714319771,1714319775,1714319776.040575,-18000,,
com.apple.Notes,1,1714319770,1714319771,1714319772.058862,-18000,,
com.google.Chrome,140,1714319630,1714319770,1714319770.7793632,-18000,,
com.apple.Notes,4,1714319626,1714319630,1714319630.269609,-18000,,
com.google.Chrome,2,1714319624,1714319626,1714319626.4714499,-18000,,
com.apple.Notes,7,1714319617,1714319624,1714319624.611144,-18000,,
com.google.Chrome,1,1714319616,1714319617,1714319617.211056,-18000,,
com.apple.Notes,4,1714319612,1714319616,1714319616.4756498,-18000,,
com.google.Chrome,1,1714319611,1714319612,1714319612.648356,-18000,,
com.apple.Notes,7,1714319604,1714319611,1714319611.184241,-18000,,
com.google.Chrome,1,1714319603,1714319604,1714319604.38313,-18000,,
com.apple.Notes,5,1714319598,1714319603,1714319603.366255,-18000,,
com.google.Chrome,6,1714319592,1714319598,1714319598.1540508,-18000,,
com.apple.Notes,8,1714319584,1714319592,1714319593.012703,-18000,,
com.google.Chrome,5,1714319579,1714319584,1714319584.964416,-18000,,
com.apple.Notes,27,1714319552,1714319579,1714319580.00752,-18000,,
com.google.Chrome,1,1714319551,1714319552,1714319552.4740338,-18000,,
com.apple.Notes,8,1714319543,1714319551,1714319551.844388,-18000,,
com.google.Chrome,3,1714319540,1714319543,1714319543.3877358,-18000,,
com.apple.Notes,5,1714319535,1714319540,1714319540.990281,-18000,,
com.google.Chrome,2,1714319533,1714319535,1714319535.506114,-18000,,
com.apple.Notes,4,1714319529,1714319533,1714319533.098758,-18000,,
com.google.Chrome,1,1714319528,1714319529,1714319529.997199,-18000,,
com.apple.Notes,8,1714319520,1714319528,1714319528.18227,-18000,,
com.google.Chrome,1,1714319519,1714319520,1714319520.8485641,-18000,,
com.apple.Notes,5,1714319514,1714319519,1714319520.008565,-18000,,
com.google.Chrome,0,1714319514,1714319514,1714319514.830573,-18000,,
com.apple.Notes,3,1714319511,1714319514,1714319514.132262,-18000,,
com.google.Chrome,1,1714319510,1714319511,1714319511.543126,-18000,,
com.apple.Notes,4,1714319506,1714319510,1714319511.027456,-18000,,
com.google.Chrome,0,1714319506,1714319506,1714319506.97049,-18000,,
com.apple.Notes,4,1714319502,1714319506,1714319506.218951,-18000,,
com.google.Chrome,5,1714319497,1714319502,1714319502.413239,-18000,,
com.apple.Notes,11,1714319486,1714319497,1714319497.490232,-18000,,
com.google.Chrome,2,1714319484,1714319486,1714319486.836158,-18000,,
com.apple.Notes,53,1714319431,1714319484,1714319484.3688068,-18000,,
com.google.Chrome,26,1714319405,1714319431,1714319431.779265,-18000,,
com.apple.Notes,5,1714319400,1714319405,1714319405.19575,-18000,,
com.google.Chrome,3,1714319397,1714319400,1714319400.507924,-18000,,
com.apple.Notes,2,1714319395,1714319397,1714319397.1432729,-18000,,
com.google.Chrome,5,1714319390,1714319395,1714319395.510982,-18000,,
com.apple.Notes,3,1714319387,1714319390,1714319390.909204,-18000,,
com.google.Chrome,24,1714319363,1714319387,1714319387.142555,-18000,,
com.apple.Notes,52,1714319311,1714319363,1714319363.149524,-18000,,
com.google.Chrome,4,1714319307,1714319311,1714319311.22641,-18000,,
com.apple.Notes,2,1714319305,1714319307,1714319307.422326,-18000,,
com.google.Chrome,6,1714319299,1714319305,1714319305.4898791,-18000,,
com.apple.Notes,4,1714319295,1714319299,1714319299.640884,-18000,,
com.google.Chrome,7,1714319288,1714319295,1714319295.9985762,-18000,,
com.apple.Notes,8,1714319280,1714319288,1714319288.3657122,-18000,,
com.google.Chrome,3,1714319277,1714319280,1714319281.0449119,-18000,,
com.apple.Notes,2,1714319275,1714319277,1714319277.115539,-18000,,
com.google.Chrome,4,1714319271,1714319275,1714319275.33646,-18000,,
com.apple.Notes,20,1714319251,1714319271,1714319271.22177,-18000,,
com.google.Chrome,4,1714319247,1714319251,1714319251.527629,-18000,,
com.apple.Notes,1,1714319246,1714319247,1714319247.659729,-18000,,
com.google.Chrome,14,1714319232,1714319246,1714319246.326298,-18000,,
com.apple.Notes,14,1714319196,1714319210,1714319210.625227,-18000,,
com.google.Chrome,53,1714319143,1714319196,1714319196.809534,-18000,,
com.leomehlig.today,22,1714319121,1714319143,1714319143.245903,-18000,,
com.apple.finder,8,1714319113,1714319121,1714319121.560835,-18000,,
com.apple.Preview,25,1714319088,1714319113,1714319113.353901,-18000,,
com.microsoft.Outlook,11,1714319077,1714319088,1714319088.216529,-18000,,
com.google.Chrome,51,1714319026,1714319077,1714319077.566042,-18000,,
com.microsoft.Outlook,9,1714319005,1714319014,1714319015.1163921,-18000,,
com.microsoft.Office.Outlook,11,1714318992,1714319003,1714319003.590891,-18000,EB445137-D7F5-57EC-87DA-1DB460D64046,"iPhone13,2"
com.apple.PosterBoard,2,1714318970,1714318972,1714318972.847003,-18000,EB445137-D7F5-57EC-87DA-1DB460D64046,"iPhone13,2"
com.apple.MobileSMS,61,1714318944,1714319005,1714319005.272379,-18000,,
com.google.Chrome,48,1714318896,1714318944,1714318944.13622,-18000,,
com.leomehlig.today,3,1714318893,1714318896,1714318896.958178,-18000,,
com.google.Chrome,166,1714318727,1714318893,1714318893.149854,-18000,,
com.leomehlig.today,1,1714318726,1714318727,1714318727.538095,-18000,,
com.google.Chrome,49,1714318677,1714318726,1714318726.933644,-18000,,
com.leomehlig.today,1,1714318676,1714318677,1714318677.211935,-18000,,
com.google.Chrome,303,1714318373,1714318676,1714318676.779954,-18000,,
com.leomehlig.today,2,1714318371,1714318373,1714318373.284754,-18000,,
com.google.Chrome,165,1714318206,1714318371,1714318371.211546,-18000,,
com.apple.Preview,1,1714318205,1714318206,1714318206.1757069,-18000,,
com.google.Chrome,419,1714317786,1714318205,1714318205.37507,-18000,,
com.apple.Preview,1,1714317785,1714317786,1714317786.700525,-18000,,
com.google.Chrome,46,1714317739,1714317785,1714317785.944921,-18000,,
com.apple.Preview,3,1714317736,1714317739,1714317739.279212,-18000,,
com.google.Chrome,8,1714317728,1714317736,1714317737.0421572,-18000,,
com.apple.Preview,1,1714317727,1714317728,1714317728.236176,-18000,,
com.google.Chrome,90,1714317637,1714317727,1714317727.483973,-18000,,
com.apple.Preview,1,1714317636,1714317637,1714317637.7222009,-18000,,
com.google.Chrome,1,1714317635,1714317636,1714317636.9149818,-18000,,
com.apple.Preview,4,1714317631,1714317635,1714317635.735272,-18000,,
com.google.Chrome,134,1714317497,1714317631,1714317631.4080381,-18000,,
com.apple.Preview,0,1714317497,1714317497,1714317497.9969,-18000,,
com.google.Chrome,14,1714317483,1714317497,1714317497.1871161,-18000,,
com.apple.Preview,12,1714317471,1714317483,1714317483.6192598,-18000,,
com.google.Chrome,144,1714317327,1714317471,1714317471.886833,-18000,,
com.apple.Preview,9,1714317318,1714317327,1714317327.8334398,-18000,,
com.google.Chrome,222,1714317096,1714317318,1714317318.918222,-18000,,
com.apple.Preview,3,1714317093,1714317096,1714317096.277096,-18000,,
com.google.Chrome,306,1714316787,1714317093,1714317093.502617,-18000,,
com.apple.Preview,1,1714316786,1714316787,1714316787.7966309,-18000,,
com.apple.finder,0,1714316786,1714316786,1714316786.6685681,-18000,,
com.apple.Preview,1,1714316785,1714316786,1714316786.189962,-18000,,
com.google.Chrome,439,1714316346,1714316785,1714316785.364862,-18000,,
com.apple.systempreferences,19,1714316327,1714316346,1714316346.4630508,-18000,,
com.google.Chrome,15,1714316304,1714316319,1714316319.79932,-18000,,
com.apple.Preview,15,1714316289,1714316304,1714316304.799042,-18000,,
com.google.Chrome,86,1714316203,1714316289,1714316289.985529,-18000,,
com.apple.Preview,24,1714316179,1714316203,1714316204.041141,-18000,,
com.google.Chrome,1,1714316178,1714316179,1714316179.187233,-18000,,
com.apple.Preview,12,1714316166,1714316178,1714316178.204946,-18000,,
com.google.Chrome,80,1714316086,1714316166,1714316166.717986,-18000,,
com.apple.Preview,8,1714316078,1714316086,1714316086.857218,-18000,,
com.google.Chrome,18,1714316060,1714316078,1714316078.628906,-18000,,
com.apple.Preview,1,1714316059,1714316060,1714316060.872041,-18000,,
com.google.Chrome,43,1714316016,1714316059,1714316059.539175,-18000,,
com.apple.Preview,1,1714316015,1714316016,1714316016.655686,-18000,,
com.google.Chrome,16,1714315999,1714316015,1714316015.889628,-18000,,
com.apple.Preview,1,1714315998,1714315999,1714315999.654859,-18000,,
com.google.Chrome,41,1714315957,1714315998,1714315998.869382,-18000,,
com.apple.Preview,1,1714315956,1714315957,1714315958.0295448,-18000,,
com.google.Chrome,31,1714315925,1714315956,1714315957.038271,-18000,,
com.apple.Preview,4,1714315921,1714315925,1714315925.2761369,-18000,,
com.google.Chrome,4,1714315917,1714315921,1714315921.893203,-18000,,
com.apple.Preview,14,1714315903,1714315917,1714315917.3795729,-18000,,
com.google.Chrome,45,1714315858,1714315903,1714315903.0685248,-18000,,
com.apple.Preview,1,1714315857,1714315858,1714315858.384046,-18000,,
com.google.Chrome,5,1714315852,1714315857,1714315857.736816,-18000,,
com.apple.Preview,3,1714315849,1714315852,1714315852.791061,-18000,,
com.google.Chrome,2,1714315847,1714315849,1714315849.8144941,-18000,,
com.apple.Preview,2,1714315845,1714315847,1714315847.090642,-18000,,
com.google.Chrome,7,1714315838,1714315845,1714315845.974333,-18000,,
com.apple.Preview,5,1714315833,1714315838,1714315839.060673,-18000,,
com.google.Chrome,221,1714315612,1714315833,1714315833.990571,-18000,,
com.apple.Preview,6,1714315606,1714315612,1714315612.596994,-18000,,
com.google.Chrome,5,1714315601,1714315606,1714315606.5467792,-18000,,
com.apple.Preview,8,1714315593,1714315601,1714315601.550667,-18000,,
com.google.Chrome,1,1714315592,1714315593,1714315593.93639,-18000,,
com.apple.finder,1,1714315591,1714315592,1714315592.5297232,-18000,,
com.google.Chrome,11,1714315580,1714315591,1714315591.53615,-18000,,
com.apple.finder,1,1714315579,1714315580,1714315580.351964,-18000,,
com.apple.Preview,145,1714315434,1714315579,1714315579.0873919,-18000,,
com.apple.finder,8,1714315426,1714315434,1714315434.921422,-18000,,
com.google.Chrome,24,1714315402,1714315426,1714315426.819813,-18000,,
com.leomehlig.today,95,1714315307,1714315402,1714315403.528862,-18000,,
com.apple.Preferences,13,1714315291,1714315304,1714315304.6264238,-18000,EB445137-D7F5-57EC-87DA-1DB460D64046,"iPhone13,2"
com.apple.Preferences,83,1714315206,1714315289,1714315289.061417,-18000,EB445137-D7F5-57EC-87DA-1DB460D64046,"iPhone13,2"
com.google.chrome.ios,23,1714312143,1714312166,1714312167.2274752,-18000,EB445137-D7F5-57EC-87DA-1DB460D64046,"iPhone13,2"
com.apple.camera,22,1714310867,1714310889,1714310889.992581,-18000,EB445137-D7F5-57EC-87DA-1DB460D64046,"iPhone13,2"
com.apple.camera,0,1714310856,1714310856,1714310856.927993,-18000,EB445137-D7F5-57EC-87DA-1DB460D64046,"iPhone13,2"
com.apple.camera,1,1714310854,1714310855,1714310855.659535,-18000,EB445137-D7F5-57EC-87DA-1DB460D64046,"iPhone13,2"
com.apple.camera,12,1714310825,1714310837,1714310837.913011,-18000,EB445137-D7F5-57EC-87DA-1DB460D64046,"iPhone13,2"
com.apple.camera,8,1714310807,1714310815,1714310815.951733,-18000,EB445137-D7F5-57EC-87DA-1DB460D64046,"iPhone13,2"
com.apple.podcasts,5,1714310806,1714310811,1714310812.177794,-18000,EB445137-D7F5-57EC-87DA-1DB460D64046,"iPhone13,2"
com.apple.podcasts,7,1714309795,1714309802,1714309802.2797298,-18000,EB445137-D7F5-57EC-87DA-1DB460D64046,"iPhone13,2"
com.apple.podcasts,69,1714309696,1714309765,1714309766.591389,-18000,EB445137-D7F5-57EC-87DA-1DB460D64046,"iPhone13,2"
com.apple.Health,6,1714309679,1714309685,1714309685.975909,-18000,EB445137-D7F5-57EC-87DA-1DB460D64046,"iPhone13,2"
com.apple.weather,5,1714309671,1714309676,1714309676.2308831,-18000,EB445137-D7F5-57EC-87DA-1DB460D64046,"iPhone13,2"
com.apple.weather,2,1714309623,1714309625,1714309625.671502,-18000,EB445137-D7F5-57EC-87DA-1DB460D64046,"iPhone13,2"
com.apple.weather,25,1714309340,1714309365,1714309365.747706,-18000,EB445137-D7F5-57EC-87DA-1DB460D64046,"iPhone13,2"
com.google.Gmail,8,1714309331,1714309339,1714309339.551149,-18000,EB445137-D7F5-57EC-87DA-1DB460D64046,"iPhone13,2"
com.thestorygraph.thestorygraph,18,1714278761,1714278779,1714278779.361695,-18000,EB445137-D7F5-57EC-87DA-1DB460D64046,"iPhone13,2"
com.thestorygraph.thestorygraph,16,1714278737,1714278753,1714278753.0668921,-18000,EB445137-D7F5-57EC-87DA-1DB460D64046,"iPhone13,2"
com.leomehlig.today,4,1714276508,1714276512,1714276512.736002,-18000,,
com.leomehlig.today,31,1714276348,1714276379,1714276379.860797,-18000,,
com.apple.finder,1,1714276347,1714276348,1714276348.6311831,-18000,,
com.google.Chrome,56,1714276291,1714276347,1714276347.194823,-18000,,
com.google.Chrome,412,1714275793,1714276205,1714276205.504215,-18000,,
com.google.Chrome,520,1714275182,1714275702,1714275702.157161,-18000,,
com.google.Chrome,323,1714273961,1714274284,1714274284.4824739,-18000,,
com.google.Chrome,417,1714272954,1714273371,1714273371.675554,-18000,,
com.microsoft.Outlook,8,1714272946,1714272954,1714272954.322112,-18000,,
com.google.Chrome,175,1714272771,1714272946,1714272946.495844,-18000,,
com.microsoft.Outlook,5,1714272684,1714272689,1714272689.634921,-18000,,
com.google.Chrome,17,1714272667,1714272684,1714272684.120472,-18000,,
com.microsoft.Outlook,4,1714272663,1714272667,1714272667.979425,-18000,,
com.google.Chrome,15,1714272648,1714272663,1714272664.023907,-18000,,
com.google.Chrome,13,1714267007,1714267020,1714267020.461029,-18000,,
com.leomehlig.today,73,1714266934,1714267007,1714267007.836938,-18000,,
com.google.Chrome,1,1714266933,1714266934,1714266934.8986878,-18000,,
com.leomehlig.today,25,1714266908,1714266933,1714266933.588923,-18000,,
com.google.Chrome,38,1714266870,1714266908,1714266908.414641,-18000,,
com.leomehlig.today,107,1714266763,1714266870,1714266871.000063,-18000,,
com.google.Chrome,8,1714266755,1714266763,1714266763.406705,-18000,,
com.leomehlig.today,38,1714266717,1714266755,1714266755.559397,-18000,,
com.apple.Preview,12,1714266705,1714266717,1714266717.311805,-18000,,
com.google.Chrome,28,1714266677,1714266705,1714266705.2358851,-18000,,
com.apple.Preview,113,1714266564,1714266677,1714266677.968632,-18000,,
com.google.Chrome,232,1714266332,1714266564,1714266564.380941,-18000,,
com.apple.Preview,7,1714266325,1714266332,1714266332.27945,-18000,,
com.google.Chrome,7,1714266318,1714266325,1714266325.111913,-18000,,
com.apple.Preview,25,1714266293,1714266318,1714266318.725136,-18000,,
com.google.Chrome,5,1714266288,1714266293,1714266293.980048,-18000,,
com.apple.Preview,4,1714266284,1714266288,1714266288.3176808,-18000,,
com.google.Chrome,3,1714266281,1714266284,1714266284.4288101,-18000,,
com.apple.Preview,4,1714266277,1714266281,1714266281.945143,-18000,,
com.google.Chrome,19,1714266258,1714266277,1714266277.557349,-18000,,
com.apple.Preview,21,1714266237,1714266258,1714266258.440178,-18000,,
com.google.Chrome,1,1714266236,1714266237,1714266237.88525,-18000,,
com.apple.Preview,34,1714266202,1714266236,1714266236.3871899,-18000,,
com.google.Chrome,29,1714266173,1714266202,1714266202.070581,-18000,,
com.leomehlig.today,4,1714266169,1714266173,1714266173.177949,-18000,,
com.google.Chrome,6,1714266163,1714266169,1714266169.295335,-18000,,
com.apple.Preview,126,1714266037,1714266163,1714266163.248999,-18000,,
com.google.Chrome,1,1714266036,1714266037,1714266037.1410332,-18000,,
com.apple.Preview,35,1714266001,1714266036,1714266036.253734,-18000,,
com.google.Chrome,4,1714265997,1714266001,1714266001.9295568,-18000,,
com.apple.Preview,253,1714265744,1714265997,1714265997.1702828,-18000,,
com.google.Chrome,2,1714265742,1714265744,1714265744.5599399,-18000,,
com.apple.Preview,8,1714265734,1714265742,1714265742.646198,-18000,,
com.google.Chrome,8,1714265726,1714265734,1714265734.528637,-18000,,
com.apple.Preview,20,1714265706,1714265726,1714265726.824792,-18000,,
com.apple.Preview,300,1714265398,1714265698,1714265698.494945,-18000,,
com.apple.Preview,300,1714265087,1714265387,1714265387.720488,-18000,,
com.apple.Preview,300,1714264786,1714265086,1714265086.353356,-18000,,
com.google.Chrome,11,1714264775,1714264786,1714264786.351418,-18000,,
com.apple.Preview,51,1714264724,1714264775,1714264775.561656,-18000,,
com.apple.Preview,653,1714264047,1714264700,1714264700.372174,-18000,,
com.leomehlig.today,8,1714264039,1714264047,1714264047.940095,-18000,,
com.apple.Preview,263,1714263776,1714264039,1714264039.4753032,-18000,,
com.google.Chrome,23,1714263753,1714263776,1714263776.172122,-18000,,
com.apple.Music,4,1714263749,1714263753,1714263753.508257,-18000,,
com.google.Chrome,1,1714263748,1714263749,1714263750.0195231,-18000,,
com.apple.Music,23,1714263725,1714263748,1714263748.73367,-18000,,
com.google.Chrome,14,1714263711,1714263725,1714263725.374912,-18000,,
com.apple.Preview,18,1714263693,1714263711,1714263711.170195,-18000,,
com.google.Chrome,10,1714263683,1714263693,1714263693.8120542,-18000,,
com.apple.Preview,4,1714263679,1714263683,1714263683.676567,-18000,,
com.apple.finder,7,1714263672,1714263679,1714263679.794242,-18000,,
com.apple.Preview,2,1714263670,1714263672,1714263672.5034099,-18000,,
com.apple.finder,7,1714263663,1714263670,1714263670.611226,-18000,,
com.google.Chrome,531,1714263132,1714263663,1714263663.965869,-18000,,
com.leomehlig.today,4,1714263128,1714263132,1714263132.576487,-18000,,
com.apple.iCal,21,1714263107,1714263128,1714263128.4738579,-18000,,
com.leomehlig.today,6,1714263101,1714263107,1714263107.8178759,-18000,,
com.apple.iCal,52,1714263049,1714263101,1714263101.811197,-18000,,
com.google.Chrome,2,1714263047,1714263049,1714263049.6555781,-18000,,
com.google.Chrome,317,1714262659,1714262976,1714262976.152251,-18000,,
com.leomehlig.today,22,1714262630,1714262652,1714262652.3269649,-18000,,
com.google.Chrome,1,1714262629,1714262630,1714262630.8474479,-18000,,
com.microsoft.onenote.mac,454,1714262175,1714262629,1714262629.330326,-18000,,
com.google.Chrome,727,1714261448,1714262175,1714262175.521987,-18000,,
com.apple.finder,1,1714261447,1714261448,1714261448.224746,-18000,,
com.google.Chrome,52,1714261395,1714261447,1714261447.390857,-18000,,
com.google.Chrome,1,1714255229,1714255230,1714255231.061265,-18000,,
com.google.Chrome,3,1714255226,1714255229,1714255229.067162,-18000,,
com.leomehlig.today,196,1714255030,1714255226,1714255226.788902,-18000,,
com.google.Chrome,14,1714255016,1714255030,1714255030.567498,-18000,,
com.leomehlig.today,14,1714255002,1714255016,1714255016.5973191,-18000,,
com.google.Chrome,1816,1714253186,1714255002,1714255003.054463,-18000,,
com.leomehlig.today,35,1714253151,1714253186,1714253186.895465,-18000,,
com.google.Chrome,29,1714253122,1714253151,1714253151.740893,-18000,,
com.apple.Preview,32,1714253090,1714253122,1714253122.6060262,-18000,,
com.google.Chrome,2,1714253088,1714253090,1714253090.6935558,-18000,,
com.apple.Preview,3,1714253085,1714253088,1714253088.330672,-18000,,
com.google.Chrome,3,1714253082,1714253085,1714253085.840063,-18000,,
com.apple.Preview,2,1714253080,1714253082,1714253082.435729,-18000,,
com.google.Chrome,4,1714253076,1714253080,1714253080.205009,-18000,,
com.apple.Preview,1,1714253075,1714253076,1714253076.794044,-18000,,
com.google.Chrome,2,1714253073,1714253075,1714253075.631799,-18000,,
com.apple.Preview,2,1714253071,1714253073,1714253073.374146,-18000,,
com.google.Chrome,5,1714253066,1714253071,1714253071.629809,-18000,,
com.apple.Preview,1,1714253065,1714253066,1714253066.962206,-18000,,
com.google.Chrome,9,1714253056,1714253065,1714253065.122715,-18000,,
com.apple.Preview,3,1714253053,1714253056,1714253056.200562,-18000,,
com.google.Chrome,2,1714253051,1714253053,1714253054.017192,-18000,,
com.apple.Preview,1,1714253050,1714253051,1714253051.6293101,-18000,,
com.google.Chrome,4,1714253046,1714253050,1714253050.555272,-18000,,
com.apple.Preview,1,1714253045,1714253046,1714253046.6362,-18000,,
com.google.Chrome,9,1714253036,1714253045,1714253045.597064,-18000,,
com.apple.Preview,64,1714252972,1714253036,1714253037.0858889,-18000,,
com.apple.finder,5,1714252967,1714252972,1714252972.203563,-18000,,
com.google.Chrome,187,1714252780,1714252967,1714252967.298038,-18000,,
com.apple.systempreferences,1,1714252698,1714252699,1714252699.3191419,-18000,,
com.google.Chrome,29,1714252662,1714252691,1714252691.232905,-18000,,
com.leomehlig.today,39,1714252623,1714252662,1714252662.2911348,-18000,,
com.apple.iCal,52,1714252571,1714252623,1714252623.141224,-18000,,
com.leomehlig.today,7,1714252564,1714252571,1714252571.8914552,-18000,,
com.google.Chrome,13,1714252551,1714252564,1714252564.7292361,-18000,,
com.google.Chrome,168,1714243622,1714243790,1714243790.021007,-18000,,
com.google.Chrome,50,1714237007,1714237057,1714237057.987124,-18000,,
com.microsoft.VSCode,47,1714236960,1714237007,1714237007.930225,-18000,,
com.google.Chrome,21,1714236939,1714236960,1714236960.5538712,-18000,,
com.google.Chrome,92,1714235127,1714235219,1714235219.9311,-18000,,
com.google.Chrome,100,1714234418,1714234518,1714234519.513901,-18000,,
com.google.Chrome,1137,1714233274,1714234411,1714234411.401428,-18000,,
com.microsoft.VSCode,3,1714233271,1714233274,1714233274.5743098,-18000,,
com.google.Chrome,105,1714233166,1714233271,1714233271.3134441,-18000,,
com.leomehlig.today,1,1714233165,1714233166,1714233166.779975,-18000,,
com.leomehlig.today,2,1714228161,1714228163,1714228164.0089378,-18000,,
com.leomehlig.today,26,1714228132,1714228158,1714228158.4460049,-18000,,
com.google.Chrome,12,1714228120,1714228132,1714228132.058741,-18000,,
com.leomehlig.today,12,1714228108,1714228120,1714228121.005879,-18000,,
com.google.Chrome,37,1714228071,1714228108,1714228108.246746,-18000,,
com.apple.finder,1,1714228070,1714228071,1714228071.940681,-18000,,
com.microsoft.Outlook,0,1714228070,1714228070,1714228070.833391,-18000,,
com.apple.finder,1,1714228069,1714228070,1714228070.283467,-18000,,
com.microsoft.Outlook,1,1714228068,1714228069,1714228069.754466,-18000,,
com.google.Chrome,478,1714227590,1714228068,1714228068.799121,-18000,,
com.apple.MobileSMS,4,1714227586,1714227590,1714227590.458941,-18000,,
com.apple.MobileSMS,113,1714177328,1714177441,1714177441.6647491,-18000,,
com.google.Chrome,75,1714177253,1714177328,1714177328.6827822,-18000,,
com.microsoft.Outlook,9,1714177244,1714177253,1714177253.9606838,-18000,,
com.google.Chrome,6,1714177238,1714177244,1714177244.25155,-18000,,
com.apple.MobileSMS,11,1714177227,1714177238,1714177238.604899,-18000,,
com.google.Chrome,10,1714177217,1714177227,1714177228.022056,-18000,,
com.google.Chrome,7,1714175599,1714175606,1714175606.686943,-18000,,
com.microsoft.onenote.mac,9,1714175590,1714175599,1714175599.710603,-18000,,
com.apple.MobileSMS,1,1714175589,1714175590,1714175590.789768,-18000,,
com.microsoft.onenote.mac,3,1714175586,1714175589,1714175589.896792,-18000,,
com.google.Chrome,3,1714175583,1714175586,1714175586.770889,-18000,,
com.leomehlig.today,72,1714175511,1714175583,1714175583.323776,-18000,,
com.google.Chrome,5,1714175506,1714175511,1714175511.907227,-18000,,
com.apple.MobileSMS,5,1714175501,1714175506,1714175506.947567,-18000,,
com.google.Chrome,22,1714175479,1714175501,1714175501.937622,-18000,,
com.apple.MobileSMS,19,1714175460,1714175479,1714175479.3785338,-18000,,
com.google.Chrome,449,1714175011,1714175460,1714175460.6514459,-18000,,
com.apple.MobileSMS,7,1714175004,1714175011,1714175011.7881541,-18000,,
com.google.Chrome,90,1714174914,1714175004,1714175004.3362699,-18000,,
com.apple.MobileSMS,204,1714174710,1714174914,1714174914.196309,-18000,,
com.google.Chrome,35,1714174675,1714174710,1714174710.793329,-18000,,
com.microsoft.VSCode,1023,1714173652,1714174675,1714174675.663595,-18000,,
com.google.Chrome,3,1714173649,1714173652,1714173652.600384,-18000,,
com.microsoft.VSCode,506,1714173143,1714173649,1714173649.62233,-18000,,
com.google.Chrome,5,1714173138,1714173143,1714173143.781791,-18000,,
com.microsoft.VSCode,60,1714173078,1714173138,1714173138.841938,-18000,,
com.google.Chrome,3,1714173075,1714173078,1714173078.061154,-18000,,
com.microsoft.VSCode,3,1714173072,1714173075,1714173076.001117,-18000,,
com.google.Chrome,9,1714173063,1714173072,1714173072.4662452,-18000,,
com.microsoft.VSCode,391,1714172672,1714173063,1714173063.121619,-18000,,
com.google.Chrome,10,1714172662,1714172672,1714172672.268647,-18000,,
com.microsoft.VSCode,565,1714172097,1714172662,1714172662.551433,-18000,,
com.apple.MobileSMS,67,1714172030,1714172097,1714172097.210197,-18000,,
com.microsoft.VSCode,113,1714171917,1714172030,1714172031.010809,-18000,,
com.google.Chrome,10,1714171907,1714171917,1714171917.3837209,-18000,,
com.apple.MobileSMS,9,1714171898,1714171907,1714171907.0513,-18000,,
com.google.Chrome,3,1714171895,1714171898,1714171898.520189,-18000,,
com.apple.MobileSMS,14,1714171881,1714171895,1714171895.057555,-18000,,
com.google.Chrome,23,1714171858,1714171881,1714171881.11889,-18000,,
com.apple.MobileSMS,1,1714171857,1714171858,1714171858.218686,-18000,,
com.google.Chrome,6,1714171851,1714171857,1714171857.600079,-18000,,
com.apple.MobileSMS,1,1714171850,1714171851,1714171851.072088,-18000,,
com.google.Chrome,59,1714171791,1714171850,1714171850.138587,-18000,,
com.apple.MobileSMS,1,1714171790,1714171791,1714171791.6931791,-18000,,
com.google.Chrome,98,1714171692,1714171790,1714171790.876298,-18000,,
com.apple.MobileSMS,19,1714171673,1714171692,1714171692.3178449,-18000,,
com.google.Chrome,1,1714171672,1714171673,1714171673.710445,-18000,,
com.apple.MobileSMS,3,1714171669,1714171672,1714171672.6017408,-18000,,
com.google.Chrome,29,1714171640,1714171669,1714171669.642648,-18000,,
com.apple.MobileSMS,21,1714171619,1714171640,1714171640.1499019,-18000,,
com.google.Chrome,12,1714171607,1714171619,1714171619.288643,-18000,,
com.apple.MobileSMS,0,1714171607,1714171607,1714171607.94461,-18000,,
com.google.Chrome,92,1714171515,1714171607,1714171607.0311918,-18000,,
com.apple.MobileSMS,1,1714171514,1714171515,1714171515.449592,-18000,,
com.google.Chrome,15,1714171499,1714171514,1714171514.4523082,-18000,,
com.apple.MobileSMS,1,1714171498,1714171499,1714171499.133061,-18000,,
com.google.Chrome,1,1714171497,1714171498,1714171498.518964,-18000,,
com.apple.MobileSMS,1,1714171496,1714171497,1714171497.691719,-18000,,
com.google.Chrome,34,1714171462,1714171496,1714171496.194172,-18000,,
com.apple.MobileSMS,6,1714171456,1714171462,1714171462.5382771,-18000,,
com.google.Chrome,14,1714171442,1714171456,1714171456.7995992,-18000,,
com.apple.MobileSMS,21,1714171421,1714171442,1714171442.6250582,-18000,,
com.google.Chrome,37,1714171384,1714171421,1714171421.2338018,-18000,,
com.microsoft.onenote.mac,2,1714171382,1714171384,1714171384.622981,-18000,,
com.microsoft.onenote.mac,2,1714171240,1714171242,1714171242.647496,-18000,,
com.google.Chrome,180,1714171060,1714171240,1714171240.410492,-18000,,
com.microsoft.onenote.mac,74,1714170986,1714171060,1714171062.0123038,-18000,,
com.google.Chrome,760,1714170226,1714170986,1714170986.321527,-18000,,
com.apple.finder,11,1714170210,1714170221,1714170221.343199,-18000,,
com.microsoft.Excel,10,1714170200,1714170210,1714170210.276537,-18000,,
com.apple.finder,5,1714170195,1714170200,1714170200.6514568,-18000,,
com.apple.TextEdit,10,1714170185,1714170195,1714170195.5068998,-18000,,
com.microsoft.Excel,315,1714169870,1714170185,1714170185.425654,-18000,,
com.apple.finder,12,1714169858,1714169870,1714169870.653633,-18000,,
com.apple.TextEdit,13,1714169845,1714169858,1714169858.404211,-18000,,
com.apple.finder,5,1714169840,1714169845,1714169845.090348,-18000,,
com.leomehlig.today,1,1714169839,1714169840,1714169840.466683,-18000,,
com.microsoft.Excel,25,1714169814,1714169839,1714169840.034277,-18000,,
com.leomehlig.today,11,1714169803,1714169814,1714169814.398542,-18000,,
com.microsoft.Excel,1,1714169802,1714169803,1714169803.427765,-18000,,
com.leomehlig.today,5,1714169797,1714169802,1714169802.254829,-18000,,
com.microsoft.Excel,1,1714169796,1714169797,1714169797.961098,-18000,,
com.leomehlig.today,4,1714169792,1714169796,1714169796.685396,-18000,,
com.microsoft.Excel,1,1714169791,1714169792,1714169792.740067,-18000,,
com.leomehlig.today,1,1714169790,1714169791,1714169791.425949,-18000,,
com.microsoft.Excel,2,1714169788,1714169790,1714169790.112705,-18000,,
com.leomehlig.today,8,1714169780,1714169788,1714169788.147629,-18000,,
com.microsoft.Excel,2,1714169778,1714169780,1714169780.3959088,-18000,,
com.leomehlig.today,10,1714169768,1714169778,1714169778.163107,-18000,,
com.microsoft.Excel,7,1714169761,1714169768,1714169768.343734,-18000,,
com.leomehlig.today,7,1714169754,1714169761,1714169761.216949,-18000,,
com.microsoft.Excel,3,1714169751,1714169754,1714169754.618703,-18000,,
com.leomehlig.today,5,1714169746,1714169751,1714169751.2929091,-18000,,
com.microsoft.Excel,1,1714169745,1714169746,1714169746.6752071,-18000,,
com.leomehlig.today,5,1714169740,1714169745,1714169745.344686,-18000,,
com.microsoft.Excel,2,1714169738,1714169740,1714169740.9289908,-18000,,
com.leomehlig.today,15,1714169723,1714169738,1714169738.2879848,-18000,,
com.microsoft.Excel,2,1714169721,1714169723,1714169723.677627,-18000,,
com.leomehlig.today,5,1714169716,1714169721,1714169721.171776,-18000,,
com.microsoft.Excel,1,1714169715,1714169716,1714169716.202774,-18000,,
com.leomehlig.today,0,1714169715,1714169715,1714169715.836173,-18000,,
com.microsoft.Excel,4,1714169711,1714169715,1714169715.1980639,-18000,,
com.leomehlig.today,5,1714169706,1714169711,1714169711.982389,-18000,,
com.microsoft.Excel,2,1714169704,1714169706,1714169706.3543239,-18000,,
com.leomehlig.today,9,1714169695,1714169704,1714169704.923164,-18000,,
com.microsoft.Excel,1,1714169694,1714169695,1714169695.386029,-18000,,
com.leomehlig.today,7,1714169687,1714169694,1714169694.435061,-18000,,
com.microsoft.Excel,3,1714169684,1714169687,1714169687.699379,-18000,,
com.leomehlig.today,8,1714169676,1714169684,1714169684.732325,-18000,,
com.microsoft.Excel,2,1714169674,1714169676,1714169676.437725,-18000,,
com.leomehlig.today,6,1714169668,1714169674,1714169674.105386,-18000,,
com.microsoft.Excel,1,1714169667,1714169668,1714169668.216515,-18000,,
com.leomehlig.today,0,1714169667,1714169667,1714169667.89461,-18000,,
com.microsoft.Excel,1,1714169666,1714169667,1714169667.148207,-18000,,
com.leomehlig.today,1,1714169665,1714169666,1714169666.325286,-18000,,
com.microsoft.Excel,2,1714169663,1714169665,1714169665.130317,-18000,,
com.leomehlig.today,6,1714169657,1714169663,1714169663.42136,-18000,,
com.microsoft.Excel,3,1714169654,1714169657,1714169657.0796242,-18000,,
com.leomehlig.today,7,1714169647,1714169654,1714169654.993071,-18000,,
com.microsoft.Excel,1,1714169646,1714169647,1714169647.368226,-18000,,
com.leomehlig.today,5,1714169641,1714169646,1714169646.13926,-18000,,
com.microsoft.Excel,5,1714169636,1714169641,1714169641.891794,-18000,,
com.leomehlig.today,15,1714169621,1714169636,1714169636.525094,-18000,,
com.microsoft.Excel,1,1714169620,1714169621,1714169621.434649,-18000,,
com.leomehlig.today,2,1714169618,1714169620,1714169620.103914,-18000,,
com.microsoft.Excel,2,1714169616,1714169618,1714169618.557979,-18000,,
com.leomehlig.today,2,1714169614,1714169616,1714169617.008479,-18000,,
com.microsoft.Excel,1,1714169613,1714169614,1714169614.444035,-18000,,
com.leomehlig.today,2,1714169611,1714169613,1714169613.16054,-18000,,
com.microsoft.Excel,2,1714169609,1714169611,1714169611.091888,-18000,,
com.leomehlig.today,2,1714169607,1714169609,1714169609.437436,-18000,,
com.microsoft.Excel,0,1714169607,1714169607,1714169607.8347821,-18000,,
com.leomehlig.today,2,1714169605,1714169607,1714169607.31534,-18000,,
com.microsoft.Excel,2,1714169603,1714169605,1714169605.384211,-18000,,
com.leomehlig.today,9,1714169594,1714169603,1714169603.7709131,-18000,,
com.microsoft.Excel,1,1714169593,1714169594,1714169594.90975,-18000,,
com.leomehlig.today,5,1714169588,1714169593,1714169593.126295,-18000,,
com.microsoft.Excel,6,1714169582,1714169588,1714169588.583813,-18000,,
com.leomehlig.today,5,1714169577,1714169582,1714169582.1976938,-18000,,
com.microsoft.Excel,2,1714169575,1714169577,1714169577.6820521,-18000,,
com.leomehlig.today,7,1714169568,1714169575,1714169575.8070111,-18000,,
com.apple.MobileSMS,21,1714169547,1714169568,1714169568.423295,-18000,,
com.leomehlig.today,7,1714169540,1714169547,1714169547.502809,-18000,,
com.microsoft.Excel,3,1714169537,1714169540,1714169540.972291,-18000,,
com.leomehlig.today,1,1714169536,1714169537,1714169537.974709,-18000,,
com.microsoft.Excel,0,1714169536,1714169536,1714169536.900114,-18000,,
com.leomehlig.today,1,1714169535,1714169536,1714169536.069629,-18000,,
com.microsoft.Excel,2,1714169533,1714169535,1714169535.347004,-18000,,
com.leomehlig.today,2,1714169531,1714169533,1714169533.306174,-18000,,
com.microsoft.Excel,2,1714169529,1714169531,1714169531.400611,-18000,,
com.leomehlig.today,9,1714169520,1714169529,1714169529.464474,-18000,,
com.microsoft.Excel,1,1714169519,1714169520,1714169521.004552,-18000,,
com.leomehlig.today,0,1714169519,1714169519,1714169520.0465488,-18000,,
com.microsoft.Excel,4,1714169515,1714169519,1714169519.3216028,-18000,,
com.leomehlig.today,6,1714169509,1714169515,1714169515.902316,-18000,,
com.microsoft.Excel,5,1714169504,1714169509,1714169509.306857,-18000,,
com.leomehlig.today,6,1714169498,1714169504,1714169504.287118,-18000,,
com.microsoft.Excel,4,1714169494,1714169498,1714169498.389826,-18000,,
com.leomehlig.today,15,1714169479,1714169494,1714169495.024889,-18000,,
com.microsoft.Excel,1,1714169478,1714169479,1714169479.721901,-18000,,
com.leomehlig.today,2,1714169476,1714169478,1714169478.245345,-18000,,
com.microsoft.Excel,1,1714169475,1714169476,1714169476.271377,-18000,,
com.leomehlig.today,8,1714169467,1714169475,1714169475.6285539,-18000,,
com.microsoft.Excel,1,1714169466,1714169467,1714169467.31745,-18000,,
com.leomehlig.today,1,1714169465,1714169466,1714169466.317377,-18000,,
com.microsoft.Excel,1,1714169464,1714169465,1714169465.304712,-18000,,
com.leomehlig.today,7,1714169457,1714169464,1714169464.10903,-18000,,
com.microsoft.Excel,2,1714169455,1714169457,1714169457.7512178,-18000,,
com.leomehlig.today,14,1714169441,1714169455,1714169455.294495,-18000,,
com.microsoft.Excel,2,1714169439,1714169441,1714169441.599852,-18000,,
com.leomehlig.today,3,1714169436,1714169439,1714169439.558099,-18000,,
com.microsoft.Excel,2,1714169434,1714169436,1714169436.110302,-18000,,
com.leomehlig.today,14,1714169420,1714169434,1714169434.7046208,-18000,,
com.microsoft.Excel,2,1714169418,1714169420,1714169420.672925,-18000,,
com.leomehlig.today,6,1714169412,1714169418,1714169418.137878,-18000,,
com.microsoft.Excel,2,1714169410,1714169412,1714169412.832704,-18000,,
com.leomehlig.today,5,1714169405,1714169410,1714169410.929658,-18000,,
com.microsoft.Excel,2,1714169403,1714169405,1714169405.725301,-18000,,
com.leomehlig.today,10,1714169393,1714169403,1714169403.690974,-18000,,
com.microsoft.Excel,2,1714169391,1714169393,1714169393.2581139,-18000,,
com.leomehlig.today,2,1714169389,1714169391,1714169392.041072,-18000,,
com.microsoft.Excel,1,1714169388,1714169389,1714169389.6922522,-18000,,
com.leomehlig.today,2,1714169386,1714169388,1714169388.806113,-18000,,
com.microsoft.Excel,0,1714169386,1714169386,1714169387.027264,-18000,,
com.leomehlig.today,4,1714169382,1714169386,1714169386.131031,-18000,,
com.microsoft.Excel,2,1714169380,1714169382,1714169382.305059,-18000,,
com.leomehlig.today,1,1714169379,1714169380,1714169380.893079,-18000,,
com.microsoft.Excel,4,1714169375,1714169379,1714169379.27758,-18000,,
com.leomehlig.today,5,1714169370,1714169375,1714169375.624789,-18000,,
com.microsoft.Excel,2,1714169368,1714169370,1714169370.772039,-18000,,
com.leomehlig.today,4,1714169364,1714169368,1714169368.562094,-18000,,
com.microsoft.Excel,1,1714169363,1714169364,1714169364.544179,-18000,,
com.leomehlig.today,7,1714169356,1714169363,1714169363.21328,-18000,,
com.microsoft.Excel,1,1714169355,1714169356,1714169356.3670511,-18000,,
com.leomehlig.today,5,1714169350,1714169355,1714169355.365402,-18000,,
com.microsoft.Excel,2,1714169348,1714169350,1714169350.38537,-18000,,
com.leomehlig.today,11,1714169337,1714169348,1714169348.831262,-18000,,
com.microsoft.Excel,8,1714169329,1714169337,1714169337.479846,-18000,,
com.leomehlig.today,11,1714169318,1714169329,1714169329.381688,-18000,,
com.microsoft.Excel,0,1714169318,1714169318,1714169318.701641,-18000,,
com.leomehlig.today,6,1714169312,1714169318,1714169318.128574,-18000,,
com.microsoft.Excel,4,1714169308,1714169312,1714169312.368177,-18000,,
com.leomehlig.today,3,1714169305,1714169308,1714169308.959584,-18000,,
com.microsoft.Excel,6,1714169299,1714169305,1714169305.538585,-18000,,
com.leomehlig.today,2,1714169297,1714169299,1714169299.238288,-18000,,
com.microsoft.Excel,4,1714169293,1714169297,1714169297.67542,-18000,,
com.leomehlig.today,8,1714169285,1714169293,1714169293.784319,-18000,,
com.microsoft.Excel,6,1714169279,1714169285,1714169285.395502,-18000,,
com.leomehlig.today,9,1714169270,1714169279,1714169279.838455,-18000,,
com.microsoft.Excel,1,1714169269,1714169270,1714169270.8910031,-18000,,
com.leomehlig.today,9,1714169260,1714169269,1714169269.735487,-18000,,
com.microsoft.Excel,3,1714169257,1714169260,1714169260.163204,-18000,,
com.leomehlig.today,3,1714169254,1714169257,1714169257.428667,-18000,,
com.microsoft.Excel,3,1714169251,1714169254,1714169254.285295,-18000,,
com.leomehlig.today,1,1714169250,1714169251,1714169252.025363,-18000,,
com.microsoft.Excel,4,1714169246,1714169250,1714169250.476152,-18000,,
com.leomehlig.today,8,1714169238,1714169246,1714169246.363945,-18000,,
com.microsoft.Excel,3,1714169235,1714169238,1714169238.250051,-18000,,
com.leomehlig.today,4,1714169231,1714169235,1714169235.714004,-18000,,
com.microsoft.Excel,6,1714169225,1714169231,1714169231.324276,-18000,,
com.leomehlig.today,3,1714169222,1714169225,1714169225.904403,-18000,,
com.microsoft.Excel,2,1714169220,1714169222,1714169222.653022,-18000,,
com.leomehlig.today,9,1714169211,1714169220,1714169221.0126681,-18000,,
com.microsoft.Excel,4,1714169207,1714169211,1714169211.615018,-18000,,
com.leomehlig.today,5,1714169202,1714169207,1714169207.057407,-18000,,
com.microsoft.Excel,6,1714169196,1714169202,1714169202.129754,-18000,,
com.leomehlig.today,3,1714169193,1714169196,1714169196.373019,-18000,,
com.microsoft.Excel,9,1714169184,1714169193,1714169193.578676,-18000,,
com.leomehlig.today,13,1714169171,1714169184,1714169184.526448,-18000,,
com.microsoft.Excel,20,1714169151,1714169171,1714169171.0588279,-18000,,
com.apple.finder,20,1714169131,1714169151,1714169152.038838,-18000,,
com.google.Chrome,4,1714169127,1714169131,1714169131.97595,-18000,,
com.google.Chrome,3,1714169011,1714169014,1714169014.5274038,-18000,,
com.leomehlig.today,23,1714168988,1714169011,1714169011.714247,-18000,,
com.microsoft.Outlook,67,1714168921,1714168988,1714168988.727205,-18000,,
com.leomehlig.today,6,1714168915,1714168921,1714168921.1492882,-18000,,
com.apple.finder,1,1714168914,1714168915,1714168915.9121962,-18000,,
com.microsoft.Outlook,3,1714168911,1714168914,1714168914.0763922,-18000,,
com.microsoft.VSCode,4,1714168907,1714168911,1714168911.119108,-18000,,
com.google.Chrome,28,1714168879,1714168907,1714168908.476892,-18000,,
com.microsoft.VSCode,3,1714168876,1714168879,1714168879.672741,-18000,,
com.google.Chrome,15,1714168861,1714168876,1714168876.2467551,-18000,,
com.microsoft.Outlook,9,1714168852,1714168861,1714168861.868472,-18000,,
com.google.Chrome,2,1714168850,1714168852,1714168852.8734841,-18000,,
com.apple.MobileSMS,9,1714168841,1714168850,1714168850.526435,-18000,,
com.google.Chrome,1,1714168840,1714168841,1714168841.924819,-18000,,
com.microsoft.Outlook,74,1714168766,1714168840,1714168840.369913,-18000,,
com.google.Chrome,9,1714168757,1714168766,1714168766.1369271,-18000,,
com.microsoft.Outlook,22,1714168735,1714168757,1714168757.421588,-18000,,
com.leomehlig.today,17,1714168718,1714168735,1714168735.8991199,-18000,,
com.microsoft.Outlook,4,1714168714,1714168718,1714168718.089301,-18000,,
com.google.Chrome,6,1714168708,1714168714,1714168714.8589869,-18000,,
com.apple.MobileSMS,15,1714168693,1714168708,1714168708.619947,-18000,,
com.google.Chrome,19,1714168674,1714168693,1714168693.101228,-18000,,
com.apple.MobileSMS,34,1714168640,1714168674,1714168674.444361,-18000,,
com.google.Chrome,358,1714168282,1714168640,1714168640.139961,-18000,,
com.microsoft.VSCode,1,1714168281,1714168282,1714168283.025521,-18000,,
com.google.Chrome,22,1714168259,1714168281,1714168282.014596,-18000,,
com.microsoft.VSCode,2,1714168257,1714168259,1714168259.2900019,-18000,,
com.google.Chrome,37,1714168220,1714168257,1714168257.914721,-18000,,
com.microsoft.VSCode,4,1714168216,1714168220,1714168220.571883,-18000,,
com.google.Chrome,30,1714168186,1714168216,1714168216.731848,-18000,,
com.microsoft.VSCode,13,1714168173,1714168186,1714168186.9397779,-18000,,
com.google.Chrome,3,1714168170,1714168173,1714168173.608774,-18000,,
com.microsoft.VSCode,1,1714168169,1714168170,1714168170.6211739,-18000,,
com.google.Chrome,14,1714168155,1714168169,1714168169.583637,-18000,,
com.microsoft.VSCode,6,1714168149,1714168155,1714168155.071848,-18000,,
com.google.Chrome,13,1714168136,1714168149,1714168149.077561,-18000,,
com.microsoft.VSCode,9,1714168127,1714168136,1714168136.52065,-18000,,
com.google.Chrome,4,1714168123,1714168127,1714168127.061696,-18000,,
com.microsoft.VSCode,2,1714168121,1714168123,1714168123.3303618,-18000,,
com.google.Chrome,2,1714168119,1714168121,1714168121.917541,-18000,,
com.microsoft.VSCode,20,1714168099,1714168119,1714168119.120405,-18000,,
com.google.Chrome,192,1714167907,1714168099,1714168099.550836,-18000,,
com.microsoft.VSCode,2,1714167905,1714167907,1714167907.6343222,-18000,,
com.google.Chrome,529,1714167376,1714167905,1714167905.227035,-18000,,
com.microsoft.VSCode,32,1714167344,1714167376,1714167376.626274,-18000,,
com.google.Chrome,42,1714167302,1714167344,1714167344.370358,-18000,,
us.zoom.xos,1,1714167301,1714167302,1714167302.5462809,-18000,,
com.google.Chrome,91,1714167210,1714167301,1714167301.161113,-18000,,
us.zoom.xos,1,1714167209,1714167210,1714167210.830532,-18000,,
com.google.Chrome,172,1714167037,1714167209,1714167209.504569,-18000,,
us.zoom.xos,4,1714167033,1714167037,1714167037.376062,-18000,,
com.leomehlig.today,1,1714167032,1714167033,1714167033.5516071,-18000,,
com.google.Chrome,271,1714166761,1714167032,1714167032.723485,-18000,,
com.google.Chrome,25,1714165340,1714165365,1714165365.756998,-18000,,
com.leomehlig.today,7,1714165333,1714165340,1714165340.418333,-18000,,
com.google.Chrome,2,1714165331,1714165333,1714165333.307701,-18000,,
com.microsoft.VSCode,3,1714165328,1714165331,1714165331.697075,-18000,,
com.google.Chrome,11,1714165317,1714165328,1714165328.05202,-18000,,
com.apple.findmy,7,1714165310,1714165317,1714165317.9091802,-18000,,
com.google.Chrome,61,1714165249,1714165310,1714165310.264818,-18000,,
us.zoom.xos,4,1714165245,1714165249,1714165249.164962,-18000,,
com.google.Chrome,5,1714165240,1714165245,1714165245.884578,-18000,,
us.zoom.xos,4,1714165236,1714165240,1714165240.451796,-18000,,
com.google.Chrome,11,1714165225,1714165236,1714165236.61942,-18000,,
us.zoom.xos,2,1714165223,1714165225,1714165225.546571,-18000,,
com.google.Chrome,6,1714165217,1714165223,1714165223.154078,-18000,,
com.microsoft.VSCode,6,1714165211,1714165217,1714165217.5489058,-18000,,
com.google.Chrome,5,1714165206,1714165211,1714165211.523737,-18000,,
com.microsoft.VSCode,20,1714165186,1714165206,1714165206.704467,-18000,,
com.google.Chrome,92,1714165094,1714165186,1714165186.931989,-18000,,
com.microsoft.VSCode,14,1714165080,1714165094,1714165094.669353,-18000,,
com.google.Chrome,30,1714165050,1714165080,1714165080.357827,-18000,,
us.zoom.xos,0,1714165050,1714165050,1714165051.034066,-18000,,
com.microsoft.VSCode,10,1714165040,1714165050,1714165050.237764,-18000,,
us.zoom.xos,1,1714165039,1714165040,1714165040.162231,-18000,,
com.google.Chrome,68,1714164971,1714165039,1714165039.268299,-18000,,
us.zoom.xos,1,1714164970,1714164971,1714164971.429861,-18000,,
com.google.Chrome,14,1714164956,1714164970,1714164970.51859,-18000,,
us.zoom.xos,3,1714164953,1714164956,1714164956.9975982,-18000,,
com.google.Chrome,6,1714164947,1714164953,1714164953.872371,-18000,,
com.microsoft.VSCode,1,1714164946,1714164947,1714164947.6619592,-18000,,
com.google.Chrome,17,1714164929,1714164946,1714164946.962012,-18000,,
com.microsoft.VSCode,57,1714164872,1714164929,1714164929.6941252,-18000,,
com.google.Chrome,2,1714164870,1714164872,1714164872.584311,-18000,,
us.zoom.xos,1,1714164869,1714164870,1714164870.2555299,-18000,,
com.google.Chrome,1,1714164868,1714164869,1714164869.502022,-18000,,
us.zoom.xos,1,1714164867,1714164868,1714164868.1686401,-18000,,
com.google.Chrome,52,1714164815,1714164867,1714164867.414651,-18000,,
us.zoom.xos,1,1714164814,1714164815,1714164816.013921,-18000,,
com.google.Chrome,17,1714164797,1714164814,1714164814.138741,-18000,,
com.microsoft.VSCode,52,1714164745,1714164797,1714164797.1814709,-18000,,
com.google.Chrome,4,1714164741,1714164745,1714164745.530037,-18000,,
com.microsoft.VSCode,120,1714164621,1714164741,1714164741.792664,-18000,,
us.zoom.xos,1,1714164620,1714164621,1714164621.106528,-18000,,
com.microsoft.VSCode,1,1714164619,1714164620,1714164620.5399761,-18000,,
us.zoom.xos,335,1714164284,1714164619,1714164619.841517,-18000,,
com.google.Chrome,22,1714164262,1714164284,1714164284.119612,-18000,,
us.zoom.xos,7,1714164255,1714164262,1714164262.494333,-18000,,
com.google.Chrome,0,1714164255,1714164255,1714164256.0196872,-18000,,
us.zoom.xos,3,1714164252,1714164255,1714164255.5100842,-18000,,
com.google.Chrome,8,1714164244,1714164252,1714164252.9551768,-18000,,
us.zoom.xos,5,1714164239,1714164244,1714164244.980818,-18000,,
com.google.Chrome,4,1714164235,1714164239,1714164239.757971,-18000,,
us.zoom.xos,1,1714164234,1714164235,1714164235.7011971,-18000,,
com.google.Chrome,29,1714164205,1714164234,1714164234.343759,-18000,,
us.zoom.xos,1,1714164204,1714164205,1714164205.608068,-18000,,
com.microsoft.VSCode,3,1714164201,1714164204,1714164204.846393,-18000,,
us.zoom.xos,1,1714164200,1714164201,1714164201.81637,-18000,,
com.microsoft.VSCode,1,1714164199,1714164200,1714164200.965018,-18000,,
com.google.Chrome,38,1714164161,1714164199,1714164199.354751,-18000,,
com.microsoft.VSCode,194,1714163967,1714164161,1714164161.7400022,-18000,,
us.zoom.xos,5,1714163962,1714163967,1714163967.513525,-18000,,
com.microsoft.VSCode,8,1714163954,1714163962,1714163962.324535,-18000,,
us.zoom.xos,5,1714163949,1714163954,1714163954.27457,-18000,,
com.microsoft.VSCode,9,1714163940,1714163949,1714163950.0859299,-18000,,
com.google.Chrome,2,1714163938,1714163940,1714163941.071055,-18000,,
us.zoom.xos,1,1714163937,1714163938,1714163938.4144568,-18000,,
com.google.Chrome,2,1714163935,1714163937,1714163937.6643639,-18000,,
com.microsoft.VSCode,9,1714163926,1714163935,1714163936.06153,-18000,,
com.google.Chrome,1,1714163925,1714163926,1714163926.391258,-18000,,
us.zoom.xos,36,1714163889,1714163925,1714163925.559329,-18000,,
com.google.Chrome,6,1714163883,1714163889,1714163889.7934818,-18000,,
com.microsoft.VSCode,8,1714163875,1714163883,1714163883.851567,-18000,,
com.google.Chrome,4,1714163871,1714163875,1714163876.051018,-18000,,
us.zoom.xos,17,1714163854,1714163871,1714163871.201294,-18000,,
com.google.Chrome,1,1714163853,1714163854,1714163854.409297,-18000,,
us.zoom.xos,43,1714163810,1714163853,1714163853.608405,-18000,,
com.google.Chrome,20,1714163790,1714163810,1714163810.1301808,-18000,,
us.zoom.xos,1,1714163789,1714163790,1714163790.3639169,-18000,,
com.google.Chrome,22,1714163767,1714163789,1714163789.361433,-18000,,
us.zoom.xos,1,1714163766,1714163767,1714163767.5118861,-18000,,
com.google.Chrome,16,1714163750,1714163766,1714163766.709913,-18000,,
us.zoom.xos,1,1714163749,1714163750,1714163750.4450889,-18000,,
com.google.Chrome,4,1714163745,1714163749,1714163749.8697581,-18000,,
us.zoom.xos,6,1714163739,1714163745,1714163745.0955238,-18000,,
com.google.Chrome,12,1714163727,1714163739,1714163739.453409,-18000,,
us.zoom.xos,7,1714163720,1714163727,1714163727.5355701,-18000,,
com.google.Chrome,2,1714163718,1714163720,1714163720.605078,-18000,,
us.zoom.xos,733,1714162985,1714163718,1714163718.186716,-18000,,
com.google.Chrome,8,1714162977,1714162985,1714162985.238493,-18000,,
us.zoom.xos,6,1714162971,1714162977,1714162977.353794,-18000,,
com.google.Chrome,117,1714162854,1714162971,1714162971.534775,-18000,,
us.zoom.xos,1,1714162853,1714162854,1714162854.70684,-18000,,
com.google.Chrome,73,1714162780,1714162853,1714162853.891796,-18000,,
us.zoom.xos,3,1714162777,1714162780,1714162780.099375,-18000,,
com.google.Chrome,43,1714162734,1714162777,1714162777.956665,-18000,,
com.toyopagroup.picaboo,21,1714162696,1714162717,1714162717.416966,-18000,EB445137-D7F5-57EC-87DA-1DB460D64046,"iPhone13,2"
us.zoom.xos,143,1714162591,1714162734,1714162734.051879,-18000,,
com.microsoft.VSCode,1,1714162590,1714162591,1714162591.849989,-18000,,
us.zoom.xos,27,1714162563,1714162590,1714162590.9744,-18000,,
com.google.Chrome,2,1714162561,1714162563,1714162563.355258,-18000,,
com.apple.MobileSMS,7,1714162554,1714162561,1714162561.64318,-18000,,
com.google.Chrome,199,1714162355,1714162554,1714162554.33185,-18000,,
com.microsoft.VSCode,14,1714162341,1714162355,1714162355.1481261,-18000,,
com.google.Chrome,114,1714162227,1714162341,1714162341.8650541,-18000,,
com.leomehlig.today,1,1714162226,1714162227,1714162227.358954,-18000,,
com.google.Chrome,488,1714161738,1714162226,1714162226.818228,-18000,,
com.leomehlig.today,26,1714161712,1714161738,1714161738.919673,-18000,,
com.apple.iCal,26,1714161686,1714161712,1714161712.95502,-18000,,
com.leomehlig.today,18,1714161668,1714161686,1714161686.441584,-18000,,
com.google.Chrome,322,1714161346,1714161668,1714161668.807622,-18000,,
com.apple.MobileSMS,7,1714161339,1714161346,1714161346.482028,-18000,,
com.google.Chrome,1732,1714159607,1714161339,1714161339.248376,-18000,,
com.leomehlig.today,5,1714159585,1714159590,1714159590.792643,-18000,,
com.google.Chrome,3,1714159582,1714159585,1714159585.526126,-18000,,
com.microsoft.VSCode,4,1714159578,1714159582,1714159582.4982839,-18000,,
com.google.chrome.ios,29,1714159530,1714159559,1714159559.945829,-18000,EB445137-D7F5-57EC-87DA-1DB460D64046,"iPhone13,2"
com.microsoft.Office.Outlook,15,1714159515,1714159530,1714159530.8895988,-18000,EB445137-D7F5-57EC-87DA-1DB460D64046,"iPhone13,2"
com.toyopagroup.picaboo,11,1714159344,1714159355,1714159355.84086,-18000,EB445137-D7F5-57EC-87DA-1DB460D64046,"iPhone13,2"
com.hammerandchisel.discord,91,1714159249,1714159340,1714159340.772639,-18000,EB445137-D7F5-57EC-87DA-1DB460D64046,"iPhone13,2"
com.toyopagroup.picaboo,29,1714159189,1714159218,1714159218.539088,-18000,EB445137-D7F5-57EC-87DA-1DB460D64046,"iPhone13,2"
com.toyopagroup.picaboo,88,1714158952,1714159040,1714159040.6137109,-18000,EB445137-D7F5-57EC-87DA-1DB460D64046,"iPhone13,2"
com.toyopagroup.picaboo,3,1714158948,1714158951,1714158951.7382212,-18000,EB445137-D7F5-57EC-87DA-1DB460D64046,"iPhone13,2"
com.toyopagroup.picaboo,20,1714158923,1714158943,1714158943.674299,-18000,EB445137-D7F5-57EC-87DA-1DB460D64046,"iPhone13,2"
com.apple.Music,4,1714158919,1714158923,1714158923.695303,-18000,EB445137-D7F5-57EC-87DA-1DB460D64046,"iPhone13,2"
com.apple.Music,8,1714158902,1714158910,1714158910.7066932,-18000,EB445137-D7F5-57EC-87DA-1DB460D64046,"iPhone13,2"
com.apple.Music,2,1714158865,1714158867,1714158867.274809,-18000,EB445137-D7F5-57EC-87DA-1DB460D64046,"iPhone13,2"
com.apple.Music,1,1714158864,1714158865,1714158865.339583,-18000,EB445137-D7F5-57EC-87DA-1DB460D64046,"iPhone13,2"
com.apple.Music,6,1714158192,1714158198,1714158198.4810271,-18000,EB445137-D7F5-57EC-87DA-1DB460D64046,"iPhone13,2"
com.apple.Music,10,1714157548,1714157558,1714157558.499109,-18000,EB445137-D7F5-57EC-87DA-1DB460D64046,"iPhone13,2"
com.microsoft.VSCode,23,1714154403,1714154426,1714154426.217983,-18000,,
com.google.Chrome,6,1714154397,1714154403,1714154403.198175,-18000,,
com.microsoft.VSCode,110,1714154287,1714154397,1714154397.6553621,-18000,,
com.apple.finder,8,1714154279,1714154287,1714154287.788412,-18000,,
com.google.Chrome,378,1714153901,1714154279,1714154279.566881,-18000,,
com.microsoft.VSCode,1,1714153900,1714153901,1714153901.360717,-18000,,
com.google.Chrome,6,1714153894,1714153900,1714153900.3034182,-18000,,
com.microsoft.VSCode,1,1714153893,1714153894,1714153894.484531,-18000,,
com.google.Chrome,29,1714153864,1714153893,1714153893.419231,-18000,,
com.microsoft.VSCode,1,1714153863,1714153864,1714153864.571239,-18000,,
com.google.Chrome,20,1714153843,1714153863,1714153863.88934,-18000,,
com.microsoft.VSCode,2,1714153841,1714153843,1714153843.374954,-18000,,
com.google.Chrome,65,1714153776,1714153841,1714153841.3356562,-18000,,
com.microsoft.VSCode,24,1714153752,1714153776,1714153776.199531,-18000,,
com.google.Chrome,22,1714153730,1714153752,1714153752.944648,-18000,,
com.microsoft.VSCode,2,1714153728,1714153730,1714153730.655623,-18000,,
com.google.Chrome,58,1714153670,1714153728,1714153728.717788,-18000,,
com.microsoft.Outlook,12,1714153658,1714153670,1714153670.698297,-18000,,
com.apple.MobileSMS,11,1714153647,1714153658,1714153659.006655,-18000,,
com.google.Chrome,9,1714153638,1714153647,1714153647.694556,-18000,,
com.leomehlig.today,25,1714153613,1714153638,1714153638.485258,-18000,,
com.google.Chrome,5,1714153608,1714153613,1714153613.956677,-18000,,
edu.illinois.rokwire.ios,85,1714152141,1714152226,1714152226.837047,-18000,EB445137-D7F5-57EC-87DA-1DB460D64046,"iPhone13,2"
edu.illinois.rokwire.ios,3,1714151520,1714151523,1714151523.526904,-18000,EB445137-D7F5-57EC-87DA-1DB460D64046,"iPhone13,2"
edu.illinois.rokwire.ios,27,1714151347,1714151374,1714151374.7639232,-18000,EB445137-D7F5-57EC-87DA-1DB460D64046,"iPhone13,2"
com.apple.MobileSMS,5,1714151246,1714151251,1714151251.465358,-18000,EB445137-D7F5-57EC-87DA-1DB460D64046,"iPhone13,2"
com.apple.InCallService,1,1714151245,1714151246,1714151246.750695,-18000,EB445137-D7F5-57EC-87DA-1DB460D64046,"iPhone13,2"
com.apple.InCallService,1,1714150262,1714150263,1714150263.915427,-18000,EB445137-D7F5-57EC-87DA-1DB460D64046,"iPhone13,2"
com.apple.MobileSMS,7,1714150255,1714150262,1714150262.998276,-18000,EB445137-D7F5-57EC-87DA-1DB460D64046,"iPhone13,2"
com.apple.MobileSMS,5,1714150249,1714150254,1714150254.924108,-18000,EB445137-D7F5-57EC-87DA-1DB460D64046,"iPhone13,2"
com.instructure.icanvas,2,1714150247,1714150249,1714150249.957479,-18000,EB445137-D7F5-57EC-87DA-1DB460D64046,"iPhone13,2"
com.instructure.icanvas,4,1714150238,1714150242,1714150242.245213,-18000,EB445137-D7F5-57EC-87DA-1DB460D64046,"iPhone13,2"
com.instructure.icanvas,218,1714147352,1714147570,1714147570.870286,-18000,EB445137-D7F5-57EC-87DA-1DB460D64046,"iPhone13,2"
com.tinyspeck.chatlyio,82,1714147207,1714147289,1714147289.709311,-18000,EB445137-D7F5-57EC-87DA-1DB460D64046,"iPhone13,2"
com.tinyspeck.chatlyio,34,1714146766,1714146800,1714146800.527282,-18000,EB445137-D7F5-57EC-87DA-1DB460D64046,"iPhone13,2"
com.apple.Health,3,1714146762,1714146765,1714146765.855462,-18000,EB445137-D7F5-57EC-87DA-1DB460D64046,"iPhone13,2"
com.apple.Health,18,1714145582,1714145600,1714145600.5959911,-18000,EB445137-D7F5-57EC-87DA-1DB460D64046,"iPhone13,2"
com.apple.weather,2,1714145580,1714145582,1714145582.8440108,-18000,EB445137-D7F5-57EC-87DA-1DB460D64046,"iPhone13,2"
com.apple.weather,4,1714145347,1714145351,1714145351.9433122,-18000,EB445137-D7F5-57EC-87DA-1DB460D64046,"iPhone13,2"
com.google.Chrome,10,1714145320,1714145330,1714145330.908196,-18000,,
com.leomehlig.today,63,1714145257,1714145320,1714145320.752131,-18000,,
com.google.Chrome,796,1714144461,1714145257,1714145257.2197409,-18000,,
com.leomehlig.today,33,1714144428,1714144461,1714144461.477973,-18000,,
com.google.Chrome,812,1714143616,1714144428,1714144428.852847,-18000,,
com.apple.finder,0,1714143616,1714143616,1714143616.8273501,-18000,,
com.leomehlig.today,24,1714143592,1714143616,1714143616.225601,-18000,,
com.apple.finder,1,1714143591,1714143592,1714143593.020396,-18000,,
com.leomehlig.today,0,1714143591,1714143591,1714143591.999464,-18000,,
com.apple.finder,2,1714143589,1714143591,1714143591.095776,-18000,,
com.leomehlig.today,47,1714143542,1714143589,1714143589.586986,-18000,,
com.apple.finder,1,1714143541,1714143542,1714143542.915173,-18000,,
com.leomehlig.today,3,1714143538,1714143541,1714143541.069644,-18000,,
com.google.Chrome,29,1714143509,1714143538,1714143538.874336,-18000,,
com.apple.Health,15,1714143469,1714143484,1714143484.549577,-18000,EB445137-D7F5-57EC-87DA-1DB460D64046,"iPhone13,2"
com.apple.weather,3,1714143466,1714143469,1714143469.157267,-18000,EB445137-D7F5-57EC-87DA-1DB460D64046,"iPhone13,2"
com.google.Chrome,633,1714142847,1714143480,1714143480.401095,-18000,,
com.google.Chrome,304,1714142438,1714142742,1714142742.818359,-18000,,
com.leomehlig.today,33,1714142405,1714142438,1714142438.729671,-18000,,
com.apple.weather,7,1714142382,1714142389,1714142389.363821,-18000,EB445137-D7F5-57EC-87DA-1DB460D64046,"iPhone13,2"
com.google.Chrome,33,1714142372,1714142405,1714142405.904622,-18000,,
com.leomehlig.today,3,1714142369,1714142372,1714142372.323042,-18000,,
com.google.Chrome,32,1714142337,1714142369,1714142369.0520191,-18000,,
com.leomehlig.today,29,1714142308,1714142337,1714142337.8682098,-18000,,
com.google.Chrome,43,1714142265,1714142308,1714142308.317397,-18000,,
com.apple.finder,2,1714142263,1714142265,1714142265.3529081,-18000,,
com.google.Chrome,38,1714142225,1714142263,1714142264.027653,-18000,,
com.apple.finder,20,1714142205,1714142225,1714142225.8054771,-18000,,
com.apple.QuickTimePlayerX,23,1714142182,1714142205,1714142205.1193051,-18000,,
com.google.Chrome,2,1714142180,1714142182,1714142182.0446072,-18000,,
com.apple.QuickTimePlayerX,14,1714142166,1714142180,1714142180.78159,-18000,,
com.google.Chrome,3,1714142163,1714142166,1714142166.579393,-18000,,
com.apple.QuickTimePlayerX,100,1714142063,1714142163,1714142163.567564,-18000,,
com.google.Chrome,11,1714142052,1714142063,1714142063.840924,-18000,,
com.apple.QuickTimePlayerX,22,1714142030,1714142052,1714142052.909195,-18000,,
com.google.Chrome,9,1714142021,1714142030,1714142030.7256799,-18000,,
com.apple.QuickTimePlayerX,3,1714142018,1714142021,1714142021.660873,-18000,,
com.apple.finder,1,1714142017,1714142018,1714142018.903913,-18000,,
com.google.Chrome,0,1714142017,1714142017,1714142017.932543,-18000,,
com.apple.finder,3,1714142001,1714142004,1714142004.787829,-18000,,
com.apple.QuickTimePlayerX,4,1714141997,1714142001,1714142001.842994,-18000,,
com.apple.finder,6,1714141991,1714141997,1714141997.451658,-18000,,
com.apple.QuickTimePlayerX,21,1714141970,1714141991,1714141991.283891,-18000,,
com.apple.Notes,4,1714141966,1714141970,1714141970.758422,-18000,,
com.apple.QuickTimePlayerX,2,1714141964,1714141966,1714141966.3424602,-18000,,
com.apple.Notes,60,1714141904,1714141964,1714141964.8676438,-18000,,
com.apple.QuickTimePlayerX,0,1714141904,1714141904,1714141904.970656,-18000,,
com.apple.Notes,120,1714141784,1714141904,1714141904.0590181,-18000,,
com.apple.QuickTimePlayerX,21,1714141763,1714141784,1714141784.436249,-18000,,
com.apple.Notes,10,1714141753,1714141763,1714141763.097399,-18000,,
com.leomehlig.today,15,1714141738,1714141753,1714141753.703393,-18000,,
com.apple.MobileSMS,3,1714141687,1714141690,1714141690.365499,-18000,EB445137-D7F5-57EC-87DA-1DB460D64046,"iPhone13,2"
com.toyopagroup.picaboo,14,1714141667,1714141681,1714141681.2758598,-18000,EB445137-D7F5-57EC-87DA-1DB460D64046,"iPhone13,2"
com.google.Chrome,127,1714141611,1714141738,1714141739.012782,-18000,,
us.zoom.xos,6,1714141605,1714141611,1714141612.053648,-18000,,
com.google.Chrome,8,1714141597,1714141605,1714141605.220705,-18000,,
us.zoom.xos,6,1714141591,1714141597,1714141597.40747,-18000,,
com.apple.camera,2,1714140654,1714140656,1714140656.754129,-18000,EB445137-D7F5-57EC-87DA-1DB460D64046,"iPhone13,2"
com.apple.camera,1,1714140527,1714140528,1714140528.508358,-18000,EB445137-D7F5-57EC-87DA-1DB460D64046,"iPhone13,2"
com.google.Chrome,1378,1714140213,1714141591,1714141591.8117251,-18000,,
us.zoom.xos,4,1714140209,1714140213,1714140213.4038692,-18000,,
com.google.Chrome,18,1714140191,1714140209,1714140209.904653,-18000,,
us.zoom.xos,1,1714140190,1714140191,1714140191.281376,-18000,,
com.google.Chrome,24,1714140166,1714140190,1714140190.903699,-18000,,
us.zoom.xos,2,1714140164,1714140166,1714140166.390349,-18000,,
com.google.Chrome,11,1714140153,1714140164,1714140164.955931,-18000,,
us.zoom.xos,2,1714140151,1714140153,1714140153.258027,-18000,,
com.google.Chrome,3,1714140148,1714140151,1714140151.25534,-18000,,
us.zoom.xos,0,1714140148,1714140148,1714140148.991924,-18000,,
com.google.Chrome,1,1714140147,1714140148,1714140148.0445728,-18000,,
us.zoom.xos,9,1714140138,1714140147,1714140147.162479,-18000,,
com.google.Chrome,12,1714140126,1714140138,1714140138.7615318,-18000,,
us.zoom.xos,1,1714140125,1714140126,1714140126.182023,-18000,,
com.google.Chrome,7,1714140118,1714140125,1714140125.468651,-18000,,
us.zoom.xos,16,1714140102,1714140118,1714140118.361619,-18000,,
com.google.Chrome,3,1714140099,1714140102,1714140102.411336,-18000,,
us.zoom.xos,5,1714140094,1714140099,1714140099.1764789,-18000,,
com.google.Chrome,6,1714140088,1714140094,1714140094.261549,-18000,,
us.zoom.xos,0,1714140088,1714140088,1714140089.030268,-18000,,
com.google.Chrome,2,1714140086,1714140088,1714140088.268178,-18000,,
us.zoom.xos,6,1714140080,1714140086,1714140086.442315,-18000,,
com.google.Chrome,7,1714140073,1714140080,1714140080.360152,-18000,,
us.zoom.xos,1,1714140072,1714140073,1714140073.891612,-18000,,
com.google.Chrome,8,1714140064,1714140072,1714140072.945487,-18000,,
us.zoom.xos,12,1714140052,1714140064,1714140064.0688581,-18000,,
com.google.Chrome,10,1714140042,1714140052,1714140052.318915,-18000,,
us.zoom.xos,6,1714140036,1714140042,1714140042.2592201,-18000,,
com.google.Chrome,24,1714140012,1714140036,1714140036.579387,-18000,,
us.zoom.xos,1,1714140011,1714140012,1714140012.527314,-18000,,
com.google.Chrome,1,1714140010,1714140011,1714140011.347969,-18000,,
us.zoom.xos,3,1714140007,1714140010,1714140010.4619288,-18000,,
com.google.Chrome,14,1714139993,1714140007,1714140007.697427,-18000,,
us.zoom.xos,17,1714139976,1714139993,1714139993.277411,-18000,,
com.google.Chrome,12,1714139964,1714139976,1714139976.880415,-18000,,
com.apple.mobiletimer,0,1714138067,1714138067,1714138067.949851,-18000,EB445137-D7F5-57EC-87DA-1DB460D64046,"iPhone13,2"
com.apple.mobiletimer,2,1714138064,1714138066,1714138066.846199,-18000,EB445137-D7F5-57EC-87DA-1DB460D64046,"iPhone13,2"
com.apple.mobiletimer,35,1714137300,1714137335,1714137335.9016318,-18000,EB445137-D7F5-57EC-87DA-1DB460D64046,"iPhone13,2"
com.apple.mobiletimer,13,1714107108,1714107121,1714107121.164857,-18000,EB445137-D7F5-57EC-87DA-1DB460D64046,"iPhone13,2"
com.apple.mobiletimer,14,1714107091,1714107105,1714107105.630581,-18000,EB445137-D7F5-57EC-87DA-1DB460D64046,"iPhone13,2"
com.thestorygraph.thestorygraph,93,1714106773,1714106866,1714106866.8679671,-18000,EB445137-D7F5-57EC-87DA-1DB460D64046,"iPhone13,2"
com.goodreads.Goodreads,8,1714106765,1714106773,1714106773.82156,-18000,EB445137-D7F5-57EC-87DA-1DB460D64046,"iPhone13,2"
com.thestorygraph.thestorygraph,11,1714106754,1714106765,1714106765.041184,-18000,EB445137-D7F5-57EC-87DA-1DB460D64046,"iPhone13,2"
com.thestorygraph.thestorygraph,34,1714106719,1714106753,1714106753.2747622,-18000,EB445137-D7F5-57EC-87DA-1DB460D64046,"iPhone13,2"
com.toyopagroup.picaboo,22,1714104565,1714104587,1714104587.497107,-18000,EB445137-D7F5-57EC-87DA-1DB460D64046,"iPhone13,2"
com.tmsoft.WhiteNoiseLite,3,1714104562,1714104565,1714104565.7462711,-18000,EB445137-D7F5-57EC-87DA-1DB460D64046,"iPhone13,2"
com.tmsoft.WhiteNoiseLite,3,1714104522,1714104525,1714104525.501305,-18000,EB445137-D7F5-57EC-87DA-1DB460D64046,"iPhone13,2"
com.tmsoft.WhiteNoiseLite,10,1714103874,1714103884,1714103884.416213,-18000,EB445137-D7F5-57EC-87DA-1DB460D64046,"iPhone13,2"
com.tmsoft.WhiteNoiseLite,32,1714103836,1714103868,1714103868.420891,-18000,EB445137-D7F5-57EC-87DA-1DB460D64046,"iPhone13,2"
com.apple.journal,510,1714103271,1714103781,1714103781.7075691,-18000,EB445137-D7F5-57EC-87DA-1DB460D64046,"iPhone13,2"
com.apple.Health,80,1714103190,1714103270,1714103270.094252,-18000,EB445137-D7F5-57EC-87DA-1DB460D64046,"iPhone13,2"
com.apple.journal,24,1714103164,1714103188,1714103188.935059,-18000,EB445137-D7F5-57EC-87DA-1DB460D64046,"iPhone13,2"
com.apple.Health,46,1714103114,1714103160,1714103160.561792,-18000,EB445137-D7F5-57EC-87DA-1DB460D64046,"iPhone13,2"
com.google.Chrome,90,1714103081,1714103171,1714103172.076608,-18000,,
com.google.Chrome,429,1714102521,1714102950,1714102950.8713279,-18000,,
com.google.Chrome,346,1714101728,1714102074,1714102075.02578,-18000,,
com.leomehlig.today,27,1714101701,1714101728,1714101729.010572,-18000,,
com.google.Chrome,89,1714101612,1714101701,1714101702.2409492,-18000,,
com.apple.finder,4,1714101596,1714101600,1714101602.465759,-18000,,
com.apple.Photos,5,1714101591,1714101596,1714101597.071766,-18000,,
com.instructure.icanvas,7,1714101584,1714101591,1714101591.918182,-18000,EB445137-D7F5-57EC-87DA-1DB460D64046,"iPhone13,2"
com.hammerandchisel.discord,61,1714101520,1714101581,1714101581.1328402,-18000,EB445137-D7F5-57EC-87DA-1DB460D64046,"iPhone13,2"
com.apple.MobileSMS,3,1714101517,1714101520,1714101520.407786,-18000,EB445137-D7F5-57EC-87DA-1DB460D64046,"iPhone13,2"
com.google.Chrome,93,1714101498,1714101591,1714101591.238546,-18000,,
com.apple.MobileSMS,21,1714101435,1714101456,1714101456.503934,-18000,EB445137-D7F5-57EC-87DA-1DB460D64046,"iPhone13,2"
com.google.Chrome,134,1714101118,1714101252,1714101252.3615952,-18000,,
com.leomehlig.today,11,1714101107,1714101118,1714101118.495743,-18000,,
com.apple.MobileSMS,10,1714101003,1714101013,1714101013.321579,-18000,EB445137-D7F5-57EC-87DA-1DB460D64046,"iPhone13,2"
com.google.Chrome,414,1714100693,1714101107,1714101107.33223,-18000,,
com.leomehlig.today,50,1714100643,1714100693,1714100693.655311,-18000,,
com.apple.Preview,89,1714100554,1714100643,1714100643.7460709,-18000,,
com.google.Chrome,3,1714100551,1714100554,1714100554.3451738,-18000,,
com.apple.Preview,499,1714100052,1714100551,1714100551.8993568,-18000,,
com.apple.MobileSMS,4,1714100048,1714100052,1714100052.199208,-18000,,
com.apple.Preview,52,1714099996,1714100048,1714100048.8957582,-18000,,
com.google.Chrome,6,1714099990,1714099996,1714099996.831509,-18000,,
com.apple.Preview,241,1714099749,1714099990,1714099990.215063,-18000,,
com.apple.finder,3,1714099746,1714099749,1714099749.566292,-18000,,
com.apple.Preview,2,1714099744,1714099746,1714099746.753368,-18000,,
com.leomehlig.today,113,1714099631,1714099744,1714099744.936981,-18000,,
com.apple.Notes,286,1714099345,1714099631,1714099632.0314422,-18000,,
com.google.Chrome,22,1714099323,1714099345,1714099345.892415,-18000,,
com.apple.Notes,171,1714099152,1714099323,1714099323.065638,-18000,,
com.google.Chrome,37,1714099115,1714099152,1714099152.191185,-18000,,
com.apple.Notes,173,1714098942,1714099115,1714099115.2580628,-18000,,
com.google.Chrome,3,1714098939,1714098942,1714098942.948998,-18000,,
com.apple.Notes,74,1714098865,1714098939,1714098939.1209521,-18000,,
com.google.Chrome,25,1714098840,1714098865,1714098865.1457481,-18000,,
com.apple.MobileSMS,54,1714098786,1714098840,1714098840.7408671,-18000,,
com.google.Chrome,46,1714098740,1714098786,1714098786.576973,-18000,,
com.microsoft.VSCode,6,1714098734,1714098740,1714098740.244611,-18000,,
com.apple.MobileSMS,13,1714098203,1714098216,1714098216.606779,-18000,EB445137-D7F5-57EC-87DA-1DB460D64046,"iPhone13,2"
com.microsoft.VSCode,12,1714098172,1714098184,1714098184.741788,-18000,,
com.google.Chrome,42,1714098130,1714098172,1714098172.959052,-18000,,
com.microsoft.VSCode,122,1714098008,1714098130,1714098130.101507,-18000,,
com.google.Chrome,3,1714098005,1714098008,1714098008.663415,-18000,,
com.microsoft.VSCode,1,1714098004,1714098005,1714098005.515708,-18000,,
com.google.Chrome,3,1714098001,1714098004,1714098004.2797198,-18000,,
com.microsoft.VSCode,2,1714097999,1714098001,1714098001.699981,-18000,,
com.google.Chrome,7,1714097992,1714097999,1714097999.660565,-18000,,
com.microsoft.VSCode,138,1714097854,1714097992,1714097992.8893561,-18000,,
com.google.Chrome,3,1714097851,1714097854,1714097854.259636,-18000,,
com.microsoft.VSCode,75,1714097776,1714097851,1714097851.845557,-18000,,
com.google.Chrome,6,1714097770,1714097776,1714097776.901867,-18000,,
com.microsoft.VSCode,3,1714097767,1714097770,1714097771.029141,-18000,,
com.google.Chrome,107,1714097660,1714097767,1714097767.441345,-18000,,
com.microsoft.VSCode,255,1714097405,1714097660,1714097660.961482,-18000,,
com.google.Chrome,2,1714097403,1714097405,1714097405.542994,-18000,,
com.microsoft.VSCode,59,1714097344,1714097403,1714097403.217548,-18000,,
com.google.Chrome,14,1714097330,1714097344,1714097344.442964,-18000,,
com.microsoft.VSCode,105,1714097225,1714097330,1714097330.424428,-18000,,
com.apple.MobileSMS,4,1714096935,1714096939,1714096939.939748,-18000,EB445137-D7F5-57EC-87DA-1DB460D64046,"iPhone13,2"
com.apple.calculator,5,1714096930,1714096935,1714096936.115927,-18000,EB445137-D7F5-57EC-87DA-1DB460D64046,"iPhone13,2"
com.apple.calculator,4,1714096920,1714096924,1714096924.30564,-18000,EB445137-D7F5-57EC-87DA-1DB460D64046,"iPhone13,2"
com.apple.calculator,6,1714096774,1714096780,1714096780.247871,-18000,EB445137-D7F5-57EC-87DA-1DB460D64046,"iPhone13,2"
com.apple.calculator,6,1714096692,1714096698,1714096698.399774,-18000,EB445137-D7F5-57EC-87DA-1DB460D64046,"iPhone13,2"
com.apple.calculator,31,1714096218,1714096249,1714096249.19836,-18000,EB445137-D7F5-57EC-87DA-1DB460D64046,"iPhone13,2"
com.apple.calculator,96,1714096113,1714096209,1714096209.9340692,-18000,EB445137-D7F5-57EC-87DA-1DB460D64046,"iPhone13,2"
com.apple.calculator,20,1714095798,1714095818,1714095818.8755279,-18000,EB445137-D7F5-57EC-87DA-1DB460D64046,"iPhone13,2"
com.apple.calculator,23,1714095714,1714095737,1714095737.139948,-18000,EB445137-D7F5-57EC-87DA-1DB460D64046,"iPhone13,2"
com.hammerandchisel.discord,3,1714095706,1714095709,1714095709.192977,-18000,EB445137-D7F5-57EC-87DA-1DB460D64046,"iPhone13,2"
com.hammerandchisel.discord,1,1714095704,1714095705,1714095705.154766,-18000,EB445137-D7F5-57EC-87DA-1DB460D64046,"iPhone13,2"
com.microsoft.VSCode,81,1714095305,1714095386,1714095386.7202091,-18000,,
com.google.Chrome,4,1714095301,1714095305,1714095305.557197,-18000,,
com.google.Chrome,242,1714094992,1714095234,1714095234.084365,-18000,,
com.microsoft.VSCode,151,1714094841,1714094992,1714094992.8662071,-18000,,
com.google.Chrome,62,1714094779,1714094841,1714094841.5791268,-18000,,
com.microsoft.VSCode,15,1714094764,1714094779,1714094779.6551142,-18000,,
com.google.Chrome,1,1714094763,1714094764,1714094764.9764628,-18000,,
com.microsoft.VSCode,1,1714094762,1714094763,1714094763.72804,-18000,,
com.google.Chrome,1,1714094761,1714094762,1714094762.242137,-18000,,
com.microsoft.VSCode,3,1714094758,1714094761,1714094761.0751061,-18000,,
com.google.Chrome,2,1714094756,1714094758,1714094759.039403,-18000,,
com.microsoft.VSCode,30,1714094726,1714094756,1714094756.471345,-18000,,
com.google.Chrome,54,1714094672,1714094726,1714094726.608901,-18000,,
com.microsoft.VSCode,82,1714094590,1714094672,1714094672.2637858,-18000,,
com.google.Chrome,622,1714093968,1714094590,1714094590.284412,-18000,,
com.apple.finder,3,1714093965,1714093968,1714093968.074676,-18000,,
com.google.Chrome,452,1714093513,1714093965,1714093965.417498,-18000,,
com.microsoft.VSCode,10,1714093503,1714093513,1714093513.401596,-18000,,
com.google.Chrome,72,1714093431,1714093503,1714093503.6179562,-18000,,
com.microsoft.VSCode,3,1714093428,1714093431,1714093431.686445,-18000,,
com.google.Chrome,1487,1714091941,1714093428,1714093428.313846,-18000,,
com.microsoft.VSCode,16,1714091925,1714091941,1714091941.5163178,-18000,,
com.google.Chrome,1453,1714090472,1714091925,1714091925.75898,-18000,,
com.microsoft.VSCode,33,1714090439,1714090472,1714090472.525615,-18000,,
com.microsoft.VSCode,124,1714090281,1714090405,1714090405.422385,-18000,,
com.google.Chrome,123,1714090158,1714090281,1714090281.636934,-18000,,
com.microsoft.VSCode,1,1714090157,1714090158,1714090158.34674,-18000,,
com.google.Chrome,2,1714090155,1714090157,1714090157.283639,-18000,,
com.apple.Notes,8,1714090147,1714090155,1714090155.283615,-18000,,
com.apple.Preview,8,1714090139,1714090147,1714090147.8853269,-18000,,
com.apple.Preview,231,1714088087,1714088318,1714088318.777388,-18000,,
com.leomehlig.today,39,1714088048,1714088087,1714088087.239845,-18000,,
com.apple.Preview,2,1714088046,1714088048,1714088048.1883469,-18000,,
com.leomehlig.today,7,1714088039,1714088046,1714088046.974988,-18000,,
com.apple.Preview,925,1714087114,1714088039,1714088039.97897,-18000,,
com.apple.finder,5,1714087109,1714087114,1714087114.423651,-18000,,
com.google.Chrome,11,1714087098,1714087109,1714087109.322576,-18000,,
com.apple.Notes,4,1714087094,1714087098,1714087098.485568,-18000,,
com.google.Chrome,7,1714087087,1714087094,1714087094.0990782,-18000,,
com.leomehlig.today,4,1714087083,1714087087,1714087087.173296,-18000,,
com.google.Chrome,21,1714087062,1714087083,1714087084.0363889,-18000,,
com.apple.Notes,13,1714087049,1714087062,1714087062.065412,-18000,,
com.google.Chrome,24,1714087025,1714087049,1714087049.5419679,-18000,,
com.apple.Notes,17,1714087008,1714087025,1714087025.162746,-18000,,
com.google.Chrome,3,1714087005,1714087008,1714087008.877451,-18000,,
com.apple.Notes,1,1714087004,1714087005,1714087005.203201,-18000,,
com.google.Chrome,3,1714087001,1714087004,1714087004.149952,-18000,,
com.apple.Notes,2,1714086999,1714087001,1714087002.035265,-18000,,
com.google.Chrome,1,1714086998,1714086999,1714086999.523073,-18000,,
com.apple.Notes,4,1714086994,1714086998,1714086998.4227772,-18000,,
com.google.Chrome,1,1714086993,1714086994,1714086994.754739,-18000,,
com.apple.Notes,3,1714086990,1714086993,1714086993.4895911,-18000,,
com.google.Chrome,2,1714086988,1714086990,1714086990.7936811,-18000,,
com.apple.Notes,3,1714086985,1714086988,1714086988.925082,-18000,,
com.google.Chrome,1,1714086984,1714086985,1714086985.2110739,-18000,,
com.apple.Notes,1,1714086983,1714086984,1714086984.486432,-18000,,
com.google.Chrome,3,1714086980,1714086983,1714086983.215898,-18000,,
com.apple.Notes,5,1714086975,1714086980,1714086980.50745,-18000,,
com.google.Chrome,15,1714086960,1714086975,1714086975.7248058,-18000,,
com.apple.Notes,7,1714086953,1714086960,1714086960.848372,-18000,,
com.google.Chrome,0,1714086953,1714086953,1714086953.946275,-18000,,
com.apple.Notes,4,1714086949,1714086953,1714086953.1410189,-18000,,
com.google.Chrome,1,1714086948,1714086949,1714086949.399774,-18000,,
com.apple.Notes,3,1714086945,1714086948,1714086948.218843,-18000,,
com.google.Chrome,2,1714086943,1714086945,1714086945.319875,-18000,,
com.apple.Notes,6,1714086937,1714086943,1714086943.443752,-18000,,
com.google.Chrome,11,1714086926,1714086937,1714086938.043967,-18000,,
com.apple.Notes,4,1714086922,1714086926,1714086926.846455,-18000,,
com.google.Chrome,1,1714086921,1714086922,1714086922.987999,-18000,,
com.apple.Notes,2,1714086919,1714086921,1714086921.6383271,-18000,,
com.google.Chrome,1,1714086918,1714086919,1714086920.080215,-18000,,
com.apple.Notes,4,1714086914,1714086918,1714086919.0109591,-18000,,
com.google.Chrome,2,1714086912,1714086914,1714086914.766218,-18000,,
com.apple.Notes,4,1714086908,1714086912,1714086912.475256,-18000,,
com.google.Chrome,2,1714086906,1714086908,1714086908.094063,-18000,,
com.apple.Notes,5,1714086901,1714086906,1714086906.731606,-18000,,
com.google.Chrome,2,1714086899,1714086901,1714086901.715642,-18000,,
com.apple.Notes,5,1714086894,1714086899,1714086899.451237,-18000,,
com.google.Chrome,16,1714086878,1714086894,1714086894.778501,-18000,,
com.apple.Notes,12,1714086866,1714086878,1714086878.20046,-18000,,
com.google.Chrome,3,1714086863,1714086866,1714086866.418581,-18000,,
com.apple.Notes,1,1714086862,1714086863,1714086863.0948071,-18000,,
com.google.Chrome,116,1714086746,1714086862,1714086862.400125,-18000,,
com.apple.Notes,1,1714086745,1714086746,1714086746.830189,-18000,,
com.google.Chrome,1,1714086744,1714086745,1714086745.983511,-18000,,
com.apple.Notes,82,1714086662,1714086744,1714086744.386971,-18000,,
com.google.Chrome,30,1714086632,1714086662,1714086662.428072,-18000,,
com.leomehlig.today,3,1714086615,1714086618,1714086618.97029,-18000,,
com.google.Chrome,14,1714086601,1714086615,1714086615.0910969,-18000,,
com.google.Chrome,1,1714079323,1714079324,1714079325.0425239,-18000,,
com.google.Chrome,1,1714079318,1714079319,1714079320.274493,-18000,,
com.leomehlig.today,33,1714079285,1714079318,1714079318.810031,-18000,,
com.google.Chrome,93,1714079192,1714079285,1714079285.2890282,-18000,,
com.leomehlig.today,2,1714079190,1714079192,1714079192.149323,-18000,,
com.microsoft.VSCode,16,1714079174,1714079190,1714079190.696612,-18000,,
com.leomehlig.today,3,1714079171,1714079174,1714079174.929533,-18000,,
com.microsoft.VSCode,2,1714079169,1714079171,1714079171.146095,-18000,,
com.google.Chrome,684,1714078485,1714079169,1714079169.8747911,-18000,,
com.leomehlig.today,27,1714078458,1714078485,1714078485.840917,-18000,,
com.google.Chrome,768,1714077690,1714078458,1714078458.8206549,-18000,,
com.leomehlig.today,11,1714077679,1714077690,1714077690.638859,-18000,,
com.google.Chrome,2,1714077677,1714077679,1714077679.5154681,-18000,,
com.leomehlig.today,11,1714077666,1714077677,1714077677.295007,-18000,,
com.google.Chrome,1398,1714076268,1714077666,1714077666.156203,-18000,,
com.google.Chrome,440,1714075808,1714076248,1714076248.40867,-18000,,
com.leomehlig.today,42,1714075766,1714075808,1714075808.294086,-18000,,
com.apple.iCal,9,1714075757,1714075766,1714075766.628592,-18000,,
com.leomehlig.today,5,1714075752,1714075757,1714075757.471708,-18000,,
com.apple.MobileSMS,0,1714075752,1714075752,1714075753.0011911,-18000,,
com.leomehlig.today,8,1714075744,1714075752,1714075752.5183148,-18000,,
com.google.Chrome,1,1714075743,1714075744,1714075744.558295,-18000,,
com.leomehlig.today,2,1714075741,1714075743,1714075743.317463,-18000,,
com.google.Chrome,308,1714075433,1714075741,1714075741.078197,-18000,,
com.apple.MobileSMS,19,1714075414,1714075433,1714075434.010367,-18000,,
com.google.Chrome,9,1714075405,1714075414,1714075414.780107,-18000,,
com.apple.MobileSMS,2,1714075403,1714075405,1714075405.1374722,-18000,,
com.google.Chrome,166,1714075237,1714075403,1714075403.753788,-18000,,
com.apple.podcasts,4,1714071991,1714071995,1714071995.21036,-18000,EB445137-D7F5-57EC-87DA-1DB460D64046,"iPhone13,2"
com.apple.podcasts,6,1714071899,1714071905,1714071905.237554,-18000,EB445137-D7F5-57EC-87DA-1DB460D64046,"iPhone13,2"
com.apple.MobileSMS,10,1714071889,1714071899,1714071899.032685,-18000,EB445137-D7F5-57EC-87DA-1DB460D64046,"iPhone13,2"
com.apple.podcasts,77,1714071812,1714071889,1714071889.4591331,-18000,EB445137-D7F5-57EC-87DA-1DB460D64046,"iPhone13,2"
com.apple.podcasts,10,1714071791,1714071801,1714071801.7913,-18000,EB445137-D7F5-57EC-87DA-1DB460D64046,"iPhone13,2"
com.apple.Music,2,1714071785,1714071787,1714071787.016216,-18000,EB445137-D7F5-57EC-87DA-1DB460D64046,"iPhone13,2"
com.apple.weather,4,1714071780,1714071784,1714071784.4469972,-18000,EB445137-D7F5-57EC-87DA-1DB460D64046,"iPhone13,2"
com.google.Chrome,4,1714071584,1714071588,1714071588.5656419,-18000,,
com.leomehlig.today,2,1714071582,1714071584,1714071584.258354,-18000,,
com.microsoft.VSCode,3,1714071579,1714071582,1714071582.309299,-18000,,
com.google.Chrome,2,1714071577,1714071579,1714071579.090756,-18000,,
com.apple.MobileSMS,31,1714071546,1714071577,1714071577.444555,-18000,,
com.google.Chrome,4,1714071542,1714071546,1714071546.271173,-18000,,
com.microsoft.VSCode,2,1714071540,1714071542,1714071542.2008781,-18000,,
com.google.Chrome,1,1714071539,1714071540,1714071540.44527,-18000,,
com.microsoft.VSCode,12,1714071527,1714071539,1714071539.419883,-18000,,
com.google.Chrome,26,1714071501,1714071527,1714071527.985997,-18000,,
com.leomehlig.today,2,1714071499,1714071501,1714071501.955521,-18000,,
com.leomehlig.today,3,1714071426,1714071429,1714071429.822789,-18000,,
com.leomehlig.today,19,1714071404,1714071423,1714071423.134675,-18000,,
com.google.Chrome,4,1714071400,1714071404,1714071404.640836,-18000,,
com.apple.MobileSMS,96,1714071304,1714071400,1714071400.321354,-18000,,
com.google.Chrome,3,1714071301,1714071304,1714071304.56777,-18000,,
com.apple.MobileSMS,8,1714071293,1714071301,1714071301.939292,-18000,,
com.google.Chrome,1,1714071292,1714071293,1714071293.652419,-18000,,
com.apple.MobileSMS,6,1714071286,1714071292,1714071292.336858,-18000,,
com.google.Chrome,5,1714071281,1714071286,1714071287.070569,-18000,,
com.apple.MobileSMS,9,1714071272,1714071281,1714071281.156678,-18000,,
com.google.Chrome,10,1714071262,1714071272,1714071272.666475,-18000,,
com.apple.MobileSMS,6,1714071256,1714071262,1714071262.9578528,-18000,,
com.google.Chrome,7,1714071249,1714071256,1714071256.363529,-18000,,
com.apple.MobileSMS,76,1714071173,1714071249,1714071249.263242,-18000,,
com.google.Chrome,7,1714071166,1714071173,1714071173.267451,-18000,,
com.apple.MobileSMS,37,1714071129,1714071166,1714071166.4587,-18000,,
com.google.Chrome,4,1714071125,1714071129,1714071129.801659,-18000,,
com.apple.MobileSMS,5,1714071120,1714071125,1714071125.724172,-18000,,
com.google.Chrome,124,1714070996,1714071120,1714071120.918922,-18000,,
com.microsoft.VSCode,1,1714070995,1714070996,1714070996.515893,-18000,,
com.google.Chrome,92,1714070903,1714070995,1714070995.698193,-18000,,
com.microsoft.VSCode,1,1714070902,1714070903,1714070903.154362,-18000,,
com.google.Chrome,124,1714070778,1714070902,1714070902.121943,-18000,,
com.microsoft.VSCode,3,1714070775,1714070778,1714070778.065274,-18000,,
com.google.Chrome,14,1714070761,1714070775,1714070775.2385159,-18000,,
com.microsoft.VSCode,1,1714070760,1714070761,1714070761.639382,-18000,,
com.google.Chrome,288,1714070472,1714070760,1714070760.8549252,-18000,,
com.microsoft.VSCode,1,1714070471,1714070472,1714070472.28722,-18000,,
com.google.Chrome,54,1714070417,1714070471,1714070471.50287,-18000,,
com.microsoft.VSCode,1,1714070416,1714070417,1714070417.4971619,-18000,,
com.google.Chrome,134,1714070282,1714070416,1714070416.3876061,-18000,,
com.microsoft.VSCode,1,1714070281,1714070282,1714070282.56598,-18000,,
com.google.Chrome,10,1714070271,1714070281,1714070281.640524,-18000,,
com.microsoft.VSCode,1,1714070270,1714070271,1714070271.80369,-18000,,
com.google.Chrome,3,1714070267,1714070270,1714070270.5539079,-18000,,
com.microsoft.VSCode,4,1714070263,1714070267,1714070267.116603,-18000,,
com.google.Chrome,186,1714070077,1714070263,1714070263.083771,-18000,,
com.microsoft.VSCode,3,1714070074,1714070077,1714070077.986666,-18000,,
com.google.Chrome,37,1714070037,1714070074,1714070074.124003,-18000,,
com.microsoft.VSCode,11,1714070026,1714070037,1714070037.226774,-18000,,
com.google.Chrome,170,1714069856,1714070026,1714070026.5725698,-18000,,
com.microsoft.VSCode,2,1714069854,1714069856,1714069858.361161,-18000,,
com.google.Chrome,10,1714069844,1714069854,1714069854.804627,-18000,,
com.google.Chrome,157,1714069300,1714069457,1714069457.9932752,-18000,,
com.apple.iCal,38,1714069262,1714069300,1714069300.682483,-18000,,
com.apple.weather,5,1714068973,1714068978,1714068978.6518168,-18000,EB445137-D7F5-57EC-87DA-1DB460D64046,"iPhone13,2"
com.apple.weather,3,1714068968,1714068971,1714068971.250833,-18000,EB445137-D7F5-57EC-87DA-1DB460D64046,"iPhone13,2"
com.apple.weather,2,1714068931,1714068933,1714068933.110303,-18000,EB445137-D7F5-57EC-87DA-1DB460D64046,"iPhone13,2"
com.google.Chrome,349,1714068913,1714069262,1714069262.055963,-18000,,
com.leomehlig.today,3,1714068910,1714068913,1714068913.218048,-18000,,
com.google.Chrome,1,1714068909,1714068910,1714068910.849393,-18000,,
com.apple.iCal,1,1714068908,1714068909,1714068909.655621,-18000,,
com.google.Chrome,269,1714068639,1714068908,1714068908.4595451,-18000,,
com.leomehlig.today,37,1714068602,1714068639,1714068639.251338,-18000,,
com.google.Chrome,2,1714068600,1714068602,1714068602.932547,-18000,,
com.leomehlig.today,0,1714068600,1714068600,1714068600.913931,-18000,,
com.apple.weather,9,1714068577,1714068586,1714068586.206955,-18000,EB445137-D7F5-57EC-87DA-1DB460D64046,"iPhone13,2"
com.google.Chrome,25,1714068575,1714068600,1714068600.09799,-18000,,
com.apple.weather,2,1714068567,1714068569,1714068569.174906,-18000,EB445137-D7F5-57EC-87DA-1DB460D64046,"iPhone13,2"
com.leomehlig.today,18,1714068544,1714068562,1714068562.0604591,-18000,,
com.google.Chrome,18,1714068526,1714068544,1714068544.254915,-18000,,
com.leomehlig.today,20,1714068506,1714068526,1714068526.1534948,-18000,,
com.google.Chrome,89,1714068417,1714068506,1714068506.3479118,-18000,,
com.apple.iCal,2,1714068415,1714068417,1714068417.199827,-18000,,
com.google.Chrome,11,1714068404,1714068415,1714068415.437923,-18000,,
com.apple.iCal,7,1714068397,1714068404,1714068404.994014,-18000,,
com.google.Chrome,43,1714068354,1714068397,1714068397.13627,-18000,,
com.leomehlig.today,33,1714068321,1714068354,1714068355.1216068,-18000,,
com.google.Chrome,154,1714068167,1714068321,1714068321.585977,-18000,,
com.microsoft.Outlook,45,1714068122,1714068167,1714068167.968627,-18000,,
com.apple.weather,15,1714067904,1714067919,1714067919.142177,-18000,EB445137-D7F5-57EC-87DA-1DB460D64046,"iPhone13,2"
com.apple.MobileSMS,3,1714067900,1714067903,1714067903.5689502,-18000,EB445137-D7F5-57EC-87DA-1DB460D64046,"iPhone13,2"
com.google.Chrome,239,1714067883,1714068122,1714068122.524603,-18000,,
com.leomehlig.today,1,1714067879,1714067880,1714067880.482312,-18000,,
com.apple.systempreferences,1,1714067878,1714067879,1714067880.2371101,-18000,,
com.leomehlig.today,14,1714067863,1714067877,1714067877.5826259,-18000,,
com.google.Chrome,273,1714067590,1714067863,1714067863.402633,-18000,,
com.apple.Preview,1,1714067589,1714067590,1714067590.461512,-18000,,
com.google.Chrome,3,1714067586,1714067589,1714067589.095135,-18000,,
com.apple.Preview,9,1714067577,1714067586,1714067586.8190799,-18000,,
com.google.Chrome,10,1714067567,1714067577,1714067577.575422,-18000,,
com.apple.Preview,10,1714067557,1714067567,1714067567.197372,-18000,,
com.google.Chrome,28,1714067529,1714067557,1714067557.401489,-18000,,
com.apple.Preview,14,1714067515,1714067529,1714067529.644213,-18000,,
com.google.Chrome,13,1714067502,1714067515,1714067515.278343,-18000,,
com.apple.Preview,8,1714067494,1714067502,1714067502.91055,-18000,,
com.google.Chrome,2,1714067492,1714067494,1714067494.221805,-18000,,
com.apple.Preview,3,1714067489,1714067492,1714067492.553155,-18000,,
com.google.Chrome,9,1714067480,1714067489,1714067489.357434,-18000,,
com.apple.Preview,3,1714067477,1714067480,1714067480.250659,-18000,,
com.google.Chrome,1,1714067476,1714067477,1714067477.482378,-18000,,
com.apple.Preview,2,1714067474,1714067476,1714067476.699264,-18000,,
com.google.Chrome,5,1714067469,1714067474,1714067474.130299,-18000,,
com.apple.Preview,10,1714067459,1714067469,1714067469.082076,-18000,,
com.google.Chrome,1,1714067458,1714067459,1714067459.9114199,-18000,,
com.apple.Preview,4,1714067454,1714067458,1714067458.04982,-18000,,
com.google.Chrome,3,1714067451,1714067454,1714067454.095604,-18000,,
com.apple.Preview,2,1714067449,1714067451,1714067451.747673,-18000,,
com.google.Chrome,3,1714067446,1714067449,1714067449.48591,-18000,,
com.apple.Preview,7,1714067439,1714067446,1714067446.438174,-18000,,
com.google.Chrome,14,1714067425,1714067439,1714067439.1622171,-18000,,
com.apple.Preview,9,1714067416,1714067425,1714067425.556621,-18000,,
com.google.Chrome,2,1714067414,1714067416,1714067416.877061,-18000,,
com.apple.Preview,4,1714067410,1714067414,1714067414.361905,-18000,,
com.google.Chrome,1,1714067409,1714067410,1714067410.742741,-18000,,
com.apple.Preview,7,1714067402,1714067409,1714067409.236511,-18000,,
com.google.Chrome,8,1714067394,1714067402,1714067402.773004,-18000,,
com.apple.Preview,14,1714067380,1714067394,1714067394.589885,-18000,,
com.google.Chrome,8,1714067372,1714067380,1714067380.1268048,-18000,,
com.apple.Preview,11,1714067361,1714067372,1714067372.924848,-18000,,
com.google.Chrome,65,1714067296,1714067361,1714067361.9282398,-18000,,
com.apple.Preview,13,1714067283,1714067296,1714067296.1368089,-18000,,
com.google.Chrome,3,1714067280,1714067283,1714067283.714157,-18000,,
com.apple.Preview,8,1714067272,1714067280,1714067281.007024,-18000,,
com.google.Chrome,50,1714067222,1714067272,1714067272.860832,-18000,,
com.apple.Preview,1,1714067221,1714067222,1714067222.884372,-18000,,
com.google.Chrome,5,1714067216,1714067221,1714067221.673626,-18000,,
com.apple.Preview,6,1714067210,1714067216,1714067216.5057359,-18000,,
com.google.Chrome,1,1714067209,1714067210,1714067210.2514238,-18000,,
com.apple.Preview,11,1714067198,1714067209,1714067209.2937741,-18000,,
com.google.Chrome,2,1714067196,1714067198,1714067198.1466432,-18000,,
com.apple.Preview,10,1714067186,1714067196,1714067196.895956,-18000,,
com.apple.finder,4,1714067182,1714067186,1714067186.163718,-18000,,
com.apple.Preview,2,1714067180,1714067182,1714067182.337019,-18000,,
com.apple.finder,5,1714067175,1714067180,1714067180.373787,-18000,,
com.apple.MobileSMS,5,1714067051,1714067056,1714067056.387371,-18000,EB445137-D7F5-57EC-87DA-1DB460D64046,"iPhone13,2"
com.google.Chrome,127,1714067048,1714067175,1714067175.268014,-18000,,
com.leomehlig.today,2,1714067046,1714067048,1714067048.089345,-18000,,
com.apple.MobileSMS,8,1714067038,1714067046,1714067046.2316651,-18000,EB445137-D7F5-57EC-87DA-1DB460D64046,"iPhone13,2"
com.apple.mobiletimer,2,1714067036,1714067038,1714067038.771052,-18000,EB445137-D7F5-57EC-87DA-1DB460D64046,"iPhone13,2"
com.apple.mobiletimer,3,1714066895,1714066898,1714066898.885042,-18000,EB445137-D7F5-57EC-87DA-1DB460D64046,"iPhone13,2"
com.apple.MobileSMS,2,1714066893,1714066895,1714066895.621993,-18000,EB445137-D7F5-57EC-87DA-1DB460D64046,"iPhone13,2"
com.apple.MobileSMS,3,1714066755,1714066758,1714066758.289099,-18000,EB445137-D7F5-57EC-87DA-1DB460D64046,"iPhone13,2"
com.apple.MobileSMS,6,1714066748,1714066754,1714066754.700129,-18000,EB445137-D7F5-57EC-87DA-1DB460D64046,"iPhone13,2"
com.leomehlig.today,318,1714066694,1714067012,1714067012.8859072,-18000,,
com.apple.MobileSMS,12,1714066610,1714066622,1714066622.047843,-18000,EB445137-D7F5-57EC-87DA-1DB460D64046,"iPhone13,2"
com.google.Chrome,1253,1714065441,1714066694,1714066694.9715838,-18000,,
com.leomehlig.today,13,1714065415,1714065428,1714065429.154943,-18000,,
com.apple.MobileSMS,30,1714065354,1714065384,1714065384.6689348,-18000,EB445137-D7F5-57EC-87DA-1DB460D64046,"iPhone13,2"
com.apple.mobiletimer,4,1714065350,1714065354,1714065354.902763,-18000,EB445137-D7F5-57EC-87DA-1DB460D64046,"iPhone13,2"
com.apple.mobiletimer,6,1714065181,1714065187,1714065187.459676,-18000,EB445137-D7F5-57EC-87DA-1DB460D64046,"iPhone13,2"
com.apple.mobiletimer,6,1714065165,1714065171,1714065171.302388,-18000,EB445137-D7F5-57EC-87DA-1DB460D64046,"iPhone13,2"
com.apple.calculator,6,1714065159,1714065165,1714065165.190506,-18000,EB445137-D7F5-57EC-87DA-1DB460D64046,"iPhone13,2"
com.apple.MobileSMS,51,1714063381,1714063432,1714063432.9610791,-18000,EB445137-D7F5-57EC-87DA-1DB460D64046,"iPhone13,2"
com.leomehlig.today,2,1714062747,1714062749,1714062749.087419,-18000,,
com.google.Chrome,17,1714062730,1714062747,1714062747.19468,-18000,,
com.apple.finder,6,1714062724,1714062730,1714062730.279093,-18000,,
com.google.Chrome,1,1714062723,1714062724,1714062724.3433142,-18000,,
com.apple.finder,11,1714062712,1714062723,1714062723.888675,-18000,,
com.google.Chrome,6,1714062706,1714062712,1714062712.307467,-18000,,
com.apple.Preview,8,1714062698,1714062706,1714062706.376672,-18000,,
com.apple.Preview,485,1714062030,1714062515,1714062515.167553,-18000,,
com.leomehlig.today,13,1714062017,1714062030,1714062030.5747728,-18000,,
com.apple.Preview,240,1714061777,1714062017,1714062017.7121859,-18000,,
com.google.Chrome,8,1714061769,1714061777,1714061777.0842009,-18000,,
com.apple.Preview,1066,1714060703,1714061769,1714061769.706491,-18000,,
com.apple.finder,3,1714060700,1714060703,1714060703.284797,-18000,,
com.google.Chrome,28,1714060672,1714060700,1714060700.758585,-18000,,
com.apple.finder,13,1714060659,1714060672,1714060672.823975,-18000,,
com.google.Chrome,21,1714060638,1714060659,1714060659.156327,-18000,,
com.apple.finder,8,1714060630,1714060638,1714060638.4126558,-18000,,
com.apple.Preview,68,1714060562,1714060630,1714060631.042655,-18000,,
com.apple.calculator,13,1714060549,1714060562,1714060562.551179,-18000,,
com.apple.Preview,17,1714060532,1714060549,1714060549.966892,-18000,,
com.apple.calculator,56,1714060476,1714060532,1714060532.388373,-18000,,
com.apple.Preview,472,1714060004,1714060476,1714060476.7537432,-18000,,
com.google.Chrome,22,1714059982,1714060004,1714060004.834908,-18000,,
com.apple.Preview,5,1714059977,1714059982,1714059982.505233,-18000,,
com.google.Chrome,37,1714059940,1714059977,1714059977.435286,-18000,,
com.apple.Preview,3,1714059937,1714059940,1714059940.9180899,-18000,,
com.google.Chrome,0,1714059937,1714059937,1714059937.730428,-18000,,
com.apple.Preview,6,1714059931,1714059937,1714059937.052836,-18000,,
com.google.Chrome,1,1714059930,1714059931,1714059931.085702,-18000,,
com.apple.Preview,5,1714059925,1714059930,1714059930.32655,-18000,,
com.google.Chrome,5,1714059920,1714059925,1714059925.68419,-18000,,
com.apple.Preview,14,1714059906,1714059920,1714059920.652738,-18000,,
com.google.Chrome,2,1714059904,1714059906,1714059906.1954188,-18000,,
com.apple.Preview,5,1714059899,1714059904,1714059904.5616012,-18000,,
com.google.Chrome,1,1714059898,1714059899,1714059899.7101579,-18000,,
com.apple.Preview,2,1714059896,1714059898,1714059898.8713279,-18000,,
com.google.Chrome,1,1714059895,1714059896,1714059896.786429,-18000,,
com.apple.Preview,4,1714059891,1714059895,1714059895.345721,-18000,,
com.google.Chrome,0,1714059891,1714059891,1714059891.965378,-18000,,
com.apple.Preview,6,1714059885,1714059891,1714059891.316453,-18000,,
com.google.Chrome,1,1714059884,1714059885,1714059885.252696,-18000,,
com.apple.Preview,1,1714059883,1714059884,1714059884.3992682,-18000,,
com.google.Chrome,63,1714059820,1714059883,1714059883.4219,-18000,,
com.apple.Preview,3,1714059817,1714059820,1714059820.8652148,-18000,,
com.google.Chrome,0,1714059817,1714059817,1714059817.969584,-18000,,
com.apple.Preview,6,1714059811,1714059817,1714059817.2351608,-18000,,
com.google.Chrome,1,1714059810,1714059811,1714059811.48284,-18000,,
com.apple.Preview,3,1714059807,1714059810,1714059810.385034,-18000,,
com.google.Chrome,3,1714059804,1714059807,1714059807.976939,-18000,,
com.apple.Preview,7,1714059797,1714059804,1714059804.368736,-18000,,
com.google.Chrome,1,1714059796,1714059797,1714059797.945969,-18000,,
com.apple.Preview,2,1714059794,1714059796,1714059796.832787,-18000,,
com.google.Chrome,3,1714059791,1714059794,1714059794.316622,-18000,,
com.apple.Preview,17,1714059774,1714059791,1714059791.4860601,-18000,,
com.google.Chrome,6,1714059768,1714059774,1714059774.700506,-18000,,
com.apple.Preview,2,1714059766,1714059768,1714059768.618143,-18000,,
com.google.Chrome,10,1714059756,1714059766,1714059766.9493232,-18000,,
com.apple.Preview,2,1714059754,1714059756,1714059756.965035,-18000,,
com.google.Chrome,68,1714059686,1714059754,1714059754.241086,-18000,,
com.apple.Preview,1,1714059685,1714059686,1714059686.7078838,-18000,,
com.google.Chrome,38,1714059647,1714059685,1714059685.067607,-18000,,
com.apple.Preview,5,1714059642,1714059647,1714059647.0860472,-18000,,
com.google.Chrome,1,1714059641,1714059642,1714059642.491055,-18000,,
com.apple.Preview,3,1714059638,1714059641,1714059641.964597,-18000,,
com.google.Chrome,1,1714059637,1714059638,1714059638.856945,-18000,,
com.apple.Preview,2,1714059635,1714059637,1714059637.6516109,-18000,,
com.google.Chrome,1,1714059634,1714059635,1714059635.024626,-18000,,
com.apple.Preview,3,1714059631,1714059634,1714059634.293807,-18000,,
com.google.Chrome,1,1714059630,1714059631,1714059631.9360518,-18000,,
com.apple.Preview,4,1714059626,1714059630,1714059630.58388,-18000,,
com.google.Chrome,54,1714059572,1714059626,1714059626.2112532,-18000,,
com.apple.Preview,3,1714059569,1714059572,1714059572.070231,-18000,,
com.google.Chrome,14,1714059555,1714059569,1714059569.5405269,-18000,,
com.apple.Preview,5,1714059550,1714059555,1714059555.41846,-18000,,
com.microsoft.Outlook,169,1714059381,1714059550,1714059550.420367,-18000,,
com.apple.Preview,322,1714059059,1714059381,1714059381.622663,-18000,,
com.google.Chrome,44,1714059015,1714059059,1714059059.315915,-18000,,
com.apple.Preview,387,1714058628,1714059015,1714059016.03199,-18000,,
com.apple.Preview,575,1714058049,1714058624,1714058624.461061,-18000,,
com.google.Chrome,160,1714057889,1714058049,1714058049.157094,-18000,,
com.apple.Preview,4,1714057885,1714057889,1714057889.80825,-18000,,
com.apple.finder,5,1714057880,1714057885,1714057885.826355,-18000,,
com.google.Chrome,574,1714057306,1714057880,1714057880.146466,-18000,,
com.leomehlig.today,4,1714057159,1714057163,1714057163.410913,-18000,,
com.leomehlig.today,6,1714055939,1714055945,1714055945.198804,-18000,,
com.microsoft.Outlook,2,1714055937,1714055939,1714055939.5960178,-18000,,
com.microsoft.onenote.mac,22,1714055915,1714055937,1714055937.871201,-18000,,
com.google.Chrome,322,1714055593,1714055915,1714055916.0159569,-18000,,
com.microsoft.onenote.mac,53,1714055540,1714055593,1714055595.0544338,-18000,,
com.google.Chrome,46,1714055494,1714055540,1714055540.750369,-18000,,
com.microsoft.onenote.mac,30,1714055464,1714055494,1714055494.810494,-18000,,
com.google.Chrome,40,1714055424,1714055464,1714055464.754209,-18000,,
com.microsoft.Outlook,3,1714055229,1714055232,1714055232.43684,-18000,,
com.google.Chrome,8,1714055221,1714055229,1714055229.357584,-18000,,
com.microsoft.Outlook,4,1714055217,1714055221,1714055221.38095,-18000,,
com.google.Chrome,17,1714055200,1714055217,1714055217.34975,-18000,,
com.microsoft.Office.Outlook,10,1714055162,1714055172,1714055172.177777,-18000,EB445137-D7F5-57EC-87DA-1DB460D64046,"iPhone13,2"
com.apple.Health,15,1714018387,1714018402,1714018402.257296,-18000,EB445137-D7F5-57EC-87DA-1DB460D64046,"iPhone13,2"
com.toyopagroup.picaboo,12,1714018367,1714018379,1714018379.817173,-18000,EB445137-D7F5-57EC-87DA-1DB460D64046,"iPhone13,2"
com.toyopagroup.picaboo,15,1714018347,1714018362,1714018362.619248,-18000,EB445137-D7F5-57EC-87DA-1DB460D64046,"iPhone13,2"
com.apple.Health,15,1714018327,1714018342,1714018342.450447,-18000,EB445137-D7F5-57EC-87DA-1DB460D64046,"iPhone13,2"
com.myfitnesspal.mfp,5,1714018322,1714018327,1714018328.34144,-18000,EB445137-D7F5-57EC-87DA-1DB460D64046,"iPhone13,2"
com.myfitnesspal.mfp,11,1714018293,1714018304,1714018304.6782541,-18000,EB445137-D7F5-57EC-87DA-1DB460D64046,"iPhone13,2"
com.myfitnesspal.mfp,12,1714018278,1714018290,1714018290.695328,-18000,EB445137-D7F5-57EC-87DA-1DB460D64046,"iPhone13,2"
com.myfitnesspal.mfp,9,1714015801,1714015810,1714015810.889625,-18000,EB445137-D7F5-57EC-87DA-1DB460D64046,"iPhone13,2"
com.myfitnesspal.mfp,10,1714014604,1714014614,1714014614.086947,-18000,EB445137-D7F5-57EC-87DA-1DB460D64046,"iPhone13,2"
com.google.Chrome,2175,1714014441,1714016616,1714016616.565386,-18000,,
com.myfitnesspal.mfp,9,1714014059,1714014068,1714014068.229908,-18000,EB445137-D7F5-57EC-87DA-1DB460D64046,"iPhone13,2"
com.myfitnesspal.mfp,1,1714013680,1714013681,1714013681.171427,-18000,EB445137-D7F5-57EC-87DA-1DB460D64046,"iPhone13,2"
com.google.Chrome,426,1714013644,1714014070,1714014070.166863,-18000,,
com.apple.reminders,5,1714013639,1714013644,1714013644.739819,-18000,,
com.google.Chrome,2,1714013637,1714013639,1714013640.016203,-18000,,
com.apple.reminders,16,1714013621,1714013637,1714013637.637975,-18000,,
com.google.Chrome,115,1714013506,1714013621,1714013621.562706,-18000,,
com.apple.finder,5,1714013501,1714013506,1714013506.902827,-18000,,
com.apple.Photos,2,1714013499,1714013501,1714013501.540084,-18000,,
com.apple.finder,2,1714013497,1714013499,1714013499.540478,-18000,,
com.google.Chrome,3,1714013494,1714013497,1714013497.903728,-18000,,
com.microsoft.onenote.mac,9,1714013485,1714013494,1714013494.459465,-18000,,
com.google.Chrome,457,1714013028,1714013485,1714013485.646373,-18000,,
com.apple.finder,76,1714012952,1714013028,1714013028.459286,-18000,,
com.google.Chrome,81,1714012871,1714012952,1714012952.588006,-18000,,
com.apple.Photos,2,1714012869,1714012871,1714012871.394901,-18000,,
com.google.Chrome,2,1714012867,1714012869,1714012869.4441519,-18000,,
com.apple.Photos,2,1714012865,1714012867,1714012867.601305,-18000,,
com.google.Chrome,15,1714012850,1714012865,1714012865.170373,-18000,,
com.apple.Photos,6,1714012844,1714012850,1714012850.771905,-18000,,
com.google.Chrome,2,1714012842,1714012844,1714012844.612422,-18000,,
com.apple.Photos,15,1714012827,1714012842,1714012842.663364,-18000,,
com.google.Chrome,194,1714012633,1714012827,1714012827.7412791,-18000,,
com.apple.finder,0,1714012633,1714012633,1714012633.7220569,-18000,,
com.google.Chrome,8,1714012625,1714012633,1714012633.357821,-18000,,
com.apple.finder,1,1714012624,1714012625,1714012625.6289492,-18000,,
com.google.Chrome,223,1714012401,1714012624,1714012625.03507,-18000,,
com.apple.finder,1,1714012400,1714012401,1714012401.255089,-18000,,
com.google.Chrome,5,1714012395,1714012400,1714012400.366977,-18000,,
com.apple.finder,1,1714012394,1714012395,1714012396.0077019,-18000,,
com.google.Chrome,295,1714012099,1714012394,1714012394.891263,-18000,,
com.apple.finder,65,1714012034,1714012099,1714012099.127933,-18000,,
com.myfitnesspal.mfp,211,1714011951,1714012162,1714012162.818562,-18000,EB445137-D7F5-57EC-87DA-1DB460D64046,"iPhone13,2"
com.apple.weather,3,1714011944,1714011947,1714011947.897939,-18000,EB445137-D7F5-57EC-87DA-1DB460D64046,"iPhone13,2"
com.google.Chrome,169,1714011865,1714012034,1714012034.505338,-18000,,
com.microsoft.onenote.mac,25,1714011840,1714011865,1714011865.958744,-18000,,
com.google.Chrome,273,1714011567,1714011840,1714011840.156129,-18000,,
com.apple.weather,4,1714011533,1714011537,1714011537.096164,-18000,EB445137-D7F5-57EC-87DA-1DB460D64046,"iPhone13,2"
com.apple.weather,12,1714011131,1714011143,1714011143.606769,-18000,EB445137-D7F5-57EC-87DA-1DB460D64046,"iPhone13,2"
edu.illinois.rokwire.ios,2,1714011128,1714011130,1714011130.83621,-18000,EB445137-D7F5-57EC-87DA-1DB460D64046,"iPhone13,2"
edu.illinois.rokwire.ios,8,1714011044,1714011052,1714011052.255034,-18000,EB445137-D7F5-57EC-87DA-1DB460D64046,"iPhone13,2"
com.goodreads.Goodreads,32,1714010854,1714010886,1714010886.7772841,-18000,EB445137-D7F5-57EC-87DA-1DB460D64046,"iPhone13,2"
com.google.Maps,1,1714010852,1714010853,1714010853.764787,-18000,EB445137-D7F5-57EC-87DA-1DB460D64046,"iPhone13,2"
com.thestorygraph.thestorygraph,17,1714010833,1714010850,1714010850.651262,-18000,EB445137-D7F5-57EC-87DA-1DB460D64046,"iPhone13,2"
com.apple.Music,2,1714010827,1714010829,1714010829.929548,-18000,EB445137-D7F5-57EC-87DA-1DB460D64046,"iPhone13,2"
com.apple.Music,2,1714010754,1714010756,1714010756.9243112,-18000,EB445137-D7F5-57EC-87DA-1DB460D64046,"iPhone13,2"
com.apple.Music,14,1714010464,1714010478,1714010478.2161489,-18000,EB445137-D7F5-57EC-87DA-1DB460D64046,"iPhone13,2"
com.google.Chrome,9,1714010328,1714010337,1714010337.5808492,-18000,,
com.leomehlig.today,9,1714010319,1714010328,1714010328.2225661,-18000,,
com.google.Chrome,8,1714010311,1714010319,1714010320.0318398,-18000,,
com.leomehlig.today,51,1714010260,1714010311,1714010311.337754,-18000,,
com.google.Chrome,429,1714009831,1714010260,1714010260.2497392,-18000,,
com.apple.Preview,7,1714009824,1714009831,1714009831.474997,-18000,,
com.google.Chrome,3,1714009821,1714009824,1714009824.447475,-18000,,
com.apple.Preview,8,1714009813,1714009821,1714009821.138233,-18000,,
com.google.Chrome,35,1714009778,1714009813,1714009813.2329059,-18000,,
com.apple.Preview,5,1714009773,1714009778,1714009778.453092,-18000,,
com.google.Chrome,13,1714009760,1714009773,1714009773.937161,-18000,,
com.apple.Preview,18,1714009742,1714009760,1714009760.67103,-18000,,
com.google.Chrome,5,1714009737,1714009742,1714009742.884186,-18000,,
com.apple.Preview,36,1714009701,1714009737,1714009737.3362179,-18000,,
com.google.Chrome,4,1714009697,1714009701,1714009701.257549,-18000,,
com.apple.Preview,41,1714009656,1714009697,1714009697.7061682,-18000,,
com.google.Chrome,78,1714009578,1714009656,1714009656.8874989,-18000,,
com.apple.Preview,12,1714009566,1714009578,1714009578.141916,-18000,,
com.google.Chrome,73,1714009493,1714009566,1714009566.120242,-18000,,
com.apple.Preview,41,1714009452,1714009493,1714009493.425798,-18000,,
com.google.Chrome,17,1714009435,1714009452,1714009452.66436,-18000,,
com.apple.Preview,40,1714009395,1714009435,1714009435.639058,-18000,,
com.google.Chrome,586,1714008809,1714009395,1714009395.801422,-18000,,
com.leomehlig.today,5,1714008804,1714008809,1714008809.621163,-18000,,
com.google.Chrome,637,1714008167,1714008804,1714008804.45545,-18000,,
com.apple.Preview,10,1714008157,1714008167,1714008167.0719929,-18000,,
com.google.Chrome,11,1714008146,1714008157,1714008157.935384,-18000,,
com.apple.Preview,3,1714008143,1714008146,1714008146.917413,-18000,,
com.google.Chrome,4,1714008139,1714008143,1714008143.272326,-18000,,
com.apple.Preview,3,1714008136,1714008139,1714008139.7170238,-18000,,
com.google.Chrome,8,1714008128,1714008136,1714008136.349595,-18000,,
com.apple.Preview,6,1714008122,1714008128,1714008128.4990292,-18000,,
com.google.Chrome,4,1714008118,1714008122,1714008122.182833,-18000,,
com.apple.Preview,12,1714008106,1714008118,1714008118.257368,-18000,,
com.google.Chrome,574,1714007532,1714008106,1714008106.600224,-18000,,
com.apple.Preview,1,1714007531,1714007532,1714007532.738524,-18000,,
com.google.Chrome,3,1714007528,1714007531,1714007531.549265,-18000,,
com.apple.Preview,2,1714007526,1714007528,1714007528.5446591,-18000,,
com.google.Chrome,5,1714007521,1714007526,1714007526.450152,-18000,,
com.apple.Preview,8,1714007513,1714007521,1714007521.700951,-18000,,
com.google.Chrome,5,1714007508,1714007513,1714007513.222168,-18000,,
com.apple.Preview,1,1714007507,1714007508,1714007508.611464,-18000,,
com.google.Chrome,2,1714007505,1714007507,1714007507.193152,-18000,,
com.apple.Preview,82,1714007423,1714007505,1714007505.4534879,-18000,,
com.google.Chrome,8,1714007415,1714007423,1714007423.158387,-18000,,
com.apple.Preview,5,1714007410,1714007415,1714007415.126863,-18000,,
com.google.Chrome,3,1714007407,1714007410,1714007410.4853358,-18000,,
com.apple.Preview,2,1714007405,1714007407,1714007407.4155169,-18000,,
com.google.Chrome,3,1714007402,1714007405,1714007405.134429,-18000,,
com.apple.Preview,24,1714007378,1714007402,1714007402.080611,-18000,,
com.google.Chrome,9,1714007369,1714007378,1714007378.103183,-18000,,
com.apple.Preview,3,1714007366,1714007369,1714007369.27296,-18000,,
com.google.Chrome,7,1714007359,1714007366,1714007366.785458,-18000,,
com.apple.Preview,7,1714007352,1714007359,1714007359.2367191,-18000,,
com.google.Chrome,12,1714007340,1714007352,1714007353.0216,-18000,,
com.apple.Preview,4,1714007336,1714007340,1714007340.784941,-18000,,
com.google.Chrome,6,1714007330,1714007336,1714007336.9896,-18000,,
com.apple.Preview,9,1714007321,1714007330,1714007330.5129352,-18000,,
com.google.Chrome,5,1714007316,1714007321,1714007321.170763,-18000,,
com.apple.Preview,3,1714007313,1714007316,1714007316.296132,-18000,,
com.google.Chrome,8,1714007305,1714007313,1714007313.909254,-18000,,
com.apple.Preview,10,1714007295,1714007305,1714007305.928438,-18000,,
com.google.Chrome,2,1714007293,1714007295,1714007295.076546,-18000,,
com.apple.Preview,1,1714007292,1714007293,1714007293.070858,-18000,,
com.google.Chrome,8,1714007284,1714007292,1714007292.074043,-18000,,
com.apple.Preview,7,1714007277,1714007284,1714007284.5829859,-18000,,
com.google.Chrome,9,1714007268,1714007277,1714007277.842035,-18000,,
com.apple.Preview,2,1714007266,1714007268,1714007268.96448,-18000,,
com.google.Chrome,9,1714007257,1714007266,1714007266.446784,-18000,,
com.apple.Preview,2,1714007255,1714007257,1714007258.038958,-18000,,
com.google.Chrome,7,1714007248,1714007255,1714007255.636662,-18000,,
com.apple.Preview,3,1714007245,1714007248,1714007248.508065,-18000,,
com.google.Chrome,3,1714007242,1714007245,1714007245.861449,-18000,,
com.apple.Preview,6,1714007236,1714007242,1714007242.5488,-18000,,
com.google.Chrome,1,1714007235,1714007236,1714007236.145813,-18000,,
com.apple.Preview,1,1714007234,1714007235,1714007235.483916,-18000,,
com.google.Chrome,9,1714007225,1714007234,1714007234.729725,-18000,,
com.apple.Preview,10,1714007215,1714007225,1714007225.428812,-18000,,
com.google.Chrome,4,1714007211,1714007215,1714007215.262342,-18000,,
com.apple.Preview,1,1714007210,1714007211,1714007211.450413,-18000,,
com.google.Chrome,12,1714007198,1714007210,1714007210.171021,-18000,,
com.apple.Preview,21,1714007177,1714007198,1714007198.827059,-18000,,
com.google.Chrome,3,1714007174,1714007177,1714007177.667066,-18000,,
com.apple.Preview,19,1714007155,1714007174,1714007174.129854,-18000,,
com.google.Chrome,11,1714007144,1714007155,1714007155.900219,-18000,,
com.apple.Preview,1,1714007143,1714007144,1714007144.5800982,-18000,,
com.google.Chrome,5,1714007138,1714007143,1714007143.295998,-18000,,
com.apple.Preview,6,1714007132,1714007138,1714007138.4831061,-18000,,
com.google.Chrome,6,1714007126,1714007132,1714007132.607685,-18000,,
com.apple.Preview,10,1714007116,1714007126,1714007126.450194,-18000,,
com.google.Chrome,6,1714007110,1714007116,1714007116.970135,-18000,,
com.apple.Preview,2,1714007108,1714007110,1714007110.1110091,-18000,,
com.google.Chrome,1,1714007107,1714007108,1714007108.7333899,-18000,,
com.apple.Preview,2,1714007105,1714007107,1714007107.275965,-18000,,
com.google.Chrome,9,1714007096,1714007105,1714007105.82586,-18000,,
com.apple.Preview,7,1714007089,1714007096,1714007096.634845,-18000,,
com.google.Chrome,16,1714007073,1714007089,1714007089.923634,-18000,,
com.apple.Preview,16,1714007057,1714007073,1714007073.545299,-18000,,
com.apple.finder,0,1714007057,1714007057,1714007058.094768,-18000,,
com.apple.Preview,43,1714007010,1714007053,1714007053.851883,-18000,,
com.apple.finder,4,1714007006,1714007010,1714007010.95872,-18000,,
com.google.Chrome,120,1714006886,1714007006,1714007006.679131,-18000,,
com.hnc.Discord,2,1714006884,1714006886,1714006886.4610438,-18000,,
com.google.Chrome,5,1714006879,1714006884,1714006884.566304,-18000,,
com.leomehlig.today,150,1714006729,1714006879,1714006880.025768,-18000,,
com.google.Chrome,2,1714006727,1714006729,1714006729.342033,-18000,,
com.apple.finder,9,1714006718,1714006727,1714006727.2284899,-18000,,
com.intsig.CamScannerLite,139,1714006552,1714006691,1714006691.247542,-18000,EB445137-D7F5-57EC-87DA-1DB460D64046,"iPhone13,2"
com.google.chrome.ios,12,1714006540,1714006552,1714006552.906091,-18000,EB445137-D7F5-57EC-87DA-1DB460D64046,"iPhone13,2"
com.intsig.CamScannerLite,5,1714006535,1714006540,1714006540.4446092,-18000,EB445137-D7F5-57EC-87DA-1DB460D64046,"iPhone13,2"
com.apple.Health,3,1714006530,1714006533,1714006533.724391,-18000,EB445137-D7F5-57EC-87DA-1DB460D64046,"iPhone13,2"
com.google.Chrome,427,1714006291,1714006718,1714006718.453092,-18000,,
com.leomehlig.today,17,1714006274,1714006291,1714006291.742389,-18000,,
com.google.Chrome,192,1714006082,1714006274,1714006274.146092,-18000,,
com.apple.Preview,6,1714006076,1714006082,1714006082.1838632,-18000,,
com.google.Chrome,592,1714005484,1714006076,1714006076.304039,-18000,,
com.apple.Preview,85,1714005399,1714005484,1714005484.465558,-18000,,
com.google.Chrome,703,1714004696,1714005399,1714005399.602038,-18000,,
com.apple.Preview,14,1714004682,1714004696,1714004696.878515,-18000,,
com.google.Chrome,526,1714004156,1714004682,1714004682.576202,-18000,,
com.hnc.Discord,59,1714004097,1714004156,1714004156.225656,-18000,,
com.google.Chrome,30,1714004067,1714004097,1714004097.710938,-18000,,
com.apple.Preview,87,1714003980,1714004067,1714004067.14504,-18000,,
com.apple.finder,3,1714003977,1714003980,1714003980.546039,-18000,,
com.google.Chrome,220,1714003757,1714003977,1714003977.818176,-18000,,
com.hnc.Discord,15,1714003742,1714003757,1714003757.125729,-18000,,
com.google.Chrome,660,1714003082,1714003742,1714003742.6866322,-18000,,
com.hnc.Discord,1,1714003081,1714003082,1714003082.4496322,-18000,,
com.google.Chrome,1257,1714001824,1714003081,1714003081.495051,-18000,,
com.hnc.Discord,59,1714001765,1714001824,1714001824.539092,-18000,,
com.google.Chrome,276,1714001489,1714001765,1714001765.604578,-18000,,
com.hnc.Discord,46,1714001433,1714001479,1714001479.435588,-18000,,
com.google.Chrome,13,1714001420,1714001433,1714001434.007185,-18000,,
com.leomehlig.today,9,1714001411,1714001420,1714001421.847351,-18000,,
com.apple.Health,27,1714000707,1714000734,1714000734.256808,-18000,EB445137-D7F5-57EC-87DA-1DB460D64046,"iPhone13,2"
com.microsoft.Office.Outlook,4,1714000701,1714000705,1714000705.444864,-18000,EB445137-D7F5-57EC-87DA-1DB460D64046,"iPhone13,2"
com.leomehlig.today,20,1714000593,1714000613,1714000613.145485,-18000,,
com.apple.iCal,14,1714000579,1714000593,1714000593.509332,-18000,,
com.microsoft.VSCode,11,1714000568,1714000579,1714000579.826684,-18000,,
com.google.Chrome,58,1714000510,1714000568,1714000568.718642,-18000,,
com.microsoft.Office.Outlook,2,1714000505,1714000507,1714000507.852531,-18000,EB445137-D7F5-57EC-87DA-1DB460D64046,"iPhone13,2"
com.microsoft.Office.Outlook,16,1713999634,1713999650,1713999650.255159,-18000,EB445137-D7F5-57EC-87DA-1DB460D64046,"iPhone13,2"
com.microsoft.Office.Outlook,65,1713999529,1713999594,1713999594.191431,-18000,EB445137-D7F5-57EC-87DA-1DB460D64046,"iPhone13,2"
com.apple.weather,1,1713999523,1713999524,1713999524.493726,-18000,EB445137-D7F5-57EC-87DA-1DB460D64046,"iPhone13,2"
com.apple.Maps,17,1713999479,1713999496,1713999496.343046,-18000,EB445137-D7F5-57EC-87DA-1DB460D64046,"iPhone13,2"
com.apple.Maps,14,1713998348,1713998362,1713998362.143776,-18000,EB445137-D7F5-57EC-87DA-1DB460D64046,"iPhone13,2"
com.google.Chrome,3,1713997205,1713997208,1713997208.9776201,-18000,,
com.leomehlig.today,18,1713997187,1713997205,1713997205.75333,-18000,,
com.google.Chrome,103,1713997084,1713997187,1713997187.5067558,-18000,,
com.microsoft.VSCode,10,1713997074,1713997084,1713997084.994015,-18000,,
com.google.Chrome,0,1713997074,1713997074,1713997075.010371,-18000,,
com.microsoft.VSCode,7,1713997067,1713997074,1713997074.34158,-18000,,
com.google.Chrome,6,1713997061,1713997067,1713997067.0746078,-18000,,
com.microsoft.VSCode,5,1713997056,1713997061,1713997061.5627031,-18000,,
com.google.Chrome,12,1713997044,1713997056,1713997056.284179,-18000,,
com.microsoft.VSCode,4,1713997040,1713997044,1713997044.812423,-18000,,
com.apple.Dictionary,2,1713997038,1713997040,1713997040.394584,-18000,,
com.microsoft.VSCode,5,1713997033,1713997038,1713997038.771501,-18000,,
com.google.Chrome,5,1713997028,1713997033,1713997033.2622662,-18000,,
com.microsoft.VSCode,4,1713997024,1713997028,1713997028.1378899,-18000,,
com.google.Chrome,0,1713997024,1713997024,1713997024.8354769,-18000,,
com.microsoft.VSCode,6,1713997018,1713997024,1713997024.121485,-18000,,
com.google.Chrome,61,1713996957,1713997018,1713997018.3432422,-18000,,
com.microsoft.VSCode,4,1713996953,1713996957,1713996957.4580631,-18000,,
com.google.Chrome,9,1713996944,1713996953,1713996953.690713,-18000,,
com.microsoft.VSCode,14,1713996930,1713996944,1713996945.009999,-18000,,
com.google.Chrome,13,1713996917,1713996930,1713996930.5803108,-18000,,
com.microsoft.VSCode,5,1713996912,1713996917,1713996917.274657,-18000,,
com.google.Chrome,1,1713996911,1713996912,1713996912.4096851,-18000,,
com.microsoft.VSCode,4,1713996907,1713996911,1713996911.09569,-18000,,
com.google.Chrome,47,1713996860,1713996907,1713996907.62744,-18000,,
com.microsoft.VSCode,1,1713996859,1713996860,1713996860.66406,-18000,,
com.google.Chrome,2,1713996857,1713996859,1713996859.376575,-18000,,
com.microsoft.VSCode,4,1713996853,1713996857,1713996857.205134,-18000,,
com.google.Chrome,17,1713996836,1713996853,1713996853.729881,-18000,,
com.microsoft.VSCode,3,1713996833,1713996836,1713996836.293246,-18000,,
com.google.Chrome,15,1713996818,1713996833,1713996833.234417,-18000,,
com.microsoft.VSCode,10,1713996808,1713996818,1713996818.1797218,-18000,,
com.google.Chrome,11,1713996797,1713996808,1713996808.22524,-18000,,
com.microsoft.VSCode,31,1713996766,1713996797,1713996797.166575,-18000,,
com.google.Chrome,3,1713996763,1713996766,1713996766.393822,-18000,,
com.microsoft.VSCode,1,1713996762,1713996763,1713996763.522208,-18000,,
com.apple.Preview,1,1713996761,1713996762,1713996762.614326,-18000,,
com.microsoft.VSCode,16,1713996745,1713996761,1713996761.4258242,-18000,,
com.apple.Preview,2,1713996743,1713996745,1713996745.106116,-18000,,
com.google.Chrome,25,1713996718,1713996743,1713996743.7338629,-18000,,
com.microsoft.VSCode,4,1713996714,1713996718,1713996718.91731,-18000,,
com.google.Chrome,7,1713996707,1713996714,1713996714.618655,-18000,,
com.microsoft.VSCode,4,1713996703,1713996707,1713996707.593274,-18000,,
com.google.Chrome,4,1713996699,1713996703,1713996703.596081,-18000,,
com.microsoft.VSCode,9,1713996690,1713996699,1713996699.8496609,-18000,,
com.google.Chrome,1,1713996689,1713996690,1713996690.352518,-18000,,
com.microsoft.VSCode,3,1713996686,1713996689,1713996689.477422,-18000,,
com.google.Chrome,20,1713996666,1713996686,1713996686.585373,-18000,,
com.microsoft.VSCode,4,1713996662,1713996666,1713996666.1642241,-18000,,
com.google.Chrome,1,1713996661,1713996662,1713996662.405628,-18000,,
com.microsoft.VSCode,31,1713996630,1713996661,1713996661.1746678,-18000,,
com.google.Chrome,43,1713996587,1713996630,1713996630.974447,-18000,,
com.microsoft.VSCode,8,1713996579,1713996587,1713996587.99108,-18000,,
com.google.Chrome,34,1713996545,1713996579,1713996579.389518,-18000,,
com.microsoft.VSCode,5,1713996540,1713996545,1713996545.074765,-18000,,
com.google.Chrome,7,1713996533,1713996540,1713996540.5763822,-18000,,
com.microsoft.VSCode,11,1713996522,1713996533,1713996533.165728,-18000,,
com.google.Chrome,10,1713996512,1713996522,1713996522.8979468,-18000,,
com.microsoft.VSCode,2,1713996510,1713996512,1713996512.884468,-18000,,
com.google.Chrome,1,1713996509,1713996510,1713996510.449727,-18000,,
com.microsoft.VSCode,1,1713996508,1713996509,1713996509.908422,-18000,,
com.google.Chrome,17,1713996491,1713996508,1713996508.532593,-18000,,
com.microsoft.VSCode,4,1713996487,1713996491,1713996491.36257,-18000,,
com.google.Chrome,9,1713996478,1713996487,1713996487.7738419,-18000,,
com.microsoft.VSCode,6,1713996472,1713996478,1713996478.110255,-18000,,
com.google.Chrome,8,1713996464,1713996472,1713996472.778089,-18000,,
com.microsoft.VSCode,12,1713996452,1713996464,1713996464.843525,-18000,,
com.google.Chrome,437,1713996015,1713996452,1713996452.6812649,-18000,,
com.microsoft.VSCode,2,1713996013,1713996015,1713996015.964384,-18000,,
com.google.Chrome,27,1713995986,1713996013,1713996013.1779819,-18000,,
com.microsoft.VSCode,24,1713995962,1713995986,1713995986.1803641,-18000,,
com.google.Chrome,1,1713995961,1713995962,1713995962.270979,-18000,,
com.microsoft.VSCode,28,1713995933,1713995961,1713995961.382461,-18000,,
com.google.Chrome,34,1713995899,1713995933,1713995933.647136,-18000,,
com.microsoft.VSCode,2,1713995897,1713995899,1713995899.8641062,-18000,,
com.google.Chrome,1,1713995896,1713995897,1713995897.185766,-18000,,
com.microsoft.VSCode,19,1713995877,1713995896,1713995896.163163,-18000,,
com.google.Chrome,47,1713995830,1713995877,1713995877.118269,-18000,,
com.microsoft.VSCode,4,1713995826,1713995830,1713995830.41856,-18000,,
com.google.Chrome,25,1713995801,1713995826,1713995826.977809,-18000,,
com.microsoft.VSCode,2,1713995799,1713995801,1713995801.870525,-18000,,
com.google.Chrome,6,1713995793,1713995799,1713995799.579101,-18000,,
com.microsoft.VSCode,5,1713995788,1713995793,1713995793.462951,-18000,,
com.google.Chrome,2,1713995786,1713995788,1713995788.381388,-18000,,
com.microsoft.VSCode,4,1713995782,1713995786,1713995786.176866,-18000,,
com.google.Chrome,26,1713995756,1713995782,1713995782.818562,-18000,,
com.microsoft.VSCode,1,1713995755,1713995756,1713995756.8842468,-18000,,
com.google.Chrome,9,1713995746,1713995755,1713995755.157895,-18000,,
com.microsoft.VSCode,4,1713995742,1713995746,1713995747.0252151,-18000,,
com.google.Chrome,6,1713995736,1713995742,1713995742.146418,-18000,,
com.microsoft.VSCode,1,1713995735,1713995736,1713995737.026123,-18000,,
com.google.Chrome,47,1713995688,1713995735,1713995735.581311,-18000,,
com.microsoft.VSCode,8,1713995680,1713995688,1713995689.032722,-18000,,
com.google.Chrome,53,1713995627,1713995680,1713995680.7022362,-18000,,
com.microsoft.VSCode,16,1713995611,1713995627,1713995627.8275762,-18000,,
com.google.Chrome,6,1713995605,1713995611,1713995611.088797,-18000,,
com.microsoft.VSCode,4,1713995601,1713995605,1713995605.898484,-18000,,
com.google.Chrome,323,1713995278,1713995601,1713995601.940425,-18000,,
com.leomehlig.today,4,1713995274,1713995278,1713995278.5391011,-18000,,
com.google.Chrome,33,1713995241,1713995274,1713995275.04036,-18000,,
com.google.Gmail,7,1713995232,1713995239,1713995239.741653,-18000,EB445137-D7F5-57EC-87DA-1DB460D64046,"iPhone13,2"
com.apple.podcasts,6,1713995219,1713995225,1713995225.9879441,-18000,EB445137-D7F5-57EC-87DA-1DB460D64046,"iPhone13,2"
com.apple.podcasts,10,1713994674,1713994684,1713994684.812626,-18000,EB445137-D7F5-57EC-87DA-1DB460D64046,"iPhone13,2"
com.apple.podcasts,3,1713994509,1713994512,1713994512.385971,-18000,EB445137-D7F5-57EC-87DA-1DB460D64046,"iPhone13,2"
com.apple.podcasts,3,1713994431,1713994434,1713994434.281148,-18000,EB445137-D7F5-57EC-87DA-1DB460D64046,"iPhone13,2"
com.apple.podcasts,11,1713993542,1713993553,1713993553.6883512,-18000,EB445137-D7F5-57EC-87DA-1DB460D64046,"iPhone13,2"
com.apple.podcasts,5,1713993526,1713993531,1713993531.5707932,-18000,EB445137-D7F5-57EC-87DA-1DB460D64046,"iPhone13,2"
com.apple.podcasts,8,1713993509,1713993517,1713993517.05517,-18000,EB445137-D7F5-57EC-87DA-1DB460D64046,"iPhone13,2"
com.apple.podcasts,13,1713992446,1713992459,1713992459.3006,-18000,EB445137-D7F5-57EC-87DA-1DB460D64046,"iPhone13,2"
com.apple.podcasts,11,1713992432,1713992443,1713992443.0845242,-18000,EB445137-D7F5-57EC-87DA-1DB460D64046,"iPhone13,2"
com.toyopagroup.picaboo,11,1713992255,1713992266,1713992266.450241,-18000,EB445137-D7F5-57EC-87DA-1DB460D64046,"iPhone13,2"
com.apple.weather,6,1713992249,1713992255,1713992255.180766,-18000,EB445137-D7F5-57EC-87DA-1DB460D64046,"iPhone13,2"
com.apple.weather,6,1713991424,1713991430,1713991430.49795,-18000,EB445137-D7F5-57EC-87DA-1DB460D64046,"iPhone13,2"
com.google.Chrome,151,1713991151,1713991302,1713991302.34381,-18000,,
com.leomehlig.today,10,1713991141,1713991151,1713991151.928142,-18000,,
com.apple.MobileSMS,4,1713991137,1713991141,1713991141.4725761,-18000,,
com.leomehlig.today,3,1713991134,1713991137,1713991137.797739,-18000,,
com.google.Chrome,163,1713990971,1713991134,1713991134.965989,-18000,,
com.leomehlig.today,10,1713990961,1713990971,1713990971.769633,-18000,,
com.google.Chrome,44,1713990917,1713990961,1713990961.800791,-18000,,
com.apple.Preview,2085,1713988832,1713990917,1713990917.055826,-18000,,
com.google.Chrome,10,1713988822,1713988832,1713988832.092215,-18000,,
com.apple.Preview,874,1713987948,1713988822,1713988822.892797,-18000,,
com.leomehlig.today,2,1713987946,1713987948,1713987948.109555,-18000,,
com.apple.Preview,2,1713987944,1713987946,1713987946.3118582,-18000,,
com.apple.finder,5,1713987939,1713987944,1713987944.087374,-18000,,
com.leomehlig.today,83,1713987856,1713987939,1713987939.8577971,-18000,,
com.apple.MobileSMS,9,1713987847,1713987856,1713987856.89528,-18000,,
com.leomehlig.today,1,1713987846,1713987847,1713987847.7975268,-18000,,
com.apple.Preview,3,1713987843,1713987846,1713987846.157309,-18000,,
com.leomehlig.today,1,1713987842,1713987843,1713987843.153168,-18000,,
com.google.Chrome,108,1713987734,1713987842,1713987842.160862,-18000,,
com.microsoft.onenote.mac,3,1713987731,1713987734,1713987734.227118,-18000,,
com.instructure.icanvas,87,1713987712,1713987799,1713987799.873067,-18000,EB445137-D7F5-57EC-87DA-1DB460D64046,"iPhone13,2"
com.apple.calculator,8,1713987704,1713987712,1713987712.385868,-18000,EB445137-D7F5-57EC-87DA-1DB460D64046,"iPhone13,2"
com.microsoft.onenote.mac,2,1713987488,1713987490,1713987490.961581,-18000,,
com.microsoft.onenote.mac,48,1713987439,1713987487,1713987487.879569,-18000,,
com.google.Chrome,2,1713987437,1713987439,1713987439.45347,-18000,,
com.apple.calculator,126,1713987312,1713987438,1713987438.5615811,-18000,EB445137-D7F5-57EC-87DA-1DB460D64046,"iPhone13,2"
edu.illinois.rokwire.ios,2,1713987310,1713987312,1713987313.238059,-18000,EB445137-D7F5-57EC-87DA-1DB460D64046,"iPhone13,2"
edu.illinois.rokwire.ios,10,1713987179,1713987189,1713987189.742651,-18000,EB445137-D7F5-57EC-87DA-1DB460D64046,"iPhone13,2"
edu.illinois.rokwire.ios,1,1713986179,1713986180,1713986180.9842172,-18000,EB445137-D7F5-57EC-87DA-1DB460D64046,"iPhone13,2"
edu.illinois.rokwire.ios,29,1713985206,1713985235,1713985235.860296,-18000,EB445137-D7F5-57EC-87DA-1DB460D64046,"iPhone13,2"
com.apple.Music,3,1713985203,1713985206,1713985206.799968,-18000,EB445137-D7F5-57EC-87DA-1DB460D64046,"iPhone13,2"
com.apple.Music,18,1713985123,1713985141,1713985141.5886889,-18000,EB445137-D7F5-57EC-87DA-1DB460D64046,"iPhone13,2"
com.hammerandchisel.discord,2,1713985121,1713985123,1713985123.5258641,-18000,EB445137-D7F5-57EC-87DA-1DB460D64046,"iPhone13,2"
com.hammerandchisel.discord,82,1713984999,1713985081,1713985081.9424272,-18000,EB445137-D7F5-57EC-87DA-1DB460D64046,"iPhone13,2"
com.hammerandchisel.discord,21,1713984874,1713984895,1713984895.964252,-18000,EB445137-D7F5-57EC-87DA-1DB460D64046,"iPhone13,2"
com.google.Chrome,25,1713981644,1713981669,1713981669.38919,-18000,,
com.microsoft.VSCode,3,1713981641,1713981644,1713981644.50757,-18000,,
com.google.Chrome,5,1713981636,1713981641,1713981642.0269551,-18000,,
com.microsoft.VSCode,1,1713981635,1713981636,1713981636.323935,-18000,,
com.google.Chrome,2,1713981633,1713981635,1713981635.690218,-18000,,
com.microsoft.VSCode,1,1713981632,1713981633,1713981633.869983,-18000,,
com.google.Chrome,11,1713981621,1713981632,1713981632.907493,-18000,,
com.microsoft.VSCode,4,1713981617,1713981621,1713981621.143283,-18000,,
com.google.Chrome,9,1713981608,1713981617,1713981617.1937761,-18000,,
com.microsoft.VSCode,4,1713981604,1713981608,1713981608.583657,-18000,,
com.google.Chrome,9,1713981595,1713981604,1713981604.272295,-18000,,
com.microsoft.VSCode,2,1713981593,1713981595,1713981595.648859,-18000,,
com.google.Chrome,5,1713981588,1713981593,1713981593.3075619,-18000,,
com.microsoft.VSCode,3,1713981585,1713981588,1713981588.632679,-18000,,
com.google.Chrome,2,1713981583,1713981585,1713981585.527312,-18000,,
com.microsoft.VSCode,1,1713981582,1713981583,1713981583.253761,-18000,,
com.google.Chrome,18,1713981564,1713981582,1713981582.281893,-18000,,
com.microsoft.VSCode,2,1713981562,1713981564,1713981564.4243898,-18000,,
com.google.Chrome,5,1713981557,1713981562,1713981562.583633,-18000,,
com.microsoft.VSCode,1,1713981556,1713981557,1713981557.864266,-18000,,
com.google.Chrome,6,1713981550,1713981556,1713981556.823791,-18000,,
com.microsoft.VSCode,2,1713981548,1713981550,1713981550.6811628,-18000,,
com.google.Chrome,12,1713981536,1713981548,1713981549.023727,-18000,,
com.microsoft.VSCode,15,1713981521,1713981536,1713981536.60442,-18000,,
com.google.Chrome,88,1713981433,1713981521,1713981522.037074,-18000,,
com.microsoft.VSCode,18,1713981415,1713981433,1713981433.293746,-18000,,
com.google.Chrome,3,1713981412,1713981415,1713981415.9283528,-18000,,
com.microsoft.VSCode,6,1713981406,1713981412,1713981413.020019,-18000,,
com.google.Chrome,22,1713981384,1713981406,1713981406.197865,-18000,,
com.microsoft.VSCode,22,1713981362,1713981384,1713981384.262823,-18000,,
com.google.Chrome,522,1713980840,1713981362,1713981362.643352,-18000,,
com.microsoft.VSCode,1,1713980839,1713980840,1713980840.419114,-18000,,
com.google.Chrome,6,1713980833,1713980839,1713980839.62679,-18000,,
com.microsoft.VSCode,1,1713980832,1713980833,1713980833.476315,-18000,,
com.google.Chrome,34,1713980798,1713980832,1713980832.7032251,-18000,,
com.microsoft.VSCode,1,1713980797,1713980798,1713980798.3074799,-18000,,
com.google.Chrome,10,1713980787,1713980797,1713980797.607418,-18000,,
com.microsoft.VSCode,1,1713980786,1713980787,1713980787.580353,-18000,,
com.google.Chrome,8,1713980778,1713980786,1713980786.7303638,-18000,,
com.microsoft.VSCode,1,1713980777,1713980778,1713980778.274014,-18000,,
com.google.Chrome,97,1713980680,1713980777,1713980777.465591,-18000,,
com.microsoft.VSCode,1,1713980679,1713980680,1713980680.7109652,-18000,,
com.google.Chrome,27,1713980652,1713980679,1713980679.531884,-18000,,
com.microsoft.VSCode,1,1713980651,1713980652,1713980652.487938,-18000,,
com.google.Chrome,1,1713980650,1713980651,1713980651.487077,-18000,,
com.microsoft.VSCode,22,1713980628,1713980650,1713980650.220622,-18000,,
com.google.Chrome,4,1713980624,1713980628,1713980628.754785,-18000,,
com.microsoft.VSCode,2,1713980622,1713980624,1713980624.7660909,-18000,,
com.google.Chrome,29,1713980593,1713980622,1713980623.013633,-18000,,
com.microsoft.VSCode,3,1713980590,1713980593,1713980593.708926,-18000,,
com.google.Chrome,112,1713980478,1713980590,1713980590.240834,-18000,,
com.microsoft.VSCode,20,1713980458,1713980478,1713980478.299282,-18000,,
com.google.Chrome,16,1713980442,1713980458,1713980458.3238878,-18000,,
com.microsoft.VSCode,1,1713980441,1713980442,1713980442.90692,-18000,,
com.google.Chrome,19,1713980422,1713980441,1713980442.020482,-18000,,
com.microsoft.VSCode,1,1713980421,1713980422,1713980422.920449,-18000,,
com.google.Chrome,19,1713980402,1713980421,1713980421.614908,-18000,,
com.microsoft.VSCode,5,1713980397,1713980402,1713980402.6405969,-18000,,
com.google.Chrome,17,1713980380,1713980397,1713980397.291852,-18000,,
com.microsoft.VSCode,2,1713980378,1713980380,1713980380.167029,-18000,,
com.google.Chrome,17,1713980361,1713980378,1713980378.461154,-18000,,
com.microsoft.VSCode,7,1713980354,1713980361,1713980361.04934,-18000,,
com.google.Chrome,31,1713980323,1713980354,1713980354.139674,-18000,,
com.microsoft.VSCode,11,1713980312,1713980323,1713980324.0248241,-18000,,
com.google.Chrome,74,1713980238,1713980312,1713980312.436284,-18000,,
com.apple.Dictionary,1,1713980237,1713980238,1713980239.098486,-18000,,
com.google.Chrome,99,1713980138,1713980237,1713980237.0743341,-18000,,
com.apple.mobileslideshow,12,1713978974,1713978986,1713978986.778043,-18000,EB445137-D7F5-57EC-87DA-1DB460D64046,"iPhone13,2"
edu.illinois.rokwire.ios,3,1713978966,1713978969,1713978969.710619,-18000,EB445137-D7F5-57EC-87DA-1DB460D64046,"iPhone13,2"
edu.illinois.rokwire.ios,20,1713978674,1713978694,1713978694.558038,-18000,EB445137-D7F5-57EC-87DA-1DB460D64046,"iPhone13,2"
com.apple.MobileSMS,11,1713978560,1713978571,1713978571.421678,-18000,EB445137-D7F5-57EC-87DA-1DB460D64046,"iPhone13,2"
com.apple.MobileSMS,11,1713977530,1713977541,1713977541.9642448,-18000,EB445137-D7F5-57EC-87DA-1DB460D64046,"iPhone13,2"
com.apple.MobileSMS,7,1713977479,1713977486,1713977486.511104,-18000,EB445137-D7F5-57EC-87DA-1DB460D64046,"iPhone13,2"
com.apple.MobileSMS,1,1713977470,1713977471,1713977471.006096,-18000,EB445137-D7F5-57EC-87DA-1DB460D64046,"iPhone13,2"
com.apple.InCallService,1,1713977469,1713977470,1713977470.2286968,-18000,EB445137-D7F5-57EC-87DA-1DB460D64046,"iPhone13,2"
com.apple.InCallService,2,1713977438,1713977440,1713977447.4182749,-18000,EB445137-D7F5-57EC-87DA-1DB460D64046,"iPhone13,2"
com.apple.MobileSMS,6,1713977432,1713977438,1713977438.543072,-18000,EB445137-D7F5-57EC-87DA-1DB460D64046,"iPhone13,2"
com.apple.findmy,12,1713977419,1713977431,1713977431.883105,-18000,EB445137-D7F5-57EC-87DA-1DB460D64046,"iPhone13,2"
com.toyopagroup.picaboo,2,1713977416,1713977418,1713977419.176862,-18000,EB445137-D7F5-57EC-87DA-1DB460D64046,"iPhone13,2"
com.google.Chrome,587,1713975686,1713976273,1713976273.6140409,-18000,,
com.microsoft.VSCode,13,1713975673,1713975686,1713975686.710285,-18000,,
com.google.Chrome,388,1713975285,1713975673,1713975673.763082,-18000,,
com.microsoft.VSCode,70,1713975215,1713975285,1713975285.901073,-18000,,
com.google.Chrome,60,1713975155,1713975215,1713975215.780412,-18000,,
com.microsoft.VSCode,6,1713975149,1713975155,1713975155.9001021,-18000,,
com.google.Chrome,1,1713975148,1713975149,1713975149.373337,-18000,,
com.microsoft.VSCode,10,1713975138,1713975148,1713975148.289442,-18000,,
com.google.Chrome,16,1713975122,1713975138,1713975138.329094,-18000,,
com.microsoft.VSCode,20,1713975102,1713975122,1713975122.161779,-18000,,
com.google.Chrome,58,1713975044,1713975102,1713975102.14752,-18000,,
com.apple.finder,14,1713974960,1713974974,1713974974.134305,-18000,,
com.apple.Preview,50,1713974910,1713974960,1713974960.449476,-18000,,
com.apple.finder,33,1713974877,1713974910,1713974910.585174,-18000,,
com.google.Chrome,76,1713974801,1713974877,1713974877.9220328,-18000,,
com.microsoft.VSCode,2,1713974799,1713974801,1713974801.728703,-18000,,
com.google.Chrome,31,1713974768,1713974799,1713974799.142879,-18000,,
com.microsoft.VSCode,4,1713974764,1713974768,1713974768.649972,-18000,,
com.google.Chrome,37,1713974727,1713974764,1713974764.8823671,-18000,,
com.microsoft.VSCode,2,1713974725,1713974727,1713974727.3888311,-18000,,
com.google.Chrome,38,1713974687,1713974725,1713974725.349551,-18000,,
com.microsoft.VSCode,13,1713974674,1713974687,1713974687.385401,-18000,,
com.google.Chrome,75,1713974599,1713974674,1713974674.5947928,-18000,,
com.apple.MobileSMS,1,1713974598,1713974599,1713974599.577718,-18000,,
com.google.Chrome,73,1713974525,1713974598,1713974598.649404,-18000,,
com.apple.MobileSMS,1,1713974524,1713974525,1713974525.382854,-18000,,
com.google.Chrome,15,1713974509,1713974524,1713974524.531893,-18000,,
com.apple.MobileSMS,1,1713974508,1713974509,1713974509.736368,-18000,,
com.google.Chrome,89,1713974419,1713974508,1713974508.976083,-18000,,
com.apple.MobileSMS,1,1713974418,1713974419,1713974419.578596,-18000,,
com.google.Chrome,62,1713974356,1713974418,1713974418.728839,-18000,,
com.microsoft.VSCode,44,1713974312,1713974356,1713974356.079969,-18000,,
com.google.Chrome,3,1713974309,1713974312,1713974312.213768,-18000,,
com.toyopagroup.picaboo,5,1713973919,1713973924,1713973924.97577,-18000,EB445137-D7F5-57EC-87DA-1DB460D64046,"iPhone13,2"
com.toyopagroup.picaboo,15,1713973260,1713973275,1713973275.1493568,-18000,EB445137-D7F5-57EC-87DA-1DB460D64046,"iPhone13,2"
com.google.Chrome,384,1713972845,1713973229,1713973229.792472,-18000,,
com.microsoft.VSCode,3,1713972842,1713972845,1713972845.379579,-18000,,
com.google.Chrome,6,1713972836,1713972842,1713972842.773979,-18000,,
com.microsoft.VSCode,1,1713972835,1713972836,1713972836.7835011,-18000,,
com.google.Chrome,28,1713972807,1713972835,1713972835.211988,-18000,,
com.microsoft.VSCode,2,1713972805,1713972807,1713972807.546365,-18000,,
com.google.Chrome,6,1713972799,1713972805,1713972805.9646292,-18000,,
com.microsoft.VSCode,1,1713972798,1713972799,1713972799.6714969,-18000,,
com.google.Chrome,23,1713972775,1713972798,1713972798.901938,-18000,,
com.microsoft.VSCode,1,1713972774,1713972775,1713972775.887941,-18000,,
com.google.Chrome,13,1713972761,1713972774,1713972774.7435632,-18000,,
com.microsoft.VSCode,1,1713972760,1713972761,1713972761.7739592,-18000,,
com.apple.MobileSMS,1,1713972759,1713972760,1713972760.5125031,-18000,,
com.google.Chrome,59,1713972700,1713972759,1713972759.071807,-18000,,
com.apple.MobileSMS,7,1713972693,1713972700,1713972700.759581,-18000,,
com.google.Chrome,16,1713972677,1713972693,1713972693.678294,-18000,,
com.microsoft.VSCode,8,1713972669,1713972677,1713972677.663436,-18000,,
com.google.Chrome,15,1713972654,1713972669,1713972670.015435,-18000,,
com.microsoft.VSCode,7,1713972647,1713972654,1713972654.397011,-18000,,
com.google.Chrome,44,1713972603,1713972647,1713972647.516313,-18000,,
com.microsoft.VSCode,12,1713972591,1713972603,1713972603.038179,-18000,,
com.google.Chrome,14,1713972577,1713972591,1713972591.235172,-18000,,
com.microsoft.VSCode,29,1713972548,1713972577,1713972577.521868,-18000,,
com.google.Chrome,42,1713972506,1713972548,1713972548.1388888,-18000,,
com.microsoft.VSCode,1,1713972505,1713972506,1713972506.679553,-18000,,
com.google.Chrome,83,1713972422,1713972505,1713972505.742563,-18000,,
com.microsoft.VSCode,6,1713972416,1713972422,1713972422.0809522,-18000,,
com.google.Chrome,1,1713972415,1713972416,1713972416.256331,-18000,,
com.microsoft.VSCode,1,1713972414,1713972415,1713972415.862249,-18000,,
com.google.Chrome,14,1713972400,1713972414,1713972414.52303,-18000,,
com.microsoft.VSCode,13,1713972387,1713972400,1713972400.817256,-18000,,
com.google.Chrome,25,1713972362,1713972387,1713972387.325838,-18000,,
com.microsoft.VSCode,7,1713972355,1713972362,1713972362.73949,-18000,,
com.google.Chrome,2,1713972353,1713972355,1713972355.773854,-18000,,
com.microsoft.VSCode,1,1713972352,1713972353,1713972353.336475,-18000,,
com.google.Chrome,6,1713972346,1713972352,1713972352.2242,-18000,,
com.microsoft.VSCode,1,1713972345,1713972346,1713972346.1801372,-18000,,
com.google.Chrome,12,1713972333,1713972345,1713972345.332442,-18000,,
com.microsoft.VSCode,0,1713972333,1713972333,1713972334.0282779,-18000,,
com.google.Chrome,11,1713972322,1713972333,1713972333.200711,-18000,,
com.microsoft.VSCode,0,1713972322,1713972322,1713972323.042313,-18000,,
com.google.Chrome,8,1713972314,1713972322,1713972322.0871239,-18000,,
com.microsoft.VSCode,4,1713972310,1713972314,1713972314.536289,-18000,,
com.google.Chrome,9,1713972301,1713972310,1713972310.959437,-18000,,
com.apple.MobileSMS,7,1713972294,1713972301,1713972301.2576041,-18000,,
com.google.Chrome,125,1713972169,1713972294,1713972294.627147,-18000,,
com.microsoft.VSCode,2,1713972167,1713972169,1713972169.748038,-18000,,
com.google.Chrome,4,1713972163,1713972167,1713972167.8920422,-18000,,
com.microsoft.VSCode,1,1713972162,1713972163,1713972163.980301,-18000,,
com.google.Chrome,7,1713972155,1713972162,1713972162.5199862,-18000,,
com.microsoft.VSCode,4,1713972151,1713972155,1713972155.570859,-18000,,
com.google.Chrome,46,1713972105,1713972151,1713972151.957912,-18000,,
com.microsoft.VSCode,3,1713972102,1713972105,1713972106.044839,-18000,,
com.google.Chrome,262,1713971840,1713972102,1713972102.2864928,-18000,,
com.microsoft.VSCode,5,1713971835,1713971840,1713971840.176038,-18000,,
com.google.Chrome,3,1713971832,1713971835,1713971835.6614552,-18000,,
com.microsoft.VSCode,17,1713971815,1713971832,1713971832.197557,-18000,,
com.google.Chrome,104,1713971711,1713971815,1713971815.28026,-18000,,
com.microsoft.VSCode,18,1713971693,1713971711,1713971712.027142,-18000,,
com.google.Chrome,31,1713971662,1713971693,1713971693.1683002,-18000,,
com.microsoft.VSCode,11,1713971651,1713971662,1713971662.5267081,-18000,,
com.google.Chrome,193,1713971458,1713971651,1713971651.5246081,-18000,,
com.microsoft.VSCode,5,1713971453,1713971458,1713971458.399342,-18000,,
com.google.Chrome,5,1713971448,1713971453,1713971453.424965,-18000,,
com.microsoft.VSCode,9,1713971439,1713971448,1713971448.3188062,-18000,,
com.google.Chrome,186,1713971253,1713971439,1713971439.356863,-18000,,
com.microsoft.VSCode,17,1713971236,1713971253,1713971253.0750098,-18000,,
com.google.Chrome,14,1713971222,1713971236,1713971236.297213,-18000,,
com.microsoft.VSCode,9,1713971213,1713971222,1713971222.137323,-18000,,
com.google.Chrome,17,1713971196,1713971213,1713971213.634673,-18000,,
com.microsoft.VSCode,4,1713971192,1713971196,1713971196.100004,-18000,,
com.google.Chrome,3,1713971189,1713971192,1713971192.472595,-18000,,
com.microsoft.VSCode,4,1713971185,1713971189,1713971189.29001,-18000,,
com.google.Chrome,28,1713971157,1713971185,1713971185.350891,-18000,,
com.microsoft.VSCode,2,1713971155,1713971157,1713971157.091553,-18000,,
com.google.Chrome,10,1713971145,1713971155,1713971155.8421268,-18000,,
com.microsoft.VSCode,5,1713971140,1713971145,1713971145.418997,-18000,,
com.google.Chrome,13,1713971127,1713971140,1713971140.857211,-18000,,
com.microsoft.VSCode,2,1713971125,1713971127,1713971127.774253,-18000,,
com.google.Chrome,7,1713971118,1713971125,1713971125.873539,-18000,,
com.microsoft.VSCode,6,1713971112,1713971118,1713971118.6211982,-18000,,
com.google.Chrome,11,1713971101,1713971112,1713971112.263198,-18000,,
com.microsoft.VSCode,2,1713971099,1713971101,1713971101.939306,-18000,,
com.google.Chrome,47,1713971052,1713971099,1713971099.87534,-18000,,
com.microsoft.VSCode,4,1713971048,1713971052,1713971052.580627,-18000,,
com.google.Chrome,3,1713971045,1713971048,1713971048.511658,-18000,,
com.microsoft.VSCode,19,1713971026,1713971045,1713971045.8335671,-18000,,
com.google.Chrome,5,1713971021,1713971026,1713971026.38239,-18000,,
com.microsoft.VSCode,0,1713971021,1713971021,1713971021.77441,-18000,,
com.google.Chrome,14,1713971007,1713971021,1713971021.180306,-18000,,
com.microsoft.VSCode,3,1713971004,1713971007,1713971007.139584,-18000,,
com.google.Chrome,35,1713970969,1713971004,1713971004.271028,-18000,,
com.microsoft.VSCode,6,1713970963,1713970969,1713970969.387549,-18000,,
com.google.Chrome,30,1713970933,1713970963,1713970963.901267,-18000,,
com.microsoft.VSCode,10,1713970923,1713970933,1713970933.943532,-18000,,
com.google.Chrome,1,1713970922,1713970923,1713970923.204226,-18000,,
com.microsoft.VSCode,9,1713970913,1713970922,1713970922.061346,-18000,,
com.google.Chrome,14,1713970899,1713970913,1713970913.056491,-18000,,
com.microsoft.VSCode,2,1713970897,1713970899,1713970899.0958261,-18000,,
com.google.Chrome,6,1713970891,1713970897,1713970897.296931,-18000,,
com.microsoft.VSCode,1,1713970890,1713970891,1713970891.967958,-18000,,
com.google.Chrome,4,1713970886,1713970890,1713970890.104609,-18000,,
com.microsoft.VSCode,3,1713970883,1713970886,1713970886.830155,-18000,,
com.google.Chrome,9,1713970874,1713970883,1713970883.642492,-18000,,
com.microsoft.VSCode,11,1713970863,1713970874,1713970874.6946568,-18000,,
com.google.Chrome,2,1713970861,1713970863,1713970863.162612,-18000,,
com.microsoft.VSCode,7,1713970854,1713970861,1713970861.163224,-18000,,
com.google.Chrome,19,1713970835,1713970854,1713970854.8502378,-18000,,
com.microsoft.VSCode,2,1713970833,1713970835,1713970835.897825,-18000,,
com.google.Chrome,5,1713970828,1713970833,1713970833.641619,-18000,,
com.microsoft.VSCode,4,1713970824,1713970828,1713970828.3013802,-18000,,
com.google.Chrome,9,1713970815,1713970824,1713970824.685631,-18000,,
com.microsoft.VSCode,1,1713970814,1713970815,1713970815.9987888,-18000,,
com.google.Chrome,4,1713970810,1713970814,1713970814.3430672,-18000,,
com.microsoft.VSCode,2,1713970808,1713970810,1713970810.558981,-18000,,
com.google.Chrome,2,1713970806,1713970808,1713970808.964983,-18000,,
com.microsoft.VSCode,2,1713970804,1713970806,1713970806.864954,-18000,,
com.google.Chrome,2,1713970802,1713970804,1713970804.5218592,-18000,,
com.microsoft.VSCode,1,1713970801,1713970802,1713970802.2038279,-18000,,
com.google.Chrome,1,1713970800,1713970801,1713970801.5030298,-18000,,
com.microsoft.VSCode,1,1713970799,1713970800,1713970800.407596,-18000,,
com.google.Chrome,2,1713970797,1713970799,1713970799.309083,-18000,,
com.microsoft.VSCode,4,1713970793,1713970797,1713970797.2551332,-18000,,
com.google.Chrome,14,1713970779,1713970793,1713970793.821896,-18000,,
com.microsoft.VSCode,5,1713970774,1713970779,1713970779.680025,-18000,,
com.google.Chrome,88,1713970686,1713970774,1713970774.095244,-18000,,
com.microsoft.VSCode,13,1713970673,1713970686,1713970686.9293551,-18000,,
com.google.Chrome,28,1713970645,1713970673,1713970673.283759,-18000,,
com.microsoft.VSCode,2,1713970643,1713970645,1713970645.2089481,-18000,,
com.google.Chrome,11,1713970632,1713970643,1713970643.248239,-18000,,
com.microsoft.VSCode,20,1713970612,1713970632,1713970632.452121,-18000,,
com.google.Chrome,10,1713970602,1713970612,1713970612.983385,-18000,,
com.microsoft.VSCode,0,1713970602,1713970602,1713970602.9189692,-18000,,
com.google.Chrome,10,1713970592,1713970602,1713970602.068826,-18000,,
com.microsoft.VSCode,2,1713970590,1713970592,1713970592.069878,-18000,,
com.google.Chrome,22,1713970568,1713970590,1713970590.8730788,-18000,,
com.microsoft.VSCode,1,1713970567,1713970568,1713970568.4796019,-18000,,
com.google.Chrome,5,1713970562,1713970567,1713970567.5563688,-18000,,
com.microsoft.VSCode,2,1713970560,1713970562,1713970562.882098,-18000,,
com.google.Chrome,17,1713970543,1713970560,1713970560.1132169,-18000,,
com.microsoft.VSCode,1,1713970542,1713970543,1713970543.1863642,-18000,,
com.google.Chrome,1,1713970541,1713970542,1713970542.343456,-18000,,
com.microsoft.VSCode,3,1713970538,1713970541,1713970541.16626,-18000,,
com.google.Chrome,16,1713970522,1713970538,1713970538.774251,-18000,,
com.microsoft.VSCode,5,1713970517,1713970522,1713970522.436555,-18000,,
com.google.Chrome,26,1713970491,1713970517,1713970517.758832,-18000,,
com.microsoft.VSCode,4,1713970487,1713970491,1713970491.190867,-18000,,
com.google.Chrome,20,1713970467,1713970487,1713970487.5418758,-18000,,
com.microsoft.VSCode,4,1713970463,1713970467,1713970467.2102299,-18000,,
com.google.Chrome,9,1713970454,1713970463,1713970463.45894,-18000,,
com.microsoft.VSCode,17,1713970437,1713970454,1713970454.5392041,-18000,,
com.google.Chrome,288,1713970149,1713970437,1713970437.218147,-18000,,
com.microsoft.VSCode,29,1713970120,1713970149,1713970149.287416,-18000,,
com.google.Chrome,291,1713969829,1713970120,1713970120.487294,-18000,,
com.microsoft.VSCode,3,1713969826,1713969829,1713969829.086646,-18000,,
com.google.Chrome,1,1713969825,1713969826,1713969826.480389,-18000,,
com.microsoft.VSCode,13,1713969812,1713969825,1713969825.924543,-18000,,
com.google.Chrome,279,1713969533,1713969812,1713969812.2162719,-18000,,
com.microsoft.VSCode,1,1713969532,1713969533,1713969533.882018,-18000,,
com.google.Chrome,10,1713969522,1713969532,1713969532.378571,-18000,,
com.microsoft.VSCode,2,1713969520,1713969522,1713969522.7738972,-18000,,
com.google.Chrome,5,1713969515,1713969520,1713969520.162712,-18000,,
com.microsoft.VSCode,5,1713969510,1713969515,1713969516.014093,-18000,,
com.google.Chrome,6,1713969504,1713969510,1713969510.7941499,-18000,,
com.microsoft.VSCode,1,1713969503,1713969504,1713969504.708857,-18000,,
com.google.Chrome,4,1713969499,1713969503,1713969503.65841,-18000,,
com.microsoft.VSCode,4,1713969495,1713969499,1713969499.7779288,-18000,,
com.google.Chrome,17,1713969478,1713969495,1713969495.5070739,-18000,,
com.microsoft.VSCode,34,1713969444,1713969478,1713969478.338398,-18000,,
com.google.Chrome,123,1713969321,1713969444,1713969444.381808,-18000,,
com.microsoft.VSCode,3,1713969318,1713969321,1713969321.7942939,-18000,,
com.google.Chrome,60,1713969258,1713969318,1713969318.943033,-18000,,
com.microsoft.VSCode,2,1713969256,1713969258,1713969258.423644,-18000,,
com.google.Chrome,3,1713969253,1713969256,1713969256.4086351,-18000,,
com.microsoft.VSCode,2,1713969251,1713969253,1713969254.024809,-18000,,
com.google.Chrome,1,1713969250,1713969251,1713969251.838459,-18000,,
com.microsoft.VSCode,2,1713969248,1713969250,1713969250.1108809,-18000,,
com.google.Chrome,10,1713969238,1713969248,1713969248.841198,-18000,,
com.microsoft.VSCode,3,1713969235,1713969238,1713969238.721457,-18000,,
com.google.Chrome,3,1713969232,1713969235,1713969235.26832,-18000,,
com.microsoft.VSCode,2,1713969230,1713969232,1713969232.294481,-18000,,
com.google.Chrome,4,1713969226,1713969230,1713969230.8469272,-18000,,
com.microsoft.VSCode,4,1713969222,1713969226,1713969226.378223,-18000,,
com.google.Chrome,4,1713969218,1713969222,1713969222.765156,-18000,,
com.microsoft.VSCode,4,1713969214,1713969218,1713969218.157157,-18000,,
com.google.Chrome,6,1713969208,1713969214,1713969214.5951428,-18000,,
com.microsoft.VSCode,2,1713969206,1713969208,1713969208.1942601,-18000,,
com.google.Chrome,6,1713969200,1713969206,1713969206.248722,-18000,,
com.microsoft.VSCode,4,1713969196,1713969200,1713969200.9061298,-18000,,
com.google.Chrome,17,1713969179,1713969196,1713969196.707969,-18000,,
com.microsoft.VSCode,4,1713969175,1713969179,1713969179.351686,-18000,,
com.google.Chrome,20,1713969155,1713969175,1713969175.042531,-18000,,
com.microsoft.VSCode,41,1713969114,1713969155,1713969155.264605,-18000,,
com.google.Chrome,30,1713969084,1713969114,1713969114.199596,-18000,,
com.microsoft.VSCode,23,1713969061,1713969084,1713969084.729707,-18000,,
com.google.Chrome,15,1713969046,1713969061,1713969061.5965428,-18000,,
com.microsoft.onenote.mac,2,1713969044,1713969046,1713969046.603776,-18000,,
com.google.Chrome,2,1713969042,1713969044,1713969044.39852,-18000,,
com.apple.Preferences,10,1713967736,1713967746,1713967746.582137,-18000,EB445137-D7F5-57EC-87DA-1DB460D64046,"iPhone13,2"
com.apple.weather,9,1713967724,1713967733,1713967733.301044,-18000,EB445137-D7F5-57EC-87DA-1DB460D64046,"iPhone13,2"
com.apple.camera,13,1713967552,1713967565,1713967565.603351,-18000,EB445137-D7F5-57EC-87DA-1DB460D64046,"iPhone13,2"
com.google.Chrome,15,1713928149,1713928164,1713928164.934093,-18000,,
com.microsoft.onenote.mac,26,1713928123,1713928149,1713928149.49701,-18000,,
com.google.Chrome,4,1713928119,1713928123,1713928123.488756,-18000,,
com.apple.MobileSMS,5,1713928114,1713928119,1713928119.693291,-18000,,
com.google.Chrome,175,1713927939,1713928114,1713928114.4697418,-18000,,
com.google.Chrome,566,1713927371,1713927937,1713927937.10514,-18000,,
com.apple.finder,15,1713927356,1713927371,1713927371.382282,-18000,,
com.google.Chrome,7,1713927349,1713927356,1713927356.850644,-18000,,
com.google.Chrome,1272,1713925885,1713927157,1713927157.078551,-18000,,
com.apple.MobileSMS,4,1713925881,1713925885,1713925885.885703,-18000,,
com.google.Chrome,138,1713925743,1713925881,1713925881.3398418,-18000,,
com.apple.finder,1,1713925742,1713925743,1713925743.300725,-18000,,
com.google.Chrome,135,1713925607,1713925742,1713925742.919067,-18000,,
com.apple.iCal,55,1713925552,1713925607,1713925607.711132,-18000,,
com.google.Chrome,502,1713925050,1713925552,1713925552.196035,-18000,,
com.apple.finder,67,1713924983,1713925050,1713925050.976225,-18000,,
com.google.Chrome,10,1713924973,1713924983,1713924983.508312,-18000,,
com.microsoft.onenote.mac,270,1713924703,1713924973,1713924973.76201,-18000,,
com.google.Chrome,7,1713924696,1713924703,1713924703.5037231,-18000,,
com.microsoft.onenote.mac,269,1713924427,1713924696,1713924696.7792392,-18000,,
com.google.Chrome,58,1713924369,1713924427,1713924427.23826,-18000,,
com.microsoft.onenote.mac,34,1713924335,1713924369,1713924369.790072,-18000,,
com.google.Chrome,2,1713924333,1713924335,1713924335.188581,-18000,,
com.microsoft.onenote.mac,5,1713924328,1713924333,1713924333.623745,-18000,,
com.google.Chrome,5,1713924323,1713924328,1713924328.3445048,-18000,,
com.microsoft.onenote.mac,6,1713924317,1713924323,1713924324.067158,-18000,,
com.google.Chrome,48,1713924269,1713924317,1713924317.3971372,-18000,,
com.apple.calculator,2,1713924267,1713924269,1713924269.364707,-18000,,
com.google.Chrome,149,1713924118,1713924267,1713924267.70133,-18000,,
com.apple.calculator,21,1713924097,1713924118,1713924118.994925,-18000,,
com.microsoft.onenote.mac,156,1713923941,1713924097,1713924097.583799,-18000,,
com.apple.calculator,13,1713923928,1713923941,1713923941.857171,-18000,,
com.microsoft.onenote.mac,7,1713923921,1713923928,1713923928.954072,-18000,,
com.apple.calculator,19,1713923902,1713923921,1713923921.516567,-18000,,
com.microsoft.onenote.mac,10,1713923892,1713923902,1713923902.2419748,-18000,,
com.apple.calculator,10,1713923882,1713923892,1713923892.9633942,-18000,,
com.microsoft.onenote.mac,91,1713923791,1713923882,1713923882.0354,-18000,,
com.google.Chrome,113,1713923678,1713923791,1713923791.397657,-18000,,
com.leomehlig.today,1,1713923677,1713923678,1713923678.4827418,-18000,,
com.google.Chrome,259,1713923418,1713923677,1713923677.4762921,-18000,,
com.leomehlig.today,126,1713923292,1713923418,1713923418.8679361,-18000,,
com.google.Chrome,2,1713923290,1713923292,1713923292.287202,-18000,,
com.leomehlig.today,101,1713923189,1713923290,1713923290.873434,-18000,,
com.hnc.Discord,95,1713923094,1713923189,1713923190.276984,-18000,,
com.leomehlig.today,40,1713923054,1713923094,1713923094.874181,-18000,,
com.google.Chrome,182,1713922872,1713923054,1713923054.106061,-18000,,
com.leomehlig.today,9,1713922863,1713922872,1713922872.3468199,-18000,,
com.apple.Health,9,1713922788,1713922797,1713922797.816471,-18000,EB445137-D7F5-57EC-87DA-1DB460D64046,"iPhone13,2"
com.apple.Health,18,1713922768,1713922786,1713922786.2347488,-18000,EB445137-D7F5-57EC-87DA-1DB460D64046,"iPhone13,2"
com.apple.Health,21,1713920853,1713920874,1713920874.551993,-18000,EB445137-D7F5-57EC-87DA-1DB460D64046,"iPhone13,2"
com.microsoft.Office.Outlook,3,1713920842,1713920845,1713920845.524535,-18000,EB445137-D7F5-57EC-87DA-1DB460D64046,"iPhone13,2"
com.google.Gmail,4,1713920837,1713920841,1713920841.6038032,-18000,EB445137-D7F5-57EC-87DA-1DB460D64046,"iPhone13,2"
com.google.Sheets,6,1713920831,1713920837,1713920838.027041,-18000,EB445137-D7F5-57EC-87DA-1DB460D64046,"iPhone13,2"
com.leomehlig.today,34,1713920644,1713920678,1713920678.920395,-18000,,
com.google.Chrome,2364,1713918280,1713920644,1713920645.1056051,-18000,,
com.leomehlig.today,9,1713918271,1713918280,1713918280.628652,-18000,,
com.google.Sheets,6,1713917158,1713917164,1713917164.579078,-18000,EB445137-D7F5-57EC-87DA-1DB460D64046,"iPhone13,2"
com.google.Sheets,2,1713916994,1713916996,1713916996.769751,-18000,EB445137-D7F5-57EC-87DA-1DB460D64046,"iPhone13,2"
com.google.Chrome,1307,1713916964,1713918271,1713918271.7130861,-18000,,
com.apple.systempreferences,11,1713916953,1713916964,1713916964.531372,-18000,,
com.google.Chrome,18,1713916929,1713916947,1713916947.129661,-18000,,
com.leomehlig.today,2,1713916927,1713916929,1713916929.778513,-18000,,
com.robinhood.release.Robinhood,48,1713916864,1713916912,1713916912.65096,-18000,EB445137-D7F5-57EC-87DA-1DB460D64046,"iPhone13,2"
com.google.Sheets,8,1713916852,1713916860,1713916860.724407,-18000,EB445137-D7F5-57EC-87DA-1DB460D64046,"iPhone13,2"
com.apple.MobileSMS,2,1713916846,1713916848,1713916848.489283,-18000,EB445137-D7F5-57EC-87DA-1DB460D64046,"iPhone13,2"
com.apple.MobileSMS,9,1713916835,1713916844,1713916844.4380589,-18000,EB445137-D7F5-57EC-87DA-1DB460D64046,"iPhone13,2"
com.apple.MobileSMS,2,1713915743,1713915745,1713915745.3974838,-18000,EB445137-D7F5-57EC-87DA-1DB460D64046,"iPhone13,2"
com.apple.MobileSMS,1,1713915736,1713915737,1713915737.4553661,-18000,EB445137-D7F5-57EC-87DA-1DB460D64046,"iPhone13,2"
com.apple.MobileSMS,2,1713915734,1713915736,1713915736.458169,-18000,EB445137-D7F5-57EC-87DA-1DB460D64046,"iPhone13,2"
com.leomehlig.today,14,1713915697,1713915711,1713915712.4348779,-18000,,
com.google.Chrome,0,1713915697,1713915697,1713915697.1920428,-18000,,
com.leomehlig.today,16,1713915678,1713915694,1713915694.505313,-18000,,
com.apple.MobileSMS,63,1713915524,1713915587,1713915587.724214,-18000,EB445137-D7F5-57EC-87DA-1DB460D64046,"iPhone13,2"
com.apple.Health,2,1713915522,1713915524,1713915525.128613,-18000,EB445137-D7F5-57EC-87DA-1DB460D64046,"iPhone13,2"
com.google.Chrome,998,1713914680,1713915678,1713915678.8839622,-18000,,
com.apple.systempreferences,33,1713914647,1713914680,1713914680.8157191,-18000,,
com.apple.Health,6,1713914149,1713914155,1713914155.476155,-18000,EB445137-D7F5-57EC-87DA-1DB460D64046,"iPhone13,2"
com.apple.MobileSMS,4,1713914143,1713914147,1713914147.213245,-18000,EB445137-D7F5-57EC-87DA-1DB460D64046,"iPhone13,2"
com.apple.MobileSMS,2,1713914089,1713914091,1713914091.998564,-18000,EB445137-D7F5-57EC-87DA-1DB460D64046,"iPhone13,2"
com.google.Chrome,590,1713914051,1713914641,1713914641.40098,-18000,,
com.leomehlig.today,5,1713914046,1713914051,1713914051.801503,-18000,,
com.apple.iCal,9,1713914037,1713914046,1713914046.808265,-18000,,
com.leomehlig.today,24,1713914013,1713914037,1713914037.116911,-18000,,
com.apple.MobileSMS,3,1713913682,1713913685,1713913685.788929,-18000,EB445137-D7F5-57EC-87DA-1DB460D64046,"iPhone13,2"
com.google.Chrome,1508,1713912505,1713914013,1713914013.492756,-18000,,
com.leomehlig.today,8,1713912497,1713912505,1713912505.17911,-18000,,
com.google.Chrome,1,1713912496,1713912497,1713912497.9977388,-18000,,
com.apple.Preview,3,1713912493,1713912496,1713912496.9287782,-18000,,
com.google.Chrome,9,1713912484,1713912493,1713912493.286543,-18000,,
com.apple.systempreferences,31,1713912453,1713912484,1713912484.224945,-18000,,
com.apple.MobileSMS,2,1713912430,1713912432,1713912432.3735042,-18000,EB445137-D7F5-57EC-87DA-1DB460D64046,"iPhone13,2"
com.google.Chrome,29,1713912417,1713912446,1713912446.875907,-18000,,
com.microsoft.onenote.mac,2,1713912415,1713912417,1713912417.307462,-18000,,
com.apple.MobileSMS,86,1713912342,1713912428,1713912428.382666,-18000,EB445137-D7F5-57EC-87DA-1DB460D64046,"iPhone13,2"
com.apple.MobileSMS,9,1713912185,1713912194,1713912194.85026,-18000,EB445137-D7F5-57EC-87DA-1DB460D64046,"iPhone13,2"
com.apple.MobileSMS,2,1713912180,1713912182,1713912182.7390718,-18000,EB445137-D7F5-57EC-87DA-1DB460D64046,"iPhone13,2"
com.apple.MobileSMS,23,1713912131,1713912154,1713912154.615734,-18000,EB445137-D7F5-57EC-87DA-1DB460D64046,"iPhone13,2"
com.hammerandchisel.discord,4,1713912127,1713912131,1713912131.488865,-18000,EB445137-D7F5-57EC-87DA-1DB460D64046,"iPhone13,2"
com.hammerandchisel.discord,2,1713911059,1713911061,1713911061.399571,-18000,EB445137-D7F5-57EC-87DA-1DB460D64046,"iPhone13,2"
com.hammerandchisel.discord,8,1713910699,1713910707,1713910707.047875,-18000,EB445137-D7F5-57EC-87DA-1DB460D64046,"iPhone13,2"
com.hammerandchisel.discord,2,1713910454,1713910456,1713910456.161802,-18000,EB445137-D7F5-57EC-87DA-1DB460D64046,"iPhone13,2"
com.hammerandchisel.discord,64,1713909165,1713909229,1713909229.791051,-18000,EB445137-D7F5-57EC-87DA-1DB460D64046,"iPhone13,2"
com.apple.mobileslideshow,2,1713909163,1713909165,1713909165.961349,-18000,EB445137-D7F5-57EC-87DA-1DB460D64046,"iPhone13,2"
com.apple.mobileslideshow,56,1713909060,1713909116,1713909116.538007,-18000,EB445137-D7F5-57EC-87DA-1DB460D64046,"iPhone13,2"
edu.illinois.rokwire.ios,2,1713909055,1713909057,1713909057.855968,-18000,EB445137-D7F5-57EC-87DA-1DB460D64046,"iPhone13,2"
edu.illinois.rokwire.ios,12,1713907579,1713907591,1713907591.1682792,-18000,EB445137-D7F5-57EC-87DA-1DB460D64046,"iPhone13,2"
com.apple.Health,3,1713907576,1713907579,1713907580.0157142,-18000,EB445137-D7F5-57EC-87DA-1DB460D64046,"iPhone13,2"
com.apple.Health,13,1713907469,1713907482,1713907483.141743,-18000,EB445137-D7F5-57EC-87DA-1DB460D64046,"iPhone13,2"
com.toyopagroup.picaboo,3,1713907464,1713907467,1713907467.642499,-18000,EB445137-D7F5-57EC-87DA-1DB460D64046,"iPhone13,2"
com.apple.weather,3,1713907461,1713907464,1713907465.4079099,-18000,EB445137-D7F5-57EC-87DA-1DB460D64046,"iPhone13,2"
com.microsoft.onenote.mac,180,1713906537,1713906717,1713906717.656143,-18000,,
com.apple.iCal,15,1713906522,1713906537,1713906538.015583,-18000,,
com.microsoft.onenote.mac,284,1713906238,1713906522,1713906522.584673,-18000,,
com.apple.iCal,17,1713906221,1713906238,1713906239.0111032,-18000,,
com.microsoft.onenote.mac,1,1713906220,1713906221,1713906221.5712209,-18000,,
com.apple.iCal,2,1713906218,1713906220,1713906220.2805161,-18000,,
com.microsoft.onenote.mac,2,1713906216,1713906218,1713906218.151257,-18000,,
com.apple.iCal,9,1713906207,1713906216,1713906216.630265,-18000,,
com.microsoft.onenote.mac,9,1713906198,1713906207,1713906207.6986961,-18000,,
com.apple.iCal,3,1713906195,1713906198,1713906198.422317,-18000,,
com.microsoft.onenote.mac,2,1713906193,1713906195,1713906195.4272451,-18000,,
com.apple.iCal,3,1713906190,1713906193,1713906193.567309,-18000,,
com.microsoft.onenote.mac,2,1713906188,1713906190,1713906190.066125,-18000,,
com.apple.iCal,2,1713906186,1713906188,1713906188.246546,-18000,,
com.microsoft.onenote.mac,2,1713906184,1713906186,1713906186.429852,-18000,,
com.apple.iCal,1,1713906183,1713906184,1713906184.772029,-18000,,
com.microsoft.onenote.mac,3,1713906180,1713906183,1713906183.7770538,-18000,,
com.apple.iCal,2,1713906178,1713906180,1713906180.9901829,-18000,,
com.microsoft.onenote.mac,2,1713906176,1713906178,1713906178.9375448,-18000,,
com.apple.iCal,1,1713906175,1713906176,1713906177.0031018,-18000,,
com.microsoft.onenote.mac,4,1713906171,1713906175,1713906175.861671,-18000,,
com.apple.iCal,1,1713906170,1713906171,1713906171.443318,-18000,,
com.microsoft.onenote.mac,2,1713906168,1713906170,1713906170.517837,-18000,,
com.apple.iCal,1,1713906167,1713906168,1713906168.848007,-18000,,
com.microsoft.onenote.mac,2,1713906165,1713906167,1713906167.595169,-18000,,
com.apple.iCal,3,1713906162,1713906165,1713906165.576222,-18000,,
com.microsoft.onenote.mac,2,1713906160,1713906162,1713906162.6673431,-18000,,
com.apple.iCal,1,1713906159,1713906160,1713906160.993741,-18000,,
com.microsoft.onenote.mac,3,1713906156,1713906159,1713906159.096122,-18000,,
com.apple.iCal,2,1713906154,1713906156,1713906156.864915,-18000,,
com.microsoft.onenote.mac,5,1713906149,1713906154,1713906154.814374,-18000,,
com.apple.iCal,11,1713906138,1713906149,1713906149.397757,-18000,,
com.microsoft.onenote.mac,1,1713906137,1713906138,1713906138.568795,-18000,,
com.apple.calculator,2,1713906135,1713906137,1713906137.233522,-18000,,
com.microsoft.onenote.mac,89,1713906046,1713906135,1713906135.874074,-18000,,
com.google.Chrome,6,1713906040,1713906046,1713906046.620697,-18000,,
com.microsoft.onenote.mac,77,1713905963,1713906040,1713906040.809184,-18000,,
com.apple.Preview,29,1713905934,1713905963,1713905963.899626,-18000,,
com.apple.finder,3,1713905931,1713905934,1713905934.458818,-18000,,
com.microsoft.onenote.mac,34,1713905897,1713905931,1713905931.29742,-18000,,
com.google.Chrome,53,1713905844,1713905897,1713905897.684466,-18000,,
com.microsoft.onenote.mac,37,1713905807,1713905844,1713905844.2121282,-18000,,
com.google.Chrome,188,1713905619,1713905807,1713905807.390757,-18000,,
com.microsoft.onenote.mac,80,1713905539,1713905619,1713905619.241437,-18000,,
com.google.Chrome,448,1713905091,1713905539,1713905540.081719,-18000,,
com.apple.Preview,1,1713905090,1713905091,1713905091.2120728,-18000,,
com.google.Chrome,1066,1713904024,1713905090,1713905090.293175,-18000,,
com.apple.Preview,48,1713903976,1713904024,1713904025.004674,-18000,,
com.apple.Notes,2,1713903974,1713903976,1713903976.443334,-18000,,
com.apple.Preview,2,1713903972,1713903974,1713903974.424955,-18000,,
com.apple.Notes,1,1713903971,1713903972,1713903972.472642,-18000,,
com.apple.Preview,1,1713903970,1713903971,1713903971.526238,-18000,,
com.apple.Notes,1,1713903969,1713903970,1713903970.621196,-18000,,
com.apple.Preview,2,1713903967,1713903969,1713903969.2270079,-18000,,
com.apple.Notes,6,1713903961,1713903967,1713903967.1565828,-18000,,
com.apple.Preview,2,1713903959,1713903961,1713903961.86615,-18000,,
com.apple.Notes,24,1713903935,1713903959,1713903959.984029,-18000,,
com.apple.Preview,33,1713903902,1713903935,1713903935.2275891,-18000,,
com.apple.finder,2,1713903900,1713903902,1713903902.452641,-18000,,
com.apple.Preview,9,1713903891,1713903900,1713903901.010625,-18000,,
com.apple.finder,10,1713903881,1713903891,1713903891.156828,-18000,,
com.microsoft.onenote.mac,5,1713903876,1713903881,1713903882.056967,-18000,,
com.google.Chrome,21,1713903855,1713903876,1713903876.5181642,-18000,,
us.zoom.xos,319,1713903536,1713903855,1713903855.207211,-18000,,
com.google.Chrome,2,1713903534,1713903536,1713903536.3479462,-18000,,
com.apple.MobileSMS,3,1713903531,1713903534,1713903535.0032768,-18000,,
com.google.Chrome,248,1713903283,1713903531,1713903531.8950748,-18000,,
com.microsoft.onenote.mac,2,1713903281,1713903283,1713903283.819324,-18000,,
us.zoom.xos,10,1713903271,1713903281,1713903281.989335,-18000,,
com.google.Chrome,2,1713903269,1713903271,1713903271.924704,-18000,,
com.apple.calculator,42,1713903227,1713903269,1713903269.465935,-18000,,
com.google.Chrome,119,1713903108,1713903227,1713903227.576929,-18000,,
us.zoom.xos,21,1713903087,1713903108,1713903108.109587,-18000,,
us.zoom.xos,303,1713902527,1713902830,1713902830.773896,-18000,,
com.google.Chrome,108,1713902419,1713902527,1713902527.443464,-18000,,
us.zoom.xos,1,1713902418,1713902419,1713902419.3797278,-18000,,
com.apple.weather,8,1713901908,1713901916,1713901916.148862,-18000,EB445137-D7F5-57EC-87DA-1DB460D64046,"iPhone13,2"
com.apple.Health,1,1713901907,1713901908,1713901908.911031,-18000,EB445137-D7F5-57EC-87DA-1DB460D64046,"iPhone13,2"
us.zoom.xos,425,1713901893,1713902318,1713902318.2400842,-18000,,
com.apple.Health,16,1713901804,1713901820,1713901820.43793,-18000,EB445137-D7F5-57EC-87DA-1DB460D64046,"iPhone13,2"
com.apple.Health,117,1713901628,1713901745,1713901745.8381371,-18000,EB445137-D7F5-57EC-87DA-1DB460D64046,"iPhone13,2"
com.google.Chrome,297,1713901596,1713901893,1713901893.568115,-18000,,
us.zoom.xos,1,1713901595,1713901596,1713901596.60531,-18000,,
com.google.Chrome,168,1713901427,1713901595,1713901595.153297,-18000,,
us.zoom.xos,106,1713901321,1713901427,1713901427.1379719,-18000,,
com.google.Chrome,60,1713901261,1713901321,1713901321.2981272,-18000,,
com.microsoft.onenote.mac,41,1713901220,1713901261,1713901261.684607,-18000,,
com.google.Chrome,2,1713901218,1713901220,1713901221.0354,-18000,,
us.zoom.xos,26,1713901192,1713901218,1713901218.1642551,-18000,,
us.zoom.xos,301,1713900813,1713901114,1713901114.9465752,-18000,,
com.google.Chrome,64,1713900749,1713900813,1713900813.8271198,-18000,,
com.tinyspeck.chatlyio,16,1713900729,1713900745,1713900745.351711,-18000,EB445137-D7F5-57EC-87DA-1DB460D64046,"iPhone13,2"
us.zoom.xos,27,1713900722,1713900749,1713900749.5929809,-18000,,
com.leomehlig.today,45,1713900677,1713900722,1713900723.023281,-18000,,
us.zoom.xos,40,1713900637,1713900677,1713900677.4748511,-18000,,
com.microsoft.onenote.mac,31,1713900606,1713900637,1713900637.7135692,-18000,,
us.zoom.xos,224,1713900382,1713900606,1713900606.938489,-18000,,
com.google.Chrome,70,1713900312,1713900382,1713900382.6758518,-18000,,
us.zoom.xos,253,1713900059,1713900312,1713900312.67761,-18000,,
com.google.Chrome,32,1713900027,1713900059,1713900059.3539472,-18000,,
us.zoom.xos,34,1713899993,1713900027,1713900027.552374,-18000,,
com.apple.Preview,1,1713899992,1713899993,1713899993.601368,-18000,,
com.microsoft.onenote.mac,18,1713899974,1713899992,1713899992.3099232,-18000,,
com.google.Chrome,33,1713899941,1713899974,1713899974.883397,-18000,,
com.apple.Preview,11,1713899930,1713899941,1713899941.160376,-18000,,
com.google.Chrome,1,1713899929,1713899930,1713899930.931954,-18000,,
com.microsoft.onenote.mac,14,1713899915,1713899929,1713899929.835135,-18000,,
com.google.Chrome,9,1713899906,1713899915,1713899915.7300081,-18000,,
com.microsoft.onenote.mac,1,1713899905,1713899906,1713899906.8651218,-18000,,
com.apple.Preview,1,1713899904,1713899905,1713899905.054631,-18000,,
com.google.Chrome,1,1713899903,1713899904,1713899904.2431169,-18000,,
com.apple.Preview,3,1713899900,1713899903,1713899903.592392,-18000,,
com.microsoft.onenote.mac,4,1713899896,1713899900,1713899900.239008,-18000,,
us.zoom.xos,81,1713899815,1713899896,1713899896.387693,-18000,,
com.microsoft.onenote.mac,14,1713899801,1713899815,1713899815.922899,-18000,,
com.google.Chrome,17,1713899784,1713899801,1713899801.683898,-18000,,
com.apple.Preview,3,1713899781,1713899784,1713899784.637875,-18000,,
com.microsoft.onenote.mac,10,1713899771,1713899781,1713899781.475266,-18000,,
com.google.Chrome,12,1713899759,1713899771,1713899771.61088,-18000,,
com.apple.Preview,1,1713899758,1713899759,1713899759.797976,-18000,,
com.microsoft.onenote.mac,6,1713899752,1713899758,1713899758.881499,-18000,,
com.apple.Preview,4,1713899748,1713899752,1713899753.010726,-18000,,
com.google.Chrome,6,1713899742,1713899748,1713899748.7449598,-18000,,
us.zoom.xos,2,1713899740,1713899742,1713899742.659402,-18000,,
com.google.Chrome,1,1713899739,1713899740,1713899740.3382978,-18000,,
us.zoom.xos,43,1713899696,1713899739,1713899739.620387,-18000,,
com.google.Chrome,3,1713899693,1713899696,1713899697.026102,-18000,,
com.apple.Preview,5,1713899688,1713899693,1713899693.594909,-18000,,
com.microsoft.onenote.mac,4,1713899684,1713899688,1713899688.353549,-18000,,
us.zoom.xos,227,1713899457,1713899684,1713899684.36058,-18000,,
com.microsoft.onenote.mac,6,1713899451,1713899457,1713899457.622674,-18000,,
com.google.Chrome,5,1713899446,1713899451,1713899451.90141,-18000,,
com.apple.Preview,11,1713899435,1713899446,1713899446.4135752,-18000,,
com.google.Chrome,5,1713899430,1713899435,1713899435.16853,-18000,,
com.microsoft.onenote.mac,14,1713899416,1713899430,1713899430.129777,-18000,,
com.apple.Preview,3,1713899413,1713899416,1713899416.570362,-18000,,
com.google.Chrome,13,1713899400,1713899413,1713899413.7981339,-18000,,
com.apple.Preview,3,1713899397,1713899400,1713899400.9051309,-18000,,
com.microsoft.onenote.mac,6,1713899391,1713899397,1713899397.537809,-18000,,
com.apple.Preview,1,1713899390,1713899391,1713899391.86864,-18000,,
com.google.Chrome,13,1713899377,1713899390,1713899390.7293339,-18000,,
com.apple.Preview,4,1713899373,1713899377,1713899378.071233,-18000,,
com.microsoft.onenote.mac,5,1713899368,1713899373,1713899373.6782079,-18000,,
com.apple.Preview,1,1713899367,1713899368,1713899368.312989,-18000,,
com.google.Chrome,4,1713899363,1713899367,1713899367.361872,-18000,,
com.apple.Preview,3,1713899360,1713899363,1713899363.632465,-18000,,
com.microsoft.onenote.mac,11,1713899349,1713899360,1713899361.016952,-18000,,
us.zoom.xos,2,1713899347,1713899349,1713899349.049572,-18000,,
com.google.Chrome,12,1713899335,1713899347,1713899347.342725,-18000,,
us.zoom.xos,22,1713899313,1713899335,1713899335.640034,-18000,,
com.google.Chrome,2,1713899311,1713899313,1713899313.084347,-18000,,
com.apple.Preview,7,1713899304,1713899311,1713899311.2856169,-18000,,
com.google.Chrome,3,1713899301,1713899304,1713899304.116965,-18000,,
com.microsoft.onenote.mac,15,1713899286,1713899301,1713899301.1453218,-18000,,
com.apple.Preview,1,1713899285,1713899286,1713899286.62185,-18000,,
com.google.Chrome,35,1713899250,1713899285,1713899285.441011,-18000,,
com.apple.Preview,5,1713899245,1713899250,1713899250.835849,-18000,,
com.microsoft.onenote.mac,8,1713899237,1713899245,1713899245.592008,-18000,,
com.apple.Preview,1,1713899236,1713899237,1713899237.761866,-18000,,
com.google.Chrome,8,1713899228,1713899236,1713899236.883956,-18000,,
com.apple.Preview,4,1713899224,1713899228,1713899228.0550451,-18000,,
com.google.Chrome,1,1713899223,1713899224,1713899224.9209309,-18000,,
com.microsoft.onenote.mac,17,1713899206,1713899223,1713899223.823498,-18000,,
com.google.Chrome,8,1713899198,1713899206,1713899206.537674,-18000,,
com.apple.Preview,5,1713899193,1713899198,1713899198.216963,-18000,,
com.microsoft.onenote.mac,14,1713899179,1713899193,1713899193.9084291,-18000,,
com.google.Chrome,30,1713899149,1713899179,1713899179.353059,-18000,,
com.apple.Preview,14,1713899135,1713899149,1713899149.60378,-18000,,
com.microsoft.onenote.mac,22,1713899113,1713899135,1713899135.4250488,-18000,,
com.apple.Preview,1,1713899112,1713899113,1713899113.7164412,-18000,,
com.google.Chrome,28,1713899084,1713899112,1713899112.313881,-18000,,
com.apple.Preview,9,1713899075,1713899084,1713899084.9383168,-18000,,
com.microsoft.onenote.mac,5,1713899070,1713899075,1713899075.7820148,-18000,,
com.apple.Preview,2,1713899068,1713899070,1713899070.3327498,-18000,,
com.microsoft.onenote.mac,22,1713899046,1713899068,1713899068.908766,-18000,,
com.apple.Preview,1,1713899045,1713899046,1713899046.521189,-18000,,
com.google.Chrome,29,1713899016,1713899045,1713899045.187263,-18000,,
com.apple.Preview,5,1713899011,1713899016,1713899016.563089,-18000,,
com.microsoft.onenote.mac,35,1713898976,1713899011,1713899011.3145351,-18000,,
com.toyopagroup.picaboo,5,1713898949,1713898954,1713898954.654552,-18000,EB445137-D7F5-57EC-87DA-1DB460D64046,"iPhone13,2"
com.muscleforlife.Stacked,5,1713898944,1713898949,1713898949.4450378,-18000,EB445137-D7F5-57EC-87DA-1DB460D64046,"iPhone13,2"
com.google.Chrome,42,1713898934,1713898976,1713898976.5213609,-18000,,
com.apple.Preview,5,1713898929,1713898934,1713898934.710915,-18000,,
com.microsoft.onenote.mac,57,1713898872,1713898929,1713898929.276902,-18000,,
com.google.Chrome,4,1713898868,1713898872,1713898872.941407,-18000,,
us.zoom.xos,6,1713898862,1713898868,1713898868.3538032,-18000,,
com.google.Chrome,3,1713898859,1713898862,1713898862.425427,-18000,,
com.apple.Preview,1,1713898858,1713898859,1713898859.2531018,-18000,,
com.google.Chrome,8,1713898850,1713898858,1713898858.150805,-18000,,
com.apple.Preview,5,1713898845,1713898850,1713898850.34816,-18000,,
com.microsoft.onenote.mac,5,1713898840,1713898845,1713898845.5690079,-18000,,
us.zoom.xos,19,1713898821,1713898840,1713898840.9829621,-18000,,
com.google.Chrome,1,1713898820,1713898821,1713898822.020599,-18000,,
us.zoom.xos,3,1713898817,1713898820,1713898820.7552729,-18000,,
com.google.Chrome,15,1713898802,1713898817,1713898817.831022,-18000,,
com.microsoft.onenote.mac,48,1713898740,1713898788,1713898788.648865,-18000,,
com.google.Chrome,1,1713898739,1713898740,1713898740.106179,-18000,,
com.apple.Preview,1,1713898738,1713898739,1713898739.437592,-18000,,
com.google.Chrome,13,1713898725,1713898738,1713898738.418273,-18000,,
com.apple.Preview,5,1713898720,1713898725,1713898725.207837,-18000,,
com.microsoft.onenote.mac,23,1713898697,1713898720,1713898720.060379,-18000,,
com.apple.Preview,2,1713898695,1713898697,1713898697.441812,-18000,,
com.google.Chrome,34,1713898661,1713898695,1713898695.9087949,-18000,,
com.apple.Preview,16,1713898645,1713898661,1713898661.840907,-18000,,
com.google.Chrome,3,1713898642,1713898645,1713898645.266578,-18000,,
com.muscleforlife.Stacked,193,1713898436,1713898629,1713898629.255728,-18000,EB445137-D7F5-57EC-87DA-1DB460D64046,"iPhone13,2"
com.apple.AppStore,22,1713898414,1713898436,1713898436.685964,-18000,EB445137-D7F5-57EC-87DA-1DB460D64046,"iPhone13,2"
com.microsoft.Office.Outlook,13,1713898397,1713898410,1713898410.885456,-18000,EB445137-D7F5-57EC-87DA-1DB460D64046,"iPhone13,2"
com.microsoft.Office.Outlook,14,1713898382,1713898396,1713898396.995222,-18000,EB445137-D7F5-57EC-87DA-1DB460D64046,"iPhone13,2"
com.microsoft.onenote.mac,281,1713898361,1713898642,1713898642.5399652,-18000,,
com.google.Chrome,161,1713898200,1713898361,1713898361.897202,-18000,,
com.apple.Preview,12,1713898188,1713898200,1713898200.243485,-18000,,
com.microsoft.onenote.mac,2,1713898186,1713898188,1713898188.235039,-18000,,
com.apple.Preview,3,1713898183,1713898186,1713898186.195523,-18000,,
com.microsoft.onenote.mac,3,1713898180,1713898183,1713898183.980937,-18000,,
com.apple.Preview,3,1713898177,1713898180,1713898180.334966,-18000,,
com.apple.finder,4,1713898173,1713898177,1713898177.797107,-18000,,
com.apple.Preview,9,1713898164,1713898173,1713898173.5814152,-18000,,
com.apple.finder,8,1713898156,1713898164,1713898164.3617048,-18000,,
com.apple.Preview,8,1713898148,1713898156,1713898157.0526829,-18000,,
com.apple.finder,9,1713898139,1713898148,1713898148.8824968,-18000,,
com.google.Chrome,25,1713898114,1713898139,1713898139.331005,-18000,,
com.leomehlig.today,15,1713898099,1713898114,1713898114.1169,-18000,,
com.google.Chrome,2733,1713895366,1713898099,1713898099.300375,-18000,,
com.leomehlig.today,18,1713895348,1713895366,1713895366.044802,-18000,,
com.google.Chrome,26,1713895322,1713895348,1713895348.343196,-18000,,
com.apple.finder,38,1713895284,1713895322,1713895322.5754519,-18000,,
com.apple.archiveutility,0,1713895284,1713895284,1713895284.698721,-18000,,
com.apple.finder,14,1713895270,1713895284,1713895284.369965,-18000,,
com.google.Chrome,3,1713895267,1713895270,1713895270.89485,-18000,,
com.apple.finder,5,1713895262,1713895267,1713895267.4985418,-18000,,
com.google.Chrome,11,1713895251,1713895262,1713895262.693739,-18000,,
com.leomehlig.today,1,1713895250,1713895251,1713895252.786746,-18000,,
com.google.Chrome,5,1713895245,1713895250,1713895250.7343931,-18000,,
com.toyopagroup.picaboo,17,1713894742,1713894759,1713894759.446334,-18000,EB445137-D7F5-57EC-87DA-1DB460D64046,"iPhone13,2"
com.apple.MobileSMS,2,1713894737,1713894739,1713894739.8223581,-18000,EB445137-D7F5-57EC-87DA-1DB460D64046,"iPhone13,2"
edu.illinois.rokwire.ios,2,1713894735,1713894737,1713894737.804898,-18000,EB445137-D7F5-57EC-87DA-1DB460D64046,"iPhone13,2"
edu.illinois.rokwire.ios,30,1713894704,1713894734,1713894734.525646,-18000,EB445137-D7F5-57EC-87DA-1DB460D64046,"iPhone13,2"
com.apple.MobileSMS,2,1713894702,1713894704,1713894704.805997,-18000,EB445137-D7F5-57EC-87DA-1DB460D64046,"iPhone13,2"
com.apple.MobileSMS,4,1713894697,1713894701,1713894701.7425709,-18000,EB445137-D7F5-57EC-87DA-1DB460D64046,"iPhone13,2"
com.google.Chrome,317,1713891543,1713891860,1713891860.8691869,-18000,,
com.microsoft.VSCode,2,1713891522,1713891524,1713891524.616189,-18000,,
com.leomehlig.today,6,1713891516,1713891522,1713891522.880076,-18000,,
com.microsoft.VSCode,4,1713891512,1713891516,1713891516.500294,-18000,,
com.microsoft.onenote.mac,4,1713891508,1713891512,1713891512.333988,-18000,,
com.toyopagroup.picaboo,19,1713891410,1713891429,1713891429.550847,-18000,EB445137-D7F5-57EC-87DA-1DB460D64046,"iPhone13,2"
com.apple.mobilecal,3,1713891404,1713891407,1713891407.692585,-18000,EB445137-D7F5-57EC-87DA-1DB460D64046,"iPhone13,2"
com.apple.weather,6,1713891394,1713891400,1713891400.770465,-18000,EB445137-D7F5-57EC-87DA-1DB460D64046,"iPhone13,2"
com.apple.weather,6,1713889334,1713889340,1713889340.385546,-18000,EB445137-D7F5-57EC-87DA-1DB460D64046,"iPhone13,2"
com.microsoft.onenote.mac,979,1713888287,1713889266,1713889266.881377,-18000,,
com.google.Chrome,66,1713888221,1713888287,1713888287.3340468,-18000,,
com.microsoft.Excel,75,1713888146,1713888221,1713888221.6251411,-18000,,
com.google.Chrome,9,1713888137,1713888146,1713888146.968277,-18000,,
com.microsoft.onenote.mac,55,1713888082,1713888137,1713888137.798871,-18000,,
com.microsoft.VSCode,0,1713888082,1713888082,1713888082.9832458,-18000,,
com.microsoft.onenote.mac,2,1713888080,1713888082,1713888082.125098,-18000,,
com.microsoft.VSCode,1,1713888079,1713888080,1713888080.9118152,-18000,,
com.microsoft.onenote.mac,17,1713888062,1713888079,1713888079.524574,-18000,,
com.microsoft.VSCode,36,1713888026,1713888062,1713888062.941862,-18000,,
com.microsoft.onenote.mac,7,1713888019,1713888026,1713888026.6825671,-18000,,
com.microsoft.VSCode,19,1713888000,1713888019,1713888019.15692,-18000,,
com.microsoft.onenote.mac,17,1713887983,1713888000,1713888000.302387,-18000,,
com.clairmail.fth.client,2,1713887972,1713887974,1713887974.652616,-18000,EB445137-D7F5-57EC-87DA-1DB460D64046,"iPhone13,2"
com.google.chrome.ios,2,1713887970,1713887972,1713887972.8415651,-18000,EB445137-D7F5-57EC-87DA-1DB460D64046,"iPhone13,2"
com.clairmail.fth.client,26,1713887944,1713887970,1713887970.790345,-18000,EB445137-D7F5-57EC-87DA-1DB460D64046,"iPhone13,2"
com.apple.weather,3,1713887939,1713887942,1713887942.942003,-18000,EB445137-D7F5-57EC-87DA-1DB460D64046,"iPhone13,2"
com.apple.weather,3,1713887936,1713887939,1713887939.3563318,-18000,EB445137-D7F5-57EC-87DA-1DB460D64046,"iPhone13,2"
com.leomehlig.today,51,1713887932,1713887983,1713887983.608971,-18000,,
com.apple.weather,8,1713887920,1713887928,1713887928.042315,-18000,EB445137-D7F5-57EC-87DA-1DB460D64046,"iPhone13,2"
com.google.Chrome,28,1713887904,1713887932,1713887932.500619,-18000,,
com.leomehlig.today,21,1713887883,1713887904,1713887904.1469889,-18000,,
com.google.Chrome,838,1713887045,1713887883,1713887883.6221452,-18000,,
com.apple.MobileSMS,3,1713887031,1713887034,1713887034.217229,-18000,,
com.google.Chrome,1,1713887030,1713887031,1713887032.061801,-18000,,
com.apple.weather,7,1713887005,1713887012,1713887012.913899,-18000,EB445137-D7F5-57EC-87DA-1DB460D64046,"iPhone13,2"
com.leomehlig.today,69,1713886961,1713887030,1713887030.9119968,-18000,,
com.apple.Preview,273,1713886688,1713886961,1713886961.669053,-18000,,
com.microsoft.Outlook,550,1713886138,1713886688,1713886688.208823,-18000,,
com.apple.Preview,2729,1713883409,1713886138,1713886138.529113,-18000,,
com.google.Chrome,617,1713882792,1713883409,1713883409.473837,-18000,,
com.apple.Preview,26,1713882766,1713882792,1713882792.5373359,-18000,,
com.leomehlig.today,1,1713882765,1713882766,1713882766.4610329,-18000,,
com.apple.Preview,28,1713882737,1713882765,1713882765.12857,-18000,,
com.apple.finder,16,1713882721,1713882737,1713882737.988692,-18000,,
com.leomehlig.today,6,1713882715,1713882721,1713882721.813201,-18000,,
com.microsoft.VSCode,3,1713882712,1713882715,1713882715.284186,-18000,,
com.google.Chrome,6,1713882706,1713882712,1713882712.1928759,-18000,,
com.microsoft.Outlook,191,1713882515,1713882706,1713882706.525312,-18000,,
com.google.Chrome,1,1713882514,1713882515,1713882515.223555,-18000,,
com.microsoft.VSCode,18,1713882496,1713882514,1713882514.152067,-18000,,
com.google.Chrome,1,1713882495,1713882496,1713882496.72892,-18000,,
com.microsoft.Outlook,62,1713882433,1713882495,1713882495.962981,-18000,,
com.google.Chrome,1,1713882432,1713882433,1713882433.1986299,-18000,,
com.microsoft.VSCode,3,1713882429,1713882432,1713882432.212353,-18000,,
com.google.Chrome,3,1713882426,1713882429,1713882430.034298,-18000,,
com.microsoft.VSCode,3,1713882423,1713882426,1713882426.156732,-18000,,
com.microsoft.Outlook,14,1713882409,1713882423,1713882423.219046,-18000,,
com.microsoft.VSCode,6,1713882403,1713882409,1713882409.8850641,-18000,,
com.microsoft.Outlook,32,1713882371,1713882403,1713882404.009633,-18000,,
com.microsoft.VSCode,5,1713882366,1713882371,1713882371.638754,-18000,,
com.microsoft.Outlook,7,1713882359,1713882366,1713882366.46033,-18000,,
com.microsoft.VSCode,11,1713882348,1713882359,1713882359.6522012,-18000,,
com.microsoft.Outlook,150,1713882198,1713882348,1713882348.4699101,-18000,,
com.google.Chrome,13,1713882185,1713882198,1713882198.870936,-18000,,
com.microsoft.Outlook,27,1713882158,1713882185,1713882185.883614,-18000,,
com.leomehlig.today,20,1713882138,1713882158,1713882159.012053,-18000,,
com.google.Chrome,4,1713882134,1713882138,1713882138.185538,-18000,,
com.apple.weather,14,1713882096,1713882110,1713882110.815072,-18000,EB445137-D7F5-57EC-87DA-1DB460D64046,"iPhone13,2"
com.apple.weather,9,1713880829,1713880838,1713880838.362536,-18000,EB445137-D7F5-57EC-87DA-1DB460D64046,"iPhone13,2"
com.apple.weather,6,1713880225,1713880231,1713880232.7163548,-18000,EB445137-D7F5-57EC-87DA-1DB460D64046,"iPhone13,2"
com.thestorygraph.thestorygraph,3,1713880222,1713880225,1713880232.296998,-18000,EB445137-D7F5-57EC-87DA-1DB460D64046,"iPhone13,2"
com.thestorygraph.thestorygraph,11,1713879551,1713879562,1713879562.594223,-18000,EB445137-D7F5-57EC-87DA-1DB460D64046,"iPhone13,2"
com.thestorygraph.thestorygraph,21,1713879000,1713879021,1713879021.6769218,-18000,EB445137-D7F5-57EC-87DA-1DB460D64046,"iPhone13,2"
com.thestorygraph.thestorygraph,13,1713863726,1713863739,1713863739.6420422,-18000,EB445137-D7F5-57EC-87DA-1DB460D64046,"iPhone13,2"
com.thestorygraph.thestorygraph,10,1713863077,1713863087,1713863087.797698,-18000,EB445137-D7F5-57EC-87DA-1DB460D64046,"iPhone13,2"
com.thestorygraph.thestorygraph,13,1713859017,1713859030,1713859030.250113,-18000,EB445137-D7F5-57EC-87DA-1DB460D64046,"iPhone13,2"
com.thestorygraph.thestorygraph,10,1713858724,1713858734,1713858734.33574,-18000,EB445137-D7F5-57EC-87DA-1DB460D64046,"iPhone13,2"
com.thestorygraph.thestorygraph,16,1713857778,1713857794,1713857794.451328,-18000,EB445137-D7F5-57EC-87DA-1DB460D64046,"iPhone13,2"
com.thestorygraph.thestorygraph,10,1713857009,1713857019,1713857019.628942,-18000,EB445137-D7F5-57EC-87DA-1DB460D64046,"iPhone13,2"
com.thestorygraph.thestorygraph,13,1713856522,1713856535,1713856535.337002,-18000,EB445137-D7F5-57EC-87DA-1DB460D64046,"iPhone13,2"
com.thestorygraph.thestorygraph,10,1713855756,1713855766,1713855766.542344,-18000,EB445137-D7F5-57EC-87DA-1DB460D64046,"iPhone13,2"
com.thestorygraph.thestorygraph,13,1713855306,1713855319,1713855319.7147598,-18000,EB445137-D7F5-57EC-87DA-1DB460D64046,"iPhone13,2"
com.thestorygraph.thestorygraph,13,1713855253,1713855266,1713855266.436068,-18000,EB445137-D7F5-57EC-87DA-1DB460D64046,"iPhone13,2"
com.google.Chrome,2,1713843273,1713843275,1713843275.556828,-18000,,
com.google.Chrome,1108,1713842156,1713843264,1713843264.363863,-18000,,
com.google.Chrome,331,1713841691,1713842022,1713842022.1023111,-18000,,
com.google.Chrome,861,1713840676,1713841537,1713841537.9475598,-18000,,
com.google.Chrome,300,1713840318,1713840618,1713840618.607722,-18000,,
com.google.Chrome,993,1713839144,1713840137,1713840137.361912,-18000,,
com.leomehlig.today,7,1713839137,1713839144,1713839144.6602,-18000,,
com.leomehlig.today,4,1713837426,1713837430,1713837430.832484,-18000,,
com.google.Chrome,8,1713837418,1713837426,1713837426.915773,-18000,,
com.microsoft.VSCode,3,1713837415,1713837418,1713837418.9519591,-18000,,
com.leomehlig.today,35,1713837380,1713837415,1713837415.35536,-18000,,
com.google.Chrome,1,1713837379,1713837380,1713837380.947556,-18000,,
com.leomehlig.today,8,1713837371,1713837379,1713837379.739015,-18000,,
com.google.Chrome,12,1713837359,1713837371,1713837371.348864,-18000,,
com.leomehlig.today,26,1713837321,1713837347,1713837347.3478389,-18000,,
com.google.Chrome,23,1713837298,1713837321,1713837321.921516,-18000,,
com.apple.iCal,12,1713837286,1713837298,1713837298.189608,-18000,,
com.leomehlig.today,64,1713837222,1713837286,1713837287.0180058,-18000,,
com.google.Chrome,7,1713837215,1713837222,1713837222.98919,-18000,,
com.leomehlig.today,12,1713837203,1713837215,1713837215.7957258,-18000,,
com.microsoft.VSCode,64,1713837139,1713837203,1713837203.799378,-18000,,
com.leomehlig.today,21,1713837118,1713837139,1713837139.739295,-18000,,
com.microsoft.VSCode,152,1713836966,1713837118,1713837118.604597,-18000,,
com.google.Chrome,4,1713836962,1713836966,1713836966.306782,-18000,,
com.microsoft.VSCode,53,1713836909,1713836962,1713836962.94596,-18000,,
com.google.Chrome,6,1713836903,1713836909,1713836909.078834,-18000,,
com.microsoft.VSCode,25,1713836878,1713836903,1713836903.926362,-18000,,
com.google.Chrome,55,1713836823,1713836878,1713836878.989203,-18000,,
com.microsoft.VSCode,76,1713836747,1713836823,1713836823.68254,-18000,,
com.google.Chrome,1,1713836746,1713836747,1713836747.235907,-18000,,
com.microsoft.VSCode,88,1713836658,1713836746,1713836746.109582,-18000,,
com.google.Chrome,4,1713836654,1713836658,1713836658.1703959,-18000,,
com.microsoft.VSCode,14,1713836640,1713836654,1713836654.3202791,-18000,,
com.google.Chrome,4,1713836636,1713836640,1713836640.933866,-18000,,
com.microsoft.VSCode,260,1713836376,1713836636,1713836636.944828,-18000,,
com.google.Chrome,6,1713836370,1713836376,1713836376.500329,-18000,,
com.microsoft.VSCode,22,1713836348,1713836370,1713836370.1140862,-18000,,
com.google.Chrome,9,1713836339,1713836348,1713836348.534027,-18000,,
com.microsoft.VSCode,81,1713836258,1713836339,1713836340.015994,-18000,,
com.google.Chrome,1,1713836257,1713836258,1713836258.385347,-18000,,
com.microsoft.VSCode,5,1713836252,1713836257,1713836257.285781,-18000,,
com.google.Chrome,2,1713836250,1713836252,1713836252.636667,-18000,,
com.microsoft.VSCode,6,1713836244,1713836250,1713836250.4005399,-18000,,
com.google.Chrome,1,1713836243,1713836244,1713836244.264285,-18000,,
com.microsoft.VSCode,7,1713836236,1713836243,1713836243.632005,-18000,,
com.google.Chrome,3,1713836233,1713836236,1713836236.201983,-18000,,
com.microsoft.VSCode,6,1713836227,1713836233,1713836233.707294,-18000,,
com.google.Chrome,16,1713836211,1713836227,1713836227.4574351,-18000,,
com.microsoft.VSCode,439,1713835772,1713836211,1713836211.979147,-18000,,
com.google.Chrome,0,1713835772,1713835772,1713835772.858897,-18000,,
com.microsoft.VSCode,7,1713835765,1713835772,1713835772.044622,-18000,,
com.google.Chrome,1,1713835764,1713835765,1713835765.515617,-18000,,
com.microsoft.VSCode,68,1713835696,1713835764,1713835764.543398,-18000,,
com.google.Chrome,2,1713835694,1713835696,1713835696.061009,-18000,,
com.microsoft.VSCode,75,1713835619,1713835694,1713835694.832829,-18000,,
com.google.Chrome,5,1713835614,1713835619,1713835619.391849,-18000,,
com.microsoft.VSCode,122,1713835492,1713835614,1713835614.899306,-18000,,
com.apple.finder,28,1713835464,1713835492,1713835492.7387471,-18000,,
com.microsoft.VSCode,32,1713835432,1713835464,1713835465.062002,-18000,,
com.apple.finder,2,1713835430,1713835432,1713835432.5065851,-18000,,
com.google.Chrome,20,1713835410,1713835430,1713835430.780459,-18000,,
com.microsoft.VSCode,17,1713835393,1713835410,1713835410.763391,-18000,,
com.google.Chrome,157,1713835236,1713835393,1713835393.778922,-18000,,
com.microsoft.VSCode,4,1713835232,1713835236,1713835236.302192,-18000,,
com.google.Chrome,232,1713835000,1713835232,1713835232.6286712,-18000,,
com.microsoft.VSCode,2,1713834998,1713835000,1713835000.792342,-18000,,
com.google.Chrome,101,1713834897,1713834998,1713834998.911518,-18000,,
com.microsoft.VSCode,6,1713834891,1713834897,1713834897.8014488,-18000,,
com.google.Chrome,14,1713834877,1713834891,1713834891.3421931,-18000,,
com.apple.finder,3,1713834874,1713834877,1713834877.3022618,-18000,,
com.google.Chrome,159,1713834715,1713834874,1713834874.990292,-18000,,
com.microsoft.VSCode,4,1713834711,1713834715,1713834715.2509742,-18000,,
com.google.Chrome,47,1713834664,1713834711,1713834711.3066092,-18000,,
com.microsoft.VSCode,12,1713834652,1713834664,1713834664.314828,-18000,,
com.google.Chrome,4,1713834648,1713834652,1713834652.5591931,-18000,,
com.apple.finder,34,1713834614,1713834648,1713834648.3640141,-18000,,
com.apple.iWork.Numbers,4,1713834610,1713834614,1713834614.878676,-18000,,
com.apple.finder,1,1713834609,1713834610,1713834610.59834,-18000,,
com.google.Chrome,13,1713834596,1713834609,1713834609.781604,-18000,,
com.microsoft.VSCode,23,1713834573,1713834596,1713834596.900893,-18000,,
com.apple.finder,40,1713834533,1713834573,1713834573.8769789,-18000,,
com.apple.iWork.Numbers,66,1713834467,1713834533,1713834533.120933,-18000,,
com.google.Chrome,32,1713834435,1713834467,1713834467.8663511,-18000,,
com.microsoft.VSCode,121,1713834314,1713834435,1713834435.351591,-18000,,
com.google.Chrome,53,1713834261,1713834314,1713834314.533729,-18000,,
com.microsoft.VSCode,5,1713834256,1713834261,1713834261.456281,-18000,,
com.google.Chrome,11,1713834245,1713834256,1713834256.8792582,-18000,,
com.microsoft.VSCode,13,1713834232,1713834245,1713834245.4545522,-18000,,
com.google.Chrome,7,1713834225,1713834232,1713834232.592114,-18000,,
com.microsoft.VSCode,4,1713834221,1713834225,1713834225.936439,-18000,,
com.google.Chrome,7,1713834214,1713834221,1713834221.090455,-18000,,
com.microsoft.VSCode,4,1713834210,1713834214,1713834214.526956,-18000,,
com.google.Chrome,11,1713834199,1713834210,1713834210.2325048,-18000,,
com.microsoft.VSCode,7,1713834192,1713834199,1713834199.1967769,-18000,,
com.google.Chrome,123,1713834069,1713834192,1713834192.882673,-18000,,
com.microsoft.VSCode,15,1713834054,1713834069,1713834069.192428,-18000,,
com.google.Chrome,56,1713833998,1713834054,1713834054.569154,-18000,,
com.microsoft.VSCode,4,1713833994,1713833998,1713833998.8615742,-18000,,
com.google.Chrome,16,1713833978,1713833994,1713833994.831624,-18000,,
com.microsoft.VSCode,8,1713833970,1713833978,1713833978.6507459,-18000,,
com.google.Chrome,242,1713833728,1713833970,1713833970.943902,-18000,,
com.microsoft.VSCode,1,1713833727,1713833728,1713833728.6234689,-18000,,
com.google.Chrome,4,1713833723,1713833727,1713833727.569758,-18000,,
com.microsoft.VSCode,3,1713833720,1713833723,1713833723.253478,-18000,,
com.google.Chrome,4,1713833716,1713833720,1713833721.022136,-18000,,
com.microsoft.VSCode,3,1713833713,1713833716,1713833716.3074589,-18000,,
com.google.Chrome,10,1713833703,1713833713,1713833713.4655929,-18000,,
com.microsoft.VSCode,2,1713833701,1713833703,1713833703.1082091,-18000,,
com.google.Chrome,17,1713833684,1713833701,1713833701.198196,-18000,,
com.microsoft.VSCode,5,1713833679,1713833684,1713833684.201983,-18000,,
com.google.Chrome,8,1713833671,1713833679,1713833679.885045,-18000,,
com.microsoft.VSCode,2,1713833669,1713833671,1713833671.692164,-18000,,
com.google.Chrome,55,1713833614,1713833669,1713833669.947643,-18000,,
com.microsoft.VSCode,6,1713833608,1713833614,1713833614.3487182,-18000,,
com.google.Chrome,44,1713833564,1713833608,1713833608.466663,-18000,,
com.microsoft.VSCode,2,1713833562,1713833564,1713833564.2267861,-18000,,
com.google.Chrome,16,1713833546,1713833562,1713833562.442739,-18000,,
com.microsoft.VSCode,3,1713833543,1713833546,1713833547.045759,-18000,,
com.google.Chrome,31,1713833512,1713833543,1713833544.0499558,-18000,,
com.microsoft.VSCode,17,1713833495,1713833512,1713833512.345144,-18000,,
com.google.Chrome,150,1713833345,1713833495,1713833495.646857,-18000,,
com.microsoft.VSCode,26,1713833319,1713833345,1713833345.346847,-18000,,
com.google.Chrome,10,1713833309,1713833319,1713833319.982335,-18000,,
com.leomehlig.today,18,1713833291,1713833309,1713833309.1344318,-18000,,
com.google.Chrome,34,1713833257,1713833291,1713833291.147581,-18000,,
com.leomehlig.today,30,1713833227,1713833257,1713833258.083605,-18000,,
com.google.Chrome,586,1713832641,1713833227,1713833227.67903,-18000,,
com.apple.Preview,334,1713832307,1713832641,1713832641.9091969,-18000,,
com.apple.finder,12,1713832295,1713832307,1713832307.276556,-18000,,
com.apple.Preview,22,1713832273,1713832295,1713832295.5706549,-18000,,
com.apple.finder,12,1713832261,1713832273,1713832273.4717278,-18000,,
com.google.Chrome,64,1713832197,1713832261,1713832261.240662,-18000,,
com.hnc.Discord,140,1713832057,1713832197,1713832197.3454928,-18000,,
com.google.Chrome,11,1713832046,1713832057,1713832057.963995,-18000,,
com.hnc.Discord,11,1713832035,1713832046,1713832047.11293,-18000,,
com.google.Chrome,61,1713831974,1713832035,1713832035.9686918,-18000,,
com.google.Chrome,621,1713831350,1713831971,1713831971.686991,-18000,,
com.microsoft.onenote.mac,1,1713831329,1713831330,1713831330.354659,-18000,,
com.google.Chrome,4,1713831325,1713831329,1713831329.396966,-18000,,
com.leomehlig.today,8,1713831317,1713831325,1713831325.7161798,-18000,,
com.google.Chrome,72,1713831245,1713831317,1713831317.19584,-18000,,
com.apple.calculator,39,1713831206,1713831245,1713831245.452992,-18000,,
com.google.Chrome,73,1713831133,1713831206,1713831206.610868,-18000,,
com.google.Chrome,3,1713825827,1713825830,1713825830.7637382,-18000,,
com.google.Chrome,68,1713825749,1713825817,1713825817.631079,-18000,,
com.microsoft.onenote.mac,130,1713825619,1713825749,1713825750.555229,-18000,,
com.google.Chrome,26,1713825593,1713825619,1713825619.7062569,-18000,,
com.leomehlig.today,10,1713825583,1713825593,1713825593.2624068,-18000,,
com.leomehlig.today,16,1713825331,1713825347,1713825348.0854359,-18000,,
com.apple.finder,30,1713825301,1713825331,1713825331.091912,-18000,,
com.apple.Preview,26,1713825275,1713825301,1713825301.753488,-18000,,
com.apple.finder,2,1713825273,1713825275,1713825275.893477,-18000,,
com.apple.Preview,123,1713825150,1713825273,1713825273.8673692,-18000,,
com.apple.finder,10,1713825140,1713825150,1713825150.6192842,-18000,,
com.apple.Preview,46,1713825094,1713825140,1713825140.479542,-18000,,
com.apple.finder,11,1713825083,1713825094,1713825094.184063,-18000,,
com.apple.Preview,2,1713825081,1713825083,1713825083.9668288,-18000,,
com.google.Chrome,2031,1713823050,1713825081,1713825081.471082,-18000,,
com.apple.iCal,37,1713823013,1713823050,1713823050.318716,-18000,,
com.microsoft.Outlook,16,1713822997,1713823013,1713823013.8433828,-18000,,
com.google.Chrome,79,1713822918,1713822997,1713822997.7727509,-18000,,
com.apple.iCal,22,1713822896,1713822918,1713822918.1211681,-18000,,
com.leomehlig.today,36,1713822860,1713822896,1713822896.771292,-18000,,
com.google.Chrome,0,1713822860,1713822860,1713822860.954704,-18000,,
com.leomehlig.today,7,1713822851,1713822858,1713822858.694972,-18000,,
com.google.Chrome,337,1713822514,1713822851,1713822851.761764,-18000,,
com.leomehlig.today,6,1713822498,1713822504,1713822504.926336,-18000,,
com.google.Chrome,582,1713821916,1713822498,1713822498.6984959,-18000,,
com.apple.iCal,31,1713821885,1713821916,1713821916.966929,-18000,,
com.google.Chrome,139,1713821746,1713821885,1713821885.633883,-18000,,
com.apple.Preview,59,1713821687,1713821746,1713821746.452714,-18000,,
com.apple.finder,17,1713821670,1713821687,1713821687.687419,-18000,,
com.google.Chrome,5,1713821665,1713821670,1713821670.109304,-18000,,
com.apple.MobileSMS,3,1713821662,1713821665,1713821665.469545,-18000,,
com.google.Chrome,76,1713821586,1713821662,1713821662.918477,-18000,,
com.apple.calculator,5,1713821581,1713821586,1713821587.029185,-18000,,
com.google.Chrome,7,1713821574,1713821581,1713821581.352541,-18000,,
com.apple.calculator,3,1713821571,1713821574,1713821574.19135,-18000,,
com.google.Chrome,8,1713821563,1713821571,1713821571.2323399,-18000,,
com.apple.calculator,2,1713821561,1713821563,1713821563.7030292,-18000,,
com.google.Chrome,10,1713821551,1713821561,1713821561.5489721,-18000,,
com.apple.calculator,3,1713821548,1713821551,1713821551.485623,-18000,,
com.google.Chrome,6,1713821542,1713821548,1713821548.270516,-18000,,
com.apple.calculator,3,1713821539,1713821542,1713821542.342097,-18000,,
com.google.Chrome,2,1713821537,1713821539,1713821539.210288,-18000,,
com.apple.calculator,3,1713821534,1713821537,1713821537.72492,-18000,,
com.google.Chrome,29,1713821505,1713821534,1713821534.262066,-18000,,
com.google.Chrome,669,1713801157,1713801826,1713801826.90898,-18000,,
com.leomehlig.today,4,1713801122,1713801126,1713801127.458184,-18000,,
com.tinyspeck.chatlyio,12,1713799251,1713799263,1713799263.636123,-18000,EB445137-D7F5-57EC-87DA-1DB460D64046,"iPhone13,2"
com.apple.weather,4,1713799236,1713799240,1713799240.752095,-18000,EB445137-D7F5-57EC-87DA-1DB460D64046,"iPhone13,2"
com.apple.weather,9,1713799063,1713799072,1713799072.172781,-18000,EB445137-D7F5-57EC-87DA-1DB460D64046,"iPhone13,2"
com.apple.podcasts,2,1713799060,1713799062,1713799063.051846,-18000,EB445137-D7F5-57EC-87DA-1DB460D64046,"iPhone13,2"
com.apple.podcasts,4,1713798991,1713798995,1713798995.5251641,-18000,EB445137-D7F5-57EC-87DA-1DB460D64046,"iPhone13,2"
com.apple.podcasts,6,1713798291,1713798297,1713798297.2241359,-18000,EB445137-D7F5-57EC-87DA-1DB460D64046,"iPhone13,2"
com.apple.podcasts,5,1713798262,1713798267,1713798267.508214,-18000,EB445137-D7F5-57EC-87DA-1DB460D64046,"iPhone13,2"
com.apple.podcasts,10,1713798248,1713798258,1713798258.3324962,-18000,EB445137-D7F5-57EC-87DA-1DB460D64046,"iPhone13,2"
com.apple.podcasts,4,1713797262,1713797266,1713797266.576109,-18000,EB445137-D7F5-57EC-87DA-1DB460D64046,"iPhone13,2"
com.apple.podcasts,50,1713796635,1713796685,1713796685.921582,-18000,EB445137-D7F5-57EC-87DA-1DB460D64046,"iPhone13,2"
com.apple.weather,5,1713796621,1713796626,1713796628.855877,-18000,EB445137-D7F5-57EC-87DA-1DB460D64046,"iPhone13,2"
com.apple.weather,3,1713796399,1713796402,1713796402.058292,-18000,EB445137-D7F5-57EC-87DA-1DB460D64046,"iPhone13,2"
com.apple.weather,11,1713796341,1713796352,1713796353.3795738,-18000,EB445137-D7F5-57EC-87DA-1DB460D64046,"iPhone13,2"
com.leomehlig.today,80,1713796324,1713796404,1713796404.031074,-18000,,
com.apple.Health,22,1713796300,1713796322,1713796322.741823,-18000,EB445137-D7F5-57EC-87DA-1DB460D64046,"iPhone13,2"
com.apple.iCal,73,1713796251,1713796324,1713796324.3480182,-18000,,
com.leomehlig.today,18,1713796233,1713796251,1713796252.018601,-18000,,
com.apple.iCal,5,1713796228,1713796233,1713796233.727683,-18000,,
com.microsoft.Office.Outlook,86,1713796213,1713796299,1713796299.4369922,-18000,EB445137-D7F5-57EC-87DA-1DB460D64046,"iPhone13,2"
com.apple.finder,16,1713796212,1713796228,1713796228.959972,-18000,,
com.microsoft.Outlook,36,1713796176,1713796212,1713796212.889216,-18000,,
com.google.Chrome,2,1713796174,1713796176,1713796176.626267,-18000,,
com.microsoft.Outlook,0,1713796174,1713796174,1713796174.6945848,-18000,,
com.google.Chrome,15,1713796159,1713796174,1713796174.140459,-18000,,
com.microsoft.Outlook,10,1713796149,1713796159,1713796160.2043571,-18000,,
com.google.Chrome,20,1713796129,1713796149,1713796149.7655802,-18000,,
com.microsoft.Office.Outlook,85,1713796126,1713796211,1713796211.429177,-18000,EB445137-D7F5-57EC-87DA-1DB460D64046,"iPhone13,2"
com.thestorygraph.thestorygraph,100,1713760997,1713761097,1713761097.506217,-18000,EB445137-D7F5-57EC-87DA-1DB460D64046,"iPhone13,2"
com.apple.Health,39,1713758928,1713758967,1713758967.5281901,-18000,EB445137-D7F5-57EC-87DA-1DB460D64046,"iPhone13,2"
com.google.Chrome,39,1713758883,1713758922,1713758922.8527799,-18000,,
com.leomehlig.today,2,1713758867,1713758869,1713758869.2620301,-18000,,
com.moodle.moodlemobile,93,1713758835,1713758928,1713758928.809359,-18000,EB445137-D7F5-57EC-87DA-1DB460D64046,"iPhone13,2"
com.toyopagroup.picaboo,19,1713758802,1713758821,1713758821.711841,-18000,EB445137-D7F5-57EC-87DA-1DB460D64046,"iPhone13,2"
com.thestorygraph.thestorygraph,29,1713758766,1713758795,1713758796.000673,-18000,EB445137-D7F5-57EC-87DA-1DB460D64046,"iPhone13,2"
com.apple.Music,7,1713758758,1713758765,1713758765.044976,-18000,EB445137-D7F5-57EC-87DA-1DB460D64046,"iPhone13,2"
com.leomehlig.today,14,1713756961,1713756975,1713756976.1481218,-18000,,
com.apple.Music,12,1713756600,1713756612,1713756612.834556,-18000,EB445137-D7F5-57EC-87DA-1DB460D64046,"iPhone13,2"
com.google.Chrome,822,1713756139,1713756961,1713756961.645046,-18000,,
com.apple.Music,12,1713756132,1713756144,1713756144.482872,-18000,EB445137-D7F5-57EC-87DA-1DB460D64046,"iPhone13,2"
com.apple.Music,15,1713756116,1713756131,1713756131.604209,-18000,EB445137-D7F5-57EC-87DA-1DB460D64046,"iPhone13,2"
com.google.Chrome,656,1713755453,1713756109,1713756109.052598,-18000,,
com.leomehlig.today,8,1713755445,1713755453,1713755453.408109,-18000,,
com.google.Chrome,1111,1713754334,1713755445,1713755445.550741,-18000,,
com.google.Chrome,566,1713753712,1713754278,1713754278.68615,-18000,,
com.google.Chrome,816,1713752639,1713753455,1713753455.618406,-18000,,
com.apple.Music,3,1713752563,1713752566,1713752566.756753,-18000,EB445137-D7F5-57EC-87DA-1DB460D64046,"iPhone13,2"
com.google.Chrome,15,1713752349,1713752364,1713752364.91921,-18000,,
com.leomehlig.today,30,1713752319,1713752349,1713752349.288299,-18000,,
com.google.Chrome,38,1713752281,1713752319,1713752319.642535,-18000,,
com.leomehlig.today,20,1713752261,1713752281,1713752281.670803,-18000,,
com.apple.Preview,697,1713751564,1713752261,1713752261.666841,-18000,,
com.google.Chrome,24,1713751540,1713751564,1713751564.699158,-18000,,
com.apple.Preview,1964,1713749576,1713751540,1713751540.597194,-18000,,
com.apple.finder,3,1713749573,1713749576,1713749576.4972138,-18000,,
com.google.Chrome,4,1713749569,1713749573,1713749573.374641,-18000,,
com.leomehlig.today,12,1713749557,1713749569,1713749569.875216,-18000,,
com.google.Chrome,474,1713749083,1713749557,1713749557.345818,-18000,,
com.apple.Music,21,1713748469,1713748490,1713748490.169704,-18000,EB445137-D7F5-57EC-87DA-1DB460D64046,"iPhone13,2"
com.apple.Health,51,1713748399,1713748450,1713748450.369354,-18000,EB445137-D7F5-57EC-87DA-1DB460D64046,"iPhone13,2"
com.apple.podcasts,5,1713748393,1713748398,1713748398.435488,-18000,EB445137-D7F5-57EC-87DA-1DB460D64046,"iPhone13,2"
com.apple.podcasts,6,1713748385,1713748391,1713748391.9000468,-18000,EB445137-D7F5-57EC-87DA-1DB460D64046,"iPhone13,2"
com.google.Chrome,492,1713748369,1713748861,1713748861.3701239,-18000,,
com.leomehlig.today,28,1713748341,1713748369,1713748369.7079458,-18000,,
com.google.Chrome,73,1713748268,1713748341,1713748341.2436519,-18000,,
com.leomehlig.today,12,1713748243,1713748255,1713748255.5681129,-18000,,
com.google.Chrome,618,1713747625,1713748243,1713748243.5175261,-18000,,
com.apple.podcasts,1,1713747222,1713747223,1713747223.670495,-18000,EB445137-D7F5-57EC-87DA-1DB460D64046,"iPhone13,2"
com.apple.podcasts,3,1713747187,1713747190,1713747190.20604,-18000,EB445137-D7F5-57EC-87DA-1DB460D64046,"iPhone13,2"
com.apple.Maps,2,1713747185,1713747187,1713747187.3526258,-18000,EB445137-D7F5-57EC-87DA-1DB460D64046,"iPhone13,2"
com.apple.podcasts,14,1713747171,1713747185,1713747185.165432,-18000,EB445137-D7F5-57EC-87DA-1DB460D64046,"iPhone13,2"
com.apple.podcasts,2,1713747070,1713747072,1713747072.88432,-18000,EB445137-D7F5-57EC-87DA-1DB460D64046,"iPhone13,2"
com.apple.podcasts,9,1713746647,1713746656,1713746656.8880749,-18000,EB445137-D7F5-57EC-87DA-1DB460D64046,"iPhone13,2"
com.apple.podcasts,9,1713746627,1713746636,1713746636.591587,-18000,EB445137-D7F5-57EC-87DA-1DB460D64046,"iPhone13,2"
com.apple.podcasts,2,1713746557,1713746559,1713746559.724368,-18000,EB445137-D7F5-57EC-87DA-1DB460D64046,"iPhone13,2"
com.apple.podcasts,3,1713745955,1713745958,1713745958.5794811,-18000,EB445137-D7F5-57EC-87DA-1DB460D64046,"iPhone13,2"
com.apple.Maps,11,1713744996,1713745007,1713745007.292237,-18000,EB445137-D7F5-57EC-87DA-1DB460D64046,"iPhone13,2"
com.apple.MobileSMS,3,1713744993,1713744996,1713744996.2137651,-18000,EB445137-D7F5-57EC-87DA-1DB460D64046,"iPhone13,2"
com.apple.MobileSMS,4,1713744146,1713744150,1713744150.0484939,-18000,EB445137-D7F5-57EC-87DA-1DB460D64046,"iPhone13,2"
com.apple.MobileSMS,6,1713744125,1713744131,1713744131.689005,-18000,EB445137-D7F5-57EC-87DA-1DB460D64046,"iPhone13,2"
com.apple.podcasts,1,1713744124,1713744125,1713744126.017587,-18000,EB445137-D7F5-57EC-87DA-1DB460D64046,"iPhone13,2"
com.apple.podcasts,6,1713743778,1713743784,1713743784.884913,-18000,EB445137-D7F5-57EC-87DA-1DB460D64046,"iPhone13,2"
com.apple.podcasts,3,1713743774,1713743777,1713743777.828202,-18000,EB445137-D7F5-57EC-87DA-1DB460D64046,"iPhone13,2"
com.apple.podcasts,3,1713743662,1713743665,1713743665.731338,-18000,EB445137-D7F5-57EC-87DA-1DB460D64046,"iPhone13,2"
com.apple.podcasts,6,1713743631,1713743637,1713743637.359132,-18000,EB445137-D7F5-57EC-87DA-1DB460D64046,"iPhone13,2"
com.apple.podcasts,7,1713743623,1713743630,1713743630.6417022,-18000,EB445137-D7F5-57EC-87DA-1DB460D64046,"iPhone13,2"
com.apple.podcasts,4,1713743616,1713743620,1713743620.622144,-18000,EB445137-D7F5-57EC-87DA-1DB460D64046,"iPhone13,2"
com.apple.podcasts,6,1713743600,1713743606,1713743606.592205,-18000,EB445137-D7F5-57EC-87DA-1DB460D64046,"iPhone13,2"
com.apple.podcasts,39,1713743542,1713743581,1713743581.643986,-18000,EB445137-D7F5-57EC-87DA-1DB460D64046,"iPhone13,2"
com.apple.Health,49,1713739695,1713739744,1713739744.562213,-18000,EB445137-D7F5-57EC-87DA-1DB460D64046,"iPhone13,2"
com.andydev.alpenglow,2,1713739691,1713739693,1713739693.8855062,-18000,EB445137-D7F5-57EC-87DA-1DB460D64046,"iPhone13,2"
com.andydev.alpenglow,56,1713739567,1713739623,1713739623.484843,-18000,EB445137-D7F5-57EC-87DA-1DB460D64046,"iPhone13,2"
com.apple.MobileSMS,8,1713739442,1713739450,1713739450.69659,-18000,EB445137-D7F5-57EC-87DA-1DB460D64046,"iPhone13,2"
com.google.Sheets,23,1713739360,1713739383,1713739383.379033,-18000,EB445137-D7F5-57EC-87DA-1DB460D64046,"iPhone13,2"
com.apple.calculator,10,1713739346,1713739356,1713739356.185697,-18000,EB445137-D7F5-57EC-87DA-1DB460D64046,"iPhone13,2"
edu.illinois.rokwire.ios,7,1713739339,1713739346,1713739346.7702398,-18000,EB445137-D7F5-57EC-87DA-1DB460D64046,"iPhone13,2"
com.apple.calculator,4,1713739335,1713739339,1713739339.034811,-18000,EB445137-D7F5-57EC-87DA-1DB460D64046,"iPhone13,2"
edu.illinois.rokwire.ios,5,1713739330,1713739335,1713739335.311487,-18000,EB445137-D7F5-57EC-87DA-1DB460D64046,"iPhone13,2"
com.apple.calculator,6,1713739324,1713739330,1713739330.395488,-18000,EB445137-D7F5-57EC-87DA-1DB460D64046,"iPhone13,2"
edu.illinois.rokwire.ios,28,1713739296,1713739324,1713739324.694113,-18000,EB445137-D7F5-57EC-87DA-1DB460D64046,"iPhone13,2"
edu.illinois.rokwire.ios,76,1713738667,1713738743,1713738743.499971,-18000,EB445137-D7F5-57EC-87DA-1DB460D64046,"iPhone13,2"
com.google.Chrome,53,1713738357,1713738410,1713738410.690792,-18000,,
com.letterboxd.LetterboxdApp,216,1713736045,1713736261,1713736261.2748919,-18000,EB445137-D7F5-57EC-87DA-1DB460D64046,"iPhone13,2"
com.google.chrome.ios,19,1713736026,1713736045,1713736045.811325,-18000,EB445137-D7F5-57EC-87DA-1DB460D64046,"iPhone13,2"
com.google.chrome.ios,3,1713733629,1713733632,1713733632.181686,-18000,EB445137-D7F5-57EC-87DA-1DB460D64046,"iPhone13,2"
com.google.chrome.ios,7,1713733565,1713733572,1713733572.6997771,-18000,EB445137-D7F5-57EC-87DA-1DB460D64046,"iPhone13,2"
com.google.chrome.ios,19,1713733024,1713733043,1713733043.5444798,-18000,EB445137-D7F5-57EC-87DA-1DB460D64046,"iPhone13,2"
com.letterboxd.LetterboxdApp,2,1713733022,1713733024,1713733024.8104749,-18000,EB445137-D7F5-57EC-87DA-1DB460D64046,"iPhone13,2"
com.letterboxd.LetterboxdApp,40,1713732233,1713732273,1713732273.3365111,-18000,EB445137-D7F5-57EC-87DA-1DB460D64046,"iPhone13,2"
com.google.chrome.ios,2,1713732231,1713732233,1713732233.749135,-18000,EB445137-D7F5-57EC-87DA-1DB460D64046,"iPhone13,2"
com.letterboxd.LetterboxdApp,3,1713732227,1713732230,1713732230.6484032,-18000,EB445137-D7F5-57EC-87DA-1DB460D64046,"iPhone13,2"
com.letterboxd.LetterboxdApp,6,1713729667,1713729673,1713729673.4213839,-18000,EB445137-D7F5-57EC-87DA-1DB460D64046,"iPhone13,2"
com.letterboxd.LetterboxdApp,27,1713729579,1713729606,1713729606.80914,-18000,EB445137-D7F5-57EC-87DA-1DB460D64046,"iPhone13,2"
com.letterboxd.LetterboxdApp,14,1713729127,1713729141,1713729141.9793758,-18000,EB445137-D7F5-57EC-87DA-1DB460D64046,"iPhone13,2"
com.google.chrome.ios,4,1713729121,1713729125,1713729125.894063,-18000,EB445137-D7F5-57EC-87DA-1DB460D64046,"iPhone13,2"
com.google.Chrome,21,1713728970,1713728991,1713728991.376755,-18000,,
com.apple.finder,2,1713728968,1713728970,1713728970.1511421,-18000,,
com.google.chrome.ios,7,1713728958,1713728965,1713728965.17068,-18000,EB445137-D7F5-57EC-87DA-1DB460D64046,"iPhone13,2"
com.apple.Health,3,1713728955,1713728958,1713728958.464854,-18000,EB445137-D7F5-57EC-87DA-1DB460D64046,"iPhone13,2"
com.apple.finder,7,1713728858,1713728865,1713728865.264285,-18000,,
com.google.Chrome,68,1713728790,1713728858,1713728858.1816,-18000,,
com.apple.finder,2,1713728788,1713728790,1713728790.3495479,-18000,,
com.apple.Health,13,1713728059,1713728072,1713728072.8984032,-18000,EB445137-D7F5-57EC-87DA-1DB460D64046,"iPhone13,2"
com.apple.podcasts,2,1713728056,1713728058,1713728058.954886,-18000,EB445137-D7F5-57EC-87DA-1DB460D64046,"iPhone13,2"
com.apple.podcasts,6,1713727864,1713727870,1713727870.306381,-18000,EB445137-D7F5-57EC-87DA-1DB460D64046,"iPhone13,2"
com.apple.podcasts,611,1713727198,1713727809,1713727809.30879,-18000,EB445137-D7F5-57EC-87DA-1DB460D64046,"iPhone13,2"
com.apple.finder,2,1713727187,1713727189,1713727189.795258,-18000,,
com.google.Chrome,264,1713726923,1713727187,1713727188.043768,-18000,,
com.apple.finder,3,1713726920,1713726923,1713726923.3207011,-18000,,
com.apple.Preview,1,1713726919,1713726920,1713726920.811224,-18000,,
com.leomehlig.today,146,1713726773,1713726919,1713726919.3113441,-18000,,
com.google.Chrome,246,1713726527,1713726773,1713726773.6211162,-18000,,
com.leomehlig.today,43,1713726484,1713726527,1713726527.136879,-18000,,
com.apple.Preview,1,1713726483,1713726484,1713726484.76459,-18000,,
com.google.Chrome,6,1713726477,1713726483,1713726483.59297,-18000,,
com.apple.Preview,1,1713726476,1713726477,1713726477.4268909,-18000,,
com.leomehlig.today,10,1713726466,1713726476,1713726476.669878,-18000,,
com.apple.Preview,1,1713726465,1713726466,1713726466.8651628,-18000,,
com.google.Chrome,4,1713726461,1713726465,1713726465.083194,-18000,,
com.apple.Preview,8,1713726453,1713726461,1713726461.960701,-18000,,
com.google.Chrome,34,1713726419,1713726453,1713726453.4240131,-18000,,
com.apple.Preview,35,1713726384,1713726419,1713726419.7773352,-18000,,
com.google.Chrome,35,1713726349,1713726384,1713726384.214165,-18000,,
com.leomehlig.today,1,1713726348,1713726349,1713726349.905652,-18000,,
com.google.Chrome,287,1713726061,1713726348,1713726348.822351,-18000,,
com.google.Chrome,849,1713725210,1713726059,1713726059.9477901,-18000,,
com.apple.Preview,8,1713725202,1713725210,1713725210.0414948,-18000,,
com.google.Chrome,2,1713725200,1713725202,1713725202.272449,-18000,,
com.apple.Preview,29,1713725171,1713725200,1713725200.793169,-18000,,
com.google.Chrome,22,1713725149,1713725171,1713725171.97808,-18000,,
com.apple.Preview,281,1713724868,1713725149,1713725149.6698751,-18000,,
com.google.Chrome,13,1713724855,1713724868,1713724868.673425,-18000,,
com.apple.Preview,115,1713724740,1713724855,1713724855.9818301,-18000,,
com.google.Chrome,37,1713724703,1713724740,1713724740.1003509,-18000,,
com.apple.Preview,39,1713724664,1713724703,1713724703.8264089,-18000,,
com.apple.finder,5,1713724659,1713724664,1713724664.2032151,-18000,,
com.google.Chrome,574,1713724085,1713724659,1713724659.4637032,-18000,,
com.leomehlig.today,3,1713724082,1713724085,1713724085.433919,-18000,,
com.google.Chrome,1207,1713722875,1713724082,1713724082.222929,-18000,,
com.leomehlig.today,4,1713722871,1713722875,1713722875.2570271,-18000,,
com.apple.MobileSMS,1,1713722863,1713722864,1713722864.8833919,-18000,EB445137-D7F5-57EC-87DA-1DB460D64046,"iPhone13,2"
com.leomehlig.today,17,1713721562,1713721579,1713721579.955637,-18000,,
com.google.Chrome,88,1713721474,1713721562,1713721562.752647,-18000,,
com.leomehlig.today,1,1713721473,1713721474,1713721474.296304,-18000,,
com.apple.Health,60,1713721409,1713721469,1713721469.618235,-18000,EB445137-D7F5-57EC-87DA-1DB460D64046,"iPhone13,2"
com.apple.findmy,8,1713721395,1713721403,1713721404.044297,-18000,EB445137-D7F5-57EC-87DA-1DB460D64046,"iPhone13,2"
com.apple.MobileSMS,6,1713721389,1713721395,1713721395.224146,-18000,EB445137-D7F5-57EC-87DA-1DB460D64046,"iPhone13,2"
com.apple.MobileSMS,3,1713721385,1713721388,1713721388.969324,-18000,EB445137-D7F5-57EC-87DA-1DB460D64046,"iPhone13,2"
com.google.chrome.ios,107,1713720995,1713721102,1713721103.010263,-18000,EB445137-D7F5-57EC-87DA-1DB460D64046,"iPhone13,2"
com.apple.podcasts,3,1713720992,1713720995,1713720995.657682,-18000,EB445137-D7F5-57EC-87DA-1DB460D64046,"iPhone13,2"
com.apple.podcasts,6,1713720585,1713720591,1713720591.7704701,-18000,EB445137-D7F5-57EC-87DA-1DB460D64046,"iPhone13,2"
com.apple.podcasts,2,1713720582,1713720584,1713720584.520014,-18000,EB445137-D7F5-57EC-87DA-1DB460D64046,"iPhone13,2"
com.apple.podcasts,4,1713719891,1713719895,1713719895.1824222,-18000,EB445137-D7F5-57EC-87DA-1DB460D64046,"iPhone13,2"
com.apple.podcasts,2,1713719352,1713719354,1713719354.2877269,-18000,EB445137-D7F5-57EC-87DA-1DB460D64046,"iPhone13,2"
com.apple.podcasts,9,1713719177,1713719186,1713719186.263967,-18000,EB445137-D7F5-57EC-87DA-1DB460D64046,"iPhone13,2"
com.apple.podcasts,3,1713719104,1713719107,1713719107.193038,-18000,EB445137-D7F5-57EC-87DA-1DB460D64046,"iPhone13,2"
com.apple.podcasts,8,1713718364,1713718372,1713718372.5594912,-18000,EB445137-D7F5-57EC-87DA-1DB460D64046,"iPhone13,2"
com.apple.podcasts,11,1713717813,1713717824,1713717824.61152,-18000,EB445137-D7F5-57EC-87DA-1DB460D64046,"iPhone13,2"
com.microsoft.Office.Outlook,2,1713717807,1713717809,1713717809.491836,-18000,EB445137-D7F5-57EC-87DA-1DB460D64046,"iPhone13,2"
com.apple.camera,1,1713717678,1713717679,1713717679.340952,-18000,EB445137-D7F5-57EC-87DA-1DB460D64046,"iPhone13,2"
com.microsoft.Office.Outlook,8,1713717677,1713717685,1713717685.15101,-18000,EB445137-D7F5-57EC-87DA-1DB460D64046,"iPhone13,2"
com.microsoft.Office.Outlook,29,1713717545,1713717574,1713717574.082433,-18000,EB445137-D7F5-57EC-87DA-1DB460D64046,"iPhone13,2"
com.google.chrome.ios,3,1713717542,1713717545,1713717545.374346,-18000,EB445137-D7F5-57EC-87DA-1DB460D64046,"iPhone13,2"
com.google.chrome.ios,30,1713717471,1713717501,1713717501.113748,-18000,EB445137-D7F5-57EC-87DA-1DB460D64046,"iPhone13,2"
edu.illinois.rokwire.ios,21,1713717450,1713717471,1713717471.920752,-18000,EB445137-D7F5-57EC-87DA-1DB460D64046,"iPhone13,2"
com.google.chrome.ios,51,1713717396,1713717447,1713717447.7896209,-18000,EB445137-D7F5-57EC-87DA-1DB460D64046,"iPhone13,2"
com.apple.findmy,21,1713717218,1713717239,1713717239.27076,-18000,EB445137-D7F5-57EC-87DA-1DB460D64046,"iPhone13,2"
com.apple.MobileSMS,95,1713717123,1713717218,1713717218.054502,-18000,EB445137-D7F5-57EC-87DA-1DB460D64046,"iPhone13,2"
com.apple.MobileSMS,115,1713717007,1713717122,1713717122.449467,-18000,EB445137-D7F5-57EC-87DA-1DB460D64046,"iPhone13,2"
com.apple.weather,3,1713717004,1713717007,1713717007.1268659,-18000,EB445137-D7F5-57EC-87DA-1DB460D64046,"iPhone13,2"
com.apple.weather,10,1713716309,1713716319,1713716319.376723,-18000,EB445137-D7F5-57EC-87DA-1DB460D64046,"iPhone13,2"
com.leomehlig.today,64,1713716112,1713716176,1713716176.7742581,-18000,,
com.google.Chrome,39,1713716073,1713716112,1713716112.156863,-18000,,
com.leomehlig.today,2,1713716071,1713716073,1713716073.2947102,-18000,,
com.google.Chrome,8,1713716063,1713716071,1713716071.134253,-18000,,
com.leomehlig.today,18,1713716029,1713716047,1713716048.627715,-18000,,
com.apple.finder,14,1713716015,1713716029,1713716029.442356,-18000,,
com.google.Chrome,40,1713715975,1713716015,1713716015.2117372,-18000,,
com.apple.finder,41,1713715934,1713715975,1713715975.520815,-18000,,
com.google.Chrome,6,1713715928,1713715934,1713715934.2632608,-18000,,
com.microsoft.Excel,36,1713715892,1713715928,1713715928.469366,-18000,,
com.google.Chrome,5,1713715887,1713715892,1713715892.991343,-18000,,
com.microsoft.Excel,28,1713715859,1713715887,1713715887.0624142,-18000,,
com.google.Chrome,57,1713715802,1713715859,1713715859.627164,-18000,,
com.apple.finder,26,1713715776,1713715802,1713715803.026645,-18000,,
com.microsoft.Word,6,1713715770,1713715776,1713715776.9023418,-18000,,
com.google.Chrome,1,1713715769,1713715770,1713715770.217201,-18000,,
com.microsoft.Word,7,1713715762,1713715769,1713715769.605959,-18000,,
com.google.Chrome,1,1713715761,1713715762,1713715762.695997,-18000,,
com.microsoft.Word,19,1713715742,1713715761,1713715761.6960058,-18000,,
com.google.Chrome,60,1713715682,1713715742,1713715742.4872708,-18000,,
com.microsoft.Word,32,1713715650,1713715682,1713715682.475995,-18000,,
com.google.Chrome,27,1713715623,1713715650,1713715650.358782,-18000,,
com.microsoft.Word,22,1713715601,1713715623,1713715623.207474,-18000,,
com.google.Chrome,11,1713715590,1713715601,1713715601.814227,-18000,,
com.microsoft.Word,20,1713715570,1713715590,1713715590.41086,-18000,,
com.google.Chrome,13,1713715557,1713715570,1713715570.8325129,-18000,,
com.microsoft.Word,79,1713715478,1713715557,1713715557.437943,-18000,,
com.google.Chrome,155,1713715323,1713715478,1713715478.6938071,-18000,,
com.microsoft.Word,2,1713715321,1713715323,1713715323.4132872,-18000,,
com.google.Chrome,58,1713715263,1713715321,1713715322.0346441,-18000,,
com.microsoft.Word,17,1713715246,1713715263,1713715263.786974,-18000,,
com.google.Chrome,8,1713715238,1713715246,1713715246.4459882,-18000,,
com.microsoft.Word,24,1713715214,1713715238,1713715238.351187,-18000,,
com.google.Chrome,1,1713715213,1713715214,1713715214.3305779,-18000,,
com.microsoft.Word,24,1713715189,1713715213,1713715213.787051,-18000,,
com.google.Chrome,13,1713715176,1713715189,1713715189.513187,-18000,,
com.microsoft.Word,119,1713715057,1713715176,1713715176.207269,-18000,,
com.google.Chrome,2,1713715055,1713715057,1713715057.8150759,-18000,,
com.microsoft.Word,54,1713715001,1713715055,1713715055.505052,-18000,,
com.leomehlig.today,4,1713714992,1713714996,1713714996.834383,-18000,,
com.google.Chrome,1,1713714991,1713714992,1713714992.6311169,-18000,,
com.microsoft.Word,22,1713714969,1713714991,1713714992.067663,-18000,,
com.google.Chrome,37,1713714932,1713714969,1713714969.715413,-18000,,
com.microsoft.Word,25,1713714907,1713714932,1713714932.276679,-18000,,
com.google.Chrome,10,1713714897,1713714907,1713714907.4422789,-18000,,
com.microsoft.Word,67,1713714830,1713714897,1713714897.158412,-18000,,
com.google.Chrome,1,1713714829,1713714830,1713714830.5492868,-18000,,
com.microsoft.Word,5,1713714824,1713714829,1713714829.55966,-18000,,
com.google.Chrome,1,1713714823,1713714824,1713714824.05969,-18000,,
com.microsoft.Word,4,1713714819,1713714823,1713714823.219526,-18000,,
com.google.Chrome,2,1713714817,1713714819,1713714819.887347,-18000,,
com.microsoft.Word,5,1713714812,1713714817,1713714818.016,-18000,,
com.google.Chrome,1,1713714811,1713714812,1713714812.131438,-18000,,
com.microsoft.Word,3,1713714808,1713714811,1713714811.373714,-18000,,
com.google.Chrome,1,1713714807,1713714808,1713714808.47559,-18000,,
com.microsoft.Word,2,1713714805,1713714807,1713714807.572439,-18000,,
com.google.Chrome,1,1713714804,1713714805,1713714805.5264912,-18000,,
com.microsoft.Word,2,1713714802,1713714804,1713714804.627624,-18000,,
com.google.Chrome,1,1713714801,1713714802,1713714802.082547,-18000,,
com.microsoft.Word,6,1713714795,1713714801,1713714801.222728,-18000,,
com.google.Chrome,3,1713714792,1713714795,1713714795.6477308,-18000,,
com.microsoft.Word,20,1713714772,1713714792,1713714792.893425,-18000,,
com.google.Chrome,16,1713714756,1713714772,1713714772.195745,-18000,,
com.microsoft.Word,5,1713714751,1713714756,1713714756.2710772,-18000,,
com.google.Chrome,12,1713714739,1713714751,1713714751.4461598,-18000,,
com.microsoft.Word,23,1713714716,1713714739,1713714739.398511,-18000,,
com.google.Chrome,21,1713714695,1713714716,1713714716.6908832,-18000,,
com.microsoft.Word,27,1713714668,1713714695,1713714695.592507,-18000,,
com.google.Chrome,1,1713714667,1713714668,1713714668.7235122,-18000,,
com.microsoft.Word,11,1713714656,1713714667,1713714668.002115,-18000,,
com.google.Chrome,4,1713714652,1713714656,1713714656.5242581,-18000,,
com.microsoft.Word,12,1713714640,1713714652,1713714652.3088388,-18000,,
com.google.Chrome,11,1713714629,1713714640,1713714640.96959,-18000,,
com.microsoft.Word,18,1713714611,1713714629,1713714629.816437,-18000,,
com.google.Chrome,3,1713714608,1713714611,1713714611.293122,-18000,,
com.microsoft.Word,1,1713714607,1713714608,1713714608.323322,-18000,,
com.google.Chrome,27,1713714580,1713714607,1713714607.659837,-18000,,
com.microsoft.Word,33,1713714547,1713714580,1713714580.729404,-18000,,
com.google.Chrome,84,1713714463,1713714547,1713714547.523032,-18000,,
com.microsoft.Word,28,1713714435,1713714463,1713714464.0395532,-18000,,
com.google.Chrome,21,1713714414,1713714435,1713714435.302095,-18000,,
com.microsoft.Word,18,1713714396,1713714414,1713714414.4435902,-18000,,
com.google.Chrome,136,1713714260,1713714396,1713714396.433686,-18000,,
com.microsoft.Word,8,1713714252,1713714260,1713714260.471875,-18000,,
com.google.Chrome,141,1713714111,1713714252,1713714252.568337,-18000,,
com.microsoft.Word,3,1713714108,1713714111,1713714111.2687922,-18000,,
com.google.Chrome,12,1713714096,1713714108,1713714109.675688,-18000,,
com.microsoft.Word,102,1713713994,1713714096,1713714096.962122,-18000,,
com.google.Chrome,5,1713713989,1713713994,1713713995.044836,-18000,,
com.microsoft.Word,0,1713713989,1713713989,1713713989.992315,-18000,,
com.google.Chrome,20,1713713969,1713713989,1713713989.56127,-18000,,
com.microsoft.Word,96,1713713873,1713713969,1713713969.62799,-18000,,
com.google.Chrome,2,1713713871,1713713873,1713713873.34291,-18000,,
com.microsoft.Word,3,1713713868,1713713871,1713713871.597451,-18000,,
com.google.Chrome,14,1713713854,1713713868,1713713868.434569,-18000,,
com.microsoft.Word,3,1713713851,1713713854,1713713854.9435039,-18000,,
com.google.Chrome,1,1713713850,1713713851,1713713851.780498,-18000,,
com.microsoft.Word,6,1713713844,1713713850,1713713851.0696568,-18000,,
com.google.Chrome,0,1713713844,1713713844,1713713844.596576,-18000,,
com.microsoft.Word,24,1713713820,1713713844,1713713844.125665,-18000,,
com.google.Chrome,8,1713713812,1713713820,1713713820.575232,-18000,,
com.microsoft.Word,7,1713713805,1713713812,1713713812.926436,-18000,,
com.google.Chrome,1,1713713804,1713713805,1713713805.249047,-18000,,
com.microsoft.Word,12,1713713792,1713713804,1713713804.373571,-18000,,
com.google.Chrome,3,1713713789,1713713792,1713713792.399122,-18000,,
com.microsoft.Word,7,1713713782,1713713789,1713713789.808177,-18000,,
com.google.Chrome,1,1713713781,1713713782,1713713782.49986,-18000,,
com.microsoft.Word,6,1713713775,1713713781,1713713781.599135,-18000,,
com.google.Chrome,1,1713713774,1713713775,1713713775.7217898,-18000,,
com.microsoft.Word,3,1713713771,1713713774,1713713774.579504,-18000,,
com.google.Chrome,35,1713713736,1713713771,1713713771.432784,-18000,,
com.microsoft.Word,3,1713713733,1713713736,1713713736.688743,-18000,,
com.google.Chrome,7,1713713726,1713713733,1713713733.213373,-18000,,
com.microsoft.Word,2,1713713724,1713713726,1713713726.353499,-18000,,
com.google.Chrome,0,1713713724,1713713724,1713713724.790561,-18000,,
com.microsoft.Word,6,1713713718,1713713724,1713713724.282361,-18000,,
com.google.Chrome,3,1713713715,1713713718,1713713718.334223,-18000,,
com.microsoft.Word,13,1713713702,1713713715,1713713715.476876,-18000,,
com.google.Chrome,11,1713713691,1713713702,1713713702.976188,-18000,,
com.microsoft.Word,9,1713713682,1713713691,1713713691.2116818,-18000,,
com.google.Chrome,9,1713713673,1713713682,1713713682.154245,-18000,,
com.microsoft.Word,9,1713713664,1713713673,1713713673.984744,-18000,,
com.google.Chrome,1,1713713663,1713713664,1713713664.7926521,-18000,,
com.microsoft.Word,6,1713713657,1713713663,1713713663.8139338,-18000,,
com.google.Chrome,15,1713713642,1713713657,1713713657.089623,-18000,,
com.microsoft.Word,11,1713713631,1713713642,1713713642.9189959,-18000,,
com.google.Chrome,39,1713713592,1713713631,1713713631.7505732,-18000,,
com.microsoft.Word,4,1713713588,1713713592,1713713592.477587,-18000,,
com.google.Chrome,8,1713713580,1713713588,1713713589.098997,-18000,,
com.microsoft.Word,18,1713713562,1713713580,1713713580.167342,-18000,,
com.google.Chrome,9,1713713553,1713713562,1713713562.252979,-18000,,
com.microsoft.Word,5,1713713548,1713713553,1713713553.237551,-18000,,
com.google.Chrome,11,1713713537,1713713548,1713713548.5426989,-18000,,
com.microsoft.Word,2,1713713535,1713713537,1713713537.571437,-18000,,
com.google.Chrome,89,1713713446,1713713535,1713713535.758158,-18000,,
com.microsoft.Word,11,1713713435,1713713446,1713713446.729197,-18000,,
com.google.Chrome,1,1713713434,1713713435,1713713435.565371,-18000,,
com.microsoft.Word,6,1713713428,1713713434,1713713434.501509,-18000,,
com.google.Chrome,3,1713713425,1713713428,1713713428.535469,-18000,,
com.microsoft.Word,7,1713713418,1713713425,1713713425.633774,-18000,,
com.google.Chrome,391,1713713027,1713713418,1713713418.679637,-18000,,
com.microsoft.Word,58,1713712969,1713713027,1713713027.949992,-18000,,
com.google.Chrome,5,1713712964,1713712969,1713712969.957697,-18000,,
com.microsoft.Word,7,1713712957,1713712964,1713712964.643313,-18000,,
com.google.Chrome,87,1713712870,1713712957,1713712957.785492,-18000,,
com.leomehlig.today,4,1713712851,1713712855,1713712856.908133,-18000,,
com.leomehlig.today,316,1713708827,1713709143,1713709143.200629,-18000,,
com.google.Chrome,38,1713708789,1713708827,1713708827.379737,-18000,,
com.leomehlig.today,28,1713708747,1713708775,1713708775.1980171,-18000,,
com.apple.finder,2,1713708745,1713708747,1713708747.414349,-18000,,
com.apple.finder,331,1713708285,1713708616,1713708616.8565722,-18000,,
com.apple.finder,2,1713672056,1713672058,1713672058.969676,-18000,,
com.google.Chrome,30,1713672026,1713672056,1713672056.847773,-18000,,
com.apple.finder,2,1713672008,1713672010,1713672010.897094,-18000,,
com.apple.finder,3,1713671803,1713671806,1713671806.747899,-18000,,
com.apple.finder,3,1713670620,1713670623,1713670623.56394,-18000,,
com.google.Chrome,1523,1713669097,1713670620,1713670620.6341949,-18000,,
com.google.Chrome,3,1713668363,1713668366,1713668366.255372,-18000,,
com.apple.TV,50,1713667956,1713668006,1713668006.704039,-18000,,
com.google.Chrome,205,1713667751,1713667956,1713667956.778267,-18000,,
com.apple.finder,2,1713667736,1713667738,1713667738.56903,-18000,,
com.apple.finder,3,1713667308,1713667311,1713667311.958939,-18000,,
com.microsoft.VSCode,6,1713667302,1713667308,1713667309.143076,-18000,,
com.apple.iCal,1,1713667301,1713667302,1713667302.363229,-18000,,
com.google.Chrome,1747,1713665554,1713667301,1713667301.664741,-18000,,
com.apple.iCal,15,1713665422,1713665437,1713665438.0091019,-18000,,
com.google.Chrome,9,1713665413,1713665422,1713665422.571066,-18000,,
com.apple.iCal,27,1713665386,1713665413,1713665413.278127,-18000,,
com.google.Chrome,850,1713664536,1713665386,1713665386.5285711,-18000,,
com.apple.iCal,60,1713664317,1713664377,1713664377.9089,-18000,,
com.google.Chrome,1439,1713662878,1713664317,1713664317.173839,-18000,,
com.google.Chrome,800,1713661857,1713662657,1713662657.6828,-18000,,
com.google.Chrome,309,1713661475,1713661784,1713661784.6778312,-18000,,
com.google.Chrome,302,1713661169,1713661471,1713661471.500685,-18000,,
com.google.Chrome,303,1713660816,1713661119,1713661119.985221,-18000,,
com.google.Chrome,774,1713659862,1713660636,1713660637.0223799,-18000,,
com.google.Chrome,323,1713652718,1713653041,1713653041.639765,-18000,,
com.microsoft.VSCode,1563,1713651155,1713652718,1713652718.477993,-18000,,
com.apple.finder,16,1713651139,1713651155,1713651155.129949,-18000,,
com.google.chrome.ios,28,1713648223,1713648251,1713648252.0329452,-18000,EB445137-D7F5-57EC-87DA-1DB460D64046,"iPhone13,2"
edu.illinois.rokwire.ios,3,1713648220,1713648223,1713648223.3742142,-18000,EB445137-D7F5-57EC-87DA-1DB460D64046,"iPhone13,2"
edu.illinois.rokwire.ios,32,1713647948,1713647980,1713647980.264503,-18000,EB445137-D7F5-57EC-87DA-1DB460D64046,"iPhone13,2"
com.thestorygraph.thestorygraph,27,1713647905,1713647932,1713647932.7293792,-18000,EB445137-D7F5-57EC-87DA-1DB460D64046,"iPhone13,2"
com.google.chrome.ios,102,1713646358,1713646460,1713646460.797217,-18000,EB445137-D7F5-57EC-87DA-1DB460D64046,"iPhone13,2"
com.apple.journal,2,1713646356,1713646358,1713646358.408134,-18000,EB445137-D7F5-57EC-87DA-1DB460D64046,"iPhone13,2"
com.apple.journal,108,1713645691,1713645799,1713645799.898168,-18000,EB445137-D7F5-57EC-87DA-1DB460D64046,"iPhone13,2"
com.apple.calculator,3,1713645687,1713645690,1713645690.250565,-18000,EB445137-D7F5-57EC-87DA-1DB460D64046,"iPhone13,2"
com.apple.calculator,3,1713645629,1713645632,1713645632.856564,-18000,EB445137-D7F5-57EC-87DA-1DB460D64046,"iPhone13,2"
com.apple.weather,2,1713645627,1713645629,1713645629.679218,-18000,EB445137-D7F5-57EC-87DA-1DB460D64046,"iPhone13,2"
com.apple.weather,13,1713644825,1713644838,1713644838.537691,-18000,EB445137-D7F5-57EC-87DA-1DB460D64046,"iPhone13,2"
com.robinhood.release.Robinhood,26,1713644265,1713644291,1713644291.7491279,-18000,EB445137-D7F5-57EC-87DA-1DB460D64046,"iPhone13,2"
com.apple.Health,6,1713644242,1713644248,1713644248.721581,-18000,EB445137-D7F5-57EC-87DA-1DB460D64046,"iPhone13,2"
com.apple.Health,10,1713643871,1713643881,1713643881.131938,-18000,EB445137-D7F5-57EC-87DA-1DB460D64046,"iPhone13,2"
com.apple.Music,3,1713643868,1713643871,1713643871.384941,-18000,EB445137-D7F5-57EC-87DA-1DB460D64046,"iPhone13,2"
com.apple.Music,4,1713643852,1713643856,1713643856.965066,-18000,EB445137-D7F5-57EC-87DA-1DB460D64046,"iPhone13,2"
com.apple.Music,4,1713643176,1713643180,1713643180.845972,-18000,EB445137-D7F5-57EC-87DA-1DB460D64046,"iPhone13,2"
com.apple.camera,12,1713643162,1713643174,1713643175.50751,-18000,EB445137-D7F5-57EC-87DA-1DB460D64046,"iPhone13,2"
com.apple.Music,14,1713643160,1713643174,1713643175.376539,-18000,EB445137-D7F5-57EC-87DA-1DB460D64046,"iPhone13,2"
com.apple.Music,3,1713641903,1713641906,1713641906.383234,-18000,EB445137-D7F5-57EC-87DA-1DB460D64046,"iPhone13,2"
com.apple.Music,18,1713641885,1713641903,1713641904.0163388,-18000,EB445137-D7F5-57EC-87DA-1DB460D64046,"iPhone13,2"
com.apple.weather,5,1713640411,1713640416,1713640416.870017,-18000,EB445137-D7F5-57EC-87DA-1DB460D64046,"iPhone13,2"
com.apple.Health,13,1713640245,1713640258,1713640258.412189,-18000,EB445137-D7F5-57EC-87DA-1DB460D64046,"iPhone13,2"
com.apple.Health,22,1713640222,1713640244,1713640245.21109,-18000,EB445137-D7F5-57EC-87DA-1DB460D64046,"iPhone13,2"
com.google.chrome.ios,2,1713640220,1713640222,1713640222.802691,-18000,EB445137-D7F5-57EC-87DA-1DB460D64046,"iPhone13,2"
com.google.chrome.ios,5,1713640214,1713640219,1713640219.703193,-18000,EB445137-D7F5-57EC-87DA-1DB460D64046,"iPhone13,2"
com.google.chrome.ios,6,1713640106,1713640112,1713640112.0542269,-18000,EB445137-D7F5-57EC-87DA-1DB460D64046,"iPhone13,2"
com.apple.finder,6,1713638772,1713638778,1713638778.0957851,-18000,,
com.apple.Notes,0,1713638772,1713638772,1713638772.295676,-18000,,
com.apple.Preview,6,1713638766,1713638772,1713638772.170639,-18000,,
com.google.chrome.ios,3,1713638715,1713638718,1713638718.748231,-18000,EB445137-D7F5-57EC-87DA-1DB460D64046,"iPhone13,2"
com.google.Chrome,81,1713638685,1713638766,1713638766.204485,-18000,,
com.apple.Notes,22,1713638663,1713638685,1713638685.7326689,-18000,,
com.apple.calculator,9,1713638654,1713638663,1713638663.2732801,-18000,,
com.apple.Notes,7,1713638647,1713638654,1713638654.40833,-18000,,
com.google.Chrome,8,1713638639,1713638647,1713638647.676015,-18000,,
com.apple.Notes,5,1713638634,1713638639,1713638639.330395,-18000,,
com.google.Chrome,23,1713638611,1713638634,1713638634.113493,-18000,,
com.apple.Notes,3,1713638608,1713638611,1713638611.119622,-18000,,
com.google.Chrome,37,1713638571,1713638608,1713638608.055692,-18000,,
com.apple.Notes,2,1713638569,1713638571,1713638571.988198,-18000,,
com.google.Chrome,15,1713638554,1713638569,1713638569.217272,-18000,,
com.apple.Notes,3,1713638551,1713638554,1713638554.8831592,-18000,,
com.google.Chrome,30,1713638521,1713638551,1713638551.1138968,-18000,,
com.apple.Notes,8,1713638513,1713638521,1713638521.9368072,-18000,,
com.google.Chrome,3,1713638510,1713638513,1713638513.394767,-18000,,
com.apple.Notes,3,1713638507,1713638510,1713638510.546562,-18000,,
com.google.Chrome,26,1713638481,1713638507,1713638507.521529,-18000,,
com.apple.finder,16,1713638465,1713638481,1713638481.981605,-18000,,
com.google.Chrome,3,1713638462,1713638465,1713638465.290853,-18000,,
com.leomehlig.today,19,1713638443,1713638462,1713638462.154207,-18000,,
com.apple.iCal,51,1713638392,1713638443,1713638443.7617722,-18000,,
com.google.Chrome,139,1713638253,1713638392,1713638392.9878721,-18000,,
com.leomehlig.today,73,1713638180,1713638253,1713638253.212126,-18000,,
com.google.Chrome,42,1713638138,1713638180,1713638181.022474,-18000,,
com.leomehlig.today,2,1713638136,1713638138,1713638138.6337361,-18000,,
com.google.Chrome,40,1713638096,1713638136,1713638136.94285,-18000,,
com.leomehlig.today,31,1713638065,1713638096,1713638096.081183,-18000,,
com.apple.Preview,0,1713638065,1713638065,1713638065.835043,-18000,,
com.leomehlig.today,8,1713638055,1713638063,1713638063.355538,-18000,,
com.apple.Preview,2,1713638053,1713638055,1713638055.192185,-18000,,
com.google.Chrome,35,1713638018,1713638053,1713638053.834794,-18000,,
com.apple.Preview,3,1713638015,1713638018,1713638018.49868,-18000,,
com.leomehlig.today,1,1713638014,1713638015,1713638015.927209,-18000,,
com.apple.Preview,13,1713638001,1713638014,1713638014.369079,-18000,,
com.leomehlig.today,28,1713637973,1713638001,1713638001.860074,-18000,,
com.apple.Preview,7,1713637966,1713637973,1713637973.238284,-18000,,
com.leomehlig.today,1,1713637965,1713637966,1713637966.435021,-18000,,
com.google.Chrome,173,1713637792,1713637965,1713637965.899753,-18000,,
com.leomehlig.today,1,1713637791,1713637792,1713637792.563673,-18000,,
com.google.Chrome,510,1713637281,1713637791,1713637791.092361,-18000,,
com.apple.Preview,238,1713637043,1713637281,1713637281.4929318,-18000,,
com.google.Chrome,8,1713637035,1713637043,1713637043.839367,-18000,,
com.apple.Preview,177,1713636858,1713637035,1713637035.227956,-18000,,
com.leomehlig.today,6,1713636852,1713636858,1713636858.085256,-18000,,
com.google.Chrome,6,1713636846,1713636852,1713636852.7202148,-18000,,
com.leomehlig.today,3,1713636843,1713636846,1713636846.224623,-18000,,
com.apple.Preview,22,1713636821,1713636843,1713636843.365921,-18000,,
com.google.Chrome,1422,1713635399,1713636821,1713636821.1813102,-18000,,
com.google.Chrome,300,1713634948,1713635248,1713635248.5033588,-18000,,
com.apple.Preview,46,1713634902,1713634948,1713634948.497004,-18000,,
com.google.Chrome,8,1713634894,1713634902,1713634902.752143,-18000,,
com.apple.Preview,97,1713634797,1713634894,1713634894.783622,-18000,,
com.google.Chrome,18,1713634779,1713634797,1713634797.199908,-18000,,
com.leomehlig.today,3,1713634776,1713634779,1713634779.48835,-18000,,
com.google.Chrome,5,1713634771,1713634776,1713634776.848331,-18000,,
com.leomehlig.today,2,1713634769,1713634771,1713634771.1825562,-18000,,
com.google.Chrome,9,1713634760,1713634769,1713634769.890349,-18000,,
com.hnc.Discord,127,1713634633,1713634760,1713634760.636275,-18000,,
com.google.Chrome,189,1713634444,1713634633,1713634633.3071609,-18000,,
com.apple.Preview,0,1713634444,1713634444,1713634444.682853,-18000,,
com.google.Chrome,2,1713634442,1713634444,1713634444.406394,-18000,,
com.apple.Preview,1,1713634441,1713634442,1713634442.7201328,-18000,,
com.apple.finder,0,1713634441,1713634441,1713634441.65257,-18000,,
com.apple.Preview,2,1713634439,1713634441,1713634441.23768,-18000,,
com.google.Chrome,60,1713634379,1713634439,1713634439.5017319,-18000,,
com.apple.Preview,129,1713634250,1713634379,1713634380.021817,-18000,,
com.google.Chrome,1,1713634249,1713634250,1713634250.2822452,-18000,,
com.apple.Preview,13,1713634236,1713634249,1713634249.689865,-18000,,
com.google.Chrome,86,1713634150,1713634236,1713634236.378355,-18000,,
com.apple.Preview,100,1713634050,1713634150,1713634150.431566,-18000,,
com.google.Chrome,5,1713634045,1713634050,1713634050.645025,-18000,,
com.apple.Preview,93,1713633952,1713634045,1713634045.560571,-18000,,
com.google.Chrome,327,1713633625,1713633952,1713633952.900238,-18000,,
com.apple.Preview,2,1713633623,1713633625,1713633625.542386,-18000,,
com.apple.finder,2,1713633621,1713633623,1713633623.702251,-18000,,
com.apple.Preview,6,1713633615,1713633621,1713633621.343466,-18000,,
com.apple.finder,4,1713633611,1713633615,1713633615.2787209,-18000,,
com.google.Chrome,27,1713633584,1713633611,1713633611.5725322,-18000,,
com.apple.Photos,1,1713633571,1713633572,1713633572.706311,-18000,,
com.apple.MobileSMS,2,1713633569,1713633571,1713633571.958957,-18000,,
com.apple.Photos,1,1713633568,1713633569,1713633569.295855,-18000,,
com.google.Chrome,1,1713633567,1713633568,1713633568.9799728,-18000,,
com.leomehlig.today,4,1713633563,1713633567,1713633568.4499779,-18000,,
com.apple.Photos,2,1713633561,1713633563,1713633563.410396,-18000,,
com.leomehlig.today,13,1713633548,1713633561,1713633561.322706,-18000,,
com.apple.finder,6,1713633542,1713633548,1713633548.528716,-18000,,
com.apple.camera,0,1713633528,1713633528,1713633528.871361,-18000,EB445137-D7F5-57EC-87DA-1DB460D64046,"iPhone13,2"
com.google.chrome.ios,2,1713633526,1713633528,1713633528.9405031,-18000,EB445137-D7F5-57EC-87DA-1DB460D64046,"iPhone13,2"
com.google.chrome.ios,6,1713632521,1713632527,1713632527.146033,-18000,EB445137-D7F5-57EC-87DA-1DB460D64046,"iPhone13,2"
com.google.chrome.ios,59,1713632326,1713632385,1713632386.434609,-18000,EB445137-D7F5-57EC-87DA-1DB460D64046,"iPhone13,2"
com.apple.weather,3,1713632322,1713632325,1713632325.201375,-18000,EB445137-D7F5-57EC-87DA-1DB460D64046,"iPhone13,2"
com.apple.weather,4,1713631569,1713631573,1713631573.061734,-18000,EB445137-D7F5-57EC-87DA-1DB460D64046,"iPhone13,2"
com.apple.finder,22,1713629818,1713629840,1713629840.573941,-18000,,
com.leomehlig.today,41,1713629777,1713629818,1713629818.910948,-18000,,
com.google.Chrome,2536,1713627241,1713629777,1713629777.548281,-18000,,
com.google.Chrome,308,1713626923,1713627231,1713627231.215352,-18000,,
com.leomehlig.today,36,1713626887,1713626923,1713626923.420016,-18000,,
com.google.Chrome,289,1713626598,1713626887,1713626887.7353492,-18000,,
com.google.Chrome,378,1713626148,1713626526,1713626526.5924292,-18000,,
com.google.ios.youtube,428,1713622942,1713623370,1713623370.048994,-18000,EB445137-D7F5-57EC-87DA-1DB460D64046,"iPhone13,2"
com.apple.Health,97,1713622842,1713622939,1713622939.7817512,-18000,EB445137-D7F5-57EC-87DA-1DB460D64046,"iPhone13,2"
com.thestorygraph.thestorygraph,44,1713586563,1713586607,1713586607.093538,-18000,EB445137-D7F5-57EC-87DA-1DB460D64046,"iPhone13,2"
org.name.serializdmobile,236,1713585899,1713586135,1713586135.050586,-18000,EB445137-D7F5-57EC-87DA-1DB460D64046,"iPhone13,2"
com.letterboxd.LetterboxdApp,12,1713585882,1713585894,1713585894.4113731,-18000,EB445137-D7F5-57EC-87DA-1DB460D64046,"iPhone13,2"
com.toyopagroup.picaboo,42,1713585827,1713585869,1713585869.482327,-18000,EB445137-D7F5-57EC-87DA-1DB460D64046,"iPhone13,2"
com.apple.Health,30,1713585792,1713585822,1713585822.9669142,-18000,EB445137-D7F5-57EC-87DA-1DB460D64046,"iPhone13,2"
com.apple.journal,747,1713585042,1713585789,1713585789.282714,-18000,EB445137-D7F5-57EC-87DA-1DB460D64046,"iPhone13,2"
com.apple.Preferences,70,1713579818,1713579888,1713579888.5585651,-18000,EB445137-D7F5-57EC-87DA-1DB460D64046,"iPhone13,2"
com.toyopagroup.picaboo,2,1713579816,1713579818,1713579818.550035,-18000,EB445137-D7F5-57EC-87DA-1DB460D64046,"iPhone13,2"
com.toyopagroup.picaboo,8,1713579804,1713579812,1713579812.177596,-18000,EB445137-D7F5-57EC-87DA-1DB460D64046,"iPhone13,2"
com.toyopagroup.picaboo,7,1713579597,1713579604,1713579604.017767,-18000,EB445137-D7F5-57EC-87DA-1DB460D64046,"iPhone13,2"
com.toyopagroup.picaboo,41,1713579553,1713579594,1713579594.975729,-18000,EB445137-D7F5-57EC-87DA-1DB460D64046,"iPhone13,2"
com.apple.weather,9,1713579544,1713579553,1713579553.418688,-18000,EB445137-D7F5-57EC-87DA-1DB460D64046,"iPhone13,2"
com.apple.weather,3,1713576292,1713576295,1713576295.767929,-18000,EB445137-D7F5-57EC-87DA-1DB460D64046,"iPhone13,2"
com.google.Chrome,3,1713576288,1713576291,1713576291.4857678,-18000,,
com.leomehlig.today,2,1713576286,1713576288,1713576288.113575,-18000,,
com.google.Chrome,4,1713576282,1713576286,1713576286.269137,-18000,,
com.leomehlig.today,143,1713576139,1713576282,1713576282.646208,-18000,,
com.google.Chrome,3,1713576136,1713576139,1713576139.947407,-18000,,
com.leomehlig.today,8,1713576128,1713576136,1713576136.958195,-18000,,
com.google.Chrome,2,1713576126,1713576128,1713576128.3228521,-18000,,
com.leomehlig.today,4,1713576122,1713576126,1713576126.8497372,-18000,,
com.google.Chrome,2,1713576120,1713576122,1713576122.639734,-18000,,
com.leomehlig.today,4,1713576116,1713576120,1713576120.2353659,-18000,,
com.google.Chrome,8,1713576108,1713576116,1713576116.092105,-18000,,
com.leomehlig.today,65,1713576043,1713576108,1713576108.182471,-18000,,
com.apple.iCal,67,1713575976,1713576043,1713576043.0899749,-18000,,
com.google.Chrome,1,1713575975,1713575976,1713575976.966146,-18000,,
com.apple.weather,8,1713575962,1713575970,1713575970.9672709,-18000,EB445137-D7F5-57EC-87DA-1DB460D64046,"iPhone13,2"
com.apple.camera,38,1713575866,1713575904,1713575909.6584492,-18000,EB445137-D7F5-57EC-87DA-1DB460D64046,"iPhone13,2"
com.letterboxd.LetterboxdApp,10,1713575865,1713575875,1713575875.6154861,-18000,EB445137-D7F5-57EC-87DA-1DB460D64046,"iPhone13,2"
com.letterboxd.LetterboxdApp,112,1713575538,1713575650,1713575650.779704,-18000,EB445137-D7F5-57EC-87DA-1DB460D64046,"iPhone13,2"
com.letterboxd.LetterboxdApp,72,1713575435,1713575507,1713575507.6872082,-18000,EB445137-D7F5-57EC-87DA-1DB460D64046,"iPhone13,2"
com.google.Chrome,229,1713575116,1713575345,1713575345.881576,-18000,,
edu.illinois.rokwire.ios,42,1713572966,1713573008,1713573008.173197,-18000,EB445137-D7F5-57EC-87DA-1DB460D64046,"iPhone13,2"
com.apple.Music,33,1713572763,1713572796,1713572796.60869,-18000,EB445137-D7F5-57EC-87DA-1DB460D64046,"iPhone13,2"
com.apple.calculator,3,1713572754,1713572757,1713572757.750578,-18000,EB445137-D7F5-57EC-87DA-1DB460D64046,"iPhone13,2"
com.apple.calculator,7,1713569479,1713569486,1713569486.4892368,-18000,EB445137-D7F5-57EC-87DA-1DB460D64046,"iPhone13,2"
com.apple.calculator,2,1713567926,1713567928,1713567928.9789891,-18000,EB445137-D7F5-57EC-87DA-1DB460D64046,"iPhone13,2"
com.apple.calculator,3,1713567782,1713567785,1713567785.847381,-18000,EB445137-D7F5-57EC-87DA-1DB460D64046,"iPhone13,2"
com.apple.calculator,7,1713567774,1713567781,1713567781.7225928,-18000,EB445137-D7F5-57EC-87DA-1DB460D64046,"iPhone13,2"
com.apple.MobileSMS,3,1713567623,1713567626,1713567626.5405889,-18000,EB445137-D7F5-57EC-87DA-1DB460D64046,"iPhone13,2"
com.microsoft.Office.Outlook,92,1713567530,1713567622,1713567622.183662,-18000,EB445137-D7F5-57EC-87DA-1DB460D64046,"iPhone13,2"
com.google.Chrome,396,1713562472,1713562868,1713562868.4199991,-18000,,
com.apple.finder,8,1713562464,1713562472,1713562472.7815928,-18000,,
com.microsoft.Office.Outlook,18,1713562389,1713562407,1713562407.9866009,-18000,EB445137-D7F5-57EC-87DA-1DB460D64046,"iPhone13,2"
Astrospheric.Astrospheric,23,1713562361,1713562384,1713562385.023978,-18000,EB445137-D7F5-57EC-87DA-1DB460D64046,"iPhone13,2"
com.google.Gmail,41,1713561680,1713561721,1713561721.801985,-18000,EB445137-D7F5-57EC-87DA-1DB460D64046,"iPhone13,2"
com.google.chrome.ios,5,1713561675,1713561680,1713561681.163396,-18000,EB445137-D7F5-57EC-87DA-1DB460D64046,"iPhone13,2"
com.google.chrome.ios,1,1713558341,1713558342,1713558342.461762,-18000,EB445137-D7F5-57EC-87DA-1DB460D64046,"iPhone13,2"
com.google.chrome.ios,10,1713558283,1713558293,1713558293.647017,-18000,EB445137-D7F5-57EC-87DA-1DB460D64046,"iPhone13,2"
com.apple.finder,10,1713558105,1713558115,1713558116.013058,-18000,,
com.apple.finder,6,1713558097,1713558103,1713558103.4477859,-18000,,
com.leomehlig.today,6,1713558091,1713558097,1713558097.632763,-18000,,
com.apple.Preview,0,1713558091,1713558091,1713558092.10812,-18000,,
com.leomehlig.today,1,1713558090,1713558091,1713558092.0634918,-18000,,
com.google.Chrome,2,1713558088,1713558090,1713558091.607923,-18000,,
com.leomehlig.today,40,1713558048,1713558088,1713558088.9572492,-18000,,
com.google.Chrome,47,1713558001,1713558048,1713558048.8116322,-18000,,
com.apple.Preview,7,1713557994,1713558001,1713558001.299197,-18000,,
com.google.Chrome,1,1713557993,1713557994,1713557994.695352,-18000,,
com.apple.Preview,18,1713557975,1713557993,1713557993.046371,-18000,,
com.google.Chrome,1,1713557974,1713557975,1713557975.26636,-18000,,
com.apple.Preview,0,1713557974,1713557974,1713557974.5227652,-18000,,
com.google.Chrome,3,1713557971,1713557974,1713557974.1057491,-18000,,
com.apple.Preview,9,1713557962,1713557971,1713557971.522968,-18000,,
com.google.Chrome,24,1713557938,1713557962,1713557962.651581,-18000,,
com.apple.Preview,12,1713557926,1713557938,1713557938.4754748,-18000,,
com.google.Chrome,32,1713557894,1713557926,1713557926.57602,-18000,,
com.apple.Preview,10,1713557884,1713557894,1713557894.444915,-18000,,
com.google.Chrome,63,1713557821,1713557884,1713557884.797346,-18000,,
com.apple.Preview,3,1713557818,1713557821,1713557821.5486522,-18000,,
com.google.Chrome,1,1713557817,1713557818,1713557818.557904,-18000,,
com.apple.Preview,31,1713557786,1713557817,1713557817.0577378,-18000,,
com.google.Chrome,1,1713557785,1713557786,1713557786.695296,-18000,,
com.apple.Preview,3,1713557782,1713557785,1713557786.027592,-18000,,
com.google.Chrome,1,1713557781,1713557782,1713557782.576253,-18000,,
com.apple.Preview,8,1713557773,1713557781,1713557781.833118,-18000,,
com.google.Chrome,5,1713557768,1713557773,1713557773.2936358,-18000,,
com.apple.Preview,11,1713557757,1713557768,1713557768.7598639,-18000,,
com.google.Chrome,30,1713557727,1713557757,1713557757.5312681,-18000,,
com.apple.Preview,11,1713557716,1713557727,1713557728.03377,-18000,,
com.google.Chrome,162,1713557554,1713557716,1713557716.060062,-18000,,
com.apple.Preview,5,1713557549,1713557554,1713557554.758449,-18000,,
com.google.Chrome,3,1713557546,1713557549,1713557549.859706,-18000,,
com.apple.Preview,16,1713557530,1713557546,1713557546.719497,-18000,,
com.google.Chrome,19,1713557511,1713557530,1713557530.8869371,-18000,,
com.apple.Preview,11,1713557500,1713557511,1713557511.154038,-18000,,
com.google.Chrome,6,1713557494,1713557500,1713557500.984838,-18000,,
com.apple.Preview,10,1713557484,1713557494,1713557494.771025,-18000,,
com.google.Chrome,5,1713557479,1713557484,1713557484.546263,-18000,,
com.apple.Preview,14,1713557465,1713557479,1713557479.490203,-18000,,
com.google.Chrome,34,1713557431,1713557465,1713557465.6135368,-18000,,
com.apple.Preview,14,1713557417,1713557431,1713557431.170821,-18000,,
com.google.Chrome,13,1713557404,1713557417,1713557417.084003,-18000,,
com.apple.Preview,5,1713557399,1713557404,1713557405.009794,-18000,,
com.google.Chrome,3,1713557396,1713557399,1713557399.280623,-18000,,
com.apple.Preview,23,1713557373,1713557396,1713557396.4962459,-18000,,
com.google.Chrome,3,1713557370,1713557373,1713557373.5789819,-18000,,
com.apple.Preview,10,1713557360,1713557370,1713557370.517741,-18000,,
com.google.Chrome,19,1713557341,1713557360,1713557360.74468,-18000,,
com.apple.Preview,3,1713557338,1713557341,1713557341.983778,-18000,,
com.google.Chrome,3,1713557335,1713557338,1713557339.006897,-18000,,
com.apple.Preview,7,1713557328,1713557335,1713557335.8937101,-18000,,
com.google.Chrome,12,1713557316,1713557328,1713557328.808955,-18000,,
com.apple.Preview,10,1713557306,1713557316,1713557316.266448,-18000,,
com.google.Chrome,2,1713557304,1713557306,1713557306.4922462,-18000,,
com.apple.Preview,13,1713557291,1713557304,1713557304.4363961,-18000,,
com.google.Chrome,30,1713557261,1713557291,1713557291.7646399,-18000,,
com.apple.Preview,15,1713557246,1713557261,1713557261.216459,-18000,,
com.google.Chrome,2,1713557244,1713557246,1713557246.032837,-18000,,
com.apple.Preview,16,1713557228,1713557244,1713557244.789304,-18000,,
com.google.Chrome,3,1713557225,1713557228,1713557228.557921,-18000,,
com.apple.Preview,19,1713557206,1713557225,1713557225.4667869,-18000,,
com.google.Chrome,2,1713557204,1713557206,1713557206.5661569,-18000,,
com.apple.Preview,4,1713557200,1713557204,1713557204.870564,-18000,,
com.google.Chrome,2,1713557198,1713557200,1713557200.23857,-18000,,
com.apple.Preview,9,1713557189,1713557198,1713557198.239828,-18000,,
com.google.Chrome,88,1713557101,1713557189,1713557189.309814,-18000,,
com.apple.Preview,0,1713557101,1713557101,1713557101.753624,-18000,,
com.google.Chrome,2,1713557099,1713557101,1713557101.369285,-18000,,
com.apple.Preview,2,1713557097,1713557099,1713557099.251213,-18000,,
com.google.Chrome,3,1713557094,1713557097,1713557097.678041,-18000,,
com.apple.Preview,20,1713557074,1713557094,1713557094.1025891,-18000,,
com.google.Chrome,278,1713556796,1713557074,1713557074.0623941,-18000,,
com.leomehlig.today,2,1713556794,1713556796,1713556796.3454971,-18000,,
com.google.Chrome,18,1713556776,1713556794,1713556794.7463531,-18000,,
com.apple.Preview,21,1713556755,1713556776,1713556776.7833161,-18000,,
com.google.Chrome,30,1713556725,1713556755,1713556755.233698,-18000,,
com.apple.Preview,5,1713556720,1713556725,1713556725.105184,-18000,,
com.google.Chrome,1,1713556719,1713556720,1713556720.617773,-18000,,
com.apple.Preview,7,1713556712,1713556719,1713556719.7064838,-18000,,
com.google.Chrome,1,1713556711,1713556712,1713556712.453191,-18000,,
com.leomehlig.today,1,1713556710,1713556711,1713556711.567797,-18000,,
com.google.Chrome,1,1713556709,1713556710,1713556710.6772208,-18000,,
com.leomehlig.today,1,1713556708,1713556709,1713556709.230854,-18000,,
com.apple.Preview,8,1713556700,1713556708,1713556708.1316361,-18000,,
com.leomehlig.today,2,1713556698,1713556700,1713556700.377262,-18000,,
com.google.Chrome,88,1713556610,1713556698,1713556698.9063668,-18000,,
com.leomehlig.today,1,1713556609,1713556610,1713556610.946652,-18000,,
com.google.Chrome,3,1713556606,1713556609,1713556609.906901,-18000,,
com.apple.Preview,1,1713556605,1713556606,1713556606.871211,-18000,,
com.google.Chrome,12,1713556593,1713556605,1713556605.582612,-18000,,
com.apple.Preview,11,1713556582,1713556593,1713556593.651479,-18000,,
com.google.Chrome,4,1713556578,1713556582,1713556582.98453,-18000,,
com.apple.Preview,1,1713556577,1713556578,1713556578.9168038,-18000,,
com.google.Chrome,0,1713556577,1713556577,1713556577.560204,-18000,,
com.apple.Preview,6,1713556571,1713556577,1713556577.2448049,-18000,,
com.google.Chrome,1,1713556570,1713556571,1713556572.0035381,-18000,,
com.apple.Preview,17,1713556553,1713556570,1713556570.44031,-18000,,
com.google.Chrome,1,1713556552,1713556553,1713556553.448186,-18000,,
com.apple.Preview,2,1713556550,1713556552,1713556552.461236,-18000,,
com.google.Chrome,2,1713556548,1713556550,1713556550.6251988,-18000,,
com.apple.Preview,34,1713556514,1713556548,1713556548.4091768,-18000,,
com.google.Chrome,7,1713556507,1713556514,1713556514.431957,-18000,,
com.apple.Preview,11,1713556496,1713556507,1713556507.641461,-18000,,
com.google.Chrome,27,1713556469,1713556496,1713556496.691632,-18000,,
com.apple.Preview,7,1713556462,1713556469,1713556469.249728,-18000,,
com.google.Chrome,1,1713556461,1713556462,1713556462.570638,-18000,,
com.apple.Preview,8,1713556453,1713556461,1713556461.4221501,-18000,,
com.google.Chrome,0,1713556453,1713556453,1713556453.83741,-18000,,
com.apple.Preview,4,1713556449,1713556453,1713556453.274006,-18000,,
com.google.Chrome,3,1713556446,1713556449,1713556449.713671,-18000,,
com.apple.Preview,8,1713556438,1713556446,1713556446.514077,-18000,,
com.google.Chrome,1,1713556437,1713556438,1713556438.9434571,-18000,,
com.apple.Preview,4,1713556433,1713556437,1713556437.4996638,-18000,,
com.google.Chrome,57,1713556376,1713556433,1713556433.63076,-18000,,
com.apple.Preview,24,1713556352,1713556376,1713556376.734659,-18000,,
com.google.Chrome,14,1713556338,1713556352,1713556352.337994,-18000,,
com.apple.Preview,11,1713556327,1713556338,1713556338.650856,-18000,,
com.google.Chrome,10,1713556317,1713556327,1713556327.8908,-18000,,
com.apple.Preview,1,1713556316,1713556317,1713556317.236875,-18000,,
com.google.Chrome,2,1713556314,1713556316,1713556316.273713,-18000,,
com.apple.Preview,4,1713556310,1713556314,1713556314.519378,-18000,,
com.google.Chrome,1,1713556309,1713556310,1713556310.932181,-18000,,
com.apple.Preview,5,1713556304,1713556309,1713556310.008655,-18000,,
com.google.Chrome,1,1713556303,1713556304,1713556305.013466,-18000,,
com.apple.Preview,2,1713556301,1713556303,1713556303.380017,-18000,,
com.google.Chrome,6,1713556295,1713556301,1713556301.292233,-18000,,
com.apple.Preview,2,1713556293,1713556295,1713556295.48393,-18000,,
com.google.Chrome,3,1713556290,1713556293,1713556293.501799,-18000,,
com.apple.Preview,70,1713556220,1713556290,1713556290.19962,-18000,,
com.google.Chrome,14,1713556206,1713556220,1713556220.373626,-18000,,
com.apple.Preview,3,1713556203,1713556206,1713556206.116386,-18000,,
com.google.Chrome,4,1713556199,1713556203,1713556203.440186,-18000,,
com.apple.Preview,4,1713556195,1713556199,1713556199.066715,-18000,,
com.google.Chrome,18,1713556177,1713556195,1713556195.584217,-18000,,
com.apple.Preview,9,1713556168,1713556177,1713556177.144071,-18000,,
com.google.Chrome,82,1713556086,1713556168,1713556168.573441,-18000,,
com.apple.Preview,6,1713556080,1713556086,1713556086.362411,-18000,,
com.google.Chrome,1,1713556079,1713556080,1713556080.6094851,-18000,,
com.apple.Preview,2,1713556077,1713556079,1713556079.722316,-18000,,
com.google.Chrome,9,1713556068,1713556077,1713556077.541084,-18000,,
com.apple.Preview,28,1713556040,1713556068,1713556068.823989,-18000,,
com.google.Chrome,15,1713556025,1713556040,1713556040.778228,-18000,,
com.apple.Preview,34,1713555991,1713556025,1713556025.5928001,-18000,,
com.google.Chrome,6,1713555985,1713555991,1713555991.634441,-18000,,
com.apple.Preview,22,1713555963,1713555985,1713555985.676237,-18000,,
com.google.Chrome,62,1713555901,1713555963,1713555963.6282392,-18000,,
com.apple.Preview,10,1713555891,1713555901,1713555901.729033,-18000,,
com.google.Chrome,1,1713555890,1713555891,1713555891.886345,-18000,,
com.apple.Preview,10,1713555880,1713555890,1713555890.4900432,-18000,,
com.google.Chrome,8,1713555872,1713555880,1713555880.9366832,-18000,,
com.apple.Preview,17,1713555855,1713555872,1713555872.070435,-18000,,
com.google.Chrome,21,1713555834,1713555855,1713555855.792426,-18000,,
com.apple.Preview,5,1713555829,1713555834,1713555834.342634,-18000,,
com.google.Chrome,6,1713555823,1713555829,1713555829.019983,-18000,,
com.apple.Preview,2,1713555821,1713555823,1713555823.6263828,-18000,,
com.google.Chrome,2,1713555819,1713555821,1713555821.1727262,-18000,,
com.apple.Preview,2,1713555817,1713555819,1713555819.501508,-18000,,
com.google.Chrome,5,1713555812,1713555817,1713555817.805457,-18000,,
com.apple.Preview,3,1713555809,1713555812,1713555812.995014,-18000,,
com.google.Chrome,13,1713555796,1713555809,1713555809.2253718,-18000,,
com.apple.Preview,5,1713555791,1713555796,1713555796.158681,-18000,,
com.google.Chrome,3,1713555788,1713555791,1713555791.7214022,-18000,,
com.apple.Preview,9,1713555779,1713555788,1713555788.328494,-18000,,
com.google.Chrome,6,1713555773,1713555779,1713555779.803261,-18000,,
com.apple.Preview,5,1713555768,1713555773,1713555773.40374,-18000,,
com.google.Chrome,13,1713555755,1713555768,1713555768.4535599,-18000,,
com.apple.Preview,27,1713555728,1713555755,1713555755.482858,-18000,,
com.google.Chrome,34,1713555694,1713555728,1713555728.0960078,-18000,,
com.apple.Preview,5,1713555689,1713555694,1713555694.8718681,-18000,,
com.google.Chrome,2,1713555687,1713555689,1713555689.7270122,-18000,,
com.apple.Preview,23,1713555664,1713555687,1713555687.555615,-18000,,
com.google.Chrome,47,1713555617,1713555664,1713555664.160857,-18000,,
com.apple.Preview,3,1713555614,1713555617,1713555617.995929,-18000,,
com.google.Chrome,5,1713555609,1713555614,1713555614.7889729,-18000,,
com.apple.Preview,6,1713555603,1713555609,1713555609.139653,-18000,,
com.google.Chrome,5,1713555598,1713555603,1713555603.072219,-18000,,
com.apple.Preview,10,1713555588,1713555598,1713555598.7673202,-18000,,
com.google.Chrome,28,1713555560,1713555588,1713555588.4707708,-18000,,
com.apple.Preview,2,1713555558,1713555560,1713555560.3780022,-18000,,
com.google.Chrome,4,1713555554,1713555558,1713555558.425726,-18000,,
com.apple.Preview,12,1713555542,1713555554,1713555554.3708138,-18000,,
com.google.Chrome,44,1713555498,1713555542,1713555542.377792,-18000,,
com.apple.Preview,10,1713555488,1713555498,1713555498.192014,-18000,,
com.google.Chrome,7,1713555481,1713555488,1713555488.437237,-18000,,
com.apple.Preview,7,1713555474,1713555481,1713555481.063705,-18000,,
com.google.Chrome,21,1713555453,1713555474,1713555474.4143271,-18000,,
com.apple.Preview,3,1713555450,1713555453,1713555453.115391,-18000,,
com.google.Chrome,8,1713555442,1713555450,1713555450.986006,-18000,,
com.apple.Preview,13,1713555429,1713555442,1713555442.243407,-18000,,
com.google.Chrome,9,1713555420,1713555429,1713555429.1757941,-18000,,
com.apple.Preview,25,1713555395,1713555420,1713555420.117072,-18000,,
com.google.Chrome,81,1713555314,1713555395,1713555395.5808492,-18000,,
com.apple.Preview,43,1713555271,1713555314,1713555314.082587,-18000,,
com.google.Chrome,21,1713555250,1713555271,1713555271.854022,-18000,,
com.apple.Preview,13,1713555237,1713555250,1713555250.376017,-18000,,
com.google.Chrome,1,1713555236,1713555237,1713555237.339981,-18000,,
com.apple.Preview,16,1713555220,1713555236,1713555236.186171,-18000,,
com.google.Chrome,35,1713555185,1713555220,1713555220.740658,-18000,,
com.apple.Preview,16,1713555169,1713555185,1713555185.3275762,-18000,,
com.google.Chrome,3,1713555166,1713555169,1713555169.198997,-18000,,
com.apple.Preview,8,1713555158,1713555166,1713555166.668655,-18000,,
com.google.Chrome,12,1713555146,1713555158,1713555158.268528,-18000,,
com.apple.Preview,5,1713555141,1713555146,1713555146.186356,-18000,,
com.google.Chrome,4,1713555137,1713555141,1713555141.7235332,-18000,,
com.apple.Preview,3,1713555134,1713555137,1713555137.864349,-18000,,
com.google.Chrome,1,1713555133,1713555134,1713555134.8001518,-18000,,
com.apple.Preview,1,1713555132,1713555133,1713555133.7585669,-18000,,
com.google.Chrome,2,1713555130,1713555132,1713555132.7721372,-18000,,
com.apple.Preview,50,1713555080,1713555130,1713555130.601562,-18000,,
com.google.Chrome,62,1713555018,1713555080,1713555080.22781,-18000,,
com.apple.Preview,2,1713555016,1713555018,1713555018.5917149,-18000,,
com.google.Chrome,1,1713555015,1713555016,1713555016.9050899,-18000,,
com.apple.Preview,46,1713554969,1713555015,1713555015.324741,-18000,,
com.google.Chrome,53,1713554916,1713554969,1713554969.4109612,-18000,,
com.apple.Preview,2,1713554890,1713554892,1713554892.37869,-18000,,
com.apple.finder,2,1713554888,1713554890,1713554890.398179,-18000,,
com.leomehlig.today,3,1713554885,1713554888,1713554888.455317,-18000,,
com.apple.MobileSMS,2,1713554883,1713554885,1713554885.9969249,-18000,,
com.leomehlig.today,15,1713554868,1713554883,1713554883.3047528,-18000,,
com.apple.Music,2,1713554866,1713554868,1713554869.023213,-18000,,
com.google.Chrome,2,1713554864,1713554866,1713554866.6839309,-18000,,
com.google.chrome.ios,34,1713554506,1713554540,1713554540.157381,-18000,EB445137-D7F5-57EC-87DA-1DB460D64046,"iPhone13,2"
com.apple.Music,2,1713554504,1713554506,1713554506.71718,-18000,EB445137-D7F5-57EC-87DA-1DB460D64046,"iPhone13,2"
com.apple.Music,2,1713553078,1713553080,1713553080.9615521,-18000,EB445137-D7F5-57EC-87DA-1DB460D64046,"iPhone13,2"
com.apple.Music,12,1713552616,1713552628,1713552628.557396,-18000,EB445137-D7F5-57EC-87DA-1DB460D64046,"iPhone13,2"
com.toyopagroup.picaboo,4,1713552513,1713552517,1713552517.660949,-18000,EB445137-D7F5-57EC-87DA-1DB460D64046,"iPhone13,2"
com.toyopagroup.picaboo,15,1713549512,1713549527,1713549527.1903682,-18000,EB445137-D7F5-57EC-87DA-1DB460D64046,"iPhone13,2"
com.google.Chrome,84,1713549199,1713549283,1713549283.1486912,-18000,,
com.google.Chrome,300,1713548809,1713549109,1713549109.39516,-18000,,
com.google.Chrome,315,1713548318,1713548633,1713548633.4095402,-18000,,
com.apple.Preview,2,1713548316,1713548318,1713548318.7984262,-18000,,
com.leomehlig.today,26,1713548290,1713548316,1713548316.6054358,-18000,,
com.apple.Preview,1,1713548289,1713548290,1713548290.706943,-18000,,
com.leomehlig.today,7,1713548282,1713548289,1713548289.975933,-18000,,
com.apple.Preview,1152,1713547130,1713548282,1713548282.648442,-18000,,
com.apple.finder,6,1713547124,1713547130,1713547130.9760299,-18000,,
com.google.Chrome,42,1713547082,1713547124,1713547124.782408,-18000,,
edu.illinois.rokwire.ios,4,1713547072,1713547076,1713547076.309073,-18000,EB445137-D7F5-57EC-87DA-1DB460D64046,"iPhone13,2"
edu.illinois.rokwire.ios,1,1713547071,1713547072,1713547072.0907521,-18000,EB445137-D7F5-57EC-87DA-1DB460D64046,"iPhone13,2"
com.truebill.truebillnative,109,1713546962,1713547071,1713547071.0820708,-18000,EB445137-D7F5-57EC-87DA-1DB460D64046,"iPhone13,2"
com.apple.systempreferences,3,1713546947,1713546950,1713546950.614387,-18000,,
com.apple.findmy,23,1713546911,1713546934,1713546934.6950588,-18000,EB445137-D7F5-57EC-87DA-1DB460D64046,"iPhone13,2"
com.instructure.icanvas,6,1713546901,1713546907,1713546907.351124,-18000,EB445137-D7F5-57EC-87DA-1DB460D64046,"iPhone13,2"
com.google.chrome.ios,8,1713546893,1713546901,1713546901.5107021,-18000,EB445137-D7F5-57EC-87DA-1DB460D64046,"iPhone13,2"
com.google.Chrome,143,1713546804,1713546947,1713546947.6795058,-18000,,
com.apple.keychainaccess,1,1713546803,1713546804,1713546804.45965,-18000,,
com.google.Chrome,5,1713546798,1713546803,1713546803.244378,-18000,,
com.apple.keychainaccess,1,1713546797,1713546798,1713546798.464633,-18000,,
com.google.Chrome,1,1713546796,1713546797,1713546797.951818,-18000,,
com.apple.keychainaccess,3,1713546793,1713546796,1713546796.119159,-18000,,
com.google.Chrome,4,1713546782,1713546786,1713546786.246914,-18000,,
com.apple.systempreferences,3,1713546771,1713546774,1713546774.2421498,-18000,,
com.google.Chrome,2,1713546769,1713546771,1713546771.705927,-18000,,
com.apple.systempreferences,2,1713546767,1713546769,1713546769.569535,-18000,,
com.google.Chrome,5,1713546756,1713546761,1713546761.572297,-18000,,
com.apple.finder,37,1713546384,1713546421,1713546421.780126,-18000,,
com.apple.Preview,41,1713546343,1713546384,1713546384.800126,-18000,,
com.apple.finder,87,1713546256,1713546343,1713546343.917017,-18000,,
com.google.Chrome,44,1713546212,1713546256,1713546256.7460198,-18000,,
com.apple.MobileSMS,4,1713546208,1713546212,1713546212.141923,-18000,,
com.google.Chrome,35,1713546173,1713546208,1713546208.3989182,-18000,,
com.leomehlig.today,31,1713546142,1713546173,1713546175.0050468,-18000,,
com.google.Chrome,3,1713546139,1713546142,1713546142.402801,-18000,,
com.google.Chrome,267,1713545364,1713545631,1713545631.472453,-18000,,
com.google.chrome.ios,15,1713545342,1713545357,1713545357.436969,-18000,EB445137-D7F5-57EC-87DA-1DB460D64046,"iPhone13,2"
com.google.Chrome,23,1713542595,1713542618,1713542618.720315,-18000,,
com.apple.finder,30,1713542565,1713542595,1713542595.957633,-18000,,
com.apple.archiveutility,1,1713542564,1713542565,1713542565.45913,-18000,,
com.apple.finder,20,1713542544,1713542564,1713542564.724278,-18000,,
com.google.Chrome,119,1713542425,1713542544,1713542545.006898,-18000,,
com.apple.calculator,16,1713542108,1713542124,1713542124.491551,-18000,,
com.google.Chrome,4,1713542104,1713542108,1713542108.838062,-18000,,
com.apple.calculator,9,1713542095,1713542104,1713542104.716347,-18000,,
com.google.Chrome,41,1713542054,1713542095,1713542095.688229,-18000,,
com.apple.systempreferences,4,1713542050,1713542054,1713542054.6504722,-18000,,
com.google.Chrome,3,1713542045,1713542048,1713542048.421782,-18000,,
com.google.chrome.ios,2,1713541846,1713541848,1713541848.5453,-18000,EB445137-D7F5-57EC-87DA-1DB460D64046,"iPhone13,2"
com.google.chrome.ios,65,1713540101,1713540166,1713540166.287839,-18000,EB445137-D7F5-57EC-87DA-1DB460D64046,"iPhone13,2"
com.apple.Health,8,1713540093,1713540101,1713540101.094842,-18000,EB445137-D7F5-57EC-87DA-1DB460D64046,"iPhone13,2"
com.apple.Health,10,1713539405,1713539415,1713539415.952211,-18000,EB445137-D7F5-57EC-87DA-1DB460D64046,"iPhone13,2"
com.apple.Health,6,1713538202,1713538208,1713538208.226616,-18000,EB445137-D7F5-57EC-87DA-1DB460D64046,"iPhone13,2"
com.apple.calculator,2,1713538200,1713538202,1713538202.896944,-18000,EB445137-D7F5-57EC-87DA-1DB460D64046,"iPhone13,2"
com.apple.Health,21,1713538179,1713538200,1713538200.331382,-18000,EB445137-D7F5-57EC-87DA-1DB460D64046,"iPhone13,2"
com.apple.calculator,100,1713538076,1713538176,1713538176.9912639,-18000,EB445137-D7F5-57EC-87DA-1DB460D64046,"iPhone13,2"
com.google.chrome.ios,5,1713538071,1713538076,1713538076.067264,-18000,EB445137-D7F5-57EC-87DA-1DB460D64046,"iPhone13,2"
com.apple.calculator,14,1713538057,1713538071,1713538071.964634,-18000,EB445137-D7F5-57EC-87DA-1DB460D64046,"iPhone13,2"
com.google.chrome.ios,30,1713538027,1713538057,1713538057.30821,-18000,EB445137-D7F5-57EC-87DA-1DB460D64046,"iPhone13,2"
com.apple.calculator,6,1713538021,1713538027,1713538027.770006,-18000,EB445137-D7F5-57EC-87DA-1DB460D64046,"iPhone13,2"
edu.illinois.rokwire.ios,41,1713537699,1713537740,1713537740.821717,-18000,EB445137-D7F5-57EC-87DA-1DB460D64046,"iPhone13,2"
com.apple.weather,5,1713537694,1713537699,1713537699.189728,-18000,EB445137-D7F5-57EC-87DA-1DB460D64046,"iPhone13,2"
com.apple.weather,7,1713537560,1713537567,1713537567.0270739,-18000,EB445137-D7F5-57EC-87DA-1DB460D64046,"iPhone13,2"
com.microsoft.Office.Outlook,21,1713537529,1713537550,1713537550.9657989,-18000,EB445137-D7F5-57EC-87DA-1DB460D64046,"iPhone13,2"
com.google.Chrome,27,1713537363,1713537390,1713537390.356427,-18000,,
com.leomehlig.today,1,1713537362,1713537363,1713537363.4130359,-18000,,
com.google.Chrome,0,1713537362,1713537362,1713537362.852936,-18000,,
us.zoom.xos,5,1713537357,1713537362,1713537362.6171598,-18000,,
com.google.Chrome,1991,1713535366,1713537357,1713537357.920965,-18000,,
us.zoom.xos,9,1713535357,1713535366,1713535366.6959429,-18000,,
com.google.Chrome,11,1713535346,1713535357,1713535357.6344628,-18000,,
com.leomehlig.today,1,1713535345,1713535346,1713535346.063064,-18000,,
us.zoom.xos,0,1713535345,1713535345,1713535345.6939979,-18000,,
com.leomehlig.today,2,1713535343,1713535345,1713535345.266151,-18000,,
com.google.Chrome,1,1713535342,1713535343,1713535343.6199288,-18000,,
us.zoom.xos,0,1713535342,1713535342,1713535342.78071,-18000,,
com.google.Chrome,3,1713535339,1713535342,1713535342.2855082,-18000,,
us.zoom.xos,6,1713535333,1713535339,1713535339.925428,-18000,,
com.google.Chrome,6,1713535327,1713535333,1713535333.755125,-18000,,
us.zoom.xos,6,1713535321,1713535327,1713535327.921277,-18000,,
com.google.Chrome,1,1713535320,1713535321,1713535321.3795118,-18000,,
us.zoom.xos,10,1713535310,1713535320,1713535320.092253,-18000,,
com.google.Chrome,8,1713535302,1713535310,1713535311.0029058,-18000,,
us.zoom.xos,61,1713535241,1713535302,1713535302.4978871,-18000,,
com.google.Chrome,1,1713535240,1713535241,1713535241.313648,-18000,,
us.zoom.xos,1,1713535239,1713535240,1713535240.2275748,-18000,,
com.google.Chrome,17,1713535222,1713535239,1713535239.0455132,-18000,,
us.zoom.xos,1,1713535221,1713535222,1713535222.188764,-18000,,
com.google.Chrome,3,1713535218,1713535221,1713535221.3067322,-18000,,
us.zoom.xos,1,1713535217,1713535218,1713535218.922766,-18000,,
com.google.Chrome,12,1713535205,1713535217,1713535218.029155,-18000,,
us.zoom.xos,18,1713535187,1713535205,1713535205.05545,-18000,,
com.google.Chrome,14,1713535173,1713535187,1713535187.050895,-18000,,
com.google.Chrome,11,1713535058,1713535069,1713535069.305152,-18000,,
com.leomehlig.today,2,1713535026,1713535028,1713535030.638379,-18000,,
com.apple.mobiletimer,3,1713533609,1713533612,1713533612.98543,-18000,EB445137-D7F5-57EC-87DA-1DB460D64046,"iPhone13,2"
com.thestorygraph.thestorygraph,7,1713500900,1713500907,1713500907.744026,-18000,EB445137-D7F5-57EC-87DA-1DB460D64046,"iPhone13,2"
com.thestorygraph.thestorygraph,18,1713500837,1713500855,1713500855.036509,-18000,EB445137-D7F5-57EC-87DA-1DB460D64046,"iPhone13,2"
com.instructure.icanvas,6,1713500505,1713500511,1713500511.79199,-18000,EB445137-D7F5-57EC-87DA-1DB460D64046,"iPhone13,2"
com.apple.journal,1385,1713499116,1713500501,1713500501.820679,-18000,EB445137-D7F5-57EC-87DA-1DB460D64046,"iPhone13,2"
com.apple.Health,33,1713497807,1713497840,1713497840.709279,-18000,EB445137-D7F5-57EC-87DA-1DB460D64046,"iPhone13,2"
com.toyopagroup.picaboo,17,1713497778,1713497795,1713497795.661878,-18000,EB445137-D7F5-57EC-87DA-1DB460D64046,"iPhone13,2"
com.leomehlig.today,19,1713497712,1713497731,1713497731.905133,-18000,,
com.google.Chrome,1018,1713496694,1713497712,1713497712.198042,-18000,,
com.google.Chrome,527,1713496146,1713496673,1713496673.9729152,-18000,,
com.google.Chrome,300,1713495569,1713495869,1713495869.3358011,-18000,,
com.instructure.icanvas,40,1713494940,1713494980,1713494980.958817,-18000,EB445137-D7F5-57EC-87DA-1DB460D64046,"iPhone13,2"
com.google.Chrome,572,1713494882,1713495454,1713495454.108315,-18000,,
com.leomehlig.today,35,1713494847,1713494882,1713494882.0899792,-18000,,
com.google.Chrome,5,1713494842,1713494847,1713494848.004833,-18000,,
com.leomehlig.today,27,1713494815,1713494842,1713494842.2851071,-18000,,
com.google.Chrome,1,1713494814,1713494815,1713494815.995759,-18000,,
com.leomehlig.today,37,1713494777,1713494814,1713494814.695329,-18000,,
com.google.Chrome,1527,1713493250,1713494777,1713494777.3615189,-18000,,
com.google.Chrome,593,1713492406,1713492999,1713492999.269701,-18000,,
com.google.Chrome,1186,1713491031,1713492217,1713492217.588407,-18000,,
com.leomehlig.today,1,1713491030,1713491031,1713491031.862164,-18000,,
com.google.Chrome,808,1713490222,1713491030,1713491031.022036,-18000,,
com.leomehlig.today,11,1713490211,1713490222,1713490222.10266,-18000,,
com.google.Chrome,15,1713490196,1713490211,1713490211.691694,-18000,,
com.apple.Preferences,21,1713490151,1713490172,1713490172.379678,-18000,EB445137-D7F5-57EC-87DA-1DB460D64046,"iPhone13,2"
com.apple.MobileSMS,42,1713490100,1713490142,1713490142.699009,-18000,EB445137-D7F5-57EC-87DA-1DB460D64046,"iPhone13,2"
com.instructure.icanvas,9,1713490082,1713490091,1713490091.659422,-18000,EB445137-D7F5-57EC-87DA-1DB460D64046,"iPhone13,2"
com.hammerandchisel.discord,65,1713490011,1713490076,1713490076.788478,-18000,EB445137-D7F5-57EC-87DA-1DB460D64046,"iPhone13,2"
com.apple.weather,4,1713490007,1713490011,1713490011.313723,-18000,EB445137-D7F5-57EC-87DA-1DB460D64046,"iPhone13,2"
com.apple.weather,5,1713489952,1713489957,1713489957.351413,-18000,EB445137-D7F5-57EC-87DA-1DB460D64046,"iPhone13,2"
com.tinyspeck.chatlyio,3,1713489949,1713489952,1713489952.489958,-18000,EB445137-D7F5-57EC-87DA-1DB460D64046,"iPhone13,2"
com.tinyspeck.chatlyio,8,1713489480,1713489488,1713489488.666342,-18000,EB445137-D7F5-57EC-87DA-1DB460D64046,"iPhone13,2"
com.tinyspeck.chatlyio,8,1713488046,1713488054,1713488054.800764,-18000,EB445137-D7F5-57EC-87DA-1DB460D64046,"iPhone13,2"
com.google.Chrome,1153,1713486844,1713487997,1713487997.975951,-18000,,
com.microsoft.VSCode,67,1713486749,1713486816,1713486816.417455,-18000,,
com.google.Chrome,2,1713486747,1713486749,1713486760.190767,-18000,,
com.apple.Photos,5,1713486742,1713486747,1713486755.4814029,-18000,,
com.google.Chrome,20,1713486722,1713486742,1713486755.386308,-18000,,
com.apple.Photos,0,1713486722,1713486722,1713486755.3364592,-18000,,
com.microsoft.VSCode,78,1713486644,1713486722,1713486724.7847872,-18000,,
com.google.Chrome,535,1713486109,1713486644,1713486644.531643,-18000,,
com.microsoft.VSCode,59,1713486050,1713486109,1713486109.8275352,-18000,,
com.google.Chrome,455,1713485595,1713486050,1713486050.116619,-18000,,
com.microsoft.VSCode,0,1713485595,1713485595,1713485595.975658,-18000,,
com.google.Chrome,1,1713485594,1713485595,1713485595.3824,-18000,,
com.microsoft.VSCode,5,1713485589,1713485594,1713485594.318396,-18000,,
com.google.Chrome,0,1713485589,1713485589,1713485589.8105469,-18000,,
com.microsoft.VSCode,21,1713485568,1713485589,1713485589.086463,-18000,,
com.google.Chrome,3,1713485565,1713485568,1713485568.786429,-18000,,
com.microsoft.VSCode,5,1713485560,1713485565,1713485565.3828769,-18000,,
com.google.Chrome,1,1713485559,1713485560,1713485560.077847,-18000,,
com.microsoft.VSCode,2,1713485557,1713485559,1713485559.406287,-18000,,
com.google.Chrome,327,1713485230,1713485557,1713485557.072485,-18000,,
com.microsoft.VSCode,203,1713485027,1713485230,1713485231.014772,-18000,,
com.google.Chrome,171,1713484856,1713485027,1713485027.0801039,-18000,,
com.apple.MobileSMS,2,1713484854,1713484856,1713484856.763308,-18000,,
com.google.Chrome,0,1713484854,1713484854,1713484854.92212,-18000,,
com.apple.MobileSMS,4,1713484850,1713484854,1713484854.126334,-18000,,
com.google.Chrome,0,1713484850,1713484850,1713484850.927309,-18000,,
com.microsoft.VSCode,18,1713484832,1713484850,1713484850.066051,-18000,,
com.google.Chrome,11,1713484821,1713484832,1713484832.632309,-18000,,
com.apple.MobileSMS,6,1713484815,1713484821,1713484821.870276,-18000,,
com.google.Chrome,87,1713484728,1713484815,1713484815.522258,-18000,,
com.microsoft.VSCode,47,1713484681,1713484728,1713484729.046321,-18000,,
com.google.Chrome,33,1713484648,1713484681,1713484681.845056,-18000,,
com.microsoft.VSCode,126,1713484522,1713484648,1713484649.02043,-18000,,
com.google.Chrome,44,1713484478,1713484522,1713484523.047443,-18000,,
com.microsoft.VSCode,22,1713484456,1713484478,1713484478.363862,-18000,,
com.google.Chrome,314,1713484142,1713484456,1713484456.893515,-18000,,
com.microsoft.VSCode,12,1713484130,1713484142,1713484142.130646,-18000,,
com.google.Chrome,4,1713484126,1713484130,1713484130.726331,-18000,,
com.microsoft.VSCode,4,1713484122,1713484126,1713484126.64065,-18000,,
com.google.Chrome,17,1713484105,1713484122,1713484122.788562,-18000,,
com.microsoft.VSCode,114,1713483991,1713484105,1713484105.093399,-18000,,
com.google.Chrome,23,1713483968,1713483991,1713483991.41802,-18000,,
com.microsoft.VSCode,23,1713483945,1713483968,1713483968.144652,-18000,,
com.google.Chrome,2,1713483943,1713483945,1713483945.492207,-18000,,
com.microsoft.VSCode,2,1713483941,1713483943,1713483943.679933,-18000,,
com.google.Chrome,5,1713483936,1713483941,1713483942.01435,-18000,,
com.microsoft.VSCode,27,1713483909,1713483936,1713483936.886117,-18000,,
com.google.Chrome,112,1713483797,1713483909,1713483909.327725,-18000,,
com.microsoft.VSCode,74,1713483723,1713483797,1713483797.633367,-18000,,
com.google.Chrome,3,1713483720,1713483723,1713483723.323196,-18000,,
com.microsoft.VSCode,193,1713483527,1713483720,1713483720.3378658,-18000,,
com.google.Chrome,318,1713483209,1713483527,1713483527.7652059,-18000,,
com.google.Chrome,161,1713482930,1713483091,1713483091.948833,-18000,,
com.tinyspeck.chatlyio,24,1713481300,1713481324,1713481324.187348,-18000,EB445137-D7F5-57EC-87DA-1DB460D64046,"iPhone13,2"
com.tinyspeck.chatlyio,8,1713481248,1713481256,1713481256.061277,-18000,EB445137-D7F5-57EC-87DA-1DB460D64046,"iPhone13,2"
com.tinyspeck.chatlyio,188,1713480856,1713481044,1713481044.96213,-18000,EB445137-D7F5-57EC-87DA-1DB460D64046,"iPhone13,2"
com.tinyspeck.chatlyio,6,1713479292,1713479298,1713479298.8522081,-18000,EB445137-D7F5-57EC-87DA-1DB460D64046,"iPhone13,2"
com.tinyspeck.chatlyio,17,1713479273,1713479290,1713479290.748848,-18000,EB445137-D7F5-57EC-87DA-1DB460D64046,"iPhone13,2"
com.tinyspeck.chatlyio,6,1713479246,1713479252,1713479252.886369,-18000,EB445137-D7F5-57EC-87DA-1DB460D64046,"iPhone13,2"
com.tinyspeck.chatlyio,14,1713479232,1713479246,1713479246.082388,-18000,EB445137-D7F5-57EC-87DA-1DB460D64046,"iPhone13,2"
com.google.Maps,3,1713479228,1713479231,1713479231.7422252,-18000,EB445137-D7F5-57EC-87DA-1DB460D64046,"iPhone13,2"
com.google.Maps,9,1713479164,1713479173,1713479173.531808,-18000,EB445137-D7F5-57EC-87DA-1DB460D64046,"iPhone13,2"
com.apple.camera,6,1713479100,1713479106,1713479106.4155521,-18000,EB445137-D7F5-57EC-87DA-1DB460D64046,"iPhone13,2"
com.google.Maps,60,1713478244,1713478304,1713478304.494592,-18000,EB445137-D7F5-57EC-87DA-1DB460D64046,"iPhone13,2"
edu.illinois.rokwire.ios,54,1713478174,1713478228,1713478228.0811381,-18000,EB445137-D7F5-57EC-87DA-1DB460D64046,"iPhone13,2"
edu.illinois.rokwire.ios,6,1713478152,1713478158,1713478158.931943,-18000,EB445137-D7F5-57EC-87DA-1DB460D64046,"iPhone13,2"
com.google.Chrome,345,1713478144,1713478489,1713478489.3794842,-18000,,
com.apple.finder,1,1713478143,1713478144,1713478144.337179,-18000,,
com.leomehlig.today,0,1713478143,1713478143,1713478143.6624851,-18000,,
com.apple.finder,1,1713478142,1713478143,1713478143.107068,-18000,,
com.google.Chrome,36,1713478106,1713478142,1713478142.054966,-18000,,
com.apple.finder,3,1713478103,1713478106,1713478107.172441,-18000,,
com.google.Chrome,7,1713478096,1713478103,1713478103.42766,-18000,,
edu.illinois.rokwire.ios,68,1713478083,1713478151,1713478151.711874,-18000,EB445137-D7F5-57EC-87DA-1DB460D64046,"iPhone13,2"
com.tinyspeck.chatlyio,12,1713478071,1713478083,1713478083.6462631,-18000,EB445137-D7F5-57EC-87DA-1DB460D64046,"iPhone13,2"
com.tinyspeck.chatlyio,11,1713477878,1713477889,1713477889.257186,-18000,EB445137-D7F5-57EC-87DA-1DB460D64046,"iPhone13,2"
edu.illinois.rokwire.ios,8,1713477859,1713477867,1713477867.9032412,-18000,EB445137-D7F5-57EC-87DA-1DB460D64046,"iPhone13,2"
com.apple.Maps,15,1713477471,1713477486,1713477486.9732208,-18000,EB445137-D7F5-57EC-87DA-1DB460D64046,"iPhone13,2"
com.apple.Health,26,1713475892,1713475918,1713475918.46298,-18000,EB445137-D7F5-57EC-87DA-1DB460D64046,"iPhone13,2"
com.truebill.truebillnative,3,1713475888,1713475891,1713475891.455956,-18000,EB445137-D7F5-57EC-87DA-1DB460D64046,"iPhone13,2"
com.truebill.truebillnative,37,1713475698,1713475735,1713475735.7529988,-18000,EB445137-D7F5-57EC-87DA-1DB460D64046,"iPhone13,2"
com.google.Chrome,296,1713475328,1713475624,1713475624.416528,-18000,,
com.leomehlig.today,218,1713475110,1713475328,1713475328.5977411,-18000,,
com.apple.finder,94,1713475016,1713475110,1713475110.270276,-18000,,
com.leomehlig.today,2,1713475014,1713475016,1713475016.572329,-18000,,
com.apple.QuickTimePlayerX,1,1713475013,1713475014,1713475015.013262,-18000,,
com.leomehlig.today,12,1713475001,1713475013,1713475013.656105,-18000,,
com.google.Chrome,126,1713474875,1713475001,1713475001.8995519,-18000,,
com.apple.finder,13,1713474862,1713474875,1713474875.496838,-18000,,
com.google.Chrome,13,1713474849,1713474862,1713474862.657384,-18000,,
com.apple.finder,1,1713474848,1713474849,1713474849.73662,-18000,,
com.apple.Photos,0,1713474848,1713474848,1713474849.0268931,-18000,,
com.apple.finder,2,1713474846,1713474848,1713474848.2588959,-18000,,
com.apple.QuickTimePlayerX,7,1713474839,1713474846,1713474846.0566468,-18000,,
com.apple.finder,3,1713474836,1713474839,1713474839.157178,-18000,,
com.apple.QuickTimePlayerX,11,1713474822,1713474833,1713474833.9287739,-18000,,
com.apple.finder,4,1713474818,1713474822,1713474822.209669,-18000,,
com.apple.QuickTimePlayerX,5,1713474808,1713474813,1713474813.691551,-18000,,
com.apple.finder,3,1713474805,1713474808,1713474808.7022939,-18000,,
com.apple.QuickTimePlayerX,1,1713474804,1713474805,1713474805.403338,-18000,,
com.apple.Photos,0,1713474804,1713474804,1713474804.315061,-18000,,
com.apple.QuickTimePlayerX,34,1713474766,1713474800,1713474800.777686,-18000,,
com.apple.Photos,9,1713474757,1713474766,1713474766.952073,-18000,,
com.apple.QuickTimePlayerX,6,1713474751,1713474757,1713474757.044636,-18000,,
com.apple.Photos,5,1713474746,1713474751,1713474751.606762,-18000,,
com.apple.QuickTimePlayerX,20,1713474726,1713474746,1713474746.1388102,-18000,,
com.apple.finder,14,1713474712,1713474726,1713474726.67868,-18000,,
com.apple.QuickTimePlayerX,71,1713474641,1713474712,1713474712.978301,-18000,,
com.apple.Preview,0,1713474641,1713474641,1713474641.847321,-18000,,
com.apple.QuickTimePlayerX,1,1713474636,1713474637,1713474637.663805,-18000,,
com.apple.Preview,132,1713474504,1713474636,1713474636.031141,-18000,,
com.google.Chrome,1,1713474503,1713474504,1713474504.654412,-18000,,
com.apple.Preview,1,1713474502,1713474503,1713474503.462904,-18000,,
com.apple.QuickTimePlayerX,2,1713474500,1713474502,1713474502.3099751,-18000,,
com.google.Chrome,8,1713474492,1713474500,1713474500.117486,-18000,,
com.apple.QuickTimePlayerX,7,1713474485,1713474492,1713474492.6384969,-18000,,
com.apple.Preview,2,1713474483,1713474485,1713474485.696007,-18000,,
com.apple.QuickTimePlayerX,2,1713474481,1713474483,1713474483.732527,-18000,,
com.apple.Preview,1,1713474480,1713474481,1713474481.9155731,-18000,,
com.apple.finder,2,1713474478,1713474480,1713474480.137022,-18000,,
com.leomehlig.today,2,1713474476,1713474478,1713474478.662766,-18000,,
com.apple.finder,4,1713474472,1713474476,1713474476.922255,-18000,,
com.apple.FinalCut,114,1713474358,1713474472,1713474472.716697,-18000,,
com.apple.finder,7,1713474351,1713474358,1713474358.098218,-18000,,
com.apple.FinalCut,9,1713474342,1713474351,1713474351.082642,-18000,,
com.google.Chrome,18,1713474324,1713474342,1713474342.7614741,-18000,,
com.apple.finder,4,1713474243,1713474247,1713474247.395365,-18000,,
com.google.Chrome,20,1713474223,1713474243,1713474243.594513,-18000,,
com.apple.QuickTimePlayerX,1,1713474222,1713474223,1713474223.3427072,-18000,,
com.apple.finder,9,1713474213,1713474222,1713474222.8145409,-18000,,
com.apple.QuickTimePlayerX,24,1713474189,1713474213,1713474213.860805,-18000,,
com.apple.Preview,1,1713474188,1713474189,1713474189.739272,-18000,,
com.apple.QuickTimePlayerX,3,1713474185,1713474188,1713474188.486084,-18000,,
com.apple.Preview,44,1713474141,1713474185,1713474185.514492,-18000,,
com.apple.QuickTimePlayerX,26,1713474115,1713474141,1713474141.714857,-18000,,
com.apple.Preview,142,1713473973,1713474115,1713474115.330492,-18000,,
com.google.Chrome,13,1713473960,1713473973,1713473973.548812,-18000,,
com.apple.Preview,115,1713473845,1713473960,1713473960.69891,-18000,,
com.google.Chrome,14,1713473831,1713473845,1713473845.228493,-18000,,
com.apple.QuickTimePlayerX,14,1713473817,1713473831,1713473831.5764961,-18000,,
com.google.Chrome,50,1713473767,1713473817,1713473817.343662,-18000,,
com.apple.Preview,1,1713473766,1713473767,1713473767.948303,-18000,,
com.apple.QuickTimePlayerX,1,1713473765,1713473766,1713473766.364509,-18000,,
com.apple.Preview,5,1713473760,1713473765,1713473765.190309,-18000,,
com.apple.finder,11,1713473749,1713473760,1713473760.253304,-18000,,
com.apple.QuickTimePlayerX,9,1713473740,1713473749,1713473749.397403,-18000,,
com.google.Chrome,5,1713473735,1713473740,1713473740.170504,-18000,,
com.leomehlig.today,125,1713473610,1713473735,1713473735.127881,-18000,,
com.google.Chrome,7,1713473603,1713473610,1713473610.238021,-18000,,
com.instructure.icanvas,16,1713473577,1713473593,1713473593.8043308,-18000,EB445137-D7F5-57EC-87DA-1DB460D64046,"iPhone13,2"
com.apple.reminders,14,1713473547,1713473561,1713473562.0036411,-18000,EB445137-D7F5-57EC-87DA-1DB460D64046,"iPhone13,2"
com.apple.reminders,1,1713473542,1713473543,1713473543.95324,-18000,EB445137-D7F5-57EC-87DA-1DB460D64046,"iPhone13,2"
com.apple.InCallService,78,1713473464,1713473542,1713473542.698313,-18000,EB445137-D7F5-57EC-87DA-1DB460D64046,"iPhone13,2"
com.apple.iCal,167,1713473436,1713473603,1713473603.793662,-18000,,
com.google.Chrome,1,1713473435,1713473436,1713473436.624882,-18000,,
com.apple.reminders,34,1713473430,1713473464,1713473464.15045,-18000,EB445137-D7F5-57EC-87DA-1DB460D64046,"iPhone13,2"
com.google.Chrome,30,1713471926,1713471956,1713471956.8596911,-18000,,
us.zoom.xos,15,1713471911,1713471926,1713471926.725223,-18000,,
com.apple.Music,95,1713471816,1713471911,1713471911.920662,-18000,,
edu.illinois.rokwire.ios,18,1713471654,1713471672,1713471672.867336,-18000,EB445137-D7F5-57EC-87DA-1DB460D64046,"iPhone13,2"
us.zoom.xos,655,1713471161,1713471816,1713471816.146082,-18000,,
us.zoom.xos,308,1713470779,1713471087,1713471087.1808228,-18000,,
us.zoom.xos,301,1713470313,1713470614,1713470614.563864,-18000,,
com.google.Chrome,1,1713470312,1713470313,1713470313.4158978,-18000,,
us.zoom.xos,1,1713470311,1713470312,1713470312.231529,-18000,,
com.apple.AppStore,60,1713470251,1713470311,1713470311.187582,-18000,,
us.zoom.xos,208,1713470043,1713470251,1713470251.29054,-18000,,
us.zoom.xos,303,1713469210,1713469513,1713469513.877167,-18000,,
us.zoom.xos,302,1713468898,1713469200,1713469200.40139,-18000,,
com.google.Chrome,99,1713468799,1713468898,1713468898.784383,-18000,,
us.zoom.xos,0,1713468799,1713468799,1713468799.252481,-18000,,
us.zoom.xos,301,1713468419,1713468720,1713468720.879493,-18000,,
com.google.Chrome,110,1713468309,1713468419,1713468419.396055,-18000,,
com.apple.iCal,6,1713468303,1713468309,1713468309.497267,-18000,,
com.google.Chrome,88,1713468215,1713468303,1713468303.884698,-18000,,
us.zoom.xos,0,1713468215,1713468215,1713468215.877146,-18000,,
us.zoom.xos,455,1713467734,1713468189,1713468189.546516,-18000,,
com.google.Chrome,79,1713467655,1713467734,1713467734.864582,-18000,,
us.zoom.xos,203,1713467452,1713467655,1713467655.8761,-18000,,
com.google.Chrome,138,1713467314,1713467452,1713467452.922648,-18000,,
us.zoom.xos,53,1713467261,1713467314,1713467315.015706,-18000,,
com.google.Chrome,2,1713467259,1713467261,1713467261.141039,-18000,,
com.leomehlig.today,45,1713467214,1713467259,1713467259.954145,-18000,,
com.apple.finder,0,1713467214,1713467214,1713467214.256047,-18000,,
us.zoom.xos,1,1713467208,1713467209,1713467209.720413,-18000,,
com.leomehlig.today,35,1713467173,1713467208,1713467208.611834,-18000,,
us.zoom.xos,2,1713467171,1713467173,1713467173.609394,-18000,,
com.apple.Preview,3,1713467168,1713467171,1713467171.6627789,-18000,,
us.zoom.xos,7,1713467161,1713467168,1713467168.963198,-18000,,
com.google.Chrome,106,1713467055,1713467161,1713467161.193118,-18000,,
com.microsoft.VSCode,24,1713467031,1713467055,1713467055.647491,-18000,,
us.zoom.xos,288,1713466743,1713467031,1713467031.380896,-18000,,
com.google.Chrome,123,1713466620,1713466743,1713466743.077311,-18000,,
com.apple.finder,200,1713466420,1713466620,1713466620.183162,-18000,,
com.google.Chrome,2,1713466418,1713466420,1713466420.52244,-18000,,
com.leomehlig.today,20,1713466398,1713466418,1713466418.747865,-18000,,
com.intsig.CamScannerLite,163,1713466273,1713466436,1713466436.2669759,-18000,EB445137-D7F5-57EC-87DA-1DB460D64046,"iPhone13,2"
edu.illinois.rokwire.ios,11,1713466260,1713466271,1713466271.2005482,-18000,EB445137-D7F5-57EC-87DA-1DB460D64046,"iPhone13,2"
com.google.Chrome,435,1713465963,1713466398,1713466398.7530699,-18000,,
com.google.Chrome,461,1713465356,1713465817,1713465817.25406,-18000,,
com.apple.systempreferences,9,1713465347,1713465356,1713465356.871912,-18000,,
com.google.Chrome,1,1713465346,1713465347,1713465347.99256,-18000,,
com.apple.systempreferences,7,1713465339,1713465346,1713465346.868878,-18000,,
com.google.Chrome,15,1713465324,1713465339,1713465339.2956061,-18000,,
com.apple.systempreferences,4,1713465320,1713465324,1713465324.787195,-18000,,
com.google.Chrome,635,1713464679,1713465314,1713465314.393023,-18000,,
com.leomehlig.today,9,1713464670,1713464679,1713464679.255416,-18000,,
com.google.Chrome,19,1713464651,1713464670,1713464670.368312,-18000,,
com.leomehlig.today,2,1713464649,1713464651,1713464651.6701012,-18000,,
com.google.Chrome,85,1713464564,1713464649,1713464649.3717,-18000,,
com.leomehlig.today,6,1713464558,1713464564,1713464564.942595,-18000,,
com.google.Chrome,21,1713464537,1713464558,1713464558.460913,-18000,,
com.apple.Preview,1,1713464536,1713464537,1713464538.025494,-18000,,
com.google.Chrome,2,1713464534,1713464536,1713464536.270475,-18000,,
com.apple.Preview,35,1713464499,1713464534,1713464535.012665,-18000,,
com.google.Chrome,34,1713464465,1713464499,1713464499.09852,-18000,,
com.apple.Preview,8,1713464457,1713464465,1713464465.512965,-18000,,
com.google.Chrome,121,1713464336,1713464457,1713464457.742145,-18000,,
com.apple.Preview,3,1713464333,1713464336,1713464336.423887,-18000,,
com.google.Chrome,3,1713464330,1713464333,1713464333.045892,-18000,,
com.apple.Preview,4,1713464326,1713464330,1713464330.329397,-18000,,
com.google.Chrome,1,1713464325,1713464326,1713464327.027703,-18000,,
com.apple.Preview,7,1713464318,1713464325,1713464325.121519,-18000,,
com.google.Chrome,13,1713464305,1713464318,1713464318.553956,-18000,,
com.apple.Preview,10,1713464295,1713464305,1713464305.334204,-18000,,
com.google.Chrome,53,1713464242,1713464295,1713464295.399647,-18000,,
com.apple.Preview,7,1713464235,1713464242,1713464242.360214,-18000,,
com.google.Chrome,7,1713464228,1713464235,1713464235.632482,-18000,,
com.apple.Preview,4,1713464224,1713464228,1713464228.929924,-18000,,
com.google.Chrome,53,1713464171,1713464224,1713464224.195641,-18000,,
com.apple.Preview,7,1713464164,1713464171,1713464171.118321,-18000,,
com.google.Chrome,90,1713464074,1713464164,1713464164.9513621,-18000,,
com.apple.Preview,12,1713464062,1713464074,1713464074.9365149,-18000,,
com.google.Chrome,71,1713463991,1713464062,1713464062.542517,-18000,,
com.apple.Preview,2,1713463989,1713463991,1713463991.6301498,-18000,,
com.google.Chrome,14,1713463975,1713463989,1713463989.611248,-18000,,
com.apple.Preview,11,1713463964,1713463975,1713463975.853012,-18000,,
com.google.Chrome,8,1713463956,1713463964,1713463965.015269,-18000,,
com.apple.Preview,36,1713463920,1713463956,1713463956.744149,-18000,,
com.google.Chrome,3,1713463917,1713463920,1713463920.166788,-18000,,
com.apple.Preview,10,1713463907,1713463917,1713463918.028588,-18000,,
com.google.Chrome,67,1713463840,1713463907,1713463907.590701,-18000,,
com.apple.Preview,18,1713463822,1713463840,1713463840.160064,-18000,,
com.google.Chrome,19,1713463803,1713463822,1713463822.564612,-18000,,
com.apple.Preview,1,1713463802,1713463803,1713463803.5854511,-18000,,
com.apple.finder,1,1713463801,1713463802,1713463802.71194,-18000,,
com.apple.Preview,13,1713463788,1713463801,1713463802.04643,-18000,,
com.apple.finder,1,1713463787,1713463788,1713463788.587871,-18000,,
com.google.Chrome,12,1713463775,1713463787,1713463787.3170109,-18000,,
com.apple.finder,3,1713463772,1713463775,1713463775.4935632,-18000,,
com.apple.Preview,2,1713463770,1713463772,1713463772.5901508,-18000,,
com.apple.finder,5,1713463765,1713463770,1713463770.49651,-18000,,
com.apple.Preview,2,1713463763,1713463765,1713463765.835791,-18000,,
com.google.Chrome,7,1713463756,1713463763,1713463763.1347861,-18000,,
com.leomehlig.today,9,1713463747,1713463756,1713463756.69621,-18000,,
com.leomehlig.today,3,1713463437,1713463440,1713463440.709496,-18000,,
com.google.Chrome,11,1713463426,1713463437,1713463437.544177,-18000,,
com.microsoft.VSCode,278,1713463148,1713463426,1713463427.153619,-18000,,
com.google.Chrome,8,1713463140,1713463148,1713463148.814516,-18000,,
com.microsoft.VSCode,26,1713463114,1713463140,1713463140.5468102,-18000,,
com.google.Chrome,67,1713463047,1713463114,1713463114.3806028,-18000,,
com.microsoft.VSCode,2,1713463045,1713463047,1713463047.434884,-18000,,
com.google.Chrome,3,1713463042,1713463045,1713463046.008785,-18000,,
com.microsoft.VSCode,47,1713462995,1713463042,1713463042.120926,-18000,,
com.apple.finder,4,1713462991,1713462995,1713462995.4544601,-18000,,
com.microsoft.Outlook,40,1713462951,1713462991,1713462991.854776,-18000,,
com.google.Chrome,2,1713462949,1713462951,1713462951.449839,-18000,,
com.apple.MobileSMS,3,1713462946,1713462949,1713462949.07739,-18000,,
com.google.Chrome,11,1713462935,1713462946,1713462946.1826181,-18000,,
com.leomehlig.today,40,1713462895,1713462935,1713462935.718338,-18000,,
com.apple.Preview,995,1713461900,1713462895,1713462895.535645,-18000,,
com.leomehlig.today,8,1713461892,1713461900,1713461900.95444,-18000,,
com.apple.Preview,2,1713461890,1713461892,1713461892.499867,-18000,,
com.apple.Preview,1452,1713460096,1713461548,1713461548.9698582,-18000,,
com.google.Chrome,13,1713460083,1713460096,1713460096.299587,-18000,,
com.apple.Preview,74,1713460009,1713460083,1713460083.5692759,-18000,,
com.apple.Preview,367,1713459306,1713459673,1713459673.804621,-18000,,
com.google.Chrome,12,1713459294,1713459306,1713459306.716789,-18000,,
com.apple.Preview,168,1713459126,1713459294,1713459294.8198872,-18000,,
com.google.Chrome,2,1713459124,1713459126,1713459126.433807,-18000,,
com.apple.Preview,29,1713459095,1713459124,1713459124.695166,-18000,,
com.google.Chrome,5,1713459090,1713459095,1713459095.665761,-18000,,
com.apple.Preview,4,1713459086,1713459090,1713459090.9118872,-18000,,
com.google.Chrome,27,1713459059,1713459086,1713459086.4586039,-18000,,
com.leomehlig.today,2,1713459057,1713459059,1713459059.869761,-18000,,
com.apple.finder,1,1713459056,1713459057,1713459057.3956861,-18000,,
com.apple.Preview,8,1713459048,1713459056,1713459056.5387611,-18000,,
com.apple.finder,4,1713459044,1713459048,1713459048.928154,-18000,,
com.apple.Preview,2,1713459042,1713459044,1713459044.399722,-18000,,
com.leomehlig.today,26,1713459016,1713459042,1713459042.657514,-18000,,
com.google.Chrome,5,1713459011,1713459016,1713459017.0140839,-18000,,
edu.illinois.rokwire.ios,5,1713458540,1713458545,1713458545.026453,-18000,EB445137-D7F5-57EC-87DA-1DB460D64046,"iPhone13,2"
edu.illinois.rokwire.ios,7,1713457743,1713457750,1713457750.066143,-18000,EB445137-D7F5-57EC-87DA-1DB460D64046,"iPhone13,2"
edu.illinois.rokwire.ios,20,1713457718,1713457738,1713457738.635715,-18000,EB445137-D7F5-57EC-87DA-1DB460D64046,"iPhone13,2"
com.apple.Health,17,1713457035,1713457052,1713457052.373971,-18000,EB445137-D7F5-57EC-87DA-1DB460D64046,"iPhone13,2"
com.apple.MobileSMS,3,1713456597,1713456600,1713456600.222416,-18000,EB445137-D7F5-57EC-87DA-1DB460D64046,"iPhone13,2"
com.google.Chrome,28,1713456480,1713456508,1713456508.639618,-18000,,
com.apple.finder,18,1713456462,1713456480,1713456480.7725291,-18000,,
com.apple.Preview,2,1713456460,1713456462,1713456462.43673,-18000,,
com.google.Chrome,20,1713456440,1713456460,1713456460.9679399,-18000,,
com.apple.Preview,112,1713456328,1713456440,1713456440.837949,-18000,,
com.apple.finder,12,1713456316,1713456328,1713456328.586711,-18000,,
com.apple.Preview,230,1713456086,1713456316,1713456316.869333,-18000,,
com.google.Chrome,33,1713456053,1713456086,1713456086.140188,-18000,,
com.apple.Preview,2,1713456051,1713456053,1713456053.337607,-18000,,
com.google.Chrome,1,1713456050,1713456051,1713456051.276598,-18000,,
com.apple.Preview,0,1713456050,1713456050,1713456050.662877,-18000,,
com.google.Chrome,13,1713456037,1713456050,1713456050.119619,-18000,,
com.apple.Preview,1,1713456036,1713456037,1713456037.975099,-18000,,
com.google.Chrome,2,1713456034,1713456036,1713456036.4572148,-18000,,
com.apple.Preview,2,1713456032,1713456034,1713456034.2082338,-18000,,
com.google.Chrome,4,1713456028,1713456032,1713456032.886066,-18000,,
com.apple.Preview,15,1713456013,1713456028,1713456028.465586,-18000,,
com.google.Chrome,19,1713455994,1713456013,1713456013.194438,-18000,,
com.apple.Preview,2,1713455992,1713455994,1713455994.5813642,-18000,,
com.google.Chrome,4,1713455988,1713455992,1713455992.820416,-18000,,
com.apple.Preview,10,1713455978,1713455988,1713455988.637968,-18000,,
com.google.Chrome,5,1713455973,1713455978,1713455978.9833388,-18000,,
com.apple.Preview,1,1713455972,1713455973,1713455973.449376,-18000,,
com.google.Chrome,2,1713455970,1713455972,1713455972.5908542,-18000,,
com.apple.Preview,9,1713455961,1713455970,1713455970.511302,-18000,,
com.google.Chrome,22,1713455939,1713455961,1713455961.5621781,-18000,,
com.apple.Preview,10,1713455929,1713455939,1713455939.141951,-18000,,
com.google.Chrome,1,1713455928,1713455929,1713455929.950774,-18000,,
com.apple.Preview,124,1713455804,1713455928,1713455928.119847,-18000,,
com.google.Chrome,14,1713455790,1713455804,1713455804.751717,-18000,,
com.apple.Preview,549,1713455241,1713455790,1713455790.372905,-18000,,
com.google.Chrome,22,1713455219,1713455241,1713455241.922405,-18000,,
com.apple.Preview,380,1713454839,1713455219,1713455219.315586,-18000,,
com.google.Chrome,32,1713454807,1713454839,1713454839.7139602,-18000,,
com.apple.Preview,1323,1713453484,1713454807,1713454807.5361052,-18000,,
com.apple.Preview,300,1713453032,1713453332,1713453332.390353,-18000,,
com.google.Chrome,250,1713452782,1713453032,1713453032.396466,-18000,,
com.apple.Preview,13,1713452769,1713452782,1713452783.004513,-18000,,
com.apple.finder,4,1713452765,1713452769,1713452769.22349,-18000,,
com.apple.Preview,2,1713452763,1713452765,1713452765.9208999,-18000,,
com.apple.finder,20,1713452743,1713452763,1713452763.1320271,-18000,,
com.apple.Preview,1,1713452742,1713452743,1713452743.829669,-18000,,
com.apple.finder,6,1713452736,1713452742,1713452742.1111841,-18000,,
com.google.Chrome,366,1713452370,1713452736,1713452736.165228,-18000,,
com.leomehlig.today,15,1713452355,1713452370,1713452370.675113,-18000,,
com.google.Chrome,1,1713452354,1713452355,1713452355.746875,-18000,,
com.leomehlig.today,3,1713452351,1713452354,1713452354.685935,-18000,,
com.google.Chrome,31,1713452320,1713452351,1713452351.4424539,-18000,,
edu.illinois.rokwire.ios,16,1713451303,1713451319,1713451319.46015,-18000,EB445137-D7F5-57EC-87DA-1DB460D64046,"iPhone13,2"
com.toyopagroup.picaboo,11,1713451062,1713451073,1713451073.91819,-18000,EB445137-D7F5-57EC-87DA-1DB460D64046,"iPhone13,2"
com.apple.weather,13,1713451049,1713451062,1713451062.7408571,-18000,EB445137-D7F5-57EC-87DA-1DB460D64046,"iPhone13,2"
com.google.Chrome,191,1713450832,1713451023,1713451024.145689,-18000,,
com.leomehlig.today,61,1713450771,1713450832,1713450832.8995528,-18000,,
com.google.Chrome,28,1713450743,1713450771,1713450771.610571,-18000,,
com.google.Chrome,102,1713450574,1713450676,1713450676.687828,-18000,,
com.google.Chrome,425,1713450074,1713450499,1713450499.4057012,-18000,,
com.leomehlig.today,2,1713449884,1713449886,1713449886.324784,-18000,,
com.google.Chrome,69,1713449815,1713449884,1713449884.1296558,-18000,,
com.microsoft.Outlook,9,1713449806,1713449815,1713449815.989115,-18000,,
com.google.Chrome,57,1713449749,1713449806,1713449806.634355,-18000,,
com.leomehlig.today,33,1713449699,1713449732,1713449732.871083,-18000,,
com.google.Chrome,4,1713449695,1713449699,1713449699.443613,-18000,,
com.apple.weather,9,1713449440,1713449449,1713449449.57647,-18000,EB445137-D7F5-57EC-87DA-1DB460D64046,"iPhone13,2"
com.instructure.icanvas,11,1713449421,1713449432,1713449432.096946,-18000,EB445137-D7F5-57EC-87DA-1DB460D64046,"iPhone13,2"
com.google.Chrome,304,1713411338,1713411642,1713411642.9168282,-18000,,
com.google.Chrome,473,1713410825,1713411298,1713411298.0389361,-18000,,
com.google.Chrome,365,1713410190,1713410555,1713410555.612959,-18000,,
com.apple.MobileSMS,5,1713410185,1713410190,1713410190.460845,-18000,,
com.google.Chrome,556,1713409629,1713410185,1713410185.1715999,-18000,,
com.apple.finder,3,1713409626,1713409629,1713409629.3836188,-18000,,
com.apple.finder,7,1713409276,1713409283,1713409283.434462,-18000,,
com.google.Chrome,5,1713409271,1713409276,1713409276.603987,-18000,,
com.apple.finder,5,1713409266,1713409271,1713409271.6842651,-18000,,
com.apple.MobileSMS,10,1713409256,1713409266,1713409267.03296,-18000,,
com.apple.news,67,1713409189,1713409256,1713409256.743856,-18000,,
com.apple.MobileSMS,6,1713409183,1713409189,1713409189.556973,-18000,,
com.apple.finder,2,1713409181,1713409183,1713409183.744066,-18000,,
com.leomehlig.today,84,1713409097,1713409181,1713409181.584811,-18000,,
com.apple.finder,2,1713409095,1713409097,1713409098.0108008,-18000,,
com.apple.Music,10,1713407807,1713407817,1713407817.9086819,-18000,EB445137-D7F5-57EC-87DA-1DB460D64046,"iPhone13,2"
com.apple.Music,10,1713407687,1713407697,1713407697.8828058,-18000,EB445137-D7F5-57EC-87DA-1DB460D64046,"iPhone13,2"
com.apple.Music,11,1713407566,1713407577,1713407577.490861,-18000,EB445137-D7F5-57EC-87DA-1DB460D64046,"iPhone13,2"
com.apple.Preview,1967,1713407128,1713409095,1713409095.270252,-18000,,
com.google.Chrome,263,1713406865,1713407128,1713407128.76332,-18000,,
com.apple.Preview,578,1713406287,1713406865,1713406866.4826899,-18000,,
com.apple.finder,2,1713406285,1713406287,1713406287.869156,-18000,,
com.leomehlig.today,2,1713406283,1713406285,1713406285.854372,-18000,,
com.apple.finder,5,1713406278,1713406283,1713406283.4940019,-18000,,
com.leomehlig.today,1,1713406277,1713406278,1713406278.955617,-18000,,
com.apple.finder,1,1713406276,1713406277,1713406277.919114,-18000,,
com.leomehlig.today,12,1713406264,1713406276,1713406276.672082,-18000,,
com.apple.Music,1,1713406263,1713406264,1713406264.442459,-18000,,
com.leomehlig.today,33,1713406230,1713406263,1713406263.649725,-18000,,
com.apple.Music,2,1713406202,1713406204,1713406204.820108,-18000,EB445137-D7F5-57EC-87DA-1DB460D64046,"iPhone13,2"
com.apple.Music,9,1713405924,1713405933,1713405933.7983809,-18000,EB445137-D7F5-57EC-87DA-1DB460D64046,"iPhone13,2"
com.apple.Music,3,1713405846,1713405849,1713405849.649549,-18000,EB445137-D7F5-57EC-87DA-1DB460D64046,"iPhone13,2"
com.apple.Music,2,1713405694,1713405696,1713405696.682897,-18000,EB445137-D7F5-57EC-87DA-1DB460D64046,"iPhone13,2"
com.apple.Music,12,1713405129,1713405141,1713405141.403714,-18000,EB445137-D7F5-57EC-87DA-1DB460D64046,"iPhone13,2"
com.leomehlig.today,2,1713405016,1713405018,1713405018.1736522,-18000,,
com.microsoft.Office.Outlook,12,1713404991,1713405003,1713405003.376453,-18000,EB445137-D7F5-57EC-87DA-1DB460D64046,"iPhone13,2"
com.google.Chrome,221,1713404795,1713405016,1713405016.479735,-18000,,
com.leomehlig.today,2,1713404779,1713404781,1713404782.007835,-18000,,
com.microsoft.Office.Outlook,61,1713404776,1713404837,1713404837.507677,-18000,EB445137-D7F5-57EC-87DA-1DB460D64046,"iPhone13,2"
org.name.serializdmobile,2,1713404774,1713404776,1713404777.3418279,-18000,EB445137-D7F5-57EC-87DA-1DB460D64046,"iPhone13,2"
com.leomehlig.today,2,1713404732,1713404734,1713404735.101866,-18000,,
com.apple.finder,1,1713404731,1713404732,1713404732.681454,-18000,,
com.google.Chrome,9,1713404722,1713404731,1713404732.036381,-18000,,
com.leomehlig.today,52,1713404670,1713404722,1713404722.1390638,-18000,,
com.apple.iCal,11,1713404659,1713404670,1713404670.2240682,-18000,,
com.leomehlig.today,83,1713404576,1713404659,1713404659.995753,-18000,,
com.google.Chrome,140,1713404436,1713404576,1713404576.2923388,-18000,,
com.google.Chrome,306,1713404125,1713404431,1713404431.2629418,-18000,,
com.leomehlig.today,1,1713404124,1713404125,1713404125.550664,-18000,,
com.google.Chrome,1153,1713402971,1713404124,1713404124.829525,-18000,,
com.leomehlig.today,4,1713402967,1713402971,1713402971.763925,-18000,,
com.google.Chrome,4,1713402963,1713402967,1713402967.05309,-18000,,
com.leomehlig.today,3,1713402960,1713402963,1713402963.378483,-18000,,
com.google.Chrome,3,1713402957,1713402960,1713402960.1140718,-18000,,
com.google.Chrome,961,1713401993,1713402954,1713402954.026256,-18000,,
com.leomehlig.today,1,1713401992,1713401993,1713401994.0438972,-18000,,
com.google.Chrome,519,1713401473,1713401992,1713401992.936089,-18000,,
com.google.Chrome,349,1713400936,1713401285,1713401285.523045,-18000,,
com.google.Chrome,549,1713399963,1713400512,1713400512.996996,-18000,,
com.google.Chrome,324,1713399390,1713399714,1713399714.8939729,-18000,,
com.leomehlig.today,3,1713399372,1713399375,1713399375.742142,-18000,,
com.apple.Music,1,1713399371,1713399372,1713399373.044272,-18000,,
com.leomehlig.today,8,1713399363,1713399371,1713399371.360764,-18000,,
org.name.serializdmobile,253,1713399103,1713399356,1713399356.217674,-18000,EB445137-D7F5-57EC-87DA-1DB460D64046,"iPhone13,2"
com.apple.Music,3,1713398969,1713398972,1713398972.29675,-18000,EB445137-D7F5-57EC-87DA-1DB460D64046,"iPhone13,2"
com.apple.Music,2,1713398954,1713398956,1713398956.2891269,-18000,EB445137-D7F5-57EC-87DA-1DB460D64046,"iPhone13,2"
com.apple.Music,7,1713398945,1713398952,1713398952.833529,-18000,EB445137-D7F5-57EC-87DA-1DB460D64046,"iPhone13,2"
com.apple.Music,2,1713398377,1713398379,1713398379.987474,-18000,EB445137-D7F5-57EC-87DA-1DB460D64046,"iPhone13,2"
com.apple.Music,17,1713398353,1713398370,1713398370.1926951,-18000,EB445137-D7F5-57EC-87DA-1DB460D64046,"iPhone13,2"
com.apple.Music,4,1713398342,1713398346,1713398346.959712,-18000,EB445137-D7F5-57EC-87DA-1DB460D64046,"iPhone13,2"
com.apple.Music,9,1713398332,1713398341,1713398341.946869,-18000,EB445137-D7F5-57EC-87DA-1DB460D64046,"iPhone13,2"
com.apple.weather,3,1713398323,1713398326,1713398326.7278981,-18000,EB445137-D7F5-57EC-87DA-1DB460D64046,"iPhone13,2"
com.apple.weather,10,1713398252,1713398262,1713398262.13981,-18000,EB445137-D7F5-57EC-87DA-1DB460D64046,"iPhone13,2"
com.leomehlig.today,18,1713397580,1713397598,1713397598.537859,-18000,,
com.google.Chrome,293,1713397287,1713397580,1713397580.167264,-18000,,
com.google.Chrome,697,1713395946,1713396643,1713396643.694892,-18000,,
com.google.Chrome,379,1713395201,1713395580,1713395580.666243,-18000,,
com.google.Chrome,607,1713394541,1713395148,1713395148.4281769,-18000,,
com.leomehlig.today,28,1713394513,1713394541,1713394541.6634269,-18000,,
com.apple.MobileSMS,1,1713391984,1713391985,1713391986.586421,-18000,EB445137-D7F5-57EC-87DA-1DB460D64046,"iPhone13,2"
com.apple.InCallService,1,1713391983,1713391984,1713391984.189223,-18000,EB445137-D7F5-57EC-87DA-1DB460D64046,"iPhone13,2"
com.apple.InCallService,1,1713391722,1713391723,1713391723.6791968,-18000,EB445137-D7F5-57EC-87DA-1DB460D64046,"iPhone13,2"
com.apple.InCallService,1,1713391488,1713391489,1713391489.827173,-18000,EB445137-D7F5-57EC-87DA-1DB460D64046,"iPhone13,2"
com.apple.InCallService,11,1713391461,1713391472,1713391472.186852,-18000,EB445137-D7F5-57EC-87DA-1DB460D64046,"iPhone13,2"
com.apple.MobileSMS,4,1713391457,1713391461,1713391463.0372639,-18000,EB445137-D7F5-57EC-87DA-1DB460D64046,"iPhone13,2"
com.apple.findmy,6,1713391450,1713391456,1713391456.999239,-18000,EB445137-D7F5-57EC-87DA-1DB460D64046,"iPhone13,2"
com.apple.camera,0,1713391372,1713391372,1713391372.529138,-18000,EB445137-D7F5-57EC-87DA-1DB460D64046,"iPhone13,2"
com.leomehlig.today,2,1713391314,1713391316,1713391316.8974528,-18000,,
com.google.Chrome,10,1713391304,1713391314,1713391314.0797381,-18000,,
com.microsoft.VSCode,10,1713391294,1713391304,1713391305.013373,-18000,,
us.zoom.xos,160,1713391134,1713391294,1713391294.141042,-18000,,
com.google.Chrome,13,1713391121,1713391134,1713391134.081701,-18000,,
us.zoom.xos,214,1713390907,1713391121,1713391121.487103,-18000,,
com.leomehlig.today,5,1713390902,1713390907,1713390907.9841619,-18000,,
com.apple.MobileSMS,3,1713390899,1713390902,1713390902.052856,-18000,,
com.leomehlig.today,6,1713390893,1713390899,1713390899.690551,-18000,,
us.zoom.xos,3,1713390890,1713390893,1713390893.689666,-18000,,
com.leomehlig.today,38,1713390852,1713390890,1713390890.806838,-18000,,
us.zoom.xos,18,1713390834,1713390852,1713390852.219856,-18000,,
com.google.Chrome,6,1713390828,1713390834,1713390834.1036649,-18000,,
com.toyopagroup.picaboo,13,1713390692,1713390705,1713390706.135867,-18000,EB445137-D7F5-57EC-87DA-1DB460D64046,"iPhone13,2"
com.facebook.Facebook,103,1713390576,1713390679,1713390680.003597,-18000,EB445137-D7F5-57EC-87DA-1DB460D64046,"iPhone13,2"
edu.illinois.rokwire.ios,31,1713390543,1713390574,1713390574.720257,-18000,EB445137-D7F5-57EC-87DA-1DB460D64046,"iPhone13,2"
com.apple.findmy,14,1713390529,1713390543,1713390543.226557,-18000,EB445137-D7F5-57EC-87DA-1DB460D64046,"iPhone13,2"
com.apple.MobileSMS,3,1713390526,1713390529,1713390529.079196,-18000,EB445137-D7F5-57EC-87DA-1DB460D64046,"iPhone13,2"
us.zoom.xos,304,1713390524,1713390828,1713390828.556312,-18000,,
com.google.Chrome,127,1713390397,1713390524,1713390524.357718,-18000,,
us.zoom.xos,48,1713390349,1713390397,1713390397.940373,-18000,,
com.apple.MobileSMS,24,1713390319,1713390343,1713390343.617955,-18000,EB445137-D7F5-57EC-87DA-1DB460D64046,"iPhone13,2"
com.google.Chrome,80,1713390269,1713390349,1713390349.6290112,-18000,,
us.zoom.xos,5,1713390264,1713390269,1713390269.196362,-18000,,
com.google.Chrome,62,1713390202,1713390264,1713390264.950746,-18000,,
us.zoom.xos,25,1713390177,1713390202,1713390203.003652,-18000,,
com.google.Chrome,101,1713390076,1713390177,1713390177.300257,-18000,,
us.zoom.xos,4,1713390072,1713390076,1713390076.406976,-18000,,
com.google.Chrome,14,1713390058,1713390072,1713390072.2013721,-18000,,
us.zoom.xos,8,1713390050,1713390058,1713390058.27859,-18000,,
com.instructure.icanvas,8,1713390047,1713390055,1713390056.0302691,-18000,EB445137-D7F5-57EC-87DA-1DB460D64046,"iPhone13,2"
com.apple.MobileSMS,10,1713390032,1713390042,1713390042.548162,-18000,EB445137-D7F5-57EC-87DA-1DB460D64046,"iPhone13,2"
com.instructure.icanvas,4,1713390017,1713390021,1713390021.381732,-18000,EB445137-D7F5-57EC-87DA-1DB460D64046,"iPhone13,2"
com.apple.Music,2,1713390015,1713390017,1713390017.713536,-18000,EB445137-D7F5-57EC-87DA-1DB460D64046,"iPhone13,2"
com.apple.Music,25,1713389990,1713390015,1713390015.167949,-18000,EB445137-D7F5-57EC-87DA-1DB460D64046,"iPhone13,2"
com.google.Chrome,146,1713389904,1713390050,1713390050.894953,-18000,,
us.zoom.xos,0,1713389904,1713389904,1713389904.9896731,-18000,,
com.google.Chrome,33,1713389871,1713389904,1713389904.683504,-18000,,
us.zoom.xos,1,1713389870,1713389871,1713389871.354439,-18000,,
com.google.Chrome,10,1713389860,1713389870,1713389870.585845,-18000,,
us.zoom.xos,8,1713389852,1713389860,1713389860.458354,-18000,,
com.google.Chrome,107,1713389745,1713389852,1713389852.4943218,-18000,,
us.zoom.xos,1,1713389744,1713389745,1713389745.084392,-18000,,
com.google.Chrome,11,1713389733,1713389744,1713389744.426793,-18000,,
us.zoom.xos,7,1713389726,1713389733,1713389734.014925,-18000,,
com.google.Chrome,2,1713389724,1713389726,1713389726.37036,-18000,,
us.zoom.xos,3,1713389721,1713389724,1713389724.539119,-18000,,
com.google.Chrome,1,1713389720,1713389721,1713389721.651258,-18000,,
us.zoom.xos,5,1713389715,1713389720,1713389720.049852,-18000,,
com.google.Chrome,11,1713389704,1713389715,1713389715.6130772,-18000,,
us.zoom.xos,39,1713389665,1713389704,1713389704.25816,-18000,,
com.google.Chrome,16,1713389649,1713389665,1713389665.85605,-18000,,
us.zoom.xos,12,1713389637,1713389649,1713389649.389523,-18000,,
com.google.Chrome,2,1713389635,1713389637,1713389637.5666041,-18000,,
us.zoom.xos,33,1713389602,1713389635,1713389635.568874,-18000,,
com.google.Chrome,9,1713389593,1713389602,1713389602.255476,-18000,,
us.zoom.xos,1,1713389592,1713389593,1713389593.276129,-18000,,
com.google.Chrome,2,1713389590,1713389592,1713389592.557413,-18000,,
us.zoom.xos,244,1713389346,1713389590,1713389590.208473,-18000,,
com.google.Chrome,31,1713389315,1713389346,1713389346.0874329,-18000,,
us.zoom.xos,59,1713389256,1713389315,1713389315.3249068,-18000,,
com.google.Chrome,147,1713389109,1713389256,1713389256.599437,-18000,,
us.zoom.xos,62,1713389047,1713389109,1713389110.005683,-18000,,
com.google.Chrome,166,1713388881,1713389047,1713389047.572281,-18000,,
us.zoom.xos,5,1713388876,1713388881,1713388881.988205,-18000,,
com.google.Chrome,23,1713388853,1713388876,1713388876.594044,-18000,,
us.zoom.xos,9,1713388844,1713388853,1713388853.2509341,-18000,,
com.google.Chrome,3,1713388841,1713388844,1713388844.515307,-18000,,
us.zoom.xos,13,1713388828,1713388841,1713388841.692634,-18000,,
com.google.Chrome,12,1713388816,1713388828,1713388828.101869,-18000,,
us.zoom.xos,17,1713388799,1713388816,1713388816.943956,-18000,,
com.google.Chrome,38,1713388761,1713388799,1713388799.8532271,-18000,,
us.zoom.xos,5,1713388756,1713388761,1713388761.149389,-18000,,
com.google.Chrome,20,1713388736,1713388756,1713388756.3536239,-18000,,
us.zoom.xos,29,1713388707,1713388736,1713388736.650086,-18000,,
com.google.Chrome,57,1713388650,1713388707,1713388707.570562,-18000,,
us.zoom.xos,4,1713388646,1713388650,1713388650.792046,-18000,,
com.google.Chrome,80,1713388566,1713388646,1713388646.6811051,-18000,,
us.zoom.xos,145,1713388421,1713388566,1713388567.002274,-18000,,
com.google.Chrome,57,1713388364,1713388421,1713388421.416642,-18000,,
us.zoom.xos,19,1713388345,1713388364,1713388364.2522922,-18000,,
com.google.Chrome,87,1713388258,1713388345,1713388345.043386,-18000,,
us.zoom.xos,45,1713388213,1713388258,1713388258.507886,-18000,,
com.google.Chrome,166,1713388047,1713388213,1713388213.4793072,-18000,,
us.zoom.xos,42,1713388005,1713388047,1713388047.861186,-18000,,
com.google.Chrome,18,1713387987,1713388005,1713388005.248533,-18000,,
us.zoom.xos,4,1713387983,1713387987,1713387987.709986,-18000,,
com.google.Chrome,15,1713387968,1713387983,1713387983.5437698,-18000,,
us.zoom.xos,17,1713387951,1713387968,1713387968.522828,-18000,,
com.google.Chrome,65,1713387886,1713387951,1713387951.650782,-18000,,
us.zoom.xos,3,1713387883,1713387886,1713387886.8285642,-18000,,
com.google.Chrome,20,1713387863,1713387883,1713387883.70646,-18000,,
us.zoom.xos,2,1713387861,1713387863,1713387863.0645862,-18000,,
com.google.Chrome,37,1713387824,1713387861,1713387861.702849,-18000,,
us.zoom.xos,7,1713387817,1713387824,1713387824.43431,-18000,,
com.google.Chrome,22,1713387795,1713387817,1713387817.475535,-18000,,
us.zoom.xos,0,1713387795,1713387795,1713387795.7876182,-18000,,
com.google.Chrome,1,1713387794,1713387795,1713387795.162607,-18000,,
us.zoom.xos,2,1713387792,1713387794,1713387794.6900048,-18000,,
com.google.Chrome,47,1713387745,1713387792,1713387792.320025,-18000,,
us.zoom.xos,26,1713387719,1713387745,1713387745.896203,-18000,,
com.google.Chrome,23,1713387696,1713387719,1713387719.705934,-18000,,
us.zoom.xos,1,1713387695,1713387696,1713387696.491694,-18000,,
com.google.Chrome,21,1713387674,1713387695,1713387695.529115,-18000,,
us.zoom.xos,7,1713387667,1713387674,1713387674.848164,-18000,,
com.google.Chrome,3,1713387664,1713387667,1713387667.3870149,-18000,,
us.zoom.xos,1,1713387663,1713387664,1713387664.918645,-18000,,
com.google.Chrome,32,1713387631,1713387663,1713387663.4738069,-18000,,
us.zoom.xos,1,1713387630,1713387631,1713387631.5909019,-18000,,
com.google.Chrome,21,1713387609,1713387630,1713387630.6224961,-18000,,
us.zoom.xos,3,1713387606,1713387609,1713387609.627184,-18000,,
com.google.Chrome,8,1713387598,1713387606,1713387606.57543,-18000,,
us.zoom.xos,10,1713387588,1713387598,1713387598.4158812,-18000,,
com.google.Chrome,2,1713387586,1713387588,1713387588.9727612,-18000,,
us.zoom.xos,15,1713387571,1713387586,1713387586.8876848,-18000,,
com.google.Chrome,0,1713387571,1713387571,1713387571.754115,-18000,,
us.zoom.xos,3,1713387568,1713387571,1713387571.129401,-18000,,
com.google.Chrome,5,1713387563,1713387568,1713387568.2044048,-18000,,
com.apple.MobileSMS,5,1713387558,1713387563,1713387563.9370708,-18000,,
com.google.Chrome,64,1713387494,1713387558,1713387558.36238,-18000,,
com.microsoft.VSCode,10,1713387484,1713387494,1713387494.6502662,-18000,,
com.google.Chrome,59,1713387425,1713387484,1713387484.7529821,-18000,,
com.apple.Music,4,1713387053,1713387057,1713387057.0309582,-18000,EB445137-D7F5-57EC-87DA-1DB460D64046,"iPhone13,2"
com.apple.Music,6,1713386521,1713386527,1713386527.3821778,-18000,EB445137-D7F5-57EC-87DA-1DB460D64046,"iPhone13,2"
com.apple.Music,12,1713386507,1713386519,1713386519.6516562,-18000,EB445137-D7F5-57EC-87DA-1DB460D64046,"iPhone13,2"
com.google.Chrome,77,1713386396,1713386473,1713386473.148185,-18000,,
com.microsoft.VSCode,1,1713386395,1713386396,1713386396.672453,-18000,,
com.google.Chrome,34,1713386361,1713386395,1713386395.3890162,-18000,,
com.microsoft.VSCode,2,1713386359,1713386361,1713386361.553658,-18000,,
com.google.Chrome,2,1713386357,1713386359,1713386359.213242,-18000,,
com.microsoft.VSCode,8,1713386349,1713386357,1713386357.6578999,-18000,,
com.google.Chrome,2,1713386347,1713386349,1713386349.4617229,-18000,,
com.microsoft.VSCode,1,1713386346,1713386347,1713386347.99126,-18000,,
com.google.Chrome,1,1713386345,1713386346,1713386346.488725,-18000,,
com.microsoft.VSCode,14,1713386331,1713386345,1713386345.194828,-18000,,
com.google.Chrome,22,1713386309,1713386331,1713386331.875972,-18000,,
com.microsoft.VSCode,1,1713386308,1713386309,1713386309.972038,-18000,,
com.google.Chrome,2,1713386306,1713386308,1713386308.228517,-18000,,
com.microsoft.VSCode,3,1713386303,1713386306,1713386306.183218,-18000,,
com.google.Chrome,5,1713386298,1713386303,1713386303.751217,-18000,,
com.microsoft.VSCode,4,1713386294,1713386298,1713386298.794183,-18000,,
com.google.Chrome,1,1713386293,1713386294,1713386294.193085,-18000,,
com.microsoft.VSCode,11,1713386282,1713386293,1713386293.717222,-18000,,
com.google.Chrome,2,1713386280,1713386282,1713386282.3542318,-18000,,
com.microsoft.VSCode,217,1713386063,1713386280,1713386280.67178,-18000,,
com.google.Chrome,46,1713386017,1713386063,1713386063.3821402,-18000,,
com.microsoft.VSCode,5,1713386012,1713386017,1713386017.408452,-18000,,
com.google.Chrome,26,1713385986,1713386012,1713386012.1433911,-18000,,
com.microsoft.VSCode,10,1713385976,1713385986,1713385986.49141,-18000,,
com.google.Chrome,106,1713385870,1713385976,1713385976.306491,-18000,,
com.microsoft.VSCode,1,1713385869,1713385870,1713385870.1305032,-18000,,
com.google.Chrome,12,1713385857,1713385869,1713385869.7076612,-18000,,
com.microsoft.VSCode,20,1713385837,1713385857,1713385857.258377,-18000,,
com.google.Chrome,4,1713385833,1713385837,1713385837.124476,-18000,,
com.microsoft.VSCode,89,1713385744,1713385833,1713385833.7210999,-18000,,
com.google.Chrome,25,1713385719,1713385744,1713385744.657192,-18000,,
com.leomehlig.today,40,1713385679,1713385719,1713385719.764924,-18000,,
com.google.Chrome,4,1713385675,1713385679,1713385679.367168,-18000,,
com.leomehlig.today,9,1713385666,1713385675,1713385675.216625,-18000,,
com.google.Chrome,1,1713385665,1713385666,1713385666.082917,-18000,,
com.leomehlig.today,14,1713385651,1713385665,1713385665.117782,-18000,,
com.google.Chrome,21,1713385630,1713385651,1713385651.67746,-18000,,
com.leomehlig.today,51,1713385579,1713385630,1713385630.6798968,-18000,,
com.intsig.CamScannerLite,120,1713385355,1713385475,1713385475.24103,-18000,EB445137-D7F5-57EC-87DA-1DB460D64046,"iPhone13,2"
com.google.Chrome,240,1713385339,1713385579,1713385579.96177,-18000,,
com.hnc.Discord,27,1713385312,1713385339,1713385339.229063,-18000,,
com.google.Chrome,767,1713384545,1713385312,1713385312.836883,-18000,,
com.leomehlig.today,4,1713384541,1713384545,1713384545.668036,-18000,,
com.google.Chrome,2,1713384539,1713384541,1713384541.6158419,-18000,,
com.apple.Preview,67,1713384472,1713384539,1713384539.808186,-18000,,
com.google.Chrome,29,1713384443,1713384472,1713384472.714171,-18000,,
com.apple.Preview,6,1713384437,1713384443,1713384443.0877519,-18000,,
com.google.Chrome,39,1713384398,1713384437,1713384437.810669,-18000,,
com.apple.Preview,92,1713384306,1713384398,1713384399.0255198,-18000,,
com.google.Chrome,968,1713383338,1713384306,1713384306.201954,-18000,,
com.apple.Preview,142,1713383196,1713383338,1713383338.484743,-18000,,
com.google.Chrome,74,1713383122,1713383196,1713383196.720571,-18000,,
com.apple.Preview,108,1713383014,1713383122,1713383122.393806,-18000,,
com.hnc.Discord,0,1713383014,1713383014,1713383014.83106,-18000,,
com.google.Chrome,374,1713382640,1713383014,1713383014.306974,-18000,,
com.hnc.Discord,209,1713382431,1713382640,1713382640.881967,-18000,,
com.google.Chrome,273,1713382158,1713382431,1713382431.26198,-18000,,
com.apple.Preview,52,1713382106,1713382158,1713382158.773542,-18000,,
com.google.Chrome,4,1713382102,1713382106,1713382106.15098,-18000,,
com.apple.Preview,105,1713381997,1713382102,1713382102.143889,-18000,,
com.google.Chrome,286,1713381711,1713381997,1713381997.396991,-18000,,
com.apple.Preview,53,1713381658,1713381711,1713381711.986959,-18000,,
com.google.Chrome,16,1713381642,1713381658,1713381658.030254,-18000,,
com.apple.Preview,7,1713381635,1713381642,1713381642.594526,-18000,,
com.google.Chrome,26,1713381609,1713381635,1713381635.048524,-18000,,
com.apple.Preview,48,1713381561,1713381609,1713381609.0408158,-18000,,
com.google.Chrome,1,1713381560,1713381561,1713381561.801944,-18000,,
com.apple.finder,1,1713381559,1713381560,1713381560.5238938,-18000,,
com.google.Chrome,2,1713381557,1713381559,1713381559.364775,-18000,,
com.apple.finder,2,1713381555,1713381557,1713381557.849934,-18000,,
com.apple.Preview,2,1713381553,1713381555,1713381555.227526,-18000,,
com.apple.finder,2,1713381551,1713381553,1713381553.137053,-18000,,
com.apple.Preview,1,1713381550,1713381551,1713381551.486664,-18000,,
com.google.Chrome,184,1713381366,1713381550,1713381550.171385,-18000,,
com.leomehlig.today,24,1713381342,1713381366,1713381366.649939,-18000,,
com.apple.mobilecal,5,1713381253,1713381258,1713381258.850041,-18000,EB445137-D7F5-57EC-87DA-1DB460D64046,"iPhone13,2"
com.google.Chrome,95,1713381247,1713381342,1713381342.215049,-18000,,
com.apple.MobileSMS,15,1713381232,1713381247,1713381247.9285111,-18000,,
com.google.Chrome,171,1713381061,1713381232,1713381232.1577458,-18000,,
com.apple.iCal,34,1713381027,1713381061,1713381061.168219,-18000,,
com.google.Chrome,29,1713380998,1713381027,1713381027.687389,-18000,,
com.leomehlig.today,45,1713380927,1713380972,1713380972.117964,-18000,,
com.apple.mobilecal,5,1713380224,1713380229,1713380229.2662,-18000,EB445137-D7F5-57EC-87DA-1DB460D64046,"iPhone13,2"
com.apple.MobileSMS,2,1713380219,1713380221,1713380221.323326,-18000,EB445137-D7F5-57EC-87DA-1DB460D64046,"iPhone13,2"
com.apple.MobileSMS,17,1713380185,1713380202,1713380202.789897,-18000,EB445137-D7F5-57EC-87DA-1DB460D64046,"iPhone13,2"
com.apple.MobileSMS,3,1713379990,1713379993,1713379993.4715118,-18000,EB445137-D7F5-57EC-87DA-1DB460D64046,"iPhone13,2"
com.apple.MobileSMS,6,1713379983,1713379989,1713379989.782969,-18000,EB445137-D7F5-57EC-87DA-1DB460D64046,"iPhone13,2"
com.apple.MobileSMS,28,1713379919,1713379947,1713379947.328085,-18000,EB445137-D7F5-57EC-87DA-1DB460D64046,"iPhone13,2"
edu.illinois.rokwire.ios,3,1713379916,1713379919,1713379919.8033671,-18000,EB445137-D7F5-57EC-87DA-1DB460D64046,"iPhone13,2"
com.leomehlig.today,5,1713376765,1713376770,1713376770.163404,-18000,,
com.apple.Preview,1749,1713375016,1713376765,1713376765.850492,-18000,,
com.leomehlig.today,16,1713375000,1713375016,1713375016.393265,-18000,,
com.apple.Preview,26,1713374974,1713375000,1713375000.0754972,-18000,,
com.apple.finder,5,1713374969,1713374974,1713374974.057317,-18000,,
com.google.Chrome,37,1713374932,1713374969,1713374969.629951,-18000,,
com.apple.iCal,14,1713374918,1713374932,1713374932.447536,-18000,,
com.google.Chrome,42,1713374876,1713374918,1713374918.094044,-18000,,
com.leomehlig.today,7,1713374869,1713374876,1713374876.789092,-18000,,
edu.illinois.rokwire.ios,13,1713374138,1713374151,1713374151.5042028,-18000,EB445137-D7F5-57EC-87DA-1DB460D64046,"iPhone13,2"
com.apple.MobileSMS,3,1713374133,1713374136,1713374136.811511,-18000,EB445137-D7F5-57EC-87DA-1DB460D64046,"iPhone13,2"
com.apple.MobileSMS,1,1713373402,1713373403,1713373403.935291,-18000,EB445137-D7F5-57EC-87DA-1DB460D64046,"iPhone13,2"
com.apple.InCallService,1,1713373401,1713373402,1713373402.864389,-18000,EB445137-D7F5-57EC-87DA-1DB460D64046,"iPhone13,2"
com.apple.InCallService,4,1713372843,1713372847,1713372847.1676211,-18000,EB445137-D7F5-57EC-87DA-1DB460D64046,"iPhone13,2"
com.apple.MobileSMS,9,1713372834,1713372843,1713372844.463293,-18000,EB445137-D7F5-57EC-87DA-1DB460D64046,"iPhone13,2"
com.apple.findmy,9,1713372824,1713372833,1713372834.1479712,-18000,EB445137-D7F5-57EC-87DA-1DB460D64046,"iPhone13,2"
edu.illinois.rokwire.ios,51,1713372720,1713372771,1713372771.503015,-18000,EB445137-D7F5-57EC-87DA-1DB460D64046,"iPhone13,2"
com.leomehlig.today,15,1713370147,1713370162,1713370162.834896,-18000,,
com.google.Chrome,1,1713370146,1713370147,1713370147.555087,-18000,,
com.apple.iCal,6,1713370140,1713370146,1713370146.148662,-18000,,
com.google.Chrome,3,1713370137,1713370140,1713370140.2318559,-18000,,
com.leomehlig.today,3,1713370134,1713370137,1713370137.469096,-18000,,
com.google.Chrome,23,1713370111,1713370134,1713370134.523134,-18000,,
com.leomehlig.today,16,1713370081,1713370097,1713370097.635165,-18000,,
com.google.Chrome,7,1713370074,1713370081,1713370081.9340758,-18000,,
com.apple.iCal,166,1713369908,1713370074,1713370074.756384,-18000,,
com.google.Chrome,5,1713369903,1713369908,1713369908.757598,-18000,,
com.apple.MobileSMS,13,1713369890,1713369903,1713369903.631191,-18000,,
com.google.Chrome,2,1713369888,1713369890,1713369890.962788,-18000,,
com.microsoft.VSCode,2,1713369886,1713369888,1713369889.060637,-18000,,
com.google.Chrome,152,1713369734,1713369886,1713369886.7682629,-18000,,
com.apple.MobileSMS,6,1713369728,1713369734,1713369734.1504889,-18000,,
com.google.Chrome,38,1713369690,1713369728,1713369728.290792,-18000,,
com.microsoft.VSCode,3,1713369687,1713369690,1713369690.7233748,-18000,,
com.apple.finder,1,1713369686,1713369687,1713369687.90502,-18000,,
com.google.Chrome,20,1713369666,1713369686,1713369686.940732,-18000,,
com.apple.finder,10,1713369656,1713369666,1713369666.815814,-18000,,
com.google.Chrome,56,1713369600,1713369656,1713369656.767519,-18000,,
com.microsoft.VSCode,2,1713369598,1713369600,1713369600.637061,-18000,,
com.google.Chrome,34,1713369564,1713369598,1713369598.2627559,-18000,,
com.apple.MobileSMS,1,1713369563,1713369564,1713369564.235399,-18000,,
com.google.Chrome,12,1713369551,1713369563,1713369563.147639,-18000,,
com.apple.MobileSMS,7,1713369544,1713369551,1713369551.8663769,-18000,,
com.google.Chrome,16,1713369528,1713369544,1713369544.528977,-18000,,
com.apple.MobileSMS,15,1713369513,1713369528,1713369528.878158,-18000,,
com.google.Chrome,4,1713369509,1713369513,1713369513.367979,-18000,,
com.apple.MobileSMS,3,1713369506,1713369509,1713369509.704395,-18000,,
com.google.Chrome,7,1713369499,1713369506,1713369506.9116058,-18000,,
com.apple.MobileSMS,7,1713369492,1713369499,1713369499.469986,-18000,,
com.google.Chrome,19,1713369473,1713369492,1713369492.581543,-18000,,
com.apple.MobileSMS,7,1713369466,1713369473,1713369473.66727,-18000,,
com.google.Chrome,2,1713369464,1713369466,1713369467.03073,-18000,,
com.apple.MobileSMS,6,1713369458,1713369464,1713369464.454575,-18000,,
com.google.Chrome,2,1713369456,1713369458,1713369458.321074,-18000,,
com.apple.MobileSMS,12,1713369444,1713369456,1713369456.56806,-18000,,
com.google.Chrome,5,1713369439,1713369444,1713369444.954006,-18000,,
com.apple.MobileSMS,2,1713369437,1713369439,1713369439.3016062,-18000,,
com.google.Chrome,14,1713369423,1713369437,1713369437.495699,-18000,,
com.microsoft.VSCode,0,1713369423,1713369423,1713369423.572751,-18000,,
com.google.Chrome,44,1713369379,1713369423,1713369423.137495,-18000,,
com.microsoft.VSCode,4,1713369375,1713369379,1713369379.134979,-18000,,
com.google.Chrome,48,1713369327,1713369375,1713369375.348932,-18000,,
com.microsoft.VSCode,2,1713369325,1713369327,1713369327.7263541,-18000,,
com.apple.finder,12,1713369313,1713369325,1713369325.7318459,-18000,,
com.microsoft.VSCode,6,1713369307,1713369313,1713369313.9979,-18000,,
com.microsoft.Outlook,10,1713369297,1713369307,1713369307.405483,-18000,,
com.google.Chrome,128,1713369169,1713369297,1713369297.720531,-18000,,
com.microsoft.Office.Outlook,5,1713369136,1713369141,1713369141.0374532,-18000,EB445137-D7F5-57EC-87DA-1DB460D64046,"iPhone13,2"
com.toyopagroup.picaboo,12,1713369123,1713369135,1713369136.024235,-18000,EB445137-D7F5-57EC-87DA-1DB460D64046,"iPhone13,2"
com.hammerandchisel.discord,4,1713369119,1713369123,1713369123.4250798,-18000,EB445137-D7F5-57EC-87DA-1DB460D64046,"iPhone13,2"
com.hammerandchisel.discord,5,1713368093,1713368098,1713368098.355188,-18000,EB445137-D7F5-57EC-87DA-1DB460D64046,"iPhone13,2"
com.hammerandchisel.discord,139,1713367801,1713367940,1713367940.387166,-18000,EB445137-D7F5-57EC-87DA-1DB460D64046,"iPhone13,2"
com.toyopagroup.picaboo,19,1713367778,1713367797,1713367797.9970431,-18000,EB445137-D7F5-57EC-87DA-1DB460D64046,"iPhone13,2"
com.google.Chrome,277,1713367738,1713368015,1713368015.6939569,-18000,,
us.zoom.xos,10,1713367728,1713367738,1713367738.522567,-18000,,
com.google.Chrome,184,1713367544,1713367728,1713367728.960177,-18000,,
com.microsoft.Outlook,3,1713367541,1713367544,1713367544.3509421,-18000,,
com.google.Chrome,40,1713367501,1713367541,1713367541.320648,-18000,,
com.microsoft.VSCode,4,1713367497,1713367501,1713367501.908356,-18000,,
com.google.Chrome,33,1713367464,1713367497,1713367497.59373,-18000,,
com.microsoft.VSCode,8,1713367456,1713367464,1713367464.295855,-18000,,
com.google.Chrome,9,1713367447,1713367456,1713367456.3873758,-18000,,
com.microsoft.VSCode,11,1713367436,1713367447,1713367447.315465,-18000,,
com.google.Chrome,8,1713367428,1713367436,1713367436.6755629,-18000,,
com.microsoft.VSCode,3,1713367425,1713367428,1713367428.562465,-18000,,
com.google.Chrome,4,1713367421,1713367425,1713367425.449891,-18000,,
com.microsoft.VSCode,7,1713367414,1713367421,1713367421.088506,-18000,,
com.google.Chrome,3,1713367411,1713367414,1713367414.281255,-18000,,
com.microsoft.VSCode,8,1713367403,1713367411,1713367411.807862,-18000,,
com.google.Chrome,14,1713367389,1713367403,1713367403.3520489,-18000,,
com.microsoft.VSCode,9,1713367380,1713367389,1713367389.151334,-18000,,
com.google.Chrome,17,1713367363,1713367380,1713367380.9588199,-18000,,
com.microsoft.VSCode,9,1713367354,1713367363,1713367363.903627,-18000,,
com.google.Chrome,33,1713367321,1713367354,1713367354.65165,-18000,,
com.microsoft.VSCode,36,1713367285,1713367321,1713367321.12461,-18000,,
com.google.Chrome,6,1713367279,1713367285,1713367285.670249,-18000,,
com.microsoft.VSCode,5,1713367274,1713367279,1713367279.174453,-18000,,
com.google.Chrome,141,1713367133,1713367274,1713367274.689759,-18000,,
us.zoom.xos,21,1713367112,1713367133,1713367133.9122,-18000,,
com.microsoft.Outlook,8,1713367104,1713367112,1713367112.058644,-18000,,
us.zoom.xos,3,1713367101,1713367104,1713367104.746512,-18000,,
com.apple.weather,4,1713367077,1713367081,1713367082.038511,-18000,EB445137-D7F5-57EC-87DA-1DB460D64046,"iPhone13,2"
com.google.Chrome,49,1713367052,1713367101,1713367101.6701841,-18000,,
com.microsoft.Outlook,3,1713367049,1713367052,1713367052.937601,-18000,,
com.microsoft.VSCode,5,1713367044,1713367049,1713367049.5247931,-18000,,
com.microsoft.VSCode,62,1713366951,1713367013,1713367013.546304,-18000,,
com.google.Chrome,89,1713366862,1713366951,1713366951.548526,-18000,,
com.microsoft.VSCode,4,1713366858,1713366862,1713366862.333663,-18000,,
com.google.Chrome,37,1713366821,1713366858,1713366858.5412111,-18000,,
com.microsoft.VSCode,75,1713366746,1713366821,1713366821.3888102,-18000,,
com.google.Chrome,2,1713366744,1713366746,1713366746.197061,-18000,,
com.microsoft.VSCode,36,1713366708,1713366744,1713366744.436003,-18000,,
com.google.Chrome,4,1713366704,1713366708,1713366708.479545,-18000,,
com.microsoft.VSCode,14,1713366690,1713366704,1713366704.753271,-18000,,
com.google.Chrome,6,1713366684,1713366690,1713366690.8909578,-18000,,
com.microsoft.VSCode,19,1713366665,1713366684,1713366684.055959,-18000,,
com.google.Chrome,7,1713366658,1713366665,1713366665.502841,-18000,,
com.microsoft.VSCode,19,1713366639,1713366658,1713366658.427576,-18000,,
com.google.Chrome,1,1713366638,1713366639,1713366639.846776,-18000,,
com.microsoft.VSCode,10,1713366628,1713366638,1713366638.7945929,-18000,,
com.google.Chrome,2,1713366626,1713366628,1713366628.721109,-18000,,
com.microsoft.VSCode,14,1713366612,1713366626,1713366626.220768,-18000,,
com.google.Chrome,2,1713366610,1713366612,1713366612.662212,-18000,,
com.microsoft.VSCode,7,1713366603,1713366610,1713366610.507447,-18000,,
com.google.Chrome,6,1713366597,1713366603,1713366603.560601,-18000,,
com.microsoft.VSCode,27,1713366570,1713366597,1713366597.1293921,-18000,,
com.google.Chrome,27,1713366543,1713366570,1713366570.24833,-18000,,
com.microsoft.VSCode,12,1713366531,1713366543,1713366543.5742478,-18000,,
com.google.Chrome,40,1713366491,1713366531,1713366531.2437282,-18000,,
com.microsoft.VSCode,4,1713366487,1713366491,1713366492.0159411,-18000,,
com.google.Chrome,1,1713366486,1713366487,1713366487.857061,-18000,,
com.microsoft.VSCode,5,1713366481,1713366486,1713366486.7564511,-18000,,
com.google.Chrome,1,1713366480,1713366481,1713366481.78247,-18000,,
com.microsoft.VSCode,34,1713366446,1713366480,1713366480.498637,-18000,,
com.google.Chrome,3,1713366443,1713366446,1713366446.28011,-18000,,
com.microsoft.VSCode,1,1713366442,1713366443,1713366444.028712,-18000,,
com.google.Chrome,3,1713366439,1713366442,1713366442.835659,-18000,,
com.microsoft.VSCode,1,1713366438,1713366439,1713366439.05351,-18000,,
com.apple.Dictionary,2,1713366436,1713366438,1713366438.530849,-18000,,
com.microsoft.VSCode,11,1713366425,1713366436,1713366436.646601,-18000,,
com.google.Chrome,2,1713366423,1713366425,1713366425.305202,-18000,,
com.microsoft.VSCode,26,1713366397,1713366423,1713366423.186232,-18000,,
com.google.Chrome,2,1713366395,1713366397,1713366397.146364,-18000,,
com.microsoft.Outlook,2,1713366393,1713366395,1713366395.1884918,-18000,,
com.google.Chrome,224,1713366169,1713366393,1713366393.993315,-18000,,
com.microsoft.VSCode,9,1713366160,1713366169,1713366169.704111,-18000,,
com.google.Chrome,55,1713366105,1713366160,1713366161.0163631,-18000,,
com.microsoft.VSCode,7,1713366098,1713366105,1713366105.750072,-18000,,
com.google.Chrome,8,1713366090,1713366098,1713366098.859425,-18000,,
com.microsoft.VSCode,4,1713366086,1713366090,1713366090.790798,-18000,,
com.google.Chrome,31,1713366055,1713366086,1713366086.164695,-18000,,
com.microsoft.VSCode,129,1713365926,1713366055,1713366055.945314,-18000,,
com.google.Chrome,85,1713365841,1713365926,1713365926.80021,-18000,,
com.microsoft.VSCode,15,1713365826,1713365841,1713365841.623553,-18000,,
com.google.Chrome,14,1713365812,1713365826,1713365826.314622,-18000,,
com.microsoft.VSCode,2,1713365810,1713365812,1713365812.66536,-18000,,
com.google.Chrome,1,1713365809,1713365810,1713365810.617529,-18000,,
com.microsoft.VSCode,17,1713365792,1713365809,1713365809.089322,-18000,,
com.google.Chrome,5,1713365787,1713365792,1713365792.584803,-18000,,
com.microsoft.VSCode,1,1713365786,1713365787,1713365787.491932,-18000,,
com.google.Chrome,177,1713365609,1713365786,1713365786.5403929,-18000,,
com.microsoft.VSCode,2,1713365607,1713365609,1713365609.2762609,-18000,,
com.google.Chrome,10,1713365597,1713365607,1713365607.885581,-18000,,
com.microsoft.VSCode,9,1713365588,1713365597,1713365597.203666,-18000,,
com.google.Chrome,4,1713365584,1713365588,1713365588.936018,-18000,,
com.microsoft.VSCode,1,1713365583,1713365584,1713365584.183502,-18000,,
com.google.Chrome,258,1713365325,1713365583,1713365583.8022099,-18000,,
com.microsoft.VSCode,21,1713365304,1713365325,1713365325.511568,-18000,,
com.google.Chrome,24,1713365280,1713365304,1713365304.928061,-18000,,
com.microsoft.VSCode,11,1713365269,1713365280,1713365280.116414,-18000,,
com.google.Chrome,16,1713365253,1713365269,1713365269.1334429,-18000,,
com.microsoft.Outlook,16,1713365237,1713365253,1713365253.397488,-18000,,
com.google.Chrome,41,1713365196,1713365237,1713365238.028895,-18000,,
com.microsoft.VSCode,1,1713365195,1713365196,1713365196.431705,-18000,,
com.google.Chrome,5,1713365190,1713365195,1713365195.200216,-18000,,
com.microsoft.VSCode,8,1713365182,1713365190,1713365190.539907,-18000,,
com.google.Chrome,28,1713365154,1713365182,1713365182.276046,-18000,,
com.microsoft.VSCode,4,1713365150,1713365154,1713365154.193744,-18000,,
com.google.Chrome,18,1713365132,1713365150,1713365150.16552,-18000,,
com.microsoft.VSCode,5,1713365127,1713365132,1713365132.4008,-18000,,
com.google.Chrome,16,1713365111,1713365127,1713365127.4253988,-18000,,
com.microsoft.VSCode,5,1713365106,1713365111,1713365111.449452,-18000,,
com.apple.Dictionary,1,1713365105,1713365106,1713365106.521891,-18000,,
com.microsoft.VSCode,8,1713365097,1713365105,1713365105.108274,-18000,,
com.google.Chrome,2,1713365095,1713365097,1713365097.513074,-18000,,
com.microsoft.VSCode,9,1713365086,1713365095,1713365095.8080769,-18000,,
com.google.Chrome,2,1713365084,1713365086,1713365086.070064,-18000,,
com.microsoft.VSCode,13,1713365071,1713365084,1713365084.7586842,-18000,,
com.google.Chrome,3,1713365068,1713365071,1713365071.693694,-18000,,
com.microsoft.VSCode,8,1713365060,1713365068,1713365068.953315,-18000,,
com.google.Chrome,70,1713364990,1713365060,1713365060.665904,-18000,,
com.microsoft.Outlook,49,1713364941,1713364990,1713364990.7188911,-18000,,
com.google.Chrome,60,1713364881,1713364941,1713364941.66662,-18000,,
com.microsoft.VSCode,1,1713364880,1713364881,1713364881.6065621,-18000,,
com.google.Chrome,8,1713364872,1713364880,1713364880.129552,-18000,,
com.microsoft.VSCode,2,1713364870,1713364872,1713364872.854531,-18000,,
com.google.Chrome,23,1713364847,1713364870,1713364870.365794,-18000,,
com.microsoft.Outlook,7,1713364840,1713364847,1713364847.5440621,-18000,,
com.google.Chrome,2,1713364838,1713364840,1713364840.109695,-18000,,
com.microsoft.Outlook,23,1713364815,1713364838,1713364838.6783972,-18000,,
com.google.Chrome,10,1713364805,1713364815,1713364815.363627,-18000,,
com.microsoft.VSCode,2,1713364803,1713364805,1713364805.496194,-18000,,
com.google.Chrome,33,1713364770,1713364803,1713364803.7861052,-18000,,
com.microsoft.VSCode,235,1713364535,1713364770,1713364770.954752,-18000,,
com.apple.finder,62,1713364473,1713364535,1713364535.58982,-18000,,
com.apple.archiveutility,0,1713364473,1713364473,1713364473.595049,-18000,,
com.google.Chrome,123,1713364350,1713364473,1713364473.2315068,-18000,,
com.microsoft.VSCode,11,1713364320,1713364331,1713364331.058836,-18000,,
com.leomehlig.today,5,1713364315,1713364320,1713364320.398037,-18000,,
com.apple.weather,31,1713363309,1713363340,1713363340.832861,-18000,EB445137-D7F5-57EC-87DA-1DB460D64046,"iPhone13,2"
com.apple.weather,6,1713363148,1713363154,1713363154.536901,-18000,EB445137-D7F5-57EC-87DA-1DB460D64046,"iPhone13,2"
com.apple.weather,4,1713363037,1713363041,1713363041.680645,-18000,EB445137-D7F5-57EC-87DA-1DB460D64046,"iPhone13,2"
com.apple.MobileSMS,3,1713363019,1713363022,1713363022.033695,-18000,EB445137-D7F5-57EC-87DA-1DB460D64046,"iPhone13,2"
com.microsoft.Office.Outlook,6,1713363011,1713363017,1713363017.831459,-18000,EB445137-D7F5-57EC-87DA-1DB460D64046,"iPhone13,2"
com.instructure.icanvas,3,1713363000,1713363003,1713363003.9698482,-18000,EB445137-D7F5-57EC-87DA-1DB460D64046,"iPhone13,2"
com.apple.weather,9,1713362991,1713363000,1713363001.198801,-18000,EB445137-D7F5-57EC-87DA-1DB460D64046,"iPhone13,2"
com.apple.weather,4,1713362802,1713362806,1713362806.857946,-18000,EB445137-D7F5-57EC-87DA-1DB460D64046,"iPhone13,2"
com.apple.weather,12,1713362699,1713362711,1713362711.2063808,-18000,EB445137-D7F5-57EC-87DA-1DB460D64046,"iPhone13,2"
com.apple.mobiletimer,7,1713362692,1713362699,1713362699.402694,-18000,EB445137-D7F5-57EC-87DA-1DB460D64046,"iPhone13,2"
com.apple.mobiletimer,10,1713361327,1713361337,1713361337.1600661,-18000,EB445137-D7F5-57EC-87DA-1DB460D64046,"iPhone13,2"
com.apple.mobiletimer,9,1713361011,1713361020,1713361020.154,-18000,EB445137-D7F5-57EC-87DA-1DB460D64046,"iPhone13,2"
com.apple.mobiletimer,3,1713360981,1713360984,1713360984.680063,-18000,EB445137-D7F5-57EC-87DA-1DB460D64046,"iPhone13,2"
com.apple.mobiletimer,4,1713360977,1713360981,1713360981.229128,-18000,EB445137-D7F5-57EC-87DA-1DB460D64046,"iPhone13,2"
com.thestorygraph.thestorygraph,59,1713329071,1713329130,1713329130.695644,-18000,EB445137-D7F5-57EC-87DA-1DB460D64046,"iPhone13,2"
com.apple.journal,685,1713327061,1713327746,1713327746.95611,-18000,EB445137-D7F5-57EC-87DA-1DB460D64046,"iPhone13,2"
com.toyopagroup.picaboo,33,1713327021,1713327054,1713327055.099474,-18000,EB445137-D7F5-57EC-87DA-1DB460D64046,"iPhone13,2"
com.apple.journal,10,1713327010,1713327020,1713327020.282042,-18000,EB445137-D7F5-57EC-87DA-1DB460D64046,"iPhone13,2"
com.leomehlig.today,2,1713326973,1713326975,1713326975.644908,-18000,,
com.leomehlig.today,18,1713326920,1713326938,1713326938.327904,-18000,,
com.google.Chrome,253,1713326667,1713326920,1713326920.617889,-18000,,
com.google.Chrome,559,1713326008,1713326567,1713326567.669101,-18000,,
com.google.Chrome,374,1713325539,1713325913,1713325913.944059,-18000,,
com.apple.Health,50,1713325398,1713325448,1713325448.0579538,-18000,EB445137-D7F5-57EC-87DA-1DB460D64046,"iPhone13,2"
com.google.Gmail,18,1713325370,1713325388,1713325388.152763,-18000,EB445137-D7F5-57EC-87DA-1DB460D64046,"iPhone13,2"
com.apple.MobileSMS,4,1713325358,1713325362,1713325362.191492,-18000,EB445137-D7F5-57EC-87DA-1DB460D64046,"iPhone13,2"
com.tinyspeck.chatlyio,105,1713325241,1713325346,1713325346.650206,-18000,EB445137-D7F5-57EC-87DA-1DB460D64046,"iPhone13,2"
com.microsoft.Office.Outlook,15,1713325214,1713325229,1713325229.70011,-18000,EB445137-D7F5-57EC-87DA-1DB460D64046,"iPhone13,2"
com.google.Chrome,97,1713321191,1713321288,1713321288.01602,-18000,,
com.leomehlig.today,9,1713321182,1713321191,1713321191.276098,-18000,,
com.hnc.Discord,1,1713321181,1713321182,1713321182.6191812,-18000,,
com.leomehlig.today,1,1713321180,1713321181,1713321181.703913,-18000,,
com.microsoft.Outlook,35,1713321145,1713321180,1713321180.391934,-18000,,
com.google.Chrome,17,1713321128,1713321145,1713321145.264909,-18000,,
com.microsoft.Outlook,113,1713321015,1713321128,1713321128.627799,-18000,,
com.google.Chrome,5,1713321010,1713321015,1713321015.820675,-18000,,
com.leomehlig.today,3,1713321007,1713321010,1713321010.122889,-18000,,
com.google.Chrome,224,1713320783,1713321007,1713321007.990896,-18000,,
com.leomehlig.today,81,1713320702,1713320783,1713320783.890409,-18000,,
com.google.Chrome,140,1713320562,1713320702,1713320702.6257749,-18000,,
com.leomehlig.today,2,1713320560,1713320562,1713320562.0645862,-18000,,
com.google.Chrome,124,1713320436,1713320560,1713320560.882304,-18000,,
com.hnc.Discord,99,1713320337,1713320436,1713320436.384054,-18000,,
com.google.Chrome,2,1713320335,1713320337,1713320337.862966,-18000,,
com.leomehlig.today,0,1713320335,1713320335,1713320335.8229818,-18000,,
com.hnc.Discord,12,1713320323,1713320335,1713320335.087048,-18000,,
com.leomehlig.today,2,1713320321,1713320323,1713320323.276027,-18000,,
com.hnc.Discord,10,1713320311,1713320321,1713320321.795351,-18000,,
com.google.Chrome,253,1713320058,1713320311,1713320311.934289,-18000,,
com.google.Chrome,1222,1713318835,1713320057,1713320057.3440042,-18000,,
com.apple.weather,9,1713318826,1713318835,1713318835.363131,-18000,,
com.google.Chrome,173,1713318653,1713318826,1713318826.5135,-18000,,
com.hnc.Discord,211,1713318442,1713318653,1713318653.830924,-18000,,
com.google.Chrome,11,1713318431,1713318442,1713318442.799787,-18000,,
com.hnc.Discord,7,1713318424,1713318431,1713318432.108618,-18000,,
com.google.Chrome,638,1713317786,1713318424,1713318424.454926,-18000,,
com.google.Chrome,595,1713317177,1713317772,1713317772.563652,-18000,,
com.google.Chrome,300,1713316810,1713317110,1713317110.950786,-18000,,
com.google.Chrome,300,1713316505,1713316805,1713316805.322857,-18000,,
com.google.Chrome,301,1713316201,1713316502,1713316502.1177258,-18000,,
com.google.Chrome,499,1713315701,1713316200,1713316200.3147988,-18000,,
com.leomehlig.today,6,1713315688,1713315694,1713315694.572923,-18000,,
com.google.Chrome,4,1713315684,1713315688,1713315688.890454,-18000,,
com.apple.Music,23,1713314750,1713314773,1713314773.194141,-18000,EB445137-D7F5-57EC-87DA-1DB460D64046,"iPhone13,2"
com.apple.weather,6,1713314744,1713314750,1713314750.5439692,-18000,EB445137-D7F5-57EC-87DA-1DB460D64046,"iPhone13,2"
com.apple.weather,3,1713314656,1713314659,1713314659.6729,-18000,EB445137-D7F5-57EC-87DA-1DB460D64046,"iPhone13,2"
com.apple.weather,8,1713314639,1713314647,1713314647.582886,-18000,EB445137-D7F5-57EC-87DA-1DB460D64046,"iPhone13,2"
com.apple.weather,24,1713314517,1713314541,1713314541.379346,-18000,EB445137-D7F5-57EC-87DA-1DB460D64046,"iPhone13,2"
com.tinyspeck.chatlyio,10,1713309333,1713309343,1713309343.2469192,-18000,EB445137-D7F5-57EC-87DA-1DB460D64046,"iPhone13,2"
com.apple.Music,3,1713309328,1713309331,1713309331.891605,-18000,EB445137-D7F5-57EC-87DA-1DB460D64046,"iPhone13,2"
com.google.Chrome,21,1713309298,1713309319,1713309319.082353,-18000,,
com.apple.finder,2,1713309296,1713309298,1713309299.030216,-18000,,
com.apple.Music,1,1713309295,1713309296,1713309296.843206,-18000,,
com.google.Chrome,2,1713309293,1713309295,1713309295.654136,-18000,,
com.apple.Music,8,1713309239,1713309247,1713309247.761251,-18000,EB445137-D7F5-57EC-87DA-1DB460D64046,"iPhone13,2"
com.apple.Music,3,1713309233,1713309236,1713309236.071474,-18000,EB445137-D7F5-57EC-87DA-1DB460D64046,"iPhone13,2"
com.apple.Music,4,1713308433,1713308437,1713308437.484881,-18000,EB445137-D7F5-57EC-87DA-1DB460D64046,"iPhone13,2"
com.apple.Music,6,1713308168,1713308174,1713308174.9243999,-18000,EB445137-D7F5-57EC-87DA-1DB460D64046,"iPhone13,2"
com.apple.weather,3,1713308165,1713308168,1713308168.674547,-18000,EB445137-D7F5-57EC-87DA-1DB460D64046,"iPhone13,2"
com.apple.weather,24,1713306399,1713306423,1713306423.226359,-18000,EB445137-D7F5-57EC-87DA-1DB460D64046,"iPhone13,2"
edu.illinois.rokwire.ios,3,1713306396,1713306399,1713306399.17407,-18000,EB445137-D7F5-57EC-87DA-1DB460D64046,"iPhone13,2"
edu.illinois.rokwire.ios,12,1713305117,1713305129,1713305129.785728,-18000,EB445137-D7F5-57EC-87DA-1DB460D64046,"iPhone13,2"
com.toyopagroup.picaboo,2,1713305114,1713305116,1713305116.9661689,-18000,EB445137-D7F5-57EC-87DA-1DB460D64046,"iPhone13,2"
com.toyopagroup.picaboo,13,1713304841,1713304854,1713304854.1066809,-18000,EB445137-D7F5-57EC-87DA-1DB460D64046,"iPhone13,2"
com.apple.weather,3,1713304838,1713304841,1713304841.901947,-18000,EB445137-D7F5-57EC-87DA-1DB460D64046,"iPhone13,2"
com.apple.weather,5,1713304238,1713304243,1713304243.495946,-18000,EB445137-D7F5-57EC-87DA-1DB460D64046,"iPhone13,2"
com.microsoft.Office.Outlook,19,1713303937,1713303956,1713303956.325846,-18000,EB445137-D7F5-57EC-87DA-1DB460D64046,"iPhone13,2"
com.toyopagroup.picaboo,7,1713303758,1713303765,1713303765.285548,-18000,EB445137-D7F5-57EC-87DA-1DB460D64046,"iPhone13,2"
com.apple.camera,1,1713303228,1713303229,1713303229.066866,-18000,EB445137-D7F5-57EC-87DA-1DB460D64046,"iPhone13,2"
com.google.Chrome,2,1713303169,1713303171,1713303172.011754,-18000,,
com.leomehlig.today,47,1713303122,1713303169,1713303169.164932,-18000,,
com.google.Chrome,31,1713303091,1713303122,1713303122.381079,-18000,,
com.leomehlig.today,5,1713303086,1713303091,1713303092.018111,-18000,,
com.google.Chrome,51,1713303035,1713303086,1713303086.768556,-18000,,
com.leomehlig.today,12,1713303023,1713303035,1713303035.486281,-18000,,
com.toyopagroup.picaboo,18,1713302826,1713302844,1713302844.457114,-18000,EB445137-D7F5-57EC-87DA-1DB460D64046,"iPhone13,2"
com.toyopagroup.picaboo,6,1713301888,1713301894,1713301894.332366,-18000,EB445137-D7F5-57EC-87DA-1DB460D64046,"iPhone13,2"
com.toyopagroup.picaboo,18,1713301720,1713301738,1713301738.9820209,-18000,EB445137-D7F5-57EC-87DA-1DB460D64046,"iPhone13,2"
com.google.Chrome,1317,1713301706,1713303023,1713303023.974572,-18000,,
edu.illinois.rokwire.ios,67,1713301653,1713301720,1713301720.405435,-18000,EB445137-D7F5-57EC-87DA-1DB460D64046,"iPhone13,2"
com.instructure.icanvas,9,1713301644,1713301653,1713301653.618719,-18000,EB445137-D7F5-57EC-87DA-1DB460D64046,"iPhone13,2"
com.apple.MobileSMS,3,1713301641,1713301644,1713301644.375639,-18000,EB445137-D7F5-57EC-87DA-1DB460D64046,"iPhone13,2"
com.leomehlig.today,86,1713301620,1713301706,1713301706.23808,-18000,,
com.toyopagroup.picaboo,13,1713301302,1713301315,1713301315.697936,-18000,EB445137-D7F5-57EC-87DA-1DB460D64046,"iPhone13,2"
com.google.Gmail,35,1713301261,1713301296,1713301296.533952,-18000,EB445137-D7F5-57EC-87DA-1DB460D64046,"iPhone13,2"
edu.illinois.rokwire.ios,16,1713301245,1713301261,1713301261.133967,-18000,EB445137-D7F5-57EC-87DA-1DB460D64046,"iPhone13,2"
com.google.Chrome,1612,1713300008,1713301620,1713301620.770201,-18000,,
com.google.Chrome,305,1713299498,1713299803,1713299803.897811,-18000,,
com.google.Chrome,410,1713298850,1713299260,1713299260.069766,-18000,,
us.zoom.xos,7,1713298843,1713298850,1713298850.3079119,-18000,,
com.google.Chrome,110,1713298733,1713298843,1713298843.3838649,-18000,,
us.zoom.xos,40,1713298693,1713298733,1713298733.83303,-18000,,
com.leomehlig.today,20,1713298673,1713298693,1713298693.339552,-18000,,
us.zoom.xos,3,1713298670,1713298673,1713298673.643511,-18000,,
com.leomehlig.today,3,1713298667,1713298670,1713298670.80531,-18000,,
edu.illinois.rokwire.ios,27,1713298594,1713298621,1713298621.2396379,-18000,EB445137-D7F5-57EC-87DA-1DB460D64046,"iPhone13,2"
us.zoom.xos,93,1713298574,1713298667,1713298667.3688731,-18000,,
com.apple.systempreferences,67,1713298507,1713298574,1713298574.147774,-18000,,
com.truebill.truebillnative,10,1713298471,1713298481,1713298481.30582,-18000,EB445137-D7F5-57EC-87DA-1DB460D64046,"iPhone13,2"
us.zoom.xos,42,1713298458,1713298500,1713298500.552819,-18000,,
com.google.Chrome,88,1713298370,1713298458,1713298458.537218,-18000,,
us.zoom.xos,5,1713298352,1713298357,1713298358.2131782,-18000,,
com.apple.MobileSMS,31,1713298321,1713298352,1713298352.2509918,-18000,,
us.zoom.xos,3,1713298318,1713298321,1713298321.429306,-18000,,
us.zoom.xos,1229,1713297009,1713298238,1713298238.9486609,-18000,,
us.zoom.xos,302,1713296202,1713296504,1713296504.0904222,-18000,,
com.google.Chrome,59,1713296143,1713296202,1713296202.0451179,-18000,,
us.zoom.xos,1,1713296121,1713296122,1713296122.5360389,-18000,,
com.truebill.truebillnative,5,1713295603,1713295608,1713295608.597485,-18000,EB445137-D7F5-57EC-87DA-1DB460D64046,"iPhone13,2"
us.zoom.xos,575,1713295463,1713296038,1713296038.140048,-18000,,
com.google.Chrome,12,1713295451,1713295463,1713295463.774907,-18000,,
us.zoom.xos,2,1713295429,1713295431,1713295431.811631,-18000,,
com.truebill.truebillnative,4,1713295415,1713295419,1713295419.0148401,-18000,EB445137-D7F5-57EC-87DA-1DB460D64046,"iPhone13,2"
com.google.Chrome,214,1713295215,1713295429,1713295429.135921,-18000,,
us.zoom.xos,147,1713295068,1713295215,1713295215.644269,-18000,,
com.google.Chrome,88,1713294980,1713295068,1713295068.240833,-18000,,
us.zoom.xos,2,1713294978,1713294980,1713294980.352186,-18000,,
com.google.Chrome,23,1713294955,1713294978,1713294978.109415,-18000,,
us.zoom.xos,6,1713294934,1713294940,1713294940.9504728,-18000,,
com.google.Chrome,4,1713294930,1713294934,1713294935.005598,-18000,,
us.zoom.xos,19,1713294911,1713294930,1713294930.253947,-18000,,
com.google.Chrome,1,1713294910,1713294911,1713294911.452269,-18000,,
us.zoom.xos,7,1713294903,1713294910,1713294910.924004,-18000,,
com.google.Chrome,427,1713294476,1713294903,1713294903.785295,-18000,,
us.zoom.xos,2,1713294474,1713294476,1713294476.8371449,-18000,,
com.google.Chrome,108,1713294366,1713294474,1713294474.973094,-18000,,
us.zoom.xos,5,1713294361,1713294366,1713294367.259706,-18000,,
com.apple.Preview,1,1713294360,1713294361,1713294361.990731,-18000,,
com.truebill.truebillnative,100,1713294304,1713294404,1713294404.050142,-18000,EB445137-D7F5-57EC-87DA-1DB460D64046,"iPhone13,2"
com.apple.news,103,1713294163,1713294266,1713294266.59168,-18000,EB445137-D7F5-57EC-87DA-1DB460D64046,"iPhone13,2"
edu.illinois.rokwire.ios,38,1713294112,1713294150,1713294150.961438,-18000,EB445137-D7F5-57EC-87DA-1DB460D64046,"iPhone13,2"
com.microsoft.Office.Outlook,5,1713294102,1713294107,1713294107.1072469,-18000,EB445137-D7F5-57EC-87DA-1DB460D64046,"iPhone13,2"
us.zoom.xos,317,1713294043,1713294360,1713294360.685005,-18000,,
com.google.Chrome,1,1713294042,1713294043,1713294043.087501,-18000,,
us.zoom.xos,1,1713294041,1713294042,1713294042.390847,-18000,,
com.google.Chrome,0,1713294041,1713294041,1713294041.795979,-18000,,
us.zoom.xos,3,1713294038,1713294041,1713294041.414485,-18000,,
com.google.Chrome,45,1713293993,1713294038,1713294038.362441,-18000,,
com.google.Chrome,300,1713293691,1713293991,1713293991.611757,-18000,,
com.microsoft.Office.Outlook,13,1713293401,1713293414,1713293414.68567,-18000,EB445137-D7F5-57EC-87DA-1DB460D64046,"iPhone13,2"
com.google.Chrome,304,1713293379,1713293683,1713293683.458637,-18000,,
com.leomehlig.today,42,1713293337,1713293379,1713293379.178977,-18000,,
com.google.Chrome,19,1713293318,1713293337,1713293337.109385,-18000,,
com.leomehlig.today,21,1713293297,1713293318,1713293318.377686,-18000,,
com.google.Chrome,1,1713293296,1713293297,1713293297.39107,-18000,,
com.leomehlig.today,1,1713293295,1713293296,1713293296.784723,-18000,,
com.google.Chrome,4,1713293291,1713293295,1713293295.380688,-18000,,
com.leomehlig.today,24,1713293267,1713293291,1713293291.554239,-18000,,
com.google.Chrome,143,1713293124,1713293267,1713293267.210388,-18000,,
com.leomehlig.today,12,1713293112,1713293124,1713293124.797604,-18000,,
com.google.Chrome,1634,1713291478,1713293112,1713293112.817847,-18000,,
com.capp.poplive,56,1713291404,1713291460,1713291460.812437,-18000,EB445137-D7F5-57EC-87DA-1DB460D64046,"iPhone13,2"
com.toyopagroup.picaboo,4,1713291397,1713291401,1713291401.689036,-18000,EB445137-D7F5-57EC-87DA-1DB460D64046,"iPhone13,2"
com.toyopagroup.picaboo,8,1713291389,1713291397,1713291397.29826,-18000,EB445137-D7F5-57EC-87DA-1DB460D64046,"iPhone13,2"
com.apple.Music,7,1713291382,1713291389,1713291389.096582,-18000,EB445137-D7F5-57EC-87DA-1DB460D64046,"iPhone13,2"
com.apple.Music,41,1713291340,1713291381,1713291382.0228481,-18000,EB445137-D7F5-57EC-87DA-1DB460D64046,"iPhone13,2"
com.leomehlig.today,169,1713291309,1713291478,1713291478.846281,-18000,,
com.google.Chrome,7,1713291302,1713291309,1713291309.153068,-18000,,
com.leomehlig.today,6,1713291296,1713291302,1713291303.044847,-18000,,
com.google.Chrome,7,1713291289,1713291296,1713291296.77103,-18000,,
com.leomehlig.today,4,1713291285,1713291289,1713291289.636864,-18000,,
com.google.Chrome,6,1713291279,1713291285,1713291285.1372309,-18000,,
com.leomehlig.today,5,1713291274,1713291279,1713291279.524524,-18000,,
com.google.Chrome,62,1713291212,1713291274,1713291274.9415212,-18000,,
com.apple.Preview,8,1713291204,1713291212,1713291212.2179909,-18000,,
com.apple.finder,9,1713291195,1713291204,1713291204.701713,-18000,,
com.apple.archiveutility,0,1713291195,1713291195,1713291195.663512,-18000,,
com.apple.finder,8,1713291187,1713291195,1713291195.361454,-18000,,
com.google.Chrome,52,1713291135,1713291187,1713291187.377295,-18000,,
com.leomehlig.today,31,1713291104,1713291135,1713291135.073257,-18000,,
com.google.Chrome,0,1713291104,1713291104,1713291105.0017471,-18000,,
com.apple.iCal,2,1713291102,1713291104,1713291104.461323,-18000,,
com.google.Chrome,4,1713291098,1713291102,1713291102.540917,-18000,,
com.apple.Music,2,1713290836,1713290838,1713290838.348635,-18000,EB445137-D7F5-57EC-87DA-1DB460D64046,"iPhone13,2"
com.apple.Music,2,1713290653,1713290655,1713290655.656259,-18000,EB445137-D7F5-57EC-87DA-1DB460D64046,"iPhone13,2"
com.microsoft.VSCode,493,1713290605,1713291098,1713291098.84043,-18000,,
com.google.Chrome,1,1713290604,1713290605,1713290605.813342,-18000,,
com.microsoft.VSCode,1,1713290603,1713290604,1713290604.496243,-18000,,
com.google.Chrome,3,1713290600,1713290603,1713290603.535585,-18000,,
com.microsoft.VSCode,10,1713290590,1713290600,1713290601.007769,-18000,,
com.google.Chrome,4,1713290586,1713290590,1713290591.0309172,-18000,,
com.microsoft.VSCode,15,1713290571,1713290586,1713290586.9794111,-18000,,
com.google.Chrome,4,1713290567,1713290571,1713290571.515383,-18000,,
com.microsoft.VSCode,4,1713290563,1713290567,1713290567.54391,-18000,,
com.google.Chrome,26,1713290537,1713290563,1713290563.500255,-18000,,
com.microsoft.VSCode,48,1713290489,1713290537,1713290537.673348,-18000,,
com.google.Chrome,11,1713290478,1713290489,1713290489.680707,-18000,,
com.microsoft.VSCode,6,1713290472,1713290478,1713290478.147347,-18000,,
com.google.Chrome,2,1713290470,1713290472,1713290473.048973,-18000,,
com.microsoft.VSCode,51,1713290419,1713290470,1713290470.639833,-18000,,
com.leomehlig.today,5,1713290414,1713290419,1713290419.339373,-18000,,
com.apple.Music,4,1713290373,1713290377,1713290377.296977,-18000,EB445137-D7F5-57EC-87DA-1DB460D64046,"iPhone13,2"
com.apple.Music,2,1713290263,1713290265,1713290265.315012,-18000,EB445137-D7F5-57EC-87DA-1DB460D64046,"iPhone13,2"
com.apple.Music,5,1713290256,1713290261,1713290261.2248049,-18000,EB445137-D7F5-57EC-87DA-1DB460D64046,"iPhone13,2"
com.apple.Music,14,1713289954,1713289968,1713289968.471346,-18000,EB445137-D7F5-57EC-87DA-1DB460D64046,"iPhone13,2"
com.apple.Music,3,1713289935,1713289938,1713289938.370508,-18000,EB445137-D7F5-57EC-87DA-1DB460D64046,"iPhone13,2"
com.apple.news,0,1713289935,1713289935,1713289936.7158198,-18000,EB445137-D7F5-57EC-87DA-1DB460D64046,"iPhone13,2"
com.apple.news,12,1713289920,1713289932,1713289932.172482,-18000,EB445137-D7F5-57EC-87DA-1DB460D64046,"iPhone13,2"
com.apple.news,4,1713289901,1713289905,1713289905.15935,-18000,EB445137-D7F5-57EC-87DA-1DB460D64046,"iPhone13,2"
com.apple.news,6,1713289770,1713289776,1713289776.502761,-18000,EB445137-D7F5-57EC-87DA-1DB460D64046,"iPhone13,2"
com.apple.news,223,1713289543,1713289766,1713289767.040107,-18000,EB445137-D7F5-57EC-87DA-1DB460D64046,"iPhone13,2"
com.apple.Preferences,143,1713289400,1713289543,1713289543.91413,-18000,EB445137-D7F5-57EC-87DA-1DB460D64046,"iPhone13,2"
com.moodle.moodlemobile,14,1713289385,1713289399,1713289399.813612,-18000,EB445137-D7F5-57EC-87DA-1DB460D64046,"iPhone13,2"
com.google.chrome.ios,3,1713289382,1713289385,1713289385.055012,-18000,EB445137-D7F5-57EC-87DA-1DB460D64046,"iPhone13,2"
com.google.chrome.ios,54,1713289324,1713289378,1713289378.5246248,-18000,EB445137-D7F5-57EC-87DA-1DB460D64046,"iPhone13,2"
com.apple.news,103,1713289221,1713289324,1713289324.447053,-18000,EB445137-D7F5-57EC-87DA-1DB460D64046,"iPhone13,2"
com.moodle.moodlemobile,5,1713289198,1713289203,1713289203.784655,-18000,EB445137-D7F5-57EC-87DA-1DB460D64046,"iPhone13,2"
com.moodle.moodlemobile,86,1713287087,1713287173,1713287173.387742,-18000,EB445137-D7F5-57EC-87DA-1DB460D64046,"iPhone13,2"
com.moodle.moodlemobile,70,1713287011,1713287081,1713287081.611846,-18000,EB445137-D7F5-57EC-87DA-1DB460D64046,"iPhone13,2"
com.apple.Preferences,176,1713286832,1713287008,1713287008.962693,-18000,EB445137-D7F5-57EC-87DA-1DB460D64046,"iPhone13,2"
com.apple.Preferences,2,1713286807,1713286809,1713286809.551698,-18000,EB445137-D7F5-57EC-87DA-1DB460D64046,"iPhone13,2"
com.apple.Preferences,55,1713286751,1713286806,1713286806.60083,-18000,EB445137-D7F5-57EC-87DA-1DB460D64046,"iPhone13,2"
com.apple.mobilecal,4,1713286663,1713286667,1713286667.623786,-18000,EB445137-D7F5-57EC-87DA-1DB460D64046,"iPhone13,2"
com.apple.Music,2,1713286055,1713286057,1713286057.543377,-18000,EB445137-D7F5-57EC-87DA-1DB460D64046,"iPhone13,2"
com.apple.Music,3,1713286050,1713286053,1713286053.116802,-18000,EB445137-D7F5-57EC-87DA-1DB460D64046,"iPhone13,2"
com.leomehlig.today,38,1713285515,1713285553,1713285553.873591,-18000,,
com.microsoft.VSCode,418,1713285097,1713285515,1713285515.947366,-18000,,
com.leomehlig.today,1,1713285096,1713285097,1713285097.066205,-18000,,
com.google.Chrome,21,1713285075,1713285096,1713285096.28951,-18000,,
com.leomehlig.today,1,1713285074,1713285075,1713285075.759376,-18000,,
com.microsoft.VSCode,2,1713285072,1713285074,1713285074.614645,-18000,,
com.leomehlig.today,1,1713285071,1713285072,1713285072.464911,-18000,,
com.google.Chrome,5,1713285066,1713285071,1713285071.680183,-18000,,
com.leomehlig.today,1,1713285065,1713285066,1713285066.9632301,-18000,,
com.microsoft.VSCode,677,1713284388,1713285065,1713285065.801825,-18000,,
com.apple.Health,35,1713284332,1713284367,1713284367.697476,-18000,EB445137-D7F5-57EC-87DA-1DB460D64046,"iPhone13,2"
com.apple.Music,11,1713284309,1713284320,1713284320.6539679,-18000,EB445137-D7F5-57EC-87DA-1DB460D64046,"iPhone13,2"
com.leomehlig.today,83,1713284305,1713284388,1713284388.8899732,-18000,,
com.apple.Music,5,1713284300,1713284305,1713284305.50126,-18000,,
com.toyopagroup.picaboo,15,1713284193,1713284208,1713284208.296112,-18000,EB445137-D7F5-57EC-87DA-1DB460D64046,"iPhone13,2"
com.apple.Preferences,8,1713284172,1713284180,1713284180.248488,-18000,EB445137-D7F5-57EC-87DA-1DB460D64046,"iPhone13,2"
com.microsoft.Office.Outlook,5,1713284160,1713284165,1713284165.016717,-18000,EB445137-D7F5-57EC-87DA-1DB460D64046,"iPhone13,2"
com.leomehlig.today,262,1713284038,1713284300,1713284300.117402,-18000,,
com.microsoft.VSCode,565,1713283473,1713284038,1713284038.858809,-18000,,
com.google.Chrome,122,1713283351,1713283473,1713283473.996829,-18000,,
com.microsoft.VSCode,8,1713283301,1713283309,1713283310.538247,-18000,,
com.leomehlig.today,1,1713283300,1713283301,1713283301.97092,-18000,,
com.google.Chrome,1,1713283299,1713283300,1713283300.252126,-18000,,
com.leomehlig.today,1,1713283298,1713283299,1713283299.617857,-18000,,
com.microsoft.VSCode,122,1713283176,1713283298,1713283298.716126,-18000,,
com.leomehlig.today,4,1713283172,1713283176,1713283176.1008558,-18000,,
com.microsoft.VSCode,3,1713283169,1713283172,1713283172.0933108,-18000,,
com.leomehlig.today,11,1713283158,1713283169,1713283169.242927,-18000,,
com.microsoft.VSCode,321,1713282837,1713283158,1713283159.053378,-18000,,
com.google.Chrome,2,1713282835,1713282837,1713282837.035105,-18000,,
com.microsoft.VSCode,70,1713282765,1713282835,1713282835.519167,-18000,,
com.google.Chrome,0,1713282765,1713282765,1713282765.841085,-18000,,
com.microsoft.VSCode,273,1713282492,1713282765,1713282765.528767,-18000,,
com.google.Chrome,1,1713282491,1713282492,1713282492.640455,-18000,,
com.leomehlig.today,1,1713282490,1713282491,1713282491.2868671,-18000,,
com.microsoft.VSCode,678,1713281812,1713282490,1713282490.156013,-18000,,
com.leomehlig.today,10,1713281802,1713281812,1713281812.8933702,-18000,,
com.microsoft.VSCode,6,1713281796,1713281802,1713281803.030061,-18000,,
com.leomehlig.today,5,1713281791,1713281796,1713281796.9584231,-18000,,
com.microsoft.Office.Outlook,53,1713280731,1713280784,1713280784.8855538,-18000,EB445137-D7F5-57EC-87DA-1DB460D64046,"iPhone13,2"
com.microsoft.VSCode,1146,1713280645,1713281791,1713281791.6013331,-18000,,
com.google.Chrome,236,1713280409,1713280645,1713280645.3966079,-18000,,
com.microsoft.Office.Outlook,189,1713280349,1713280538,1713280538.838914,-18000,EB445137-D7F5-57EC-87DA-1DB460D64046,"iPhone13,2"
com.microsoft.VSCode,72,1713280321,1713280393,1713280393.802201,-18000,,
com.google.Chrome,15,1713280306,1713280321,1713280321.560529,-18000,,
com.leomehlig.today,13,1713280293,1713280306,1713280306.709327,-18000,,
com.google.Chrome,31,1713280262,1713280293,1713280293.257546,-18000,,
com.apple.finder,17,1713280245,1713280262,1713280262.81668,-18000,,
com.google.Chrome,2,1713280243,1713280245,1713280245.4375339,-18000,,
com.apple.Preview,181,1713280062,1713280243,1713280243.524152,-18000,,
com.google.Chrome,5,1713280057,1713280062,1713280062.545234,-18000,,
com.apple.Preview,9,1713280048,1713280057,1713280057.9852982,-18000,,
com.google.Chrome,6,1713280042,1713280048,1713280048.819458,-18000,,
com.leomehlig.today,1,1713280041,1713280042,1713280042.602032,-18000,,
com.google.Chrome,437,1713279604,1713280041,1713280041.0366368,-18000,,
com.apple.Preview,133,1713279471,1713279604,1713279604.5864592,-18000,,
com.google.Chrome,182,1713279289,1713279471,1713279471.553996,-18000,,
com.leomehlig.today,8,1713279281,1713279289,1713279289.700817,-18000,,
com.google.Chrome,21,1713279260,1713279281,1713279281.50309,-18000,,
com.apple.Preview,22,1713279238,1713279260,1713279260.7469192,-18000,,
com.apple.finder,17,1713279221,1713279238,1713279238.092989,-18000,,
com.google.Chrome,3,1713279218,1713279221,1713279221.223562,-18000,,
com.apple.finder,4,1713279214,1713279218,1713279218.964961,-18000,,
com.google.Chrome,6,1713279208,1713279214,1713279214.830381,-18000,,
com.leomehlig.today,17,1713279191,1713279208,1713279208.3911328,-18000,,
com.google.Chrome,1517,1713277674,1713279191,1713279191.342062,-18000,,
com.leomehlig.today,4,1713277659,1713277663,1713277664.314028,-18000,,
com.apple.Preferences,8,1713277623,1713277631,1713277631.2130342,-18000,EB445137-D7F5-57EC-87DA-1DB460D64046,"iPhone13,2"
com.google.chrome.ios,8,1713277432,1713277440,1713277440.8376222,-18000,EB445137-D7F5-57EC-87DA-1DB460D64046,"iPhone13,2"
com.google.chrome.ios,10,1713277410,1713277420,1713277420.63575,-18000,EB445137-D7F5-57EC-87DA-1DB460D64046,"iPhone13,2"
com.google.Chrome,299,1713277360,1713277659,1713277661.802311,-18000,,
com.apple.finder,7,1713277353,1713277360,1713277360.3431191,-18000,,
com.google.chrome.ios,17,1713277345,1713277362,1713277362.783921,-18000,EB445137-D7F5-57EC-87DA-1DB460D64046,"iPhone13,2"
com.google.chrome.ios,51,1713275639,1713275690,1713275690.5896502,-18000,EB445137-D7F5-57EC-87DA-1DB460D64046,"iPhone13,2"
com.apple.Preferences,82,1713275557,1713275639,1713275639.938808,-18000,EB445137-D7F5-57EC-87DA-1DB460D64046,"iPhone13,2"
com.google.chrome.ios,112,1713275338,1713275450,1713275450.628664,-18000,EB445137-D7F5-57EC-87DA-1DB460D64046,"iPhone13,2"
com.apple.Preferences,58,1713275280,1713275338,1713275338.568142,-18000,EB445137-D7F5-57EC-87DA-1DB460D64046,"iPhone13,2"
com.google.chrome.ios,82,1713275198,1713275280,1713275280.289085,-18000,EB445137-D7F5-57EC-87DA-1DB460D64046,"iPhone13,2"
com.apple.Preferences,134,1713275064,1713275198,1713275198.3099442,-18000,EB445137-D7F5-57EC-87DA-1DB460D64046,"iPhone13,2"
com.hulu.plus,73,1713274917,1713274990,1713274990.3934278,-18000,EB445137-D7F5-57EC-87DA-1DB460D64046,"iPhone13,2"
com.toyopagroup.picaboo,21,1713274867,1713274888,1713274888.4186502,-18000,EB445137-D7F5-57EC-87DA-1DB460D64046,"iPhone13,2"
com.apple.journal,411,1713242788,1713243199,1713243199.8756928,-18000,EB445137-D7F5-57EC-87DA-1DB460D64046,"iPhone13,2"
com.apple.Health,20,1713242765,1713242785,1713242785.7935162,-18000,EB445137-D7F5-57EC-87DA-1DB460D64046,"iPhone13,2"
com.thestorygraph.thestorygraph,17,1713242745,1713242762,1713242762.847457,-18000,EB445137-D7F5-57EC-87DA-1DB460D64046,"iPhone13,2"
com.thestorygraph.thestorygraph,13,1713242731,1713242744,1713242744.623985,-18000,EB445137-D7F5-57EC-87DA-1DB460D64046,"iPhone13,2"
com.apple.finder,3,1713240332,1713240335,1713240335.503067,-18000,,
com.google.Chrome,18,1713240314,1713240332,1713240332.589894,-18000,,
com.google.Chrome,371,1713239789,1713240160,1713240160.784343,-18000,,
com.apple.Preferences,22,1713239083,1713239105,1713239105.7918901,-18000,EB445137-D7F5-57EC-87DA-1DB460D64046,"iPhone13,2"
com.apple.Preferences,60,1713239011,1713239071,1713239071.233848,-18000,EB445137-D7F5-57EC-87DA-1DB460D64046,"iPhone13,2"
com.google.Chrome,548,1713238873,1713239421,1713239421.499691,-18000,,
com.apple.Health,47,1713238871,1713238918,1713238918.452275,-18000,EB445137-D7F5-57EC-87DA-1DB460D64046,"iPhone13,2"
com.apple.Preferences,249,1713238620,1713238869,1713238869.2755718,-18000,EB445137-D7F5-57EC-87DA-1DB460D64046,"iPhone13,2"
com.apple.finder,259,1713238614,1713238873,1713238873.607914,-18000,,
com.apple.Terminal,0,1713238614,1713238614,1713238614.570098,-18000,,
com.apple.finder,4,1713238610,1713238614,1713238614.179713,-18000,,
com.apple.reminders,15,1713238595,1713238610,1713238610.3463778,-18000,,
com.apple.finder,2,1713238593,1713238595,1713238595.6445,-18000,,
com.apple.Terminal,1,1713238592,1713238593,1713238593.271618,-18000,,
com.apple.finder,2,1713238590,1713238592,1713238592.883549,-18000,,
com.apple.reminders,27,1713238563,1713238590,1713238590.987372,-18000,,
com.apple.finder,15,1713238548,1713238563,1713238563.878495,-18000,,
com.apple.Terminal,57,1713238491,1713238548,1713238548.098458,-18000,,
com.apple.finder,4,1713238487,1713238491,1713238491.2229528,-18000,,
com.apple.Terminal,3,1713238484,1713238487,1713238487.7944489,-18000,,
com.apple.finder,16,1713238468,1713238484,1713238484.824403,-18000,,
com.google.Chrome,18,1713238450,1713238468,1713238468.3519769,-18000,,
com.microsoft.Outlook,80,1713238370,1713238450,1713238450.554615,-18000,,
com.google.Chrome,5,1713238365,1713238370,1713238370.162795,-18000,,
com.microsoft.Outlook,120,1713238245,1713238365,1713238365.5136561,-18000,,
com.google.Chrome,1,1713238244,1713238245,1713238245.191537,-18000,,
com.microsoft.Outlook,56,1713238188,1713238244,1713238244.416606,-18000,,
com.google.Chrome,119,1713238069,1713238188,1713238188.830302,-18000,,
com.microsoft.Outlook,2,1713238067,1713238069,1713238069.821233,-18000,,
com.google.Chrome,7,1713238060,1713238067,1713238067.0487962,-18000,,
com.microsoft.Outlook,4,1713238056,1713238060,1713238060.782185,-18000,,
com.google.Chrome,31,1713238025,1713238056,1713238057.001076,-18000,,
com.microsoft.Outlook,70,1713237955,1713238025,1713238025.350377,-18000,,
com.google.Chrome,10,1713237945,1713237955,1713237955.8292809,-18000,,
com.microsoft.Outlook,1,1713237944,1713237945,1713237945.6385489,-18000,,
com.google.Chrome,10,1713237934,1713237944,1713237944.884934,-18000,,
com.microsoft.Outlook,1,1713237933,1713237934,1713237934.565783,-18000,,
com.google.Chrome,10,1713237923,1713237933,1713237933.3786268,-18000,,
com.microsoft.Outlook,1,1713237922,1713237923,1713237923.303163,-18000,,
com.google.Chrome,11,1713237911,1713237922,1713237922.332748,-18000,,
com.microsoft.Outlook,1,1713237910,1713237911,1713237911.9768372,-18000,,
com.google.Chrome,10,1713237900,1713237910,1713237910.7719321,-18000,,
com.microsoft.Outlook,2,1713237898,1713237900,1713237900.787871,-18000,,
com.google.Chrome,32,1713237866,1713237898,1713237898.6923618,-18000,,
com.microsoft.Outlook,3,1713237863,1713237866,1713237866.186996,-18000,,
com.google.Chrome,6,1713237857,1713237863,1713237864.042438,-18000,,
com.microsoft.Outlook,3,1713237854,1713237857,1713237857.3210878,-18000,,
com.google.Chrome,2,1713237852,1713237854,1713237854.674501,-18000,,
com.microsoft.Outlook,3,1713237849,1713237852,1713237852.3820682,-18000,,
com.google.Chrome,7,1713237842,1713237849,1713237849.742124,-18000,,
com.microsoft.Outlook,68,1713237774,1713237842,1713237842.981286,-18000,,
com.google.Chrome,6,1713237768,1713237774,1713237774.180731,-18000,,
com.microsoft.Outlook,441,1713237327,1713237768,1713237768.068227,-18000,,
com.google.Chrome,45,1713237282,1713237327,1713237327.465419,-18000,,
com.microsoft.Outlook,4,1713237278,1713237282,1713237283.0149121,-18000,,
com.google.Chrome,1,1713237277,1713237278,1713237278.137147,-18000,,
com.microsoft.Outlook,2,1713237268,1713237270,1713237270.155871,-18000,,
com.apple.finder,1,1713237267,1713237268,1713237268.115145,-18000,,
com.google.Chrome,43,1713237224,1713237267,1713237267.18471,-18000,,
com.apple.finder,1,1713237223,1713237224,1713237225.303783,-18000,,
com.google.Chrome,1,1713237222,1713237223,1713237223.5257711,-18000,,
com.microsoft.Outlook,27,1713237195,1713237222,1713237222.501231,-18000,,
com.google.Chrome,277,1713236918,1713237195,1713237195.561338,-18000,,
com.leomehlig.today,1,1713236917,1713236918,1713236918.344658,-18000,,
com.google.Chrome,11,1713236906,1713236917,1713236917.839232,-18000,,
com.apple.iCal,21,1713236885,1713236906,1713236906.266145,-18000,,
com.google.Chrome,41,1713236844,1713236885,1713236885.850933,-18000,,
com.apple.iCal,4,1713236840,1713236844,1713236844.9154491,-18000,,
com.google.Chrome,32,1713236808,1713236840,1713236840.9111772,-18000,,
com.apple.iCal,2,1713236806,1713236808,1713236808.3598871,-18000,,
com.apple.MobileSMS,2,1713236804,1713236806,1713236806.921865,-18000,,
com.apple.iCal,8,1713236796,1713236804,1713236804.71345,-18000,,
com.apple.MobileSMS,17,1713236779,1713236796,1713236796.825774,-18000,,
com.apple.iCal,27,1713236752,1713236779,1713236779.60498,-18000,,
com.apple.MobileSMS,9,1713236743,1713236752,1713236752.548857,-18000,,
com.leomehlig.today,64,1713236679,1713236743,1713236743.825091,-18000,,
com.google.Chrome,585,1713236094,1713236679,1713236679.946706,-18000,,
com.leomehlig.today,2,1713236092,1713236094,1713236094.620163,-18000,,
com.apple.mobilephone,15,1713235974,1713235989,1713235989.709395,-18000,EB445137-D7F5-57EC-87DA-1DB460D64046,"iPhone13,2"
com.toyopagroup.picaboo,4,1713235943,1713235947,1713235947.7202559,-18000,EB445137-D7F5-57EC-87DA-1DB460D64046,"iPhone13,2"
com.toyopagroup.picaboo,10,1713235920,1713235930,1713235930.338083,-18000,EB445137-D7F5-57EC-87DA-1DB460D64046,"iPhone13,2"
com.google.Chrome,681,1713235411,1713236092,1713236092.9874191,-18000,,
com.leomehlig.today,11,1713235400,1713235411,1713235411.860332,-18000,,
com.toyopagroup.picaboo,25,1713234745,1713234770,1713234770.094682,-18000,EB445137-D7F5-57EC-87DA-1DB460D64046,"iPhone13,2"
com.capp.poplive,4,1713234741,1713234745,1713234745.500848,-18000,EB445137-D7F5-57EC-87DA-1DB460D64046,"iPhone13,2"
com.google.Chrome,729,1713234671,1713235400,1713235400.0666862,-18000,,
com.leomehlig.today,6,1713234649,1713234655,1713234656.4583921,-18000,,
com.google.Chrome,3,1713234646,1713234649,1713234649.659029,-18000,,
com.capp.poplive,47,1713234550,1713234597,1713234597.4592109,-18000,EB445137-D7F5-57EC-87DA-1DB460D64046,"iPhone13,2"
com.apple.camera,0,1713230686,1713230686,1713230686.6480088,-18000,EB445137-D7F5-57EC-87DA-1DB460D64046,"iPhone13,2"
com.google.Chrome,235,1713230240,1713230475,1713230475.66817,-18000,,
com.leomehlig.today,6,1713230234,1713230240,1713230240.137425,-18000,,
com.google.Chrome,15,1713230219,1713230234,1713230234.656431,-18000,,
com.google.Chrome,16,1713229832,1713229848,1713229848.699023,-18000,,
com.apple.MobileSMS,3,1713229788,1713229791,1713229791.700825,-18000,,
com.google.Chrome,3,1713229785,1713229788,1713229788.862311,-18000,,
com.leomehlig.today,45,1713229740,1713229785,1713229785.140369,-18000,,
com.hammerandchisel.discord,27,1713229142,1713229169,1713229169.070219,-18000,EB445137-D7F5-57EC-87DA-1DB460D64046,"iPhone13,2"
com.hammerandchisel.discord,9,1713229130,1713229139,1713229139.9765902,-18000,EB445137-D7F5-57EC-87DA-1DB460D64046,"iPhone13,2"
com.hammerandchisel.discord,5,1713228827,1713228832,1713228832.344438,-18000,EB445137-D7F5-57EC-87DA-1DB460D64046,"iPhone13,2"
com.leomehlig.today,81,1713227981,1713228062,1713228062.381108,-18000,,
com.google.Chrome,58,1713227923,1713227981,1713227981.814847,-18000,,
com.leomehlig.today,4,1713227919,1713227923,1713227923.86279,-18000,,
com.google.Chrome,627,1713227292,1713227919,1713227919.3461761,-18000,,
com.leomehlig.today,7,1713227285,1713227292,1713227292.639976,-18000,,
com.google.Chrome,1339,1713225946,1713227285,1713227285.498771,-18000,,
com.leomehlig.today,9,1713225937,1713225946,1713225946.7450309,-18000,,
com.google.Chrome,517,1713225420,1713225937,1713225937.713279,-18000,,
com.leomehlig.today,32,1713225388,1713225420,1713225420.920202,-18000,,
com.google.Chrome,373,1713225015,1713225388,1713225388.18928,-18000,,
com.leomehlig.today,48,1713224967,1713225015,1713225015.095238,-18000,,
com.google.Chrome,1315,1713223652,1713224967,1713224967.216886,-18000,,
com.apple.camera,1,1713222118,1713222119,1713222119.047051,-18000,EB445137-D7F5-57EC-87DA-1DB460D64046,"iPhone13,2"
com.facebook.Facebook,33,1713221121,1713221154,1713221154.984743,-18000,EB445137-D7F5-57EC-87DA-1DB460D64046,"iPhone13,2"
com.facebook.Facebook,35,1713220502,1713220537,1713220537.441652,-18000,EB445137-D7F5-57EC-87DA-1DB460D64046,"iPhone13,2"
com.facebook.Facebook,6,1713219930,1713219936,1713219936.394909,-18000,EB445137-D7F5-57EC-87DA-1DB460D64046,"iPhone13,2"
com.facebook.Facebook,6,1713219805,1713219811,1713219811.080533,-18000,EB445137-D7F5-57EC-87DA-1DB460D64046,"iPhone13,2"
com.facebook.Facebook,102,1713219682,1713219784,1713219784.251814,-18000,EB445137-D7F5-57EC-87DA-1DB460D64046,"iPhone13,2"
com.google.Chrome,7,1713215999,1713216006,1713216007.01265,-18000,,
com.leomehlig.today,194,1713215805,1713215999,1713215999.13169,-18000,,
com.google.Chrome,774,1713215031,1713215805,1713215805.6008,-18000,,
com.google.Chrome,310,1713214321,1713214631,1713214631.306264,-18000,,
com.leomehlig.today,2,1713214319,1713214321,1713214321.898376,-18000,,
com.google.Chrome,631,1713213688,1713214319,1713214319.375558,-18000,,
com.leomehlig.today,33,1713213655,1713213688,1713213688.09089,-18000,,
com.google.Chrome,1243,1713212412,1713213655,1713213655.578141,-18000,,
com.leomehlig.today,3,1713212409,1713212412,1713212412.372791,-18000,,
com.google.Chrome,618,1713211791,1713212409,1713212409.204421,-18000,,
edu.illinois.rokwire.ios,64,1713211107,1713211171,1713211171.322588,-18000,EB445137-D7F5-57EC-87DA-1DB460D64046,"iPhone13,2"
com.instructure.icanvas,9,1713211094,1713211103,1713211103.242824,-18000,EB445137-D7F5-57EC-87DA-1DB460D64046,"iPhone13,2"
com.google.Chrome,325,1713211005,1713211330,1713211330.16524,-18000,,
com.google.Chrome,308,1713209694,1713210002,1713210002.29466,-18000,,
com.google.Chrome,345,1713209265,1713209610,1713209610.9321089,-18000,,
com.google.Chrome,434,1713208664,1713209098,1713209098.227483,-18000,,
com.leomehlig.today,15,1713208649,1713208664,1713208664.5133948,-18000,,
com.google.Chrome,79,1713208570,1713208649,1713208649.265564,-18000,,
com.instructure.icanvas,2,1713208447,1713208449,1713208449.234879,-18000,EB445137-D7F5-57EC-87DA-1DB460D64046,"iPhone13,2"
com.instructure.icanvas,10,1713208377,1713208387,1713208387.773796,-18000,EB445137-D7F5-57EC-87DA-1DB460D64046,"iPhone13,2"
com.instructure.icanvas,7,1713208280,1713208287,1713208287.009304,-18000,EB445137-D7F5-57EC-87DA-1DB460D64046,"iPhone13,2"
com.instructure.icanvas,2,1713208278,1713208280,1713208280.499968,-18000,EB445137-D7F5-57EC-87DA-1DB460D64046,"iPhone13,2"
com.instructure.icanvas,2,1713208276,1713208278,1713208278.26073,-18000,EB445137-D7F5-57EC-87DA-1DB460D64046,"iPhone13,2"
com.instructure.icanvas,2,1713208082,1713208084,1713208084.698866,-18000,EB445137-D7F5-57EC-87DA-1DB460D64046,"iPhone13,2"
com.instructure.icanvas,3,1713207798,1713207801,1713207801.181058,-18000,EB445137-D7F5-57EC-87DA-1DB460D64046,"iPhone13,2"
com.instructure.icanvas,2,1713207794,1713207796,1713207796.124566,-18000,EB445137-D7F5-57EC-87DA-1DB460D64046,"iPhone13,2"
com.instructure.icanvas,8,1713207591,1713207599,1713207599.671245,-18000,EB445137-D7F5-57EC-87DA-1DB460D64046,"iPhone13,2"
com.instructure.icanvas,37,1713207356,1713207393,1713207393.6653109,-18000,EB445137-D7F5-57EC-87DA-1DB460D64046,"iPhone13,2"
com.google.Chrome,56,1713203849,1713203905,1713203905.542551,-18000,,
com.leomehlig.today,41,1713203808,1713203849,1713203849.678115,-18000,,
com.google.Chrome,591,1713203217,1713203808,1713203809.007302,-18000,,
com.apple.MobileSMS,4,1713203213,1713203217,1713203217.5368981,-18000,,
com.google.Chrome,45,1713203168,1713203213,1713203213.2836561,-18000,,
com.leomehlig.today,54,1713203114,1713203168,1713203168.191838,-18000,,
com.google.Chrome,2,1713203112,1713203114,1713203114.854738,-18000,,
com.leomehlig.today,20,1713203092,1713203112,1713203112.3100948,-18000,,
com.apple.MobileSMS,12,1713202607,1713202619,1713202619.6575232,-18000,EB445137-D7F5-57EC-87DA-1DB460D64046,"iPhone13,2"
com.google.Chrome,513,1713202579,1713203092,1713203092.239227,-18000,,
com.leomehlig.today,25,1713202554,1713202579,1713202579.301597,-18000,,
com.google.Chrome,2,1713202552,1713202554,1713202554.459262,-18000,,
com.google.Chrome,318,1713201898,1713202216,1713202216.2740421,-18000,,
com.hammerandchisel.discord,5,1713199368,1713199373,1713199373.009924,-18000,EB445137-D7F5-57EC-87DA-1DB460D64046,"iPhone13,2"
com.hammerandchisel.discord,99,1713199268,1713199367,1713199367.997027,-18000,EB445137-D7F5-57EC-87DA-1DB460D64046,"iPhone13,2"
com.thestorygraph.thestorygraph,15,1713199247,1713199262,1713199263.063695,-18000,EB445137-D7F5-57EC-87DA-1DB460D64046,"iPhone13,2"
edu.illinois.rokwire.ios,36,1713199207,1713199243,1713199243.049652,-18000,EB445137-D7F5-57EC-87DA-1DB460D64046,"iPhone13,2"
com.microsoft.Office.Outlook,10,1713199193,1713199203,1713199203.326164,-18000,EB445137-D7F5-57EC-87DA-1DB460D64046,"iPhone13,2"
com.apple.MobileSMS,3,1713199188,1713199191,1713199191.7331262,-18000,EB445137-D7F5-57EC-87DA-1DB460D64046,"iPhone13,2"
com.microsoft.Office.Outlook,4,1713199184,1713199188,1713199189.401458,-18000,EB445137-D7F5-57EC-87DA-1DB460D64046,"iPhone13,2"
com.microsoft.Office.Outlook,166,1713198113,1713198279,1713198279.774355,-18000,EB445137-D7F5-57EC-87DA-1DB460D64046,"iPhone13,2"
com.microsoft.Office.Outlook,31,1713198061,1713198092,1713198092.381541,-18000,EB445137-D7F5-57EC-87DA-1DB460D64046,"iPhone13,2"
com.microsoft.Office.Outlook,22,1713198039,1713198061,1713198061.291481,-18000,EB445137-D7F5-57EC-87DA-1DB460D64046,"iPhone13,2"
com.apple.mobilecal,30,1713197020,1713197050,1713197050.823587,-18000,EB445137-D7F5-57EC-87DA-1DB460D64046,"iPhone13,2"
com.google.Chrome,74,1713196933,1713197007,1713197007.601263,-18000,,
com.apple.finder,65,1713196868,1713196933,1713196933.6873798,-18000,,
com.google.Chrome,11,1713196857,1713196868,1713196868.5421782,-18000,,
com.apple.finder,24,1713196833,1713196857,1713196857.61474,-18000,,
com.apple.archiveutility,1,1713196832,1713196833,1713196833.175181,-18000,,
com.apple.finder,3,1713196829,1713196832,1713196832.876103,-18000,,
com.apple.archiveutility,0,1713196829,1713196829,1713196829.4593391,-18000,,
com.apple.finder,9,1713196820,1713196829,1713196829.187952,-18000,,
com.google.Chrome,6,1713196814,1713196820,1713196820.100275,-18000,,
com.apple.finder,37,1713196777,1713196814,1713196814.441465,-18000,,
com.google.Chrome,12,1713196765,1713196777,1713196777.41328,-18000,,
com.apple.finder,1,1713196764,1713196765,1713196766.004924,-18000,,
com.google.Chrome,12,1713196752,1713196764,1713196764.605176,-18000,,
com.apple.finder,4,1713196748,1713196752,1713196752.929421,-18000,,
com.google.Chrome,1,1713196747,1713196748,1713196748.654553,-18000,,
com.leomehlig.today,7,1713196740,1713196747,1713196747.51601,-18000,,
com.google.Chrome,34,1713196706,1713196740,1713196740.902423,-18000,,
com.leomehlig.today,59,1713196647,1713196706,1713196706.788876,-18000,,
com.google.Chrome,87,1713196560,1713196647,1713196648.036532,-18000,,
com.leomehlig.today,79,1713196481,1713196560,1713196560.843793,-18000,,
com.google.Chrome,6,1713196475,1713196481,1713196481.997179,-18000,,
com.microsoft.Office.Outlook,17,1713196401,1713196418,1713196418.387127,-18000,EB445137-D7F5-57EC-87DA-1DB460D64046,"iPhone13,2"
com.apple.MobileSMS,5,1713196395,1713196400,1713196400.786552,-18000,EB445137-D7F5-57EC-87DA-1DB460D64046,"iPhone13,2"
com.apple.mobilecal,7,1713196388,1713196395,1713196395.891407,-18000,EB445137-D7F5-57EC-87DA-1DB460D64046,"iPhone13,2"
com.apple.MobileSMS,11,1713196331,1713196342,1713196342.0931711,-18000,EB445137-D7F5-57EC-87DA-1DB460D64046,"iPhone13,2"
com.apple.Music,1,1713196330,1713196331,1713196331.598367,-18000,EB445137-D7F5-57EC-87DA-1DB460D64046,"iPhone13,2"
com.apple.Music,5,1713196045,1713196050,1713196050.9748778,-18000,EB445137-D7F5-57EC-87DA-1DB460D64046,"iPhone13,2"
com.apple.Music,9,1713195712,1713195721,1713195721.8567681,-18000,EB445137-D7F5-57EC-87DA-1DB460D64046,"iPhone13,2"
com.apple.Music,2,1713195216,1713195218,1713195218.404639,-18000,EB445137-D7F5-57EC-87DA-1DB460D64046,"iPhone13,2"
com.apple.Music,4,1713195021,1713195025,1713195025.055697,-18000,EB445137-D7F5-57EC-87DA-1DB460D64046,"iPhone13,2"
com.apple.Music,12,1713194828,1713194840,1713194840.719005,-18000,EB445137-D7F5-57EC-87DA-1DB460D64046,"iPhone13,2"
com.apple.Music,5,1713194821,1713194826,1713194826.752228,-18000,EB445137-D7F5-57EC-87DA-1DB460D64046,"iPhone13,2"
com.apple.weather,5,1713194814,1713194819,1713194819.920877,-18000,EB445137-D7F5-57EC-87DA-1DB460D64046,"iPhone13,2"
com.google.Chrome,258,1713194385,1713194643,1713194643.717598,-18000,,
com.leomehlig.today,21,1713194364,1713194385,1713194385.605766,-18000,,
com.google.Chrome,185,1713194179,1713194364,1713194364.888444,-18000,,
com.microsoft.Powerpoint,217,1713193962,1713194179,1713194179.2478719,-18000,,
com.google.Chrome,931,1713193031,1713193962,1713193962.982184,-18000,,
com.apple.weather,8,1713192973,1713192981,1713192981.693232,-18000,EB445137-D7F5-57EC-87DA-1DB460D64046,"iPhone13,2"
com.microsoft.Powerpoint,568,1713192463,1713193031,1713193031.645063,-18000,,
com.google.Chrome,340,1713192123,1713192463,1713192463.602998,-18000,,
com.leomehlig.today,14,1713192092,1713192106,1713192108.2691422,-18000,,
com.apple.weather,6,1713192081,1713192087,1713192087.261969,-18000,EB445137-D7F5-57EC-87DA-1DB460D64046,"iPhone13,2"
com.apple.Health,61,1713192016,1713192077,1713192077.844552,-18000,EB445137-D7F5-57EC-87DA-1DB460D64046,"iPhone13,2"
com.toyopagroup.picaboo,13,1713192000,1713192013,1713192013.860126,-18000,EB445137-D7F5-57EC-87DA-1DB460D64046,"iPhone13,2"
com.apple.MobileSMS,3,1713191995,1713191998,1713191998.43309,-18000,EB445137-D7F5-57EC-87DA-1DB460D64046,"iPhone13,2"
com.google.Chrome,151,1713191941,1713192092,1713192092.0858421,-18000,,
com.hulu.plus,1389,1713188413,1713189802,1713189802.724784,-18000,EB445137-D7F5-57EC-87DA-1DB460D64046,"iPhone13,2"
com.google.Chrome,264,1713154602,1713154866,1713154866.704433,-18000,,
com.google.Chrome,1004,1713153517,1713154521,1713154521.933068,-18000,,
com.apple.finder,11,1713153506,1713153517,1713153517.793686,-18000,,
com.apple.finder,4,1713150263,1713150267,1713150267.37878,-18000,,
com.apple.MobileSMS,3,1713150260,1713150263,1713150263.112853,-18000,,
com.apple.finder,7,1713150253,1713150260,1713150260.212235,-18000,,
com.hnc.Discord,33,1713150220,1713150253,1713150253.136352,-18000,,
com.google.Chrome,4,1713150216,1713150220,1713150220.301678,-18000,,
com.leomehlig.today,83,1713150133,1713150216,1713150216.573032,-18000,,
com.google.Chrome,15,1713150118,1713150133,1713150133.413203,-18000,,
com.leomehlig.today,39,1713150079,1713150118,1713150118.36403,-18000,,
com.google.Chrome,474,1713149605,1713150079,1713150079.832864,-18000,,
com.leomehlig.today,5,1713149600,1713149605,1713149605.898759,-18000,,
com.apple.Preview,1236,1713148364,1713149600,1713149601.0315142,-18000,,
com.leomehlig.today,1,1713148363,1713148364,1713148364.6035829,-18000,,
com.google.Chrome,2,1713148361,1713148363,1713148363.086283,-18000,,
com.apple.Photos,2,1713148359,1713148361,1713148362.0264149,-18000,,
com.google.Chrome,3,1713148356,1713148359,1713148360.046006,-18000,,
com.apple.MobileSMS,10,1713148346,1713148356,1713148356.850981,-18000,,
com.google.Chrome,98,1713148248,1713148346,1713148346.981851,-18000,,
com.apple.MobileSMS,29,1713148219,1713148248,1713148248.6510901,-18000,,
com.apple.Preview,11,1713148208,1713148219,1713148219.250129,-18000,,
com.google.Chrome,77,1713148131,1713148208,1713148208.993483,-18000,,
com.apple.finder,1,1713148130,1713148131,1713148131.785143,-18000,,
com.apple.Photos,5,1713148125,1713148130,1713148130.785764,-18000,,
com.apple.finder,1,1713148124,1713148125,1713148125.8295388,-18000,,
com.apple.Photos,3,1713148121,1713148124,1713148124.273185,-18000,,
com.apple.finder,2,1713148119,1713148121,1713148121.13375,-18000,,
com.google.Chrome,22,1713148097,1713148119,1713148119.874545,-18000,,
com.apple.Photos,5,1713148092,1713148097,1713148097.4143372,-18000,,
com.google.Chrome,1,1713148091,1713148092,1713148092.945281,-18000,,
com.apple.Photos,44,1713148047,1713148091,1713148092.043075,-18000,,
com.google.Chrome,32,1713148015,1713148047,1713148047.274966,-18000,,
com.apple.Preview,91,1713147924,1713148015,1713148015.483696,-18000,,
com.google.Chrome,46,1713147878,1713147924,1713147924.469635,-18000,,
com.apple.Preview,667,1713147211,1713147878,1713147878.2292361,-18000,,
com.google.Chrome,16,1713147195,1713147211,1713147211.2696939,-18000,,
com.apple.Preview,17,1713147178,1713147195,1713147195.4624538,-18000,,
com.leomehlig.today,26,1713147152,1713147178,1713147178.33336,-18000,,
com.google.Chrome,4,1713147148,1713147152,1713147152.359527,-18000,,
com.apple.iCal,235,1713146913,1713147148,1713147148.150406,-18000,,
com.google.Chrome,16,1713146897,1713146913,1713146913.272676,-18000,,
com.apple.Preview,19,1713146878,1713146897,1713146897.5368729,-18000,,
com.google.Chrome,2,1713146876,1713146878,1713146878.167023,-18000,,
com.apple.Preview,27,1713146849,1713146876,1713146876.613256,-18000,,
com.google.Chrome,14,1713146835,1713146849,1713146849.713091,-18000,,
com.apple.Preview,101,1713146734,1713146835,1713146835.544002,-18000,,
com.google.Chrome,228,1713146506,1713146734,1713146734.846833,-18000,,
com.apple.Preview,18,1713146488,1713146506,1713146506.059377,-18000,,
com.google.Chrome,2,1713146486,1713146488,1713146488.2398682,-18000,,
com.hnc.Discord,0,1713146486,1713146486,1713146486.776037,-18000,,
com.google.Chrome,151,1713146335,1713146486,1713146486.200656,-18000,,
com.hnc.Discord,9,1713146326,1713146335,1713146335.2872128,-18000,,
com.apple.Preview,9,1713146317,1713146326,1713146326.504888,-18000,,
com.hnc.Discord,58,1713146259,1713146317,1713146317.244838,-18000,,
com.apple.Preview,78,1713146181,1713146259,1713146259.926865,-18000,,
com.google.Chrome,10,1713146171,1713146181,1713146181.713478,-18000,,
com.apple.Preview,151,1713146020,1713146171,1713146171.44661,-18000,,
com.google.Chrome,3,1713146017,1713146020,1713146020.631229,-18000,,
com.apple.Preview,21,1713145996,1713146017,1713146017.846945,-18000,,
com.google.Chrome,69,1713145927,1713145996,1713145996.235275,-18000,,
com.leomehlig.today,28,1713145899,1713145927,1713145927.744893,-18000,,
com.google.Chrome,424,1713145475,1713145899,1713145899.219898,-18000,,
com.apple.Preview,1,1713145474,1713145475,1713145475.193831,-18000,,
com.google.Chrome,1091,1713144383,1713145474,1713145474.238803,-18000,,
com.apple.Preview,1,1713144382,1713144383,1713144383.531306,-18000,,
com.google.Chrome,243,1713144139,1713144382,1713144382.429841,-18000,,
com.apple.Preview,2,1713144137,1713144139,1713144139.091357,-18000,,
com.google.Chrome,1,1713144136,1713144137,1713144137.791893,-18000,,
com.apple.Preview,2,1713144134,1713144136,1713144136.5768142,-18000,,
com.google.Chrome,1,1713144133,1713144134,1713144134.7952042,-18000,,
com.apple.Preview,1,1713144132,1713144133,1713144133.725764,-18000,,
com.google.Chrome,2,1713144130,1713144132,1713144132.4565768,-18000,,
com.apple.Preview,2,1713144128,1713144130,1713144130.886354,-18000,,
com.google.Chrome,2,1713144126,1713144128,1713144128.7900171,-18000,,
com.apple.Preview,1,1713144125,1713144126,1713144126.657411,-18000,,
com.google.Chrome,1,1713144124,1713144125,1713144125.5943651,-18000,,
com.apple.Preview,1,1713144123,1713144124,1713144124.6520991,-18000,,
com.google.Chrome,1,1713144122,1713144123,1713144123.562257,-18000,,
com.apple.Preview,1,1713144121,1713144122,1713144122.6494222,-18000,,
com.google.Chrome,1,1713144120,1713144121,1713144121.742836,-18000,,
com.apple.Preview,1,1713144119,1713144120,1713144120.909409,-18000,,
com.google.Chrome,0,1713144119,1713144119,1713144120.033235,-18000,,
com.apple.Preview,3,1713144116,1713144119,1713144119.272314,-18000,,
com.google.Chrome,2,1713144114,1713144116,1713144116.9612079,-18000,,
com.apple.Preview,2,1713144112,1713144114,1713144114.639718,-18000,,
com.google.Chrome,88,1713144024,1713144112,1713144112.623044,-18000,,
com.apple.Preview,2,1713144022,1713144024,1713144024.751638,-18000,,
com.google.Chrome,2,1713144020,1713144022,1713144022.742043,-18000,,
com.apple.Preview,3,1713144017,1713144020,1713144020.1765661,-18000,,
com.google.Chrome,6,1713144011,1713144017,1713144017.9201632,-18000,,
com.apple.Preview,28,1713143983,1713144011,1713144011.659573,-18000,,
com.google.Chrome,54,1713143929,1713143983,1713143983.185637,-18000,,
com.leomehlig.today,12,1713143917,1713143929,1713143929.8074322,-18000,,
com.google.Chrome,15,1713143902,1713143917,1713143917.9824119,-18000,,
com.google.Chrome,305,1713143593,1713143898,1713143898.960184,-18000,,
com.apple.Preview,93,1713143500,1713143593,1713143593.8194451,-18000,,
com.google.Chrome,52,1713143448,1713143500,1713143500.3194041,-18000,,
com.apple.Preview,54,1713143394,1713143448,1713143448.122655,-18000,,
com.google.Chrome,741,1713142653,1713143394,1713143394.457501,-18000,,
com.google.Chrome,533,1713142120,1713142653,1713142653.098598,-18000,,
com.hnc.Discord,48,1713142072,1713142120,1713142120.281774,-18000,,
com.google.Chrome,140,1713141932,1713142072,1713142072.7263799,-18000,,
com.leomehlig.today,19,1713141913,1713141932,1713141932.636159,-18000,,
com.google.Chrome,82,1713141831,1713141913,1713141913.196847,-18000,,
com.google.Chrome,161,1713138350,1713138511,1713138511.95183,-18000,,
com.apple.MobileSMS,43,1713138307,1713138350,1713138350.551564,-18000,,
com.leomehlig.today,27,1713138280,1713138307,1713138307.771469,-18000,,
com.google.Chrome,16,1713138264,1713138280,1713138280.410656,-18000,,
com.leomehlig.today,5,1713138259,1713138264,1713138264.529325,-18000,,
com.google.Chrome,2,1713138257,1713138259,1713138259.285173,-18000,,
com.leomehlig.today,9,1713138248,1713138257,1713138257.252276,-18000,,
com.google.Chrome,28,1713138220,1713138248,1713138248.738935,-18000,,
com.leomehlig.today,79,1713138141,1713138220,1713138220.954557,-18000,,
com.google.Chrome,5,1713138136,1713138141,1713138141.802332,-18000,,
com.leomehlig.today,16,1713138120,1713138136,1713138136.0596519,-18000,,
com.google.Chrome,5,1713138115,1713138120,1713138120.753648,-18000,,
com.leomehlig.today,6,1713138109,1713138115,1713138115.185075,-18000,,
com.google.Chrome,2,1713138107,1713138109,1713138109.646628,-18000,,
com.leomehlig.today,15,1713138092,1713138107,1713138107.119123,-18000,,
com.google.Chrome,8,1713138084,1713138092,1713138092.063025,-18000,,
com.leomehlig.today,3,1713138081,1713138084,1713138084.3908129,-18000,,
com.google.Chrome,9,1713138072,1713138081,1713138081.778789,-18000,,
com.leomehlig.today,12,1713138060,1713138072,1713138073.029365,-18000,,
com.google.Chrome,2,1713138058,1713138060,1713138060.4219599,-18000,,
com.leomehlig.today,8,1713138050,1713138058,1713138058.941197,-18000,,
com.google.Chrome,9,1713138041,1713138050,1713138050.634032,-18000,,
com.leomehlig.today,1,1713138040,1713138041,1713138042.039995,-18000,,
com.google.Chrome,15,1713138025,1713138040,1713138040.514123,-18000,,
com.apple.iCal,51,1713137974,1713138025,1713138025.091836,-18000,,
com.leomehlig.today,159,1713137815,1713137974,1713137974.135406,-18000,,
com.google.Chrome,12,1713137803,1713137815,1713137815.879305,-18000,,
com.apple.PosterBoard,0,1713132348,1713132348,1713132348.874466,-18000,EB445137-D7F5-57EC-87DA-1DB460D64046,"iPhone13,2"
com.apple.Maps,12,1713132345,1713132357,1713132357.825252,-18000,EB445137-D7F5-57EC-87DA-1DB460D64046,"iPhone13,2"
com.apple.camera,0,1713129649,1713129649,1713129649.942251,-18000,EB445137-D7F5-57EC-87DA-1DB460D64046,"iPhone13,2"
com.apple.Maps,15,1713129648,1713129663,1713129663.921552,-18000,EB445137-D7F5-57EC-87DA-1DB460D64046,"iPhone13,2"
com.apple.Maps,20,1713129625,1713129645,1713129645.586154,-18000,EB445137-D7F5-57EC-87DA-1DB460D64046,"iPhone13,2"
com.hulu.plus,3,1713129620,1713129623,1713129623.503118,-18000,EB445137-D7F5-57EC-87DA-1DB460D64046,"iPhone13,2"
com.hulu.plus,4,1713129603,1713129607,1713129607.517733,-18000,EB445137-D7F5-57EC-87DA-1DB460D64046,"iPhone13,2"
com.apple.MobileSMS,11,1713129592,1713129603,1713129603.843107,-18000,EB445137-D7F5-57EC-87DA-1DB460D64046,"iPhone13,2"
com.hulu.plus,3008,1713126584,1713129592,1713129592.079639,-18000,EB445137-D7F5-57EC-87DA-1DB460D64046,"iPhone13,2"
com.apple.Maps,13,1713126529,1713126542,1713126542.4765658,-18000,EB445137-D7F5-57EC-87DA-1DB460D64046,"iPhone13,2"
com.apple.MobileSMS,2,1713126525,1713126527,1713126527.987084,-18000,EB445137-D7F5-57EC-87DA-1DB460D64046,"iPhone13,2"
com.microsoft.Office.Outlook,6,1713126516,1713126522,1713126522.594561,-18000,EB445137-D7F5-57EC-87DA-1DB460D64046,"iPhone13,2"
com.microsoft.Office.Outlook,1,1713126435,1713126436,1713126436.755522,-18000,EB445137-D7F5-57EC-87DA-1DB460D64046,"iPhone13,2"
com.microsoft.Office.Outlook,120,1713125839,1713125959,1713125959.209564,-18000,EB445137-D7F5-57EC-87DA-1DB460D64046,"iPhone13,2"
com.apple.MobileSMS,2,1713125837,1713125839,1713125839.8973699,-18000,EB445137-D7F5-57EC-87DA-1DB460D64046,"iPhone13,2"
com.google.chrome.ios,4,1713125833,1713125837,1713125837.9008222,-18000,EB445137-D7F5-57EC-87DA-1DB460D64046,"iPhone13,2"
com.google.chrome.ios,29,1713125313,1713125342,1713125342.3266249,-18000,EB445137-D7F5-57EC-87DA-1DB460D64046,"iPhone13,2"
com.google.chrome.ios,6,1713125277,1713125283,1713125283.552167,-18000,EB445137-D7F5-57EC-87DA-1DB460D64046,"iPhone13,2"
com.apple.MobileSMS,3,1713125274,1713125277,1713125277.3789759,-18000,EB445137-D7F5-57EC-87DA-1DB460D64046,"iPhone13,2"
com.apple.MobileSMS,10,1713125170,1713125180,1713125180.248615,-18000,EB445137-D7F5-57EC-87DA-1DB460D64046,"iPhone13,2"
com.apple.MobileSMS,10,1713125114,1713125124,1713125124.914184,-18000,EB445137-D7F5-57EC-87DA-1DB460D64046,"iPhone13,2"
com.apple.MobileSMS,29,1713124726,1713124755,1713124755.34043,-18000,EB445137-D7F5-57EC-87DA-1DB460D64046,"iPhone13,2"
com.apple.MobileSMS,10,1713124715,1713124725,1713124725.740539,-18000,EB445137-D7F5-57EC-87DA-1DB460D64046,"iPhone13,2"
com.apple.MobileSMS,31,1713124664,1713124695,1713124695.937259,-18000,EB445137-D7F5-57EC-87DA-1DB460D64046,"iPhone13,2"
com.apple.MobileSMS,43,1713124435,1713124478,1713124478.919368,-18000,EB445137-D7F5-57EC-87DA-1DB460D64046,"iPhone13,2"
com.google.chrome.ios,3,1713124432,1713124435,1713124435.121278,-18000,EB445137-D7F5-57EC-87DA-1DB460D64046,"iPhone13,2"
com.google.chrome.ios,17,1713124372,1713124389,1713124390.0693521,-18000,EB445137-D7F5-57EC-87DA-1DB460D64046,"iPhone13,2"
com.google.Gmail,14,1713124358,1713124372,1713124372.864606,-18000,EB445137-D7F5-57EC-87DA-1DB460D64046,"iPhone13,2"
com.apple.Maps,5,1713124344,1713124349,1713124349.5675402,-18000,EB445137-D7F5-57EC-87DA-1DB460D64046,"iPhone13,2"
com.apple.Maps,10,1713122967,1713122977,1713122977.4398398,-18000,EB445137-D7F5-57EC-87DA-1DB460D64046,"iPhone13,2"
com.apple.Maps,128,1713122240,1713122368,1713122368.459651,-18000,EB445137-D7F5-57EC-87DA-1DB460D64046,"iPhone13,2"
com.apple.findmy,3,1713122237,1713122240,1713122240.659508,-18000,EB445137-D7F5-57EC-87DA-1DB460D64046,"iPhone13,2"
com.apple.findmy,4,1713122201,1713122205,1713122206.041627,-18000,EB445137-D7F5-57EC-87DA-1DB460D64046,"iPhone13,2"
com.apple.findmy,4,1713121286,1713121290,1713121290.726033,-18000,EB445137-D7F5-57EC-87DA-1DB460D64046,"iPhone13,2"
com.apple.findmy,10,1713121231,1713121241,1713121241.250925,-18000,EB445137-D7F5-57EC-87DA-1DB460D64046,"iPhone13,2"
com.apple.findmy,8,1713120967,1713120975,1713120975.39622,-18000,EB445137-D7F5-57EC-87DA-1DB460D64046,"iPhone13,2"
com.apple.findmy,12,1713120870,1713120882,1713120882.249627,-18000,EB445137-D7F5-57EC-87DA-1DB460D64046,"iPhone13,2"
com.apple.MobileSMS,2,1713117621,1713117623,1713117623.555265,-18000,EB445137-D7F5-57EC-87DA-1DB460D64046,"iPhone13,2"
com.google.Chrome,871,1713116955,1713117826,1713117826.13195,-18000,,
com.google.Chrome,312,1713115930,1713116242,1713116242.657543,-18000,,
com.hnc.Discord,95,1713115835,1713115930,1713115930.5990028,-18000,,
com.google.Chrome,256,1713115579,1713115835,1713115835.2742891,-18000,,
com.leomehlig.today,39,1713115540,1713115579,1713115579.350517,-18000,,
com.google.Chrome,61,1713115479,1713115540,1713115540.7276878,-18000,,
com.google.Chrome,396,1713115082,1713115478,1713115478.935957,-18000,,
com.apple.Preview,22,1713115060,1713115082,1713115082.246828,-18000,,
com.google.Chrome,59,1713115001,1713115060,1713115060.73168,-18000,,
com.google.ios.youtube,537,1713114370,1713114907,1713114907.627291,-18000,EB445137-D7F5-57EC-87DA-1DB460D64046,"iPhone13,2"
com.apple.news,55,1713114315,1713114370,1713114370.157476,-18000,EB445137-D7F5-57EC-87DA-1DB460D64046,"iPhone13,2"
com.google.ios.youtube,446,1713113869,1713114315,1713114315.714364,-18000,EB445137-D7F5-57EC-87DA-1DB460D64046,"iPhone13,2"
com.apple.news,342,1713113527,1713113869,1713113869.834391,-18000,EB445137-D7F5-57EC-87DA-1DB460D64046,"iPhone13,2"
com.apple.findmy,7,1713113520,1713113527,1713113527.196593,-18000,EB445137-D7F5-57EC-87DA-1DB460D64046,"iPhone13,2"
com.apple.news,54,1713113465,1713113519,1713113519.931676,-18000,EB445137-D7F5-57EC-87DA-1DB460D64046,"iPhone13,2"
com.apple.Health,6,1713113452,1713113458,1713113458.6728082,-18000,EB445137-D7F5-57EC-87DA-1DB460D64046,"iPhone13,2"
com.google.Chrome,303,1713113447,1713113750,1713113751.0272632,-18000,,
com.google.Chrome,783,1713112046,1713112829,1713112829.091562,-18000,,
com.leomehlig.today,14,1713112032,1713112046,1713112046.76318,-18000,,
com.apple.Health,21,1713111970,1713111991,1713111991.950494,-18000,EB445137-D7F5-57EC-87DA-1DB460D64046,"iPhone13,2"
com.apple.findmy,15,1713111953,1713111968,1713111968.558755,-18000,EB445137-D7F5-57EC-87DA-1DB460D64046,"iPhone13,2"
com.leomehlig.today,304,1713111245,1713111549,1713111549.070193,-18000,,
com.apple.findmy,6,1713110876,1713110882,1713110882.764173,-18000,EB445137-D7F5-57EC-87DA-1DB460D64046,"iPhone13,2"
com.google.Chrome,391,1713110854,1713111245,1713111245.388855,-18000,,
com.apple.Preview,15,1713110839,1713110854,1713110854.3467798,-18000,,
com.google.Chrome,28,1713110811,1713110839,1713110839.9111571,-18000,,
com.apple.Preview,61,1713110750,1713110811,1713110811.27845,-18000,,
com.google.Chrome,2,1713110748,1713110750,1713110750.115483,-18000,,
com.apple.Preview,83,1713110665,1713110748,1713110748.28164,-18000,,
com.google.Chrome,2,1713110663,1713110665,1713110665.031116,-18000,,
com.apple.Preview,17,1713110646,1713110663,1713110663.1547132,-18000,,
com.google.Chrome,16,1713110630,1713110646,1713110646.539926,-18000,,
com.apple.Preview,124,1713110506,1713110630,1713110630.314107,-18000,,
com.apple.finder,8,1713110498,1713110506,1713110506.180382,-18000,,
com.apple.Preview,2,1713110496,1713110498,1713110498.6530972,-18000,,
com.burbn.instagram,223,1713110262,1713110485,1713110485.240471,-18000,EB445137-D7F5-57EC-87DA-1DB460D64046,"iPhone13,2"
com.apple.MobileSMS,1,1713110244,1713110245,1713110246.000696,-18000,EB445137-D7F5-57EC-87DA-1DB460D64046,"iPhone13,2"
com.apple.MobileSMS,15,1713109987,1713110002,1713110002.680269,-18000,EB445137-D7F5-57EC-87DA-1DB460D64046,"iPhone13,2"
com.apple.findmy,9,1713109978,1713109987,1713109987.898025,-18000,EB445137-D7F5-57EC-87DA-1DB460D64046,"iPhone13,2"
com.google.Chrome,611,1713109885,1713110496,1713110496.784143,-18000,,
com.hnc.Discord,36,1713109849,1713109885,1713109885.059636,-18000,,
com.google.Chrome,62,1713109787,1713109849,1713109849.702579,-18000,,
com.hnc.Discord,190,1713109597,1713109787,1713109787.081201,-18000,,
com.google.Chrome,3,1713109594,1713109597,1713109597.596972,-18000,,
com.hnc.Discord,4,1713109590,1713109594,1713109594.890933,-18000,,
com.google.Chrome,12,1713109578,1713109590,1713109590.106247,-18000,,
com.hnc.Discord,5,1713109573,1713109578,1713109579.223027,-18000,,
com.google.Chrome,658,1713108915,1713109573,1713109573.148109,-18000,,
com.apple.findmy,21,1713108862,1713108883,1713108883.527061,-18000,EB445137-D7F5-57EC-87DA-1DB460D64046,"iPhone13,2"
com.apple.MobileSMS,3,1713108858,1713108861,1713108861.835676,-18000,EB445137-D7F5-57EC-87DA-1DB460D64046,"iPhone13,2"
com.google.Chrome,392,1713108520,1713108912,1713108912.230423,-18000,,
com.apple.MobileSMS,7,1713107764,1713107771,1713107771.249936,-18000,EB445137-D7F5-57EC-87DA-1DB460D64046,"iPhone13,2"
com.google.Chrome,859,1713107658,1713108517,1713108517.924839,-18000,,
com.leomehlig.today,53,1713107577,1713107630,1713107630.529571,-18000,,
com.apple.iCal,14,1713107563,1713107577,1713107577.867158,-18000,,
com.apple.MobileSMS,3,1713107557,1713107560,1713107560.6345859,-18000,EB445137-D7F5-57EC-87DA-1DB460D64046,"iPhone13,2"
com.apple.InCallService,233,1713107324,1713107557,1713107557.301477,-18000,EB445137-D7F5-57EC-87DA-1DB460D64046,"iPhone13,2"
com.apple.MobileSMS,7,1713107317,1713107324,1713107324.914102,-18000,EB445137-D7F5-57EC-87DA-1DB460D64046,"iPhone13,2"
com.truebill.truebillnative,5,1713105994,1713105999,1713105999.942009,-18000,EB445137-D7F5-57EC-87DA-1DB460D64046,"iPhone13,2"
com.burbn.instagram,10,1713105952,1713105962,1713105962.496161,-18000,EB445137-D7F5-57EC-87DA-1DB460D64046,"iPhone13,2"
com.apple.findmy,14,1713105937,1713105951,1713105951.1883988,-18000,EB445137-D7F5-57EC-87DA-1DB460D64046,"iPhone13,2"
com.apple.Maps,57,1713105876,1713105933,1713105933.905529,-18000,EB445137-D7F5-57EC-87DA-1DB460D64046,"iPhone13,2"
com.hulu.plus,949,1713104887,1713105836,1713105836.902946,-18000,EB445137-D7F5-57EC-87DA-1DB460D64046,"iPhone13,2"
com.apple.findmy,13,1713104874,1713104887,1713104887.3777509,-18000,EB445137-D7F5-57EC-87DA-1DB460D64046,"iPhone13,2"
com.hulu.plus,537,1713104336,1713104873,1713104873.776118,-18000,EB445137-D7F5-57EC-87DA-1DB460D64046,"iPhone13,2"
com.google.ios.youtube,452,1713103883,1713104335,1713104336.496108,-18000,EB445137-D7F5-57EC-87DA-1DB460D64046,"iPhone13,2"
com.burbn.instagram,318,1713103564,1713103882,1713103882.912667,-18000,EB445137-D7F5-57EC-87DA-1DB460D64046,"iPhone13,2"
com.apple.journal,2,1713103548,1713103550,1713103550.7103019,-18000,EB445137-D7F5-57EC-87DA-1DB460D64046,"iPhone13,2"
com.hammerandchisel.discord,36,1713103506,1713103542,1713103542.520853,-18000,EB445137-D7F5-57EC-87DA-1DB460D64046,"iPhone13,2"
com.apple.MobileSMS,43,1713103454,1713103497,1713103497.952063,-18000,EB445137-D7F5-57EC-87DA-1DB460D64046,"iPhone13,2"
com.apple.mobiletimer,12,1713070483,1713070495,1713070495.829864,-18000,EB445137-D7F5-57EC-87DA-1DB460D64046,"iPhone13,2"
com.apple.mobiletimer,1,1713070479,1713070480,1713070480.688314,-18000,EB445137-D7F5-57EC-87DA-1DB460D64046,"iPhone13,2"
com.apple.mobiletimer,6,1713070472,1713070478,1713070478.773454,-18000,EB445137-D7F5-57EC-87DA-1DB460D64046,"iPhone13,2"
com.apple.Health,63,1713070378,1713070441,1713070441.725265,-18000,EB445137-D7F5-57EC-87DA-1DB460D64046,"iPhone13,2"
com.hulu.plus,3013,1713067362,1713070375,1713070375.271675,-18000,EB445137-D7F5-57EC-87DA-1DB460D64046,"iPhone13,2"
com.apple.Preferences,10,1713067346,1713067356,1713067356.237711,-18000,EB445137-D7F5-57EC-87DA-1DB460D64046,"iPhone13,2"
com.apple.iCal,13,1713067218,1713067231,1713067231.8308148,-18000,,
com.google.Chrome,22,1713067196,1713067218,1713067218.470269,-18000,,
com.google.Chrome,342,1713066810,1713067152,1713067152.208479,-18000,,
com.google.Chrome,954,1713065433,1713066387,1713066387.8403769,-18000,,
com.google.Chrome,645,1713064664,1713065309,1713065309.363017,-18000,,
com.toyopagroup.picaboo,46,1713063881,1713063927,1713063927.906568,-18000,EB445137-D7F5-57EC-87DA-1DB460D64046,"iPhone13,2"
com.google.Chrome,924,1713063674,1713064598,1713064598.2083468,-18000,,
com.google.Chrome,300,1713063161,1713063461,1713063461.8528771,-18000,,
com.google.Chrome,378,1713062601,1713062979,1713062979.535523,-18000,,
com.google.Chrome,302,1713062243,1713062545,1713062545.127181,-18000,,
com.google.Chrome,306,1713061714,1713062020,1713062020.4203439,-18000,,
com.google.Chrome,705,1713060931,1713061636,1713061636.741448,-18000,,
com.google.Chrome,871,1713059509,1713060380,1713060380.7039208,-18000,,
com.google.Chrome,478,1713058646,1713059124,1713059124.448461,-18000,,
com.apple.iCal,22,1713058624,1713058646,1713058646.5483441,-18000,,
com.google.Chrome,162,1713058462,1713058624,1713058624.065176,-18000,,
com.leomehlig.today,17,1713058445,1713058462,1713058462.329987,-18000,,
com.google.Chrome,729,1713057716,1713058445,1713058445.6668901,-18000,,
com.leomehlig.today,2,1713057714,1713057716,1713057716.265386,-18000,,
com.google.Chrome,6,1713057708,1713057714,1713057714.417434,-18000,,
com.apple.finder,430,1713057278,1713057708,1713057708.770915,-18000,,
com.google.Chrome,4,1713057274,1713057278,1713057278.361362,-18000,,
com.apple.Photos,628,1713056277,1713056905,1713056905.597646,-18000,,
com.google.Chrome,1065,1713055212,1713056277,1713056277.3384042,-18000,,
com.leomehlig.today,31,1713055181,1713055212,1713055212.51514,-18000,,
com.google.Chrome,54,1713055127,1713055181,1713055182.050709,-18000,,
com.leomehlig.today,6,1713055102,1713055108,1713055108.953055,-18000,,
com.google.Chrome,65,1713055037,1713055102,1713055102.7876248,-18000,,
com.google.Chrome,27,1713051208,1713051235,1713051235.1247559,-18000,,
com.apple.keychainaccess,1,1713051207,1713051208,1713051208.172728,-18000,,
com.google.Chrome,3,1713051204,1713051207,1713051207.2615929,-18000,,
com.apple.keychainaccess,1,1713051203,1713051204,1713051204.897789,-18000,,
com.google.Chrome,2,1713051201,1713051203,1713051203.8406348,-18000,,
com.apple.keychainaccess,2,1713051199,1713051201,1713051202.025094,-18000,,
com.google.Chrome,63,1713051127,1713051190,1713051190.747405,-18000,,
com.google.Chrome,215,1712981477,1712981692,1712981692.4896588,-18000,,
com.google.Chrome,308,1712981011,1712981319,1712981319.760462,-18000,,
com.google.Chrome,554,1712980106,1712980660,1712980660.786121,-18000,,
com.google.Chrome,354,1712979605,1712979959,1712979959.5657601,-18000,,
com.google.Chrome,462,1712978683,1712979145,1712979145.853379,-18000,,
com.google.Chrome,713,1712977952,1712978665,1712978665.5516229,-18000,,
com.google.Chrome,585,1712976568,1712977153,1712977153.800657,-18000,,
com.google.Chrome,305,1712975512,1712975817,1712975817.967486,-18000,,
com.google.Chrome,875,1712974401,1712975276,1712975276.347228,-18000,,
com.leomehlig.today,60,1712974248,1712974308,1712974308.995791,-18000,,
com.google.Chrome,524,1712973724,1712974248,1712974248.834857,-18000,,
com.leomehlig.today,6,1712973718,1712973724,1712973724.995899,-18000,,
com.apple.Preview,909,1712972809,1712973718,1712973718.5612779,-18000,,
com.google.Chrome,21,1712972788,1712972809,1712972809.473038,-18000,,
com.apple.Preview,279,1712972509,1712972788,1712972788.160321,-18000,,
com.google.Chrome,6,1712972503,1712972509,1712972510.026483,-18000,,
com.apple.iCal,18,1712972485,1712972503,1712972503.619406,-18000,,
com.google.Chrome,31,1712972454,1712972485,1712972485.9354548,-18000,,
com.apple.iCal,227,1712972218,1712972445,1712972445.355534,-18000,,
com.google.Chrome,21,1712972197,1712972218,1712972218.550328,-18000,,
com.apple.iCal,30,1712972167,1712972197,1712972197.0622811,-18000,,
com.apple.Preview,491,1712971676,1712972167,1712972168.011496,-18000,,
com.leomehlig.today,100,1712971576,1712971676,1712971676.8884091,-18000,,
com.google.Chrome,54,1712971522,1712971576,1712971577.0073571,-18000,,
com.leomehlig.today,88,1712971434,1712971522,1712971522.212161,-18000,,
com.google.Chrome,85,1712971349,1712971434,1712971434.534894,-18000,,
com.leomehlig.today,38,1712971311,1712971349,1712971349.276386,-18000,,
com.google.Chrome,1,1712971310,1712971311,1712971311.778189,-18000,,
com.apple.MobileSMS,3,1712971307,1712971310,1712971310.465415,-18000,,
com.google.Chrome,92,1712971215,1712971307,1712971307.538085,-18000,,
com.google.Chrome,232,1712970596,1712970828,1712970828.927517,-18000,,
com.google.Chrome,277,1712969964,1712970241,1712970241.276104,-18000,,
com.google.Chrome,772,1712967881,1712968653,1712968653.687285,-18000,,
com.google.Chrome,450,1712966680,1712967130,1712967130.257794,-18000,,
com.google.Chrome,665,1712965011,1712965676,1712965676.6563358,-18000,,
com.google.Chrome,764,1712963469,1712964233,1712964233.417424,-18000,,
com.google.Chrome,300,1712961688,1712961988,1712961988.360509,-18000,,
com.google.Chrome,924,1712960121,1712961045,1712961045.7965221,-18000,,
com.google.Chrome,595,1712959050,1712959645,1712959645.8412871,-18000,,
com.google.Chrome,737,1712958283,1712959020,1712959020.771854,-18000,,
com.google.Chrome,627,1712957249,1712957876,1712957876.288708,-18000,,
com.leomehlig.today,19,1712957230,1712957249,1712957249.699462,-18000,,
com.google.Chrome,62,1712957168,1712957230,1712957230.368952,-18000,,
com.apple.Preview,24,1712957144,1712957168,1712957168.4123368,-18000,,
com.google.Chrome,3,1712957141,1712957144,1712957144.874771,-18000,,
com.apple.Preview,15,1712957126,1712957141,1712957141.075935,-18000,,
com.google.Chrome,148,1712956978,1712957126,1712957126.511894,-18000,,
com.apple.Preview,9,1712956969,1712956978,1712956978.6342468,-18000,,
com.google.Chrome,27,1712956942,1712956969,1712956970.019726,-18000,,
com.apple.Preview,7,1712956935,1712956942,1712956942.566526,-18000,,
com.google.Chrome,25,1712956910,1712956935,1712956935.578854,-18000,,
com.apple.Preview,4,1712956906,1712956910,1712956910.9308429,-18000,,
com.google.Chrome,3,1712956903,1712956906,1712956906.19841,-18000,,
com.apple.Preview,6,1712956897,1712956903,1712956903.0612001,-18000,,
com.google.Chrome,3,1712956894,1712956897,1712956897.554781,-18000,,
com.apple.Preview,15,1712956879,1712956894,1712956894.387708,-18000,,
com.google.Chrome,2,1712956877,1712956879,1712956880.019053,-18000,,
com.apple.Preview,16,1712956861,1712956877,1712956877.748026,-18000,,
com.google.Chrome,53,1712956808,1712956861,1712956861.077674,-18000,,
com.apple.Preview,23,1712956785,1712956808,1712956808.77194,-18000,,
com.google.Chrome,6,1712956779,1712956785,1712956785.398984,-18000,,
com.apple.Preview,9,1712956770,1712956779,1712956779.564674,-18000,,
com.google.Chrome,26,1712956744,1712956770,1712956770.8812342,-18000,,
com.apple.Preview,48,1712956696,1712956744,1712956744.652234,-18000,,
com.leomehlig.today,2,1712956694,1712956696,1712956696.1929379,-18000,,
com.google.Chrome,20,1712956674,1712956694,1712956694.75267,-18000,,
com.leomehlig.today,12,1712956662,1712956674,1712956674.172596,-18000,,
com.google.Chrome,162,1712956500,1712956662,1712956662.4633698,-18000,,
com.apple.Preview,5,1712956495,1712956500,1712956500.827141,-18000,,
com.google.Chrome,16,1712956479,1712956495,1712956495.823989,-18000,,
com.apple.Preview,175,1712956304,1712956479,1712956479.5814838,-18000,,
com.google.Chrome,1584,1712954720,1712956304,1712956304.9579291,-18000,,
com.apple.Preview,13,1712954707,1712954720,1712954720.317193,-18000,,
com.google.Chrome,29,1712954678,1712954707,1712954707.9385428,-18000,,
com.apple.Preview,42,1712954636,1712954678,1712954678.149224,-18000,,
com.google.Chrome,217,1712954419,1712954636,1712954636.881009,-18000,,
com.apple.Preview,61,1712954358,1712954419,1712954419.580421,-18000,,
com.google.Chrome,76,1712954282,1712954358,1712954358.7325602,-18000,,
com.apple.Preview,47,1712954235,1712954282,1712954282.4771972,-18000,,
com.apple.finder,1,1712954234,1712954235,1712954235.162051,-18000,,
com.google.Chrome,2,1712954232,1712954234,1712954234.189487,-18000,,
com.apple.finder,1,1712954231,1712954232,1712954232.534241,-18000,,
com.apple.Preview,8,1712954223,1712954231,1712954231.100906,-18000,,
com.apple.finder,5,1712954218,1712954223,1712954223.38093,-18000,,
com.google.Chrome,584,1712953634,1712954218,1712954218.5176868,-18000,,
com.leomehlig.today,200,1712953434,1712953634,1712953634.060313,-18000,,
com.apple.Preview,3,1712953431,1712953434,1712953434.8347402,-18000,,
com.google.Chrome,42,1712953389,1712953431,1712953431.681701,-18000,,
com.google.Chrome,728,1712952534,1712953262,1712953263.0105681,-18000,,
com.google.Chrome,1007,1712951052,1712952059,1712952059.049151,-18000,,
com.google.Chrome,418,1712950088,1712950506,1712950506.7191892,-18000,,
com.google.Chrome,524,1712949539,1712950063,1712950063.3795772,-18000,,
com.google.Chrome,300,1712949238,1712949538,1712949538.330315,-18000,,
com.google.Chrome,494,1712948662,1712949156,1712949156.233273,-18000,,
com.google.Chrome,491,1712947832,1712948323,1712948323.349725,-18000,,
com.google.Chrome,650,1712947115,1712947765,1712947765.630033,-18000,,
com.google.Chrome,304,1712946345,1712946649,1712946649.136982,-18000,,
com.google.Chrome,338,1712945895,1712946233,1712946233.9551048,-18000,,
com.google.Chrome,343,1712944566,1712944909,1712944909.271747,-18000,,
com.google.Chrome,473,1712943708,1712944181,1712944181.685707,-18000,,
com.google.Chrome,361,1712943228,1712943589,1712943589.6683378,-18000,,
com.apple.MobileSMS,26,1712942142,1712942168,1712942168.0658278,-18000,EB445137-D7F5-57EC-87DA-1DB460D64046,"iPhone13,2"
com.google.Chrome,1,1712942107,1712942108,1712942109.236508,-18000,,
com.google.Chrome,386,1712941718,1712942104,1712942105.147194,-18000,,
com.google.Chrome,341,1712940761,1712941102,1712941102.2603788,-18000,,
com.apple.MobileSMS,27,1712940734,1712940761,1712940761.3765101,-18000,,
com.google.Chrome,1120,1712939614,1712940734,1712940734.693492,-18000,,
com.google.Chrome,417,1712938979,1712939396,1712939396.263015,-18000,,
com.google.Chrome,347,1712938301,1712938648,1712938648.687942,-18000,,
com.apple.camera,4,1712938265,1712938269,1712938269.703947,-18000,EB445137-D7F5-57EC-87DA-1DB460D64046,"iPhone13,2"
com.google.Chrome,520,1712937707,1712938227,1712938227.930263,-18000,,
com.google.Chrome,300,1712936768,1712937068,1712937068.7624521,-18000,,
com.google.Chrome,438,1712935964,1712936402,1712936402.577205,-18000,,
com.leomehlig.today,3,1712935529,1712935532,1712935532.203446,-18000,,
com.google.Chrome,17,1712935512,1712935529,1712935529.372892,-18000,,
com.leomehlig.today,1,1712935511,1712935512,1712935512.389991,-18000,,
com.google.Chrome,86,1712935410,1712935496,1712935496.864507,-18000,,
com.apple.MobileSMS,3,1712935389,1712935392,1712935392.94754,-18000,EB445137-D7F5-57EC-87DA-1DB460D64046,"iPhone13,2"
com.apple.reminders,5,1712935370,1712935375,1712935375.584188,-18000,EB445137-D7F5-57EC-87DA-1DB460D64046,"iPhone13,2"
com.apple.Health,46,1712935274,1712935320,1712935320.304817,-18000,EB445137-D7F5-57EC-87DA-1DB460D64046,"iPhone13,2"
com.apple.Health,24,1712935236,1712935260,1712935260.8611069,-18000,EB445137-D7F5-57EC-87DA-1DB460D64046,"iPhone13,2"
com.apple.camera,1,1712932850,1712932851,1712932851.1565042,-18000,EB445137-D7F5-57EC-87DA-1DB460D64046,"iPhone13,2"
com.toyopagroup.picaboo,31,1712932773,1712932804,1712932804.279571,-18000,EB445137-D7F5-57EC-87DA-1DB460D64046,"iPhone13,2"
com.toyopagroup.picaboo,23,1712898368,1712898391,1712898392.0028582,-18000,EB445137-D7F5-57EC-87DA-1DB460D64046,"iPhone13,2"
com.toyopagroup.picaboo,4,1712898363,1712898367,1712898367.413015,-18000,EB445137-D7F5-57EC-87DA-1DB460D64046,"iPhone13,2"
com.google.Chrome,176,1712898050,1712898226,1712898227.146759,-18000,,
com.google.Chrome,300,1712897446,1712897746,1712897746.555639,-18000,,
com.google.Chrome,434,1712896924,1712897358,1712897358.870424,-18000,,
com.toyopagroup.picaboo,3,1712895968,1712895971,1712895971.222327,-18000,EB445137-D7F5-57EC-87DA-1DB460D64046,"iPhone13,2"
com.google.Chrome,620,1712895612,1712896232,1712896232.769428,-18000,,
com.google.Chrome,336,1712894300,1712894636,1712894636.513904,-18000,,
com.google.Chrome,653,1712892837,1712893490,1712893490.987893,-18000,,
