app,usage,start_time,end_time,created_at,tz,device_id,device_model
com.apple.finder,3,1726606890,1726606893,1726606893.116374,-18000,,
com.apple.Terminal,10,1726606880,1726606890,1726606890.832619,-18000,,
com.apple.finder,1,1726606879,1726606880,1726606880.137954,-18000,,
com.apple.Terminal,8,1726606871,1726606879,1726606879.16186,-18000,,
com.apple.finder,12,1726606859,1726606871,1726606871.5884929,-18000,,
com.google.Chrome,5,1726606854,1726606859,1726606859.8420749,-18000,,
com.google.Chrome,302,1726606344,1726606646,1726606646.741169,-18000,,
com.leomehlig.today,8,1726606336,1726606344,1726606344.4042358,-18000,,
com.google.Chrome,5,1726606331,1726606336,1726606336.417519,-18000,,
com.leomehlig.today,99,1726606232,1726606331,1726606331.9687018,-18000,,
com.google.Chrome,14,1726606218,1726606232,1726606232.7802181,-18000,,
com.leomehlig.today,3,1726606215,1726606218,1726606218.161003,-18000,,
com.google.Chrome,7,1726606208,1726606215,1726606215.398128,-18000,,
com.apple.iCal,1,1726606207,1726606208,1726606208.69804,-18000,,
com.leomehlig.today,5,1726606202,1726606207,1726606207.1484861,-18000,,
com.google.Chrome,54,1726606148,1726606202,1726606202.162932,-18000,,
com.leomehlig.today,17,1726606131,1726606148,1726606148.969012,-18000,,
com.google.Chrome,145,1726605986,1726606131,1726606131.515163,-18000,,
com.leomehlig.today,20,1726605966,1726605986,1726605986.169337,-18000,,
com.google.Chrome,305,1726605661,1726605966,1726605966.249593,-18000,,
com.leomehlig.today,43,1726605618,1726605661,1726605661.758412,-18000,,
com.apple.iCal,15,1726605603,1726605618,1726605618.182763,-18000,,
com.google.Chrome,24,1726605579,1726605603,1726605603.346144,-18000,,
com.apple.iCal,2,1726605563,1726605565,1726605565.197812,-18000,,
com.leomehlig.today,3,1726605560,1726605563,1726605563.118734,-18000,,
com.leomehlig.today,80,1726595794,1726595874,1726595874.840973,-18000,,
com.google.Chrome,12,1726595782,1726595794,1726595794.521898,-18000,,
com.hnc.Discord,12,1726595770,1726595782,1726595782.964448,-18000,,
com.hnc.Discord,524,1726594407,1726594931,1726594931.086588,-18000,,
com.google.Chrome,21,1726594386,1726594407,1726594407.856025,-18000,,
com.google.Chrome,300,1726594067,1726594367,1726594367.995346,-18000,,
com.google.Chrome,2421,1726589461,1726591882,1726591882.267823,-18000,,
com.google.Chrome,7,1726588192,1726588199,1726588199.852876,-18000,,
com.microsoft.onenote.mac,4,1726588188,1726588192,1726588192.985965,-18000,,
com.google.Chrome,1,1726588187,1726588188,1726588188.1398668,-18000,,
com.apple.dt.Xcode,3,1726588184,1726588187,1726588187.1620312,-18000,,
com.google.Chrome,1,1726588183,1726588184,1726588184.0662088,-18000,,
com.google.android.studio,40,1726588143,1726588183,1726588183.673335,-18000,,
com.google.Chrome,46,1726588097,1726588143,1726588143.5217109,-18000,,
com.google.android.studio,262,1726587835,1726588097,1726588097.846754,-18000,,
com.microsoft.onenote.mac,5,1726587830,1726587835,1726587835.946377,-18000,,
com.google.android.studio,53,1726587777,1726587830,1726587830.5366921,-18000,,
com.apple.dt.Xcode,92,1726587641,1726587733,1726587733.484068,-18000,,
com.microsoft.onenote.mac,8,1726587633,1726587641,1726587641.068815,-18000,,
com.apple.dt.Xcode,79,1726587554,1726587633,1726587633.415207,-18000,,
com.google.Chrome,65,1726587489,1726587554,1726587554.4846401,-18000,,
com.apple.dt.Xcode,143,1726587346,1726587489,1726587489.68993,-18000,,
com.microsoft.onenote.mac,10,1726587336,1726587346,1726587346.808442,-18000,,
com.apple.dt.Xcode,275,1726587061,1726587336,1726587337.000842,-18000,,
com.microsoft.onenote.mac,12,1726587049,1726587061,1726587061.4484549,-18000,,
com.apple.systempreferences,1,1726587044,1726587045,1726587045.726752,-18000,,
com.microsoft.onenote.mac,2,1726587041,1726587043,1726587043.265486,-18000,,
com.google.Chrome,26,1726587015,1726587041,1726587041.645277,-18000,,
com.google.Chrome,20,1726586605,1726586625,1726586625.21222,-18000,,
com.leomehlig.today,11,1726586594,1726586605,1726586605.26199,-18000,,
com.google.Chrome,199,1726586395,1726586594,1726586595.021947,-18000,,
com.apple.finder,41,1726586354,1726586395,1726586396.016141,-18000,,
com.apple.Preview,3,1726586351,1726586354,1726586354.7215528,-18000,,
com.google.Chrome,5,1726586346,1726586351,1726586351.531024,-18000,,
com.apple.finder,12,1726586334,1726586346,1726586346.1909518,-18000,,
com.google.Chrome,8,1726586326,1726586334,1726586334.083195,-18000,,
com.apple.finder,51,1726586275,1726586326,1726586326.129129,-18000,,
com.google.Chrome,41,1726586234,1726586275,1726586275.061892,-18000,,
com.microsoft.VSCode,5,1726586229,1726586234,1726586234.859827,-18000,,
com.apple.Preview,39,1726586190,1726586229,1726586229.74654,-18000,,
com.microsoft.VSCode,93,1726586097,1726586190,1726586190.690371,-18000,,
com.apple.Preview,36,1726586061,1726586097,1726586097.9022121,-18000,,
com.microsoft.VSCode,26,1726586035,1726586061,1726586061.8500218,-18000,,
com.google.Chrome,8,1726586027,1726586035,1726586035.213797,-18000,,
com.microsoft.VSCode,87,1726585940,1726586027,1726586027.194854,-18000,,
com.google.Chrome,2,1726585938,1726585940,1726585940.151326,-18000,,
com.microsoft.VSCode,5,1726585933,1726585938,1726585938.9112968,-18000,,
com.google.Chrome,4,1726585929,1726585933,1726585933.356841,-18000,,
com.microsoft.VSCode,6,1726585923,1726585929,1726585929.473933,-18000,,
com.google.Chrome,5,1726585918,1726585923,1726585923.325066,-18000,,
com.microsoft.VSCode,16,1726585902,1726585918,1726585918.894184,-18000,,
com.google.Chrome,30,1726585872,1726585902,1726585902.076644,-18000,,
com.microsoft.VSCode,18,1726585854,1726585872,1726585872.055139,-18000,,
com.google.Chrome,2,1726585852,1726585854,1726585854.4388251,-18000,,
com.microsoft.VSCode,11,1726585841,1726585852,1726585852.5396,-18000,,
com.google.Chrome,6,1726585835,1726585841,1726585841.212997,-18000,,
com.microsoft.VSCode,3,1726585832,1726585835,1726585835.0841,-18000,,
com.google.Chrome,2,1726585830,1726585832,1726585833.000342,-18000,,
com.microsoft.VSCode,50,1726585780,1726585830,1726585830.110283,-18000,,
com.google.Chrome,1,1726585779,1726585780,1726585780.66501,-18000,,
com.microsoft.VSCode,2,1726585777,1726585779,1726585779.7093492,-18000,,
com.google.Chrome,8,1726585769,1726585777,1726585777.802175,-18000,,
com.microsoft.VSCode,19,1726585750,1726585769,1726585769.424845,-18000,,
com.google.Chrome,1,1726585749,1726585750,1726585750.999456,-18000,,
com.microsoft.VSCode,4,1726585745,1726585749,1726585749.957746,-18000,,
com.google.Chrome,33,1726585712,1726585745,1726585745.8100672,-18000,,
com.microsoft.VSCode,2,1726585710,1726585712,1726585712.4614038,-18000,,
com.google.Chrome,2,1726585708,1726585710,1726585710.481663,-18000,,
com.microsoft.VSCode,218,1726585490,1726585708,1726585708.2765942,-18000,,
com.google.Chrome,2,1726585488,1726585490,1726585490.6637201,-18000,,
com.microsoft.VSCode,402,1726585086,1726585488,1726585488.25313,-18000,,
com.google.Chrome,2,1726585084,1726585086,1726585086.487266,-18000,,
com.microsoft.VSCode,6,1726585078,1726585084,1726585084.8562322,-18000,,
com.google.Chrome,16,1726585062,1726585078,1726585078.783746,-18000,,
com.microsoft.VSCode,35,1726585027,1726585062,1726585062.774458,-18000,,
com.google.Chrome,6,1726585021,1726585027,1726585027.790866,-18000,,
com.microsoft.VSCode,51,1726584970,1726585021,1726585021.212016,-18000,,
com.google.Chrome,7,1726584963,1726584970,1726584970.147726,-18000,,
com.microsoft.VSCode,142,1726584821,1726584963,1726584963.588625,-18000,,
com.google.Chrome,29,1726584792,1726584821,1726584822.0347838,-18000,,
com.microsoft.VSCode,26,1726584766,1726584792,1726584792.4304361,-18000,,
com.google.Chrome,1,1726584765,1726584766,1726584766.9603472,-18000,,
com.microsoft.VSCode,61,1726584704,1726584765,1726584765.3672152,-18000,,
com.google.Chrome,27,1726584677,1726584704,1726584705.007782,-18000,,
com.microsoft.VSCode,585,1726584092,1726584677,1726584677.2447329,-18000,,
com.apple.finder,20,1726584072,1726584092,1726584092.238319,-18000,,
com.google.Chrome,48,1726584024,1726584072,1726584072.9599519,-18000,,
com.google.Chrome,5,1726582331,1726582336,1726582336.5115008,-18000,,
com.google.Chrome,358,1726581945,1726582303,1726582303.282405,-18000,,
com.leomehlig.today,2,1726581408,1726581410,1726581410.084517,-18000,,
com.leomehlig.today,12,1726546598,1726546610,1726546610.528693,-18000,,
com.apple.iCal,3,1726546595,1726546598,1726546598.706348,-18000,,
com.leomehlig.today,112,1726546483,1726546595,1726546595.9978151,-18000,,
com.apple.iCal,5,1726546478,1726546483,1726546483.1097279,-18000,,
com.leomehlig.today,24,1726546454,1726546478,1726546478.630894,-18000,,
com.apple.iCal,36,1726546418,1726546454,1726546454.101176,-18000,,
com.leomehlig.today,51,1726546367,1726546418,1726546418.7551708,-18000,,
com.google.Chrome,40,1726546327,1726546367,1726546367.387569,-18000,,
com.leomehlig.today,8,1726546304,1726546312,1726546313.074494,-18000,,
com.google.Chrome,12,1726546292,1726546304,1726546304.275295,-18000,,
com.microsoft.onenote.mac,20,1726546272,1726546292,1726546292.496395,-18000,,
com.apple.dt.Xcode,4,1726546268,1726546272,1726546272.611522,-18000,,
com.microsoft.onenote.mac,5,1726546263,1726546268,1726546268.784793,-18000,,
com.apple.dt.Xcode,1,1726546262,1726546263,1726546263.6064591,-18000,,
com.microsoft.onenote.mac,2,1726546260,1726546262,1726546262.4122171,-18000,,
com.google.android.studio,109,1726546151,1726546260,1726546260.3236299,-18000,,
com.microsoft.onenote.mac,37,1726546114,1726546151,1726546151.909706,-18000,,
com.google.android.studio,142,1726545972,1726546114,1726546114.742848,-18000,,
com.apple.dt.Xcode,16,1726545956,1726545972,1726545972.514565,-18000,,
com.google.android.studio,462,1726545494,1726545956,1726545956.5848951,-18000,,
com.google.Chrome,3,1726545386,1726545389,1726545389.8049831,-18000,,
com.google.android.studio,6,1726545380,1726545386,1726545386.801392,-18000,,
com.google.Chrome,3,1726545377,1726545380,1726545380.617827,-18000,,
com.google.android.studio,6,1726545371,1726545377,1726545377.673429,-18000,,
com.google.Chrome,4,1726545367,1726545371,1726545371.073797,-18000,,
com.google.android.studio,10,1726545357,1726545367,1726545367.1135058,-18000,,
com.google.Chrome,1,1726545356,1726545357,1726545357.4182072,-18000,,
com.google.android.studio,6,1726545350,1726545356,1726545356.740485,-18000,,
com.google.Chrome,3,1726545347,1726545350,1726545350.552747,-18000,,
com.google.android.studio,3,1726545344,1726545347,1726545347.8322182,-18000,,
com.google.Chrome,6,1726545338,1726545344,1726545344.3110719,-18000,,
com.google.android.studio,2,1726545336,1726545338,1726545338.95049,-18000,,
com.google.Chrome,35,1726545301,1726545336,1726545337.045902,-18000,,
com.google.android.studio,1,1726545300,1726545301,1726545301.48671,-18000,,
com.google.Chrome,44,1726545256,1726545300,1726545300.187801,-18000,,
com.google.android.studio,61,1726545195,1726545256,1726545256.298547,-18000,,
com.google.Chrome,55,1726545140,1726545195,1726545195.089,-18000,,
com.google.android.studio,105,1726545035,1726545140,1726545140.58244,-18000,,
com.microsoft.onenote.mac,1,1726545034,1726545035,1726545035.924138,-18000,,
com.apple.dt.Xcode,6,1726545028,1726545034,1726545034.8621411,-18000,,
com.microsoft.onenote.mac,6,1726545022,1726545028,1726545028.841663,-18000,,
com.apple.dt.Xcode,13,1726545009,1726545022,1726545022.2283401,-18000,,
com.microsoft.onenote.mac,0,1726545009,1726545009,1726545009.568773,-18000,,
com.apple.dt.Xcode,2,1726545007,1726545009,1726545009.278702,-18000,,
com.google.android.studio,10,1726544997,1726545007,1726545007.324851,-18000,,
com.apple.dt.Xcode,94,1726544903,1726544997,1726544997.8561969,-18000,,
com.google.android.studio,16,1726544887,1726544903,1726544903.393842,-18000,,
com.apple.dt.Xcode,8,1726544879,1726544887,1726544887.3291059,-18000,,
com.google.android.studio,2,1726544877,1726544879,1726544879.831059,-18000,,
com.apple.dt.Xcode,16,1726544861,1726544877,1726544877.251394,-18000,,
com.google.android.studio,283,1726544578,1726544861,1726544861.2534142,-18000,,
com.apple.dt.Xcode,78,1726544500,1726544578,1726544578.455707,-18000,,
com.google.android.studio,6,1726544494,1726544500,1726544500.442239,-18000,,
com.apple.dt.Xcode,8,1726544486,1726544494,1726544494.960326,-18000,,
com.google.android.studio,1,1726544485,1726544486,1726544486.84358,-18000,,
com.apple.dt.Xcode,3,1726544482,1726544485,1726544485.533516,-18000,,
com.google.android.studio,2,1726544480,1726544482,1726544482.226798,-18000,,
com.apple.dt.Xcode,14,1726544466,1726544480,1726544480.802855,-18000,,
com.google.android.studio,2,1726544464,1726544466,1726544466.290004,-18000,,
com.apple.dt.Xcode,13,1726544451,1726544464,1726544464.19246,-18000,,
com.microsoft.onenote.mac,6,1726544445,1726544451,1726544451.126967,-18000,,
com.apple.dt.Xcode,36,1726544409,1726544445,1726544445.791666,-18000,,
com.google.android.studio,9,1726544400,1726544409,1726544409.0881371,-18000,,
com.apple.dt.Xcode,94,1726544306,1726544400,1726544400.285005,-18000,,
com.google.android.studio,34,1726544272,1726544306,1726544306.993095,-18000,,
com.apple.dt.Xcode,2,1726544270,1726544272,1726544272.8711262,-18000,,
com.google.android.studio,31,1726544239,1726544270,1726544270.578604,-18000,,
com.apple.dt.Xcode,1,1726544238,1726544239,1726544239.354358,-18000,,
com.google.android.studio,1,1726544237,1726544238,1726544238.535132,-18000,,
com.apple.dt.Xcode,2,1726544235,1726544237,1726544237.6558762,-18000,,
com.google.android.studio,0,1726544235,1726544235,1726544235.676165,-18000,,
com.apple.dt.Xcode,2,1726544233,1726544235,1726544235.313006,-18000,,
com.google.android.studio,79,1726544154,1726544233,1726544233.994988,-18000,,
com.apple.dt.Xcode,23,1726544131,1726544154,1726544154.8942928,-18000,,
com.google.android.studio,2,1726544129,1726544131,1726544131.234865,-18000,,
com.apple.dt.Xcode,2,1726544127,1726544129,1726544129.941753,-18000,,
com.google.android.studio,4,1726544123,1726544127,1726544127.239338,-18000,,
com.apple.dt.Xcode,7,1726544116,1726544123,1726544123.248757,-18000,,
com.google.android.studio,1,1726544115,1726544116,1726544116.705536,-18000,,
com.apple.dt.Xcode,1,1726544114,1726544115,1726544115.807687,-18000,,
com.google.android.studio,9,1726544105,1726544114,1726544114.723514,-18000,,
com.apple.dt.Xcode,4,1726544101,1726544105,1726544105.381453,-18000,,
com.google.android.studio,10,1726544091,1726544101,1726544101.9776,-18000,,
com.google.Chrome,1,1726544090,1726544091,1726544091.9381762,-18000,,
com.google.android.studio,1,1726544089,1726544090,1726544090.1679602,-18000,,
com.apple.dt.Xcode,1,1726544088,1726544089,1726544089.551258,-18000,,
com.google.android.studio,4,1726544084,1726544088,1726544088.331798,-18000,,
com.apple.dt.Xcode,22,1726544062,1726544084,1726544084.1467571,-18000,,
com.google.android.studio,149,1726543913,1726544062,1726544062.232847,-18000,,
com.apple.dt.Xcode,4,1726543909,1726543913,1726543913.631501,-18000,,
com.google.android.studio,20,1726543889,1726543909,1726543909.4351978,-18000,,
com.apple.dt.Xcode,1,1726543888,1726543889,1726543889.818623,-18000,,
com.google.android.studio,6,1726543882,1726543888,1726543888.785795,-18000,,
com.apple.dt.Xcode,3,1726543879,1726543882,1726543882.593247,-18000,,
com.google.android.studio,10,1726543869,1726543879,1726543879.5606651,-18000,,
com.apple.dt.Xcode,12,1726543857,1726543869,1726543869.5150828,-18000,,
com.google.android.studio,5,1726543852,1726543857,1726543857.440531,-18000,,
com.apple.dt.Xcode,9,1726543843,1726543852,1726543852.328177,-18000,,
com.google.android.studio,3,1726543840,1726543843,1726543843.548326,-18000,,
com.apple.dt.Xcode,6,1726543834,1726543840,1726543840.830431,-18000,,
com.google.android.studio,22,1726543812,1726543834,1726543834.3808022,-18000,,
com.apple.dt.Xcode,6,1726543806,1726543812,1726543812.2176309,-18000,,
com.google.android.studio,17,1726543789,1726543806,1726543806.180066,-18000,,
com.apple.dt.Xcode,2,1726543787,1726543789,1726543789.418165,-18000,,
com.google.android.studio,25,1726543762,1726543787,1726543787.074475,-18000,,
com.apple.dt.Xcode,3,1726543759,1726543762,1726543762.4540129,-18000,,
com.google.android.studio,49,1726543710,1726543759,1726543759.159548,-18000,,
com.apple.dt.Xcode,2,1726543708,1726543710,1726543710.713012,-18000,,
com.google.android.studio,8,1726543700,1726543708,1726543708.781168,-18000,,
com.apple.dt.Xcode,18,1726543682,1726543700,1726543701.080113,-18000,,
com.google.android.studio,15,1726543667,1726543682,1726543682.796698,-18000,,
com.apple.dt.Xcode,4,1726543663,1726543667,1726543667.417521,-18000,,
com.google.android.studio,10,1726543653,1726543663,1726543663.3797998,-18000,,
com.apple.dt.Xcode,23,1726543630,1726543653,1726543653.8775492,-18000,,
com.google.android.studio,18,1726543612,1726543630,1726543630.412709,-18000,,
com.apple.dt.Xcode,2,1726543610,1726543612,1726543612.308673,-18000,,
com.google.android.studio,7,1726543603,1726543610,1726543610.7765,-18000,,
com.apple.dt.Xcode,1,1726543602,1726543603,1726543603.697225,-18000,,
com.google.android.studio,7,1726543595,1726543602,1726543602.701201,-18000,,
com.apple.dt.Xcode,25,1726543570,1726543595,1726543595.212194,-18000,,
com.google.android.studio,34,1726543536,1726543570,1726543570.288336,-18000,,
com.apple.dt.Xcode,2,1726543534,1726543536,1726543536.741737,-18000,,
com.google.android.studio,5,1726543529,1726543534,1726543534.194394,-18000,,
com.apple.dt.Xcode,36,1726543493,1726543529,1726543529.2062988,-18000,,
com.google.android.studio,43,1726543450,1726543493,1726543493.089423,-18000,,
com.apple.dt.Xcode,1,1726543449,1726543450,1726543450.6894488,-18000,,
com.google.android.studio,10,1726543439,1726543449,1726543449.706439,-18000,,
com.apple.dt.Xcode,15,1726543424,1726543439,1726543439.791826,-18000,,
com.google.android.studio,77,1726543347,1726543424,1726543424.630033,-18000,,
com.google.Chrome,2,1726543345,1726543347,1726543347.639754,-18000,,
com.google.android.studio,7,1726543338,1726543345,1726543345.925161,-18000,,
com.google.Chrome,6,1726543332,1726543338,1726543338.6455832,-18000,,
com.google.android.studio,53,1726543279,1726543332,1726543333.047472,-18000,,
com.google.Chrome,45,1726543234,1726543279,1726543279.773282,-18000,,
com.google.Chrome,320,1726542585,1726542905,1726542905.062865,-18000,,
com.google.android.studio,1,1726542584,1726542585,1726542585.555928,-18000,,
com.google.Chrome,6,1726542578,1726542584,1726542584.843817,-18000,,
com.google.android.studio,14,1726542564,1726542578,1726542578.214273,-18000,,
com.google.Chrome,5,1726542559,1726542564,1726542564.844588,-18000,,
com.google.android.studio,13,1726542546,1726542559,1726542559.4813728,-18000,,
com.google.Chrome,16,1726542530,1726542546,1726542546.939186,-18000,,
com.google.android.studio,3,1726542527,1726542530,1726542530.080903,-18000,,
com.google.Chrome,4,1726542523,1726542527,1726542527.357065,-18000,,
com.google.android.studio,25,1726542498,1726542523,1726542523.322031,-18000,,
com.google.Chrome,4,1726542494,1726542498,1726542498.4194388,-18000,,
com.google.android.studio,4,1726542490,1726542494,1726542494.6942348,-18000,,
com.google.Chrome,3,1726542487,1726542490,1726542490.187152,-18000,,
com.google.android.studio,13,1726542474,1726542487,1726542487.236919,-18000,,
com.google.Chrome,15,1726542459,1726542474,1726542474.7950292,-18000,,
com.google.android.studio,122,1726542337,1726542459,1726542459.520771,-18000,,
com.google.Chrome,4,1726542333,1726542337,1726542337.599319,-18000,,
com.google.android.studio,34,1726542299,1726542333,1726542333.269878,-18000,,
com.google.Chrome,3,1726542296,1726542299,1726542299.8208709,-18000,,
com.google.android.studio,70,1726542226,1726542296,1726542296.5814018,-18000,,
com.google.Chrome,1,1726542225,1726542226,1726542227.005584,-18000,,
com.google.android.studio,18,1726542207,1726542225,1726542225.641755,-18000,,
com.google.Chrome,10,1726542197,1726542207,1726542207.702883,-18000,,
com.google.android.studio,20,1726542177,1726542197,1726542197.496141,-18000,,
com.google.Chrome,2,1726542175,1726542177,1726542177.926229,-18000,,
com.google.android.studio,14,1726542161,1726542175,1726542175.075409,-18000,,
com.google.Chrome,18,1726542143,1726542161,1726542161.5735102,-18000,,
com.leomehlig.today,32,1726542111,1726542143,1726542143.5982041,-18000,,
com.google.Chrome,2,1726542109,1726542111,1726542111.505704,-18000,,
com.google.Chrome,40,1726540404,1726540444,1726540444.4473271,-18000,,
com.google.android.studio,155,1726539968,1726540123,1726540123.361896,-18000,,
com.google.Chrome,32,1726539936,1726539968,1726539968.722148,-18000,,
com.google.android.studio,14,1726539922,1726539936,1726539936.887357,-18000,,
com.google.Chrome,37,1726539885,1726539922,1726539922.121705,-18000,,
com.google.android.studio,71,1726539814,1726539885,1726539885.459655,-18000,,
com.apple.dt.Xcode,15,1726539799,1726539814,1726539814.6913729,-18000,,
com.google.android.studio,44,1726539755,1726539799,1726539799.223154,-18000,,
com.apple.dt.Xcode,1,1726539754,1726539755,1726539755.268921,-18000,,
com.google.android.studio,2,1726539752,1726539754,1726539754.5857801,-18000,,
com.apple.dt.Xcode,2,1726539750,1726539752,1726539752.239249,-18000,,
com.google.android.studio,3,1726539747,1726539750,1726539750.6647549,-18000,,
com.apple.dt.Xcode,11,1726539736,1726539747,1726539747.84145,-18000,,
com.google.android.studio,1,1726539735,1726539736,1726539736.121933,-18000,,
com.apple.dt.Xcode,1,1726539734,1726539735,1726539735.4041882,-18000,,
com.google.Chrome,1,1726539733,1726539734,1726539734.4538,-18000,,
com.google.android.studio,34,1726539699,1726539733,1726539733.152447,-18000,,
com.google.Chrome,13,1726539686,1726539699,1726539699.5617762,-18000,,
com.google.android.studio,19,1726539667,1726539686,1726539686.6553822,-18000,,
com.apple.dt.Xcode,1,1726539666,1726539667,1726539667.6205502,-18000,,
com.google.android.studio,7,1726539659,1726539666,1726539666.592582,-18000,,
com.apple.dt.Xcode,0,1726539659,1726539659,1726539660.053207,-18000,,
com.google.android.studio,9,1726539650,1726539659,1726539659.101114,-18000,,
com.apple.dt.Xcode,3,1726539647,1726539650,1726539650.187069,-18000,,
com.google.android.studio,6,1726539641,1726539647,1726539647.77606,-18000,,
com.apple.dt.Xcode,1,1726539640,1726539641,1726539641.8217359,-18000,,
com.google.android.studio,9,1726539631,1726539640,1726539640.573831,-18000,,
com.apple.dt.Xcode,10,1726539621,1726539631,1726539631.488807,-18000,,
com.google.android.studio,23,1726539598,1726539621,1726539621.201254,-18000,,
com.apple.dt.Xcode,1,1726539597,1726539598,1726539598.093785,-18000,,
com.google.android.studio,10,1726539587,1726539597,1726539597.121863,-18000,,
com.apple.dt.Xcode,5,1726539582,1726539587,1726539587.7245378,-18000,,
com.google.android.studio,7,1726539575,1726539582,1726539582.623348,-18000,,
com.apple.dt.Xcode,3,1726539572,1726539575,1726539575.1173139,-18000,,
com.google.android.studio,22,1726539550,1726539572,1726539572.364036,-18000,,
com.microsoft.onenote.mac,10,1726539540,1726539550,1726539550.2779388,-18000,,
com.google.android.studio,2,1726539538,1726539540,1726539540.103259,-18000,,
com.microsoft.onenote.mac,6,1726539532,1726539538,1726539538.805705,-18000,,
com.google.android.studio,2,1726539530,1726539532,1726539532.942315,-18000,,
com.microsoft.onenote.mac,2,1726539528,1726539530,1726539530.174192,-18000,,
com.google.android.studio,8,1726539520,1726539528,1726539528.148319,-18000,,
com.microsoft.onenote.mac,16,1726539504,1726539520,1726539520.900024,-18000,,
com.google.android.studio,172,1726539332,1726539504,1726539504.29537,-18000,,
com.apple.dt.Xcode,8,1726539324,1726539332,1726539332.563508,-18000,,
com.google.android.studio,11,1726539313,1726539324,1726539324.631145,-18000,,
com.apple.dt.Xcode,12,1726539301,1726539313,1726539314.023279,-18000,,
com.google.android.studio,68,1726539233,1726539301,1726539301.269824,-18000,,
com.apple.dt.Xcode,1,1726539232,1726539233,1726539233.0922909,-18000,,
com.google.android.studio,15,1726539217,1726539232,1726539232.1098208,-18000,,
com.apple.dt.Xcode,4,1726539213,1726539217,1726539217.257849,-18000,,
com.google.android.studio,33,1726539180,1726539213,1726539213.0678148,-18000,,
com.apple.dt.Xcode,28,1726539152,1726539180,1726539180.234679,-18000,,
com.google.android.studio,35,1726539117,1726539152,1726539152.0511432,-18000,,
com.apple.dt.Xcode,8,1726539109,1726539117,1726539118.01577,-18000,,
com.google.android.studio,12,1726539097,1726539109,1726539109.962991,-18000,,
com.apple.dt.Xcode,8,1726539089,1726539097,1726539097.330577,-18000,,
com.google.android.studio,11,1726539078,1726539089,1726539089.259913,-18000,,
com.apple.dt.Xcode,2,1726539076,1726539078,1726539079.005224,-18000,,
com.google.Chrome,1,1726539075,1726539076,1726539076.303144,-18000,,
com.google.android.studio,49,1726539026,1726539075,1726539075.392243,-18000,,
com.google.Chrome,9,1726539017,1726539026,1726539026.772678,-18000,,
com.google.android.studio,14,1726539003,1726539017,1726539018.001488,-18000,,
com.apple.dt.Xcode,6,1726538997,1726539003,1726539003.724275,-18000,,
com.google.android.studio,9,1726538988,1726538997,1726538997.483982,-18000,,
com.apple.dt.Xcode,3,1726538985,1726538988,1726538988.17091,-18000,,
com.google.android.studio,20,1726538965,1726538985,1726538985.848686,-18000,,
com.google.Chrome,1,1726538964,1726538965,1726538965.56504,-18000,,
com.apple.dt.Xcode,11,1726538953,1726538964,1726538964.119422,-18000,,
com.google.Chrome,1,1726538952,1726538953,1726538953.508811,-18000,,
com.google.android.studio,80,1726538872,1726538952,1726538952.7506561,-18000,,
com.google.Chrome,21,1726538851,1726538872,1726538872.775413,-18000,,
com.google.android.studio,24,1726538827,1726538851,1726538851.730869,-18000,,
com.apple.dt.Xcode,4,1726538823,1726538827,1726538827.296556,-18000,,
com.google.android.studio,53,1726538770,1726538823,1726538823.191711,-18000,,
com.apple.dt.Xcode,9,1726538761,1726538770,1726538770.076425,-18000,,
com.google.android.studio,6,1726538755,1726538761,1726538761.3227801,-18000,,
com.apple.dt.Xcode,1,1726538754,1726538755,1726538756.024436,-18000,,
com.google.android.studio,8,1726538746,1726538754,1726538754.746646,-18000,,
com.apple.dt.Xcode,1,1726538745,1726538746,1726538746.639624,-18000,,
com.google.android.studio,1,1726538744,1726538745,1726538745.661696,-18000,,
com.apple.dt.Xcode,13,1726538731,1726538744,1726538744.1772099,-18000,,
com.google.android.studio,261,1726538470,1726538731,1726538731.61509,-18000,,
com.google.Chrome,41,1726538429,1726538470,1726538470.917522,-18000,,
com.google.android.studio,3,1726538426,1726538429,1726538429.13445,-18000,,
com.google.Chrome,19,1726538407,1726538426,1726538426.714755,-18000,,
com.google.android.studio,2,1726538405,1726538407,1726538407.3583832,-18000,,
com.google.Chrome,33,1726538372,1726538405,1726538405.430516,-18000,,
com.google.android.studio,26,1726538346,1726538372,1726538372.352467,-18000,,
com.apple.dt.Xcode,2,1726538344,1726538346,1726538346.538665,-18000,,
com.google.Chrome,29,1726538315,1726538344,1726538344.094362,-18000,,
com.apple.dt.Xcode,1,1726538314,1726538315,1726538315.485547,-18000,,
com.google.android.studio,8,1726538306,1726538314,1726538314.481631,-18000,,
com.apple.dt.Xcode,25,1726538281,1726538306,1726538306.912317,-18000,,
com.google.android.studio,122,1726538159,1726538281,1726538281.907156,-18000,,
com.apple.dt.Xcode,0,1726538159,1726538159,1726538159.686955,-18000,,
com.google.android.studio,46,1726538113,1726538159,1726538159.092428,-18000,,
com.apple.dt.Xcode,41,1726538072,1726538113,1726538113.532669,-18000,,
com.google.android.studio,8,1726538064,1726538072,1726538072.226574,-18000,,
com.apple.dt.Xcode,146,1726537918,1726538064,1726538064.2126231,-18000,,
com.google.android.studio,1,1726537917,1726537918,1726537918.6046991,-18000,,
com.apple.dt.Xcode,6,1726537911,1726537917,1726537917.374316,-18000,,
com.google.android.studio,19,1726537892,1726537911,1726537911.304287,-18000,,
com.apple.dt.Xcode,75,1726537817,1726537892,1726537892.9963322,-18000,,
com.google.android.studio,15,1726537802,1726537817,1726537817.53422,-18000,,
com.apple.dt.Xcode,4,1726537798,1726537802,1726537802.123925,-18000,,
com.google.android.studio,21,1726537777,1726537798,1726537799.022609,-18000,,
com.apple.dt.Xcode,5,1726537772,1726537777,1726537777.1383982,-18000,,
com.google.android.studio,49,1726537723,1726537772,1726537772.8485231,-18000,,
com.apple.dt.Xcode,2,1726537721,1726537723,1726537724.011796,-18000,,
com.google.android.studio,13,1726537708,1726537721,1726537721.911329,-18000,,
com.apple.dt.Xcode,2,1726537706,1726537708,1726537708.424996,-18000,,
com.google.android.studio,2,1726537704,1726537706,1726537706.938906,-18000,,
com.apple.dt.Xcode,13,1726537691,1726537704,1726537704.5323172,-18000,,
com.google.android.studio,27,1726537664,1726537691,1726537691.204371,-18000,,
com.apple.dt.Xcode,2,1726537662,1726537664,1726537664.910423,-18000,,
com.google.android.studio,14,1726537648,1726537662,1726537662.507169,-18000,,
com.apple.dt.Xcode,3,1726537645,1726537648,1726537648.616539,-18000,,
com.google.android.studio,25,1726537620,1726537645,1726537645.852363,-18000,,
com.apple.dt.Xcode,13,1726537607,1726537620,1726537620.930067,-18000,,
com.google.android.studio,26,1726537581,1726537607,1726537607.3778582,-18000,,
com.apple.dt.Xcode,4,1726537577,1726537581,1726537581.166352,-18000,,
com.google.Chrome,17,1726537560,1726537577,1726537577.259612,-18000,,
com.apple.dt.Xcode,1,1726537559,1726537560,1726537560.601654,-18000,,
com.google.android.studio,44,1726537515,1726537559,1726537559.702044,-18000,,
com.apple.dt.Xcode,118,1726537397,1726537515,1726537515.294338,-18000,,
com.google.android.studio,11,1726537386,1726537397,1726537397.398432,-18000,,
com.apple.dt.Xcode,11,1726537375,1726537386,1726537386.9815168,-18000,,
com.google.android.studio,80,1726537295,1726537375,1726537375.7938519,-18000,,
com.apple.dt.Xcode,1,1726537294,1726537295,1726537295.238346,-18000,,
com.google.Chrome,1,1726537293,1726537294,1726537294.6282868,-18000,,
com.apple.dt.Xcode,6,1726537287,1726537293,1726537293.3141,-18000,,
com.google.Chrome,1,1726537286,1726537287,1726537287.51689,-18000,,
com.google.android.studio,11,1726537275,1726537286,1726537286.606941,-18000,,
com.google.Chrome,4,1726537271,1726537275,1726537275.239773,-18000,,
com.google.android.studio,11,1726537260,1726537271,1726537271.118784,-18000,,
com.google.Chrome,21,1726537239,1726537260,1726537260.173291,-18000,,
com.google.android.studio,8,1726537231,1726537239,1726537239.376251,-18000,,
com.apple.dt.Xcode,6,1726537225,1726537231,1726537231.930573,-18000,,
com.google.android.studio,67,1726537158,1726537225,1726537225.930049,-18000,,
com.apple.dt.Xcode,2,1726537156,1726537158,1726537158.68452,-18000,,
com.google.android.studio,22,1726537134,1726537156,1726537156.1820111,-18000,,
com.apple.Music,6,1726537128,1726537134,1726537134.0946321,-18000,,
com.google.android.studio,26,1726537102,1726537128,1726537128.525852,-18000,,
com.apple.dt.Xcode,33,1726537069,1726537102,1726537102.618291,-18000,,
com.google.android.studio,12,1726537057,1726537069,1726537069.559554,-18000,,
com.apple.dt.Xcode,3,1726537054,1726537057,1726537057.6216412,-18000,,
com.google.android.studio,8,1726537046,1726537054,1726537054.481705,-18000,,
com.apple.dt.Xcode,13,1726537033,1726537046,1726537046.764034,-18000,,
com.google.android.studio,19,1726537014,1726537033,1726537033.8814769,-18000,,
com.apple.dt.Xcode,0,1726537014,1726537014,1726537014.8283901,-18000,,
com.google.android.studio,14,1726537000,1726537014,1726537014.5687408,-18000,,
com.apple.dt.Xcode,1,1726536999,1726537000,1726537000.858549,-18000,,
com.google.android.studio,9,1726536990,1726536999,1726536999.970131,-18000,,
com.apple.dt.Xcode,1,1726536989,1726536990,1726536990.5990639,-18000,,
com.google.android.studio,11,1726536978,1726536989,1726536989.682396,-18000,,
com.apple.dt.Xcode,1,1726536977,1726536978,1726536978.7762032,-18000,,
com.google.android.studio,17,1726536960,1726536977,1726536977.454833,-18000,,
com.apple.dt.Xcode,81,1726536879,1726536960,1726536961.021069,-18000,,
com.google.android.studio,14,1726536865,1726536879,1726536879.903126,-18000,,
com.microsoft.onenote.mac,24,1726536841,1726536865,1726536865.194439,-18000,,
com.leomehlig.today,50,1726536791,1726536841,1726536841.978722,-18000,,
com.apple.Health,51,1726536323,1726536374,1726536374.5789518,-18000,EB445137-D7F5-57EC-87DA-1DB460D64046,"iPhone13,2"
com.apple.Music,5,1726535372,1726535377,1726535377.457778,-18000,EB445137-D7F5-57EC-87DA-1DB460D64046,"iPhone13,2"
com.leomehlig.today,91,1726535165,1726535256,1726535256.720545,-18000,,
com.apple.camera,0,1726534886,1726534886,1726534887.050488,-18000,EB445137-D7F5-57EC-87DA-1DB460D64046,"iPhone13,2"
com.google.Chrome,282,1726534883,1726535165,1726535166.036779,-18000,,
com.leomehlig.today,235,1726534648,1726534883,1726534884.053221,-18000,,
com.google.Chrome,60,1726534588,1726534648,1726534648.4522629,-18000,,
com.leomehlig.today,19,1726534569,1726534588,1726534588.1897712,-18000,,
com.google.Chrome,3,1726534566,1726534569,1726534569.836893,-18000,,
com.leomehlig.today,7,1726534559,1726534566,1726534566.743645,-18000,,
com.apple.camera,3,1726534357,1726534360,1726534360.294757,-18000,EB445137-D7F5-57EC-87DA-1DB460D64046,"iPhone13,2"
com.apple.Passwords,3,1726534341,1726534344,1726534344.8378382,-18000,EB445137-D7F5-57EC-87DA-1DB460D64046,"iPhone13,2"
com.intsig.CamScannerLite,1,1726534285,1726534286,1726534286.287465,-18000,EB445137-D7F5-57EC-87DA-1DB460D64046,"iPhone13,2"
com.apple.mobilenotes,24,1726534261,1726534285,1726534285.164504,-18000,EB445137-D7F5-57EC-87DA-1DB460D64046,"iPhone13,2"
com.apple.camera,3,1726534218,1726534221,1726534221.874927,-18000,EB445137-D7F5-57EC-87DA-1DB460D64046,"iPhone13,2"
com.google.Chrome,349,1726534210,1726534559,1726534559.6518779,-18000,,
com.leomehlig.today,3,1726534207,1726534210,1726534211.0407748,-18000,,
com.google.Chrome,530,1726533677,1726534207,1726534207.666607,-18000,,
com.intsig.CamScannerLite,3,1726533570,1726533573,1726533573.272388,-18000,EB445137-D7F5-57EC-87DA-1DB460D64046,"iPhone13,2"
com.apple.Preferences,29,1726533371,1726533400,1726533400.3289042,-18000,EB445137-D7F5-57EC-87DA-1DB460D64046,"iPhone13,2"
com.apple.BarcodeScanner,3,1726533306,1726533309,1726533309.2678561,-18000,EB445137-D7F5-57EC-87DA-1DB460D64046,"iPhone13,2"
com.apple.mobiletimer,2,1726533295,1726533297,1726533297.092727,-18000,EB445137-D7F5-57EC-87DA-1DB460D64046,"iPhone13,2"
com.apple.Preferences,13,1726533202,1726533215,1726533215.4516149,-18000,EB445137-D7F5-57EC-87DA-1DB460D64046,"iPhone13,2"
com.apple.Preferences,109,1726532944,1726533053,1726533053.435567,-18000,EB445137-D7F5-57EC-87DA-1DB460D64046,"iPhone13,2"
com.apple.weather,11,1726532931,1726532942,1726532942.8148031,-18000,EB445137-D7F5-57EC-87DA-1DB460D64046,"iPhone13,2"
com.google.Chrome,973,1726532570,1726533543,1726533543.665362,-18000,,
com.leomehlig.today,1,1726532569,1726532570,1726532570.462276,-18000,,
com.google.Chrome,460,1726532109,1726532569,1726532569.1168652,-18000,,
com.leomehlig.today,2,1726532107,1726532109,1726532109.400728,-18000,,
com.google.Chrome,803,1726531304,1726532107,1726532107.8310928,-18000,,
com.leomehlig.today,1,1726531303,1726531304,1726531304.690552,-18000,,
com.google.Chrome,87,1726531216,1726531303,1726531303.9456391,-18000,,
com.leomehlig.today,1,1726531215,1726531216,1726531216.138262,-18000,,
com.google.Chrome,3,1726531212,1726531215,1726531215.412432,-18000,,
com.leomehlig.today,1,1726531211,1726531212,1726531212.764614,-18000,,
com.google.Chrome,878,1726530333,1726531211,1726531211.9288468,-18000,,
com.leomehlig.today,17,1726530316,1726530333,1726530333.155283,-18000,,
com.google.Chrome,35,1726530281,1726530316,1726530317.072386,-18000,,
com.apple.iCal,71,1726530174,1726530245,1726530245.371774,-18000,,
com.google.Chrome,51,1726530123,1726530174,1726530174.7287989,-18000,,
com.microsoft.Outlook,7,1726530116,1726530123,1726530123.90092,-18000,,
com.google.Chrome,18,1726530098,1726530116,1726530116.358076,-18000,,
com.microsoft.Outlook,7,1726530091,1726530098,1726530098.977656,-18000,,
com.apple.iCal,80,1726530011,1726530091,1726530091.412405,-18000,,
com.apple.weather,3,1726529981,1726529984,1726529984.7828689,-18000,EB445137-D7F5-57EC-87DA-1DB460D64046,"iPhone13,2"
com.leomehlig.today,36,1726529975,1726530011,1726530011.087403,-18000,,
com.apple.weather,3,1726529313,1726529316,1726529316.980274,-18000,EB445137-D7F5-57EC-87DA-1DB460D64046,"iPhone13,2"
com.apple.weather,6,1726529306,1726529312,1726529312.859482,-18000,EB445137-D7F5-57EC-87DA-1DB460D64046,"iPhone13,2"
com.myfitnesspal.mfp,2,1726529304,1726529306,1726529306.804554,-18000,EB445137-D7F5-57EC-87DA-1DB460D64046,"iPhone13,2"
com.myfitnesspal.mfp,40,1726528859,1726528899,1726528899.69447,-18000,EB445137-D7F5-57EC-87DA-1DB460D64046,"iPhone13,2"
com.myfitnesspal.mfp,30,1726528820,1726528850,1726528850.550308,-18000,EB445137-D7F5-57EC-87DA-1DB460D64046,"iPhone13,2"
com.myfitnesspal.mfp,9,1726528590,1726528599,1726528599.7918072,-18000,EB445137-D7F5-57EC-87DA-1DB460D64046,"iPhone13,2"
com.myfitnesspal.mfp,20,1726528568,1726528588,1726528588.652818,-18000,EB445137-D7F5-57EC-87DA-1DB460D64046,"iPhone13,2"
com.apple.Music,2,1726528566,1726528568,1726528568.21411,-18000,EB445137-D7F5-57EC-87DA-1DB460D64046,"iPhone13,2"
com.apple.Music,11,1726528517,1726528528,1726528528.3470569,-18000,EB445137-D7F5-57EC-87DA-1DB460D64046,"iPhone13,2"
com.apple.Health,3,1726528512,1726528515,1726528515.112015,-18000,EB445137-D7F5-57EC-87DA-1DB460D64046,"iPhone13,2"
com.apple.Health,27,1726528469,1726528496,1726528497.597296,-18000,EB445137-D7F5-57EC-87DA-1DB460D64046,"iPhone13,2"
com.apple.weather,24,1726528430,1726528454,1726528454.0546331,-18000,EB445137-D7F5-57EC-87DA-1DB460D64046,"iPhone13,2"
com.myfitnesspal.mfp,2,1726528428,1726528430,1726528431.001649,-18000,EB445137-D7F5-57EC-87DA-1DB460D64046,"iPhone13,2"
com.myfitnesspal.mfp,2,1726528426,1726528428,1726528428.464838,-18000,EB445137-D7F5-57EC-87DA-1DB460D64046,"iPhone13,2"
com.myfitnesspal.mfp,10,1726528341,1726528351,1726528351.630793,-18000,EB445137-D7F5-57EC-87DA-1DB460D64046,"iPhone13,2"
com.myfitnesspal.mfp,56,1726528279,1726528335,1726528335.94363,-18000,EB445137-D7F5-57EC-87DA-1DB460D64046,"iPhone13,2"
com.hammerandchisel.discord,73,1726528176,1726528249,1726528249.9768,-18000,EB445137-D7F5-57EC-87DA-1DB460D64046,"iPhone13,2"
com.microsoft.Office.Outlook,28,1726528145,1726528173,1726528173.959835,-18000,EB445137-D7F5-57EC-87DA-1DB460D64046,"iPhone13,2"
com.burbn.instagram,4,1726528141,1726528145,1726528145.709141,-18000,EB445137-D7F5-57EC-87DA-1DB460D64046,"iPhone13,2"
com.leomehlig.today,22,1726528023,1726528045,1726528045.076431,-18000,,
com.apple.iCal,4,1726528019,1726528023,1726528024.005405,-18000,,
com.leomehlig.today,12,1726528007,1726528019,1726528019.384694,-18000,,
com.google.Chrome,1,1726528006,1726528007,1726528007.360818,-18000,,
com.apple.iCal,9,1726527997,1726528006,1726528006.1633558,-18000,,
com.google.Chrome,551,1726527446,1726527997,1726527997.158469,-18000,,
com.leomehlig.today,1,1726527445,1726527446,1726527446.7128549,-18000,,
com.microsoft.Outlook,0,1726527445,1726527445,1726527445.963624,-18000,,
com.google.Chrome,155,1726527290,1726527445,1726527445.115456,-18000,,
com.microsoft.Outlook,2,1726527288,1726527290,1726527290.440827,-18000,,
com.leomehlig.today,1,1726527287,1726527288,1726527288.867443,-18000,,
com.google.Chrome,65,1726527222,1726527287,1726527288.051794,-18000,,
com.leomehlig.today,9,1726527213,1726527222,1726527222.7142491,-18000,,
com.google.Chrome,93,1726527120,1726527213,1726527213.916784,-18000,,
com.microsoft.Outlook,5,1726527115,1726527120,1726527120.401016,-18000,,
com.apple.finder,0,1726527115,1726527115,1726527115.548034,-18000,,
com.google.Chrome,22,1726527093,1726527115,1726527115.095026,-18000,,
com.microsoft.Outlook,64,1726527029,1726527093,1726527093.919035,-18000,,
com.apple.iCal,227,1726526802,1726527029,1726527029.904422,-18000,,
com.microsoft.Outlook,7,1726526795,1726526802,1726526802.389268,-18000,,
com.apple.MobileSMS,8,1726526787,1726526795,1726526795.172771,-18000,,
com.microsoft.Outlook,0,1726526787,1726526787,1726526788.0473871,-18000,,
com.leomehlig.today,19,1726526768,1726526787,1726526787.103744,-18000,,
com.google.Chrome,3,1726526765,1726526768,1726526768.420527,-18000,,
com.burbn.instagram,38,1726526686,1726526724,1726526725.011208,-18000,EB445137-D7F5-57EC-87DA-1DB460D64046,"iPhone13,2"
com.burbn.instagram,72,1726526583,1726526655,1726526655.9659839,-18000,EB445137-D7F5-57EC-87DA-1DB460D64046,"iPhone13,2"
com.apple.calculator,120,1726526278,1726526398,1726526398.418416,-18000,EB445137-D7F5-57EC-87DA-1DB460D64046,"iPhone13,2"
com.apple.PosterBoard,12,1726526264,1726526276,1726526277.12092,-18000,EB445137-D7F5-57EC-87DA-1DB460D64046,"iPhone13,2"
com.apple.PosterBoard,23,1726526232,1726526255,1726526255.6781101,-18000,EB445137-D7F5-57EC-87DA-1DB460D64046,"iPhone13,2"
com.apple.camera,1,1726526229,1726526230,1726526230.7348561,-18000,EB445137-D7F5-57EC-87DA-1DB460D64046,"iPhone13,2"
com.apple.camera,2,1726526225,1726526227,1726526227.781245,-18000,EB445137-D7F5-57EC-87DA-1DB460D64046,"iPhone13,2"
com.apple.PosterBoard,9,1726526216,1726526225,1726526225.384315,-18000,EB445137-D7F5-57EC-87DA-1DB460D64046,"iPhone13,2"
com.apple.camera,2,1726526213,1726526215,1726526215.20185,-18000,EB445137-D7F5-57EC-87DA-1DB460D64046,"iPhone13,2"
com.apple.camera,2,1726526207,1726526209,1726526209.723299,-18000,EB445137-D7F5-57EC-87DA-1DB460D64046,"iPhone13,2"
com.apple.mobiletimer,2,1726526193,1726526195,1726526195.641726,-18000,EB445137-D7F5-57EC-87DA-1DB460D64046,"iPhone13,2"
com.apple.PosterBoard,39,1726526150,1726526189,1726526189.504467,-18000,EB445137-D7F5-57EC-87DA-1DB460D64046,"iPhone13,2"
com.apple.PosterBoard,37,1726526103,1726526140,1726526140.8028789,-18000,EB445137-D7F5-57EC-87DA-1DB460D64046,"iPhone13,2"
com.apple.Passwords,5,1726526058,1726526063,1726526063.405416,-18000,EB445137-D7F5-57EC-87DA-1DB460D64046,"iPhone13,2"
com.apple.camera,2,1726526038,1726526040,1726526040.337284,-18000,EB445137-D7F5-57EC-87DA-1DB460D64046,"iPhone13,2"
com.apple.Passwords,26,1726525739,1726525765,1726525784.5824862,-18000,EB445137-D7F5-57EC-87DA-1DB460D64046,"iPhone13,2"
com.apple.InCallService,93,1726525065,1726525158,1726525158.720958,-18000,EB445137-D7F5-57EC-87DA-1DB460D64046,"iPhone13,2"
com.microsoft.Office.Outlook,16,1726525049,1726525065,1726525065.462532,-18000,EB445137-D7F5-57EC-87DA-1DB460D64046,"iPhone13,2"
com.leomehlig.today,4,1726525045,1726525049,1726525049.57388,-18000,EB445137-D7F5-57EC-87DA-1DB460D64046,"iPhone13,2"
com.apple.InCallService,942,1726524101,1726525043,1726525043.056789,-18000,EB445137-D7F5-57EC-87DA-1DB460D64046,"iPhone13,2"
com.apple.Maps,27,1726524074,1726524101,1726524101.695046,-18000,EB445137-D7F5-57EC-87DA-1DB460D64046,"iPhone13,2"
com.apple.InCallService,3,1726524071,1726524074,1726524074.130434,-18000,EB445137-D7F5-57EC-87DA-1DB460D64046,"iPhone13,2"
com.apple.InCallService,1062,1726523007,1726524069,1726524069.016042,-18000,EB445137-D7F5-57EC-87DA-1DB460D64046,"iPhone13,2"
com.apple.MobileSMS,2,1726523005,1726523007,1726523007.721651,-18000,EB445137-D7F5-57EC-87DA-1DB460D64046,"iPhone13,2"
com.apple.InCallService,73,1726522932,1726523005,1726523005.387964,-18000,EB445137-D7F5-57EC-87DA-1DB460D64046,"iPhone13,2"
com.apple.MobileSMS,6,1726522926,1726522932,1726522932.071841,-18000,EB445137-D7F5-57EC-87DA-1DB460D64046,"iPhone13,2"
com.apple.InCallService,617,1726522309,1726522926,1726522926.718421,-18000,EB445137-D7F5-57EC-87DA-1DB460D64046,"iPhone13,2"
com.apple.mobilephone,9,1726522300,1726522309,1726522309.934115,-18000,EB445137-D7F5-57EC-87DA-1DB460D64046,"iPhone13,2"
com.leomehlig.today,10,1726522289,1726522299,1726522299.9186091,-18000,EB445137-D7F5-57EC-87DA-1DB460D64046,"iPhone13,2"
com.leomehlig.today,6,1726522275,1726522281,1726522281.5085778,-18000,EB445137-D7F5-57EC-87DA-1DB460D64046,"iPhone13,2"
com.apple.mobilecal,2,1726522267,1726522269,1726522269.744852,-18000,EB445137-D7F5-57EC-87DA-1DB460D64046,"iPhone13,2"
com.apple.MobileSMS,3,1726522263,1726522266,1726522266.2015781,-18000,EB445137-D7F5-57EC-87DA-1DB460D64046,"iPhone13,2"
com.apple.MobileSMS,23,1726522227,1726522250,1726522250.4242759,-18000,EB445137-D7F5-57EC-87DA-1DB460D64046,"iPhone13,2"
com.apple.MobileSMS,14,1726522212,1726522226,1726522226.414078,-18000,EB445137-D7F5-57EC-87DA-1DB460D64046,"iPhone13,2"
com.apple.Preferences,6,1726522206,1726522212,1726522213.0529552,-18000,EB445137-D7F5-57EC-87DA-1DB460D64046,"iPhone13,2"
com.apple.Preferences,8,1726521771,1726521779,1726521779.1774259,-18000,EB445137-D7F5-57EC-87DA-1DB460D64046,"iPhone13,2"
com.apple.Preferences,10,1726521736,1726521746,1726521746.077832,-18000,EB445137-D7F5-57EC-87DA-1DB460D64046,"iPhone13,2"
com.apple.Preferences,100,1726521178,1726521278,1726521278.356128,-18000,EB445137-D7F5-57EC-87DA-1DB460D64046,"iPhone13,2"
com.apple.MobileSMS,4,1726521174,1726521178,1726521178.118235,-18000,EB445137-D7F5-57EC-87DA-1DB460D64046,"iPhone13,2"
com.google.Chrome,850,1726521052,1726521902,1726521902.635624,-18000,,
com.leomehlig.today,36,1726521016,1726521052,1726521052.208858,-18000,,
com.google.Chrome,317,1726520699,1726521016,1726521016.221342,-18000,,
com.apple.MobileSMS,7,1726519690,1726519697,1726519697.6945071,-18000,EB445137-D7F5-57EC-87DA-1DB460D64046,"iPhone13,2"
com.google.Chrome,440,1726519606,1726520046,1726520046.8931031,-18000,,
com.leomehlig.today,11,1726519595,1726519606,1726519607.257529,-18000,,
com.hnc.Discord,51,1726519544,1726519595,1726519595.9842281,-18000,,
com.google.Chrome,38,1726519506,1726519544,1726519544.300076,-18000,,
com.apple.MobileSMS,2,1726519332,1726519334,1726519334.486493,-18000,EB445137-D7F5-57EC-87DA-1DB460D64046,"iPhone13,2"
com.apple.InCallService,12,1726519320,1726519332,1726519332.7116718,-18000,EB445137-D7F5-57EC-87DA-1DB460D64046,"iPhone13,2"
com.apple.MobileSMS,3,1726519317,1726519320,1726519320.7787352,-18000,EB445137-D7F5-57EC-87DA-1DB460D64046,"iPhone13,2"
com.apple.InCallService,140,1726519177,1726519317,1726519317.154605,-18000,EB445137-D7F5-57EC-87DA-1DB460D64046,"iPhone13,2"
com.google.Chrome,302,1726519170,1726519472,1726519472.873335,-18000,,
com.hnc.Discord,16,1726519154,1726519170,1726519170.400113,-18000,,
com.robinhood.release.Robinhood,42,1726519094,1726519136,1726519136.940093,-18000,EB445137-D7F5-57EC-87DA-1DB460D64046,"iPhone13,2"
com.apple.weather,5,1726518959,1726518964,1726518964.987387,-18000,EB445137-D7F5-57EC-87DA-1DB460D64046,"iPhone13,2"
com.leomehlig.today,224,1726518930,1726519154,1726519154.0400991,-18000,,
com.apple.weather,3,1726517821,1726517824,1726517824.861627,-18000,EB445137-D7F5-57EC-87DA-1DB460D64046,"iPhone13,2"
com.apple.weather,1,1726517819,1726517820,1726517820.558182,-18000,EB445137-D7F5-57EC-87DA-1DB460D64046,"iPhone13,2"
com.apple.weather,10,1726517807,1726517817,1726517817.75837,-18000,EB445137-D7F5-57EC-87DA-1DB460D64046,"iPhone13,2"
com.apple.InCallService,4,1726517704,1726517708,1726517708.648479,-18000,EB445137-D7F5-57EC-87DA-1DB460D64046,"iPhone13,2"
com.apple.mobilephone,8,1726517696,1726517704,1726517706.485985,-18000,EB445137-D7F5-57EC-87DA-1DB460D64046,"iPhone13,2"
com.apple.findmy,44,1726517652,1726517696,1726517696.794445,-18000,EB445137-D7F5-57EC-87DA-1DB460D64046,"iPhone13,2"
com.microsoft.Office.Outlook,25,1726517468,1726517493,1726517493.488285,-18000,EB445137-D7F5-57EC-87DA-1DB460D64046,"iPhone13,2"
com.google.Gmail,3,1726517465,1726517468,1726517469.244328,-18000,EB445137-D7F5-57EC-87DA-1DB460D64046,"iPhone13,2"
com.google.Gmail,68,1726517063,1726517131,1726517131.772887,-18000,EB445137-D7F5-57EC-87DA-1DB460D64046,"iPhone13,2"
com.google.chrome.ios,10,1726517052,1726517062,1726517063.011236,-18000,EB445137-D7F5-57EC-87DA-1DB460D64046,"iPhone13,2"
com.google.Gmail,31,1726517021,1726517052,1726517052.082511,-18000,EB445137-D7F5-57EC-87DA-1DB460D64046,"iPhone13,2"
com.google.chrome.ios,18,1726517003,1726517021,1726517021.550465,-18000,EB445137-D7F5-57EC-87DA-1DB460D64046,"iPhone13,2"
com.google.Gmail,24,1726516979,1726517003,1726517003.393485,-18000,EB445137-D7F5-57EC-87DA-1DB460D64046,"iPhone13,2"
com.apple.news,55,1726516861,1726516916,1726516916.581502,-18000,EB445137-D7F5-57EC-87DA-1DB460D64046,"iPhone13,2"
com.apple.news,4,1726516856,1726516860,1726516860.573351,-18000,EB445137-D7F5-57EC-87DA-1DB460D64046,"iPhone13,2"
com.apple.Preferences,32,1726516818,1726516850,1726516850.2943258,-18000,EB445137-D7F5-57EC-87DA-1DB460D64046,"iPhone13,2"
com.google.chrome.ios,12,1726516805,1726516817,1726516818.1408582,-18000,EB445137-D7F5-57EC-87DA-1DB460D64046,"iPhone13,2"
com.apple.news,14,1726516791,1726516805,1726516805.730932,-18000,EB445137-D7F5-57EC-87DA-1DB460D64046,"iPhone13,2"
com.apple.news,4,1726516545,1726516549,1726516549.180469,-18000,EB445137-D7F5-57EC-87DA-1DB460D64046,"iPhone13,2"
com.apple.news,54,1726516458,1726516512,1726516512.8064032,-18000,EB445137-D7F5-57EC-87DA-1DB460D64046,"iPhone13,2"
com.google.chrome.ios,54,1726516316,1726516370,1726516370.906776,-18000,EB445137-D7F5-57EC-87DA-1DB460D64046,"iPhone13,2"
com.apple.PosterBoard,1,1726516310,1726516311,1726516311.148154,-18000,EB445137-D7F5-57EC-87DA-1DB460D64046,"iPhone13,2"
com.apple.mobilenotes,9,1726516307,1726516316,1726516316.478276,-18000,EB445137-D7F5-57EC-87DA-1DB460D64046,"iPhone13,2"
com.apple.mobilenotes,8,1726515874,1726515882,1726515882.6399841,-18000,EB445137-D7F5-57EC-87DA-1DB460D64046,"iPhone13,2"
com.apple.news,2,1726515872,1726515874,1726515874.310264,-18000,EB445137-D7F5-57EC-87DA-1DB460D64046,"iPhone13,2"
com.apple.news,1,1726515852,1726515853,1726515853.916177,-18000,EB445137-D7F5-57EC-87DA-1DB460D64046,"iPhone13,2"
com.apple.news,23,1726515791,1726515814,1726515814.9886389,-18000,EB445137-D7F5-57EC-87DA-1DB460D64046,"iPhone13,2"
com.apple.news,75,1726515704,1726515779,1726515779.611381,-18000,EB445137-D7F5-57EC-87DA-1DB460D64046,"iPhone13,2"
com.apple.news,88,1726515548,1726515636,1726515636.316936,-18000,EB445137-D7F5-57EC-87DA-1DB460D64046,"iPhone13,2"
com.apple.mobilenotes,3,1726515534,1726515537,1726515537.817858,-18000,EB445137-D7F5-57EC-87DA-1DB460D64046,"iPhone13,2"
com.apple.camera,0,1726515436,1726515436,1726515436.584041,-18000,EB445137-D7F5-57EC-87DA-1DB460D64046,"iPhone13,2"
com.apple.mobilenotes,29,1726515434,1726515463,1726515463.9328,-18000,EB445137-D7F5-57EC-87DA-1DB460D64046,"iPhone13,2"
com.apple.mobilenotes,6,1726515357,1726515363,1726515363.207792,-18000,EB445137-D7F5-57EC-87DA-1DB460D64046,"iPhone13,2"
com.apple.mobilenotes,8,1726515338,1726515346,1726515346.8590422,-18000,EB445137-D7F5-57EC-87DA-1DB460D64046,"iPhone13,2"
com.apple.mobilenotes,35,1726515286,1726515321,1726515321.971628,-18000,EB445137-D7F5-57EC-87DA-1DB460D64046,"iPhone13,2"
com.apple.mobilenotes,4,1726515271,1726515275,1726515275.114087,-18000,EB445137-D7F5-57EC-87DA-1DB460D64046,"iPhone13,2"
com.apple.mobilenotes,2,1726515211,1726515213,1726515213.9200292,-18000,EB445137-D7F5-57EC-87DA-1DB460D64046,"iPhone13,2"
com.apple.mobilenotes,2,1726515133,1726515135,1726515135.045133,-18000,EB445137-D7F5-57EC-87DA-1DB460D64046,"iPhone13,2"
com.apple.mobilenotes,43,1726515073,1726515116,1726515116.3249822,-18000,EB445137-D7F5-57EC-87DA-1DB460D64046,"iPhone13,2"
com.apple.mobilenotes,8,1726515006,1726515014,1726515014.840163,-18000,EB445137-D7F5-57EC-87DA-1DB460D64046,"iPhone13,2"
com.google.chrome.ios,76,1726514930,1726515006,1726515006.11042,-18000,EB445137-D7F5-57EC-87DA-1DB460D64046,"iPhone13,2"
com.apple.Music,10,1726514889,1726514899,1726514899.622184,-18000,EB445137-D7F5-57EC-87DA-1DB460D64046,"iPhone13,2"
com.apple.mobilenotes,5,1726514881,1726514886,1726514886.268821,-18000,EB445137-D7F5-57EC-87DA-1DB460D64046,"iPhone13,2"
com.apple.mobilenotes,6,1726514822,1726514828,1726514828.885654,-18000,EB445137-D7F5-57EC-87DA-1DB460D64046,"iPhone13,2"
com.apple.mobilenotes,2,1726514706,1726514708,1726514708.920658,-18000,EB445137-D7F5-57EC-87DA-1DB460D64046,"iPhone13,2"
com.apple.mobilenotes,49,1726514443,1726514492,1726514492.146512,-18000,EB445137-D7F5-57EC-87DA-1DB460D64046,"iPhone13,2"
com.apple.mobileslideshow,2,1726514437,1726514439,1726514439.8555012,-18000,EB445137-D7F5-57EC-87DA-1DB460D64046,"iPhone13,2"
com.apple.mobileslideshow,6,1726514267,1726514273,1726514273.650299,-18000,EB445137-D7F5-57EC-87DA-1DB460D64046,"iPhone13,2"
com.apple.mobileslideshow,5,1726514256,1726514261,1726514261.261972,-18000,EB445137-D7F5-57EC-87DA-1DB460D64046,"iPhone13,2"
com.leomehlig.today,2,1726514248,1726514250,1726514250.993582,-18000,EB445137-D7F5-57EC-87DA-1DB460D64046,"iPhone13,2"
com.leomehlig.today,18,1726514176,1726514194,1726514194.86806,-18000,EB445137-D7F5-57EC-87DA-1DB460D64046,"iPhone13,2"
com.microsoft.Office.Outlook,6,1726513426,1726513432,1726513432.297285,-18000,EB445137-D7F5-57EC-87DA-1DB460D64046,"iPhone13,2"
com.instructure.icanvas,16,1726513403,1726513419,1726513419.62816,-18000,EB445137-D7F5-57EC-87DA-1DB460D64046,"iPhone13,2"
com.instructure.icanvas,6,1726512556,1726512562,1726512562.745117,-18000,EB445137-D7F5-57EC-87DA-1DB460D64046,"iPhone13,2"
com.instructure.icanvas,6,1726511715,1726511721,1726511721.6032848,-18000,EB445137-D7F5-57EC-87DA-1DB460D64046,"iPhone13,2"
com.instructure.icanvas,35,1726511680,1726511715,1726511715.058896,-18000,EB445137-D7F5-57EC-87DA-1DB460D64046,"iPhone13,2"
com.google.chrome.ios,94,1726509457,1726509551,1726509551.5811849,-18000,EB445137-D7F5-57EC-87DA-1DB460D64046,"iPhone13,2"
com.apple.news,79,1726509377,1726509456,1726509456.734408,-18000,EB445137-D7F5-57EC-87DA-1DB460D64046,"iPhone13,2"
com.ally.MobileBanking,65,1726509295,1726509360,1726509360.767643,-18000,EB445137-D7F5-57EC-87DA-1DB460D64046,"iPhone13,2"
com.clairmail.fth.client,24,1726509264,1726509288,1726509288.097563,-18000,EB445137-D7F5-57EC-87DA-1DB460D64046,"iPhone13,2"
com.truebill.truebillnative,7,1726509256,1726509263,1726509263.067851,-18000,EB445137-D7F5-57EC-87DA-1DB460D64046,"iPhone13,2"
com.burbn.instagram,16,1726509229,1726509245,1726509245.4825048,-18000,EB445137-D7F5-57EC-87DA-1DB460D64046,"iPhone13,2"
com.burbn.instagram,15,1726509207,1726509222,1726509222.764669,-18000,EB445137-D7F5-57EC-87DA-1DB460D64046,"iPhone13,2"
com.truebill.truebillnative,35,1726509171,1726509206,1726509206.648118,-18000,EB445137-D7F5-57EC-87DA-1DB460D64046,"iPhone13,2"
com.apple.weather,16,1726509155,1726509171,1726509171.836405,-18000,EB445137-D7F5-57EC-87DA-1DB460D64046,"iPhone13,2"
com.truebill.truebillnative,7,1726509148,1726509155,1726509155.2349539,-18000,EB445137-D7F5-57EC-87DA-1DB460D64046,"iPhone13,2"
com.apple.news,10,1726509137,1726509147,1726509147.489377,-18000,EB445137-D7F5-57EC-87DA-1DB460D64046,"iPhone13,2"
com.apple.weather,6,1726509131,1726509137,1726509137.387733,-18000,EB445137-D7F5-57EC-87DA-1DB460D64046,"iPhone13,2"
com.truebill.truebillnative,18,1726509112,1726509130,1726509130.634369,-18000,EB445137-D7F5-57EC-87DA-1DB460D64046,"iPhone13,2"
com.truebill.truebillnative,39,1726508968,1726509007,1726509007.681798,-18000,EB445137-D7F5-57EC-87DA-1DB460D64046,"iPhone13,2"
com.truebill.truebillnative,53,1726508912,1726508965,1726508965.857823,-18000,EB445137-D7F5-57EC-87DA-1DB460D64046,"iPhone13,2"
com.leomehlig.today,5,1726507941,1726507946,1726507946.602694,-18000,,
com.myfitnesspal.mfp,4,1726507746,1726507750,1726507750.4954882,-18000,EB445137-D7F5-57EC-87DA-1DB460D64046,"iPhone13,2"
com.myfitnesspal.mfp,5,1726507692,1726507697,1726507697.1642141,-18000,EB445137-D7F5-57EC-87DA-1DB460D64046,"iPhone13,2"
com.leomehlig.today,314,1726507365,1726507679,1726507679.2609081,-18000,,
com.apple.Notes,8,1726507357,1726507365,1726507365.583158,-18000,,
com.leomehlig.today,4,1726507353,1726507357,1726507357.743299,-18000,,
com.hnc.Discord,36,1726507317,1726507353,1726507353.978389,-18000,,
com.leomehlig.today,1,1726507316,1726507317,1726507317.9588661,-18000,,
com.microsoft.Outlook,5,1726507311,1726507316,1726507316.519598,-18000,,
com.myfitnesspal.mfp,68,1726507241,1726507309,1726507309.458977,-18000,EB445137-D7F5-57EC-87DA-1DB460D64046,"iPhone13,2"
com.microsoft.Office.Outlook,3,1726507238,1726507241,1726507241.6491761,-18000,EB445137-D7F5-57EC-87DA-1DB460D64046,"iPhone13,2"
com.leomehlig.today,134,1726507177,1726507311,1726507311.921082,-18000,,
com.apple.Notes,4,1726507173,1726507177,1726507177.908834,-18000,,
com.leomehlig.today,3,1726507170,1726507173,1726507173.647233,-18000,,
com.apple.iCal,2,1726507168,1726507170,1726507170.760806,-18000,,
com.leomehlig.today,18,1726507150,1726507168,1726507168.966078,-18000,,
com.apple.iCal,2,1726507148,1726507150,1726507150.671622,-18000,,
com.apple.Notes,5,1726507143,1726507148,1726507148.543812,-18000,,
com.apple.iCal,15,1726507128,1726507143,1726507143.466195,-18000,,
com.microsoft.Outlook,2,1726507126,1726507128,1726507128.8602781,-18000,,
com.hnc.Discord,1,1726507125,1726507126,1726507126.908139,-18000,,
com.microsoft.Outlook,1,1726507124,1726507125,1726507125.922667,-18000,,
com.hnc.Discord,31,1726507093,1726507124,1726507124.689733,-18000,,
com.microsoft.Office.Outlook,62,1726507084,1726507146,1726507146.148777,-18000,EB445137-D7F5-57EC-87DA-1DB460D64046,"iPhone13,2"
com.myfitnesspal.mfp,2,1726507081,1726507083,1726507083.338413,-18000,EB445137-D7F5-57EC-87DA-1DB460D64046,"iPhone13,2"
com.microsoft.Outlook,16,1726507077,1726507093,1726507093.0435371,-18000,,
com.leomehlig.today,14,1726507063,1726507077,1726507077.0770922,-18000,,
com.microsoft.Outlook,55,1726507008,1726507063,1726507063.3271189,-18000,,
com.hnc.Discord,16,1726506992,1726507008,1726507008.5909848,-18000,,
com.myfitnesspal.mfp,6,1726506978,1726506984,1726506985.1555882,-18000,EB445137-D7F5-57EC-87DA-1DB460D64046,"iPhone13,2"
com.microsoft.Outlook,62,1726506930,1726506992,1726506993.0306869,-18000,,
com.hnc.Discord,5,1726506925,1726506930,1726506930.072042,-18000,,
com.microsoft.Outlook,0,1726506925,1726506925,1726506925.418961,-18000,,
com.hnc.Discord,4,1726506921,1726506925,1726506925.103774,-18000,,
com.myfitnesspal.mfp,9,1726506918,1726506927,1726506927.400382,-18000,EB445137-D7F5-57EC-87DA-1DB460D64046,"iPhone13,2"
com.microsoft.Outlook,7,1726506914,1726506921,1726506921.606238,-18000,,
com.hnc.Discord,4,1726506910,1726506914,1726506914.95294,-18000,,
com.microsoft.Outlook,28,1726506882,1726506910,1726506910.146153,-18000,,
com.hnc.Discord,7,1726506875,1726506882,1726506882.700255,-18000,,
com.microsoft.Outlook,53,1726506822,1726506875,1726506875.3684459,-18000,,
com.hnc.Discord,8,1726506814,1726506822,1726506822.368314,-18000,,
com.myfitnesspal.mfp,7,1726506812,1726506819,1726506819.645132,-18000,EB445137-D7F5-57EC-87DA-1DB460D64046,"iPhone13,2"
com.microsoft.Outlook,4,1726506810,1726506814,1726506814.8048239,-18000,,
com.hnc.Discord,2,1726506808,1726506810,1726506810.284154,-18000,,
com.microsoft.Outlook,60,1726506748,1726506808,1726506808.719435,-18000,,
com.hnc.Discord,4,1726506744,1726506748,1726506748.328713,-18000,,
com.microsoft.Outlook,25,1726506719,1726506744,1726506744.414163,-18000,,
com.hnc.Discord,1,1726506718,1726506719,1726506719.3583,-18000,,
com.myfitnesspal.mfp,7,1726506717,1726506724,1726506724.9330711,-18000,EB445137-D7F5-57EC-87DA-1DB460D64046,"iPhone13,2"
com.microsoft.Outlook,6,1726506712,1726506718,1726506718.5244331,-18000,,
com.hnc.Discord,23,1726506689,1726506712,1726506712.446748,-18000,,
com.myfitnesspal.mfp,8,1726506687,1726506695,1726506695.046475,-18000,EB445137-D7F5-57EC-87DA-1DB460D64046,"iPhone13,2"
com.myfitnesspal.mfp,8,1726506664,1726506672,1726506672.228292,-18000,EB445137-D7F5-57EC-87DA-1DB460D64046,"iPhone13,2"
com.myfitnesspal.mfp,7,1726506650,1726506657,1726506657.773923,-18000,EB445137-D7F5-57EC-87DA-1DB460D64046,"iPhone13,2"
com.myfitnesspal.mfp,7,1726506571,1726506578,1726506578.992968,-18000,EB445137-D7F5-57EC-87DA-1DB460D64046,"iPhone13,2"
com.myfitnesspal.mfp,7,1726506543,1726506550,1726506550.710813,-18000,EB445137-D7F5-57EC-87DA-1DB460D64046,"iPhone13,2"
com.microsoft.Outlook,244,1726506445,1726506689,1726506689.847997,-18000,,
com.hnc.Discord,15,1726506430,1726506445,1726506445.1127372,-18000,,
com.myfitnesspal.mfp,197,1726506344,1726506541,1726506541.423868,-18000,EB445137-D7F5-57EC-87DA-1DB460D64046,"iPhone13,2"
com.myfitnesspal.mfp,7,1726506295,1726506302,1726506302.4295511,-18000,EB445137-D7F5-57EC-87DA-1DB460D64046,"iPhone13,2"
com.microsoft.Outlook,139,1726506291,1726506430,1726506430.311521,-18000,,
com.hnc.Discord,9,1726506282,1726506291,1726506291.765973,-18000,,
com.microsoft.Outlook,5,1726506277,1726506282,1726506282.577413,-18000,,
com.hnc.Discord,5,1726506272,1726506277,1726506277.6092892,-18000,,
com.myfitnesspal.mfp,11,1726506234,1726506245,1726506245.166179,-18000,EB445137-D7F5-57EC-87DA-1DB460D64046,"iPhone13,2"
com.microsoft.Outlook,42,1726506230,1726506272,1726506272.2013679,-18000,,
com.hnc.Discord,3,1726506227,1726506230,1726506230.129377,-18000,,
com.myfitnesspal.mfp,13,1726506140,1726506153,1726506153.229625,-18000,EB445137-D7F5-57EC-87DA-1DB460D64046,"iPhone13,2"
com.myfitnesspal.mfp,13,1726506093,1726506106,1726506106.86033,-18000,EB445137-D7F5-57EC-87DA-1DB460D64046,"iPhone13,2"
com.microsoft.Outlook,166,1726506061,1726506227,1726506227.714655,-18000,,
com.hnc.Discord,4,1726506057,1726506061,1726506062.0218601,-18000,,
com.microsoft.Outlook,3,1726506054,1726506057,1726506057.605778,-18000,,
com.hnc.Discord,12,1726506042,1726506054,1726506054.712235,-18000,,
com.microsoft.Outlook,17,1726506025,1726506042,1726506042.842912,-18000,,
com.hnc.Discord,7,1726506018,1726506025,1726506025.473283,-18000,,
com.microsoft.Outlook,10,1726506008,1726506018,1726506018.689678,-18000,,
com.hnc.Discord,3,1726506005,1726506008,1726506008.164208,-18000,,
com.myfitnesspal.mfp,7,1726506001,1726506008,1726506008.210247,-18000,EB445137-D7F5-57EC-87DA-1DB460D64046,"iPhone13,2"
com.myfitnesspal.mfp,6,1726505994,1726506000,1726506000.6087332,-18000,EB445137-D7F5-57EC-87DA-1DB460D64046,"iPhone13,2"
com.microsoft.Outlook,27,1726505978,1726506005,1726506005.90447,-18000,,
com.hnc.Discord,112,1726505866,1726505978,1726505979.027622,-18000,,
com.microsoft.Outlook,5,1726505861,1726505866,1726505866.8277888,-18000,,
com.google.Chrome,4,1726505857,1726505861,1726505861.546268,-18000,,
com.myfitnesspal.mfp,69,1726505784,1726505853,1726505853.5043979,-18000,EB445137-D7F5-57EC-87DA-1DB460D64046,"iPhone13,2"
com.myfitnesspal.mfp,1,1726505768,1726505769,1726505769.5372062,-18000,EB445137-D7F5-57EC-87DA-1DB460D64046,"iPhone13,2"
com.myfitnesspal.mfp,102,1726505635,1726505737,1726505737.049212,-18000,EB445137-D7F5-57EC-87DA-1DB460D64046,"iPhone13,2"
com.myfitnesspal.mfp,125,1726505134,1726505259,1726505259.0769029,-18000,EB445137-D7F5-57EC-87DA-1DB460D64046,"iPhone13,2"
com.toyopagroup.picaboo,20,1726504892,1726504912,1726504912.645689,-18000,EB445137-D7F5-57EC-87DA-1DB460D64046,"iPhone13,2"
com.thestorygraph.thestorygraph,17,1726504873,1726504890,1726504890.9189448,-18000,EB445137-D7F5-57EC-87DA-1DB460D64046,"iPhone13,2"
com.instructure.icanvas,4,1726504866,1726504870,1726504870.880972,-18000,EB445137-D7F5-57EC-87DA-1DB460D64046,"iPhone13,2"
com.instructure.icanvas,1,1726504809,1726504810,1726504810.38092,-18000,EB445137-D7F5-57EC-87DA-1DB460D64046,"iPhone13,2"
com.instructure.icanvas,1,1726503697,1726503698,1726503698.808243,-18000,EB445137-D7F5-57EC-87DA-1DB460D64046,"iPhone13,2"
com.instructure.icanvas,10,1726498749,1726498759,1726498759.835081,-18000,EB445137-D7F5-57EC-87DA-1DB460D64046,"iPhone13,2"
com.microsoft.Office.Outlook,13,1726498734,1726498747,1726498747.69065,-18000,EB445137-D7F5-57EC-87DA-1DB460D64046,"iPhone13,2"
com.myfitnesspal.mfp,3,1726498731,1726498734,1726498734.95617,-18000,EB445137-D7F5-57EC-87DA-1DB460D64046,"iPhone13,2"
com.myfitnesspal.mfp,2,1726498729,1726498731,1726498731.3051639,-18000,EB445137-D7F5-57EC-87DA-1DB460D64046,"iPhone13,2"
com.myfitnesspal.mfp,1,1726497774,1726497775,1726497775.080608,-18000,EB445137-D7F5-57EC-87DA-1DB460D64046,"iPhone13,2"
com.google.Chrome,35,1726497721,1726497756,1726497756.293083,-18000,,
com.apple.finder,4,1726497703,1726497707,1726497707.41753,-18000,,
com.microsoft.onenote.mac,5,1726497698,1726497703,1726497703.0851622,-18000,,
com.google.Chrome,4,1726497694,1726497698,1726497698.222124,-18000,,
com.microsoft.Word,78,1726497616,1726497694,1726497694.89712,-18000,,
com.google.Chrome,2,1726497614,1726497616,1726497616.539773,-18000,,
com.microsoft.Word,10,1726497604,1726497614,1726497614.87689,-18000,,
com.google.Chrome,9,1726497595,1726497604,1726497604.280905,-18000,,
com.microsoft.Word,219,1726497376,1726497595,1726497597.015007,-18000,,
com.apple.finder,4,1726497372,1726497376,1726497376.29368,-18000,,
com.microsoft.onenote.mac,53,1726497319,1726497372,1726497372.494241,-18000,,
com.apple.iCal,18,1726497301,1726497319,1726497319.8681211,-18000,,
com.leomehlig.today,25,1726497276,1726497301,1726497301.953391,-18000,,
com.myfitnesspal.mfp,58,1726497215,1726497273,1726497273.6668181,-18000,EB445137-D7F5-57EC-87DA-1DB460D64046,"iPhone13,2"
com.apple.weather,2,1726497213,1726497215,1726497215.607079,-18000,EB445137-D7F5-57EC-87DA-1DB460D64046,"iPhone13,2"
com.apple.weather,6,1726496354,1726496360,1726496360.888885,-18000,EB445137-D7F5-57EC-87DA-1DB460D64046,"iPhone13,2"
com.apple.weather,5,1726496283,1726496288,1726496288.54045,-18000,EB445137-D7F5-57EC-87DA-1DB460D64046,"iPhone13,2"
com.renpho.health,3,1726496280,1726496283,1726496283.062533,-18000,EB445137-D7F5-57EC-87DA-1DB460D64046,"iPhone13,2"
com.renpho.health,26,1726496210,1726496236,1726496236.111002,-18000,EB445137-D7F5-57EC-87DA-1DB460D64046,"iPhone13,2"
com.tinyspeck.chatlyio,5,1726496203,1726496208,1726496208.418573,-18000,EB445137-D7F5-57EC-87DA-1DB460D64046,"iPhone13,2"
com.leomehlig.today,57,1726495517,1726495574,1726495574.97503,-18000,,
com.apple.iCal,3,1726495514,1726495517,1726495517.852113,-18000,,
com.tinyspeck.chatlyio,38,1726495474,1726495512,1726495512.6662111,-18000,EB445137-D7F5-57EC-87DA-1DB460D64046,"iPhone13,2"
com.apple.Photos,69,1726495445,1726495514,1726495515.061853,-18000,,
com.apple.iCal,11,1726495434,1726495445,1726495445.870265,-18000,,
com.leomehlig.today,187,1726495247,1726495434,1726495434.780287,-18000,,
com.google.Chrome,224,1726495023,1726495247,1726495247.9695249,-18000,,
com.microsoft.Outlook,48,1726494975,1726495023,1726495023.1855059,-18000,,
com.google.Chrome,105,1726494870,1726494975,1726494975.133713,-18000,,
com.microsoft.Outlook,66,1726494804,1726494870,1726494870.233532,-18000,,
com.google.Chrome,8,1726494796,1726494804,1726494804.393919,-18000,,
com.apple.news,453,1726494088,1726494541,1726494541.334626,-18000,EB445137-D7F5-57EC-87DA-1DB460D64046,"iPhone13,2"
com.google.Chrome,44,1726459953,1726459997,1726459997.928133,-18000,,
com.leomehlig.today,175,1726459778,1726459953,1726459953.5140982,-18000,,
com.apple.Notes,1,1726459541,1726459542,1726459542.8290029,-18000,,
com.leomehlig.today,38,1726459503,1726459541,1726459541.201642,-18000,,
com.apple.Notes,3,1726459500,1726459503,1726459503.340482,-18000,,
com.leomehlig.today,18,1726459482,1726459500,1726459500.756511,-18000,,
com.apple.Notes,16,1726459466,1726459482,1726459482.545399,-18000,,
com.leomehlig.today,17,1726459449,1726459466,1726459466.5450869,-18000,,
com.apple.Notes,38,1726459411,1726459449,1726459449.912379,-18000,,
com.leomehlig.today,15,1726459396,1726459411,1726459411.538204,-18000,,
com.google.Chrome,25,1726459371,1726459396,1726459396.561744,-18000,,
com.leomehlig.today,13,1726459346,1726459359,1726459359.660943,-18000,,
com.microsoft.onenote.mac,205,1726459141,1726459346,1726459346.522532,-18000,,
com.leomehlig.today,47,1726459094,1726459141,1726459141.621348,-18000,,
com.google.Chrome,67,1726459027,1726459094,1726459094.815474,-18000,,
com.apple.Notes,130,1726458897,1726459027,1726459027.339227,-18000,,
com.google.Chrome,33,1726458864,1726458897,1726458898.021152,-18000,,
com.apple.Notes,10,1726458854,1726458864,1726458864.8727422,-18000,,
com.google.Chrome,35,1726458819,1726458854,1726458854.998018,-18000,,
com.apple.Notes,25,1726458794,1726458819,1726458819.609345,-18000,,
com.google.Chrome,1,1726458793,1726458794,1726458794.4151459,-18000,,
com.apple.Notes,3,1726458790,1726458793,1726458793.0758471,-18000,,
com.google.Chrome,1,1726458789,1726458790,1726458790.2260761,-18000,,
com.apple.Notes,1,1726458788,1726458789,1726458789.545315,-18000,,
com.google.Chrome,2,1726458786,1726458788,1726458788.569988,-18000,,
com.apple.Notes,1,1726458785,1726458786,1726458786.620449,-18000,,
com.google.Chrome,2,1726458783,1726458785,1726458785.403084,-18000,,
com.apple.Notes,3,1726458780,1726458783,1726458783.340948,-18000,,
com.google.Chrome,13,1726458767,1726458780,1726458780.651425,-18000,,
com.apple.Notes,2,1726458765,1726458767,1726458767.668134,-18000,,
com.google.Chrome,4,1726458761,1726458765,1726458765.713918,-18000,,
com.apple.Notes,1,1726458760,1726458761,1726458761.3982081,-18000,,
com.google.Chrome,2,1726458758,1726458760,1726458760.087522,-18000,,
com.apple.Notes,7,1726458751,1726458758,1726458758.243864,-18000,,
com.google.Chrome,1,1726458750,1726458751,1726458751.620401,-18000,,
com.apple.Notes,2,1726458748,1726458750,1726458750.8471022,-18000,,
com.google.Chrome,2,1726458746,1726458748,1726458748.12702,-18000,,
com.apple.Notes,2,1726458744,1726458746,1726458746.9254851,-18000,,
com.google.Chrome,1,1726458743,1726458744,1726458744.976739,-18000,,
com.apple.Notes,5,1726458738,1726458743,1726458743.997046,-18000,,
com.google.Chrome,28,1726458710,1726458738,1726458738.7584848,-18000,,
com.apple.Notes,60,1726458650,1726458710,1726458710.84731,-18000,,
com.google.Chrome,8,1726458642,1726458650,1726458650.3150182,-18000,,
com.apple.Notes,0,1726458642,1726458642,1726458642.953065,-18000,,
com.google.Chrome,3,1726458639,1726458642,1726458642.382617,-18000,,
com.apple.Notes,3,1726458636,1726458639,1726458639.494314,-18000,,
com.google.Chrome,2,1726458634,1726458636,1726458636.174341,-18000,,
com.apple.Notes,2,1726458632,1726458634,1726458634.377754,-18000,,
com.google.Chrome,20,1726458612,1726458632,1726458632.620856,-18000,,
com.apple.Notes,4,1726458608,1726458612,1726458612.9145179,-18000,,
com.google.Chrome,0,1726458608,1726458608,1726458608.913725,-18000,,
com.apple.Notes,3,1726458605,1726458608,1726458608.2282681,-18000,,
com.google.Chrome,1,1726458604,1726458605,1726458605.2636771,-18000,,
com.apple.Notes,2,1726458602,1726458604,1726458604.4381142,-18000,,
com.google.Chrome,1,1726458601,1726458602,1726458602.4173841,-18000,,
com.apple.Notes,4,1726458597,1726458601,1726458601.540825,-18000,,
com.google.Chrome,16,1726458581,1726458597,1726458597.3005772,-18000,,
com.apple.Notes,4,1726458577,1726458581,1726458581.959556,-18000,,
com.google.Chrome,22,1726458555,1726458577,1726458577.9394078,-18000,,
com.apple.Notes,2,1726458553,1726458555,1726458555.456423,-18000,,
com.google.Chrome,28,1726458525,1726458553,1726458553.721822,-18000,,
com.apple.Notes,1,1726458524,1726458525,1726458525.770385,-18000,,
com.google.Chrome,17,1726458507,1726458524,1726458524.917666,-18000,,
com.apple.Notes,18,1726458489,1726458507,1726458507.524644,-18000,,
com.google.Chrome,9,1726458480,1726458489,1726458489.68519,-18000,,
com.apple.Notes,6,1726458474,1726458480,1726458480.3451838,-18000,,
com.google.Chrome,39,1726458435,1726458474,1726458474.52393,-18000,,
com.apple.Notes,2,1726458433,1726458435,1726458435.943162,-18000,,
com.google.Chrome,2,1726458431,1726458433,1726458433.551759,-18000,,
com.apple.Notes,9,1726458422,1726458431,1726458431.093831,-18000,,
com.google.Chrome,1,1726458421,1726458422,1726458422.4740071,-18000,,
com.apple.Notes,0,1726458421,1726458421,1726458421.924631,-18000,,
com.google.Chrome,1,1726458420,1726458421,1726458421.501601,-18000,,
com.apple.Notes,4,1726458416,1726458420,1726458420.302696,-18000,,
com.google.Chrome,1,1726458415,1726458416,1726458416.7018209,-18000,,
com.apple.Notes,2,1726458413,1726458415,1726458415.738591,-18000,,
com.google.Chrome,5,1726458408,1726458413,1726458413.21671,-18000,,
com.apple.Notes,9,1726458399,1726458408,1726458408.458599,-18000,,
com.google.Chrome,0,1726458399,1726458399,1726458400.0367742,-18000,,
com.apple.Notes,17,1726458382,1726458399,1726458399.3637872,-18000,,
com.google.Chrome,70,1726458312,1726458382,1726458383.0156112,-18000,,
com.apple.Notes,3,1726458309,1726458312,1726458312.622383,-18000,,
com.google.Chrome,1,1726458308,1726458309,1726458309.166069,-18000,,
com.apple.Notes,3,1726458305,1726458308,1726458308.3962831,-18000,,
com.google.Chrome,1,1726458304,1726458305,1726458305.163353,-18000,,
com.apple.Notes,2,1726458302,1726458304,1726458304.1494179,-18000,,
com.google.Chrome,1,1726458301,1726458302,1726458302.090024,-18000,,
com.apple.Notes,6,1726458295,1726458301,1726458301.23404,-18000,,
com.google.Chrome,280,1726458015,1726458295,1726458295.836756,-18000,,
com.apple.Notes,31,1726457984,1726458015,1726458015.644804,-18000,,
com.google.Chrome,43,1726457941,1726457984,1726457984.9727411,-18000,,
com.apple.Notes,4,1726457937,1726457941,1726457941.881898,-18000,,
com.google.Chrome,10,1726457927,1726457937,1726457937.72608,-18000,,
com.apple.Notes,4,1726457923,1726457927,1726457927.262878,-18000,,
com.google.Chrome,19,1726457904,1726457923,1726457923.559694,-18000,,
com.apple.Notes,2,1726457902,1726457904,1726457904.750617,-18000,,
com.google.Chrome,5,1726457897,1726457902,1726457902.214641,-18000,,
com.apple.Notes,16,1726457881,1726457897,1726457897.837421,-18000,,
com.google.Chrome,1,1726457880,1726457881,1726457881.709995,-18000,,
com.apple.Notes,2,1726457878,1726457880,1726457880.722158,-18000,,
com.google.Chrome,5,1726457873,1726457878,1726457878.6133208,-18000,,
com.apple.Notes,7,1726457866,1726457873,1726457873.8912292,-18000,,
com.google.Chrome,2,1726457864,1726457866,1726457866.1079478,-18000,,
com.apple.Notes,2,1726457862,1726457864,1726457864.573399,-18000,,
com.google.Chrome,1,1726457861,1726457862,1726457862.627598,-18000,,
com.apple.Notes,4,1726457857,1726457861,1726457861.5784512,-18000,,
com.google.Chrome,2,1726457855,1726457857,1726457857.34634,-18000,,
com.apple.Notes,5,1726457850,1726457855,1726457856.044342,-18000,,
com.google.Chrome,15,1726457835,1726457850,1726457851.020117,-18000,,
com.apple.Notes,3,1726457832,1726457835,1726457835.437511,-18000,,
com.google.Chrome,3,1726457829,1726457832,1726457832.124267,-18000,,
com.apple.Notes,4,1726457825,1726457829,1726457830.011767,-18000,,
com.google.Chrome,11,1726457814,1726457825,1726457825.129163,-18000,,
com.apple.Notes,10,1726457804,1726457814,1726457814.262899,-18000,,
com.google.Chrome,44,1726457760,1726457804,1726457804.803073,-18000,,
com.apple.Notes,5,1726457755,1726457760,1726457760.2413158,-18000,,
com.google.Chrome,1,1726457754,1726457755,1726457755.590266,-18000,,
com.apple.Notes,1,1726457753,1726457754,1726457754.909627,-18000,,
com.google.Chrome,1,1726457752,1726457753,1726457753.492,-18000,,
com.apple.Notes,7,1726457745,1726457752,1726457752.4243999,-18000,,
com.google.Chrome,1,1726457744,1726457745,1726457745.938243,-18000,,
com.apple.Notes,31,1726457713,1726457744,1726457744.834858,-18000,,
com.google.Chrome,71,1726457642,1726457713,1726457713.1692219,-18000,,
com.apple.Notes,3,1726457639,1726457642,1726457642.657714,-18000,,
com.google.Chrome,17,1726457622,1726457639,1726457639.800647,-18000,,
com.apple.Notes,11,1726457611,1726457622,1726457622.808354,-18000,,
com.google.Chrome,1,1726457610,1726457611,1726457611.3645859,-18000,,
com.apple.Notes,13,1726457597,1726457610,1726457610.0795832,-18000,,
com.google.Chrome,1,1726457596,1726457597,1726457597.740668,-18000,,
com.apple.Notes,3,1726457593,1726457596,1726457596.6275768,-18000,,
com.google.Chrome,37,1726457556,1726457593,1726457593.76343,-18000,,
com.apple.Notes,81,1726457475,1726457556,1726457556.653547,-18000,,
com.google.Chrome,776,1726456699,1726457475,1726457475.861772,-18000,,
com.apple.MobileSMS,53,1726456646,1726456699,1726456699.105819,-18000,,
com.google.Chrome,156,1726456490,1726456646,1726456646.251302,-18000,,
com.apple.MobileSMS,5,1726456485,1726456490,1726456490.549891,-18000,,
com.google.Chrome,9,1726456476,1726456485,1726456485.271988,-18000,,
com.apple.MobileSMS,1,1726456475,1726456476,1726456476.470423,-18000,,
com.google.Chrome,18,1726456457,1726456475,1726456475.726502,-18000,,
com.apple.MobileSMS,13,1726456444,1726456457,1726456457.974544,-18000,,
com.google.Chrome,4,1726456440,1726456444,1726456444.91601,-18000,,
com.apple.MobileSMS,10,1726456430,1726456440,1726456440.0670009,-18000,,
com.google.Chrome,5,1726456425,1726456430,1726456430.517395,-18000,,
com.apple.MobileSMS,2,1726456423,1726456425,1726456425.153708,-18000,,
com.google.Chrome,18,1726456405,1726456423,1726456423.608448,-18000,,
com.apple.MobileSMS,14,1726456391,1726456405,1726456405.593213,-18000,,
com.google.Chrome,370,1726456021,1726456391,1726456391.735076,-18000,,
com.leomehlig.today,5,1726456016,1726456021,1726456022.176227,-18000,,
com.leomehlig.today,11,1726452042,1726452053,1726452053.2303982,-18000,,
com.google.Chrome,10,1726452032,1726452042,1726452042.986823,-18000,,
com.microsoft.onenote.mac,34,1726451998,1726452032,1726452032.42343,-18000,,
com.google.Chrome,2,1726451996,1726451998,1726451998.209748,-18000,,
com.microsoft.onenote.mac,50,1726451946,1726451996,1726451996.820463,-18000,,
com.google.Chrome,38,1726451908,1726451946,1726451946.361446,-18000,,
com.google.android.studio,425,1726451483,1726451908,1726451908.728993,-18000,,
com.google.Chrome,10,1726451473,1726451483,1726451483.3603,-18000,,
com.google.android.studio,247,1726451226,1726451473,1726451473.4256492,-18000,,
com.google.Chrome,9,1726451217,1726451226,1726451227.0826411,-18000,,
com.google.android.studio,91,1726451126,1726451217,1726451217.865872,-18000,,
com.google.Chrome,2,1726451124,1726451126,1726451126.686298,-18000,,
com.google.android.studio,6,1726451118,1726451124,1726451124.4700742,-18000,,
com.google.Chrome,25,1726451093,1726451118,1726451118.822558,-18000,,
com.google.android.studio,4,1726451089,1726451093,1726451094.043522,-18000,,
com.google.Chrome,23,1726451066,1726451089,1726451089.402211,-18000,,
com.google.android.studio,18,1726451048,1726451066,1726451066.97149,-18000,,
com.google.Chrome,35,1726451013,1726451048,1726451048.8386412,-18000,,
com.google.android.studio,923,1726450090,1726451013,1726451013.993052,-18000,,
com.google.Chrome,29,1726450061,1726450090,1726450090.550739,-18000,,
com.google.android.studio,233,1726449828,1726450061,1726450061.387857,-18000,,
com.google.Chrome,12,1726449816,1726449828,1726449828.857226,-18000,,
com.google.android.studio,22,1726449794,1726449816,1726449817.1045032,-18000,,
com.google.Chrome,3,1726449791,1726449794,1726449794.468426,-18000,,
com.google.android.studio,8,1726449783,1726449791,1726449791.707689,-18000,,
com.google.Chrome,3,1726449780,1726449783,1726449783.2593222,-18000,,
com.google.android.studio,52,1726449728,1726449780,1726449780.225731,-18000,,
com.google.Chrome,3,1726449725,1726449728,1726449728.094362,-18000,,
com.google.android.studio,9,1726449716,1726449725,1726449725.1010818,-18000,,
com.google.Chrome,16,1726449700,1726449716,1726449716.132065,-18000,,
com.google.android.studio,33,1726449667,1726449700,1726449700.448937,-18000,,
com.google.Chrome,12,1726449655,1726449667,1726449668.0599,-18000,,
com.google.android.studio,41,1726449614,1726449655,1726449655.266348,-18000,,
com.google.Chrome,43,1726449571,1726449614,1726449614.141763,-18000,,
com.google.android.studio,51,1726449520,1726449571,1726449572.058837,-18000,,
com.google.Chrome,10,1726449510,1726449520,1726449520.827969,-18000,,
com.google.android.studio,3,1726449507,1726449510,1726449510.9920568,-18000,,
com.google.Chrome,3,1726449504,1726449507,1726449507.166539,-18000,,
com.google.android.studio,55,1726449449,1726449504,1726449504.665513,-18000,,
com.google.Chrome,9,1726449440,1726449449,1726449450.0110002,-18000,,
com.google.android.studio,1,1726449439,1726449440,1726449440.513269,-18000,,
com.google.Chrome,9,1726449430,1726449439,1726449439.694207,-18000,,
com.google.android.studio,22,1726449408,1726449430,1726449430.618825,-18000,,
com.google.Chrome,3,1726449405,1726449408,1726449408.169005,-18000,,
com.google.android.studio,5,1726449400,1726449405,1726449405.8743548,-18000,,
com.google.Chrome,1,1726449399,1726449400,1726449400.507461,-18000,,
com.google.android.studio,4,1726449395,1726449399,1726449399.266397,-18000,,
com.google.Chrome,1,1726449394,1726449395,1726449395.4573731,-18000,,
com.google.android.studio,4,1726449390,1726449394,1726449394.331427,-18000,,
com.google.Chrome,1,1726449389,1726449390,1726449390.90106,-18000,,
com.google.android.studio,2,1726449387,1726449389,1726449389.866696,-18000,,
com.google.Chrome,0,1726449387,1726449387,1726449387.9875932,-18000,,
com.google.android.studio,15,1726449372,1726449387,1726449387.2190619,-18000,,
com.google.Chrome,2,1726449370,1726449372,1726449372.8609638,-18000,,
com.google.android.studio,1,1726449369,1726449370,1726449370.332859,-18000,,
com.google.Chrome,3,1726449366,1726449369,1726449369.15345,-18000,,
com.google.android.studio,10,1726449356,1726449366,1726449366.991575,-18000,,
com.google.Chrome,3,1726449353,1726449356,1726449356.762042,-18000,,
com.google.android.studio,3,1726449350,1726449353,1726449353.502921,-18000,,
com.google.Chrome,2,1726449348,1726449350,1726449350.156581,-18000,,
com.google.android.studio,22,1726449326,1726449348,1726449348.5760698,-18000,,
com.google.Chrome,1,1726449325,1726449326,1726449326.344829,-18000,,
com.google.android.studio,11,1726449314,1726449325,1726449325.1595922,-18000,,
com.google.Chrome,12,1726449302,1726449314,1726449314.080412,-18000,,
com.google.android.studio,3,1726449299,1726449302,1726449302.440055,-18000,,
com.google.Chrome,5,1726449294,1726449299,1726449299.220952,-18000,,
com.google.android.studio,7,1726449287,1726449294,1726449294.07275,-18000,,
com.google.Chrome,1,1726449286,1726449287,1726449287.865442,-18000,,
com.google.android.studio,19,1726449267,1726449286,1726449286.214297,-18000,,
com.google.Chrome,2,1726449265,1726449267,1726449267.3304482,-18000,,
com.google.android.studio,5,1726449260,1726449265,1726449266.026299,-18000,,
com.google.Chrome,7,1726449253,1726449260,1726449260.167495,-18000,,
com.google.android.studio,3,1726449250,1726449253,1726449253.902374,-18000,,
com.google.Chrome,36,1726449214,1726449250,1726449250.7174048,-18000,,
com.google.android.studio,35,1726449179,1726449214,1726449214.3072119,-18000,,
com.google.Chrome,2,1726449177,1726449179,1726449179.495292,-18000,,
com.google.android.studio,37,1726449140,1726449177,1726449177.996326,-18000,,
com.google.Chrome,151,1726448989,1726449140,1726449140.964713,-18000,,
com.google.android.studio,121,1726448868,1726448989,1726448989.947459,-18000,,
com.microsoft.onenote.mac,27,1726448841,1726448868,1726448868.71249,-18000,,
com.google.android.studio,14,1726448827,1726448841,1726448842.05405,-18000,,
com.google.Chrome,6,1726448470,1726448476,1726448476.5493898,-18000,,
com.google.android.studio,12,1726448458,1726448470,1726448470.64053,-18000,,
com.google.Chrome,5,1726448453,1726448458,1726448458.765723,-18000,,
com.google.android.studio,5,1726448448,1726448453,1726448453.86902,-18000,,
com.google.Chrome,3,1726448445,1726448448,1726448448.3856611,-18000,,
com.google.android.studio,7,1726448438,1726448445,1726448445.47134,-18000,,
com.google.Chrome,139,1726448299,1726448438,1726448438.349849,-18000,,
com.apple.Notes,22,1726448277,1726448299,1726448299.433892,-18000,,
com.google.Chrome,7,1726448270,1726448277,1726448277.643287,-18000,,
com.leomehlig.today,60,1726448210,1726448270,1726448270.433072,-18000,,
com.google.Chrome,625,1726447585,1726448210,1726448210.554618,-18000,,
com.leomehlig.today,17,1726447568,1726447585,1726447585.360489,-18000,,
com.google.Chrome,404,1726447164,1726447568,1726447568.887511,-18000,,
com.leomehlig.today,16,1726447148,1726447164,1726447164.119098,-18000,,
com.google.Chrome,327,1726446821,1726447148,1726447148.891135,-18000,,
com.leomehlig.today,11,1726446810,1726446821,1726446821.518245,-18000,,
com.google.Chrome,5,1726446805,1726446810,1726446810.752208,-18000,,
com.leomehlig.today,3,1726446802,1726446805,1726446805.494862,-18000,,
com.google.Chrome,852,1726445950,1726446802,1726446802.326612,-18000,,
com.leomehlig.today,6,1726445944,1726445950,1726445950.751466,-18000,,
com.google.Chrome,1149,1726444795,1726445944,1726445944.355593,-18000,,
com.google.Chrome,2173,1726442426,1726444599,1726444599.26503,-18000,,
com.leomehlig.today,32,1726442394,1726442426,1726442426.8921208,-18000,,
com.google.Chrome,155,1726442239,1726442394,1726442394.259781,-18000,,
com.myfitnesspal.mfp,4,1726442184,1726442188,1726442188.645248,-18000,EB445137-D7F5-57EC-87DA-1DB460D64046,"iPhone13,2"
com.myfitnesspal.mfp,449,1726440907,1726441356,1726441356.180723,-18000,EB445137-D7F5-57EC-87DA-1DB460D64046,"iPhone13,2"
com.hammerandchisel.discord,3,1726440904,1726440907,1726440907.125449,-18000,EB445137-D7F5-57EC-87DA-1DB460D64046,"iPhone13,2"
com.apple.MobileSMS,9,1726440895,1726440904,1726440904.471335,-18000,EB445137-D7F5-57EC-87DA-1DB460D64046,"iPhone13,2"
com.apple.mobilenotes,3,1726440892,1726440895,1726440895.9456549,-18000,EB445137-D7F5-57EC-87DA-1DB460D64046,"iPhone13,2"
com.apple.camera,7,1726440638,1726440645,1726440646.1821818,-18000,EB445137-D7F5-57EC-87DA-1DB460D64046,"iPhone13,2"
com.apple.mobilenotes,9,1726440636,1726440645,1726440646.237033,-18000,EB445137-D7F5-57EC-87DA-1DB460D64046,"iPhone13,2"
com.apple.mobilenotes,71,1726440306,1726440377,1726440377.489583,-18000,EB445137-D7F5-57EC-87DA-1DB460D64046,"iPhone13,2"
com.toyopagroup.picaboo,2,1726439131,1726439133,1726439133.667083,-18000,EB445137-D7F5-57EC-87DA-1DB460D64046,"iPhone13,2"
com.apple.mobiletimer,3,1726439128,1726439131,1726439131.743091,-18000,EB445137-D7F5-57EC-87DA-1DB460D64046,"iPhone13,2"
com.apple.mobiletimer,11,1726438926,1726438937,1726438937.440888,-18000,EB445137-D7F5-57EC-87DA-1DB460D64046,"iPhone13,2"
com.apple.mobiletimer,129,1726438545,1726438674,1726438674.3753572,-18000,EB445137-D7F5-57EC-87DA-1DB460D64046,"iPhone13,2"
com.google.chrome.ios,45,1726438500,1726438545,1726438545.42806,-18000,EB445137-D7F5-57EC-87DA-1DB460D64046,"iPhone13,2"
com.toyopagroup.picaboo,3,1726438497,1726438500,1726438501.08384,-18000,EB445137-D7F5-57EC-87DA-1DB460D64046,"iPhone13,2"
com.toyopagroup.picaboo,22,1726438474,1726438496,1726438496.1377602,-18000,EB445137-D7F5-57EC-87DA-1DB460D64046,"iPhone13,2"
com.google.chrome.ios,98,1726438376,1726438474,1726438474.9468122,-18000,EB445137-D7F5-57EC-87DA-1DB460D64046,"iPhone13,2"
com.google.chrome.ios,67,1726438285,1726438352,1726438352.319485,-18000,EB445137-D7F5-57EC-87DA-1DB460D64046,"iPhone13,2"
com.apple.mobiletimer,3,1726438282,1726438285,1726438285.259155,-18000,EB445137-D7F5-57EC-87DA-1DB460D64046,"iPhone13,2"
com.apple.mobiletimer,17,1726438168,1726438185,1726438185.3549829,-18000,EB445137-D7F5-57EC-87DA-1DB460D64046,"iPhone13,2"
com.apple.mobilenotes,3,1726438165,1726438168,1726438168.459631,-18000,EB445137-D7F5-57EC-87DA-1DB460D64046,"iPhone13,2"
com.apple.mobilenotes,1,1726437103,1726437104,1726437104.705941,-18000,EB445137-D7F5-57EC-87DA-1DB460D64046,"iPhone13,2"
com.apple.mobilenotes,12,1726437020,1726437032,1726437032.640808,-18000,EB445137-D7F5-57EC-87DA-1DB460D64046,"iPhone13,2"
com.target.Target,2,1726437015,1726437017,1726437017.14672,-18000,EB445137-D7F5-57EC-87DA-1DB460D64046,"iPhone13,2"
com.target.Target,6,1726436138,1726436144,1726436144.675548,-18000,EB445137-D7F5-57EC-87DA-1DB460D64046,"iPhone13,2"
com.target.Target,35,1726436102,1726436137,1726436137.789221,-18000,EB445137-D7F5-57EC-87DA-1DB460D64046,"iPhone13,2"
com.google.chrome.ios,35,1726436067,1726436102,1726436102.470635,-18000,EB445137-D7F5-57EC-87DA-1DB460D64046,"iPhone13,2"
com.discoverfinancial.mobile,142,1726435562,1726435704,1726435704.362585,-18000,EB445137-D7F5-57EC-87DA-1DB460D64046,"iPhone13,2"
com.truebill.truebillnative,50,1726435510,1726435560,1726435560.110235,-18000,EB445137-D7F5-57EC-87DA-1DB460D64046,"iPhone13,2"
com.clairmail.fth.client,100,1726435342,1726435442,1726435442.7715921,-18000,EB445137-D7F5-57EC-87DA-1DB460D64046,"iPhone13,2"
com.truebill.truebillnative,5,1726435335,1726435340,1726435340.466615,-18000,EB445137-D7F5-57EC-87DA-1DB460D64046,"iPhone13,2"
com.google.Chrome,477,1726435246,1726435723,1726435723.149554,-18000,,
com.microsoft.onenote.mac,3,1726435243,1726435246,1726435246.4486299,-18000,,
com.google.Chrome,7,1726435236,1726435243,1726435243.506016,-18000,,
com.microsoft.onenote.mac,7,1726435229,1726435236,1726435236.6071892,-18000,,
com.truebill.truebillnative,12,1726435187,1726435199,1726435199.5731502,-18000,EB445137-D7F5-57EC-87DA-1DB460D64046,"iPhone13,2"
com.google.Chrome,187,1726435042,1726435229,1726435229.72942,-18000,,
com.microsoft.onenote.mac,6,1726435036,1726435042,1726435042.361291,-18000,,
com.google.Chrome,1,1726435035,1726435036,1726435036.8499808,-18000,,
com.microsoft.onenote.mac,3,1726435032,1726435035,1726435035.523242,-18000,,
com.google.Chrome,49,1726434983,1726435032,1726435032.070356,-18000,,
com.microsoft.onenote.mac,9,1726434974,1726434983,1726434983.5225759,-18000,,
com.apple.calculator,14,1726434960,1726434974,1726434974.601914,-18000,,
com.microsoft.onenote.mac,1,1726434959,1726434960,1726434960.904942,-18000,,
com.apple.calculator,9,1726434950,1726434959,1726434959.3513,-18000,,
com.microsoft.onenote.mac,2,1726434948,1726434950,1726434950.6600351,-18000,,
com.apple.calculator,2,1726434946,1726434948,1726434948.498452,-18000,,
com.microsoft.onenote.mac,39,1726434907,1726434946,1726434946.927589,-18000,,
com.google.Chrome,13,1726434894,1726434907,1726434907.759702,-18000,,
com.microsoft.onenote.mac,0,1726434894,1726434894,1726434894.950879,-18000,,
com.google.Chrome,12,1726434882,1726434894,1726434894.599699,-18000,,
com.microsoft.onenote.mac,2,1726434880,1726434882,1726434882.565768,-18000,,
com.google.Chrome,19,1726434861,1726434880,1726434880.400029,-18000,,
com.microsoft.onenote.mac,4,1726434857,1726434861,1726434861.137383,-18000,,
com.google.Chrome,32,1726434825,1726434857,1726434857.874959,-18000,,
com.microsoft.onenote.mac,138,1726434687,1726434825,1726434825.854624,-18000,,
com.google.Chrome,7,1726434680,1726434687,1726434687.918031,-18000,,
com.microsoft.onenote.mac,71,1726434609,1726434680,1726434680.6638699,-18000,,
com.google.Chrome,1,1726434608,1726434609,1726434609.1204119,-18000,,
com.apple.calculator,6,1726434602,1726434608,1726434608.12016,-18000,,
com.google.Chrome,3,1726434599,1726434602,1726434602.173078,-18000,,
com.apple.calculator,21,1726434578,1726434599,1726434599.542918,-18000,,
com.microsoft.onenote.mac,1,1726434577,1726434578,1726434578.907018,-18000,,
com.google.Chrome,10,1726434567,1726434577,1726434577.5852408,-18000,,
com.microsoft.onenote.mac,1,1726434566,1726434567,1726434567.3023071,-18000,,
com.apple.calculator,1,1726434565,1726434566,1726434566.220665,-18000,,
com.microsoft.onenote.mac,4,1726434561,1726434565,1726434565.5185862,-18000,,
com.apple.calculator,5,1726434556,1726434561,1726434561.9725409,-18000,,
com.microsoft.onenote.mac,11,1726434545,1726434556,1726434556.808797,-18000,,
com.apple.calculator,6,1726434539,1726434545,1726434545.558082,-18000,,
com.google.Chrome,2,1726434537,1726434539,1726434539.803252,-18000,,
com.apple.calculator,6,1726434531,1726434537,1726434537.072305,-18000,,
com.google.Chrome,1,1726434530,1726434531,1726434531.8300219,-18000,,
com.apple.calculator,4,1726434526,1726434530,1726434530.398032,-18000,,
com.google.Chrome,1,1726434525,1726434526,1726434526.64879,-18000,,
com.apple.calculator,5,1726434520,1726434525,1726434525.231133,-18000,,
com.google.Chrome,2,1726434518,1726434520,1726434520.049684,-18000,,
com.apple.calculator,4,1726434514,1726434518,1726434518.636345,-18000,,
com.google.Chrome,2,1726434512,1726434514,1726434514.35672,-18000,,
com.apple.calculator,4,1726434508,1726434512,1726434512.9574351,-18000,,
com.google.Chrome,1,1726434507,1726434508,1726434508.5451322,-18000,,
com.apple.calculator,5,1726434502,1726434507,1726434507.149966,-18000,,
com.google.Chrome,2,1726434500,1726434502,1726434502.216635,-18000,,
com.apple.calculator,4,1726434496,1726434500,1726434500.761335,-18000,,
com.google.Chrome,1,1726434495,1726434496,1726434496.612224,-18000,,
com.apple.calculator,5,1726434490,1726434495,1726434495.117054,-18000,,
com.google.Chrome,2,1726434488,1726434490,1726434490.282568,-18000,,
com.apple.calculator,5,1726434483,1726434488,1726434488.576623,-18000,,
com.google.Chrome,1,1726434482,1726434483,1726434483.205271,-18000,,
com.apple.calculator,8,1726434474,1726434482,1726434482.354909,-18000,,
com.google.Chrome,1,1726434473,1726434474,1726434474.9700499,-18000,,
com.apple.calculator,6,1726434467,1726434473,1726434473.2653089,-18000,,
com.google.Chrome,348,1726434119,1726434467,1726434467.318754,-18000,,
com.leomehlig.today,2,1726434067,1726434069,1726434069.128209,-18000,,
com.apple.keychainaccess,1,1726434066,1726434067,1726434067.806546,-18000,,
com.google.Chrome,11,1726434055,1726434066,1726434066.231732,-18000,,
com.apple.keychainaccess,7,1726434048,1726434055,1726434055.52934,-18000,,
com.google.Chrome,27,1726434021,1726434048,1726434049.027942,-18000,,
com.leomehlig.today,67,1726433756,1726433823,1726433823.58359,-18000,,
com.google.Chrome,19,1726433737,1726433756,1726433756.259756,-18000,,
com.leomehlig.today,4,1726433733,1726433737,1726433737.979877,-18000,,
com.google.Chrome,2220,1726431513,1726433733,1726433733.1692572,-18000,,
com.leomehlig.today,27,1726431486,1726431513,1726431513.945061,-18000,,
com.google.Chrome,195,1726431291,1726431486,1726431486.428602,-18000,,
com.apple.iCal,8,1726431283,1726431291,1726431291.847354,-18000,,
com.google.Chrome,8,1726431275,1726431283,1726431283.249121,-18000,,
com.leomehlig.today,10,1726431265,1726431275,1726431275.959686,-18000,,
com.google.Chrome,251,1726431014,1726431265,1726431265.543706,-18000,,
com.leomehlig.today,37,1726430977,1726431014,1726431014.0947042,-18000,,
com.google.Chrome,2,1726430975,1726430977,1726430977.355315,-18000,,
com.leomehlig.today,2,1726430973,1726430975,1726430975.344283,-18000,,
com.google.Chrome,1,1726430972,1726430973,1726430973.502205,-18000,,
com.apple.systempreferences,3,1726430969,1726430972,1726430973.033351,-18000,,
com.google.Chrome,18,1726430951,1726430969,1726430969.756386,-18000,,
com.apple.systempreferences,6,1726430945,1726430951,1726430951.869296,-18000,,
com.google.Chrome,16,1726430929,1726430945,1726430945.53969,-18000,,
com.leomehlig.today,8,1726430921,1726430929,1726430929.3624558,-18000,,
com.google.Chrome,47,1726430874,1726430921,1726430922.007534,-18000,,
com.apple.systempreferences,1,1726430873,1726430874,1726430874.7262511,-18000,,
com.google.Chrome,5,1726430861,1726430866,1726430867.001659,-18000,,
com.leomehlig.today,91,1726430770,1726430861,1726430861.681484,-18000,,
com.apple.iCal,43,1726430727,1726430770,1726430770.3953838,-18000,,
com.leomehlig.today,2,1726430725,1726430727,1726430727.279712,-18000,,
com.apple.iCal,1,1726430724,1726430725,1726430725.610678,-18000,,
com.leomehlig.today,25,1726430699,1726430724,1726430724.965095,-18000,,
com.apple.iCal,108,1726430591,1726430699,1726430699.632625,-18000,,
com.leomehlig.today,28,1726430563,1726430591,1726430591.2942228,-18000,,
com.google.Chrome,8,1726430555,1726430563,1726430563.571957,-18000,,
com.leomehlig.today,10,1726430545,1726430555,1726430555.6892672,-18000,,
com.google.Chrome,374,1726430171,1726430545,1726430545.1515288,-18000,,
com.leomehlig.today,40,1726430131,1726430171,1726430171.9353771,-18000,,
com.google.Chrome,236,1726429895,1726430131,1726430131.587759,-18000,,
com.leomehlig.today,14,1726429881,1726429895,1726429895.553701,-18000,,
com.google.Chrome,508,1726429373,1726429881,1726429881.5997949,-18000,,
com.leomehlig.today,2,1726429371,1726429373,1726429373.216761,-18000,,
com.google.Chrome,425,1726428946,1726429371,1726429371.74874,-18000,,
com.leomehlig.today,2,1726428944,1726428946,1726428946.8205528,-18000,,
com.google.Chrome,25,1726428919,1726428944,1726428944.7059631,-18000,,
com.leomehlig.today,3,1726428916,1726428919,1726428919.246994,-18000,,
com.microsoft.Office.Outlook,14,1726427969,1726427983,1726427983.243916,-18000,EB445137-D7F5-57EC-87DA-1DB460D64046,"iPhone13,2"
com.apple.MobileSMS,2,1726427964,1726427966,1726427966.989509,-18000,EB445137-D7F5-57EC-87DA-1DB460D64046,"iPhone13,2"
com.apple.Health,4,1726427960,1726427964,1726427964.335026,-18000,EB445137-D7F5-57EC-87DA-1DB460D64046,"iPhone13,2"
com.google.Chrome,1293,1726427623,1726428916,1726428917.023226,-18000,,
com.leomehlig.today,5,1726427618,1726427623,1726427623.557136,-18000,,
com.google.Chrome,29,1726427589,1726427618,1726427618.206449,-18000,,
com.leomehlig.today,29,1726427545,1726427574,1726427574.551544,-18000,,
com.google.Chrome,7,1726427538,1726427545,1726427545.734026,-18000,,
com.apple.Health,23,1726427175,1726427198,1726427198.951875,-18000,EB445137-D7F5-57EC-87DA-1DB460D64046,"iPhone13,2"
com.tier9digital.sundial,2,1726427171,1726427173,1726427173.910483,-18000,EB445137-D7F5-57EC-87DA-1DB460D64046,"iPhone13,2"
com.tier9digital.sundial,11,1726427120,1726427131,1726427131.968421,-18000,EB445137-D7F5-57EC-87DA-1DB460D64046,"iPhone13,2"
com.tier9digital.sundial,6,1726426383,1726426389,1726426389.682907,-18000,EB445137-D7F5-57EC-87DA-1DB460D64046,"iPhone13,2"
com.tier9digital.sundial,18,1726426364,1726426382,1726426382.9250731,-18000,EB445137-D7F5-57EC-87DA-1DB460D64046,"iPhone13,2"
Astrospheric.Astrospheric,2,1726426361,1726426363,1726426363.9365082,-18000,EB445137-D7F5-57EC-87DA-1DB460D64046,"iPhone13,2"
Astrospheric.Astrospheric,11,1726426348,1726426359,1726426359.876745,-18000,EB445137-D7F5-57EC-87DA-1DB460D64046,"iPhone13,2"
com.myfitnesspal.mfp,2,1726426345,1726426347,1726426347.815798,-18000,EB445137-D7F5-57EC-87DA-1DB460D64046,"iPhone13,2"
com.myfitnesspal.mfp,33,1726426153,1726426186,1726426187.1201792,-18000,EB445137-D7F5-57EC-87DA-1DB460D64046,"iPhone13,2"
com.apple.MobileSMS,2,1726426150,1726426152,1726426152.363895,-18000,EB445137-D7F5-57EC-87DA-1DB460D64046,"iPhone13,2"
com.apple.MobileSMS,39,1726425787,1726425826,1726425826.644516,-18000,EB445137-D7F5-57EC-87DA-1DB460D64046,"iPhone13,2"
com.apple.Health,4,1726425783,1726425787,1726425787.896226,-18000,EB445137-D7F5-57EC-87DA-1DB460D64046,"iPhone13,2"
com.google.Chrome,259,1726425701,1726425960,1726425960.7829242,-18000,,
com.google.android.studio,417,1726425284,1726425701,1726425701.581033,-18000,,
com.google.Chrome,10,1726425274,1726425284,1726425284.721874,-18000,,
com.google.android.studio,5,1726425269,1726425274,1726425274.908667,-18000,,
com.google.Chrome,2,1726425267,1726425269,1726425269.83583,-18000,,
com.google.android.studio,45,1726425222,1726425267,1726425267.1763248,-18000,,
com.google.Chrome,1,1726425221,1726425222,1726425222.364974,-18000,,
com.google.android.studio,1,1726425220,1726425221,1726425221.352693,-18000,,
com.google.Chrome,8,1726425212,1726425220,1726425220.3319921,-18000,,
com.google.android.studio,19,1726425193,1726425212,1726425213.004507,-18000,,
com.google.Chrome,2,1726425191,1726425193,1726425193.401648,-18000,,
com.google.android.studio,10,1726425181,1726425191,1726425191.759476,-18000,,
com.google.Chrome,1,1726425180,1726425181,1726425181.919488,-18000,,
com.google.android.studio,4,1726425176,1726425180,1726425180.6047878,-18000,,
com.google.Chrome,5,1726425171,1726425176,1726425176.071559,-18000,,
com.google.android.studio,2,1726425169,1726425171,1726425171.187649,-18000,,
com.google.Chrome,0,1726425169,1726425169,1726425169.963671,-18000,,
com.google.android.studio,131,1726425038,1726425169,1726425169.249496,-18000,,
com.google.Chrome,18,1726425020,1726425038,1726425038.869528,-18000,,
com.google.android.studio,157,1726424863,1726425020,1726425020.898699,-18000,,
com.google.Chrome,1,1726424862,1726424863,1726424864.060334,-18000,,
com.google.android.studio,2,1726424860,1726424862,1726424862.792115,-18000,,
com.google.Chrome,83,1726424777,1726424860,1726424860.8566031,-18000,,
com.google.android.studio,17,1726424760,1726424777,1726424777.3037229,-18000,,
com.google.Chrome,9,1726424751,1726424760,1726424760.1435242,-18000,,
com.leomehlig.today,93,1726424658,1726424751,1726424752.016317,-18000,,
com.google.Chrome,3,1726424655,1726424658,1726424658.444292,-18000,,
com.apple.Health,6,1726423286,1726423292,1726423292.379822,-18000,EB445137-D7F5-57EC-87DA-1DB460D64046,"iPhone13,2"
com.apple.Health,2,1726423283,1726423285,1726423285.75802,-18000,EB445137-D7F5-57EC-87DA-1DB460D64046,"iPhone13,2"
com.apple.Health,13,1726423258,1726423271,1726423271.833548,-18000,EB445137-D7F5-57EC-87DA-1DB460D64046,"iPhone13,2"
com.apple.camera,6,1726423250,1726423256,1726423256.354558,-18000,EB445137-D7F5-57EC-87DA-1DB460D64046,"iPhone13,2"
com.hammerandchisel.discord,5,1726423244,1726423249,1726423249.3913488,-18000,EB445137-D7F5-57EC-87DA-1DB460D64046,"iPhone13,2"
com.hammerandchisel.discord,6,1726423016,1726423022,1726423022.37155,-18000,EB445137-D7F5-57EC-87DA-1DB460D64046,"iPhone13,2"
com.hammerandchisel.discord,78,1726422854,1726422932,1726422932.257622,-18000,EB445137-D7F5-57EC-87DA-1DB460D64046,"iPhone13,2"
com.apple.mobilephone,9,1726422843,1726422852,1726422852.932102,-18000,EB445137-D7F5-57EC-87DA-1DB460D64046,"iPhone13,2"
com.apple.news,13,1726422827,1726422840,1726422840.257297,-18000,EB445137-D7F5-57EC-87DA-1DB460D64046,"iPhone13,2"
com.apple.news,60,1726422692,1726422752,1726422752.628109,-18000,EB445137-D7F5-57EC-87DA-1DB460D64046,"iPhone13,2"
com.apple.news,3,1726422480,1726422483,1726422483.310409,-18000,EB445137-D7F5-57EC-87DA-1DB460D64046,"iPhone13,2"
com.apple.news,67,1726422277,1726422344,1726422344.169349,-18000,EB445137-D7F5-57EC-87DA-1DB460D64046,"iPhone13,2"
com.apple.MobileSMS,4,1726422269,1726422273,1726422273.139441,-18000,EB445137-D7F5-57EC-87DA-1DB460D64046,"iPhone13,2"
com.apple.findmy,11,1726422258,1726422269,1726422269.65348,-18000,EB445137-D7F5-57EC-87DA-1DB460D64046,"iPhone13,2"
com.apple.MobileSMS,4,1726422108,1726422112,1726422112.343511,-18000,EB445137-D7F5-57EC-87DA-1DB460D64046,"iPhone13,2"
com.apple.mobilephone,14,1726422093,1726422107,1726422108.237453,-18000,EB445137-D7F5-57EC-87DA-1DB460D64046,"iPhone13,2"
com.apple.InCallService,11,1726422069,1726422080,1726422080.572775,-18000,EB445137-D7F5-57EC-87DA-1DB460D64046,"iPhone13,2"
com.apple.InCallService,2,1726422049,1726422051,1726422051.490687,-18000,EB445137-D7F5-57EC-87DA-1DB460D64046,"iPhone13,2"
com.microsoft.Office.Outlook,3,1726422046,1726422049,1726422049.421128,-18000,EB445137-D7F5-57EC-87DA-1DB460D64046,"iPhone13,2"
com.apple.InCallService,21,1726422025,1726422046,1726422047.009625,-18000,EB445137-D7F5-57EC-87DA-1DB460D64046,"iPhone13,2"
com.microsoft.Office.Outlook,36,1726421989,1726422025,1726422025.1479821,-18000,EB445137-D7F5-57EC-87DA-1DB460D64046,"iPhone13,2"
com.apple.MobileSMS,2,1726421985,1726421987,1726421987.454454,-18000,EB445137-D7F5-57EC-87DA-1DB460D64046,"iPhone13,2"
com.apple.Music,11,1726421974,1726421985,1726421985.448483,-18000,EB445137-D7F5-57EC-87DA-1DB460D64046,"iPhone13,2"
com.apple.Music,5,1726421723,1726421728,1726421728.7710829,-18000,EB445137-D7F5-57EC-87DA-1DB460D64046,"iPhone13,2"
com.apple.Music,6,1726421240,1726421246,1726421246.7130399,-18000,EB445137-D7F5-57EC-87DA-1DB460D64046,"iPhone13,2"
com.apple.Music,13,1726421227,1726421240,1726421240.17224,-18000,EB445137-D7F5-57EC-87DA-1DB460D64046,"iPhone13,2"
com.apple.mobilenotes,2,1726421223,1726421225,1726421225.84629,-18000,EB445137-D7F5-57EC-87DA-1DB460D64046,"iPhone13,2"
com.google.Chrome,165,1726419411,1726419576,1726419577.144249,-18000,,
com.google.android.studio,205,1726419166,1726419371,1726419371.372847,-18000,,
com.google.android.studio,431,1726418580,1726419011,1726419011.589222,-18000,,
com.google.Chrome,3,1726418577,1726418580,1726418580.870387,-18000,,
com.google.android.studio,5,1726418572,1726418577,1726418577.769546,-18000,,
com.google.Chrome,1,1726418571,1726418572,1726418572.51685,-18000,,
com.google.android.studio,1,1726418570,1726418571,1726418571.124918,-18000,,
com.google.Chrome,3,1726418567,1726418570,1726418570.1853352,-18000,,
com.google.android.studio,6,1726418561,1726418567,1726418567.665419,-18000,,
com.google.Chrome,1,1726418560,1726418561,1726418561.551824,-18000,,
com.google.android.studio,3,1726418557,1726418560,1726418560.159502,-18000,,
com.google.Chrome,13,1726418544,1726418557,1726418557.492362,-18000,,
com.google.android.studio,12,1726418532,1726418544,1726418544.842884,-18000,,
com.google.Chrome,92,1726418440,1726418532,1726418532.953407,-18000,,
com.google.android.studio,11,1726418429,1726418440,1726418440.668964,-18000,,
com.google.Chrome,2,1726418427,1726418429,1726418429.766223,-18000,,
com.google.android.studio,9,1726418418,1726418427,1726418427.712465,-18000,,
com.google.Chrome,54,1726418364,1726418418,1726418419.052864,-18000,,
com.google.android.studio,449,1726417915,1726418364,1726418364.7122478,-18000,,
com.google.Chrome,3,1726417912,1726417915,1726417915.549325,-18000,,
com.google.android.studio,102,1726417810,1726417912,1726417912.447933,-18000,,
com.google.Chrome,7,1726417803,1726417810,1726417810.180203,-18000,,
com.google.android.studio,62,1726417741,1726417803,1726417804.005526,-18000,,
com.google.Chrome,21,1726417720,1726417741,1726417741.724004,-18000,,
com.google.android.studio,49,1726417671,1726417720,1726417720.661652,-18000,,
com.google.Chrome,3,1726417668,1726417671,1726417671.173959,-18000,,
com.google.android.studio,21,1726417647,1726417668,1726417668.65699,-18000,,
com.google.Chrome,159,1726417488,1726417647,1726417647.48399,-18000,,
com.google.android.studio,2,1726417486,1726417488,1726417488.443026,-18000,,
com.google.Chrome,90,1726417396,1726417486,1726417486.605478,-18000,,
com.google.android.studio,176,1726417220,1726417396,1726417396.286765,-18000,,
com.google.Chrome,22,1726417198,1726417220,1726417220.493526,-18000,,
com.google.android.studio,1,1726417197,1726417198,1726417198.472125,-18000,,
com.google.Chrome,24,1726417173,1726417197,1726417197.653259,-18000,,
com.google.android.studio,373,1726416800,1726417173,1726417173.450262,-18000,,
com.google.Chrome,6,1726416794,1726416800,1726416800.26492,-18000,,
com.google.android.studio,16,1726416778,1726416794,1726416795.035497,-18000,,
com.google.Chrome,7,1726416771,1726416778,1726416779.005818,-18000,,
com.google.android.studio,2,1726416769,1726416771,1726416771.63587,-18000,,
com.google.Chrome,14,1726416755,1726416769,1726416770.030923,-18000,,
com.google.android.studio,3,1726416752,1726416755,1726416755.694181,-18000,,
com.google.Chrome,3,1726416749,1726416752,1726416752.496659,-18000,,
com.google.android.studio,10,1726416739,1726416749,1726416749.217071,-18000,,
com.google.Chrome,4,1726416735,1726416739,1726416739.436782,-18000,,
com.google.android.studio,9,1726416726,1726416735,1726416735.479195,-18000,,
com.google.Chrome,3,1726416723,1726416726,1726416726.842859,-18000,,
com.google.android.studio,9,1726416714,1726416723,1726416723.995809,-18000,,
com.google.Chrome,1,1726416713,1726416714,1726416714.998739,-18000,,
com.google.android.studio,1,1726416712,1726416713,1726416713.5807018,-18000,,
com.google.Chrome,2,1726416710,1726416712,1726416712.077704,-18000,,
com.google.android.studio,9,1726416701,1726416710,1726416710.969665,-18000,,
com.google.Chrome,2,1726416699,1726416701,1726416701.526791,-18000,,
com.google.android.studio,4,1726416695,1726416699,1726416700.012738,-18000,,
com.google.Chrome,2,1726416693,1726416695,1726416695.795649,-18000,,
com.google.android.studio,4,1726416689,1726416693,1726416693.219009,-18000,,
com.google.Chrome,4,1726416685,1726416689,1726416689.2036052,-18000,,
com.google.android.studio,12,1726416673,1726416685,1726416685.854466,-18000,,
com.google.Chrome,5,1726416668,1726416673,1726416673.939992,-18000,,
com.google.android.studio,4,1726416664,1726416668,1726416668.421722,-18000,,
com.google.Chrome,3,1726416661,1726416664,1726416664.497661,-18000,,
com.google.android.studio,1,1726416660,1726416661,1726416661.997503,-18000,,
com.google.Chrome,2,1726416658,1726416660,1726416660.712868,-18000,,
com.google.android.studio,14,1726416644,1726416658,1726416658.08799,-18000,,
com.google.Chrome,32,1726416612,1726416644,1726416644.2465758,-18000,,
com.google.android.studio,66,1726416546,1726416612,1726416612.950438,-18000,,
com.google.Chrome,1,1726416545,1726416546,1726416546.657841,-18000,,
com.google.android.studio,82,1726416463,1726416545,1726416545.911211,-18000,,
com.google.Chrome,1,1726416462,1726416463,1726416463.9514132,-18000,,
com.google.android.studio,12,1726416450,1726416462,1726416462.8213248,-18000,,
com.google.Chrome,12,1726416438,1726416450,1726416450.220978,-18000,,
com.google.android.studio,2,1726416436,1726416438,1726416438.437693,-18000,,
com.google.Chrome,13,1726416423,1726416436,1726416436.6718411,-18000,,
com.google.android.studio,56,1726416367,1726416423,1726416424.055447,-18000,,
com.google.Chrome,24,1726416343,1726416367,1726416367.480427,-18000,,
com.google.android.studio,211,1726416132,1726416343,1726416344.054727,-18000,,
com.google.Chrome,207,1726415790,1726415997,1726415997.525405,-18000,,
com.leomehlig.today,35,1726415755,1726415790,1726415791.022808,-18000,,
com.google.Chrome,6,1726415749,1726415755,1726415755.326682,-18000,,
com.google.Chrome,4,1726375530,1726375534,1726375534.4296331,-18000,,
com.apple.finder,6,1726375524,1726375530,1726375530.085772,-18000,,
com.apple.Preview,0,1726375524,1726375524,1726375524.7470589,-18000,,
com.apple.finder,1,1726375523,1726375524,1726375524.324183,-18000,,
com.leomehlig.today,0,1726375523,1726375523,1726375523.8016891,-18000,,
com.google.android.studio,152,1726375371,1726375523,1726375523.644583,-18000,,
com.google.Chrome,63,1726375308,1726375371,1726375371.920706,-18000,,
com.google.android.studio,667,1726374616,1726375283,1726375284.096788,-18000,,
com.leomehlig.today,4,1726374612,1726374616,1726374616.885329,-18000,,
com.google.android.studio,724,1726373888,1726374612,1726374612.662603,-18000,,
com.leomehlig.today,80,1726373808,1726373888,1726373888.201439,-18000,,
com.google.android.studio,3,1726373805,1726373808,1726373808.6783,-18000,,
com.google.android.studio,567,1726358448,1726359015,1726359015.442467,-18000,,
com.google.Chrome,1,1726358447,1726358448,1726358448.3113608,-18000,,
com.google.android.studio,3,1726358444,1726358447,1726358447.90464,-18000,,
com.google.Chrome,0,1726358444,1726358444,1726358444.8650231,-18000,,
com.google.android.studio,4,1726358440,1726358444,1726358444.065656,-18000,,
com.google.Chrome,0,1726358440,1726358440,1726358440.8906,-18000,,
com.google.android.studio,2,1726358438,1726358440,1726358440.173466,-18000,,
com.google.Chrome,2,1726358436,1726358438,1726358438.179086,-18000,,
com.google.android.studio,2,1726358434,1726358436,1726358436.960966,-18000,,
com.google.Chrome,2,1726358432,1726358434,1726358434.9478679,-18000,,
com.google.android.studio,53,1726358379,1726358432,1726358432.433943,-18000,,
com.google.Chrome,1,1726358378,1726358379,1726358379.5949259,-18000,,
com.google.android.studio,1,1726358377,1726358378,1726358378.399825,-18000,,
com.google.Chrome,0,1726358377,1726358377,1726358377.84838,-18000,,
com.google.android.studio,6,1726358371,1726358377,1726358377.394114,-18000,,
com.google.Chrome,4,1726358367,1726358371,1726358371.11375,-18000,,
com.google.android.studio,2,1726358365,1726358367,1726358367.193325,-18000,,
com.google.Chrome,17,1726358348,1726358365,1726358365.390224,-18000,,
com.google.android.studio,5,1726358343,1726358348,1726358348.607099,-18000,,
com.google.Chrome,1,1726358342,1726358343,1726358343.522501,-18000,,
com.google.android.studio,27,1726358315,1726358342,1726358342.4288201,-18000,,
com.google.Chrome,1,1726358314,1726358315,1726358315.503758,-18000,,
com.google.android.studio,2,1726358312,1726358314,1726358314.61198,-18000,,
com.google.Chrome,27,1726358285,1726358312,1726358312.787663,-18000,,
com.google.android.studio,17,1726358268,1726358285,1726358285.061037,-18000,,
com.google.Chrome,34,1726358234,1726358268,1726358268.6765661,-18000,,
com.google.android.studio,63,1726358171,1726358234,1726358234.995817,-18000,,
com.google.Chrome,284,1726357887,1726358171,1726358171.8685908,-18000,,
com.google.android.studio,10,1726357877,1726357887,1726357887.046126,-18000,,
com.google.Chrome,13,1726357864,1726357877,1726357877.5977511,-18000,,
com.google.android.studio,5,1726357859,1726357864,1726357864.4533648,-18000,,
com.google.android.studio,67,1726352690,1726352757,1726352757.402256,-18000,,
com.google.Chrome,64,1726352626,1726352690,1726352690.7632961,-18000,,
com.google.android.studio,10,1726352616,1726352626,1726352626.670708,-18000,,
com.google.Chrome,31,1726352585,1726352616,1726352616.4368792,-18000,,
com.google.android.studio,9,1726352576,1726352585,1726352585.2243838,-18000,,
com.google.Chrome,5,1726352571,1726352576,1726352576.902056,-18000,,
com.google.android.studio,2,1726352569,1726352571,1726352571.565497,-18000,,
com.google.Chrome,9,1726352560,1726352569,1726352569.710359,-18000,,
com.google.android.studio,8,1726352552,1726352560,1726352560.340131,-18000,,
com.google.Chrome,2,1726352550,1726352552,1726352552.891461,-18000,,
com.google.android.studio,2,1726352548,1726352550,1726352550.515434,-18000,,
com.google.Chrome,2,1726352546,1726352548,1726352548.805605,-18000,,
com.google.android.studio,6,1726352540,1726352546,1726352546.660163,-18000,,
com.google.Chrome,7,1726352533,1726352540,1726352540.259711,-18000,,
com.google.android.studio,21,1726352512,1726352533,1726352534.0027041,-18000,,
com.google.Chrome,7,1726352505,1726352512,1726352513.0032039,-18000,,
com.google.android.studio,12,1726352493,1726352505,1726352505.279017,-18000,,
com.google.Chrome,3,1726352490,1726352493,1726352493.206637,-18000,,
com.google.android.studio,61,1726352429,1726352490,1726352490.8706331,-18000,,
com.google.Chrome,15,1726352414,1726352429,1726352429.396546,-18000,,
com.google.android.studio,75,1726352339,1726352414,1726352414.185775,-18000,,
com.google.Chrome,5,1726352334,1726352339,1726352339.993973,-18000,,
com.google.android.studio,9,1726352325,1726352334,1726352334.3885689,-18000,,
com.google.Chrome,3,1726352322,1726352325,1726352325.916827,-18000,,
com.google.android.studio,32,1726352290,1726352322,1726352322.900576,-18000,,
com.google.Chrome,37,1726352253,1726352290,1726352290.5703092,-18000,,
com.google.android.studio,165,1726352088,1726352253,1726352253.749878,-18000,,
com.google.Chrome,2,1726352086,1726352088,1726352088.796504,-18000,,
com.google.android.studio,5,1726352081,1726352086,1726352086.272244,-18000,,
com.google.Chrome,38,1726352043,1726352081,1726352081.653559,-18000,,
com.google.android.studio,7,1726352036,1726352043,1726352043.170833,-18000,,
com.google.Chrome,29,1726352007,1726352036,1726352036.907577,-18000,,
com.google.android.studio,87,1726351920,1726352007,1726352007.303393,-18000,,
com.google.Chrome,125,1726351795,1726351920,1726351920.923802,-18000,,
com.google.android.studio,49,1726351746,1726351795,1726351796.011128,-18000,,
com.google.Chrome,4,1726351742,1726351746,1726351746.830267,-18000,,
com.google.android.studio,1,1726351741,1726351742,1726351742.819726,-18000,,
com.google.Chrome,4,1726351737,1726351741,1726351741.261168,-18000,,
com.google.android.studio,5,1726351732,1726351737,1726351737.317397,-18000,,
com.google.Chrome,4,1726351728,1726351732,1726351732.962524,-18000,,
com.google.android.studio,16,1726351712,1726351728,1726351729.0418549,-18000,,
com.google.Chrome,19,1726351693,1726351712,1726351712.570222,-18000,,
com.google.android.studio,59,1726351634,1726351693,1726351693.311822,-18000,,
com.google.Chrome,5,1726351629,1726351634,1726351635.0505319,-18000,,
com.google.android.studio,10,1726351619,1726351629,1726351629.3067598,-18000,,
com.google.Chrome,25,1726351594,1726351619,1726351619.528829,-18000,,
com.google.android.studio,11,1726351583,1726351594,1726351594.324984,-18000,,
com.google.Chrome,9,1726351574,1726351583,1726351583.811481,-18000,,
com.google.android.studio,1,1726351573,1726351574,1726351574.859281,-18000,,
com.google.Chrome,16,1726351557,1726351573,1726351573.113037,-18000,,
com.google.android.studio,95,1726351462,1726351557,1726351557.1957989,-18000,,
com.google.Chrome,11,1726351451,1726351462,1726351462.823241,-18000,,
com.google.android.studio,40,1726351411,1726351451,1726351451.80386,-18000,,
com.google.Chrome,9,1726351402,1726351411,1726351411.9416618,-18000,,
com.google.android.studio,13,1726351389,1726351402,1726351402.946095,-18000,,
com.google.Chrome,3,1726351386,1726351389,1726351389.7091532,-18000,,
com.google.android.studio,49,1726351337,1726351386,1726351386.6051722,-18000,,
com.google.Chrome,1,1726351336,1726351337,1726351337.221425,-18000,,
com.google.android.studio,5,1726351331,1726351336,1726351336.651322,-18000,,
com.google.Chrome,5,1726351326,1726351331,1726351331.654224,-18000,,
com.google.android.studio,65,1726351261,1726351326,1726351326.149739,-18000,,
com.google.Chrome,1,1726351260,1726351261,1726351261.909123,-18000,,
com.google.android.studio,19,1726351241,1726351260,1726351260.4604,-18000,,
com.google.Chrome,356,1726350885,1726351241,1726351241.854003,-18000,,
com.google.android.studio,1,1726350884,1726350885,1726350885.863877,-18000,,
com.google.Chrome,19,1726350865,1726350884,1726350884.0970259,-18000,,
com.google.android.studio,8,1726350857,1726350865,1726350865.159186,-18000,,
com.google.Chrome,2,1726350855,1726350857,1726350857.547503,-18000,,
com.google.android.studio,13,1726350842,1726350855,1726350855.645763,-18000,,
com.google.Chrome,35,1726350807,1726350842,1726350842.687436,-18000,,
com.google.android.studio,33,1726350774,1726350807,1726350807.9160252,-18000,,
com.google.Chrome,2,1726350772,1726350774,1726350774.093921,-18000,,
com.google.android.studio,8,1726350764,1726350772,1726350772.466964,-18000,,
com.google.Chrome,160,1726350604,1726350764,1726350764.688552,-18000,,
com.google.android.studio,180,1726350424,1726350604,1726350604.893223,-18000,,
com.google.Chrome,40,1726350384,1726350424,1726350424.2630439,-18000,,
com.google.android.studio,261,1726350123,1726350384,1726350384.844555,-18000,,
com.google.Chrome,1,1726350122,1726350123,1726350123.145897,-18000,,
com.google.android.studio,22,1726350100,1726350122,1726350122.053793,-18000,,
com.google.Chrome,5,1726350095,1726350100,1726350101.012944,-18000,,
com.google.android.studio,6,1726350089,1726350095,1726350095.171176,-18000,,
com.google.Chrome,5,1726350084,1726350089,1726350089.229971,-18000,,
com.google.android.studio,1,1726350083,1726350084,1726350084.7595382,-18000,,
com.google.Chrome,1,1726350082,1726350083,1726350083.180781,-18000,,
com.google.android.studio,18,1726350064,1726350082,1726350082.626844,-18000,,
com.google.Chrome,16,1726350048,1726350064,1726350064.704132,-18000,,
com.google.android.studio,166,1726349882,1726350048,1726350048.782237,-18000,,
com.google.Chrome,0,1726349882,1726349882,1726349882.859776,-18000,,
com.google.android.studio,7,1726349875,1726349882,1726349882.3919868,-18000,,
com.google.Chrome,8,1726349867,1726349875,1726349875.848415,-18000,,
com.apple.dt.Instruments,1,1726349866,1726349867,1726349867.5122461,-18000,,
com.google.Chrome,23,1726349843,1726349866,1726349866.4608068,-18000,,
com.apple.dt.Instruments,24,1726349819,1726349843,1726349843.27767,-18000,,
com.google.android.studio,35,1726349784,1726349819,1726349819.667717,-18000,,
com.apple.finder,29,1726349734,1726349763,1726349763.218522,-18000,,
com.google.android.studio,9,1726349725,1726349734,1726349734.424236,-18000,,
com.apple.dt.Instruments,5,1726349720,1726349725,1726349725.319724,-18000,,
com.apple.dt.Xcode,112,1726349608,1726349720,1726349720.1255732,-18000,,
com.apple.dt.Instruments,104,1726349504,1726349608,1726349608.068009,-18000,,
com.apple.iphonesimulator,4,1726349500,1726349504,1726349504.9325519,-18000,,
com.apple.dt.Instruments,6,1726349494,1726349500,1726349500.289995,-18000,,
com.apple.dt.Xcode,5,1726349489,1726349494,1726349494.796579,-18000,,
com.apple.iphonesimulator,9,1726349480,1726349489,1726349489.737114,-18000,,
com.apple.dt.Xcode,172,1726349308,1726349480,1726349480.891364,-18000,,
com.apple.dt.Instruments,299,1726349009,1726349308,1726349308.766753,-18000,,
com.apple.dt.Xcode,2,1726349007,1726349009,1726349009.484906,-18000,,
com.apple.dt.Instruments,78,1726348929,1726349007,1726349007.767575,-18000,,
com.apple.iphonesimulator,5,1726348924,1726348929,1726348929.7896662,-18000,,
com.apple.dt.Instruments,2,1726348922,1726348924,1726348924.7171721,-18000,,
com.apple.iphonesimulator,9,1726348913,1726348922,1726348922.25018,-18000,,
com.apple.dt.Instruments,277,1726348636,1726348913,1726348913.88938,-18000,,
com.apple.dt.Xcode,9,1726348627,1726348636,1726348636.871413,-18000,,
com.apple.iphonesimulator,1,1726348626,1726348627,1726348627.908068,-18000,,
com.apple.dt.Instruments,117,1726348509,1726348626,1726348626.213005,-18000,,
com.apple.iphonesimulator,14,1726348495,1726348509,1726348509.1660318,-18000,,
com.apple.dt.Instruments,4,1726348491,1726348495,1726348495.619079,-18000,,
com.apple.iphonesimulator,2,1726348489,1726348491,1726348491.606503,-18000,,
com.apple.dt.Xcode,1,1726348488,1726348489,1726348489.0579572,-18000,,
com.apple.dt.Instruments,16,1726348472,1726348488,1726348488.261188,-18000,,
com.apple.dt.Xcode,6,1726348466,1726348472,1726348472.8418841,-18000,,
com.apple.iphonesimulator,30,1726348436,1726348466,1726348466.764484,-18000,,
com.apple.dt.Xcode,37,1726348387,1726348424,1726348425.98801,-18000,,
com.apple.dt.Instruments,6,1726348381,1726348387,1726348387.484288,-18000,,
com.apple.dt.Xcode,3,1726348378,1726348381,1726348381.119851,-18000,,
com.apple.dt.Instruments,17,1726348361,1726348378,1726348378.0482001,-18000,,
com.apple.dt.Xcode,1,1726348360,1726348361,1726348361.677058,-18000,,
com.apple.dt.Instruments,16,1726348344,1726348360,1726348360.098733,-18000,,
com.apple.dt.Xcode,202,1726348142,1726348344,1726348344.528965,-18000,,
com.leomehlig.today,100,1726348042,1726348142,1726348142.99949,-18000,,
com.leomehlig.today,420,1726342703,1726343123,1726343123.649188,-18000,,
com.apple.finder,6,1726342697,1726342703,1726342703.19964,-18000,,
com.apple.Preview,715,1726341982,1726342697,1726342697.979661,-18000,,
com.apple.finder,9,1726341973,1726341982,1726341982.528843,-18000,,
com.google.Chrome,10,1726341963,1726341973,1726341973.801976,-18000,,
com.google.Chrome,300,1726341553,1726341853,1726341853.772268,-18000,,
com.google.Chrome,338,1726340506,1726340844,1726340844.518301,-18000,,
com.google.Chrome,655,1726339456,1726340111,1726340111.536106,-18000,,
com.google.Chrome,556,1726338839,1726339395,1726339395.616005,-18000,,
com.leomehlig.today,8,1726338831,1726338839,1726338839.631191,-18000,,
com.leomehlig.today,307,1726338431,1726338738,1726338738.95402,-18000,,
com.google.Chrome,807,1726337624,1726338431,1726338431.303989,-18000,,
com.apple.Notes,2,1726337607,1726337609,1726337610.269948,-18000,,
com.myfitnesspal.mfp,59,1726337211,1726337270,1726337270.644092,-18000,EB445137-D7F5-57EC-87DA-1DB460D64046,"iPhone13,2"
com.apple.Health,8,1726336914,1726336922,1726336922.240454,-18000,EB445137-D7F5-57EC-87DA-1DB460D64046,"iPhone13,2"
com.apple.camera,12,1726336390,1726336402,1726336402.364256,-18000,EB445137-D7F5-57EC-87DA-1DB460D64046,"iPhone13,2"
com.goodreads.Goodreads,23,1726336086,1726336109,1726336109.358601,-18000,EB445137-D7F5-57EC-87DA-1DB460D64046,"iPhone13,2"
com.apple.Health,3,1726336080,1726336083,1726336083.182471,-18000,EB445137-D7F5-57EC-87DA-1DB460D64046,"iPhone13,2"
com.apple.Notes,44,1726336025,1726336069,1726336069.784902,-18000,,
com.leomehlig.today,396,1726335629,1726336025,1726336025.1907182,-18000,,
com.apple.Notes,280,1726335349,1726335629,1726335630.068317,-18000,,
com.apple.Health,6,1726335338,1726335344,1726335344.708144,-18000,EB445137-D7F5-57EC-87DA-1DB460D64046,"iPhone13,2"
com.apple.Health,6,1726335330,1726335336,1726335336.931911,-18000,EB445137-D7F5-57EC-87DA-1DB460D64046,"iPhone13,2"
com.leomehlig.today,57,1726335292,1726335349,1726335349.068419,-18000,,
com.microsoft.VSCode,3,1726335289,1726335292,1726335292.408729,-18000,,
com.google.Chrome,5,1726335284,1726335289,1726335289.29392,-18000,,
com.apple.Notes,4,1726335280,1726335284,1726335284.5572538,-18000,,
com.leomehlig.today,63,1726335217,1726335280,1726335280.476888,-18000,,
com.apple.Notes,20,1726335197,1726335217,1726335217.664238,-18000,,
com.leomehlig.today,8,1726335189,1726335197,1726335198.006658,-18000,,
com.apple.Notes,269,1726334920,1726335189,1726335189.870829,-18000,,
com.hnc.Discord,3,1726334917,1726334920,1726334921.1566591,-18000,,
com.apple.Notes,3,1726334914,1726334917,1726334917.3399029,-18000,,
com.apple.Health,2,1726334899,1726334901,1726334901.066234,-18000,EB445137-D7F5-57EC-87DA-1DB460D64046,"iPhone13,2"
com.leomehlig.today,71,1726334843,1726334914,1726334914.860203,-18000,,
com.google.Chrome,13,1726334830,1726334843,1726334843.321673,-18000,,
com.leomehlig.today,14,1726334816,1726334830,1726334831.004324,-18000,,
com.google.Chrome,799,1726334017,1726334816,1726334817.000237,-18000,,
com.leomehlig.today,16,1726334001,1726334017,1726334017.634366,-18000,,
com.google.Chrome,38,1726333963,1726334001,1726334001.3666558,-18000,,
com.leomehlig.today,1,1726333962,1726333963,1726333964.0158281,-18000,,
com.google.Chrome,4,1726333958,1726333962,1726333962.687379,-18000,,
com.leomehlig.today,35,1726333923,1726333958,1726333958.780797,-18000,,
com.google.Chrome,32,1726333891,1726333923,1726333924.0647159,-18000,,
com.apple.Preview,67,1726333824,1726333891,1726333891.977088,-18000,,
com.microsoft.VSCode,18,1726333806,1726333824,1726333824.18357,-18000,,
com.apple.finder,8,1726333798,1726333806,1726333806.601454,-18000,,
com.microsoft.VSCode,453,1726333345,1726333798,1726333798.488844,-18000,,
com.apple.finder,35,1726333310,1726333345,1726333345.686283,-18000,,
com.microsoft.VSCode,55,1726333255,1726333310,1726333310.6393008,-18000,,
com.google.Chrome,21,1726333234,1726333255,1726333255.160398,-18000,,
com.microsoft.VSCode,931,1726332303,1726333234,1726333234.2222729,-18000,,
com.google.Chrome,12,1726332291,1726332303,1726332303.348335,-18000,,
com.microsoft.VSCode,76,1726332215,1726332291,1726332291.197571,-18000,,
com.google.Chrome,4,1726332211,1726332215,1726332216.023312,-18000,,
com.microsoft.VSCode,3,1726332208,1726332211,1726332211.93502,-18000,,
com.google.Chrome,2,1726332206,1726332208,1726332208.976694,-18000,,
com.microsoft.VSCode,1,1726332205,1726332206,1726332206.642153,-18000,,
com.google.Chrome,0,1726332205,1726332205,1726332205.550362,-18000,,
com.microsoft.VSCode,1,1726332204,1726332205,1726332205.14713,-18000,,
com.google.Chrome,19,1726332185,1726332204,1726332204.5084848,-18000,,
com.microsoft.VSCode,97,1726332088,1726332185,1726332185.802325,-18000,,
com.google.Chrome,63,1726332025,1726332088,1726332088.742204,-18000,,
com.microsoft.VSCode,4,1726332021,1726332025,1726332025.9167461,-18000,,
com.google.Chrome,23,1726331998,1726332021,1726332021.627777,-18000,,
com.microsoft.VSCode,16,1726331982,1726331998,1726331998.2690291,-18000,,
com.google.Chrome,0,1726331982,1726331982,1726331983.032113,-18000,,
com.microsoft.VSCode,7,1726331975,1726331982,1726331982.230814,-18000,,
com.google.Chrome,3,1726331972,1726331975,1726331975.952753,-18000,,
com.microsoft.VSCode,1,1726331971,1726331972,1726331972.9682698,-18000,,
com.google.Chrome,4,1726331967,1726331971,1726331971.440012,-18000,,
com.microsoft.VSCode,1,1726331966,1726331967,1726331967.542951,-18000,,
com.google.Chrome,27,1726331939,1726331966,1726331966.222384,-18000,,
com.microsoft.VSCode,21,1726331918,1726331939,1726331939.909841,-18000,,
com.hnc.Discord,99,1726331819,1726331918,1726331919.110588,-18000,,
com.microsoft.VSCode,2,1726331817,1726331819,1726331819.4425468,-18000,,
com.hnc.Discord,33,1726331784,1726331817,1726331817.939796,-18000,,
com.microsoft.VSCode,53,1726331731,1726331784,1726331784.7606192,-18000,,
com.hnc.Discord,4,1726331727,1726331731,1726331731.167917,-18000,,
com.microsoft.VSCode,25,1726331702,1726331727,1726331727.948024,-18000,,
com.hnc.Discord,2,1726331700,1726331702,1726331702.141926,-18000,,
com.microsoft.VSCode,10,1726331690,1726331700,1726331700.791453,-18000,,
com.hnc.Discord,5,1726331685,1726331690,1726331690.99372,-18000,,
com.microsoft.VSCode,1,1726331684,1726331685,1726331685.357956,-18000,,
com.hnc.Discord,39,1726331645,1726331684,1726331684.171005,-18000,,
com.microsoft.VSCode,58,1726331587,1726331645,1726331645.392614,-18000,,
com.hnc.Discord,32,1726331555,1726331587,1726331587.209902,-18000,,
com.apple.Health,17,1726331546,1726331563,1726331563.737897,-18000,EB445137-D7F5-57EC-87DA-1DB460D64046,"iPhone13,2"
com.microsoft.VSCode,13,1726331542,1726331555,1726331555.512216,-18000,,
com.hnc.Discord,6,1726331536,1726331542,1726331542.7529988,-18000,,
com.microsoft.VSCode,1,1726331535,1726331536,1726331536.285485,-18000,,
com.hnc.Discord,0,1726331535,1726331535,1726331535.637823,-18000,,
com.microsoft.VSCode,528,1726331007,1726331535,1726331535.397763,-18000,,
com.google.Chrome,8,1726330999,1726331007,1726331007.112016,-18000,,
com.microsoft.VSCode,1402,1726329597,1726330999,1726330999.744945,-18000,,
com.google.Chrome,2,1726329595,1726329597,1726329598.011509,-18000,,
com.leomehlig.today,5,1726329590,1726329595,1726329595.062932,-18000,,
com.intsig.CamScannerLite,276,1726329430,1726329706,1726329706.920655,-18000,EB445137-D7F5-57EC-87DA-1DB460D64046,"iPhone13,2"
com.google.Chrome,525,1726329065,1726329590,1726329590.089336,-18000,,
com.leomehlig.today,5,1726329050,1726329055,1726329055.085839,-18000,,
com.google.Chrome,150,1726328900,1726329050,1726329050.343672,-18000,,
com.google.Chrome,760,1726328074,1726328834,1726328834.410285,-18000,,
com.leomehlig.today,3,1726328056,1726328059,1726328059.227991,-18000,,
com.microsoft.onenote.mac,5,1726328051,1726328056,1726328056.93406,-18000,,
com.apple.dt.Xcode,6,1726328045,1726328051,1726328051.833712,-18000,,
com.leomehlig.today,1,1726328044,1726328045,1726328045.405191,-18000,,
com.google.android.studio,2,1726328042,1726328044,1726328044.535753,-18000,,
com.google.Chrome,24,1726328018,1726328042,1726328042.7291899,-18000,,
com.leomehlig.today,23,1726327995,1726328018,1726328018.2731838,-18000,,
com.microsoft.Outlook,14,1726327981,1726327995,1726327995.9740648,-18000,,
com.apple.dt.Xcode,7,1726327974,1726327981,1726327981.1242142,-18000,,
com.apple.Health,17,1726327935,1726327952,1726327953.118505,-18000,EB445137-D7F5-57EC-87DA-1DB460D64046,"iPhone13,2"
com.myfitnesspal.mfp,26,1726327900,1726327926,1726327926.53657,-18000,EB445137-D7F5-57EC-87DA-1DB460D64046,"iPhone13,2"
com.google.chrome.ios,14,1726327886,1726327900,1726327901.2215362,-18000,EB445137-D7F5-57EC-87DA-1DB460D64046,"iPhone13,2"
com.myfitnesspal.mfp,23,1726327862,1726327885,1726327886.379152,-18000,EB445137-D7F5-57EC-87DA-1DB460D64046,"iPhone13,2"
com.amazon.Amazon,4,1726327835,1726327839,1726327839.493082,-18000,EB445137-D7F5-57EC-87DA-1DB460D64046,"iPhone13,2"
com.apple.Maps,4,1726327829,1726327833,1726327833.4963331,-18000,EB445137-D7F5-57EC-87DA-1DB460D64046,"iPhone13,2"
com.apple.Maps,9,1726327649,1726327658,1726327659.3881679,-18000,EB445137-D7F5-57EC-87DA-1DB460D64046,"iPhone13,2"
com.amazon.Amazon,3,1726327646,1726327649,1726327649.0974588,-18000,EB445137-D7F5-57EC-87DA-1DB460D64046,"iPhone13,2"
com.amazon.Amazon,13,1726327526,1726327539,1726327539.7814898,-18000,EB445137-D7F5-57EC-87DA-1DB460D64046,"iPhone13,2"
com.amazon.Amazon,14,1726327054,1726327068,1726327068.22753,-18000,EB445137-D7F5-57EC-87DA-1DB460D64046,"iPhone13,2"
com.google.chrome.ios,51,1726327003,1726327054,1726327054.930798,-18000,EB445137-D7F5-57EC-87DA-1DB460D64046,"iPhone13,2"
com.google.chrome.ios,30,1726326963,1726326993,1726326993.328721,-18000,EB445137-D7F5-57EC-87DA-1DB460D64046,"iPhone13,2"
com.google.chrome.ios,7,1726326615,1726326622,1726326622.009737,-18000,EB445137-D7F5-57EC-87DA-1DB460D64046,"iPhone13,2"
com.google.chrome.ios,90,1726326523,1726326613,1726326613.726428,-18000,EB445137-D7F5-57EC-87DA-1DB460D64046,"iPhone13,2"
com.amazon.Amazon,24,1726326498,1726326522,1726326523.171171,-18000,EB445137-D7F5-57EC-87DA-1DB460D64046,"iPhone13,2"
com.google.chrome.ios,27,1726326471,1726326498,1726326498.885511,-18000,EB445137-D7F5-57EC-87DA-1DB460D64046,"iPhone13,2"
com.apple.Health,8,1726326462,1726326470,1726326471.1643329,-18000,EB445137-D7F5-57EC-87DA-1DB460D64046,"iPhone13,2"
com.apple.Health,20,1726325751,1726325771,1726325771.876954,-18000,EB445137-D7F5-57EC-87DA-1DB460D64046,"iPhone13,2"
com.apple.Music,13,1726325647,1726325660,1726325660.771097,-18000,EB445137-D7F5-57EC-87DA-1DB460D64046,"iPhone13,2"
com.apple.weather,5,1726325641,1726325646,1726325646.201186,-18000,EB445137-D7F5-57EC-87DA-1DB460D64046,"iPhone13,2"
com.apple.weather,4,1726325370,1726325374,1726325374.573637,-18000,EB445137-D7F5-57EC-87DA-1DB460D64046,"iPhone13,2"
com.google.chrome.ios,36,1726324426,1726324462,1726324462.227909,-18000,EB445137-D7F5-57EC-87DA-1DB460D64046,"iPhone13,2"
com.apple.Maps,19,1726324407,1726324426,1726324426.440386,-18000,EB445137-D7F5-57EC-87DA-1DB460D64046,"iPhone13,2"
com.apple.weather,3,1726324404,1726324407,1726324407.030884,-18000,EB445137-D7F5-57EC-87DA-1DB460D64046,"iPhone13,2"
com.apple.weather,6,1726324208,1726324214,1726324214.86838,-18000,EB445137-D7F5-57EC-87DA-1DB460D64046,"iPhone13,2"
com.apple.weather,7,1726324200,1726324207,1726324207.08948,-18000,EB445137-D7F5-57EC-87DA-1DB460D64046,"iPhone13,2"
com.apple.weather,6,1726323578,1726323584,1726323584.065737,-18000,EB445137-D7F5-57EC-87DA-1DB460D64046,"iPhone13,2"
com.myfitnesspal.mfp,170,1726323388,1726323558,1726323558.358845,-18000,EB445137-D7F5-57EC-87DA-1DB460D64046,"iPhone13,2"
com.apple.Health,7,1726323381,1726323388,1726323388.775837,-18000,EB445137-D7F5-57EC-87DA-1DB460D64046,"iPhone13,2"
com.renpho.health,21,1726323353,1726323374,1726323374.858413,-18000,EB445137-D7F5-57EC-87DA-1DB460D64046,"iPhone13,2"
com.apple.mobiletimer,4,1726323348,1726323352,1726323352.9777951,-18000,EB445137-D7F5-57EC-87DA-1DB460D64046,"iPhone13,2"
com.apple.mobiletimer,8,1726320740,1726320748,1726320748.944686,-18000,EB445137-D7F5-57EC-87DA-1DB460D64046,"iPhone13,2"
com.apple.mobiletimer,6,1726320730,1726320736,1726320736.905375,-18000,EB445137-D7F5-57EC-87DA-1DB460D64046,"iPhone13,2"
com.apple.Health,13,1726291473,1726291486,1726291486.466362,-18000,EB445137-D7F5-57EC-87DA-1DB460D64046,"iPhone13,2"
com.apple.Health,8,1726291085,1726291093,1726291093.680495,-18000,EB445137-D7F5-57EC-87DA-1DB460D64046,"iPhone13,2"
com.apple.news,1,1726291084,1726291085,1726291085.799117,-18000,EB445137-D7F5-57EC-87DA-1DB460D64046,"iPhone13,2"
com.apple.news,3,1726291080,1726291083,1726291083.3851929,-18000,EB445137-D7F5-57EC-87DA-1DB460D64046,"iPhone13,2"
com.apple.news,10,1726291028,1726291038,1726291038.257452,-18000,EB445137-D7F5-57EC-87DA-1DB460D64046,"iPhone13,2"
com.apple.news,4,1726291022,1726291026,1726291026.676348,-18000,EB445137-D7F5-57EC-87DA-1DB460D64046,"iPhone13,2"
com.apple.news,302,1726287641,1726287943,1726287943.150883,-18000,EB445137-D7F5-57EC-87DA-1DB460D64046,"iPhone13,2"
com.apple.mobilecal,10,1726284553,1726284563,1726284563.790169,-18000,EB445137-D7F5-57EC-87DA-1DB460D64046,"iPhone13,2"
com.apple.weather,4,1726284429,1726284433,1726284433.091247,-18000,EB445137-D7F5-57EC-87DA-1DB460D64046,"iPhone13,2"
com.apple.weather,6,1726284418,1726284424,1726284424.644464,-18000,EB445137-D7F5-57EC-87DA-1DB460D64046,"iPhone13,2"
Astrospheric.Astrospheric,12,1726284404,1726284416,1726284416.8738189,-18000,EB445137-D7F5-57EC-87DA-1DB460D64046,"iPhone13,2"
com.discoverfinancial.mobile,4,1726284064,1726284068,1726284068.379344,-18000,EB445137-D7F5-57EC-87DA-1DB460D64046,"iPhone13,2"
com.discoverfinancial.mobile,1,1726284030,1726284031,1726284031.948147,-18000,EB445137-D7F5-57EC-87DA-1DB460D64046,"iPhone13,2"
com.google.chrome.ios,5,1726284025,1726284030,1726284030.557732,-18000,EB445137-D7F5-57EC-87DA-1DB460D64046,"iPhone13,2"
com.google.chrome.ios,2,1726283414,1726283416,1726283416.662159,-18000,EB445137-D7F5-57EC-87DA-1DB460D64046,"iPhone13,2"
com.google.chrome.ios,15,1726283073,1726283088,1726283088.6157498,-18000,EB445137-D7F5-57EC-87DA-1DB460D64046,"iPhone13,2"
com.apple.Health,2,1726283071,1726283073,1726283073.9176679,-18000,EB445137-D7F5-57EC-87DA-1DB460D64046,"iPhone13,2"
com.apple.Health,5,1726282647,1726282652,1726282652.1769462,-18000,EB445137-D7F5-57EC-87DA-1DB460D64046,"iPhone13,2"
com.myfitnesspal.mfp,21,1726282626,1726282647,1726282647.388293,-18000,EB445137-D7F5-57EC-87DA-1DB460D64046,"iPhone13,2"
com.hammerandchisel.discord,13,1726282612,1726282625,1726282625.310643,-18000,EB445137-D7F5-57EC-87DA-1DB460D64046,"iPhone13,2"
com.myfitnesspal.mfp,11,1726282601,1726282612,1726282613.414176,-18000,EB445137-D7F5-57EC-87DA-1DB460D64046,"iPhone13,2"
com.apple.weather,6,1726282595,1726282601,1726282601.9717932,-18000,EB445137-D7F5-57EC-87DA-1DB460D64046,"iPhone13,2"
com.apple.weather,15,1726280300,1726280315,1726280315.290365,-18000,EB445137-D7F5-57EC-87DA-1DB460D64046,"iPhone13,2"
com.apple.MobileSMS,24,1726280152,1726280176,1726280177.075595,-18000,EB445137-D7F5-57EC-87DA-1DB460D64046,"iPhone13,2"
com.truebill.truebillnative,23,1726279747,1726279770,1726279770.6900182,-18000,EB445137-D7F5-57EC-87DA-1DB460D64046,"iPhone13,2"
com.truebill.truebillnative,29,1726279716,1726279745,1726279745.131578,-18000,EB445137-D7F5-57EC-87DA-1DB460D64046,"iPhone13,2"
com.toyopagroup.picaboo,53,1726279482,1726279535,1726279535.243616,-18000,EB445137-D7F5-57EC-87DA-1DB460D64046,"iPhone13,2"
com.truebill.truebillnative,14,1726279465,1726279479,1726279479.940433,-18000,EB445137-D7F5-57EC-87DA-1DB460D64046,"iPhone13,2"
com.clairmail.fth.client,2,1726279463,1726279465,1726279465.4637341,-18000,EB445137-D7F5-57EC-87DA-1DB460D64046,"iPhone13,2"
com.toyopagroup.picaboo,8,1726279455,1726279463,1726279463.807465,-18000,EB445137-D7F5-57EC-87DA-1DB460D64046,"iPhone13,2"
com.toyopagroup.picaboo,13,1726279188,1726279201,1726279201.933941,-18000,EB445137-D7F5-57EC-87DA-1DB460D64046,"iPhone13,2"
com.hammerandchisel.discord,4,1726279184,1726279188,1726279188.832751,-18000,EB445137-D7F5-57EC-87DA-1DB460D64046,"iPhone13,2"
com.apple.dt.Xcode,10,1726252343,1726252353,1726252353.49115,-18000,,
com.google.android.studio,8,1726252335,1726252343,1726252343.4153771,-18000,,
com.google.android.studio,38,1726251902,1726251940,1726251940.716188,-18000,,
com.google.Chrome,1,1726251901,1726251902,1726251903.0110059,-18000,,
com.google.android.studio,888,1726251013,1726251901,1726251901.968447,-18000,,
com.google.Chrome,3,1726251010,1726251013,1726251013.63913,-18000,,
com.google.android.studio,14,1726250996,1726251010,1726251010.6176481,-18000,,
com.google.Chrome,2,1726250994,1726250996,1726250996.901669,-18000,,
com.google.android.studio,13,1726250981,1726250994,1726250994.907376,-18000,,
com.google.Chrome,6,1726250975,1726250981,1726250981.315151,-18000,,
com.google.android.studio,5,1726250970,1726250975,1726250975.268601,-18000,,
com.google.Chrome,23,1726250947,1726250970,1726250970.222594,-18000,,
com.google.android.studio,122,1726250825,1726250947,1726250947.919452,-18000,,
com.google.Chrome,1,1726250824,1726250825,1726250825.528785,-18000,,
com.google.android.studio,2,1726250822,1726250824,1726250824.917155,-18000,,
com.google.Chrome,27,1726250795,1726250822,1726250822.1724858,-18000,,
com.google.android.studio,1,1726250794,1726250795,1726250795.424628,-18000,,
com.google.Chrome,7,1726250787,1726250794,1726250794.4645119,-18000,,
com.google.android.studio,169,1726250618,1726250787,1726250788.0122929,-18000,,
com.google.Chrome,1,1726250617,1726250618,1726250618.6364489,-18000,,
com.google.android.studio,17,1726250600,1726250617,1726250617.5681891,-18000,,
com.google.Chrome,53,1726250547,1726250600,1726250600.230727,-18000,,
com.google.android.studio,834,1726249713,1726250547,1726250547.743459,-18000,,
com.google.Chrome,12,1726249701,1726249713,1726249713.299052,-18000,,
com.google.android.studio,77,1726249624,1726249701,1726249701.111522,-18000,,
com.google.Chrome,12,1726249612,1726249624,1726249624.255621,-18000,,
com.google.android.studio,30,1726249582,1726249612,1726249612.9968429,-18000,,
com.google.Chrome,32,1726249550,1726249582,1726249582.1048532,-18000,,
com.google.android.studio,180,1726249370,1726249550,1726249550.985719,-18000,,
com.google.Chrome,1,1726249369,1726249370,1726249370.5248342,-18000,,
com.google.android.studio,1,1726249368,1726249369,1726249369.8087668,-18000,,
com.google.Chrome,1,1726249367,1726249368,1726249368.8404012,-18000,,
com.google.android.studio,1,1726249366,1726249367,1726249367.326186,-18000,,
com.google.Chrome,19,1726249347,1726249366,1726249366.2936459,-18000,,
com.google.android.studio,64,1726249283,1726249347,1726249347.876989,-18000,,
com.google.Chrome,27,1726249256,1726249283,1726249283.5211802,-18000,,
com.google.android.studio,54,1726249202,1726249256,1726249256.5843349,-18000,,
com.google.Chrome,1,1726249201,1726249202,1726249202.404705,-18000,,
com.google.android.studio,14,1726249187,1726249201,1726249201.7770739,-18000,,
com.google.Chrome,3,1726249184,1726249187,1726249187.1324801,-18000,,
com.google.android.studio,2,1726249182,1726249184,1726249184.933578,-18000,,
com.google.Chrome,14,1726249168,1726249182,1726249182.4176579,-18000,,
com.google.android.studio,30,1726249138,1726249168,1726249168.7933989,-18000,,
com.google.Chrome,8,1726249130,1726249138,1726249138.536447,-18000,,
com.google.android.studio,10,1726249120,1726249130,1726249130.717273,-18000,,
com.google.Chrome,5,1726249115,1726249120,1726249120.5218282,-18000,,
com.google.android.studio,5,1726249110,1726249115,1726249115.727501,-18000,,
com.google.Chrome,0,1726249110,1726249110,1726249111.033526,-18000,,
com.google.android.studio,2,1726249108,1726249110,1726249110.3649359,-18000,,
com.google.Chrome,1,1726249107,1726249108,1726249108.975414,-18000,,
com.google.android.studio,27,1726249080,1726249107,1726249107.405194,-18000,,
com.google.Chrome,2,1726249078,1726249080,1726249080.3965921,-18000,,
com.google.android.studio,7,1726249071,1726249078,1726249078.970927,-18000,,
com.google.Chrome,1,1726249070,1726249071,1726249071.1973329,-18000,,
com.google.android.studio,3,1726249067,1726249070,1726249070.0905051,-18000,,
com.google.Chrome,1,1726249066,1726249067,1726249067.375994,-18000,,
com.google.android.studio,3,1726249063,1726249066,1726249066.290856,-18000,,
com.google.Chrome,1,1726249062,1726249063,1726249063.824504,-18000,,
com.google.android.studio,8,1726249054,1726249062,1726249062.8320398,-18000,,
com.google.Chrome,21,1726249033,1726249054,1726249055.013047,-18000,,
com.google.android.studio,12,1726249021,1726249033,1726249033.370899,-18000,,
com.google.Chrome,7,1726249014,1726249021,1726249022.062121,-18000,,
com.google.android.studio,6,1726249008,1726249014,1726249014.994865,-18000,,
com.google.Chrome,1,1726249007,1726249008,1726249008.50859,-18000,,
com.google.android.studio,2,1726249005,1726249007,1726249007.632752,-18000,,
com.google.Chrome,3,1726249002,1726249005,1726249005.7307081,-18000,,
com.google.android.studio,1,1726249001,1726249002,1726249002.717777,-18000,,
com.google.Chrome,248,1726248753,1726249001,1726249001.577476,-18000,,
com.google.android.studio,83,1726248670,1726248753,1726248753.708356,-18000,,
com.google.Chrome,3,1726248667,1726248670,1726248670.279233,-18000,,
com.google.android.studio,149,1726248518,1726248667,1726248667.715606,-18000,,
com.google.Chrome,438,1726248080,1726248518,1726248518.918895,-18000,,
com.microsoft.Outlook,2,1726248078,1726248080,1726248080.3512769,-18000,,
com.google.android.studio,1,1726248077,1726248078,1726248078.5572019,-18000,,
com.google.Chrome,42,1726248035,1726248077,1726248077.425432,-18000,,
com.google.android.studio,32,1726248003,1726248035,1726248035.702837,-18000,,
com.google.Chrome,727,1726247276,1726248003,1726248003.423326,-18000,,
com.microsoft.Outlook,10,1726247266,1726247276,1726247276.445864,-18000,,
com.google.Chrome,80,1726247186,1726247266,1726247266.53195,-18000,,
com.google.android.studio,285,1726246901,1726247186,1726247186.453844,-18000,,
com.apple.dt.Xcode,83,1726246818,1726246901,1726246901.565445,-18000,,
com.google.android.studio,80,1726246738,1726246818,1726246818.880029,-18000,,
com.microsoft.onenote.mac,18,1726246626,1726246644,1726246644.7463942,-18000,,
com.google.android.studio,6,1726246620,1726246626,1726246626.8630881,-18000,,
com.apple.finder,30,1726246590,1726246620,1726246620.633418,-18000,,
com.leomehlig.today,24,1726246566,1726246590,1726246590.217307,-18000,,
com.google.Chrome,118,1726246448,1726246566,1726246566.569315,-18000,,
com.microsoft.Word,114,1726246334,1726246448,1726246448.627348,-18000,,
com.google.Chrome,135,1726246199,1726246334,1726246334.951457,-18000,,
com.microsoft.Word,80,1726246119,1726246199,1726246199.288589,-18000,,
com.apple.finder,23,1726246096,1726246119,1726246119.7457871,-18000,,
com.microsoft.Word,2,1726246094,1726246096,1726246097.038962,-18000,,
com.apple.finder,9,1726246085,1726246094,1726246094.152658,-18000,,
com.google.Chrome,536,1726245549,1726246085,1726246085.232429,-18000,,
com.google.Chrome,941,1726237667,1726238608,1726238608.2675052,-18000,,
com.google.Chrome,463,1726200890,1726201353,1726201353.659152,-18000,,
com.leomehlig.today,14,1726200876,1726200890,1726200890.269511,-18000,,
com.leomehlig.today,29,1726200719,1726200748,1726200748.439697,-18000,,
com.apple.finder,1,1726200718,1726200719,1726200719.325033,-18000,,
com.apple.Notes,10,1726200708,1726200718,1726200718.341373,-18000,,
com.apple.finder,2,1726200706,1726200708,1726200708.419061,-18000,,
com.microsoft.VSCode,1,1726200705,1726200706,1726200706.5852308,-18000,,
com.leomehlig.today,245,1726200460,1726200705,1726200705.174171,-18000,,
com.google.Chrome,5,1726200455,1726200460,1726200460.516193,-18000,,
com.microsoft.VSCode,6,1726200449,1726200455,1726200455.161588,-18000,,
com.microsoft.onenote.mac,560,1726199889,1726200449,1726200449.424375,-18000,,
com.microsoft.VSCode,78,1726199811,1726199889,1726199889.510618,-18000,,
com.google.Chrome,131,1726199680,1726199811,1726199811.8757,-18000,,
com.microsoft.VSCode,144,1726199536,1726199680,1726199680.391901,-18000,,
com.google.Chrome,6,1726199530,1726199536,1726199536.690748,-18000,,
com.microsoft.VSCode,1,1726199529,1726199530,1726199530.856595,-18000,,
com.google.Chrome,2,1726199527,1726199529,1726199529.728133,-18000,,
com.microsoft.VSCode,43,1726199484,1726199527,1726199527.76893,-18000,,
com.google.Chrome,2,1726199482,1726199484,1726199484.256659,-18000,,
com.microsoft.VSCode,49,1726199433,1726199482,1726199482.933714,-18000,,
com.google.Chrome,6,1726199427,1726199433,1726199433.933542,-18000,,
com.microsoft.VSCode,2,1726199425,1726199427,1726199427.7853398,-18000,,
com.google.Chrome,1,1726199424,1726199425,1726199425.158516,-18000,,
com.microsoft.VSCode,3,1726199421,1726199424,1726199424.174625,-18000,,
com.google.Chrome,2,1726199419,1726199421,1726199421.195269,-18000,,
com.microsoft.VSCode,10,1726199409,1726199419,1726199419.492688,-18000,,
com.google.Chrome,15,1726199394,1726199409,1726199409.845886,-18000,,
com.microsoft.VSCode,3,1726199391,1726199394,1726199394.901936,-18000,,
com.google.Chrome,1,1726199390,1726199391,1726199391.167419,-18000,,
com.microsoft.VSCode,4,1726199386,1726199390,1726199390.275841,-18000,,
com.google.Chrome,1,1726199385,1726199386,1726199386.811613,-18000,,
com.microsoft.VSCode,3,1726199382,1726199385,1726199385.1811252,-18000,,
com.google.Chrome,1,1726199381,1726199382,1726199382.173276,-18000,,
com.microsoft.VSCode,1,1726199380,1726199381,1726199381.4302049,-18000,,
com.google.Chrome,1,1726199379,1726199380,1726199380.327898,-18000,,
com.microsoft.VSCode,2,1726199377,1726199379,1726199379.670677,-18000,,
com.google.Chrome,1,1726199376,1726199377,1726199377.535235,-18000,,
com.microsoft.VSCode,2,1726199374,1726199376,1726199376.737595,-18000,,
com.google.Chrome,9,1726199365,1726199374,1726199374.224247,-18000,,
com.microsoft.VSCode,8,1726199357,1726199365,1726199365.418751,-18000,,
com.google.Chrome,4,1726199353,1726199357,1726199357.999774,-18000,,
com.microsoft.VSCode,7,1726199346,1726199353,1726199353.773509,-18000,,
com.google.Chrome,1,1726199345,1726199346,1726199346.646151,-18000,,
com.microsoft.VSCode,5,1726199340,1726199345,1726199345.109912,-18000,,
com.google.Chrome,1,1726199339,1726199340,1726199340.866359,-18000,,
com.microsoft.VSCode,7,1726199332,1726199339,1726199339.672723,-18000,,
com.google.Chrome,1,1726199331,1726199332,1726199332.433064,-18000,,
com.microsoft.VSCode,2,1726199329,1726199331,1726199331.497023,-18000,,
com.google.Chrome,4,1726199325,1726199329,1726199329.25703,-18000,,
com.microsoft.VSCode,2,1726199323,1726199325,1726199325.590735,-18000,,
com.google.Chrome,1,1726199322,1726199323,1726199323.681202,-18000,,
com.microsoft.VSCode,3,1726199319,1726199322,1726199322.5859861,-18000,,
com.google.Chrome,2,1726199317,1726199319,1726199319.9751601,-18000,,
com.microsoft.VSCode,6,1726199311,1726199317,1726199318.017622,-18000,,
com.google.Chrome,2,1726199309,1726199311,1726199311.954577,-18000,,
com.microsoft.VSCode,4,1726199305,1726199309,1726199309.492113,-18000,,
com.google.Chrome,1,1726199304,1726199305,1726199305.815751,-18000,,
com.microsoft.VSCode,3,1726199301,1726199304,1726199304.582255,-18000,,
com.google.Chrome,18,1726199283,1726199301,1726199301.281654,-18000,,
com.microsoft.VSCode,4,1726199279,1726199283,1726199283.979815,-18000,,
com.google.Chrome,22,1726199257,1726199279,1726199279.92914,-18000,,
com.microsoft.VSCode,8,1726199249,1726199257,1726199257.049272,-18000,,
com.google.Chrome,6,1726199243,1726199249,1726199249.133977,-18000,,
com.microsoft.VSCode,9,1726199234,1726199243,1726199243.106379,-18000,,
com.google.Chrome,2,1726199232,1726199234,1726199234.554706,-18000,,
com.microsoft.VSCode,25,1726199207,1726199232,1726199232.9283261,-18000,,
com.google.Chrome,1,1726199206,1726199207,1726199207.741905,-18000,,
com.microsoft.VSCode,9,1726199197,1726199206,1726199206.425606,-18000,,
com.google.Chrome,1,1726199196,1726199197,1726199197.9750218,-18000,,
com.microsoft.VSCode,3,1726199193,1726199196,1726199196.768332,-18000,,
com.google.Chrome,8,1726199185,1726199193,1726199193.409661,-18000,,
com.microsoft.VSCode,4,1726199181,1726199185,1726199185.517838,-18000,,
com.google.Chrome,5,1726199176,1726199181,1726199181.882467,-18000,,
com.microsoft.VSCode,8,1726199168,1726199176,1726199176.897355,-18000,,
com.google.Chrome,22,1726199146,1726199168,1726199168.070662,-18000,,
com.microsoft.VSCode,15,1726199131,1726199146,1726199146.637279,-18000,,
com.google.Chrome,2,1726199129,1726199131,1726199131.4081678,-18000,,
com.microsoft.VSCode,10,1726199119,1726199129,1726199129.6084619,-18000,,
com.google.Chrome,4,1726199115,1726199119,1726199119.133435,-18000,,
com.microsoft.VSCode,8,1726199107,1726199115,1726199115.4276528,-18000,,
com.google.Chrome,4,1726199103,1726199107,1726199107.563045,-18000,,
com.microsoft.VSCode,6,1726199097,1726199103,1726199103.188401,-18000,,
com.google.Chrome,3,1726199094,1726199097,1726199097.284042,-18000,,
com.microsoft.VSCode,3,1726199091,1726199094,1726199094.269339,-18000,,
com.google.Chrome,3,1726199088,1726199091,1726199091.82226,-18000,,
com.microsoft.VSCode,29,1726199059,1726199088,1726199088.327713,-18000,,
com.google.Chrome,1,1726199058,1726199059,1726199059.676354,-18000,,
com.microsoft.VSCode,5,1726199053,1726199058,1726199058.173442,-18000,,
com.google.Chrome,2,1726199051,1726199053,1726199053.254232,-18000,,
com.microsoft.VSCode,13,1726199038,1726199051,1726199052.023756,-18000,,
com.google.Chrome,32,1726199006,1726199038,1726199038.629099,-18000,,
com.microsoft.VSCode,5,1726199001,1726199006,1726199006.9884071,-18000,,
com.google.Chrome,5,1726198996,1726199001,1726199001.6714358,-18000,,
com.microsoft.VSCode,1,1726198995,1726198996,1726198996.828494,-18000,,
com.google.Chrome,2,1726198993,1726198995,1726198995.999704,-18000,,
com.microsoft.VSCode,6,1726198987,1726198993,1726198993.580412,-18000,,
com.google.Chrome,1,1726198986,1726198987,1726198987.215873,-18000,,
com.microsoft.VSCode,2,1726198984,1726198986,1726198986.401716,-18000,,
com.google.Chrome,0,1726198984,1726198984,1726198984.9824228,-18000,,
com.microsoft.VSCode,2,1726198982,1726198984,1726198984.185347,-18000,,
com.google.Chrome,1,1726198981,1726198982,1726198982.842441,-18000,,
com.microsoft.VSCode,5,1726198976,1726198981,1726198981.349211,-18000,,
com.google.Chrome,2,1726198974,1726198976,1726198976.5964751,-18000,,
com.microsoft.VSCode,1,1726198973,1726198974,1726198974.889631,-18000,,
com.google.Chrome,1,1726198972,1726198973,1726198973.566386,-18000,,
com.microsoft.VSCode,2,1726198970,1726198972,1726198972.46684,-18000,,
com.google.Chrome,2,1726198968,1726198970,1726198970.5342321,-18000,,
com.microsoft.VSCode,5,1726198963,1726198968,1726198968.899506,-18000,,
com.google.Chrome,1,1726198962,1726198963,1726198963.314825,-18000,,
com.microsoft.VSCode,2,1726198960,1726198962,1726198962.119487,-18000,,
com.google.Chrome,1,1726198959,1726198960,1726198960.70048,-18000,,
com.microsoft.VSCode,4,1726198955,1726198959,1726198959.512178,-18000,,
com.google.Chrome,1,1726198954,1726198955,1726198955.998908,-18000,,
com.microsoft.VSCode,4,1726198950,1726198954,1726198954.8481588,-18000,,
com.google.Chrome,2,1726198948,1726198950,1726198950.1508942,-18000,,
com.microsoft.VSCode,3,1726198945,1726198948,1726198948.775282,-18000,,
com.google.Chrome,27,1726198918,1726198945,1726198945.456825,-18000,,
com.microsoft.VSCode,4,1726198914,1726198918,1726198918.8010821,-18000,,
com.google.Chrome,2,1726198912,1726198914,1726198914.658176,-18000,,
com.microsoft.VSCode,8,1726198904,1726198912,1726198912.114063,-18000,,
com.google.Chrome,1,1726198903,1726198904,1726198904.2404408,-18000,,
com.microsoft.VSCode,3,1726198900,1726198903,1726198903.408183,-18000,,
com.google.Chrome,1,1726198899,1726198900,1726198900.188984,-18000,,
com.microsoft.VSCode,5,1726198894,1726198899,1726198899.405004,-18000,,
com.google.Chrome,1,1726198893,1726198894,1726198894.471288,-18000,,
com.microsoft.VSCode,8,1726198885,1726198893,1726198893.04677,-18000,,
com.google.Chrome,1,1726198884,1726198885,1726198885.583877,-18000,,
com.microsoft.VSCode,7,1726198877,1726198884,1726198884.777472,-18000,,
com.google.Chrome,2,1726198875,1726198877,1726198877.190021,-18000,,
com.microsoft.VSCode,2,1726198873,1726198875,1726198875.381133,-18000,,
com.google.Chrome,2,1726198871,1726198873,1726198873.632772,-18000,,
com.microsoft.VSCode,4,1726198867,1726198871,1726198871.578228,-18000,,
com.google.Chrome,1,1726198866,1726198867,1726198867.327042,-18000,,
com.microsoft.VSCode,2,1726198864,1726198866,1726198866.678108,-18000,,
com.google.Chrome,1,1726198863,1726198864,1726198864.6734328,-18000,,
com.microsoft.VSCode,2,1726198861,1726198863,1726198863.7285662,-18000,,
com.google.Chrome,1,1726198860,1726198861,1726198862.029289,-18000,,
com.microsoft.VSCode,17,1726198843,1726198860,1726198860.769504,-18000,,
com.google.Chrome,1,1726198842,1726198843,1726198843.524612,-18000,,
com.microsoft.VSCode,18,1726198824,1726198842,1726198842.130357,-18000,,
com.google.Chrome,1,1726198823,1726198824,1726198824.4928489,-18000,,
com.microsoft.VSCode,0,1726198823,1726198823,1726198823.828195,-18000,,
com.google.Chrome,12,1726198811,1726198823,1726198823.4003901,-18000,,
com.microsoft.VSCode,1,1726198810,1726198811,1726198811.616303,-18000,,
com.google.Chrome,1,1726198809,1726198810,1726198810.28509,-18000,,
com.microsoft.VSCode,7,1726198802,1726198809,1726198809.066916,-18000,,
com.google.Chrome,3,1726198799,1726198802,1726198802.4390569,-18000,,
com.microsoft.VSCode,1,1726198798,1726198799,1726198799.631243,-18000,,
com.google.Chrome,3,1726198795,1726198798,1726198798.071481,-18000,,
com.microsoft.VSCode,4,1726198791,1726198795,1726198795.127769,-18000,,
com.google.Chrome,2,1726198789,1726198791,1726198791.496324,-18000,,
com.microsoft.VSCode,1,1726198788,1726198789,1726198790.031904,-18000,,
com.google.Chrome,1,1726198787,1726198788,1726198788.344424,-18000,,
com.microsoft.VSCode,8,1726198779,1726198787,1726198787.375955,-18000,,
com.google.Chrome,1,1726198778,1726198779,1726198779.318265,-18000,,
com.microsoft.VSCode,2,1726198776,1726198778,1726198778.4502401,-18000,,
com.google.Chrome,1,1726198775,1726198776,1726198776.530705,-18000,,
com.microsoft.VSCode,2,1726198773,1726198775,1726198775.325197,-18000,,
com.google.Chrome,1,1726198772,1726198773,1726198773.581311,-18000,,
com.microsoft.VSCode,3,1726198769,1726198772,1726198772.450111,-18000,,
com.google.Chrome,1,1726198768,1726198769,1726198769.696422,-18000,,
com.microsoft.VSCode,4,1726198764,1726198768,1726198768.676971,-18000,,
com.google.Chrome,1,1726198763,1726198764,1726198764.944273,-18000,,
com.microsoft.VSCode,3,1726198760,1726198763,1726198763.443993,-18000,,
com.google.Chrome,1,1726198759,1726198760,1726198760.393043,-18000,,
com.microsoft.VSCode,3,1726198756,1726198759,1726198759.613342,-18000,,
com.google.Chrome,41,1726198715,1726198756,1726198756.565186,-18000,,
com.microsoft.VSCode,1,1726198714,1726198715,1726198715.6343641,-18000,,
com.google.Chrome,1,1726198713,1726198714,1726198715.0347319,-18000,,
com.microsoft.VSCode,7,1726198706,1726198713,1726198713.3986301,-18000,,
com.google.Chrome,78,1726198628,1726198706,1726198706.539822,-18000,,
com.microsoft.VSCode,152,1726198476,1726198628,1726198628.523973,-18000,,
com.google.Chrome,57,1726198419,1726198476,1726198476.355685,-18000,,
com.microsoft.VSCode,1,1726198418,1726198419,1726198419.827657,-18000,,
com.google.Chrome,1,1726198417,1726198418,1726198418.226125,-18000,,
com.microsoft.VSCode,70,1726198347,1726198417,1726198417.7358851,-18000,,
com.google.Chrome,35,1726198312,1726198347,1726198347.759234,-18000,,
com.microsoft.VSCode,37,1726198275,1726198312,1726198312.842735,-18000,,
com.microsoft.onenote.mac,50,1726198225,1726198275,1726198275.4897208,-18000,,
com.leomehlig.today,1,1726198224,1726198225,1726198225.975922,-18000,,
com.microsoft.onenote.mac,5,1726198219,1726198224,1726198224.547124,-18000,,
com.leomehlig.today,8,1726198211,1726198219,1726198219.336045,-18000,,
com.microsoft.onenote.mac,245,1726197966,1726198211,1726198211.235436,-18000,,
com.google.Chrome,27,1726197939,1726197966,1726197966.630523,-18000,,
com.google.Chrome,9,1726197384,1726197393,1726197393.6009622,-18000,,
com.leomehlig.today,55,1726197329,1726197384,1726197384.414243,-18000,,
com.google.Chrome,4385,1726192944,1726197329,1726197329.630671,-18000,,
com.leomehlig.today,29,1726192915,1726192944,1726192944.220252,-18000,,
com.apple.Notes,12,1726192903,1726192915,1726192915.901674,-18000,,
com.leomehlig.today,103,1726192800,1726192903,1726192903.139637,-18000,,
com.apple.Notes,407,1726192393,1726192800,1726192800.67859,-18000,,
com.google.Chrome,99,1726192294,1726192393,1726192393.978431,-18000,,
com.apple.Notes,238,1726192045,1726192283,1726192283.564703,-18000,,
com.leomehlig.today,1,1726192044,1726192045,1726192045.305474,-18000,,
com.google.Chrome,20,1726192024,1726192044,1726192044.3814502,-18000,,
com.leomehlig.today,1,1726192023,1726192024,1726192024.646496,-18000,,
com.apple.Notes,36,1726191987,1726192023,1726192023.718492,-18000,,
com.leomehlig.today,1,1726191986,1726191987,1726191988.0018969,-18000,,
com.google.Chrome,5,1726191981,1726191986,1726191986.413702,-18000,,
com.leomehlig.today,5,1726191976,1726191981,1726191981.645791,-18000,,
com.google.Chrome,32,1726191944,1726191976,1726191976.662226,-18000,,
com.apple.Notes,181,1726191742,1726191923,1726191924.264596,-18000,,
com.leomehlig.today,7,1726191735,1726191742,1726191742.387075,-18000,,
com.google.Chrome,216,1726191519,1726191735,1726191735.371406,-18000,,
com.leomehlig.today,19,1726191481,1726191500,1726191501.663934,-18000,,
com.burbn.instagram,11,1726189682,1726189693,1726189693.763761,-18000,EB445137-D7F5-57EC-87DA-1DB460D64046,"iPhone13,2"
com.burbn.instagram,6,1726189475,1726189481,1726189481.7077088,-18000,EB445137-D7F5-57EC-87DA-1DB460D64046,"iPhone13,2"
com.burbn.instagram,16,1726189444,1726189460,1726189460.9290938,-18000,EB445137-D7F5-57EC-87DA-1DB460D64046,"iPhone13,2"
com.apple.news,3,1726189439,1726189442,1726189442.690753,-18000,EB445137-D7F5-57EC-87DA-1DB460D64046,"iPhone13,2"
com.apple.news,6,1726188676,1726188682,1726188682.293165,-18000,EB445137-D7F5-57EC-87DA-1DB460D64046,"iPhone13,2"
com.apple.news,9,1726188577,1726188586,1726188586.0755439,-18000,EB445137-D7F5-57EC-87DA-1DB460D64046,"iPhone13,2"
com.tinyspeck.chatlyio,13,1726188422,1726188435,1726188435.393116,-18000,EB445137-D7F5-57EC-87DA-1DB460D64046,"iPhone13,2"
com.tinyspeck.chatlyio,7,1726188395,1726188402,1726188402.503271,-18000,EB445137-D7F5-57EC-87DA-1DB460D64046,"iPhone13,2"
com.thestorygraph.thestorygraph,4,1726188391,1726188395,1726188395.149459,-18000,EB445137-D7F5-57EC-87DA-1DB460D64046,"iPhone13,2"
com.thestorygraph.thestorygraph,36,1726187556,1726187592,1726187593.009317,-18000,EB445137-D7F5-57EC-87DA-1DB460D64046,"iPhone13,2"
com.google.chrome.ios,4,1726187549,1726187553,1726187553.178473,-18000,EB445137-D7F5-57EC-87DA-1DB460D64046,"iPhone13,2"
com.google.chrome.ios,1,1726187114,1726187115,1726187115.8641438,-18000,EB445137-D7F5-57EC-87DA-1DB460D64046,"iPhone13,2"
com.google.chrome.ios,6,1726187016,1726187022,1726187022.627221,-18000,EB445137-D7F5-57EC-87DA-1DB460D64046,"iPhone13,2"
com.google.chrome.ios,29,1726186248,1726186277,1726186277.683387,-18000,EB445137-D7F5-57EC-87DA-1DB460D64046,"iPhone13,2"
com.google.chrome.ios,9,1726186236,1726186245,1726186245.1949959,-18000,EB445137-D7F5-57EC-87DA-1DB460D64046,"iPhone13,2"
com.google.chrome.ios,30,1726186172,1726186202,1726186203.033627,-18000,EB445137-D7F5-57EC-87DA-1DB460D64046,"iPhone13,2"
com.apple.camera,4,1726186167,1726186171,1726186172.5223489,-18000,EB445137-D7F5-57EC-87DA-1DB460D64046,"iPhone13,2"
com.tinyspeck.chatlyio,6,1726186166,1726186172,1726186174.126841,-18000,EB445137-D7F5-57EC-87DA-1DB460D64046,"iPhone13,2"
com.tinyspeck.chatlyio,20,1726185634,1726185654,1726185654.985498,-18000,EB445137-D7F5-57EC-87DA-1DB460D64046,"iPhone13,2"
com.myfitnesspal.mfp,2,1726185630,1726185632,1726185633.129678,-18000,EB445137-D7F5-57EC-87DA-1DB460D64046,"iPhone13,2"
com.myfitnesspal.mfp,303,1726184069,1726184372,1726184372.6303139,-18000,EB445137-D7F5-57EC-87DA-1DB460D64046,"iPhone13,2"
com.myfitnesspal.mfp,74,1726183963,1726184037,1726184037.6521869,-18000,EB445137-D7F5-57EC-87DA-1DB460D64046,"iPhone13,2"
com.microsoft.Office.Outlook,53,1726183908,1726183961,1726183961.458808,-18000,EB445137-D7F5-57EC-87DA-1DB460D64046,"iPhone13,2"
com.toyopagroup.picaboo,7,1726183050,1726183057,1726183057.8902168,-18000,EB445137-D7F5-57EC-87DA-1DB460D64046,"iPhone13,2"
com.apple.mobiletimer,3,1726183047,1726183050,1726183050.771346,-18000,EB445137-D7F5-57EC-87DA-1DB460D64046,"iPhone13,2"
com.apple.mobiletimer,4,1726182849,1726182853,1726182853.387731,-18000,EB445137-D7F5-57EC-87DA-1DB460D64046,"iPhone13,2"
com.toyopagroup.picaboo,3,1726182846,1726182849,1726182850.004359,-18000,EB445137-D7F5-57EC-87DA-1DB460D64046,"iPhone13,2"
com.toyopagroup.picaboo,8,1726182835,1726182843,1726182844.1959882,-18000,EB445137-D7F5-57EC-87DA-1DB460D64046,"iPhone13,2"
com.apple.mobilecal,1,1726182832,1726182833,1726182833.5856,-18000,EB445137-D7F5-57EC-87DA-1DB460D64046,"iPhone13,2"
com.leomehlig.today,12,1726182820,1726182832,1726182832.6811109,-18000,EB445137-D7F5-57EC-87DA-1DB460D64046,"iPhone13,2"
com.apple.mobilecal,3,1726182813,1726182816,1726182816.6324182,-18000,EB445137-D7F5-57EC-87DA-1DB460D64046,"iPhone13,2"
com.toyopagroup.picaboo,34,1726182776,1726182810,1726182810.596994,-18000,EB445137-D7F5-57EC-87DA-1DB460D64046,"iPhone13,2"
com.apple.mobiletimer,3,1726182773,1726182776,1726182776.325945,-18000,EB445137-D7F5-57EC-87DA-1DB460D64046,"iPhone13,2"
com.apple.camera,0,1726182744,1726182744,1726182744.620326,-18000,EB445137-D7F5-57EC-87DA-1DB460D64046,"iPhone13,2"
com.apple.mobiletimer,14,1726182730,1726182744,1726182744.667121,-18000,EB445137-D7F5-57EC-87DA-1DB460D64046,"iPhone13,2"
com.apple.mobiletimer,3,1726182488,1726182491,1726182491.54074,-18000,EB445137-D7F5-57EC-87DA-1DB460D64046,"iPhone13,2"
com.google.chrome.ios,84,1726182404,1726182488,1726182488.71309,-18000,EB445137-D7F5-57EC-87DA-1DB460D64046,"iPhone13,2"
com.apple.mobiletimer,2,1726182401,1726182403,1726182403.792159,-18000,EB445137-D7F5-57EC-87DA-1DB460D64046,"iPhone13,2"
com.apple.mobiletimer,12,1726182289,1726182301,1726182301.9327989,-18000,EB445137-D7F5-57EC-87DA-1DB460D64046,"iPhone13,2"
com.apple.mobiletimer,4,1726181685,1726181689,1726181689.671926,-18000,EB445137-D7F5-57EC-87DA-1DB460D64046,"iPhone13,2"
com.apple.mobiletimer,2,1726181644,1726181646,1726181646.894568,-18000,EB445137-D7F5-57EC-87DA-1DB460D64046,"iPhone13,2"
com.apple.mobiletimer,6,1726181472,1726181478,1726181478.293312,-18000,EB445137-D7F5-57EC-87DA-1DB460D64046,"iPhone13,2"
com.apple.mobiletimer,12,1726181433,1726181445,1726181445.246839,-18000,EB445137-D7F5-57EC-87DA-1DB460D64046,"iPhone13,2"
com.apple.mobiletimer,1,1726181431,1726181432,1726181432.84451,-18000,EB445137-D7F5-57EC-87DA-1DB460D64046,"iPhone13,2"
com.apple.mobiletimer,4,1726181082,1726181086,1726181086.7862601,-18000,EB445137-D7F5-57EC-87DA-1DB460D64046,"iPhone13,2"
com.apple.Music,3,1726181079,1726181082,1726181082.209095,-18000,EB445137-D7F5-57EC-87DA-1DB460D64046,"iPhone13,2"
com.apple.Music,42,1726179426,1726179468,1726179468.5380812,-18000,EB445137-D7F5-57EC-87DA-1DB460D64046,"iPhone13,2"
com.leomehlig.today,38,1726179238,1726179276,1726179276.6929321,-18000,,
com.google.Chrome,2,1726179236,1726179238,1726179238.717761,-18000,,
com.apple.Notes,56,1726179180,1726179236,1726179236.635983,-18000,,
com.leomehlig.today,27,1726179153,1726179180,1726179180.40834,-18000,,
com.google.Chrome,16,1726179137,1726179153,1726179153.9977632,-18000,,
com.leomehlig.today,190,1726178933,1726179123,1726179124.503374,-18000,,
com.apple.Notes,6,1726178927,1726178933,1726178933.616837,-18000,,
com.leomehlig.today,30,1726178897,1726178927,1726178927.424609,-18000,,
com.apple.finder,6,1726178891,1726178897,1726178897.918735,-18000,,
com.leomehlig.today,20,1726178871,1726178891,1726178891.6174111,-18000,,
com.apple.finder,14,1726178857,1726178871,1726178871.173173,-18000,,
com.leomehlig.today,60,1726178797,1726178857,1726178857.0376449,-18000,,
com.apple.finder,27,1726178770,1726178797,1726178797.767394,-18000,,
com.leomehlig.today,17,1726178753,1726178770,1726178770.711423,-18000,,
com.google.Chrome,752,1726178001,1726178753,1726178753.815031,-18000,,
com.leomehlig.today,159,1726177682,1726177841,1726177841.867866,-18000,,
com.google.Chrome,1,1726177681,1726177682,1726177682.8406491,-18000,,
com.microsoft.VSCode,12,1726177669,1726177681,1726177681.238375,-18000,,
us.zoom.xos,14,1726177655,1726177669,1726177669.891798,-18000,,
com.microsoft.VSCode,36,1726177619,1726177655,1726177655.724557,-18000,,
com.google.Chrome,61,1726177558,1726177619,1726177619.5401192,-18000,,
com.microsoft.VSCode,4,1726177554,1726177558,1726177558.702373,-18000,,
com.google.Chrome,46,1726177508,1726177554,1726177554.16461,-18000,,
com.microsoft.VSCode,13,1726177495,1726177508,1726177508.5876222,-18000,,
com.google.Chrome,21,1726177474,1726177495,1726177495.700166,-18000,,
com.microsoft.VSCode,396,1726177078,1726177474,1726177474.10296,-18000,,
us.zoom.xos,8,1726177070,1726177078,1726177078.5124311,-18000,,
com.microsoft.VSCode,0,1726177070,1726177070,1726177070.99558,-18000,,
us.zoom.xos,2,1726177068,1726177070,1726177070.457456,-18000,,
com.microsoft.VSCode,80,1726176988,1726177068,1726177069.032648,-18000,,
us.zoom.xos,2,1726176986,1726176988,1726176988.809766,-18000,,
com.microsoft.VSCode,135,1726176851,1726176986,1726176986.092521,-18000,,
us.zoom.xos,23,1726176828,1726176851,1726176851.878601,-18000,,
com.microsoft.VSCode,154,1726176674,1726176828,1726176828.128926,-18000,,
us.zoom.xos,3,1726176671,1726176674,1726176674.371934,-18000,,
com.microsoft.VSCode,71,1726176600,1726176671,1726176672.0063581,-18000,,
us.zoom.xos,39,1726176561,1726176600,1726176600.227823,-18000,,
com.microsoft.VSCode,64,1726176497,1726176561,1726176561.6327472,-18000,,
com.google.Chrome,23,1726176474,1726176497,1726176497.592545,-18000,,
com.microsoft.VSCode,11,1726176463,1726176474,1726176474.785221,-18000,,
us.zoom.xos,32,1726176431,1726176463,1726176463.783725,-18000,,
com.microsoft.VSCode,7,1726176424,1726176431,1726176431.134622,-18000,,
us.zoom.xos,17,1726176407,1726176424,1726176424.063925,-18000,,
com.microsoft.VSCode,18,1726176389,1726176407,1726176407.349833,-18000,,
us.zoom.xos,10,1726176379,1726176389,1726176389.0758672,-18000,,
com.google.Chrome,1,1726176378,1726176379,1726176379.953425,-18000,,
com.microsoft.VSCode,37,1726176341,1726176378,1726176378.765388,-18000,,
com.google.Chrome,2,1726176339,1726176341,1726176341.953718,-18000,,
us.zoom.xos,24,1726176315,1726176339,1726176339.66371,-18000,,
com.microsoft.VSCode,20,1726176295,1726176315,1726176315.2571511,-18000,,
com.google.Chrome,13,1726176282,1726176295,1726176295.146272,-18000,,
com.microsoft.VSCode,10,1726176272,1726176282,1726176282.727366,-18000,,
com.google.Chrome,6,1726176266,1726176272,1726176272.3190799,-18000,,
com.microsoft.VSCode,3,1726176263,1726176266,1726176266.544801,-18000,,
com.google.Chrome,6,1726176257,1726176263,1726176263.566118,-18000,,
com.microsoft.VSCode,3,1726176254,1726176257,1726176257.2793999,-18000,,
us.zoom.xos,3,1726176251,1726176254,1726176254.7832541,-18000,,
com.microsoft.VSCode,45,1726176206,1726176251,1726176251.958544,-18000,,
us.zoom.xos,20,1726176186,1726176206,1726176206.923497,-18000,,
com.microsoft.VSCode,75,1726176111,1726176186,1726176186.8664331,-18000,,
us.zoom.xos,12,1726176099,1726176111,1726176111.658317,-18000,,
com.microsoft.VSCode,1,1726176098,1726176099,1726176099.74482,-18000,,
us.zoom.xos,22,1726176076,1726176098,1726176098.3663402,-18000,,
com.microsoft.VSCode,108,1726175968,1726176076,1726176076.3802881,-18000,,
com.google.Chrome,3,1726175965,1726175968,1726175968.500907,-18000,,
us.zoom.xos,26,1726175939,1726175965,1726175965.393702,-18000,,
com.google.Chrome,1,1726175938,1726175939,1726175939.507845,-18000,,
com.microsoft.VSCode,51,1726175887,1726175938,1726175938.378148,-18000,,
com.google.Chrome,4,1726175883,1726175887,1726175887.360771,-18000,,
com.microsoft.VSCode,5,1726175878,1726175883,1726175883.558557,-18000,,
com.google.Chrome,44,1726175834,1726175878,1726175878.632452,-18000,,
com.microsoft.VSCode,31,1726175803,1726175834,1726175834.441803,-18000,,
us.zoom.xos,2,1726175801,1726175803,1726175803.192724,-18000,,
com.microsoft.VSCode,1,1726175800,1726175801,1726175801.900298,-18000,,
us.zoom.xos,9,1726175791,1726175800,1726175800.7708411,-18000,,
com.microsoft.VSCode,57,1726175734,1726175791,1726175791.9343982,-18000,,
us.zoom.xos,13,1726175721,1726175734,1726175734.811224,-18000,,
com.microsoft.VSCode,143,1726175578,1726175721,1726175721.613855,-18000,,
us.zoom.xos,7,1726175571,1726175578,1726175578.606379,-18000,,
com.microsoft.VSCode,17,1726175554,1726175571,1726175571.20689,-18000,,
us.zoom.xos,17,1726175537,1726175554,1726175554.322891,-18000,,
com.google.Chrome,2,1726175535,1726175537,1726175537.218807,-18000,,
com.microsoft.VSCode,155,1726175380,1726175535,1726175535.051889,-18000,,
com.google.Chrome,5,1726175375,1726175380,1726175381.052346,-18000,,
com.microsoft.VSCode,10,1726175365,1726175375,1726175375.546506,-18000,,
com.google.Chrome,1,1726175364,1726175365,1726175366.0021029,-18000,,
com.microsoft.VSCode,1,1726175363,1726175364,1726175364.993569,-18000,,
com.google.Chrome,3,1726175360,1726175363,1726175363.179086,-18000,,
com.microsoft.VSCode,3,1726175357,1726175360,1726175360.517715,-18000,,
com.google.Chrome,8,1726175349,1726175357,1726175357.10491,-18000,,
com.microsoft.VSCode,2,1726175347,1726175349,1726175349.260507,-18000,,
com.google.Chrome,3,1726175344,1726175347,1726175347.2410989,-18000,,
com.microsoft.VSCode,2,1726175342,1726175344,1726175344.38588,-18000,,
com.google.Chrome,4,1726175338,1726175342,1726175342.9747782,-18000,,
com.microsoft.VSCode,3,1726175335,1726175338,1726175338.669615,-18000,,
com.google.Chrome,30,1726175305,1726175335,1726175335.7518349,-18000,,
com.microsoft.VSCode,3,1726175302,1726175305,1726175305.700728,-18000,,
com.google.Chrome,1,1726175301,1726175302,1726175302.7882519,-18000,,
com.microsoft.VSCode,7,1726175294,1726175301,1726175301.589384,-18000,,
us.zoom.xos,4,1726175290,1726175294,1726175294.21245,-18000,,
com.google.Chrome,0,1726175290,1726175290,1726175290.700708,-18000,,
us.zoom.xos,3,1726175287,1726175290,1726175290.298438,-18000,,
com.google.Chrome,67,1726175220,1726175287,1726175287.1766071,-18000,,
com.microsoft.VSCode,8,1726175212,1726175220,1726175220.66192,-18000,,
com.google.Chrome,10,1726175202,1726175212,1726175212.327231,-18000,,
us.zoom.xos,8,1726175194,1726175202,1726175202.5074348,-18000,,
com.microsoft.VSCode,19,1726175175,1726175194,1726175194.4331222,-18000,,
com.google.Chrome,60,1726175115,1726175175,1726175176.029494,-18000,,
us.zoom.xos,75,1726175040,1726175115,1726175115.5934138,-18000,,
com.google.Chrome,1,1726175039,1726175040,1726175040.89114,-18000,,
com.microsoft.VSCode,32,1726175007,1726175039,1726175039.453411,-18000,,
com.google.Chrome,33,1726174974,1726175007,1726175007.765382,-18000,,
com.microsoft.VSCode,1,1726174973,1726174974,1726174974.680167,-18000,,
us.zoom.xos,12,1726174961,1726174973,1726174973.5441089,-18000,,
com.microsoft.VSCode,32,1726174929,1726174961,1726174961.034809,-18000,,
us.zoom.xos,1,1726174928,1726174929,1726174929.2912378,-18000,,
com.google.Chrome,10,1726174918,1726174928,1726174928.183758,-18000,,
us.zoom.xos,1,1726174917,1726174918,1726174918.141258,-18000,,
com.microsoft.VSCode,24,1726174893,1726174917,1726174917.148347,-18000,,
us.zoom.xos,41,1726174852,1726174893,1726174893.503621,-18000,,
com.microsoft.VSCode,40,1726174812,1726174852,1726174852.952605,-18000,,
us.zoom.xos,4,1726174808,1726174812,1726174812.987836,-18000,,
com.microsoft.VSCode,18,1726174790,1726174808,1726174808.976025,-18000,,
us.zoom.xos,3,1726174787,1726174790,1726174790.75892,-18000,,
com.microsoft.VSCode,1,1726174786,1726174787,1726174788.012413,-18000,,
com.google.Chrome,27,1726174759,1726174786,1726174786.287424,-18000,,
us.zoom.xos,1,1726174758,1726174759,1726174759.297595,-18000,,
com.google.Chrome,1,1726174757,1726174758,1726174758.7367148,-18000,,
us.zoom.xos,6,1726174751,1726174757,1726174757.112815,-18000,,
com.google.Chrome,1,1726174750,1726174751,1726174751.993877,-18000,,
us.zoom.xos,566,1726174184,1726174750,1726174750.9282842,-18000,,
us.zoom.xos,300,1726173405,1726173705,1726173705.320064,-18000,,
com.google.Chrome,15,1726173390,1726173405,1726173405.322726,-18000,,
us.zoom.xos,12,1726173378,1726173390,1726173390.094863,-18000,,
com.google.Chrome,14,1726173364,1726173378,1726173378.051437,-18000,,
us.zoom.xos,27,1726173337,1726173364,1726173364.240531,-18000,,
com.google.Chrome,17,1726173320,1726173337,1726173337.807332,-18000,,
us.zoom.xos,17,1726173303,1726173320,1726173320.507526,-18000,,
com.google.Chrome,0,1726173303,1726173303,1726173303.927182,-18000,,
us.zoom.xos,2,1726173301,1726173303,1726173303.555945,-18000,,
com.google.Chrome,1,1726173300,1726173301,1726173301.302369,-18000,,
com.leomehlig.today,2,1726173298,1726173300,1726173300.301053,-18000,,
com.google.Chrome,1,1726173297,1726173298,1726173298.848394,-18000,,
com.leomehlig.today,4,1726173293,1726173297,1726173297.817539,-18000,,
com.google.Chrome,15,1726173278,1726173293,1726173293.144205,-18000,,
com.apple.Notes,11,1726173267,1726173278,1726173278.698512,-18000,,
us.zoom.xos,2,1726173265,1726173267,1726173267.230214,-18000,,
com.apple.iCal,2,1726173263,1726173265,1726173265.549907,-18000,,
us.zoom.xos,5,1726173258,1726173263,1726173263.835637,-18000,,
com.google.Chrome,57,1726173201,1726173258,1726173258.175854,-18000,,
us.zoom.xos,12,1726173189,1726173201,1726173201.2651582,-18000,,
com.google.Chrome,126,1726173063,1726173189,1726173189.265579,-18000,,
us.zoom.xos,3,1726173060,1726173063,1726173063.960752,-18000,,
com.google.Chrome,2,1726173058,1726173060,1726173060.612437,-18000,,
us.zoom.xos,1,1726173057,1726173058,1726173058.48648,-18000,,
com.google.Chrome,3,1726173054,1726173057,1726173057.4592519,-18000,,
us.zoom.xos,2,1726173052,1726173054,1726173054.1974602,-18000,,
com.google.Chrome,417,1726172635,1726173052,1726173052.568021,-18000,,
com.leomehlig.today,54,1726172581,1726172635,1726172635.5882878,-18000,,
com.google.Chrome,64,1726172517,1726172581,1726172581.2400908,-18000,,
com.google.Chrome,5,1726172454,1726172459,1726172459.2883658,-18000,,
com.google.Chrome,326,1726172093,1726172419,1726172419.8727632,-18000,,
com.google.Chrome,40,1726169727,1726169767,1726169767.8439121,-18000,,
com.google.Chrome,445,1726168435,1726168880,1726168880.738624,-18000,,
com.google.Chrome,58,1726162953,1726163011,1726163011.661744,-18000,,
com.apple.iCal,18,1726162935,1726162953,1726162953.191931,-18000,,
com.google.Chrome,534,1726162401,1726162935,1726162935.210824,-18000,,
com.leomehlig.today,27,1726162374,1726162401,1726162401.5864239,-18000,,
com.leomehlig.today,43,1726161924,1726161967,1726161967.740773,-18000,,
com.google.Chrome,1956,1726159968,1726161924,1726161924.6731691,-18000,,
com.leomehlig.today,17,1726159951,1726159968,1726159968.376696,-18000,,
com.google.Chrome,2621,1726157330,1726159951,1726159951.426628,-18000,,
com.leomehlig.today,3,1726157133,1726157136,1726157136.23155,-18000,,
com.apple.systempreferences,0,1726157127,1726157127,1726157129.125587,-18000,,
com.apple.Notes,1,1726157126,1726157127,1726157127.464872,-18000,,
com.google.Chrome,48,1726157078,1726157126,1726157126.642861,-18000,,
com.leomehlig.today,18,1726157060,1726157078,1726157078.658788,-18000,,
com.google.Chrome,35,1726157025,1726157060,1726157060.088851,-18000,,
com.leomehlig.today,0,1726157025,1726157025,1726157025.606439,-18000,,
com.google.Chrome,1,1726157024,1726157025,1726157025.2595,-18000,,
com.leomehlig.today,5,1726157019,1726157024,1726157024.473527,-18000,,
com.apple.finder,1,1726157018,1726157019,1726157019.402372,-18000,,
com.google.Chrome,8,1726157010,1726157018,1726157018.29991,-18000,,
com.apple.finder,5,1726156995,1726157000,1726157000.634531,-18000,,
com.leomehlig.today,99,1726156896,1726156995,1726156995.248814,-18000,,
com.apple.Notes,15,1726156881,1726156896,1726156896.2979379,-18000,,
com.leomehlig.today,82,1726156799,1726156881,1726156881.483389,-18000,,
com.apple.Notes,256,1726156543,1726156799,1726156799.572795,-18000,,
com.apple.finder,4,1726156539,1726156543,1726156543.554885,-18000,,
com.apple.Notes,9,1726156530,1726156539,1726156539.755265,-18000,,
com.apple.finder,1,1726156529,1726156530,1726156530.604827,-18000,,
com.google.Chrome,31,1726156498,1726156529,1726156529.834923,-18000,,
com.apple.finder,3,1726156495,1726156498,1726156498.56411,-18000,,
com.apple.Notes,39,1726156456,1726156495,1726156495.969843,-18000,,
com.apple.finder,13,1726156443,1726156456,1726156456.078558,-18000,,
com.apple.Notes,5,1726156438,1726156443,1726156443.1643472,-18000,,
com.apple.finder,1,1726156437,1726156438,1726156438.94974,-18000,,
com.apple.Notes,12,1726156425,1726156437,1726156437.045514,-18000,,
com.apple.finder,9,1726156416,1726156425,1726156425.188645,-18000,,
com.apple.Notes,5,1726156411,1726156416,1726156416.767991,-18000,,
com.apple.finder,15,1726156396,1726156411,1726156411.221589,-18000,,
com.apple.Notes,14,1726156382,1726156396,1726156396.54943,-18000,,
com.apple.finder,38,1726156344,1726156382,1726156382.8721209,-18000,,
com.apple.Notes,15,1726156329,1726156344,1726156344.948566,-18000,,
com.apple.finder,2,1726156327,1726156329,1726156329.7097878,-18000,,
com.apple.Notes,1,1726156326,1726156327,1726156327.572535,-18000,,
com.apple.finder,5,1726156321,1726156326,1726156326.582401,-18000,,
com.apple.Notes,8,1726156313,1726156321,1726156321.5604959,-18000,,
com.apple.finder,17,1726156296,1726156313,1726156314.002386,-18000,,
com.google.Chrome,8,1726156288,1726156296,1726156296.1867208,-18000,,
com.apple.Notes,36,1726156252,1726156288,1726156288.7264252,-18000,,
com.google.Chrome,3,1726156249,1726156252,1726156252.12391,-18000,,
com.apple.Notes,29,1726156220,1726156249,1726156249.235929,-18000,,
com.google.Chrome,15,1726156205,1726156220,1726156220.63114,-18000,,
com.leomehlig.today,1,1726156204,1726156205,1726156205.582371,-18000,,
com.google.Chrome,12,1726156192,1726156204,1726156204.99297,-18000,,
com.leomehlig.today,1,1726156191,1726156192,1726156192.72661,-18000,,
com.apple.Notes,14,1726156177,1726156191,1726156191.5103412,-18000,,
com.leomehlig.today,1,1726156176,1726156177,1726156178.030298,-18000,,
com.google.Chrome,27,1726156149,1726156176,1726156176.6686568,-18000,,
com.leomehlig.today,1,1726156148,1726156149,1726156150.0286279,-18000,,
com.apple.Notes,21,1726156127,1726156148,1726156148.80162,-18000,,
com.leomehlig.today,1,1726156126,1726156127,1726156128.0046182,-18000,,
com.google.Chrome,24,1726156102,1726156126,1726156126.139838,-18000,,
com.leomehlig.today,26,1726156076,1726156102,1726156102.752675,-18000,,
com.google.Chrome,5,1726156071,1726156076,1726156076.833476,-18000,,
com.apple.Notes,9,1726156062,1726156071,1726156071.591206,-18000,,
com.google.Chrome,2,1726156060,1726156062,1726156062.281094,-18000,,
com.apple.iCal,3,1726156057,1726156060,1726156060.072665,-18000,,
com.google.Chrome,24,1726156033,1726156057,1726156057.3839421,-18000,,
com.apple.Notes,65,1726155968,1726156033,1726156033.481839,-18000,,
com.google.Chrome,24,1726155944,1726155968,1726155968.968546,-18000,,
com.apple.news,7,1726155855,1726155862,1726155862.59025,-18000,EB445137-D7F5-57EC-87DA-1DB460D64046,"iPhone13,2"
com.apple.news,185,1726155669,1726155854,1726155854.433169,-18000,EB445137-D7F5-57EC-87DA-1DB460D64046,"iPhone13,2"
com.microsoft.Office.Outlook,45,1726155612,1726155657,1726155657.843365,-18000,EB445137-D7F5-57EC-87DA-1DB460D64046,"iPhone13,2"
com.apple.weather,3,1726155416,1726155419,1726155419.6736112,-18000,EB445137-D7F5-57EC-87DA-1DB460D64046,"iPhone13,2"
com.apple.weather,2,1726154525,1726154527,1726154527.211887,-18000,EB445137-D7F5-57EC-87DA-1DB460D64046,"iPhone13,2"
com.apple.weather,13,1726154469,1726154482,1726154482.608299,-18000,EB445137-D7F5-57EC-87DA-1DB460D64046,"iPhone13,2"
com.apple.weather,5,1726154395,1726154400,1726154400.408777,-18000,EB445137-D7F5-57EC-87DA-1DB460D64046,"iPhone13,2"
com.google.Chrome,43,1726154307,1726154350,1726154350.836767,-18000,,
com.apple.finder,7,1726154300,1726154307,1726154307.130928,-18000,,
com.apple.Preview,3,1726154297,1726154300,1726154300.988686,-18000,,
com.apple.finder,11,1726154286,1726154297,1726154297.3060431,-18000,,
com.apple.Preview,62,1726154224,1726154286,1726154286.668556,-18000,,
com.microsoft.VSCode,106,1726154118,1726154224,1726154224.416326,-18000,,
com.apple.finder,1,1726154117,1726154118,1726154119.030818,-18000,,
com.microsoft.VSCode,3,1726154114,1726154117,1726154117.505261,-18000,,
com.apple.finder,35,1726154079,1726154114,1726154114.680573,-18000,,
com.microsoft.VSCode,17,1726154062,1726154079,1726154079.8346848,-18000,,
com.google.Chrome,13,1726154049,1726154062,1726154062.205436,-18000,,
com.microsoft.VSCode,0,1726154049,1726154049,1726154049.780895,-18000,,
com.google.Chrome,1,1726154048,1726154049,1726154049.160784,-18000,,
com.microsoft.VSCode,133,1726153915,1726154048,1726154048.18261,-18000,,
com.google.Chrome,3,1726153912,1726153915,1726153915.1161861,-18000,,
com.microsoft.VSCode,68,1726153844,1726153912,1726153912.88799,-18000,,
com.google.Chrome,6,1726153838,1726153844,1726153844.451552,-18000,,
com.microsoft.VSCode,24,1726153814,1726153838,1726153838.882141,-18000,,
com.google.Chrome,1,1726153813,1726153814,1726153814.828226,-18000,,
com.microsoft.VSCode,8,1726153805,1726153813,1726153813.3020868,-18000,,
com.google.Chrome,1,1726153804,1726153805,1726153805.644443,-18000,,
com.microsoft.VSCode,68,1726153736,1726153804,1726153804.153833,-18000,,
com.google.Chrome,4,1726153732,1726153736,1726153736.395218,-18000,,
com.microsoft.VSCode,7,1726153725,1726153732,1726153732.3824139,-18000,,
com.google.Chrome,10,1726153715,1726153725,1726153725.713171,-18000,,
com.microsoft.VSCode,42,1726153673,1726153715,1726153715.940649,-18000,,
com.google.Chrome,6,1726153667,1726153673,1726153673.60109,-18000,,
com.microsoft.VSCode,3,1726153664,1726153667,1726153667.955634,-18000,,
com.google.Chrome,7,1726153657,1726153664,1726153664.954222,-18000,,
com.microsoft.VSCode,2,1726153655,1726153657,1726153657.3379169,-18000,,
com.google.Chrome,3,1726153652,1726153655,1726153655.2727962,-18000,,
com.microsoft.VSCode,25,1726153627,1726153652,1726153652.8907418,-18000,,
com.google.Chrome,1,1726153626,1726153627,1726153627.510429,-18000,,
com.microsoft.VSCode,46,1726153580,1726153626,1726153626.3567019,-18000,,
com.google.Chrome,13,1726153567,1726153580,1726153580.673153,-18000,,
com.microsoft.VSCode,8,1726153559,1726153567,1726153568.0056229,-18000,,
com.google.Chrome,5,1726153554,1726153559,1726153559.459115,-18000,,
com.microsoft.VSCode,60,1726153494,1726153554,1726153554.703614,-18000,,
com.google.Chrome,10,1726153484,1726153494,1726153494.108717,-18000,,
com.microsoft.VSCode,90,1726153394,1726153484,1726153484.228441,-18000,,
com.google.Chrome,18,1726153376,1726153394,1726153394.587864,-18000,,
com.microsoft.VSCode,3,1726153373,1726153376,1726153376.302841,-18000,,
com.google.Chrome,4,1726153369,1726153373,1726153373.1287851,-18000,,
com.microsoft.VSCode,14,1726153355,1726153369,1726153369.781187,-18000,,
com.google.Chrome,13,1726153342,1726153355,1726153355.31568,-18000,,
com.microsoft.VSCode,1,1726153341,1726153342,1726153342.879435,-18000,,
com.google.Chrome,3,1726153338,1726153341,1726153342.0540562,-18000,,
com.microsoft.VSCode,2,1726153336,1726153338,1726153338.2483559,-18000,,
com.google.Chrome,4,1726153332,1726153336,1726153336.075774,-18000,,
com.microsoft.VSCode,2,1726153330,1726153332,1726153332.916671,-18000,,
com.google.Chrome,14,1726153316,1726153330,1726153330.709368,-18000,,
com.microsoft.VSCode,0,1726153316,1726153316,1726153316.69717,-18000,,
com.google.Chrome,1,1726153315,1726153316,1726153316.172405,-18000,,
com.microsoft.VSCode,13,1726153302,1726153315,1726153315.536016,-18000,,
com.google.Chrome,6,1726153296,1726153302,1726153302.9476151,-18000,,
com.microsoft.VSCode,122,1726153174,1726153296,1726153296.953913,-18000,,
com.google.Chrome,26,1726153148,1726153174,1726153174.149384,-18000,,
com.microsoft.VSCode,23,1726153125,1726153148,1726153148.293863,-18000,,
com.google.Chrome,10,1726153115,1726153125,1726153125.50417,-18000,,
com.microsoft.VSCode,5,1726153110,1726153115,1726153115.714587,-18000,,
com.google.Chrome,10,1726153100,1726153110,1726153110.291918,-18000,,
com.microsoft.VSCode,24,1726153076,1726153100,1726153100.878766,-18000,,
com.google.Chrome,3,1726153073,1726153076,1726153076.604578,-18000,,
com.microsoft.VSCode,15,1726153058,1726153073,1726153073.2370229,-18000,,
com.google.Chrome,2,1726153056,1726153058,1726153058.407212,-18000,,
com.microsoft.VSCode,1,1726153055,1726153056,1726153056.449523,-18000,,
com.google.Chrome,7,1726153048,1726153055,1726153055.148274,-18000,,
com.microsoft.VSCode,49,1726152999,1726153048,1726153048.714301,-18000,,
com.google.Chrome,1,1726152998,1726152999,1726152999.995444,-18000,,
com.microsoft.VSCode,4,1726152994,1726152998,1726152998.6356869,-18000,,
com.google.Chrome,5,1726152989,1726152994,1726152994.6833549,-18000,,
com.microsoft.VSCode,6,1726152983,1726152989,1726152989.5504441,-18000,,
com.google.Chrome,3,1726152980,1726152983,1726152983.483845,-18000,,
com.microsoft.VSCode,6,1726152974,1726152980,1726152980.7356138,-18000,,
com.google.Chrome,1,1726152973,1726152974,1726152974.5355802,-18000,,
com.microsoft.VSCode,2,1726152971,1726152973,1726152973.420875,-18000,,
com.google.Chrome,2,1726152969,1726152971,1726152971.097544,-18000,,
com.microsoft.VSCode,2,1726152967,1726152969,1726152969.887979,-18000,,
com.google.Chrome,6,1726152961,1726152967,1726152967.547236,-18000,,
com.microsoft.VSCode,2,1726152959,1726152961,1726152961.469955,-18000,,
com.google.Chrome,2,1726152957,1726152959,1726152959.214093,-18000,,
com.microsoft.VSCode,5,1726152952,1726152957,1726152957.2598128,-18000,,
com.google.Chrome,2,1726152950,1726152952,1726152952.780521,-18000,,
com.microsoft.VSCode,2,1726152948,1726152950,1726152950.306236,-18000,,
com.google.Chrome,5,1726152943,1726152948,1726152948.98404,-18000,,
com.microsoft.VSCode,65,1726152878,1726152943,1726152943.318867,-18000,,
com.google.Chrome,7,1726152871,1726152878,1726152879.011636,-18000,,
com.microsoft.VSCode,2,1726152869,1726152871,1726152871.711732,-18000,,
com.google.Chrome,4,1726152865,1726152869,1726152869.514888,-18000,,
com.microsoft.VSCode,1,1726152864,1726152865,1726152865.754936,-18000,,
com.google.Chrome,1,1726152863,1726152864,1726152864.180893,-18000,,
com.microsoft.VSCode,1,1726152862,1726152863,1726152863.069604,-18000,,
com.google.Chrome,44,1726152818,1726152862,1726152862.0666342,-18000,,
com.microsoft.VSCode,11,1726152807,1726152818,1726152818.659673,-18000,,
com.google.Chrome,0,1726152807,1726152807,1726152808.0089478,-18000,,
com.microsoft.VSCode,5,1726152802,1726152807,1726152807.091919,-18000,,
com.google.Chrome,40,1726152762,1726152802,1726152802.229857,-18000,,
com.microsoft.VSCode,72,1726152690,1726152762,1726152762.1831598,-18000,,
com.google.Chrome,2,1726152688,1726152690,1726152690.068492,-18000,,
com.microsoft.VSCode,98,1726152590,1726152688,1726152688.8834438,-18000,,
com.google.Chrome,197,1726152393,1726152590,1726152590.4192,-18000,,
com.microsoft.VSCode,426,1726151967,1726152393,1726152393.397987,-18000,,
com.google.Chrome,0,1726151967,1726151967,1726151967.9475641,-18000,,
com.microsoft.VSCode,1,1726151966,1726151967,1726151967.389741,-18000,,
com.apple.finder,2,1726151964,1726151966,1726151966.5341969,-18000,,
com.google.Chrome,346,1726151618,1726151964,1726151964.906966,-18000,,
com.apple.finder,4,1726151614,1726151618,1726151618.5770621,-18000,,
com.microsoft.VSCode,16,1726151598,1726151614,1726151614.189701,-18000,,
com.apple.finder,2,1726151596,1726151598,1726151598.940981,-18000,,
com.microsoft.VSCode,4,1726151592,1726151596,1726151596.4749699,-18000,,
com.apple.finder,17,1726151575,1726151592,1726151592.820209,-18000,,
com.google.Chrome,161,1726151414,1726151575,1726151575.770411,-18000,,
com.leomehlig.today,3,1726151397,1726151400,1726151400.5939078,-18000,,
com.apple.weather,9,1726151200,1726151209,1726151209.334836,-18000,EB445137-D7F5-57EC-87DA-1DB460D64046,"iPhone13,2"
com.apple.weather,4,1726150337,1726150341,1726150341.325098,-18000,EB445137-D7F5-57EC-87DA-1DB460D64046,"iPhone13,2"
com.apple.news,173,1726150105,1726150278,1726150278.4724178,-18000,EB445137-D7F5-57EC-87DA-1DB460D64046,"iPhone13,2"
com.apple.Health,12,1726150077,1726150089,1726150089.868068,-18000,EB445137-D7F5-57EC-87DA-1DB460D64046,"iPhone13,2"
com.facebook.Facebook,59,1726150015,1726150074,1726150074.432685,-18000,EB445137-D7F5-57EC-87DA-1DB460D64046,"iPhone13,2"
com.leomehlig.today,278,1726149941,1726150219,1726150219.841114,-18000,,
com.myfitnesspal.mfp,72,1726149934,1726150006,1726150006.4800181,-18000,EB445137-D7F5-57EC-87DA-1DB460D64046,"iPhone13,2"
com.apple.weather,12,1726149922,1726149934,1726149934.364462,-18000,EB445137-D7F5-57EC-87DA-1DB460D64046,"iPhone13,2"
com.google.Chrome,7,1726149908,1726149915,1726149915.4005,-18000,,
com.apple.weather,10,1726149029,1726149039,1726149039.357606,-18000,EB445137-D7F5-57EC-87DA-1DB460D64046,"iPhone13,2"
com.apple.weather,14,1726148967,1726148981,1726148981.510542,-18000,EB445137-D7F5-57EC-87DA-1DB460D64046,"iPhone13,2"
com.renpho.health,53,1726148914,1726148967,1726148967.672554,-18000,EB445137-D7F5-57EC-87DA-1DB460D64046,"iPhone13,2"
com.apple.Music,44,1726147800,1726147844,1726147845.1648169,-18000,EB445137-D7F5-57EC-87DA-1DB460D64046,"iPhone13,2"
com.apple.Music,13,1726115626,1726115639,1726115639.8911982,-18000,EB445137-D7F5-57EC-87DA-1DB460D64046,"iPhone13,2"
com.apple.camera,0,1726115616,1726115616,1726115616.697671,-18000,EB445137-D7F5-57EC-87DA-1DB460D64046,"iPhone13,2"
com.apple.Music,6,1726115610,1726115616,1726115616.685238,-18000,EB445137-D7F5-57EC-87DA-1DB460D64046,"iPhone13,2"
com.apple.Music,16,1726114991,1726115007,1726115007.438442,-18000,EB445137-D7F5-57EC-87DA-1DB460D64046,"iPhone13,2"
com.apple.Music,5,1726114545,1726114550,1726114550.955519,-18000,EB445137-D7F5-57EC-87DA-1DB460D64046,"iPhone13,2"
com.apple.Music,3,1726114366,1726114369,1726114369.9404569,-18000,EB445137-D7F5-57EC-87DA-1DB460D64046,"iPhone13,2"
com.apple.Music,36,1726113783,1726113819,1726113819.7403312,-18000,EB445137-D7F5-57EC-87DA-1DB460D64046,"iPhone13,2"
com.google.Chrome,0,1726113709,1726113709,1726113709.6972718,-18000,,
com.google.Chrome,819,1726112882,1726113701,1726113701.520998,-18000,,
com.apple.iCal,4,1726112878,1726112882,1726112882.163533,-18000,,
com.apple.MobileSMS,3,1726112875,1726112878,1726112879.191078,-18000,,
com.apple.iCal,7,1726112868,1726112875,1726112875.414994,-18000,,
com.leomehlig.today,2,1726112866,1726112868,1726112868.43207,-18000,,
com.apple.camera,1,1726112130,1726112131,1726112131.222927,-18000,EB445137-D7F5-57EC-87DA-1DB460D64046,"iPhone13,2"
com.instructure.icanvas,5,1726109854,1726109859,1726109859.7940788,-18000,EB445137-D7F5-57EC-87DA-1DB460D64046,"iPhone13,2"
com.google.chrome.ios,9,1726109845,1726109854,1726109854.208123,-18000,EB445137-D7F5-57EC-87DA-1DB460D64046,"iPhone13,2"
com.google.chrome.ios,3,1726109826,1726109829,1726109829.8370252,-18000,EB445137-D7F5-57EC-87DA-1DB460D64046,"iPhone13,2"
com.google.chrome.ios,31,1726109786,1726109817,1726109817.337456,-18000,EB445137-D7F5-57EC-87DA-1DB460D64046,"iPhone13,2"
com.myfitnesspal.mfp,6,1726109780,1726109786,1726109787.0489302,-18000,EB445137-D7F5-57EC-87DA-1DB460D64046,"iPhone13,2"
com.myfitnesspal.mfp,6,1726108811,1726108817,1726108817.191196,-18000,EB445137-D7F5-57EC-87DA-1DB460D64046,"iPhone13,2"
com.myfitnesspal.mfp,2,1726108749,1726108751,1726108752.024386,-18000,EB445137-D7F5-57EC-87DA-1DB460D64046,"iPhone13,2"
com.myfitnesspal.mfp,2,1726108471,1726108473,1726108473.2647672,-18000,EB445137-D7F5-57EC-87DA-1DB460D64046,"iPhone13,2"
com.myfitnesspal.mfp,14,1726107892,1726107906,1726107906.050492,-18000,EB445137-D7F5-57EC-87DA-1DB460D64046,"iPhone13,2"
com.myfitnesspal.mfp,6,1726107710,1726107716,1726107716.774729,-18000,EB445137-D7F5-57EC-87DA-1DB460D64046,"iPhone13,2"
com.myfitnesspal.mfp,1,1726107408,1726107409,1726107409.701179,-18000,EB445137-D7F5-57EC-87DA-1DB460D64046,"iPhone13,2"
com.myfitnesspal.mfp,11,1726107276,1726107287,1726107287.907264,-18000,EB445137-D7F5-57EC-87DA-1DB460D64046,"iPhone13,2"
com.burbn.instagram,38,1726107231,1726107269,1726107269.2682061,-18000,EB445137-D7F5-57EC-87DA-1DB460D64046,"iPhone13,2"
com.myfitnesspal.mfp,4,1726107225,1726107229,1726107229.37818,-18000,EB445137-D7F5-57EC-87DA-1DB460D64046,"iPhone13,2"
com.myfitnesspal.mfp,2,1726106899,1726106901,1726106901.216398,-18000,EB445137-D7F5-57EC-87DA-1DB460D64046,"iPhone13,2"
com.myfitnesspal.mfp,102,1726106692,1726106794,1726106794.114136,-18000,EB445137-D7F5-57EC-87DA-1DB460D64046,"iPhone13,2"
com.apple.MobileSMS,6,1726103726,1726103732,1726103732.181042,-18000,EB445137-D7F5-57EC-87DA-1DB460D64046,"iPhone13,2"
com.apple.MobileSMS,5,1726103617,1726103622,1726103622.968174,-18000,EB445137-D7F5-57EC-87DA-1DB460D64046,"iPhone13,2"
com.apple.MobileSMS,2,1726103553,1726103555,1726103555.849125,-18000,EB445137-D7F5-57EC-87DA-1DB460D64046,"iPhone13,2"
com.apple.MobileSMS,5,1726103492,1726103497,1726103497.473722,-18000,EB445137-D7F5-57EC-87DA-1DB460D64046,"iPhone13,2"
com.apple.MobileSMS,10,1726103458,1726103468,1726103468.466255,-18000,EB445137-D7F5-57EC-87DA-1DB460D64046,"iPhone13,2"
com.facebook.Facebook,5,1726099415,1726099420,1726099420.20681,-18000,EB445137-D7F5-57EC-87DA-1DB460D64046,"iPhone13,2"
com.apple.MobileSMS,36,1726099379,1726099415,1726099415.571642,-18000,EB445137-D7F5-57EC-87DA-1DB460D64046,"iPhone13,2"
com.apple.MobileSMS,20,1726099303,1726099323,1726099324.000747,-18000,EB445137-D7F5-57EC-87DA-1DB460D64046,"iPhone13,2"
com.google.chrome.ios,2,1726099301,1726099303,1726099303.869018,-18000,EB445137-D7F5-57EC-87DA-1DB460D64046,"iPhone13,2"
com.google.chrome.ios,36,1726098268,1726098304,1726098304.613761,-18000,EB445137-D7F5-57EC-87DA-1DB460D64046,"iPhone13,2"
com.google.chrome.ios,29,1726098187,1726098216,1726098216.437025,-18000,EB445137-D7F5-57EC-87DA-1DB460D64046,"iPhone13,2"
com.apple.MobileSMS,2,1726098185,1726098187,1726098187.687097,-18000,EB445137-D7F5-57EC-87DA-1DB460D64046,"iPhone13,2"
com.apple.MobileSMS,22,1726098141,1726098163,1726098163.126431,-18000,EB445137-D7F5-57EC-87DA-1DB460D64046,"iPhone13,2"
com.google.chrome.ios,2,1726098139,1726098141,1726098141.866513,-18000,EB445137-D7F5-57EC-87DA-1DB460D64046,"iPhone13,2"
com.google.chrome.ios,19,1726098057,1726098076,1726098076.771395,-18000,EB445137-D7F5-57EC-87DA-1DB460D64046,"iPhone13,2"
com.google.chrome.ios,21,1726097381,1726097402,1726097402.361959,-18000,EB445137-D7F5-57EC-87DA-1DB460D64046,"iPhone13,2"
com.apple.InCallService,1218,1726096570,1726097788,1726097788.215034,-18000,EB445137-D7F5-57EC-87DA-1DB460D64046,"iPhone13,2"
com.apple.MobileSMS,30,1726096540,1726096570,1726096570.344625,-18000,EB445137-D7F5-57EC-87DA-1DB460D64046,"iPhone13,2"
com.apple.MobileSMS,3,1726096536,1726096539,1726096539.08055,-18000,EB445137-D7F5-57EC-87DA-1DB460D64046,"iPhone13,2"
com.myfitnesspal.mfp,2,1726096534,1726096536,1726096536.1490679,-18000,EB445137-D7F5-57EC-87DA-1DB460D64046,"iPhone13,2"
com.myfitnesspal.mfp,41,1726096411,1726096452,1726096452.975408,-18000,EB445137-D7F5-57EC-87DA-1DB460D64046,"iPhone13,2"
com.myfitnesspal.mfp,82,1726096152,1726096234,1726096234.438482,-18000,EB445137-D7F5-57EC-87DA-1DB460D64046,"iPhone13,2"
com.apple.camera,7,1726096145,1726096152,1726096152.390374,-18000,EB445137-D7F5-57EC-87DA-1DB460D64046,"iPhone13,2"
com.google.ios.youtube,3,1726096103,1726096106,1726096106.302944,-18000,EB445137-D7F5-57EC-87DA-1DB460D64046,"iPhone13,2"
com.google.ios.youtube,2,1726095721,1726095723,1726095723.487858,-18000,EB445137-D7F5-57EC-87DA-1DB460D64046,"iPhone13,2"
com.google.ios.youtube,117,1726095397,1726095514,1726095514.690607,-18000,EB445137-D7F5-57EC-87DA-1DB460D64046,"iPhone13,2"
com.myfitnesspal.mfp,3,1726095110,1726095113,1726095113.618157,-18000,EB445137-D7F5-57EC-87DA-1DB460D64046,"iPhone13,2"
com.myfitnesspal.mfp,10,1726094821,1726094831,1726094831.8034701,-18000,EB445137-D7F5-57EC-87DA-1DB460D64046,"iPhone13,2"
com.apple.mobilecal,11,1726093844,1726093855,1726093855.6421351,-18000,EB445137-D7F5-57EC-87DA-1DB460D64046,"iPhone13,2"
com.myfitnesspal.mfp,3,1726093838,1726093841,1726093841.6328049,-18000,EB445137-D7F5-57EC-87DA-1DB460D64046,"iPhone13,2"
com.myfitnesspal.mfp,28,1726093553,1726093581,1726093581.272769,-18000,EB445137-D7F5-57EC-87DA-1DB460D64046,"iPhone13,2"
com.apple.news,163,1726093366,1726093529,1726093529.1718822,-18000,EB445137-D7F5-57EC-87DA-1DB460D64046,"iPhone13,2"
com.apple.news,3,1726093318,1726093321,1726093321.50595,-18000,EB445137-D7F5-57EC-87DA-1DB460D64046,"iPhone13,2"
com.apple.news,2,1726093312,1726093314,1726093314.24881,-18000,EB445137-D7F5-57EC-87DA-1DB460D64046,"iPhone13,2"
com.apple.news,50,1726093253,1726093303,1726093304.211423,-18000,EB445137-D7F5-57EC-87DA-1DB460D64046,"iPhone13,2"
com.apple.news,148,1726093070,1726093218,1726093218.723381,-18000,EB445137-D7F5-57EC-87DA-1DB460D64046,"iPhone13,2"
com.apple.news,66,1726093003,1726093069,1726093069.13188,-18000,EB445137-D7F5-57EC-87DA-1DB460D64046,"iPhone13,2"
com.apple.news,6,1726092767,1726092773,1726092773.412879,-18000,EB445137-D7F5-57EC-87DA-1DB460D64046,"iPhone13,2"
com.apple.news,78,1726092176,1726092254,1726092254.2694001,-18000,EB445137-D7F5-57EC-87DA-1DB460D64046,"iPhone13,2"
com.apple.news,15,1726092106,1726092121,1726092121.643996,-18000,EB445137-D7F5-57EC-87DA-1DB460D64046,"iPhone13,2"
com.toyopagroup.picaboo,3,1726091931,1726091934,1726091934.263938,-18000,EB445137-D7F5-57EC-87DA-1DB460D64046,"iPhone13,2"
com.leomehlig.today,12,1726091116,1726091128,1726091128.354494,-18000,,
com.google.Chrome,953,1726090163,1726091116,1726091116.8547869,-18000,,
com.google.Chrome,394,1726089544,1726089938,1726089938.853282,-18000,,
com.microsoft.Outlook,8,1726089536,1726089544,1726089544.114655,-18000,,
com.facebook.Facebook,57,1726089274,1726089331,1726089331.465438,-18000,EB445137-D7F5-57EC-87DA-1DB460D64046,"iPhone13,2"
com.google.Chrome,452,1726089084,1726089536,1726089536.653846,-18000,,
com.apple.iCal,6,1726089078,1726089084,1726089084.230618,-18000,,
com.google.Chrome,30,1726089048,1726089078,1726089078.054868,-18000,,
com.apple.iCal,9,1726089039,1726089048,1726089048.031889,-18000,,
com.facebook.Facebook,218,1726089023,1726089241,1726089241.416059,-18000,EB445137-D7F5-57EC-87DA-1DB460D64046,"iPhone13,2"
com.google.Chrome,85,1726088954,1726089039,1726089039.631906,-18000,,
com.google.chrome.ios,68,1726088874,1726088942,1726088942.5722442,-18000,EB445137-D7F5-57EC-87DA-1DB460D64046,"iPhone13,2"
com.google.Gmail,3,1726088871,1726088874,1726088874.7833,-18000,EB445137-D7F5-57EC-87DA-1DB460D64046,"iPhone13,2"
com.apple.mobileslideshow,43,1726088811,1726088854,1726088854.967258,-18000,EB445137-D7F5-57EC-87DA-1DB460D64046,"iPhone13,2"
com.apple.MobileSMS,2,1726088806,1726088808,1726088808.286106,-18000,EB445137-D7F5-57EC-87DA-1DB460D64046,"iPhone13,2"
com.microsoft.Outlook,152,1726088802,1726088954,1726088955.040872,-18000,,
com.apple.mobileslideshow,13,1726088793,1726088806,1726088806.443408,-18000,EB445137-D7F5-57EC-87DA-1DB460D64046,"iPhone13,2"
com.google.Chrome,13,1726088789,1726088802,1726088802.2026172,-18000,,
com.leomehlig.today,57,1726088732,1726088789,1726088789.6239638,-18000,,
com.apple.mobileslideshow,175,1726088518,1726088693,1726088693.897441,-18000,EB445137-D7F5-57EC-87DA-1DB460D64046,"iPhone13,2"
com.apple.camera,431,1726087893,1726088324,1726088324.8056378,-18000,EB445137-D7F5-57EC-87DA-1DB460D64046,"iPhone13,2"
com.google.Chrome,1004,1726087728,1726088732,1726088732.249346,-18000,,
com.toyopagroup.picaboo,36,1726087134,1726087170,1726087170.5053248,-18000,EB445137-D7F5-57EC-87DA-1DB460D64046,"iPhone13,2"
com.intsig.CamScannerLite,10,1726087124,1726087134,1726087134.5469651,-18000,EB445137-D7F5-57EC-87DA-1DB460D64046,"iPhone13,2"
com.intsig.CamScannerLite,5,1726086470,1726086475,1726086475.90611,-18000,EB445137-D7F5-57EC-87DA-1DB460D64046,"iPhone13,2"
com.google.Chrome,614,1726086409,1726087023,1726087023.6586971,-18000,,
com.apple.finder,26,1726086383,1726086409,1726086409.08153,-18000,,
com.google.Chrome,2,1726086381,1726086383,1726086383.866239,-18000,,
com.apple.finder,2,1726086379,1726086381,1726086381.678586,-18000,,
com.google.Chrome,2,1726086377,1726086379,1726086379.967917,-18000,,
com.apple.finder,3,1726086374,1726086377,1726086377.825361,-18000,,
com.intsig.CamScannerLite,132,1726086296,1726086428,1726086428.86778,-18000,EB445137-D7F5-57EC-87DA-1DB460D64046,"iPhone13,2"
com.microsoft.Office.Outlook,5,1726086289,1726086294,1726086294.227818,-18000,EB445137-D7F5-57EC-87DA-1DB460D64046,"iPhone13,2"
com.google.Chrome,480,1726085894,1726086374,1726086374.212349,-18000,,
com.google.Chrome,1299,1726084450,1726085749,1726085749.9529529,-18000,,
com.google.Chrome,394,1726083540,1726083934,1726083934.425571,-18000,,
com.apple.systempreferences,1,1726083539,1726083540,1726083540.554751,-18000,,
com.google.Chrome,15,1726083517,1726083532,1726083533.071342,-18000,,
com.leomehlig.today,1,1726083516,1726083517,1726083521.2042089,-18000,,
com.microsoft.Office.Outlook,3,1726081079,1726081082,1726081082.224724,-18000,EB445137-D7F5-57EC-87DA-1DB460D64046,"iPhone13,2"
com.microsoft.Office.Outlook,15,1726080937,1726080952,1726080953.047433,-18000,EB445137-D7F5-57EC-87DA-1DB460D64046,"iPhone13,2"
com.apple.MobileSMS,8,1726080928,1726080936,1726080936.3286,-18000,EB445137-D7F5-57EC-87DA-1DB460D64046,"iPhone13,2"
com.apple.MobileSMS,3,1726080924,1726080927,1726080927.359642,-18000,EB445137-D7F5-57EC-87DA-1DB460D64046,"iPhone13,2"
com.apple.MobileSMS,5,1726077575,1726077580,1726077580.977433,-18000,EB445137-D7F5-57EC-87DA-1DB460D64046,"iPhone13,2"
com.apple.MobileSMS,37,1726077526,1726077563,1726077563.28786,-18000,EB445137-D7F5-57EC-87DA-1DB460D64046,"iPhone13,2"
com.burbn.instagram,28,1726077498,1726077526,1726077526.7554011,-18000,EB445137-D7F5-57EC-87DA-1DB460D64046,"iPhone13,2"
com.apple.MobileSMS,34,1726077460,1726077494,1726077495.0638618,-18000,EB445137-D7F5-57EC-87DA-1DB460D64046,"iPhone13,2"
com.google.chrome.ios,60,1726077400,1726077460,1726077460.87572,-18000,EB445137-D7F5-57EC-87DA-1DB460D64046,"iPhone13,2"
com.apple.news,184,1726077216,1726077400,1726077400.522682,-18000,EB445137-D7F5-57EC-87DA-1DB460D64046,"iPhone13,2"
com.toyopagroup.picaboo,4,1726077200,1726077204,1726077205.230525,-18000,EB445137-D7F5-57EC-87DA-1DB460D64046,"iPhone13,2"
com.toyopagroup.picaboo,7,1726077192,1726077199,1726077199.431499,-18000,EB445137-D7F5-57EC-87DA-1DB460D64046,"iPhone13,2"
com.myfitnesspal.mfp,9,1726077095,1726077104,1726077104.049701,-18000,EB445137-D7F5-57EC-87DA-1DB460D64046,"iPhone13,2"
com.myfitnesspal.mfp,1,1726077077,1726077078,1726077078.457576,-18000,EB445137-D7F5-57EC-87DA-1DB460D64046,"iPhone13,2"
com.myfitnesspal.mfp,16,1726077052,1726077068,1726077068.3738232,-18000,EB445137-D7F5-57EC-87DA-1DB460D64046,"iPhone13,2"
com.myfitnesspal.mfp,2,1726077049,1726077051,1726077051.33152,-18000,EB445137-D7F5-57EC-87DA-1DB460D64046,"iPhone13,2"
com.myfitnesspal.mfp,1,1726077044,1726077045,1726077046.027895,-18000,EB445137-D7F5-57EC-87DA-1DB460D64046,"iPhone13,2"
com.myfitnesspal.mfp,92,1726076950,1726077042,1726077042.981694,-18000,EB445137-D7F5-57EC-87DA-1DB460D64046,"iPhone13,2"
com.leomehlig.today,51,1726076889,1726076940,1726076940.2836099,-18000,EB445137-D7F5-57EC-87DA-1DB460D64046,"iPhone13,2"
com.apple.mobilecal,19,1726076867,1726076886,1726076887.0473762,-18000,EB445137-D7F5-57EC-87DA-1DB460D64046,"iPhone13,2"
com.instructure.icanvas,62,1726076804,1726076866,1726076866.4889011,-18000,EB445137-D7F5-57EC-87DA-1DB460D64046,"iPhone13,2"
com.leomehlig.today,58,1726071847,1726071905,1726071905.471727,-18000,,
com.apple.finder,5,1726071842,1726071847,1726071847.571268,-18000,,
com.leomehlig.today,0,1726071842,1726071842,1726071843.023003,-18000,,
com.apple.finder,2,1726071840,1726071842,1726071842.415663,-18000,,
com.leomehlig.today,2,1726071838,1726071840,1726071840.2216449,-18000,,
com.apple.Preview,2,1726071836,1726071838,1726071838.8892179,-18000,,
com.leomehlig.today,76,1726071760,1726071836,1726071836.6290941,-18000,,
com.apple.Preview,4,1726071756,1726071760,1726071760.5836968,-18000,,
com.leomehlig.today,5,1726071751,1726071756,1726071756.483788,-18000,,
com.apple.Preview,1,1726071750,1726071751,1726071751.1483622,-18000,,
com.leomehlig.today,10,1726071740,1726071750,1726071750.6395268,-18000,,
com.apple.Preview,1,1726071739,1726071740,1726071740.855624,-18000,,
com.leomehlig.today,7,1726071732,1726071739,1726071739.3578172,-18000,,
com.apple.Preview,21,1726071711,1726071732,1726071732.872302,-18000,,
com.apple.finder,5,1726071706,1726071711,1726071711.1482801,-18000,,
com.leomehlig.today,66,1726071640,1726071706,1726071706.206874,-18000,,
com.leomehlig.today,107,1726065357,1726065464,1726065464.854103,-18000,,
com.google.Chrome,6,1726065351,1726065357,1726065357.592298,-18000,,
com.google.Chrome,63,1726027469,1726027532,1726027533.0499182,-18000,,
com.google.Chrome,452,1726026880,1726027332,1726027332.5314689,-18000,,
com.google.Chrome,861,1726025053,1726025914,1726025914.324099,-18000,,
com.leomehlig.today,90,1726024963,1726025053,1726025053.6270208,-18000,,
com.google.Chrome,91,1726024872,1726024963,1726024963.7547898,-18000,,
com.leomehlig.today,4,1726024868,1726024872,1726024872.930629,-18000,,
com.robinhood.release.Robinhood,43,1726024338,1726024381,1726024381.755879,-18000,EB445137-D7F5-57EC-87DA-1DB460D64046,"iPhone13,2"
com.apple.Health,51,1726024271,1726024322,1726024322.748544,-18000,EB445137-D7F5-57EC-87DA-1DB460D64046,"iPhone13,2"
com.myfitnesspal.mfp,21,1726024249,1726024270,1726024271.6408901,-18000,EB445137-D7F5-57EC-87DA-1DB460D64046,"iPhone13,2"
com.apple.Health,9,1726024240,1726024249,1726024249.237442,-18000,EB445137-D7F5-57EC-87DA-1DB460D64046,"iPhone13,2"
com.leomehlig.today,40,1726024190,1726024230,1726024230.739563,-18000,,
com.leomehlig.today,4,1726023724,1726023728,1726023728.3383288,-18000,,
com.google.Chrome,2,1726023722,1726023724,1726023724.168283,-18000,,
com.leomehlig.today,1,1726023721,1726023722,1726023722.6485791,-18000,,
com.apple.iCal,66,1726023655,1726023721,1726023721.8098822,-18000,,
com.leomehlig.today,13,1726023642,1726023655,1726023655.5540261,-18000,,
com.google.Chrome,1,1726023641,1726023642,1726023642.619637,-18000,,
com.leomehlig.today,6,1726023635,1726023641,1726023641.1023278,-18000,,
com.apple.finder,4,1726023631,1726023635,1726023635.091469,-18000,,
com.leomehlig.today,2,1726023629,1726023631,1726023631.9325972,-18000,,
com.apple.news,129,1726022836,1726022965,1726022965.086869,-18000,EB445137-D7F5-57EC-87DA-1DB460D64046,"iPhone13,2"
com.apple.camera,1,1726022829,1726022830,1726022830.148045,-18000,EB445137-D7F5-57EC-87DA-1DB460D64046,"iPhone13,2"
com.google.Chrome,1169,1726022460,1726023629,1726023629.6870751,-18000,,
com.leomehlig.today,22,1726022383,1726022405,1726022405.548359,-18000,,
com.google.Chrome,71,1726022312,1726022383,1726022383.300397,-18000,,
com.apple.iCal,1,1726022311,1726022312,1726022312.6439152,-18000,,
com.leomehlig.today,109,1726022202,1726022311,1726022311.069704,-18000,,
com.apple.iCal,39,1726022163,1726022202,1726022202.771172,-18000,,
com.leomehlig.today,5,1726022158,1726022163,1726022163.526573,-18000,,
com.apple.camera,92,1726021900,1726021992,1726021997.737191,-18000,EB445137-D7F5-57EC-87DA-1DB460D64046,"iPhone13,2"
com.google.Chrome,1578,1726020580,1726022158,1726022158.1611881,-18000,,
com.apple.news,22,1726019490,1726019512,1726019512.560813,-18000,EB445137-D7F5-57EC-87DA-1DB460D64046,"iPhone13,2"
com.apple.news,335,1726018990,1726019325,1726019325.465489,-18000,EB445137-D7F5-57EC-87DA-1DB460D64046,"iPhone13,2"
com.apple.news,17,1726018615,1726018632,1726018632.733883,-18000,EB445137-D7F5-57EC-87DA-1DB460D64046,"iPhone13,2"
com.myfitnesspal.mfp,4,1726018611,1726018615,1726018616.158062,-18000,EB445137-D7F5-57EC-87DA-1DB460D64046,"iPhone13,2"
com.myfitnesspal.mfp,6,1726018580,1726018586,1726018586.2280998,-18000,EB445137-D7F5-57EC-87DA-1DB460D64046,"iPhone13,2"
com.apple.news,3,1726018574,1726018577,1726018577.980017,-18000,EB445137-D7F5-57EC-87DA-1DB460D64046,"iPhone13,2"
com.apple.news,13,1726018347,1726018360,1726018360.4413571,-18000,EB445137-D7F5-57EC-87DA-1DB460D64046,"iPhone13,2"
com.myfitnesspal.mfp,3,1726018344,1726018347,1726018348.634649,-18000,EB445137-D7F5-57EC-87DA-1DB460D64046,"iPhone13,2"
com.myfitnesspal.mfp,7,1726018192,1726018199,1726018200.309132,-18000,EB445137-D7F5-57EC-87DA-1DB460D64046,"iPhone13,2"
com.apple.news,3,1726018189,1726018192,1726018192.594149,-18000,EB445137-D7F5-57EC-87DA-1DB460D64046,"iPhone13,2"
com.apple.news,3,1726018181,1726018184,1726018184.471013,-18000,EB445137-D7F5-57EC-87DA-1DB460D64046,"iPhone13,2"
com.apple.news,24,1726017992,1726018016,1726018016.417004,-18000,EB445137-D7F5-57EC-87DA-1DB460D64046,"iPhone13,2"
com.apple.news,24,1726017706,1726017730,1726017730.3166718,-18000,EB445137-D7F5-57EC-87DA-1DB460D64046,"iPhone13,2"
com.apple.news,129,1726017232,1726017361,1726017361.911199,-18000,EB445137-D7F5-57EC-87DA-1DB460D64046,"iPhone13,2"
com.apple.news,124,1726016766,1726016890,1726016890.749605,-18000,EB445137-D7F5-57EC-87DA-1DB460D64046,"iPhone13,2"
com.apple.MobileSMS,2,1726016763,1726016765,1726016765.31177,-18000,EB445137-D7F5-57EC-87DA-1DB460D64046,"iPhone13,2"
com.google.Chrome,3896,1726016629,1726020525,1726020525.245939,-18000,,
com.apple.MobileSMS,2,1726016262,1726016264,1726016264.998977,-18000,EB445137-D7F5-57EC-87DA-1DB460D64046,"iPhone13,2"
com.myfitnesspal.mfp,13,1726016249,1726016262,1726016262.538104,-18000,EB445137-D7F5-57EC-87DA-1DB460D64046,"iPhone13,2"
com.google.Chrome,1145,1726015477,1726016622,1726016622.820726,-18000,,
com.microsoft.Word,61,1726015416,1726015477,1726015477.737694,-18000,,
com.google.Chrome,149,1726015267,1726015416,1726015416.5844378,-18000,,
com.leomehlig.today,1,1726015239,1726015240,1726015241.0130181,-18000,,
com.google.Chrome,1,1726015238,1726015239,1726015239.393663,-18000,,
com.microsoft.Outlook,8,1726015230,1726015238,1726015238.288374,-18000,,
com.google.Chrome,0,1726015230,1726015230,1726015230.9710069,-18000,,
com.microsoft.VSCode,2,1726015228,1726015230,1726015230.3808022,-18000,,
com.google.Chrome,0,1726015228,1726015228,1726015228.80937,-18000,,
com.apple.iCal,2,1726015226,1726015228,1726015228.187762,-18000,,
com.google.Chrome,4,1726015222,1726015226,1726015226.324613,-18000,,
com.apple.Preview,1,1726015221,1726015222,1726015222.485151,-18000,,
com.google.Chrome,45,1726015176,1726015221,1726015221.5743442,-18000,,
com.apple.Preview,2,1726015174,1726015176,1726015176.207786,-18000,,
com.google.Chrome,4,1726015170,1726015174,1726015174.240237,-18000,,
com.apple.Preview,4,1726015166,1726015170,1726015170.04041,-18000,,
com.google.Chrome,14,1726015152,1726015166,1726015166.769278,-18000,,
com.apple.Preview,10,1726015142,1726015152,1726015153.0267081,-18000,,
com.apple.finder,9,1726015133,1726015142,1726015142.835864,-18000,,
com.google.Chrome,35,1726015098,1726015133,1726015133.992677,-18000,,
com.myfitnesspal.mfp,73,1726014946,1726015019,1726015020.106741,-18000,EB445137-D7F5-57EC-87DA-1DB460D64046,"iPhone13,2"
com.toyopagroup.picaboo,3,1726014941,1726014944,1726014944.2575111,-18000,EB445137-D7F5-57EC-87DA-1DB460D64046,"iPhone13,2"
com.tinyspeck.chatlyio,4,1726014937,1726014941,1726014942.3333359,-18000,EB445137-D7F5-57EC-87DA-1DB460D64046,"iPhone13,2"
com.google.Chrome,4,1726013954,1726013958,1726013958.1464849,-18000,,
com.microsoft.VSCode,303,1726013651,1726013954,1726013954.510196,-18000,,
com.google.Chrome,42,1726013609,1726013651,1726013651.556003,-18000,,
com.tinyspeck.chatlyio,24,1726012406,1726012430,1726012430.752645,-18000,EB445137-D7F5-57EC-87DA-1DB460D64046,"iPhone13,2"
com.toyopagroup.picaboo,2,1726012402,1726012404,1726012405.811557,-18000,EB445137-D7F5-57EC-87DA-1DB460D64046,"iPhone13,2"
com.toyopagroup.picaboo,3,1726012268,1726012271,1726012271.5009031,-18000,EB445137-D7F5-57EC-87DA-1DB460D64046,"iPhone13,2"
com.google.Chrome,255,1726011358,1726011613,1726011613.9130058,-18000,,
com.apple.systempreferences,1,1726011352,1726011353,1726011353.881434,-18000,,
com.toyopagroup.picaboo,7,1726011202,1726011209,1726011209.366592,-18000,EB445137-D7F5-57EC-87DA-1DB460D64046,"iPhone13,2"
com.toyopagroup.picaboo,10,1726011162,1726011172,1726011172.46484,-18000,EB445137-D7F5-57EC-87DA-1DB460D64046,"iPhone13,2"
com.google.Chrome,198,1726011154,1726011352,1726011352.812505,-18000,,
com.leomehlig.today,1,1726011153,1726011154,1726011156.072912,-18000,,
com.google.chrome.ios,2,1726011144,1726011146,1726011146.6736832,-18000,EB445137-D7F5-57EC-87DA-1DB460D64046,"iPhone13,2"
com.apple.InCallService,42,1726011102,1726011144,1726011144.853746,-18000,EB445137-D7F5-57EC-87DA-1DB460D64046,"iPhone13,2"
com.google.chrome.ios,12,1726011090,1726011102,1726011102.8646889,-18000,EB445137-D7F5-57EC-87DA-1DB460D64046,"iPhone13,2"
com.apple.MobileSMS,2,1726011088,1726011090,1726011090.3825521,-18000,EB445137-D7F5-57EC-87DA-1DB460D64046,"iPhone13,2"
com.apple.InCallService,43,1726011045,1726011088,1726011088.807104,-18000,EB445137-D7F5-57EC-87DA-1DB460D64046,"iPhone13,2"
com.apple.MobileSMS,11,1726011034,1726011045,1726011046.1331038,-18000,EB445137-D7F5-57EC-87DA-1DB460D64046,"iPhone13,2"
com.google.ios.youtube,450,1726010393,1726010843,1726010843.862534,-18000,EB445137-D7F5-57EC-87DA-1DB460D64046,"iPhone13,2"
com.apple.MobileSMS,58,1726010333,1726010391,1726010391.095619,-18000,EB445137-D7F5-57EC-87DA-1DB460D64046,"iPhone13,2"
com.apple.MobileSMS,11,1726009778,1726009789,1726009789.731141,-18000,EB445137-D7F5-57EC-87DA-1DB460D64046,"iPhone13,2"
com.apple.MobileSMS,11,1726009752,1726009763,1726009763.211369,-18000,EB445137-D7F5-57EC-87DA-1DB460D64046,"iPhone13,2"
com.leomehlig.today,65,1726009610,1726009675,1726009675.424402,-18000,,
com.google.Chrome,591,1726009019,1726009610,1726009610.494518,-18000,,
com.microsoft.Outlook,101,1726008918,1726009019,1726009019.544261,-18000,,
com.google.Chrome,60,1726008858,1726008918,1726008918.6243439,-18000,,
com.apple.systempreferences,5,1726008845,1726008850,1726008850.158177,-18000,,
com.google.Chrome,9,1726008834,1726008843,1726008843.532922,-18000,,
com.apple.Preview,2,1726008800,1726008802,1726008802.3599238,-18000,,
com.leomehlig.today,10,1726008790,1726008800,1726008800.540806,-18000,,
com.apple.finder,21,1726008769,1726008790,1726008790.818577,-18000,,
com.leomehlig.today,72,1726008697,1726008769,1726008769.297476,-18000,,
com.google.Chrome,43,1726008654,1726008697,1726008697.5467849,-18000,,
com.apple.iCal,32,1726008622,1726008654,1726008654.155591,-18000,,
com.google.Chrome,1,1726008621,1726008622,1726008622.4021258,-18000,,
com.apple.iCal,9,1726008612,1726008621,1726008621.094487,-18000,,
com.google.Chrome,1,1726008611,1726008612,1726008612.912916,-18000,,
com.apple.iCal,13,1726008598,1726008611,1726008611.746757,-18000,,
com.google.Chrome,4,1726008594,1726008598,1726008598.1621928,-18000,,
com.apple.iCal,1,1726008593,1726008594,1726008594.708422,-18000,,
com.google.Chrome,2,1726008591,1726008593,1726008593.47016,-18000,,
com.apple.iCal,2,1726008589,1726008591,1726008591.789875,-18000,,
com.google.Chrome,1,1726008588,1726008589,1726008589.614081,-18000,,
com.apple.iCal,7,1726008581,1726008588,1726008588.4510841,-18000,,
com.google.Chrome,1,1726008580,1726008581,1726008581.83775,-18000,,
com.apple.iCal,0,1726008580,1726008580,1726008580.4240332,-18000,,
com.google.Chrome,1,1726008579,1726008580,1726008580.10176,-18000,,
com.leomehlig.today,1,1726008578,1726008579,1726008579.136431,-18000,,
com.apple.iCal,4,1726008574,1726008578,1726008578.1188102,-18000,,
com.leomehlig.today,2,1726008572,1726008574,1726008574.418983,-18000,,
com.google.Chrome,17,1726008555,1726008572,1726008572.543326,-18000,,
com.leomehlig.today,46,1726008509,1726008555,1726008555.480659,-18000,,
com.apple.iCal,19,1726008490,1726008509,1726008509.314063,-18000,,
com.leomehlig.today,2,1726008488,1726008490,1726008490.384163,-18000,,
com.google.Chrome,9,1726008479,1726008488,1726008488.32097,-18000,,
com.leomehlig.today,5,1726008474,1726008479,1726008479.084528,-18000,,
com.google.Chrome,16,1726008458,1726008474,1726008474.850038,-18000,,
com.leomehlig.today,31,1726008427,1726008458,1726008458.5676441,-18000,,
com.apple.finder,44,1726008383,1726008427,1726008427.2419329,-18000,,
com.google.Chrome,9,1726008374,1726008383,1726008383.338663,-18000,,
com.apple.MobileSMS,24,1726008160,1726008184,1726008184.327209,-18000,EB445137-D7F5-57EC-87DA-1DB460D64046,"iPhone13,2"
com.apple.mobilecal,26,1726008132,1726008158,1726008158.3293571,-18000,EB445137-D7F5-57EC-87DA-1DB460D64046,"iPhone13,2"
com.apple.MobileSMS,19,1726008107,1726008126,1726008126.13356,-18000,EB445137-D7F5-57EC-87DA-1DB460D64046,"iPhone13,2"
com.microsoft.Office.Outlook,10,1726008073,1726008083,1726008083.205944,-18000,EB445137-D7F5-57EC-87DA-1DB460D64046,"iPhone13,2"
com.apple.MobileSMS,13,1726008058,1726008071,1726008071.9573522,-18000,EB445137-D7F5-57EC-87DA-1DB460D64046,"iPhone13,2"
com.apple.mobilecal,10,1726008048,1726008058,1726008058.1354198,-18000,EB445137-D7F5-57EC-87DA-1DB460D64046,"iPhone13,2"
com.apple.Music,5,1726008040,1726008045,1726008045.499354,-18000,EB445137-D7F5-57EC-87DA-1DB460D64046,"iPhone13,2"
com.apple.Music,3,1726006964,1726006967,1726006967.826448,-18000,EB445137-D7F5-57EC-87DA-1DB460D64046,"iPhone13,2"
com.apple.Music,17,1726006946,1726006963,1726006964.574327,-18000,EB445137-D7F5-57EC-87DA-1DB460D64046,"iPhone13,2"
com.apple.news,13,1726006931,1726006944,1726006944.8642,-18000,EB445137-D7F5-57EC-87DA-1DB460D64046,"iPhone13,2"
com.apple.news,84,1726005766,1726005850,1726005850.832463,-18000,EB445137-D7F5-57EC-87DA-1DB460D64046,"iPhone13,2"
com.apple.MobileSMS,26,1726005676,1726005702,1726005702.473906,-18000,EB445137-D7F5-57EC-87DA-1DB460D64046,"iPhone13,2"
com.apple.MobileSMS,34,1726005591,1726005625,1726005625.642086,-18000,EB445137-D7F5-57EC-87DA-1DB460D64046,"iPhone13,2"
com.apple.findmy,7,1726005427,1726005434,1726005435.642329,-18000,EB445137-D7F5-57EC-87DA-1DB460D64046,"iPhone13,2"
com.apple.MobileSMS,3,1726005424,1726005427,1726005427.801762,-18000,EB445137-D7F5-57EC-87DA-1DB460D64046,"iPhone13,2"
com.apple.MobileSMS,1,1726005422,1726005423,1726005423.9435182,-18000,EB445137-D7F5-57EC-87DA-1DB460D64046,"iPhone13,2"
com.apple.MobileSMS,7,1726005415,1726005422,1726005422.208346,-18000,EB445137-D7F5-57EC-87DA-1DB460D64046,"iPhone13,2"
com.apple.MobileSMS,1,1726005398,1726005399,1726005399.597616,-18000,EB445137-D7F5-57EC-87DA-1DB460D64046,"iPhone13,2"
com.apple.MobileSMS,19,1726005374,1726005393,1726005393.409065,-18000,EB445137-D7F5-57EC-87DA-1DB460D64046,"iPhone13,2"
com.google.chrome.ios,21,1726005353,1726005374,1726005374.4113278,-18000,EB445137-D7F5-57EC-87DA-1DB460D64046,"iPhone13,2"
com.google.chrome.ios,4,1726005093,1726005097,1726005097.7280989,-18000,EB445137-D7F5-57EC-87DA-1DB460D64046,"iPhone13,2"
com.google.chrome.ios,100,1726004969,1726005069,1726005069.403512,-18000,EB445137-D7F5-57EC-87DA-1DB460D64046,"iPhone13,2"
com.toyopagroup.picaboo,9,1726004954,1726004963,1726004963.8873081,-18000,EB445137-D7F5-57EC-87DA-1DB460D64046,"iPhone13,2"
com.apple.camera,1,1726004801,1726004802,1726004802.4127002,-18000,EB445137-D7F5-57EC-87DA-1DB460D64046,"iPhone13,2"
com.toyopagroup.picaboo,8,1726004800,1726004808,1726004808.3887339,-18000,EB445137-D7F5-57EC-87DA-1DB460D64046,"iPhone13,2"
com.toyopagroup.picaboo,22,1726004694,1726004716,1726004717.030171,-18000,EB445137-D7F5-57EC-87DA-1DB460D64046,"iPhone13,2"
com.apple.camera,2,1726004688,1726004690,1726004691.470864,-18000,EB445137-D7F5-57EC-87DA-1DB460D64046,"iPhone13,2"
com.instructure.icanvas,11,1726003853,1726003864,1726003864.838499,-18000,EB445137-D7F5-57EC-87DA-1DB460D64046,"iPhone13,2"
com.apple.MobileSMS,9,1726003844,1726003853,1726003854.054692,-18000,EB445137-D7F5-57EC-87DA-1DB460D64046,"iPhone13,2"
com.google.Chrome,2408,1726002398,1726004806,1726004806.74683,-18000,,
com.apple.MobileSMS,11,1726001835,1726001846,1726001846.305054,-18000,EB445137-D7F5-57EC-87DA-1DB460D64046,"iPhone13,2"
com.google.chrome.ios,67,1726001768,1726001835,1726001835.289455,-18000,EB445137-D7F5-57EC-87DA-1DB460D64046,"iPhone13,2"
com.apple.MobileSMS,4,1726001764,1726001768,1726001768.4747648,-18000,EB445137-D7F5-57EC-87DA-1DB460D64046,"iPhone13,2"
com.apple.MobileSMS,1,1726001740,1726001741,1726001741.711259,-18000,EB445137-D7F5-57EC-87DA-1DB460D64046,"iPhone13,2"
com.google.chrome.ios,2,1726001738,1726001740,1726001740.8297238,-18000,EB445137-D7F5-57EC-87DA-1DB460D64046,"iPhone13,2"
com.google.chrome.ios,80,1726001370,1726001450,1726001450.312916,-18000,EB445137-D7F5-57EC-87DA-1DB460D64046,"iPhone13,2"
com.apple.MobileSMS,2,1726001368,1726001370,1726001370.692854,-18000,EB445137-D7F5-57EC-87DA-1DB460D64046,"iPhone13,2"
com.apple.MobileSMS,24,1726001195,1726001219,1726001219.194814,-18000,EB445137-D7F5-57EC-87DA-1DB460D64046,"iPhone13,2"
com.apple.MobileSMS,172,1726000934,1726001106,1726001106.852844,-18000,EB445137-D7F5-57EC-87DA-1DB460D64046,"iPhone13,2"
com.apple.MobileSMS,99,1726000747,1726000846,1726000846.099797,-18000,EB445137-D7F5-57EC-87DA-1DB460D64046,"iPhone13,2"
com.apple.MobileSMS,12,1726000724,1726000736,1726000736.170477,-18000,EB445137-D7F5-57EC-87DA-1DB460D64046,"iPhone13,2"
com.apple.MobileSMS,8,1726000587,1726000595,1726000595.00791,-18000,EB445137-D7F5-57EC-87DA-1DB460D64046,"iPhone13,2"
com.google.Chrome,1877,1726000519,1726002396,1726002396.260062,-18000,,
com.apple.MobileSMS,63,1726000509,1726000572,1726000572.820005,-18000,EB445137-D7F5-57EC-87DA-1DB460D64046,"iPhone13,2"
com.apple.MobileSMS,6,1726000452,1726000458,1726000458.036969,-18000,EB445137-D7F5-57EC-87DA-1DB460D64046,"iPhone13,2"
com.apple.finder,9,1726000423,1726000432,1726000432.903502,-18000,,
com.apple.Preview,10,1726000413,1726000423,1726000423.065948,-18000,,
com.google.Chrome,11,1726000385,1726000396,1726000396.558322,-18000,,
com.apple.Preview,29,1726000356,1726000385,1726000385.13243,-18000,,
com.apple.finder,13,1726000343,1726000356,1726000356.765792,-18000,,
com.apple.MobileSMS,35,1726000304,1726000339,1726000340.050294,-18000,EB445137-D7F5-57EC-87DA-1DB460D64046,"iPhone13,2"
com.google.chrome.ios,2,1726000302,1726000304,1726000304.696008,-18000,EB445137-D7F5-57EC-87DA-1DB460D64046,"iPhone13,2"
com.google.Chrome,275,1726000068,1726000343,1726000343.356004,-18000,,
com.google.chrome.ios,6,1726000031,1726000037,1726000037.670788,-18000,EB445137-D7F5-57EC-87DA-1DB460D64046,"iPhone13,2"
com.google.chrome.ios,86,1725999938,1726000024,1726000024.57232,-18000,EB445137-D7F5-57EC-87DA-1DB460D64046,"iPhone13,2"
com.apple.MobileSMS,31,1725999897,1725999928,1725999928.565103,-18000,EB445137-D7F5-57EC-87DA-1DB460D64046,"iPhone13,2"
com.myfitnesspal.mfp,25,1725999871,1725999896,1725999896.4470758,-18000,EB445137-D7F5-57EC-87DA-1DB460D64046,"iPhone13,2"
com.google.chrome.ios,64,1725999795,1725999859,1725999859.243819,-18000,EB445137-D7F5-57EC-87DA-1DB460D64046,"iPhone13,2"
com.apple.MobileSMS,28,1725999767,1725999795,1725999795.950283,-18000,EB445137-D7F5-57EC-87DA-1DB460D64046,"iPhone13,2"
com.hammerandchisel.discord,13,1725999753,1725999766,1725999766.919311,-18000,EB445137-D7F5-57EC-87DA-1DB460D64046,"iPhone13,2"
com.instructure.icanvas,18,1725999734,1725999752,1725999752.5909,-18000,EB445137-D7F5-57EC-87DA-1DB460D64046,"iPhone13,2"
com.instructure.icanvas,37,1725999662,1725999699,1725999699.1750321,-18000,EB445137-D7F5-57EC-87DA-1DB460D64046,"iPhone13,2"
com.microsoft.Office.Outlook,10,1725999645,1725999655,1725999655.464639,-18000,EB445137-D7F5-57EC-87DA-1DB460D64046,"iPhone13,2"
com.apple.MobileSMS,88,1725999557,1725999645,1725999645.645969,-18000,EB445137-D7F5-57EC-87DA-1DB460D64046,"iPhone13,2"
com.google.chrome.ios,12,1725999545,1725999557,1725999557.898364,-18000,EB445137-D7F5-57EC-87DA-1DB460D64046,"iPhone13,2"
com.apple.MobileSMS,23,1725999522,1725999545,1725999545.398042,-18000,EB445137-D7F5-57EC-87DA-1DB460D64046,"iPhone13,2"
com.apple.mobilephone,2,1725999520,1725999522,1725999523.539578,-18000,EB445137-D7F5-57EC-87DA-1DB460D64046,"iPhone13,2"
com.apple.InCallService,1,1725999519,1725999520,1725999520.661419,-18000,EB445137-D7F5-57EC-87DA-1DB460D64046,"iPhone13,2"
com.apple.InCallService,5,1725998605,1725998610,1725998610.4763842,-18000,EB445137-D7F5-57EC-87DA-1DB460D64046,"iPhone13,2"
com.apple.mobilephone,4,1725998601,1725998605,1725998605.480136,-18000,EB445137-D7F5-57EC-87DA-1DB460D64046,"iPhone13,2"
com.apple.mobilephone,15,1725998573,1725998588,1725998588.813134,-18000,EB445137-D7F5-57EC-87DA-1DB460D64046,"iPhone13,2"
com.apple.findmy,3,1725998570,1725998573,1725998573.413255,-18000,EB445137-D7F5-57EC-87DA-1DB460D64046,"iPhone13,2"
com.apple.findmy,1,1725998520,1725998521,1725998521.94152,-18000,EB445137-D7F5-57EC-87DA-1DB460D64046,"iPhone13,2"
com.apple.findmy,3,1725998498,1725998501,1725998501.1906362,-18000,EB445137-D7F5-57EC-87DA-1DB460D64046,"iPhone13,2"
com.apple.findmy,2,1725998495,1725998497,1725998497.971473,-18000,EB445137-D7F5-57EC-87DA-1DB460D64046,"iPhone13,2"
com.google.Chrome,3,1725998425,1725998428,1725998428.39598,-18000,,
com.apple.finder,2,1725998423,1725998425,1725998425.563909,-18000,,
com.microsoft.Outlook,1,1725998422,1725998423,1725998423.543745,-18000,,
com.microsoft.VSCode,8,1725998414,1725998422,1725998422.527123,-18000,,
com.google.Chrome,12,1725998402,1725998414,1725998414.416346,-18000,,
com.leomehlig.today,15,1725998387,1725998402,1725998402.9587579,-18000,,
com.apple.findmy,7,1725998378,1725998385,1725998385.964911,-18000,EB445137-D7F5-57EC-87DA-1DB460D64046,"iPhone13,2"
com.apple.MobileSMS,4,1725998371,1725998375,1725998375.6183062,-18000,EB445137-D7F5-57EC-87DA-1DB460D64046,"iPhone13,2"
com.leomehlig.today,302,1725998056,1725998358,1725998359.351242,-18000,,
com.apple.iCal,24,1725998032,1725998056,1725998056.371386,-18000,,
com.leomehlig.today,14,1725998018,1725998032,1725998033.016496,-18000,,
com.google.Chrome,6,1725998012,1725998018,1725998018.449712,-18000,,
com.google.Chrome,0,1725998004,1725998004,1725998004.490447,-18000,,
com.apple.MobileSMS,87,1725997913,1725998000,1725998000.473064,-18000,EB445137-D7F5-57EC-87DA-1DB460D64046,"iPhone13,2"
com.apple.Music,2,1725997911,1725997913,1725997914.281698,-18000,EB445137-D7F5-57EC-87DA-1DB460D64046,"iPhone13,2"
com.google.Chrome,333,1725997329,1725997662,1725997662.425737,-18000,,
com.google.Chrome,358,1725996516,1725996874,1725996874.75427,-18000,,
com.leomehlig.today,7,1725996509,1725996516,1725996517.091881,-18000,,
com.apple.Music,13,1725996258,1725996271,1725996271.650237,-18000,EB445137-D7F5-57EC-87DA-1DB460D64046,"iPhone13,2"
com.apple.Music,2,1725995790,1725995792,1725995792.868485,-18000,EB445137-D7F5-57EC-87DA-1DB460D64046,"iPhone13,2"
com.apple.Music,7,1725995353,1725995360,1725995360.13772,-18000,EB445137-D7F5-57EC-87DA-1DB460D64046,"iPhone13,2"
com.apple.MobileSMS,7,1725995344,1725995351,1725995351.385447,-18000,EB445137-D7F5-57EC-87DA-1DB460D64046,"iPhone13,2"
com.apple.MobileSMS,3,1725995251,1725995254,1725995254.1800709,-18000,EB445137-D7F5-57EC-87DA-1DB460D64046,"iPhone13,2"
com.apple.MobileSMS,6,1725995218,1725995224,1725995224.913528,-18000,EB445137-D7F5-57EC-87DA-1DB460D64046,"iPhone13,2"
com.apple.MobileSMS,6,1725995057,1725995063,1725995063.9384341,-18000,EB445137-D7F5-57EC-87DA-1DB460D64046,"iPhone13,2"
com.apple.MobileSMS,24,1725994924,1725994948,1725994948.397515,-18000,EB445137-D7F5-57EC-87DA-1DB460D64046,"iPhone13,2"
com.microsoft.Office.Outlook,68,1725994265,1725994333,1725994333.986758,-18000,EB445137-D7F5-57EC-87DA-1DB460D64046,"iPhone13,2"
com.apple.mobilecal,10,1725994254,1725994264,1725994264.202851,-18000,EB445137-D7F5-57EC-87DA-1DB460D64046,"iPhone13,2"
com.apple.Maps,5,1725994237,1725994242,1725994243.134068,-18000,EB445137-D7F5-57EC-87DA-1DB460D64046,"iPhone13,2"
com.apple.Maps,7,1725993996,1725994003,1725994003.803231,-18000,EB445137-D7F5-57EC-87DA-1DB460D64046,"iPhone13,2"
com.apple.Maps,2,1725993715,1725993717,1725993717.811428,-18000,EB445137-D7F5-57EC-87DA-1DB460D64046,"iPhone13,2"
com.apple.Maps,370,1725993302,1725993672,1725993672.376806,-18000,EB445137-D7F5-57EC-87DA-1DB460D64046,"iPhone13,2"
com.instructure.icanvas,38,1725990400,1725990438,1725990439.030761,-18000,EB445137-D7F5-57EC-87DA-1DB460D64046,"iPhone13,2"
com.leomehlig.today,387,1725990285,1725990672,1725990672.378745,-18000,,
com.google.Chrome,112,1725990173,1725990285,1725990286.0805821,-18000,,
com.apple.iCal,4,1725989360,1725989364,1725989364.284721,-18000,,
com.google.Chrome,31,1725989329,1725989360,1725989360.347435,-18000,,
com.apple.iCal,8,1725989321,1725989329,1725989329.934391,-18000,,
com.google.Chrome,2,1725989313,1725989315,1725989315.996408,-18000,,
com.hammerandchisel.discord,148,1725988705,1725988853,1725988853.795094,-18000,EB445137-D7F5-57EC-87DA-1DB460D64046,"iPhone13,2"
com.myfitnesspal.mfp,6,1725988699,1725988705,1725988705.999792,-18000,EB445137-D7F5-57EC-87DA-1DB460D64046,"iPhone13,2"
com.google.Chrome,351,1725988518,1725988869,1725988869.715026,-18000,,
com.apple.iCal,17,1725988501,1725988518,1725988518.4584389,-18000,,
com.google.Chrome,4,1725988497,1725988501,1725988501.676157,-18000,,
com.myfitnesspal.mfp,63,1725987980,1725988043,1725988043.947217,-18000,EB445137-D7F5-57EC-87DA-1DB460D64046,"iPhone13,2"
com.apple.mobilephone,8,1725987971,1725987979,1725987979.541401,-18000,EB445137-D7F5-57EC-87DA-1DB460D64046,"iPhone13,2"
com.apple.mobilephone,3,1725987750,1725987753,1725987753.5107222,-18000,EB445137-D7F5-57EC-87DA-1DB460D64046,"iPhone13,2"
com.apple.mobilephone,2,1725987634,1725987636,1725987636.239639,-18000,EB445137-D7F5-57EC-87DA-1DB460D64046,"iPhone13,2"
com.apple.InCallService,1,1725987633,1725987634,1725987634.807529,-18000,EB445137-D7F5-57EC-87DA-1DB460D64046,"iPhone13,2"
com.apple.InCallService,2,1725987418,1725987420,1725987420.58044,-18000,EB445137-D7F5-57EC-87DA-1DB460D64046,"iPhone13,2"
com.apple.mobilephone,3,1725987415,1725987418,1725987419.259911,-18000,EB445137-D7F5-57EC-87DA-1DB460D64046,"iPhone13,2"
com.apple.mobilephone,2,1725987411,1725987413,1725987413.9930959,-18000,EB445137-D7F5-57EC-87DA-1DB460D64046,"iPhone13,2"
com.apple.mobilephone,4,1725987390,1725987394,1725987394.5686479,-18000,EB445137-D7F5-57EC-87DA-1DB460D64046,"iPhone13,2"
com.apple.InCallService,1,1725987389,1725987390,1725987390.5526729,-18000,EB445137-D7F5-57EC-87DA-1DB460D64046,"iPhone13,2"
com.apple.InCallService,3,1725987185,1725987188,1725987188.969238,-18000,EB445137-D7F5-57EC-87DA-1DB460D64046,"iPhone13,2"
com.apple.InCallService,3,1725987174,1725987177,1725987177.2792702,-18000,EB445137-D7F5-57EC-87DA-1DB460D64046,"iPhone13,2"
com.apple.mobilephone,38,1725987136,1725987174,1725987175.083595,-18000,EB445137-D7F5-57EC-87DA-1DB460D64046,"iPhone13,2"
com.apple.mobilecal,13,1725987122,1725987135,1725987136.075391,-18000,EB445137-D7F5-57EC-87DA-1DB460D64046,"iPhone13,2"
com.apple.MobileSMS,11,1725987077,1725987088,1725987088.8985739,-18000,EB445137-D7F5-57EC-87DA-1DB460D64046,"iPhone13,2"
com.apple.mobilecal,2,1725987075,1725987077,1725987077.946764,-18000,EB445137-D7F5-57EC-87DA-1DB460D64046,"iPhone13,2"
com.apple.mobilecal,13,1725987053,1725987066,1725987066.040794,-18000,EB445137-D7F5-57EC-87DA-1DB460D64046,"iPhone13,2"
com.intsig.CamScannerLite,99,1725984165,1725984264,1725984264.950881,-18000,EB445137-D7F5-57EC-87DA-1DB460D64046,"iPhone13,2"
com.microsoft.Office.Outlook,3,1725984161,1725984164,1725984164.8323522,-18000,EB445137-D7F5-57EC-87DA-1DB460D64046,"iPhone13,2"
com.google.Chrome,2893,1725984080,1725986973,1725986973.454533,-18000,,
com.microsoft.Outlook,0,1725984080,1725984080,1725984080.910369,-18000,,
com.apple.iCal,2,1725984078,1725984080,1725984080.05482,-18000,,
com.microsoft.Outlook,1,1725984077,1725984078,1725984078.670347,-18000,,
com.google.Chrome,12,1725984065,1725984077,1725984077.263658,-18000,,
com.microsoft.Outlook,18,1725984047,1725984065,1725984065.893291,-18000,,
com.apple.iCal,4,1725984043,1725984047,1725984047.436934,-18000,,
com.microsoft.Outlook,2,1725984041,1725984043,1725984043.730515,-18000,,
com.apple.iCal,7,1725984034,1725984041,1725984041.782555,-18000,,
com.microsoft.Outlook,4,1725984030,1725984034,1725984034.881,-18000,,
com.apple.iCal,12,1725984018,1725984030,1725984030.948586,-18000,,
com.microsoft.Outlook,10,1725984008,1725984018,1725984018.504222,-18000,,
com.google.Chrome,4,1725984004,1725984008,1725984008.955065,-18000,,
com.apple.iCal,10,1725983994,1725984004,1725984004.894732,-18000,,
com.google.Chrome,23,1725983971,1725983994,1725983994.878457,-18000,,
com.microsoft.Outlook,6,1725983965,1725983971,1725983971.98911,-18000,,
com.google.Chrome,64,1725983901,1725983965,1725983965.396381,-18000,,
com.microsoft.Outlook,20,1725983881,1725983901,1725983901.632416,-18000,,
com.google.Chrome,16,1725983865,1725983881,1725983881.235318,-18000,,
com.microsoft.Office.Outlook,6,1725983852,1725983858,1725983858.0676231,-18000,EB445137-D7F5-57EC-87DA-1DB460D64046,"iPhone13,2"
com.microsoft.Outlook,25,1725983840,1725983865,1725983865.368319,-18000,,
com.microsoft.Office.Outlook,14,1725983826,1725983840,1725983840.729517,-18000,EB445137-D7F5-57EC-87DA-1DB460D64046,"iPhone13,2"
com.intsig.CamScannerLite,8,1725983798,1725983806,1725983806.910707,-18000,EB445137-D7F5-57EC-87DA-1DB460D64046,"iPhone13,2"
com.google.Chrome,69,1725983771,1725983840,1725983840.431991,-18000,,
com.microsoft.VSCode,3,1725983768,1725983771,1725983771.249765,-18000,,
com.microsoft.VSCode,1044,1725982220,1725983264,1725983264.317751,-18000,,
com.apple.finder,21,1725982199,1725982220,1725982220.8523479,-18000,,
com.google.Chrome,10,1725982189,1725982199,1725982200.020849,-18000,,
com.apple.finder,3,1725982186,1725982189,1725982189.598587,-18000,,
com.microsoft.VSCode,36,1725982150,1725982186,1725982186.888668,-18000,,
com.apple.finder,13,1725982137,1725982150,1725982150.99195,-18000,,
com.google.Chrome,1,1725982136,1725982137,1725982137.46157,-18000,,
com.apple.finder,2,1725982134,1725982136,1725982136.265655,-18000,,
com.microsoft.Word,5,1725982129,1725982134,1725982135.0652142,-18000,,
com.apple.finder,10,1725982119,1725982129,1725982129.371094,-18000,,
com.google.Chrome,13,1725982106,1725982119,1725982119.485064,-18000,,
com.apple.finder,54,1725982052,1725982106,1725982107.014241,-18000,,
com.google.Chrome,270,1725981782,1725982052,1725982052.8627748,-18000,,
com.apple.Notes,1,1725981781,1725981782,1725981782.989666,-18000,,
com.google.Chrome,6,1725981775,1725981781,1725981781.5711188,-18000,,
com.apple.Notes,2,1725981773,1725981775,1725981775.4004312,-18000,,
com.google.Chrome,25,1725981748,1725981773,1725981774.017243,-18000,,
com.apple.Notes,2,1725981746,1725981748,1725981748.326772,-18000,,
com.google.Chrome,20,1725981726,1725981746,1725981746.977437,-18000,,
com.apple.Notes,3,1725981723,1725981726,1725981726.7847729,-18000,,
com.apple.Terminal,2,1725981721,1725981723,1725981723.735774,-18000,,
com.google.Chrome,5,1725981716,1725981721,1725981721.814447,-18000,,
com.apple.Terminal,25,1725981691,1725981716,1725981716.7124848,-18000,,
com.google.Chrome,3,1725981688,1725981691,1725981691.734037,-18000,,
com.apple.Terminal,34,1725981654,1725981688,1725981688.228393,-18000,,
com.google.Chrome,10,1725981644,1725981654,1725981654.228755,-18000,,
com.apple.Terminal,1,1725981643,1725981644,1725981644.961362,-18000,,
com.google.Chrome,74,1725981569,1725981643,1725981643.65797,-18000,,
com.apple.Notes,7,1725981562,1725981569,1725981569.220828,-18000,,
com.google.Chrome,1,1725981561,1725981562,1725981562.6126552,-18000,,
com.apple.Notes,3,1725981558,1725981561,1725981561.260699,-18000,,
com.google.Chrome,68,1725981490,1725981558,1725981558.8409638,-18000,,
com.apple.Notes,5,1725981485,1725981490,1725981490.056713,-18000,,
com.google.Chrome,12,1725981473,1725981485,1725981485.912755,-18000,,
com.apple.Notes,12,1725981461,1725981473,1725981473.188029,-18000,,
com.google.Chrome,1,1725981460,1725981461,1725981462.040704,-18000,,
com.apple.Notes,7,1725981453,1725981460,1725981460.255521,-18000,,
com.google.Chrome,61,1725981392,1725981453,1725981453.674707,-18000,,
com.microsoft.VSCode,73,1725981319,1725981392,1725981392.530786,-18000,,
com.apple.finder,59,1725981260,1725981319,1725981319.193777,-18000,,
com.microsoft.VSCode,150,1725981110,1725981260,1725981260.9641418,-18000,,
com.apple.finder,8,1725981102,1725981110,1725981110.50464,-18000,,
com.google.Chrome,82,1725981020,1725981102,1725981103.011431,-18000,,
com.apple.finder,4,1725981016,1725981020,1725981020.683957,-18000,,
com.google.Chrome,12,1725981004,1725981016,1725981016.918808,-18000,,
com.apple.Preview,3,1725981001,1725981004,1725981004.0446029,-18000,,
com.google.Chrome,0,1725981001,1725981001,1725981001.73919,-18000,,
com.apple.Preview,12,1725980989,1725981001,1725981001.433619,-18000,,
com.google.Chrome,1,1725980988,1725980989,1725980989.2919931,-18000,,
com.apple.Preview,1,1725980987,1725980988,1725980988.571175,-18000,,
com.google.Chrome,1,1725980986,1725980987,1725980987.604302,-18000,,
com.apple.Preview,1,1725980985,1725980986,1725980986.853983,-18000,,
com.google.Chrome,2,1725980983,1725980985,1725980985.698611,-18000,,
com.apple.Preview,1,1725980982,1725980983,1725980983.877166,-18000,,
com.google.Chrome,28,1725980954,1725980982,1725980982.569861,-18000,,
com.apple.Preview,11,1725980943,1725980954,1725980954.4790301,-18000,,
com.apple.finder,10,1725980933,1725980943,1725980943.7644749,-18000,,
com.microsoft.VSCode,33,1725980900,1725980933,1725980934.03214,-18000,,
com.google.Chrome,11,1725980889,1725980900,1725980900.786154,-18000,,
com.microsoft.VSCode,54,1725980835,1725980889,1725980889.76964,-18000,,
com.google.Chrome,6,1725980829,1725980835,1725980835.063243,-18000,,
com.microsoft.VSCode,50,1725980779,1725980829,1725980829.204865,-18000,,
com.google.Chrome,7,1725980772,1725980779,1725980779.254822,-18000,,
com.microsoft.VSCode,1,1725980771,1725980772,1725980772.983982,-18000,,
com.google.Chrome,1,1725980770,1725980771,1725980771.942957,-18000,,
com.microsoft.VSCode,155,1725980615,1725980770,1725980770.381505,-18000,,
com.google.Chrome,11,1725980604,1725980615,1725980615.8536859,-18000,,
com.microsoft.VSCode,6,1725980598,1725980604,1725980604.942854,-18000,,
com.google.Chrome,2,1725980596,1725980598,1725980598.54703,-18000,,
com.microsoft.VSCode,353,1725980243,1725980596,1725980596.978848,-18000,,
com.google.Chrome,4,1725980239,1725980243,1725980243.304322,-18000,,
com.microsoft.VSCode,14,1725980225,1725980239,1725980239.730648,-18000,,
com.google.Chrome,1,1725980224,1725980225,1725980225.838789,-18000,,
com.microsoft.VSCode,2,1725980222,1725980224,1725980224.326565,-18000,,
com.google.Chrome,12,1725980210,1725980222,1725980222.763293,-18000,,
com.microsoft.VSCode,151,1725980059,1725980210,1725980210.188976,-18000,,
com.apple.Dictionary,2,1725980057,1725980059,1725980059.451535,-18000,,
com.microsoft.VSCode,880,1725979177,1725980057,1725980057.3070722,-18000,,
com.apple.finder,28,1725979149,1725979177,1725979177.338265,-18000,,
com.google.Chrome,164,1725978985,1725979149,1725979149.101393,-18000,,
com.google.Chrome,346,1725978637,1725978983,1725978983.939999,-18000,,
com.leomehlig.today,3,1725978611,1725978614,1725978616.2119222,-18000,,
com.apple.news,4,1725977837,1725977841,1725977842.100111,-18000,EB445137-D7F5-57EC-87DA-1DB460D64046,"iPhone13,2"
com.apple.news,155,1725977430,1725977585,1725977585.800776,-18000,EB445137-D7F5-57EC-87DA-1DB460D64046,"iPhone13,2"
com.hammerandchisel.discord,44,1725977378,1725977422,1725977422.943349,-18000,EB445137-D7F5-57EC-87DA-1DB460D64046,"iPhone13,2"
com.myfitnesspal.mfp,10,1725977361,1725977371,1725977371.591393,-18000,EB445137-D7F5-57EC-87DA-1DB460D64046,"iPhone13,2"
com.myfitnesspal.mfp,29,1725977332,1725977361,1725977361.71646,-18000,EB445137-D7F5-57EC-87DA-1DB460D64046,"iPhone13,2"
com.apple.weather,11,1725977319,1725977330,1725977330.704132,-18000,EB445137-D7F5-57EC-87DA-1DB460D64046,"iPhone13,2"
com.apple.weather,74,1725976732,1725976806,1725976806.350562,-18000,EB445137-D7F5-57EC-87DA-1DB460D64046,"iPhone13,2"
com.renpho.health,30,1725976659,1725976689,1725976689.055811,-18000,EB445137-D7F5-57EC-87DA-1DB460D64046,"iPhone13,2"
com.microsoft.Office.Outlook,46,1725975128,1725975174,1725975175.167248,-18000,EB445137-D7F5-57EC-87DA-1DB460D64046,"iPhone13,2"
com.apple.news,135,1725941129,1725941264,1725941264.256369,-18000,EB445137-D7F5-57EC-87DA-1DB460D64046,"iPhone13,2"
com.apple.mobiletimer,1,1725941106,1725941107,1725941107.354289,-18000,EB445137-D7F5-57EC-87DA-1DB460D64046,"iPhone13,2"
com.apple.mobiletimer,9,1725941097,1725941106,1725941106.538096,-18000,EB445137-D7F5-57EC-87DA-1DB460D64046,"iPhone13,2"
com.apple.journal,1098,1725939972,1725941070,1725941070.190388,-18000,EB445137-D7F5-57EC-87DA-1DB460D64046,"iPhone13,2"
com.apple.Health,71,1725939899,1725939970,1725939970.2653189,-18000,EB445137-D7F5-57EC-87DA-1DB460D64046,"iPhone13,2"
com.thestorygraph.thestorygraph,3,1725939896,1725939899,1725939899.4264789,-18000,EB445137-D7F5-57EC-87DA-1DB460D64046,"iPhone13,2"
com.thestorygraph.thestorygraph,26,1725939855,1725939881,1725939881.3028622,-18000,EB445137-D7F5-57EC-87DA-1DB460D64046,"iPhone13,2"
com.goodreads.Goodreads,42,1725939156,1725939198,1725939198.63412,-18000,EB445137-D7F5-57EC-87DA-1DB460D64046,"iPhone13,2"
com.thestorygraph.thestorygraph,81,1725939074,1725939155,1725939156.0493731,-18000,EB445137-D7F5-57EC-87DA-1DB460D64046,"iPhone13,2"
com.apple.mobilecal,20,1725937921,1725937941,1725937941.1682749,-18000,EB445137-D7F5-57EC-87DA-1DB460D64046,"iPhone13,2"
com.apple.weather,22,1725937898,1725937920,1725937920.109824,-18000,EB445137-D7F5-57EC-87DA-1DB460D64046,"iPhone13,2"
com.apple.mobilecal,40,1725937853,1725937893,1725937893.6189818,-18000,EB445137-D7F5-57EC-87DA-1DB460D64046,"iPhone13,2"
com.apple.news,38,1725937813,1725937851,1725937851.686297,-18000,EB445137-D7F5-57EC-87DA-1DB460D64046,"iPhone13,2"
com.burbn.instagram,46,1725937759,1725937805,1725937805.568264,-18000,EB445137-D7F5-57EC-87DA-1DB460D64046,"iPhone13,2"
com.apple.news,106,1725937454,1725937560,1725937560.975316,-18000,EB445137-D7F5-57EC-87DA-1DB460D64046,"iPhone13,2"
com.apple.news,2,1725937447,1725937449,1725937449.2118258,-18000,EB445137-D7F5-57EC-87DA-1DB460D64046,"iPhone13,2"
com.apple.news,912,1725936420,1725937332,1725937332.305217,-18000,EB445137-D7F5-57EC-87DA-1DB460D64046,"iPhone13,2"
com.apple.Health,31,1725936310,1725936341,1725936341.280324,-18000,EB445137-D7F5-57EC-87DA-1DB460D64046,"iPhone13,2"
com.myfitnesspal.mfp,25,1725936158,1725936183,1725936183.876399,-18000,EB445137-D7F5-57EC-87DA-1DB460D64046,"iPhone13,2"
com.hammerandchisel.discord,78,1725936047,1725936125,1725936125.40132,-18000,EB445137-D7F5-57EC-87DA-1DB460D64046,"iPhone13,2"
com.truebill.truebillnative,14,1725936025,1725936039,1725936039.986851,-18000,EB445137-D7F5-57EC-87DA-1DB460D64046,"iPhone13,2"
com.google.chrome.ios,56,1725935948,1725936004,1725936005.28216,-18000,EB445137-D7F5-57EC-87DA-1DB460D64046,"iPhone13,2"
com.myfitnesspal.mfp,31,1725935915,1725935946,1725935947.663661,-18000,EB445137-D7F5-57EC-87DA-1DB460D64046,"iPhone13,2"
com.myfitnesspal.mfp,2,1725935897,1725935899,1725935899.731621,-18000,EB445137-D7F5-57EC-87DA-1DB460D64046,"iPhone13,2"
com.myfitnesspal.mfp,7,1725935864,1725935871,1725935871.508527,-18000,EB445137-D7F5-57EC-87DA-1DB460D64046,"iPhone13,2"
com.myfitnesspal.mfp,6,1725935828,1725935834,1725935834.619415,-18000,EB445137-D7F5-57EC-87DA-1DB460D64046,"iPhone13,2"
com.myfitnesspal.mfp,29,1725935798,1725935827,1725935827.3277779,-18000,EB445137-D7F5-57EC-87DA-1DB460D64046,"iPhone13,2"
com.wbd.stream,3,1725935260,1725935263,1725935263.098326,-18000,EB445137-D7F5-57EC-87DA-1DB460D64046,"iPhone13,2"
com.wbd.stream,193,1725935015,1725935208,1725935208.240253,-18000,EB445137-D7F5-57EC-87DA-1DB460D64046,"iPhone13,2"
com.apple.news,301,1725934597,1725934898,1725934899.078098,-18000,EB445137-D7F5-57EC-87DA-1DB460D64046,"iPhone13,2"
com.burbn.instagram,299,1725934295,1725934594,1725934594.729058,-18000,EB445137-D7F5-57EC-87DA-1DB460D64046,"iPhone13,2"
com.wbd.stream,74,1725934221,1725934295,1725934295.606659,-18000,EB445137-D7F5-57EC-87DA-1DB460D64046,"iPhone13,2"
com.burbn.instagram,2,1725934215,1725934217,1725934218.159648,-18000,EB445137-D7F5-57EC-87DA-1DB460D64046,"iPhone13,2"
com.burbn.instagram,1,1725934197,1725934198,1725934198.32936,-18000,EB445137-D7F5-57EC-87DA-1DB460D64046,"iPhone13,2"
com.burbn.instagram,48,1725934147,1725934195,1725934195.732216,-18000,EB445137-D7F5-57EC-87DA-1DB460D64046,"iPhone13,2"
com.myfitnesspal.mfp,9,1725934026,1725934035,1725934035.243094,-18000,EB445137-D7F5-57EC-87DA-1DB460D64046,"iPhone13,2"
com.hammerandchisel.discord,34,1725933966,1725934000,1725934000.968525,-18000,EB445137-D7F5-57EC-87DA-1DB460D64046,"iPhone13,2"
com.toyopagroup.picaboo,10,1725933946,1725933956,1725933956.288727,-18000,EB445137-D7F5-57EC-87DA-1DB460D64046,"iPhone13,2"
com.google.chrome.ios,11,1725933305,1725933316,1725933316.794389,-18000,EB445137-D7F5-57EC-87DA-1DB460D64046,"iPhone13,2"
com.apple.mobilecal,16,1725932895,1725932911,1725932911.887803,-18000,EB445137-D7F5-57EC-87DA-1DB460D64046,"iPhone13,2"
com.apple.mobilecal,20,1725932774,1725932794,1725932794.905875,-18000,EB445137-D7F5-57EC-87DA-1DB460D64046,"iPhone13,2"
com.apple.mobilecal,30,1725932730,1725932760,1725932760.3222399,-18000,EB445137-D7F5-57EC-87DA-1DB460D64046,"iPhone13,2"
com.toyopagroup.picaboo,19,1725932708,1725932727,1725932727.654012,-18000,EB445137-D7F5-57EC-87DA-1DB460D64046,"iPhone13,2"
com.apple.mobileslideshow,4,1725932704,1725932708,1725932710.630687,-18000,EB445137-D7F5-57EC-87DA-1DB460D64046,"iPhone13,2"
com.apple.mobileslideshow,50,1725930536,1725930586,1725930586.535431,-18000,EB445137-D7F5-57EC-87DA-1DB460D64046,"iPhone13,2"
com.t11.celeste,4,1725930531,1725930535,1725930535.303226,-18000,EB445137-D7F5-57EC-87DA-1DB460D64046,"iPhone13,2"
com.t11.celeste,14,1725930488,1725930502,1725930503.057794,-18000,EB445137-D7F5-57EC-87DA-1DB460D64046,"iPhone13,2"
com.hammerandchisel.discord,10,1725929706,1725929716,1725929716.950423,-18000,EB445137-D7F5-57EC-87DA-1DB460D64046,"iPhone13,2"
com.toyopagroup.picaboo,2,1725929704,1725929706,1725929708.745985,-18000,EB445137-D7F5-57EC-87DA-1DB460D64046,"iPhone13,2"
com.toyopagroup.picaboo,10,1725929393,1725929403,1725929404.000696,-18000,EB445137-D7F5-57EC-87DA-1DB460D64046,"iPhone13,2"
com.leomehlig.today,4,1725929031,1725929035,1725929035.1661448,-18000,,
com.apple.Preview,1,1725929030,1725929031,1725929032.036129,-18000,,
com.leomehlig.today,1,1725929029,1725929030,1725929030.823245,-18000,,
com.microsoft.VSCode,18,1725929011,1725929029,1725929029.198076,-18000,,
com.google.Chrome,4,1725929007,1725929011,1725929011.673281,-18000,,
com.leomehlig.today,12,1725928995,1725929007,1725929007.8450131,-18000,,
com.google.Chrome,1,1725928994,1725928995,1725928995.817563,-18000,,
com.apple.Preview,2,1725928992,1725928994,1725928994.517684,-18000,,
com.leomehlig.today,29,1725928963,1725928992,1725928992.29325,-18000,,
com.apple.finder,1,1725928962,1725928963,1725928963.973917,-18000,,
com.apple.Preview,0,1725928962,1725928962,1725928963.0459971,-18000,,
com.google.Chrome,140,1725928822,1725928962,1725928962.159167,-18000,,
com.apple.Preview,22,1725928800,1725928822,1725928822.872174,-18000,,
com.google.Chrome,2,1725928798,1725928800,1725928800.1174731,-18000,,
com.apple.Preview,27,1725928771,1725928798,1725928798.1332269,-18000,,
com.google.Chrome,1,1725928770,1725928771,1725928771.735918,-18000,,
com.apple.Preview,82,1725928688,1725928770,1725928770.217578,-18000,,
com.google.Chrome,4,1725928684,1725928688,1725928688.6108232,-18000,,
com.apple.Preview,72,1725928612,1725928684,1725928684.242944,-18000,,
com.google.Chrome,38,1725928574,1725928612,1725928612.0516028,-18000,,
com.apple.Preview,40,1725928534,1725928574,1725928574.4710479,-18000,,
com.apple.finder,0,1725928534,1725928534,1725928534.342507,-18000,,
com.apple.Preview,3,1725928531,1725928534,1725928534.168054,-18000,,
com.apple.finder,4,1725928527,1725928531,1725928531.6219292,-18000,,
com.google.Chrome,919,1725927608,1725928527,1725928527.397591,-18000,,
com.toyopagroup.picaboo,25,1725927443,1725927468,1725927468.85468,-18000,EB445137-D7F5-57EC-87DA-1DB460D64046,"iPhone13,2"
com.leomehlig.today,187,1725927421,1725927608,1725927608.7667398,-18000,,
com.google.Chrome,40,1725927381,1725927421,1725927421.229285,-18000,,
com.leomehlig.today,38,1725927331,1725927369,1725927369.172707,-18000,,
com.google.Chrome,3311,1725924020,1725927331,1725927331.662681,-18000,,
com.leomehlig.today,56,1725923953,1725924009,1725924010.442795,-18000,,
com.toyopagroup.picaboo,4,1725923781,1725923785,1725923785.9982839,-18000,EB445137-D7F5-57EC-87DA-1DB460D64046,"iPhone13,2"
com.toyopagroup.picaboo,3,1725923722,1725923725,1725923725.542035,-18000,EB445137-D7F5-57EC-87DA-1DB460D64046,"iPhone13,2"
com.toyopagroup.picaboo,26,1725923659,1725923685,1725923685.340116,-18000,EB445137-D7F5-57EC-87DA-1DB460D64046,"iPhone13,2"
com.toyopagroup.picaboo,10,1725923645,1725923655,1725923656.0038152,-18000,EB445137-D7F5-57EC-87DA-1DB460D64046,"iPhone13,2"
com.apple.camera,30,1725923582,1725923612,1725923612.6330109,-18000,EB445137-D7F5-57EC-87DA-1DB460D64046,"iPhone13,2"
com.toyopagroup.picaboo,31,1725923581,1725923612,1725923612.628752,-18000,EB445137-D7F5-57EC-87DA-1DB460D64046,"iPhone13,2"
com.toyopagroup.picaboo,57,1725923515,1725923572,1725923572.702588,-18000,EB445137-D7F5-57EC-87DA-1DB460D64046,"iPhone13,2"
com.myfitnesspal.mfp,54,1725922817,1725922871,1725922871.623461,-18000,EB445137-D7F5-57EC-87DA-1DB460D64046,"iPhone13,2"
com.apple.Music,2,1725922814,1725922816,1725922817.182098,-18000,EB445137-D7F5-57EC-87DA-1DB460D64046,"iPhone13,2"
com.apple.Music,12,1725922608,1725922620,1725922621.299926,-18000,EB445137-D7F5-57EC-87DA-1DB460D64046,"iPhone13,2"
com.apple.weather,5,1725922601,1725922606,1725922606.119008,-18000,EB445137-D7F5-57EC-87DA-1DB460D64046,"iPhone13,2"
com.leomehlig.today,29,1725922320,1725922349,1725922349.3334188,-18000,,
com.google.Chrome,5,1725922315,1725922320,1725922320.350738,-18000,,
com.apple.weather,13,1725922285,1725922298,1725922298.997251,-18000,EB445137-D7F5-57EC-87DA-1DB460D64046,"iPhone13,2"
com.myfitnesspal.mfp,4,1725922281,1725922285,1725922285.20091,-18000,EB445137-D7F5-57EC-87DA-1DB460D64046,"iPhone13,2"
com.myfitnesspal.mfp,10,1725922255,1725922265,1725922265.3481,-18000,EB445137-D7F5-57EC-87DA-1DB460D64046,"iPhone13,2"
com.myfitnesspal.mfp,19,1725921750,1725921769,1725921769.714433,-18000,EB445137-D7F5-57EC-87DA-1DB460D64046,"iPhone13,2"
com.apple.news,450,1725921277,1725921727,1725921727.385283,-18000,EB445137-D7F5-57EC-87DA-1DB460D64046,"iPhone13,2"
com.myfitnesspal.mfp,60,1725921170,1725921230,1725921230.292214,-18000,EB445137-D7F5-57EC-87DA-1DB460D64046,"iPhone13,2"
com.microsoft.Office.Outlook,209,1725920959,1725921168,1725921168.826631,-18000,EB445137-D7F5-57EC-87DA-1DB460D64046,"iPhone13,2"
com.apple.mobiletimer,7,1725920952,1725920959,1725920960.157814,-18000,EB445137-D7F5-57EC-87DA-1DB460D64046,"iPhone13,2"
com.apple.mobiletimer,16,1725919862,1725919878,1725919878.1641011,-18000,EB445137-D7F5-57EC-87DA-1DB460D64046,"iPhone13,2"
com.apple.mobiletimer,64,1725919497,1725919561,1725919561.135625,-18000,EB445137-D7F5-57EC-87DA-1DB460D64046,"iPhone13,2"
com.apple.mobiletimer,64,1725919335,1725919399,1725919399.988836,-18000,EB445137-D7F5-57EC-87DA-1DB460D64046,"iPhone13,2"
com.apple.mobiletimer,10,1725919313,1725919323,1725919323.7494202,-18000,EB445137-D7F5-57EC-87DA-1DB460D64046,"iPhone13,2"
com.apple.mobiletimer,66,1725919086,1725919152,1725919152.02245,-18000,EB445137-D7F5-57EC-87DA-1DB460D64046,"iPhone13,2"
com.apple.mobiletimer,60,1725918928,1725918988,1725918988.891793,-18000,EB445137-D7F5-57EC-87DA-1DB460D64046,"iPhone13,2"
com.apple.Health,2,1725918926,1725918928,1725918928.5518541,-18000,EB445137-D7F5-57EC-87DA-1DB460D64046,"iPhone13,2"
com.apple.Health,3,1725918917,1725918920,1725918920.257553,-18000,EB445137-D7F5-57EC-87DA-1DB460D64046,"iPhone13,2"
com.apple.Health,5,1725918037,1725918042,1725918042.2581701,-18000,EB445137-D7F5-57EC-87DA-1DB460D64046,"iPhone13,2"
com.google.Chrome,1,1725917872,1725917873,1725917873.833616,-18000,,
com.google.Chrome,355,1725917514,1725917869,1725917869.9616098,-18000,,
com.apple.Health,13,1725917441,1725917454,1725917454.15814,-18000,EB445137-D7F5-57EC-87DA-1DB460D64046,"iPhone13,2"
com.apple.Health,8,1725917425,1725917433,1725917433.4364672,-18000,EB445137-D7F5-57EC-87DA-1DB460D64046,"iPhone13,2"
com.leomehlig.today,347,1725917167,1725917514,1725917514.292166,-18000,,
com.apple.Preview,16,1725917151,1725917167,1725917167.585181,-18000,,
com.microsoft.VSCode,2,1725917149,1725917151,1725917151.365047,-18000,,
com.google.Chrome,77,1725917072,1725917149,1725917149.864409,-18000,,
com.apple.Preview,7,1725917065,1725917072,1725917072.492087,-18000,,
com.google.Chrome,63,1725917002,1725917065,1725917065.122052,-18000,,
com.apple.Preview,40,1725916962,1725917002,1725917002.39436,-18000,,
com.google.Chrome,52,1725916910,1725916962,1725916962.447678,-18000,,
com.apple.Preview,4,1725916906,1725916910,1725916910.2946792,-18000,,
com.microsoft.VSCode,3,1725916903,1725916906,1725916906.781489,-18000,,
com.google.Chrome,50,1725916853,1725916903,1725916903.0895529,-18000,,
com.apple.Preview,389,1725916464,1725916853,1725916853.6695318,-18000,,
com.apple.finder,5,1725916459,1725916464,1725916464.598465,-18000,,
com.google.Chrome,6,1725916453,1725916459,1725916459.635052,-18000,,
com.apple.MobileSMS,2,1725916451,1725916453,1725916453.522892,-18000,,
com.google.Chrome,66,1725916385,1725916451,1725916451.554215,-18000,,
com.google.Chrome,368,1725915031,1725915399,1725915399.7338328,-18000,,
com.apple.Notes,8,1725915023,1725915031,1725915031.980866,-18000,,
com.apple.Health,9,1725914685,1725914694,1725914694.052146,-18000,EB445137-D7F5-57EC-87DA-1DB460D64046,"iPhone13,2"
com.apple.Health,22,1725913797,1725913819,1725913819.828284,-18000,EB445137-D7F5-57EC-87DA-1DB460D64046,"iPhone13,2"
com.apple.news,73,1725913522,1725913595,1725913595.851416,-18000,EB445137-D7F5-57EC-87DA-1DB460D64046,"iPhone13,2"
com.apple.mobilenotes,12,1725913499,1725913511,1725913511.956636,-18000,EB445137-D7F5-57EC-87DA-1DB460D64046,"iPhone13,2"
com.google.ios.youtube,10,1725913020,1725913030,1725913030.1127338,-18000,EB445137-D7F5-57EC-87DA-1DB460D64046,"iPhone13,2"
com.google.ios.youtube,96,1725912923,1725913019,1725913020.140201,-18000,EB445137-D7F5-57EC-87DA-1DB460D64046,"iPhone13,2"
com.google.chrome.ios,116,1725912795,1725912911,1725912912.3065748,-18000,EB445137-D7F5-57EC-87DA-1DB460D64046,"iPhone13,2"
com.apple.mobilenotes,7,1725912539,1725912546,1725912546.8762388,-18000,EB445137-D7F5-57EC-87DA-1DB460D64046,"iPhone13,2"
com.apple.mobilenotes,29,1725912454,1725912483,1725912483.9176931,-18000,EB445137-D7F5-57EC-87DA-1DB460D64046,"iPhone13,2"
com.apple.mobilenotes,31,1725912287,1725912318,1725912318.59875,-18000,EB445137-D7F5-57EC-87DA-1DB460D64046,"iPhone13,2"
com.microsoft.Office.Outlook,20,1725912124,1725912144,1725912144.081095,-18000,EB445137-D7F5-57EC-87DA-1DB460D64046,"iPhone13,2"
com.apple.mobilenotes,7,1725912117,1725912124,1725912124.1246161,-18000,EB445137-D7F5-57EC-87DA-1DB460D64046,"iPhone13,2"
com.apple.mobilenotes,15,1725911916,1725911931,1725911931.529469,-18000,EB445137-D7F5-57EC-87DA-1DB460D64046,"iPhone13,2"
com.apple.mobilenotes,14,1725911318,1725911332,1725911333.004595,-18000,EB445137-D7F5-57EC-87DA-1DB460D64046,"iPhone13,2"
com.google.ios.youtube,3,1725911315,1725911318,1725911319.082162,-18000,EB445137-D7F5-57EC-87DA-1DB460D64046,"iPhone13,2"
com.google.ios.youtube,6,1725910924,1725910930,1725910930.252485,-18000,EB445137-D7F5-57EC-87DA-1DB460D64046,"iPhone13,2"
com.google.ios.youtube,24,1725910838,1725910862,1725910862.0960898,-18000,EB445137-D7F5-57EC-87DA-1DB460D64046,"iPhone13,2"
com.google.chrome.ios,18,1725910820,1725910838,1725910838.803911,-18000,EB445137-D7F5-57EC-87DA-1DB460D64046,"iPhone13,2"
com.apple.mobilenotes,2,1725910818,1725910820,1725910820.243377,-18000,EB445137-D7F5-57EC-87DA-1DB460D64046,"iPhone13,2"
com.apple.mobilenotes,16,1725910267,1725910283,1725910283.11293,-18000,EB445137-D7F5-57EC-87DA-1DB460D64046,"iPhone13,2"
com.apple.mobilenotes,38,1725910227,1725910265,1725910265.085732,-18000,EB445137-D7F5-57EC-87DA-1DB460D64046,"iPhone13,2"
com.apple.Health,3,1725910224,1725910227,1725910227.539211,-18000,EB445137-D7F5-57EC-87DA-1DB460D64046,"iPhone13,2"
com.apple.Health,6,1725909615,1725909621,1725909621.636462,-18000,EB445137-D7F5-57EC-87DA-1DB460D64046,"iPhone13,2"
com.apple.Health,5,1725909609,1725909614,1725909614.885309,-18000,EB445137-D7F5-57EC-87DA-1DB460D64046,"iPhone13,2"
com.apple.Health,8,1725909518,1725909526,1725909526.974242,-18000,EB445137-D7F5-57EC-87DA-1DB460D64046,"iPhone13,2"
com.apple.Music,2,1725909516,1725909518,1725909518.8136392,-18000,EB445137-D7F5-57EC-87DA-1DB460D64046,"iPhone13,2"
com.apple.Music,18,1725909461,1725909479,1725909479.426229,-18000,EB445137-D7F5-57EC-87DA-1DB460D64046,"iPhone13,2"
com.muscleforlife.Stacked,2,1725909454,1725909456,1725909456.93857,-18000,EB445137-D7F5-57EC-87DA-1DB460D64046,"iPhone13,2"
com.apple.Notes,204,1725909162,1725909366,1725909366.2555552,-18000,,
com.google.Chrome,31,1725909131,1725909162,1725909162.4085112,-18000,,
com.muscleforlife.Stacked,308,1725909042,1725909350,1725909350.430635,-18000,EB445137-D7F5-57EC-87DA-1DB460D64046,"iPhone13,2"
com.apple.Notes,101,1725909030,1725909131,1725909131.877922,-18000,,
com.apple.finder,51,1725908979,1725909030,1725909030.965742,-18000,,
com.google.Chrome,3,1725908976,1725908979,1725908979.883337,-18000,,
com.muscleforlife.Stacked,107,1725908904,1725909011,1725909011.470121,-18000,EB445137-D7F5-57EC-87DA-1DB460D64046,"iPhone13,2"
com.apple.MobileSMS,8,1725908895,1725908903,1725908903.436306,-18000,EB445137-D7F5-57EC-87DA-1DB460D64046,"iPhone13,2"
com.apple.Maps,2,1725908893,1725908895,1725908895.55949,-18000,EB445137-D7F5-57EC-87DA-1DB460D64046,"iPhone13,2"
com.apple.Maps,6,1725908701,1725908707,1725908707.287741,-18000,EB445137-D7F5-57EC-87DA-1DB460D64046,"iPhone13,2"
com.apple.Maps,6,1725908492,1725908498,1725908498.5357819,-18000,EB445137-D7F5-57EC-87DA-1DB460D64046,"iPhone13,2"
com.apple.Maps,35,1725908455,1725908490,1725908491.01093,-18000,EB445137-D7F5-57EC-87DA-1DB460D64046,"iPhone13,2"
com.microsoft.Office.Outlook,2,1725908452,1725908454,1725908454.8461828,-18000,EB445137-D7F5-57EC-87DA-1DB460D64046,"iPhone13,2"
com.microsoft.Office.Outlook,21,1725907877,1725907898,1725907898.55577,-18000,EB445137-D7F5-57EC-87DA-1DB460D64046,"iPhone13,2"
com.truebill.truebillnative,7,1725907870,1725907877,1725907877.413609,-18000,EB445137-D7F5-57EC-87DA-1DB460D64046,"iPhone13,2"
com.truebill.truebillnative,114,1725904340,1725904454,1725904454.283413,-18000,EB445137-D7F5-57EC-87DA-1DB460D64046,"iPhone13,2"
com.apple.Health,10,1725904328,1725904338,1725904338.595674,-18000,EB445137-D7F5-57EC-87DA-1DB460D64046,"iPhone13,2"
com.google.Gmail,41,1725904238,1725904279,1725904280.1799068,-18000,EB445137-D7F5-57EC-87DA-1DB460D64046,"iPhone13,2"
com.google.Gmail,35,1725904031,1725904066,1725904066.271529,-18000,EB445137-D7F5-57EC-87DA-1DB460D64046,"iPhone13,2"
com.myfitnesspal.mfp,19,1725903562,1725903581,1725903581.769012,-18000,EB445137-D7F5-57EC-87DA-1DB460D64046,"iPhone13,2"
com.apple.weather,4,1725903558,1725903562,1725903562.165607,-18000,EB445137-D7F5-57EC-87DA-1DB460D64046,"iPhone13,2"
com.apple.weather,9,1725903225,1725903234,1725903234.942359,-18000,EB445137-D7F5-57EC-87DA-1DB460D64046,"iPhone13,2"
com.hammerandchisel.discord,4,1725903219,1725903223,1725903223.477437,-18000,EB445137-D7F5-57EC-87DA-1DB460D64046,"iPhone13,2"
com.google.Chrome,396,1725902966,1725903362,1725903362.4561539,-18000,,
com.leomehlig.today,61,1725902905,1725902966,1725902966.360327,-18000,,
com.google.Chrome,323,1725902582,1725902905,1725902906.0356212,-18000,,
com.hammerandchisel.discord,156,1725902435,1725902591,1725902591.296803,-18000,EB445137-D7F5-57EC-87DA-1DB460D64046,"iPhone13,2"
com.apple.iCal,192,1725902390,1725902582,1725902582.17928,-18000,,
com.google.Chrome,17,1725902373,1725902390,1725902390.883012,-18000,,
com.microsoft.Office.Outlook,72,1725902363,1725902435,1725902435.514546,-18000,EB445137-D7F5-57EC-87DA-1DB460D64046,"iPhone13,2"
com.apple.Music,2,1725902044,1725902046,1725902046.258656,-18000,,
com.google.Chrome,290,1725901754,1725902044,1725902044.969229,-18000,,
com.microsoft.VSCode,7,1725901747,1725901754,1725901754.329124,-18000,,
com.google.Chrome,2,1725901745,1725901747,1725901747.726749,-18000,,
com.microsoft.VSCode,4,1725901741,1725901745,1725901745.5676,-18000,,
com.google.Chrome,2,1725901739,1725901741,1725901741.474142,-18000,,
com.microsoft.VSCode,3,1725901736,1725901739,1725901740.0146809,-18000,,
com.google.Chrome,2,1725901734,1725901736,1725901736.16705,-18000,,
com.microsoft.VSCode,5,1725901729,1725901734,1725901734.538041,-18000,,
com.google.Chrome,1,1725901728,1725901729,1725901729.201995,-18000,,
com.microsoft.VSCode,5,1725901723,1725901728,1725901728.5848432,-18000,,
com.google.Chrome,9,1725901714,1725901723,1725901723.67605,-18000,,
com.microsoft.VSCode,17,1725901697,1725901714,1725901714.267199,-18000,,
com.google.Chrome,5,1725901692,1725901697,1725901697.222715,-18000,,
com.microsoft.VSCode,8,1725901684,1725901692,1725901692.1008039,-18000,,
com.google.Chrome,1,1725901683,1725901684,1725901684.6583118,-18000,,
com.microsoft.VSCode,6,1725901677,1725901683,1725901683.776248,-18000,,
com.google.Chrome,29,1725901648,1725901677,1725901677.5090652,-18000,,
com.microsoft.VSCode,1,1725901647,1725901648,1725901649.024414,-18000,,
com.google.Chrome,14,1725901633,1725901647,1725901647.946538,-18000,,
com.microsoft.VSCode,9,1725901624,1725901633,1725901633.308566,-18000,,
com.google.Chrome,4,1725901620,1725901624,1725901624.656456,-18000,,
com.microsoft.VSCode,8,1725901612,1725901620,1725901620.8211632,-18000,,
com.google.Chrome,3,1725901609,1725901612,1725901612.036344,-18000,,
com.microsoft.VSCode,1,1725901608,1725901609,1725901609.9416199,-18000,,
com.google.Chrome,3,1725901605,1725901608,1725901608.773127,-18000,,
com.microsoft.VSCode,2,1725901603,1725901605,1725901605.901052,-18000,,
com.google.Chrome,45,1725901558,1725901603,1725901604.031672,-18000,,
com.microsoft.VSCode,33,1725901525,1725901558,1725901558.350595,-18000,,
com.google.Chrome,35,1725901490,1725901525,1725901525.789645,-18000,,
com.microsoft.VSCode,42,1725901448,1725901490,1725901490.944882,-18000,,
com.google.Chrome,10,1725901438,1725901448,1725901448.431991,-18000,,
com.microsoft.VSCode,75,1725901363,1725901438,1725901438.065124,-18000,,
com.google.Chrome,74,1725901289,1725901363,1725901363.5251532,-18000,,
com.apple.finder,25,1725901264,1725901289,1725901289.81247,-18000,,
com.apple.finder,17,1725900935,1725900952,1725900952.3952432,-18000,,
com.apple.archiveutility,6,1725900929,1725900935,1725900935.288341,-18000,,
com.apple.finder,10,1725900919,1725900929,1725900929.098434,-18000,,
com.microsoft.VSCode,243,1725900676,1725900919,1725900920.006164,-18000,,
com.google.Chrome,7,1725900669,1725900676,1725900676.941612,-18000,,
com.microsoft.VSCode,123,1725900546,1725900669,1725900669.2613602,-18000,,
com.google.Chrome,3,1725900543,1725900546,1725900546.467617,-18000,,
com.microsoft.VSCode,4,1725900539,1725900543,1725900543.423069,-18000,,
com.google.Chrome,13,1725900526,1725900539,1725900539.245141,-18000,,
com.microsoft.VSCode,33,1725900493,1725900526,1725900526.72653,-18000,,
com.google.Chrome,44,1725900449,1725900493,1725900493.447116,-18000,,
com.microsoft.VSCode,55,1725900394,1725900449,1725900449.330898,-18000,,
com.google.Chrome,2,1725900392,1725900394,1725900394.448025,-18000,,
com.microsoft.VSCode,1,1725900391,1725900392,1725900392.453423,-18000,,
com.google.Chrome,25,1725900366,1725900391,1725900391.41475,-18000,,
com.microsoft.VSCode,145,1725900221,1725900366,1725900366.208194,-18000,,
com.apple.MobileSMS,7,1725900214,1725900221,1725900221.174963,-18000,,
com.microsoft.VSCode,94,1725900120,1725900214,1725900214.316802,-18000,,
com.apple.iCal,10,1725900110,1725900120,1725900120.3739362,-18000,,
com.apple.Music,7,1725900103,1725900110,1725900110.741559,-18000,,
com.apple.mobilephone,11,1725899694,1725899705,1725899705.507975,-18000,EB445137-D7F5-57EC-87DA-1DB460D64046,"iPhone13,2"
com.microsoft.Office.Outlook,29,1725899664,1725899693,1725899693.150748,-18000,EB445137-D7F5-57EC-87DA-1DB460D64046,"iPhone13,2"
com.apple.MobileSMS,15,1725899649,1725899664,1725899664.740817,-18000,EB445137-D7F5-57EC-87DA-1DB460D64046,"iPhone13,2"
com.apple.MobileSMS,11,1725899626,1725899637,1725899637.425583,-18000,EB445137-D7F5-57EC-87DA-1DB460D64046,"iPhone13,2"
com.apple.MobileSMS,100,1725899442,1725899542,1725899542.394402,-18000,EB445137-D7F5-57EC-87DA-1DB460D64046,"iPhone13,2"
com.apple.Maps,5,1725899437,1725899442,1725899442.8651109,-18000,EB445137-D7F5-57EC-87DA-1DB460D64046,"iPhone13,2"
com.google.Chrome,668,1725899435,1725900103,1725900103.603747,-18000,,
com.apple.Music,4,1725899431,1725899435,1725899435.596288,-18000,,
com.google.Chrome,8,1725899423,1725899431,1725899431.39463,-18000,,
com.apple.Maps,16,1725899387,1725899403,1725899403.127116,-18000,EB445137-D7F5-57EC-87DA-1DB460D64046,"iPhone13,2"
com.apple.iCal,152,1725899271,1725899423,1725899423.939259,-18000,,
com.apple.Music,62,1725899209,1725899271,1725899271.830502,-18000,,
com.google.Chrome,19,1725899190,1725899209,1725899209.712974,-18000,,
com.apple.Music,5,1725899185,1725899190,1725899190.423842,-18000,,
com.apple.FaceTime,10,1725899175,1725899185,1725899185.0897589,-18000,,
com.apple.Maps,8,1725899173,1725899181,1725899181.823522,-18000,EB445137-D7F5-57EC-87DA-1DB460D64046,"iPhone13,2"
com.apple.Maps,12,1725899113,1725899125,1725899125.59587,-18000,EB445137-D7F5-57EC-87DA-1DB460D64046,"iPhone13,2"
com.google.Chrome,329,1725898368,1725898697,1725898697.6089869,-18000,,
com.apple.Music,22,1725898346,1725898368,1725898368.104276,-18000,,
com.google.Chrome,41,1725898305,1725898346,1725898346.527394,-18000,,
com.leomehlig.today,3,1725898302,1725898305,1725898305.7616692,-18000,,
com.google.Chrome,6,1725898296,1725898302,1725898302.472656,-18000,,
com.apple.Maps,3,1725897561,1725897564,1725897564.821192,-18000,EB445137-D7F5-57EC-87DA-1DB460D64046,"iPhone13,2"
com.apple.InCallService,0,1725897561,1725897561,1725897561.5254889,-18000,EB445137-D7F5-57EC-87DA-1DB460D64046,"iPhone13,2"
com.apple.InCallService,4,1725897404,1725897408,1725897408.174417,-18000,EB445137-D7F5-57EC-87DA-1DB460D64046,"iPhone13,2"
com.apple.InCallService,2,1725897393,1725897395,1725897396.8256269,-18000,EB445137-D7F5-57EC-87DA-1DB460D64046,"iPhone13,2"
com.apple.Maps,9,1725897384,1725897393,1725897394.627851,-18000,EB445137-D7F5-57EC-87DA-1DB460D64046,"iPhone13,2"
com.apple.Maps,5,1725897335,1725897340,1725897340.594466,-18000,EB445137-D7F5-57EC-87DA-1DB460D64046,"iPhone13,2"
com.apple.mobilecal,21,1725897309,1725897330,1725897330.58599,-18000,EB445137-D7F5-57EC-87DA-1DB460D64046,"iPhone13,2"
com.apple.news,3,1725897304,1725897307,1725897307.262815,-18000,EB445137-D7F5-57EC-87DA-1DB460D64046,"iPhone13,2"
com.apple.news,2,1725895751,1725895753,1725895753.256167,-18000,EB445137-D7F5-57EC-87DA-1DB460D64046,"iPhone13,2"
com.apple.news,117,1725893933,1725894050,1725894050.5323691,-18000,EB445137-D7F5-57EC-87DA-1DB460D64046,"iPhone13,2"
com.google.Chrome,278,1725892730,1725893008,1725893008.988549,-18000,,
com.leomehlig.today,10,1725892601,1725892611,1725892611.060611,-18000,,
com.apple.finder,53,1725892548,1725892601,1725892602.0537438,-18000,,
com.apple.news,101,1725892404,1725892505,1725892505.630372,-18000,EB445137-D7F5-57EC-87DA-1DB460D64046,"iPhone13,2"
com.apple.weather,19,1725892373,1725892392,1725892392.86852,-18000,EB445137-D7F5-57EC-87DA-1DB460D64046,"iPhone13,2"
com.myfitnesspal.mfp,7,1725892366,1725892373,1725892373.1973,-18000,EB445137-D7F5-57EC-87DA-1DB460D64046,"iPhone13,2"
com.google.Chrome,188,1725892360,1725892548,1725892548.583118,-18000,,
com.leomehlig.today,40,1725892320,1725892360,1725892360.551793,-18000,,
com.google.Chrome,102,1725892218,1725892320,1725892320.722363,-18000,,
com.apple.FinalCut,6,1725892212,1725892218,1725892219.171783,-18000,,
com.google.Chrome,71,1725892141,1725892212,1725892212.224598,-18000,,
com.apple.FinalCut,43,1725892098,1725892141,1725892141.803317,-18000,,
com.myfitnesspal.mfp,62,1725891918,1725891980,1725891980.664132,-18000,EB445137-D7F5-57EC-87DA-1DB460D64046,"iPhone13,2"
com.renpho.health,2,1725891916,1725891918,1725891918.826134,-18000,EB445137-D7F5-57EC-87DA-1DB460D64046,"iPhone13,2"
com.renpho.health,93,1725890708,1725890801,1725890801.772845,-18000,EB445137-D7F5-57EC-87DA-1DB460D64046,"iPhone13,2"
com.microsoft.Office.Outlook,250,1725889540,1725889790,1725889790.692697,-18000,EB445137-D7F5-57EC-87DA-1DB460D64046,"iPhone13,2"
com.apple.mobiletimer,15,1725857188,1725857203,1725857203.724899,-18000,EB445137-D7F5-57EC-87DA-1DB460D64046,"iPhone13,2"
com.apple.Health,76,1725857103,1725857179,1725857179.519218,-18000,EB445137-D7F5-57EC-87DA-1DB460D64046,"iPhone13,2"
com.thestorygraph.thestorygraph,19,1725857011,1725857030,1725857030.489801,-18000,EB445137-D7F5-57EC-87DA-1DB460D64046,"iPhone13,2"
com.microsoft.Office.Outlook,22,1725854616,1725854638,1725854638.458249,-18000,EB445137-D7F5-57EC-87DA-1DB460D64046,"iPhone13,2"
com.myfitnesspal.mfp,29,1725854586,1725854615,1725854615.038902,-18000,EB445137-D7F5-57EC-87DA-1DB460D64046,"iPhone13,2"
com.google.ios.youtube,0,1725854577,1725854577,1725854577.980278,-18000,EB445137-D7F5-57EC-87DA-1DB460D64046,"iPhone13,2"
com.apple.FinalCut,51,1725854462,1725854513,1725854513.187377,-18000,,
com.apple.finder,9,1725854453,1725854462,1725854462.0733519,-18000,,
com.apple.FinalCut,3,1725854435,1725854438,1725854438.336909,-18000,,
com.apple.Terminal,2,1725854433,1725854435,1725854435.6411428,-18000,,
com.apple.FinalCut,4,1725854429,1725854433,1725854433.7537022,-18000,,
com.microsoft.VSCode,1,1725854428,1725854429,1725854429.9886909,-18000,,
com.apple.FinalCut,141,1725854287,1725854428,1725854428.5223951,-18000,,
com.apple.finder,4,1725854281,1725854285,1725854285.283679,-18000,,
com.apple.Terminal,64,1725854217,1725854281,1725854281.432345,-18000,,
com.apple.finder,7,1725854210,1725854217,1725854217.8716068,-18000,,
com.apple.Terminal,18,1725854192,1725854210,1725854212.7295709,-18000,,
com.google.Chrome,1,1725854175,1725854176,1725854178.373302,-18000,,
org.nerdpower.tabula.Tabula,8,1725854167,1725854175,1725854176.0894341,-18000,,
com.google.Chrome,17,1725854150,1725854167,1725854167.670723,-18000,,
org.nerdpower.tabula.Tabula,6,1725854144,1725854150,1725854150.756036,-18000,,
com.microsoft.VSCode,8,1725854136,1725854144,1725854144.497388,-18000,,
com.apple.finder,13,1725854123,1725854136,1725854136.842046,-18000,,
org.videolan.vlc,1,1725854116,1725854117,1725854117.8067,-18000,,
com.apple.finder,18,1725854098,1725854116,1725854117.106141,-18000,,
com.apple.Terminal,10,1725854066,1725854076,1725854076.490356,-18000,,
com.google.ios.youtube,13,1725853620,1725853633,1725853633.4041948,-18000,EB445137-D7F5-57EC-87DA-1DB460D64046,"iPhone13,2"
com.apple.Terminal,300,1725853605,1725853905,1725853905.438751,-18000,,
com.google.ios.youtube,3,1725853552,1725853555,1725853555.778634,-18000,EB445137-D7F5-57EC-87DA-1DB460D64046,"iPhone13,2"
com.apple.Terminal,301,1725853280,1725853581,1725853581.945092,-18000,,
com.google.ios.youtube,19,1725853278,1725853297,1725853297.022416,-18000,EB445137-D7F5-57EC-87DA-1DB460D64046,"iPhone13,2"
com.google.ios.youtube,5,1725853232,1725853237,1725853237.1254501,-18000,EB445137-D7F5-57EC-87DA-1DB460D64046,"iPhone13,2"
com.google.ios.youtube,38,1725853186,1725853224,1725853224.990179,-18000,EB445137-D7F5-57EC-87DA-1DB460D64046,"iPhone13,2"
com.google.ios.youtube,6,1725853148,1725853154,1725853154.6076899,-18000,EB445137-D7F5-57EC-87DA-1DB460D64046,"iPhone13,2"
com.google.ios.youtube,117,1725853007,1725853124,1725853124.287562,-18000,EB445137-D7F5-57EC-87DA-1DB460D64046,"iPhone13,2"
com.google.chrome.ios,4,1725852996,1725853000,1725853000.914119,-18000,EB445137-D7F5-57EC-87DA-1DB460D64046,"iPhone13,2"
com.apple.Terminal,300,1725852967,1725853267,1725853267.970117,-18000,,
com.apple.Terminal,302,1725852662,1725852964,1725852964.545251,-18000,,
com.apple.Terminal,299,1725852358,1725852657,1725852657.900062,-18000,,
com.apple.Terminal,300,1725852029,1725852329,1725852329.816959,-18000,,
com.apple.finder,55,1725851974,1725852029,1725852029.868453,-18000,,
com.apple.Terminal,128,1725851846,1725851974,1725851974.223658,-18000,,
com.apple.finder,5,1725851841,1725851846,1725851846.7987828,-18000,,
com.apple.QuickTimePlayerX,5,1725851836,1725851841,1725851841.4535952,-18000,,
com.apple.finder,3,1725851833,1725851836,1725851836.252907,-18000,,
com.apple.QuickTimePlayerX,35,1725851798,1725851833,1725851833.754453,-18000,,
com.apple.finder,2,1725851796,1725851798,1725851798.665966,-18000,,
com.apple.QuickTimePlayerX,39,1725851757,1725851796,1725851796.205905,-18000,,
com.apple.finder,4,1725851753,1725851757,1725851757.679154,-18000,,
com.apple.QuickTimePlayerX,28,1725851725,1725851753,1725851753.787869,-18000,,
com.apple.finder,2,1725851723,1725851725,1725851726.0671558,-18000,,
com.apple.QuickTimePlayerX,113,1725851610,1725851723,1725851723.6612492,-18000,,
com.apple.finder,8,1725851602,1725851610,1725851611.1959581,-18000,,
com.apple.QuickTimePlayerX,82,1725851520,1725851602,1725851602.9074001,-18000,,
com.apple.finder,10,1725851510,1725851520,1725851520.217283,-18000,,
com.apple.Terminal,32,1725851478,1725851510,1725851510.686832,-18000,,
com.apple.finder,2,1725851476,1725851478,1725851478.0564961,-18000,,
com.apple.QuickTimePlayerX,6,1725851470,1725851476,1725851476.504067,-18000,,
com.apple.finder,4,1725851466,1725851470,1725851470.980496,-18000,,
com.apple.QuickTimePlayerX,37,1725851429,1725851466,1725851466.509222,-18000,,
com.apple.finder,1,1725851428,1725851429,1725851429.31282,-18000,,
com.apple.QuickTimePlayerX,1,1725851427,1725851428,1725851428.7672272,-18000,,
com.apple.finder,1,1725851426,1725851427,1725851427.2134109,-18000,,
com.apple.QuickTimePlayerX,9,1725851417,1725851426,1725851426.916078,-18000,,
com.apple.finder,0,1725851417,1725851417,1725851417.4143639,-18000,,
com.apple.QuickTimePlayerX,11,1725851406,1725851417,1725851417.147407,-18000,,
com.apple.finder,82,1725851324,1725851406,1725851406.2355309,-18000,,
com.apple.Terminal,3,1725851321,1725851324,1725851324.2211971,-18000,,
com.apple.finder,3,1725851318,1725851321,1725851322.015249,-18000,,
com.google.Chrome,2,1725851316,1725851318,1725851318.445386,-18000,,
com.apple.finder,2,1725851314,1725851316,1725851316.395901,-18000,,
com.apple.Terminal,35,1725851279,1725851314,1725851314.388781,-18000,,
com.google.Chrome,9,1725851270,1725851279,1725851279.199501,-18000,,
com.apple.Terminal,35,1725851235,1725851270,1725851270.8757381,-18000,,
com.apple.Terminal,303,1725850927,1725851230,1725851230.201662,-18000,,
com.apple.finder,4,1725850923,1725850927,1725850927.296037,-18000,,
com.apple.Terminal,12,1725850911,1725850923,1725850923.884618,-18000,,
com.google.Chrome,31,1725850880,1725850911,1725850911.728747,-18000,,
com.apple.Terminal,36,1725850844,1725850880,1725850880.679003,-18000,,
com.apple.finder,0,1725850844,1725850844,1725850844.308928,-18000,,
com.apple.Terminal,43,1725850801,1725850844,1725850844.132782,-18000,,
com.apple.finder,3,1725850798,1725850801,1725850801.866376,-18000,,
com.apple.Terminal,8,1725850790,1725850798,1725850798.296414,-18000,,
com.apple.finder,3,1725850787,1725850790,1725850790.525749,-18000,,
com.apple.archiveutility,0,1725850787,1725850787,1725850787.776942,-18000,,
com.apple.finder,50,1725850737,1725850787,1725850787.2832232,-18000,,
com.google.Chrome,41,1725850696,1725850737,1725850737.374578,-18000,,
com.apple.Terminal,7,1725850689,1725850696,1725850696.054982,-18000,,
com.apple.FinalCut,24,1725850665,1725850689,1725850689.587601,-18000,,
org.videolan.vlc,91,1725850574,1725850665,1725850665.4951239,-18000,,
com.apple.FinalCut,15,1725850559,1725850574,1725850574.9667292,-18000,,
org.videolan.vlc,2,1725850557,1725850559,1725850559.041847,-18000,,
com.google.Chrome,70,1725850487,1725850557,1725850557.303718,-18000,,
org.videolan.vlc,53,1725850434,1725850487,1725850487.16438,-18000,,
com.apple.FinalCut,10,1725850424,1725850434,1725850435.8308659,-18000,,
com.apple.finder,2,1725850422,1725850424,1725850424.1405401,-18000,,
com.apple.FinalCut,4,1725850418,1725850422,1725850422.427506,-18000,,
com.apple.finder,1,1725850417,1725850418,1725850418.986539,-18000,,
com.apple.FinalCut,2,1725850415,1725850417,1725850417.445065,-18000,,
com.apple.finder,5,1725850410,1725850415,1725850416.083332,-18000,,
com.apple.FinalCut,17,1725850393,1725850410,1725850410.355499,-18000,,
com.google.Chrome,1,1725850392,1725850393,1725850394.633492,-18000,,
com.microsoft.Excel,1,1725850391,1725850392,1725850394.2023501,-18000,,
com.google.Chrome,23,1725850368,1725850391,1725850391.158798,-18000,,
com.apple.finder,18,1725850350,1725850368,1725850369.035235,-18000,,
org.videolan.vlc,61,1725850289,1725850350,1725850350.6568232,-18000,,
com.apple.finder,2,1725850287,1725850289,1725850289.303112,-18000,,
org.videolan.vlc,24,1725850263,1725850287,1725850287.419815,-18000,,
com.apple.finder,6,1725850257,1725850263,1725850263.716255,-18000,,
com.google.Chrome,8,1725850249,1725850257,1725850258.012404,-18000,,
com.apple.finder,145,1725850104,1725850249,1725850249.460544,-18000,,
com.microsoft.VSCode,2,1725850102,1725850104,1725850104.60762,-18000,,
com.google.Chrome,2,1725849439,1725849441,1725849441.130065,-18000,,
com.microsoft.VSCode,3,1725849436,1725849439,1725849439.308042,-18000,,
com.google.Chrome,3,1725849433,1725849436,1725849436.2824922,-18000,,
com.microsoft.VSCode,4,1725849429,1725849433,1725849433.670439,-18000,,
com.google.Chrome,597,1725848832,1725849429,1725849429.6587029,-18000,,
com.microsoft.VSCode,2,1725848830,1725848832,1725848832.783777,-18000,,
com.google.Chrome,3,1725848827,1725848830,1725848830.407764,-18000,,
com.microsoft.VSCode,1,1725848826,1725848827,1725848827.661621,-18000,,
com.google.Chrome,9,1725848817,1725848826,1725848826.228117,-18000,,
com.microsoft.VSCode,91,1725848726,1725848817,1725848817.625798,-18000,,
com.google.Chrome,2,1725848724,1725848726,1725848726.7350268,-18000,,
com.apple.finder,5,1725848719,1725848724,1725848724.334208,-18000,,
com.google.Chrome,5,1725848714,1725848719,1725848719.61686,-18000,,
com.microsoft.VSCode,110,1725848604,1725848714,1725848714.878553,-18000,,
com.apple.Preview,2,1725848602,1725848604,1725848604.315759,-18000,,
com.microsoft.VSCode,1,1725848601,1725848602,1725848602.246337,-18000,,
com.google.Chrome,15,1725848586,1725848601,1725848601.498311,-18000,,
com.apple.finder,44,1725848542,1725848586,1725848586.116617,-18000,,
com.google.Chrome,198,1725848344,1725848542,1725848542.415,-18000,,
org.nerdpower.tabula.Tabula,2,1725848342,1725848344,1725848344.069363,-18000,,
com.apple.finder,31,1725848311,1725848342,1725848342.084364,-18000,,
com.apple.archiveutility,1,1725848310,1725848311,1725848311.775986,-18000,,
com.apple.finder,37,1725848273,1725848310,1725848310.7615561,-18000,,
com.google.Chrome,39,1725848234,1725848273,1725848273.875062,-18000,,
com.apple.finder,38,1725848196,1725848234,1725848234.535353,-18000,,
com.google.Chrome,191,1725848005,1725848196,1725848196.681529,-18000,,
com.apple.Terminal,82,1725847923,1725848005,1725848005.72048,-18000,,
com.google.Chrome,170,1725847753,1725847923,1725847923.882885,-18000,,
com.apple.finder,1,1725847752,1725847753,1725847753.68251,-18000,,
com.apple.Preview,16,1725847736,1725847752,1725847752.9001498,-18000,,
com.apple.finder,19,1725847717,1725847736,1725847736.6348948,-18000,,
com.google.Chrome,26,1725847691,1725847717,1725847717.570508,-18000,,
com.microsoft.Excel,7,1725847684,1725847691,1725847691.108767,-18000,,
com.google.Chrome,5,1725847679,1725847684,1725847684.138771,-18000,,
com.microsoft.Excel,4,1725847675,1725847679,1725847679.358613,-18000,,
com.google.Chrome,9,1725847666,1725847675,1725847675.051681,-18000,,
com.microsoft.Excel,7,1725847659,1725847666,1725847667.026091,-18000,,
com.google.Chrome,24,1725847635,1725847659,1725847659.442517,-18000,,
com.microsoft.Excel,13,1725847622,1725847635,1725847636.2335448,-18000,,
com.google.Chrome,70,1725847552,1725847622,1725847622.296035,-18000,,
com.apple.finder,28,1725847524,1725847552,1725847552.8853722,-18000,,
com.apple.archiveutility,0,1725847524,1725847524,1725847524.9153662,-18000,,
com.apple.finder,9,1725847515,1725847524,1725847524.311907,-18000,,
com.google.Chrome,74,1725847441,1725847515,1725847515.457168,-18000,,
com.apple.finder,23,1725847418,1725847441,1725847441.83008,-18000,,
com.google.Chrome,1215,1725846203,1725847418,1725847418.5647411,-18000,,
com.google.Chrome,7,1725846162,1725846169,1725846169.224849,-18000,,
com.leomehlig.today,5,1725846157,1725846162,1725846164.5943131,-18000,,
com.google.chrome.ios,43,1725846095,1725846138,1725846138.7764301,-18000,EB445137-D7F5-57EC-87DA-1DB460D64046,"iPhone13,2"
com.apple.Health,3,1725846085,1725846088,1725846088.802393,-18000,EB445137-D7F5-57EC-87DA-1DB460D64046,"iPhone13,2"
com.apple.Health,2,1725845976,1725845978,1725845978.615138,-18000,EB445137-D7F5-57EC-87DA-1DB460D64046,"iPhone13,2"
com.apple.Health,3,1725845973,1725845976,1725845976.259315,-18000,EB445137-D7F5-57EC-87DA-1DB460D64046,"iPhone13,2"
com.apple.Health,6,1725845724,1725845730,1725845730.3561301,-18000,EB445137-D7F5-57EC-87DA-1DB460D64046,"iPhone13,2"
com.apple.Health,50,1725845673,1725845723,1725845723.4012508,-18000,EB445137-D7F5-57EC-87DA-1DB460D64046,"iPhone13,2"
com.myfitnesspal.mfp,2,1725845671,1725845673,1725845673.621216,-18000,EB445137-D7F5-57EC-87DA-1DB460D64046,"iPhone13,2"
com.myfitnesspal.mfp,2,1725845514,1725845516,1725845516.3918982,-18000,EB445137-D7F5-57EC-87DA-1DB460D64046,"iPhone13,2"
com.myfitnesspal.mfp,4,1725844919,1725844923,1725844924.0423179,-18000,EB445137-D7F5-57EC-87DA-1DB460D64046,"iPhone13,2"
com.myfitnesspal.mfp,19,1725844863,1725844882,1725844883.061235,-18000,EB445137-D7F5-57EC-87DA-1DB460D64046,"iPhone13,2"
com.apple.Music,2,1725844860,1725844862,1725844862.9438992,-18000,EB445137-D7F5-57EC-87DA-1DB460D64046,"iPhone13,2"
com.apple.Music,12,1725844782,1725844794,1725844794.664524,-18000,EB445137-D7F5-57EC-87DA-1DB460D64046,"iPhone13,2"
com.apple.MobileSMS,8,1725844767,1725844775,1725844775.692847,-18000,EB445137-D7F5-57EC-87DA-1DB460D64046,"iPhone13,2"
com.apple.MobileSMS,8,1725844758,1725844766,1725844766.35494,-18000,EB445137-D7F5-57EC-87DA-1DB460D64046,"iPhone13,2"
com.apple.MobileSMS,2,1725844727,1725844729,1725844729.328954,-18000,EB445137-D7F5-57EC-87DA-1DB460D64046,"iPhone13,2"
com.apple.MobileSMS,2,1725844711,1725844713,1725844713.2310119,-18000,EB445137-D7F5-57EC-87DA-1DB460D64046,"iPhone13,2"
com.apple.MobileSMS,3,1725844708,1725844711,1725844711.1244888,-18000,EB445137-D7F5-57EC-87DA-1DB460D64046,"iPhone13,2"
com.apple.MobileSMS,2,1725844551,1725844553,1725844553.747622,-18000,EB445137-D7F5-57EC-87DA-1DB460D64046,"iPhone13,2"
com.apple.camera,0,1725844533,1725844533,1725844533.702579,-18000,EB445137-D7F5-57EC-87DA-1DB460D64046,"iPhone13,2"
com.apple.MobileSMS,20,1725844530,1725844550,1725844550.6742,-18000,EB445137-D7F5-57EC-87DA-1DB460D64046,"iPhone13,2"
com.apple.MobileSMS,3,1725844492,1725844495,1725844495.3633971,-18000,EB445137-D7F5-57EC-87DA-1DB460D64046,"iPhone13,2"
com.leomehlig.today,83,1725844409,1725844492,1725844492.184938,-18000,,
com.google.Chrome,110,1725844299,1725844409,1725844409.439416,-18000,,
com.leomehlig.today,18,1725844281,1725844299,1725844299.5493422,-18000,,
com.google.Chrome,490,1725843791,1725844281,1725844281.198317,-18000,,
com.leomehlig.today,9,1725843782,1725843791,1725843792.0401359,-18000,,
com.apple.MobileSMS,12,1725843027,1725843039,1725843039.605891,-18000,EB445137-D7F5-57EC-87DA-1DB460D64046,"iPhone13,2"
com.apple.MobileSMS,12,1725839895,1725839907,1725839907.16429,-18000,EB445137-D7F5-57EC-87DA-1DB460D64046,"iPhone13,2"
com.google.Chrome,5501,1725838281,1725843782,1725843782.66017,-18000,,
com.leomehlig.today,16,1725838265,1725838281,1725838281.850002,-18000,,
com.apple.MobileSMS,10,1725838093,1725838103,1725838103.5641298,-18000,EB445137-D7F5-57EC-87DA-1DB460D64046,"iPhone13,2"
com.google.Chrome,262,1725838003,1725838265,1725838265.558487,-18000,,
com.apple.finder,3,1725838000,1725838003,1725838003.770462,-18000,,
com.apple.camera,83,1725837975,1725838058,1725838058.800267,-18000,EB445137-D7F5-57EC-87DA-1DB460D64046,"iPhone13,2"
com.apple.MobileSMS,85,1725837973,1725838058,1725838058.795599,-18000,EB445137-D7F5-57EC-87DA-1DB460D64046,"iPhone13,2"
com.apple.MobileSMS,0,1725837973,1725837973,1725837973.857343,-18000,EB445137-D7F5-57EC-87DA-1DB460D64046,"iPhone13,2"
com.google.Chrome,1423,1725836577,1725838000,1725838001.025134,-18000,,
com.leomehlig.today,16,1725836558,1725836574,1725836574.3342109,-18000,,
com.google.Chrome,22,1725836536,1725836558,1725836559.144362,-18000,,
com.apple.MobileSMS,13,1725836339,1725836352,1725836352.1983151,-18000,EB445137-D7F5-57EC-87DA-1DB460D64046,"iPhone13,2"
com.apple.Maps,9,1725836330,1725836339,1725836339.769483,-18000,EB445137-D7F5-57EC-87DA-1DB460D64046,"iPhone13,2"
com.apple.Maps,8,1725836241,1725836249,1725836249.155867,-18000,EB445137-D7F5-57EC-87DA-1DB460D64046,"iPhone13,2"
com.apple.Maps,3,1725836238,1725836241,1725836241.184894,-18000,EB445137-D7F5-57EC-87DA-1DB460D64046,"iPhone13,2"
com.apple.mobilecal,72,1725836165,1725836237,1725836237.154869,-18000,EB445137-D7F5-57EC-87DA-1DB460D64046,"iPhone13,2"
com.apple.mobilecal,22,1725836127,1725836149,1725836149.756386,-18000,EB445137-D7F5-57EC-87DA-1DB460D64046,"iPhone13,2"
com.apple.Maps,3,1725836122,1725836125,1725836125.079689,-18000,EB445137-D7F5-57EC-87DA-1DB460D64046,"iPhone13,2"
com.apple.Maps,31,1725836077,1725836108,1725836108.372639,-18000,EB445137-D7F5-57EC-87DA-1DB460D64046,"iPhone13,2"
com.apple.MobileSMS,4,1725836072,1725836076,1725836076.9125528,-18000,EB445137-D7F5-57EC-87DA-1DB460D64046,"iPhone13,2"
com.apple.MobileSMS,6,1725835637,1725835643,1725835643.263911,-18000,EB445137-D7F5-57EC-87DA-1DB460D64046,"iPhone13,2"
com.apple.MobileSMS,5,1725835496,1725835501,1725835501.557096,-18000,EB445137-D7F5-57EC-87DA-1DB460D64046,"iPhone13,2"
com.apple.MobileSMS,2,1725835398,1725835400,1725835400.19122,-18000,EB445137-D7F5-57EC-87DA-1DB460D64046,"iPhone13,2"
com.apple.MobileSMS,4,1725835332,1725835336,1725835336.226799,-18000,EB445137-D7F5-57EC-87DA-1DB460D64046,"iPhone13,2"
com.apple.MobileSMS,59,1725835252,1725835311,1725835312.0148249,-18000,EB445137-D7F5-57EC-87DA-1DB460D64046,"iPhone13,2"
com.apple.MobileSMS,17,1725835115,1725835132,1725835132.722717,-18000,EB445137-D7F5-57EC-87DA-1DB460D64046,"iPhone13,2"
com.myfitnesspal.mfp,6,1725835107,1725835113,1725835114.130577,-18000,EB445137-D7F5-57EC-87DA-1DB460D64046,"iPhone13,2"
com.myfitnesspal.mfp,1,1725834877,1725834878,1725834878.853863,-18000,EB445137-D7F5-57EC-87DA-1DB460D64046,"iPhone13,2"
com.myfitnesspal.mfp,86,1725834433,1725834519,1725834520.014816,-18000,EB445137-D7F5-57EC-87DA-1DB460D64046,"iPhone13,2"
com.google.chrome.ios,3,1725834430,1725834433,1725834433.947698,-18000,EB445137-D7F5-57EC-87DA-1DB460D64046,"iPhone13,2"
com.google.chrome.ios,10,1725834343,1725834353,1725834353.5915298,-18000,EB445137-D7F5-57EC-87DA-1DB460D64046,"iPhone13,2"
com.myfitnesspal.mfp,2,1725834341,1725834343,1725834343.340605,-18000,EB445137-D7F5-57EC-87DA-1DB460D64046,"iPhone13,2"
com.myfitnesspal.mfp,3,1725833478,1725833481,1725833481.282866,-18000,EB445137-D7F5-57EC-87DA-1DB460D64046,"iPhone13,2"
com.google.Chrome,464,1725833312,1725833776,1725833776.2138638,-18000,,
com.leomehlig.today,18,1725833275,1725833293,1725833293.299859,-18000,,
com.myfitnesspal.mfp,14,1725833254,1725833268,1725833269.00452,-18000,EB445137-D7F5-57EC-87DA-1DB460D64046,"iPhone13,2"
com.myfitnesspal.mfp,4,1725833159,1725833163,1725833163.376802,-18000,EB445137-D7F5-57EC-87DA-1DB460D64046,"iPhone13,2"
com.myfitnesspal.mfp,8,1725833078,1725833086,1725833086.242801,-18000,EB445137-D7F5-57EC-87DA-1DB460D64046,"iPhone13,2"
com.apple.Notes,466,1725832809,1725833275,1725833275.751062,-18000,,
com.leomehlig.today,5,1725832804,1725832809,1725832809.379477,-18000,,
com.myfitnesspal.mfp,6,1725832800,1725832806,1725832806.370699,-18000,EB445137-D7F5-57EC-87DA-1DB460D64046,"iPhone13,2"
com.myfitnesspal.mfp,447,1725832346,1725832793,1725832793.7782059,-18000,EB445137-D7F5-57EC-87DA-1DB460D64046,"iPhone13,2"
com.apple.mobiletimer,2,1725832342,1725832344,1725832344.444343,-18000,EB445137-D7F5-57EC-87DA-1DB460D64046,"iPhone13,2"
com.apple.mobiletimer,6,1725832296,1725832302,1725832302.7935538,-18000,EB445137-D7F5-57EC-87DA-1DB460D64046,"iPhone13,2"
com.google.Chrome,520,1725832284,1725832804,1725832804.665681,-18000,,
com.google.Chrome,5,1725832230,1725832235,1725832235.619203,-18000,,
com.apple.mobiletimer,3,1725831875,1725831878,1725831878.688014,-18000,EB445137-D7F5-57EC-87DA-1DB460D64046,"iPhone13,2"
com.google.Chrome,310,1725831836,1725832146,1725832146.543645,-18000,,
com.google.Chrome,1012,1725830395,1725831407,1725831407.433012,-18000,,
com.apple.mobileslideshow,23,1725830051,1725830074,1725830075.133883,-18000,EB445137-D7F5-57EC-87DA-1DB460D64046,"iPhone13,2"
com.google.chrome.ios,2,1725830047,1725830049,1725830049.6482549,-18000,EB445137-D7F5-57EC-87DA-1DB460D64046,"iPhone13,2"
com.google.chrome.ios,97,1725829411,1725829508,1725829509.1077142,-18000,EB445137-D7F5-57EC-87DA-1DB460D64046,"iPhone13,2"
com.apple.Maps,3,1725829407,1725829410,1725829410.528074,-18000,EB445137-D7F5-57EC-87DA-1DB460D64046,"iPhone13,2"
com.apple.Maps,196,1725828684,1725828880,1725828880.1536012,-18000,EB445137-D7F5-57EC-87DA-1DB460D64046,"iPhone13,2"
com.apple.Music,5,1725828679,1725828684,1725828684.172023,-18000,EB445137-D7F5-57EC-87DA-1DB460D64046,"iPhone13,2"
com.apple.Music,9,1725828203,1725828212,1725828212.791407,-18000,EB445137-D7F5-57EC-87DA-1DB460D64046,"iPhone13,2"
com.apple.Music,8,1725828183,1725828191,1725828191.554491,-18000,EB445137-D7F5-57EC-87DA-1DB460D64046,"iPhone13,2"
com.apple.Music,10,1725828170,1725828180,1725828180.503512,-18000,EB445137-D7F5-57EC-87DA-1DB460D64046,"iPhone13,2"
com.apple.Music,33,1725828131,1725828164,1725828165.112184,-18000,EB445137-D7F5-57EC-87DA-1DB460D64046,"iPhone13,2"
com.google.chrome.ios,4,1725828126,1725828130,1725828130.6578221,-18000,EB445137-D7F5-57EC-87DA-1DB460D64046,"iPhone13,2"
com.google.chrome.ios,12,1725828071,1725828083,1725828083.158179,-18000,EB445137-D7F5-57EC-87DA-1DB460D64046,"iPhone13,2"
com.google.Chrome,2,1725827903,1725827905,1725827905.120398,-18000,,
com.google.chrome.ios,247,1725827764,1725828011,1725828011.807559,-18000,EB445137-D7F5-57EC-87DA-1DB460D64046,"iPhone13,2"
com.apple.Maps,4,1725827760,1725827764,1725827764.3915029,-18000,EB445137-D7F5-57EC-87DA-1DB460D64046,"iPhone13,2"
com.apple.Maps,2,1725827735,1725827737,1725827737.992581,-18000,EB445137-D7F5-57EC-87DA-1DB460D64046,"iPhone13,2"
com.apple.Maps,99,1725827523,1725827622,1725827622.3699632,-18000,EB445137-D7F5-57EC-87DA-1DB460D64046,"iPhone13,2"
com.apple.news,5,1725827514,1725827519,1725827519.066228,-18000,EB445137-D7F5-57EC-87DA-1DB460D64046,"iPhone13,2"
com.google.Chrome,258,1725827401,1725827659,1725827659.3606539,-18000,,
com.apple.iCal,8,1725827378,1725827386,1725827386.454029,-18000,,
com.google.Chrome,4,1725827374,1725827378,1725827378.7590818,-18000,,
com.google.Chrome,690,1725826534,1725827224,1725827224.2963428,-18000,,
com.leomehlig.today,4,1725826530,1725826534,1725826535.326781,-18000,,
com.apple.news,11,1725826386,1725826397,1725826397.8389912,-18000,EB445137-D7F5-57EC-87DA-1DB460D64046,"iPhone13,2"
com.google.ios.youtube,197,1725826176,1725826373,1725826373.894661,-18000,EB445137-D7F5-57EC-87DA-1DB460D64046,"iPhone13,2"
com.apple.weather,4,1725826169,1725826173,1725826173.521574,-18000,EB445137-D7F5-57EC-87DA-1DB460D64046,"iPhone13,2"
com.leomehlig.today,43,1725826104,1725826147,1725826147.775793,-18000,,
com.apple.Notes,6,1725826098,1725826104,1725826104.876549,-18000,,
com.leomehlig.today,2,1725826096,1725826098,1725826098.263825,-18000,,
com.google.Chrome,5,1725826091,1725826096,1725826096.624244,-18000,,
com.apple.weather,12,1725826076,1725826088,1725826088.571971,-18000,EB445137-D7F5-57EC-87DA-1DB460D64046,"iPhone13,2"
com.google.chrome.ios,18,1725826025,1725826043,1725826043.857809,-18000,EB445137-D7F5-57EC-87DA-1DB460D64046,"iPhone13,2"
com.google.ios.youtube,734,1725825291,1725826025,1725826025.665705,-18000,EB445137-D7F5-57EC-87DA-1DB460D64046,"iPhone13,2"
com.myfitnesspal.mfp,10,1725825269,1725825279,1725825279.932471,-18000,EB445137-D7F5-57EC-87DA-1DB460D64046,"iPhone13,2"
com.myfitnesspal.mfp,15,1725825170,1725825185,1725825185.551941,-18000,EB445137-D7F5-57EC-87DA-1DB460D64046,"iPhone13,2"
com.google.Chrome,469,1725825098,1725825567,1725825567.1757731,-18000,,
com.myfitnesspal.mfp,189,1725824961,1725825150,1725825150.8851252,-18000,EB445137-D7F5-57EC-87DA-1DB460D64046,"iPhone13,2"
com.apple.Health,40,1725824921,1725824961,1725824961.146414,-18000,EB445137-D7F5-57EC-87DA-1DB460D64046,"iPhone13,2"
com.leomehlig.today,216,1725824882,1725825098,1725825098.1316528,-18000,,
com.google.Chrome,122,1725824760,1725824882,1725824882.8672981,-18000,,
com.leomehlig.today,247,1725824492,1725824739,1725824739.082952,-18000,,
com.apple.Notes,14,1725824478,1725824492,1725824492.2721891,-18000,,
com.toyopagroup.picaboo,5,1725816577,1725816582,1725816582.139468,-18000,EB445137-D7F5-57EC-87DA-1DB460D64046,"iPhone13,2"
com.toyopagroup.picaboo,5,1725816530,1725816535,1725816535.903903,-18000,EB445137-D7F5-57EC-87DA-1DB460D64046,"iPhone13,2"
com.toyopagroup.picaboo,9,1725816256,1725816265,1725816265.191512,-18000,EB445137-D7F5-57EC-87DA-1DB460D64046,"iPhone13,2"
com.toyopagroup.picaboo,2,1725816251,1725816253,1725816253.38379,-18000,EB445137-D7F5-57EC-87DA-1DB460D64046,"iPhone13,2"
com.google.ios.youtube,3,1725816248,1725816251,1725816252.19374,-18000,EB445137-D7F5-57EC-87DA-1DB460D64046,"iPhone13,2"
com.google.ios.youtube,4,1725816055,1725816059,1725816060.006792,-18000,EB445137-D7F5-57EC-87DA-1DB460D64046,"iPhone13,2"
com.google.ios.youtube,437,1725815391,1725815828,1725815829.052,-18000,EB445137-D7F5-57EC-87DA-1DB460D64046,"iPhone13,2"
com.apple.camera,2,1725814329,1725814331,1725814332.2107391,-18000,EB445137-D7F5-57EC-87DA-1DB460D64046,"iPhone13,2"
com.renpho.health,3,1725813382,1725813385,1725813385.668769,-18000,EB445137-D7F5-57EC-87DA-1DB460D64046,"iPhone13,2"
com.renpho.health,20,1725813324,1725813344,1725813344.1270308,-18000,EB445137-D7F5-57EC-87DA-1DB460D64046,"iPhone13,2"
com.toyopagroup.picaboo,14,1725812560,1725812574,1725812574.800704,-18000,EB445137-D7F5-57EC-87DA-1DB460D64046,"iPhone13,2"
com.apple.news,1209,1725811351,1725812560,1725812560.501914,-18000,EB445137-D7F5-57EC-87DA-1DB460D64046,"iPhone13,2"
com.truebill.truebillnative,89,1725811243,1725811332,1725811332.29604,-18000,EB445137-D7F5-57EC-87DA-1DB460D64046,"iPhone13,2"
com.myfitnesspal.mfp,68,1725811157,1725811225,1725811225.316938,-18000,EB445137-D7F5-57EC-87DA-1DB460D64046,"iPhone13,2"
com.apple.mobileslideshow,81,1725811053,1725811134,1725811134.476493,-18000,EB445137-D7F5-57EC-87DA-1DB460D64046,"iPhone13,2"
com.microsoft.Office.Outlook,17,1725811036,1725811053,1725811053.448093,-18000,EB445137-D7F5-57EC-87DA-1DB460D64046,"iPhone13,2"
com.microsoft.Office.Outlook,13,1725810996,1725811009,1725811009.166657,-18000,EB445137-D7F5-57EC-87DA-1DB460D64046,"iPhone13,2"
com.microsoft.Office.Outlook,2,1725810992,1725810994,1725810994.020869,-18000,EB445137-D7F5-57EC-87DA-1DB460D64046,"iPhone13,2"
com.microsoft.Office.Outlook,66,1725810908,1725810974,1725810974.232534,-18000,EB445137-D7F5-57EC-87DA-1DB460D64046,"iPhone13,2"
com.apple.mobiletimer,24,1725810884,1725810908,1725810909.088279,-18000,EB445137-D7F5-57EC-87DA-1DB460D64046,"iPhone13,2"
com.apple.mobiletimer,3,1725810828,1725810831,1725810831.62321,-18000,EB445137-D7F5-57EC-87DA-1DB460D64046,"iPhone13,2"
com.apple.mobiletimer,20,1725806004,1725806024,1725806024.412806,-18000,EB445137-D7F5-57EC-87DA-1DB460D64046,"iPhone13,2"
com.apple.mobiletimer,21,1725805453,1725805474,1725805474.053365,-18000,EB445137-D7F5-57EC-87DA-1DB460D64046,"iPhone13,2"
com.apple.mobiletimer,23,1725804900,1725804923,1725804923.747827,-18000,EB445137-D7F5-57EC-87DA-1DB460D64046,"iPhone13,2"
com.apple.mobiletimer,13,1725775256,1725775269,1725775269.340533,-18000,EB445137-D7F5-57EC-87DA-1DB460D64046,"iPhone13,2"
com.apple.mobiletimer,7,1725775247,1725775254,1725775254.589263,-18000,EB445137-D7F5-57EC-87DA-1DB460D64046,"iPhone13,2"
com.hammerandchisel.discord,20,1725774694,1725774714,1725774714.159224,-18000,EB445137-D7F5-57EC-87DA-1DB460D64046,"iPhone13,2"
com.hammerandchisel.discord,3,1725772387,1725772390,1725772390.0545568,-18000,EB445137-D7F5-57EC-87DA-1DB460D64046,"iPhone13,2"
com.hammerandchisel.discord,68,1725772299,1725772367,1725772367.470804,-18000,EB445137-D7F5-57EC-87DA-1DB460D64046,"iPhone13,2"
com.letterboxd.LetterboxdApp,106,1725770215,1725770321,1725770321.7615762,-18000,EB445137-D7F5-57EC-87DA-1DB460D64046,"iPhone13,2"
com.apple.MobileSMS,44,1725770171,1725770215,1725770215.3897629,-18000,EB445137-D7F5-57EC-87DA-1DB460D64046,"iPhone13,2"
com.letterboxd.LetterboxdApp,136,1725770035,1725770171,1725770171.686228,-18000,EB445137-D7F5-57EC-87DA-1DB460D64046,"iPhone13,2"
com.apple.news,56,1725769968,1725770024,1725770025.00032,-18000,EB445137-D7F5-57EC-87DA-1DB460D64046,"iPhone13,2"
com.apple.camera,1,1725769604,1725769605,1725769605.540392,-18000,EB445137-D7F5-57EC-87DA-1DB460D64046,"iPhone13,2"
com.apple.camera,1,1725769602,1725769603,1725769603.016024,-18000,EB445137-D7F5-57EC-87DA-1DB460D64046,"iPhone13,2"
com.apple.MobileSMS,9,1725769579,1725769588,1725769588.453275,-18000,EB445137-D7F5-57EC-87DA-1DB460D64046,"iPhone13,2"
com.apple.MobileSMS,14,1725767917,1725767931,1725767931.81961,-18000,EB445137-D7F5-57EC-87DA-1DB460D64046,"iPhone13,2"
com.apple.MobileSMS,10,1725767874,1725767884,1725767884.6626801,-18000,EB445137-D7F5-57EC-87DA-1DB460D64046,"iPhone13,2"
com.myfitnesspal.mfp,7,1725767867,1725767874,1725767876.6853251,-18000,EB445137-D7F5-57EC-87DA-1DB460D64046,"iPhone13,2"
com.myfitnesspal.mfp,55,1725766869,1725766924,1725766924.81817,-18000,EB445137-D7F5-57EC-87DA-1DB460D64046,"iPhone13,2"
com.google.chrome.ios,38,1725766050,1725766088,1725766088.592726,-18000,EB445137-D7F5-57EC-87DA-1DB460D64046,"iPhone13,2"
com.apple.MobileSMS,4,1725766045,1725766049,1725766049.844118,-18000,EB445137-D7F5-57EC-87DA-1DB460D64046,"iPhone13,2"
com.apple.MobileSMS,13,1725764780,1725764793,1725764793.053752,-18000,EB445137-D7F5-57EC-87DA-1DB460D64046,"iPhone13,2"
com.apple.MobileSMS,52,1725764195,1725764247,1725764247.665909,-18000,EB445137-D7F5-57EC-87DA-1DB460D64046,"iPhone13,2"
com.toyopagroup.picaboo,27,1725764168,1725764195,1725764195.65949,-18000,EB445137-D7F5-57EC-87DA-1DB460D64046,"iPhone13,2"
com.apple.MobileSMS,4,1725764092,1725764096,1725764096.9455771,-18000,EB445137-D7F5-57EC-87DA-1DB460D64046,"iPhone13,2"
com.apple.MobileSMS,17,1725764074,1725764091,1725764091.20806,-18000,EB445137-D7F5-57EC-87DA-1DB460D64046,"iPhone13,2"
com.apple.MobileSMS,4,1725763068,1725763072,1725763072.5777612,-18000,EB445137-D7F5-57EC-87DA-1DB460D64046,"iPhone13,2"
com.apple.MobileSMS,13,1725762896,1725762909,1725762909.2698212,-18000,EB445137-D7F5-57EC-87DA-1DB460D64046,"iPhone13,2"
com.toyopagroup.picaboo,21,1725761220,1725761241,1725761241.585853,-18000,EB445137-D7F5-57EC-87DA-1DB460D64046,"iPhone13,2"
com.myfitnesspal.mfp,3,1725761217,1725761220,1725761220.8934422,-18000,EB445137-D7F5-57EC-87DA-1DB460D64046,"iPhone13,2"
com.myfitnesspal.mfp,3,1725760903,1725760906,1725760906.193078,-18000,EB445137-D7F5-57EC-87DA-1DB460D64046,"iPhone13,2"
com.myfitnesspal.mfp,14,1725760237,1725760251,1725760252.346373,-18000,EB445137-D7F5-57EC-87DA-1DB460D64046,"iPhone13,2"
com.myfitnesspal.mfp,49,1725752968,1725753017,1725753017.191969,-18000,EB445137-D7F5-57EC-87DA-1DB460D64046,"iPhone13,2"
com.google.chrome.ios,3,1725752965,1725752968,1725752968.485021,-18000,EB445137-D7F5-57EC-87DA-1DB460D64046,"iPhone13,2"
com.google.chrome.ios,18,1725752699,1725752717,1725752717.325194,-18000,EB445137-D7F5-57EC-87DA-1DB460D64046,"iPhone13,2"
com.myfitnesspal.mfp,3,1725752696,1725752699,1725752699.3168712,-18000,EB445137-D7F5-57EC-87DA-1DB460D64046,"iPhone13,2"
com.myfitnesspal.mfp,29,1725752055,1725752084,1725752084.8996801,-18000,EB445137-D7F5-57EC-87DA-1DB460D64046,"iPhone13,2"
com.toyopagroup.picaboo,9,1725751922,1725751931,1725751931.573842,-18000,EB445137-D7F5-57EC-87DA-1DB460D64046,"iPhone13,2"
com.myfitnesspal.mfp,8,1725751853,1725751861,1725751861.210141,-18000,EB445137-D7F5-57EC-87DA-1DB460D64046,"iPhone13,2"
com.apple.news,4,1725751849,1725751853,1725751853.7158961,-18000,EB445137-D7F5-57EC-87DA-1DB460D64046,"iPhone13,2"
com.apple.Notes,105,1725738847,1725738952,1725738952.037601,-18000,,
com.google.Chrome,155,1725738692,1725738847,1725738847.994426,-18000,,
com.apple.Notes,43,1725738649,1725738692,1725738692.993163,-18000,,
com.leomehlig.today,10,1725738639,1725738649,1725738649.864713,-18000,,
com.leomehlig.today,134,1725736880,1725737014,1725737014.1281981,-18000,,
com.google.Chrome,39,1725736841,1725736880,1725736880.183289,-18000,,
com.leomehlig.today,30,1725736797,1725736827,1725736827.609277,-18000,,
com.google.Chrome,1,1725736796,1725736797,1725736797.1625729,-18000,,
com.apple.finder,19,1725736777,1725736796,1725736796.122128,-18000,,
com.google.Chrome,19,1725736758,1725736777,1725736778.000093,-18000,,
com.leomehlig.today,49,1725736709,1725736758,1725736758.950965,-18000,,
com.google.Chrome,556,1725736153,1725736709,1725736709.566424,-18000,,
com.apple.mail,1,1725736152,1725736153,1725736153.873207,-18000,,
com.google.Chrome,154,1725735998,1725736152,1725736152.5082169,-18000,,
com.apple.mail,2,1725735996,1725735998,1725735998.745358,-18000,,
com.google.Chrome,1453,1725734543,1725735996,1725735996.992198,-18000,,
com.leomehlig.today,114,1725734429,1725734543,1725734544.019878,-18000,,
com.google.Chrome,760,1725733669,1725734429,1725734429.521038,-18000,,
com.google.Chrome,2444,1725731088,1725733532,1725733532.844142,-18000,,
com.leomehlig.today,27,1725731028,1725731055,1725731055.080246,-18000,,
com.google.Chrome,575,1725730453,1725731028,1725731028.870177,-18000,,
com.leomehlig.today,41,1725730412,1725730453,1725730453.561781,-18000,,
com.google.Chrome,1245,1725729167,1725730412,1725730412.7140598,-18000,,
com.apple.finder,5,1725729162,1725729167,1725729167.634224,-18000,,
com.google.Chrome,130,1725729032,1725729162,1725729162.748904,-18000,,
com.apple.finder,52,1725728969,1725729021,1725729021.100181,-18000,,
com.google.Chrome,19,1725728950,1725728969,1725728969.528934,-18000,,
com.apple.finder,6,1725728944,1725728950,1725728950.576962,-18000,,
com.google.Chrome,8,1725728936,1725728944,1725728945.102778,-18000,,
com.apple.finder,6,1725728930,1725728936,1725728936.70456,-18000,,
com.google.Chrome,235,1725728695,1725728930,1725728930.402087,-18000,,
com.leomehlig.today,56,1725728639,1725728695,1725728695.235095,-18000,,
com.leomehlig.today,52,1725724928,1725724980,1725724980.3765311,-18000,,
com.google.Chrome,16,1725724912,1725724928,1725724928.685581,-18000,,
com.leomehlig.today,23,1725724889,1725724912,1725724912.36128,-18000,,
com.google.Chrome,111,1725724778,1725724889,1725724889.0767112,-18000,,
com.leomehlig.today,3,1725724749,1725724752,1725724752.784569,-18000,,
com.google.Chrome,13,1725724736,1725724749,1725724749.810409,-18000,,
com.leomehlig.today,105,1725724631,1725724736,1725724736.9275,-18000,,
com.google.Chrome,1,1725724630,1725724631,1725724631.988978,-18000,,
com.apple.Preview,0,1725724630,1725724630,1725724630.8730512,-18000,,
com.google.Chrome,1,1725724629,1725724630,1725724630.101499,-18000,,
com.apple.Preview,1,1725724628,1725724629,1725724629.766005,-18000,,
com.google.Chrome,4,1725724624,1725724628,1725724628.755095,-18000,,
com.google.Chrome,5,1725689501,1725689506,1725689506.317285,-18000,,
com.google.Chrome,306,1725688629,1725688935,1725688935.365703,-18000,,
com.google.Chrome,302,1725688225,1725688527,1725688527.875634,-18000,,
com.google.Chrome,583,1725686708,1725687291,1725687291.429003,-18000,,
com.apple.Preview,4,1725686704,1725686708,1725686708.976231,-18000,,
com.apple.Preview,4,1725667807,1725667811,1725667811.3772678,-18000,,
com.google.Chrome,3,1725667804,1725667807,1725667807.851968,-18000,,
com.google.Chrome,16,1725667787,1725667803,1725667803.057409,-18000,,
com.apple.Preview,32,1725667755,1725667787,1725667787.133091,-18000,,
com.apple.finder,7,1725667748,1725667755,1725667755.519185,-18000,,
com.leomehlig.today,2,1725667746,1725667748,1725667748.229972,-18000,,
com.leomehlig.today,25,1725655973,1725655998,1725655998.670041,-18000,,
com.google.Chrome,53,1725655920,1725655973,1725655973.0743551,-18000,,
com.leomehlig.today,2,1725655888,1725655890,1725655890.270118,-18000,,
com.leomehlig.today,80,1725654079,1725654159,1725654160.021205,-18000,,
com.apple.finder,16,1725654063,1725654079,1725654079.822074,-18000,,
com.google.Chrome,2,1725654061,1725654063,1725654063.617918,-18000,,
com.leomehlig.today,2,1725654059,1725654061,1725654062.052907,-18000,,
com.microsoft.Word,1,1725654058,1725654059,1725654059.549883,-18000,,
com.leomehlig.today,27,1725654031,1725654058,1725654058.129798,-18000,,
com.google.Chrome,133,1725653898,1725654031,1725654032.01398,-18000,,
com.apple.systempreferences,3,1725653842,1725653845,1725653845.6654348,-18000,,
com.google.Chrome,975,1725652860,1725653835,1725653835.297564,-18000,,
com.google.Chrome,168,1725652616,1725652784,1725652784.607857,-18000,,
com.apple.camera,4,1725648129,1725648133,1725648134.598322,-18000,EB445137-D7F5-57EC-87DA-1DB460D64046,"iPhone13,2"
com.apple.MobileSMS,3,1725646875,1725646878,1725646878.381812,-18000,EB445137-D7F5-57EC-87DA-1DB460D64046,"iPhone13,2"
com.apple.MobileSMS,61,1725646176,1725646237,1725646237.874631,-18000,EB445137-D7F5-57EC-87DA-1DB460D64046,"iPhone13,2"
com.apple.MobileSMS,20,1725646155,1725646175,1725646175.1082659,-18000,EB445137-D7F5-57EC-87DA-1DB460D64046,"iPhone13,2"
com.apple.MobileSMS,31,1725646078,1725646109,1725646109.719455,-18000,EB445137-D7F5-57EC-87DA-1DB460D64046,"iPhone13,2"
com.apple.MobileSMS,102,1725645965,1725646067,1725646067.52169,-18000,EB445137-D7F5-57EC-87DA-1DB460D64046,"iPhone13,2"
com.apple.MobileSMS,9,1725645955,1725645964,1725645964.5822039,-18000,EB445137-D7F5-57EC-87DA-1DB460D64046,"iPhone13,2"
com.apple.MobileSMS,15,1725645937,1725645952,1725645952.976242,-18000,EB445137-D7F5-57EC-87DA-1DB460D64046,"iPhone13,2"
com.apple.MobileSMS,58,1725645876,1725645934,1725645934.577896,-18000,EB445137-D7F5-57EC-87DA-1DB460D64046,"iPhone13,2"
com.apple.MobileSMS,12,1725645836,1725645848,1725645848.893399,-18000,EB445137-D7F5-57EC-87DA-1DB460D64046,"iPhone13,2"
com.apple.camera,4,1725645800,1725645804,1725645804.755997,-18000,EB445137-D7F5-57EC-87DA-1DB460D64046,"iPhone13,2"
com.apple.MobileSMS,5,1725645799,1725645804,1725645804.734333,-18000,EB445137-D7F5-57EC-87DA-1DB460D64046,"iPhone13,2"
com.apple.MobileSMS,12,1725645353,1725645365,1725645365.953341,-18000,EB445137-D7F5-57EC-87DA-1DB460D64046,"iPhone13,2"
com.apple.MobileSMS,11,1725645167,1725645178,1725645178.012957,-18000,EB445137-D7F5-57EC-87DA-1DB460D64046,"iPhone13,2"
com.apple.MobileSMS,10,1725645157,1725645167,1725645167.39634,-18000,EB445137-D7F5-57EC-87DA-1DB460D64046,"iPhone13,2"
com.apple.MobileSMS,9,1725644970,1725644979,1725644979.0688338,-18000,EB445137-D7F5-57EC-87DA-1DB460D64046,"iPhone13,2"
com.apple.MobileSMS,9,1725644751,1725644760,1725644760.634572,-18000,EB445137-D7F5-57EC-87DA-1DB460D64046,"iPhone13,2"
com.apple.MobileSMS,2,1725644608,1725644610,1725644610.246829,-18000,EB445137-D7F5-57EC-87DA-1DB460D64046,"iPhone13,2"
com.apple.MobileSMS,5,1725644378,1725644383,1725644383.942369,-18000,EB445137-D7F5-57EC-87DA-1DB460D64046,"iPhone13,2"
com.apple.MobileSMS,36,1725644340,1725644376,1725644376.2791162,-18000,EB445137-D7F5-57EC-87DA-1DB460D64046,"iPhone13,2"
com.toyopagroup.picaboo,6,1725644333,1725644339,1725644340.028724,-18000,EB445137-D7F5-57EC-87DA-1DB460D64046,"iPhone13,2"
com.google.chrome.ios,4,1725644327,1725644331,1725644331.835164,-18000,EB445137-D7F5-57EC-87DA-1DB460D64046,"iPhone13,2"
com.google.chrome.ios,11,1725643003,1725643014,1725643014.4479818,-18000,EB445137-D7F5-57EC-87DA-1DB460D64046,"iPhone13,2"
com.google.chrome.ios,26,1725642975,1725643001,1725643001.8190432,-18000,EB445137-D7F5-57EC-87DA-1DB460D64046,"iPhone13,2"
com.apple.camera,7,1725642967,1725642974,1725642975.494709,-18000,EB445137-D7F5-57EC-87DA-1DB460D64046,"iPhone13,2"
com.apple.camera,4,1725642474,1725642478,1725642479.175837,-18000,EB445137-D7F5-57EC-87DA-1DB460D64046,"iPhone13,2"
com.google.chrome.ios,4,1725642473,1725642477,1725642478.1695352,-18000,EB445137-D7F5-57EC-87DA-1DB460D64046,"iPhone13,2"
com.apple.camera,6,1725642453,1725642459,1725642459.593453,-18000,EB445137-D7F5-57EC-87DA-1DB460D64046,"iPhone13,2"
com.google.chrome.ios,7,1725642452,1725642459,1725642459.5969129,-18000,EB445137-D7F5-57EC-87DA-1DB460D64046,"iPhone13,2"
com.google.Chrome,327,1725642288,1725642615,1725642615.160389,-18000,,
com.google.chrome.ios,1,1725642284,1725642285,1725642285.7600222,-18000,EB445137-D7F5-57EC-87DA-1DB460D64046,"iPhone13,2"
com.google.Maps,4,1725642045,1725642049,1725642049.190782,-18000,EB445137-D7F5-57EC-87DA-1DB460D64046,"iPhone13,2"
com.google.Chrome,436,1725641249,1725641685,1725641685.8443499,-18000,,
com.microsoft.Word,2,1725641247,1725641249,1725641249.7294822,-18000,,
com.microsoft.Word,6,1725640896,1725640902,1725640902.1437411,-18000,,
com.google.Maps,39,1725640801,1725640840,1725640840.07085,-18000,EB445137-D7F5-57EC-87DA-1DB460D64046,"iPhone13,2"
com.myfitnesspal.mfp,72,1725640729,1725640801,1725640801.4493341,-18000,EB445137-D7F5-57EC-87DA-1DB460D64046,"iPhone13,2"
com.microsoft.Word,314,1725640486,1725640800,1725640800.315401,-18000,,
com.leomehlig.today,39,1725640447,1725640486,1725640486.861143,-18000,,
com.google.Chrome,200,1725640247,1725640447,1725640447.4661899,-18000,,
com.google.chrome.ios,105,1725640124,1725640229,1725640229.434087,-18000,EB445137-D7F5-57EC-87DA-1DB460D64046,"iPhone13,2"
com.google.chrome.ios,16,1725640007,1725640023,1725640023.7113152,-18000,EB445137-D7F5-57EC-87DA-1DB460D64046,"iPhone13,2"
com.apple.news,66,1725639733,1725639799,1725639799.207848,-18000,EB445137-D7F5-57EC-87DA-1DB460D64046,"iPhone13,2"
com.apple.mobilecal,21,1725639690,1725639711,1725639711.749988,-18000,EB445137-D7F5-57EC-87DA-1DB460D64046,"iPhone13,2"
com.toyopagroup.picaboo,29,1725639652,1725639681,1725639682.114221,-18000,EB445137-D7F5-57EC-87DA-1DB460D64046,"iPhone13,2"
com.google.chrome.ios,4,1725639648,1725639652,1725639652.478977,-18000,EB445137-D7F5-57EC-87DA-1DB460D64046,"iPhone13,2"
com.google.Chrome,3,1725638711,1725638714,1725638714.867546,-18000,,
com.apple.Preview,26,1725638513,1725638539,1725638539.108702,-18000,,
com.apple.finder,0,1725638513,1725638513,1725638513.6643472,-18000,,
com.microsoft.Word,22,1725638491,1725638513,1725638513.308762,-18000,,
com.apple.finder,0,1725638491,1725638491,1725638492.019878,-18000,,
com.apple.Preview,31,1725638460,1725638491,1725638491.4035912,-18000,,
com.apple.finder,7,1725638453,1725638460,1725638460.2035189,-18000,,
com.google.Chrome,6,1725638447,1725638453,1725638453.264954,-18000,,
com.microsoft.Outlook,2,1725638445,1725638447,1725638447.949552,-18000,,
com.google.chrome.ios,6,1725638063,1725638069,1725638069.272459,-18000,EB445137-D7F5-57EC-87DA-1DB460D64046,"iPhone13,2"
com.microsoft.Outlook,73,1725634752,1725634825,1725634825.9740071,-18000,,
com.google.Chrome,46,1725634706,1725634752,1725634752.4584088,-18000,,
com.google.chrome.ios,19,1725634302,1725634321,1725634321.238692,-18000,EB445137-D7F5-57EC-87DA-1DB460D64046,"iPhone13,2"
com.google.chrome.ios,28,1725634271,1725634299,1725634300.009845,-18000,EB445137-D7F5-57EC-87DA-1DB460D64046,"iPhone13,2"
com.google.chrome.ios,79,1725634191,1725634270,1725634270.7382941,-18000,EB445137-D7F5-57EC-87DA-1DB460D64046,"iPhone13,2"
com.apple.camera,1,1725634188,1725634189,1725634189.9716802,-18000,EB445137-D7F5-57EC-87DA-1DB460D64046,"iPhone13,2"
com.apple.Health,65,1725633701,1725633766,1725633766.972176,-18000,EB445137-D7F5-57EC-87DA-1DB460D64046,"iPhone13,2"
com.myfitnesspal.mfp,5,1725633681,1725633686,1725633686.863272,-18000,EB445137-D7F5-57EC-87DA-1DB460D64046,"iPhone13,2"
com.google.Chrome,7,1725633675,1725633682,1725633682.7743149,-18000,,
com.leomehlig.today,1,1725633674,1725633675,1725633675.167978,-18000,,
com.microsoft.Word,2,1725633672,1725633674,1725633674.673042,-18000,,
com.leomehlig.today,10,1725633662,1725633672,1725633672.761743,-18000,,
com.google.Chrome,74,1725633588,1725633662,1725633662.612554,-18000,,
com.myfitnesspal.mfp,20,1725633525,1725633545,1725633545.827344,-18000,EB445137-D7F5-57EC-87DA-1DB460D64046,"iPhone13,2"
com.microsoft.Word,267,1725633321,1725633588,1725633588.9271479,-18000,,
com.apple.finder,5,1725633316,1725633321,1725633321.589186,-18000,,
com.leomehlig.today,2,1725633314,1725633316,1725633316.835882,-18000,,
com.renpho.health,22,1725632794,1725632816,1725632816.998661,-18000,EB445137-D7F5-57EC-87DA-1DB460D64046,"iPhone13,2"
com.apple.Health,58,1725631906,1725631964,1725631964.772526,-18000,EB445137-D7F5-57EC-87DA-1DB460D64046,"iPhone13,2"
com.apple.weather,34,1725631872,1725631906,1725631906.8875132,-18000,EB445137-D7F5-57EC-87DA-1DB460D64046,"iPhone13,2"
com.apple.mobiletimer,17,1725631818,1725631835,1725631835.378265,-18000,EB445137-D7F5-57EC-87DA-1DB460D64046,"iPhone13,2"
com.apple.Health,9,1725631809,1725631818,1725631818.4967918,-18000,EB445137-D7F5-57EC-87DA-1DB460D64046,"iPhone13,2"
com.apple.Health,84,1725631723,1725631807,1725631807.562101,-18000,EB445137-D7F5-57EC-87DA-1DB460D64046,"iPhone13,2"
com.apple.reminders,6,1725631713,1725631719,1725631719.62497,-18000,EB445137-D7F5-57EC-87DA-1DB460D64046,"iPhone13,2"
com.instructure.icanvas,16,1725631697,1725631713,1725631713.6941319,-18000,EB445137-D7F5-57EC-87DA-1DB460D64046,"iPhone13,2"
com.apple.mobiletimer,8,1725631689,1725631697,1725631697.566431,-18000,EB445137-D7F5-57EC-87DA-1DB460D64046,"iPhone13,2"
com.apple.mobiletimer,3,1725631608,1725631611,1725631611.237148,-18000,EB445137-D7F5-57EC-87DA-1DB460D64046,"iPhone13,2"
com.apple.mobiletimer,25,1725630000,1725630025,1725630026.0055242,-18000,EB445137-D7F5-57EC-87DA-1DB460D64046,"iPhone13,2"
com.apple.mobiletimer,13,1725598627,1725598640,1725598640.928349,-18000,EB445137-D7F5-57EC-87DA-1DB460D64046,"iPhone13,2"
com.apple.mobiletimer,10,1725598154,1725598164,1725598164.341658,-18000,EB445137-D7F5-57EC-87DA-1DB460D64046,"iPhone13,2"
com.apple.mobiletimer,13,1725598137,1725598150,1725598150.680567,-18000,EB445137-D7F5-57EC-87DA-1DB460D64046,"iPhone13,2"
com.thestorygraph.thestorygraph,7,1725598130,1725598137,1725598137.4331021,-18000,EB445137-D7F5-57EC-87DA-1DB460D64046,"iPhone13,2"
com.thestorygraph.thestorygraph,63,1725598058,1725598121,1725598121.2440271,-18000,EB445137-D7F5-57EC-87DA-1DB460D64046,"iPhone13,2"
com.apple.news,23,1725595053,1725595076,1725595076.43244,-18000,EB445137-D7F5-57EC-87DA-1DB460D64046,"iPhone13,2"
com.google.chrome.ios,6,1725595037,1725595043,1725595043.951912,-18000,EB445137-D7F5-57EC-87DA-1DB460D64046,"iPhone13,2"
com.apple.mobilecal,80,1725594957,1725595037,1725595037.995323,-18000,EB445137-D7F5-57EC-87DA-1DB460D64046,"iPhone13,2"
com.apple.weather,19,1725594933,1725594952,1725594952.834496,-18000,EB445137-D7F5-57EC-87DA-1DB460D64046,"iPhone13,2"
com.google.chrome.ios,64,1725594856,1725594920,1725594920.109951,-18000,EB445137-D7F5-57EC-87DA-1DB460D64046,"iPhone13,2"
com.google.chrome.ios,11,1725594829,1725594840,1725594840.421201,-18000,EB445137-D7F5-57EC-87DA-1DB460D64046,"iPhone13,2"
com.google.chrome.ios,2,1725594827,1725594829,1725594829.08892,-18000,EB445137-D7F5-57EC-87DA-1DB460D64046,"iPhone13,2"
com.google.chrome.ios,62,1725594741,1725594803,1725594803.340361,-18000,EB445137-D7F5-57EC-87DA-1DB460D64046,"iPhone13,2"
com.google.chrome.ios,4,1725594524,1725594528,1725594528.4280849,-18000,EB445137-D7F5-57EC-87DA-1DB460D64046,"iPhone13,2"
com.google.chrome.ios,2,1725594390,1725594392,1725594392.589329,-18000,EB445137-D7F5-57EC-87DA-1DB460D64046,"iPhone13,2"
com.google.chrome.ios,5,1725594379,1725594384,1725594384.256685,-18000,EB445137-D7F5-57EC-87DA-1DB460D64046,"iPhone13,2"
com.google.chrome.ios,14,1725594216,1725594230,1725594230.980371,-18000,EB445137-D7F5-57EC-87DA-1DB460D64046,"iPhone13,2"
com.google.chrome.ios,12,1725594071,1725594083,1725594083.2142549,-18000,EB445137-D7F5-57EC-87DA-1DB460D64046,"iPhone13,2"
com.google.chrome.ios,6,1725594065,1725594071,1725594071.062471,-18000,EB445137-D7F5-57EC-87DA-1DB460D64046,"iPhone13,2"
com.google.chrome.ios,5,1725593677,1725593682,1725593682.827365,-18000,EB445137-D7F5-57EC-87DA-1DB460D64046,"iPhone13,2"
com.google.chrome.ios,3,1725593403,1725593406,1725593406.43571,-18000,EB445137-D7F5-57EC-87DA-1DB460D64046,"iPhone13,2"
com.google.chrome.ios,6,1725593316,1725593322,1725593322.26845,-18000,EB445137-D7F5-57EC-87DA-1DB460D64046,"iPhone13,2"
com.google.chrome.ios,4,1725593188,1725593192,1725593192.053884,-18000,EB445137-D7F5-57EC-87DA-1DB460D64046,"iPhone13,2"
com.apple.camera,1,1725592869,1725592870,1725592870.497992,-18000,EB445137-D7F5-57EC-87DA-1DB460D64046,"iPhone13,2"
com.google.chrome.ios,20,1725592861,1725592881,1725592881.813568,-18000,EB445137-D7F5-57EC-87DA-1DB460D64046,"iPhone13,2"
com.google.chrome.ios,5,1725592372,1725592377,1725592377.736861,-18000,EB445137-D7F5-57EC-87DA-1DB460D64046,"iPhone13,2"
com.google.chrome.ios,2,1725592204,1725592206,1725592206.510824,-18000,EB445137-D7F5-57EC-87DA-1DB460D64046,"iPhone13,2"
com.google.chrome.ios,20,1725592012,1725592032,1725592032.6231441,-18000,EB445137-D7F5-57EC-87DA-1DB460D64046,"iPhone13,2"
com.google.chrome.ios,53,1725591591,1725591644,1725591644.923894,-18000,EB445137-D7F5-57EC-87DA-1DB460D64046,"iPhone13,2"
com.hammerandchisel.discord,97,1725591141,1725591238,1725591238.4101439,-18000,EB445137-D7F5-57EC-87DA-1DB460D64046,"iPhone13,2"
com.google.chrome.ios,8,1725591131,1725591139,1725591140.043472,-18000,EB445137-D7F5-57EC-87DA-1DB460D64046,"iPhone13,2"
com.google.chrome.ios,7,1725591104,1725591111,1725591111.7261229,-18000,EB445137-D7F5-57EC-87DA-1DB460D64046,"iPhone13,2"
com.google.chrome.ios,36,1725590054,1725590090,1725590090.8106809,-18000,EB445137-D7F5-57EC-87DA-1DB460D64046,"iPhone13,2"
com.apple.Health,2,1725590052,1725590054,1725590054.897015,-18000,EB445137-D7F5-57EC-87DA-1DB460D64046,"iPhone13,2"
com.apple.Health,33,1725589745,1725589778,1725589778.576044,-18000,EB445137-D7F5-57EC-87DA-1DB460D64046,"iPhone13,2"
com.apple.Music,3,1725589704,1725589707,1725589707.244993,-18000,EB445137-D7F5-57EC-87DA-1DB460D64046,"iPhone13,2"
com.apple.Music,2,1725589678,1725589680,1725589680.974366,-18000,EB445137-D7F5-57EC-87DA-1DB460D64046,"iPhone13,2"
com.apple.Music,8,1725588185,1725588193,1725588193.162169,-18000,EB445137-D7F5-57EC-87DA-1DB460D64046,"iPhone13,2"
com.apple.Music,6,1725587850,1725587856,1725587856.402485,-18000,EB445137-D7F5-57EC-87DA-1DB460D64046,"iPhone13,2"
com.apple.Music,3,1725587845,1725587848,1725587848.6869411,-18000,EB445137-D7F5-57EC-87DA-1DB460D64046,"iPhone13,2"
com.apple.Music,8,1725587349,1725587357,1725587357.365178,-18000,EB445137-D7F5-57EC-87DA-1DB460D64046,"iPhone13,2"
com.apple.Music,8,1725587339,1725587347,1725587347.396306,-18000,EB445137-D7F5-57EC-87DA-1DB460D64046,"iPhone13,2"
com.apple.Music,8,1725587327,1725587335,1725587335.4256,-18000,EB445137-D7F5-57EC-87DA-1DB460D64046,"iPhone13,2"
com.leomehlig.today,2,1725586929,1725586931,1725586931.394311,-18000,,
com.apple.finder,1,1725586928,1725586929,1725586929.578548,-18000,,
com.google.Chrome,10,1725586918,1725586928,1725586928.696188,-18000,,
com.apple.Photos,1,1725586917,1725586918,1725586918.8630838,-18000,,
com.apple.Notes,0,1725586917,1725586917,1725586917.492296,-18000,,
com.leomehlig.today,78,1725586839,1725586917,1725586917.164407,-18000,,
com.apple.iCal,11,1725586828,1725586839,1725586839.752664,-18000,,
com.leomehlig.today,39,1725586789,1725586828,1725586828.510287,-18000,,
com.apple.Notes,237,1725586552,1725586789,1725586789.4670439,-18000,,
com.apple.Notes,728,1725585642,1725586370,1725586370.376536,-18000,,
com.apple.Photos,10,1725585632,1725585642,1725585642.984385,-18000,,
com.apple.Notes,59,1725585573,1725585632,1725585632.0614119,-18000,,
com.google.Chrome,3,1725585570,1725585573,1725585573.141789,-18000,,
com.apple.Notes,19,1725585551,1725585570,1725585570.54312,-18000,,
com.google.Chrome,4,1725585547,1725585551,1725585551.327639,-18000,,
com.apple.Notes,47,1725585500,1725585547,1725585547.296354,-18000,,
com.google.Chrome,13,1725585487,1725585500,1725585500.231911,-18000,,
com.apple.Notes,6,1725585481,1725585487,1725585487.283396,-18000,,
com.google.Chrome,0,1725585481,1725585481,1725585481.855476,-18000,,
com.apple.Notes,8,1725585473,1725585481,1725585481.273862,-18000,,
com.google.Chrome,64,1725585409,1725585473,1725585473.970062,-18000,,
com.apple.Notes,2,1725585407,1725585409,1725585410.048716,-18000,,
com.google.Chrome,2,1725585405,1725585407,1725585407.324585,-18000,,
com.apple.Notes,11,1725585394,1725585405,1725585405.36279,-18000,,
com.google.Chrome,2,1725585392,1725585394,1725585394.119683,-18000,,
com.apple.Notes,5,1725585387,1725585392,1725585392.606322,-18000,,
com.google.Chrome,7,1725585380,1725585387,1725585387.217186,-18000,,
com.apple.Notes,8,1725585372,1725585380,1725585380.5090342,-18000,,
com.google.Chrome,14,1725585358,1725585372,1725585372.184906,-18000,,
com.apple.Notes,11,1725585347,1725585358,1725585359.011056,-18000,,
com.google.Chrome,113,1725585234,1725585347,1725585347.989949,-18000,,
com.apple.Notes,2,1725585232,1725585234,1725585234.909724,-18000,,
com.google.Chrome,7,1725585225,1725585232,1725585232.679064,-18000,,
com.apple.Notes,1,1725585224,1725585225,1725585225.949357,-18000,,
com.google.Chrome,1,1725585223,1725585224,1725585225.062409,-18000,,
com.apple.Notes,14,1725585209,1725585223,1725585223.367935,-18000,,
com.google.Chrome,9,1725585147,1725585156,1725585156.264018,-18000,,
com.apple.Notes,12,1725585027,1725585039,1725585039.988912,-18000,,
com.google.Chrome,5,1725585022,1725585027,1725585027.3519092,-18000,,
com.apple.Notes,7,1725585015,1725585022,1725585022.2731462,-18000,,
com.google.Chrome,1,1725585014,1725585015,1725585015.401711,-18000,,
com.apple.Notes,6,1725585008,1725585014,1725585014.5312529,-18000,,
com.google.Chrome,1,1725585007,1725585008,1725585008.876855,-18000,,
com.apple.Notes,5,1725585002,1725585007,1725585008.006085,-18000,,
com.google.Chrome,53,1725584949,1725585002,1725585002.9495502,-18000,,
com.apple.Notes,32,1725584917,1725584949,1725584949.677003,-18000,,
com.google.Chrome,0,1725584917,1725584917,1725584917.918031,-18000,,
com.apple.Notes,21,1725584896,1725584917,1725584917.310214,-18000,,
com.google.Chrome,131,1725584765,1725584896,1725584896.5161219,-18000,,
com.apple.Notes,19,1725584746,1725584765,1725584765.280066,-18000,,
com.google.Chrome,16,1725584730,1725584746,1725584746.573833,-18000,,
com.apple.Notes,1,1725584729,1725584730,1725584730.694525,-18000,,
com.google.Chrome,5,1725584724,1725584729,1725584729.589933,-18000,,
com.apple.Notes,17,1725584707,1725584724,1725584724.159457,-18000,,
com.google.Chrome,16,1725584691,1725584707,1725584707.3692741,-18000,,
com.apple.Notes,11,1725584680,1725584691,1725584691.997981,-18000,,
com.google.Chrome,60,1725584620,1725584680,1725584680.082869,-18000,,
com.apple.Notes,71,1725584549,1725584620,1725584620.3325849,-18000,,
com.google.Chrome,4,1725584545,1725584549,1725584549.059309,-18000,,
com.apple.Notes,6,1725584539,1725584545,1725584545.700056,-18000,,
com.google.Chrome,2,1725584537,1725584539,1725584540.044827,-18000,,
com.apple.Notes,10,1725584527,1725584537,1725584537.263443,-18000,,
com.google.Chrome,1,1725584526,1725584527,1725584527.505964,-18000,,
com.apple.Notes,3,1725584523,1725584526,1725584526.6177258,-18000,,
com.google.Chrome,2,1725584521,1725584523,1725584523.967778,-18000,,
com.apple.Notes,5,1725584516,1725584521,1725584521.157843,-18000,,
com.google.Chrome,1,1725584515,1725584516,1725584516.33189,-18000,,
com.apple.Notes,7,1725584508,1725584515,1725584515.829969,-18000,,
com.google.Chrome,1,1725584507,1725584508,1725584508.475599,-18000,,
com.apple.Notes,1,1725584506,1725584507,1725584507.683934,-18000,,
com.google.Chrome,3,1725584503,1725584506,1725584506.4903688,-18000,,
com.apple.Notes,5,1725584498,1725584503,1725584503.7612581,-18000,,
com.google.Chrome,81,1725584417,1725584498,1725584498.606971,-18000,,
com.apple.Notes,3,1725584414,1725584417,1725584417.654619,-18000,,
com.google.Chrome,3,1725584411,1725584414,1725584414.8689408,-18000,,
com.apple.Notes,1,1725584410,1725584411,1725584411.2609138,-18000,,
com.google.Chrome,7,1725584403,1725584410,1725584410.6857982,-18000,,
com.apple.Notes,10,1725584393,1725584403,1725584403.078373,-18000,,
com.google.Chrome,130,1725584263,1725584393,1725584393.5160608,-18000,,
com.apple.Notes,24,1725584239,1725584263,1725584263.246671,-18000,,
com.google.Chrome,0,1725584239,1725584239,1725584239.807663,-18000,,
com.apple.Notes,3,1725584236,1725584239,1725584239.353679,-18000,,
com.google.Chrome,49,1725584187,1725584236,1725584236.71562,-18000,,
com.apple.Notes,16,1725584171,1725584187,1725584187.858942,-18000,,
com.google.Chrome,19,1725584152,1725584171,1725584171.4891438,-18000,,
com.apple.Notes,3,1725584149,1725584152,1725584152.5310721,-18000,,
com.google.Chrome,133,1725584016,1725584149,1725584149.9361439,-18000,,
com.apple.Notes,37,1725583979,1725584016,1725584016.795944,-18000,,
com.google.Chrome,58,1725583921,1725583979,1725583979.914013,-18000,,
com.apple.Notes,3,1725583918,1725583921,1725583921.674667,-18000,,
com.google.Chrome,3,1725583915,1725583918,1725583918.386879,-18000,,
com.apple.Notes,5,1725583910,1725583915,1725583915.9924989,-18000,,
com.google.Chrome,1,1725583909,1725583910,1725583910.97983,-18000,,
com.apple.Notes,7,1725583902,1725583909,1725583909.075913,-18000,,
com.google.Chrome,3,1725583899,1725583902,1725583902.391485,-18000,,
com.apple.Notes,8,1725583891,1725583899,1725583899.120757,-18000,,
com.google.Chrome,199,1725583692,1725583891,1725583891.091401,-18000,,
com.google.Chrome,305,1725582810,1725583115,1725583115.696169,-18000,,
com.apple.Notes,289,1725582521,1725582810,1725582810.898858,-18000,,
com.google.Chrome,0,1725582521,1725582521,1725582521.886773,-18000,,
com.apple.Notes,19,1725582502,1725582521,1725582521.5846472,-18000,,
com.google.Chrome,3,1725582499,1725582502,1725582502.606158,-18000,,
com.leomehlig.today,1,1725582498,1725582499,1725582499.835528,-18000,,
com.google.Chrome,1,1725582497,1725582498,1725582498.587318,-18000,,
com.leomehlig.today,13,1725582484,1725582497,1725582497.8176398,-18000,,
com.google.Chrome,5,1725582479,1725582484,1725582484.68033,-18000,,
com.apple.Notes,376,1725582103,1725582479,1725582479.348196,-18000,,
com.google.Chrome,0,1725582103,1725582103,1725582103.7745109,-18000,,
com.apple.Notes,2,1725582101,1725582103,1725582103.243871,-18000,,
com.google.Chrome,5,1725582096,1725582101,1725582101.4425812,-18000,,
com.apple.Notes,16,1725582080,1725582096,1725582096.7726378,-18000,,
com.google.Chrome,0,1725582080,1725582080,1725582080.8221369,-18000,,
com.apple.Notes,2,1725582078,1725582080,1725582080.399622,-18000,,
com.google.Chrome,10,1725582068,1725582078,1725582078.3031821,-18000,,
com.apple.Notes,1,1725582067,1725582068,1725582068.112427,-18000,,
com.google.Chrome,6,1725582061,1725582067,1725582067.451782,-18000,,
com.apple.Notes,33,1725582028,1725582061,1725582061.687702,-18000,,
com.google.Chrome,3,1725582025,1725582028,1725582028.2382212,-18000,,
com.apple.Notes,5,1725582020,1725582025,1725582025.275813,-18000,,
com.google.Chrome,9,1725582011,1725582020,1725582020.23439,-18000,,
com.apple.Notes,4,1725582007,1725582011,1725582011.89369,-18000,,
com.google.Chrome,3,1725582004,1725582007,1725582007.35605,-18000,,
com.apple.Notes,9,1725581995,1725582004,1725582004.456723,-18000,,
com.google.Chrome,4,1725581991,1725581995,1725581995.71138,-18000,,
com.apple.Notes,7,1725581984,1725581991,1725581991.112078,-18000,,
com.google.Chrome,6,1725581978,1725581984,1725581984.54759,-18000,,
com.apple.Notes,3,1725581975,1725581978,1725581978.372309,-18000,,
com.google.Chrome,8,1725581967,1725581975,1725581976.003434,-18000,,
com.apple.Notes,8,1725581959,1725581967,1725581967.124481,-18000,,
com.google.Chrome,4,1725581955,1725581959,1725581959.6148129,-18000,,
com.apple.Notes,7,1725581948,1725581955,1725581955.931421,-18000,,
com.google.Chrome,2,1725581946,1725581948,1725581948.645994,-18000,,
com.apple.Notes,8,1725581938,1725581946,1725581946.867513,-18000,,
com.google.Chrome,2,1725581936,1725581938,1725581938.753257,-18000,,
com.apple.Notes,1,1725581935,1725581936,1725581936.877564,-18000,,
com.google.Chrome,384,1725581551,1725581935,1725581935.2356029,-18000,,
com.apple.iCal,2,1725581549,1725581551,1725581551.10788,-18000,,
com.google.Chrome,4,1725581545,1725581549,1725581549.202128,-18000,,
com.apple.Notes,75,1725581470,1725581545,1725581545.2844791,-18000,,
com.google.Chrome,3,1725581467,1725581470,1725581470.961251,-18000,,
com.apple.Notes,203,1725581264,1725581467,1725581467.501473,-18000,,
com.google.Chrome,34,1725581230,1725581264,1725581264.549731,-18000,,
com.apple.Notes,25,1725581205,1725581230,1725581230.702718,-18000,,
com.apple.Photos,2,1725581203,1725581205,1725581205.74142,-18000,,
com.apple.Notes,38,1725581165,1725581203,1725581203.147067,-18000,,
com.apple.Photos,5,1725581160,1725581165,1725581165.899029,-18000,,
com.apple.Notes,82,1725581078,1725581160,1725581160.944339,-18000,,
com.apple.Photos,14,1725581064,1725581078,1725581078.1867461,-18000,,
com.apple.Notes,36,1725581028,1725581064,1725581064.194941,-18000,,
com.apple.Photos,3,1725581025,1725581028,1725581028.549284,-18000,,
com.apple.Notes,55,1725580970,1725581025,1725581025.880805,-18000,,
com.apple.Photos,3,1725580967,1725580970,1725580970.466877,-18000,,
com.apple.Notes,108,1725580859,1725580967,1725580967.70082,-18000,,
com.apple.Photos,3,1725580856,1725580859,1725580859.965197,-18000,,
com.apple.Notes,12,1725580844,1725580856,1725580856.949662,-18000,,
com.apple.Photos,2,1725580842,1725580844,1725580844.0403461,-18000,,
com.apple.Notes,2,1725580840,1725580842,1725580842.540968,-18000,,
com.apple.Photos,19,1725580821,1725580840,1725580840.613064,-18000,,
com.google.Chrome,62,1725580759,1725580821,1725580821.311644,-18000,,
com.apple.Notes,2,1725580757,1725580759,1725580759.557965,-18000,,
com.google.Chrome,46,1725580711,1725580757,1725580757.803339,-18000,,
com.apple.Notes,4,1725580707,1725580711,1725580711.269728,-18000,,
com.google.Chrome,0,1725580707,1725580707,1725580707.548201,-18000,,
com.apple.Notes,1,1725580706,1725580707,1725580707.201562,-18000,,
com.google.Chrome,1,1725580705,1725580706,1725580706.346036,-18000,,
com.apple.Notes,1,1725580704,1725580705,1725580705.97262,-18000,,
com.google.Chrome,0,1725580704,1725580704,1725580704.941148,-18000,,
com.apple.Notes,2,1725580702,1725580704,1725580704.3970342,-18000,,
com.google.Chrome,0,1725580702,1725580702,1725580702.788502,-18000,,
com.apple.Notes,1,1725580701,1725580702,1725580702.213515,-18000,,
com.google.Chrome,1,1725580700,1725580701,1725580701.200609,-18000,,
com.apple.Notes,1,1725580699,1725580700,1725580700.615736,-18000,,
com.google.Chrome,13,1725580686,1725580699,1725580699.8993359,-18000,,
com.apple.Notes,30,1725580656,1725580686,1725580686.215656,-18000,,
com.google.Chrome,13,1725580643,1725580656,1725580656.6143188,-18000,,
com.apple.Notes,5,1725580638,1725580643,1725580643.9559898,-18000,,
com.google.Chrome,2,1725580636,1725580638,1725580638.59394,-18000,,
com.apple.Notes,10,1725580626,1725580636,1725580636.194704,-18000,,
com.google.Chrome,41,1725580585,1725580626,1725580626.7000818,-18000,,
com.apple.Notes,21,1725580564,1725580585,1725580585.994226,-18000,,
com.google.Chrome,30,1725580534,1725580564,1725580564.177129,-18000,,
com.apple.Notes,7,1725580527,1725580534,1725580534.909725,-18000,,
com.google.Chrome,1,1725580526,1725580527,1725580527.862567,-18000,,
com.apple.Notes,0,1725580526,1725580526,1725580526.934843,-18000,,
com.google.Chrome,98,1725580428,1725580526,1725580526.411621,-18000,,
com.apple.Notes,1,1725580427,1725580428,1725580429.0126839,-18000,,
com.google.Chrome,3,1725580424,1725580427,1725580427.3609319,-18000,,
com.apple.Notes,3,1725580421,1725580424,1725580424.8770242,-18000,,
com.google.Chrome,30,1725580391,1725580421,1725580421.975122,-18000,,
com.apple.Notes,9,1725580382,1725580391,1725580391.8515692,-18000,,
com.google.Chrome,55,1725580327,1725580382,1725580383.0343862,-18000,,
com.apple.Notes,27,1725580300,1725580327,1725580327.319555,-18000,,
com.google.Chrome,15,1725580285,1725580300,1725580300.776925,-18000,,
com.apple.Notes,5,1725580280,1725580285,1725580285.151319,-18000,,
com.google.Chrome,827,1725579453,1725580280,1725580280.478287,-18000,,
com.apple.Notes,20,1725579433,1725579453,1725579453.09801,-18000,,
com.google.Chrome,1,1725579432,1725579433,1725579433.127727,-18000,,
com.apple.Notes,1,1725579431,1725579432,1725579432.631269,-18000,,
com.google.Chrome,272,1725579159,1725579431,1725579431.323073,-18000,,
com.apple.Notes,1,1725579158,1725579159,1725579159.321013,-18000,,
com.google.Chrome,2,1725579156,1725579158,1725579158.35214,-18000,,
com.apple.Notes,2,1725579154,1725579156,1725579156.137682,-18000,,
com.google.Chrome,133,1725579021,1725579154,1725579154.677104,-18000,,
com.apple.Notes,12,1725579009,1725579021,1725579021.951713,-18000,,
com.google.Chrome,230,1725578779,1725579009,1725579009.75986,-18000,,
com.apple.Notes,7,1725578772,1725578779,1725578779.425787,-18000,,
com.google.Chrome,25,1725578747,1725578772,1725578772.264673,-18000,,
com.apple.Notes,19,1725578728,1725578747,1725578747.24525,-18000,,
com.google.Chrome,195,1725578533,1725578728,1725578728.946883,-18000,,
com.apple.MobileSMS,1,1725578532,1725578533,1725578533.657146,-18000,,
com.apple.Notes,19,1725578513,1725578532,1725578532.481534,-18000,,
com.apple.MobileSMS,1,1725578512,1725578513,1725578513.517932,-18000,,
com.google.Chrome,24,1725578488,1725578512,1725578512.3863192,-18000,,
com.apple.MobileSMS,1,1725578487,1725578488,1725578488.452217,-18000,,
com.google.Chrome,395,1725578092,1725578487,1725578487.972189,-18000,,
com.apple.MobileSMS,5,1725578087,1725578092,1725578092.23249,-18000,,
com.google.Chrome,49,1725578038,1725578087,1725578088.0357509,-18000,,
com.apple.MobileSMS,5,1725578033,1725578038,1725578038.876967,-18000,,
com.google.Chrome,7,1725578026,1725578033,1725578033.563387,-18000,,
com.apple.MobileSMS,0,1725578026,1725578026,1725578026.794867,-18000,,
com.google.Chrome,6,1725578020,1725578026,1725578026.127861,-18000,,
com.apple.MobileSMS,37,1725577983,1725578020,1725578020.721012,-18000,,
com.google.Chrome,59,1725577924,1725577983,1725577983.239448,-18000,,
com.apple.MobileSMS,2,1725577922,1725577924,1725577924.360409,-18000,,
com.google.Chrome,1,1725577921,1725577922,1725577922.128748,-18000,,
com.apple.Notes,9,1725577912,1725577921,1725577921.2075071,-18000,,
com.google.Chrome,2,1725577910,1725577912,1725577912.962963,-18000,,
com.apple.Notes,7,1725577903,1725577910,1725577910.0556722,-18000,,
com.google.Chrome,3,1725577900,1725577903,1725577903.161675,-18000,,
com.apple.Notes,4,1725577896,1725577900,1725577900.165961,-18000,,
com.apple.MobileSMS,1,1725577895,1725577896,1725577896.8306131,-18000,,
com.google.Chrome,22,1725577873,1725577895,1725577895.559191,-18000,,
com.apple.MobileSMS,0,1725577873,1725577873,1725577873.903729,-18000,,
com.google.Chrome,10,1725577863,1725577873,1725577873.232748,-18000,,
com.apple.MobileSMS,14,1725577849,1725577863,1725577863.9051251,-18000,,
com.google.Chrome,4,1725577845,1725577849,1725577849.915567,-18000,,
com.apple.MobileSMS,29,1725577816,1725577845,1725577845.7259722,-18000,,
com.google.Chrome,7,1725577809,1725577816,1725577816.154279,-18000,,
com.apple.MobileSMS,44,1725577765,1725577809,1725577809.7475529,-18000,,
com.google.Chrome,33,1725577732,1725577765,1725577765.072319,-18000,,
com.apple.Notes,1,1725577731,1725577732,1725577732.671382,-18000,,
com.google.Chrome,3,1725577728,1725577731,1725577731.289482,-18000,,
com.apple.Notes,2,1725577726,1725577728,1725577728.485451,-18000,,
com.leomehlig.today,213,1725577513,1725577726,1725577726.515765,-18000,,
com.apple.Notes,2,1725577511,1725577513,1725577513.141374,-18000,,
com.apple.iCal,69,1725577442,1725577511,1725577511.4798799,-18000,,
com.apple.Notes,22,1725577420,1725577442,1725577442.3602428,-18000,,
com.apple.Notes,17,1725575933,1725575950,1725575950.4039001,-18000,,
com.google.Chrome,2,1725575931,1725575933,1725575933.049765,-18000,,
com.apple.Notes,8,1725575923,1725575931,1725575931.4723768,-18000,,
com.google.Chrome,13,1725575910,1725575923,1725575923.23801,-18000,,
com.apple.Notes,10,1725575900,1725575910,1725575910.769171,-18000,,
com.google.Chrome,1,1725575899,1725575900,1725575900.187056,-18000,,
com.apple.Notes,9,1725575890,1725575899,1725575899.3179889,-18000,,
com.google.Chrome,4,1725575886,1725575890,1725575890.255188,-18000,,
com.apple.Notes,20,1725575866,1725575886,1725575886.896595,-18000,,
com.google.Chrome,566,1725575300,1725575866,1725575866.1579251,-18000,,
com.google.Chrome,238,1725574856,1725575094,1725575095.16122,-18000,,
com.google.Chrome,301,1725574208,1725574509,1725574509.251301,-18000,,
com.google.Chrome,326,1725573737,1725574063,1725574063.12833,-18000,,
com.google.Chrome,308,1725573296,1725573604,1725573604.971288,-18000,,
com.microsoft.VSCode,33,1725573263,1725573296,1725573296.988224,-18000,,
com.apple.MobileSMS,6,1725573257,1725573263,1725573263.225344,-18000,,
us.zoom.xos,8,1725573249,1725573257,1725573257.694419,-18000,,
com.microsoft.VSCode,1,1725573248,1725573249,1725573249.501288,-18000,,
com.apple.MobileSMS,66,1725573182,1725573248,1725573248.591558,-18000,,
com.google.Chrome,53,1725573129,1725573182,1725573182.250195,-18000,,
com.apple.finder,10,1725573119,1725573129,1725573129.079691,-18000,,
com.apple.archiveutility,0,1725573119,1725573119,1725573120.1143131,-18000,,
com.google.Chrome,13,1725573106,1725573119,1725573119.64088,-18000,,
us.zoom.xos,62,1725573044,1725573106,1725573106.309933,-18000,,
com.google.Chrome,4,1725573040,1725573044,1725573044.063343,-18000,,
us.zoom.xos,34,1725573006,1725573040,1725573040.1317291,-18000,,
com.google.Chrome,20,1725572986,1725573006,1725573006.440582,-18000,,
us.zoom.xos,22,1725572964,1725572986,1725572986.871767,-18000,,
com.google.Chrome,5,1725572959,1725572964,1725572964.880649,-18000,,
com.microsoft.VSCode,4,1725572955,1725572959,1725572959.509031,-18000,,
com.google.Chrome,26,1725572929,1725572955,1725572955.837486,-18000,,
com.microsoft.VSCode,4,1725572925,1725572929,1725572929.549752,-18000,,
com.google.Chrome,5,1725572920,1725572925,1725572925.361928,-18000,,
us.zoom.xos,5,1725572915,1725572920,1725572920.1808162,-18000,,
com.google.Chrome,193,1725572722,1725572915,1725572915.801433,-18000,,
us.zoom.xos,3,1725572719,1725572722,1725572722.826761,-18000,,
com.microsoft.VSCode,3,1725572716,1725572719,1725572720.010614,-18000,,
com.google.Chrome,19,1725572697,1725572716,1725572716.988647,-18000,,
com.microsoft.VSCode,27,1725572670,1725572697,1725572697.785799,-18000,,
com.google.Chrome,39,1725572631,1725572670,1725572670.54699,-18000,,
com.microsoft.VSCode,46,1725572585,1725572631,1725572631.337237,-18000,,
us.zoom.xos,3,1725572582,1725572585,1725572585.710314,-18000,,
com.microsoft.VSCode,36,1725572546,1725572582,1725572582.9808378,-18000,,
us.zoom.xos,7,1725572539,1725572546,1725572546.323622,-18000,,
com.microsoft.VSCode,0,1725572539,1725572539,1725572539.9300308,-18000,,
us.zoom.xos,11,1725572528,1725572539,1725572539.505896,-18000,,
com.microsoft.VSCode,175,1725572353,1725572528,1725572528.522653,-18000,,
us.zoom.xos,11,1725572342,1725572353,1725572353.897327,-18000,,
com.microsoft.VSCode,13,1725572329,1725572342,1725572342.218443,-18000,,
us.zoom.xos,6,1725572323,1725572329,1725572329.6135879,-18000,,
com.microsoft.VSCode,5,1725572318,1725572323,1725572323.3156219,-18000,,
us.zoom.xos,19,1725572299,1725572318,1725572318.6184568,-18000,,
com.microsoft.VSCode,265,1725572034,1725572299,1725572299.435368,-18000,,
com.google.Chrome,2,1725572032,1725572034,1725572034.361862,-18000,,
us.zoom.xos,12,1725572020,1725572032,1725572032.594545,-18000,,
com.microsoft.VSCode,361,1725571659,1725572020,1725572020.167434,-18000,,
us.zoom.xos,26,1725571633,1725571659,1725571659.183476,-18000,,
com.microsoft.VSCode,773,1725570860,1725571633,1725571633.7804031,-18000,,
us.zoom.xos,13,1725570847,1725570860,1725570860.996601,-18000,,
com.microsoft.VSCode,3,1725570844,1725570847,1725570847.057425,-18000,,
us.zoom.xos,43,1725570801,1725570844,1725570844.063099,-18000,,
com.microsoft.VSCode,75,1725570726,1725570801,1725570801.8742619,-18000,,
com.google.Chrome,17,1725570709,1725570726,1725570726.777148,-18000,,
com.microsoft.VSCode,23,1725570686,1725570709,1725570709.16082,-18000,,
com.google.Chrome,10,1725570676,1725570686,1725570686.5647988,-18000,,
com.microsoft.VSCode,66,1725570610,1725570676,1725570676.172151,-18000,,
com.apple.Terminal,1,1725570609,1725570610,1725570610.489732,-18000,,
com.google.Chrome,2,1725570607,1725570609,1725570609.434568,-18000,,
com.apple.Terminal,1,1725570606,1725570607,1725570607.5751739,-18000,,
com.microsoft.VSCode,10,1725570596,1725570606,1725570606.2100558,-18000,,
com.apple.Terminal,2,1725570594,1725570596,1725570597.006124,-18000,,
com.google.Chrome,17,1725570577,1725570594,1725570594.8763409,-18000,,
com.microsoft.VSCode,2,1725570575,1725570577,1725570577.3812718,-18000,,
com.apple.Terminal,2,1725570573,1725570575,1725570575.396693,-18000,,
com.microsoft.VSCode,29,1725570544,1725570573,1725570573.472023,-18000,,
com.apple.Terminal,2,1725570542,1725570544,1725570544.803874,-18000,,
us.zoom.xos,3,1725570539,1725570542,1725570542.5854812,-18000,,
com.apple.iCal,2,1725570537,1725570539,1725570539.5657191,-18000,,
us.zoom.xos,11,1725570526,1725570537,1725570537.710476,-18000,,
com.google.Chrome,3,1725570523,1725570526,1725570526.382804,-18000,,
com.apple.Terminal,6,1725570517,1725570523,1725570523.440433,-18000,,
com.apple.finder,9,1725570508,1725570517,1725570517.6457,-18000,,
com.apple.Terminal,42,1725570466,1725570508,1725570508.6734118,-18000,,
com.google.Chrome,11,1725570455,1725570466,1725570466.963643,-18000,,
com.apple.finder,22,1725570433,1725570455,1725570455.799357,-18000,,
com.apple.Terminal,84,1725570349,1725570433,1725570433.313274,-18000,,
com.google.Chrome,51,1725570298,1725570349,1725570349.3579202,-18000,,
us.zoom.xos,3,1725570295,1725570298,1725570298.498137,-18000,,
com.google.Chrome,62,1725570233,1725570295,1725570295.753345,-18000,,
us.zoom.xos,221,1725570012,1725570233,1725570233.564491,-18000,,
com.google.Chrome,47,1725569965,1725570012,1725570012.773227,-18000,,
us.zoom.xos,88,1725569877,1725569965,1725569965.792486,-18000,,
com.google.Chrome,23,1725569854,1725569877,1725569877.808714,-18000,,
us.zoom.xos,1,1725569853,1725569854,1725569854.3416882,-18000,,
com.apple.Terminal,18,1725569835,1725569853,1725569853.755031,-18000,,
us.zoom.xos,2,1725569833,1725569835,1725569835.6984239,-18000,,
us.zoom.xos,321,1725569162,1725569483,1725569483.656009,-18000,,
us.zoom.xos,511,1725568607,1725569118,1725569118.924354,-18000,,
com.google.Chrome,55,1725568552,1725568607,1725568607.4067879,-18000,,
us.zoom.xos,4,1725568548,1725568552,1725568552.947027,-18000,,
com.google.Chrome,29,1725568519,1725568548,1725568548.578716,-18000,,
us.zoom.xos,6,1725568513,1725568519,1725568519.062043,-18000,,
com.google.Chrome,4,1725568509,1725568513,1725568513.3049932,-18000,,
us.zoom.xos,11,1725568498,1725568509,1725568509.7112641,-18000,,
com.google.Chrome,32,1725568466,1725568498,1725568498.746376,-18000,,
us.zoom.xos,120,1725568346,1725568466,1725568466.543478,-18000,,
com.google.Chrome,32,1725568314,1725568346,1725568346.106067,-18000,,
us.zoom.xos,3,1725568311,1725568314,1725568314.896024,-18000,,
com.google.Chrome,44,1725568267,1725568311,1725568311.4968982,-18000,,
us.zoom.xos,11,1725568256,1725568267,1725568268.021368,-18000,,
com.google.Chrome,41,1725568215,1725568256,1725568256.559029,-18000,,
us.zoom.xos,90,1725568125,1725568215,1725568215.2786422,-18000,,
com.google.Chrome,577,1725567548,1725568125,1725568125.989997,-18000,,
com.apple.finder,1,1725567547,1725567548,1725567549.004148,-18000,,
com.google.Chrome,2,1725567545,1725567547,1725567547.743957,-18000,,
com.apple.systempreferences,0,1725567542,1725567542,1725567542.9169168,-18000,,
com.google.Chrome,147,1725567395,1725567542,1725567542.2558331,-18000,,
com.google.Chrome,300,1725565150,1725565450,1725565450.923674,-18000,,
com.google.Chrome,402,1725564747,1725565149,1725565149.89238,-18000,,
com.google.Chrome,789,1725563229,1725564018,1725564018.7687922,-18000,,
com.google.Chrome,271,1725559212,1725559483,1725559483.903269,-18000,,
com.leomehlig.today,3,1725559209,1725559212,1725559212.353859,-18000,,
com.leomehlig.today,76,1725558130,1725558206,1725558206.309103,-18000,,
com.google.Chrome,354,1725557776,1725558130,1725558130.7483191,-18000,,
com.google.Chrome,310,1725557352,1725557662,1725557662.190211,-18000,,
com.google.Chrome,2909,1725552079,1725554988,1725554988.734823,-18000,,
com.apple.iCal,32,1725552047,1725552079,1725552079.078611,-18000,,
com.google.Chrome,25,1725552022,1725552047,1725552047.934012,-18000,,
com.apple.iCal,12,1725552010,1725552022,1725552022.554058,-18000,,
com.google.Chrome,3,1725552007,1725552010,1725552010.670356,-18000,,
com.apple.iCal,11,1725551996,1725552007,1725552007.5263638,-18000,,
com.google.Chrome,4,1725551992,1725551996,1725551996.160356,-18000,,
com.apple.iCal,1,1725551991,1725551992,1725551992.9333038,-18000,,
com.google.Chrome,96,1725551895,1725551991,1725551991.192641,-18000,,
com.google.Chrome,84,1725551107,1725551191,1725551191.5184011,-18000,,
com.apple.iCal,8,1725551099,1725551107,1725551107.490391,-18000,,
com.google.Chrome,60,1725551039,1725551099,1725551099.832747,-18000,,
com.apple.Terminal,4,1725551035,1725551039,1725551040.051609,-18000,,
com.google.Chrome,42,1725550993,1725551035,1725551035.6919432,-18000,,
com.apple.finder,46,1725550947,1725550993,1725550993.564054,-18000,,
com.google.Chrome,13,1725550934,1725550947,1725550947.7022982,-18000,,
com.leomehlig.today,71,1725550863,1725550934,1725550934.2856112,-18000,,
com.google.Chrome,37,1725550826,1725550863,1725550863.46306,-18000,,
com.apple.Terminal,3,1725550823,1725550826,1725550826.419396,-18000,,
com.google.Chrome,293,1725550530,1725550823,1725550823.3114,-18000,,
com.apple.Terminal,39,1725550491,1725550530,1725550530.8078132,-18000,,
com.google.Chrome,46,1725550445,1725550491,1725550491.812683,-18000,,
com.apple.Terminal,38,1725550407,1725550445,1725550445.575585,-18000,,
com.google.Chrome,85,1725550322,1725550407,1725550407.303926,-18000,,
com.apple.Terminal,1,1725550321,1725550322,1725550322.133316,-18000,,
com.google.Chrome,119,1725550202,1725550321,1725550321.610546,-18000,,
com.apple.Terminal,6,1725550196,1725550202,1725550202.240768,-18000,,
com.google.Chrome,36,1725550160,1725550196,1725550196.1559582,-18000,,
com.apple.Terminal,5,1725550155,1725550160,1725550160.2901,-18000,,
com.google.Chrome,44,1725550111,1725550155,1725550155.5361261,-18000,,
com.apple.Terminal,19,1725550092,1725550111,1725550111.844788,-18000,,
com.google.Chrome,16,1725550076,1725550092,1725550092.535612,-18000,,
com.apple.Terminal,29,1725550047,1725550076,1725550076.083922,-18000,,
com.google.Chrome,8,1725550039,1725550047,1725550047.684681,-18000,,
com.apple.Terminal,13,1725550026,1725550039,1725550039.392364,-18000,,
com.google.Chrome,78,1725549948,1725550026,1725550026.840523,-18000,,
com.apple.Terminal,2,1725549946,1725549948,1725549948.946951,-18000,,
com.google.Chrome,30,1725549916,1725549946,1725549946.981596,-18000,,
com.apple.Terminal,76,1725549840,1725549916,1725549917.033823,-18000,,
com.google.Chrome,46,1725549794,1725549840,1725549840.761806,-18000,,
com.apple.Terminal,2,1725549792,1725549794,1725549794.636173,-18000,,
com.google.Chrome,7,1725549785,1725549792,1725549792.192175,-18000,,
com.apple.Terminal,6,1725549779,1725549785,1725549785.250561,-18000,,
com.google.Chrome,95,1725549684,1725549779,1725549779.567682,-18000,,
com.apple.finder,4,1725549680,1725549684,1725549684.8545961,-18000,,
com.google.Chrome,60,1725549620,1725549680,1725549680.352055,-18000,,
com.apple.Terminal,5,1725549615,1725549620,1725549620.541469,-18000,,
com.google.Chrome,11,1725549604,1725549615,1725549615.9883208,-18000,,
com.apple.Terminal,3,1725549601,1725549604,1725549604.634544,-18000,,
com.google.Chrome,40,1725549561,1725549601,1725549601.262799,-18000,,
com.apple.Terminal,4,1725549557,1725549561,1725549561.543633,-18000,,
com.google.Chrome,15,1725549542,1725549557,1725549557.771308,-18000,,
com.apple.Terminal,38,1725549504,1725549542,1725549542.599259,-18000,,
com.google.Chrome,21,1725549483,1725549504,1725549504.189815,-18000,,
com.anaconda.io,29,1725549454,1725549483,1725549483.48136,-18000,,
com.google.Chrome,1474,1725547980,1725549454,1725549454.430563,-18000,,
com.apple.Terminal,37,1725547943,1725547980,1725547980.8101668,-18000,,
com.google.Chrome,442,1725547501,1725547943,1725547943.6911469,-18000,,
com.apple.Terminal,9,1725547492,1725547501,1725547501.991959,-18000,,
com.google.Chrome,99,1725547393,1725547492,1725547492.142978,-18000,,
com.apple.Terminal,7,1725547386,1725547393,1725547393.139124,-18000,,
com.google.Chrome,163,1725547223,1725547386,1725547386.2436671,-18000,,
com.apple.iCal,17,1725547206,1725547223,1725547223.819093,-18000,,
com.google.Chrome,33,1725547173,1725547206,1725547206.2591329,-18000,,
com.apple.iCal,15,1725547158,1725547173,1725547173.350863,-18000,,
com.google.Chrome,2,1725547156,1725547158,1725547159.017355,-18000,,
com.apple.iCal,10,1725547146,1725547156,1725547156.66125,-18000,,
com.google.Chrome,407,1725546739,1725547146,1725547146.350212,-18000,,
com.apple.finder,1,1725546721,1725546722,1725546722.11763,-18000,,
com.microsoft.Word,7,1725546714,1725546721,1725546721.849529,-18000,,
com.instructure.icanvas,23,1725543162,1725543185,1725543186.090897,-18000,EB445137-D7F5-57EC-87DA-1DB460D64046,"iPhone13,2"
com.apple.mobiletimer,13,1725511940,1725511953,1725511953.116071,-18000,EB445137-D7F5-57EC-87DA-1DB460D64046,"iPhone13,2"
com.apple.mobiletimer,2,1725511932,1725511934,1725511934.818781,-18000,EB445137-D7F5-57EC-87DA-1DB460D64046,"iPhone13,2"
com.apple.mobiletimer,7,1725511925,1725511932,1725511932.123673,-18000,EB445137-D7F5-57EC-87DA-1DB460D64046,"iPhone13,2"
com.apple.journal,1180,1725510717,1725511897,1725511897.943562,-18000,EB445137-D7F5-57EC-87DA-1DB460D64046,"iPhone13,2"
com.apple.Health,66,1725510649,1725510715,1725510715.116703,-18000,EB445137-D7F5-57EC-87DA-1DB460D64046,"iPhone13,2"
com.apple.Health,62,1725510586,1725510648,1725510648.63938,-18000,EB445137-D7F5-57EC-87DA-1DB460D64046,"iPhone13,2"
com.thestorygraph.thestorygraph,75,1725510277,1725510352,1725510352.318773,-18000,EB445137-D7F5-57EC-87DA-1DB460D64046,"iPhone13,2"
com.thestorygraph.thestorygraph,13,1725509891,1725509904,1725509904.1997561,-18000,EB445137-D7F5-57EC-87DA-1DB460D64046,"iPhone13,2"
com.thestorygraph.thestorygraph,2,1725508819,1725508821,1725508821.276252,-18000,EB445137-D7F5-57EC-87DA-1DB460D64046,"iPhone13,2"
com.thestorygraph.thestorygraph,23,1725508791,1725508814,1725508814.14045,-18000,EB445137-D7F5-57EC-87DA-1DB460D64046,"iPhone13,2"
com.toyopagroup.picaboo,3,1725508785,1725508788,1725508788.90799,-18000,EB445137-D7F5-57EC-87DA-1DB460D64046,"iPhone13,2"
com.toyopagroup.picaboo,12,1725508071,1725508083,1725508083.9753962,-18000,EB445137-D7F5-57EC-87DA-1DB460D64046,"iPhone13,2"
com.toyopagroup.picaboo,3,1725508064,1725508067,1725508067.5497851,-18000,EB445137-D7F5-57EC-87DA-1DB460D64046,"iPhone13,2"
com.toyopagroup.picaboo,18,1725507857,1725507875,1725507875.8594031,-18000,EB445137-D7F5-57EC-87DA-1DB460D64046,"iPhone13,2"
com.microsoft.Word,95,1725507853,1725507948,1725507948.472196,-18000,,
com.apple.Music,1396,1725506457,1725507853,1725507853.178057,-18000,,
com.hammerandchisel.discord,16,1725506293,1725506309,1725506309.380341,-18000,EB445137-D7F5-57EC-87DA-1DB460D64046,"iPhone13,2"
com.microsoft.Office.Outlook,23,1725506269,1725506292,1725506292.730321,-18000,EB445137-D7F5-57EC-87DA-1DB460D64046,"iPhone13,2"
com.toyopagroup.picaboo,26,1725506237,1725506263,1725506263.962291,-18000,EB445137-D7F5-57EC-87DA-1DB460D64046,"iPhone13,2"
com.apple.Health,20,1725506217,1725506237,1725506237.254509,-18000,EB445137-D7F5-57EC-87DA-1DB460D64046,"iPhone13,2"
com.toyopagroup.picaboo,49,1725506168,1725506217,1725506217.449997,-18000,EB445137-D7F5-57EC-87DA-1DB460D64046,"iPhone13,2"
com.burbn.instagram,41,1725506117,1725506158,1725506158.7129579,-18000,EB445137-D7F5-57EC-87DA-1DB460D64046,"iPhone13,2"
com.google.Chrome,369,1725506088,1725506457,1725506458.0084019,-18000,,
com.apple.finder,20,1725506068,1725506088,1725506088.606605,-18000,,
net.kortina.labs.Venmo,149,1725505966,1725506115,1725506115.4428902,-18000,EB445137-D7F5-57EC-87DA-1DB460D64046,"iPhone13,2"
com.tinyspeck.chatlyio,13,1725505951,1725505964,1725505964.4102879,-18000,EB445137-D7F5-57EC-87DA-1DB460D64046,"iPhone13,2"
com.google.chrome.ios,16,1725505935,1725505951,1725505951.549518,-18000,EB445137-D7F5-57EC-87DA-1DB460D64046,"iPhone13,2"
com.google.Chrome,176,1725505892,1725506068,1725506068.6189032,-18000,,
com.google.chrome.ios,10,1725505802,1725505812,1725505812.422816,-18000,EB445137-D7F5-57EC-87DA-1DB460D64046,"iPhone13,2"
com.apple.finder,122,1725505770,1725505892,1725505892.8778028,-18000,,
com.microsoft.Word,56,1725505714,1725505770,1725505770.164825,-18000,,
com.apple.finder,2,1725505712,1725505714,1725505714.773808,-18000,,
com.microsoft.Word,3,1725505709,1725505712,1725505712.868853,-18000,,
com.google.Chrome,78,1725505631,1725505709,1725505709.4566832,-18000,,
com.microsoft.Word,258,1725505373,1725505631,1725505631.578978,-18000,,
com.google.Chrome,65,1725505308,1725505373,1725505373.49339,-18000,,
com.microsoft.Word,46,1725505262,1725505308,1725505308.2136111,-18000,,
com.apple.finder,15,1725505247,1725505262,1725505262.8337522,-18000,,
com.google.chrome.ios,60,1725505240,1725505300,1725505300.933408,-18000,EB445137-D7F5-57EC-87DA-1DB460D64046,"iPhone13,2"
com.tinyspeck.chatlyio,27,1725505213,1725505240,1725505240.2863941,-18000,EB445137-D7F5-57EC-87DA-1DB460D64046,"iPhone13,2"
com.google.chrome.ios,6,1725505206,1725505212,1725505212.463087,-18000,EB445137-D7F5-57EC-87DA-1DB460D64046,"iPhone13,2"
com.google.Chrome,47,1725505200,1725505247,1725505247.3844008,-18000,,
com.apple.Health,0,1725505198,1725505198,1725505198.302659,-18000,EB445137-D7F5-57EC-87DA-1DB460D64046,"iPhone13,2"
com.apple.Health,9,1725504534,1725504543,1725504543.843096,-18000,EB445137-D7F5-57EC-87DA-1DB460D64046,"iPhone13,2"
com.apple.Health,2,1725504517,1725504519,1725504519.999013,-18000,EB445137-D7F5-57EC-87DA-1DB460D64046,"iPhone13,2"
com.apple.Health,73,1725503437,1725503510,1725503510.2640839,-18000,EB445137-D7F5-57EC-87DA-1DB460D64046,"iPhone13,2"
com.myfitnesspal.mfp,32,1725503405,1725503437,1725503437.372757,-18000,EB445137-D7F5-57EC-87DA-1DB460D64046,"iPhone13,2"
com.apple.Music,3,1725503400,1725503403,1725503403.678551,-18000,EB445137-D7F5-57EC-87DA-1DB460D64046,"iPhone13,2"
com.apple.Music,25,1725503302,1725503327,1725503327.33994,-18000,EB445137-D7F5-57EC-87DA-1DB460D64046,"iPhone13,2"
com.google.Maps,2,1725503296,1725503298,1725503298.761946,-18000,EB445137-D7F5-57EC-87DA-1DB460D64046,"iPhone13,2"
com.google.Maps,28,1725503134,1725503162,1725503162.110538,-18000,EB445137-D7F5-57EC-87DA-1DB460D64046,"iPhone13,2"
edu.illinois.rokwire.ios,2,1725503129,1725503131,1725503131.605894,-18000,EB445137-D7F5-57EC-87DA-1DB460D64046,"iPhone13,2"
edu.illinois.rokwire.ios,2,1725503104,1725503106,1725503106.5001721,-18000,EB445137-D7F5-57EC-87DA-1DB460D64046,"iPhone13,2"
edu.illinois.rokwire.ios,9,1725503076,1725503085,1725503085.9937038,-18000,EB445137-D7F5-57EC-87DA-1DB460D64046,"iPhone13,2"
com.google.Chrome,90,1725502938,1725503028,1725503028.2756782,-18000,,
com.apple.finder,5,1725502933,1725502938,1725502938.991445,-18000,,
com.google.Chrome,1,1725502932,1725502933,1725502933.927758,-18000,,
com.leomehlig.today,2,1725502930,1725502932,1725502932.442237,-18000,,
com.google.Chrome,1,1725502929,1725502930,1725502930.780127,-18000,,
com.apple.finder,4,1725502925,1725502929,1725502929.5514522,-18000,,
com.apple.systempreferences,1,1725502924,1725502925,1725502925.085198,-18000,,
com.leomehlig.today,94,1725502830,1725502924,1725502924.333004,-18000,,
com.google.Chrome,276,1725502554,1725502830,1725502830.480791,-18000,,
com.apple.Terminal,64,1725502490,1725502554,1725502554.640208,-18000,,
com.google.Chrome,126,1725502364,1725502490,1725502490.391889,-18000,,
com.leomehlig.today,5,1725502359,1725502364,1725502364.913168,-18000,,
com.google.Chrome,1,1725502358,1725502359,1725502359.73106,-18000,,
com.leomehlig.today,2,1725502356,1725502358,1725502358.198683,-18000,,
com.google.Chrome,20,1725502336,1725502356,1725502356.204881,-18000,,
com.leomehlig.today,11,1725502325,1725502336,1725502336.044096,-18000,,
com.google.Chrome,2,1725502323,1725502325,1725502326.023788,-18000,,
com.leomehlig.today,12,1725502311,1725502323,1725502323.145751,-18000,,
com.google.Chrome,15,1725502296,1725502311,1725502311.3236542,-18000,,
com.leomehlig.today,5,1725502291,1725502296,1725502296.2116609,-18000,,
com.google.Chrome,4,1725502287,1725502291,1725502291.306437,-18000,,
com.leomehlig.today,24,1725502263,1725502287,1725502287.743994,-18000,,
com.google.Chrome,29,1725502234,1725502263,1725502263.264683,-18000,,
com.leomehlig.today,7,1725502227,1725502234,1725502234.176602,-18000,,
com.google.Chrome,198,1725502029,1725502227,1725502227.690911,-18000,,
com.leomehlig.today,25,1725501676,1725501701,1725501702.037345,-18000,,
com.google.Chrome,121,1725501555,1725501676,1725501676.419159,-18000,,
edu.illinois.rokwire.ios,68,1725501419,1725501487,1725501487.358828,-18000,EB445137-D7F5-57EC-87DA-1DB460D64046,"iPhone13,2"
com.instructure.icanvas,2,1725501413,1725501415,1725501416.025671,-18000,EB445137-D7F5-57EC-87DA-1DB460D64046,"iPhone13,2"
com.apple.systempreferences,5,1725501374,1725501379,1725501379.290508,-18000,,
com.google.Chrome,19,1725501355,1725501374,1725501374.123088,-18000,,
com.apple.systempreferences,10,1725501345,1725501355,1725501355.364377,-18000,,
com.google.Chrome,46,1725501292,1725501338,1725501338.7832909,-18000,,
com.leomehlig.today,6,1725501286,1725501292,1725501292.53707,-18000,,
com.google.Chrome,42,1725501244,1725501286,1725501286.661912,-18000,,
com.leomehlig.today,2,1725501242,1725501244,1725501244.231883,-18000,,
com.google.Chrome,285,1725500957,1725501242,1725501242.909759,-18000,,
com.leomehlig.today,7,1725500950,1725500957,1725500957.174855,-18000,,
com.instructure.icanvas,6,1725500492,1725500498,1725500498.3343658,-18000,EB445137-D7F5-57EC-87DA-1DB460D64046,"iPhone13,2"
com.toyopagroup.picaboo,15,1725500476,1725500491,1725500491.172295,-18000,EB445137-D7F5-57EC-87DA-1DB460D64046,"iPhone13,2"
com.google.Chrome,1281,1725499669,1725500950,1725500950.086132,-18000,,
com.leomehlig.today,15,1725499654,1725499669,1725499669.362101,-18000,,
com.google.Chrome,1,1725499653,1725499654,1725499654.525564,-18000,,
com.leomehlig.today,2,1725499651,1725499653,1725499653.492116,-18000,,
com.google.Chrome,700,1725498951,1725499651,1725499652.1438189,-18000,,
com.leomehlig.today,1,1725498950,1725498951,1725498951.394027,-18000,,
com.google.Chrome,327,1725498623,1725498950,1725498950.830246,-18000,,
com.leomehlig.today,1,1725498622,1725498623,1725498623.283746,-18000,,
com.google.Chrome,154,1725498468,1725498622,1725498622.8721318,-18000,,
com.leomehlig.today,0,1725498468,1725498468,1725498469.01444,-18000,,
com.google.Chrome,27,1725498441,1725498468,1725498468.05023,-18000,,
com.leomehlig.today,1,1725498440,1725498441,1725498441.898561,-18000,,
com.toyopagroup.picaboo,15,1725498241,1725498256,1725498256.218299,-18000,EB445137-D7F5-57EC-87DA-1DB460D64046,"iPhone13,2"
com.apple.Health,4,1725498237,1725498241,1725498241.1251612,-18000,EB445137-D7F5-57EC-87DA-1DB460D64046,"iPhone13,2"
com.google.Chrome,410,1725498030,1725498440,1725498440.2722,-18000,,
com.microsoft.Outlook,3,1725498027,1725498030,1725498031.0978842,-18000,,
com.google.Chrome,1057,1725496970,1725498027,1725498027.201993,-18000,,
com.leomehlig.today,11,1725496751,1725496762,1725496762.16084,-18000,,
com.google.Chrome,448,1725496303,1725496751,1725496752.523536,-18000,,
com.leomehlig.today,8,1725496295,1725496303,1725496304.007057,-18000,,
com.google.Chrome,7,1725496288,1725496295,1725496295.982393,-18000,,
com.apple.Health,29,1725495821,1725495850,1725495850.307385,-18000,EB445137-D7F5-57EC-87DA-1DB460D64046,"iPhone13,2"
com.google.chrome.ios,27,1725495673,1725495700,1725495700.811799,-18000,EB445137-D7F5-57EC-87DA-1DB460D64046,"iPhone13,2"
com.apple.Health,2,1725495671,1725495673,1725495673.864073,-18000,EB445137-D7F5-57EC-87DA-1DB460D64046,"iPhone13,2"
com.apple.Health,28,1725495619,1725495647,1725495647.691613,-18000,EB445137-D7F5-57EC-87DA-1DB460D64046,"iPhone13,2"
com.google.chrome.ios,1,1725495617,1725495618,1725495619.180562,-18000,EB445137-D7F5-57EC-87DA-1DB460D64046,"iPhone13,2"
com.google.chrome.ios,7,1725495188,1725495195,1725495195.03573,-18000,EB445137-D7F5-57EC-87DA-1DB460D64046,"iPhone13,2"
com.google.chrome.ios,27,1725495159,1725495186,1725495186.751001,-18000,EB445137-D7F5-57EC-87DA-1DB460D64046,"iPhone13,2"
com.google.Maps,2,1725495157,1725495159,1725495159.6471949,-18000,EB445137-D7F5-57EC-87DA-1DB460D64046,"iPhone13,2"
com.google.Maps,7,1725494999,1725495006,1725495006.025416,-18000,EB445137-D7F5-57EC-87DA-1DB460D64046,"iPhone13,2"
com.google.Maps,17,1725494979,1725494996,1725494996.977398,-18000,EB445137-D7F5-57EC-87DA-1DB460D64046,"iPhone13,2"
com.apple.Maps,20,1725494959,1725494979,1725494979.9938989,-18000,EB445137-D7F5-57EC-87DA-1DB460D64046,"iPhone13,2"
com.google.Maps,17,1725494942,1725494959,1725494959.377969,-18000,EB445137-D7F5-57EC-87DA-1DB460D64046,"iPhone13,2"
com.google.Maps,0,1725494936,1725494936,1725494936.937944,-18000,EB445137-D7F5-57EC-87DA-1DB460D64046,"iPhone13,2"
com.google.Maps,129,1725494740,1725494869,1725494869.48952,-18000,EB445137-D7F5-57EC-87DA-1DB460D64046,"iPhone13,2"
com.google.Maps,1,1725494724,1725494725,1725494725.513389,-18000,EB445137-D7F5-57EC-87DA-1DB460D64046,"iPhone13,2"
com.google.Maps,33,1725494688,1725494721,1725494721.763723,-18000,EB445137-D7F5-57EC-87DA-1DB460D64046,"iPhone13,2"
com.google.Maps,7,1725494649,1725494656,1725494657.251018,-18000,EB445137-D7F5-57EC-87DA-1DB460D64046,"iPhone13,2"
com.apple.Music,3,1725494646,1725494649,1725494649.529381,-18000,EB445137-D7F5-57EC-87DA-1DB460D64046,"iPhone13,2"
com.apple.Music,17,1725494621,1725494638,1725494638.329036,-18000,EB445137-D7F5-57EC-87DA-1DB460D64046,"iPhone13,2"
com.google.Maps,3,1725494618,1725494621,1725494621.189182,-18000,EB445137-D7F5-57EC-87DA-1DB460D64046,"iPhone13,2"
com.google.Maps,13,1725494563,1725494576,1725494576.5560021,-18000,EB445137-D7F5-57EC-87DA-1DB460D64046,"iPhone13,2"
com.google.Chrome,13,1725494490,1725494503,1725494503.889979,-18000,,
com.leomehlig.today,13,1725494477,1725494490,1725494491.029574,-18000,,
com.google.Chrome,38,1725494439,1725494477,1725494477.994401,-18000,,
com.leomehlig.today,44,1725494382,1725494426,1725494426.420889,-18000,,
com.apple.Preview,7,1725494375,1725494382,1725494382.8366718,-18000,,
com.google.Maps,1,1725494286,1725494287,1725494287.9157271,-18000,EB445137-D7F5-57EC-87DA-1DB460D64046,"iPhone13,2"
com.google.Maps,27,1725494208,1725494235,1725494235.990817,-18000,EB445137-D7F5-57EC-87DA-1DB460D64046,"iPhone13,2"
com.apple.Maps,4,1725494201,1725494205,1725494205.550369,-18000,EB445137-D7F5-57EC-87DA-1DB460D64046,"iPhone13,2"
com.apple.mobiletimer,4,1725494194,1725494198,1725494198.340255,-18000,EB445137-D7F5-57EC-87DA-1DB460D64046,"iPhone13,2"
com.apple.mobiletimer,6,1725494169,1725494175,1725494175.605253,-18000,EB445137-D7F5-57EC-87DA-1DB460D64046,"iPhone13,2"
com.apple.Preview,165,1725493981,1725494146,1725494146.398386,-18000,,
com.apple.mobiletimer,255,1725493874,1725494129,1725494129.528366,-18000,EB445137-D7F5-57EC-87DA-1DB460D64046,"iPhone13,2"
com.apple.mobiletimer,62,1725493811,1725493873,1725493873.922358,-18000,EB445137-D7F5-57EC-87DA-1DB460D64046,"iPhone13,2"
com.apple.news,2,1725493809,1725493811,1725493811.5085511,-18000,EB445137-D7F5-57EC-87DA-1DB460D64046,"iPhone13,2"
com.apple.Preview,565,1725493396,1725493961,1725493961.687526,-18000,,
com.apple.finder,21,1725493375,1725493396,1725493396.603672,-18000,,
com.google.Chrome,6,1725493369,1725493375,1725493376.844396,-18000,,
com.apple.news,8,1725493359,1725493367,1725493367.581712,-18000,EB445137-D7F5-57EC-87DA-1DB460D64046,"iPhone13,2"
com.apple.news,8,1725493189,1725493197,1725493197.145399,-18000,EB445137-D7F5-57EC-87DA-1DB460D64046,"iPhone13,2"
com.apple.camera,1,1725493189,1725493190,1725493191.278928,-18000,EB445137-D7F5-57EC-87DA-1DB460D64046,"iPhone13,2"
com.apple.news,363,1725492402,1725492765,1725492765.7308168,-18000,EB445137-D7F5-57EC-87DA-1DB460D64046,"iPhone13,2"
com.truebill.truebillnative,85,1725492304,1725492389,1725492389.371378,-18000,EB445137-D7F5-57EC-87DA-1DB460D64046,"iPhone13,2"
com.clairmail.fth.client,2,1725492301,1725492303,1725492303.360131,-18000,EB445137-D7F5-57EC-87DA-1DB460D64046,"iPhone13,2"
com.clairmail.fth.client,54,1725492247,1725492301,1725492301.508511,-18000,EB445137-D7F5-57EC-87DA-1DB460D64046,"iPhone13,2"
com.apple.Music,18,1725492227,1725492245,1725492245.664686,-18000,EB445137-D7F5-57EC-87DA-1DB460D64046,"iPhone13,2"
com.clairmail.fth.client,56,1725491514,1725491570,1725491570.952887,-18000,EB445137-D7F5-57EC-87DA-1DB460D64046,"iPhone13,2"
com.myfitnesspal.mfp,45,1725491118,1725491163,1725491163.728088,-18000,EB445137-D7F5-57EC-87DA-1DB460D64046,"iPhone13,2"
com.apple.Music,3,1725491114,1725491117,1725491117.783766,-18000,EB445137-D7F5-57EC-87DA-1DB460D64046,"iPhone13,2"
com.apple.Music,8,1725489984,1725489992,1725489992.8155231,-18000,EB445137-D7F5-57EC-87DA-1DB460D64046,"iPhone13,2"
com.apple.Music,11,1725489512,1725489523,1725489523.8745952,-18000,EB445137-D7F5-57EC-87DA-1DB460D64046,"iPhone13,2"
com.google.chrome.ios,3,1725489505,1725489508,1725489508.533282,-18000,EB445137-D7F5-57EC-87DA-1DB460D64046,"iPhone13,2"
com.google.chrome.ios,5,1725489466,1725489471,1725489471.772208,-18000,EB445137-D7F5-57EC-87DA-1DB460D64046,"iPhone13,2"
com.google.chrome.ios,6,1725489351,1725489357,1725489357.888434,-18000,EB445137-D7F5-57EC-87DA-1DB460D64046,"iPhone13,2"
com.google.chrome.ios,1,1725489331,1725489332,1725489332.5829601,-18000,EB445137-D7F5-57EC-87DA-1DB460D64046,"iPhone13,2"
com.google.chrome.ios,1,1725489327,1725489328,1725489328.891173,-18000,EB445137-D7F5-57EC-87DA-1DB460D64046,"iPhone13,2"
com.google.chrome.ios,3,1725489249,1725489252,1725489252.620867,-18000,EB445137-D7F5-57EC-87DA-1DB460D64046,"iPhone13,2"
com.google.chrome.ios,69,1725489094,1725489163,1725489163.629539,-18000,EB445137-D7F5-57EC-87DA-1DB460D64046,"iPhone13,2"
com.google.chrome.ios,88,1725488992,1725489080,1725489080.372855,-18000,EB445137-D7F5-57EC-87DA-1DB460D64046,"iPhone13,2"
com.apple.camera,4,1725488987,1725488991,1725488992.483463,-18000,EB445137-D7F5-57EC-87DA-1DB460D64046,"iPhone13,2"
com.microsoft.Office.Outlook,6,1725488986,1725488992,1725488993.403183,-18000,EB445137-D7F5-57EC-87DA-1DB460D64046,"iPhone13,2"
com.microsoft.Office.Outlook,8,1725488884,1725488892,1725488892.0029101,-18000,EB445137-D7F5-57EC-87DA-1DB460D64046,"iPhone13,2"
com.microsoft.Office.Outlook,3,1725488855,1725488858,1725488858.234544,-18000,EB445137-D7F5-57EC-87DA-1DB460D64046,"iPhone13,2"
com.apple.camera,14,1725488792,1725488806,1725488806.342352,-18000,EB445137-D7F5-57EC-87DA-1DB460D64046,"iPhone13,2"
com.microsoft.Office.Outlook,15,1725488791,1725488806,1725488806.337856,-18000,EB445137-D7F5-57EC-87DA-1DB460D64046,"iPhone13,2"
com.apple.camera,47,1725488742,1725488789,1725488789.692893,-18000,EB445137-D7F5-57EC-87DA-1DB460D64046,"iPhone13,2"
com.microsoft.Office.Outlook,48,1725488741,1725488789,1725488789.691257,-18000,EB445137-D7F5-57EC-87DA-1DB460D64046,"iPhone13,2"
com.apple.camera,36,1725488698,1725488734,1725488735.392004,-18000,EB445137-D7F5-57EC-87DA-1DB460D64046,"iPhone13,2"
com.microsoft.Office.Outlook,37,1725488697,1725488734,1725488735.225473,-18000,EB445137-D7F5-57EC-87DA-1DB460D64046,"iPhone13,2"
com.apple.camera,7,1725488682,1725488689,1725488690.5884109,-18000,EB445137-D7F5-57EC-87DA-1DB460D64046,"iPhone13,2"
com.microsoft.Office.Outlook,8,1725488681,1725488689,1725488690.442556,-18000,EB445137-D7F5-57EC-87DA-1DB460D64046,"iPhone13,2"
com.microsoft.Office.Outlook,6,1725488602,1725488608,1725488608.322999,-18000,EB445137-D7F5-57EC-87DA-1DB460D64046,"iPhone13,2"
com.apple.camera,8,1725488526,1725488534,1725488536.248894,-18000,EB445137-D7F5-57EC-87DA-1DB460D64046,"iPhone13,2"
com.microsoft.Office.Outlook,10,1725488524,1725488534,1725488536.206541,-18000,EB445137-D7F5-57EC-87DA-1DB460D64046,"iPhone13,2"
com.microsoft.Office.Outlook,6,1725488407,1725488413,1725488413.914449,-18000,EB445137-D7F5-57EC-87DA-1DB460D64046,"iPhone13,2"
com.microsoft.Office.Outlook,2,1725488379,1725488381,1725488381.274881,-18000,EB445137-D7F5-57EC-87DA-1DB460D64046,"iPhone13,2"
com.apple.camera,8,1725488335,1725488343,1725488344.581238,-18000,EB445137-D7F5-57EC-87DA-1DB460D64046,"iPhone13,2"
com.microsoft.Office.Outlook,9,1725488334,1725488343,1725488344.467637,-18000,EB445137-D7F5-57EC-87DA-1DB460D64046,"iPhone13,2"
com.microsoft.Office.Outlook,3,1725487234,1725487237,1725487237.148891,-18000,EB445137-D7F5-57EC-87DA-1DB460D64046,"iPhone13,2"
com.microsoft.Office.Outlook,6,1725487008,1725487014,1725487014.4583821,-18000,EB445137-D7F5-57EC-87DA-1DB460D64046,"iPhone13,2"
com.instructure.icanvas,5,1725486649,1725486654,1725486654.7090158,-18000,EB445137-D7F5-57EC-87DA-1DB460D64046,"iPhone13,2"
com.toyopagroup.picaboo,3,1725486641,1725486644,1725486644.874347,-18000,EB445137-D7F5-57EC-87DA-1DB460D64046,"iPhone13,2"
com.google.Chrome,6,1725486476,1725486482,1725486482.794187,-18000,,
us.zoom.xos,7,1725486469,1725486476,1725486476.7519832,-18000,,
com.google.Chrome,236,1725486233,1725486469,1725486469.604737,-18000,,
us.zoom.xos,3,1725486230,1725486233,1725486234.069792,-18000,,
com.google.Chrome,271,1725485959,1725486230,1725486230.0771852,-18000,,
us.zoom.xos,2,1725485957,1725485959,1725485959.4258142,-18000,,
com.google.Chrome,37,1725485920,1725485957,1725485957.553049,-18000,,
us.zoom.xos,3,1725485917,1725485920,1725485920.571231,-18000,,
com.google.Chrome,637,1725485280,1725485917,1725485917.1721969,-18000,,
us.zoom.xos,5,1725485275,1725485280,1725485280.970176,-18000,,
com.google.Chrome,17,1725485258,1725485275,1725485275.112328,-18000,,
us.zoom.xos,3,1725485255,1725485258,1725485258.926662,-18000,,
com.google.Chrome,7,1725485248,1725485255,1725485255.982337,-18000,,
com.microsoft.Outlook,2,1725485246,1725485248,1725485248.9198852,-18000,,
com.google.Chrome,21,1725485225,1725485246,1725485246.071865,-18000,,
com.microsoft.Outlook,2,1725485223,1725485225,1725485225.3721418,-18000,,
com.google.Chrome,106,1725485117,1725485223,1725485223.352999,-18000,,
us.zoom.xos,3,1725485114,1725485117,1725485118.038893,-18000,,
com.truebill.truebillnative,23,1725484687,1725484710,1725484710.382958,-18000,EB445137-D7F5-57EC-87DA-1DB460D64046,"iPhone13,2"
com.apple.news,18,1725484560,1725484578,1725484578.612893,-18000,EB445137-D7F5-57EC-87DA-1DB460D64046,"iPhone13,2"
com.microsoft.Office.Outlook,8,1725484544,1725484552,1725484552.7814279,-18000,EB445137-D7F5-57EC-87DA-1DB460D64046,"iPhone13,2"
com.microsoft.Office.Outlook,2,1725484532,1725484534,1725484534.141677,-18000,EB445137-D7F5-57EC-87DA-1DB460D64046,"iPhone13,2"
us.zoom.xos,300,1725484526,1725484826,1725484826.4728332,-18000,,
com.google.Chrome,97,1725484429,1725484526,1725484526.492289,-18000,,
us.zoom.xos,28,1725484401,1725484429,1725484429.611886,-18000,,
com.google.Chrome,0,1725484401,1725484401,1725484401.837356,-18000,,
us.zoom.xos,3,1725484398,1725484401,1725484401.121982,-18000,,
com.google.Chrome,48,1725484350,1725484398,1725484398.816961,-18000,,
com.leomehlig.today,12,1725484338,1725484350,1725484350.394053,-18000,,
us.zoom.xos,2,1725484336,1725484338,1725484338.4339561,-18000,,
com.apple.Notes,6,1725484330,1725484336,1725484336.309314,-18000,,
us.zoom.xos,1,1725484329,1725484330,1725484330.86805,-18000,,
com.microsoft.Word,5,1725484324,1725484329,1725484329.26256,-18000,,
com.microsoft.Office.Outlook,2,1725484316,1725484318,1725484318.218058,-18000,EB445137-D7F5-57EC-87DA-1DB460D64046,"iPhone13,2"
us.zoom.xos,46,1725484278,1725484324,1725484324.798028,-18000,,
com.apple.finder,27,1725484251,1725484278,1725484279.016155,-18000,,
com.google.Chrome,15,1725484236,1725484251,1725484251.8488932,-18000,,
com.apple.finder,24,1725484212,1725484236,1725484236.3263922,-18000,,
com.google.Chrome,28,1725484184,1725484212,1725484212.097058,-18000,,
com.microsoft.Word,2,1725484182,1725484184,1725484184.905422,-18000,,
com.google.Chrome,36,1725484146,1725484182,1725484182.133791,-18000,,
com.microsoft.Word,6,1725484140,1725484146,1725484146.138729,-18000,,
com.google.Chrome,90,1725484050,1725484140,1725484140.285565,-18000,,
us.zoom.xos,4,1725484046,1725484050,1725484050.178679,-18000,,
com.google.Chrome,16,1725484030,1725484046,1725484047.0509,-18000,,
us.zoom.xos,64,1725483966,1725484030,1725484031.009026,-18000,,
com.google.Chrome,36,1725483930,1725483966,1725483966.435348,-18000,,
us.zoom.xos,6,1725483924,1725483930,1725483930.101866,-18000,,
com.google.Chrome,52,1725483872,1725483924,1725483924.419884,-18000,,
us.zoom.xos,9,1725483863,1725483872,1725483872.2795072,-18000,,
com.google.Chrome,153,1725483710,1725483863,1725483863.1894689,-18000,,
us.zoom.xos,5,1725483705,1725483710,1725483710.3866038,-18000,,
com.google.Chrome,19,1725483686,1725483705,1725483706.024796,-18000,,
com.microsoft.Word,6,1725483680,1725483686,1725483686.6543012,-18000,,
com.google.Chrome,27,1725483653,1725483680,1725483680.945492,-18000,,
com.microsoft.Word,4,1725483649,1725483653,1725483653.9281092,-18000,,
com.google.Chrome,33,1725483616,1725483649,1725483649.741071,-18000,,
com.microsoft.Word,4,1725483612,1725483616,1725483616.711234,-18000,,
com.google.Chrome,9,1725483603,1725483612,1725483612.063613,-18000,,
com.microsoft.Word,10,1725483593,1725483603,1725483604.035327,-18000,,
com.google.Chrome,8,1725483585,1725483593,1725483593.819145,-18000,,
com.microsoft.Word,5,1725483580,1725483585,1725483585.605304,-18000,,
us.zoom.xos,19,1725483561,1725483580,1725483580.738306,-18000,,
com.google.Chrome,25,1725483536,1725483561,1725483561.4671931,-18000,,
com.microsoft.Word,225,1725483311,1725483536,1725483536.398663,-18000,,
com.microsoft.Office.Outlook,10,1725483080,1725483090,1725483090.3139992,-18000,EB445137-D7F5-57EC-87DA-1DB460D64046,"iPhone13,2"
com.google.Chrome,596,1725482715,1725483311,1725483311.141933,-18000,,
com.microsoft.Word,1,1725482714,1725482715,1725482715.873491,-18000,,
com.google.Chrome,153,1725482561,1725482714,1725482714.986844,-18000,,
com.microsoft.Word,3,1725482558,1725482561,1725482561.636753,-18000,,
com.google.Chrome,86,1725482472,1725482558,1725482558.4732199,-18000,,
com.microsoft.Word,4,1725482468,1725482472,1725482472.232257,-18000,,
com.google.Chrome,69,1725482399,1725482468,1725482468.9733381,-18000,,
com.microsoft.Word,5,1725482394,1725482399,1725482399.924286,-18000,,
com.google.Chrome,23,1725482371,1725482394,1725482394.935927,-18000,,
com.microsoft.Word,2,1725482369,1725482371,1725482371.925397,-18000,,
com.google.Chrome,163,1725482206,1725482369,1725482369.4345899,-18000,,
com.microsoft.Word,3,1725482203,1725482206,1725482206.8156009,-18000,,
com.google.Chrome,31,1725482172,1725482203,1725482203.81185,-18000,,
com.microsoft.Word,3,1725482169,1725482172,1725482172.960254,-18000,,
com.google.Chrome,25,1725482144,1725482169,1725482169.501823,-18000,,
com.microsoft.Word,5,1725482139,1725482144,1725482144.4629579,-18000,,
com.google.Chrome,179,1725481960,1725482139,1725482139.6872191,-18000,,
com.apple.iCal,43,1725481917,1725481960,1725481960.219876,-18000,,
com.google.Chrome,1,1725481916,1725481917,1725481917.542691,-18000,,
com.apple.iCal,12,1725481904,1725481916,1725481916.3370461,-18000,,
com.microsoft.Word,27,1725481877,1725481904,1725481904.4788852,-18000,,
com.google.Chrome,198,1725481679,1725481877,1725481877.254883,-18000,,
com.microsoft.Word,166,1725481513,1725481679,1725481679.644026,-18000,,
com.google.Chrome,14,1725481499,1725481513,1725481513.490927,-18000,,
com.microsoft.Word,77,1725481422,1725481499,1725481499.7907128,-18000,,
com.google.Chrome,13,1725481409,1725481422,1725481422.974931,-18000,,
com.toyopagroup.picaboo,63,1725481210,1725481273,1725481273.299629,-18000,EB445137-D7F5-57EC-87DA-1DB460D64046,"iPhone13,2"
com.apple.MobileSMS,7,1725481203,1725481210,1725481210.8283072,-18000,EB445137-D7F5-57EC-87DA-1DB460D64046,"iPhone13,2"
com.toyopagroup.picaboo,15,1725481187,1725481202,1725481203.047936,-18000,EB445137-D7F5-57EC-87DA-1DB460D64046,"iPhone13,2"
com.microsoft.Word,287,1725481122,1725481409,1725481409.7468262,-18000,,
com.google.Chrome,1,1725481121,1725481122,1725481122.80565,-18000,,
com.microsoft.Word,2,1725481119,1725481121,1725481121.607086,-18000,,
com.google.Chrome,2,1725481117,1725481119,1725481119.4622688,-18000,,
com.microsoft.Word,14,1725481103,1725481117,1725481117.54984,-18000,,
com.google.Chrome,3,1725481100,1725481103,1725481103.327992,-18000,,
com.microsoft.Word,6,1725481094,1725481100,1725481100.304554,-18000,,
com.google.Chrome,30,1725481064,1725481094,1725481094.597604,-18000,,
com.microsoft.Word,4,1725481060,1725481064,1725481064.732133,-18000,,
com.google.Chrome,3,1725481057,1725481060,1725481060.6186352,-18000,,
com.microsoft.Word,75,1725480982,1725481057,1725481057.163248,-18000,,
com.google.Chrome,1,1725480981,1725480982,1725480982.911382,-18000,,
com.microsoft.Word,19,1725480962,1725480981,1725480981.33476,-18000,,
com.google.Chrome,2,1725480960,1725480962,1725480962.5515351,-18000,,
com.microsoft.Word,19,1725480941,1725480960,1725480960.077189,-18000,,
com.google.Chrome,41,1725480900,1725480941,1725480941.6824598,-18000,,
com.microsoft.Word,473,1725480427,1725480900,1725480900.105184,-18000,,
com.google.Chrome,1,1725480426,1725480427,1725480427.452551,-18000,,
com.microsoft.Word,1,1725480425,1725480426,1725480426.74685,-18000,,
com.google.Chrome,1,1725480424,1725480425,1725480425.9564219,-18000,,
com.microsoft.Word,6,1725480418,1725480424,1725480425.0216641,-18000,,
com.google.Chrome,2,1725480416,1725480418,1725480418.507679,-18000,,
com.microsoft.Word,1,1725480415,1725480416,1725480416.734167,-18000,,
com.google.Chrome,3,1725480412,1725480415,1725480415.5634232,-18000,,
com.microsoft.Word,17,1725480395,1725480412,1725480412.617379,-18000,,
com.google.Chrome,2,1725480393,1725480395,1725480395.1015549,-18000,,
com.microsoft.Word,6,1725480387,1725480393,1725480393.545515,-18000,,
com.google.Chrome,11,1725480376,1725480387,1725480387.457902,-18000,,
com.microsoft.Word,613,1725479763,1725480376,1725480376.31913,-18000,,
com.google.Chrome,2,1725479761,1725479763,1725479763.8792849,-18000,,
com.microsoft.Word,38,1725479723,1725479761,1725479761.452241,-18000,,
com.google.Chrome,21,1725479702,1725479723,1725479723.4024858,-18000,,
com.microsoft.Word,13,1725479689,1725479702,1725479702.477211,-18000,,
com.google.Chrome,2,1725479687,1725479689,1725479690.027625,-18000,,
com.microsoft.Word,8,1725479679,1725479687,1725479687.970038,-18000,,
com.google.Chrome,6,1725479673,1725479679,1725479679.333801,-18000,,
com.microsoft.Word,4,1725479669,1725479673,1725479673.640959,-18000,,
com.google.Chrome,9,1725479660,1725479669,1725479669.980658,-18000,,
com.microsoft.Word,52,1725479608,1725479660,1725479660.5422258,-18000,,
com.apple.finder,0,1725479608,1725479608,1725479608.8743582,-18000,,
com.apple.mail,2,1725479606,1725479608,1725479608.465609,-18000,,
com.microsoft.Word,121,1725479485,1725479606,1725479606.9381762,-18000,,
com.apple.finder,3,1725479482,1725479485,1725479485.445214,-18000,,
com.google.Chrome,9,1725479473,1725479482,1725479482.340177,-18000,,
com.apple.camera,4,1725478786,1725478790,1725478791.3065948,-18000,EB445137-D7F5-57EC-87DA-1DB460D64046,"iPhone13,2"
com.apple.camera,5,1725478654,1725478659,1725478659.984836,-18000,EB445137-D7F5-57EC-87DA-1DB460D64046,"iPhone13,2"
com.apple.mobilenotes,18,1725478063,1725478081,1725478081.249638,-18000,EB445137-D7F5-57EC-87DA-1DB460D64046,"iPhone13,2"
com.apple.news,81,1725477979,1725478060,1725478060.493882,-18000,EB445137-D7F5-57EC-87DA-1DB460D64046,"iPhone13,2"
com.apple.mobilecal,80,1725477885,1725477965,1725477965.47889,-18000,EB445137-D7F5-57EC-87DA-1DB460D64046,"iPhone13,2"
com.apple.news,16,1725477842,1725477858,1725477858.551476,-18000,EB445137-D7F5-57EC-87DA-1DB460D64046,"iPhone13,2"
com.apple.news,335,1725477499,1725477834,1725477834.495157,-18000,EB445137-D7F5-57EC-87DA-1DB460D64046,"iPhone13,2"
com.google.Chrome,29,1725477462,1725477491,1725477491.360085,-18000,,
com.apple.Notes,32,1725477430,1725477462,1725477462.193733,-18000,,
com.google.Chrome,173,1725477257,1725477430,1725477430.546449,-18000,,
com.leomehlig.today,20,1725477237,1725477257,1725477257.1593208,-18000,,
com.google.Chrome,8,1725477229,1725477237,1725477237.323152,-18000,,
com.apple.news,169,1725477042,1725477211,1725477212.060878,-18000,EB445137-D7F5-57EC-87DA-1DB460D64046,"iPhone13,2"
com.google.Chrome,59,1725476453,1725476512,1725476512.9515781,-18000,,
com.apple.finder,6,1725476447,1725476453,1725476453.089499,-18000,,
com.google.Chrome,1,1725476446,1725476447,1725476447.747608,-18000,,
com.apple.finder,3,1725476443,1725476446,1725476446.728218,-18000,,
com.google.Chrome,56,1725476387,1725476443,1725476443.6930099,-18000,,
com.apple.wifi.diagnostics,4,1725476373,1725476377,1725476377.894531,-18000,,
com.google.Chrome,6,1725476367,1725476373,1725476373.712115,-18000,,
com.apple.wifi.diagnostics,23,1725476344,1725476367,1725476367.518259,-18000,,
com.google.Chrome,3,1725476341,1725476344,1725476344.9559522,-18000,,
com.apple.wifi.diagnostics,8,1725476333,1725476341,1725476341.218659,-18000,,
com.toyopagroup.picaboo,3,1725476311,1725476314,1725476314.734221,-18000,EB445137-D7F5-57EC-87DA-1DB460D64046,"iPhone13,2"
com.microsoft.Office.Outlook,3,1725476308,1725476311,1725476311.931542,-18000,EB445137-D7F5-57EC-87DA-1DB460D64046,"iPhone13,2"
com.google.Chrome,69,1725476264,1725476333,1725476333.343412,-18000,,
com.microsoft.Office.Outlook,8,1725475722,1725475730,1725475730.9434628,-18000,EB445137-D7F5-57EC-87DA-1DB460D64046,"iPhone13,2"
com.microsoft.Office.Outlook,16,1725474336,1725474352,1725474352.0495238,-18000,EB445137-D7F5-57EC-87DA-1DB460D64046,"iPhone13,2"
com.instructure.icanvas,22,1725474314,1725474336,1725474337.105411,-18000,EB445137-D7F5-57EC-87DA-1DB460D64046,"iPhone13,2"
com.google.chrome.ios,11,1725474303,1725474314,1725474314.766803,-18000,EB445137-D7F5-57EC-87DA-1DB460D64046,"iPhone13,2"
com.google.chrome.ios,171,1725472518,1725472689,1725472689.1877232,-18000,EB445137-D7F5-57EC-87DA-1DB460D64046,"iPhone13,2"
com.instructure.icanvas,40,1725472478,1725472518,1725472518.872583,-18000,EB445137-D7F5-57EC-87DA-1DB460D64046,"iPhone13,2"
com.microsoft.Office.Outlook,30,1725472448,1725472478,1725472478.209593,-18000,EB445137-D7F5-57EC-87DA-1DB460D64046,"iPhone13,2"
com.instructure.icanvas,35,1725472413,1725472448,1725472448.219821,-18000,EB445137-D7F5-57EC-87DA-1DB460D64046,"iPhone13,2"
com.google.chrome.ios,52,1725472361,1725472413,1725472413.293311,-18000,EB445137-D7F5-57EC-87DA-1DB460D64046,"iPhone13,2"
com.instructure.icanvas,33,1725472328,1725472361,1725472362.0274792,-18000,EB445137-D7F5-57EC-87DA-1DB460D64046,"iPhone13,2"
com.toyopagroup.picaboo,12,1725472297,1725472309,1725472309.552328,-18000,EB445137-D7F5-57EC-87DA-1DB460D64046,"iPhone13,2"
com.apple.weather,5,1725472292,1725472297,1725472297.365875,-18000,EB445137-D7F5-57EC-87DA-1DB460D64046,"iPhone13,2"
com.apple.weather,37,1725471733,1725471770,1725471770.874567,-18000,EB445137-D7F5-57EC-87DA-1DB460D64046,"iPhone13,2"
com.apple.mobilephone,2,1725471731,1725471733,1725471733.632495,-18000,EB445137-D7F5-57EC-87DA-1DB460D64046,"iPhone13,2"
com.thestorygraph.thestorygraph,3,1725471728,1725471731,1725471731.153444,-18000,EB445137-D7F5-57EC-87DA-1DB460D64046,"iPhone13,2"
com.thestorygraph.thestorygraph,40,1725471299,1725471339,1725471339.130021,-18000,EB445137-D7F5-57EC-87DA-1DB460D64046,"iPhone13,2"
com.myfitnesspal.mfp,4,1725471292,1725471296,1725471296.290611,-18000,EB445137-D7F5-57EC-87DA-1DB460D64046,"iPhone13,2"
com.myfitnesspal.mfp,6,1725471215,1725471221,1725471221.144154,-18000,EB445137-D7F5-57EC-87DA-1DB460D64046,"iPhone13,2"
com.myfitnesspal.mfp,6,1725471008,1725471014,1725471014.1925,-18000,EB445137-D7F5-57EC-87DA-1DB460D64046,"iPhone13,2"
com.myfitnesspal.mfp,6,1725470721,1725470727,1725470727.620409,-18000,EB445137-D7F5-57EC-87DA-1DB460D64046,"iPhone13,2"
com.myfitnesspal.mfp,6,1725470352,1725470358,1725470358.5273762,-18000,EB445137-D7F5-57EC-87DA-1DB460D64046,"iPhone13,2"
com.myfitnesspal.mfp,13,1725470329,1725470342,1725470342.802161,-18000,EB445137-D7F5-57EC-87DA-1DB460D64046,"iPhone13,2"
com.myfitnesspal.mfp,9,1725469075,1725469084,1725469084.2982059,-18000,EB445137-D7F5-57EC-87DA-1DB460D64046,"iPhone13,2"
com.myfitnesspal.mfp,96,1725468977,1725469073,1725469073.96895,-18000,EB445137-D7F5-57EC-87DA-1DB460D64046,"iPhone13,2"
com.google.ios.youtube,242,1725468735,1725468977,1725468978.144058,-18000,EB445137-D7F5-57EC-87DA-1DB460D64046,"iPhone13,2"
com.google.ios.youtube,522,1725468165,1725468687,1725468687.914948,-18000,EB445137-D7F5-57EC-87DA-1DB460D64046,"iPhone13,2"
com.google.Chrome,313,1725467452,1725467765,1725467765.299237,-18000,,
com.burbn.instagram,79,1725467298,1725467377,1725467377.7974381,-18000,EB445137-D7F5-57EC-87DA-1DB460D64046,"iPhone13,2"
com.toyopagroup.picaboo,5,1725467293,1725467298,1725467298.455017,-18000,EB445137-D7F5-57EC-87DA-1DB460D64046,"iPhone13,2"
com.burbn.instagram,87,1725467206,1725467293,1725467295.277316,-18000,EB445137-D7F5-57EC-87DA-1DB460D64046,"iPhone13,2"
com.toyopagroup.picaboo,27,1725467174,1725467201,1725467201.660289,-18000,EB445137-D7F5-57EC-87DA-1DB460D64046,"iPhone13,2"
com.toyopagroup.picaboo,134,1725467028,1725467162,1725467162.778006,-18000,EB445137-D7F5-57EC-87DA-1DB460D64046,"iPhone13,2"
com.apple.mobilecal,8,1725467020,1725467028,1725467028.401824,-18000,EB445137-D7F5-57EC-87DA-1DB460D64046,"iPhone13,2"
com.toyopagroup.picaboo,65,1725466952,1725467017,1725467017.091134,-18000,EB445137-D7F5-57EC-87DA-1DB460D64046,"iPhone13,2"
com.hammerandchisel.discord,216,1725466712,1725466928,1725466928.031538,-18000,EB445137-D7F5-57EC-87DA-1DB460D64046,"iPhone13,2"
com.microsoft.Office.Outlook,16,1725466694,1725466710,1725466710.988647,-18000,EB445137-D7F5-57EC-87DA-1DB460D64046,"iPhone13,2"
com.microsoft.Office.Outlook,3,1725466689,1725466692,1725466692.9829578,-18000,EB445137-D7F5-57EC-87DA-1DB460D64046,"iPhone13,2"
com.microsoft.Office.Outlook,8,1725466636,1725466644,1725466644.642302,-18000,EB445137-D7F5-57EC-87DA-1DB460D64046,"iPhone13,2"
com.toyopagroup.picaboo,72,1725466555,1725466627,1725466627.425891,-18000,EB445137-D7F5-57EC-87DA-1DB460D64046,"iPhone13,2"
com.truebill.truebillnative,213,1725466312,1725466525,1725466525.933298,-18000,EB445137-D7F5-57EC-87DA-1DB460D64046,"iPhone13,2"
com.instructure.icanvas,4,1725466285,1725466289,1725466289.229113,-18000,EB445137-D7F5-57EC-87DA-1DB460D64046,"iPhone13,2"
com.google.Chrome,671,1725466266,1725466937,1725466937.15138,-18000,,
com.leomehlig.today,57,1725466209,1725466266,1725466266.247034,-18000,,
com.apple.MobileSMS,6,1725466203,1725466209,1725466209.829273,-18000,,
com.google.Chrome,204,1725465999,1725466203,1725466203.136983,-18000,,
com.instructure.icanvas,7,1725465924,1725465931,1725465931.6153522,-18000,EB445137-D7F5-57EC-87DA-1DB460D64046,"iPhone13,2"
com.instructure.icanvas,7,1725465843,1725465850,1725465850.307805,-18000,EB445137-D7F5-57EC-87DA-1DB460D64046,"iPhone13,2"
com.instructure.icanvas,2,1725465349,1725465351,1725465351.596271,-18000,EB445137-D7F5-57EC-87DA-1DB460D64046,"iPhone13,2"
com.instructure.icanvas,2,1725465347,1725465349,1725465349.2156281,-18000,EB445137-D7F5-57EC-87DA-1DB460D64046,"iPhone13,2"
com.instructure.icanvas,36,1725465112,1725465148,1725465148.885223,-18000,EB445137-D7F5-57EC-87DA-1DB460D64046,"iPhone13,2"
com.hammerandchisel.discord,5,1725465060,1725465065,1725465065.81537,-18000,EB445137-D7F5-57EC-87DA-1DB460D64046,"iPhone13,2"
com.google.ios.youtube,2,1725465058,1725465060,1725465060.8903341,-18000,EB445137-D7F5-57EC-87DA-1DB460D64046,"iPhone13,2"
com.google.Chrome,33,1725464959,1725464992,1725464992.974396,-18000,,
com.google.Chrome,1187,1725463771,1725464958,1725464958.1013598,-18000,,
com.google.ios.youtube,2,1725461170,1725461172,1725461172.877253,-18000,EB445137-D7F5-57EC-87DA-1DB460D64046,"iPhone13,2"
com.google.ios.youtube,7,1725461046,1725461053,1725461053.0195398,-18000,EB445137-D7F5-57EC-87DA-1DB460D64046,"iPhone13,2"
com.google.ios.youtube,2,1725461012,1725461014,1725461014.18532,-18000,EB445137-D7F5-57EC-87DA-1DB460D64046,"iPhone13,2"
com.google.ios.youtube,6,1725460506,1725460512,1725460512.3896608,-18000,EB445137-D7F5-57EC-87DA-1DB460D64046,"iPhone13,2"
com.google.ios.youtube,435,1725460056,1725460491,1725460491.523803,-18000,EB445137-D7F5-57EC-87DA-1DB460D64046,"iPhone13,2"
com.apple.MobileSMS,8,1725460048,1725460056,1725460056.2267342,-18000,EB445137-D7F5-57EC-87DA-1DB460D64046,"iPhone13,2"
com.myfitnesspal.mfp,5,1725460043,1725460048,1725460048.836818,-18000,EB445137-D7F5-57EC-87DA-1DB460D64046,"iPhone13,2"
com.myfitnesspal.mfp,66,1725459954,1725460020,1725460020.7776341,-18000,EB445137-D7F5-57EC-87DA-1DB460D64046,"iPhone13,2"
com.apple.Health,3,1725459951,1725459954,1725459954.447394,-18000,EB445137-D7F5-57EC-87DA-1DB460D64046,"iPhone13,2"
com.apple.Health,6,1725459413,1725459419,1725459419.987648,-18000,EB445137-D7F5-57EC-87DA-1DB460D64046,"iPhone13,2"
com.apple.Health,13,1725459389,1725459402,1725459402.630446,-18000,EB445137-D7F5-57EC-87DA-1DB460D64046,"iPhone13,2"
com.apple.Health,7,1725459375,1725459382,1725459382.150097,-18000,EB445137-D7F5-57EC-87DA-1DB460D64046,"iPhone13,2"
com.renpho.health,78,1725459297,1725459375,1725459375.3262072,-18000,EB445137-D7F5-57EC-87DA-1DB460D64046,"iPhone13,2"
com.apple.camera,1,1725459293,1725459294,1725459294.249874,-18000,EB445137-D7F5-57EC-87DA-1DB460D64046,"iPhone13,2"
com.google.ios.youtube,1,1725459286,1725459287,1725459287.270364,-18000,EB445137-D7F5-57EC-87DA-1DB460D64046,"iPhone13,2"
com.google.ios.youtube,13,1725458448,1725458461,1725458461.970283,-18000,EB445137-D7F5-57EC-87DA-1DB460D64046,"iPhone13,2"
com.google.ios.youtube,1033,1725457389,1725458422,1725458422.516669,-18000,EB445137-D7F5-57EC-87DA-1DB460D64046,"iPhone13,2"
com.apple.Health,38,1725457324,1725457362,1725457362.987568,-18000,EB445137-D7F5-57EC-87DA-1DB460D64046,"iPhone13,2"
com.apple.Health,76,1725457222,1725457298,1725457298.989437,-18000,EB445137-D7F5-57EC-87DA-1DB460D64046,"iPhone13,2"
com.thestorygraph.thestorygraph,33,1725425934,1725425967,1725425967.797423,-18000,EB445137-D7F5-57EC-87DA-1DB460D64046,"iPhone13,2"
com.apple.mobilenotes,9,1725425922,1725425931,1725425931.398487,-18000,EB445137-D7F5-57EC-87DA-1DB460D64046,"iPhone13,2"
com.google.Chrome,68,1725424238,1725424306,1725424306.205832,-18000,,
com.leomehlig.today,0,1725424238,1725424238,1725424238.790187,-18000,,
com.apple.iCal,145,1725424093,1725424238,1725424238.5847569,-18000,,
com.google.Chrome,6,1725424087,1725424093,1725424093.106635,-18000,,
com.apple.iCal,42,1725424045,1725424087,1725424087.475986,-18000,,
com.google.Chrome,2,1725424043,1725424045,1725424045.30444,-18000,,
com.apple.iCal,2,1725424041,1725424043,1725424043.306153,-18000,,
com.google.Chrome,4,1725424037,1725424041,1725424041.480227,-18000,,
com.apple.iCal,23,1725424014,1725424037,1725424037.603915,-18000,,
com.google.Chrome,130,1725423884,1725424014,1725424014.257388,-18000,,
com.apple.iCal,4,1725423880,1725423884,1725423884.89995,-18000,,
com.google.Chrome,5,1725423875,1725423880,1725423880.9942431,-18000,,
com.apple.iCal,6,1725423869,1725423875,1725423875.061788,-18000,,
com.google.Chrome,122,1725423747,1725423869,1725423869.090405,-18000,,
com.apple.finder,30,1725423717,1725423747,1725423747.2636871,-18000,,
com.microsoft.Word,524,1725423193,1725423717,1725423717.2033238,-18000,,
com.apple.finder,27,1725423166,1725423193,1725423193.206942,-18000,,
com.google.Chrome,1053,1725422113,1725423166,1725423166.850039,-18000,,
com.apple.mobilenotes,13,1725422095,1725422108,1725422108.13592,-18000,EB445137-D7F5-57EC-87DA-1DB460D64046,"iPhone13,2"
com.apple.mobilenotes,14,1725422078,1725422092,1725422092.873579,-18000,EB445137-D7F5-57EC-87DA-1DB460D64046,"iPhone13,2"
com.hammerandchisel.discord,26,1725421765,1725421791,1725421791.969002,-18000,EB445137-D7F5-57EC-87DA-1DB460D64046,"iPhone13,2"
com.toyopagroup.picaboo,5,1725421757,1725421762,1725421762.661345,-18000,EB445137-D7F5-57EC-87DA-1DB460D64046,"iPhone13,2"
com.burbn.instagram,74,1725418733,1725418807,1725418807.7764568,-18000,EB445137-D7F5-57EC-87DA-1DB460D64046,"iPhone13,2"
com.google.chrome.ios,2,1725418727,1725418729,1725418730.1140661,-18000,EB445137-D7F5-57EC-87DA-1DB460D64046,"iPhone13,2"
com.google.chrome.ios,45,1725418550,1725418595,1725418595.622823,-18000,EB445137-D7F5-57EC-87DA-1DB460D64046,"iPhone13,2"
com.tinyspeck.chatlyio,36,1725418514,1725418550,1725418550.968852,-18000,EB445137-D7F5-57EC-87DA-1DB460D64046,"iPhone13,2"
com.google.chrome.ios,33,1725418480,1725418513,1725418513.1652222,-18000,EB445137-D7F5-57EC-87DA-1DB460D64046,"iPhone13,2"
com.microsoft.Office.Outlook,7,1725417446,1725417453,1725417454.046448,-18000,EB445137-D7F5-57EC-87DA-1DB460D64046,"iPhone13,2"
com.google.chrome.ios,22,1725417421,1725417443,1725417443.349705,-18000,EB445137-D7F5-57EC-87DA-1DB460D64046,"iPhone13,2"
com.google.chrome.ios,29,1725416187,1725416216,1725416216.55022,-18000,EB445137-D7F5-57EC-87DA-1DB460D64046,"iPhone13,2"
com.apple.Health,2,1725416185,1725416187,1725416187.724381,-18000,EB445137-D7F5-57EC-87DA-1DB460D64046,"iPhone13,2"
com.apple.Health,7,1725413614,1725413621,1725413621.329108,-18000,EB445137-D7F5-57EC-87DA-1DB460D64046,"iPhone13,2"
com.myfitnesspal.mfp,3,1725413609,1725413612,1725413612.190453,-18000,EB445137-D7F5-57EC-87DA-1DB460D64046,"iPhone13,2"
com.myfitnesspal.mfp,72,1725413533,1725413605,1725413605.7419229,-18000,EB445137-D7F5-57EC-87DA-1DB460D64046,"iPhone13,2"
com.apple.mobilecal,15,1725412759,1725412774,1725412774.635954,-18000,EB445137-D7F5-57EC-87DA-1DB460D64046,"iPhone13,2"
com.apple.news,14,1725412742,1725412756,1725412756.4522262,-18000,EB445137-D7F5-57EC-87DA-1DB460D64046,"iPhone13,2"
com.apple.MobileSMS,4,1725412663,1725412667,1725412667.823995,-18000,EB445137-D7F5-57EC-87DA-1DB460D64046,"iPhone13,2"
com.apple.MobileSMS,30,1725412607,1725412637,1725412637.9091768,-18000,EB445137-D7F5-57EC-87DA-1DB460D64046,"iPhone13,2"
com.toyopagroup.picaboo,11,1725412595,1725412606,1725412606.792398,-18000,EB445137-D7F5-57EC-87DA-1DB460D64046,"iPhone13,2"
com.myfitnesspal.mfp,5,1725412585,1725412590,1725412590.215166,-18000,EB445137-D7F5-57EC-87DA-1DB460D64046,"iPhone13,2"
com.myfitnesspal.mfp,10,1725412399,1725412409,1725412409.8734179,-18000,EB445137-D7F5-57EC-87DA-1DB460D64046,"iPhone13,2"
com.google.chrome.ios,17,1725412381,1725412398,1725412398.5973601,-18000,EB445137-D7F5-57EC-87DA-1DB460D64046,"iPhone13,2"
com.google.chrome.ios,19,1725412327,1725412346,1725412346.533036,-18000,EB445137-D7F5-57EC-87DA-1DB460D64046,"iPhone13,2"
com.google.chrome.ios,3,1725412222,1725412225,1725412225.939427,-18000,EB445137-D7F5-57EC-87DA-1DB460D64046,"iPhone13,2"
com.google.chrome.ios,6,1725411715,1725411721,1725411721.129624,-18000,EB445137-D7F5-57EC-87DA-1DB460D64046,"iPhone13,2"
com.google.chrome.ios,11,1725411578,1725411589,1725411589.071589,-18000,EB445137-D7F5-57EC-87DA-1DB460D64046,"iPhone13,2"
com.apple.camera,6,1725411571,1725411577,1725411578.426866,-18000,EB445137-D7F5-57EC-87DA-1DB460D64046,"iPhone13,2"
com.apple.mobilecal,8,1725411570,1725411578,1725411579.190723,-18000,EB445137-D7F5-57EC-87DA-1DB460D64046,"iPhone13,2"
com.apple.mobilecal,15,1725411426,1725411441,1725411441.403117,-18000,EB445137-D7F5-57EC-87DA-1DB460D64046,"iPhone13,2"
com.truebill.truebillnative,36,1725407372,1725407408,1725407408.2588758,-18000,EB445137-D7F5-57EC-87DA-1DB460D64046,"iPhone13,2"
com.google.ios.youtube,81,1725407211,1725407292,1725407292.7477489,-18000,EB445137-D7F5-57EC-87DA-1DB460D64046,"iPhone13,2"
com.myfitnesspal.mfp,47,1725407148,1725407195,1725407195.882824,-18000,EB445137-D7F5-57EC-87DA-1DB460D64046,"iPhone13,2"
com.instructure.icanvas,86,1725407059,1725407145,1725407145.416798,-18000,EB445137-D7F5-57EC-87DA-1DB460D64046,"iPhone13,2"
com.hammerandchisel.discord,36,1725407017,1725407053,1725407053.4553452,-18000,EB445137-D7F5-57EC-87DA-1DB460D64046,"iPhone13,2"
com.tinyspeck.chatlyio,4,1725407013,1725407017,1725407018.576157,-18000,EB445137-D7F5-57EC-87DA-1DB460D64046,"iPhone13,2"
com.google.Chrome,342,1725406955,1725407297,1725407297.328244,-18000,,
com.apple.Maps,67,1725406888,1725406955,1725406955.6347861,-18000,,
com.leomehlig.today,94,1725406794,1725406888,1725406888.929807,-18000,,
com.google.Chrome,39,1725406755,1725406794,1725406794.0890431,-18000,,
com.leomehlig.today,5,1725406750,1725406755,1725406755.632893,-18000,,
com.google.Chrome,38,1725406712,1725406750,1725406750.330889,-18000,,
com.apple.finder,4,1725406708,1725406712,1725406712.131593,-18000,,
com.apple.Terminal,2,1725406706,1725406708,1725406708.4407,-18000,,
com.apple.finder,7,1725406699,1725406706,1725406706.1374412,-18000,,
com.tinyspeck.chatlyio,26,1725406608,1725406634,1725406634.5195332,-18000,EB445137-D7F5-57EC-87DA-1DB460D64046,"iPhone13,2"
com.google.Chrome,95,1725406604,1725406699,1725406699.574069,-18000,,
com.myfitnesspal.mfp,35,1725406571,1725406606,1725406606.465977,-18000,EB445137-D7F5-57EC-87DA-1DB460D64046,"iPhone13,2"
com.leomehlig.today,4,1725406567,1725406571,1725406571.9717212,-18000,EB445137-D7F5-57EC-87DA-1DB460D64046,"iPhone13,2"
com.leomehlig.today,24,1725406060,1725406084,1725406084.878644,-18000,EB445137-D7F5-57EC-87DA-1DB460D64046,"iPhone13,2"
com.google.chrome.ios,173,1725405882,1725406055,1725406055.5338411,-18000,EB445137-D7F5-57EC-87DA-1DB460D64046,"iPhone13,2"
com.google.chrome.ios,20,1725405074,1725405094,1725405094.8710341,-18000,EB445137-D7F5-57EC-87DA-1DB460D64046,"iPhone13,2"
com.google.chrome.ios,17,1725404995,1725405012,1725405012.111068,-18000,EB445137-D7F5-57EC-87DA-1DB460D64046,"iPhone13,2"
com.google.chrome.ios,71,1725404917,1725404988,1725404988.178872,-18000,EB445137-D7F5-57EC-87DA-1DB460D64046,"iPhone13,2"
com.google.chrome.ios,75,1725404590,1725404665,1725404666.0007439,-18000,EB445137-D7F5-57EC-87DA-1DB460D64046,"iPhone13,2"
com.myfitnesspal.mfp,7,1725404582,1725404589,1725404589.845983,-18000,EB445137-D7F5-57EC-87DA-1DB460D64046,"iPhone13,2"
com.microsoft.Office.Outlook,16,1725404566,1725404582,1725404582.736919,-18000,EB445137-D7F5-57EC-87DA-1DB460D64046,"iPhone13,2"
com.microsoft.Office.Outlook,3,1725404186,1725404189,1725404189.1267939,-18000,EB445137-D7F5-57EC-87DA-1DB460D64046,"iPhone13,2"
com.apple.MobileSMS,5,1725404176,1725404181,1725404181.254715,-18000,EB445137-D7F5-57EC-87DA-1DB460D64046,"iPhone13,2"
com.apple.Fitness,7,1725404169,1725404176,1725404176.773869,-18000,EB445137-D7F5-57EC-87DA-1DB460D64046,"iPhone13,2"
com.apple.Fitness,14,1725403514,1725403528,1725403528.717998,-18000,EB445137-D7F5-57EC-87DA-1DB460D64046,"iPhone13,2"
com.apple.Fitness,659,1725402853,1725403512,1725403512.770134,-18000,EB445137-D7F5-57EC-87DA-1DB460D64046,"iPhone13,2"
com.google.Chrome,545,1725402366,1725402911,1725402912.145515,-18000,,
com.google.Chrome,380,1725401375,1725401755,1725401755.531794,-18000,,
com.hammerandchisel.discord,10,1725401240,1725401250,1725401250.232953,-18000,EB445137-D7F5-57EC-87DA-1DB460D64046,"iPhone13,2"
com.muscleforlife.Stacked,85,1725401154,1725401239,1725401239.439608,-18000,EB445137-D7F5-57EC-87DA-1DB460D64046,"iPhone13,2"
com.apple.news,2,1725401147,1725401149,1725401149.672669,-18000,EB445137-D7F5-57EC-87DA-1DB460D64046,"iPhone13,2"
com.apple.news,55,1725401088,1725401143,1725401143.7452831,-18000,EB445137-D7F5-57EC-87DA-1DB460D64046,"iPhone13,2"
com.myfitnesspal.mfp,102,1725400965,1725401067,1725401067.8570008,-18000,EB445137-D7F5-57EC-87DA-1DB460D64046,"iPhone13,2"
com.microsoft.Office.Outlook,34,1725400835,1725400869,1725400869.100587,-18000,EB445137-D7F5-57EC-87DA-1DB460D64046,"iPhone13,2"
com.apple.MobileSMS,7,1725400828,1725400835,1725400835.4995918,-18000,EB445137-D7F5-57EC-87DA-1DB460D64046,"iPhone13,2"
com.apple.MobileSMS,4,1725400297,1725400301,1725400301.379729,-18000,EB445137-D7F5-57EC-87DA-1DB460D64046,"iPhone13,2"
com.apple.MobileSMS,2,1725399071,1725399073,1725399073.3686671,-18000,EB445137-D7F5-57EC-87DA-1DB460D64046,"iPhone13,2"
com.apple.MobileSMS,16,1725399026,1725399042,1725399042.6452808,-18000,EB445137-D7F5-57EC-87DA-1DB460D64046,"iPhone13,2"
com.apple.MobileSMS,5,1725399005,1725399010,1725399010.383922,-18000,EB445137-D7F5-57EC-87DA-1DB460D64046,"iPhone13,2"
com.apple.MobileSMS,22,1725398945,1725398967,1725398967.265538,-18000,EB445137-D7F5-57EC-87DA-1DB460D64046,"iPhone13,2"
com.apple.AppStore,3,1725398942,1725398945,1725398945.8511949,-18000,EB445137-D7F5-57EC-87DA-1DB460D64046,"iPhone13,2"
com.google.Chrome,1270,1725398862,1725400132,1725400132.979693,-18000,,
com.apple.iCal,2,1725398860,1725398862,1725398862.553807,-18000,,
com.apple.AppStore,51,1725398829,1725398880,1725398880.7537022,-18000,EB445137-D7F5-57EC-87DA-1DB460D64046,"iPhone13,2"
com.hammerandchisel.discord,4,1725398824,1725398828,1725398828.083595,-18000,EB445137-D7F5-57EC-87DA-1DB460D64046,"iPhone13,2"
com.hammerandchisel.discord,3,1725398793,1725398796,1725398796.221494,-18000,EB445137-D7F5-57EC-87DA-1DB460D64046,"iPhone13,2"
com.apple.camera,1,1725398743,1725398744,1725398744.621459,-18000,EB445137-D7F5-57EC-87DA-1DB460D64046,"iPhone13,2"
com.hammerandchisel.discord,11,1725398739,1725398750,1725398750.57369,-18000,EB445137-D7F5-57EC-87DA-1DB460D64046,"iPhone13,2"
com.hammerandchisel.discord,3,1725398642,1725398645,1725398645.283783,-18000,EB445137-D7F5-57EC-87DA-1DB460D64046,"iPhone13,2"
com.hammerandchisel.discord,14,1725398596,1725398610,1725398610.7337918,-18000,EB445137-D7F5-57EC-87DA-1DB460D64046,"iPhone13,2"
com.hammerandchisel.discord,42,1725398551,1725398593,1725398593.5128489,-18000,EB445137-D7F5-57EC-87DA-1DB460D64046,"iPhone13,2"
com.apple.iCal,328,1725398513,1725398841,1725398841.865282,-18000,,
com.microsoft.Office.Outlook,38,1725398513,1725398551,1725398551.480472,-18000,EB445137-D7F5-57EC-87DA-1DB460D64046,"iPhone13,2"
com.apple.MobileSMS,21,1725398492,1725398513,1725398513.86278,-18000,EB445137-D7F5-57EC-87DA-1DB460D64046,"iPhone13,2"
com.google.Chrome,1298,1725397215,1725398513,1725398513.648436,-18000,,
com.apple.iCal,114,1725397101,1725397215,1725397215.2272248,-18000,,
com.google.Chrome,1707,1725395394,1725397101,1725397101.369863,-18000,,
com.apple.InCallService,32,1725394399,1725394431,1725394431.516124,-18000,EB445137-D7F5-57EC-87DA-1DB460D64046,"iPhone13,2"
com.apple.InCallService,2,1725393660,1725393662,1725393663.0180101,-18000,EB445137-D7F5-57EC-87DA-1DB460D64046,"iPhone13,2"
com.apple.mobilephone,7,1725393653,1725393660,1725393661.059421,-18000,EB445137-D7F5-57EC-87DA-1DB460D64046,"iPhone13,2"
com.hammerandchisel.discord,26,1725393627,1725393653,1725393653.151493,-18000,EB445137-D7F5-57EC-87DA-1DB460D64046,"iPhone13,2"
com.google.Maps,103,1725393521,1725393624,1725393624.799796,-18000,EB445137-D7F5-57EC-87DA-1DB460D64046,"iPhone13,2"
com.toyopagroup.picaboo,6,1725393506,1725393512,1725393512.7839,-18000,EB445137-D7F5-57EC-87DA-1DB460D64046,"iPhone13,2"
com.toyopagroup.picaboo,2,1725393439,1725393441,1725393441.607405,-18000,EB445137-D7F5-57EC-87DA-1DB460D64046,"iPhone13,2"
com.toyopagroup.picaboo,5,1725391788,1725391793,1725391794.006514,-18000,EB445137-D7F5-57EC-87DA-1DB460D64046,"iPhone13,2"
com.toyopagroup.picaboo,3,1725390644,1725390647,1725390647.0336308,-18000,EB445137-D7F5-57EC-87DA-1DB460D64046,"iPhone13,2"
com.hammerandchisel.discord,3,1725390641,1725390644,1725390644.964947,-18000,EB445137-D7F5-57EC-87DA-1DB460D64046,"iPhone13,2"
com.hammerandchisel.discord,6,1725389428,1725389434,1725389434.590323,-18000,EB445137-D7F5-57EC-87DA-1DB460D64046,"iPhone13,2"
com.google.Chrome,654,1725388768,1725389422,1725389422.8560371,-18000,,
com.apple.Terminal,12,1725388756,1725388768,1725388768.840448,-18000,,
com.google.Chrome,6,1725388750,1725388756,1725388756.7441258,-18000,,
com.hammerandchisel.discord,8,1725388471,1725388479,1725388479.385028,-18000,EB445137-D7F5-57EC-87DA-1DB460D64046,"iPhone13,2"
com.google.ios.youtube,69,1725388397,1725388466,1725388466.483186,-18000,EB445137-D7F5-57EC-87DA-1DB460D64046,"iPhone13,2"
com.toyopagroup.picaboo,5,1725388388,1725388393,1725388393.4244142,-18000,EB445137-D7F5-57EC-87DA-1DB460D64046,"iPhone13,2"
com.toyopagroup.picaboo,20,1725388361,1725388381,1725388381.252225,-18000,EB445137-D7F5-57EC-87DA-1DB460D64046,"iPhone13,2"
com.toyopagroup.picaboo,43,1725388318,1725388361,1725388361.0632029,-18000,EB445137-D7F5-57EC-87DA-1DB460D64046,"iPhone13,2"
com.google.Gmail,9,1725388309,1725388318,1725388318.072634,-18000,EB445137-D7F5-57EC-87DA-1DB460D64046,"iPhone13,2"
com.google.Gmail,12,1725388083,1725388095,1725388095.354652,-18000,EB445137-D7F5-57EC-87DA-1DB460D64046,"iPhone13,2"
com.google.Gmail,12,1725387867,1725387879,1725387879.179978,-18000,EB445137-D7F5-57EC-87DA-1DB460D64046,"iPhone13,2"
com.google.Gmail,2,1725387708,1725387710,1725387710.4817982,-18000,EB445137-D7F5-57EC-87DA-1DB460D64046,"iPhone13,2"
com.google.Gmail,158,1725387363,1725387521,1725387521.550953,-18000,EB445137-D7F5-57EC-87DA-1DB460D64046,"iPhone13,2"
com.google.Chrome,2087,1725386266,1725388353,1725388354.1876302,-18000,,
com.google.Chrome,527,1725385061,1725385588,1725385588.639147,-18000,,
com.google.Chrome,482,1725384124,1725384606,1725384606.040359,-18000,,
com.leomehlig.today,37,1725384087,1725384124,1725384124.891937,-18000,,
com.google.Chrome,13,1725384074,1725384087,1725384087.104527,-18000,,
com.leomehlig.today,93,1725383981,1725384074,1725384074.564626,-18000,,
com.google.Chrome,27,1725383954,1725383981,1725383981.745109,-18000,,
com.leomehlig.today,27,1725383927,1725383954,1725383954.557802,-18000,,
com.apple.iCal,5,1725383922,1725383927,1725383927.6550279,-18000,,
com.leomehlig.today,92,1725383830,1725383922,1725383922.791346,-18000,,
com.myfitnesspal.mfp,1,1725383784,1725383785,1725383785.5804238,-18000,EB445137-D7F5-57EC-87DA-1DB460D64046,"iPhone13,2"
com.myfitnesspal.mfp,2,1725383748,1725383750,1725383750.170185,-18000,EB445137-D7F5-57EC-87DA-1DB460D64046,"iPhone13,2"
com.myfitnesspal.mfp,32,1725383712,1725383744,1725383744.141629,-18000,EB445137-D7F5-57EC-87DA-1DB460D64046,"iPhone13,2"
com.google.ios.youtube,6,1725383706,1725383712,1725383712.1344461,-18000,EB445137-D7F5-57EC-87DA-1DB460D64046,"iPhone13,2"
com.google.ios.youtube,844,1725382738,1725383582,1725383582.65153,-18000,EB445137-D7F5-57EC-87DA-1DB460D64046,"iPhone13,2"
com.apple.MobileSMS,31,1725382707,1725382738,1725382738.361401,-18000,EB445137-D7F5-57EC-87DA-1DB460D64046,"iPhone13,2"
com.google.ios.youtube,83,1725382624,1725382707,1725382708.066814,-18000,EB445137-D7F5-57EC-87DA-1DB460D64046,"iPhone13,2"
com.toyopagroup.picaboo,4,1725382619,1725382623,1725382623.545773,-18000,EB445137-D7F5-57EC-87DA-1DB460D64046,"iPhone13,2"
com.google.ios.youtube,3,1725382616,1725382619,1725382619.901557,-18000,EB445137-D7F5-57EC-87DA-1DB460D64046,"iPhone13,2"
com.toyopagroup.picaboo,7,1725382566,1725382573,1725382573.2830381,-18000,EB445137-D7F5-57EC-87DA-1DB460D64046,"iPhone13,2"
com.toyopagroup.picaboo,45,1725382510,1725382555,1725382555.448776,-18000,EB445137-D7F5-57EC-87DA-1DB460D64046,"iPhone13,2"
com.google.chrome.ios,3,1725382507,1725382510,1725382510.351709,-18000,EB445137-D7F5-57EC-87DA-1DB460D64046,"iPhone13,2"
com.google.chrome.ios,33,1725382463,1725382496,1725382496.2098641,-18000,EB445137-D7F5-57EC-87DA-1DB460D64046,"iPhone13,2"
com.toyopagroup.picaboo,72,1725382073,1725382145,1725382145.1465058,-18000,EB445137-D7F5-57EC-87DA-1DB460D64046,"iPhone13,2"
com.muscleforlife.Stacked,23,1725382050,1725382073,1725382073.737001,-18000,EB445137-D7F5-57EC-87DA-1DB460D64046,"iPhone13,2"
com.toyopagroup.picaboo,94,1725381955,1725382049,1725382049.572517,-18000,EB445137-D7F5-57EC-87DA-1DB460D64046,"iPhone13,2"
com.toyopagroup.picaboo,46,1725381889,1725381935,1725381936.072494,-18000,EB445137-D7F5-57EC-87DA-1DB460D64046,"iPhone13,2"
com.google.ios.youtube,723,1725381160,1725381883,1725381884.050488,-18000,EB445137-D7F5-57EC-87DA-1DB460D64046,"iPhone13,2"
com.apple.PosterBoard,3,1725381151,1725381154,1725381154.066196,-18000,EB445137-D7F5-57EC-87DA-1DB460D64046,"iPhone13,2"
com.leomehlig.today,325,1725381112,1725381437,1725381437.654752,-18000,,
com.google.Chrome,16,1725381096,1725381112,1725381112.88697,-18000,,
com.leomehlig.today,2,1725381094,1725381096,1725381096.049833,-18000,,
com.google.Chrome,1,1725381093,1725381094,1725381094.5088649,-18000,,
com.leomehlig.today,21,1725381072,1725381093,1725381093.7388859,-18000,,
com.hammerandchisel.discord,256,1725380812,1725381068,1725381068.492573,-18000,EB445137-D7F5-57EC-87DA-1DB460D64046,"iPhone13,2"
com.apple.Music,5,1725380807,1725380812,1725380812.023031,-18000,EB445137-D7F5-57EC-87DA-1DB460D64046,"iPhone13,2"
com.google.Chrome,298,1725380774,1725381072,1725381072.722385,-18000,,
com.apple.Terminal,60,1725380714,1725380774,1725380774.363934,-18000,,
com.google.Chrome,25,1725380689,1725380714,1725380714.242031,-18000,,
com.apple.Terminal,108,1725380581,1725380689,1725380689.942642,-18000,,
com.google.Chrome,16,1725380565,1725380581,1725380581.6474972,-18000,,
com.apple.Terminal,20,1725380545,1725380565,1725380565.653648,-18000,,
com.google.Chrome,20,1725380525,1725380545,1725380546.004973,-18000,,
com.apple.Terminal,29,1725380496,1725380525,1725380525.656053,-18000,,
com.google.Chrome,1,1725380495,1725380496,1725380496.08706,-18000,,
com.apple.Terminal,23,1725380472,1725380495,1725380495.305516,-18000,,
com.google.Chrome,34,1725380438,1725380472,1725380472.2273622,-18000,,
com.apple.Terminal,6,1725380432,1725380438,1725380438.881748,-18000,,
com.google.Chrome,11,1725380421,1725380432,1725380432.8859801,-18000,,
com.apple.Terminal,95,1725380326,1725380421,1725380421.68186,-18000,,
com.google.Chrome,11,1725380315,1725380326,1725380326.215446,-18000,,
com.apple.Terminal,153,1725380162,1725380315,1725380315.48533,-18000,,
com.google.Chrome,11,1725380151,1725380162,1725380162.365685,-18000,,
com.apple.Terminal,15,1725380136,1725380151,1725380151.125736,-18000,,
com.google.Chrome,30,1725380106,1725380136,1725380136.9888902,-18000,,
com.apple.Terminal,208,1725379898,1725380106,1725380106.811644,-18000,,
com.google.Chrome,68,1725379830,1725379898,1725379898.0655432,-18000,,
com.apple.Terminal,33,1725379797,1725379830,1725379830.730201,-18000,,
com.google.Chrome,2,1725379795,1725379797,1725379797.780075,-18000,,
com.apple.Terminal,31,1725379764,1725379795,1725379795.9602718,-18000,,
com.google.Chrome,54,1725379710,1725379764,1725379764.8631968,-18000,,
com.apple.Terminal,135,1725379575,1725379710,1725379710.55287,-18000,,
com.google.Chrome,26,1725379549,1725379575,1725379575.462634,-18000,,
com.apple.Terminal,196,1725379353,1725379549,1725379550.048984,-18000,,
com.google.Chrome,2,1725379351,1725379353,1725379353.634249,-18000,,
com.apple.Terminal,3,1725379348,1725379351,1725379351.645328,-18000,,
com.google.Chrome,2,1725379346,1725379348,1725379348.1634269,-18000,,
com.apple.Terminal,2,1725379344,1725379346,1725379346.905487,-18000,,
com.google.Chrome,20,1725379324,1725379344,1725379344.6811318,-18000,,
com.apple.Terminal,85,1725379239,1725379324,1725379324.5393991,-18000,,
com.google.Chrome,10,1725379229,1725379239,1725379239.917624,-18000,,
com.apple.Terminal,19,1725379210,1725379229,1725379229.140456,-18000,,
com.google.Chrome,28,1725379182,1725379210,1725379210.249164,-18000,,
com.leomehlig.today,12,1725379170,1725379182,1725379182.319221,-18000,,
com.google.Chrome,4,1725379166,1725379170,1725379170.716533,-18000,,
com.apple.Music,3,1725379137,1725379140,1725379140.319312,-18000,EB445137-D7F5-57EC-87DA-1DB460D64046,"iPhone13,2"
com.apple.Music,7,1725378401,1725378408,1725378408.4763532,-18000,EB445137-D7F5-57EC-87DA-1DB460D64046,"iPhone13,2"
com.apple.Music,9,1725378391,1725378400,1725378401.2207808,-18000,EB445137-D7F5-57EC-87DA-1DB460D64046,"iPhone13,2"
com.apple.Music,3,1725378379,1725378382,1725378382.719585,-18000,EB445137-D7F5-57EC-87DA-1DB460D64046,"iPhone13,2"
com.microsoft.Office.Outlook,3,1725378374,1725378377,1725378380.340733,-18000,EB445137-D7F5-57EC-87DA-1DB460D64046,"iPhone13,2"
com.microsoft.Office.Outlook,6,1725378228,1725378234,1725378234.6730251,-18000,EB445137-D7F5-57EC-87DA-1DB460D64046,"iPhone13,2"
com.google.Chrome,52,1725378143,1725378195,1725378195.829565,-18000,,
com.apple.Terminal,68,1725378075,1725378143,1725378144.023727,-18000,,
com.google.Chrome,18,1725378057,1725378075,1725378075.601326,-18000,,
com.apple.Terminal,72,1725377985,1725378057,1725378057.168556,-18000,,
com.google.Chrome,49,1725377936,1725377985,1725377985.448446,-18000,,
com.apple.Terminal,208,1725377728,1725377936,1725377936.377349,-18000,,
com.google.Chrome,41,1725377687,1725377728,1725377728.464006,-18000,,
com.apple.Terminal,138,1725377549,1725377687,1725377687.248217,-18000,,
com.google.Chrome,62,1725377487,1725377549,1725377549.790331,-18000,,
com.apple.Terminal,65,1725377422,1725377487,1725377488.0150871,-18000,,
com.google.Chrome,19,1725377403,1725377422,1725377422.956608,-18000,,
com.apple.Terminal,82,1725377321,1725377403,1725377403.257255,-18000,,
com.google.Chrome,11,1725377310,1725377321,1725377321.758061,-18000,,
com.apple.Terminal,3,1725377307,1725377310,1725377310.95081,-18000,,
com.google.Chrome,25,1725377282,1725377307,1725377307.355235,-18000,,
com.apple.Terminal,99,1725377183,1725377282,1725377282.7371922,-18000,,
com.google.Chrome,117,1725377066,1725377183,1725377183.4562669,-18000,,
com.apple.Terminal,141,1725376925,1725377066,1725377066.335495,-18000,,
com.google.Chrome,51,1725376874,1725376925,1725376925.860231,-18000,,
com.apple.Terminal,3,1725376871,1725376874,1725376874.329107,-18000,,
com.google.Chrome,16,1725376855,1725376871,1725376871.782803,-18000,,
com.apple.Terminal,228,1725376627,1725376855,1725376855.352999,-18000,,
com.google.Chrome,134,1725376493,1725376627,1725376627.8606791,-18000,,
com.apple.Terminal,178,1725376315,1725376493,1725376493.519054,-18000,,
com.google.Chrome,12,1725376303,1725376315,1725376315.1724138,-18000,,
com.apple.Terminal,17,1725376286,1725376303,1725376303.222934,-18000,,
com.google.Chrome,28,1725376258,1725376286,1725376286.420018,-18000,,
com.apple.finder,9,1725376249,1725376258,1725376258.405414,-18000,,
com.apple.Terminal,5,1725376244,1725376249,1725376249.616375,-18000,,
com.apple.finder,7,1725376237,1725376244,1725376244.6164942,-18000,,
com.apple.Terminal,74,1725376163,1725376237,1725376237.143091,-18000,,
com.google.Chrome,2,1725376161,1725376163,1725376163.670795,-18000,,
com.apple.Terminal,2,1725376159,1725376161,1725376161.9700541,-18000,,
com.google.Chrome,0,1725376159,1725376159,1725376159.566889,-18000,,
com.apple.Terminal,2,1725376157,1725376159,1725376159.2155871,-18000,,
com.apple.finder,19,1725376138,1725376157,1725376157.6307511,-18000,,
com.apple.Terminal,58,1725376080,1725376138,1725376138.71213,-18000,,
com.google.Chrome,24,1725376056,1725376080,1725376080.592962,-18000,,
com.apple.Terminal,523,1725375533,1725376056,1725376056.110055,-18000,,
com.google.Chrome,6,1725375527,1725375533,1725375533.3967419,-18000,,
com.apple.Terminal,0,1725375527,1725375527,1725375527.895684,-18000,,
com.apple.finder,4,1725375523,1725375527,1725375527.142858,-18000,,
com.apple.Terminal,109,1725375414,1725375523,1725375524.005266,-18000,,
com.google.Chrome,3,1725375411,1725375414,1725375414.8428779,-18000,,
com.apple.finder,1,1725375410,1725375411,1725375411.9026299,-18000,,
com.google.Chrome,40,1725375370,1725375410,1725375410.643396,-18000,,
com.apple.finder,2,1725375368,1725375370,1725375371.016537,-18000,,
com.google.Chrome,4,1725375364,1725375368,1725375368.3502069,-18000,,
com.apple.finder,3,1725375361,1725375364,1725375364.208705,-18000,,
com.google.Chrome,1,1725375360,1725375361,1725375361.7234402,-18000,,
com.apple.Terminal,12,1725375348,1725375360,1725375360.966176,-18000,,
com.google.Chrome,11,1725375337,1725375348,1725375348.940078,-18000,,
com.apple.Terminal,13,1725375324,1725375337,1725375337.071577,-18000,,
com.apple.finder,15,1725375309,1725375324,1725375324.8833752,-18000,,
com.apple.Terminal,41,1725375268,1725375309,1725375309.909553,-18000,,
com.apple.finder,2,1725375266,1725375268,1725375268.2096272,-18000,,
com.apple.Terminal,43,1725375223,1725375266,1725375266.435889,-18000,,
com.apple.finder,6,1725375217,1725375223,1725375223.400346,-18000,,
com.apple.Terminal,16,1725375201,1725375217,1725375217.9759889,-18000,,
com.apple.finder,41,1725375160,1725375201,1725375201.449802,-18000,,
com.google.Chrome,3,1725375157,1725375160,1725375160.220336,-18000,,
com.apple.finder,3,1725375154,1725375157,1725375157.063144,-18000,,
com.google.Chrome,18,1725375136,1725375154,1725375154.29007,-18000,,
com.apple.finder,4,1725375132,1725375136,1725375136.2049541,-18000,,
com.apple.Terminal,49,1725375083,1725375132,1725375132.439461,-18000,,
com.apple.finder,4,1725375079,1725375083,1725375083.664778,-18000,,
com.apple.Terminal,80,1725374999,1725375079,1725375079.598363,-18000,,
com.apple.finder,8,1725374991,1725374999,1725374999.6959171,-18000,,
com.apple.Terminal,5,1725374986,1725374991,1725374991.814522,-18000,,
com.apple.finder,24,1725374962,1725374986,1725374986.258893,-18000,,
com.apple.Terminal,2,1725374960,1725374962,1725374962.521661,-18000,,
com.google.Chrome,9,1725374951,1725374960,1725374960.21052,-18000,,
com.apple.Terminal,6,1725374945,1725374951,1725374951.327043,-18000,,
com.apple.finder,13,1725374932,1725374945,1725374945.1364489,-18000,,
com.apple.Terminal,88,1725374844,1725374932,1725374932.9838262,-18000,,
com.google.Chrome,15,1725374829,1725374844,1725374844.650305,-18000,,
com.apple.Terminal,3,1725374826,1725374829,1725374829.07921,-18000,,
com.google.Chrome,2,1725374824,1725374826,1725374826.397737,-18000,,
com.apple.Terminal,6,1725374818,1725374824,1725374824.533068,-18000,,
com.google.Chrome,5,1725374813,1725374818,1725374818.2344651,-18000,,
com.apple.Terminal,2,1725374811,1725374813,1725374813.268698,-18000,,
com.google.Chrome,4,1725374807,1725374811,1725374811.05961,-18000,,
com.apple.Terminal,17,1725374790,1725374807,1725374807.5268931,-18000,,
com.google.Chrome,183,1725374607,1725374790,1725374790.825587,-18000,,
com.apple.finder,35,1725374572,1725374607,1725374607.439303,-18000,,
com.microsoft.Office.Outlook,4,1725373895,1725373899,1725373899.579685,-18000,EB445137-D7F5-57EC-87DA-1DB460D64046,"iPhone13,2"
com.google.Chrome,731,1725373841,1725374572,1725374572.475308,-18000,,
com.microsoft.Office.Outlook,3,1725373014,1725373017,1725373017.207094,-18000,EB445137-D7F5-57EC-87DA-1DB460D64046,"iPhone13,2"
com.microsoft.Office.Outlook,50,1725372812,1725372862,1725372862.583241,-18000,EB445137-D7F5-57EC-87DA-1DB460D64046,"iPhone13,2"
com.myfitnesspal.mfp,257,1725372549,1725372806,1725372806.3935409,-18000,EB445137-D7F5-57EC-87DA-1DB460D64046,"iPhone13,2"
com.myfitnesspal.mfp,91,1725372454,1725372545,1725372545.8718162,-18000,EB445137-D7F5-57EC-87DA-1DB460D64046,"iPhone13,2"
com.apple.Health,5,1725372449,1725372454,1725372454.5480042,-18000,EB445137-D7F5-57EC-87DA-1DB460D64046,"iPhone13,2"
com.apple.Health,2,1725371946,1725371948,1725371948.858581,-18000,EB445137-D7F5-57EC-87DA-1DB460D64046,"iPhone13,2"
com.apple.Health,41,1725371373,1725371414,1725371414.973747,-18000,EB445137-D7F5-57EC-87DA-1DB460D64046,"iPhone13,2"
com.renpho.health,7,1725371366,1725371373,1725371373.515287,-18000,EB445137-D7F5-57EC-87DA-1DB460D64046,"iPhone13,2"
com.renpho.health,30,1725371314,1725371344,1725371344.8208652,-18000,EB445137-D7F5-57EC-87DA-1DB460D64046,"iPhone13,2"
com.markhambly.APOD,66,1725370466,1725370532,1725370532.85986,-18000,EB445137-D7F5-57EC-87DA-1DB460D64046,"iPhone13,2"
com.apple.mobiletimer,7,1725339069,1725339076,1725339076.963173,-18000,EB445137-D7F5-57EC-87DA-1DB460D64046,"iPhone13,2"
com.thestorygraph.thestorygraph,49,1725338977,1725339026,1725339026.857401,-18000,EB445137-D7F5-57EC-87DA-1DB460D64046,"iPhone13,2"
com.google.chrome.ios,3,1725338974,1725338977,1725338977.938805,-18000,EB445137-D7F5-57EC-87DA-1DB460D64046,"iPhone13,2"
com.google.chrome.ios,10,1725338951,1725338961,1725338961.617301,-18000,EB445137-D7F5-57EC-87DA-1DB460D64046,"iPhone13,2"
com.google.chrome.ios,13,1725338648,1725338661,1725338661.057697,-18000,EB445137-D7F5-57EC-87DA-1DB460D64046,"iPhone13,2"
com.google.chrome.ios,10,1725338134,1725338144,1725338144.599729,-18000,EB445137-D7F5-57EC-87DA-1DB460D64046,"iPhone13,2"
com.google.chrome.ios,2,1725336840,1725336842,1725336842.3623629,-18000,EB445137-D7F5-57EC-87DA-1DB460D64046,"iPhone13,2"
com.google.chrome.ios,10,1725336437,1725336447,1725336447.100713,-18000,EB445137-D7F5-57EC-87DA-1DB460D64046,"iPhone13,2"
com.google.chrome.ios,3,1725336368,1725336371,1725336371.5495129,-18000,EB445137-D7F5-57EC-87DA-1DB460D64046,"iPhone13,2"
com.google.chrome.ios,2,1725336362,1725336364,1725336364.578206,-18000,EB445137-D7F5-57EC-87DA-1DB460D64046,"iPhone13,2"
com.google.chrome.ios,3,1725335018,1725335021,1725335021.9791322,-18000,EB445137-D7F5-57EC-87DA-1DB460D64046,"iPhone13,2"
com.google.chrome.ios,22,1725334995,1725335017,1725335017.631599,-18000,EB445137-D7F5-57EC-87DA-1DB460D64046,"iPhone13,2"
com.google.chrome.ios,36,1725334238,1725334274,1725334274.992574,-18000,EB445137-D7F5-57EC-87DA-1DB460D64046,"iPhone13,2"
com.google.chrome.ios,44,1725333348,1725333392,1725333392.928868,-18000,EB445137-D7F5-57EC-87DA-1DB460D64046,"iPhone13,2"
com.netflix.Netflix,19,1725333325,1725333344,1725333344.958561,-18000,EB445137-D7F5-57EC-87DA-1DB460D64046,"iPhone13,2"
com.netflix.Netflix,15,1725333291,1725333306,1725333306.153996,-18000,EB445137-D7F5-57EC-87DA-1DB460D64046,"iPhone13,2"
com.netflix.Netflix,6,1725333224,1725333230,1725333230.9566731,-18000,EB445137-D7F5-57EC-87DA-1DB460D64046,"iPhone13,2"
com.netflix.Netflix,70,1725332980,1725333050,1725333050.305445,-18000,EB445137-D7F5-57EC-87DA-1DB460D64046,"iPhone13,2"
com.apple.mobilenotes,25,1725332918,1725332943,1725332943.236371,-18000,EB445137-D7F5-57EC-87DA-1DB460D64046,"iPhone13,2"
com.apple.camera,0,1725331984,1725331984,1725331984.9439259,-18000,EB445137-D7F5-57EC-87DA-1DB460D64046,"iPhone13,2"
com.apple.camera,1,1725325326,1725325327,1725325327.15875,-18000,EB445137-D7F5-57EC-87DA-1DB460D64046,"iPhone13,2"
com.truebill.truebillnative,204,1725321432,1725321636,1725321636.551241,-18000,EB445137-D7F5-57EC-87DA-1DB460D64046,"iPhone13,2"
com.apple.calculator,5,1725321427,1725321432,1725321432.143907,-18000,EB445137-D7F5-57EC-87DA-1DB460D64046,"iPhone13,2"
com.truebill.truebillnative,9,1725321418,1725321427,1725321427.548047,-18000,EB445137-D7F5-57EC-87DA-1DB460D64046,"iPhone13,2"
com.apple.calculator,4,1725321414,1725321418,1725321418.424825,-18000,EB445137-D7F5-57EC-87DA-1DB460D64046,"iPhone13,2"
com.apple.MobileSMS,58,1725321356,1725321414,1725321414.5086188,-18000,EB445137-D7F5-57EC-87DA-1DB460D64046,"iPhone13,2"
com.truebill.truebillnative,85,1725321271,1725321356,1725321356.942268,-18000,EB445137-D7F5-57EC-87DA-1DB460D64046,"iPhone13,2"
com.apple.Health,129,1725321133,1725321262,1725321262.973201,-18000,EB445137-D7F5-57EC-87DA-1DB460D64046,"iPhone13,2"
com.myfitnesspal.mfp,4,1725321129,1725321133,1725321133.690103,-18000,EB445137-D7F5-57EC-87DA-1DB460D64046,"iPhone13,2"
com.myfitnesspal.mfp,7,1725320493,1725320500,1725320500.40974,-18000,EB445137-D7F5-57EC-87DA-1DB460D64046,"iPhone13,2"
com.apple.news,3,1725320490,1725320493,1725320493.577409,-18000,EB445137-D7F5-57EC-87DA-1DB460D64046,"iPhone13,2"
com.apple.news,84,1725320210,1725320294,1725320294.396346,-18000,EB445137-D7F5-57EC-87DA-1DB460D64046,"iPhone13,2"
com.myfitnesspal.mfp,60,1725320133,1725320193,1725320193.556668,-18000,EB445137-D7F5-57EC-87DA-1DB460D64046,"iPhone13,2"
com.myfitnesspal.mfp,19,1725319994,1725320013,1725320013.205724,-18000,EB445137-D7F5-57EC-87DA-1DB460D64046,"iPhone13,2"
com.myfitnesspal.mfp,9,1725319902,1725319911,1725319911.7660189,-18000,EB445137-D7F5-57EC-87DA-1DB460D64046,"iPhone13,2"
com.myfitnesspal.mfp,17,1725319861,1725319878,1725319879.011129,-18000,EB445137-D7F5-57EC-87DA-1DB460D64046,"iPhone13,2"
com.myfitnesspal.mfp,6,1725319827,1725319833,1725319833.302495,-18000,EB445137-D7F5-57EC-87DA-1DB460D64046,"iPhone13,2"
com.myfitnesspal.mfp,39,1725319615,1725319654,1725319654.3671122,-18000,EB445137-D7F5-57EC-87DA-1DB460D64046,"iPhone13,2"
com.myfitnesspal.mfp,198,1725319288,1725319486,1725319486.5253658,-18000,EB445137-D7F5-57EC-87DA-1DB460D64046,"iPhone13,2"
com.truebill.truebillnative,6,1725319282,1725319288,1725319288.0895271,-18000,EB445137-D7F5-57EC-87DA-1DB460D64046,"iPhone13,2"
com.doordash.dasher,27,1725319248,1725319275,1725319275.7435632,-18000,EB445137-D7F5-57EC-87DA-1DB460D64046,"iPhone13,2"
com.myfitnesspal.mfp,30,1725319197,1725319227,1725319227.651814,-18000,EB445137-D7F5-57EC-87DA-1DB460D64046,"iPhone13,2"
com.myfitnesspal.mfp,6,1725319191,1725319197,1725319197.151523,-18000,EB445137-D7F5-57EC-87DA-1DB460D64046,"iPhone13,2"
com.myfitnesspal.mfp,63,1725319026,1725319089,1725319089.4541512,-18000,EB445137-D7F5-57EC-87DA-1DB460D64046,"iPhone13,2"
com.myfitnesspal.mfp,25,1725318982,1725319007,1725319007.08745,-18000,EB445137-D7F5-57EC-87DA-1DB460D64046,"iPhone13,2"
com.apple.camera,7,1725318579,1725318586,1725318587.5275269,-18000,EB445137-D7F5-57EC-87DA-1DB460D64046,"iPhone13,2"
com.google.chrome.ios,6,1725318578,1725318584,1725318586.685169,-18000,EB445137-D7F5-57EC-87DA-1DB460D64046,"iPhone13,2"
com.google.chrome.ios,8,1725318387,1725318395,1725318395.2898378,-18000,EB445137-D7F5-57EC-87DA-1DB460D64046,"iPhone13,2"
com.myfitnesspal.mfp,2,1725318385,1725318387,1725318387.6551661,-18000,EB445137-D7F5-57EC-87DA-1DB460D64046,"iPhone13,2"
com.myfitnesspal.mfp,116,1725318260,1725318376,1725318376.932489,-18000,EB445137-D7F5-57EC-87DA-1DB460D64046,"iPhone13,2"
com.myfitnesspal.mfp,271,1725317925,1725318196,1725318196.13575,-18000,EB445137-D7F5-57EC-87DA-1DB460D64046,"iPhone13,2"
com.google.chrome.ios,72,1725317853,1725317925,1725317926.148407,-18000,EB445137-D7F5-57EC-87DA-1DB460D64046,"iPhone13,2"
com.google.chrome.ios,69,1725316608,1725316677,1725316677.666956,-18000,EB445137-D7F5-57EC-87DA-1DB460D64046,"iPhone13,2"
com.google.chrome.ios,66,1725316495,1725316561,1725316561.54864,-18000,EB445137-D7F5-57EC-87DA-1DB460D64046,"iPhone13,2"
com.google.chrome.ios,2,1725316341,1725316343,1725316343.395228,-18000,EB445137-D7F5-57EC-87DA-1DB460D64046,"iPhone13,2"
com.google.chrome.ios,138,1725315842,1725315980,1725315980.424799,-18000,EB445137-D7F5-57EC-87DA-1DB460D64046,"iPhone13,2"
com.google.chrome.ios,112,1725315642,1725315754,1725315754.92487,-18000,EB445137-D7F5-57EC-87DA-1DB460D64046,"iPhone13,2"
com.google.chrome.ios,7,1725315010,1725315017,1725315017.2182798,-18000,EB445137-D7F5-57EC-87DA-1DB460D64046,"iPhone13,2"
com.google.ios.youtube,460,1725314414,1725314874,1725314874.58326,-18000,EB445137-D7F5-57EC-87DA-1DB460D64046,"iPhone13,2"
com.google.ios.youtube,166,1725314243,1725314409,1725314410.265102,-18000,EB445137-D7F5-57EC-87DA-1DB460D64046,"iPhone13,2"
com.google.chrome.ios,8,1725314235,1725314243,1725314243.386725,-18000,EB445137-D7F5-57EC-87DA-1DB460D64046,"iPhone13,2"
com.google.ios.youtube,7,1725314228,1725314235,1725314235.438634,-18000,EB445137-D7F5-57EC-87DA-1DB460D64046,"iPhone13,2"
com.google.chrome.ios,10,1725314218,1725314228,1725314228.627036,-18000,EB445137-D7F5-57EC-87DA-1DB460D64046,"iPhone13,2"
com.google.chrome.ios,112,1725314045,1725314157,1725314157.5575309,-18000,EB445137-D7F5-57EC-87DA-1DB460D64046,"iPhone13,2"
com.google.ios.youtube,269,1725313776,1725314045,1725314046.3353481,-18000,EB445137-D7F5-57EC-87DA-1DB460D64046,"iPhone13,2"
com.apple.Health,56,1725313715,1725313771,1725313771.049444,-18000,EB445137-D7F5-57EC-87DA-1DB460D64046,"iPhone13,2"
com.robinhood.release.Robinhood,13,1725313695,1725313708,1725313708.988564,-18000,EB445137-D7F5-57EC-87DA-1DB460D64046,"iPhone13,2"
com.myfitnesspal.mfp,61,1725313617,1725313678,1725313678.3881202,-18000,EB445137-D7F5-57EC-87DA-1DB460D64046,"iPhone13,2"
com.google.chrome.ios,287,1725313315,1725313602,1725313602.451859,-18000,EB445137-D7F5-57EC-87DA-1DB460D64046,"iPhone13,2"
com.google.chrome.ios,107,1725313191,1725313298,1725313298.6893039,-18000,EB445137-D7F5-57EC-87DA-1DB460D64046,"iPhone13,2"
com.apple.Music,6,1725313183,1725313189,1725313189.878856,-18000,EB445137-D7F5-57EC-87DA-1DB460D64046,"iPhone13,2"
com.apple.Music,5,1725312112,1725312117,1725312117.6314359,-18000,EB445137-D7F5-57EC-87DA-1DB460D64046,"iPhone13,2"
com.apple.MobileSMS,3,1725312106,1725312109,1725312109.80268,-18000,EB445137-D7F5-57EC-87DA-1DB460D64046,"iPhone13,2"
com.apple.MobileSMS,7,1725312022,1725312029,1725312029.106839,-18000,EB445137-D7F5-57EC-87DA-1DB460D64046,"iPhone13,2"
com.apple.camera,0,1725312006,1725312006,1725312006.4886909,-18000,EB445137-D7F5-57EC-87DA-1DB460D64046,"iPhone13,2"
com.apple.MobileSMS,115,1725311891,1725312006,1725312006.423085,-18000,EB445137-D7F5-57EC-87DA-1DB460D64046,"iPhone13,2"
com.apple.Music,6,1725311885,1725311891,1725311891.767407,-18000,EB445137-D7F5-57EC-87DA-1DB460D64046,"iPhone13,2"
com.apple.Music,73,1725310701,1725310774,1725310774.533767,-18000,EB445137-D7F5-57EC-87DA-1DB460D64046,"iPhone13,2"
com.apple.Maps,69,1725310632,1725310701,1725310701.412025,-18000,EB445137-D7F5-57EC-87DA-1DB460D64046,"iPhone13,2"
com.apple.mobiletimer,8,1725310624,1725310632,1725310632.451838,-18000,EB445137-D7F5-57EC-87DA-1DB460D64046,"iPhone13,2"
com.apple.mobiletimer,60,1725310288,1725310348,1725310348.509754,-18000,EB445137-D7F5-57EC-87DA-1DB460D64046,"iPhone13,2"
com.apple.mobiletimer,6,1725310242,1725310248,1725310248.974252,-18000,EB445137-D7F5-57EC-87DA-1DB460D64046,"iPhone13,2"
com.apple.mobiletimer,3,1725310077,1725310080,1725310080.108801,-18000,EB445137-D7F5-57EC-87DA-1DB460D64046,"iPhone13,2"
com.apple.mobiletimer,9,1725309897,1725309906,1725309906.176676,-18000,EB445137-D7F5-57EC-87DA-1DB460D64046,"iPhone13,2"
com.apple.mobiletimer,13,1725309799,1725309812,1725309812.110969,-18000,EB445137-D7F5-57EC-87DA-1DB460D64046,"iPhone13,2"
com.google.Chrome,920,1725308708,1725309628,1725309628.618257,-18000,,
com.apple.iCal,4,1725308704,1725308708,1725308709.298846,-18000,,
com.microsoft.Excel,80,1725308624,1725308704,1725308704.854138,-18000,,
com.apple.iCal,3,1725308621,1725308624,1725308624.134039,-18000,,
com.leomehlig.today,15,1725308606,1725308621,1725308621.244546,-18000,,
com.google.Chrome,10,1725308596,1725308606,1725308606.211852,-18000,,
com.apple.iCal,15,1725308581,1725308596,1725308596.332334,-18000,,
com.microsoft.Excel,90,1725308491,1725308581,1725308581.63993,-18000,,
com.apple.finder,10,1725308481,1725308491,1725308491.598707,-18000,,
com.google.Chrome,240,1725308241,1725308481,1725308481.783721,-18000,,
com.google.Chrome,672,1725307462,1725308134,1725308134.657284,-18000,,
com.leomehlig.today,8,1725307454,1725307462,1725307462.534082,-18000,,
com.google.Chrome,2,1725307452,1725307454,1725307454.583129,-18000,,
com.apple.mobiletimer,156,1725307285,1725307441,1725307441.2770638,-18000,EB445137-D7F5-57EC-87DA-1DB460D64046,"iPhone13,2"
com.apple.mobiletimer,6,1725307278,1725307284,1725307284.35928,-18000,EB445137-D7F5-57EC-87DA-1DB460D64046,"iPhone13,2"
com.apple.mobiletimer,122,1725307112,1725307234,1725307234.297626,-18000,EB445137-D7F5-57EC-87DA-1DB460D64046,"iPhone13,2"
com.apple.Preview,967,1725306485,1725307452,1725307452.8995209,-18000,,
com.apple.finder,24,1725306461,1725306485,1725306485.7377129,-18000,,
com.google.Chrome,367,1725306094,1725306461,1725306461.745764,-18000,,
com.google.Chrome,407,1725305477,1725305884,1725305884.578947,-18000,,
com.google.Chrome,874,1725304318,1725305192,1725305192.454416,-18000,,
com.leomehlig.today,2,1725304316,1725304318,1725304318.15301,-18000,,
com.ryansponzilli.DeepSkyCatalog,72,1725304220,1725304292,1725304292.8897939,-18000,EB445137-D7F5-57EC-87DA-1DB460D64046,"iPhone13,2"
com.ryansponzilli.DeepSkyCatalog,177,1725303863,1725304040,1725304041.2929769,-18000,EB445137-D7F5-57EC-87DA-1DB460D64046,"iPhone13,2"
org.stellarium.Stellarium,492,1725303824,1725304316,1725304316.6794639,-18000,,
com.leomehlig.today,3,1725303821,1725303824,1725303824.942152,-18000,,
com.ryansponzilli.DeepSkyCatalog,31,1725303789,1725303820,1725303820.5121279,-18000,EB445137-D7F5-57EC-87DA-1DB460D64046,"iPhone13,2"
com.ryansponzilli.DeepSkyCatalog,47,1725303710,1725303757,1725303757.74563,-18000,EB445137-D7F5-57EC-87DA-1DB460D64046,"iPhone13,2"
Astrospheric.Astrospheric,1,1725303708,1725303709,1725303710.37658,-18000,EB445137-D7F5-57EC-87DA-1DB460D64046,"iPhone13,2"
com.apple.news,143,1725303521,1725303664,1725303664.8219771,-18000,EB445137-D7F5-57EC-87DA-1DB460D64046,"iPhone13,2"
com.leomehlig.today,326,1725303469,1725303795,1725303795.679782,-18000,,
com.google.Chrome,352,1725303117,1725303469,1725303469.553597,-18000,,
com.muscleforlife.Stacked,2,1725302964,1725302966,1725302966.9773788,-18000,EB445137-D7F5-57EC-87DA-1DB460D64046,"iPhone13,2"
com.leomehlig.today,165,1725302952,1725303117,1725303117.739452,-18000,,
com.google.Chrome,130,1725302822,1725302952,1725302952.803215,-18000,,
com.leomehlig.today,13,1725302809,1725302822,1725302822.3590178,-18000,,
com.apple.camera,0,1725301668,1725301668,1725301668.988898,-18000,EB445137-D7F5-57EC-87DA-1DB460D64046,"iPhone13,2"
com.muscleforlife.Stacked,9,1725301667,1725301676,1725301676.267679,-18000,EB445137-D7F5-57EC-87DA-1DB460D64046,"iPhone13,2"
com.muscleforlife.Stacked,165,1725301493,1725301658,1725301658.9870548,-18000,EB445137-D7F5-57EC-87DA-1DB460D64046,"iPhone13,2"
com.apple.Music,44,1725301449,1725301493,1725301493.256293,-18000,EB445137-D7F5-57EC-87DA-1DB460D64046,"iPhone13,2"
com.apple.Music,38,1725300521,1725300559,1725300559.280239,-18000,EB445137-D7F5-57EC-87DA-1DB460D64046,"iPhone13,2"
com.myfitnesspal.mfp,3,1725300518,1725300521,1725300521.1786609,-18000,EB445137-D7F5-57EC-87DA-1DB460D64046,"iPhone13,2"
com.myfitnesspal.mfp,6,1725300290,1725300296,1725300296.881336,-18000,EB445137-D7F5-57EC-87DA-1DB460D64046,"iPhone13,2"
com.myfitnesspal.mfp,4,1725300284,1725300288,1725300288.940459,-18000,EB445137-D7F5-57EC-87DA-1DB460D64046,"iPhone13,2"
com.myfitnesspal.mfp,6,1725300265,1725300271,1725300271.61397,-18000,EB445137-D7F5-57EC-87DA-1DB460D64046,"iPhone13,2"
com.myfitnesspal.mfp,1,1725300195,1725300196,1725300196.8790069,-18000,EB445137-D7F5-57EC-87DA-1DB460D64046,"iPhone13,2"
com.apple.camera,0,1725300193,1725300193,1725300193.4936938,-18000,EB445137-D7F5-57EC-87DA-1DB460D64046,"iPhone13,2"
com.myfitnesspal.mfp,3,1725300191,1725300194,1725300194.764853,-18000,EB445137-D7F5-57EC-87DA-1DB460D64046,"iPhone13,2"
com.leomehlig.today,3,1725300191,1725300194,1725300194.210623,-18000,,
com.myfitnesspal.mfp,69,1725300121,1725300190,1725300191.076307,-18000,EB445137-D7F5-57EC-87DA-1DB460D64046,"iPhone13,2"
com.myfitnesspal.mfp,48,1725300071,1725300119,1725300119.250689,-18000,EB445137-D7F5-57EC-87DA-1DB460D64046,"iPhone13,2"
com.thestorygraph.thestorygraph,1,1725300070,1725300071,1725300072.068553,-18000,EB445137-D7F5-57EC-87DA-1DB460D64046,"iPhone13,2"
com.google.ios.youtube,365,1725299704,1725300069,1725300070.76496,-18000,EB445137-D7F5-57EC-87DA-1DB460D64046,"iPhone13,2"
com.apple.news,36,1725299665,1725299701,1725299701.3601232,-18000,EB445137-D7F5-57EC-87DA-1DB460D64046,"iPhone13,2"
com.leomehlig.today,309,1725299581,1725299890,1725299890.04353,-18000,,
com.google.Chrome,555,1725299026,1725299581,1725299581.207506,-18000,,
com.apple.keychainaccess,1,1725299025,1725299026,1725299026.838352,-18000,,
com.google.Chrome,133,1725298892,1725299025,1725299026.007818,-18000,,
com.apple.keychainaccess,2,1725298890,1725298892,1725298893.007288,-18000,,
com.google.Chrome,124,1725298760,1725298884,1725298884.638761,-18000,,
com.leomehlig.today,2,1725298758,1725298760,1725298761.3285599,-18000,,
com.apple.news,763,1725298156,1725298919,1725298919.294262,-18000,EB445137-D7F5-57EC-87DA-1DB460D64046,"iPhone13,2"
com.apple.findmy,52,1725298089,1725298141,1725298141.404949,-18000,EB445137-D7F5-57EC-87DA-1DB460D64046,"iPhone13,2"
com.apple.PeopleViewService,4,1725298085,1725298089,1725298089.873097,-18000,EB445137-D7F5-57EC-87DA-1DB460D64046,"iPhone13,2"
com.apple.news,3,1725298080,1725298083,1725298083.304686,-18000,EB445137-D7F5-57EC-87DA-1DB460D64046,"iPhone13,2"
com.apple.news,1,1725298079,1725298080,1725298080.522637,-18000,EB445137-D7F5-57EC-87DA-1DB460D64046,"iPhone13,2"
com.leomehlig.today,305,1725298068,1725298373,1725298373.512772,-18000,,
com.apple.MobileSMS,1,1725298067,1725298068,1725298068.9924831,-18000,,
com.leomehlig.today,6,1725298061,1725298067,1725298067.299039,-18000,,
com.google.Chrome,4,1725298057,1725298061,1725298061.8599892,-18000,,
com.apple.news,985,1725296885,1725297870,1725297870.632104,-18000,EB445137-D7F5-57EC-87DA-1DB460D64046,"iPhone13,2"
com.doordash.dasher,43,1725296821,1725296864,1725296864.457253,-18000,EB445137-D7F5-57EC-87DA-1DB460D64046,"iPhone13,2"
com.toyopagroup.picaboo,11,1725296801,1725296812,1725296812.5213861,-18000,EB445137-D7F5-57EC-87DA-1DB460D64046,"iPhone13,2"
com.google.ios.youtube,4,1725296797,1725296801,1725296801.254883,-18000,EB445137-D7F5-57EC-87DA-1DB460D64046,"iPhone13,2"
com.google.ios.youtube,2,1725296795,1725296797,1725296797.475438,-18000,EB445137-D7F5-57EC-87DA-1DB460D64046,"iPhone13,2"
com.google.ios.youtube,1048,1725294432,1725295480,1725295480.628282,-18000,EB445137-D7F5-57EC-87DA-1DB460D64046,"iPhone13,2"
com.apple.weather,4,1725294424,1725294428,1725294428.713249,-18000,EB445137-D7F5-57EC-87DA-1DB460D64046,"iPhone13,2"
com.apple.weather,12,1725294409,1725294421,1725294421.790122,-18000,EB445137-D7F5-57EC-87DA-1DB460D64046,"iPhone13,2"
com.apple.weather,13,1725294323,1725294336,1725294336.593991,-18000,EB445137-D7F5-57EC-87DA-1DB460D64046,"iPhone13,2"
com.truebill.truebillnative,111,1725294182,1725294293,1725294293.518952,-18000,EB445137-D7F5-57EC-87DA-1DB460D64046,"iPhone13,2"
com.thestorygraph.thestorygraph,3,1725294179,1725294182,1725294182.539765,-18000,EB445137-D7F5-57EC-87DA-1DB460D64046,"iPhone13,2"
com.google.Chrome,580,1725294127,1725294707,1725294707.8671231,-18000,,
com.microsoft.Outlook,11,1725294094,1725294105,1725294105.937948,-18000,,
com.google.Chrome,254,1725293840,1725294094,1725294094.251861,-18000,,
com.microsoft.Outlook,14,1725293826,1725293840,1725293840.395325,-18000,,
com.google.Chrome,2,1725293824,1725293826,1725293826.913628,-18000,,
com.thestorygraph.thestorygraph,18,1725293746,1725293764,1725293764.623742,-18000,EB445137-D7F5-57EC-87DA-1DB460D64046,"iPhone13,2"
com.google.chrome.ios,17,1725293729,1725293746,1725293746.724098,-18000,EB445137-D7F5-57EC-87DA-1DB460D64046,"iPhone13,2"
com.microsoft.Office.Outlook,16,1725293713,1725293729,1725293729.12367,-18000,EB445137-D7F5-57EC-87DA-1DB460D64046,"iPhone13,2"
com.myfitnesspal.mfp,8,1725293705,1725293713,1725293714.169554,-18000,EB445137-D7F5-57EC-87DA-1DB460D64046,"iPhone13,2"
com.myfitnesspal.mfp,54,1725292165,1725292219,1725292219.445476,-18000,EB445137-D7F5-57EC-87DA-1DB460D64046,"iPhone13,2"
com.apple.Health,62,1725292103,1725292165,1725292165.717242,-18000,EB445137-D7F5-57EC-87DA-1DB460D64046,"iPhone13,2"
com.myfitnesspal.mfp,5,1725292096,1725292101,1725292101.794816,-18000,EB445137-D7F5-57EC-87DA-1DB460D64046,"iPhone13,2"
com.myfitnesspal.mfp,250,1725291786,1725292036,1725292036.890327,-18000,EB445137-D7F5-57EC-87DA-1DB460D64046,"iPhone13,2"
com.google.Chrome,1011,1725291452,1725292463,1725292463.4426398,-18000,,
com.hammerandchisel.discord,179,1725291260,1725291439,1725291439.375214,-18000,EB445137-D7F5-57EC-87DA-1DB460D64046,"iPhone13,2"
com.apple.MobileSMS,197,1725291255,1725291452,1725291452.272038,-18000,,
Astrospheric.Astrospheric,4,1725291255,1725291259,1725291259.5736709,-18000,EB445137-D7F5-57EC-87DA-1DB460D64046,"iPhone13,2"
com.google.Chrome,19,1725291236,1725291255,1725291255.437051,-18000,,
com.leomehlig.today,2,1725291182,1725291184,1725291184.9256458,-18000,,
com.google.Chrome,56,1725291126,1725291182,1725291182.871542,-18000,,
com.leomehlig.today,8,1725290713,1725290721,1725290721.7959309,-18000,,
com.google.Chrome,6,1725290707,1725290713,1725290713.290217,-18000,,
com.apple.finder,1,1725290706,1725290707,1725290708.792409,-18000,,
com.google.Chrome,5,1725290701,1725290706,1725290706.927041,-18000,,
Astrospheric.Astrospheric,17,1725290657,1725290674,1725290674.762269,-18000,EB445137-D7F5-57EC-87DA-1DB460D64046,"iPhone13,2"
com.apple.iCal,75,1725290626,1725290701,1725290701.10638,-18000,,
com.google.Chrome,5,1725290621,1725290626,1725290626.328351,-18000,,
Astrospheric.Astrospheric,80,1725290576,1725290656,1725290656.740562,-18000,EB445137-D7F5-57EC-87DA-1DB460D64046,"iPhone13,2"
com.myfitnesspal.mfp,13,1725290545,1725290558,1725290558.280295,-18000,EB445137-D7F5-57EC-87DA-1DB460D64046,"iPhone13,2"
com.myfitnesspal.mfp,143,1725290323,1725290466,1725290466.178678,-18000,EB445137-D7F5-57EC-87DA-1DB460D64046,"iPhone13,2"
com.myfitnesspal.mfp,160,1725290139,1725290299,1725290299.577941,-18000,EB445137-D7F5-57EC-87DA-1DB460D64046,"iPhone13,2"
com.renpho.health,4,1725290134,1725290138,1725290138.2316232,-18000,EB445137-D7F5-57EC-87DA-1DB460D64046,"iPhone13,2"
com.renpho.health,23,1725289253,1725289276,1725289276.3730888,-18000,EB445137-D7F5-57EC-87DA-1DB460D64046,"iPhone13,2"
com.apple.mobiletimer,12,1725284470,1725284482,1725284482.8270988,-18000,EB445137-D7F5-57EC-87DA-1DB460D64046,"iPhone13,2"
com.myfitnesspal.mfp,2,1725284468,1725284470,1725284471.20265,-18000,EB445137-D7F5-57EC-87DA-1DB460D64046,"iPhone13,2"
com.apple.mobiletimer,2,1725284453,1725284455,1725284455.694961,-18000,EB445137-D7F5-57EC-87DA-1DB460D64046,"iPhone13,2"
com.myfitnesspal.mfp,60,1725249443,1725249503,1725249503.8384151,-18000,EB445137-D7F5-57EC-87DA-1DB460D64046,"iPhone13,2"
com.myfitnesspal.mfp,149,1725246732,1725246881,1725246881.633965,-18000,EB445137-D7F5-57EC-87DA-1DB460D64046,"iPhone13,2"
com.myfitnesspal.mfp,57,1725246634,1725246691,1725246691.439703,-18000,EB445137-D7F5-57EC-87DA-1DB460D64046,"iPhone13,2"
com.apple.news,3,1725246631,1725246634,1725246634.610094,-18000,EB445137-D7F5-57EC-87DA-1DB460D64046,"iPhone13,2"
com.apple.news,170,1725246388,1725246558,1725246558.457995,-18000,EB445137-D7F5-57EC-87DA-1DB460D64046,"iPhone13,2"
com.apple.news,88,1725246274,1725246362,1725246362.0939898,-18000,EB445137-D7F5-57EC-87DA-1DB460D64046,"iPhone13,2"
com.myfitnesspal.mfp,39,1725246224,1725246263,1725246263.288527,-18000,EB445137-D7F5-57EC-87DA-1DB460D64046,"iPhone13,2"
com.apple.mobiletimer,15,1725246206,1725246221,1725246221.648664,-18000,EB445137-D7F5-57EC-87DA-1DB460D64046,"iPhone13,2"
com.truebill.truebillnative,6,1725246200,1725246206,1725246206.094586,-18000,EB445137-D7F5-57EC-87DA-1DB460D64046,"iPhone13,2"
com.truebill.truebillnative,2,1725243586,1725243588,1725243588.7090878,-18000,EB445137-D7F5-57EC-87DA-1DB460D64046,"iPhone13,2"
com.truebill.truebillnative,2,1725241802,1725241804,1725241804.523947,-18000,EB445137-D7F5-57EC-87DA-1DB460D64046,"iPhone13,2"
com.truebill.truebillnative,181,1725241531,1725241712,1725241712.7767649,-18000,EB445137-D7F5-57EC-87DA-1DB460D64046,"iPhone13,2"
com.toyopagroup.picaboo,9,1725241506,1725241515,1725241515.807773,-18000,EB445137-D7F5-57EC-87DA-1DB460D64046,"iPhone13,2"
com.toyopagroup.picaboo,4,1725241486,1725241490,1725241490.569525,-18000,EB445137-D7F5-57EC-87DA-1DB460D64046,"iPhone13,2"
com.toyopagroup.picaboo,6,1725241209,1725241215,1725241215.614368,-18000,EB445137-D7F5-57EC-87DA-1DB460D64046,"iPhone13,2"
com.toyopagroup.picaboo,3,1725240567,1725240570,1725240570.1275349,-18000,EB445137-D7F5-57EC-87DA-1DB460D64046,"iPhone13,2"
com.toyopagroup.picaboo,3,1725240426,1725240429,1725240429.84623,-18000,EB445137-D7F5-57EC-87DA-1DB460D64046,"iPhone13,2"
com.toyopagroup.picaboo,6,1725240028,1725240034,1725240034.760566,-18000,EB445137-D7F5-57EC-87DA-1DB460D64046,"iPhone13,2"
com.toyopagroup.picaboo,20,1725239973,1725239993,1725239993.173213,-18000,EB445137-D7F5-57EC-87DA-1DB460D64046,"iPhone13,2"
com.apple.Health,36,1725237725,1725237761,1725237761.185844,-18000,EB445137-D7F5-57EC-87DA-1DB460D64046,"iPhone13,2"
com.apple.MobileSMS,3,1725237119,1725237122,1725237122.658598,-18000,EB445137-D7F5-57EC-87DA-1DB460D64046,"iPhone13,2"
com.microsoft.Office.Outlook,8,1725237109,1725237117,1725237118.011056,-18000,EB445137-D7F5-57EC-87DA-1DB460D64046,"iPhone13,2"
com.apple.camera,1,1725236657,1725236658,1725236658.219283,-18000,EB445137-D7F5-57EC-87DA-1DB460D64046,"iPhone13,2"
com.hammerandchisel.discord,70,1725236584,1725236654,1725236654.895127,-18000,EB445137-D7F5-57EC-87DA-1DB460D64046,"iPhone13,2"
com.myfitnesspal.mfp,13,1725236571,1725236584,1725236584.5229259,-18000,EB445137-D7F5-57EC-87DA-1DB460D64046,"iPhone13,2"
com.myfitnesspal.mfp,2,1725234005,1725234007,1725234007.948981,-18000,EB445137-D7F5-57EC-87DA-1DB460D64046,"iPhone13,2"
com.myfitnesspal.mfp,53,1725233428,1725233481,1725233481.719685,-18000,EB445137-D7F5-57EC-87DA-1DB460D64046,"iPhone13,2"
com.microsoft.Office.Outlook,9,1725233410,1725233419,1725233420.023926,-18000,EB445137-D7F5-57EC-87DA-1DB460D64046,"iPhone13,2"
com.apple.MobileSMS,18,1725228646,1725228664,1725228664.6293259,-18000,EB445137-D7F5-57EC-87DA-1DB460D64046,"iPhone13,2"
com.apple.MobileSMS,9,1725228567,1725228576,1725228576.130409,-18000,EB445137-D7F5-57EC-87DA-1DB460D64046,"iPhone13,2"
com.apple.MobileSMS,7,1725228519,1725228526,1725228526.256396,-18000,EB445137-D7F5-57EC-87DA-1DB460D64046,"iPhone13,2"
com.apple.MobileSMS,2,1725228513,1725228515,1725228515.2779741,-18000,EB445137-D7F5-57EC-87DA-1DB460D64046,"iPhone13,2"
com.apple.MobileSMS,73,1725228415,1725228488,1725228488.681844,-18000,EB445137-D7F5-57EC-87DA-1DB460D64046,"iPhone13,2"
com.google.Chrome,2,1725224452,1725224454,1725224454.5592918,-18000,,
com.apple.finder,6,1725224446,1725224452,1725224452.6538181,-18000,,
com.apple.iCal,25,1725224421,1725224446,1725224447.073103,-18000,,
com.apple.Notes,68,1725224353,1725224421,1725224421.499033,-18000,,
com.apple.iCal,12,1725224341,1725224353,1725224353.715631,-18000,,
com.apple.finder,270,1725224071,1725224341,1725224341.992066,-18000,,
com.microsoft.Word,22,1725224049,1725224071,1725224071.535061,-18000,,
com.google.Chrome,275,1725223774,1725224049,1725224049.589395,-18000,,
com.apple.Notes,74,1725223700,1725223774,1725223774.826373,-18000,,
com.google.Chrome,6,1725223694,1725223700,1725223700.5380092,-18000,,
com.apple.Notes,187,1725223507,1725223694,1725223694.477963,-18000,,
com.google.Chrome,209,1725223298,1725223507,1725223507.375833,-18000,,
com.apple.Notes,36,1725223262,1725223298,1725223298.557076,-18000,,
com.google.Chrome,2,1725223260,1725223262,1725223262.3068519,-18000,,
com.apple.Notes,76,1725223184,1725223260,1725223260.5550199,-18000,,
com.google.Chrome,2,1725223182,1725223184,1725223184.9050422,-18000,,
com.apple.Notes,21,1725223161,1725223182,1725223182.891512,-18000,,
com.google.Chrome,46,1725223115,1725223161,1725223161.068619,-18000,,
com.microsoft.Word,119,1725222996,1725223115,1725223115.085093,-18000,,
com.google.Chrome,65,1725222931,1725222996,1725222996.691654,-18000,,
com.microsoft.Word,35,1725222896,1725222931,1725222931.813154,-18000,,
com.google.Chrome,16,1725222880,1725222896,1725222896.574636,-18000,,
com.microsoft.Word,98,1725222772,1725222870,1725222870.5486841,-18000,,
com.google.Chrome,14,1725222758,1725222772,1725222772.534785,-18000,,
com.microsoft.Word,121,1725222637,1725222758,1725222758.859298,-18000,,
com.google.Chrome,29,1725222608,1725222637,1725222637.303358,-18000,,
com.microsoft.Word,52,1725222556,1725222608,1725222608.245171,-18000,,
com.google.Chrome,11,1725222545,1725222556,1725222556.933965,-18000,,
com.microsoft.Word,8,1725222537,1725222545,1725222545.8441858,-18000,,
com.google.Chrome,2,1725222535,1725222537,1725222537.699048,-18000,,
com.microsoft.Word,41,1725222494,1725222535,1725222535.6094851,-18000,,
com.google.Chrome,14,1725222480,1725222494,1725222494.6083379,-18000,,
com.microsoft.Word,19,1725222461,1725222480,1725222480.963906,-18000,,
com.google.Chrome,35,1725222426,1725222461,1725222461.343464,-18000,,
com.microsoft.Word,28,1725222398,1725222426,1725222426.194077,-18000,,
com.google.Chrome,43,1725222355,1725222398,1725222398.396048,-18000,,
com.microsoft.Word,10,1725222330,1725222340,1725222340.798256,-18000,,
com.google.Chrome,221,1725222109,1725222330,1725222330.981906,-18000,,
com.microsoft.Word,17,1725222092,1725222109,1725222109.979099,-18000,,
com.google.Chrome,119,1725221973,1725222092,1725222092.946124,-18000,,
com.apple.iCal,31,1725221942,1725221973,1725221973.773792,-18000,,
com.microsoft.Word,251,1725221691,1725221942,1725221942.235863,-18000,,
com.apple.iCal,181,1725221510,1725221691,1725221691.319124,-18000,,
com.google.Chrome,3,1725221507,1725221510,1725221510.3538752,-18000,,
com.apple.iCal,6,1725221501,1725221507,1725221507.9615788,-18000,,
com.google.Chrome,71,1725221430,1725221501,1725221501.789278,-18000,,
com.apple.iCal,1,1725221429,1725221430,1725221430.688015,-18000,,
com.leomehlig.today,7,1725221422,1725221429,1725221429.872696,-18000,,
com.apple.iCal,2,1725221420,1725221422,1725221422.5233521,-18000,,
com.google.Chrome,3,1725221417,1725221420,1725221420.2843862,-18000,,
com.apple.iCal,1,1725221416,1725221417,1725221417.163361,-18000,,
com.leomehlig.today,27,1725221389,1725221416,1725221416.3339128,-18000,,
com.apple.iCal,12,1725221377,1725221389,1725221389.437464,-18000,,
com.google.Chrome,40,1725221337,1725221377,1725221377.16991,-18000,,
com.apple.iCal,29,1725221308,1725221337,1725221337.6649241,-18000,,
com.google.Chrome,64,1725221244,1725221308,1725221308.8081012,-18000,,
com.microsoft.Word,330,1725220914,1725221244,1725221244.4507232,-18000,,
com.apple.finder,18,1725220896,1725220914,1725220914.175596,-18000,,
com.google.Chrome,938,1725219958,1725220896,1725220896.834872,-18000,,
com.microsoft.Outlook,12,1725219946,1725219958,1725219958.8973951,-18000,,
com.apple.iCal,11,1725219935,1725219946,1725219946.621181,-18000,,
com.google.Chrome,0,1725219935,1725219935,1725219935.5872278,-18000,,
com.apple.iCal,2,1725219933,1725219935,1725219935.152662,-18000,,
com.google.Chrome,1,1725219932,1725219933,1725219933.14528,-18000,,
com.apple.iCal,2,1725219930,1725219932,1725219932.2250872,-18000,,
com.google.Chrome,2,1725219928,1725219930,1725219930.5291219,-18000,,
com.apple.iCal,12,1725219916,1725219928,1725219928.625926,-18000,,
com.google.Chrome,6,1725219910,1725219916,1725219916.492187,-18000,,
com.apple.iCal,27,1725219883,1725219910,1725219910.7440572,-18000,,
com.google.Chrome,6,1725219877,1725219883,1725219883.3041859,-18000,,
com.apple.iCal,9,1725219868,1725219877,1725219877.264005,-18000,,
com.google.Chrome,4,1725219864,1725219868,1725219868.450026,-18000,,
com.apple.iCal,7,1725219857,1725219864,1725219865.00043,-18000,,
com.google.Chrome,2,1725219855,1725219857,1725219857.78315,-18000,,
com.apple.iCal,7,1725219848,1725219855,1725219855.405796,-18000,,
com.google.Chrome,1,1725219847,1725219848,1725219848.956215,-18000,,
com.apple.iCal,2,1725219845,1725219847,1725219847.581783,-18000,,
com.google.Chrome,2,1725219843,1725219845,1725219845.426395,-18000,,
com.apple.iCal,2,1725219841,1725219843,1725219843.936345,-18000,,
com.google.Chrome,1,1725219840,1725219841,1725219841.742794,-18000,,
com.apple.iCal,3,1725219837,1725219840,1725219840.2040958,-18000,,
com.google.Chrome,1,1725219836,1725219837,1725219837.347281,-18000,,
com.apple.iCal,6,1725219830,1725219836,1725219836.9592829,-18000,,
com.google.Chrome,3,1725219827,1725219830,1725219830.70363,-18000,,
com.apple.iCal,12,1725219815,1725219827,1725219827.697911,-18000,,
com.google.Chrome,159,1725219656,1725219815,1725219816.0047488,-18000,,
com.microsoft.Outlook,39,1725219617,1725219656,1725219656.551086,-18000,,
com.google.Chrome,12,1725219605,1725219617,1725219617.556096,-18000,,
com.apple.iCal,7,1725219598,1725219605,1725219605.150423,-18000,,
com.google.Chrome,2,1725219596,1725219598,1725219598.61099,-18000,,
com.apple.iCal,4,1725219592,1725219596,1725219596.214785,-18000,,
com.google.Chrome,1,1725219591,1725219592,1725219592.031705,-18000,,
com.apple.iCal,2,1725219589,1725219591,1725219591.299426,-18000,,
com.google.Chrome,1,1725219588,1725219589,1725219589.23345,-18000,,
com.apple.iCal,5,1725219583,1725219588,1725219588.668277,-18000,,
com.google.Chrome,23,1725219560,1725219583,1725219583.816211,-18000,,
com.microsoft.Outlook,13,1725219547,1725219560,1725219560.1067271,-18000,,
com.google.Chrome,1,1725219546,1725219547,1725219547.2303991,-18000,,
com.apple.iCal,10,1725219536,1725219546,1725219546.198182,-18000,,
com.google.Chrome,1,1725219535,1725219536,1725219536.2703362,-18000,,
com.microsoft.Outlook,7,1725219528,1725219535,1725219535.360773,-18000,,
com.google.Chrome,9,1725219519,1725219528,1725219528.603703,-18000,,
com.apple.iCal,11,1725219508,1725219519,1725219519.386112,-18000,,
com.google.Chrome,7,1725219501,1725219508,1725219508.40586,-18000,,
com.apple.iCal,6,1725219495,1725219501,1725219501.85786,-18000,,
com.google.Chrome,3,1725219492,1725219495,1725219495.6708,-18000,,
com.apple.iCal,6,1725219486,1725219492,1725219492.990878,-18000,,
com.google.Chrome,24,1725219462,1725219486,1725219486.3300672,-18000,,
com.microsoft.Outlook,15,1725219447,1725219462,1725219462.234899,-18000,,
com.google.Chrome,1,1725219446,1725219447,1725219447.588032,-18000,,
com.apple.iCal,8,1725219438,1725219446,1725219446.1630611,-18000,,
com.microsoft.Outlook,24,1725219414,1725219438,1725219438.2846398,-18000,,
com.google.Chrome,48,1725219366,1725219414,1725219414.4736152,-18000,,
com.microsoft.Outlook,23,1725219343,1725219366,1725219366.859648,-18000,,
com.google.Chrome,226,1725219117,1725219343,1725219343.299983,-18000,,
com.leomehlig.today,13,1725219104,1725219117,1725219118.012717,-18000,,
com.google.Chrome,979,1725218125,1725219104,1725219104.4377031,-18000,,
com.apple.iCal,51,1725218074,1725218125,1725218125.617996,-18000,,
com.leomehlig.today,7,1725218067,1725218074,1725218074.4293861,-18000,,
com.apple.iCal,1,1725218066,1725218067,1725218067.161989,-18000,,
com.google.Chrome,70,1725217996,1725218066,1725218066.303302,-18000,,
com.apple.iCal,2,1725217994,1725217996,1725217996.969564,-18000,,
com.leomehlig.today,24,1725217970,1725217994,1725217994.1219711,-18000,,
com.apple.iCal,1,1725217969,1725217970,1725217970.9360309,-18000,,
com.google.Chrome,3504,1725214465,1725217969,1725217969.384107,-18000,,
com.leomehlig.today,11,1725214271,1725214282,1725214283.1754851,-18000,,
com.leomehlig.today,45,1725209949,1725209994,1725209994.9692268,-18000,,
com.google.Chrome,33,1725209916,1725209949,1725209950.009718,-18000,,
com.leomehlig.today,26,1725209890,1725209916,1725209916.255791,-18000,,
com.google.Chrome,20,1725209870,1725209890,1725209890.929902,-18000,,
com.leomehlig.today,2,1725209860,1725209862,1725209862.490308,-18000,,
com.google.Chrome,46,1725209814,1725209860,1725209860.3599849,-18000,,
com.google.Chrome,309,1725206147,1725206456,1725206456.9345531,-18000,,
com.leomehlig.today,217,1725205930,1725206147,1725206148.66327,-18000,,
com.leomehlig.today,315,1725144068,1725144383,1725144383.4815888,-18000,,
com.google.Chrome,48,1725144020,1725144068,1725144068.7248502,-18000,,
com.leomehlig.today,2,1725143799,1725143801,1725143801.782382,-18000,,
com.google.Chrome,61,1725143738,1725143799,1725143799.626834,-18000,,
com.leomehlig.today,74,1725143534,1725143608,1725143608.107208,-18000,,
com.apple.iCal,2,1725143532,1725143534,1725143534.615731,-18000,,
com.leomehlig.today,17,1725143515,1725143532,1725143532.741548,-18000,,
com.google.Chrome,253,1725143262,1725143515,1725143515.6663709,-18000,,
com.apple.iCal,16,1725143246,1725143262,1725143262.966573,-18000,,
com.google.Chrome,64,1725143182,1725143246,1725143246.4756432,-18000,,
com.apple.iCal,38,1725143003,1725143041,1725143041.4478002,-18000,,
com.google.Chrome,24,1725142979,1725143003,1725143003.269995,-18000,,
com.apple.iCal,14,1725142965,1725142979,1725142979.2184238,-18000,,
com.google.Chrome,16,1725142949,1725142965,1725142965.558747,-18000,,
com.google.Chrome,707,1725137889,1725138596,1725138597.038793,-18000,,
com.apple.finder,8,1725137881,1725137889,1725137889.474244,-18000,,
com.google.Chrome,49,1725137832,1725137881,1725137881.3196511,-18000,,
com.apple.finder,46,1725137786,1725137832,1725137833.816236,-18000,,
com.google.Chrome,63,1725137723,1725137786,1725137786.715102,-18000,,
com.apple.finder,34,1725137689,1725137723,1725137723.1394181,-18000,,
com.google.Chrome,28,1725137661,1725137689,1725137689.375519,-18000,,
com.apple.keychainaccess,96,1725137565,1725137661,1725137661.9116879,-18000,,
com.microsoft.Outlook,3,1725137562,1725137565,1725137565.519676,-18000,,
com.google.Chrome,143,1725137419,1725137562,1725137562.346137,-18000,,
com.google.Chrome,155,1725136408,1725136563,1725136563.688632,-18000,,
com.google.Chrome,92,1725128141,1725128233,1725128233.4202042,-18000,,
com.apple.Terminal,274,1725127867,1725128141,1725128141.615056,-18000,,
com.google.Chrome,126,1725127741,1725127867,1725127867.441248,-18000,,
com.leomehlig.today,9,1725127722,1725127731,1725127732.0215678,-18000,,
com.google.Chrome,85,1725127637,1725127722,1725127722.995061,-18000,,
com.microsoft.Outlook,13,1725127521,1725127534,1725127534.880024,-18000,,
com.google.Chrome,97,1725127424,1725127521,1725127521.8511171,-18000,,
com.apple.keychainaccess,2,1725127422,1725127424,1725127424.542273,-18000,,
com.google.Chrome,1,1725127421,1725127422,1725127422.195853,-18000,,
com.apple.keychainaccess,3,1725127418,1725127421,1725127421.328682,-18000,,
com.google.Chrome,58,1725127353,1725127411,1725127411.195385,-18000,,
com.apple.iCal,9,1725127328,1725127337,1725127337.321635,-18000,,
com.leomehlig.today,11,1725127317,1725127328,1725127328.4542289,-18000,,
com.microsoft.Excel,4,1725127313,1725127317,1725127317.980832,-18000,,
com.apple.mobiletimer,8,1725123988,1725123996,1725123996.251367,-18000,EB445137-D7F5-57EC-87DA-1DB460D64046,"iPhone13,2"
com.apple.camera,2,1725123988,1725123990,1725123990.263515,-18000,EB445137-D7F5-57EC-87DA-1DB460D64046,"iPhone13,2"
com.apple.mobiletimer,2,1725123984,1725123986,1725123986.412802,-18000,EB445137-D7F5-57EC-87DA-1DB460D64046,"iPhone13,2"
com.apple.mobiletimer,1,1725123933,1725123934,1725123934.947916,-18000,EB445137-D7F5-57EC-87DA-1DB460D64046,"iPhone13,2"
com.apple.mobiletimer,2,1725123889,1725123891,1725123891.17226,-18000,EB445137-D7F5-57EC-87DA-1DB460D64046,"iPhone13,2"
com.apple.mobiletimer,10,1725123620,1725123630,1725123630.2792501,-18000,EB445137-D7F5-57EC-87DA-1DB460D64046,"iPhone13,2"
com.apple.mobiletimer,36,1725123567,1725123603,1725123603.323893,-18000,EB445137-D7F5-57EC-87DA-1DB460D64046,"iPhone13,2"
com.apple.mobiletimer,6,1725123559,1725123565,1725123565.200407,-18000,EB445137-D7F5-57EC-87DA-1DB460D64046,"iPhone13,2"
com.apple.mobiletimer,7,1725123431,1725123438,1725123438.405087,-18000,EB445137-D7F5-57EC-87DA-1DB460D64046,"iPhone13,2"
com.apple.mobiletimer,6,1725123372,1725123378,1725123378.467936,-18000,EB445137-D7F5-57EC-87DA-1DB460D64046,"iPhone13,2"
com.apple.mobiletimer,33,1725123219,1725123252,1725123252.2727041,-18000,EB445137-D7F5-57EC-87DA-1DB460D64046,"iPhone13,2"
com.google.chrome.ios,9,1725123210,1725123219,1725123219.227673,-18000,EB445137-D7F5-57EC-87DA-1DB460D64046,"iPhone13,2"
com.google.chrome.ios,39,1725123127,1725123166,1725123166.3087401,-18000,EB445137-D7F5-57EC-87DA-1DB460D64046,"iPhone13,2"
com.google.chrome.ios,3,1725123124,1725123127,1725123127.466136,-18000,EB445137-D7F5-57EC-87DA-1DB460D64046,"iPhone13,2"
com.google.chrome.ios,11,1725122709,1725122720,1725122720.5967278,-18000,EB445137-D7F5-57EC-87DA-1DB460D64046,"iPhone13,2"
com.google.chrome.ios,16,1725122006,1725122022,1725122022.714624,-18000,EB445137-D7F5-57EC-87DA-1DB460D64046,"iPhone13,2"
com.apple.MobileSMS,55,1725121491,1725121546,1725121546.473053,-18000,EB445137-D7F5-57EC-87DA-1DB460D64046,"iPhone13,2"
Astrospheric.Astrospheric,13,1725121477,1725121490,1725121490.998639,-18000,EB445137-D7F5-57EC-87DA-1DB460D64046,"iPhone13,2"
com.apple.mobilecal,9,1725121452,1725121461,1725121461.86419,-18000,EB445137-D7F5-57EC-87DA-1DB460D64046,"iPhone13,2"
com.hammerandchisel.discord,155,1725120995,1725121150,1725121150.934187,-18000,EB445137-D7F5-57EC-87DA-1DB460D64046,"iPhone13,2"
com.apple.MobileSMS,6,1725120883,1725120889,1725120889.6899571,-18000,EB445137-D7F5-57EC-87DA-1DB460D64046,"iPhone13,2"
com.apple.weather,66,1725120678,1725120744,1725120744.998804,-18000,EB445137-D7F5-57EC-87DA-1DB460D64046,"iPhone13,2"
com.apple.Health,178,1725120499,1725120677,1725120677.680225,-18000,EB445137-D7F5-57EC-87DA-1DB460D64046,"iPhone13,2"
com.myfitnesspal.mfp,8,1725120491,1725120499,1725120499.1984348,-18000,EB445137-D7F5-57EC-87DA-1DB460D64046,"iPhone13,2"
com.myfitnesspal.mfp,208,1725119903,1725120111,1725120111.9800591,-18000,EB445137-D7F5-57EC-87DA-1DB460D64046,"iPhone13,2"
com.myfitnesspal.mfp,474,1725119428,1725119902,1725119902.465352,-18000,EB445137-D7F5-57EC-87DA-1DB460D64046,"iPhone13,2"
com.google.chrome.ios,252,1725119176,1725119428,1725119428.267235,-18000,EB445137-D7F5-57EC-87DA-1DB460D64046,"iPhone13,2"
com.google.chrome.ios,44,1725119110,1725119154,1725119154.086976,-18000,EB445137-D7F5-57EC-87DA-1DB460D64046,"iPhone13,2"
com.myfitnesspal.mfp,33,1725119076,1725119109,1725119109.420802,-18000,EB445137-D7F5-57EC-87DA-1DB460D64046,"iPhone13,2"
com.apple.Health,76,1725118986,1725119062,1725119062.962239,-18000,EB445137-D7F5-57EC-87DA-1DB460D64046,"iPhone13,2"
com.clairmail.fth.client,51,1725118589,1725118640,1725118640.5643702,-18000,EB445137-D7F5-57EC-87DA-1DB460D64046,"iPhone13,2"
com.truebill.truebillnative,10,1725118579,1725118589,1725118589.0565062,-18000,EB445137-D7F5-57EC-87DA-1DB460D64046,"iPhone13,2"
com.clairmail.fth.client,50,1725118529,1725118579,1725118580.025762,-18000,EB445137-D7F5-57EC-87DA-1DB460D64046,"iPhone13,2"
com.apple.calculator,30,1725118497,1725118527,1725118527.607265,-18000,EB445137-D7F5-57EC-87DA-1DB460D64046,"iPhone13,2"
com.apple.MobileSMS,3,1725118494,1725118497,1725118497.4715838,-18000,EB445137-D7F5-57EC-87DA-1DB460D64046,"iPhone13,2"
com.apple.calculator,26,1725118468,1725118494,1725118494.0878649,-18000,EB445137-D7F5-57EC-87DA-1DB460D64046,"iPhone13,2"
com.truebill.truebillnative,17,1725118451,1725118468,1725118468.402152,-18000,EB445137-D7F5-57EC-87DA-1DB460D64046,"iPhone13,2"
com.apple.calculator,6,1725118445,1725118451,1725118451.894239,-18000,EB445137-D7F5-57EC-87DA-1DB460D64046,"iPhone13,2"
com.truebill.truebillnative,128,1725118317,1725118445,1725118445.695341,-18000,EB445137-D7F5-57EC-87DA-1DB460D64046,"iPhone13,2"
com.apple.Health,19,1725118263,1725118282,1725118282.239609,-18000,EB445137-D7F5-57EC-87DA-1DB460D64046,"iPhone13,2"
com.apple.Health,36,1725118204,1725118240,1725118241.037564,-18000,EB445137-D7F5-57EC-87DA-1DB460D64046,"iPhone13,2"
com.myfitnesspal.mfp,162,1725118041,1725118203,1725118203.64693,-18000,EB445137-D7F5-57EC-87DA-1DB460D64046,"iPhone13,2"
com.apple.Health,192,1725117849,1725118041,1725118041.690027,-18000,EB445137-D7F5-57EC-87DA-1DB460D64046,"iPhone13,2"
com.apple.news,7,1725117840,1725117847,1725117847.645895,-18000,EB445137-D7F5-57EC-87DA-1DB460D64046,"iPhone13,2"
com.apple.news,51,1725117787,1725117838,1725117838.341573,-18000,EB445137-D7F5-57EC-87DA-1DB460D64046,"iPhone13,2"
com.google.chrome.ios,5,1725117773,1725117778,1725117778.625026,-18000,EB445137-D7F5-57EC-87DA-1DB460D64046,"iPhone13,2"
com.google.chrome.ios,9,1725117729,1725117738,1725117738.40981,-18000,EB445137-D7F5-57EC-87DA-1DB460D64046,"iPhone13,2"
com.google.chrome.ios,83,1725117556,1725117639,1725117639.512761,-18000,EB445137-D7F5-57EC-87DA-1DB460D64046,"iPhone13,2"
com.apple.camera,6,1725117549,1725117555,1725117556.410303,-18000,EB445137-D7F5-57EC-87DA-1DB460D64046,"iPhone13,2"
com.myfitnesspal.mfp,12,1725117544,1725117556,1725117558.014132,-18000,EB445137-D7F5-57EC-87DA-1DB460D64046,"iPhone13,2"
com.myfitnesspal.mfp,6,1725117472,1725117478,1725117478.900286,-18000,EB445137-D7F5-57EC-87DA-1DB460D64046,"iPhone13,2"
com.myfitnesspal.mfp,18,1725117320,1725117338,1725117338.233035,-18000,EB445137-D7F5-57EC-87DA-1DB460D64046,"iPhone13,2"
com.myfitnesspal.mfp,68,1725117202,1725117270,1725117271.015396,-18000,EB445137-D7F5-57EC-87DA-1DB460D64046,"iPhone13,2"
com.myfitnesspal.mfp,144,1725117004,1725117148,1725117148.7585201,-18000,EB445137-D7F5-57EC-87DA-1DB460D64046,"iPhone13,2"
com.myfitnesspal.mfp,8,1725116199,1725116207,1725116208.0284219,-18000,EB445137-D7F5-57EC-87DA-1DB460D64046,"iPhone13,2"
com.apple.Health,2,1725116196,1725116198,1725116198.412725,-18000,EB445137-D7F5-57EC-87DA-1DB460D64046,"iPhone13,2"
com.apple.Health,7,1725116172,1725116179,1725116179.8658462,-18000,EB445137-D7F5-57EC-87DA-1DB460D64046,"iPhone13,2"
com.apple.Health,56,1725116115,1725116171,1725116171.4834762,-18000,EB445137-D7F5-57EC-87DA-1DB460D64046,"iPhone13,2"
com.renpho.health,105,1725116009,1725116114,1725116114.825659,-18000,EB445137-D7F5-57EC-87DA-1DB460D64046,"iPhone13,2"
com.myfitnesspal.mfp,7,1725116002,1725116009,1725116010.0388079,-18000,EB445137-D7F5-57EC-87DA-1DB460D64046,"iPhone13,2"
com.myfitnesspal.mfp,16,1725110100,1725110116,1725110117.005138,-18000,EB445137-D7F5-57EC-87DA-1DB460D64046,"iPhone13,2"
com.myfitnesspal.mfp,19,1725074581,1725074600,1725074600.179033,-18000,EB445137-D7F5-57EC-87DA-1DB460D64046,"iPhone13,2"
com.myfitnesspal.mfp,9,1725065821,1725065830,1725065830.564477,-18000,EB445137-D7F5-57EC-87DA-1DB460D64046,"iPhone13,2"
com.myfitnesspal.mfp,2,1725065757,1725065759,1725065759.989474,-18000,EB445137-D7F5-57EC-87DA-1DB460D64046,"iPhone13,2"
com.myfitnesspal.mfp,23,1725065733,1725065756,1725065756.982698,-18000,EB445137-D7F5-57EC-87DA-1DB460D64046,"iPhone13,2"
com.toyopagroup.picaboo,43,1725065541,1725065584,1725065584.931416,-18000,EB445137-D7F5-57EC-87DA-1DB460D64046,"iPhone13,2"
com.toyopagroup.picaboo,6,1725065535,1725065541,1725065541.5653648,-18000,EB445137-D7F5-57EC-87DA-1DB460D64046,"iPhone13,2"
com.toyopagroup.picaboo,4,1725064916,1725064920,1725064920.449295,-18000,EB445137-D7F5-57EC-87DA-1DB460D64046,"iPhone13,2"
com.toyopagroup.picaboo,5,1725064600,1725064605,1725064605.740069,-18000,EB445137-D7F5-57EC-87DA-1DB460D64046,"iPhone13,2"
com.tinyspeck.chatlyio,14,1725064586,1725064600,1725064600.790528,-18000,EB445137-D7F5-57EC-87DA-1DB460D64046,"iPhone13,2"
com.toyopagroup.picaboo,4,1725064577,1725064581,1725064581.619303,-18000,EB445137-D7F5-57EC-87DA-1DB460D64046,"iPhone13,2"
com.toyopagroup.picaboo,65,1725064510,1725064575,1725064575.3772922,-18000,EB445137-D7F5-57EC-87DA-1DB460D64046,"iPhone13,2"
com.apple.MobileSMS,12,1725064494,1725064506,1725064506.33009,-18000,EB445137-D7F5-57EC-87DA-1DB460D64046,"iPhone13,2"
com.toyopagroup.picaboo,20,1725063463,1725063483,1725063483.847506,-18000,EB445137-D7F5-57EC-87DA-1DB460D64046,"iPhone13,2"
com.apple.mobileslideshow,2,1725063461,1725063463,1725063463.778132,-18000,EB445137-D7F5-57EC-87DA-1DB460D64046,"iPhone13,2"
com.apple.mobileslideshow,54,1725063371,1725063425,1725063425.060574,-18000,EB445137-D7F5-57EC-87DA-1DB460D64046,"iPhone13,2"
com.apple.MobileSMS,8,1725063354,1725063362,1725063362.751184,-18000,EB445137-D7F5-57EC-87DA-1DB460D64046,"iPhone13,2"
com.apple.MobileSMS,12,1725063268,1725063280,1725063280.98756,-18000,EB445137-D7F5-57EC-87DA-1DB460D64046,"iPhone13,2"
com.apple.MobileSMS,39,1725063222,1725063261,1725063261.342042,-18000,EB445137-D7F5-57EC-87DA-1DB460D64046,"iPhone13,2"
com.toyopagroup.picaboo,9,1725063212,1725063221,1725063221.188673,-18000,EB445137-D7F5-57EC-87DA-1DB460D64046,"iPhone13,2"
com.microsoft.Office.Outlook,4,1725063208,1725063212,1725063213.0500531,-18000,EB445137-D7F5-57EC-87DA-1DB460D64046,"iPhone13,2"
com.microsoft.Office.Outlook,16,1725061637,1725061653,1725061653.703511,-18000,EB445137-D7F5-57EC-87DA-1DB460D64046,"iPhone13,2"
com.instructure.icanvas,20,1725061612,1725061632,1725061632.269897,-18000,EB445137-D7F5-57EC-87DA-1DB460D64046,"iPhone13,2"
com.toyopagroup.picaboo,32,1725061571,1725061603,1725061603.532332,-18000,EB445137-D7F5-57EC-87DA-1DB460D64046,"iPhone13,2"
com.apple.MobileSMS,3,1725061568,1725061571,1725061571.346558,-18000,EB445137-D7F5-57EC-87DA-1DB460D64046,"iPhone13,2"
com.apple.MobileSMS,3,1725061555,1725061558,1725061558.159473,-18000,EB445137-D7F5-57EC-87DA-1DB460D64046,"iPhone13,2"
com.apple.MobileSMS,49,1725059280,1725059329,1725059329.562735,-18000,EB445137-D7F5-57EC-87DA-1DB460D64046,"iPhone13,2"
com.apple.camera,10,1725059227,1725059237,1725059239.048773,-18000,EB445137-D7F5-57EC-87DA-1DB460D64046,"iPhone13,2"
com.toyopagroup.picaboo,14,1725059202,1725059216,1725059216.9816098,-18000,EB445137-D7F5-57EC-87DA-1DB460D64046,"iPhone13,2"
com.apple.MobileSMS,3,1725059199,1725059202,1725059202.4784498,-18000,EB445137-D7F5-57EC-87DA-1DB460D64046,"iPhone13,2"
com.apple.MobileSMS,1,1725058948,1725058949,1725058949.955357,-18000,EB445137-D7F5-57EC-87DA-1DB460D64046,"iPhone13,2"
com.apple.MobileSMS,2,1725058803,1725058805,1725058805.118009,-18000,EB445137-D7F5-57EC-87DA-1DB460D64046,"iPhone13,2"
com.apple.MobileSMS,88,1725055200,1725055288,1725055288.029959,-18000,EB445137-D7F5-57EC-87DA-1DB460D64046,"iPhone13,2"
com.apple.MobileSMS,142,1725055046,1725055188,1725055188.4929008,-18000,EB445137-D7F5-57EC-87DA-1DB460D64046,"iPhone13,2"
com.apple.MobileSMS,79,1725054966,1725055045,1725055045.081832,-18000,EB445137-D7F5-57EC-87DA-1DB460D64046,"iPhone13,2"
com.apple.calculator,2,1725054964,1725054966,1725054966.6883621,-18000,EB445137-D7F5-57EC-87DA-1DB460D64046,"iPhone13,2"
com.apple.calculator,55,1725054831,1725054886,1725054886.473736,-18000,EB445137-D7F5-57EC-87DA-1DB460D64046,"iPhone13,2"
com.apple.Music,3,1725054828,1725054831,1725054831.4281468,-18000,EB445137-D7F5-57EC-87DA-1DB460D64046,"iPhone13,2"
com.apple.Music,10,1725053543,1725053553,1725053553.827409,-18000,EB445137-D7F5-57EC-87DA-1DB460D64046,"iPhone13,2"
com.toyopagroup.picaboo,6,1725053535,1725053541,1725053541.111206,-18000,EB445137-D7F5-57EC-87DA-1DB460D64046,"iPhone13,2"
com.apple.mobilenotes,5,1725053530,1725053535,1725053535.166497,-18000,EB445137-D7F5-57EC-87DA-1DB460D64046,"iPhone13,2"
com.apple.mobilenotes,4,1725053045,1725053049,1725053049.484513,-18000,EB445137-D7F5-57EC-87DA-1DB460D64046,"iPhone13,2"
com.apple.camera,7,1725052994,1725053001,1725053002.156276,-18000,EB445137-D7F5-57EC-87DA-1DB460D64046,"iPhone13,2"
com.apple.mobilenotes,8,1725052993,1725053001,1725053002.162571,-18000,EB445137-D7F5-57EC-87DA-1DB460D64046,"iPhone13,2"
com.apple.mobilenotes,9,1725052891,1725052900,1725052900.103304,-18000,EB445137-D7F5-57EC-87DA-1DB460D64046,"iPhone13,2"
com.myfitnesspal.mfp,2,1725052889,1725052891,1725052891.535392,-18000,EB445137-D7F5-57EC-87DA-1DB460D64046,"iPhone13,2"
com.myfitnesspal.mfp,27,1725052861,1725052888,1725052888.451911,-18000,EB445137-D7F5-57EC-87DA-1DB460D64046,"iPhone13,2"
com.myfitnesspal.mfp,4,1725052836,1725052840,1725052840.496891,-18000,EB445137-D7F5-57EC-87DA-1DB460D64046,"iPhone13,2"
com.myfitnesspal.mfp,4,1725052800,1725052804,1725052804.1375132,-18000,EB445137-D7F5-57EC-87DA-1DB460D64046,"iPhone13,2"
com.myfitnesspal.mfp,28,1725052765,1725052793,1725052793.735543,-18000,EB445137-D7F5-57EC-87DA-1DB460D64046,"iPhone13,2"
com.meijer.mobile.Meijer,5,1725052760,1725052765,1725052765.6970901,-18000,EB445137-D7F5-57EC-87DA-1DB460D64046,"iPhone13,2"
com.meijer.mobile.Meijer,5,1725052749,1725052754,1725052754.640419,-18000,EB445137-D7F5-57EC-87DA-1DB460D64046,"iPhone13,2"
com.meijer.mobile.Meijer,25,1725052669,1725052694,1725052694.9766831,-18000,EB445137-D7F5-57EC-87DA-1DB460D64046,"iPhone13,2"
com.apple.mobilenotes,10,1725052657,1725052667,1725052667.776062,-18000,EB445137-D7F5-57EC-87DA-1DB460D64046,"iPhone13,2"
com.apple.mobilenotes,15,1725052566,1725052581,1725052581.207798,-18000,EB445137-D7F5-57EC-87DA-1DB460D64046,"iPhone13,2"
com.apple.mobilenotes,16,1725052498,1725052514,1725052514.926569,-18000,EB445137-D7F5-57EC-87DA-1DB460D64046,"iPhone13,2"
com.apple.mobilenotes,17,1725052383,1725052400,1725052400.712178,-18000,EB445137-D7F5-57EC-87DA-1DB460D64046,"iPhone13,2"
com.apple.mobilenotes,13,1725052350,1725052363,1725052363.6756039,-18000,EB445137-D7F5-57EC-87DA-1DB460D64046,"iPhone13,2"
com.apple.mobilenotes,13,1725052327,1725052340,1725052340.2320719,-18000,EB445137-D7F5-57EC-87DA-1DB460D64046,"iPhone13,2"
com.apple.mobilenotes,37,1725052289,1725052326,1725052326.561876,-18000,EB445137-D7F5-57EC-87DA-1DB460D64046,"iPhone13,2"
com.apple.mobilenotes,7,1725052221,1725052228,1725052228.0187201,-18000,EB445137-D7F5-57EC-87DA-1DB460D64046,"iPhone13,2"
com.toyopagroup.picaboo,8,1725052213,1725052221,1725052221.140003,-18000,EB445137-D7F5-57EC-87DA-1DB460D64046,"iPhone13,2"
com.apple.mobilenotes,7,1725052206,1725052213,1725052214.0903869,-18000,EB445137-D7F5-57EC-87DA-1DB460D64046,"iPhone13,2"
com.apple.mobilenotes,6,1725050377,1725050383,1725050383.550978,-18000,EB445137-D7F5-57EC-87DA-1DB460D64046,"iPhone13,2"
com.apple.mobilenotes,7,1725050369,1725050376,1725050376.817544,-18000,EB445137-D7F5-57EC-87DA-1DB460D64046,"iPhone13,2"
com.google.chrome.ios,2,1725050367,1725050369,1725050369.857811,-18000,EB445137-D7F5-57EC-87DA-1DB460D64046,"iPhone13,2"
com.google.chrome.ios,51,1725048799,1725048850,1725048850.698052,-18000,EB445137-D7F5-57EC-87DA-1DB460D64046,"iPhone13,2"
com.microsoft.Excel,80,1725047651,1725047731,1725047731.4605951,-18000,,
com.leomehlig.today,7,1725047644,1725047651,1725047651.444789,-18000,,
com.microsoft.Excel,201,1725047443,1725047644,1725047644.120378,-18000,,
com.leomehlig.today,1,1725047442,1725047443,1725047443.73282,-18000,,
com.apple.finder,1,1725047441,1725047442,1725047442.3235478,-18000,,
com.apple.iCal,6,1725047435,1725047441,1725047441.4264011,-18000,,
com.apple.finder,1,1725047434,1725047435,1725047435.65346,-18000,,
com.leomehlig.today,1,1725047433,1725047434,1725047434.63806,-18000,,
com.microsoft.Excel,95,1725047338,1725047433,1725047433.165008,-18000,,
com.leomehlig.today,6,1725047332,1725047338,1725047338.101111,-18000,,
com.microsoft.Excel,158,1725047174,1725047332,1725047332.3081322,-18000,,
com.leomehlig.today,63,1725047111,1725047174,1725047174.753098,-18000,,
com.microsoft.Excel,10,1725047101,1725047111,1725047111.3017201,-18000,,
com.apple.finder,30,1725047071,1725047101,1725047102.023355,-18000,,
com.leomehlig.today,22,1725047049,1725047071,1725047071.510633,-18000,,
com.apple.iCal,4,1725047045,1725047049,1725047049.2756739,-18000,,
com.leomehlig.today,60,1725046985,1725047045,1725047045.661707,-18000,,
com.apple.iCal,49,1725046936,1725046985,1725046985.869563,-18000,,
com.leomehlig.today,30,1725046906,1725046936,1725046936.4857001,-18000,,
com.apple.iCal,45,1725046861,1725046906,1725046906.3199902,-18000,,
com.leomehlig.today,22,1725046839,1725046861,1725046861.601606,-18000,,
com.apple.iCal,9,1725046830,1725046839,1725046839.451674,-18000,,
com.leomehlig.today,6,1725046824,1725046830,1725046830.33246,-18000,,
com.apple.Health,52,1725046710,1725046762,1725046762.750705,-18000,EB445137-D7F5-57EC-87DA-1DB460D64046,"iPhone13,2"
com.apple.Health,5,1725046697,1725046702,1725046702.347122,-18000,EB445137-D7F5-57EC-87DA-1DB460D64046,"iPhone13,2"
com.apple.calculator,38,1725046659,1725046697,1725046697.251157,-18000,EB445137-D7F5-57EC-87DA-1DB460D64046,"iPhone13,2"
com.apple.Health,48,1725046611,1725046659,1725046659.8691711,-18000,EB445137-D7F5-57EC-87DA-1DB460D64046,"iPhone13,2"
com.myfitnesspal.mfp,28,1725046581,1725046609,1725046609.348927,-18000,EB445137-D7F5-57EC-87DA-1DB460D64046,"iPhone13,2"
com.google.chrome.ios,6,1725046575,1725046581,1725046581.294102,-18000,EB445137-D7F5-57EC-87DA-1DB460D64046,"iPhone13,2"
com.myfitnesspal.mfp,32,1725046543,1725046575,1725046575.730818,-18000,EB445137-D7F5-57EC-87DA-1DB460D64046,"iPhone13,2"
com.google.chrome.ios,3,1725046540,1725046543,1725046543.70076,-18000,EB445137-D7F5-57EC-87DA-1DB460D64046,"iPhone13,2"
com.myfitnesspal.mfp,17,1725046523,1725046540,1725046540.495041,-18000,EB445137-D7F5-57EC-87DA-1DB460D64046,"iPhone13,2"
com.google.chrome.ios,3,1725046520,1725046523,1725046523.137099,-18000,EB445137-D7F5-57EC-87DA-1DB460D64046,"iPhone13,2"
com.myfitnesspal.mfp,19,1725046501,1725046520,1725046520.933878,-18000,EB445137-D7F5-57EC-87DA-1DB460D64046,"iPhone13,2"
com.google.chrome.ios,1,1725046500,1725046501,1725046501.7874699,-18000,EB445137-D7F5-57EC-87DA-1DB460D64046,"iPhone13,2"
com.myfitnesspal.mfp,27,1725046473,1725046500,1725046500.094739,-18000,EB445137-D7F5-57EC-87DA-1DB460D64046,"iPhone13,2"
com.google.chrome.ios,2,1725046471,1725046473,1725046473.541157,-18000,EB445137-D7F5-57EC-87DA-1DB460D64046,"iPhone13,2"
com.myfitnesspal.mfp,55,1725046416,1725046471,1725046472.0725,-18000,EB445137-D7F5-57EC-87DA-1DB460D64046,"iPhone13,2"
com.google.chrome.ios,8,1725046408,1725046416,1725046416.369882,-18000,EB445137-D7F5-57EC-87DA-1DB460D64046,"iPhone13,2"
com.myfitnesspal.mfp,50,1725046358,1725046408,1725046408.2229872,-18000,EB445137-D7F5-57EC-87DA-1DB460D64046,"iPhone13,2"
com.google.Chrome,496,1725046328,1725046824,1725046824.870259,-18000,,
com.myfitnesspal.mfp,0,1725046056,1725046056,1725046056.950739,-18000,EB445137-D7F5-57EC-87DA-1DB460D64046,"iPhone13,2"
com.myfitnesspal.mfp,7,1725045669,1725045676,1725045676.975914,-18000,EB445137-D7F5-57EC-87DA-1DB460D64046,"iPhone13,2"
com.myfitnesspal.mfp,12,1725045657,1725045669,1725045669.194248,-18000,EB445137-D7F5-57EC-87DA-1DB460D64046,"iPhone13,2"
com.myfitnesspal.mfp,70,1725045350,1725045420,1725045420.6811671,-18000,EB445137-D7F5-57EC-87DA-1DB460D64046,"iPhone13,2"
com.google.chrome.ios,4,1725045346,1725045350,1725045351.1415339,-18000,EB445137-D7F5-57EC-87DA-1DB460D64046,"iPhone13,2"
com.myfitnesspal.mfp,18,1725045328,1725045346,1725045346.2374191,-18000,EB445137-D7F5-57EC-87DA-1DB460D64046,"iPhone13,2"
com.google.chrome.ios,57,1725045269,1725045326,1725045326.527024,-18000,EB445137-D7F5-57EC-87DA-1DB460D64046,"iPhone13,2"
com.google.chrome.ios,43,1725045174,1725045217,1725045217.5607228,-18000,EB445137-D7F5-57EC-87DA-1DB460D64046,"iPhone13,2"
com.apple.camera,1,1725045090,1725045091,1725045091.3971791,-18000,EB445137-D7F5-57EC-87DA-1DB460D64046,"iPhone13,2"
com.muscleforlife.Stacked,32,1725045050,1725045082,1725045082.411386,-18000,EB445137-D7F5-57EC-87DA-1DB460D64046,"iPhone13,2"
com.instructure.icanvas,4,1725045046,1725045050,1725045050.5889258,-18000,EB445137-D7F5-57EC-87DA-1DB460D64046,"iPhone13,2"
com.instructure.icanvas,2,1725044897,1725044899,1725044899.2766628,-18000,EB445137-D7F5-57EC-87DA-1DB460D64046,"iPhone13,2"
com.instructure.icanvas,6,1725044751,1725044757,1725044757.2304049,-18000,EB445137-D7F5-57EC-87DA-1DB460D64046,"iPhone13,2"
com.muscleforlife.Stacked,7,1725044744,1725044751,1725044751.761395,-18000,EB445137-D7F5-57EC-87DA-1DB460D64046,"iPhone13,2"
com.muscleforlife.Stacked,11,1725044240,1725044251,1725044251.146402,-18000,EB445137-D7F5-57EC-87DA-1DB460D64046,"iPhone13,2"
com.muscleforlife.Stacked,53,1725044164,1725044217,1725044217.787375,-18000,EB445137-D7F5-57EC-87DA-1DB460D64046,"iPhone13,2"
com.muscleforlife.Stacked,9,1725044109,1725044118,1725044118.29245,-18000,EB445137-D7F5-57EC-87DA-1DB460D64046,"iPhone13,2"
com.muscleforlife.Stacked,100,1725044008,1725044108,1725044108.248744,-18000,EB445137-D7F5-57EC-87DA-1DB460D64046,"iPhone13,2"
com.google.chrome.ios,37,1725043971,1725044008,1725044008.485365,-18000,EB445137-D7F5-57EC-87DA-1DB460D64046,"iPhone13,2"
com.muscleforlife.Stacked,26,1725043945,1725043971,1725043971.142472,-18000,EB445137-D7F5-57EC-87DA-1DB460D64046,"iPhone13,2"
com.muscleforlife.Stacked,20,1725043764,1725043784,1725043784.077034,-18000,EB445137-D7F5-57EC-87DA-1DB460D64046,"iPhone13,2"
com.muscleforlife.Stacked,5,1725043528,1725043533,1725043533.454177,-18000,EB445137-D7F5-57EC-87DA-1DB460D64046,"iPhone13,2"
com.google.ios.youtube,67,1725043461,1725043528,1725043528.216508,-18000,EB445137-D7F5-57EC-87DA-1DB460D64046,"iPhone13,2"
com.google.ios.youtube,80,1725043158,1725043238,1725043238.224231,-18000,EB445137-D7F5-57EC-87DA-1DB460D64046,"iPhone13,2"
com.google.chrome.ios,12,1725043146,1725043158,1725043159.139457,-18000,EB445137-D7F5-57EC-87DA-1DB460D64046,"iPhone13,2"
com.muscleforlife.Stacked,46,1725042973,1725043019,1725043019.9608622,-18000,EB445137-D7F5-57EC-87DA-1DB460D64046,"iPhone13,2"
com.muscleforlife.Stacked,7,1725042746,1725042753,1725042753.903976,-18000,EB445137-D7F5-57EC-87DA-1DB460D64046,"iPhone13,2"
com.muscleforlife.Stacked,8,1725042736,1725042744,1725042744.925138,-18000,EB445137-D7F5-57EC-87DA-1DB460D64046,"iPhone13,2"
com.muscleforlife.Stacked,124,1725042609,1725042733,1725042733.4274778,-18000,EB445137-D7F5-57EC-87DA-1DB460D64046,"iPhone13,2"
com.myfitnesspal.mfp,64,1725042533,1725042597,1725042597.177565,-18000,EB445137-D7F5-57EC-87DA-1DB460D64046,"iPhone13,2"
com.myfitnesspal.mfp,40,1725042270,1725042310,1725042310.796098,-18000,EB445137-D7F5-57EC-87DA-1DB460D64046,"iPhone13,2"
com.apple.weather,2,1725042267,1725042269,1725042269.834869,-18000,EB445137-D7F5-57EC-87DA-1DB460D64046,"iPhone13,2"
com.apple.weather,8,1725041304,1725041312,1725041312.877195,-18000,EB445137-D7F5-57EC-87DA-1DB460D64046,"iPhone13,2"
com.apple.weather,5,1725041279,1725041284,1725041284.910898,-18000,EB445137-D7F5-57EC-87DA-1DB460D64046,"iPhone13,2"
com.apple.weather,3,1725041274,1725041277,1725041277.276219,-18000,EB445137-D7F5-57EC-87DA-1DB460D64046,"iPhone13,2"
com.apple.Maps,45,1725041229,1725041274,1725041274.6986918,-18000,EB445137-D7F5-57EC-87DA-1DB460D64046,"iPhone13,2"
com.apple.news,330,1725040898,1725041228,1725041228.6586928,-18000,EB445137-D7F5-57EC-87DA-1DB460D64046,"iPhone13,2"
com.myfitnesspal.mfp,5,1725040881,1725040886,1725040886.5940928,-18000,EB445137-D7F5-57EC-87DA-1DB460D64046,"iPhone13,2"
com.myfitnesspal.mfp,3,1725040865,1725040868,1725040868.196821,-18000,EB445137-D7F5-57EC-87DA-1DB460D64046,"iPhone13,2"
com.google.Chrome,3,1725040859,1725040862,1725040863.000544,-18000,,
com.leomehlig.today,36,1725040823,1725040859,1725040859.96327,-18000,,
com.google.Chrome,1098,1725039725,1725040823,1725040823.71031,-18000,,
com.leomehlig.today,10,1725039715,1725039725,1725039725.674761,-18000,,
com.myfitnesspal.mfp,230,1725039274,1725039504,1725039504.485591,-18000,EB445137-D7F5-57EC-87DA-1DB460D64046,"iPhone13,2"
com.apple.Maps,4,1725039270,1725039274,1725039274.732343,-18000,EB445137-D7F5-57EC-87DA-1DB460D64046,"iPhone13,2"
com.apple.Maps,24,1725039226,1725039250,1725039250.924199,-18000,EB445137-D7F5-57EC-87DA-1DB460D64046,"iPhone13,2"
com.google.Chrome,1013,1725038702,1725039715,1725039715.5347,-18000,,
com.leomehlig.today,2,1725038700,1725038702,1725038703.231247,-18000,,
com.myfitnesspal.mfp,273,1725038342,1725038615,1725038615.665401,-18000,EB445137-D7F5-57EC-87DA-1DB460D64046,"iPhone13,2"
com.leomehlig.today,321,1725037340,1725037661,1725037661.400636,-18000,,
com.microsoft.Office.Outlook,10,1725036543,1725036553,1725036553.150523,-18000,EB445137-D7F5-57EC-87DA-1DB460D64046,"iPhone13,2"
com.clairmail.fth.client,4,1725036539,1725036543,1725036543.612629,-18000,EB445137-D7F5-57EC-87DA-1DB460D64046,"iPhone13,2"
com.google.Chrome,1491,1725035849,1725037340,1725037340.5116038,-18000,,
com.leomehlig.today,28,1725035821,1725035849,1725035849.184544,-18000,,
com.google.Chrome,2,1725035819,1725035821,1725035821.3415189,-18000,,
com.clairmail.fth.client,5,1725035678,1725035683,1725035683.274313,-18000,EB445137-D7F5-57EC-87DA-1DB460D64046,"iPhone13,2"
com.clairmail.fth.client,8,1725035642,1725035650,1725035650.697369,-18000,EB445137-D7F5-57EC-87DA-1DB460D64046,"iPhone13,2"
com.apple.MobileSMS,7,1725035635,1725035642,1725035642.844794,-18000,EB445137-D7F5-57EC-87DA-1DB460D64046,"iPhone13,2"
com.apple.MobileSMS,7,1725034403,1725034410,1725034410.205505,-18000,EB445137-D7F5-57EC-87DA-1DB460D64046,"iPhone13,2"
com.apple.MobileSMS,6,1725034288,1725034294,1725034294.768332,-18000,EB445137-D7F5-57EC-87DA-1DB460D64046,"iPhone13,2"
com.apple.MobileSMS,9,1725034017,1725034026,1725034026.5707421,-18000,EB445137-D7F5-57EC-87DA-1DB460D64046,"iPhone13,2"
com.apple.MobileSMS,29,1725033942,1725033971,1725033971.4852781,-18000,EB445137-D7F5-57EC-87DA-1DB460D64046,"iPhone13,2"
com.apple.MobileSMS,43,1725033896,1725033939,1725033939.22912,-18000,EB445137-D7F5-57EC-87DA-1DB460D64046,"iPhone13,2"
com.apple.MobileSMS,13,1725033883,1725033896,1725033896.0128431,-18000,EB445137-D7F5-57EC-87DA-1DB460D64046,"iPhone13,2"
com.apple.MobileSMS,1,1725033882,1725033883,1725033883.4525352,-18000,EB445137-D7F5-57EC-87DA-1DB460D64046,"iPhone13,2"
com.apple.MobileSMS,21,1725033848,1725033869,1725033869.332845,-18000,EB445137-D7F5-57EC-87DA-1DB460D64046,"iPhone13,2"
com.apple.MobileSMS,8,1725033820,1725033828,1725033828.387278,-18000,EB445137-D7F5-57EC-87DA-1DB460D64046,"iPhone13,2"
com.apple.MobileSMS,2,1725033472,1725033474,1725033474.490241,-18000,EB445137-D7F5-57EC-87DA-1DB460D64046,"iPhone13,2"
com.apple.MobileSMS,3,1725033256,1725033259,1725033259.275159,-18000,EB445137-D7F5-57EC-87DA-1DB460D64046,"iPhone13,2"
com.apple.MobileSMS,2,1725033238,1725033240,1725033240.598692,-18000,EB445137-D7F5-57EC-87DA-1DB460D64046,"iPhone13,2"
com.apple.MobileSMS,3,1725033205,1725033208,1725033208.838468,-18000,EB445137-D7F5-57EC-87DA-1DB460D64046,"iPhone13,2"
com.apple.MobileSMS,4,1725033176,1725033180,1725033180.006654,-18000,EB445137-D7F5-57EC-87DA-1DB460D64046,"iPhone13,2"
com.apple.MobileSMS,4,1725033170,1725033174,1725033174.539185,-18000,EB445137-D7F5-57EC-87DA-1DB460D64046,"iPhone13,2"
com.apple.MobileSMS,8,1725033128,1725033136,1725033136.764408,-18000,EB445137-D7F5-57EC-87DA-1DB460D64046,"iPhone13,2"
com.apple.MobileSMS,24,1725033097,1725033121,1725033121.338036,-18000,EB445137-D7F5-57EC-87DA-1DB460D64046,"iPhone13,2"
com.apple.reminders,7,1725033088,1725033095,1725033095.708364,-18000,EB445137-D7F5-57EC-87DA-1DB460D64046,"iPhone13,2"
com.google.Chrome,1243,1725029674,1725030917,1725030917.253958,-18000,,
com.apple.reminders,7,1725029589,1725029596,1725029596.40948,-18000,EB445137-D7F5-57EC-87DA-1DB460D64046,"iPhone13,2"
com.apple.reminders,2,1725029586,1725029588,1725029588.490274,-18000,EB445137-D7F5-57EC-87DA-1DB460D64046,"iPhone13,2"
com.apple.weather,3,1725029583,1725029586,1725029586.6540818,-18000,EB445137-D7F5-57EC-87DA-1DB460D64046,"iPhone13,2"
com.apple.weather,6,1725029576,1725029582,1725029582.218368,-18000,EB445137-D7F5-57EC-87DA-1DB460D64046,"iPhone13,2"
com.apple.weather,3,1725029483,1725029486,1725029486.0656629,-18000,EB445137-D7F5-57EC-87DA-1DB460D64046,"iPhone13,2"
com.apple.weather,7,1725028707,1725028714,1725028714.353724,-18000,EB445137-D7F5-57EC-87DA-1DB460D64046,"iPhone13,2"
com.toyopagroup.picaboo,3,1725028704,1725028707,1725028707.622394,-18000,EB445137-D7F5-57EC-87DA-1DB460D64046,"iPhone13,2"
com.toyopagroup.picaboo,7,1725028388,1725028395,1725028395.040431,-18000,EB445137-D7F5-57EC-87DA-1DB460D64046,"iPhone13,2"
com.google.Chrome,8,1725028364,1725028372,1725028372.341557,-18000,,
com.apple.camera,19,1725028343,1725028362,1725028372.948602,-18000,EB445137-D7F5-57EC-87DA-1DB460D64046,"iPhone13,2"
com.toyopagroup.picaboo,20,1725028342,1725028362,1725028372.9469051,-18000,EB445137-D7F5-57EC-87DA-1DB460D64046,"iPhone13,2"
com.apple.finder,75,1725028289,1725028364,1725028364.858333,-18000,,
com.apple.Preview,3,1725028286,1725028289,1725028289.417831,-18000,,
com.google.Chrome,192,1725028094,1725028286,1725028286.596132,-18000,,
com.apple.finder,67,1725028027,1725028094,1725028094.373262,-18000,,
com.apple.iCal,8,1725028019,1725028027,1725028027.32062,-18000,,
com.toyopagroup.picaboo,1,1725027942,1725027943,1725027943.853718,-18000,EB445137-D7F5-57EC-87DA-1DB460D64046,"iPhone13,2"
com.toyopagroup.picaboo,24,1725027916,1725027940,1725027941.018025,-18000,EB445137-D7F5-57EC-87DA-1DB460D64046,"iPhone13,2"
com.leomehlig.today,182,1725027837,1725028019,1725028019.174273,-18000,,
com.apple.iCal,24,1725027813,1725027837,1725027837.2281132,-18000,,
com.leomehlig.today,36,1725027777,1725027813,1725027813.335863,-18000,,
com.google.Chrome,116,1725027661,1725027777,1725027777.6934772,-18000,,
com.renpho.health,6,1725027528,1725027534,1725027535.034339,-18000,EB445137-D7F5-57EC-87DA-1DB460D64046,"iPhone13,2"
com.renpho.health,5,1725027337,1725027342,1725027342.137342,-18000,EB445137-D7F5-57EC-87DA-1DB460D64046,"iPhone13,2"
com.renpho.health,24,1725026967,1725026991,1725026991.2738872,-18000,EB445137-D7F5-57EC-87DA-1DB460D64046,"iPhone13,2"
com.google.ios.youtube,1199,1725024702,1725025901,1725025901.604275,-18000,EB445137-D7F5-57EC-87DA-1DB460D64046,"iPhone13,2"
com.apple.weather,2,1725024698,1725024700,1725024701.035644,-18000,EB445137-D7F5-57EC-87DA-1DB460D64046,"iPhone13,2"
com.apple.weather,2,1725024649,1725024651,1725024651.4130812,-18000,EB445137-D7F5-57EC-87DA-1DB460D64046,"iPhone13,2"
com.apple.Preferences,14,1725024634,1725024648,1725024648.925336,-18000,EB445137-D7F5-57EC-87DA-1DB460D64046,"iPhone13,2"
com.instructure.icanvas,15,1725024608,1725024623,1725024623.109254,-18000,EB445137-D7F5-57EC-87DA-1DB460D64046,"iPhone13,2"
com.thestorygraph.thestorygraph,33,1724992848,1724992881,1724992881.694387,-18000,EB445137-D7F5-57EC-87DA-1DB460D64046,"iPhone13,2"
com.myfitnesspal.mfp,21,1724990811,1724990832,1724990832.458737,-18000,EB445137-D7F5-57EC-87DA-1DB460D64046,"iPhone13,2"
com.apple.Health,31,1724990777,1724990808,1724990808.525676,-18000,EB445137-D7F5-57EC-87DA-1DB460D64046,"iPhone13,2"
com.apple.news,143,1724990629,1724990772,1724990772.579719,-18000,EB445137-D7F5-57EC-87DA-1DB460D64046,"iPhone13,2"
com.toyopagroup.picaboo,23,1724990595,1724990618,1724990618.083354,-18000,EB445137-D7F5-57EC-87DA-1DB460D64046,"iPhone13,2"
com.thestorygraph.thestorygraph,17,1724990578,1724990595,1724990595.1310592,-18000,EB445137-D7F5-57EC-87DA-1DB460D64046,"iPhone13,2"
com.google.chrome.ios,6,1724990571,1724990577,1724990578.048119,-18000,EB445137-D7F5-57EC-87DA-1DB460D64046,"iPhone13,2"
com.google.chrome.ios,10,1724990391,1724990401,1724990401.343886,-18000,EB445137-D7F5-57EC-87DA-1DB460D64046,"iPhone13,2"
com.google.chrome.ios,13,1724988902,1724988915,1724988915.542201,-18000,EB445137-D7F5-57EC-87DA-1DB460D64046,"iPhone13,2"
com.google.chrome.ios,3,1724988451,1724988454,1724988454.922285,-18000,EB445137-D7F5-57EC-87DA-1DB460D64046,"iPhone13,2"
com.google.chrome.ios,45,1724987606,1724987651,1724987652.031654,-18000,EB445137-D7F5-57EC-87DA-1DB460D64046,"iPhone13,2"
com.toyopagroup.picaboo,27,1724985247,1724985274,1724985274.825028,-18000,EB445137-D7F5-57EC-87DA-1DB460D64046,"iPhone13,2"
com.toyopagroup.picaboo,13,1724985092,1724985105,1724985105.077952,-18000,EB445137-D7F5-57EC-87DA-1DB460D64046,"iPhone13,2"
com.toyopagroup.picaboo,24,1724985058,1724985082,1724985082.190712,-18000,EB445137-D7F5-57EC-87DA-1DB460D64046,"iPhone13,2"
com.toyopagroup.picaboo,16,1724984893,1724984909,1724984909.108177,-18000,EB445137-D7F5-57EC-87DA-1DB460D64046,"iPhone13,2"
com.microsoft.Office.Outlook,5,1724982255,1724982260,1724982260.14418,-18000,EB445137-D7F5-57EC-87DA-1DB460D64046,"iPhone13,2"
com.microsoft.Office.Outlook,15,1724982217,1724982232,1724982232.9777741,-18000,EB445137-D7F5-57EC-87DA-1DB460D64046,"iPhone13,2"
com.microsoft.Office.Outlook,2,1724981818,1724981820,1724981820.504727,-18000,EB445137-D7F5-57EC-87DA-1DB460D64046,"iPhone13,2"
com.microsoft.Office.Outlook,12,1724981200,1724981212,1724981212.445348,-18000,EB445137-D7F5-57EC-87DA-1DB460D64046,"iPhone13,2"
com.instructure.icanvas,4,1724980374,1724980378,1724980378.489043,-18000,EB445137-D7F5-57EC-87DA-1DB460D64046,"iPhone13,2"
com.instructure.icanvas,19,1724979825,1724979844,1724979844.278957,-18000,EB445137-D7F5-57EC-87DA-1DB460D64046,"iPhone13,2"
com.toyopagroup.picaboo,3,1724979818,1724979821,1724979821.886571,-18000,EB445137-D7F5-57EC-87DA-1DB460D64046,"iPhone13,2"
com.toyopagroup.picaboo,4,1724978739,1724978743,1724978743.017568,-18000,EB445137-D7F5-57EC-87DA-1DB460D64046,"iPhone13,2"
com.toyopagroup.picaboo,2,1724978545,1724978547,1724978547.424412,-18000,EB445137-D7F5-57EC-87DA-1DB460D64046,"iPhone13,2"
com.toyopagroup.picaboo,1,1724978389,1724978390,1724978390.968034,-18000,EB445137-D7F5-57EC-87DA-1DB460D64046,"iPhone13,2"
com.toyopagroup.picaboo,2,1724978170,1724978172,1724978172.699459,-18000,EB445137-D7F5-57EC-87DA-1DB460D64046,"iPhone13,2"
com.toyopagroup.picaboo,2,1724977978,1724977980,1724977980.60458,-18000,EB445137-D7F5-57EC-87DA-1DB460D64046,"iPhone13,2"
com.toyopagroup.picaboo,2,1724977867,1724977869,1724977869.621309,-18000,EB445137-D7F5-57EC-87DA-1DB460D64046,"iPhone13,2"
com.toyopagroup.picaboo,2,1724977788,1724977790,1724977790.718789,-18000,EB445137-D7F5-57EC-87DA-1DB460D64046,"iPhone13,2"
com.toyopagroup.picaboo,5,1724977715,1724977720,1724977720.2382278,-18000,EB445137-D7F5-57EC-87DA-1DB460D64046,"iPhone13,2"
com.toyopagroup.picaboo,3,1724977711,1724977714,1724977714.151434,-18000,EB445137-D7F5-57EC-87DA-1DB460D64046,"iPhone13,2"
com.toyopagroup.picaboo,3,1724977531,1724977534,1724977534.554216,-18000,EB445137-D7F5-57EC-87DA-1DB460D64046,"iPhone13,2"
com.toyopagroup.picaboo,39,1724977424,1724977463,1724977463.592474,-18000,EB445137-D7F5-57EC-87DA-1DB460D64046,"iPhone13,2"
com.toyopagroup.picaboo,5,1724976972,1724976977,1724976977.4400768,-18000,EB445137-D7F5-57EC-87DA-1DB460D64046,"iPhone13,2"
com.toyopagroup.picaboo,38,1724976628,1724976666,1724976666.6108298,-18000,EB445137-D7F5-57EC-87DA-1DB460D64046,"iPhone13,2"
com.google.chrome.ios,3,1724976520,1724976523,1724976523.286556,-18000,EB445137-D7F5-57EC-87DA-1DB460D64046,"iPhone13,2"
com.google.chrome.ios,2,1724976516,1724976518,1724976518.470979,-18000,EB445137-D7F5-57EC-87DA-1DB460D64046,"iPhone13,2"
com.google.chrome.ios,6,1724976509,1724976515,1724976515.503798,-18000,EB445137-D7F5-57EC-87DA-1DB460D64046,"iPhone13,2"
com.google.chrome.ios,3,1724976505,1724976508,1724976508.105027,-18000,EB445137-D7F5-57EC-87DA-1DB460D64046,"iPhone13,2"
com.google.chrome.ios,8,1724976497,1724976505,1724976505.0101361,-18000,EB445137-D7F5-57EC-87DA-1DB460D64046,"iPhone13,2"
com.google.chrome.ios,3,1724976488,1724976491,1724976491.085609,-18000,EB445137-D7F5-57EC-87DA-1DB460D64046,"iPhone13,2"
com.google.chrome.ios,89,1724975122,1724975211,1724975211.7672648,-18000,EB445137-D7F5-57EC-87DA-1DB460D64046,"iPhone13,2"
com.google.chrome.ios,3,1724975107,1724975110,1724975110.353499,-18000,EB445137-D7F5-57EC-87DA-1DB460D64046,"iPhone13,2"
com.google.chrome.ios,58,1724974937,1724974995,1724974995.380022,-18000,EB445137-D7F5-57EC-87DA-1DB460D64046,"iPhone13,2"
com.google.chrome.ios,20,1724974891,1724974911,1724974911.910822,-18000,EB445137-D7F5-57EC-87DA-1DB460D64046,"iPhone13,2"
com.apple.mobilenotes,8,1724974883,1724974891,1724974891.541978,-18000,EB445137-D7F5-57EC-87DA-1DB460D64046,"iPhone13,2"
com.google.chrome.ios,4,1724974879,1724974883,1724974883.7004151,-18000,EB445137-D7F5-57EC-87DA-1DB460D64046,"iPhone13,2"
com.apple.mobilenotes,41,1724974838,1724974879,1724974879.180859,-18000,EB445137-D7F5-57EC-87DA-1DB460D64046,"iPhone13,2"
com.google.chrome.ios,68,1724974770,1724974838,1724974838.660327,-18000,EB445137-D7F5-57EC-87DA-1DB460D64046,"iPhone13,2"
com.google.chrome.ios,17,1724974717,1724974734,1724974734.868287,-18000,EB445137-D7F5-57EC-87DA-1DB460D64046,"iPhone13,2"
com.apple.mobilenotes,4,1724974713,1724974717,1724974717.1377602,-18000,EB445137-D7F5-57EC-87DA-1DB460D64046,"iPhone13,2"
com.google.chrome.ios,74,1724974639,1724974713,1724974713.269212,-18000,EB445137-D7F5-57EC-87DA-1DB460D64046,"iPhone13,2"
com.apple.mobilenotes,23,1724974616,1724974639,1724974639.255564,-18000,EB445137-D7F5-57EC-87DA-1DB460D64046,"iPhone13,2"
com.apple.mobileslideshow,39,1724974577,1724974616,1724974616.736727,-18000,EB445137-D7F5-57EC-87DA-1DB460D64046,"iPhone13,2"
com.apple.mobilenotes,70,1724974505,1724974575,1724974575.293649,-18000,EB445137-D7F5-57EC-87DA-1DB460D64046,"iPhone13,2"
com.apple.news,444,1724973982,1724974426,1724974426.814147,-18000,EB445137-D7F5-57EC-87DA-1DB460D64046,"iPhone13,2"
com.toyopagroup.picaboo,53,1724973924,1724973977,1724973977.832726,-18000,EB445137-D7F5-57EC-87DA-1DB460D64046,"iPhone13,2"
com.apple.news,9,1724973910,1724973919,1724973919.917707,-18000,EB445137-D7F5-57EC-87DA-1DB460D64046,"iPhone13,2"
com.myfitnesspal.mfp,55,1724973837,1724973892,1724973892.7473469,-18000,EB445137-D7F5-57EC-87DA-1DB460D64046,"iPhone13,2"
com.google.chrome.ios,32,1724973805,1724973837,1724973838.216713,-18000,EB445137-D7F5-57EC-87DA-1DB460D64046,"iPhone13,2"
com.myfitnesspal.mfp,68,1724973737,1724973805,1724973805.6151152,-18000,EB445137-D7F5-57EC-87DA-1DB460D64046,"iPhone13,2"
com.instructure.icanvas,37,1724973700,1724973737,1724973737.347276,-18000,EB445137-D7F5-57EC-87DA-1DB460D64046,"iPhone13,2"
com.myfitnesspal.mfp,7,1724973693,1724973700,1724973701.020485,-18000,EB445137-D7F5-57EC-87DA-1DB460D64046,"iPhone13,2"
com.myfitnesspal.mfp,6,1724973669,1724973675,1724973675.3494592,-18000,EB445137-D7F5-57EC-87DA-1DB460D64046,"iPhone13,2"
com.myfitnesspal.mfp,65,1724973595,1724973660,1724973661.037791,-18000,EB445137-D7F5-57EC-87DA-1DB460D64046,"iPhone13,2"
com.myfitnesspal.mfp,84,1724973506,1724973590,1724973590.5153198,-18000,EB445137-D7F5-57EC-87DA-1DB460D64046,"iPhone13,2"
com.apple.news,2,1724973492,1724973494,1724973494.651025,-18000,EB445137-D7F5-57EC-87DA-1DB460D64046,"iPhone13,2"
com.amazon.Amazon,35,1724973455,1724973490,1724973491.388324,-18000,EB445137-D7F5-57EC-87DA-1DB460D64046,"iPhone13,2"
com.truebill.truebillnative,54,1724973400,1724973454,1724973454.516914,-18000,EB445137-D7F5-57EC-87DA-1DB460D64046,"iPhone13,2"
com.myfitnesspal.mfp,39,1724973314,1724973353,1724973353.362599,-18000,EB445137-D7F5-57EC-87DA-1DB460D64046,"iPhone13,2"
com.toyopagroup.picaboo,18,1724973294,1724973312,1724973312.472534,-18000,EB445137-D7F5-57EC-87DA-1DB460D64046,"iPhone13,2"
com.myfitnesspal.mfp,3,1724973291,1724973294,1724973295.270146,-18000,EB445137-D7F5-57EC-87DA-1DB460D64046,"iPhone13,2"
com.myfitnesspal.mfp,6,1724973009,1724973015,1724973015.575418,-18000,EB445137-D7F5-57EC-87DA-1DB460D64046,"iPhone13,2"
com.myfitnesspal.mfp,3,1724973005,1724973008,1724973008.773446,-18000,EB445137-D7F5-57EC-87DA-1DB460D64046,"iPhone13,2"
com.myfitnesspal.mfp,68,1724972935,1724973003,1724973003.840256,-18000,EB445137-D7F5-57EC-87DA-1DB460D64046,"iPhone13,2"
com.google.Chrome,713,1724970854,1724971567,1724971567.5527759,-18000,,
com.apple.news,204,1724970254,1724970458,1724970458.7785249,-18000,EB445137-D7F5-57EC-87DA-1DB460D64046,"iPhone13,2"
com.hammerandchisel.discord,82,1724970124,1724970206,1724970206.354927,-18000,EB445137-D7F5-57EC-87DA-1DB460D64046,"iPhone13,2"
com.instructure.icanvas,4,1724970120,1724970124,1724970124.299903,-18000,EB445137-D7F5-57EC-87DA-1DB460D64046,"iPhone13,2"
com.google.Chrome,308,1724970093,1724970401,1724970401.695477,-18000,,
com.leomehlig.today,72,1724970021,1724970093,1724970093.718287,-18000,,
com.google.Chrome,135,1724969886,1724970021,1724970021.341144,-18000,,
com.leomehlig.today,17,1724969869,1724969886,1724969886.288002,-18000,,
com.google.Chrome,8,1724969861,1724969869,1724969869.7783098,-18000,,
com.leomehlig.today,5,1724969856,1724969861,1724969861.5611382,-18000,,
com.instructure.icanvas,116,1724969613,1724969729,1724969729.999126,-18000,EB445137-D7F5-57EC-87DA-1DB460D64046,"iPhone13,2"
com.google.Chrome,319,1724969537,1724969856,1724969856.6626759,-18000,,
com.leomehlig.today,6,1724969531,1724969537,1724969537.0621219,-18000,,
com.toyopagroup.picaboo,5,1724969507,1724969512,1724969512.467454,-18000,EB445137-D7F5-57EC-87DA-1DB460D64046,"iPhone13,2"
com.toyopagroup.picaboo,40,1724969456,1724969496,1724969496.378461,-18000,EB445137-D7F5-57EC-87DA-1DB460D64046,"iPhone13,2"
com.apple.Preview,112,1724969419,1724969531,1724969531.648999,-18000,,
com.google.Chrome,249,1724969170,1724969419,1724969419.4512172,-18000,,
com.intsig.CamScannerLite,570,1724968883,1724969453,1724969453.4427319,-18000,EB445137-D7F5-57EC-87DA-1DB460D64046,"iPhone13,2"
com.google.Chrome,303,1724968865,1724969168,1724969168.443548,-18000,,
com.google.Chrome,455,1724968360,1724968815,1724968815.876117,-18000,,
com.leomehlig.today,43,1724968317,1724968360,1724968360.252455,-18000,,
com.intsig.CamScannerLite,85,1724968220,1724968305,1724968305.5477219,-18000,EB445137-D7F5-57EC-87DA-1DB460D64046,"iPhone13,2"
com.google.Chrome,242,1724968075,1724968317,1724968317.921078,-18000,,
com.apple.finder,44,1724967541,1724967585,1724967585.900729,-18000,,
com.google.Gmail,10,1724966351,1724966361,1724966361.3752189,-18000,EB445137-D7F5-57EC-87DA-1DB460D64046,"iPhone13,2"
com.instructure.icanvas,3,1724966348,1724966351,1724966351.7281551,-18000,EB445137-D7F5-57EC-87DA-1DB460D64046,"iPhone13,2"
com.apple.finder,7,1724966319,1724966326,1724966327.0358481,-18000,,
com.apple.Terminal,6,1724966313,1724966319,1724966319.9276838,-18000,,
com.apple.finder,7,1724966306,1724966313,1724966313.2914062,-18000,,
com.google.Chrome,63,1724966243,1724966306,1724966307.681594,-18000,,
com.apple.TextEdit,194,1724966049,1724966243,1724966243.205827,-18000,,
com.apple.finder,1,1724966048,1724966049,1724966049.3902612,-18000,,
com.apple.TextEdit,6,1724966042,1724966048,1724966049.012288,-18000,,
com.apple.finder,1,1724966041,1724966042,1724966042.161228,-18000,,
com.apple.Terminal,41,1724966000,1724966041,1724966041.934864,-18000,,
com.apple.TextEdit,8,1724965992,1724966000,1724966000.164809,-18000,,
com.apple.finder,1,1724965991,1724965992,1724965992.143224,-18000,,
com.apple.Terminal,16,1724965975,1724965991,1724965991.814265,-18000,,
com.apple.finder,1,1724965974,1724965975,1724965975.661632,-18000,,
com.google.Chrome,4,1724965970,1724965974,1724965974.2311769,-18000,,
com.apple.finder,12,1724965958,1724965970,1724965970.1226048,-18000,,
com.apple.Terminal,49,1724965909,1724965958,1724965958.8984718,-18000,,
com.google.Chrome,7,1724965902,1724965909,1724965909.84186,-18000,,
com.apple.TextEdit,3,1724965899,1724965902,1724965902.268575,-18000,,
com.apple.finder,7,1724965892,1724965899,1724965900.00458,-18000,,
com.google.Chrome,30,1724965862,1724965892,1724965892.309753,-18000,,
com.apple.Terminal,3,1724965859,1724965862,1724965862.963481,-18000,,
com.google.Chrome,35,1724965824,1724965859,1724965859.058893,-18000,,
com.microsoft.VSCode,5,1724965819,1724965824,1724965824.1583219,-18000,,
com.google.Chrome,373,1724965446,1724965819,1724965819.32834,-18000,,
com.microsoft.VSCode,47,1724965399,1724965446,1724965446.1515632,-18000,,
com.google.Chrome,107,1724965292,1724965399,1724965399.691949,-18000,,
com.microsoft.VSCode,13,1724965279,1724965292,1724965292.863604,-18000,,
com.google.Chrome,7,1724965272,1724965279,1724965280.018693,-18000,,
com.microsoft.VSCode,32,1724965240,1724965272,1724965272.103137,-18000,,
com.google.Chrome,30,1724965210,1724965240,1724965240.451132,-18000,,
com.microsoft.VSCode,3,1724965207,1724965210,1724965210.969384,-18000,,
com.google.Chrome,21,1724965186,1724965207,1724965207.0675821,-18000,,
com.microsoft.VSCode,0,1724965186,1724965186,1724965186.5217562,-18000,,
com.google.Chrome,15,1724965171,1724965186,1724965186.171036,-18000,,
com.microsoft.VSCode,16,1724965155,1724965171,1724965171.702472,-18000,,
com.google.Chrome,7,1724965148,1724965155,1724965155.753955,-18000,,
com.microsoft.VSCode,2,1724965146,1724965148,1724965148.2469049,-18000,,
com.google.Chrome,1,1724965145,1724965146,1724965146.847608,-18000,,
com.microsoft.VSCode,8,1724965137,1724965145,1724965145.616456,-18000,,
com.google.Chrome,2,1724965135,1724965137,1724965137.164352,-18000,,
com.microsoft.VSCode,1,1724965134,1724965135,1724965135.731381,-18000,,
com.google.Chrome,2,1724965132,1724965134,1724965134.753669,-18000,,
com.microsoft.VSCode,7,1724965125,1724965132,1724965132.619897,-18000,,
com.google.Chrome,13,1724965112,1724965125,1724965126.00794,-18000,,
com.microsoft.VSCode,9,1724965103,1724965112,1724965112.651568,-18000,,
com.google.Chrome,3,1724965100,1724965103,1724965103.8274121,-18000,,
com.microsoft.VSCode,3,1724965097,1724965100,1724965100.212981,-18000,,
com.google.Chrome,1,1724965096,1724965097,1724965097.6056151,-18000,,
com.microsoft.VSCode,2,1724965094,1724965096,1724965096.879465,-18000,,
com.google.Chrome,3,1724965091,1724965094,1724965094.8779778,-18000,,
com.microsoft.VSCode,1,1724965090,1724965091,1724965091.614389,-18000,,
com.google.Chrome,21,1724965069,1724965090,1724965090.837976,-18000,,
com.microsoft.VSCode,27,1724965042,1724965069,1724965069.768172,-18000,,
com.google.Chrome,1,1724965041,1724965042,1724965043.023569,-18000,,
com.apple.Terminal,9,1724965032,1724965041,1724965041.990443,-18000,,
com.google.Chrome,3,1724965029,1724965032,1724965032.992348,-18000,,
com.microsoft.VSCode,4,1724965025,1724965029,1724965029.84418,-18000,,
com.google.Chrome,2,1724965023,1724965025,1724965025.9566631,-18000,,
com.microsoft.VSCode,4,1724965019,1724965023,1724965023.6633701,-18000,,
com.google.Chrome,1,1724965018,1724965019,1724965019.649901,-18000,,
com.apple.Terminal,9,1724965009,1724965018,1724965018.79984,-18000,,
com.google.Chrome,2,1724965007,1724965009,1724965009.775669,-18000,,
com.microsoft.VSCode,8,1724964999,1724965007,1724965007.440413,-18000,,
com.google.Chrome,3,1724964996,1724964999,1724964999.778204,-18000,,
com.microsoft.VSCode,0,1724964996,1724964996,1724964996.621084,-18000,,
com.apple.Terminal,1,1724964995,1724964996,1724964996.089169,-18000,,
com.microsoft.VSCode,7,1724964988,1724964995,1724964995.336015,-18000,,
com.apple.Terminal,1,1724964987,1724964988,1724964988.287051,-18000,,
com.google.Chrome,5,1724964982,1724964987,1724964987.319107,-18000,,
com.apple.Terminal,27,1724964955,1724964982,1724964982.217,-18000,,
com.google.Chrome,17,1724964938,1724964955,1724964955.641206,-18000,,
com.microsoft.VSCode,2,1724964936,1724964938,1724964938.819561,-18000,,
com.google.Chrome,2,1724964934,1724964936,1724964936.939056,-18000,,
com.microsoft.VSCode,4,1724964930,1724964934,1724964934.720803,-18000,,
com.google.Chrome,7,1724964923,1724964930,1724964930.1017709,-18000,,
com.microsoft.VSCode,5,1724964918,1724964923,1724964923.695253,-18000,,
com.google.Chrome,3,1724964915,1724964918,1724964918.5240688,-18000,,
com.microsoft.VSCode,3,1724964912,1724964915,1724964915.934657,-18000,,
com.google.Chrome,6,1724964906,1724964912,1724964912.963646,-18000,,
com.microsoft.VSCode,3,1724964903,1724964906,1724964906.3136292,-18000,,
com.google.Chrome,2,1724964901,1724964903,1724964903.56145,-18000,,
com.microsoft.VSCode,4,1724964897,1724964901,1724964901.0829558,-18000,,
com.google.Chrome,32,1724964865,1724964897,1724964897.892949,-18000,,
com.apple.finder,14,1724964851,1724964865,1724964865.449411,-18000,,
com.microsoft.VSCode,20,1724964831,1724964851,1724964851.9353352,-18000,,
com.apple.finder,14,1724964817,1724964831,1724964831.256298,-18000,,
com.microsoft.VSCode,40,1724964777,1724964817,1724964817.631847,-18000,,
com.google.Chrome,22,1724964755,1724964777,1724964777.700966,-18000,,
com.microsoft.VSCode,6,1724964749,1724964755,1724964755.467107,-18000,,
com.google.Chrome,17,1724964732,1724964749,1724964749.724817,-18000,,
com.apple.Terminal,1,1724964731,1724964732,1724964732.58477,-18000,,
com.microsoft.VSCode,2,1724964729,1724964731,1724964731.435408,-18000,,
com.apple.Terminal,14,1724964715,1724964729,1724964729.4099889,-18000,,
com.microsoft.VSCode,6,1724964709,1724964715,1724964715.065119,-18000,,
com.google.Chrome,1,1724964708,1724964709,1724964709.428649,-18000,,
com.microsoft.VSCode,2,1724964706,1724964708,1724964708.488064,-18000,,
com.google.Chrome,3,1724964703,1724964706,1724964706.600373,-18000,,
com.microsoft.VSCode,14,1724964689,1724964703,1724964703.822744,-18000,,
com.google.Chrome,19,1724964670,1724964689,1724964689.826964,-18000,,
com.microsoft.VSCode,0,1724964670,1724964670,1724964670.435338,-18000,,
com.google.Chrome,222,1724964448,1724964670,1724964670.4073849,-18000,,
com.apple.Terminal,6,1724964442,1724964448,1724964448.793711,-18000,,
com.google.Chrome,5,1724964437,1724964442,1724964442.3316789,-18000,,
com.apple.Terminal,7,1724964430,1724964437,1724964437.5820699,-18000,,
com.google.Chrome,38,1724964392,1724964430,1724964430.6199431,-18000,,
com.google.Chrome,330,1724963976,1724964306,1724964306.542338,-18000,,
com.google.Chrome,456,1724963289,1724963745,1724963745.42445,-18000,,
com.apple.finder,3,1724963286,1724963289,1724963289.956387,-18000,,
com.apple.Preview,3,1724963283,1724963286,1724963286.92746,-18000,,
com.apple.finder,6,1724963277,1724963283,1724963283.199967,-18000,,
com.apple.Terminal,13,1724963264,1724963277,1724963277.10469,-18000,,
com.instructure.icanvas,2,1724963206,1724963208,1724963208.7821531,-18000,EB445137-D7F5-57EC-87DA-1DB460D64046,"iPhone13,2"
com.google.Chrome,81,1724963183,1724963264,1724963264.313573,-18000,,
com.instructure.icanvas,2,1724962816,1724962818,1724962818.621872,-18000,EB445137-D7F5-57EC-87DA-1DB460D64046,"iPhone13,2"
com.instructure.icanvas,284,1724962142,1724962426,1724962426.126697,-18000,EB445137-D7F5-57EC-87DA-1DB460D64046,"iPhone13,2"
com.instructure.icanvas,96,1724961945,1724962041,1724962041.1132069,-18000,EB445137-D7F5-57EC-87DA-1DB460D64046,"iPhone13,2"
com.instructure.icanvas,66,1724961878,1724961944,1724961944.8239841,-18000,EB445137-D7F5-57EC-87DA-1DB460D64046,"iPhone13,2"
com.microsoft.Office.Outlook,2,1724961876,1724961878,1724961879.017226,-18000,EB445137-D7F5-57EC-87DA-1DB460D64046,"iPhone13,2"
com.microsoft.Office.Outlook,13,1724961710,1724961723,1724961723.9039922,-18000,EB445137-D7F5-57EC-87DA-1DB460D64046,"iPhone13,2"
com.microsoft.Office.Outlook,9,1724961482,1724961491,1724961491.357017,-18000,EB445137-D7F5-57EC-87DA-1DB460D64046,"iPhone13,2"
com.instructure.icanvas,7,1724961475,1724961482,1724961482.759835,-18000,EB445137-D7F5-57EC-87DA-1DB460D64046,"iPhone13,2"
com.instructure.icanvas,100,1724961323,1724961423,1724961423.369319,-18000,EB445137-D7F5-57EC-87DA-1DB460D64046,"iPhone13,2"
com.instructure.icanvas,110,1724961178,1724961288,1724961288.563983,-18000,EB445137-D7F5-57EC-87DA-1DB460D64046,"iPhone13,2"
com.instructure.icanvas,61,1724960848,1724960909,1724960909.623616,-18000,EB445137-D7F5-57EC-87DA-1DB460D64046,"iPhone13,2"
com.google.chrome.ios,3,1724960845,1724960848,1724960848.934,-18000,EB445137-D7F5-57EC-87DA-1DB460D64046,"iPhone13,2"
com.google.chrome.ios,62,1724960715,1724960777,1724960777.397152,-18000,EB445137-D7F5-57EC-87DA-1DB460D64046,"iPhone13,2"
com.google.chrome.ios,114,1724960592,1724960706,1724960706.187492,-18000,EB445137-D7F5-57EC-87DA-1DB460D64046,"iPhone13,2"
com.instructure.icanvas,3,1724960589,1724960592,1724960592.77823,-18000,EB445137-D7F5-57EC-87DA-1DB460D64046,"iPhone13,2"
com.instructure.icanvas,256,1724960267,1724960523,1724960523.3459148,-18000,EB445137-D7F5-57EC-87DA-1DB460D64046,"iPhone13,2"
com.instructure.icanvas,111,1724960100,1724960211,1724960211.9248,-18000,EB445137-D7F5-57EC-87DA-1DB460D64046,"iPhone13,2"
com.apple.news,2,1724960097,1724960099,1724960099.751648,-18000,EB445137-D7F5-57EC-87DA-1DB460D64046,"iPhone13,2"
com.apple.news,1,1724954375,1724954376,1724954376.775607,-18000,EB445137-D7F5-57EC-87DA-1DB460D64046,"iPhone13,2"
com.apple.news,162,1724954153,1724954315,1724954316.067071,-18000,EB445137-D7F5-57EC-87DA-1DB460D64046,"iPhone13,2"
com.toyopagroup.picaboo,29,1724953370,1724953399,1724953399.3341498,-18000,EB445137-D7F5-57EC-87DA-1DB460D64046,"iPhone13,2"
com.google.ios.youtube,3,1724953364,1724953367,1724953367.341269,-18000,EB445137-D7F5-57EC-87DA-1DB460D64046,"iPhone13,2"
com.google.ios.youtube,216,1724952354,1724952570,1724952570.579525,-18000,EB445137-D7F5-57EC-87DA-1DB460D64046,"iPhone13,2"
com.apple.news,403,1724951948,1724952351,1724952351.9008899,-18000,EB445137-D7F5-57EC-87DA-1DB460D64046,"iPhone13,2"
com.myfitnesspal.mfp,83,1724951852,1724951935,1724951935.878736,-18000,EB445137-D7F5-57EC-87DA-1DB460D64046,"iPhone13,2"
com.google.Gmail,4,1724951812,1724951816,1724951816.521923,-18000,EB445137-D7F5-57EC-87DA-1DB460D64046,"iPhone13,2"
com.google.Gmail,19,1724951742,1724951761,1724951761.81569,-18000,EB445137-D7F5-57EC-87DA-1DB460D64046,"iPhone13,2"
com.google.chrome.ios,37,1724950152,1724950189,1724950189.772363,-18000,EB445137-D7F5-57EC-87DA-1DB460D64046,"iPhone13,2"
com.microsoft.Office.Outlook,24,1724950128,1724950152,1724950152.213104,-18000,EB445137-D7F5-57EC-87DA-1DB460D64046,"iPhone13,2"
com.apple.mobilecal,12,1724950116,1724950128,1724950128.8899431,-18000,EB445137-D7F5-57EC-87DA-1DB460D64046,"iPhone13,2"
com.google.Chrome,1308,1724948791,1724950099,1724950099.603327,-18000,,
com.google.Chrome,312,1724948476,1724948788,1724948788.8613539,-18000,,
com.apple.Preview,33,1724948443,1724948476,1724948476.843597,-18000,,
com.google.Chrome,99,1724948344,1724948443,1724948444.008498,-18000,,
com.apple.Preview,1,1724948343,1724948344,1724948344.1905499,-18000,,
com.google.Chrome,194,1724948149,1724948343,1724948343.7659779,-18000,,
com.apple.Preview,78,1724947419,1724947497,1724947497.152822,-18000,,
com.apple.finder,8,1724947411,1724947419,1724947419.989057,-18000,,
com.google.Chrome,154,1724947257,1724947411,1724947411.214632,-18000,,
com.google.Chrome,44,1724947078,1724947122,1724947122.4597769,-18000,,
com.apple.Terminal,2,1724947076,1724947078,1724947078.606643,-18000,,
com.apple.mobilecal,3,1724946974,1724946977,1724946977.956954,-18000,EB445137-D7F5-57EC-87DA-1DB460D64046,"iPhone13,2"
com.apple.news,3,1724946710,1724946713,1724946713.501749,-18000,EB445137-D7F5-57EC-87DA-1DB460D64046,"iPhone13,2"
com.apple.news,2,1724946707,1724946709,1724946709.8809052,-18000,EB445137-D7F5-57EC-87DA-1DB460D64046,"iPhone13,2"
com.apple.Terminal,25,1724946527,1724946552,1724946552.5653381,-18000,,
com.google.Chrome,10,1724946517,1724946527,1724946527.8233352,-18000,,
com.apple.Terminal,20,1724946497,1724946517,1724946517.036707,-18000,,
com.google.Chrome,6,1724946491,1724946497,1724946497.7418041,-18000,,
com.apple.Terminal,35,1724946456,1724946491,1724946491.105202,-18000,,
com.apple.TextEdit,2,1724946454,1724946456,1724946456.979815,-18000,,
com.google.Chrome,3,1724946451,1724946454,1724946454.213602,-18000,,
com.apple.TextEdit,15,1724946436,1724946451,1724946451.590962,-18000,,
com.apple.finder,2,1724946434,1724946436,1724946436.558461,-18000,,
com.apple.Terminal,17,1724946417,1724946434,1724946434.330216,-18000,,
com.apple.TextEdit,12,1724946405,1724946417,1724946417.691261,-18000,,
com.apple.finder,0,1724946405,1724946405,1724946406.065342,-18000,,
com.apple.Terminal,10,1724946395,1724946405,1724946405.721569,-18000,,
com.apple.TextEdit,3,1724946392,1724946395,1724946395.517263,-18000,,
com.apple.finder,0,1724946392,1724946392,1724946392.480293,-18000,,
com.apple.TextEdit,10,1724946382,1724946392,1724946392.118266,-18000,,
com.apple.finder,0,1724946382,1724946382,1724946382.907953,-18000,,
com.apple.Terminal,9,1724946373,1724946382,1724946382.638222,-18000,,
com.apple.TextEdit,11,1724946362,1724946373,1724946373.042896,-18000,,
com.apple.finder,1,1724946361,1724946362,1724946362.565861,-18000,,
com.apple.Terminal,12,1724946349,1724946361,1724946361.769736,-18000,,
com.apple.TextEdit,8,1724946341,1724946349,1724946349.883436,-18000,,
com.apple.finder,0,1724946341,1724946341,1724946341.4953089,-18000,,
com.apple.Terminal,118,1724946223,1724946341,1724946341.2008882,-18000,,
com.apple.finder,8,1724946215,1724946223,1724946223.835747,-18000,,
com.apple.Terminal,2,1724946213,1724946215,1724946215.766233,-18000,,
com.google.Chrome,2,1724946211,1724946213,1724946214.016378,-18000,,
com.apple.Terminal,3,1724946208,1724946211,1724946211.867085,-18000,,
com.apple.finder,19,1724946189,1724946208,1724946208.733138,-18000,,
com.apple.Terminal,5,1724946184,1724946189,1724946189.298804,-18000,,
com.apple.finder,5,1724946179,1724946184,1724946184.63173,-18000,,
com.apple.Terminal,117,1724946062,1724946179,1724946179.555571,-18000,,
com.apple.TextEdit,5,1724946057,1724946062,1724946062.328356,-18000,,
com.google.Chrome,1,1724946056,1724946057,1724946057.408952,-18000,,
com.apple.TextEdit,4,1724946052,1724946056,1724946056.580173,-18000,,
com.apple.finder,3,1724946049,1724946052,1724946052.712805,-18000,,
com.apple.Terminal,99,1724945950,1724946049,1724946049.113023,-18000,,
com.google.Chrome,6,1724945944,1724945950,1724945950.590868,-18000,,
com.apple.Terminal,48,1724945896,1724945944,1724945944.183115,-18000,,
com.google.Chrome,5,1724945891,1724945896,1724945896.442641,-18000,,
com.apple.Terminal,1,1724945890,1724945891,1724945891.420878,-18000,,
com.apple.finder,8,1724945882,1724945890,1724945890.664692,-18000,,
com.apple.Terminal,51,1724945831,1724945882,1724945882.514958,-18000,,
com.apple.TextEdit,10,1724945821,1724945831,1724945831.8453689,-18000,,
com.apple.finder,9,1724945812,1724945821,1724945821.184751,-18000,,
com.apple.Terminal,23,1724945789,1724945812,1724945812.1818419,-18000,,
com.apple.TextEdit,38,1724945751,1724945789,1724945789.4180841,-18000,,
com.apple.finder,9,1724945742,1724945751,1724945751.722005,-18000,,
com.apple.Terminal,10,1724945732,1724945742,1724945742.331778,-18000,,
com.apple.finder,3,1724945729,1724945732,1724945732.0900378,-18000,,
com.apple.Terminal,20,1724945709,1724945729,1724945729.933492,-18000,,
com.apple.finder,1,1724945708,1724945709,1724945710.004674,-18000,,
com.apple.Terminal,9,1724945699,1724945708,1724945708.393023,-18000,,
com.apple.finder,2,1724945697,1724945699,1724945699.695324,-18000,,
com.apple.Terminal,8,1724945689,1724945697,1724945697.926944,-18000,,
com.apple.finder,14,1724945675,1724945689,1724945689.3260942,-18000,,
com.apple.Terminal,17,1724945658,1724945675,1724945675.165664,-18000,,
com.google.Chrome,6,1724945652,1724945658,1724945658.31785,-18000,,
com.apple.Terminal,23,1724945629,1724945652,1724945652.284369,-18000,,
com.apple.finder,7,1724945622,1724945629,1724945629.781317,-18000,,
com.apple.Terminal,27,1724945595,1724945622,1724945622.8048282,-18000,,
com.google.Chrome,3,1724945592,1724945595,1724945595.062176,-18000,,
com.apple.Terminal,59,1724945533,1724945592,1724945593.036819,-18000,,
com.google.Chrome,93,1724945440,1724945533,1724945533.5482259,-18000,,
com.apple.Terminal,62,1724945378,1724945440,1724945440.485026,-18000,,
com.apple.finder,12,1724945366,1724945378,1724945379.044425,-18000,,
com.google.Chrome,10,1724945356,1724945366,1724945366.08572,-18000,,
com.apple.finder,3,1724945353,1724945356,1724945356.0935168,-18000,,
com.apple.Terminal,32,1724945321,1724945353,1724945353.737362,-18000,,
com.apple.finder,23,1724945298,1724945321,1724945321.2339349,-18000,,
com.apple.TextEdit,2,1724945296,1724945298,1724945298.6156402,-18000,,
com.apple.finder,2,1724945294,1724945296,1724945297.0263171,-18000,,
com.apple.Terminal,107,1724945187,1724945294,1724945294.5720081,-18000,,
com.google.Chrome,1,1724945186,1724945187,1724945187.469523,-18000,,
com.apple.Terminal,17,1724945169,1724945186,1724945186.731481,-18000,,
com.google.Chrome,3,1724945166,1724945169,1724945169.38891,-18000,,
com.apple.Terminal,91,1724945075,1724945166,1724945166.6599422,-18000,,
com.apple.finder,1,1724945074,1724945075,1724945075.671578,-18000,,
com.apple.Terminal,13,1724945061,1724945074,1724945074.796856,-18000,,
com.google.Chrome,2,1724945059,1724945061,1724945061.941318,-18000,,
com.apple.Terminal,13,1724945046,1724945059,1724945059.9028249,-18000,,
com.google.Chrome,37,1724945009,1724945046,1724945046.505722,-18000,,
com.apple.Terminal,24,1724944985,1724945009,1724945009.62239,-18000,,
com.google.Chrome,7,1724944978,1724944985,1724944985.8772469,-18000,,
com.apple.Terminal,2,1724944976,1724944978,1724944978.19384,-18000,,
com.google.Chrome,4,1724944972,1724944976,1724944976.425496,-18000,,
com.apple.Terminal,6,1724944966,1724944972,1724944972.208809,-18000,,
com.apple.finder,3,1724944963,1724944966,1724944966.3961391,-18000,,
com.google.Chrome,6,1724944957,1724944963,1724944963.212875,-18000,,
com.apple.finder,25,1724944932,1724944957,1724944957.652031,-18000,,
com.apple.Terminal,5,1724944927,1724944932,1724944932.648941,-18000,,
com.google.Chrome,23,1724944904,1724944927,1724944927.150301,-18000,,
com.apple.finder,1,1724944903,1724944904,1724944904.9126348,-18000,,
com.google.Chrome,2,1724944901,1724944903,1724944903.625873,-18000,,
com.apple.finder,26,1724944875,1724944901,1724944901.763735,-18000,,
com.apple.Terminal,120,1724944755,1724944875,1724944875.6608582,-18000,,
com.apple.finder,3,1724944752,1724944755,1724944755.899365,-18000,,
com.apple.Terminal,27,1724944725,1724944752,1724944752.2148008,-18000,,
com.google.Chrome,1,1724944724,1724944725,1724944725.975146,-18000,,
com.apple.Terminal,2,1724944722,1724944724,1724944725.008584,-18000,,
com.google.Chrome,0,1724944722,1724944722,1724944722.858542,-18000,,
com.apple.Terminal,1,1724944721,1724944722,1724944722.275426,-18000,,
com.apple.finder,1,1724944720,1724944721,1724944721.305758,-18000,,
com.apple.Terminal,1,1724944719,1724944720,1724944720.490422,-18000,,
com.google.Chrome,2,1724944717,1724944719,1724944719.6798801,-18000,,
com.apple.Terminal,10,1724944707,1724944717,1724944717.8197079,-18000,,
com.google.Chrome,12,1724944695,1724944707,1724944707.146992,-18000,,
com.apple.finder,2,1724944693,1724944695,1724944695.2254229,-18000,,
com.google.Chrome,1,1724944692,1724944693,1724944693.818603,-18000,,
com.apple.finder,12,1724944680,1724944692,1724944692.8390841,-18000,,
com.apple.Terminal,72,1724944608,1724944680,1724944680.209297,-18000,,
com.google.Chrome,176,1724944432,1724944608,1724944608.6450582,-18000,,
com.apple.finder,4,1724944428,1724944432,1724944432.91186,-18000,,
com.google.Chrome,11,1724944417,1724944428,1724944428.370644,-18000,,
com.apple.Terminal,4,1724944413,1724944417,1724944417.8420901,-18000,,
com.google.Chrome,1,1724944412,1724944413,1724944413.60377,-18000,,
com.apple.Terminal,86,1724944326,1724944412,1724944412.082618,-18000,,
com.google.Chrome,3,1724944323,1724944326,1724944326.196337,-18000,,
com.apple.Terminal,2,1724944321,1724944323,1724944323.489728,-18000,,
com.google.Chrome,1,1724944320,1724944321,1724944321.284785,-18000,,
com.apple.Terminal,2,1724944318,1724944320,1724944320.61925,-18000,,
com.apple.finder,1,1724944317,1724944318,1724944318.4501019,-18000,,
com.google.Chrome,11,1724944306,1724944317,1724944317.3837981,-18000,,
com.apple.finder,16,1724944290,1724944306,1724944306.331695,-18000,,
com.google.Chrome,8,1724944282,1724944290,1724944290.4726849,-18000,,
com.apple.finder,14,1724944268,1724944282,1724944282.646491,-18000,,
com.apple.Terminal,70,1724944198,1724944268,1724944268.583657,-18000,,
com.google.Chrome,1,1724944197,1724944198,1724944198.1724648,-18000,,
com.apple.Terminal,10,1724944187,1724944197,1724944197.580034,-18000,,
com.google.Chrome,14,1724944173,1724944187,1724944187.996941,-18000,,
com.apple.Terminal,54,1724944119,1724944173,1724944173.104578,-18000,,
com.apple.finder,3,1724944116,1724944119,1724944119.676167,-18000,,
com.google.Chrome,1,1724944115,1724944116,1724944116.259443,-18000,,
com.apple.finder,6,1724944109,1724944115,1724944115.722278,-18000,,
com.apple.Terminal,26,1724944083,1724944109,1724944109.882375,-18000,,
com.apple.finder,8,1724944075,1724944083,1724944083.9145641,-18000,,
com.apple.Terminal,128,1724943947,1724944075,1724944075.858813,-18000,,
com.apple.finder,2,1724943945,1724943947,1724943947.7559118,-18000,,
com.google.Chrome,4,1724943941,1724943945,1724943945.8590422,-18000,,
com.apple.finder,5,1724943936,1724943941,1724943941.255904,-18000,,
com.apple.Terminal,1,1724943935,1724943936,1724943936.512258,-18000,,
com.google.Chrome,20,1724943915,1724943935,1724943935.167962,-18000,,
com.apple.Terminal,65,1724943850,1724943915,1724943916.0152779,-18000,,
com.apple.finder,2,1724943848,1724943850,1724943850.949842,-18000,,
com.google.Chrome,7,1724943841,1724943848,1724943848.876899,-18000,,
com.apple.finder,13,1724943828,1724943841,1724943841.9913769,-18000,,
com.google.Chrome,3,1724943825,1724943828,1724943828.9909658,-18000,,
com.apple.Terminal,90,1724943735,1724943825,1724943825.741297,-18000,,
com.google.Chrome,1,1724943734,1724943735,1724943735.5089622,-18000,,
com.apple.Terminal,3,1724943731,1724943734,1724943734.857261,-18000,,
com.google.Chrome,4,1724943727,1724943731,1724943732.00842,-18000,,
com.apple.Terminal,72,1724943655,1724943727,1724943727.894003,-18000,,
com.google.Chrome,20,1724943635,1724943655,1724943655.064656,-18000,,
com.apple.Terminal,0,1724943635,1724943635,1724943635.92083,-18000,,
com.google.Chrome,12,1724943623,1724943635,1724943635.05836,-18000,,
com.apple.Terminal,26,1724943597,1724943623,1724943623.204766,-18000,,
com.google.Chrome,4,1724943593,1724943597,1724943597.226122,-18000,,
com.apple.Terminal,18,1724943575,1724943593,1724943593.272369,-18000,,
com.google.Chrome,3,1724943572,1724943575,1724943575.1720881,-18000,,
com.apple.Terminal,33,1724943539,1724943572,1724943572.319073,-18000,,
com.google.Chrome,3,1724943536,1724943539,1724943539.940466,-18000,,
com.apple.Terminal,0,1724943536,1724943536,1724943536.8420691,-18000,,
com.apple.finder,31,1724943505,1724943536,1724943536.226028,-18000,,
com.apple.Terminal,4,1724943501,1724943505,1724943505.527457,-18000,,
com.google.Chrome,1,1724943500,1724943501,1724943501.823502,-18000,,
com.apple.Terminal,2,1724943498,1724943500,1724943500.544578,-18000,,
com.google.Chrome,0,1724943498,1724943498,1724943499.013818,-18000,,
com.apple.Terminal,5,1724943493,1724943498,1724943498.164833,-18000,,
com.google.Chrome,1,1724943492,1724943493,1724943493.9358559,-18000,,
com.apple.Terminal,8,1724943484,1724943492,1724943492.409646,-18000,,
com.google.Chrome,1,1724943483,1724943484,1724943484.18957,-18000,,
com.apple.Terminal,2,1724943481,1724943483,1724943483.2515159,-18000,,
com.google.Chrome,22,1724943459,1724943481,1724943481.059133,-18000,,
com.apple.Terminal,15,1724943444,1724943459,1724943459.45006,-18000,,
com.google.Chrome,1,1724943443,1724943444,1724943444.618187,-18000,,
com.apple.Terminal,2,1724943441,1724943443,1724943443.564036,-18000,,
com.google.Chrome,1,1724943440,1724943441,1724943441.9705958,-18000,,
com.apple.Terminal,2,1724943438,1724943440,1724943440.376872,-18000,,
com.google.Chrome,1,1724943437,1724943438,1724943438.392004,-18000,,
com.apple.Terminal,1,1724943436,1724943437,1724943437.307807,-18000,,
com.google.Chrome,4,1724943432,1724943436,1724943436.591833,-18000,,
com.apple.Terminal,13,1724943419,1724943432,1724943432.504493,-18000,,
com.google.Chrome,2,1724943417,1724943419,1724943419.158459,-18000,,
com.apple.Terminal,1,1724943416,1724943417,1724943417.833829,-18000,,
com.google.Chrome,3,1724943413,1724943416,1724943416.2258449,-18000,,
com.apple.Terminal,0,1724943413,1724943413,1724943413.8574781,-18000,,
com.google.Chrome,2,1724943411,1724943413,1724943413.1428409,-18000,,
com.apple.Terminal,3,1724943408,1724943411,1724943411.330745,-18000,,
com.google.Chrome,1,1724943407,1724943408,1724943408.5596309,-18000,,
com.apple.Terminal,1,1724943406,1724943407,1724943407.558404,-18000,,
com.google.Chrome,1,1724943405,1724943406,1724943406.826425,-18000,,
com.apple.Terminal,4,1724943401,1724943405,1724943405.479708,-18000,,
com.google.Chrome,7,1724943394,1724943401,1724943401.986874,-18000,,
com.apple.Terminal,7,1724943387,1724943394,1724943394.103267,-18000,,
com.google.Chrome,1,1724943386,1724943387,1724943387.428052,-18000,,
com.apple.Terminal,6,1724943380,1724943386,1724943386.735969,-18000,,
com.google.Chrome,34,1724943346,1724943380,1724943380.498695,-18000,,
com.apple.Terminal,24,1724943322,1724943346,1724943346.4726381,-18000,,
com.google.Chrome,77,1724943245,1724943322,1724943322.2753448,-18000,,
com.apple.Terminal,5,1724943240,1724943245,1724943245.74233,-18000,,
com.apple.finder,5,1724943235,1724943240,1724943240.807214,-18000,,
com.apple.TextEdit,5,1724943230,1724943235,1724943235.8663812,-18000,,
com.apple.finder,4,1724943226,1724943230,1724943230.3930159,-18000,,
com.apple.Terminal,342,1724942884,1724943226,1724943226.194957,-18000,,
com.google.Chrome,25,1724942859,1724942884,1724942884.50301,-18000,,
com.apple.finder,1,1724942858,1724942859,1724942860.034587,-18000,,
com.apple.finder,329,1724942336,1724942665,1724942665.53814,-18000,,
com.google.Chrome,98,1724942238,1724942336,1724942336.5267591,-18000,,
com.apple.finder,202,1724942036,1724942238,1724942238.60493,-18000,,
com.google.Chrome,152,1724941884,1724942036,1724942036.451435,-18000,,
com.apple.news,96,1724941710,1724941806,1724941806.91358,-18000,EB445137-D7F5-57EC-87DA-1DB460D64046,"iPhone13,2"
com.apple.news,143,1724941561,1724941704,1724941705.01109,-18000,EB445137-D7F5-57EC-87DA-1DB460D64046,"iPhone13,2"
com.apple.news,522,1724939979,1724940501,1724940501.099739,-18000,EB445137-D7F5-57EC-87DA-1DB460D64046,"iPhone13,2"
com.apple.news,1,1724939978,1724939979,1724939979.693409,-18000,EB445137-D7F5-57EC-87DA-1DB460D64046,"iPhone13,2"
com.apple.news,23,1724939618,1724939641,1724939641.393853,-18000,EB445137-D7F5-57EC-87DA-1DB460D64046,"iPhone13,2"
com.apple.weather,5,1724939613,1724939618,1724939618.5825238,-18000,EB445137-D7F5-57EC-87DA-1DB460D64046,"iPhone13,2"
com.apple.Health,10,1724939595,1724939605,1724939605.3622599,-18000,EB445137-D7F5-57EC-87DA-1DB460D64046,"iPhone13,2"
com.apple.Health,16,1724939560,1724939576,1724939577.056119,-18000,EB445137-D7F5-57EC-87DA-1DB460D64046,"iPhone13,2"
com.renpho.health,40,1724939435,1724939475,1724939476.236949,-18000,EB445137-D7F5-57EC-87DA-1DB460D64046,"iPhone13,2"
com.microsoft.Office.Outlook,0,1724939423,1724939423,1724939423.3301091,-18000,EB445137-D7F5-57EC-87DA-1DB460D64046,"iPhone13,2"
com.microsoft.Office.Outlook,13,1724937990,1724938003,1724938003.103774,-18000,EB445137-D7F5-57EC-87DA-1DB460D64046,"iPhone13,2"
com.microsoft.Office.Outlook,10,1724937968,1724937978,1724937978.8240309,-18000,EB445137-D7F5-57EC-87DA-1DB460D64046,"iPhone13,2"
com.microsoft.Office.Outlook,10,1724937696,1724937706,1724937706.08525,-18000,EB445137-D7F5-57EC-87DA-1DB460D64046,"iPhone13,2"
com.microsoft.Office.Outlook,10,1724937542,1724937552,1724937552.683226,-18000,EB445137-D7F5-57EC-87DA-1DB460D64046,"iPhone13,2"
com.microsoft.Office.Outlook,12,1724937468,1724937480,1724937480.84588,-18000,EB445137-D7F5-57EC-87DA-1DB460D64046,"iPhone13,2"
com.microsoft.Office.Outlook,61,1724937398,1724937459,1724937459.330174,-18000,EB445137-D7F5-57EC-87DA-1DB460D64046,"iPhone13,2"
com.google.Gmail,7,1724937372,1724937379,1724937379.373595,-18000,EB445137-D7F5-57EC-87DA-1DB460D64046,"iPhone13,2"
com.apple.Health,2,1724937354,1724937356,1724937357.0572228,-18000,EB445137-D7F5-57EC-87DA-1DB460D64046,"iPhone13,2"
com.thestorygraph.thestorygraph,16,1724906508,1724906524,1724906524.4671888,-18000,EB445137-D7F5-57EC-87DA-1DB460D64046,"iPhone13,2"
com.thestorygraph.thestorygraph,6,1724906502,1724906508,1724906508.135668,-18000,EB445137-D7F5-57EC-87DA-1DB460D64046,"iPhone13,2"
com.thestorygraph.thestorygraph,11,1724906378,1724906389,1724906389.604968,-18000,EB445137-D7F5-57EC-87DA-1DB460D64046,"iPhone13,2"
com.thestorygraph.thestorygraph,7,1724904107,1724904114,1724904114.020839,-18000,EB445137-D7F5-57EC-87DA-1DB460D64046,"iPhone13,2"
com.thestorygraph.thestorygraph,126,1724903887,1724904013,1724904013.146793,-18000,EB445137-D7F5-57EC-87DA-1DB460D64046,"iPhone13,2"
com.letterboxd.LetterboxdApp,130,1724902287,1724902417,1724902417.1828399,-18000,EB445137-D7F5-57EC-87DA-1DB460D64046,"iPhone13,2"
com.google.Chrome,143,1724902280,1724902423,1724902423.914054,-18000,,
com.leomehlig.today,6,1724902274,1724902280,1724902280.516292,-18000,,
com.apple.Notes,2,1724902272,1724902274,1724902274.851774,-18000,,
com.leomehlig.today,2,1724902270,1724902272,1724902272.448416,-18000,,
com.microsoft.Outlook,5,1724902265,1724902270,1724902270.094925,-18000,,
com.leomehlig.today,2,1724902263,1724902265,1724902265.505608,-18000,,
com.apple.iCal,15,1724902248,1724902263,1724902263.8862538,-18000,,
com.leomehlig.today,29,1724902219,1724902248,1724902248.691073,-18000,,
com.google.Chrome,93,1724902126,1724902219,1724902219.8568459,-18000,,
com.apple.systempreferences,5,1724902121,1724902126,1724902126.56921,-18000,,
com.google.Chrome,2,1724902117,1724902119,1724902119.491811,-18000,,
com.apple.systempreferences,1,1724902114,1724902115,1724902116.0155768,-18000,,
com.clairmail.fth.client,123,1724902066,1724902189,1724902189.19944,-18000,EB445137-D7F5-57EC-87DA-1DB460D64046,"iPhone13,2"
com.apple.mobiletimer,4,1724902057,1724902061,1724902061.404325,-18000,EB445137-D7F5-57EC-87DA-1DB460D64046,"iPhone13,2"
com.google.Chrome,75,1724902039,1724902114,1724902114.7715049,-18000,,
com.apple.iCal,4,1724902035,1724902039,1724902040.025303,-18000,,
com.apple.mobiletimer,11,1724901373,1724901384,1724901384.260119,-18000,EB445137-D7F5-57EC-87DA-1DB460D64046,"iPhone13,2"
com.apple.mobilecal,10,1724901363,1724901373,1724901373.337336,-18000,EB445137-D7F5-57EC-87DA-1DB460D64046,"iPhone13,2"
com.google.Gmail,14,1724901325,1724901339,1724901339.613224,-18000,EB445137-D7F5-57EC-87DA-1DB460D64046,"iPhone13,2"
com.google.Gmail,5,1724901313,1724901318,1724901318.775467,-18000,EB445137-D7F5-57EC-87DA-1DB460D64046,"iPhone13,2"
com.google.Gmail,19,1724901288,1724901307,1724901308.373825,-18000,EB445137-D7F5-57EC-87DA-1DB460D64046,"iPhone13,2"
com.google.chrome.ios,4,1724901284,1724901288,1724901288.937438,-18000,EB445137-D7F5-57EC-87DA-1DB460D64046,"iPhone13,2"
com.google.chrome.ios,4,1724901269,1724901273,1724901273.977192,-18000,EB445137-D7F5-57EC-87DA-1DB460D64046,"iPhone13,2"
com.google.chrome.ios,10,1724901190,1724901200,1724901200.576478,-18000,EB445137-D7F5-57EC-87DA-1DB460D64046,"iPhone13,2"
com.google.chrome.ios,4,1724901011,1724901015,1724901015.082528,-18000,EB445137-D7F5-57EC-87DA-1DB460D64046,"iPhone13,2"
com.google.chrome.ios,3,1724899934,1724899937,1724899937.135963,-18000,EB445137-D7F5-57EC-87DA-1DB460D64046,"iPhone13,2"
com.google.chrome.ios,1,1724899809,1724899810,1724899810.471796,-18000,EB445137-D7F5-57EC-87DA-1DB460D64046,"iPhone13,2"
com.google.chrome.ios,37,1724899553,1724899590,1724899591.043201,-18000,EB445137-D7F5-57EC-87DA-1DB460D64046,"iPhone13,2"
com.google.ios.youtube,7,1724899546,1724899553,1724899553.659082,-18000,EB445137-D7F5-57EC-87DA-1DB460D64046,"iPhone13,2"
com.google.ios.youtube,358,1724895343,1724895701,1724895701.150363,-18000,EB445137-D7F5-57EC-87DA-1DB460D64046,"iPhone13,2"
com.doordash.dasher,61,1724895244,1724895305,1724895306.05438,-18000,EB445137-D7F5-57EC-87DA-1DB460D64046,"iPhone13,2"
com.thestorygraph.thestorygraph,6,1724895230,1724895236,1724895236.8288941,-18000,EB445137-D7F5-57EC-87DA-1DB460D64046,"iPhone13,2"
com.thestorygraph.thestorygraph,23,1724894911,1724894934,1724894934.8460932,-18000,EB445137-D7F5-57EC-87DA-1DB460D64046,"iPhone13,2"
com.burbn.instagram,20,1724894867,1724894887,1724894887.350628,-18000,EB445137-D7F5-57EC-87DA-1DB460D64046,"iPhone13,2"
com.apple.mobileslideshow,14,1724894851,1724894865,1724894866.005292,-18000,EB445137-D7F5-57EC-87DA-1DB460D64046,"iPhone13,2"
com.hammerandchisel.discord,54,1724894759,1724894813,1724894813.651115,-18000,EB445137-D7F5-57EC-87DA-1DB460D64046,"iPhone13,2"
com.hammerandchisel.discord,97,1724894661,1724894758,1724894758.954133,-18000,EB445137-D7F5-57EC-87DA-1DB460D64046,"iPhone13,2"
com.burbn.instagram,35,1724894626,1724894661,1724894661.4348989,-18000,EB445137-D7F5-57EC-87DA-1DB460D64046,"iPhone13,2"
com.hammerandchisel.discord,98,1724894524,1724894622,1724894622.940093,-18000,EB445137-D7F5-57EC-87DA-1DB460D64046,"iPhone13,2"
com.google.chrome.ios,41,1724894483,1724894524,1724894524.2028298,-18000,EB445137-D7F5-57EC-87DA-1DB460D64046,"iPhone13,2"
com.google.Sheets,27,1724894456,1724894483,1724894484.131559,-18000,EB445137-D7F5-57EC-87DA-1DB460D64046,"iPhone13,2"
com.hammerandchisel.discord,29,1724894424,1724894453,1724894453.939054,-18000,EB445137-D7F5-57EC-87DA-1DB460D64046,"iPhone13,2"
com.google.chrome.ios,68,1724894335,1724894403,1724894403.2728271,-18000,EB445137-D7F5-57EC-87DA-1DB460D64046,"iPhone13,2"
com.google.chrome.ios,112,1724894171,1724894283,1724894283.270807,-18000,EB445137-D7F5-57EC-87DA-1DB460D64046,"iPhone13,2"
com.apple.news,128,1724894042,1724894170,1724894170.823124,-18000,EB445137-D7F5-57EC-87DA-1DB460D64046,"iPhone13,2"
com.google.chrome.ios,365,1724893668,1724894033,1724894033.833802,-18000,EB445137-D7F5-57EC-87DA-1DB460D64046,"iPhone13,2"
com.apple.news,230,1724893437,1724893667,1724893667.639276,-18000,EB445137-D7F5-57EC-87DA-1DB460D64046,"iPhone13,2"
com.microsoft.Office.Outlook,33,1724893386,1724893419,1724893420.002283,-18000,EB445137-D7F5-57EC-87DA-1DB460D64046,"iPhone13,2"
com.tinyspeck.chatlyio,161,1724893224,1724893385,1724893385.303176,-18000,EB445137-D7F5-57EC-87DA-1DB460D64046,"iPhone13,2"
com.google.chrome.ios,2,1724893222,1724893224,1724893224.9009151,-18000,EB445137-D7F5-57EC-87DA-1DB460D64046,"iPhone13,2"
com.tinyspeck.chatlyio,15,1724893207,1724893222,1724893222.939992,-18000,EB445137-D7F5-57EC-87DA-1DB460D64046,"iPhone13,2"
com.google.chrome.ios,11,1724893196,1724893207,1724893207.496841,-18000,EB445137-D7F5-57EC-87DA-1DB460D64046,"iPhone13,2"
com.microsoft.Office.Outlook,8,1724893188,1724893196,1724893196.4131908,-18000,EB445137-D7F5-57EC-87DA-1DB460D64046,"iPhone13,2"
com.tinyspeck.chatlyio,34,1724893153,1724893187,1724893187.259221,-18000,EB445137-D7F5-57EC-87DA-1DB460D64046,"iPhone13,2"
com.apple.news,85,1724893061,1724893146,1724893147.022657,-18000,EB445137-D7F5-57EC-87DA-1DB460D64046,"iPhone13,2"
com.microsoft.Office.Outlook,14,1724893006,1724893020,1724893020.431407,-18000,EB445137-D7F5-57EC-87DA-1DB460D64046,"iPhone13,2"
com.instructure.icanvas,12,1724892994,1724893006,1724893007.144402,-18000,EB445137-D7F5-57EC-87DA-1DB460D64046,"iPhone13,2"
com.apple.iCal,253,1724892907,1724893160,1724893160.44319,-18000,,
com.google.Chrome,129,1724892778,1724892907,1724892907.925127,-18000,,
com.leomehlig.today,18,1724892760,1724892778,1724892778.301656,-18000,,
com.google.Chrome,99,1724892661,1724892760,1724892760.45232,-18000,,
com.instructure.icanvas,40,1724890981,1724891021,1724891021.610633,-18000,EB445137-D7F5-57EC-87DA-1DB460D64046,"iPhone13,2"
com.myfitnesspal.mfp,44,1724890937,1724890981,1724890981.736465,-18000,EB445137-D7F5-57EC-87DA-1DB460D64046,"iPhone13,2"
com.google.Chrome,2781,1724889742,1724892523,1724892523.5401149,-18000,,
com.apple.iCal,6,1724889736,1724889742,1724889742.0497441,-18000,,
com.google.Chrome,321,1724889415,1724889736,1724889737.038908,-18000,,
com.leomehlig.today,8,1724889407,1724889415,1724889416.020455,-18000,,
com.myfitnesspal.mfp,187,1724888439,1724888626,1724888626.2159882,-18000,EB445137-D7F5-57EC-87DA-1DB460D64046,"iPhone13,2"
com.google.chrome.ios,5,1724888433,1724888438,1724888438.841193,-18000,EB445137-D7F5-57EC-87DA-1DB460D64046,"iPhone13,2"
com.google.chrome.ios,62,1724885487,1724885549,1724885549.303076,-18000,EB445137-D7F5-57EC-87DA-1DB460D64046,"iPhone13,2"
com.google.chrome.ios,33,1724885359,1724885392,1724885392.2109098,-18000,EB445137-D7F5-57EC-87DA-1DB460D64046,"iPhone13,2"
com.leomehlig.today,67,1724884994,1724885061,1724885061.230866,-18000,,
com.apple.mobilephone,5,1724882882,1724882887,1724882887.4745622,-18000,EB445137-D7F5-57EC-87DA-1DB460D64046,"iPhone13,2"
com.apple.InCallService,3,1724882879,1724882882,1724882882.382797,-18000,EB445137-D7F5-57EC-87DA-1DB460D64046,"iPhone13,2"
com.apple.InCallService,13,1724882859,1724882872,1724882872.430039,-18000,EB445137-D7F5-57EC-87DA-1DB460D64046,"iPhone13,2"
com.google.Chrome,2349,1724882645,1724884994,1724884994.272056,-18000,,
com.apple.InCallService,1,1724882542,1724882543,1724882543.6713161,-18000,EB445137-D7F5-57EC-87DA-1DB460D64046,"iPhone13,2"
com.apple.Notes,108,1724882537,1724882645,1724882645.762177,-18000,,
com.apple.InCallService,14,1724882526,1724882540,1724882540.7000341,-18000,EB445137-D7F5-57EC-87DA-1DB460D64046,"iPhone13,2"
com.apple.InCallService,5,1724882480,1724882485,1724882485.1138391,-18000,EB445137-D7F5-57EC-87DA-1DB460D64046,"iPhone13,2"
com.apple.InCallService,1,1724882447,1724882448,1724882448.918738,-18000,EB445137-D7F5-57EC-87DA-1DB460D64046,"iPhone13,2"
com.apple.InCallService,3,1724882444,1724882447,1724882447.470222,-18000,EB445137-D7F5-57EC-87DA-1DB460D64046,"iPhone13,2"
com.apple.InCallService,5,1724882414,1724882419,1724882419.867323,-18000,EB445137-D7F5-57EC-87DA-1DB460D64046,"iPhone13,2"
com.apple.InCallService,4,1724882408,1724882412,1724882412.2598438,-18000,EB445137-D7F5-57EC-87DA-1DB460D64046,"iPhone13,2"
com.apple.InCallService,2,1724882324,1724882326,1724882326.234867,-18000,EB445137-D7F5-57EC-87DA-1DB460D64046,"iPhone13,2"
com.apple.Notes,326,1724882204,1724882530,1724882530.4762201,-18000,,
com.apple.InCallService,1,1724882005,1724882006,1724882006.539312,-18000,EB445137-D7F5-57EC-87DA-1DB460D64046,"iPhone13,2"
com.google.Chrome,207,1724881997,1724882204,1724882204.609727,-18000,,
com.apple.InCallService,2,1724881993,1724881995,1724881995.300189,-18000,EB445137-D7F5-57EC-87DA-1DB460D64046,"iPhone13,2"
com.apple.mobilephone,15,1724881978,1724881993,1724881993.487447,-18000,EB445137-D7F5-57EC-87DA-1DB460D64046,"iPhone13,2"
com.apple.MobileSMS,1,1724881977,1724881978,1724881978.7618861,-18000,EB445137-D7F5-57EC-87DA-1DB460D64046,"iPhone13,2"
com.apple.iCal,52,1724881945,1724881997,1724881997.158407,-18000,,
com.apple.findmy,54,1724881922,1724881976,1724881976.60316,-18000,EB445137-D7F5-57EC-87DA-1DB460D64046,"iPhone13,2"
com.ryansponzilli.DeepSkyCatalog,3,1724881919,1724881922,1724881922.0147572,-18000,EB445137-D7F5-57EC-87DA-1DB460D64046,"iPhone13,2"
com.google.Chrome,236,1724881709,1724881945,1724881945.729255,-18000,,
com.ryansponzilli.DeepSkyCatalog,23,1724881444,1724881467,1724881467.109937,-18000,EB445137-D7F5-57EC-87DA-1DB460D64046,"iPhone13,2"
com.burbn.instagram,107,1724881320,1724881427,1724881427.5351992,-18000,EB445137-D7F5-57EC-87DA-1DB460D64046,"iPhone13,2"
com.apple.findmy,9,1724881280,1724881289,1724881289.725628,-18000,EB445137-D7F5-57EC-87DA-1DB460D64046,"iPhone13,2"
com.hammerandchisel.discord,251,1724880996,1724881247,1724881247.604607,-18000,EB445137-D7F5-57EC-87DA-1DB460D64046,"iPhone13,2"
com.google.Chrome,308,1724880944,1724881252,1724881252.750129,-18000,,
us.zoom.xos,25,1724880919,1724880944,1724880944.633693,-18000,,
com.google.Chrome,2,1724880917,1724880919,1724880919.664517,-18000,,
us.zoom.xos,25,1724880892,1724880917,1724880917.780776,-18000,,
com.google.Chrome,2,1724880890,1724880892,1724880892.455309,-18000,,
us.zoom.xos,11,1724880879,1724880890,1724880890.627863,-18000,,
com.google.Chrome,2,1724880877,1724880879,1724880879.893302,-18000,,
us.zoom.xos,4,1724880873,1724880877,1724880877.614293,-18000,,
com.google.Chrome,1,1724880872,1724880873,1724880873.9190521,-18000,,
us.zoom.xos,33,1724880839,1724880872,1724880872.7266111,-18000,,
com.google.Chrome,88,1724880751,1724880839,1724880839.331524,-18000,,
us.zoom.xos,5,1724880746,1724880751,1724880751.366815,-18000,,
com.hammerandchisel.discord,49,1724880695,1724880744,1724880744.861964,-18000,EB445137-D7F5-57EC-87DA-1DB460D64046,"iPhone13,2"
com.google.Chrome,89,1724880657,1724880746,1724880746.237375,-18000,,
us.zoom.xos,3,1724880654,1724880657,1724880657.489156,-18000,,
com.google.Chrome,390,1724880264,1724880654,1724880654.971418,-18000,,
us.zoom.xos,2,1724880262,1724880264,1724880264.273559,-18000,,
com.google.Chrome,34,1724880228,1724880262,1724880262.795751,-18000,,
us.zoom.xos,2,1724880226,1724880228,1724880228.878654,-18000,,
com.google.Chrome,3,1724880223,1724880226,1724880226.5164928,-18000,,
com.microsoft.Outlook,1,1724880222,1724880223,1724880223.4244962,-18000,,
com.google.Chrome,56,1724880166,1724880222,1724880222.4171262,-18000,,
com.microsoft.Outlook,4,1724880162,1724880166,1724880166.8351011,-18000,,
com.google.Chrome,8,1724880154,1724880162,1724880162.955565,-18000,,
com.hammerandchisel.discord,85,1724880067,1724880152,1724880152.220804,-18000,EB445137-D7F5-57EC-87DA-1DB460D64046,"iPhone13,2"
com.apple.mobileslideshow,25,1724880042,1724880067,1724880067.9011822,-18000,EB445137-D7F5-57EC-87DA-1DB460D64046,"iPhone13,2"
com.hammerandchisel.discord,113,1724879926,1724880039,1724880039.930159,-18000,EB445137-D7F5-57EC-87DA-1DB460D64046,"iPhone13,2"
us.zoom.xos,302,1724879852,1724880154,1724880154.741883,-18000,,
com.apple.iCal,113,1724879739,1724879852,1724879852.6532168,-18000,,
us.zoom.xos,2,1724879737,1724879739,1724879739.754733,-18000,,
com.apple.mobileslideshow,137,1724879723,1724879860,1724879860.4423919,-18000,EB445137-D7F5-57EC-87DA-1DB460D64046,"iPhone13,2"
com.instructure.icanvas,28,1724879686,1724879714,1724879714.3306231,-18000,EB445137-D7F5-57EC-87DA-1DB460D64046,"iPhone13,2"
us.zoom.xos,477,1724879211,1724879688,1724879688.042948,-18000,,
com.google.Chrome,13,1724879198,1724879211,1724879211.855535,-18000,,
us.zoom.xos,32,1724879166,1724879198,1724879198.088503,-18000,,
com.google.Chrome,19,1724879147,1724879166,1724879166.118822,-18000,,
us.zoom.xos,6,1724879141,1724879147,1724879147.686761,-18000,,
com.google.Chrome,1,1724879140,1724879141,1724879141.763643,-18000,,
us.zoom.xos,1,1724879139,1724879140,1724879140.2783918,-18000,,
com.google.Chrome,31,1724879108,1724879139,1724879139.843174,-18000,,
com.instructure.icanvas,17,1724879078,1724879095,1724879095.4130359,-18000,EB445137-D7F5-57EC-87DA-1DB460D64046,"iPhone13,2"
us.zoom.xos,174,1724878934,1724879108,1724879108.135576,-18000,,
com.google.Chrome,32,1724878902,1724878934,1724878934.652596,-18000,,
us.zoom.xos,42,1724878860,1724878902,1724878902.803227,-18000,,
com.google.Chrome,36,1724878824,1724878860,1724878860.781563,-18000,,
us.zoom.xos,10,1724878814,1724878824,1724878824.9024692,-18000,,
com.google.Chrome,18,1724878796,1724878814,1724878814.180441,-18000,,
us.zoom.xos,2,1724878794,1724878796,1724878796.527837,-18000,,
com.google.Chrome,26,1724878768,1724878794,1724878794.41417,-18000,,
us.zoom.xos,25,1724878743,1724878768,1724878768.249862,-18000,,
com.google.Chrome,129,1724878614,1724878743,1724878743.37844,-18000,,
com.google.Chrome,872,1724877352,1724878224,1724878224.809277,-18000,,
com.google.Chrome,301,1724877043,1724877344,1724877344.311774,-18000,,
us.zoom.xos,1,1724877042,1724877043,1724877043.625597,-18000,,
com.google.Chrome,4,1724877038,1724877042,1724877042.165525,-18000,,
us.zoom.xos,24,1724877014,1724877038,1724877038.99491,-18000,,
com.google.Chrome,4,1724877010,1724877014,1724877014.2025871,-18000,,
us.zoom.xos,10,1724877000,1724877010,1724877010.354389,-18000,,
com.google.Chrome,1,1724876999,1724877000,1724877000.628418,-18000,,
com.apple.installer,8,1724876991,1724876999,1724876999.242245,-18000,,
com.google.Chrome,3,1724876974,1724876977,1724876977.43904,-18000,,
us.zoom.xos,26,1724876948,1724876974,1724876974.275223,-18000,,
com.google.Chrome,23,1724876925,1724876948,1724876948.931683,-18000,,
com.leomehlig.today,2,1724876923,1724876925,1724876925.738896,-18000,,
com.google.Chrome,17,1724876906,1724876923,1724876923.1791,-18000,,
com.microsoft.Outlook,3,1724876887,1724876890,1724876890.0931811,-18000,,
com.apple.iCal,55,1724876832,1724876887,1724876887.434238,-18000,,
com.google.Chrome,252,1724876580,1724876832,1724876832.0933518,-18000,,
com.microsoft.Outlook,56,1724876524,1724876580,1724876580.952732,-18000,,
com.apple.Notes,9,1724876515,1724876524,1724876524.959831,-18000,,
com.leomehlig.today,15,1724876500,1724876515,1724876515.94664,-18000,,
com.apple.Maps,39,1724875086,1724875125,1724875125.72685,-18000,EB445137-D7F5-57EC-87DA-1DB460D64046,"iPhone13,2"
com.apple.weather,4,1724875082,1724875086,1724875086.0601258,-18000,EB445137-D7F5-57EC-87DA-1DB460D64046,"iPhone13,2"
com.toyopagroup.picaboo,3,1724875079,1724875082,1724875082.369549,-18000,EB445137-D7F5-57EC-87DA-1DB460D64046,"iPhone13,2"
com.leomehlig.today,21,1724875012,1724875033,1724875033.351124,-18000,,
com.leomehlig.today,130,1724874880,1724875010,1724875010.9982471,-18000,,
com.google.Chrome,2,1724874878,1724874880,1724874880.318376,-18000,,
com.leomehlig.today,36,1724874842,1724874878,1724874879.014886,-18000,,
com.google.Chrome,389,1724874453,1724874842,1724874842.452406,-18000,,
com.leomehlig.today,45,1724874408,1724874453,1724874453.888793,-18000,,
com.google.Chrome,43,1724874365,1724874408,1724874408.986271,-18000,,
com.leomehlig.today,3,1724874362,1724874365,1724874365.8864021,-18000,,
com.apple.Preview,13,1724874349,1724874362,1724874363.006362,-18000,,
com.google.Chrome,5,1724874344,1724874349,1724874349.250914,-18000,,
com.apple.Preview,1,1724874343,1724874344,1724874344.687228,-18000,,
com.leomehlig.today,1,1724874342,1724874343,1724874343.376933,-18000,,
com.google.Chrome,142,1724874200,1724874342,1724874342.477458,-18000,,
com.leomehlig.today,3,1724874197,1724874200,1724874200.682224,-18000,,
com.google.Chrome,13,1724874184,1724874197,1724874197.450716,-18000,,
com.apple.Preview,37,1724874147,1724874184,1724874184.2864861,-18000,,
com.google.Chrome,7,1724874140,1724874147,1724874147.646636,-18000,,
com.apple.Preview,463,1724873677,1724874140,1724874140.1634169,-18000,,
com.google.Chrome,3,1724873674,1724873677,1724873677.782623,-18000,,
com.apple.Preview,3,1724873671,1724873674,1724873674.950334,-18000,,
com.google.Chrome,44,1724873627,1724873671,1724873671.9332762,-18000,,
com.apple.Preview,204,1724873423,1724873627,1724873628.021078,-18000,,
com.google.Chrome,1,1724873422,1724873423,1724873423.323193,-18000,,
com.apple.Preview,1,1724873421,1724873422,1724873422.192394,-18000,,
com.apple.finder,4,1724873417,1724873421,1724873421.275167,-18000,,
com.google.Chrome,1,1724873416,1724873417,1724873417.830288,-18000,,
com.apple.finder,1,1724873415,1724873416,1724873416.4287472,-18000,,
com.apple.Preview,23,1724873392,1724873415,1724873415.149311,-18000,,
com.apple.finder,1,1724873391,1724873392,1724873392.779584,-18000,,
com.google.Chrome,12,1724873379,1724873391,1724873391.916018,-18000,,
com.apple.finder,1,1724873378,1724873379,1724873379.696213,-18000,,
com.apple.Preview,6,1724873372,1724873378,1724873378.9377232,-18000,,
com.apple.finder,1,1724873371,1724873372,1724873372.4641972,-18000,,
com.google.Chrome,5,1724873366,1724873371,1724873371.645028,-18000,,
com.apple.finder,1,1724873365,1724873366,1724873366.922543,-18000,,
com.apple.Preview,67,1724873298,1724873365,1724873366.036423,-18000,,
com.apple.finder,3,1724873295,1724873298,1724873298.9674149,-18000,,
com.google.Chrome,26,1724873269,1724873295,1724873295.090354,-18000,,
com.apple.iCal,14,1724873255,1724873269,1724873269.958391,-18000,,
com.leomehlig.today,17,1724873238,1724873255,1724873255.626173,-18000,,
com.apple.iCal,2,1724873236,1724873238,1724873238.315249,-18000,,
com.google.Chrome,22,1724873214,1724873236,1724873236.990759,-18000,,
com.apple.iCal,11,1724873203,1724873214,1724873214.92389,-18000,,
com.google.Chrome,4,1724873199,1724873203,1724873203.8731298,-18000,,
com.apple.iCal,7,1724873192,1724873199,1724873199.081212,-18000,,
com.google.Chrome,3,1724873189,1724873192,1724873192.84895,-18000,,
com.apple.iCal,7,1724873182,1724873189,1724873189.784755,-18000,,
com.google.Chrome,2,1724873180,1724873182,1724873182.784642,-18000,,
com.apple.iCal,7,1724873173,1724873180,1724873180.7848969,-18000,,
com.google.Chrome,1,1724873172,1724873173,1724873173.562941,-18000,,
com.apple.iCal,1,1724873171,1724873172,1724873172.2241979,-18000,,
com.google.Chrome,2,1724873169,1724873171,1724873171.741282,-18000,,
com.apple.iCal,8,1724873161,1724873169,1724873169.499212,-18000,,
com.google.Chrome,140,1724873021,1724873161,1724873161.662094,-18000,,
com.google.Chrome,40,1724872950,1724872990,1724872990.746951,-18000,,
com.leomehlig.today,82,1724872868,1724872950,1724872950.4208531,-18000,,
com.google.Chrome,228,1724872640,1724872868,1724872868.6036,-18000,,
com.apple.systempreferences,46,1724872594,1724872640,1724872640.493556,-18000,,
com.google.Chrome,7,1724872587,1724872594,1724872594.396143,-18000,,
com.apple.systempreferences,7,1724872580,1724872587,1724872587.087891,-18000,,
com.google.Chrome,3,1724872575,1724872578,1724872578.163916,-18000,,
com.microsoft.Outlook,11,1724872551,1724872562,1724872562.83225,-18000,,
com.google.Chrome,83,1724872468,1724872551,1724872552.319628,-18000,,
com.apple.Notes,153,1724872315,1724872468,1724872468.88652,-18000,,
com.google.Chrome,125,1724872190,1724872315,1724872315.408643,-18000,,
com.apple.iCal,1,1724872176,1724872177,1724872178.294352,-18000,,
com.google.Chrome,0,1724872176,1724872176,1724872176.9807239,-18000,,
com.apple.iCal,0,1724872176,1724872176,1724872176.816031,-18000,,
com.leomehlig.today,8,1724872168,1724872176,1724872176.21875,-18000,,
com.google.Chrome,16,1724872152,1724872168,1724872168.385694,-18000,,
com.toyopagroup.picaboo,12,1724870970,1724870982,1724870982.753094,-18000,EB445137-D7F5-57EC-87DA-1DB460D64046,"iPhone13,2"
com.apple.calculator,9,1724870961,1724870970,1724870970.859626,-18000,EB445137-D7F5-57EC-87DA-1DB460D64046,"iPhone13,2"
com.apple.calculator,23,1724868688,1724868711,1724868711.955379,-18000,EB445137-D7F5-57EC-87DA-1DB460D64046,"iPhone13,2"
com.apple.mobilecal,3,1724868685,1724868688,1724868688.4866261,-18000,EB445137-D7F5-57EC-87DA-1DB460D64046,"iPhone13,2"
com.apple.mobilecal,16,1724868052,1724868068,1724868068.6352181,-18000,EB445137-D7F5-57EC-87DA-1DB460D64046,"iPhone13,2"
com.apple.news,3,1724868047,1724868050,1724868050.392523,-18000,EB445137-D7F5-57EC-87DA-1DB460D64046,"iPhone13,2"
com.apple.news,1,1724868004,1724868005,1724868005.316657,-18000,EB445137-D7F5-57EC-87DA-1DB460D64046,"iPhone13,2"
com.apple.news,2,1724867911,1724867913,1724867913.056809,-18000,EB445137-D7F5-57EC-87DA-1DB460D64046,"iPhone13,2"
com.apple.news,2,1724867664,1724867666,1724867666.314861,-18000,EB445137-D7F5-57EC-87DA-1DB460D64046,"iPhone13,2"
com.apple.news,16,1724867599,1724867615,1724867615.663944,-18000,EB445137-D7F5-57EC-87DA-1DB460D64046,"iPhone13,2"
com.apple.news,83,1724867486,1724867569,1724867569.468234,-18000,EB445137-D7F5-57EC-87DA-1DB460D64046,"iPhone13,2"
com.apple.news,209,1724867207,1724867416,1724867416.704949,-18000,EB445137-D7F5-57EC-87DA-1DB460D64046,"iPhone13,2"
com.myfitnesspal.mfp,45,1724867146,1724867191,1724867191.227145,-18000,EB445137-D7F5-57EC-87DA-1DB460D64046,"iPhone13,2"
com.leomehlig.today,25,1724867119,1724867144,1724867144.03322,-18000,EB445137-D7F5-57EC-87DA-1DB460D64046,"iPhone13,2"
com.instructure.icanvas,16,1724867103,1724867119,1724867119.4804258,-18000,EB445137-D7F5-57EC-87DA-1DB460D64046,"iPhone13,2"
com.leomehlig.today,24,1724867079,1724867103,1724867103.671407,-18000,EB445137-D7F5-57EC-87DA-1DB460D64046,"iPhone13,2"
com.apple.mobilecal,4,1724867074,1724867078,1724867078.750576,-18000,EB445137-D7F5-57EC-87DA-1DB460D64046,"iPhone13,2"
com.instructure.icanvas,27,1724867046,1724867073,1724867073.450206,-18000,EB445137-D7F5-57EC-87DA-1DB460D64046,"iPhone13,2"
com.google.Maps,14,1724867030,1724867044,1724867044.354058,-18000,EB445137-D7F5-57EC-87DA-1DB460D64046,"iPhone13,2"
com.apple.MobileSMS,4,1724867026,1724867030,1724867030.790195,-18000,EB445137-D7F5-57EC-87DA-1DB460D64046,"iPhone13,2"
com.apple.camera,14,1724866984,1724866998,1724866998.8514318,-18000,EB445137-D7F5-57EC-87DA-1DB460D64046,"iPhone13,2"
com.apple.MobileSMS,16,1724866982,1724866998,1724866998.8467941,-18000,EB445137-D7F5-57EC-87DA-1DB460D64046,"iPhone13,2"
com.apple.MobileSMS,4,1724866909,1724866913,1724866913.357531,-18000,EB445137-D7F5-57EC-87DA-1DB460D64046,"iPhone13,2"
com.apple.MobileSMS,50,1724866845,1724866895,1724866895.1930141,-18000,EB445137-D7F5-57EC-87DA-1DB460D64046,"iPhone13,2"
com.google.Maps,3,1724866842,1724866845,1724866845.952352,-18000,EB445137-D7F5-57EC-87DA-1DB460D64046,"iPhone13,2"
com.google.Maps,72,1724866328,1724866400,1724866400.16797,-18000,EB445137-D7F5-57EC-87DA-1DB460D64046,"iPhone13,2"
com.apple.camera,1,1724866195,1724866196,1724866196.1030731,-18000,EB445137-D7F5-57EC-87DA-1DB460D64046,"iPhone13,2"
com.google.Maps,8,1724866194,1724866202,1724866202.079421,-18000,EB445137-D7F5-57EC-87DA-1DB460D64046,"iPhone13,2"
com.google.Maps,6,1724866186,1724866192,1724866192.864775,-18000,EB445137-D7F5-57EC-87DA-1DB460D64046,"iPhone13,2"
com.google.Maps,87,1724865315,1724865402,1724865402.8933082,-18000,EB445137-D7F5-57EC-87DA-1DB460D64046,"iPhone13,2"
com.apple.weather,7,1724865303,1724865310,1724865310.7282162,-18000,EB445137-D7F5-57EC-87DA-1DB460D64046,"iPhone13,2"
com.truebill.truebillnative,4,1724865299,1724865303,1724865303.712723,-18000,EB445137-D7F5-57EC-87DA-1DB460D64046,"iPhone13,2"
com.google.Chrome,225,1724865240,1724865465,1724865465.52946,-18000,,
com.truebill.truebillnative,92,1724865147,1724865239,1724865239.501742,-18000,EB445137-D7F5-57EC-87DA-1DB460D64046,"iPhone13,2"
com.apple.weather,8,1724865001,1724865009,1724865009.023984,-18000,EB445137-D7F5-57EC-87DA-1DB460D64046,"iPhone13,2"
com.apple.weather,9,1724864679,1724864688,1724864688.3215032,-18000,EB445137-D7F5-57EC-87DA-1DB460D64046,"iPhone13,2"
com.google.ios.youtube,372,1724863466,1724863838,1724863838.850214,-18000,EB445137-D7F5-57EC-87DA-1DB460D64046,"iPhone13,2"
com.discoverfinancial.mobile,108,1724863220,1724863328,1724863328.9838362,-18000,EB445137-D7F5-57EC-87DA-1DB460D64046,"iPhone13,2"
com.instructure.icanvas,333,1724862861,1724863194,1724863194.818372,-18000,EB445137-D7F5-57EC-87DA-1DB460D64046,"iPhone13,2"
com.toyopagroup.picaboo,5,1724862855,1724862860,1724862860.8454828,-18000,EB445137-D7F5-57EC-87DA-1DB460D64046,"iPhone13,2"
com.google.Chrome,561,1724862819,1724863380,1724863380.9965901,-18000,,
com.toyopagroup.picaboo,14,1724862391,1724862405,1724862405.5066938,-18000,EB445137-D7F5-57EC-87DA-1DB460D64046,"iPhone13,2"
com.google.Chrome,330,1724862260,1724862590,1724862590.07004,-18000,,
com.toyopagroup.picaboo,13,1724861811,1724861824,1724861824.162932,-18000,EB445137-D7F5-57EC-87DA-1DB460D64046,"iPhone13,2"
com.instructure.icanvas,12,1724861793,1724861805,1724861805.962853,-18000,EB445137-D7F5-57EC-87DA-1DB460D64046,"iPhone13,2"
com.google.ios.youtube,8,1724861760,1724861768,1724861768.160231,-18000,EB445137-D7F5-57EC-87DA-1DB460D64046,"iPhone13,2"
com.google.ios.youtube,7,1724861749,1724861756,1724861756.821357,-18000,EB445137-D7F5-57EC-87DA-1DB460D64046,"iPhone13,2"
com.google.Chrome,487,1724861736,1724862223,1724862223.484171,-18000,,
com.google.ios.youtube,8,1724861726,1724861734,1724861734.355614,-18000,EB445137-D7F5-57EC-87DA-1DB460D64046,"iPhone13,2"
com.myfitnesspal.mfp,2,1724861181,1724861183,1724861183.332931,-18000,EB445137-D7F5-57EC-87DA-1DB460D64046,"iPhone13,2"
com.instructure.icanvas,183,1724860998,1724861181,1724861181.210617,-18000,EB445137-D7F5-57EC-87DA-1DB460D64046,"iPhone13,2"
com.myfitnesspal.mfp,2,1724860994,1724860996,1724860996.9347901,-18000,EB445137-D7F5-57EC-87DA-1DB460D64046,"iPhone13,2"
com.myfitnesspal.mfp,7,1724860860,1724860867,1724860867.914525,-18000,EB445137-D7F5-57EC-87DA-1DB460D64046,"iPhone13,2"
com.myfitnesspal.mfp,41,1724860066,1724860107,1724860107.311264,-18000,EB445137-D7F5-57EC-87DA-1DB460D64046,"iPhone13,2"
com.google.Chrome,1388,1724859999,1724861387,1724861387.782707,-18000,,
com.leomehlig.today,11,1724859988,1724859999,1724859999.80885,-18000,,
com.apple.iCal,5,1724859983,1724859988,1724859988.6011338,-18000,,
com.leomehlig.today,4,1724859979,1724859983,1724859983.581561,-18000,,
com.google.Chrome,1,1724859978,1724859979,1724859980.031838,-18000,,
com.leomehlig.today,10,1724859968,1724859978,1724859978.5513592,-18000,,
com.google.Chrome,527,1724859441,1724859968,1724859968.1494951,-18000,,
com.leomehlig.today,11,1724859430,1724859441,1724859441.3739629,-18000,,
com.apple.iCal,10,1724859420,1724859430,1724859430.978883,-18000,,
com.leomehlig.today,8,1724859412,1724859420,1724859420.745933,-18000,,
com.microsoft.Office.Outlook,13,1724859388,1724859401,1724859401.9590502,-18000,EB445137-D7F5-57EC-87DA-1DB460D64046,"iPhone13,2"
com.apple.Health,11,1724859377,1724859388,1724859388.192641,-18000,EB445137-D7F5-57EC-87DA-1DB460D64046,"iPhone13,2"
com.google.Chrome,622,1724858790,1724859412,1724859412.96909,-18000,,
com.apple.iCal,2,1724858788,1724858790,1724858790.785873,-18000,,
com.leomehlig.today,2,1724858786,1724858788,1724858789.016796,-18000,,
com.apple.iCal,3,1724858783,1724858786,1724858786.422584,-18000,,
com.leomehlig.today,15,1724858768,1724858783,1724858783.935194,-18000,,
com.google.Chrome,851,1724857917,1724858768,1724858768.786289,-18000,,
com.apple.Health,6,1724856916,1724856922,1724856922.9170408,-18000,EB445137-D7F5-57EC-87DA-1DB460D64046,"iPhone13,2"
com.apple.Health,37,1724856077,1724856114,1724856114.2533479,-18000,EB445137-D7F5-57EC-87DA-1DB460D64046,"iPhone13,2"
com.renpho.health,120,1724855957,1724856077,1724856077.7976952,-18000,EB445137-D7F5-57EC-87DA-1DB460D64046,"iPhone13,2"
com.instructure.icanvas,3,1724855951,1724855954,1724855954.347365,-18000,EB445137-D7F5-57EC-87DA-1DB460D64046,"iPhone13,2"
com.instructure.icanvas,13,1724855062,1724855075,1724855075.2651958,-18000,EB445137-D7F5-57EC-87DA-1DB460D64046,"iPhone13,2"
com.instructure.icanvas,3,1724855057,1724855060,1724855060.850796,-18000,EB445137-D7F5-57EC-87DA-1DB460D64046,"iPhone13,2"
com.instructure.icanvas,31,1724854964,1724854995,1724854995.289978,-18000,EB445137-D7F5-57EC-87DA-1DB460D64046,"iPhone13,2"
com.google.ios.youtube,2499,1724852460,1724854959,1724854959.285186,-18000,EB445137-D7F5-57EC-87DA-1DB460D64046,"iPhone13,2"
com.markhambly.APOD,24,1724852422,1724852446,1724852446.591012,-18000,EB445137-D7F5-57EC-87DA-1DB460D64046,"iPhone13,2"
com.apple.mobilecal,60,1724852354,1724852414,1724852414.436271,-18000,EB445137-D7F5-57EC-87DA-1DB460D64046,"iPhone13,2"
com.google.Gmail,97,1724852249,1724852346,1724852346.335211,-18000,EB445137-D7F5-57EC-87DA-1DB460D64046,"iPhone13,2"
com.apple.journal,13,1724820691,1724820704,1724820704.35399,-18000,EB445137-D7F5-57EC-87DA-1DB460D64046,"iPhone13,2"
com.apple.journal,3,1724820684,1724820687,1724820687.392318,-18000,EB445137-D7F5-57EC-87DA-1DB460D64046,"iPhone13,2"
com.apple.journal,1161,1724819522,1724820683,1724820683.3941379,-18000,EB445137-D7F5-57EC-87DA-1DB460D64046,"iPhone13,2"
com.apple.Health,69,1724819452,1724819521,1724819521.129817,-18000,EB445137-D7F5-57EC-87DA-1DB460D64046,"iPhone13,2"
com.apple.mobiletimer,10,1724819433,1724819443,1724819443.471237,-18000,EB445137-D7F5-57EC-87DA-1DB460D64046,"iPhone13,2"
com.thestorygraph.thestorygraph,17,1724819261,1724819278,1724819278.323049,-18000,EB445137-D7F5-57EC-87DA-1DB460D64046,"iPhone13,2"
com.google.Chrome,5,1724817399,1724817404,1724817404.399329,-18000,,
com.google.Chrome,3,1724817396,1724817399,1724817399.496578,-18000,,
com.apple.news,145,1724817168,1724817313,1724817313.432271,-18000,EB445137-D7F5-57EC-87DA-1DB460D64046,"iPhone13,2"
com.google.Chrome,674,1724816582,1724817256,1724817256.080964,-18000,,
com.leomehlig.today,20,1724816562,1724816582,1724816582.411121,-18000,,
com.leomehlig.today,342,1724816138,1724816480,1724816480.552031,-18000,,
com.google.Chrome,3165,1724812973,1724816138,1724816138.947507,-18000,,
com.leomehlig.today,50,1724812923,1724812973,1724812973.556859,-18000,,
com.google.Chrome,540,1724812383,1724812923,1724812923.434301,-18000,,
com.google.Chrome,2100,1724798422,1724800522,1724800522.05508,-18000,,
com.google.Chrome,628,1724797149,1724797777,1724797777.7236118,-18000,,
com.leomehlig.today,35,1724797114,1724797149,1724797149.683769,-18000,,
com.google.Chrome,12,1724797102,1724797114,1724797114.1804318,-18000,,
com.leomehlig.today,22,1724797080,1724797102,1724797102.233432,-18000,,
com.google.Chrome,23,1724797057,1724797080,1724797080.417575,-18000,,
com.leomehlig.today,19,1724797038,1724797057,1724797057.4887009,-18000,,
com.google.Chrome,33,1724797005,1724797038,1724797038.5989242,-18000,,
com.leomehlig.today,22,1724796983,1724797005,1724797005.4663482,-18000,,
com.google.Chrome,817,1724796166,1724796983,1724796983.289751,-18000,,
com.leomehlig.today,23,1724796143,1724796166,1724796167.0415769,-18000,,
com.google.Chrome,4,1724796139,1724796143,1724796143.4424481,-18000,,
com.leomehlig.today,1,1724796138,1724796139,1724796139.411705,-18000,,
com.google.Chrome,2,1724796136,1724796138,1724796138.730845,-18000,,
com.leomehlig.today,41,1724796095,1724796136,1724796136.391722,-18000,,
com.google.Chrome,58,1724796037,1724796095,1724796095.631147,-18000,,
com.google.Chrome,581,1724793489,1724794070,1724794070.9417,-18000,,
com.google.Chrome,451,1724792123,1724792574,1724792574.722797,-18000,,
com.google.Chrome,405,1724790530,1724790935,1724790935.3055859,-18000,,
com.apple.iCal,6,1724790524,1724790530,1724790530.809006,-18000,,
com.google.Chrome,187,1724790337,1724790524,1724790524.701854,-18000,,
com.google.Chrome,67,1724786122,1724786189,1724786189.5733008,-18000,,
com.apple.iCal,3,1724786062,1724786065,1724786065.496242,-18000,,
com.apple.iCal,54,1724783181,1724783235,1724783235.6499748,-18000,,
com.google.Chrome,305,1724782876,1724783181,1724783181.790762,-18000,,
com.apple.Notes,60,1724782816,1724782876,1724782876.8686829,-18000,,
com.apple.iCal,53,1724782763,1724782816,1724782816.753211,-18000,,
com.apple.Notes,538,1724782225,1724782763,1724782763.643732,-18000,,
com.google.Chrome,433,1724781792,1724782225,1724782225.5124512,-18000,,
com.google.Chrome,2785,1724774664,1724777449,1724777449.697104,-18000,,
com.google.Chrome,366,1724772274,1724772640,1724772640.5757499,-18000,,
com.apple.Terminal,3,1724772271,1724772274,1724772274.320873,-18000,,
com.google.Chrome,2,1724772269,1724772271,1724772271.118715,-18000,,
com.apple.Terminal,7,1724772262,1724772269,1724772270.0186992,-18000,,
com.google.Chrome,606,1724771656,1724772262,1724772262.853029,-18000,,
com.apple.finder,3,1724771640,1724771643,1724771644.814046,-18000,,
com.anaconda.io,3,1724771637,1724771640,1724771640.6568298,-18000,,
com.apple.Terminal,46,1724771591,1724771637,1724771637.5688071,-18000,,
com.google.Chrome,172,1724771419,1724771591,1724771591.878674,-18000,,
com.anaconda.io,18,1724771401,1724771419,1724771419.20462,-18000,,
com.microsoft.VSCode,39,1724771362,1724771401,1724771401.282384,-18000,,
com.anaconda.io,33,1724771329,1724771362,1724771362.439797,-18000,,
com.apple.finder,23,1724771306,1724771329,1724771329.429597,-18000,,
com.anaconda.io,4,1724771302,1724771306,1724771306.684939,-18000,,
com.apple.finder,3,1724771277,1724771280,1724771280.166874,-18000,,
com.google.Chrome,3,1724771266,1724771269,1724771275.051471,-18000,,
com.apple.finder,3,1724771263,1724771266,1724771273.090615,-18000,,
com.apple.finder,3,1724771233,1724771236,1724771238.011544,-18000,,
com.apple.installer,4,1724771229,1724771233,1724771233.390757,-18000,,
com.apple.systempreferences,35,1724771194,1724771229,1724771229.948618,-18000,,
com.apple.installer,14,1724771174,1724771188,1724771188.247417,-18000,,
com.apple.finder,3,1724771109,1724771112,1724771112.82332,-18000,,
com.apple.installer,1,1724771108,1724771109,1724771109.2579908,-18000,,
com.google.Chrome,6,1724771102,1724771108,1724771108.348243,-18000,,
com.apple.installer,10,1724771092,1724771102,1724771102.533385,-18000,,
com.apple.finder,14,1724771078,1724771092,1724771092.6545029,-18000,,
com.apple.installer,39,1724771039,1724771078,1724771078.341609,-18000,,
com.apple.systempreferences,5,1724771034,1724771039,1724771039.430412,-18000,,
com.apple.installer,4,1724771030,1724771034,1724771034.565685,-18000,,
com.leomehlig.today,1,1724771029,1724771030,1724771030.982862,-18000,,
com.apple.installer,51,1724770978,1724771029,1724771030.008132,-18000,,
com.google.Chrome,8,1724770970,1724770978,1724770978.053699,-18000,,
com.apple.systempreferences,32,1724770938,1724770970,1724770970.8454819,-18000,,
com.apple.installer,17,1724770914,1724770931,1724770931.860734,-18000,,
com.apple.systempreferences,1,1724770913,1724770914,1724770914.8003569,-18000,,
com.apple.installer,10,1724770903,1724770913,1724770913.4043279,-18000,,
com.apple.systempreferences,4,1724770899,1724770903,1724770903.038293,-18000,,
com.anaconda.io,3,1724770896,1724770899,1724770899.9508948,-18000,,
com.apple.systempreferences,0,1724770871,1724770871,1724770871.4698,-18000,,
com.apple.installer,4,1724770864,1724770868,1724770871.21651,-18000,,
com.apple.finder,3,1724770842,1724770845,1724770845.120541,-18000,,
com.microsoft.VSCode,42,1724770800,1724770842,1724770842.5241451,-18000,,
com.apple.finder,12,1724770788,1724770800,1724770801.024698,-18000,,
com.apple.installer,9,1724770779,1724770788,1724770788.358499,-18000,,
com.apple.finder,50,1724770729,1724770779,1724770779.55764,-18000,,
com.apple.installer,34,1724770695,1724770729,1724770729.850792,-18000,,
com.apple.finder,2,1724770693,1724770695,1724770695.196032,-18000,,
com.google.Chrome,8,1724770685,1724770693,1724770693.3121018,-18000,,
com.apple.installer,7,1724770678,1724770685,1724770685.249609,-18000,,
com.google.Chrome,62,1724770616,1724770678,1724770679.003963,-18000,,
com.apple.installer,30,1724770586,1724770616,1724770616.626596,-18000,,
com.apple.finder,4,1724770528,1724770532,1724770532.3618941,-18000,,
com.google.Chrome,43,1724770485,1724770528,1724770528.484678,-18000,,
com.apple.finder,3,1724770482,1724770485,1724770485.119781,-18000,,
com.apple.dt.Xcode,5,1724770477,1724770482,1724770483.044876,-18000,,
com.apple.finder,5,1724770472,1724770477,1724770478.0598922,-18000,,
com.google.Chrome,8,1724770464,1724770472,1724770472.620384,-18000,,
com.apple.dt.Xcode,10,1724770454,1724770464,1724770464.632409,-18000,,
com.apple.finder,6,1724770448,1724770454,1724770454.0591779,-18000,,
com.google.Chrome,1757,1724768691,1724770448,1724770448.461052,-18000,,
com.google.Chrome,310,1724766789,1724767099,1724767099.185909,-18000,,
com.google.Chrome,553,1724766048,1724766601,1724766601.5010061,-18000,,
com.apple.mobiletimer,13,1724730973,1724730986,1724730986.926742,-18000,EB445137-D7F5-57EC-87DA-1DB460D64046,"iPhone13,2"
com.apple.mobiletimer,6,1724730943,1724730949,1724730949.326359,-18000,EB445137-D7F5-57EC-87DA-1DB460D64046,"iPhone13,2"
com.myfitnesspal.mfp,11,1724730932,1724730943,1724730943.188066,-18000,EB445137-D7F5-57EC-87DA-1DB460D64046,"iPhone13,2"
com.myfitnesspal.mfp,13,1724730916,1724730929,1724730929.5210161,-18000,EB445137-D7F5-57EC-87DA-1DB460D64046,"iPhone13,2"
com.google.Chrome,379,1724730273,1724730652,1724730652.606427,-18000,,
com.apple.finder,5,1724730268,1724730273,1724730273.440741,-18000,,
com.microsoft.Office.Outlook,14,1724729638,1724729652,1724729652.427311,-18000,EB445137-D7F5-57EC-87DA-1DB460D64046,"iPhone13,2"
com.hammerandchisel.discord,29,1724725267,1724725296,1724725296.6008348,-18000,EB445137-D7F5-57EC-87DA-1DB460D64046,"iPhone13,2"
com.hammerandchisel.discord,2,1724725212,1724725214,1724725214.929806,-18000,EB445137-D7F5-57EC-87DA-1DB460D64046,"iPhone13,2"
com.hammerandchisel.discord,7,1724725199,1724725206,1724725206.582912,-18000,EB445137-D7F5-57EC-87DA-1DB460D64046,"iPhone13,2"
com.hammerandchisel.discord,6,1724725178,1724725184,1724725184.979618,-18000,EB445137-D7F5-57EC-87DA-1DB460D64046,"iPhone13,2"
com.hammerandchisel.discord,2,1724725168,1724725170,1724725170.751511,-18000,EB445137-D7F5-57EC-87DA-1DB460D64046,"iPhone13,2"
com.hammerandchisel.discord,8,1724725150,1724725158,1724725158.844596,-18000,EB445137-D7F5-57EC-87DA-1DB460D64046,"iPhone13,2"
com.hammerandchisel.discord,17,1724725016,1724725033,1724725033.118631,-18000,EB445137-D7F5-57EC-87DA-1DB460D64046,"iPhone13,2"
com.instructure.icanvas,2,1724725014,1724725016,1724725016.1259332,-18000,EB445137-D7F5-57EC-87DA-1DB460D64046,"iPhone13,2"
com.instructure.icanvas,5,1724723290,1724723295,1724723295.232778,-18000,EB445137-D7F5-57EC-87DA-1DB460D64046,"iPhone13,2"
com.instructure.icanvas,15,1724722940,1724722955,1724722955.6750321,-18000,EB445137-D7F5-57EC-87DA-1DB460D64046,"iPhone13,2"
com.apple.weather,6,1724722934,1724722940,1724722940.3226619,-18000,EB445137-D7F5-57EC-87DA-1DB460D64046,"iPhone13,2"
com.apple.weather,4,1724722733,1724722737,1724722737.138006,-18000,EB445137-D7F5-57EC-87DA-1DB460D64046,"iPhone13,2"
com.google.Maps,3,1724722730,1724722733,1724722733.206955,-18000,EB445137-D7F5-57EC-87DA-1DB460D64046,"iPhone13,2"
com.google.Maps,9,1724719646,1724719655,1724719655.817286,-18000,EB445137-D7F5-57EC-87DA-1DB460D64046,"iPhone13,2"
com.google.Maps,16,1724719529,1724719545,1724719545.936728,-18000,EB445137-D7F5-57EC-87DA-1DB460D64046,"iPhone13,2"
com.google.Maps,19,1724719468,1724719487,1724719487.81921,-18000,EB445137-D7F5-57EC-87DA-1DB460D64046,"iPhone13,2"
com.google.Maps,14,1724719409,1724719423,1724719423.762681,-18000,EB445137-D7F5-57EC-87DA-1DB460D64046,"iPhone13,2"
com.google.Maps,48,1724719194,1724719242,1724719242.580203,-18000,EB445137-D7F5-57EC-87DA-1DB460D64046,"iPhone13,2"
com.hindsightlabs.paprika.ios.v3,1,1724719189,1724719190,1724719190.87883,-18000,EB445137-D7F5-57EC-87DA-1DB460D64046,"iPhone13,2"
com.hindsightlabs.paprika.ios.v3,6,1724719135,1724719141,1724719141.22137,-18000,EB445137-D7F5-57EC-87DA-1DB460D64046,"iPhone13,2"
com.hindsightlabs.paprika.ios.v3,27,1724719107,1724719134,1724719134.054309,-18000,EB445137-D7F5-57EC-87DA-1DB460D64046,"iPhone13,2"
com.apple.mobilecal,6,1724719097,1724719103,1724719103.390341,-18000,EB445137-D7F5-57EC-87DA-1DB460D64046,"iPhone13,2"
com.apple.mobilecal,3,1724719071,1724719074,1724719074.362056,-18000,EB445137-D7F5-57EC-87DA-1DB460D64046,"iPhone13,2"
com.apple.mobilecal,1,1724719069,1724719070,1724719070.8300838,-18000,EB445137-D7F5-57EC-87DA-1DB460D64046,"iPhone13,2"
com.apple.mobilecal,16,1724719053,1724719069,1724719069.285604,-18000,EB445137-D7F5-57EC-87DA-1DB460D64046,"iPhone13,2"
com.leomehlig.today,3,1724719049,1724719052,1724719052.213959,-18000,EB445137-D7F5-57EC-87DA-1DB460D64046,"iPhone13,2"
com.toyopagroup.picaboo,11,1724719006,1724719017,1724719017.630175,-18000,EB445137-D7F5-57EC-87DA-1DB460D64046,"iPhone13,2"
com.burbn.instagram,17,1724716095,1724716112,1724716112.786679,-18000,EB445137-D7F5-57EC-87DA-1DB460D64046,"iPhone13,2"
com.burbn.instagram,45,1724716041,1724716086,1724716086.796366,-18000,EB445137-D7F5-57EC-87DA-1DB460D64046,"iPhone13,2"
com.toyopagroup.picaboo,7,1724715340,1724715347,1724715348.394475,-18000,EB445137-D7F5-57EC-87DA-1DB460D64046,"iPhone13,2"
com.myfitnesspal.mfp,2,1724715337,1724715339,1724715339.9455519,-18000,EB445137-D7F5-57EC-87DA-1DB460D64046,"iPhone13,2"
com.myfitnesspal.mfp,10,1724715212,1724715222,1724715222.414053,-18000,EB445137-D7F5-57EC-87DA-1DB460D64046,"iPhone13,2"
com.myfitnesspal.mfp,1,1724715016,1724715017,1724715017.514045,-18000,EB445137-D7F5-57EC-87DA-1DB460D64046,"iPhone13,2"
com.myfitnesspal.mfp,3,1724714932,1724714935,1724714935.5574489,-18000,EB445137-D7F5-57EC-87DA-1DB460D64046,"iPhone13,2"
com.myfitnesspal.mfp,2,1724714880,1724714882,1724714882.904344,-18000,EB445137-D7F5-57EC-87DA-1DB460D64046,"iPhone13,2"
com.myfitnesspal.mfp,2,1724714810,1724714812,1724714812.999517,-18000,EB445137-D7F5-57EC-87DA-1DB460D64046,"iPhone13,2"
com.myfitnesspal.mfp,27,1724714776,1724714803,1724714803.647015,-18000,EB445137-D7F5-57EC-87DA-1DB460D64046,"iPhone13,2"
com.microsoft.Office.Outlook,14,1724714760,1724714774,1724714774.482218,-18000,EB445137-D7F5-57EC-87DA-1DB460D64046,"iPhone13,2"
com.apple.MobileSMS,4,1724714756,1724714760,1724714760.4143028,-18000,EB445137-D7F5-57EC-87DA-1DB460D64046,"iPhone13,2"
com.apple.MobileSMS,2,1724714741,1724714743,1724714743.897921,-18000,EB445137-D7F5-57EC-87DA-1DB460D64046,"iPhone13,2"
com.toyopagroup.picaboo,5,1724714736,1724714741,1724714741.90245,-18000,EB445137-D7F5-57EC-87DA-1DB460D64046,"iPhone13,2"
com.toyopagroup.picaboo,0,1724714735,1724714735,1724714735.8067951,-18000,EB445137-D7F5-57EC-87DA-1DB460D64046,"iPhone13,2"
com.toyopagroup.picaboo,11,1724712013,1724712024,1724712024.97269,-18000,EB445137-D7F5-57EC-87DA-1DB460D64046,"iPhone13,2"
com.apple.Maps,2,1724712007,1724712009,1724712009.7673678,-18000,EB445137-D7F5-57EC-87DA-1DB460D64046,"iPhone13,2"
com.apple.Maps,55,1724711697,1724711752,1724711753.027525,-18000,EB445137-D7F5-57EC-87DA-1DB460D64046,"iPhone13,2"
com.google.Maps,1,1724711696,1724711697,1724711697.3169599,-18000,EB445137-D7F5-57EC-87DA-1DB460D64046,"iPhone13,2"
com.gosund.smart,4,1724711689,1724711693,1724711693.351035,-18000,EB445137-D7F5-57EC-87DA-1DB460D64046,"iPhone13,2"
com.gosund.smart,2,1724711324,1724711326,1724711326.2256498,-18000,EB445137-D7F5-57EC-87DA-1DB460D64046,"iPhone13,2"
com.gosund.smart,7,1724710541,1724710548,1724710548.4839911,-18000,EB445137-D7F5-57EC-87DA-1DB460D64046,"iPhone13,2"
com.goodreads.Goodreads,10,1724710530,1724710540,1724710541.0205178,-18000,EB445137-D7F5-57EC-87DA-1DB460D64046,"iPhone13,2"
com.goodreads.Goodreads,34,1724710248,1724710282,1724710282.2270021,-18000,EB445137-D7F5-57EC-87DA-1DB460D64046,"iPhone13,2"
com.thestorygraph.thestorygraph,2,1724710243,1724710245,1724710245.926042,-18000,EB445137-D7F5-57EC-87DA-1DB460D64046,"iPhone13,2"
com.thestorygraph.thestorygraph,22,1724710181,1724710203,1724710203.49756,-18000,EB445137-D7F5-57EC-87DA-1DB460D64046,"iPhone13,2"
com.myfitnesspal.mfp,3,1724710176,1724710179,1724710179.6905599,-18000,EB445137-D7F5-57EC-87DA-1DB460D64046,"iPhone13,2"
com.myfitnesspal.mfp,55,1724707343,1724707398,1724707399.04515,-18000,EB445137-D7F5-57EC-87DA-1DB460D64046,"iPhone13,2"
com.google.Sheets,23,1724707320,1724707343,1724707343.14589,-18000,EB445137-D7F5-57EC-87DA-1DB460D64046,"iPhone13,2"
com.myfitnesspal.mfp,25,1724707295,1724707320,1724707320.511106,-18000,EB445137-D7F5-57EC-87DA-1DB460D64046,"iPhone13,2"
com.google.Sheets,30,1724707265,1724707295,1724707295.280606,-18000,EB445137-D7F5-57EC-87DA-1DB460D64046,"iPhone13,2"
com.myfitnesspal.mfp,30,1724707235,1724707265,1724707266.078707,-18000,EB445137-D7F5-57EC-87DA-1DB460D64046,"iPhone13,2"
com.google.Sheets,14,1724707221,1724707235,1724707235.5117211,-18000,EB445137-D7F5-57EC-87DA-1DB460D64046,"iPhone13,2"
com.apple.DocumentsApp,4,1724707213,1724707217,1724707217.512923,-18000,EB445137-D7F5-57EC-87DA-1DB460D64046,"iPhone13,2"
com.myfitnesspal.mfp,24,1724707189,1724707213,1724707213.9109678,-18000,EB445137-D7F5-57EC-87DA-1DB460D64046,"iPhone13,2"
com.myfitnesspal.mfp,8,1724707174,1724707182,1724707182.427156,-18000,EB445137-D7F5-57EC-87DA-1DB460D64046,"iPhone13,2"
com.apple.DocumentsApp,8,1724707166,1724707174,1724707174.236638,-18000,EB445137-D7F5-57EC-87DA-1DB460D64046,"iPhone13,2"
com.apple.finder,316,1724706003,1724706319,1724706319.783623,-18000,,
com.google.Chrome,2,1724706001,1724706003,1724706003.69368,-18000,,
com.apple.finder,13,1724705988,1724706001,1724706001.503331,-18000,,
com.google.Chrome,4,1724705984,1724705988,1724705988.260974,-18000,,
com.apple.finder,79,1724705905,1724705984,1724705984.297748,-18000,,
com.apple.DocumentsApp,121,1724705900,1724706021,1724706021.864509,-18000,EB445137-D7F5-57EC-87DA-1DB460D64046,"iPhone13,2"
com.apple.MobileSMS,8,1724705892,1724705900,1724705900.7998462,-18000,EB445137-D7F5-57EC-87DA-1DB460D64046,"iPhone13,2"
com.apple.MobileSMS,3,1724705889,1724705892,1724705892.8655071,-18000,EB445137-D7F5-57EC-87DA-1DB460D64046,"iPhone13,2"
com.google.Chrome,71,1724705834,1724705905,1724705905.658961,-18000,,
com.apple.iCal,74,1724705760,1724705834,1724705834.3240008,-18000,,
com.apple.MobileSMS,57,1724705143,1724705200,1724705200.37611,-18000,EB445137-D7F5-57EC-87DA-1DB460D64046,"iPhone13,2"
com.apple.MobileAddressBook,10,1724705133,1724705143,1724705143.53595,-18000,EB445137-D7F5-57EC-87DA-1DB460D64046,"iPhone13,2"
com.google.Chrome,642,1724705118,1724705760,1724705760.486181,-18000,,
com.google.Maps,49,1724704871,1724704920,1724704920.879118,-18000,EB445137-D7F5-57EC-87DA-1DB460D64046,"iPhone13,2"
com.leomehlig.today,20,1724704847,1724704867,1724704867.7148662,-18000,EB445137-D7F5-57EC-87DA-1DB460D64046,"iPhone13,2"
com.microsoft.Office.Outlook,27,1724704793,1724704820,1724704820.676334,-18000,EB445137-D7F5-57EC-87DA-1DB460D64046,"iPhone13,2"
com.microsoft.Office.Outlook,6,1724704715,1724704721,1724704721.352556,-18000,EB445137-D7F5-57EC-87DA-1DB460D64046,"iPhone13,2"
com.microsoft.Office.Outlook,3,1724704709,1724704712,1724704712.578079,-18000,EB445137-D7F5-57EC-87DA-1DB460D64046,"iPhone13,2"
com.apple.mobilephone,2,1724704704,1724704706,1724704706.932281,-18000,EB445137-D7F5-57EC-87DA-1DB460D64046,"iPhone13,2"
com.apple.InCallService,354,1724704350,1724704704,1724704704.8981519,-18000,EB445137-D7F5-57EC-87DA-1DB460D64046,"iPhone13,2"
com.google.Chrome,354,1724704243,1724704597,1724704597.469698,-18000,,
com.apple.InCallService,1,1724704175,1724704176,1724704176.632153,-18000,EB445137-D7F5-57EC-87DA-1DB460D64046,"iPhone13,2"
com.apple.InCallService,7,1724704159,1724704166,1724704166.1403952,-18000,EB445137-D7F5-57EC-87DA-1DB460D64046,"iPhone13,2"
com.apple.InCallService,6,1724704148,1724704154,1724704154.427161,-18000,EB445137-D7F5-57EC-87DA-1DB460D64046,"iPhone13,2"
com.apple.InCallService,3,1724704122,1724704125,1724704125.4022222,-18000,EB445137-D7F5-57EC-87DA-1DB460D64046,"iPhone13,2"
com.apple.InCallService,2,1724704113,1724704115,1724704115.1178,-18000,EB445137-D7F5-57EC-87DA-1DB460D64046,"iPhone13,2"
com.apple.InCallService,52,1724704024,1724704076,1724704076.204627,-18000,EB445137-D7F5-57EC-87DA-1DB460D64046,"iPhone13,2"
com.apple.InCallService,6,1724704013,1724704019,1724704019.935655,-18000,EB445137-D7F5-57EC-87DA-1DB460D64046,"iPhone13,2"
com.apple.InCallService,16,1724703992,1724704008,1724704008.7155452,-18000,EB445137-D7F5-57EC-87DA-1DB460D64046,"iPhone13,2"
com.apple.InCallService,6,1724703956,1724703962,1724703962.3360481,-18000,EB445137-D7F5-57EC-87DA-1DB460D64046,"iPhone13,2"
com.apple.InCallService,2,1724703952,1724703954,1724703954.569046,-18000,EB445137-D7F5-57EC-87DA-1DB460D64046,"iPhone13,2"
com.apple.InCallService,1,1724703946,1724703947,1724703947.701818,-18000,EB445137-D7F5-57EC-87DA-1DB460D64046,"iPhone13,2"
com.apple.InCallService,2,1724703936,1724703938,1724703938.672075,-18000,EB445137-D7F5-57EC-87DA-1DB460D64046,"iPhone13,2"
com.apple.InCallService,1,1724703894,1724703895,1724703895.3330622,-18000,EB445137-D7F5-57EC-87DA-1DB460D64046,"iPhone13,2"
com.apple.InCallService,2,1724703885,1724703887,1724703887.259355,-18000,EB445137-D7F5-57EC-87DA-1DB460D64046,"iPhone13,2"
com.apple.InCallService,2,1724703872,1724703874,1724703874.440808,-18000,EB445137-D7F5-57EC-87DA-1DB460D64046,"iPhone13,2"
com.apple.InCallService,2,1724703234,1724703236,1724703236.502886,-18000,EB445137-D7F5-57EC-87DA-1DB460D64046,"iPhone13,2"
com.apple.InCallService,1,1724703229,1724703230,1724703230.540242,-18000,EB445137-D7F5-57EC-87DA-1DB460D64046,"iPhone13,2"
com.apple.InCallService,2,1724703206,1724703208,1724703209.00333,-18000,EB445137-D7F5-57EC-87DA-1DB460D64046,"iPhone13,2"
com.apple.mobilephone,15,1724703191,1724703206,1724703206.4911351,-18000,EB445137-D7F5-57EC-87DA-1DB460D64046,"iPhone13,2"
com.apple.findmy,11,1724703180,1724703191,1724703191.926951,-18000,EB445137-D7F5-57EC-87DA-1DB460D64046,"iPhone13,2"
com.microsoft.Office.Outlook,32,1724703139,1724703171,1724703171.56783,-18000,EB445137-D7F5-57EC-87DA-1DB460D64046,"iPhone13,2"
com.ally.MobileBanking,7,1724703132,1724703139,1724703139.857933,-18000,EB445137-D7F5-57EC-87DA-1DB460D64046,"iPhone13,2"
com.ally.MobileBanking,39,1724702713,1724702752,1724702752.817824,-18000,EB445137-D7F5-57EC-87DA-1DB460D64046,"iPhone13,2"
com.google.Chrome,903,1724702525,1724703428,1724703428.374881,-18000,,
com.truebill.truebillnative,237,1724702253,1724702490,1724702490.493973,-18000,EB445137-D7F5-57EC-87DA-1DB460D64046,"iPhone13,2"
com.gosund.smart,2,1724702251,1724702253,1724702253.753129,-18000,EB445137-D7F5-57EC-87DA-1DB460D64046,"iPhone13,2"
com.gosund.smart,61,1724702096,1724702157,1724702157.747004,-18000,EB445137-D7F5-57EC-87DA-1DB460D64046,"iPhone13,2"
com.apple.findmy,3,1724702093,1724702096,1724702097.132283,-18000,EB445137-D7F5-57EC-87DA-1DB460D64046,"iPhone13,2"
com.apple.findmy,30,1724702019,1724702049,1724702050.023087,-18000,EB445137-D7F5-57EC-87DA-1DB460D64046,"iPhone13,2"
com.google.Chrome,528,1724701951,1724702479,1724702479.641614,-18000,,
com.google.Gmail,34,1724701908,1724701942,1724701942.5446439,-18000,EB445137-D7F5-57EC-87DA-1DB460D64046,"iPhone13,2"
com.gosund.smart,8,1724701900,1724701908,1724701908.946165,-18000,EB445137-D7F5-57EC-87DA-1DB460D64046,"iPhone13,2"
com.gosund.smart,21,1724701740,1724701761,1724701761.756448,-18000,EB445137-D7F5-57EC-87DA-1DB460D64046,"iPhone13,2"
com.gosund.smart,6,1724700467,1724700473,1724700473.208708,-18000,EB445137-D7F5-57EC-87DA-1DB460D64046,"iPhone13,2"
com.gosund.smart,144,1724699952,1724700096,1724700096.083342,-18000,EB445137-D7F5-57EC-87DA-1DB460D64046,"iPhone13,2"
com.apple.Preferences,7,1724699945,1724699952,1724699952.0531402,-18000,EB445137-D7F5-57EC-87DA-1DB460D64046,"iPhone13,2"
com.gosund.smart,13,1724699932,1724699945,1724699945.163141,-18000,EB445137-D7F5-57EC-87DA-1DB460D64046,"iPhone13,2"
com.apple.Preferences,18,1724699914,1724699932,1724699932.998004,-18000,EB445137-D7F5-57EC-87DA-1DB460D64046,"iPhone13,2"
com.gosund.smart,83,1724699831,1724699914,1724699914.7889462,-18000,EB445137-D7F5-57EC-87DA-1DB460D64046,"iPhone13,2"
com.apple.Preferences,3,1724699828,1724699831,1724699831.588407,-18000,EB445137-D7F5-57EC-87DA-1DB460D64046,"iPhone13,2"
com.gosund.smart,72,1724699756,1724699828,1724699828.832032,-18000,EB445137-D7F5-57EC-87DA-1DB460D64046,"iPhone13,2"
com.google.Gmail,6,1724699750,1724699756,1724699756.539606,-18000,EB445137-D7F5-57EC-87DA-1DB460D64046,"iPhone13,2"
com.gosund.smart,69,1724699681,1724699750,1724699750.489749,-18000,EB445137-D7F5-57EC-87DA-1DB460D64046,"iPhone13,2"
com.google.chrome.ios,81,1724699600,1724699681,1724699682.031464,-18000,EB445137-D7F5-57EC-87DA-1DB460D64046,"iPhone13,2"
com.apple.camera,10,1724699590,1724699600,1724699600.475918,-18000,EB445137-D7F5-57EC-87DA-1DB460D64046,"iPhone13,2"
com.apple.AppStore,38,1724699552,1724699590,1724699590.751507,-18000,EB445137-D7F5-57EC-87DA-1DB460D64046,"iPhone13,2"
com.toyopagroup.picaboo,7,1724699533,1724699540,1724699540.48582,-18000,EB445137-D7F5-57EC-87DA-1DB460D64046,"iPhone13,2"
com.toyopagroup.picaboo,19,1724698162,1724698181,1724698181.473007,-18000,EB445137-D7F5-57EC-87DA-1DB460D64046,"iPhone13,2"
com.apple.mobilecal,5,1724698141,1724698146,1724698146.8066359,-18000,EB445137-D7F5-57EC-87DA-1DB460D64046,"iPhone13,2"
com.apple.mobilecal,24,1724694480,1724694504,1724694504.68137,-18000,EB445137-D7F5-57EC-87DA-1DB460D64046,"iPhone13,2"
com.apple.mobilecal,2,1724694477,1724694479,1724694479.58253,-18000,EB445137-D7F5-57EC-87DA-1DB460D64046,"iPhone13,2"
com.myfitnesspal.mfp,3,1724694083,1724694086,1724694086.189067,-18000,EB445137-D7F5-57EC-87DA-1DB460D64046,"iPhone13,2"
com.myfitnesspal.mfp,2,1724694069,1724694071,1724694071.7023602,-18000,EB445137-D7F5-57EC-87DA-1DB460D64046,"iPhone13,2"
com.apple.camera,4,1724693870,1724693874,1724693874.714913,-18000,EB445137-D7F5-57EC-87DA-1DB460D64046,"iPhone13,2"
com.myfitnesspal.mfp,5,1724693869,1724693874,1724693874.582267,-18000,EB445137-D7F5-57EC-87DA-1DB460D64046,"iPhone13,2"
com.myfitnesspal.mfp,33,1724692960,1724692993,1724692993.426811,-18000,EB445137-D7F5-57EC-87DA-1DB460D64046,"iPhone13,2"
com.google.Chrome,906,1724692706,1724693612,1724693613.003612,-18000,,
com.myfitnesspal.mfp,74,1724692581,1724692655,1724692655.908961,-18000,EB445137-D7F5-57EC-87DA-1DB460D64046,"iPhone13,2"
com.myfitnesspal.mfp,5,1724692236,1724692241,1724692241.5688028,-18000,EB445137-D7F5-57EC-87DA-1DB460D64046,"iPhone13,2"
com.myfitnesspal.mfp,3,1724692218,1724692221,1724692221.8909512,-18000,EB445137-D7F5-57EC-87DA-1DB460D64046,"iPhone13,2"
com.myfitnesspal.mfp,105,1724691680,1724691785,1724691785.3542051,-18000,EB445137-D7F5-57EC-87DA-1DB460D64046,"iPhone13,2"
com.apple.calculator,2,1724691677,1724691679,1724691679.834611,-18000,EB445137-D7F5-57EC-87DA-1DB460D64046,"iPhone13,2"
com.google.Chrome,943,1724691616,1724692559,1724692559.6538901,-18000,,
com.apple.calculator,4,1724691469,1724691473,1724691473.391746,-18000,EB445137-D7F5-57EC-87DA-1DB460D64046,"iPhone13,2"
com.discoverfinancial.mobile,3,1724690818,1724690821,1724690821.886369,-18000,EB445137-D7F5-57EC-87DA-1DB460D64046,"iPhone13,2"
com.google.Chrome,146,1724690684,1724690830,1724690830.4113588,-18000,,
com.discoverfinancial.mobile,242,1724690398,1724690640,1724690640.833321,-18000,EB445137-D7F5-57EC-87DA-1DB460D64046,"iPhone13,2"
com.microsoft.Office.Outlook,95,1724690302,1724690397,1724690397.512938,-18000,EB445137-D7F5-57EC-87DA-1DB460D64046,"iPhone13,2"
com.google.Maps,4,1724690298,1724690302,1724690302.879803,-18000,EB445137-D7F5-57EC-87DA-1DB460D64046,"iPhone13,2"
com.apple.iCal,18,1724689882,1724689900,1724689900.976849,-18000,,
com.google.Chrome,135,1724689747,1724689882,1724689882.1312342,-18000,,
com.apple.iCal,2,1724689745,1724689747,1724689747.606632,-18000,,
com.google.Chrome,86,1724689659,1724689745,1724689745.4530659,-18000,,
com.apple.iCal,19,1724689640,1724689659,1724689659.6030998,-18000,,
com.google.Chrome,3,1724689637,1724689640,1724689640.687529,-18000,,
com.apple.iCal,18,1724689619,1724689637,1724689637.182438,-18000,,
com.google.Chrome,4,1724689615,1724689619,1724689619.250696,-18000,,
com.apple.iCal,9,1724689606,1724689615,1724689615.386743,-18000,,
com.google.Chrome,106,1724689500,1724689606,1724689606.418675,-18000,,
com.google.Maps,25,1724688469,1724688494,1724688494.979156,-18000,EB445137-D7F5-57EC-87DA-1DB460D64046,"iPhone13,2"
com.google.Maps,35,1724688420,1724688455,1724688455.107043,-18000,EB445137-D7F5-57EC-87DA-1DB460D64046,"iPhone13,2"
com.amazon.Amazon,2,1724688415,1724688417,1724688417.368641,-18000,EB445137-D7F5-57EC-87DA-1DB460D64046,"iPhone13,2"
com.amazon.Amazon,18,1724688355,1724688373,1724688373.760569,-18000,EB445137-D7F5-57EC-87DA-1DB460D64046,"iPhone13,2"
com.apple.MobileSMS,2,1724688350,1724688352,1724688352.860911,-18000,EB445137-D7F5-57EC-87DA-1DB460D64046,"iPhone13,2"
com.apple.MobileSMS,6,1724688331,1724688337,1724688337.6305509,-18000,EB445137-D7F5-57EC-87DA-1DB460D64046,"iPhone13,2"
com.apple.MobileSMS,4,1724688326,1724688330,1724688330.480362,-18000,EB445137-D7F5-57EC-87DA-1DB460D64046,"iPhone13,2"
com.apple.MobileSMS,9,1724688295,1724688304,1724688304.093848,-18000,EB445137-D7F5-57EC-87DA-1DB460D64046,"iPhone13,2"
com.apple.MobileSMS,4,1724687517,1724687521,1724687521.163445,-18000,EB445137-D7F5-57EC-87DA-1DB460D64046,"iPhone13,2"
com.google.Chrome,73,1724682293,1724682366,1724682366.983885,-18000,,
com.apple.iCal,7,1724682286,1724682293,1724682293.2731051,-18000,,
com.google.Chrome,101,1724682185,1724682286,1724682286.7478418,-18000,,
com.google.Chrome,329,1724681555,1724681884,1724681884.484167,-18000,,
com.apple.finder,9,1724681380,1724681389,1724681389.846541,-18000,,
com.google.Chrome,7,1724681373,1724681380,1724681380.916397,-18000,,
com.apple.MobileSMS,7,1724681043,1724681050,1724681050.897039,-18000,,
com.apple.MobileSMS,46,1724638882,1724638928,1724638929.121954,-18000,,
com.google.Chrome,685,1724638197,1724638882,1724638882.7156758,-18000,,
com.microsoft.onenote.mac,34,1724638163,1724638197,1724638197.93625,-18000,,
com.microsoft.onenote.mac,4,1724637054,1724637058,1724637058.8995261,-18000,,
com.google.Chrome,549,1724636505,1724637054,1724637054.546812,-18000,,
com.microsoft.onenote.mac,78,1724636358,1724636436,1724636436.446502,-18000,,
com.google.Chrome,22,1724636336,1724636358,1724636358.048917,-18000,,
com.microsoft.onenote.mac,1,1724636335,1724636336,1724636336.731179,-18000,,
com.apple.calculator,2,1724636333,1724636335,1724636335.684063,-18000,,
com.microsoft.onenote.mac,21,1724636312,1724636333,1724636333.751449,-18000,,
com.apple.calculator,15,1724636297,1724636312,1724636312.7131581,-18000,,
com.microsoft.onenote.mac,7,1724636290,1724636297,1724636297.936713,-18000,,
com.google.Chrome,1,1724636289,1724636290,1724636290.6597872,-18000,,
com.microsoft.onenote.mac,17,1724636272,1724636289,1724636289.832057,-18000,,
com.google.Chrome,74,1724636198,1724636272,1724636272.759023,-18000,,
com.google.Chrome,2847,1724633247,1724636094,1724636094.5953588,-18000,,
com.google.Chrome,922,1724630686,1724631608,1724631608.867619,-18000,,
com.leomehlig.today,36,1724630650,1724630686,1724630686.5129771,-18000,,
com.leomehlig.today,3,1724623725,1724623728,1724623728.58289,-18000,,
com.apple.finder,0,1724623725,1724623725,1724623725.806056,-18000,,
com.apple.iCal,33,1724623692,1724623725,1724623725.095974,-18000,,
com.google.Chrome,308,1724623384,1724623692,1724623692.485276,-18000,,
com.apple.systempreferences,1,1724623368,1724623369,1724623370.5105848,-18000,,
com.google.Chrome,15,1724623329,1724623344,1724623344.7736778,-18000,,
com.apple.iCal,1,1724623328,1724623329,1724623329.6550179,-18000,,
com.google.Chrome,1,1724623327,1724623328,1724623328.511421,-18000,,
com.apple.iCal,3,1724623324,1724623327,1724623327.542756,-18000,,
com.google.Chrome,2,1724623322,1724623324,1724623324.828584,-18000,,
com.microsoft.Excel,180,1724623142,1724623322,1724623322.510827,-18000,,
com.microsoft.Excel,272,1724610383,1724610655,1724610655.6017299,-18000,,
com.google.Chrome,363,1724610020,1724610383,1724610383.123007,-18000,,
com.microsoft.Excel,3,1724610017,1724610020,1724610020.4203691,-18000,,
com.apple.Notes,22,1724609995,1724610017,1724610017.6845489,-18000,,
com.google.Chrome,9,1724609986,1724609995,1724609995.940561,-18000,,
com.google.Chrome,161,1724607867,1724608028,1724608028.132973,-18000,,
com.apple.iCal,47,1724607820,1724607867,1724607867.776585,-18000,,
com.apple.iCal,125,1724607460,1724607585,1724607585.942739,-18000,,
com.google.Chrome,4,1724607456,1724607460,1724607460.990292,-18000,,
com.apple.iCal,8,1724607448,1724607456,1724607456.820354,-18000,,
com.google.Chrome,2,1724607446,1724607448,1724607448.288711,-18000,,
com.apple.iCal,8,1724607438,1724607446,1724607446.127603,-18000,,
com.google.Chrome,7,1724607431,1724607438,1724607438.4691339,-18000,,
com.apple.iCal,20,1724607411,1724607431,1724607431.903372,-18000,,
com.google.Chrome,12,1724607399,1724607411,1724607411.0333061,-18000,,
com.microsoft.Outlook,0,1724607399,1724607399,1724607399.7632,-18000,,
com.apple.iCal,2,1724607397,1724607399,1724607399.1325788,-18000,,
com.google.Chrome,5,1724607392,1724607397,1724607397.625008,-18000,,
com.apple.iCal,4,1724607388,1724607392,1724607392.44145,-18000,,
com.google.Chrome,10,1724607378,1724607388,1724607388.6488528,-18000,,
com.apple.iCal,3,1724607375,1724607378,1724607378.45326,-18000,,
com.google.Chrome,16,1724607359,1724607375,1724607375.354003,-18000,,
com.apple.iCal,5,1724607258,1724607263,1724607263.458128,-18000,,
com.google.Chrome,7,1724607251,1724607258,1724607259.000691,-18000,,
com.microsoft.Excel,191,1724607060,1724607251,1724607251.947335,-18000,,
com.leomehlig.today,29,1724607031,1724607060,1724607060.1344671,-18000,,
com.microsoft.Excel,263,1724606768,1724607031,1724607031.958181,-18000,,
com.apple.iCal,1,1724606767,1724606768,1724606768.9446359,-18000,,
com.microsoft.Excel,0,1724606767,1724606767,1724606767.50509,-18000,,
com.apple.iCal,2,1724606765,1724606767,1724606767.119488,-18000,,
com.microsoft.Excel,5,1724606760,1724606765,1724606765.833547,-18000,,
com.apple.iCal,1,1724606759,1724606760,1724606761.001484,-18000,,
com.microsoft.Excel,1,1724606758,1724606759,1724606759.951606,-18000,,
com.apple.iCal,2,1724606756,1724606758,1724606758.478523,-18000,,
com.microsoft.Excel,1,1724606755,1724606756,1724606756.620619,-18000,,
com.apple.iCal,1,1724606754,1724606755,1724606755.6475391,-18000,,
com.microsoft.Excel,3,1724606751,1724606754,1724606754.386362,-18000,,
com.apple.iCal,1,1724606750,1724606751,1724606751.666528,-18000,,
com.microsoft.Excel,3,1724606747,1724606750,1724606750.374148,-18000,,
com.apple.iCal,1,1724606746,1724606747,1724606747.923469,-18000,,
com.microsoft.Excel,11,1724606735,1724606746,1724606746.150116,-18000,,
com.apple.iCal,2,1724606733,1724606735,1724606735.109338,-18000,,
com.microsoft.Excel,2,1724606731,1724606733,1724606733.7274451,-18000,,
com.apple.iCal,6,1724606725,1724606731,1724606731.042973,-18000,,
com.microsoft.Excel,12,1724606713,1724606725,1724606725.752451,-18000,,
com.apple.iCal,2,1724606711,1724606713,1724606713.965193,-18000,,
com.microsoft.Excel,9,1724606702,1724606711,1724606711.146426,-18000,,
com.apple.iCal,4,1724606698,1724606702,1724606702.3029819,-18000,,
com.microsoft.Excel,16,1724606682,1724606698,1724606698.7991362,-18000,,
com.apple.iCal,4,1724606678,1724606682,1724606682.20801,-18000,,
com.microsoft.Excel,12,1724606666,1724606678,1724606678.51875,-18000,,
com.apple.iCal,1,1724606665,1724606666,1724606666.09137,-18000,,
com.microsoft.Excel,2,1724606663,1724606665,1724606665.044879,-18000,,
com.apple.iCal,3,1724606660,1724606663,1724606663.691718,-18000,,
com.microsoft.Excel,10,1724606650,1724606660,1724606660.868626,-18000,,
com.apple.iCal,4,1724606646,1724606650,1724606650.1902518,-18000,,
com.microsoft.Excel,23,1724606623,1724606646,1724606646.531602,-18000,,
com.apple.iCal,1,1724606622,1724606623,1724606623.9087682,-18000,,
com.microsoft.Excel,23,1724606599,1724606622,1724606622.587459,-18000,,
com.apple.iCal,1,1724606598,1724606599,1724606599.74561,-18000,,
com.microsoft.Excel,2,1724606596,1724606598,1724606598.418689,-18000,,
com.apple.iCal,3,1724606593,1724606596,1724606596.974956,-18000,,
com.microsoft.Excel,157,1724606436,1724606593,1724606593.765279,-18000,,
com.apple.finder,17,1724606419,1724606436,1724606436.55962,-18000,,
com.leomehlig.today,56,1724606363,1724606419,1724606419.0528212,-18000,,
com.google.Chrome,29,1724606334,1724606363,1724606363.758667,-18000,,
com.apple.iCal,19,1724606315,1724606334,1724606334.698999,-18000,,
com.google.Chrome,136,1724606179,1724606315,1724606315.057557,-18000,,
com.apple.iCal,10,1724606169,1724606179,1724606179.969374,-18000,,
com.microsoft.Outlook,18,1724606151,1724606169,1724606169.262394,-18000,,
com.microsoft.Outlook,320,1724602756,1724603076,1724603076.0853438,-18000,,
com.google.Chrome,26,1724602730,1724602756,1724602756.296653,-18000,,
com.microsoft.Outlook,18,1724602712,1724602730,1724602730.068938,-18000,,
com.google.Chrome,99,1724602613,1724602712,1724602712.4367971,-18000,,
com.microsoft.Outlook,151,1724602402,1724602553,1724602553.6990972,-18000,,
com.google.Chrome,33,1724602369,1724602402,1724602402.273285,-18000,,
com.microsoft.Outlook,39,1724602330,1724602369,1724602369.476476,-18000,,
com.google.Chrome,309,1724602021,1724602330,1724602330.55659,-18000,,
com.microsoft.Outlook,93,1724601928,1724602021,1724602021.148628,-18000,,
com.google.Chrome,2,1724601926,1724601928,1724601928.175218,-18000,,
com.google.Chrome,460,1724569162,1724569622,1724569622.420954,-18000,,
com.google.Chrome,1586,1724534555,1724536141,1724536141.076662,-18000,,
com.google.Chrome,771,1724533779,1724534550,1724534550.630952,-18000,,
com.google.Chrome,613,1724532519,1724533132,1724533132.425737,-18000,,
com.google.Chrome,1081,1724530658,1724531739,1724531739.295733,-18000,,
com.google.Chrome,812,1724529605,1724530417,1724530417.1783051,-18000,,
com.microsoft.Outlook,5,1724529600,1724529605,1724529605.1106071,-18000,,
com.google.Chrome,590,1724529010,1724529600,1724529600.685178,-18000,,
com.microsoft.Outlook,7,1724529003,1724529010,1724529010.358237,-18000,,
com.google.Chrome,171,1724528832,1724529003,1724529003.755188,-18000,,
com.microsoft.Outlook,15,1724528817,1724528832,1724528832.9393358,-18000,,
com.google.Chrome,9,1724528808,1724528817,1724528817.664846,-18000,,
com.google.Chrome,38,1724514792,1724514830,1724514830.423969,-18000,,
com.apple.systempreferences,98,1724514694,1724514792,1724514792.328604,-18000,,
com.google.Chrome,190,1724514498,1724514688,1724514688.7096992,-18000,,
com.google.Chrome,168,1724513958,1724514126,1724514126.636522,-18000,,
com.apple.MobileSMS,30,1724513928,1724513958,1724513958.2603369,-18000,,
com.google.Chrome,551,1724513377,1724513928,1724513928.150508,-18000,,
com.google.Chrome,874,1724443515,1724444389,1724444389.389577,-18000,,
com.apple.keychainaccess,2,1724443513,1724443515,1724443515.366415,-18000,,
com.google.Chrome,2,1724443511,1724443513,1724443513.4917622,-18000,,
com.apple.keychainaccess,1,1724443510,1724443511,1724443511.450879,-18000,,
com.google.Chrome,3,1724443507,1724443510,1724443510.387395,-18000,,
com.apple.keychainaccess,2,1724443505,1724443507,1724443507.2648048,-18000,,
com.google.Chrome,1,1724443504,1724443505,1724443505.817354,-18000,,
com.apple.keychainaccess,2,1724443502,1724443504,1724443504.720686,-18000,,
com.google.Chrome,1,1724443501,1724443502,1724443502.609909,-18000,,
com.apple.keychainaccess,1,1724443500,1724443501,1724443501.398977,-18000,,
com.google.Chrome,2,1724443498,1724443500,1724443500.305444,-18000,,
com.apple.keychainaccess,1,1724443497,1724443498,1724443498.3134131,-18000,,
com.google.Chrome,1,1724443496,1724443497,1724443497.3276281,-18000,,
com.apple.keychainaccess,1,1724443495,1724443496,1724443496.287375,-18000,,
com.google.Chrome,1,1724443494,1724443495,1724443495.589648,-18000,,
com.apple.keychainaccess,1,1724443493,1724443494,1724443494.463484,-18000,,
com.google.Chrome,1,1724443492,1724443493,1724443493.0606642,-18000,,
com.apple.keychainaccess,3,1724443489,1724443492,1724443492.374436,-18000,,
com.google.Chrome,2,1724443487,1724443489,1724443489.407507,-18000,,
com.apple.keychainaccess,1,1724443486,1724443487,1724443487.817713,-18000,,
com.google.Chrome,273,1724443204,1724443477,1724443477.878049,-18000,,
com.apple.calculator,1,1724443203,1724443204,1724443204.059194,-18000,,
com.google.Chrome,5,1724443198,1724443203,1724443203.218821,-18000,,
com.apple.calculator,9,1724443189,1724443198,1724443198.801365,-18000,,
com.apple.finder,1,1724443188,1724443189,1724443189.5789518,-18000,,
com.google.Chrome,17,1724443171,1724443188,1724443188.415135,-18000,,
com.apple.systempreferences,10,1724443161,1724443171,1724443171.212977,-18000,,
com.google.Chrome,3,1724443156,1724443159,1724443159.916356,-18000,,
com.apple.keychainaccess,61,1724443056,1724443117,1724443118.0370111,-18000,,
com.google.Chrome,47,1724443009,1724443056,1724443056.755861,-18000,,
com.apple.keychainaccess,149,1724442860,1724443009,1724443009.708657,-18000,,
com.google.Chrome,114,1724442733,1724442847,1724442847.112134,-18000,,
com.google.Chrome,78,1724441529,1724441607,1724441607.910006,-18000,,
com.apple.MobileSMS,111,1724441207,1724441318,1724441318.7054582,-18000,,
com.google.Chrome,46,1724441161,1724441207,1724441207.416039,-18000,,
com.apple.MobileSMS,68,1724441093,1724441161,1724441161.817543,-18000,,
com.google.Chrome,468,1724440625,1724441093,1724441093.921243,-18000,,
com.google.Chrome,166,1724433972,1724434138,1724434138.1284251,-18000,,
com.google.Chrome,341,1724433630,1724433971,1724433971.4076428,-18000,,
com.google.Chrome,2197,1724429443,1724431640,1724431640.792053,-18000,,
com.apple.MobileSMS,14,1724429429,1724429443,1724429443.57299,-18000,,
com.microsoft.Outlook,4,1724429425,1724429429,1724429429.257191,-18000,,
com.microsoft.Outlook,11,1724427784,1724427795,1724427795.9984078,-18000,,
com.google.Chrome,19,1724427765,1724427784,1724427784.647584,-18000,,
com.microsoft.Outlook,26,1724427739,1724427765,1724427765.7516189,-18000,,
com.apple.systempreferences,131,1724427608,1724427739,1724427739.683827,-18000,,
com.apple.finder,4,1724427598,1724427602,1724427602.648221,-18000,,
com.microsoft.Outlook,6,1724427592,1724427598,1724427598.885602,-18000,,
com.google.Chrome,886,1724426706,1724427592,1724427592.848727,-18000,,
com.apple.Notes,6,1724426608,1724426614,1724426614.787869,-18000,,
com.google.Chrome,5,1724426603,1724426608,1724426608.557652,-18000,,
com.google.Chrome,1019,1724367587,1724368606,1724368606.721256,-18000,,
com.google.Chrome,300,1724366999,1724367299,1724367299.67361,-18000,,
com.google.Chrome,529,1724366435,1724366964,1724366964.1405501,-18000,,
com.google.Chrome,368,1724366057,1724366425,1724366425.0590959,-18000,,
com.google.Chrome,311,1724365708,1724366019,1724366019.3136458,-18000,,
com.google.Chrome,290,1724363236,1724363526,1724363527.033904,-18000,,
com.apple.iCal,3,1724363233,1724363236,1724363236.20187,-18000,,
com.google.Chrome,1,1724363232,1724363233,1724363233.529609,-18000,,
com.apple.iCal,21,1724363211,1724363232,1724363232.957804,-18000,,
com.google.Chrome,2,1724363209,1724363211,1724363211.987694,-18000,,
com.apple.iCal,10,1724363199,1724363209,1724363209.372941,-18000,,
com.google.Chrome,1,1724363198,1724363199,1724363199.645762,-18000,,
com.apple.iCal,6,1724363192,1724363198,1724363198.3654299,-18000,,
com.google.Chrome,614,1724362578,1724363192,1724363192.793947,-18000,,
com.microsoft.Outlook,1,1724362577,1724362578,1724362578.527402,-18000,,
com.google.Chrome,10,1724362567,1724362577,1724362577.235575,-18000,,
com.microsoft.Outlook,1,1724362566,1724362567,1724362568.235322,-18000,,
com.google.Chrome,48,1724362518,1724362566,1724362566.862601,-18000,,
com.microsoft.Outlook,1,1724362517,1724362518,1724362518.861058,-18000,,
com.google.Chrome,21,1724362496,1724362517,1724362518.726314,-18000,,
com.microsoft.Outlook,9,1724362487,1724362496,1724362496.467188,-18000,,
com.apple.iCal,438,1724362049,1724362487,1724362487.731648,-18000,,
com.google.Chrome,80,1724361969,1724362049,1724362049.868211,-18000,,
com.apple.iCal,2,1724361967,1724361969,1724361969.445056,-18000,,
com.google.Chrome,60,1724361907,1724361967,1724361967.3884702,-18000,,
com.apple.iCal,112,1724361795,1724361907,1724361907.411691,-18000,,
com.google.Chrome,74,1724361721,1724361795,1724361795.343288,-18000,,
com.apple.iCal,6,1724361662,1724361668,1724361668.309157,-18000,,
com.google.Chrome,749,1724360913,1724361662,1724361662.397814,-18000,,
com.apple.Notes,10,1724360903,1724360913,1724360913.735794,-18000,,
com.google.Chrome,9,1724360894,1724360903,1724360903.406642,-18000,,
com.google.Chrome,46,1724359408,1724359454,1724359454.212719,-18000,,
com.apple.Notes,15,1724359393,1724359408,1724359408.5399551,-18000,,
com.google.Chrome,1,1724359392,1724359393,1724359393.5437331,-18000,,
com.apple.Notes,3,1724359389,1724359392,1724359392.283299,-18000,,
com.google.Chrome,1,1724359388,1724359389,1724359389.455903,-18000,,
com.apple.Notes,3,1724359385,1724359388,1724359388.673459,-18000,,
com.google.Chrome,1,1724359384,1724359385,1724359385.5037851,-18000,,
com.apple.Notes,2,1724359382,1724359384,1724359384.677219,-18000,,
com.google.Chrome,4,1724359378,1724359382,1724359383.053546,-18000,,
com.apple.Notes,4,1724359374,1724359378,1724359378.304891,-18000,,
com.google.Chrome,4,1724359370,1724359374,1724359374.611311,-18000,,
com.apple.Notes,4,1724359366,1724359370,1724359370.336141,-18000,,
com.google.Chrome,9,1724359357,1724359366,1724359366.467613,-18000,,
com.apple.Notes,3,1724359354,1724359357,1724359357.411031,-18000,,
com.google.Chrome,1,1724359353,1724359354,1724359354.877764,-18000,,
com.apple.Notes,2,1724359351,1724359353,1724359353.669746,-18000,,
com.google.Chrome,0,1724359351,1724359351,1724359352.005745,-18000,,
com.apple.Notes,2,1724359349,1724359351,1724359351.374092,-18000,,
com.google.Chrome,7,1724359342,1724359349,1724359349.8474631,-18000,,
com.apple.Notes,12,1724359330,1724359342,1724359342.082371,-18000,,
com.google.Chrome,6148,1724353182,1724359330,1724359330.888362,-18000,,
com.apple.MobileSMS,2,1724352735,1724352737,1724352737.179579,-18000,EB445137-D7F5-57EC-87DA-1DB460D64046,"iPhone13,2"
com.apple.MobileSMS,3,1724352598,1724352601,1724352601.005515,-18000,EB445137-D7F5-57EC-87DA-1DB460D64046,"iPhone13,2"
com.apple.MobileSMS,81,1724352373,1724352454,1724352454.132427,-18000,EB445137-D7F5-57EC-87DA-1DB460D64046,"iPhone13,2"
com.apple.MobileSMS,13,1724352359,1724352372,1724352372.420734,-18000,EB445137-D7F5-57EC-87DA-1DB460D64046,"iPhone13,2"
com.apple.MobileSMS,6,1724351977,1724351983,1724351983.230026,-18000,EB445137-D7F5-57EC-87DA-1DB460D64046,"iPhone13,2"
com.apple.MobileSMS,23,1724351915,1724351938,1724351938.085248,-18000,EB445137-D7F5-57EC-87DA-1DB460D64046,"iPhone13,2"
com.apple.Maps,3,1724351911,1724351914,1724351915.0782208,-18000,EB445137-D7F5-57EC-87DA-1DB460D64046,"iPhone13,2"
com.google.Chrome,30,1724351626,1724351656,1724351656.8319979,-18000,,
com.google.Chrome,22,1724351602,1724351624,1724351624.755559,-18000,,
com.microsoft.Outlook,12,1724351572,1724351584,1724351584.638855,-18000,,
com.google.Chrome,41,1724351531,1724351572,1724351572.155764,-18000,,
com.microsoft.Outlook,22,1724351509,1724351531,1724351531.6650028,-18000,,
com.google.Chrome,7,1724351502,1724351509,1724351509.10996,-18000,,
com.microsoft.Outlook,1,1724351501,1724351502,1724351502.934478,-18000,,
com.google.Chrome,11,1724351490,1724351501,1724351501.066002,-18000,,
com.apple.Maps,5,1724351483,1724351488,1724351488.624052,-18000,EB445137-D7F5-57EC-87DA-1DB460D64046,"iPhone13,2"
com.google.Chrome,6,1724351315,1724351321,1724351321.4099932,-18000,,
com.google.Chrome,311,1724350796,1724351107,1724351107.054183,-18000,,
com.google.Chrome,517,1724349810,1724350327,1724350327.6232328,-18000,,
com.apple.iCal,1,1724349809,1724349810,1724349811.694284,-18000,,
com.apple.Maps,2,1724347729,1724347731,1724347731.6220899,-18000,EB445137-D7F5-57EC-87DA-1DB460D64046,"iPhone13,2"
com.apple.Maps,841,1724346667,1724347508,1724347509.061696,-18000,EB445137-D7F5-57EC-87DA-1DB460D64046,"iPhone13,2"
com.discoverfinancial.mobile,15,1724346651,1724346666,1724346666.797257,-18000,EB445137-D7F5-57EC-87DA-1DB460D64046,"iPhone13,2"
com.toyopagroup.picaboo,16,1724346631,1724346647,1724346647.870239,-18000,EB445137-D7F5-57EC-87DA-1DB460D64046,"iPhone13,2"
com.discoverfinancial.mobile,5,1724346626,1724346631,1724346631.215173,-18000,EB445137-D7F5-57EC-87DA-1DB460D64046,"iPhone13,2"
com.discoverfinancial.mobile,2,1724346443,1724346445,1724346445.371455,-18000,EB445137-D7F5-57EC-87DA-1DB460D64046,"iPhone13,2"
com.discoverfinancial.mobile,19,1724346424,1724346443,1724346443.727528,-18000,EB445137-D7F5-57EC-87DA-1DB460D64046,"iPhone13,2"
com.apple.mobilenotes,3,1724346416,1724346419,1724346419.232897,-18000,EB445137-D7F5-57EC-87DA-1DB460D64046,"iPhone13,2"
com.apple.mobilenotes,6,1724345643,1724345649,1724345649.09732,-18000,EB445137-D7F5-57EC-87DA-1DB460D64046,"iPhone13,2"
com.apple.mobilenotes,14,1724345627,1724345641,1724345641.92643,-18000,EB445137-D7F5-57EC-87DA-1DB460D64046,"iPhone13,2"
com.apple.mobilenotes,7,1724345564,1724345571,1724345571.0464702,-18000,EB445137-D7F5-57EC-87DA-1DB460D64046,"iPhone13,2"
com.meijer.mobile.Meijer,9,1724345555,1724345564,1724345564.3138041,-18000,EB445137-D7F5-57EC-87DA-1DB460D64046,"iPhone13,2"
com.meijer.mobile.Meijer,22,1724345466,1724345488,1724345488.389857,-18000,EB445137-D7F5-57EC-87DA-1DB460D64046,"iPhone13,2"
com.meijer.mobile.Meijer,6,1724345428,1724345434,1724345434.565815,-18000,EB445137-D7F5-57EC-87DA-1DB460D64046,"iPhone13,2"
com.meijer.mobile.Meijer,44,1724345329,1724345373,1724345374.058008,-18000,EB445137-D7F5-57EC-87DA-1DB460D64046,"iPhone13,2"
com.apple.AppStore,23,1724345306,1724345329,1724345330.092721,-18000,EB445137-D7F5-57EC-87DA-1DB460D64046,"iPhone13,2"
com.apple.mobilenotes,3,1724345302,1724345305,1724345305.219872,-18000,EB445137-D7F5-57EC-87DA-1DB460D64046,"iPhone13,2"
com.apple.mobilenotes,5,1724345194,1724345199,1724345199.3812451,-18000,EB445137-D7F5-57EC-87DA-1DB460D64046,"iPhone13,2"
com.apple.mobilenotes,6,1724345127,1724345133,1724345133.8714662,-18000,EB445137-D7F5-57EC-87DA-1DB460D64046,"iPhone13,2"
com.apple.mobilenotes,6,1724345120,1724345126,1724345126.980134,-18000,EB445137-D7F5-57EC-87DA-1DB460D64046,"iPhone13,2"
com.apple.mobilenotes,14,1724345042,1724345056,1724345056.710643,-18000,EB445137-D7F5-57EC-87DA-1DB460D64046,"iPhone13,2"
com.apple.mobilenotes,36,1724344964,1724345000,1724345000.877116,-18000,EB445137-D7F5-57EC-87DA-1DB460D64046,"iPhone13,2"
com.apple.MobileSMS,3,1724344961,1724344964,1724344964.357693,-18000,EB445137-D7F5-57EC-87DA-1DB460D64046,"iPhone13,2"
com.apple.MobileSMS,7,1724344937,1724344944,1724344944.6074882,-18000,EB445137-D7F5-57EC-87DA-1DB460D64046,"iPhone13,2"
com.apple.MobileSMS,12,1724344862,1724344874,1724344874.517843,-18000,EB445137-D7F5-57EC-87DA-1DB460D64046,"iPhone13,2"
com.apple.MobileSMS,7,1724344818,1724344825,1724344825.166636,-18000,EB445137-D7F5-57EC-87DA-1DB460D64046,"iPhone13,2"
com.apple.mobilenotes,2,1724344816,1724344818,1724344818.329675,-18000,EB445137-D7F5-57EC-87DA-1DB460D64046,"iPhone13,2"
com.apple.mobilenotes,50,1724344577,1724344627,1724344627.754345,-18000,EB445137-D7F5-57EC-87DA-1DB460D64046,"iPhone13,2"
com.apple.mobilenotes,6,1724344554,1724344560,1724344560.294407,-18000,EB445137-D7F5-57EC-87DA-1DB460D64046,"iPhone13,2"
com.apple.mobilenotes,18,1724344507,1724344525,1724344525.879387,-18000,EB445137-D7F5-57EC-87DA-1DB460D64046,"iPhone13,2"
com.apple.mobilenotes,75,1724344396,1724344471,1724344471.340548,-18000,EB445137-D7F5-57EC-87DA-1DB460D64046,"iPhone13,2"
com.apple.mobilenotes,7,1724344342,1724344349,1724344349.619326,-18000,EB445137-D7F5-57EC-87DA-1DB460D64046,"iPhone13,2"
com.apple.Maps,346,1724343988,1724344334,1724344335.054366,-18000,EB445137-D7F5-57EC-87DA-1DB460D64046,"iPhone13,2"
com.apple.mobilenotes,6,1724343982,1724343988,1724343988.994894,-18000,EB445137-D7F5-57EC-87DA-1DB460D64046,"iPhone13,2"
com.apple.mobilenotes,6,1724343575,1724343581,1724343581.82929,-18000,EB445137-D7F5-57EC-87DA-1DB460D64046,"iPhone13,2"
com.apple.mobilenotes,5,1724343569,1724343574,1724343574.58925,-18000,EB445137-D7F5-57EC-87DA-1DB460D64046,"iPhone13,2"
com.apple.MobileSMS,2,1724343567,1724343569,1724343569.724915,-18000,EB445137-D7F5-57EC-87DA-1DB460D64046,"iPhone13,2"
com.apple.MobileSMS,3,1724343470,1724343473,1724343473.723268,-18000,EB445137-D7F5-57EC-87DA-1DB460D64046,"iPhone13,2"
com.apple.Maps,2,1724343468,1724343470,1724343470.714711,-18000,EB445137-D7F5-57EC-87DA-1DB460D64046,"iPhone13,2"
com.apple.Maps,12,1724342910,1724342922,1724342922.706558,-18000,EB445137-D7F5-57EC-87DA-1DB460D64046,"iPhone13,2"
com.apple.Maps,180,1724342710,1724342890,1724342890.976558,-18000,EB445137-D7F5-57EC-87DA-1DB460D64046,"iPhone13,2"
com.apple.Music,8,1724342702,1724342710,1724342710.2551498,-18000,EB445137-D7F5-57EC-87DA-1DB460D64046,"iPhone13,2"
com.apple.Maps,526,1724342174,1724342700,1724342700.882685,-18000,EB445137-D7F5-57EC-87DA-1DB460D64046,"iPhone13,2"
com.apple.mobilenotes,3,1724342171,1724342174,1724342174.022307,-18000,EB445137-D7F5-57EC-87DA-1DB460D64046,"iPhone13,2"
com.apple.mobilenotes,6,1724342021,1724342027,1724342027.3994079,-18000,EB445137-D7F5-57EC-87DA-1DB460D64046,"iPhone13,2"
com.apple.AppStore,11,1724341803,1724341814,1724341814.6392179,-18000,EB445137-D7F5-57EC-87DA-1DB460D64046,"iPhone13,2"
com.google.chrome.ios,118,1724341653,1724341771,1724341771.150326,-18000,EB445137-D7F5-57EC-87DA-1DB460D64046,"iPhone13,2"
com.apple.news,20,1724341632,1724341652,1724341652.7536368,-18000,EB445137-D7F5-57EC-87DA-1DB460D64046,"iPhone13,2"
com.google.chrome.ios,8,1724341430,1724341438,1724341438.6523519,-18000,EB445137-D7F5-57EC-87DA-1DB460D64046,"iPhone13,2"
com.renpho.health,66,1724341364,1724341430,1724341430.7877898,-18000,EB445137-D7F5-57EC-87DA-1DB460D64046,"iPhone13,2"
com.apple.Health,21,1724341343,1724341364,1724341364.2689219,-18000,EB445137-D7F5-57EC-87DA-1DB460D64046,"iPhone13,2"
com.renpho.health,54,1724341284,1724341338,1724341338.599097,-18000,EB445137-D7F5-57EC-87DA-1DB460D64046,"iPhone13,2"
com.renpho.health,205,1724341075,1724341280,1724341280.161932,-18000,EB445137-D7F5-57EC-87DA-1DB460D64046,"iPhone13,2"
com.google.chrome.ios,2,1724341073,1724341075,1724341075.825938,-18000,EB445137-D7F5-57EC-87DA-1DB460D64046,"iPhone13,2"
com.google.chrome.ios,128,1724340925,1724341053,1724341053.720654,-18000,EB445137-D7F5-57EC-87DA-1DB460D64046,"iPhone13,2"
com.apple.camera,4,1724340921,1724340925,1724340925.946673,-18000,EB445137-D7F5-57EC-87DA-1DB460D64046,"iPhone13,2"
com.apple.mobiletimer,10,1724340777,1724340787,1724340787.690604,-18000,EB445137-D7F5-57EC-87DA-1DB460D64046,"iPhone13,2"
com.apple.mobilecal,32,1724340745,1724340777,1724340777.206067,-18000,EB445137-D7F5-57EC-87DA-1DB460D64046,"iPhone13,2"
com.apple.weather,3,1724340720,1724340723,1724340723.691992,-18000,EB445137-D7F5-57EC-87DA-1DB460D64046,"iPhone13,2"
com.apple.weather,3,1724340397,1724340400,1724340400.906194,-18000,EB445137-D7F5-57EC-87DA-1DB460D64046,"iPhone13,2"
com.apple.news,8,1724340389,1724340397,1724340397.502814,-18000,EB445137-D7F5-57EC-87DA-1DB460D64046,"iPhone13,2"
com.apple.news,5,1724340365,1724340370,1724340370.1161308,-18000,EB445137-D7F5-57EC-87DA-1DB460D64046,"iPhone13,2"
com.apple.news,2,1724340353,1724340355,1724340355.357329,-18000,EB445137-D7F5-57EC-87DA-1DB460D64046,"iPhone13,2"
com.apple.iCal,179,1724339480,1724339659,1724339659.719603,-18000,,
com.apple.news,97,1724339379,1724339476,1724339476.613162,-18000,EB445137-D7F5-57EC-87DA-1DB460D64046,"iPhone13,2"
com.apple.weather,8,1724339357,1724339365,1724339365.5895119,-18000,EB445137-D7F5-57EC-87DA-1DB460D64046,"iPhone13,2"
com.google.Chrome,632,1724338848,1724339480,1724339481.012395,-18000,,
com.apple.weather,1,1724338788,1724338789,1724338789.125426,-18000,EB445137-D7F5-57EC-87DA-1DB460D64046,"iPhone13,2"
com.clairmail.fth.client,55,1724338733,1724338788,1724338788.1082559,-18000,EB445137-D7F5-57EC-87DA-1DB460D64046,"iPhone13,2"
com.ally.MobileBanking,2,1724338728,1724338730,1724338730.821686,-18000,EB445137-D7F5-57EC-87DA-1DB460D64046,"iPhone13,2"
com.ally.MobileBanking,104,1724338596,1724338700,1724338700.848514,-18000,EB445137-D7F5-57EC-87DA-1DB460D64046,"iPhone13,2"
com.apple.calculator,115,1724338586,1724338701,1724338701.812103,-18000,,
com.google.Chrome,1,1724338585,1724338586,1724338586.092334,-18000,,
com.apple.calculator,7,1724338578,1724338585,1724338585.284867,-18000,,
com.robinhood.release.Robinhood,27,1724338516,1724338543,1724338543.9062371,-18000,EB445137-D7F5-57EC-87DA-1DB460D64046,"iPhone13,2"
com.truebill.truebillnative,3,1724338511,1724338514,1724338514.202831,-18000,EB445137-D7F5-57EC-87DA-1DB460D64046,"iPhone13,2"
com.truebill.truebillnative,81,1724338401,1724338482,1724338482.968782,-18000,EB445137-D7F5-57EC-87DA-1DB460D64046,"iPhone13,2"
com.clairmail.fth.client,4,1724338397,1724338401,1724338401.013091,-18000,EB445137-D7F5-57EC-87DA-1DB460D64046,"iPhone13,2"
com.robinhood.release.Robinhood,246,1724338148,1724338394,1724338394.755381,-18000,EB445137-D7F5-57EC-87DA-1DB460D64046,"iPhone13,2"
com.truebill.truebillnative,4,1724338144,1724338148,1724338148.122659,-18000,EB445137-D7F5-57EC-87DA-1DB460D64046,"iPhone13,2"
com.truebill.truebillnative,50,1724338074,1724338124,1724338124.410256,-18000,EB445137-D7F5-57EC-87DA-1DB460D64046,"iPhone13,2"
com.apple.MobileSMS,5,1724338067,1724338072,1724338072.266108,-18000,EB445137-D7F5-57EC-87DA-1DB460D64046,"iPhone13,2"
com.google.Chrome,567,1724338011,1724338578,1724338578.827736,-18000,,
com.apple.finder,2,1724338009,1724338011,1724338011.821733,-18000,,
com.apple.MobileSMS,10,1724336921,1724336931,1724336931.322647,-18000,EB445137-D7F5-57EC-87DA-1DB460D64046,"iPhone13,2"
com.microsoft.Office.Outlook,2,1724336919,1724336921,1724336922.1382031,-18000,EB445137-D7F5-57EC-87DA-1DB460D64046,"iPhone13,2"
com.microsoft.Office.Outlook,43,1724336805,1724336848,1724336848.085397,-18000,EB445137-D7F5-57EC-87DA-1DB460D64046,"iPhone13,2"
com.truebill.truebillnative,64,1724336731,1724336795,1724336795.853857,-18000,EB445137-D7F5-57EC-87DA-1DB460D64046,"iPhone13,2"
com.ally.MobileBanking,108,1724336621,1724336729,1724336729.975064,-18000,EB445137-D7F5-57EC-87DA-1DB460D64046,"iPhone13,2"
com.apple.Preferences,18,1724336593,1724336611,1724336611.201236,-18000,EB445137-D7F5-57EC-87DA-1DB460D64046,"iPhone13,2"
com.apple.finder,1,1724303542,1724303543,1724303544.0979152,-18000,,
com.apple.finder,3,1724303538,1724303541,1724303541.733288,-18000,,
com.microsoft.onenote.mac,35,1724303503,1724303538,1724303538.593025,-18000,,
com.google.Chrome,60,1724303443,1724303503,1724303503.1138701,-18000,,
com.google.Chrome,302,1724303086,1724303388,1724303389.016479,-18000,,
com.google.Chrome,1082,1724301771,1724302853,1724302853.2179441,-18000,,
com.apple.Notes,32,1724301739,1724301771,1724301771.907584,-18000,,
com.google.Chrome,50,1724301689,1724301739,1724301739.1022859,-18000,,
com.apple.Notes,13,1724301676,1724301689,1724301690.031389,-18000,,
com.google.Chrome,6,1724301670,1724301676,1724301676.6512132,-18000,,
com.apple.Notes,3,1724301667,1724301670,1724301670.101532,-18000,,
com.google.Chrome,4,1724301663,1724301667,1724301667.133199,-18000,,
com.apple.Notes,4,1724301659,1724301663,1724301663.632537,-18000,,
com.google.Chrome,1,1724301658,1724301659,1724301659.915318,-18000,,
com.apple.Notes,3,1724301655,1724301658,1724301658.576229,-18000,,
com.google.Chrome,1,1724301654,1724301655,1724301655.458076,-18000,,
com.apple.Notes,14,1724301640,1724301654,1724301654.23858,-18000,,
com.google.Chrome,44,1724301596,1724301640,1724301640.0850239,-18000,,
com.apple.Notes,5,1724301591,1724301596,1724301596.46482,-18000,,
com.google.Chrome,0,1724301591,1724301591,1724301591.8582401,-18000,,
com.apple.Notes,3,1724301588,1724301591,1724301591.13767,-18000,,
com.google.Chrome,3,1724301585,1724301588,1724301588.375886,-18000,,
com.apple.Notes,3,1724301582,1724301585,1724301585.390151,-18000,,
com.google.Chrome,2,1724301580,1724301582,1724301582.383078,-18000,,
com.apple.Notes,3,1724301577,1724301580,1724301580.611959,-18000,,
com.google.Chrome,2,1724301575,1724301577,1724301577.581989,-18000,,
com.apple.Notes,3,1724301572,1724301575,1724301575.100151,-18000,,
com.google.Chrome,4,1724301568,1724301572,1724301572.185474,-18000,,
com.apple.Notes,4,1724301564,1724301568,1724301569.060014,-18000,,
com.google.Chrome,1,1724301563,1724301564,1724301565.021964,-18000,,
com.apple.Notes,11,1724301552,1724301563,1724301563.424909,-18000,,
com.google.Chrome,3,1724301549,1724301552,1724301552.167243,-18000,,
com.apple.Notes,12,1724301537,1724301549,1724301549.557914,-18000,,
com.google.Chrome,6,1724301531,1724301537,1724301537.913378,-18000,,
com.apple.Notes,8,1724301523,1724301531,1724301531.793978,-18000,,
com.google.Chrome,4,1724301519,1724301523,1724301523.9659739,-18000,,
com.apple.Notes,15,1724301504,1724301519,1724301519.7056541,-18000,,
com.google.Chrome,8,1724301490,1724301498,1724301498.686734,-18000,,
com.apple.Notes,18,1724301472,1724301490,1724301490.409625,-18000,,
com.google.Chrome,9,1724301463,1724301472,1724301472.07976,-18000,,
com.google.Chrome,632,1724300367,1724300999,1724300999.629232,-18000,,
com.apple.Maps,2,1724291656,1724291658,1724291658.487204,-18000,EB445137-D7F5-57EC-87DA-1DB460D64046,"iPhone13,2"
com.apple.Preferences,60,1724291415,1724291475,1724291475.245692,-18000,EB445137-D7F5-57EC-87DA-1DB460D64046,"iPhone13,2"
com.apple.Maps,60,1724291415,1724291475,1724291475.243384,-18000,EB445137-D7F5-57EC-87DA-1DB460D64046,"iPhone13,2"
com.apple.Preferences,31,1724291194,1724291225,1724291225.6270099,-18000,EB445137-D7F5-57EC-87DA-1DB460D64046,"iPhone13,2"
com.apple.Music,89,1724291105,1724291194,1724291194.905662,-18000,EB445137-D7F5-57EC-87DA-1DB460D64046,"iPhone13,2"
com.apple.Maps,83,1724291105,1724291188,1724291188.1097322,-18000,EB445137-D7F5-57EC-87DA-1DB460D64046,"iPhone13,2"
com.apple.Music,61,1724290979,1724291040,1724291040.9556088,-18000,EB445137-D7F5-57EC-87DA-1DB460D64046,"iPhone13,2"
com.apple.Maps,61,1724290979,1724291040,1724291040.958245,-18000,EB445137-D7F5-57EC-87DA-1DB460D64046,"iPhone13,2"
com.apple.Music,8,1724290699,1724290707,1724290707.4973068,-18000,EB445137-D7F5-57EC-87DA-1DB460D64046,"iPhone13,2"
com.apple.Maps,2,1724290699,1724290701,1724290701.844746,-18000,EB445137-D7F5-57EC-87DA-1DB460D64046,"iPhone13,2"
com.apple.Music,10,1724290496,1724290506,1724290506.221875,-18000,EB445137-D7F5-57EC-87DA-1DB460D64046,"iPhone13,2"
com.apple.Maps,3441,1724287051,1724290492,1724290492.675796,-18000,EB445137-D7F5-57EC-87DA-1DB460D64046,"iPhone13,2"
com.apple.Maps,3,1724286990,1724286993,1724286993.0943751,-18000,EB445137-D7F5-57EC-87DA-1DB460D64046,"iPhone13,2"
com.apple.Maps,41,1724286868,1724286909,1724286909.952951,-18000,EB445137-D7F5-57EC-87DA-1DB460D64046,"iPhone13,2"
com.apple.Maps,1,1724286866,1724286867,1724286867.946532,-18000,EB445137-D7F5-57EC-87DA-1DB460D64046,"iPhone13,2"
com.apple.Maps,174,1724286692,1724286866,1724286866.893759,-18000,EB445137-D7F5-57EC-87DA-1DB460D64046,"iPhone13,2"
com.apple.Maps,117,1724286530,1724286647,1724286648.15269,-18000,EB445137-D7F5-57EC-87DA-1DB460D64046,"iPhone13,2"
com.apple.Maps,2,1724286137,1724286139,1724286139.707267,-18000,EB445137-D7F5-57EC-87DA-1DB460D64046,"iPhone13,2"
com.apple.Maps,3009,1724283119,1724286128,1724286128.84691,-18000,EB445137-D7F5-57EC-87DA-1DB460D64046,"iPhone13,2"
com.apple.Music,7,1724283112,1724283119,1724283120.084662,-18000,EB445137-D7F5-57EC-87DA-1DB460D64046,"iPhone13,2"
com.apple.Maps,38,1724283073,1724283111,1724283112.044517,-18000,EB445137-D7F5-57EC-87DA-1DB460D64046,"iPhone13,2"
com.apple.Maps,153,1724282905,1724283058,1724283058.514693,-18000,EB445137-D7F5-57EC-87DA-1DB460D64046,"iPhone13,2"
com.apple.podcasts,31,1724282873,1724282904,1724282904.914686,-18000,EB445137-D7F5-57EC-87DA-1DB460D64046,"iPhone13,2"
com.apple.Maps,3,1724282859,1724282862,1724282862.95294,-18000,EB445137-D7F5-57EC-87DA-1DB460D64046,"iPhone13,2"
com.apple.Maps,23,1724282056,1724282079,1724282079.646593,-18000,EB445137-D7F5-57EC-87DA-1DB460D64046,"iPhone13,2"
com.apple.news,2,1724282053,1724282055,1724282057.363151,-18000,EB445137-D7F5-57EC-87DA-1DB460D64046,"iPhone13,2"
com.apple.news,6,1724280789,1724280795,1724280795.8951468,-18000,EB445137-D7F5-57EC-87DA-1DB460D64046,"iPhone13,2"
com.apple.news,95,1724280690,1724280785,1724280785.753735,-18000,EB445137-D7F5-57EC-87DA-1DB460D64046,"iPhone13,2"
com.apple.Maps,7,1724280663,1724280670,1724280671.089792,-18000,EB445137-D7F5-57EC-87DA-1DB460D64046,"iPhone13,2"
com.apple.Maps,24,1724280483,1724280507,1724280507.975593,-18000,EB445137-D7F5-57EC-87DA-1DB460D64046,"iPhone13,2"
com.apple.mobileslideshow,1,1724280482,1724280483,1724280483.575932,-18000,EB445137-D7F5-57EC-87DA-1DB460D64046,"iPhone13,2"
com.myfitnesspal.mfp,2,1724280479,1724280481,1724280481.966652,-18000,EB445137-D7F5-57EC-87DA-1DB460D64046,"iPhone13,2"
com.apple.camera,0,1724280264,1724280264,1724280264.6579142,-18000,EB445137-D7F5-57EC-87DA-1DB460D64046,"iPhone13,2"
com.myfitnesspal.mfp,7,1724280263,1724280270,1724280270.64606,-18000,EB445137-D7F5-57EC-87DA-1DB460D64046,"iPhone13,2"
com.myfitnesspal.mfp,30,1724280232,1724280262,1724280262.852199,-18000,EB445137-D7F5-57EC-87DA-1DB460D64046,"iPhone13,2"
com.apple.mobileslideshow,2,1724280230,1724280232,1724280232.9136128,-18000,EB445137-D7F5-57EC-87DA-1DB460D64046,"iPhone13,2"
com.apple.mobileslideshow,75,1724280122,1724280197,1724280197.3522248,-18000,EB445137-D7F5-57EC-87DA-1DB460D64046,"iPhone13,2"
com.apple.mobilenotes,2,1724280120,1724280122,1724280122.3872042,-18000,EB445137-D7F5-57EC-87DA-1DB460D64046,"iPhone13,2"
com.apple.mobilenotes,5,1724280010,1724280015,1724280015.487957,-18000,EB445137-D7F5-57EC-87DA-1DB460D64046,"iPhone13,2"
com.apple.findmy,3,1724280007,1724280010,1724280010.5895429,-18000,EB445137-D7F5-57EC-87DA-1DB460D64046,"iPhone13,2"
com.apple.findmy,7,1724279738,1724279745,1724279745.1280332,-18000,EB445137-D7F5-57EC-87DA-1DB460D64046,"iPhone13,2"
com.apple.findmy,8,1724279729,1724279737,1724279737.537379,-18000,EB445137-D7F5-57EC-87DA-1DB460D64046,"iPhone13,2"
com.amazon.Amazon,2,1724279726,1724279728,1724279728.794661,-18000,EB445137-D7F5-57EC-87DA-1DB460D64046,"iPhone13,2"
com.amazon.Amazon,230,1724279491,1724279721,1724279721.6585531,-18000,EB445137-D7F5-57EC-87DA-1DB460D64046,"iPhone13,2"
com.apple.mobilenotes,23,1724279466,1724279489,1724279489.342382,-18000,EB445137-D7F5-57EC-87DA-1DB460D64046,"iPhone13,2"
com.ally.MobileBanking,81,1724279380,1724279461,1724279461.418693,-18000,EB445137-D7F5-57EC-87DA-1DB460D64046,"iPhone13,2"
com.apple.Health,12,1724279365,1724279377,1724279378.128521,-18000,EB445137-D7F5-57EC-87DA-1DB460D64046,"iPhone13,2"
com.truebill.truebillnative,146,1724279217,1724279363,1724279363.57831,-18000,EB445137-D7F5-57EC-87DA-1DB460D64046,"iPhone13,2"
com.apple.news,3,1724279206,1724279209,1724279209.947088,-18000,EB445137-D7F5-57EC-87DA-1DB460D64046,"iPhone13,2"
com.apple.news,25,1724278297,1724278322,1724278322.578844,-18000,EB445137-D7F5-57EC-87DA-1DB460D64046,"iPhone13,2"
com.apple.news,16,1724278241,1724278257,1724278257.1965451,-18000,EB445137-D7F5-57EC-87DA-1DB460D64046,"iPhone13,2"
com.apple.news,207,1724278024,1724278231,1724278231.428917,-18000,EB445137-D7F5-57EC-87DA-1DB460D64046,"iPhone13,2"
com.apple.findmy,7,1724278002,1724278009,1724278009.09509,-18000,EB445137-D7F5-57EC-87DA-1DB460D64046,"iPhone13,2"
com.apple.findmy,13,1724277648,1724277661,1724277661.368497,-18000,EB445137-D7F5-57EC-87DA-1DB460D64046,"iPhone13,2"
com.apple.findmy,7,1724277276,1724277283,1724277283.3458,-18000,EB445137-D7F5-57EC-87DA-1DB460D64046,"iPhone13,2"
com.google.Chrome,420,1724277225,1724277645,1724277645.7320771,-18000,,
com.apple.iCal,115,1724277110,1724277225,1724277225.294914,-18000,,
com.google.Chrome,44,1724277066,1724277110,1724277110.6127,-18000,,
com.apple.iCal,22,1724277044,1724277066,1724277066.762111,-18000,,
com.google.Chrome,10,1724277034,1724277044,1724277044.5226212,-18000,,
com.apple.iCal,2,1724277032,1724277034,1724277034.71084,-18000,,
com.google.Chrome,14,1724277018,1724277032,1724277032.154488,-18000,,
com.apple.iCal,14,1724277004,1724277018,1724277018.433093,-18000,,
com.google.Chrome,1,1724277003,1724277004,1724277004.154736,-18000,,
com.apple.iCal,1,1724277002,1724277003,1724277003.199545,-18000,,
com.google.Chrome,4,1724276998,1724277002,1724277002.2310681,-18000,,
com.apple.iCal,15,1724276983,1724276998,1724276998.8087258,-18000,,
com.google.Chrome,2,1724276981,1724276983,1724276983.910928,-18000,,
com.apple.iCal,3,1724276978,1724276981,1724276981.597952,-18000,,
com.google.Chrome,4,1724276974,1724276978,1724276978.5779881,-18000,,
com.apple.iCal,19,1724276955,1724276974,1724276974.26683,-18000,,
com.google.Chrome,5,1724276950,1724276955,1724276955.947711,-18000,,
com.apple.iCal,7,1724276943,1724276950,1724276950.172405,-18000,,
com.google.Chrome,3,1724276940,1724276943,1724276943.600703,-18000,,
com.apple.iCal,9,1724276931,1724276940,1724276940.461179,-18000,,
com.google.Chrome,2,1724276929,1724276931,1724276931.696377,-18000,,
com.apple.iCal,1,1724276928,1724276929,1724276929.809921,-18000,,
com.google.Chrome,88,1724276840,1724276928,1724276928.9962459,-18000,,
com.apple.MobileSMS,12,1724276828,1724276840,1724276840.2852712,-18000,,
com.google.Chrome,493,1724276335,1724276828,1724276828.291677,-18000,,
com.microsoft.onenote.mac,20,1724276241,1724276261,1724276261.880622,-18000,,
com.apple.mobilephone,2,1724276143,1724276145,1724276145.491386,-18000,EB445137-D7F5-57EC-87DA-1DB460D64046,"iPhone13,2"
com.google.Chrome,268,1724275973,1724276241,1724276241.847064,-18000,,
com.apple.InCallService,179,1724275964,1724276143,1724276143.508791,-18000,EB445137-D7F5-57EC-87DA-1DB460D64046,"iPhone13,2"
com.apple.mobilephone,2,1724275962,1724275964,1724275964.066983,-18000,EB445137-D7F5-57EC-87DA-1DB460D64046,"iPhone13,2"
com.apple.mobilenotes,3,1724275959,1724275962,1724275962.325655,-18000,EB445137-D7F5-57EC-87DA-1DB460D64046,"iPhone13,2"
com.apple.mobilenotes,4,1724275803,1724275807,1724275807.2858272,-18000,EB445137-D7F5-57EC-87DA-1DB460D64046,"iPhone13,2"
com.apple.findmy,4,1724275799,1724275803,1724275803.730947,-18000,EB445137-D7F5-57EC-87DA-1DB460D64046,"iPhone13,2"
com.apple.findmy,7,1724275691,1724275698,1724275698.094925,-18000,EB445137-D7F5-57EC-87DA-1DB460D64046,"iPhone13,2"
com.hammerandchisel.discord,3,1724275688,1724275691,1724275691.402011,-18000,EB445137-D7F5-57EC-87DA-1DB460D64046,"iPhone13,2"
com.hammerandchisel.discord,6,1724274972,1724274978,1724274978.4186091,-18000,EB445137-D7F5-57EC-87DA-1DB460D64046,"iPhone13,2"
com.microsoft.Office.Outlook,26,1724272917,1724272943,1724272944.0323029,-18000,EB445137-D7F5-57EC-87DA-1DB460D64046,"iPhone13,2"
com.apple.mobilenotes,8,1724272909,1724272917,1724272917.319031,-18000,EB445137-D7F5-57EC-87DA-1DB460D64046,"iPhone13,2"
com.apple.mobilenotes,3,1724272905,1724272908,1724272908.51562,-18000,EB445137-D7F5-57EC-87DA-1DB460D64046,"iPhone13,2"
com.apple.mobilenotes,9,1724272833,1724272842,1724272842.445425,-18000,EB445137-D7F5-57EC-87DA-1DB460D64046,"iPhone13,2"
com.apple.findmy,18,1724272812,1724272830,1724272830.316162,-18000,EB445137-D7F5-57EC-87DA-1DB460D64046,"iPhone13,2"
com.apple.mobilenotes,9,1724272802,1724272811,1724272811.213244,-18000,EB445137-D7F5-57EC-87DA-1DB460D64046,"iPhone13,2"
com.apple.mobilephone,4,1724272794,1724272798,1724272798.9336061,-18000,EB445137-D7F5-57EC-87DA-1DB460D64046,"iPhone13,2"
com.apple.mobilephone,1,1724272782,1724272783,1724272783.2796779,-18000,EB445137-D7F5-57EC-87DA-1DB460D64046,"iPhone13,2"
com.apple.InCallService,131,1724272651,1724272782,1724272782.237368,-18000,EB445137-D7F5-57EC-87DA-1DB460D64046,"iPhone13,2"
com.apple.mobilephone,2,1724272649,1724272651,1724272651.682444,-18000,EB445137-D7F5-57EC-87DA-1DB460D64046,"iPhone13,2"
com.toyopagroup.picaboo,10,1724271924,1724271934,1724271935.042032,-18000,EB445137-D7F5-57EC-87DA-1DB460D64046,"iPhone13,2"
com.apple.Music,8,1724271916,1724271924,1724271925.0606441,-18000,EB445137-D7F5-57EC-87DA-1DB460D64046,"iPhone13,2"
com.apple.Music,8,1724268973,1724268981,1724268982.922379,-18000,EB445137-D7F5-57EC-87DA-1DB460D64046,"iPhone13,2"
com.apple.MobileSMS,4,1724268959,1724268963,1724268963.619578,-18000,EB445137-D7F5-57EC-87DA-1DB460D64046,"iPhone13,2"
com.apple.podcasts,3,1724266888,1724266891,1724266891.913897,-18000,EB445137-D7F5-57EC-87DA-1DB460D64046,"iPhone13,2"
com.apple.MobileSMS,1,1724263135,1724263136,1724263136.6830568,-18000,EB445137-D7F5-57EC-87DA-1DB460D64046,"iPhone13,2"
com.apple.MobileSMS,12,1724262735,1724262747,1724262747.288485,-18000,EB445137-D7F5-57EC-87DA-1DB460D64046,"iPhone13,2"
com.apple.Maps,689,1724262676,1724263365,1724263365.993711,-18000,EB445137-D7F5-57EC-87DA-1DB460D64046,"iPhone13,2"
com.apple.MobileSMS,49,1724262655,1724262704,1724262704.306174,-18000,EB445137-D7F5-57EC-87DA-1DB460D64046,"iPhone13,2"
com.apple.podcasts,5,1724262649,1724262654,1724262655.099613,-18000,EB445137-D7F5-57EC-87DA-1DB460D64046,"iPhone13,2"
com.apple.podcasts,73,1724262293,1724262366,1724262367.486539,-18000,EB445137-D7F5-57EC-87DA-1DB460D64046,"iPhone13,2"
com.apple.Maps,98,1724262274,1724262372,1724262372.990973,-18000,EB445137-D7F5-57EC-87DA-1DB460D64046,"iPhone13,2"
com.apple.MobileSMS,3,1724262271,1724262274,1724262274.419064,-18000,EB445137-D7F5-57EC-87DA-1DB460D64046,"iPhone13,2"
com.apple.MobileSMS,37,1724262228,1724262265,1724262265.61573,-18000,EB445137-D7F5-57EC-87DA-1DB460D64046,"iPhone13,2"
com.apple.Maps,3,1724262225,1724262228,1724262228.442337,-18000,EB445137-D7F5-57EC-87DA-1DB460D64046,"iPhone13,2"
com.apple.InCallService,308,1724261917,1724262225,1724262226.2292051,-18000,EB445137-D7F5-57EC-87DA-1DB460D64046,"iPhone13,2"
com.apple.Maps,46,1724261871,1724261917,1724261917.035773,-18000,EB445137-D7F5-57EC-87DA-1DB460D64046,"iPhone13,2"
com.apple.InCallService,58,1724261813,1724261871,1724261871.3441901,-18000,EB445137-D7F5-57EC-87DA-1DB460D64046,"iPhone13,2"
com.apple.mobilephone,29,1724261784,1724261813,1724261813.685542,-18000,EB445137-D7F5-57EC-87DA-1DB460D64046,"iPhone13,2"
com.apple.mobilenotes,3,1724261780,1724261783,1724261783.628975,-18000,EB445137-D7F5-57EC-87DA-1DB460D64046,"iPhone13,2"
com.apple.mobilenotes,6,1724261722,1724261728,1724261728.923661,-18000,EB445137-D7F5-57EC-87DA-1DB460D64046,"iPhone13,2"
com.apple.mobilenotes,3,1724261691,1724261694,1724261694.886899,-18000,EB445137-D7F5-57EC-87DA-1DB460D64046,"iPhone13,2"
com.toyopagroup.picaboo,2,1724261689,1724261691,1724261691.6102839,-18000,EB445137-D7F5-57EC-87DA-1DB460D64046,"iPhone13,2"
com.toyopagroup.picaboo,6,1724261595,1724261601,1724261601.55656,-18000,EB445137-D7F5-57EC-87DA-1DB460D64046,"iPhone13,2"
com.toyopagroup.picaboo,6,1724261588,1724261594,1724261594.203011,-18000,EB445137-D7F5-57EC-87DA-1DB460D64046,"iPhone13,2"
com.apple.news,2,1724261586,1724261588,1724261589.040855,-18000,EB445137-D7F5-57EC-87DA-1DB460D64046,"iPhone13,2"
com.apple.news,6,1724261254,1724261260,1724261260.918993,-18000,EB445137-D7F5-57EC-87DA-1DB460D64046,"iPhone13,2"
com.apple.news,301,1724260929,1724261230,1724261230.27444,-18000,EB445137-D7F5-57EC-87DA-1DB460D64046,"iPhone13,2"
com.toyopagroup.picaboo,9,1724260890,1724260899,1724260899.810466,-18000,EB445137-D7F5-57EC-87DA-1DB460D64046,"iPhone13,2"
com.toyopagroup.picaboo,4,1724260870,1724260874,1724260874.817606,-18000,EB445137-D7F5-57EC-87DA-1DB460D64046,"iPhone13,2"
com.toyopagroup.picaboo,10,1724260635,1724260645,1724260645.270901,-18000,EB445137-D7F5-57EC-87DA-1DB460D64046,"iPhone13,2"
com.apple.mobilenotes,3,1724260632,1724260635,1724260635.743307,-18000,EB445137-D7F5-57EC-87DA-1DB460D64046,"iPhone13,2"
com.apple.mobilenotes,13,1724259803,1724259816,1724259816.304558,-18000,EB445137-D7F5-57EC-87DA-1DB460D64046,"iPhone13,2"
com.apple.weather,13,1724259786,1724259799,1724259799.5550442,-18000,EB445137-D7F5-57EC-87DA-1DB460D64046,"iPhone13,2"
com.google.chrome.ios,28,1724259757,1724259785,1724259785.946404,-18000,EB445137-D7F5-57EC-87DA-1DB460D64046,"iPhone13,2"
com.google.chrome.ios,63,1724259634,1724259697,1724259697.1569629,-18000,EB445137-D7F5-57EC-87DA-1DB460D64046,"iPhone13,2"
com.apple.camera,10,1724259622,1724259632,1724259632.742444,-18000,EB445137-D7F5-57EC-87DA-1DB460D64046,"iPhone13,2"
com.instructure.icanvas,9,1724259621,1724259630,1724259630.643076,-18000,EB445137-D7F5-57EC-87DA-1DB460D64046,"iPhone13,2"
com.instructure.icanvas,1,1724259619,1724259620,1724259620.578327,-18000,EB445137-D7F5-57EC-87DA-1DB460D64046,"iPhone13,2"
com.instructure.icanvas,47,1724259523,1724259570,1724259570.560154,-18000,EB445137-D7F5-57EC-87DA-1DB460D64046,"iPhone13,2"
com.apple.MobileSMS,6,1724259517,1724259523,1724259523.626019,-18000,EB445137-D7F5-57EC-87DA-1DB460D64046,"iPhone13,2"
com.apple.MobileSMS,59,1724259377,1724259436,1724259436.286531,-18000,EB445137-D7F5-57EC-87DA-1DB460D64046,"iPhone13,2"
com.apple.MobileSMS,60,1724259206,1724259266,1724259266.4515162,-18000,EB445137-D7F5-57EC-87DA-1DB460D64046,"iPhone13,2"
com.apple.InCallService,69,1724259137,1724259206,1724259206.0772228,-18000,EB445137-D7F5-57EC-87DA-1DB460D64046,"iPhone13,2"
com.apple.MobileSMS,7,1724259130,1724259137,1724259137.0989208,-18000,EB445137-D7F5-57EC-87DA-1DB460D64046,"iPhone13,2"
com.apple.MobileSMS,2,1724259128,1724259130,1724259130.8277168,-18000,EB445137-D7F5-57EC-87DA-1DB460D64046,"iPhone13,2"
com.apple.MobileSMS,33,1724259009,1724259042,1724259042.237148,-18000,EB445137-D7F5-57EC-87DA-1DB460D64046,"iPhone13,2"
com.apple.camera,2,1724259006,1724259008,1724259008.335681,-18000,EB445137-D7F5-57EC-87DA-1DB460D64046,"iPhone13,2"
com.myfitnesspal.mfp,5,1724259004,1724259009,1724259009.834334,-18000,EB445137-D7F5-57EC-87DA-1DB460D64046,"iPhone13,2"
com.myfitnesspal.mfp,69,1724258563,1724258632,1724258632.351344,-18000,EB445137-D7F5-57EC-87DA-1DB460D64046,"iPhone13,2"
com.myfitnesspal.mfp,71,1724258487,1724258558,1724258558.352512,-18000,EB445137-D7F5-57EC-87DA-1DB460D64046,"iPhone13,2"
com.myfitnesspal.mfp,245,1724258091,1724258336,1724258336.437237,-18000,EB445137-D7F5-57EC-87DA-1DB460D64046,"iPhone13,2"
com.myfitnesspal.mfp,153,1724257882,1724258035,1724258035.186496,-18000,EB445137-D7F5-57EC-87DA-1DB460D64046,"iPhone13,2"
com.myfitnesspal.mfp,118,1724257688,1724257806,1724257806.974513,-18000,EB445137-D7F5-57EC-87DA-1DB460D64046,"iPhone13,2"
com.myfitnesspal.mfp,162,1724257306,1724257468,1724257468.0226579,-18000,EB445137-D7F5-57EC-87DA-1DB460D64046,"iPhone13,2"
com.myfitnesspal.mfp,72,1724257092,1724257164,1724257164.51845,-18000,EB445137-D7F5-57EC-87DA-1DB460D64046,"iPhone13,2"
com.apple.camera,4,1724257088,1724257092,1724257092.767869,-18000,EB445137-D7F5-57EC-87DA-1DB460D64046,"iPhone13,2"
com.apple.camera,194,1724256856,1724257050,1724257050.713431,-18000,EB445137-D7F5-57EC-87DA-1DB460D64046,"iPhone13,2"
com.apple.camera,53,1724256799,1724256852,1724256852.331606,-18000,EB445137-D7F5-57EC-87DA-1DB460D64046,"iPhone13,2"
com.myfitnesspal.mfp,171,1724256613,1724256784,1724256784.18427,-18000,EB445137-D7F5-57EC-87DA-1DB460D64046,"iPhone13,2"
com.myfitnesspal.mfp,22,1724256569,1724256591,1724256591.970261,-18000,EB445137-D7F5-57EC-87DA-1DB460D64046,"iPhone13,2"
com.myfitnesspal.mfp,61,1724256435,1724256496,1724256496.951449,-18000,EB445137-D7F5-57EC-87DA-1DB460D64046,"iPhone13,2"
com.myfitnesspal.mfp,61,1724256341,1724256402,1724256402.306682,-18000,EB445137-D7F5-57EC-87DA-1DB460D64046,"iPhone13,2"
com.myfitnesspal.mfp,176,1724256135,1724256311,1724256311.362704,-18000,EB445137-D7F5-57EC-87DA-1DB460D64046,"iPhone13,2"
com.google.Chrome,2861,1724255820,1724258681,1724258681.991139,-18000,,
com.apple.news,373,1724253099,1724253472,1724253472.915452,-18000,EB445137-D7F5-57EC-87DA-1DB460D64046,"iPhone13,2"
com.toyopagroup.picaboo,36,1724252997,1724253033,1724253033.900172,-18000,EB445137-D7F5-57EC-87DA-1DB460D64046,"iPhone13,2"
com.google.Gmail,15,1724252973,1724252988,1724252988.5496159,-18000,EB445137-D7F5-57EC-87DA-1DB460D64046,"iPhone13,2"
com.apple.mobiletimer,13,1724227008,1724227021,1724227021.2038798,-18000,EB445137-D7F5-57EC-87DA-1DB460D64046,"iPhone13,2"
com.apple.mobiletimer,12,1724226993,1724227005,1724227005.440775,-18000,EB445137-D7F5-57EC-87DA-1DB460D64046,"iPhone13,2"
com.google.Chrome,109,1724212685,1724212794,1724212794.137867,-18000,,
com.google.Chrome,411,1724212271,1724212682,1724212682.570936,-18000,,
com.apple.keychainaccess,4,1724212267,1724212271,1724212272.029585,-18000,,
com.apple.camera,0,1724211850,1724211850,1724211850.711823,-18000,EB445137-D7F5-57EC-87DA-1DB460D64046,"iPhone13,2"
com.apple.camera,1,1724209357,1724209358,1724209358.842128,-18000,EB445137-D7F5-57EC-87DA-1DB460D64046,"iPhone13,2"
com.apple.news,5,1724209346,1724209351,1724209351.016626,-18000,EB445137-D7F5-57EC-87DA-1DB460D64046,"iPhone13,2"
com.apple.keychainaccess,3,1724209297,1724209300,1724209300.477878,-18000,,
com.microsoft.onenote.mac,23,1724209274,1724209297,1724209297.833581,-18000,,
com.google.Chrome,9,1724209265,1724209274,1724209274.885072,-18000,,
com.apple.MobileSMS,22,1724209243,1724209265,1724209265.606998,-18000,,
com.google.Chrome,4,1724209238,1724209242,1724209242.587902,-18000,,
com.google.Chrome,111,1724209014,1724209125,1724209125.2894468,-18000,,
com.microsoft.onenote.mac,85,1724208914,1724208999,1724208999.7575002,-18000,,
com.apple.iCal,8,1724208906,1724208914,1724208914.9356642,-18000,,
com.microsoft.onenote.mac,13,1724208893,1724208906,1724208906.83949,-18000,,
com.apple.systempreferences,0,1724208887,1724208887,1724208888.4142709,-18000,,
com.apple.MobileSMS,1,1724208886,1724208887,1724208887.3654919,-18000,,
com.google.Chrome,159,1724208727,1724208886,1724208886.133195,-18000,,
com.apple.news,19,1724208100,1724208119,1724208119.142671,-18000,EB445137-D7F5-57EC-87DA-1DB460D64046,"iPhone13,2"
com.apple.news,2,1724208068,1724208070,1724208070.2910318,-18000,EB445137-D7F5-57EC-87DA-1DB460D64046,"iPhone13,2"
com.apple.news,31,1724208013,1724208044,1724208044.205075,-18000,EB445137-D7F5-57EC-87DA-1DB460D64046,"iPhone13,2"
com.apple.news,35,1724207978,1724208013,1724208013.259798,-18000,EB445137-D7F5-57EC-87DA-1DB460D64046,"iPhone13,2"
com.apple.Music,22,1724207848,1724207870,1724207870.892074,-18000,EB445137-D7F5-57EC-87DA-1DB460D64046,"iPhone13,2"
com.apple.Music,0,1724207481,1724207481,1724207481.959851,-18000,EB445137-D7F5-57EC-87DA-1DB460D64046,"iPhone13,2"
com.apple.Maps,20,1724207455,1724207475,1724207475.311761,-18000,EB445137-D7F5-57EC-87DA-1DB460D64046,"iPhone13,2"
com.apple.Maps,6,1724206747,1724206753,1724206753.555173,-18000,EB445137-D7F5-57EC-87DA-1DB460D64046,"iPhone13,2"
com.apple.Maps,1,1724206745,1724206746,1724206746.909133,-18000,EB445137-D7F5-57EC-87DA-1DB460D64046,"iPhone13,2"
com.apple.Maps,2,1724206580,1724206582,1724206582.5991812,-18000,EB445137-D7F5-57EC-87DA-1DB460D64046,"iPhone13,2"
com.apple.Maps,4,1724206344,1724206348,1724206348.265108,-18000,EB445137-D7F5-57EC-87DA-1DB460D64046,"iPhone13,2"
com.apple.Maps,2,1724206079,1724206081,1724206081.689066,-18000,EB445137-D7F5-57EC-87DA-1DB460D64046,"iPhone13,2"
com.apple.Maps,5,1724205966,1724205971,1724205971.299166,-18000,EB445137-D7F5-57EC-87DA-1DB460D64046,"iPhone13,2"
com.apple.Maps,6,1724205949,1724205955,1724205955.1206741,-18000,EB445137-D7F5-57EC-87DA-1DB460D64046,"iPhone13,2"
com.apple.Maps,13,1724205935,1724205948,1724205948.517981,-18000,EB445137-D7F5-57EC-87DA-1DB460D64046,"iPhone13,2"
com.apple.Maps,7,1724205921,1724205928,1724205928.1337562,-18000,EB445137-D7F5-57EC-87DA-1DB460D64046,"iPhone13,2"
com.google.ios.youtube,3,1724205918,1724205921,1724205921.1703892,-18000,EB445137-D7F5-57EC-87DA-1DB460D64046,"iPhone13,2"
com.google.ios.youtube,568,1724205292,1724205860,1724205860.2091,-18000,EB445137-D7F5-57EC-87DA-1DB460D64046,"iPhone13,2"
com.google.Chrome,300,1724205184,1724205484,1724205484.415876,-18000,,
com.apple.keychainaccess,154,1724205030,1724205184,1724205184.442375,-18000,,
com.truebill.truebillnative,281,1724205008,1724205289,1724205290.104804,-18000,EB445137-D7F5-57EC-87DA-1DB460D64046,"iPhone13,2"
com.google.Chrome,41,1724204982,1724205023,1724205023.9085999,-18000,,
com.apple.keychainaccess,28,1724204954,1724204982,1724204982.351121,-18000,,
com.google.Chrome,25,1724204929,1724204954,1724204954.8907928,-18000,,
com.apple.AppStore,107,1724204524,1724204631,1724204631.962821,-18000,EB445137-D7F5-57EC-87DA-1DB460D64046,"iPhone13,2"
com.google.chrome.ios,56,1724204467,1724204523,1724204523.4851289,-18000,EB445137-D7F5-57EC-87DA-1DB460D64046,"iPhone13,2"
com.google.ios.youtube,4,1724204463,1724204467,1724204467.02617,-18000,EB445137-D7F5-57EC-87DA-1DB460D64046,"iPhone13,2"
com.google.ios.youtube,2,1724204447,1724204449,1724204449.478584,-18000,EB445137-D7F5-57EC-87DA-1DB460D64046,"iPhone13,2"
com.apple.camera,11,1724204380,1724204391,1724204391.262588,-18000,EB445137-D7F5-57EC-87DA-1DB460D64046,"iPhone13,2"
com.google.ios.youtube,13,1724204378,1724204391,1724204391.259585,-18000,EB445137-D7F5-57EC-87DA-1DB460D64046,"iPhone13,2"
com.google.ios.youtube,253,1724204081,1724204334,1724204334.638723,-18000,EB445137-D7F5-57EC-87DA-1DB460D64046,"iPhone13,2"
com.toyopagroup.picaboo,7,1724204057,1724204064,1724204064.8763242,-18000,EB445137-D7F5-57EC-87DA-1DB460D64046,"iPhone13,2"
com.toyopagroup.picaboo,1,1724204032,1724204033,1724204033.8688369,-18000,EB445137-D7F5-57EC-87DA-1DB460D64046,"iPhone13,2"
com.apple.camera,9,1724203916,1724203925,1724203925.3682408,-18000,EB445137-D7F5-57EC-87DA-1DB460D64046,"iPhone13,2"
com.toyopagroup.picaboo,10,1724203915,1724203925,1724203925.36545,-18000,EB445137-D7F5-57EC-87DA-1DB460D64046,"iPhone13,2"
com.toyopagroup.picaboo,46,1724203807,1724203853,1724203853.2877212,-18000,EB445137-D7F5-57EC-87DA-1DB460D64046,"iPhone13,2"
com.apple.camera,0,1724203498,1724203498,1724203498.5084,-18000,EB445137-D7F5-57EC-87DA-1DB460D64046,"iPhone13,2"
com.toyopagroup.picaboo,23,1724203472,1724203495,1724203495.6658149,-18000,EB445137-D7F5-57EC-87DA-1DB460D64046,"iPhone13,2"
com.google.Chrome,396,1724197950,1724198346,1724198347.217216,-18000,,
com.google.Chrome,461,1724197233,1724197694,1724197694.501482,-18000,,
com.google.Chrome,485,1724196738,1724197223,1724197224.012084,-18000,,
com.google.Chrome,468,1724195805,1724196273,1724196273.9089022,-18000,,
com.google.Chrome,8,1724188769,1724188777,1724188777.546062,-18000,,
com.google.Chrome,95,1724188642,1724188737,1724188737.78714,-18000,,
com.apple.systempreferences,3,1724188639,1724188642,1724188642.16554,-18000,,
com.google.Chrome,1,1724188511,1724188512,1724188512.913317,-18000,,
com.apple.systempreferences,31,1724188480,1724188511,1724188511.916318,-18000,,
com.google.Chrome,194,1724188279,1724188473,1724188473.9366012,-18000,,
com.apple.MobileSMS,4,1724178043,1724178047,1724178047.431243,-18000,EB445137-D7F5-57EC-87DA-1DB460D64046,"iPhone13,2"
com.apple.MobileSMS,8,1724177827,1724177835,1724177835.1467218,-18000,EB445137-D7F5-57EC-87DA-1DB460D64046,"iPhone13,2"
com.toyopagroup.picaboo,1,1724177826,1724177827,1724177827.791538,-18000,EB445137-D7F5-57EC-87DA-1DB460D64046,"iPhone13,2"
com.toyopagroup.picaboo,7,1724177765,1724177772,1724177772.494065,-18000,EB445137-D7F5-57EC-87DA-1DB460D64046,"iPhone13,2"
com.toyopagroup.picaboo,81,1724177676,1724177757,1724177757.235918,-18000,EB445137-D7F5-57EC-87DA-1DB460D64046,"iPhone13,2"
com.apple.MobileSMS,82,1724177594,1724177676,1724177676.490113,-18000,EB445137-D7F5-57EC-87DA-1DB460D64046,"iPhone13,2"
com.apple.camera,0,1724177494,1724177494,1724177494.973641,-18000,EB445137-D7F5-57EC-87DA-1DB460D64046,"iPhone13,2"
com.toyopagroup.picaboo,5,1724177486,1724177491,1724177491.527515,-18000,EB445137-D7F5-57EC-87DA-1DB460D64046,"iPhone13,2"
com.apple.MobileSMS,3,1724177483,1724177486,1724177486.954036,-18000,EB445137-D7F5-57EC-87DA-1DB460D64046,"iPhone13,2"
com.apple.MobileSMS,22,1724177402,1724177424,1724177424.023175,-18000,EB445137-D7F5-57EC-87DA-1DB460D64046,"iPhone13,2"
com.toyopagroup.picaboo,1,1724177400,1724177401,1724177402.018311,-18000,EB445137-D7F5-57EC-87DA-1DB460D64046,"iPhone13,2"
com.toyopagroup.picaboo,17,1724177379,1724177396,1724177396.307516,-18000,EB445137-D7F5-57EC-87DA-1DB460D64046,"iPhone13,2"
com.apple.MobileSMS,3,1724177376,1724177379,1724177379.253998,-18000,EB445137-D7F5-57EC-87DA-1DB460D64046,"iPhone13,2"
com.toyopagroup.picaboo,93,1724177283,1724177376,1724177376.77321,-18000,EB445137-D7F5-57EC-87DA-1DB460D64046,"iPhone13,2"
com.apple.MobileSMS,108,1724177175,1724177283,1724177284.309598,-18000,EB445137-D7F5-57EC-87DA-1DB460D64046,"iPhone13,2"
com.apple.MobileSMS,7,1724177120,1724177127,1724177127.7874808,-18000,EB445137-D7F5-57EC-87DA-1DB460D64046,"iPhone13,2"
com.apple.MobileSMS,10,1724177059,1724177069,1724177069.369736,-18000,EB445137-D7F5-57EC-87DA-1DB460D64046,"iPhone13,2"
com.apple.MobileSMS,58,1724176985,1724177043,1724177043.472211,-18000,EB445137-D7F5-57EC-87DA-1DB460D64046,"iPhone13,2"
com.apple.findmy,32,1724176681,1724176713,1724176714.0567641,-18000,EB445137-D7F5-57EC-87DA-1DB460D64046,"iPhone13,2"
com.apple.MobileSMS,2,1724176679,1724176681,1724176681.291668,-18000,EB445137-D7F5-57EC-87DA-1DB460D64046,"iPhone13,2"
com.apple.MobileSMS,19,1724176659,1724176678,1724176678.127078,-18000,EB445137-D7F5-57EC-87DA-1DB460D64046,"iPhone13,2"
com.toyopagroup.picaboo,11,1724176647,1724176658,1724176658.158654,-18000,EB445137-D7F5-57EC-87DA-1DB460D64046,"iPhone13,2"
com.apple.camera,82,1724176562,1724176644,1724176644.8731809,-18000,EB445137-D7F5-57EC-87DA-1DB460D64046,"iPhone13,2"
com.apple.camera,8,1724176371,1724176379,1724176382.604264,-18000,EB445137-D7F5-57EC-87DA-1DB460D64046,"iPhone13,2"
com.toyopagroup.picaboo,8,1724176370,1724176378,1724176382.310804,-18000,EB445137-D7F5-57EC-87DA-1DB460D64046,"iPhone13,2"
com.toyopagroup.picaboo,11,1724176324,1724176335,1724176335.956397,-18000,EB445137-D7F5-57EC-87DA-1DB460D64046,"iPhone13,2"
com.toyopagroup.picaboo,27,1724176258,1724176285,1724176285.1761432,-18000,EB445137-D7F5-57EC-87DA-1DB460D64046,"iPhone13,2"
com.toyopagroup.picaboo,24,1724176141,1724176165,1724176165.119666,-18000,EB445137-D7F5-57EC-87DA-1DB460D64046,"iPhone13,2"
com.apple.InCallService,28,1724176113,1724176141,1724176141.088859,-18000,EB445137-D7F5-57EC-87DA-1DB460D64046,"iPhone13,2"
com.toyopagroup.picaboo,44,1724176069,1724176113,1724176113.261199,-18000,EB445137-D7F5-57EC-87DA-1DB460D64046,"iPhone13,2"
com.apple.InCallService,77,1724175991,1724176068,1724176068.2300038,-18000,EB445137-D7F5-57EC-87DA-1DB460D64046,"iPhone13,2"
com.toyopagroup.picaboo,7,1724175984,1724175991,1724175991.796375,-18000,EB445137-D7F5-57EC-87DA-1DB460D64046,"iPhone13,2"
com.apple.InCallService,65,1724175919,1724175984,1724175984.336884,-18000,EB445137-D7F5-57EC-87DA-1DB460D64046,"iPhone13,2"
com.toyopagroup.picaboo,16,1724175903,1724175919,1724175919.604361,-18000,EB445137-D7F5-57EC-87DA-1DB460D64046,"iPhone13,2"
com.apple.InCallService,128,1724175775,1724175903,1724175903.900868,-18000,EB445137-D7F5-57EC-87DA-1DB460D64046,"iPhone13,2"
com.apple.mobilephone,18,1724175757,1724175775,1724175775.820897,-18000,EB445137-D7F5-57EC-87DA-1DB460D64046,"iPhone13,2"
com.apple.InCallService,2,1724175755,1724175757,1724175757.5224261,-18000,EB445137-D7F5-57EC-87DA-1DB460D64046,"iPhone13,2"
com.apple.mobilephone,5,1724175750,1724175755,1724175755.486915,-18000,EB445137-D7F5-57EC-87DA-1DB460D64046,"iPhone13,2"
com.toyopagroup.picaboo,60,1724175690,1724175750,1724175750.6156712,-18000,EB445137-D7F5-57EC-87DA-1DB460D64046,"iPhone13,2"
com.apple.mobilephone,20,1724175670,1724175690,1724175690.600648,-18000,EB445137-D7F5-57EC-87DA-1DB460D64046,"iPhone13,2"
com.toyopagroup.picaboo,42,1724175618,1724175660,1724175660.5879102,-18000,EB445137-D7F5-57EC-87DA-1DB460D64046,"iPhone13,2"
com.toyopagroup.picaboo,40,1724175541,1724175581,1724175581.072456,-18000,EB445137-D7F5-57EC-87DA-1DB460D64046,"iPhone13,2"
com.apple.Maps,5,1724175532,1724175537,1724175537.682318,-18000,EB445137-D7F5-57EC-87DA-1DB460D64046,"iPhone13,2"
com.apple.Maps,65,1724174968,1724175033,1724175033.082384,-18000,EB445137-D7F5-57EC-87DA-1DB460D64046,"iPhone13,2"
com.apple.Maps,45,1724174817,1724174862,1724174862.822102,-18000,EB445137-D7F5-57EC-87DA-1DB460D64046,"iPhone13,2"
com.apple.Maps,4,1724174810,1724174814,1724174814.985816,-18000,EB445137-D7F5-57EC-87DA-1DB460D64046,"iPhone13,2"
com.apple.Maps,14,1724174764,1724174778,1724174778.493665,-18000,EB445137-D7F5-57EC-87DA-1DB460D64046,"iPhone13,2"
com.apple.Maps,77,1724174281,1724174358,1724174358.9438019,-18000,EB445137-D7F5-57EC-87DA-1DB460D64046,"iPhone13,2"
com.apple.Maps,1,1724174280,1724174281,1724174281.4487162,-18000,EB445137-D7F5-57EC-87DA-1DB460D64046,"iPhone13,2"
com.toyopagroup.picaboo,76,1724174204,1724174280,1724174280.393945,-18000,EB445137-D7F5-57EC-87DA-1DB460D64046,"iPhone13,2"
com.apple.Maps,76,1724174204,1724174280,1724174280.361596,-18000,EB445137-D7F5-57EC-87DA-1DB460D64046,"iPhone13,2"
com.toyopagroup.picaboo,7,1724173970,1724173977,1724173977.283451,-18000,EB445137-D7F5-57EC-87DA-1DB460D64046,"iPhone13,2"
com.apple.Maps,597,1724173605,1724174202,1724174203.3574162,-18000,EB445137-D7F5-57EC-87DA-1DB460D64046,"iPhone13,2"
com.toyopagroup.picaboo,19,1724173578,1724173597,1724173597.8555598,-18000,EB445137-D7F5-57EC-87DA-1DB460D64046,"iPhone13,2"
com.toyopagroup.picaboo,16,1724173409,1724173425,1724173425.836156,-18000,EB445137-D7F5-57EC-87DA-1DB460D64046,"iPhone13,2"
com.toyopagroup.picaboo,8,1724173326,1724173334,1724173334.461958,-18000,EB445137-D7F5-57EC-87DA-1DB460D64046,"iPhone13,2"
com.toyopagroup.picaboo,13,1724173292,1724173305,1724173305.969089,-18000,EB445137-D7F5-57EC-87DA-1DB460D64046,"iPhone13,2"
com.toyopagroup.picaboo,23,1724173092,1724173115,1724173115.9569159,-18000,EB445137-D7F5-57EC-87DA-1DB460D64046,"iPhone13,2"
com.toyopagroup.picaboo,3,1724173088,1724173091,1724173092.2564821,-18000,EB445137-D7F5-57EC-87DA-1DB460D64046,"iPhone13,2"
com.toyopagroup.picaboo,8,1724170843,1724170851,1724170851.733144,-18000,EB445137-D7F5-57EC-87DA-1DB460D64046,"iPhone13,2"
com.toyopagroup.picaboo,16,1724170804,1724170820,1724170820.483151,-18000,EB445137-D7F5-57EC-87DA-1DB460D64046,"iPhone13,2"
com.apple.Maps,5,1724170804,1724170809,1724170809.856021,-18000,EB445137-D7F5-57EC-87DA-1DB460D64046,"iPhone13,2"
com.toyopagroup.picaboo,6,1724170793,1724170799,1724170802.6768332,-18000,EB445137-D7F5-57EC-87DA-1DB460D64046,"iPhone13,2"
com.apple.podcasts,23,1724169310,1724169333,1724169333.998626,-18000,EB445137-D7F5-57EC-87DA-1DB460D64046,"iPhone13,2"
com.apple.podcasts,5,1724168742,1724168747,1724168747.987798,-18000,EB445137-D7F5-57EC-87DA-1DB460D64046,"iPhone13,2"
com.toyopagroup.picaboo,15,1724165299,1724165314,1724165314.464495,-18000,EB445137-D7F5-57EC-87DA-1DB460D64046,"iPhone13,2"
com.apple.Maps,3,1724165296,1724165299,1724165300.085382,-18000,EB445137-D7F5-57EC-87DA-1DB460D64046,"iPhone13,2"
com.apple.Maps,2,1724164545,1724164547,1724164547.742167,-18000,EB445137-D7F5-57EC-87DA-1DB460D64046,"iPhone13,2"
com.apple.Maps,2,1724164424,1724164426,1724164426.478001,-18000,EB445137-D7F5-57EC-87DA-1DB460D64046,"iPhone13,2"
com.apple.Maps,2,1724164340,1724164342,1724164342.3242512,-18000,EB445137-D7F5-57EC-87DA-1DB460D64046,"iPhone13,2"
com.toyopagroup.picaboo,29,1724164311,1724164340,1724164340.6929479,-18000,EB445137-D7F5-57EC-87DA-1DB460D64046,"iPhone13,2"
com.apple.Maps,8,1724164303,1724164311,1724164311.898951,-18000,EB445137-D7F5-57EC-87DA-1DB460D64046,"iPhone13,2"
com.apple.podcasts,94,1724164209,1724164303,1724164303.774286,-18000,EB445137-D7F5-57EC-87DA-1DB460D64046,"iPhone13,2"
com.apple.Music,13,1724164194,1724164207,1724164208.77709,-18000,EB445137-D7F5-57EC-87DA-1DB460D64046,"iPhone13,2"
com.apple.Maps,8,1724164185,1724164193,1724164193.8009791,-18000,EB445137-D7F5-57EC-87DA-1DB460D64046,"iPhone13,2"
com.truebill.truebillnative,4,1724164181,1724164185,1724164185.534837,-18000,EB445137-D7F5-57EC-87DA-1DB460D64046,"iPhone13,2"
com.apple.Maps,5,1724164176,1724164181,1724164185.15608,-18000,EB445137-D7F5-57EC-87DA-1DB460D64046,"iPhone13,2"
com.truebill.truebillnative,80,1724163626,1724163706,1724163706.687624,-18000,EB445137-D7F5-57EC-87DA-1DB460D64046,"iPhone13,2"
com.apple.Maps,46,1724163579,1724163625,1724163626.042439,-18000,EB445137-D7F5-57EC-87DA-1DB460D64046,"iPhone13,2"
com.google.Gmail,24,1724163555,1724163579,1724163579.48661,-18000,EB445137-D7F5-57EC-87DA-1DB460D64046,"iPhone13,2"
com.apple.Maps,1,1724163551,1724163552,1724163552.8813171,-18000,EB445137-D7F5-57EC-87DA-1DB460D64046,"iPhone13,2"
com.apple.Health,7,1724163535,1724163542,1724163542.2455611,-18000,EB445137-D7F5-57EC-87DA-1DB460D64046,"iPhone13,2"
com.microsoft.Office.Outlook,9,1724163526,1724163535,1724163535.844071,-18000,EB445137-D7F5-57EC-87DA-1DB460D64046,"iPhone13,2"
com.google.chrome.ios,7,1724163519,1724163526,1724163526.299937,-18000,EB445137-D7F5-57EC-87DA-1DB460D64046,"iPhone13,2"
com.apple.mobilecal,27,1724163492,1724163519,1724163519.851754,-18000,EB445137-D7F5-57EC-87DA-1DB460D64046,"iPhone13,2"
com.google.chrome.ios,2,1724163490,1724163492,1724163492.389312,-18000,EB445137-D7F5-57EC-87DA-1DB460D64046,"iPhone13,2"
com.apple.mobilecal,22,1724163468,1724163490,1724163490.849544,-18000,EB445137-D7F5-57EC-87DA-1DB460D64046,"iPhone13,2"
com.google.chrome.ios,61,1724163407,1724163468,1724163468.1896381,-18000,EB445137-D7F5-57EC-87DA-1DB460D64046,"iPhone13,2"
com.apple.mobilecal,5,1724163402,1724163407,1724163407.8681011,-18000,EB445137-D7F5-57EC-87DA-1DB460D64046,"iPhone13,2"
com.google.chrome.ios,4,1724163398,1724163402,1724163402.3803759,-18000,EB445137-D7F5-57EC-87DA-1DB460D64046,"iPhone13,2"
com.apple.mobilecal,3,1724163395,1724163398,1724163398.687886,-18000,EB445137-D7F5-57EC-87DA-1DB460D64046,"iPhone13,2"
com.google.chrome.ios,4,1724163391,1724163395,1724163395.555434,-18000,EB445137-D7F5-57EC-87DA-1DB460D64046,"iPhone13,2"
com.apple.mobilecal,6,1724163385,1724163391,1724163391.464834,-18000,EB445137-D7F5-57EC-87DA-1DB460D64046,"iPhone13,2"
com.google.chrome.ios,18,1724163363,1724163381,1724163381.984359,-18000,EB445137-D7F5-57EC-87DA-1DB460D64046,"iPhone13,2"
com.microsoft.Office.Outlook,23,1724163340,1724163363,1724163363.28562,-18000,EB445137-D7F5-57EC-87DA-1DB460D64046,"iPhone13,2"
com.apple.Preferences,14,1724159958,1724159972,1724159972.8074589,-18000,EB445137-D7F5-57EC-87DA-1DB460D64046,"iPhone13,2"
com.google.Chrome,374,1724121474,1724121848,1724121848.096713,-18000,,
