app,usage,start_time,end_time,created_at,tz,device_id,device_model
com.apple.finder,3,1746808192,1746808195,1746808195.66743,-18000,,
com.apple.Terminal,4,1746808188,1746808192,1746808192.2669039,-18000,,
com.apple.finder,13,1746808175,1746808188,1746808188.634613,-18000,,
com.leomehlig.today,58,1746808110,1746808168,1746808168.8702068,-18000,,
com.leomehlig.today,18,1746746212,1746746230,1746746231.091999,-18000,,
com.google.Chrome,8,1746746204,1746746212,1746746212.725591,-18000,,
com.apple.finder,125,1746746079,1746746204,1746746204.70906,-18000,,
com.apple.Preview,4,1746746075,1746746079,1746746079.817768,-18000,,
com.apple.finder,50,1746746025,1746746075,1746746075.87858,-18000,,
com.apple.archiveutility,1,1746746024,1746746025,1746746025.403654,-18000,,
com.apple.finder,41,1746745983,1746746024,1746746024.740171,-18000,,
com.google.Chrome,0,1746745983,1746745983,1746745983.989717,-18000,,
com.apple.finder,42,1746745941,1746745983,1746745983.389584,-18000,,
com.google.Chrome,38,1746745903,1746745941,1746745941.1003299,-18000,,
com.apple.finder,59,1746745844,1746745903,1746745903.348789,-18000,,
com.apple.Preview,29,1746745815,1746745844,1746745844.3205252,-18000,,
com.apple.finder,134,1746745681,1746745815,1746745815.8300018,-18000,,
com.apple.archiveutility,0,1746745681,1746745681,1746745681.735962,-18000,,
com.apple.finder,128,1746745553,1746745681,1746745681.108151,-18000,,
com.apple.MobileSMS,7,1746745546,1746745553,1746745553.738347,-18000,,
com.apple.finder,3,1746745543,1746745546,1746745546.9098148,-18000,,
com.apple.MobileSMS,41,1746745502,1746745543,1746745543.46297,-18000,,
com.apple.finder,242,1746745260,1746745502,1746745502.3208408,-18000,,
com.apple.TextEdit,3,1746745257,1746745260,1746745260.862677,-18000,,
com.apple.finder,90,1746745167,1746745257,1746745257.785296,-18000,,
com.apple.finder,307,1746743628,1746743935,1746743935.224424,-18000,,
com.google.Chrome,2,1746743626,1746743628,1746743628.277494,-18000,,
com.intsig.CamScannerLite,2,1746743434,1746743436,1746743436.309557,-18000,EB445137-D7F5-57EC-87DA-1DB460D64046,"iPhone13,2"
com.intsig.CamScannerLite,80,1746743332,1746743412,1746743416.310591,-18000,EB445137-D7F5-57EC-87DA-1DB460D64046,"iPhone13,2"
com.google.chrome.ios,30,1746742899,1746742929,1746742929.560035,-18000,EB445137-D7F5-57EC-87DA-1DB460D64046,"iPhone13,2"
com.thestorygraph.thestorygraph,20,1746742596,1746742616,1746742616.916379,-18000,EB445137-D7F5-57EC-87DA-1DB460D64046,"iPhone13,2"
com.apple.CoreAuthUI,7,1746742586,1746742593,1746742593.247545,-18000,EB445137-D7F5-57EC-87DA-1DB460D64046,"iPhone13,2"
com.truebill.truebillnative,12,1746742582,1746742594,1746742594.986263,-18000,EB445137-D7F5-57EC-87DA-1DB460D64046,"iPhone13,2"
com.apple.InCallService,77,1746742501,1746742578,1746742578.793741,-18000,EB445137-D7F5-57EC-87DA-1DB460D64046,"iPhone13,2"
com.apple.findmy,10,1746742491,1746742501,1746742501.351962,-18000,EB445137-D7F5-57EC-87DA-1DB460D64046,"iPhone13,2"
com.apple.InCallService,633,1746741857,1746742490,1746742490.961131,-18000,EB445137-D7F5-57EC-87DA-1DB460D64046,"iPhone13,2"
com.apple.mobilecal,18,1746741839,1746741857,1746741857.879226,-18000,EB445137-D7F5-57EC-87DA-1DB460D64046,"iPhone13,2"
com.apple.InCallService,775,1746741059,1746741834,1746741834.3346848,-18000,EB445137-D7F5-57EC-87DA-1DB460D64046,"iPhone13,2"
com.apple.mobilephone,5,1746741054,1746741059,1746741059.72885,-18000,EB445137-D7F5-57EC-87DA-1DB460D64046,"iPhone13,2"
com.apple.findmy,10,1746741044,1746741054,1746741054.4579592,-18000,EB445137-D7F5-57EC-87DA-1DB460D64046,"iPhone13,2"
com.groupme.iphone-app,2,1746737781,1746737783,1746737783.576116,-18000,EB445137-D7F5-57EC-87DA-1DB460D64046,"iPhone13,2"
com.intsig.CamScannerLite,1,1746737780,1746737781,1746737782.050853,-18000,EB445137-D7F5-57EC-87DA-1DB460D64046,"iPhone13,2"
com.intsig.CamScannerLite,290,1746735871,1746736161,1746736162.299866,-18000,EB445137-D7F5-57EC-87DA-1DB460D64046,"iPhone13,2"
com.google.Chrome,452,1746735681,1746736133,1746736133.879915,-18000,,
com.leomehlig.today,2,1746735679,1746735681,1746735681.227481,-18000,,
com.leomehlig.today,0,1746735676,1746735676,1746735676.807615,-18000,,
com.intsig.CamScannerLite,420,1746735011,1746735431,1746735431.247458,-18000,EB445137-D7F5-57EC-87DA-1DB460D64046,"iPhone13,2"
com.intsig.CamScannerLite,667,1746734282,1746734949,1746734949.6866899,-18000,EB445137-D7F5-57EC-87DA-1DB460D64046,"iPhone13,2"
com.toyopagroup.picaboo,4,1746734278,1746734282,1746734282.979876,-18000,EB445137-D7F5-57EC-87DA-1DB460D64046,"iPhone13,2"
com.intsig.CamScannerLite,0,1746734278,1746734278,1746734279.668174,-18000,EB445137-D7F5-57EC-87DA-1DB460D64046,"iPhone13,2"
com.intsig.CamScannerLite,223,1746734051,1746734274,1746734274.386485,-18000,EB445137-D7F5-57EC-87DA-1DB460D64046,"iPhone13,2"
com.intsig.CamScannerLite,595,1746733350,1746733945,1746733945.9989781,-18000,EB445137-D7F5-57EC-87DA-1DB460D64046,"iPhone13,2"
com.intsig.CamScannerLite,327,1746732889,1746733216,1746733216.746094,-18000,EB445137-D7F5-57EC-87DA-1DB460D64046,"iPhone13,2"
com.toyopagroup.picaboo,22,1746732568,1746732590,1746732590.8323278,-18000,EB445137-D7F5-57EC-87DA-1DB460D64046,"iPhone13,2"
com.apple.news,1213,1746731347,1746732560,1746732560.686389,-18000,EB445137-D7F5-57EC-87DA-1DB460D64046,"iPhone13,2"
com.tier9digital.sundial,1,1746731339,1746731340,1746731341.101225,-18000,EB445137-D7F5-57EC-87DA-1DB460D64046,"iPhone13,2"
com.leomehlig.today,319,1746731301,1746731620,1746731620.952989,-18000,,
com.google.Chrome,13,1746731288,1746731301,1746731301.8837528,-18000,,
com.google.Chrome,518,1746730323,1746730841,1746730841.990979,-18000,,
com.tier9digital.sundial,6,1746729634,1746729640,1746729640.7292109,-18000,EB445137-D7F5-57EC-87DA-1DB460D64046,"iPhone13,2"
Astrospheric.Astrospheric,25,1746729605,1746729630,1746729630.4908261,-18000,EB445137-D7F5-57EC-87DA-1DB460D64046,"iPhone13,2"
com.instructure.icanvas,2,1746729600,1746729602,1746729602.602515,-18000,EB445137-D7F5-57EC-87DA-1DB460D64046,"iPhone13,2"
com.google.Chrome,608,1746729332,1746729940,1746729940.927167,-18000,,
com.apple.MobileSMS,6,1746729273,1746729279,1746729279.578048,-18000,EB445137-D7F5-57EC-87DA-1DB460D64046,"iPhone13,2"
com.strava.stravaride,22,1746729250,1746729272,1746729272.113056,-18000,EB445137-D7F5-57EC-87DA-1DB460D64046,"iPhone13,2"
com.strava.stravaride,16,1746729233,1746729249,1746729249.374372,-18000,EB445137-D7F5-57EC-87DA-1DB460D64046,"iPhone13,2"
com.apple.Fitness,19,1746729214,1746729233,1746729233.8323588,-18000,EB445137-D7F5-57EC-87DA-1DB460D64046,"iPhone13,2"
com.strava.stravaride,121,1746729090,1746729211,1746729211.9899468,-18000,EB445137-D7F5-57EC-87DA-1DB460D64046,"iPhone13,2"
com.google.chrome.ios,2,1746729088,1746729090,1746729091.106707,-18000,EB445137-D7F5-57EC-87DA-1DB460D64046,"iPhone13,2"
com.leomehlig.today,328,1746728979,1746729307,1746729307.40568,-18000,,
com.google.Chrome,6,1746728973,1746728979,1746728979.425037,-18000,,
com.google.chrome.ios,56,1746728589,1746728645,1746728645.789195,-18000,EB445137-D7F5-57EC-87DA-1DB460D64046,"iPhone13,2"
com.apple.news,378,1746728209,1746728587,1746728588.03421,-18000,EB445137-D7F5-57EC-87DA-1DB460D64046,"iPhone13,2"
com.apple.CoreAuthUI,6,1746728155,1746728161,1746728161.6996632,-18000,EB445137-D7F5-57EC-87DA-1DB460D64046,"iPhone13,2"
com.robinhood.release.Robinhood,53,1746728149,1746728202,1746728202.4539661,-18000,EB445137-D7F5-57EC-87DA-1DB460D64046,"iPhone13,2"
com.apple.news,106,1746728041,1746728147,1746728147.980819,-18000,EB445137-D7F5-57EC-87DA-1DB460D64046,"iPhone13,2"
com.apple.MobileSMS,2,1746728034,1746728036,1746728036.984613,-18000,EB445137-D7F5-57EC-87DA-1DB460D64046,"iPhone13,2"
com.apple.MobileSMS,9,1746727508,1746727517,1746727517.9506788,-18000,EB445137-D7F5-57EC-87DA-1DB460D64046,"iPhone13,2"
com.microsoft.Office.Outlook,22,1746726819,1746726841,1746726841.3154511,-18000,EB445137-D7F5-57EC-87DA-1DB460D64046,"iPhone13,2"
com.apple.news,332,1746726484,1746726816,1746726816.260226,-18000,EB445137-D7F5-57EC-87DA-1DB460D64046,"iPhone13,2"
com.apple.MobileSMS,36,1746726448,1746726484,1746726484.2957249,-18000,EB445137-D7F5-57EC-87DA-1DB460D64046,"iPhone13,2"
com.apple.news,35,1746726413,1746726448,1746726448.3522,-18000,EB445137-D7F5-57EC-87DA-1DB460D64046,"iPhone13,2"
com.apple.news,25,1746726385,1746726410,1746726410.938313,-18000,EB445137-D7F5-57EC-87DA-1DB460D64046,"iPhone13,2"
com.google.chrome.ios,2,1746726381,1746726383,1746726383.1198912,-18000,EB445137-D7F5-57EC-87DA-1DB460D64046,"iPhone13,2"
com.apple.MobileSMS,21,1746726360,1746726381,1746726381.192229,-18000,EB445137-D7F5-57EC-87DA-1DB460D64046,"iPhone13,2"
com.google.chrome.ios,6,1746726354,1746726360,1746726360.835552,-18000,EB445137-D7F5-57EC-87DA-1DB460D64046,"iPhone13,2"
com.apple.MobileSMS,39,1746726315,1746726354,1746726354.070767,-18000,EB445137-D7F5-57EC-87DA-1DB460D64046,"iPhone13,2"
com.apple.news,0,1746726315,1746726315,1746726316.873168,-18000,EB445137-D7F5-57EC-87DA-1DB460D64046,"iPhone13,2"
com.apple.news,81,1746725452,1746725533,1746725534.2081552,-18000,EB445137-D7F5-57EC-87DA-1DB460D64046,"iPhone13,2"
com.google.chrome.ios,578,1746724872,1746725450,1746725450.673411,-18000,EB445137-D7F5-57EC-87DA-1DB460D64046,"iPhone13,2"
com.apple.news,22,1746724850,1746724872,1746724872.793937,-18000,EB445137-D7F5-57EC-87DA-1DB460D64046,"iPhone13,2"
com.google.chrome.ios,461,1746724386,1746724847,1746724847.713516,-18000,EB445137-D7F5-57EC-87DA-1DB460D64046,"iPhone13,2"
com.google.chrome.ios,82,1746724303,1746724385,1746724385.4164538,-18000,EB445137-D7F5-57EC-87DA-1DB460D64046,"iPhone13,2"
com.apple.news,8,1746724288,1746724296,1746724297.025752,-18000,EB445137-D7F5-57EC-87DA-1DB460D64046,"iPhone13,2"
com.google.Chrome,220,1746720924,1746721144,1746721144.489116,-18000,,
com.apple.finder,2,1746720922,1746720924,1746720924.972176,-18000,,
com.microsoft.Office.Outlook,13,1746719848,1746719861,1746719861.965911,-18000,EB445137-D7F5-57EC-87DA-1DB460D64046,"iPhone13,2"
com.tinyspeck.chatlyio,15,1746719828,1746719843,1746719843.649846,-18000,EB445137-D7F5-57EC-87DA-1DB460D64046,"iPhone13,2"
com.tinyspeck.chatlyio,59,1746719729,1746719788,1746719788.972415,-18000,EB445137-D7F5-57EC-87DA-1DB460D64046,"iPhone13,2"
com.microsoft.Office.Outlook,24,1746719705,1746719729,1746719729.41694,-18000,EB445137-D7F5-57EC-87DA-1DB460D64046,"iPhone13,2"
com.tinyspeck.chatlyio,29,1746719676,1746719705,1746719705.426958,-18000,EB445137-D7F5-57EC-87DA-1DB460D64046,"iPhone13,2"
com.tinyspeck.chatlyio,79,1746719596,1746719675,1746719675.7853951,-18000,EB445137-D7F5-57EC-87DA-1DB460D64046,"iPhone13,2"
com.microsoft.Office.Outlook,55,1746719534,1746719589,1746719589.331296,-18000,EB445137-D7F5-57EC-87DA-1DB460D64046,"iPhone13,2"
com.apple.finder,2,1746719195,1746719197,1746719197.515527,-18000,,
com.leomehlig.today,87,1746719108,1746719195,1746719195.7724009,-18000,,
com.google.Chrome,55,1746719053,1746719108,1746719108.551151,-18000,,
com.apple.Preview,676,1746718377,1746719053,1746719053.8382468,-18000,,
com.google.Chrome,2,1746718375,1746718377,1746718377.896356,-18000,,
com.apple.Preview,8,1746718367,1746718375,1746718375.8121681,-18000,,
com.google.Chrome,28,1746718339,1746718367,1746718367.040806,-18000,,
com.apple.Preview,82,1746718257,1746718339,1746718339.824362,-18000,,
com.google.Chrome,1,1746718256,1746718257,1746718257.336019,-18000,,
com.apple.Preview,1,1746718255,1746718256,1746718256.7233071,-18000,,
com.google.Chrome,35,1746718220,1746718255,1746718255.413447,-18000,,
com.apple.Preview,10,1746718210,1746718220,1746718220.959848,-18000,,
com.google.Chrome,19,1746718191,1746718210,1746718210.1996279,-18000,,
com.apple.Preview,440,1746717751,1746718191,1746718191.398504,-18000,,
com.google.Chrome,0,1746717751,1746717751,1746717751.8792748,-18000,,
com.apple.Preview,4,1746717747,1746717751,1746717751.3050761,-18000,,
com.google.Chrome,1,1746717746,1746717747,1746717747.3320541,-18000,,
com.apple.Preview,29,1746717717,1746717746,1746717746.613614,-18000,,
com.google.Chrome,1,1746717716,1746717717,1746717717.976743,-18000,,
com.apple.finder,1,1746717715,1746717716,1746717716.1183329,-18000,,
com.apple.Preview,41,1746717674,1746717715,1746717715.300476,-18000,,
com.apple.finder,3,1746717671,1746717674,1746717674.826505,-18000,,
com.apple.Preview,99,1746717572,1746717671,1746717671.880265,-18000,,
com.google.Chrome,10,1746717562,1746717572,1746717572.673727,-18000,,
com.apple.Preview,2,1746717560,1746717562,1746717562.230874,-18000,,
com.google.Chrome,1,1746717559,1746717560,1746717560.3977199,-18000,,
com.apple.Preview,348,1746717211,1746717559,1746717559.134176,-18000,,
com.apple.news,42,1746717155,1746717197,1746717197.328123,-18000,EB445137-D7F5-57EC-87DA-1DB460D64046,"iPhone13,2"
com.google.chrome.ios,0,1746717155,1746717155,1746717155.957597,-18000,EB445137-D7F5-57EC-87DA-1DB460D64046,"iPhone13,2"
com.apple.Preview,369,1746716831,1746717200,1746717200.0081959,-18000,,
com.leomehlig.today,1,1746716830,1746716831,1746716831.508436,-18000,,
com.apple.Preview,22,1746716808,1746716830,1746716830.457288,-18000,,
com.google.Chrome,10,1746716798,1746716808,1746716809.032059,-18000,,
com.apple.Preview,316,1746716482,1746716798,1746716798.7152982,-18000,,
com.google.Chrome,4,1746716478,1746716482,1746716482.403502,-18000,,
com.apple.Preview,121,1746716357,1746716478,1746716478.9218678,-18000,,
com.google.Chrome,2,1746716355,1746716357,1746716357.532816,-18000,,
com.leomehlig.today,1,1746716354,1746716355,1746716355.626525,-18000,,
com.google.Chrome,161,1746716193,1746716354,1746716354.352735,-18000,,
com.apple.Preview,5,1746716188,1746716193,1746716193.172513,-18000,,
com.google.Chrome,2,1746716186,1746716188,1746716188.717064,-18000,,
com.apple.Preview,99,1746716087,1746716186,1746716186.7937698,-18000,,
com.google.chrome.ios,113,1746715642,1746715755,1746715756.6269798,-18000,EB445137-D7F5-57EC-87DA-1DB460D64046,"iPhone13,2"
com.apple.Preview,311,1746715534,1746715845,1746715845.555892,-18000,,
com.apple.finder,118,1746715416,1746715534,1746715534.67256,-18000,,
com.apple.Preview,113,1746715303,1746715416,1746715416.839817,-18000,,
com.leomehlig.today,2,1746715301,1746715303,1746715303.8327699,-18000,,
com.apple.Preview,299,1746715002,1746715301,1746715301.5756788,-18000,,
com.google.Chrome,33,1746714969,1746715002,1746715002.647801,-18000,,
com.apple.Preview,9,1746714960,1746714969,1746714969.493952,-18000,,
com.google.Chrome,30,1746714930,1746714960,1746714960.864198,-18000,,
com.apple.Preview,142,1746714788,1746714930,1746714931.0205631,-18000,,
com.google.Chrome,51,1746714737,1746714788,1746714788.7449698,-18000,,
com.apple.Preview,1,1746714736,1746714737,1746714737.9048681,-18000,,
com.google.Chrome,2,1746714734,1746714736,1746714736.3158932,-18000,,
com.apple.Preview,25,1746714709,1746714734,1746714734.824274,-18000,,
com.google.Chrome,2,1746714707,1746714709,1746714709.3220801,-18000,,
com.apple.Preview,45,1746714662,1746714707,1746714707.305326,-18000,,
com.apple.news,81,1746714576,1746714657,1746714657.497993,-18000,EB445137-D7F5-57EC-87DA-1DB460D64046,"iPhone13,2"
com.google.Chrome,190,1746714472,1746714662,1746714662.30655,-18000,,
com.apple.news,61,1746714469,1746714530,1746714531.355645,-18000,EB445137-D7F5-57EC-87DA-1DB460D64046,"iPhone13,2"
com.microsoft.Office.Outlook,5,1746714460,1746714465,1746714465.302487,-18000,EB445137-D7F5-57EC-87DA-1DB460D64046,"iPhone13,2"
com.apple.Preview,38,1746714434,1746714472,1746714472.685813,-18000,,
com.google.Chrome,6,1746714428,1746714434,1746714434.817585,-18000,,
com.apple.Preview,59,1746714369,1746714428,1746714428.462453,-18000,,
com.google.Chrome,43,1746714326,1746714369,1746714369.493078,-18000,,
com.apple.Preview,3,1746714323,1746714326,1746714326.9443321,-18000,,
com.google.Chrome,3,1746714320,1746714323,1746714323.454272,-18000,,
com.apple.Preview,125,1746714195,1746714320,1746714320.9758859,-18000,,
com.apple.Health,87,1746713637,1746713724,1746713725.0823689,-18000,EB445137-D7F5-57EC-87DA-1DB460D64046,"iPhone13,2"
com.microsoft.Office.Outlook,11,1746713624,1746713635,1746713635.816784,-18000,EB445137-D7F5-57EC-87DA-1DB460D64046,"iPhone13,2"
com.microsoft.Office.Outlook,8,1746713616,1746713624,1746713624.5158958,-18000,EB445137-D7F5-57EC-87DA-1DB460D64046,"iPhone13,2"
com.apple.MobileSMS,9,1746713603,1746713612,1746713612.9294,-18000,EB445137-D7F5-57EC-87DA-1DB460D64046,"iPhone13,2"
com.apple.weather,0,1746713603,1746713603,1746713604.106958,-18000,EB445137-D7F5-57EC-87DA-1DB460D64046,"iPhone13,2"
com.apple.Preview,662,1746713000,1746713662,1746713662.890499,-18000,,
com.apple.Photos,4,1746712996,1746713000,1746713001.017276,-18000,,
com.apple.Preview,570,1746712426,1746712996,1746712996.413927,-18000,,
com.google.Chrome,6,1746712420,1746712426,1746712426.179786,-18000,,
com.apple.Preview,154,1746712266,1746712420,1746712420.859617,-18000,,
com.google.Chrome,34,1746712232,1746712266,1746712266.852514,-18000,,
com.apple.Preview,163,1746712069,1746712232,1746712232.6015282,-18000,,
com.apple.finder,2,1746712067,1746712069,1746712069.40906,-18000,,
com.apple.Preview,34,1746712033,1746712067,1746712067.681951,-18000,,
com.apple.finder,10,1746712023,1746712033,1746712033.1857228,-18000,,
com.apple.Preview,5,1746712018,1746712023,1746712023.2467232,-18000,,
com.apple.finder,2,1746712016,1746712018,1746712018.288056,-18000,,
com.apple.Preview,7,1746712009,1746712016,1746712016.697866,-18000,,
com.apple.finder,1,1746712008,1746712009,1746712009.6328511,-18000,,
com.apple.Preview,26,1746711982,1746712008,1746712008.6039171,-18000,,
com.apple.finder,10,1746711972,1746711982,1746711982.671986,-18000,,
com.apple.Preview,3,1746711969,1746711972,1746711972.8181381,-18000,,
com.apple.finder,36,1746711933,1746711969,1746711970.013933,-18000,,
com.apple.Preview,83,1746711850,1746711933,1746711933.568182,-18000,,
com.apple.finder,6,1746711844,1746711850,1746711851.027354,-18000,,
com.google.Chrome,50,1746711794,1746711844,1746711844.525141,-18000,,
com.leomehlig.today,4,1746711790,1746711794,1746711794.3054829,-18000,,
com.google.Chrome,354,1746711436,1746711790,1746711790.297402,-18000,,
com.leomehlig.today,18,1746711375,1746711393,1746711394.600549,-18000,,
com.apple.finder,7,1746711368,1746711375,1746711375.6510592,-18000,,
com.apple.weather,4,1746709688,1746709692,1746709692.827009,-18000,EB445137-D7F5-57EC-87DA-1DB460D64046,"iPhone13,2"
com.renpho.health,1,1746709687,1746709688,1746709688.580937,-18000,EB445137-D7F5-57EC-87DA-1DB460D64046,"iPhone13,2"
com.renpho.health,44,1746709598,1746709642,1746709642.2939029,-18000,EB445137-D7F5-57EC-87DA-1DB460D64046,"iPhone13,2"
com.apple.news,329,1746708733,1746709062,1746709062.81374,-18000,EB445137-D7F5-57EC-87DA-1DB460D64046,"iPhone13,2"
com.apple.finder,2,1746676691,1746676693,1746676693.925548,-18000,,
com.apple.news,52,1746676639,1746676691,1746676692.010736,-18000,,
com.apple.finder,9,1746676630,1746676639,1746676639.3718228,-18000,,
com.leomehlig.today,23,1746676607,1746676630,1746676630.8923368,-18000,,
com.apple.finder,9,1746676598,1746676607,1746676607.2058182,-18000,,
com.apple.findmy,2,1746676596,1746676598,1746676598.53809,-18000,,
com.apple.MobileSMS,69,1746676169,1746676238,1746676238.311527,-18000,EB445137-D7F5-57EC-87DA-1DB460D64046,"iPhone13,2"
com.apple.MobileSMS,35,1746676127,1746676162,1746676162.6271791,-18000,EB445137-D7F5-57EC-87DA-1DB460D64046,"iPhone13,2"
com.apple.Health,68,1746676056,1746676124,1746676124.754606,-18000,EB445137-D7F5-57EC-87DA-1DB460D64046,"iPhone13,2"
com.apple.findmy,317,1746675988,1746676305,1746676305.255375,-18000,,
com.apple.finder,2,1746675986,1746675988,1746675988.237339,-18000,,
com.apple.finder,5,1746663508,1746663513,1746663513.606216,-18000,,
com.leomehlig.today,1,1746663507,1746663508,1746663509.020553,-18000,,
com.google.Chrome,46,1746663461,1746663507,1746663507.785314,-18000,,
com.leomehlig.today,88,1746663373,1746663461,1746663462.443593,-18000,,
com.google.Chrome,30,1746663343,1746663373,1746663373.166026,-18000,,
com.leomehlig.today,18,1746663325,1746663343,1746663343.774996,-18000,,
com.apple.MobileSMS,4,1746663321,1746663325,1746663325.361599,-18000,,
com.leomehlig.today,1,1746663320,1746663321,1746663321.3331351,-18000,,
com.google.Chrome,6,1746663314,1746663320,1746663320.533649,-18000,,
com.toyopagroup.picaboo,71,1746662124,1746662195,1746662196.195759,-18000,EB445137-D7F5-57EC-87DA-1DB460D64046,"iPhone13,2"
com.apple.news,677,1746661444,1746662121,1746662121.259516,-18000,EB445137-D7F5-57EC-87DA-1DB460D64046,"iPhone13,2"
com.strava.stravaride,2,1746661442,1746661444,1746661444.2651892,-18000,EB445137-D7F5-57EC-87DA-1DB460D64046,"iPhone13,2"
com.strava.stravaride,4,1746661432,1746661436,1746661437.015521,-18000,EB445137-D7F5-57EC-87DA-1DB460D64046,"iPhone13,2"
com.strava.stravaride,30,1746660591,1746660621,1746660621.583984,-18000,EB445137-D7F5-57EC-87DA-1DB460D64046,"iPhone13,2"
com.apple.news,2,1746660562,1746660564,1746660564.927195,-18000,EB445137-D7F5-57EC-87DA-1DB460D64046,"iPhone13,2"
com.apple.news,248,1746658719,1746658967,1746658968.247973,-18000,EB445137-D7F5-57EC-87DA-1DB460D64046,"iPhone13,2"
com.apple.news,103,1746658612,1746658715,1746658716.35022,-18000,EB445137-D7F5-57EC-87DA-1DB460D64046,"iPhone13,2"
com.apple.news,81,1746658529,1746658610,1746658610.648538,-18000,EB445137-D7F5-57EC-87DA-1DB460D64046,"iPhone13,2"
com.google.chrome.ios,50,1746658479,1746658529,1746658529.812478,-18000,EB445137-D7F5-57EC-87DA-1DB460D64046,"iPhone13,2"
com.apple.news,115,1746658363,1746658478,1746658478.4241738,-18000,EB445137-D7F5-57EC-87DA-1DB460D64046,"iPhone13,2"
com.toyopagroup.picaboo,25,1746658335,1746658360,1746658360.2584162,-18000,EB445137-D7F5-57EC-87DA-1DB460D64046,"iPhone13,2"
com.apple.news,5,1746657876,1746657881,1746657881.0837278,-18000,EB445137-D7F5-57EC-87DA-1DB460D64046,"iPhone13,2"
com.apple.news,16,1746657601,1746657617,1746657617.452673,-18000,EB445137-D7F5-57EC-87DA-1DB460D64046,"iPhone13,2"
com.apple.MobileSMS,4,1746657576,1746657580,1746657580.265397,-18000,EB445137-D7F5-57EC-87DA-1DB460D64046,"iPhone13,2"
com.google.chrome.ios,197,1746657379,1746657576,1746657576.665166,-18000,EB445137-D7F5-57EC-87DA-1DB460D64046,"iPhone13,2"
com.apple.MobileSMS,14,1746657365,1746657379,1746657379.30722,-18000,EB445137-D7F5-57EC-87DA-1DB460D64046,"iPhone13,2"
com.thestorygraph.thestorygraph,261,1746654848,1746655109,1746655109.4856849,-18000,EB445137-D7F5-57EC-87DA-1DB460D64046,"iPhone13,2"
com.google.chrome.ios,65,1746654783,1746654848,1746654848.90934,-18000,EB445137-D7F5-57EC-87DA-1DB460D64046,"iPhone13,2"
com.thestorygraph.thestorygraph,24,1746654759,1746654783,1746654784.0697,-18000,EB445137-D7F5-57EC-87DA-1DB460D64046,"iPhone13,2"
com.google.chrome.ios,21,1746654734,1746654755,1746654755.894501,-18000,EB445137-D7F5-57EC-87DA-1DB460D64046,"iPhone13,2"
com.thestorygraph.thestorygraph,3,1746654731,1746654734,1746654734.409274,-18000,EB445137-D7F5-57EC-87DA-1DB460D64046,"iPhone13,2"
com.apple.CoreAuthUI,2,1746654648,1746654650,1746654650.414212,-18000,EB445137-D7F5-57EC-87DA-1DB460D64046,"iPhone13,2"
com.google.chrome.ios,160,1746654571,1746654731,1746654731.20715,-18000,EB445137-D7F5-57EC-87DA-1DB460D64046,"iPhone13,2"
com.thestorygraph.thestorygraph,117,1746654454,1746654571,1746654571.797782,-18000,EB445137-D7F5-57EC-87DA-1DB460D64046,"iPhone13,2"
com.google.Chrome,470,1746653474,1746653944,1746653944.4559932,-18000,,
com.thestorygraph.thestorygraph,20,1746653222,1746653242,1746653243.4341311,-18000,EB445137-D7F5-57EC-87DA-1DB460D64046,"iPhone13,2"
com.apple.news,85,1746650692,1746650777,1746650777.28375,-18000,EB445137-D7F5-57EC-87DA-1DB460D64046,"iPhone13,2"
com.microsoft.Office.Outlook,10,1746650678,1746650688,1746650688.792078,-18000,EB445137-D7F5-57EC-87DA-1DB460D64046,"iPhone13,2"
com.tinyspeck.chatlyio,14,1746650662,1746650676,1746650676.934857,-18000,EB445137-D7F5-57EC-87DA-1DB460D64046,"iPhone13,2"
com.google.chrome.ios,1,1746650661,1746650662,1746650662.515472,-18000,EB445137-D7F5-57EC-87DA-1DB460D64046,"iPhone13,2"
com.google.chrome.ios,53,1746649070,1746649123,1746649123.9713511,-18000,EB445137-D7F5-57EC-87DA-1DB460D64046,"iPhone13,2"
com.google.chrome.ios,2,1746649021,1746649023,1746649023.9993238,-18000,EB445137-D7F5-57EC-87DA-1DB460D64046,"iPhone13,2"
com.leomehlig.today,9,1746648341,1746648350,1746648350.7186909,-18000,EB445137-D7F5-57EC-87DA-1DB460D64046,"iPhone13,2"
com.strava.stravaride,2,1746648339,1746648341,1746648341.323911,-18000,EB445137-D7F5-57EC-87DA-1DB460D64046,"iPhone13,2"
com.microsoft.Office.Outlook,19,1746648128,1746648147,1746648147.129054,-18000,EB445137-D7F5-57EC-87DA-1DB460D64046,"iPhone13,2"
com.instructure.icanvas,16,1746648061,1746648077,1746648077.907465,-18000,EB445137-D7F5-57EC-87DA-1DB460D64046,"iPhone13,2"
com.instructure.icanvas,5,1746648050,1746648055,1746648055.952126,-18000,EB445137-D7F5-57EC-87DA-1DB460D64046,"iPhone13,2"
com.apple.news,0,1746648050,1746648050,1746648051.318552,-18000,EB445137-D7F5-57EC-87DA-1DB460D64046,"iPhone13,2"
com.apple.news,10,1746644029,1746644039,1746644039.739101,-18000,EB445137-D7F5-57EC-87DA-1DB460D64046,"iPhone13,2"
com.apple.news,182,1746643831,1746644013,1746644014.086586,-18000,EB445137-D7F5-57EC-87DA-1DB460D64046,"iPhone13,2"
com.apple.mobileslideshow,3,1746643818,1746643821,1746643821.608968,-18000,EB445137-D7F5-57EC-87DA-1DB460D64046,"iPhone13,2"
com.apple.mobileslideshow,5,1746643573,1746643578,1746643578.670875,-18000,EB445137-D7F5-57EC-87DA-1DB460D64046,"iPhone13,2"
com.apple.mobileslideshow,16,1746643481,1746643497,1746643497.827568,-18000,EB445137-D7F5-57EC-87DA-1DB460D64046,"iPhone13,2"
com.apple.mobileslideshow,18,1746643298,1746643316,1746643317.6275659,-18000,EB445137-D7F5-57EC-87DA-1DB460D64046,"iPhone13,2"
com.google.Chrome,418,1746643290,1746643708,1746643708.2960181,-18000,,
com.google.Chrome,94,1746641976,1746642070,1746642070.495687,-18000,,
com.apple.finder,4,1746641972,1746641976,1746641976.272938,-18000,,
com.apple.finder,2,1746641404,1746641406,1746641406.5807009,-18000,,
com.microsoft.Word,23,1746641381,1746641404,1746641404.311503,-18000,,
com.google.Chrome,16,1746641365,1746641381,1746641381.530704,-18000,,
com.apple.calculator,52,1746641313,1746641365,1746641365.523313,-18000,,
com.google.Chrome,71,1746641242,1746641313,1746641313.583581,-18000,,
com.apple.calculator,11,1746641231,1746641242,1746641242.185855,-18000,,
com.google.Chrome,12,1746641219,1746641231,1746641231.596015,-18000,,
com.apple.finder,1,1746641218,1746641219,1746641219.78364,-18000,,
com.google.Chrome,6,1746641212,1746641218,1746641218.647953,-18000,,
com.apple.finder,4,1746641208,1746641212,1746641212.567653,-18000,,
com.google.Chrome,24,1746641184,1746641208,1746641208.25349,-18000,,
com.apple.finder,8,1746641176,1746641184,1746641184.671956,-18000,,
com.google.Chrome,32,1746641144,1746641176,1746641176.527375,-18000,,
com.apple.finder,16,1746641128,1746641144,1746641144.338294,-18000,,
com.google.Chrome,3,1746641125,1746641128,1746641128.80023,-18000,,
com.apple.finder,2,1746641123,1746641125,1746641125.269754,-18000,,
com.google.Chrome,6,1746641117,1746641123,1746641123.326727,-18000,,
com.apple.finder,2,1746641115,1746641117,1746641117.475778,-18000,,
com.google.Chrome,88,1746641027,1746641115,1746641115.3339171,-18000,,
com.apple.finder,17,1746640997,1746641014,1746641014.059709,-18000,,
com.google.Chrome,267,1746640730,1746640997,1746640997.136873,-18000,,
com.microsoft.Word,108,1746640622,1746640730,1746640730.2439198,-18000,,
com.google.Chrome,39,1746640583,1746640622,1746640622.177164,-18000,,
com.microsoft.Word,1,1746640582,1746640583,1746640583.777324,-18000,,
com.google.Chrome,38,1746640544,1746640582,1746640582.414552,-18000,,
com.microsoft.Word,501,1746640030,1746640531,1746640531.739421,-18000,,
com.apple.finder,27,1746640003,1746640030,1746640030.963622,-18000,,
com.leomehlig.today,1,1746640002,1746640003,1746640003.610769,-18000,,
com.apple.finder,7,1746639995,1746640002,1746640002.352128,-18000,,
com.leomehlig.today,3,1746639992,1746639995,1746639996.459903,-18000,,
com.apple.Health,97,1746639878,1746639975,1746639975.625803,-18000,EB445137-D7F5-57EC-87DA-1DB460D64046,"iPhone13,2"
com.leomehlig.today,10,1746639068,1746639078,1746639078.6385,-18000,,
com.microsoft.Powerpoint,23,1746639045,1746639068,1746639068.360444,-18000,,
com.leomehlig.today,4,1746638786,1746638790,1746638790.871667,-18000,,
com.apple.news,28,1746638600,1746638628,1746638628.392504,-18000,EB445137-D7F5-57EC-87DA-1DB460D64046,"iPhone13,2"
com.apple.news,511,1746638089,1746638600,1746638600.422023,-18000,EB445137-D7F5-57EC-87DA-1DB460D64046,"iPhone13,2"
com.instructure.icanvas,12,1746636712,1746636724,1746636724.22548,-18000,EB445137-D7F5-57EC-87DA-1DB460D64046,"iPhone13,2"
com.apple.MobileSMS,14,1746636695,1746636709,1746636709.774652,-18000,EB445137-D7F5-57EC-87DA-1DB460D64046,"iPhone13,2"
com.strava.stravaride,0,1746636695,1746636695,1746636696.306349,-18000,EB445137-D7F5-57EC-87DA-1DB460D64046,"iPhone13,2"
com.strava.stravaride,1,1746636693,1746636694,1746636695.0549932,-18000,EB445137-D7F5-57EC-87DA-1DB460D64046,"iPhone13,2"
com.leomehlig.today,4,1746636663,1746636667,1746636667.4958081,-18000,,
com.google.Chrome,4,1746636659,1746636663,1746636663.400024,-18000,,
com.apple.Notes,42,1746636617,1746636659,1746636659.367854,-18000,,
com.google.Chrome,21,1746636596,1746636617,1746636617.075811,-18000,,
com.apple.Notes,7,1746636589,1746636596,1746636597.063149,-18000,,
com.google.Chrome,5,1746636584,1746636589,1746636589.376348,-18000,,
com.apple.Notes,44,1746636540,1746636584,1746636584.7002249,-18000,,
com.google.Chrome,974,1746635566,1746636540,1746636540.521934,-18000,,
com.leomehlig.today,5,1746635561,1746635566,1746635566.28371,-18000,,
com.microsoft.Excel,10,1746635551,1746635561,1746635561.352495,-18000,,
com.leomehlig.today,127,1746635424,1746635551,1746635551.925905,-18000,,
com.microsoft.Excel,170,1746635254,1746635424,1746635424.423905,-18000,,
com.leomehlig.today,75,1746635179,1746635254,1746635254.654804,-18000,,
com.google.Chrome,3,1746635176,1746635179,1746635179.599876,-18000,,
com.leomehlig.today,3,1746635173,1746635176,1746635176.737174,-18000,,
com.google.Chrome,39,1746635134,1746635173,1746635173.8437672,-18000,,
com.leomehlig.today,61,1746635054,1746635115,1746635115.1684809,-18000,,
com.apple.finder,7,1746635047,1746635054,1746635054.0768518,-18000,,
com.strava.stravaride,82,1746634442,1746634524,1746634525.340636,-18000,EB445137-D7F5-57EC-87DA-1DB460D64046,"iPhone13,2"
com.google.chrome.ios,75,1746634362,1746634437,1746634437.797796,-18000,EB445137-D7F5-57EC-87DA-1DB460D64046,"iPhone13,2"
com.apple.Health,30,1746634332,1746634362,1746634362.843039,-18000,EB445137-D7F5-57EC-87DA-1DB460D64046,"iPhone13,2"
com.toyopagroup.picaboo,23,1746634304,1746634327,1746634327.455389,-18000,EB445137-D7F5-57EC-87DA-1DB460D64046,"iPhone13,2"
com.leomehlig.today,86,1746633772,1746633858,1746633858.301862,-18000,EB445137-D7F5-57EC-87DA-1DB460D64046,"iPhone13,2"
com.instructure.icanvas,25,1746633747,1746633772,1746633772.612668,-18000,EB445137-D7F5-57EC-87DA-1DB460D64046,"iPhone13,2"
com.leomehlig.today,62,1746633682,1746633744,1746633744.8143492,-18000,EB445137-D7F5-57EC-87DA-1DB460D64046,"iPhone13,2"
com.apple.mobilecal,13,1746633669,1746633682,1746633682.662677,-18000,EB445137-D7F5-57EC-87DA-1DB460D64046,"iPhone13,2"
com.leomehlig.today,284,1746633382,1746633666,1746633666.423348,-18000,EB445137-D7F5-57EC-87DA-1DB460D64046,"iPhone13,2"
com.microsoft.Office.Outlook,9,1746633367,1746633376,1746633376.693489,-18000,EB445137-D7F5-57EC-87DA-1DB460D64046,"iPhone13,2"
com.apple.news,133,1746633198,1746633331,1746633331.710077,-18000,EB445137-D7F5-57EC-87DA-1DB460D64046,"iPhone13,2"
com.apple.news,9,1746632998,1746633007,1746633008.16261,-18000,EB445137-D7F5-57EC-87DA-1DB460D64046,"iPhone13,2"
com.apple.MobileSMS,11,1746632983,1746632994,1746632995.023954,-18000,EB445137-D7F5-57EC-87DA-1DB460D64046,"iPhone13,2"
com.thestorygraph.thestorygraph,0,1746632983,1746632983,1746632983.982413,-18000,EB445137-D7F5-57EC-87DA-1DB460D64046,"iPhone13,2"
com.apple.finder,1,1746632934,1746632935,1746632935.650329,-18000,,
com.leomehlig.today,10,1746632924,1746632934,1746632934.429663,-18000,,
com.google.Chrome,719,1746632205,1746632924,1746632924.937299,-18000,,
com.apple.weather,22,1746632183,1746632205,1746632205.064184,-18000,,
com.google.Chrome,574,1746631609,1746632183,1746632183.103015,-18000,,
com.thestorygraph.thestorygraph,115,1746630753,1746630868,1746630868.773981,-18000,EB445137-D7F5-57EC-87DA-1DB460D64046,"iPhone13,2"
com.google.Chrome,895,1746630712,1746631607,1746631607.5841498,-18000,,
com.thestorygraph.thestorygraph,115,1746630532,1746630647,1746630647.106842,-18000,EB445137-D7F5-57EC-87DA-1DB460D64046,"iPhone13,2"
com.apple.news,2,1746630395,1746630397,1746630397.5484881,-18000,EB445137-D7F5-57EC-87DA-1DB460D64046,"iPhone13,2"
com.apple.news,34,1746629985,1746630019,1746630020.5726929,-18000,EB445137-D7F5-57EC-87DA-1DB460D64046,"iPhone13,2"
com.google.Chrome,8,1746628480,1746628488,1746628488.786508,-18000,,
com.leomehlig.today,72,1746628408,1746628480,1746628480.746368,-18000,,
com.google.Chrome,2350,1746626058,1746628408,1746628408.3837261,-18000,,
com.google.Chrome,1481,1746624513,1746625994,1746625994.3366609,-18000,,
com.apple.news,465,1746624216,1746624681,1746624682.432878,-18000,EB445137-D7F5-57EC-87DA-1DB460D64046,"iPhone13,2"
com.google.Chrome,376,1746624136,1746624512,1746624512.828404,-18000,,
com.apple.news,91,1746624102,1746624193,1746624193.940036,-18000,EB445137-D7F5-57EC-87DA-1DB460D64046,"iPhone13,2"
com.apple.weather,2,1746624086,1746624088,1746624088.442358,-18000,EB445137-D7F5-57EC-87DA-1DB460D64046,"iPhone13,2"
com.apple.weather,62,1746622654,1746622716,1746622716.828718,-18000,EB445137-D7F5-57EC-87DA-1DB460D64046,"iPhone13,2"
com.renpho.health,6,1746622646,1746622652,1746622652.965641,-18000,EB445137-D7F5-57EC-87DA-1DB460D64046,"iPhone13,2"
com.renpho.health,48,1746622109,1746622157,1746622158.005981,-18000,EB445137-D7F5-57EC-87DA-1DB460D64046,"iPhone13,2"
com.instructure.icanvas,2,1746621068,1746621070,1746621071.023068,-18000,EB445137-D7F5-57EC-87DA-1DB460D64046,"iPhone13,2"
com.instructure.icanvas,31,1746621026,1746621057,1746621057.472908,-18000,EB445137-D7F5-57EC-87DA-1DB460D64046,"iPhone13,2"
com.apple.journal,3,1746588993,1746588996,1746588996.973459,-18000,EB445137-D7F5-57EC-87DA-1DB460D64046,"iPhone13,2"
com.apple.CoreAuthUI,2,1746588297,1746588299,1746588299.748084,-18000,EB445137-D7F5-57EC-87DA-1DB460D64046,"iPhone13,2"
com.apple.journal,693,1746588296,1746588989,1746588989.253127,-18000,EB445137-D7F5-57EC-87DA-1DB460D64046,"iPhone13,2"
com.thestorygraph.thestorygraph,257,1746588027,1746588284,1746588284.3407478,-18000,EB445137-D7F5-57EC-87DA-1DB460D64046,"iPhone13,2"
com.thestorygraph.thestorygraph,35,1746587984,1746588019,1746588019.5995,-18000,EB445137-D7F5-57EC-87DA-1DB460D64046,"iPhone13,2"
com.apple.Health,31,1746587947,1746587978,1746587978.923242,-18000,EB445137-D7F5-57EC-87DA-1DB460D64046,"iPhone13,2"
com.instructure.icanvas,3,1746587941,1746587944,1746587944.966728,-18000,EB445137-D7F5-57EC-87DA-1DB460D64046,"iPhone13,2"
com.instructure.icanvas,18,1746586823,1746586841,1746586841.27792,-18000,EB445137-D7F5-57EC-87DA-1DB460D64046,"iPhone13,2"
com.tinyspeck.chatlyio,2,1746586820,1746586822,1746586822.9800649,-18000,EB445137-D7F5-57EC-87DA-1DB460D64046,"iPhone13,2"
com.google.Chrome,544,1746586130,1746586674,1746586674.678745,-18000,,
com.google.Chrome,307,1746585530,1746585837,1746585837.91272,-18000,,
com.google.Chrome,2074,1746581815,1746583889,1746583890.004005,-18000,,
com.microsoft.Outlook,15,1746581800,1746581815,1746581816.049423,-18000,,
com.google.Chrome,12,1746581788,1746581800,1746581800.554842,-18000,,
com.microsoft.Outlook,39,1746581749,1746581788,1746581788.808279,-18000,,
com.google.Chrome,44,1746581705,1746581749,1746581749.5560431,-18000,,
com.microsoft.Outlook,96,1746581609,1746581705,1746581705.532722,-18000,,
com.google.Chrome,36,1746581573,1746581609,1746581609.035324,-18000,,
com.apple.weather,17,1746580485,1746580502,1746580502.2256699,-18000,EB445137-D7F5-57EC-87DA-1DB460D64046,"iPhone13,2"
com.apple.news,65,1746580037,1746580102,1746580103.0455499,-18000,EB445137-D7F5-57EC-87DA-1DB460D64046,"iPhone13,2"
com.apple.news,485,1746579551,1746580036,1746580036.276633,-18000,EB445137-D7F5-57EC-87DA-1DB460D64046,"iPhone13,2"
com.microsoft.Office.Outlook,2,1746575695,1746575697,1746575697.224069,-18000,EB445137-D7F5-57EC-87DA-1DB460D64046,"iPhone13,2"
com.apple.mobilecal,32,1746575663,1746575695,1746575695.7416701,-18000,EB445137-D7F5-57EC-87DA-1DB460D64046,"iPhone13,2"
com.tinyspeck.chatlyio,1,1746575662,1746575663,1746575663.519281,-18000,EB445137-D7F5-57EC-87DA-1DB460D64046,"iPhone13,2"
com.microsoft.Office.Outlook,10,1746575652,1746575662,1746575662.7093349,-18000,EB445137-D7F5-57EC-87DA-1DB460D64046,"iPhone13,2"
com.tinyspeck.chatlyio,5,1746575639,1746575644,1746575644.175663,-18000,EB445137-D7F5-57EC-87DA-1DB460D64046,"iPhone13,2"
com.apple.mobilecal,16,1746575623,1746575639,1746575639.906708,-18000,EB445137-D7F5-57EC-87DA-1DB460D64046,"iPhone13,2"
com.tinyspeck.chatlyio,18,1746575600,1746575618,1746575618.859895,-18000,EB445137-D7F5-57EC-87DA-1DB460D64046,"iPhone13,2"
com.apple.weather,0,1746575600,1746575600,1746575600.182292,-18000,EB445137-D7F5-57EC-87DA-1DB460D64046,"iPhone13,2"
com.apple.weather,4,1746575590,1746575594,1746575594.633173,-18000,EB445137-D7F5-57EC-87DA-1DB460D64046,"iPhone13,2"
com.apple.weather,9,1746572578,1746572587,1746572587.3993158,-18000,EB445137-D7F5-57EC-87DA-1DB460D64046,"iPhone13,2"
com.microsoft.Office.Outlook,5,1746572570,1746572575,1746572575.311061,-18000,EB445137-D7F5-57EC-87DA-1DB460D64046,"iPhone13,2"
com.instructure.icanvas,5,1746572561,1746572566,1746572566.9528399,-18000,EB445137-D7F5-57EC-87DA-1DB460D64046,"iPhone13,2"
com.instructure.icanvas,5,1746572555,1746572560,1746572560.4165359,-18000,EB445137-D7F5-57EC-87DA-1DB460D64046,"iPhone13,2"
com.instructure.icanvas,4,1746572531,1746572535,1746572536.027657,-18000,EB445137-D7F5-57EC-87DA-1DB460D64046,"iPhone13,2"
com.google.Chrome,1470,1746569686,1746571156,1746571156.7382631,-18000,,
com.google.Chrome,375,1746568976,1746569351,1746569351.631293,-18000,,
com.instructure.icanvas,3,1746568971,1746568974,1746568974.6930141,-18000,EB445137-D7F5-57EC-87DA-1DB460D64046,"iPhone13,2"
com.instructure.icanvas,8,1746568962,1746568970,1746568970.8198051,-18000,EB445137-D7F5-57EC-87DA-1DB460D64046,"iPhone13,2"
com.google.Chrome,422,1746568485,1746568907,1746568907.1112928,-18000,,
com.microsoft.Outlook,17,1746568468,1746568485,1746568486.060818,-18000,,
com.google.Chrome,125,1746568343,1746568468,1746568468.049924,-18000,,
com.instructure.icanvas,17,1746568325,1746568342,1746568343.037274,-18000,EB445137-D7F5-57EC-87DA-1DB460D64046,"iPhone13,2"
com.instructure.icanvas,5,1746568319,1746568324,1746568324.3007112,-18000,EB445137-D7F5-57EC-87DA-1DB460D64046,"iPhone13,2"
com.apple.MobileSMS,4,1746568310,1746568314,1746568314.172462,-18000,EB445137-D7F5-57EC-87DA-1DB460D64046,"iPhone13,2"
com.strava.stravaride,0,1746568310,1746568310,1746568310.807111,-18000,EB445137-D7F5-57EC-87DA-1DB460D64046,"iPhone13,2"
com.strava.stravaride,13,1746568042,1746568055,1746568055.2613049,-18000,EB445137-D7F5-57EC-87DA-1DB460D64046,"iPhone13,2"
com.microsoft.Office.Outlook,0,1746568042,1746568042,1746568042.781304,-18000,EB445137-D7F5-57EC-87DA-1DB460D64046,"iPhone13,2"
com.microsoft.Office.Outlook,19,1746567550,1746567569,1746567571.15628,-18000,EB445137-D7F5-57EC-87DA-1DB460D64046,"iPhone13,2"
com.apple.MobileSMS,21,1746557283,1746557304,1746557305.029042,-18000,EB445137-D7F5-57EC-87DA-1DB460D64046,"iPhone13,2"
com.thestorygraph.thestorygraph,10,1746556971,1746556981,1746556981.500778,-18000,EB445137-D7F5-57EC-87DA-1DB460D64046,"iPhone13,2"
com.apple.weather,6,1746556962,1746556968,1746556968.3688679,-18000,EB445137-D7F5-57EC-87DA-1DB460D64046,"iPhone13,2"
com.microsoft.Office.Outlook,30,1746556927,1746556957,1746556957.506736,-18000,EB445137-D7F5-57EC-87DA-1DB460D64046,"iPhone13,2"
com.strava.stravaride,9,1746553843,1746553852,1746553853.006682,-18000,EB445137-D7F5-57EC-87DA-1DB460D64046,"iPhone13,2"
com.google.Chrome,88,1746553778,1746553866,1746553866.2825341,-18000,,
com.apple.CoreAuthUI,2,1746553767,1746553769,1746553769.66715,-18000,EB445137-D7F5-57EC-87DA-1DB460D64046,"iPhone13,2"
com.truebill.truebillnative,74,1746553764,1746553838,1746553838.805877,-18000,EB445137-D7F5-57EC-87DA-1DB460D64046,"iPhone13,2"
com.instructure.icanvas,15,1746553741,1746553756,1746553756.3904738,-18000,EB445137-D7F5-57EC-87DA-1DB460D64046,"iPhone13,2"
com.google.Chrome,12,1746553715,1746553727,1746553727.916377,-18000,,
com.leomehlig.today,65,1746553650,1746553715,1746553715.806799,-18000,,
com.google.Chrome,113,1746553537,1746553650,1746553650.0649738,-18000,,
com.google.Chrome,1014,1746552159,1746553173,1746553173.483299,-18000,,
com.google.Chrome,331,1746551827,1746552158,1746552158.202589,-18000,,
com.google.Chrome,378,1746551446,1746551824,1746551824.129123,-18000,,
com.leomehlig.today,2,1746551444,1746551446,1746551446.5486898,-18000,,
com.groupme.iphone-app,2463,1746551240,1746553703,1746553703.106108,-18000,EB445137-D7F5-57EC-87DA-1DB460D64046,"iPhone13,2"
com.leomehlig.today,2,1746551219,1746551221,1746551221.057277,-18000,,
com.apple.finder,1,1746551218,1746551219,1746551219.649219,-18000,,
com.microsoft.VSCode,4,1746551214,1746551218,1746551218.717348,-18000,,
com.apple.finder,4,1746551210,1746551214,1746551214.854303,-18000,,
com.leomehlig.today,4,1746551206,1746551210,1746551210.850028,-18000,,
com.google.Chrome,62,1746551144,1746551206,1746551206.6851459,-18000,,
com.leomehlig.today,38,1746551106,1746551144,1746551144.147943,-18000,,
com.google.Chrome,2,1746551104,1746551106,1746551106.3926458,-18000,,
com.google.Chrome,199,1746550719,1746550918,1746550918.4765592,-18000,,
com.google.Chrome,517,1746550130,1746550647,1746550647.0954351,-18000,,
com.strava.stravaride,194,1746548970,1746549164,1746549164.157689,-18000,EB445137-D7F5-57EC-87DA-1DB460D64046,"iPhone13,2"
com.apple.Fitness,137,1746548833,1746548970,1746548970.7341619,-18000,EB445137-D7F5-57EC-87DA-1DB460D64046,"iPhone13,2"
com.apple.MobileSMS,42,1746545682,1746545724,1746545724.9025211,-18000,EB445137-D7F5-57EC-87DA-1DB460D64046,"iPhone13,2"
com.google.Chrome,1,1746545647,1746545648,1746545648.643688,-18000,,
com.apple.iCal,42,1746545605,1746545647,1746545647.116915,-18000,,
com.google.Chrome,2,1746545603,1746545605,1746545605.908063,-18000,,
com.apple.MobileSMS,10,1746545394,1746545404,1746545404.551018,-18000,EB445137-D7F5-57EC-87DA-1DB460D64046,"iPhone13,2"
com.apple.weather,13,1746545113,1746545126,1746545126.3281798,-18000,EB445137-D7F5-57EC-87DA-1DB460D64046,"iPhone13,2"
com.apple.Maps,218,1746544883,1746545101,1746545101.322238,-18000,EB445137-D7F5-57EC-87DA-1DB460D64046,"iPhone13,2"
com.apple.weather,14,1746544862,1746544876,1746544876.838244,-18000,EB445137-D7F5-57EC-87DA-1DB460D64046,"iPhone13,2"
com.apple.news,874,1746543939,1746544813,1746544813.9326959,-18000,EB445137-D7F5-57EC-87DA-1DB460D64046,"iPhone13,2"
com.google.chrome.ios,658,1746543277,1746543935,1746543935.6265368,-18000,EB445137-D7F5-57EC-87DA-1DB460D64046,"iPhone13,2"
com.apple.news,199,1746543078,1746543277,1746543277.2772799,-18000,EB445137-D7F5-57EC-87DA-1DB460D64046,"iPhone13,2"
com.google.chrome.ios,28,1746543050,1746543078,1746543078.633946,-18000,EB445137-D7F5-57EC-87DA-1DB460D64046,"iPhone13,2"
com.intsig.CamScannerLite,2,1746543048,1746543050,1746543050.625838,-18000,EB445137-D7F5-57EC-87DA-1DB460D64046,"iPhone13,2"
com.google.Chrome,300,1746543037,1746543337,1746543337.724945,-18000,,
com.leomehlig.today,2,1746543035,1746543037,1746543037.749584,-18000,,
com.google.Chrome,6,1746543029,1746543035,1746543035.8597522,-18000,,
com.leomehlig.today,14,1746543015,1746543029,1746543029.369869,-18000,,
com.google.Chrome,8,1746543007,1746543015,1746543015.823656,-18000,,
com.leomehlig.today,7,1746543000,1746543007,1746543007.043313,-18000,,
com.google.Chrome,40,1746542960,1746543000,1746543000.22653,-18000,,
com.apple.finder,2,1746542958,1746542960,1746542960.785825,-18000,,
com.apple.Preview,39,1746542919,1746542958,1746542959.0428429,-18000,,
com.apple.finder,1,1746542918,1746542919,1746542919.997802,-18000,,
com.apple.Preview,9,1746542909,1746542918,1746542918.708256,-18000,,
com.apple.finder,1,1746542908,1746542909,1746542909.3697839,-18000,,
com.apple.Preview,3,1746542905,1746542908,1746542908.265849,-18000,,
com.apple.finder,1,1746542904,1746542905,1746542905.1294842,-18000,,
com.apple.Preview,10,1746542894,1746542904,1746542904.346385,-18000,,
com.apple.finder,2,1746542892,1746542894,1746542894.3054051,-18000,,
com.apple.Preview,10,1746542882,1746542892,1746542892.995467,-18000,,
com.apple.finder,2,1746542880,1746542882,1746542882.099242,-18000,,
com.apple.Preview,12,1746542868,1746542880,1746542880.572217,-18000,,
com.apple.finder,1,1746542867,1746542868,1746542868.667064,-18000,,
com.apple.Preview,4,1746542863,1746542867,1746542867.4975882,-18000,,
com.apple.finder,3,1746542860,1746542863,1746542863.742209,-18000,,
com.google.Chrome,27,1746542833,1746542860,1746542860.641701,-18000,,
com.apple.finder,23,1746542810,1746542833,1746542833.501065,-18000,,
com.intsig.CamScannerLite,136,1746542734,1746542870,1746542870.434222,-18000,EB445137-D7F5-57EC-87DA-1DB460D64046,"iPhone13,2"
com.apple.news,2,1746542731,1746542733,1746542733.399893,-18000,EB445137-D7F5-57EC-87DA-1DB460D64046,"iPhone13,2"
com.google.Chrome,127,1746542683,1746542810,1746542810.670082,-18000,,
com.microsoft.VSCode,12,1746542671,1746542683,1746542683.870095,-18000,,
com.apple.finder,2,1746542669,1746542671,1746542671.700243,-18000,,
com.google.Chrome,191,1746542478,1746542669,1746542669.403816,-18000,,
com.microsoft.VSCode,3,1746542475,1746542478,1746542478.44331,-18000,,
com.google.Chrome,6,1746542469,1746542475,1746542475.51561,-18000,,
com.microsoft.VSCode,8,1746542461,1746542469,1746542469.627238,-18000,,
com.google.Chrome,13,1746542448,1746542461,1746542461.527367,-18000,,
com.microsoft.VSCode,5,1746542443,1746542448,1746542448.5021439,-18000,,
com.google.Chrome,11,1746542432,1746542443,1746542443.8557692,-18000,,
com.microsoft.VSCode,7,1746542425,1746542432,1746542432.548501,-18000,,
com.google.Chrome,2,1746542423,1746542425,1746542425.100599,-18000,,
com.microsoft.VSCode,49,1746542374,1746542423,1746542423.93217,-18000,,
com.google.Chrome,6,1746542368,1746542374,1746542374.6092548,-18000,,
com.microsoft.VSCode,4,1746542364,1746542368,1746542368.521111,-18000,,
com.google.Chrome,2,1746542362,1746542364,1746542364.626099,-18000,,
com.microsoft.VSCode,1,1746542361,1746542362,1746542362.868307,-18000,,
com.google.Chrome,1,1746542360,1746542361,1746542361.432775,-18000,,
com.microsoft.VSCode,4,1746542356,1746542360,1746542360.131583,-18000,,
com.google.Chrome,1,1746542355,1746542356,1746542356.8783221,-18000,,
com.microsoft.VSCode,3,1746542352,1746542355,1746542355.279814,-18000,,
com.google.Chrome,3,1746542349,1746542352,1746542352.0518498,-18000,,
com.microsoft.VSCode,6,1746542343,1746542349,1746542349.651524,-18000,,
com.google.Chrome,13,1746542330,1746542343,1746542343.32425,-18000,,
com.microsoft.VSCode,7,1746542323,1746542330,1746542330.097453,-18000,,
com.google.Chrome,3,1746542320,1746542323,1746542324.0222301,-18000,,
com.microsoft.VSCode,41,1746542279,1746542320,1746542320.272433,-18000,,
com.google.Chrome,24,1746542255,1746542279,1746542279.260608,-18000,,
com.microsoft.VSCode,31,1746542224,1746542255,1746542255.9545941,-18000,,
com.google.Chrome,7,1746542217,1746542224,1746542224.281014,-18000,,
com.microsoft.VSCode,20,1746542197,1746542217,1746542217.475178,-18000,,
com.google.Chrome,2,1746542195,1746542197,1746542197.078133,-18000,,
com.microsoft.VSCode,4,1746542191,1746542195,1746542195.698658,-18000,,
com.google.Chrome,38,1746542153,1746542191,1746542191.173713,-18000,,
com.microsoft.VSCode,89,1746542064,1746542153,1746542153.196321,-18000,,
com.google.Chrome,5,1746542059,1746542064,1746542064.257584,-18000,,
com.microsoft.VSCode,3,1746542056,1746542059,1746542059.678183,-18000,,
com.google.Chrome,7,1746542049,1746542056,1746542056.690515,-18000,,
com.microsoft.VSCode,16,1746542033,1746542049,1746542049.242732,-18000,,
com.google.Chrome,9,1746542024,1746542033,1746542033.3789248,-18000,,
com.microsoft.VSCode,4,1746542020,1746542024,1746542024.471078,-18000,,
com.google.Chrome,2,1746542018,1746542020,1746542020.192006,-18000,,
com.microsoft.VSCode,6,1746542012,1746542018,1746542018.460137,-18000,,
com.google.Chrome,96,1746541916,1746542012,1746542013.003971,-18000,,
com.apple.finder,2,1746541914,1746541916,1746541916.578315,-18000,,
com.microsoft.VSCode,52,1746541862,1746541914,1746541914.63223,-18000,,
com.google.Chrome,2,1746541860,1746541862,1746541862.1442041,-18000,,
com.microsoft.VSCode,26,1746541834,1746541860,1746541860.4361238,-18000,,
com.google.Chrome,4,1746541830,1746541834,1746541834.823139,-18000,,
com.microsoft.VSCode,7,1746541823,1746541830,1746541830.557005,-18000,,
com.google.Chrome,61,1746541762,1746541823,1746541823.919125,-18000,,
com.apple.news,189,1746541563,1746541752,1746541753.741493,-18000,EB445137-D7F5-57EC-87DA-1DB460D64046,"iPhone13,2"
com.microsoft.VSCode,301,1746541461,1746541762,1746541763.008945,-18000,,
com.google.Chrome,2,1746541459,1746541461,1746541462.043106,-18000,,
com.microsoft.VSCode,8,1746541451,1746541459,1746541459.8068562,-18000,,
com.google.Chrome,2,1746541449,1746541451,1746541451.9666429,-18000,,
com.microsoft.VSCode,12,1746541437,1746541449,1746541449.522674,-18000,,
com.google.Chrome,38,1746541399,1746541437,1746541437.684742,-18000,,
com.microsoft.VSCode,87,1746541312,1746541399,1746541399.91727,-18000,,
com.google.Chrome,5,1746541307,1746541312,1746541312.8035421,-18000,,
com.microsoft.VSCode,23,1746541284,1746541307,1746541307.5051742,-18000,,
com.google.Chrome,7,1746541277,1746541284,1746541284.8302078,-18000,,
com.microsoft.VSCode,7,1746541270,1746541277,1746541277.129838,-18000,,
com.google.Chrome,9,1746541261,1746541270,1746541271.044131,-18000,,
com.microsoft.VSCode,13,1746541248,1746541261,1746541261.972066,-18000,,
com.google.Chrome,14,1746541234,1746541248,1746541248.149653,-18000,,
com.microsoft.VSCode,1,1746541233,1746541234,1746541234.358773,-18000,,
com.apple.finder,2,1746541231,1746541233,1746541233.48419,-18000,,
com.microsoft.VSCode,8,1746541223,1746541231,1746541231.860361,-18000,,
com.apple.finder,1,1746541222,1746541223,1746541223.783825,-18000,,
com.google.Chrome,13,1746541209,1746541222,1746541222.363373,-18000,,
com.apple.finder,1,1746541208,1746541209,1746541209.378238,-18000,,
com.microsoft.VSCode,7,1746541201,1746541208,1746541208.816313,-18000,,
com.apple.finder,42,1746541159,1746541201,1746541201.4392428,-18000,,
com.microsoft.VSCode,118,1746541041,1746541159,1746541159.488594,-18000,,
com.google.Chrome,4,1746541037,1746541041,1746541041.1403341,-18000,,
com.microsoft.VSCode,7,1746541030,1746541037,1746541037.625103,-18000,,
com.google.Chrome,3,1746541027,1746541030,1746541030.31713,-18000,,
com.microsoft.VSCode,54,1746540973,1746541027,1746541027.801752,-18000,,
com.google.Chrome,4,1746540969,1746540973,1746540973.138307,-18000,,
com.microsoft.VSCode,6,1746540963,1746540969,1746540969.7546911,-18000,,
com.google.Chrome,5,1746540958,1746540963,1746540963.87709,-18000,,
com.microsoft.VSCode,7,1746540951,1746540958,1746540958.870215,-18000,,
com.google.Chrome,16,1746540935,1746540951,1746540951.235313,-18000,,
com.microsoft.VSCode,128,1746540807,1746540935,1746540935.950465,-18000,,
com.google.Chrome,8,1746540799,1746540807,1746540808.033369,-18000,,
com.microsoft.VSCode,2,1746540797,1746540799,1746540799.9902039,-18000,,
com.google.Chrome,12,1746540775,1746540787,1746540787.3851562,-18000,,
com.microsoft.VSCode,11,1746540764,1746540775,1746540775.642013,-18000,,
com.google.Chrome,9,1746540755,1746540764,1746540764.087296,-18000,,
com.microsoft.VSCode,15,1746540740,1746540755,1746540755.423593,-18000,,
com.groupme.iphone-app,62,1746540338,1746540400,1746540400.5591989,-18000,EB445137-D7F5-57EC-87DA-1DB460D64046,"iPhone13,2"
com.google.Chrome,1274,1746539466,1746540740,1746540740.564172,-18000,,
com.apple.Preview,419,1746539047,1746539466,1746539466.380889,-18000,,
com.google.Chrome,2,1746539045,1746539047,1746539047.182688,-18000,,
com.apple.Preview,18,1746539027,1746539045,1746539045.37905,-18000,,
com.apple.finder,17,1746539010,1746539027,1746539027.8953052,-18000,,
com.apple.Preview,52,1746538958,1746539010,1746539010.830943,-18000,,
com.strava.stravaride,255,1746538699,1746538954,1746538954.083727,-18000,EB445137-D7F5-57EC-87DA-1DB460D64046,"iPhone13,2"
com.microsoft.Office.Outlook,60,1746538622,1746538682,1746538682.16293,-18000,EB445137-D7F5-57EC-87DA-1DB460D64046,"iPhone13,2"
com.apple.Preview,1181,1746537708,1746538889,1746538889.7496328,-18000,,
com.apple.finder,60,1746537648,1746537708,1746537708.744565,-18000,,
com.apple.Preview,34,1746537614,1746537648,1746537648.7229571,-18000,,
com.apple.finder,1,1746537613,1746537614,1746537614.826575,-18000,,
com.apple.Preview,3,1746537610,1746537613,1746537613.415681,-18000,,
com.apple.finder,1,1746537609,1746537610,1746537610.788659,-18000,,
com.apple.Preview,6,1746537603,1746537609,1746537609.657192,-18000,,
com.apple.finder,4,1746537599,1746537603,1746537603.1367831,-18000,,
com.apple.Preview,4,1746537595,1746537599,1746537599.453676,-18000,,
com.apple.finder,1,1746537594,1746537595,1746537595.829537,-18000,,
com.apple.Preview,4,1746537590,1746537594,1746537594.214731,-18000,,
com.apple.finder,3,1746537587,1746537590,1746537590.662199,-18000,,
com.apple.Preview,52,1746537535,1746537587,1746537588.003557,-18000,,
com.apple.finder,13,1746537522,1746537535,1746537535.507998,-18000,,
com.google.Chrome,115,1746537407,1746537522,1746537522.3900971,-18000,,
com.leomehlig.today,34,1746537373,1746537407,1746537407.974164,-18000,,
com.google.Chrome,2,1746537371,1746537373,1746537374.1673908,-18000,,
com.apple.Health,17,1746536797,1746536814,1746536814.148139,-18000,EB445137-D7F5-57EC-87DA-1DB460D64046,"iPhone13,2"
com.renpho.health,34,1746536762,1746536796,1746536797.006524,-18000,EB445137-D7F5-57EC-87DA-1DB460D64046,"iPhone13,2"
com.apple.news,758,1746534686,1746535444,1746535444.6189852,-18000,EB445137-D7F5-57EC-87DA-1DB460D64046,"iPhone13,2"
com.apple.Health,43,1746502317,1746502360,1746502361.012126,-18000,EB445137-D7F5-57EC-87DA-1DB460D64046,"iPhone13,2"
com.apple.CoreAuthUI,2,1746501953,1746501955,1746501955.7955952,-18000,EB445137-D7F5-57EC-87DA-1DB460D64046,"iPhone13,2"
com.apple.journal,363,1746501952,1746502315,1746502315.682286,-18000,EB445137-D7F5-57EC-87DA-1DB460D64046,"iPhone13,2"
com.instructure.icanvas,2,1746501940,1746501942,1746501942.465016,-18000,EB445137-D7F5-57EC-87DA-1DB460D64046,"iPhone13,2"
com.google.Chrome,11,1746501289,1746501300,1746501300.043813,-18000,,
com.instructure.icanvas,4,1746500612,1746500616,1746500616.6018062,-18000,EB445137-D7F5-57EC-87DA-1DB460D64046,"iPhone13,2"
com.instructure.icanvas,6,1746497809,1746497815,1746497815.8597841,-18000,EB445137-D7F5-57EC-87DA-1DB460D64046,"iPhone13,2"
com.google.Chrome,301,1746497765,1746498066,1746498066.684523,-18000,,
com.instructure.icanvas,17,1746496457,1746496474,1746496474.72718,-18000,EB445137-D7F5-57EC-87DA-1DB460D64046,"iPhone13,2"
com.google.chrome.ios,0,1746496457,1746496457,1746496458.02035,-18000,EB445137-D7F5-57EC-87DA-1DB460D64046,"iPhone13,2"
com.google.chrome.ios,43,1746494811,1746494854,1746494855.054624,-18000,EB445137-D7F5-57EC-87DA-1DB460D64046,"iPhone13,2"
com.apple.news,2,1746494809,1746494811,1746494811.5917,-18000,EB445137-D7F5-57EC-87DA-1DB460D64046,"iPhone13,2"
com.google.Chrome,321,1746494477,1746494798,1746494798.292005,-18000,,
com.apple.news,73,1746494247,1746494320,1746494321.140209,-18000,EB445137-D7F5-57EC-87DA-1DB460D64046,"iPhone13,2"
com.apple.news,55,1746494191,1746494246,1746494247.454626,-18000,EB445137-D7F5-57EC-87DA-1DB460D64046,"iPhone13,2"
com.google.Chrome,418,1746493913,1746494331,1746494331.538011,-18000,,
com.apple.finder,3,1746493910,1746493913,1746493913.4799209,-18000,,
com.apple.iCal,3,1746493907,1746493910,1746493910.744598,-18000,,
com.apple.news,2,1746493859,1746493861,1746493861.621989,-18000,EB445137-D7F5-57EC-87DA-1DB460D64046,"iPhone13,2"
com.apple.news,45,1746493814,1746493859,1746493859.27354,-18000,EB445137-D7F5-57EC-87DA-1DB460D64046,"iPhone13,2"
com.microsoft.Office.Outlook,3,1746491263,1746491266,1746491266.507365,-18000,EB445137-D7F5-57EC-87DA-1DB460D64046,"iPhone13,2"
com.microsoft.Office.Outlook,105,1746491157,1746491262,1746491262.8286319,-18000,EB445137-D7F5-57EC-87DA-1DB460D64046,"iPhone13,2"
com.toyopagroup.picaboo,4,1746491124,1746491128,1746491128.754327,-18000,EB445137-D7F5-57EC-87DA-1DB460D64046,"iPhone13,2"
com.clairmail.fth.client,1,1746491123,1746491124,1746491124.982082,-18000,EB445137-D7F5-57EC-87DA-1DB460D64046,"iPhone13,2"
com.apple.CoreAuthUI,2,1746487616,1746487618,1746487618.596036,-18000,EB445137-D7F5-57EC-87DA-1DB460D64046,"iPhone13,2"
com.clairmail.fth.client,162,1746487613,1746487775,1746487776.094372,-18000,EB445137-D7F5-57EC-87DA-1DB460D64046,"iPhone13,2"
com.hammerandchisel.discord,108,1746487351,1746487459,1746487459.9700541,-18000,EB445137-D7F5-57EC-87DA-1DB460D64046,"iPhone13,2"
com.truebill.truebillnative,135,1746487215,1746487350,1746487350.6446052,-18000,EB445137-D7F5-57EC-87DA-1DB460D64046,"iPhone13,2"
com.strava.stravaride,123,1746487087,1746487210,1746487211.025255,-18000,EB445137-D7F5-57EC-87DA-1DB460D64046,"iPhone13,2"
com.apple.CoreAuthUI,2,1746487040,1746487042,1746487042.415921,-18000,EB445137-D7F5-57EC-87DA-1DB460D64046,"iPhone13,2"
com.robinhood.release.Robinhood,47,1746487038,1746487085,1746487085.468769,-18000,EB445137-D7F5-57EC-87DA-1DB460D64046,"iPhone13,2"
com.apple.iCal,303,1746486996,1746487299,1746487299.5316582,-18000,,
com.apple.finder,1,1746486995,1746486996,1746486996.6278028,-18000,,
com.microsoft.Word,1,1746486994,1746486995,1746486995.201314,-18000,,
com.apple.finder,3,1746486991,1746486994,1746486994.249059,-18000,,
com.leomehlig.today,62,1746486929,1746486991,1746486991.932946,-18000,,
com.apple.Preview,25,1746486904,1746486929,1746486929.115615,-18000,,
com.apple.finder,8,1746486820,1746486828,1746486828.34022,-18000,,
com.apple.Preview,351,1746486469,1746486820,1746486820.949798,-18000,,
com.apple.finder,3,1746486466,1746486469,1746486469.290875,-18000,,
com.leomehlig.today,20,1746486446,1746486466,1746486466.350556,-18000,,
com.leomehlig.today,47,1746486202,1746486249,1746486250.19945,-18000,,
com.google.Chrome,1,1746486201,1746486202,1746486202.547202,-18000,,
com.microsoft.Word,33,1746486168,1746486201,1746486201.0831652,-18000,,
com.google.Chrome,17,1746486151,1746486168,1746486168.1635451,-18000,,
com.microsoft.Word,28,1746486123,1746486151,1746486151.9474611,-18000,,
com.apple.finder,12,1746486111,1746486123,1746486123.341888,-18000,,
com.google.Chrome,223,1746485888,1746486111,1746486111.8282351,-18000,,
com.google.Chrome,306,1746485575,1746485881,1746485881.019963,-18000,,
com.google.Chrome,325,1746485174,1746485499,1746485499.276159,-18000,,
com.apple.finder,2,1746485172,1746485174,1746485174.158083,-18000,,
com.groupme.iphone-app,50,1746484687,1746484737,1746484738.087404,-18000,EB445137-D7F5-57EC-87DA-1DB460D64046,"iPhone13,2"
com.instructure.icanvas,2,1746484511,1746484513,1746484514.126367,-18000,EB445137-D7F5-57EC-87DA-1DB460D64046,"iPhone13,2"
com.groupme.iphone-app,1,1746484510,1746484511,1746484512.143589,-18000,EB445137-D7F5-57EC-87DA-1DB460D64046,"iPhone13,2"
com.apple.finder,300,1746484469,1746484769,1746484769.996197,-18000,,
com.apple.Preview,71,1746484398,1746484469,1746484469.9736528,-18000,,
com.apple.finder,1,1746484397,1746484398,1746484398.2563229,-18000,,
com.apple.Preview,137,1746484260,1746484397,1746484398.057836,-18000,,
com.apple.finder,1,1746484259,1746484260,1746484260.4082131,-18000,,
com.apple.Preview,261,1746483998,1746484259,1746484259.460555,-18000,,
com.apple.finder,0,1746483998,1746483998,1746483998.931982,-18000,,
com.apple.Preview,220,1746483778,1746483998,1746483998.673191,-18000,,
com.apple.finder,1,1746483777,1746483778,1746483778.313116,-18000,,
com.apple.Preview,97,1746483680,1746483777,1746483777.0647259,-18000,,
com.apple.finder,1,1746483679,1746483680,1746483680.607583,-18000,,
com.apple.Preview,129,1746483550,1746483679,1746483679.327656,-18000,,
com.apple.finder,0,1746483550,1746483550,1746483550.6159139,-18000,,
com.apple.Preview,120,1746483430,1746483550,1746483550.3607302,-18000,,
com.apple.finder,0,1746483430,1746483430,1746483430.5461931,-18000,,
com.apple.Preview,97,1746483333,1746483430,1746483430.3168092,-18000,,
com.apple.finder,8,1746483325,1746483333,1746483333.570605,-18000,,
com.google.Chrome,5,1746483320,1746483325,1746483325.64909,-18000,,
com.groupme.iphone-app,41,1746483278,1746483319,1746483320.246642,-18000,EB445137-D7F5-57EC-87DA-1DB460D64046,"iPhone13,2"
com.google.Chrome,689,1746482307,1746482996,1746482996.553592,-18000,,
com.leomehlig.today,9,1746482298,1746482307,1746482307.301264,-18000,,
com.google.Chrome,662,1746481636,1746482298,1746482298.294057,-18000,,
com.leomehlig.today,14,1746481622,1746481636,1746481636.460925,-18000,,
com.google.Chrome,19,1746481603,1746481622,1746481622.065264,-18000,,
com.leomehlig.today,21,1746481582,1746481603,1746481603.770218,-18000,,
com.google.Chrome,156,1746481426,1746481582,1746481582.9965591,-18000,,
com.google.Chrome,462,1746480419,1746480881,1746480881.7344708,-18000,,
com.apple.finder,2,1746480417,1746480419,1746480419.804861,-18000,,
com.apple.news,979,1746478865,1746479844,1746479844.049465,-18000,EB445137-D7F5-57EC-87DA-1DB460D64046,"iPhone13,2"
com.microsoft.Office.Outlook,44,1746478814,1746478858,1746478858.518785,-18000,EB445137-D7F5-57EC-87DA-1DB460D64046,"iPhone13,2"
com.apple.Health,2,1746478811,1746478813,1746478813.9365458,-18000,EB445137-D7F5-57EC-87DA-1DB460D64046,"iPhone13,2"
com.apple.Health,31,1746477552,1746477583,1746477583.636454,-18000,EB445137-D7F5-57EC-87DA-1DB460D64046,"iPhone13,2"
com.groupme.iphone-app,4,1746477479,1746477483,1746477483.3118901,-18000,EB445137-D7F5-57EC-87DA-1DB460D64046,"iPhone13,2"
com.groupme.iphone-app,38,1746477098,1746477136,1746477137.223589,-18000,EB445137-D7F5-57EC-87DA-1DB460D64046,"iPhone13,2"
com.instructure.icanvas,6,1746477088,1746477094,1746477094.787736,-18000,EB445137-D7F5-57EC-87DA-1DB460D64046,"iPhone13,2"
com.apple.InCallService,6,1746475480,1746475486,1746475486.227418,-18000,EB445137-D7F5-57EC-87DA-1DB460D64046,"iPhone13,2"
com.apple.mobilephone,9,1746475471,1746475480,1746475480.661271,-18000,EB445137-D7F5-57EC-87DA-1DB460D64046,"iPhone13,2"
com.apple.findmy,2,1746475468,1746475470,1746475474.92342,-18000,EB445137-D7F5-57EC-87DA-1DB460D64046,"iPhone13,2"
com.apple.findmy,6,1746475335,1746475341,1746475342.040504,-18000,EB445137-D7F5-57EC-87DA-1DB460D64046,"iPhone13,2"
com.apple.weather,26,1746475309,1746475335,1746475335.9709811,-18000,EB445137-D7F5-57EC-87DA-1DB460D64046,"iPhone13,2"
com.microsoft.Office.Outlook,37,1746470984,1746471021,1746471021.3654351,-18000,EB445137-D7F5-57EC-87DA-1DB460D64046,"iPhone13,2"
com.apple.finder,3,1746470489,1746470492,1746470492.840045,-18000,,
com.apple.Notes,1,1746470488,1746470489,1746470489.3165631,-18000,,
com.apple.finder,4,1746470484,1746470488,1746470488.432313,-18000,,
com.apple.iCal,1,1746470483,1746470484,1746470484.130992,-18000,,
com.google.Chrome,6,1746470477,1746470483,1746470483.330322,-18000,,
com.apple.finder,2,1746470475,1746470477,1746470477.126771,-18000,,
com.google.Chrome,43,1746470432,1746470475,1746470475.118383,-18000,,
com.apple.finder,24,1746470408,1746470432,1746470432.7830172,-18000,,
com.microsoft.VSCode,56,1746470352,1746470408,1746470408.255156,-18000,,
com.apple.finder,25,1746470327,1746470352,1746470352.287139,-18000,,
com.google.Chrome,12,1746470315,1746470327,1746470327.485787,-18000,,
com.apple.finder,3,1746470312,1746470315,1746470315.597434,-18000,,
com.google.Chrome,1,1746470311,1746470312,1746470312.388066,-18000,,
com.apple.finder,0,1746470311,1746470311,1746470312.027854,-18000,,
com.google.Chrome,8,1746470303,1746470311,1746470311.256001,-18000,,
com.apple.finder,2,1746470301,1746470303,1746470303.423997,-18000,,
com.google.Chrome,195,1746470106,1746470301,1746470301.515192,-18000,,
com.apple.finder,3,1746470103,1746470106,1746470106.637747,-18000,,
com.google.Chrome,6,1746470097,1746470103,1746470103.811185,-18000,,
com.apple.finder,8,1746470089,1746470097,1746470097.099577,-18000,,
com.google.Chrome,2,1746470087,1746470089,1746470089.5301008,-18000,,
com.apple.finder,2,1746470085,1746470087,1746470087.312903,-18000,,
com.google.Chrome,8,1746470077,1746470085,1746470085.496165,-18000,,
com.apple.finder,31,1746470046,1746470077,1746470077.6854,-18000,,
com.google.Chrome,288,1746469758,1746470046,1746470047.032862,-18000,,
com.apple.iCal,14,1746469744,1746469758,1746469758.714618,-18000,,
com.google.Chrome,68,1746469676,1746469744,1746469744.611954,-18000,,
com.apple.Notes,3,1746468808,1746468811,1746468811.8584251,-18000,,
com.google.Chrome,575,1746468233,1746468808,1746468808.299082,-18000,,
com.apple.Notes,8,1746468225,1746468233,1746468233.957683,-18000,,
com.google.Chrome,1,1746468224,1746468225,1746468225.80356,-18000,,
com.microsoft.Office.Outlook,38,1746467897,1746467935,1746467935.123945,-18000,EB445137-D7F5-57EC-87DA-1DB460D64046,"iPhone13,2"
com.apple.weather,1,1746467896,1746467897,1746467897.6482291,-18000,EB445137-D7F5-57EC-87DA-1DB460D64046,"iPhone13,2"
com.google.Chrome,55,1746467822,1746467877,1746467877.38231,-18000,,
com.apple.Notes,35,1746467787,1746467822,1746467822.7219648,-18000,,
com.google.Chrome,126,1746467661,1746467787,1746467787.28776,-18000,,
com.apple.Notes,3,1746467658,1746467661,1746467661.571333,-18000,,
com.google.Chrome,1,1746467657,1746467658,1746467658.763047,-18000,,
com.apple.Notes,3,1746467654,1746467657,1746467657.828858,-18000,,
com.google.Chrome,107,1746467547,1746467654,1746467654.526647,-18000,,
com.apple.Notes,7,1746467540,1746467547,1746467547.743849,-18000,,
com.google.Chrome,85,1746467455,1746467540,1746467540.778335,-18000,,
com.apple.Notes,16,1746467439,1746467455,1746467456.036778,-18000,,
com.google.Chrome,19,1746467420,1746467439,1746467439.8738499,-18000,,
com.apple.Notes,11,1746467409,1746467420,1746467420.760215,-18000,,
com.google.Chrome,165,1746467244,1746467409,1746467409.4554,-18000,,
com.apple.weather,41,1746467203,1746467244,1746467244.9294071,-18000,,
com.google.Chrome,6,1746467197,1746467203,1746467203.648283,-18000,,
com.apple.Notes,20,1746467177,1746467197,1746467197.6204681,-18000,,
com.google.Chrome,18,1746467159,1746467177,1746467177.0641708,-18000,,
com.leomehlig.today,9,1746467150,1746467159,1746467159.645372,-18000,,
com.apple.weather,7,1746467054,1746467061,1746467061.5988312,-18000,EB445137-D7F5-57EC-87DA-1DB460D64046,"iPhone13,2"
com.apple.news,3,1746467051,1746467054,1746467056.5071158,-18000,EB445137-D7F5-57EC-87DA-1DB460D64046,"iPhone13,2"
com.apple.news,117,1746466221,1746466338,1746466339.330421,-18000,EB445137-D7F5-57EC-87DA-1DB460D64046,"iPhone13,2"
com.leomehlig.today,218,1746466155,1746466373,1746466373.715528,-18000,,
com.google.Chrome,2,1746466153,1746466155,1746466155.40198,-18000,,
com.apple.iCal,8,1746466145,1746466153,1746466153.978889,-18000,,
com.google.Chrome,23,1746466122,1746466145,1746466145.8122668,-18000,,
com.apple.news,562,1746465449,1746466011,1746466011.68227,-18000,EB445137-D7F5-57EC-87DA-1DB460D64046,"iPhone13,2"
com.toyopagroup.picaboo,4,1746465441,1746465445,1746465445.578196,-18000,EB445137-D7F5-57EC-87DA-1DB460D64046,"iPhone13,2"
com.toyopagroup.picaboo,14,1746465331,1746465345,1746465346.052637,-18000,EB445137-D7F5-57EC-87DA-1DB460D64046,"iPhone13,2"
com.apple.MobileSMS,15,1746464379,1746464394,1746464395.0602489,-18000,EB445137-D7F5-57EC-87DA-1DB460D64046,"iPhone13,2"
com.apple.MobileSMS,3,1746464374,1746464377,1746464377.781831,-18000,EB445137-D7F5-57EC-87DA-1DB460D64046,"iPhone13,2"
com.apple.news,1,1746464373,1746464374,1746464374.579484,-18000,EB445137-D7F5-57EC-87DA-1DB460D64046,"iPhone13,2"
com.apple.news,103,1746463297,1746463400,1746463401.3400102,-18000,EB445137-D7F5-57EC-87DA-1DB460D64046,"iPhone13,2"
com.apple.news,376,1746462721,1746463097,1746463098.056305,-18000,EB445137-D7F5-57EC-87DA-1DB460D64046,"iPhone13,2"
com.apple.news,12,1746461942,1746461954,1746461955.206357,-18000,EB445137-D7F5-57EC-87DA-1DB460D64046,"iPhone13,2"
com.toyopagroup.picaboo,3,1746461841,1746461844,1746461844.9874458,-18000,EB445137-D7F5-57EC-87DA-1DB460D64046,"iPhone13,2"
com.toyopagroup.picaboo,184,1746461634,1746461818,1746461818.8062859,-18000,EB445137-D7F5-57EC-87DA-1DB460D64046,"iPhone13,2"
com.google.chrome.ios,368,1746460638,1746461006,1746461006.2812161,-18000,EB445137-D7F5-57EC-87DA-1DB460D64046,"iPhone13,2"
com.strava.stravaride,1,1746460636,1746460637,1746460638.520121,-18000,EB445137-D7F5-57EC-87DA-1DB460D64046,"iPhone13,2"
com.apple.news,219,1746460417,1746460636,1746460636.804198,-18000,EB445137-D7F5-57EC-87DA-1DB460D64046,"iPhone13,2"
com.strava.stravaride,26,1746460231,1746460257,1746460257.17261,-18000,EB445137-D7F5-57EC-87DA-1DB460D64046,"iPhone13,2"
com.google.Chrome,143,1746459711,1746459854,1746459854.8847651,-18000,,
com.apple.iCal,6,1746459705,1746459711,1746459711.326371,-18000,,
com.google.Chrome,97,1746459608,1746459705,1746459706.021584,-18000,,
com.microsoft.Office.Outlook,31,1746459493,1746459524,1746459524.878993,-18000,EB445137-D7F5-57EC-87DA-1DB460D64046,"iPhone13,2"
com.apple.news,2,1746459491,1746459493,1746459493.79104,-18000,EB445137-D7F5-57EC-87DA-1DB460D64046,"iPhone13,2"
com.apple.iCal,131,1746459477,1746459608,1746459608.193017,-18000,,
com.google.Chrome,25,1746459452,1746459477,1746459478.032771,-18000,,
com.apple.iCal,11,1746459441,1746459452,1746459452.342884,-18000,,
com.leomehlig.today,62,1746459379,1746459441,1746459441.8686872,-18000,,
com.apple.iCal,4,1746459375,1746459379,1746459379.69853,-18000,,
com.google.Chrome,166,1746459209,1746459375,1746459375.2867541,-18000,,
com.apple.iCal,31,1746459178,1746459209,1746459209.513351,-18000,,
com.leomehlig.today,16,1746459162,1746459178,1746459178.528456,-18000,,
com.google.Chrome,2,1746459160,1746459162,1746459162.5893369,-18000,,
com.microsoft.VSCode,141,1746459019,1746459160,1746459160.7475162,-18000,,
com.google.Chrome,264,1746458755,1746459019,1746459019.6059709,-18000,,
com.microsoft.VSCode,205,1746458550,1746458755,1746458755.2168021,-18000,,
com.google.Chrome,5,1746458545,1746458550,1746458550.654422,-18000,,
com.leomehlig.today,9,1746458536,1746458545,1746458545.2567558,-18000,,
com.google.Chrome,29,1746458507,1746458536,1746458536.15036,-18000,,
com.microsoft.VSCode,95,1746458412,1746458507,1746458507.811366,-18000,,
com.google.Chrome,22,1746458390,1746458412,1746458412.092431,-18000,,
com.microsoft.VSCode,1390,1746457000,1746458390,1746458390.9287271,-18000,,
com.microsoft.VSCode,395,1746456570,1746456965,1746456965.408248,-18000,,
com.google.Chrome,4,1746456566,1746456570,1746456570.412183,-18000,,
com.microsoft.VSCode,105,1746456461,1746456566,1746456567.007407,-18000,,
com.google.Chrome,4,1746456457,1746456461,1746456461.971659,-18000,,
com.microsoft.VSCode,57,1746456400,1746456457,1746456457.9023309,-18000,,
com.google.Chrome,16,1746456384,1746456400,1746456400.702098,-18000,,
com.microsoft.VSCode,219,1746456165,1746456384,1746456384.0709891,-18000,,
com.google.Chrome,83,1746456082,1746456165,1746456165.277519,-18000,,
com.microsoft.VSCode,20,1746456062,1746456082,1746456082.977151,-18000,,
com.google.Chrome,52,1746456010,1746456062,1746456062.6709461,-18000,,
com.microsoft.VSCode,30,1746455980,1746456010,1746456010.027777,-18000,,
com.google.Chrome,31,1746455949,1746455980,1746455980.853801,-18000,,
com.microsoft.VSCode,9,1746455940,1746455949,1746455949.509097,-18000,,
com.google.Chrome,19,1746455921,1746455940,1746455940.402787,-18000,,
com.microsoft.VSCode,7,1746455914,1746455921,1746455921.020125,-18000,,
com.google.Chrome,5,1746455909,1746455914,1746455914.570866,-18000,,
com.microsoft.VSCode,13,1746455896,1746455909,1746455909.29001,-18000,,
com.google.Chrome,15,1746455881,1746455896,1746455896.066136,-18000,,
com.microsoft.VSCode,25,1746455856,1746455881,1746455881.6648169,-18000,,
com.google.Chrome,41,1746455815,1746455856,1746455856.992044,-18000,,
com.microsoft.VSCode,42,1746455773,1746455815,1746455815.542258,-18000,,
com.google.Chrome,4,1746455769,1746455773,1746455773.588799,-18000,,
com.microsoft.VSCode,1,1746455768,1746455769,1746455769.774342,-18000,,
com.google.Chrome,3,1746455765,1746455768,1746455768.9547129,-18000,,
com.microsoft.VSCode,2,1746455763,1746455765,1746455765.675037,-18000,,
com.apple.news,62,1746455684,1746455746,1746455746.314866,-18000,EB445137-D7F5-57EC-87DA-1DB460D64046,"iPhone13,2"
com.microsoft.Office.Outlook,30,1746455649,1746455679,1746455679.916449,-18000,EB445137-D7F5-57EC-87DA-1DB460D64046,"iPhone13,2"
com.instructure.icanvas,5,1746455644,1746455649,1746455649.2892752,-18000,EB445137-D7F5-57EC-87DA-1DB460D64046,"iPhone13,2"
com.apple.mobiletimer,1,1746455643,1746455644,1746455644.8759189,-18000,EB445137-D7F5-57EC-87DA-1DB460D64046,"iPhone13,2"
com.instructure.icanvas,5,1746455638,1746455643,1746455643.237483,-18000,EB445137-D7F5-57EC-87DA-1DB460D64046,"iPhone13,2"
com.apple.mobiletimer,0,1746455638,1746455638,1746455639.1871328,-18000,EB445137-D7F5-57EC-87DA-1DB460D64046,"iPhone13,2"
com.google.Chrome,153,1746455610,1746455763,1746455764.0263128,-18000,,
com.leomehlig.today,32,1746455578,1746455610,1746455610.10914,-18000,,
com.google.Chrome,478,1746455100,1746455578,1746455578.4207911,-18000,,
com.leomehlig.today,17,1746455083,1746455100,1746455100.913208,-18000,,
com.google.Chrome,1104,1746453979,1746455083,1746455083.724992,-18000,,
com.google.Chrome,492,1746453466,1746453958,1746453958.897042,-18000,,
com.leomehlig.today,1,1746453465,1746453466,1746453466.990282,-18000,,
com.google.Chrome,9,1746453456,1746453465,1746453465.19751,-18000,,
com.leomehlig.today,1,1746453432,1746453433,1746453434.499422,-18000,,
com.microsoft.Powerpoint,1,1746453431,1746453432,1746453432.635391,-18000,,
com.leomehlig.today,18,1746453413,1746453431,1746453431.440988,-18000,,
com.apple.mobiletimer,3,1746453406,1746453409,1746453409.160016,-18000,EB445137-D7F5-57EC-87DA-1DB460D64046,"iPhone13,2"
com.apple.mobiletimer,284,1746453119,1746453403,1746453404.11875,-18000,EB445137-D7F5-57EC-87DA-1DB460D64046,"iPhone13,2"
com.apple.mobiletimer,316,1746452772,1746453088,1746453088.928698,-18000,EB445137-D7F5-57EC-87DA-1DB460D64046,"iPhone13,2"
com.apple.Health,11,1746452710,1746452721,1746452721.432962,-18000,EB445137-D7F5-57EC-87DA-1DB460D64046,"iPhone13,2"
com.toyopagroup.picaboo,26,1746452678,1746452704,1746452704.277135,-18000,EB445137-D7F5-57EC-87DA-1DB460D64046,"iPhone13,2"
com.microsoft.Office.Outlook,1,1746452677,1746452678,1746452678.5923629,-18000,EB445137-D7F5-57EC-87DA-1DB460D64046,"iPhone13,2"
com.microsoft.Powerpoint,771,1746452642,1746453413,1746453413.2625098,-18000,,
com.apple.finder,11,1746452631,1746452642,1746452642.67486,-18000,,
com.leomehlig.today,0,1746452631,1746452631,1746452631.7094588,-18000,,
com.google.Chrome,18,1746452613,1746452631,1746452631.192669,-18000,,
com.leomehlig.today,19,1746452594,1746452613,1746452613.410213,-18000,,
com.google.Chrome,94,1746452500,1746452594,1746452595.018012,-18000,,
com.microsoft.Office.Outlook,11,1746452132,1746452143,1746452143.78935,-18000,EB445137-D7F5-57EC-87DA-1DB460D64046,"iPhone13,2"
com.instructure.icanvas,29,1746452101,1746452130,1746452130.7281718,-18000,EB445137-D7F5-57EC-87DA-1DB460D64046,"iPhone13,2"
com.apple.weather,1,1746452100,1746452101,1746452101.7772288,-18000,EB445137-D7F5-57EC-87DA-1DB460D64046,"iPhone13,2"
com.apple.weather,4,1746450813,1746450817,1746450817.215673,-18000,EB445137-D7F5-57EC-87DA-1DB460D64046,"iPhone13,2"
com.apple.weather,5,1746450807,1746450812,1746450812.730377,-18000,EB445137-D7F5-57EC-87DA-1DB460D64046,"iPhone13,2"
com.renpho.health,1,1746450806,1746450807,1746450807.855682,-18000,EB445137-D7F5-57EC-87DA-1DB460D64046,"iPhone13,2"
com.renpho.health,86,1746450182,1746450268,1746450268.718715,-18000,EB445137-D7F5-57EC-87DA-1DB460D64046,"iPhone13,2"
com.apple.news,216,1746448945,1746449161,1746449161.830215,-18000,EB445137-D7F5-57EC-87DA-1DB460D64046,"iPhone13,2"
com.apple.Music,2,1746448931,1746448933,1746448933.839715,-18000,EB445137-D7F5-57EC-87DA-1DB460D64046,"iPhone13,2"
com.microsoft.Office.Outlook,2,1746448916,1746448918,1746448918.185971,-18000,EB445137-D7F5-57EC-87DA-1DB460D64046,"iPhone13,2"
com.apple.Health,29,1746417478,1746417507,1746417507.44028,-18000,EB445137-D7F5-57EC-87DA-1DB460D64046,"iPhone13,2"
com.apple.CoreAuthUI,1,1746416104,1746416105,1746416105.966483,-18000,EB445137-D7F5-57EC-87DA-1DB460D64046,"iPhone13,2"
com.apple.journal,1376,1746416101,1746417477,1746417477.694621,-18000,EB445137-D7F5-57EC-87DA-1DB460D64046,"iPhone13,2"
com.thestorygraph.thestorygraph,0,1746416101,1746416101,1746416101.962491,-18000,EB445137-D7F5-57EC-87DA-1DB460D64046,"iPhone13,2"
com.thestorygraph.thestorygraph,91,1746415917,1746416008,1746416008.61116,-18000,EB445137-D7F5-57EC-87DA-1DB460D64046,"iPhone13,2"
com.apple.MobileSMS,4,1746415912,1746415916,1746415916.6322,-18000,EB445137-D7F5-57EC-87DA-1DB460D64046,"iPhone13,2"
com.apple.MobileSMS,6,1746411479,1746411485,1746411485.4809918,-18000,EB445137-D7F5-57EC-87DA-1DB460D64046,"iPhone13,2"
com.google.chrome.ios,1,1746411478,1746411479,1746411480.22569,-18000,EB445137-D7F5-57EC-87DA-1DB460D64046,"iPhone13,2"
com.google.chrome.ios,20,1746408600,1746408620,1746408621.040681,-18000,EB445137-D7F5-57EC-87DA-1DB460D64046,"iPhone13,2"
com.google.Chrome,717,1746407201,1746407918,1746407918.930026,-18000,,
com.apple.finder,3,1746407198,1746407201,1746407201.378752,-18000,,
com.apple.Notes,2,1746407196,1746407198,1746407198.620347,-18000,,
com.microsoft.Excel,1,1746407195,1746407196,1746407196.956352,-18000,,
com.google.Chrome,58,1746407137,1746407195,1746407195.1009312,-18000,,
com.apple.iCal,3,1746407134,1746407137,1746407137.1921039,-18000,,
com.burbn.instagram,620,1746404735,1746405355,1746405355.989437,-18000,EB445137-D7F5-57EC-87DA-1DB460D64046,"iPhone13,2"
com.facebook.Facebook,23,1746404710,1746404733,1746404733.885425,-18000,EB445137-D7F5-57EC-87DA-1DB460D64046,"iPhone13,2"
com.letterboxd.LetterboxdApp,62,1746404631,1746404693,1746404693.541858,-18000,EB445137-D7F5-57EC-87DA-1DB460D64046,"iPhone13,2"
com.apple.weather,2,1746404628,1746404630,1746404630.847386,-18000,EB445137-D7F5-57EC-87DA-1DB460D64046,"iPhone13,2"
com.apple.weather,12,1746403604,1746403616,1746403617.193074,-18000,EB445137-D7F5-57EC-87DA-1DB460D64046,"iPhone13,2"
com.apple.news,692,1746402906,1746403598,1746403598.3175979,-18000,EB445137-D7F5-57EC-87DA-1DB460D64046,"iPhone13,2"
com.apple.news,19,1746402879,1746402898,1746402900.372322,-18000,EB445137-D7F5-57EC-87DA-1DB460D64046,"iPhone13,2"
com.instructure.icanvas,5,1746402872,1746402877,1746402877.1139169,-18000,EB445137-D7F5-57EC-87DA-1DB460D64046,"iPhone13,2"
com.instructure.icanvas,9,1746401858,1746401867,1746401867.7065182,-18000,EB445137-D7F5-57EC-87DA-1DB460D64046,"iPhone13,2"
com.apple.iCal,81,1746401161,1746401242,1746401242.699337,-18000,,
com.google.Chrome,16,1746401145,1746401161,1746401161.710808,-18000,,
com.apple.iCal,8,1746401137,1746401145,1746401145.231992,-18000,,
com.google.Chrome,31,1746401106,1746401137,1746401137.299866,-18000,,
com.apple.iCal,13,1746401093,1746401106,1746401106.055042,-18000,,
com.google.Chrome,20,1746401073,1746401093,1746401093.563232,-18000,,
com.apple.iCal,40,1746400986,1746401026,1746401026.3785172,-18000,,
com.google.Chrome,57,1746400929,1746400986,1746400986.4386969,-18000,,
com.apple.iCal,105,1746400824,1746400929,1746400929.282589,-18000,,
com.microsoft.Excel,5,1746400819,1746400824,1746400824.1389232,-18000,,
com.apple.iCal,70,1746400749,1746400819,1746400819.281786,-18000,,
com.microsoft.Excel,64,1746400685,1746400749,1746400749.8600302,-18000,,
com.apple.Notes,83,1746400602,1746400685,1746400685.468557,-18000,,
com.microsoft.Excel,294,1746400308,1746400602,1746400602.810161,-18000,,
com.google.Chrome,19,1746400289,1746400308,1746400308.848428,-18000,,
com.microsoft.Excel,2644,1746397645,1746400289,1746400290.503438,-18000,,
com.apple.finder,25,1746397620,1746397645,1746397645.780777,-18000,,
com.apple.MobileSMS,2,1746397618,1746397620,1746397620.1703959,-18000,,
com.apple.Notes,256,1746397362,1746397618,1746397618.49923,-18000,,
com.apple.MobileSMS,0,1746397362,1746397362,1746397362.532806,-18000,,
com.apple.finder,5,1746397345,1746397350,1746397350.503556,-18000,,
com.apple.Health,69,1746395021,1746395090,1746395090.417748,-18000,EB445137-D7F5-57EC-87DA-1DB460D64046,"iPhone13,2"
com.strava.stravaride,26,1746394990,1746395016,1746395016.9445062,-18000,EB445137-D7F5-57EC-87DA-1DB460D64046,"iPhone13,2"
com.apple.Health,50,1746394934,1746394984,1746394984.3385181,-18000,EB445137-D7F5-57EC-87DA-1DB460D64046,"iPhone13,2"
com.strava.stravaride,93,1746394841,1746394934,1746394934.9935021,-18000,EB445137-D7F5-57EC-87DA-1DB460D64046,"iPhone13,2"
com.apple.weather,2,1746394820,1746394822,1746394822.892127,-18000,EB445137-D7F5-57EC-87DA-1DB460D64046,"iPhone13,2"
com.apple.weather,7,1746392736,1746392743,1746392743.496465,-18000,EB445137-D7F5-57EC-87DA-1DB460D64046,"iPhone13,2"
com.thestorygraph.thestorygraph,2,1746392734,1746392736,1746392736.623178,-18000,EB445137-D7F5-57EC-87DA-1DB460D64046,"iPhone13,2"
com.thestorygraph.thestorygraph,74,1746392455,1746392529,1746392530.223105,-18000,EB445137-D7F5-57EC-87DA-1DB460D64046,"iPhone13,2"
com.apple.weather,34,1746392419,1746392453,1746392453.537496,-18000,EB445137-D7F5-57EC-87DA-1DB460D64046,"iPhone13,2"
com.apple.finder,1,1746389315,1746389316,1746389317.310575,-18000,,
com.apple.weather,14,1746389287,1746389301,1746389301.414651,-18000,EB445137-D7F5-57EC-87DA-1DB460D64046,"iPhone13,2"
com.leomehlig.today,42,1746389234,1746389276,1746389276.5968142,-18000,,
com.apple.shortcuts,4,1746389230,1746389234,1746389234.090168,-18000,,
com.leomehlig.today,1,1746389229,1746389230,1746389230.319576,-18000,,
com.microsoft.VSCode,261,1746388968,1746389229,1746389229.307201,-18000,,
com.leomehlig.today,12,1746388956,1746388968,1746388968.973329,-18000,,
com.microsoft.VSCode,63,1746388893,1746388956,1746388956.207818,-18000,,
com.apple.shortcuts,3,1746388890,1746388893,1746388893.210635,-18000,,
com.apple.weather,15,1746388873,1746388888,1746388888.4205341,-18000,EB445137-D7F5-57EC-87DA-1DB460D64046,"iPhone13,2"
com.apple.mobiletimer,2,1746388871,1746388873,1746388873.3378692,-18000,EB445137-D7F5-57EC-87DA-1DB460D64046,"iPhone13,2"
com.microsoft.VSCode,1,1746388846,1746388847,1746388847.6169782,-18000,,
com.apple.shortcuts,5,1746388841,1746388846,1746388846.0912519,-18000,,
com.apple.finder,2,1746388829,1746388831,1746388831.517817,-18000,,
com.leomehlig.today,137,1746388692,1746388829,1746388829.862877,-18000,,
com.apple.mobiletimer,313,1746388377,1746388690,1746388690.486876,-18000,EB445137-D7F5-57EC-87DA-1DB460D64046,"iPhone13,2"
com.apple.mobiletimer,319,1746388025,1746388344,1746388344.3734431,-18000,EB445137-D7F5-57EC-87DA-1DB460D64046,"iPhone13,2"
com.microsoft.Powerpoint,693,1746387999,1746388692,1746388692.91453,-18000,,
com.google.Chrome,1,1746387998,1746387999,1746387999.326325,-18000,,
com.leomehlig.today,3,1746387995,1746387998,1746387998.108162,-18000,,
com.microsoft.Powerpoint,5,1746387990,1746387995,1746387995.589453,-18000,,
com.leomehlig.today,6,1746387984,1746387990,1746387990.440477,-18000,,
com.apple.weather,14,1746387366,1746387380,1746387381.593725,-18000,EB445137-D7F5-57EC-87DA-1DB460D64046,"iPhone13,2"
com.leomehlig.today,19,1746387084,1746387103,1746387103.4424071,-18000,,
com.google.Chrome,1638,1746385446,1746387084,1746387084.25722,-18000,,
com.google.Chrome,523,1746384774,1746385297,1746385297.124147,-18000,,
com.apple.Preview,9,1746384765,1746384774,1746384774.477495,-18000,,
com.google.Chrome,257,1746384508,1746384765,1746384766.0466828,-18000,,
com.apple.Preview,34,1746384474,1746384508,1746384508.675818,-18000,,
com.apple.finder,2,1746384472,1746384474,1746384474.206212,-18000,,
com.apple.Preview,3,1746384469,1746384472,1746384472.571229,-18000,,
com.google.Chrome,326,1746384143,1746384469,1746384469.056201,-18000,,
com.apple.Preview,63,1746384080,1746384143,1746384143.679069,-18000,,
com.google.Chrome,26,1746384054,1746384080,1746384080.217476,-18000,,
com.google.Chrome,307,1746383715,1746384022,1746384022.083582,-18000,,
com.apple.Preview,9,1746383706,1746383715,1746383715.493638,-18000,,
com.apple.finder,3,1746383703,1746383706,1746383706.941889,-18000,,
com.google.Chrome,32,1746383671,1746383703,1746383703.609417,-18000,,
com.google.Chrome,300,1746383245,1746383545,1746383545.326128,-18000,,
com.apple.Preview,3,1746383242,1746383245,1746383245.325883,-18000,,
com.google.Chrome,714,1746382528,1746383242,1746383242.36814,-18000,,
com.apple.Preview,2,1746382526,1746382528,1746382528.441242,-18000,,
com.google.Chrome,439,1746382087,1746382526,1746382526.223531,-18000,,
com.apple.Preview,2,1746382085,1746382087,1746382087.835462,-18000,,
com.google.Chrome,4,1746382081,1746382085,1746382085.6699371,-18000,,
com.apple.Preview,2,1746382079,1746382081,1746382081.393169,-18000,,
com.google.Chrome,5,1746382074,1746382079,1746382079.956565,-18000,,
com.apple.Preview,2,1746382072,1746382074,1746382074.944598,-18000,,
com.google.Chrome,3,1746382069,1746382072,1746382072.854784,-18000,,
com.apple.Preview,2,1746382067,1746382069,1746382069.369448,-18000,,
com.google.Chrome,2,1746382065,1746382067,1746382067.204252,-18000,,
com.apple.Preview,1,1746382064,1746382065,1746382065.9869828,-18000,,
com.google.Chrome,5,1746382059,1746382064,1746382064.782435,-18000,,
com.apple.Preview,0,1746382059,1746382059,1746382060.0459418,-18000,,
com.google.Chrome,3,1746382056,1746382059,1746382059.098033,-18000,,
com.apple.Preview,5,1746382051,1746382056,1746382056.138115,-18000,,
com.google.Chrome,5,1746382046,1746382051,1746382051.905621,-18000,,
com.apple.Preview,1,1746382045,1746382046,1746382046.9451752,-18000,,
com.google.Chrome,4,1746382041,1746382045,1746382045.150727,-18000,,
com.apple.Preview,2,1746382039,1746382041,1746382041.498899,-18000,,
com.google.Chrome,2,1746382037,1746382039,1746382039.990674,-18000,,
com.apple.Preview,1,1746382036,1746382037,1746382037.8934588,-18000,,
com.google.Chrome,2,1746382034,1746382036,1746382036.706681,-18000,,
com.apple.Preview,2,1746382032,1746382034,1746382034.0997128,-18000,,
com.google.Chrome,1,1746382031,1746382032,1746382032.360972,-18000,,
com.apple.Preview,0,1746382031,1746382031,1746382031.8525748,-18000,,
com.google.Chrome,2,1746382029,1746382031,1746382031.228656,-18000,,
com.apple.Preview,3,1746382026,1746382029,1746382029.7169352,-18000,,
com.apple.weather,7,1746381949,1746381956,1746381956.410109,-18000,EB445137-D7F5-57EC-87DA-1DB460D64046,"iPhone13,2"
com.google.Chrome,150,1746381876,1746382026,1746382026.310606,-18000,,
com.apple.Preview,1,1746381875,1746381876,1746381877.082267,-18000,,
com.google.Chrome,8,1746381867,1746381875,1746381875.994781,-18000,,
com.apple.Preview,2,1746381865,1746381867,1746381867.1819758,-18000,,
com.google.Chrome,8,1746381857,1746381865,1746381865.7692142,-18000,,
com.apple.Preview,1,1746381856,1746381857,1746381857.292928,-18000,,
com.google.Chrome,7,1746381849,1746381856,1746381856.6864018,-18000,,
com.apple.Preview,1,1746381848,1746381849,1746381849.220007,-18000,,
com.google.Chrome,23,1746381825,1746381848,1746381848.128125,-18000,,
com.apple.Preview,1,1746381824,1746381825,1746381825.499711,-18000,,
com.google.Chrome,3,1746381821,1746381824,1746381824.753693,-18000,,
com.apple.Preview,0,1746381821,1746381821,1746381821.780497,-18000,,
com.google.Chrome,2,1746381819,1746381821,1746381821.446419,-18000,,
com.apple.Preview,1,1746381818,1746381819,1746381819.739733,-18000,,
com.google.Chrome,23,1746381795,1746381818,1746381818.382104,-18000,,
com.apple.Preview,0,1746381795,1746381795,1746381795.9039478,-18000,,
com.google.Chrome,4,1746381791,1746381795,1746381795.148545,-18000,,
com.apple.Preview,1,1746381790,1746381791,1746381791.7560248,-18000,,
com.google.Chrome,4,1746381786,1746381790,1746381790.5398521,-18000,,
com.apple.Preview,1,1746381785,1746381786,1746381786.930996,-18000,,
com.google.Chrome,11,1746381774,1746381785,1746381785.886769,-18000,,
com.apple.Preview,0,1746381774,1746381774,1746381774.927433,-18000,,
com.google.Chrome,8,1746381766,1746381774,1746381774.068182,-18000,,
com.apple.Preview,1,1746381765,1746381766,1746381766.976688,-18000,,
com.google.Chrome,7,1746381758,1746381765,1746381765.151671,-18000,,
com.apple.Preview,8,1746381750,1746381758,1746381758.794056,-18000,,
com.google.Chrome,4,1746381746,1746381750,1746381750.463584,-18000,,
com.apple.Preview,3,1746381743,1746381746,1746381746.826227,-18000,,
com.google.Chrome,9,1746381734,1746381743,1746381743.988439,-18000,,
com.apple.Preview,1,1746381733,1746381734,1746381734.224344,-18000,,
com.google.Chrome,50,1746381683,1746381733,1746381733.091088,-18000,,
com.apple.Preview,12,1746381671,1746381683,1746381683.75383,-18000,,
com.apple.finder,1,1746381670,1746381671,1746381671.2984061,-18000,,
com.apple.Preview,39,1746381631,1746381670,1746381671.0173512,-18000,,
com.apple.finder,3,1746381628,1746381631,1746381631.412383,-18000,,
com.apple.Preview,4,1746381624,1746381628,1746381628.461275,-18000,,
com.google.Chrome,275,1746381349,1746381624,1746381624.24388,-18000,,
com.google.Chrome,300,1746381048,1746381348,1746381348.972583,-18000,,
com.google.Chrome,377,1746380667,1746381044,1746381044.9133801,-18000,,
com.apple.Preview,24,1746380643,1746380667,1746380667.522217,-18000,,
com.google.Chrome,5,1746380638,1746380643,1746380643.5590029,-18000,,
com.apple.Preview,7,1746380631,1746380638,1746380638.963136,-18000,,
com.google.Chrome,2,1746380629,1746380631,1746380631.278212,-18000,,
com.apple.Preview,17,1746380612,1746380629,1746380629.8822222,-18000,,
com.google.Chrome,113,1746380499,1746380612,1746380612.2711182,-18000,,
com.apple.Preview,2,1746380497,1746380499,1746380499.2550921,-18000,,
com.google.Chrome,7,1746380490,1746380497,1746380497.4848042,-18000,,
com.apple.Preview,1,1746380489,1746380490,1746380490.6879091,-18000,,
com.google.Chrome,225,1746380264,1746380489,1746380489.189392,-18000,,
com.apple.Preview,26,1746380238,1746380264,1746380264.839929,-18000,,
com.google.Chrome,107,1746380131,1746380238,1746380238.062087,-18000,,
com.apple.Preview,39,1746380092,1746380131,1746380131.702246,-18000,,
com.google.Chrome,34,1746380058,1746380092,1746380092.492521,-18000,,
com.apple.Preview,2,1746380056,1746380058,1746380058.6216512,-18000,,
com.google.Chrome,4,1746380052,1746380056,1746380056.644361,-18000,,
com.apple.Preview,1,1746380051,1746380052,1746380052.844418,-18000,,
com.google.Chrome,6,1746380045,1746380051,1746380051.371608,-18000,,
com.apple.Preview,3,1746380042,1746380045,1746380045.8838248,-18000,,
com.google.Chrome,2,1746380040,1746380042,1746380042.651273,-18000,,
com.apple.Preview,2,1746380038,1746380040,1746380040.415555,-18000,,
com.google.Chrome,5,1746380033,1746380038,1746380038.105956,-18000,,
com.apple.Preview,5,1746380028,1746380033,1746380033.4361491,-18000,,
com.google.Chrome,619,1746379409,1746380028,1746380028.23863,-18000,,
com.apple.Preview,2,1746379407,1746379409,1746379409.191745,-18000,,
com.google.Chrome,137,1746379270,1746379407,1746379407.935316,-18000,,
com.apple.Preview,1,1746379269,1746379270,1746379270.3469272,-18000,,
com.google.Chrome,1,1746379268,1746379269,1746379270.002732,-18000,,
com.apple.Preview,22,1746379246,1746379268,1746379269.013918,-18000,,
com.google.Chrome,23,1746379223,1746379246,1746379246.398098,-18000,,
com.apple.Preview,15,1746379208,1746379223,1746379223.2985358,-18000,,
com.google.Chrome,237,1746378971,1746379208,1746379208.5922952,-18000,,
com.apple.Preview,1,1746378970,1746378971,1746378971.426233,-18000,,
com.google.Chrome,374,1746378596,1746378970,1746378970.78306,-18000,,
com.apple.Preview,3,1746378593,1746378596,1746378597.040051,-18000,,
com.google.Chrome,214,1746378379,1746378593,1746378593.72211,-18000,,
com.apple.Preview,3,1746378376,1746378379,1746378379.740716,-18000,,
com.google.Chrome,4,1746378372,1746378376,1746378376.3102531,-18000,,
com.apple.Preview,2,1746378370,1746378372,1746378372.046157,-18000,,
com.google.Chrome,9,1746378361,1746378370,1746378370.797481,-18000,,
com.apple.Preview,0,1746378361,1746378361,1746378362.075663,-18000,,
com.google.Chrome,3,1746378358,1746378361,1746378361.2042,-18000,,
com.apple.Preview,2,1746378356,1746378358,1746378359.0237222,-18000,,
com.google.Chrome,123,1746378233,1746378356,1746378356.247494,-18000,,
com.apple.Preview,2,1746378231,1746378233,1746378233.263042,-18000,,
com.apple.finder,6,1746378225,1746378231,1746378231.210682,-18000,,
com.leomehlig.today,131,1746378094,1746378225,1746378225.9129229,-18000,,
com.leomehlig.today,9,1746377067,1746377076,1746377076.222975,-18000,,
com.google.Chrome,141,1746376926,1746377067,1746377067.747503,-18000,,
Astrospheric.Astrospheric,22,1746376886,1746376908,1746376908.463722,-18000,EB445137-D7F5-57EC-87DA-1DB460D64046,"iPhone13,2"
com.ryansponzilli.DeepSkyCatalog,6,1746376873,1746376879,1746376879.787148,-18000,EB445137-D7F5-57EC-87DA-1DB460D64046,"iPhone13,2"
com.facebook.Facebook,108,1746376758,1746376866,1746376866.457368,-18000,EB445137-D7F5-57EC-87DA-1DB460D64046,"iPhone13,2"
com.microsoft.Office.Outlook,22,1746376569,1746376591,1746376591.6486158,-18000,EB445137-D7F5-57EC-87DA-1DB460D64046,"iPhone13,2"
com.apple.news,0,1746376569,1746376569,1746376569.960666,-18000,EB445137-D7F5-57EC-87DA-1DB460D64046,"iPhone13,2"
com.apple.news,241,1746376097,1746376338,1746376338.676872,-18000,EB445137-D7F5-57EC-87DA-1DB460D64046,"iPhone13,2"
com.apple.weather,12,1746376076,1746376088,1746376088.158832,-18000,EB445137-D7F5-57EC-87DA-1DB460D64046,"iPhone13,2"
com.google.Chrome,710,1746376030,1746376740,1746376740.4531631,-18000,,
com.apple.finder,2,1746376028,1746376030,1746376030.874193,-18000,,
com.leomehlig.today,0,1746376028,1746376028,1746376029.012137,-18000,,
com.google.Chrome,9,1746376019,1746376028,1746376028.53899,-18000,,
com.apple.news,40,1746375979,1746376019,1746376019.2609792,-18000,,
com.google.Chrome,45,1746375934,1746375979,1746375979.4167051,-18000,,
com.apple.Preview,10,1746375924,1746375934,1746375934.5982351,-18000,,
com.google.Chrome,4,1746375920,1746375924,1746375924.704589,-18000,,
com.apple.Preview,16,1746375904,1746375920,1746375920.178469,-18000,,
com.google.Chrome,9,1746375895,1746375904,1746375904.50704,-18000,,
com.apple.Preview,10,1746375885,1746375895,1746375895.9086251,-18000,,
com.google.Chrome,4,1746375881,1746375885,1746375885.3732018,-18000,,
com.apple.Preview,3,1746375878,1746375881,1746375881.138435,-18000,,
com.google.Chrome,2,1746375876,1746375878,1746375878.6495209,-18000,,
com.apple.Preview,4,1746375872,1746375876,1746375876.499021,-18000,,
com.google.Chrome,15,1746375857,1746375872,1746375872.315114,-18000,,
com.apple.Preview,5,1746375852,1746375857,1746375857.563755,-18000,,
com.google.Chrome,90,1746375762,1746375852,1746375852.097832,-18000,,
com.apple.Preview,35,1746375727,1746375762,1746375762.390778,-18000,,
com.google.Chrome,10,1746375717,1746375727,1746375727.8697371,-18000,,
com.apple.Preview,5,1746375712,1746375717,1746375717.8831239,-18000,,
com.google.Chrome,27,1746375685,1746375712,1746375713.028617,-18000,,
com.apple.Preview,6,1746375679,1746375685,1746375685.663653,-18000,,
com.google.Chrome,11,1746375668,1746375679,1746375679.816294,-18000,,
com.apple.Preview,23,1746375645,1746375668,1746375668.3085399,-18000,,
com.google.Chrome,20,1746375625,1746375645,1746375645.563873,-18000,,
com.apple.Preview,12,1746375613,1746375625,1746375625.651805,-18000,,
com.apple.finder,4,1746375609,1746375613,1746375613.071949,-18000,,
com.apple.Preview,1,1746375608,1746375609,1746375609.940484,-18000,,
com.apple.finder,22,1746375586,1746375608,1746375608.4073272,-18000,,
com.google.Chrome,9,1746375577,1746375586,1746375586.076334,-18000,,
com.apple.finder,7,1746375570,1746375577,1746375577.593522,-18000,,
com.google.Chrome,5,1746375565,1746375570,1746375570.699461,-18000,,
com.apple.finder,32,1746375533,1746375565,1746375565.9075642,-18000,,
com.google.Chrome,19,1746375514,1746375533,1746375533.2237458,-18000,,
com.leomehlig.today,7,1746375507,1746375514,1746375514.47681,-18000,,
com.google.Chrome,1396,1746374111,1746375507,1746375507.406732,-18000,,
com.leomehlig.today,15,1746374096,1746374111,1746374111.993554,-18000,,
com.google.Chrome,1329,1746372767,1746374096,1746374096.3110561,-18000,,
com.leomehlig.today,31,1746372724,1746372755,1746372755.362668,-18000,,
com.google.Chrome,1,1746372723,1746372724,1746372724.675725,-18000,,
com.leomehlig.today,3,1746372720,1746372723,1746372723.507563,-18000,,
com.google.Chrome,288,1746372432,1746372720,1746372720.364606,-18000,,
com.google.Chrome,336,1746372026,1746372362,1746372362.274431,-18000,,
com.apple.news,153,1746371423,1746371576,1746371576.0807462,-18000,EB445137-D7F5-57EC-87DA-1DB460D64046,"iPhone13,2"
com.microsoft.Office.Outlook,7,1746371411,1746371418,1746371418.728207,-18000,EB445137-D7F5-57EC-87DA-1DB460D64046,"iPhone13,2"
com.apple.Health,25,1746371382,1746371407,1746371407.623564,-18000,EB445137-D7F5-57EC-87DA-1DB460D64046,"iPhone13,2"
com.leomehlig.today,58,1746371218,1746371276,1746371276.9088678,-18000,,
com.google.Chrome,1,1746371217,1746371218,1746371219.633329,-18000,,
com.apple.finder,3,1746371214,1746371217,1746371217.752612,-18000,,
com.apple.Preferences,17,1746369716,1746369733,1746369733.983087,-18000,EB445137-D7F5-57EC-87DA-1DB460D64046,"iPhone13,2"
com.apple.Health,29,1746369683,1746369712,1746369712.480793,-18000,EB445137-D7F5-57EC-87DA-1DB460D64046,"iPhone13,2"
com.renpho.health,34,1746369646,1746369680,1746369680.180544,-18000,EB445137-D7F5-57EC-87DA-1DB460D64046,"iPhone13,2"
com.apple.MobileSMS,7,1746369638,1746369645,1746369645.309732,-18000,EB445137-D7F5-57EC-87DA-1DB460D64046,"iPhone13,2"
com.apple.news,1036,1746367068,1746368104,1746368104.2787151,-18000,EB445137-D7F5-57EC-87DA-1DB460D64046,"iPhone13,2"
com.google.chrome.ios,23,1746332822,1746332845,1746332845.649035,-18000,EB445137-D7F5-57EC-87DA-1DB460D64046,"iPhone13,2"
com.apple.news,2,1746332820,1746332822,1746332822.298318,-18000,EB445137-D7F5-57EC-87DA-1DB460D64046,"iPhone13,2"
com.apple.news,185,1746332415,1746332600,1746332601.289915,-18000,EB445137-D7F5-57EC-87DA-1DB460D64046,"iPhone13,2"
com.apple.news,4,1746332400,1746332404,1746332404.838283,-18000,EB445137-D7F5-57EC-87DA-1DB460D64046,"iPhone13,2"
com.apple.news,109,1746328304,1746328413,1746328413.5549169,-18000,EB445137-D7F5-57EC-87DA-1DB460D64046,"iPhone13,2"
com.apple.news,2,1746328288,1746328290,1746328290.319934,-18000,EB445137-D7F5-57EC-87DA-1DB460D64046,"iPhone13,2"
com.apple.news,2,1746326762,1746326764,1746326764.930664,-18000,EB445137-D7F5-57EC-87DA-1DB460D64046,"iPhone13,2"
com.apple.news,151,1746324737,1746324888,1746324889.6953979,-18000,EB445137-D7F5-57EC-87DA-1DB460D64046,"iPhone13,2"
com.microsoft.Office.Outlook,9,1746324707,1746324716,1746324716.2957969,-18000,EB445137-D7F5-57EC-87DA-1DB460D64046,"iPhone13,2"
com.google.chrome.ios,120,1746324585,1746324705,1746324706.051275,-18000,EB445137-D7F5-57EC-87DA-1DB460D64046,"iPhone13,2"
com.google.chrome.ios,10,1746324558,1746324568,1746324568.409208,-18000,EB445137-D7F5-57EC-87DA-1DB460D64046,"iPhone13,2"
com.google.chrome.ios,6,1746323043,1746323049,1746323049.581634,-18000,EB445137-D7F5-57EC-87DA-1DB460D64046,"iPhone13,2"
com.google.chrome.ios,38,1746323002,1746323040,1746323040.607555,-18000,EB445137-D7F5-57EC-87DA-1DB460D64046,"iPhone13,2"
com.letterboxd.LetterboxdApp,3,1746322999,1746323002,1746323002.914217,-18000,EB445137-D7F5-57EC-87DA-1DB460D64046,"iPhone13,2"
com.letterboxd.LetterboxdApp,94,1746322152,1746322246,1746322247.134917,-18000,EB445137-D7F5-57EC-87DA-1DB460D64046,"iPhone13,2"
com.letterboxd.LetterboxdApp,18,1746321653,1746321671,1746321671.350018,-18000,EB445137-D7F5-57EC-87DA-1DB460D64046,"iPhone13,2"
com.apple.news,475,1746320456,1746320931,1746320931.200026,-18000,EB445137-D7F5-57EC-87DA-1DB460D64046,"iPhone13,2"
com.apple.news,129,1746316624,1746316753,1746316753.709136,-18000,EB445137-D7F5-57EC-87DA-1DB460D64046,"iPhone13,2"
com.apple.news,168,1746316331,1746316499,1746316499.653712,-18000,EB445137-D7F5-57EC-87DA-1DB460D64046,"iPhone13,2"
com.apple.MobileSMS,10,1746316318,1746316328,1746316328.187203,-18000,EB445137-D7F5-57EC-87DA-1DB460D64046,"iPhone13,2"
com.apple.MobileSMS,2,1746316258,1746316260,1746316260.602912,-18000,EB445137-D7F5-57EC-87DA-1DB460D64046,"iPhone13,2"
com.apple.MobileSMS,37,1746313469,1746313506,1746313506.4900951,-18000,EB445137-D7F5-57EC-87DA-1DB460D64046,"iPhone13,2"
com.google.chrome.ios,1,1746313468,1746313469,1746313469.463259,-18000,EB445137-D7F5-57EC-87DA-1DB460D64046,"iPhone13,2"
com.google.chrome.ios,32,1746311985,1746312017,1746312017.579283,-18000,EB445137-D7F5-57EC-87DA-1DB460D64046,"iPhone13,2"
com.intsig.CamScannerLite,42,1746311942,1746311984,1746311984.58091,-18000,EB445137-D7F5-57EC-87DA-1DB460D64046,"iPhone13,2"
com.letterboxd.LetterboxdApp,3,1746311935,1746311938,1746311938.460209,-18000,EB445137-D7F5-57EC-87DA-1DB460D64046,"iPhone13,2"
com.letterboxd.LetterboxdApp,33,1746311810,1746311843,1746311844.217443,-18000,EB445137-D7F5-57EC-87DA-1DB460D64046,"iPhone13,2"
com.toyopagroup.picaboo,4,1746311800,1746311804,1746311804.2138991,-18000,EB445137-D7F5-57EC-87DA-1DB460D64046,"iPhone13,2"
com.microsoft.Office.Outlook,1,1746311799,1746311800,1746311800.4788032,-18000,EB445137-D7F5-57EC-87DA-1DB460D64046,"iPhone13,2"
com.microsoft.Office.Outlook,33,1746311238,1746311271,1746311271.897265,-18000,EB445137-D7F5-57EC-87DA-1DB460D64046,"iPhone13,2"
com.apple.mobilecal,17,1746311221,1746311238,1746311238.505023,-18000,EB445137-D7F5-57EC-87DA-1DB460D64046,"iPhone13,2"
com.microsoft.Office.Outlook,9,1746311207,1746311216,1746311217.045049,-18000,EB445137-D7F5-57EC-87DA-1DB460D64046,"iPhone13,2"
com.toyopagroup.picaboo,28,1746311173,1746311201,1746311201.720705,-18000,EB445137-D7F5-57EC-87DA-1DB460D64046,"iPhone13,2"
com.apple.Music,1,1746311172,1746311173,1746311175.173919,-18000,EB445137-D7F5-57EC-87DA-1DB460D64046,"iPhone13,2"
com.apple.Music,2,1746302042,1746302044,1746302044.476969,-18000,EB445137-D7F5-57EC-87DA-1DB460D64046,"iPhone13,2"
com.apple.Music,19,1746302016,1746302035,1746302035.6727672,-18000,EB445137-D7F5-57EC-87DA-1DB460D64046,"iPhone13,2"
com.google.chrome.ios,4,1746302012,1746302016,1746302017.303869,-18000,EB445137-D7F5-57EC-87DA-1DB460D64046,"iPhone13,2"
com.google.chrome.ios,1,1746301546,1746301547,1746301547.938525,-18000,EB445137-D7F5-57EC-87DA-1DB460D64046,"iPhone13,2"
com.google.chrome.ios,58,1746301086,1746301144,1746301144.813016,-18000,EB445137-D7F5-57EC-87DA-1DB460D64046,"iPhone13,2"
com.apple.Music,2,1746300548,1746300550,1746300550.684791,-18000,EB445137-D7F5-57EC-87DA-1DB460D64046,"iPhone13,2"
com.apple.Music,14,1746300446,1746300460,1746300460.938356,-18000,EB445137-D7F5-57EC-87DA-1DB460D64046,"iPhone13,2"
com.apple.Music,43,1746299620,1746299663,1746299663.441619,-18000,EB445137-D7F5-57EC-87DA-1DB460D64046,"iPhone13,2"
com.apple.weather,14,1746298245,1746298259,1746298259.0216398,-18000,EB445137-D7F5-57EC-87DA-1DB460D64046,"iPhone13,2"
com.thestorygraph.thestorygraph,2,1746298243,1746298245,1746298245.5295382,-18000,EB445137-D7F5-57EC-87DA-1DB460D64046,"iPhone13,2"
com.apple.finder,2,1746298208,1746298210,1746298210.361151,-18000,,
com.leomehlig.today,6,1746298202,1746298208,1746298208.3135061,-18000,,
com.google.Chrome,4,1746298198,1746298202,1746298202.5120258,-18000,,
com.apple.Notes,8,1746298190,1746298198,1746298198.840158,-18000,,
com.google.Chrome,5,1746298185,1746298190,1746298190.529098,-18000,,
com.apple.Notes,5,1746298180,1746298185,1746298185.410229,-18000,,
com.google.Chrome,21,1746298159,1746298180,1746298180.812499,-18000,,
com.apple.Notes,2,1746298157,1746298159,1746298159.430134,-18000,,
com.google.Chrome,2,1746298155,1746298157,1746298157.250478,-18000,,
com.apple.Notes,3,1746298152,1746298155,1746298155.6637812,-18000,,
com.google.Chrome,48,1746298104,1746298152,1746298152.578237,-18000,,
com.apple.Notes,4,1746298100,1746298104,1746298104.981797,-18000,,
com.google.Chrome,6,1746298094,1746298100,1746298100.244296,-18000,,
com.apple.Notes,33,1746298061,1746298094,1746298094.6962461,-18000,,
com.google.Chrome,463,1746297598,1746298061,1746298061.453131,-18000,,
com.apple.Notes,20,1746297578,1746297598,1746297598.0872421,-18000,,
com.apple.Passwords,0,1746297578,1746297578,1746297578.732792,-18000,,
com.apple.Notes,3,1746297575,1746297578,1746297578.136324,-18000,,
com.apple.news,183,1746297392,1746297575,1746297575.44819,-18000,,
com.apple.Notes,53,1746297339,1746297392,1746297392.8778172,-18000,,
com.google.Chrome,19,1746297320,1746297339,1746297339.2475948,-18000,,
com.apple.Notes,1,1746297319,1746297320,1746297320.268742,-18000,,
com.google.Chrome,6,1746297313,1746297319,1746297319.259531,-18000,,
com.apple.Notes,13,1746297300,1746297313,1746297313.88054,-18000,,
com.google.Chrome,1,1746297299,1746297300,1746297300.511404,-18000,,
com.apple.Notes,4,1746297295,1746297299,1746297299.324507,-18000,,
com.google.Chrome,2,1746297293,1746297295,1746297295.071872,-18000,,
com.apple.Notes,6,1746297287,1746297293,1746297293.313756,-18000,,
com.google.Chrome,42,1746297245,1746297287,1746297287.864361,-18000,,
com.apple.Notes,104,1746297141,1746297245,1746297245.742443,-18000,,
com.google.Chrome,7,1746297134,1746297141,1746297141.1848369,-18000,,
com.thestorygraph.thestorygraph,148,1746297119,1746297267,1746297267.2526941,-18000,EB445137-D7F5-57EC-87DA-1DB460D64046,"iPhone13,2"
com.truebill.truebillnative,2,1746297116,1746297118,1746297118.88276,-18000,EB445137-D7F5-57EC-87DA-1DB460D64046,"iPhone13,2"
com.apple.Notes,239,1746296895,1746297134,1746297134.144872,-18000,,
com.microsoft.onenote.mac,8,1746296887,1746296895,1746296895.106439,-18000,,
com.apple.Notes,8,1746296879,1746296887,1746296887.717022,-18000,,
com.google.Chrome,42,1746296837,1746296879,1746296880.017143,-18000,,
com.apple.calculator,9,1746296828,1746296837,1746296837.289322,-18000,,
com.google.Chrome,0,1746296828,1746296828,1746296828.833535,-18000,,
com.apple.calculator,6,1746296822,1746296828,1746296828.154008,-18000,,
com.google.Chrome,1,1746296821,1746296822,1746296822.723096,-18000,,
com.apple.calculator,3,1746296818,1746296821,1746296821.656547,-18000,,
com.google.Chrome,1,1746296817,1746296818,1746296818.105679,-18000,,
com.apple.calculator,4,1746296813,1746296817,1746296817.392071,-18000,,
com.google.Chrome,1,1746296812,1746296813,1746296813.722776,-18000,,
com.apple.calculator,13,1746296799,1746296812,1746296812.760645,-18000,,
com.google.Chrome,1,1746296798,1746296799,1746296799.8684459,-18000,,
com.apple.calculator,5,1746296793,1746296798,1746296798.572823,-18000,,
com.google.Chrome,293,1746296500,1746296793,1746296793.4155421,-18000,,
com.apple.Passwords,3,1746296497,1746296500,1746296500.8260121,-18000,,
com.google.Chrome,9,1746296488,1746296497,1746296497.2606049,-18000,,
com.apple.Passwords,9,1746296479,1746296488,1746296488.547515,-18000,,
com.google.Chrome,4,1746296475,1746296479,1746296479.6305718,-18000,,
com.apple.Passwords,2,1746296473,1746296475,1746296475.9348888,-18000,,
com.google.Chrome,3,1746296470,1746296473,1746296473.699029,-18000,,
com.apple.Passwords,2,1746296468,1746296470,1746296470.837048,-18000,,
com.google.Chrome,11,1746296457,1746296468,1746296468.79503,-18000,,
com.apple.Passwords,6,1746296451,1746296457,1746296457.068186,-18000,,
com.apple.calculator,2,1746296449,1746296451,1746296451.92928,-18000,,
com.truebill.truebillnative,128,1746296419,1746296547,1746296547.698766,-18000,EB445137-D7F5-57EC-87DA-1DB460D64046,"iPhone13,2"
com.google.Chrome,81,1746296368,1746296449,1746296450.013917,-18000,,
com.apple.calculator,12,1746296356,1746296368,1746296368.231004,-18000,,
com.google.Chrome,108,1746296248,1746296356,1746296356.523803,-18000,,
com.truebill.truebillnative,142,1746296218,1746296360,1746296360.1817632,-18000,EB445137-D7F5-57EC-87DA-1DB460D64046,"iPhone13,2"
com.apple.Notes,50,1746296167,1746296217,1746296217.59689,-18000,,
com.apple.CoreAuthUI,2,1746296116,1746296118,1746296118.928317,-18000,EB445137-D7F5-57EC-87DA-1DB460D64046,"iPhone13,2"
com.clairmail.fth.client,103,1746296112,1746296215,1746296215.821373,-18000,EB445137-D7F5-57EC-87DA-1DB460D64046,"iPhone13,2"
com.apple.calculator,80,1746296087,1746296167,1746296167.803776,-18000,,
com.apple.Notes,13,1746296074,1746296087,1746296087.449839,-18000,,
com.apple.calculator,16,1746296058,1746296074,1746296074.809367,-18000,,
com.truebill.truebillnative,59,1746296045,1746296104,1746296104.697774,-18000,EB445137-D7F5-57EC-87DA-1DB460D64046,"iPhone13,2"
com.apple.MobileSMS,10,1746296035,1746296045,1746296045.222089,-18000,EB445137-D7F5-57EC-87DA-1DB460D64046,"iPhone13,2"
com.apple.MobileSMS,4,1746296031,1746296035,1746296035.070792,-18000,EB445137-D7F5-57EC-87DA-1DB460D64046,"iPhone13,2"
com.apple.Notes,93,1746295965,1746296058,1746296058.829576,-18000,,
com.truebill.truebillnative,72,1746295959,1746296031,1746296031.665402,-18000,EB445137-D7F5-57EC-87DA-1DB460D64046,"iPhone13,2"
com.google.Chrome,10,1746295955,1746295965,1746295965.366823,-18000,,
com.apple.MobileSMS,32,1746295927,1746295959,1746295959.555966,-18000,EB445137-D7F5-57EC-87DA-1DB460D64046,"iPhone13,2"
com.apple.calculator,53,1746295902,1746295955,1746295955.761952,-18000,,
com.truebill.truebillnative,52,1746295875,1746295927,1746295927.988388,-18000,EB445137-D7F5-57EC-87DA-1DB460D64046,"iPhone13,2"
com.apple.CoreAuthUI,2,1746295814,1746295816,1746295816.698213,-18000,EB445137-D7F5-57EC-87DA-1DB460D64046,"iPhone13,2"
com.robinhood.release.Robinhood,63,1746295810,1746295873,1746295873.527844,-18000,EB445137-D7F5-57EC-87DA-1DB460D64046,"iPhone13,2"
com.apple.CoreAuthUI,4,1746295777,1746295781,1746295781.722297,-18000,EB445137-D7F5-57EC-87DA-1DB460D64046,"iPhone13,2"
com.truebill.truebillnative,33,1746295774,1746295807,1746295807.587626,-18000,EB445137-D7F5-57EC-87DA-1DB460D64046,"iPhone13,2"
com.google.Chrome,161,1746295741,1746295902,1746295902.638505,-18000,,
com.apple.MobileSMS,3,1746295738,1746295741,1746295741.226663,-18000,,
com.google.Chrome,381,1746295357,1746295738,1746295739.4419909,-18000,,
com.apple.MobileSMS,6,1746295309,1746295315,1746295315.30541,-18000,,
com.apple.finder,3,1746295306,1746295309,1746295309.897653,-18000,,
com.apple.Preview,0,1746295306,1746295306,1746295307.862824,-18000,,
com.google.Chrome,6,1746295300,1746295306,1746295306.513123,-18000,,
com.leomehlig.today,10,1746295290,1746295300,1746295300.990668,-18000,,
com.apple.MobileSMS,40,1746295045,1746295085,1746295085.94029,-18000,EB445137-D7F5-57EC-87DA-1DB460D64046,"iPhone13,2"
com.apple.MobileSMS,9,1746295028,1746295037,1746295037.4527678,-18000,EB445137-D7F5-57EC-87DA-1DB460D64046,"iPhone13,2"
com.google.chrome.ios,15,1746295013,1746295028,1746295028.293038,-18000,EB445137-D7F5-57EC-87DA-1DB460D64046,"iPhone13,2"
com.apple.MobileSMS,36,1746294977,1746295013,1746295013.959144,-18000,EB445137-D7F5-57EC-87DA-1DB460D64046,"iPhone13,2"
com.apple.weather,6,1746294144,1746294150,1746294150.142027,-18000,EB445137-D7F5-57EC-87DA-1DB460D64046,"iPhone13,2"
com.leomehlig.today,324,1746293738,1746294062,1746294062.8783321,-18000,,
com.google.Chrome,14,1746293724,1746293738,1746293738.352456,-18000,,
com.leomehlig.today,50,1746293674,1746293724,1746293724.843569,-18000,,
com.apple.finder,5,1746293669,1746293674,1746293674.24927,-18000,,
com.leomehlig.today,9,1746293660,1746293669,1746293669.176972,-18000,,
com.google.Chrome,221,1746293439,1746293660,1746293660.137786,-18000,,
com.leomehlig.today,1,1746293438,1746293439,1746293439.9847379,-18000,,
com.google.Chrome,157,1746293281,1746293438,1746293438.934824,-18000,,
com.apple.finder,38,1746293243,1746293281,1746293281.402934,-18000,,
com.google.Chrome,53,1746293190,1746293243,1746293243.4485831,-18000,,
com.google.Chrome,396,1746292789,1746293185,1746293185.671061,-18000,,
com.google.Chrome,489,1746292298,1746292787,1746292787.447977,-18000,,
com.google.Chrome,305,1746291990,1746292295,1746292295.954626,-18000,,
com.google.Chrome,303,1746291447,1746291750,1746291750.962596,-18000,,
com.apple.finder,94,1746291353,1746291447,1746291448.015826,-18000,,
com.google.Chrome,816,1746290537,1746291353,1746291354.001926,-18000,,
com.apple.Preview,294,1746290243,1746290537,1746290537.53515,-18000,,
com.apple.news,251,1746289975,1746290226,1746290226.779008,-18000,EB445137-D7F5-57EC-87DA-1DB460D64046,"iPhone13,2"
com.apple.Preview,316,1746289858,1746290174,1746290174.150332,-18000,,
com.apple.finder,4,1746289854,1746289858,1746289858.351668,-18000,,
com.google.Chrome,18,1746289836,1746289854,1746289854.1121368,-18000,,
com.apple.finder,18,1746289806,1746289824,1746289824.939104,-18000,,
com.apple.Preview,3,1746289803,1746289806,1746289806.611294,-18000,,
com.google.Chrome,257,1746289546,1746289803,1746289803.8779259,-18000,,
com.apple.Preview,71,1746289475,1746289546,1746289546.5059361,-18000,,
com.google.Chrome,837,1746288638,1746289475,1746289475.8960361,-18000,,
com.apple.finder,1,1746288637,1746288638,1746288639.008812,-18000,,
com.apple.Preview,9,1746288628,1746288637,1746288637.6428308,-18000,,
com.apple.finder,1,1746288627,1746288628,1746288628.155116,-18000,,
com.google.Chrome,18,1746288609,1746288627,1746288627.302322,-18000,,
com.apple.finder,1,1746288608,1746288609,1746288609.3418589,-18000,,
com.apple.Preview,9,1746288599,1746288608,1746288608.114785,-18000,,
com.apple.finder,2,1746288597,1746288599,1746288599.967301,-18000,,
com.apple.Preview,4,1746288593,1746288597,1746288597.0760279,-18000,,
com.google.Chrome,55,1746288538,1746288593,1746288593.826778,-18000,,
com.apple.Preview,1,1746288537,1746288538,1746288538.612407,-18000,,
com.google.Chrome,232,1746288305,1746288537,1746288537.2908092,-18000,,
com.apple.Preview,1,1746288304,1746288305,1746288305.459041,-18000,,
com.google.Chrome,12,1746288292,1746288304,1746288304.302857,-18000,,
com.apple.Preview,32,1746288260,1746288292,1746288292.16792,-18000,,
com.google.Chrome,740,1746287520,1746288260,1746288261.032074,-18000,,
com.leomehlig.today,50,1746287470,1746287520,1746287520.945187,-18000,,
com.google.Chrome,41,1746287429,1746287470,1746287470.274805,-18000,,
com.apple.Preview,92,1746287337,1746287429,1746287429.2636971,-18000,,
com.apple.finder,1,1746287336,1746287337,1746287337.735515,-18000,,
com.apple.Preview,3,1746287333,1746287336,1746287336.384053,-18000,,
com.google.Chrome,953,1746286380,1746287333,1746287333.890172,-18000,,
com.apple.news,348,1746285906,1746286254,1746286255.2403178,-18000,EB445137-D7F5-57EC-87DA-1DB460D64046,"iPhone13,2"
com.google.chrome.ios,45,1746285861,1746285906,1746285906.991651,-18000,EB445137-D7F5-57EC-87DA-1DB460D64046,"iPhone13,2"
com.apple.news,121,1746285739,1746285860,1746285861.098127,-18000,EB445137-D7F5-57EC-87DA-1DB460D64046,"iPhone13,2"
com.apple.Health,23,1746285707,1746285730,1746285730.488349,-18000,EB445137-D7F5-57EC-87DA-1DB460D64046,"iPhone13,2"
com.apple.Health,1,1746285703,1746285704,1746285704.821241,-18000,EB445137-D7F5-57EC-87DA-1DB460D64046,"iPhone13,2"
com.google.Chrome,423,1746285307,1746285730,1746285730.7949471,-18000,,
com.apple.Preview,11,1746285296,1746285307,1746285307.217906,-18000,,
com.google.Chrome,174,1746285122,1746285296,1746285296.323717,-18000,,
com.apple.Preview,9,1746285113,1746285122,1746285122.7227988,-18000,,
com.google.Chrome,33,1746285080,1746285113,1746285113.953761,-18000,,
com.apple.Preview,6,1746285074,1746285080,1746285080.820298,-18000,,
com.google.Chrome,393,1746284681,1746285074,1746285074.944062,-18000,,
com.apple.Preview,2,1746284679,1746284681,1746284681.5951,-18000,,
com.google.Chrome,6,1746284673,1746284679,1746284679.645914,-18000,,
com.apple.Preview,3,1746284670,1746284673,1746284674.05973,-18000,,
com.google.Chrome,130,1746284540,1746284670,1746284670.4751348,-18000,,
com.apple.Preview,30,1746284510,1746284540,1746284540.094909,-18000,,
com.apple.finder,2,1746284508,1746284510,1746284510.02861,-18000,,
com.google.Chrome,1729,1746282779,1746284508,1746284508.179432,-18000,,
com.apple.finder,2,1746282777,1746282779,1746282779.4596748,-18000,,
com.google.Chrome,349,1746282428,1746282777,1746282777.873739,-18000,,
com.apple.finder,3,1746282425,1746282428,1746282428.3211532,-18000,,
com.google.Chrome,23,1746282402,1746282425,1746282425.968797,-18000,,
com.apple.finder,2,1746282400,1746282402,1746282402.9032578,-18000,,
com.google.Chrome,48,1746282352,1746282400,1746282400.323401,-18000,,
com.apple.finder,138,1746282214,1746282352,1746282353.4291692,-18000,,
com.apple.Health,7,1746281551,1746281558,1746281558.2752,-18000,EB445137-D7F5-57EC-87DA-1DB460D64046,"iPhone13,2"
com.apple.Health,29,1746281514,1746281543,1746281543.429727,-18000,EB445137-D7F5-57EC-87DA-1DB460D64046,"iPhone13,2"
com.renpho.health,35,1746280082,1746280117,1746280117.818713,-18000,EB445137-D7F5-57EC-87DA-1DB460D64046,"iPhone13,2"
com.apple.weather,16,1746279435,1746279451,1746279452.023016,-18000,EB445137-D7F5-57EC-87DA-1DB460D64046,"iPhone13,2"
com.apple.news,468,1746278965,1746279433,1746279433.43272,-18000,EB445137-D7F5-57EC-87DA-1DB460D64046,"iPhone13,2"
com.apple.news,30,1746239442,1746239472,1746239473.456728,-18000,EB445137-D7F5-57EC-87DA-1DB460D64046,"iPhone13,2"
com.apple.news,411,1746239029,1746239440,1746239441.213773,-18000,EB445137-D7F5-57EC-87DA-1DB460D64046,"iPhone13,2"
com.apple.Health,33,1746229031,1746229064,1746229064.932169,-18000,EB445137-D7F5-57EC-87DA-1DB460D64046,"iPhone13,2"
com.apple.weather,2,1746229014,1746229016,1746229016.714216,-18000,EB445137-D7F5-57EC-87DA-1DB460D64046,"iPhone13,2"
com.apple.weather,9,1746228999,1746229008,1746229009.3604589,-18000,EB445137-D7F5-57EC-87DA-1DB460D64046,"iPhone13,2"
com.apple.news,2,1746228997,1746228999,1746228999.512008,-18000,EB445137-D7F5-57EC-87DA-1DB460D64046,"iPhone13,2"
com.apple.news,98,1746228657,1746228755,1746228756.4140558,-18000,EB445137-D7F5-57EC-87DA-1DB460D64046,"iPhone13,2"
com.apple.mobilenotes,4,1746226088,1746226092,1746226092.11441,-18000,EB445137-D7F5-57EC-87DA-1DB460D64046,"iPhone13,2"
com.apple.mobilenotes,12,1746223431,1746223443,1746223443.516212,-18000,EB445137-D7F5-57EC-87DA-1DB460D64046,"iPhone13,2"
com.apple.mobilenotes,7,1746221985,1746221992,1746221993.063585,-18000,EB445137-D7F5-57EC-87DA-1DB460D64046,"iPhone13,2"
com.supercell.magic,358,1746220452,1746220810,1746220810.684582,-18000,EB445137-D7F5-57EC-87DA-1DB460D64046,"iPhone13,2"
com.apple.PeopleViewService,3,1746220445,1746220448,1746220448.245774,-18000,EB445137-D7F5-57EC-87DA-1DB460D64046,"iPhone13,2"
com.apple.PeopleViewService,1,1746220105,1746220106,1746220106.2186751,-18000,EB445137-D7F5-57EC-87DA-1DB460D64046,"iPhone13,2"
com.hammerandchisel.discord,8,1746220093,1746220101,1746220101.367536,-18000,EB445137-D7F5-57EC-87DA-1DB460D64046,"iPhone13,2"
com.microsoft.Office.Outlook,17,1746219959,1746219976,1746219976.069505,-18000,EB445137-D7F5-57EC-87DA-1DB460D64046,"iPhone13,2"
com.toyopagroup.picaboo,7,1746219951,1746219958,1746219959.0026278,-18000,EB445137-D7F5-57EC-87DA-1DB460D64046,"iPhone13,2"
com.toyopagroup.picaboo,5,1746219945,1746219950,1746219950.919754,-18000,EB445137-D7F5-57EC-87DA-1DB460D64046,"iPhone13,2"
com.apple.finder,3,1746219699,1746219702,1746219702.8924398,-18000,,
com.leomehlig.today,0,1746219699,1746219699,1746219699.829951,-18000,,
com.apple.finder,7,1746219692,1746219699,1746219699.4358869,-18000,,
com.apple.MobileSMS,1,1746219691,1746219692,1746219692.640929,-18000,,
com.apple.finder,1,1746219690,1746219691,1746219691.657918,-18000,,
com.microsoft.Excel,2,1746219688,1746219690,1746219690.5826159,-18000,,
com.apple.finder,2,1746219686,1746219688,1746219688.129983,-18000,,
com.apple.systempreferences,1,1746219685,1746219686,1746219686.439578,-18000,,
com.apple.Passwords,1,1746219684,1746219685,1746219685.616034,-18000,,
com.google.Chrome,91,1746219593,1746219684,1746219684.5552769,-18000,,
com.apple.Passwords,6,1746219572,1746219578,1746219578.5226588,-18000,,
com.google.Chrome,1,1746219571,1746219572,1746219572.501718,-18000,,
com.apple.systempreferences,2,1746219560,1746219562,1746219563.93045,-18000,,
com.google.Chrome,125,1746219425,1746219550,1746219550.69276,-18000,,
com.apple.finder,1,1746219424,1746219425,1746219425.037972,-18000,,
com.intsig.CamScannerLite,97,1746219355,1746219452,1746219454.543305,-18000,EB445137-D7F5-57EC-87DA-1DB460D64046,"iPhone13,2"
com.leomehlig.today,75,1746219349,1746219424,1746219424.568021,-18000,,
com.apple.MobileSMS,3,1746217887,1746217890,1746217890.329041,-18000,EB445137-D7F5-57EC-87DA-1DB460D64046,"iPhone13,2"
com.leomehlig.today,49,1746217870,1746217919,1746217919.881547,-18000,,
com.google.Chrome,229,1746217641,1746217870,1746217870.800881,-18000,,
com.microsoft.Excel,0,1746217641,1746217641,1746217641.760566,-18000,,
com.google.Chrome,4,1746217637,1746217641,1746217641.333212,-18000,,
com.microsoft.Excel,2,1746217635,1746217637,1746217637.89288,-18000,,
com.google.Chrome,14,1746217621,1746217635,1746217635.109662,-18000,,
com.microsoft.Excel,2,1746217619,1746217621,1746217621.5451,-18000,,
com.google.Chrome,1,1746217618,1746217619,1746217619.976398,-18000,,
com.microsoft.Excel,1,1746217617,1746217618,1746217618.317059,-18000,,
com.google.Chrome,2,1746217615,1746217617,1746217617.126729,-18000,,
com.microsoft.Excel,1,1746217614,1746217615,1746217615.57003,-18000,,
com.google.Chrome,2,1746217612,1746217614,1746217614.35753,-18000,,
com.microsoft.Excel,1,1746217611,1746217612,1746217612.402039,-18000,,
com.google.Chrome,4,1746217607,1746217611,1746217611.195531,-18000,,
com.microsoft.Excel,6,1746217601,1746217607,1746217607.585328,-18000,,
com.google.Chrome,4,1746217597,1746217601,1746217601.378316,-18000,,
com.microsoft.Excel,55,1746217542,1746217597,1746217597.899475,-18000,,
com.google.Chrome,188,1746217354,1746217542,1746217542.250005,-18000,,
com.microsoft.Excel,10,1746217344,1746217354,1746217354.5597239,-18000,,
com.google.Chrome,11,1746217333,1746217344,1746217344.434525,-18000,,
com.microsoft.Excel,1,1746217332,1746217333,1746217333.495007,-18000,,
com.google.Chrome,2,1746217330,1746217332,1746217332.0928922,-18000,,
com.microsoft.Excel,3,1746217327,1746217330,1746217330.5210052,-18000,,
com.google.Chrome,4,1746217323,1746217327,1746217327.222413,-18000,,
com.microsoft.Excel,3,1746217320,1746217323,1746217323.156948,-18000,,
com.google.Chrome,2,1746217318,1746217320,1746217320.2869658,-18000,,
com.microsoft.Excel,3,1746217315,1746217318,1746217318.408828,-18000,,
com.google.Chrome,1,1746217314,1746217315,1746217315.770778,-18000,,
com.microsoft.Excel,2,1746217312,1746217314,1746217314.8220282,-18000,,
com.google.Chrome,4,1746217308,1746217312,1746217312.378027,-18000,,
com.microsoft.Excel,5,1746217303,1746217308,1746217308.552897,-18000,,
com.google.Chrome,1,1746217302,1746217303,1746217304.0863562,-18000,,
com.microsoft.Excel,3,1746217299,1746217302,1746217302.691678,-18000,,
com.google.Chrome,3,1746217296,1746217299,1746217299.9382482,-18000,,
com.microsoft.Excel,1,1746217295,1746217296,1746217296.461628,-18000,,
com.google.Chrome,1,1746217294,1746217295,1746217295.369806,-18000,,
com.microsoft.Excel,40,1746217254,1746217294,1746217294.5439038,-18000,,
com.google.Chrome,4,1746217250,1746217254,1746217254.399945,-18000,,
com.microsoft.Excel,1,1746217249,1746217250,1746217250.930646,-18000,,
com.google.Chrome,4,1746217245,1746217249,1746217249.468133,-18000,,
com.microsoft.Excel,6,1746217239,1746217245,1746217245.057098,-18000,,
com.google.Chrome,10,1746217229,1746217239,1746217239.472125,-18000,,
com.microsoft.Excel,7,1746217222,1746217229,1746217229.853591,-18000,,
com.google.Chrome,3,1746217219,1746217222,1746217222.155182,-18000,,
com.microsoft.Excel,2,1746217217,1746217219,1746217219.249243,-18000,,
com.google.Chrome,1,1746217216,1746217217,1746217217.575392,-18000,,
com.microsoft.Excel,52,1746217164,1746217216,1746217216.179268,-18000,,
com.google.Chrome,3,1746217161,1746217164,1746217164.784754,-18000,,
com.microsoft.Excel,44,1746217117,1746217161,1746217161.226557,-18000,,
com.google.Chrome,3,1746217114,1746217117,1746217117.7920408,-18000,,
com.microsoft.Excel,15,1746217099,1746217114,1746217114.094089,-18000,,
com.google.Chrome,10,1746217089,1746217099,1746217099.887288,-18000,,
com.microsoft.Excel,3,1746217086,1746217089,1746217089.134835,-18000,,
com.google.Chrome,16,1746217070,1746217086,1746217086.156419,-18000,,
com.microsoft.Excel,91,1746216979,1746217070,1746217070.127736,-18000,,
com.google.Chrome,7,1746216972,1746216979,1746216979.378203,-18000,,
com.microsoft.Excel,2,1746216970,1746216972,1746216972.649643,-18000,,
com.google.Chrome,45,1746216925,1746216970,1746216970.962821,-18000,,
com.microsoft.Excel,1,1746216924,1746216925,1746216925.8374119,-18000,,
com.google.Chrome,7,1746216917,1746216924,1746216924.9607959,-18000,,
com.microsoft.Excel,2,1746216915,1746216917,1746216917.108737,-18000,,
com.google.Chrome,3,1746216912,1746216915,1746216915.869559,-18000,,
com.microsoft.Excel,3,1746216909,1746216912,1746216912.707128,-18000,,
com.google.Chrome,34,1746216875,1746216909,1746216909.5957289,-18000,,
com.microsoft.Excel,3,1746216872,1746216875,1746216875.299793,-18000,,
com.google.Chrome,103,1746216769,1746216872,1746216872.807416,-18000,,
com.microsoft.Excel,3,1746216766,1746216769,1746216769.286553,-18000,,
com.google.Chrome,3,1746216763,1746216766,1746216766.77322,-18000,,
com.microsoft.Excel,2,1746216761,1746216763,1746216763.34437,-18000,,
com.google.Chrome,6,1746216755,1746216761,1746216761.377311,-18000,,
com.microsoft.Excel,2,1746216753,1746216755,1746216755.476305,-18000,,
com.google.Chrome,8,1746216745,1746216753,1746216753.366127,-18000,,
com.microsoft.Excel,2,1746216743,1746216745,1746216745.163959,-18000,,
com.google.Chrome,2,1746216741,1746216743,1746216743.982944,-18000,,
com.microsoft.Excel,1,1746216740,1746216741,1746216741.7394109,-18000,,
com.google.Chrome,2,1746216738,1746216740,1746216740.2846808,-18000,,
com.microsoft.Excel,2,1746216736,1746216738,1746216738.053241,-18000,,
com.google.Chrome,7,1746216729,1746216736,1746216736.6910129,-18000,,
com.microsoft.Excel,2,1746216727,1746216729,1746216729.253885,-18000,,
com.google.Chrome,9,1746216718,1746216727,1746216728.0094938,-18000,,
com.microsoft.Excel,1,1746216717,1746216718,1746216718.8240519,-18000,,
com.google.Chrome,2,1746216715,1746216717,1746216717.654177,-18000,,
com.microsoft.Excel,1,1746216714,1746216715,1746216715.729871,-18000,,
com.google.Chrome,2,1746216712,1746216714,1746216714.235966,-18000,,
com.microsoft.Excel,5,1746216707,1746216712,1746216712.296001,-18000,,
com.google.Chrome,4,1746216703,1746216707,1746216707.38722,-18000,,
com.microsoft.Excel,3,1746216700,1746216703,1746216703.4450579,-18000,,
com.google.Chrome,20,1746216680,1746216700,1746216700.641604,-18000,,
com.microsoft.Excel,131,1746216549,1746216680,1746216680.1384258,-18000,,
com.google.Chrome,1,1746216548,1746216549,1746216549.907761,-18000,,
com.microsoft.Excel,130,1746216418,1746216548,1746216548.277189,-18000,,
com.google.Chrome,22,1746216396,1746216418,1746216418.37958,-18000,,
com.microsoft.Excel,76,1746216320,1746216396,1746216396.787756,-18000,,
com.google.Chrome,31,1746216289,1746216320,1746216320.6254401,-18000,,
com.microsoft.Excel,35,1746216254,1746216289,1746216289.076699,-18000,,
com.google.Chrome,45,1746216209,1746216254,1746216254.4010072,-18000,,
com.microsoft.Excel,11,1746216198,1746216209,1746216209.306345,-18000,,
com.google.Chrome,560,1746215638,1746216198,1746216198.788928,-18000,,
com.microsoft.Excel,2,1746215636,1746215638,1746215638.4973269,-18000,,
com.google.Chrome,5,1746215631,1746215636,1746215637.0587091,-18000,,
com.microsoft.Excel,1,1746215630,1746215631,1746215631.71087,-18000,,
com.google.Chrome,2,1746215628,1746215630,1746215630.1413112,-18000,,
com.microsoft.Excel,2,1746215626,1746215628,1746215628.568592,-18000,,
com.google.Chrome,7,1746215619,1746215626,1746215626.456853,-18000,,
com.microsoft.Excel,1,1746215618,1746215619,1746215619.847333,-18000,,
com.google.Chrome,2,1746215616,1746215618,1746215618.3724961,-18000,,
com.microsoft.Excel,1,1746215615,1746215616,1746215616.413137,-18000,,
com.google.Chrome,4,1746215611,1746215615,1746215615.3061938,-18000,,
com.microsoft.Excel,71,1746215540,1746215611,1746215612.0820289,-18000,,
com.google.Chrome,353,1746215187,1746215540,1746215540.811654,-18000,,
com.microsoft.Excel,7,1746215180,1746215187,1746215187.884712,-18000,,
com.google.Chrome,3,1746215177,1746215180,1746215181.015658,-18000,,
com.microsoft.Excel,1,1746215176,1746215177,1746215177.328661,-18000,,
com.google.Chrome,8,1746215168,1746215176,1746215176.232503,-18000,,
com.microsoft.Excel,1,1746215167,1746215168,1746215168.9458818,-18000,,
com.google.Chrome,2,1746215165,1746215167,1746215167.5346189,-18000,,
com.microsoft.Excel,1,1746215164,1746215165,1746215165.906787,-18000,,
com.google.Chrome,2,1746215162,1746215164,1746215164.8851109,-18000,,
com.microsoft.Excel,1,1746215161,1746215162,1746215162.624751,-18000,,
com.google.Chrome,2,1746215159,1746215161,1746215161.288752,-18000,,
com.microsoft.Excel,1,1746215158,1746215159,1746215159.873801,-18000,,
com.google.Chrome,5,1746215153,1746215158,1746215158.4987001,-18000,,
com.microsoft.Excel,83,1746215070,1746215153,1746215153.337466,-18000,,
com.apple.MobileSMS,12,1746215058,1746215070,1746215070.161674,-18000,,
com.microsoft.Excel,11,1746215047,1746215058,1746215058.258062,-18000,,
com.google.Chrome,37,1746215010,1746215047,1746215047.9161491,-18000,,
com.microsoft.Excel,23,1746214987,1746215010,1746215010.529237,-18000,,
com.google.Chrome,33,1746214954,1746214987,1746214987.658063,-18000,,
com.microsoft.Excel,115,1746214839,1746214954,1746214954.41954,-18000,,
com.google.Chrome,11,1746214828,1746214839,1746214839.8274999,-18000,,
com.microsoft.Excel,2,1746214826,1746214828,1746214828.3269382,-18000,,
com.google.Chrome,12,1746214814,1746214826,1746214826.923696,-18000,,
com.microsoft.Excel,2,1746214812,1746214814,1746214814.540351,-18000,,
com.google.Chrome,4,1746214808,1746214812,1746214812.46786,-18000,,
com.microsoft.Excel,2,1746214806,1746214808,1746214808.875657,-18000,,
com.google.Chrome,2,1746214804,1746214806,1746214806.612371,-18000,,
com.microsoft.Excel,2,1746214802,1746214804,1746214804.8161678,-18000,,
com.google.Chrome,1,1746214801,1746214802,1746214802.923868,-18000,,
com.microsoft.Excel,10,1746214791,1746214801,1746214801.1661901,-18000,,
com.google.Chrome,13,1746214778,1746214791,1746214791.980226,-18000,,
com.microsoft.Excel,3,1746214775,1746214778,1746214778.119007,-18000,,
com.google.Chrome,9,1746214766,1746214775,1746214775.917492,-18000,,
com.microsoft.Excel,2,1746214764,1746214766,1746214766.264141,-18000,,
com.google.Chrome,2,1746214762,1746214764,1746214764.8405871,-18000,,
com.microsoft.Excel,2,1746214760,1746214762,1746214762.899957,-18000,,
com.google.Chrome,2,1746214758,1746214760,1746214760.5626411,-18000,,
com.microsoft.Excel,1,1746214757,1746214758,1746214758.489423,-18000,,
com.google.Chrome,2,1746214755,1746214757,1746214757.70008,-18000,,
com.microsoft.Excel,2,1746214753,1746214755,1746214756.014034,-18000,,
com.google.Chrome,2,1746214751,1746214753,1746214753.1727428,-18000,,
com.microsoft.Excel,2,1746214749,1746214751,1746214751.5482268,-18000,,
com.google.Chrome,3,1746214746,1746214749,1746214749.720607,-18000,,
com.microsoft.Excel,1,1746214745,1746214746,1746214746.157191,-18000,,
com.google.Chrome,2,1746214743,1746214745,1746214745.279434,-18000,,
com.microsoft.Excel,1,1746214742,1746214743,1746214743.967867,-18000,,
com.google.Chrome,20,1746214722,1746214742,1746214742.324016,-18000,,
com.microsoft.Excel,1,1746214721,1746214722,1746214722.330402,-18000,,
com.google.Chrome,1,1746214720,1746214721,1746214721.338289,-18000,,
com.microsoft.Excel,2,1746214718,1746214720,1746214720.114863,-18000,,
com.google.Chrome,7,1746214711,1746214718,1746214718.5088181,-18000,,
com.microsoft.Excel,4,1746214707,1746214711,1746214711.4721599,-18000,,
com.google.Chrome,5,1746214702,1746214707,1746214707.926351,-18000,,
com.microsoft.Excel,141,1746214561,1746214702,1746214702.6511788,-18000,,
com.google.Chrome,3,1746214558,1746214561,1746214562.0682058,-18000,,
com.microsoft.Excel,26,1746214532,1746214558,1746214558.384427,-18000,,
com.google.Chrome,4,1746214528,1746214532,1746214532.284483,-18000,,
com.microsoft.Excel,37,1746214491,1746214528,1746214528.132084,-18000,,
com.google.Chrome,34,1746214457,1746214491,1746214491.377678,-18000,,
com.microsoft.Excel,31,1746214426,1746214457,1746214457.284522,-18000,,
com.google.Chrome,1,1746214425,1746214426,1746214426.6244988,-18000,,
com.microsoft.Excel,6,1746214419,1746214425,1746214425.1840239,-18000,,
com.google.Chrome,3,1746214416,1746214419,1746214419.222852,-18000,,
com.microsoft.Excel,6,1746214410,1746214416,1746214416.289777,-18000,,
com.google.Chrome,3,1746214407,1746214410,1746214410.128223,-18000,,
com.microsoft.Excel,0,1746214407,1746214407,1746214407.499999,-18000,,
com.google.Chrome,5,1746214402,1746214407,1746214407.2262611,-18000,,
com.microsoft.Excel,5,1746214397,1746214402,1746214402.231861,-18000,,
com.google.Chrome,7,1746214390,1746214397,1746214397.885366,-18000,,
com.microsoft.Excel,12,1746214378,1746214390,1746214390.8754768,-18000,,
com.google.Chrome,6,1746214372,1746214378,1746214378.68333,-18000,,
com.microsoft.Excel,8,1746214364,1746214372,1746214372.45293,-18000,,
com.google.Chrome,7,1746214357,1746214364,1746214364.527539,-18000,,
com.microsoft.Excel,19,1746214338,1746214357,1746214357.118087,-18000,,
com.google.Chrome,5,1746214333,1746214338,1746214338.769656,-18000,,
com.microsoft.Excel,0,1746214333,1746214333,1746214333.847305,-18000,,
com.google.Chrome,1,1746214332,1746214333,1746214333.378581,-18000,,
com.microsoft.Excel,33,1746214299,1746214332,1746214332.32587,-18000,,
com.google.Chrome,22,1746214277,1746214299,1746214299.52566,-18000,,
com.microsoft.Excel,5,1746214272,1746214277,1746214277.762121,-18000,,
com.google.Chrome,61,1746214211,1746214272,1746214272.2915049,-18000,,
com.leomehlig.today,31,1746214124,1746214155,1746214155.293841,-18000,,
com.google.Chrome,9,1746214115,1746214124,1746214124.289781,-18000,,
com.apple.finder,31,1746214084,1746214115,1746214115.886047,-18000,,
com.intsig.CamScannerLite,141,1746213965,1746214106,1746214109.112413,-18000,EB445137-D7F5-57EC-87DA-1DB460D64046,"iPhone13,2"
com.apple.Preview,328,1746213756,1746214084,1746214084.8344831,-18000,,
com.apple.finder,11,1746213745,1746213756,1746213756.719026,-18000,,
com.microsoft.Office.Outlook,5,1746213637,1746213642,1746213642.398356,-18000,EB445137-D7F5-57EC-87DA-1DB460D64046,"iPhone13,2"
com.toyopagroup.picaboo,39,1746213582,1746213621,1746213621.039774,-18000,EB445137-D7F5-57EC-87DA-1DB460D64046,"iPhone13,2"
com.apple.MobileSMS,4,1746213545,1746213549,1746213549.941077,-18000,EB445137-D7F5-57EC-87DA-1DB460D64046,"iPhone13,2"
com.google.Chrome,1104,1746212641,1746213745,1746213746.025821,-18000,,
com.apple.MobileSMS,12,1746212600,1746212612,1746212612.516216,-18000,EB445137-D7F5-57EC-87DA-1DB460D64046,"iPhone13,2"
com.apple.mobilenotes,1,1746212599,1746212600,1746212600.230932,-18000,EB445137-D7F5-57EC-87DA-1DB460D64046,"iPhone13,2"
com.apple.mobilenotes,44,1746211693,1746211737,1746211737.853414,-18000,EB445137-D7F5-57EC-87DA-1DB460D64046,"iPhone13,2"
com.apple.mobilenotes,153,1746211427,1746211580,1746211580.9823508,-18000,EB445137-D7F5-57EC-87DA-1DB460D64046,"iPhone13,2"
com.apple.weather,73,1746210400,1746210473,1746210473.914166,-18000,EB445137-D7F5-57EC-87DA-1DB460D64046,"iPhone13,2"
com.toyopagroup.picaboo,47,1746209930,1746209977,1746209977.5923119,-18000,EB445137-D7F5-57EC-87DA-1DB460D64046,"iPhone13,2"
com.apple.news,1,1746209929,1746209930,1746209931.7254748,-18000,EB445137-D7F5-57EC-87DA-1DB460D64046,"iPhone13,2"
com.google.Chrome,86,1746209273,1746209359,1746209359.5040112,-18000,,
com.apple.finder,12,1746209261,1746209273,1746209273.06475,-18000,,
com.google.Chrome,72,1746209189,1746209261,1746209261.8983889,-18000,,
com.apple.finder,33,1746209156,1746209189,1746209189.200591,-18000,,
com.google.Chrome,201,1746208955,1746209156,1746209156.365612,-18000,,
com.apple.finder,2,1746208938,1746208940,1746208940.4509978,-18000,,
com.apple.news,466,1746208465,1746208931,1746208932.365689,-18000,EB445137-D7F5-57EC-87DA-1DB460D64046,"iPhone13,2"
com.openai.chat,9,1746208453,1746208462,1746208462.7546248,-18000,EB445137-D7F5-57EC-87DA-1DB460D64046,"iPhone13,2"
com.apple.finder,40,1746208402,1746208442,1746208443.086012,-18000,,
com.google.Chrome,83,1746208319,1746208402,1746208402.8561,-18000,,
com.apple.finder,2,1746208317,1746208319,1746208319.4591799,-18000,,
com.openai.chat,84,1746207478,1746207562,1746207562.56453,-18000,EB445137-D7F5-57EC-87DA-1DB460D64046,"iPhone13,2"
com.apple.news,1,1746207472,1746207473,1746207474.000607,-18000,EB445137-D7F5-57EC-87DA-1DB460D64046,"iPhone13,2"
com.apple.news,85,1746206668,1746206753,1746206754.132246,-18000,EB445137-D7F5-57EC-87DA-1DB460D64046,"iPhone13,2"
com.apple.news,195,1746204065,1746204260,1746204260.874124,-18000,EB445137-D7F5-57EC-87DA-1DB460D64046,"iPhone13,2"
com.apple.news,443,1746201225,1746201668,1746201669.0818682,-18000,EB445137-D7F5-57EC-87DA-1DB460D64046,"iPhone13,2"
com.apple.finder,2,1746200853,1746200855,1746200855.8098679,-18000,,
com.leomehlig.today,14,1746200708,1746200722,1746200722.80163,-18000,EB445137-D7F5-57EC-87DA-1DB460D64046,"iPhone13,2"
com.apple.CoreAuthUI,2,1746200703,1746200705,1746200705.561602,-18000,EB445137-D7F5-57EC-87DA-1DB460D64046,"iPhone13,2"
com.robinhood.release.Robinhood,4,1746200701,1746200705,1746200705.387958,-18000,EB445137-D7F5-57EC-87DA-1DB460D64046,"iPhone13,2"
com.leomehlig.today,159,1746200694,1746200853,1746200853.153448,-18000,,
com.apple.CoreAuthUI,4,1746199885,1746199889,1746199889.369149,-18000,EB445137-D7F5-57EC-87DA-1DB460D64046,"iPhone13,2"
com.robinhood.release.Robinhood,33,1746199873,1746199906,1746199906.9007158,-18000,EB445137-D7F5-57EC-87DA-1DB460D64046,"iPhone13,2"
com.apple.news,249,1746199622,1746199871,1746199871.911721,-18000,EB445137-D7F5-57EC-87DA-1DB460D64046,"iPhone13,2"
com.thestorygraph.thestorygraph,1,1746199621,1746199622,1746199622.4346151,-18000,EB445137-D7F5-57EC-87DA-1DB460D64046,"iPhone13,2"
com.thestorygraph.thestorygraph,1,1746199293,1746199294,1746199295.207471,-18000,EB445137-D7F5-57EC-87DA-1DB460D64046,"iPhone13,2"
com.microsoft.Office.Outlook,48,1746199245,1746199293,1746199293.9590468,-18000,EB445137-D7F5-57EC-87DA-1DB460D64046,"iPhone13,2"
com.thestorygraph.thestorygraph,0,1746199245,1746199245,1746199245.8617182,-18000,EB445137-D7F5-57EC-87DA-1DB460D64046,"iPhone13,2"
com.leomehlig.today,303,1746198746,1746199049,1746199049.431686,-18000,,
com.apple.iCal,15,1746198731,1746198746,1746198746.240907,-18000,,
com.google.Chrome,19,1746198712,1746198731,1746198731.8679318,-18000,,
com.google.Chrome,648,1746198056,1746198704,1746198704.298121,-18000,,
com.apple.iCal,100,1746197956,1746198056,1746198056.757563,-18000,,
com.google.Chrome,3,1746197953,1746197956,1746197956.7511039,-18000,,
com.apple.iCal,25,1746197928,1746197953,1746197953.789223,-18000,,
com.google.Chrome,8,1746197920,1746197928,1746197928.926334,-18000,,
com.apple.iCal,31,1746197889,1746197920,1746197920.3096519,-18000,,
com.google.Chrome,1,1746197888,1746197889,1746197889.696212,-18000,,
com.apple.iCal,11,1746197877,1746197888,1746197888.0547218,-18000,,
com.google.Chrome,9,1746197868,1746197877,1746197877.5247788,-18000,,
com.apple.iCal,39,1746197829,1746197868,1746197868.06466,-18000,,
com.google.Chrome,65,1746197764,1746197829,1746197829.8166928,-18000,,
com.apple.Notes,9,1746197755,1746197764,1746197764.394507,-18000,,
com.google.Chrome,8,1746197747,1746197755,1746197755.970047,-18000,,
com.apple.Notes,11,1746197736,1746197747,1746197747.291631,-18000,,
com.thestorygraph.thestorygraph,33,1746197496,1746197529,1746197530.251642,-18000,EB445137-D7F5-57EC-87DA-1DB460D64046,"iPhone13,2"
com.google.Chrome,1020,1746196716,1746197736,1746197736.9564419,-18000,,
com.microsoft.VSCode,1,1746196702,1746196703,1746196704.2100391,-18000,,
com.google.Chrome,5,1746196697,1746196702,1746196702.22689,-18000,,
com.microsoft.Office.Outlook,13,1746196676,1746196689,1746196689.538487,-18000,EB445137-D7F5-57EC-87DA-1DB460D64046,"iPhone13,2"
com.leomehlig.today,63,1746196634,1746196697,1746196698.77491,-18000,,
com.apple.shortcuts,53,1746196622,1746196675,1746196675.78024,-18000,EB445137-D7F5-57EC-87DA-1DB460D64046,"iPhone13,2"
com.instructure.icanvas,17,1746196556,1746196573,1746196574.13912,-18000,EB445137-D7F5-57EC-87DA-1DB460D64046,"iPhone13,2"
com.google.chrome.ios,1,1746196555,1746196556,1746196556.418048,-18000,EB445137-D7F5-57EC-87DA-1DB460D64046,"iPhone13,2"
com.google.Chrome,133,1746196501,1746196634,1746196634.580666,-18000,,
com.microsoft.VSCode,27,1746196474,1746196501,1746196501.618118,-18000,,
com.google.Chrome,19,1746196455,1746196474,1746196474.323563,-18000,,
com.leomehlig.today,46,1746196409,1746196455,1746196455.407233,-18000,,
com.google.Chrome,57,1746196352,1746196409,1746196409.143229,-18000,,
com.google.Chrome,145,1746195844,1746195989,1746195989.201658,-18000,,
com.leomehlig.today,2,1746195842,1746195844,1746195844.92725,-18000,,
com.leomehlig.today,11,1746194510,1746194521,1746194521.501833,-18000,,
com.google.Chrome,1449,1746193061,1746194510,1746194510.567862,-18000,,
com.google.chrome.ios,80,1746192997,1746193077,1746193077.644319,-18000,EB445137-D7F5-57EC-87DA-1DB460D64046,"iPhone13,2"
com.apple.weather,1,1746192996,1746192997,1746192997.938128,-18000,EB445137-D7F5-57EC-87DA-1DB460D64046,"iPhone13,2"
com.apple.weather,2,1746191484,1746191486,1746191487.593775,-18000,EB445137-D7F5-57EC-87DA-1DB460D64046,"iPhone13,2"
com.renpho.health,29,1746190567,1746190596,1746190597.180139,-18000,EB445137-D7F5-57EC-87DA-1DB460D64046,"iPhone13,2"
com.apple.Health,5,1746189618,1746189623,1746189623.161767,-18000,EB445137-D7F5-57EC-87DA-1DB460D64046,"iPhone13,2"
com.apple.Health,41,1746156520,1746156561,1746156561.509176,-18000,EB445137-D7F5-57EC-87DA-1DB460D64046,"iPhone13,2"
com.apple.Music,2,1746156492,1746156494,1746156494.664532,-18000,EB445137-D7F5-57EC-87DA-1DB460D64046,"iPhone13,2"
com.google.Chrome,3377,1746152979,1746156356,1746156356.3336139,-18000,,
com.google.Chrome,883,1746151953,1746152836,1746152836.8879461,-18000,,
com.apple.finder,2,1746151951,1746151953,1746151953.2493849,-18000,,
com.apple.finder,68,1746151552,1746151620,1746151620.444025,-18000,,
com.microsoft.Outlook,1,1746151551,1746151552,1746151552.4347491,-18000,,
com.google.Chrome,413,1746151138,1746151551,1746151551.283675,-18000,,
com.microsoft.Outlook,16,1746151109,1746151125,1746151125.6791282,-18000,,
com.google.Chrome,11,1746151098,1746151109,1746151109.1107569,-18000,,
com.apple.finder,14,1746151084,1746151098,1746151098.829224,-18000,,
com.apple.Music,6,1746150157,1746150163,1746150163.983196,-18000,EB445137-D7F5-57EC-87DA-1DB460D64046,"iPhone13,2"
com.apple.MusicUIService,3,1746150134,1746150137,1746150137.8473768,-18000,EB445137-D7F5-57EC-87DA-1DB460D64046,"iPhone13,2"
com.apple.Music,38,1746150103,1746150141,1746150141.42208,-18000,EB445137-D7F5-57EC-87DA-1DB460D64046,"iPhone13,2"
com.microsoft.Office.Outlook,10,1746149922,1746149932,1746149932.491261,-18000,EB445137-D7F5-57EC-87DA-1DB460D64046,"iPhone13,2"
com.instructure.icanvas,4,1746149916,1746149920,1746149920.140796,-18000,EB445137-D7F5-57EC-87DA-1DB460D64046,"iPhone13,2"
com.strava.stravaride,0,1746149916,1746149916,1746149917.936374,-18000,EB445137-D7F5-57EC-87DA-1DB460D64046,"iPhone13,2"
com.apple.finder,343,1746149826,1746150169,1746150169.903889,-18000,,
com.apple.finder,410,1746149325,1746149735,1746149735.7246141,-18000,,
com.leomehlig.today,118,1746149207,1746149325,1746149325.811798,-18000,,
com.google.Chrome,197,1746149010,1746149207,1746149208.094472,-18000,,
com.strava.stravaride,60,1746148950,1746149010,1746149010.318779,-18000,EB445137-D7F5-57EC-87DA-1DB460D64046,"iPhone13,2"
com.leomehlig.today,68,1746148942,1746149010,1746149010.878693,-18000,,
com.google.Chrome,1,1746148941,1746148942,1746148942.3101048,-18000,,
com.apple.finder,38,1746148903,1746148941,1746148941.6935558,-18000,,
com.google.Chrome,2,1746148901,1746148903,1746148903.7717319,-18000,,
com.leomehlig.today,1,1746148900,1746148901,1746148901.8184772,-18000,,
com.google.Chrome,62,1746148838,1746148900,1746148900.965016,-18000,,
com.leomehlig.today,2,1746148829,1746148831,1746148831.1613522,-18000,,
com.google.Chrome,5,1746148824,1746148829,1746148829.45709,-18000,,
com.leomehlig.today,1,1746148823,1746148824,1746148825.9046721,-18000,,
com.microsoft.Powerpoint,544,1746148279,1746148823,1746148823.260116,-18000,,
com.leomehlig.today,2,1746148277,1746148279,1746148279.639694,-18000,,
com.apple.weather,4,1746148273,1746148277,1746148277.500555,-18000,,
com.leomehlig.today,10,1746148263,1746148273,1746148273.3641381,-18000,,
com.google.chrome.ios,123,1746146242,1746146365,1746146366.113085,-18000,EB445137-D7F5-57EC-87DA-1DB460D64046,"iPhone13,2"
com.instructure.icanvas,15,1746146227,1746146242,1746146243.084527,-18000,EB445137-D7F5-57EC-87DA-1DB460D64046,"iPhone13,2"
com.apple.CoreAuthUI,3,1746146212,1746146215,1746146215.911593,-18000,EB445137-D7F5-57EC-87DA-1DB460D64046,"iPhone13,2"
com.google.chrome.ios,27,1746146199,1746146226,1746146226.899767,-18000,EB445137-D7F5-57EC-87DA-1DB460D64046,"iPhone13,2"
com.microsoft.Office.Outlook,16,1746146183,1746146199,1746146199.6584039,-18000,EB445137-D7F5-57EC-87DA-1DB460D64046,"iPhone13,2"
com.apple.calculator,0,1746146183,1746146183,1746146183.977539,-18000,EB445137-D7F5-57EC-87DA-1DB460D64046,"iPhone13,2"
com.apple.calculator,117,1746143002,1746143119,1746143119.2334862,-18000,EB445137-D7F5-57EC-87DA-1DB460D64046,"iPhone13,2"
com.apple.news,108,1746141130,1746141238,1746141239.649802,-18000,EB445137-D7F5-57EC-87DA-1DB460D64046,"iPhone13,2"
com.leomehlig.today,24,1746140894,1746140918,1746140918.354751,-18000,,
com.apple.finder,1,1746140893,1746140894,1746140894.4360452,-18000,,
com.apple.Notes,1,1746140892,1746140893,1746140893.1318002,-18000,,
com.google.Chrome,47,1746140845,1746140892,1746140892.342447,-18000,,
com.toyopagroup.picaboo,2,1746140803,1746140805,1746140805.772357,-18000,EB445137-D7F5-57EC-87DA-1DB460D64046,"iPhone13,2"
com.microsoft.Office.Outlook,8,1746140794,1746140802,1746140802.256047,-18000,EB445137-D7F5-57EC-87DA-1DB460D64046,"iPhone13,2"
com.google.chrome.ios,1,1746140793,1746140794,1746140794.314783,-18000,EB445137-D7F5-57EC-87DA-1DB460D64046,"iPhone13,2"
com.google.chrome.ios,15,1746140076,1746140091,1746140091.49019,-18000,EB445137-D7F5-57EC-87DA-1DB460D64046,"iPhone13,2"
com.google.Chrome,50,1746139455,1746139505,1746139506.019319,-18000,,
com.leomehlig.today,11,1746139444,1746139455,1746139455.4025989,-18000,,
com.apple.iCal,2,1746139442,1746139444,1746139444.872171,-18000,,
com.apple.FaceTime,1,1746139441,1746139442,1746139443.026238,-18000,,
com.apple.iCal,7,1746139434,1746139441,1746139441.8060532,-18000,,
com.microsoft.Office.Outlook,21,1746139071,1746139092,1746139092.9777489,-18000,EB445137-D7F5-57EC-87DA-1DB460D64046,"iPhone13,2"
com.apple.weather,2,1746139068,1746139070,1746139070.692824,-18000,EB445137-D7F5-57EC-87DA-1DB460D64046,"iPhone13,2"
com.apple.iCal,300,1746139058,1746139358,1746139358.55894,-18000,,
com.apple.weather,2,1746139046,1746139048,1746139048.264293,-18000,EB445137-D7F5-57EC-87DA-1DB460D64046,"iPhone13,2"
com.apple.MobileSMS,3,1746139042,1746139045,1746139045.378716,-18000,EB445137-D7F5-57EC-87DA-1DB460D64046,"iPhone13,2"
com.microsoft.Office.Outlook,25,1746139017,1746139042,1746139042.842472,-18000,EB445137-D7F5-57EC-87DA-1DB460D64046,"iPhone13,2"
com.apple.MobileSMS,15,1746138999,1746139014,1746139014.4643269,-18000,EB445137-D7F5-57EC-87DA-1DB460D64046,"iPhone13,2"
com.apple.MobileSMS,11,1746138986,1746138997,1746138998.1305299,-18000,EB445137-D7F5-57EC-87DA-1DB460D64046,"iPhone13,2"
com.apple.MobileSMS,78,1746138908,1746138986,1746138986.9157329,-18000,EB445137-D7F5-57EC-87DA-1DB460D64046,"iPhone13,2"
com.apple.iCal,300,1746138691,1746138991,1746138991.303441,-18000,,
com.leomehlig.today,123,1746138568,1746138691,1746138691.31361,-18000,,
com.apple.iCal,11,1746138557,1746138568,1746138568.8317971,-18000,,
com.toyopagroup.picaboo,11,1746138543,1746138554,1746138555.1409822,-18000,EB445137-D7F5-57EC-87DA-1DB460D64046,"iPhone13,2"
com.intsig.CamScannerLite,1,1746138542,1746138543,1746138543.340814,-18000,EB445137-D7F5-57EC-87DA-1DB460D64046,"iPhone13,2"
com.google.Chrome,281,1746138276,1746138557,1746138557.048857,-18000,,
com.apple.finder,2,1746138274,1746138276,1746138276.506009,-18000,,
com.google.Chrome,3,1746138271,1746138274,1746138274.823565,-18000,,
com.apple.finder,2,1746138269,1746138271,1746138271.536567,-18000,,
com.microsoft.Powerpoint,29,1746138240,1746138269,1746138269.7900739,-18000,,
com.apple.finder,3,1746138237,1746138240,1746138240.603903,-18000,,
com.microsoft.Powerpoint,7,1746138230,1746138237,1746138237.1274061,-18000,,
com.apple.finder,7,1746138223,1746138230,1746138230.606491,-18000,,
com.microsoft.Powerpoint,46,1746138177,1746138223,1746138224.402777,-18000,,
com.google.Chrome,32,1746138145,1746138177,1746138177.754521,-18000,,
com.microsoft.Powerpoint,1,1746138144,1746138145,1746138145.866754,-18000,,
com.google.Chrome,1,1746138143,1746138144,1746138144.756703,-18000,,
com.apple.finder,6,1746138137,1746138143,1746138143.565329,-18000,,
com.google.Chrome,4,1746138133,1746138137,1746138137.7670789,-18000,,
com.apple.finder,3,1746138130,1746138133,1746138133.136816,-18000,,
com.google.Chrome,53,1746138077,1746138130,1746138130.46946,-18000,,
com.apple.finder,32,1746138045,1746138077,1746138077.5277472,-18000,,
com.google.Chrome,19,1746138026,1746138045,1746138045.867562,-18000,,
com.apple.finder,6,1746138020,1746138026,1746138026.994555,-18000,,
com.google.Chrome,14,1746138006,1746138020,1746138020.808629,-18000,,
com.apple.finder,1,1746138005,1746138006,1746138006.973442,-18000,,
com.microsoft.Powerpoint,33,1746137972,1746138005,1746138005.883939,-18000,,
com.apple.finder,17,1746137955,1746137972,1746137972.834511,-18000,,
com.google.Chrome,3,1746137952,1746137955,1746137955.544337,-18000,,
com.apple.finder,147,1746137805,1746137952,1746137952.620199,-18000,,
com.google.Chrome,1,1746137804,1746137805,1746137805.754156,-18000,,
com.microsoft.Powerpoint,2,1746137802,1746137804,1746137804.7138438,-18000,,
com.google.Chrome,12,1746137790,1746137802,1746137802.1747298,-18000,,
com.microsoft.Powerpoint,455,1746137335,1746137790,1746137790.714215,-18000,,
com.google.Chrome,52,1746137283,1746137335,1746137335.586014,-18000,,
com.microsoft.Powerpoint,26,1746137257,1746137283,1746137283.520626,-18000,,
com.apple.FaceTime,2,1746137255,1746137257,1746137257.414196,-18000,,
com.apple.MobileSMS,2,1746137253,1746137255,1746137255.116421,-18000,,
com.apple.FaceTime,12,1746137241,1746137253,1746137253.3107262,-18000,,
com.apple.MobileSMS,55,1746137186,1746137241,1746137241.368267,-18000,,
com.apple.FaceTime,0,1746137186,1746137186,1746137186.9098701,-18000,,
com.apple.MobileSMS,13,1746137173,1746137186,1746137186.454062,-18000,,
com.microsoft.Powerpoint,48,1746137125,1746137173,1746137173.917097,-18000,,
com.apple.MobileSMS,0,1746137125,1746137125,1746137126.094111,-18000,,
com.apple.FaceTime,12,1746137113,1746137125,1746137125.423562,-18000,,
com.apple.MobileSMS,0,1746137113,1746137113,1746137113.360623,-18000,,
com.apple.FaceTime,1,1746137112,1746137113,1746137113.244184,-18000,,
com.apple.MobileSMS,5,1746137107,1746137112,1746137112.728457,-18000,,
com.microsoft.Powerpoint,71,1746137036,1746137107,1746137107.307911,-18000,,
com.apple.MobileSMS,1,1746137035,1746137036,1746137036.362934,-18000,,
com.apple.finder,7,1746137028,1746137035,1746137035.256199,-18000,,
com.intsig.CamScannerLite,124,1746136964,1746137088,1746137088.121741,-18000,EB445137-D7F5-57EC-87DA-1DB460D64046,"iPhone13,2"
com.apple.findmy,20,1746136944,1746136964,1746136965.2909951,-18000,EB445137-D7F5-57EC-87DA-1DB460D64046,"iPhone13,2"
com.apple.MobileSMS,88,1746136940,1746137028,1746137028.915793,-18000,,
com.apple.FaceTime,1,1746136939,1746136940,1746136940.4365659,-18000,,
com.apple.MobileSMS,12,1746136927,1746136939,1746136939.219589,-18000,,
com.microsoft.Powerpoint,227,1746136700,1746136927,1746136927.8167481,-18000,,
com.google.Chrome,2,1746136698,1746136700,1746136700.6473088,-18000,,
com.microsoft.Powerpoint,5,1746136693,1746136698,1746136698.776873,-18000,,
com.google.Chrome,2,1746136691,1746136693,1746136693.56106,-18000,,
com.microsoft.Powerpoint,3,1746136688,1746136691,1746136691.787739,-18000,,
com.google.Chrome,1,1746136687,1746136688,1746136688.8734741,-18000,,
com.microsoft.Powerpoint,3,1746136684,1746136687,1746136687.822844,-18000,,
com.google.Chrome,1,1746136683,1746136684,1746136684.338149,-18000,,
com.microsoft.Powerpoint,9,1746136674,1746136683,1746136683.215817,-18000,,
com.google.Chrome,3,1746136671,1746136674,1746136674.8684149,-18000,,
com.microsoft.Powerpoint,25,1746136646,1746136671,1746136671.455028,-18000,,
com.google.Chrome,2,1746136644,1746136646,1746136646.6538281,-18000,,
com.microsoft.Powerpoint,1,1746136643,1746136644,1746136644.1950989,-18000,,
com.google.Chrome,2,1746136641,1746136643,1746136643.192024,-18000,,
com.microsoft.Powerpoint,5,1746136636,1746136641,1746136641.554863,-18000,,
com.google.Chrome,2,1746136634,1746136636,1746136636.66977,-18000,,
com.microsoft.Powerpoint,0,1746136634,1746136634,1746136634.4668322,-18000,,
com.google.Chrome,10,1746136624,1746136634,1746136634.0708818,-18000,,
com.microsoft.Powerpoint,1,1746136623,1746136624,1746136624.595418,-18000,,
com.google.Chrome,1,1746136622,1746136623,1746136623.7555962,-18000,,
com.microsoft.Powerpoint,1,1746136621,1746136622,1746136622.51562,-18000,,
com.google.Chrome,1,1746136620,1746136621,1746136621.690812,-18000,,
com.microsoft.Powerpoint,1,1746136619,1746136620,1746136620.635881,-18000,,
com.google.Chrome,1,1746136618,1746136619,1746136619.845769,-18000,,
com.microsoft.Powerpoint,1,1746136617,1746136618,1746136618.9133139,-18000,,
com.google.Chrome,3,1746136614,1746136617,1746136617.7887778,-18000,,
com.microsoft.Powerpoint,44,1746136570,1746136614,1746136614.311053,-18000,,
com.google.Chrome,2,1746136568,1746136570,1746136570.499985,-18000,,
com.microsoft.Powerpoint,4,1746136564,1746136568,1746136568.7442322,-18000,,
com.google.Chrome,21,1746136543,1746136564,1746136564.699585,-18000,,
com.microsoft.Powerpoint,1,1746136542,1746136543,1746136543.209384,-18000,,
com.google.Chrome,7,1746136535,1746136542,1746136542.2556272,-18000,,
com.microsoft.Powerpoint,3,1746136532,1746136535,1746136535.099529,-18000,,
com.google.Chrome,1,1746136531,1746136532,1746136532.851698,-18000,,
com.microsoft.Powerpoint,1,1746136530,1746136531,1746136532.028368,-18000,,
com.google.Chrome,30,1746136500,1746136530,1746136530.459487,-18000,,
com.microsoft.Powerpoint,32,1746136468,1746136500,1746136500.862684,-18000,,
com.google.Chrome,116,1746136352,1746136468,1746136468.6255178,-18000,,
com.microsoft.Powerpoint,38,1746136314,1746136352,1746136352.296169,-18000,,
com.google.Chrome,9,1746136305,1746136314,1746136314.0886111,-18000,,
com.microsoft.Powerpoint,47,1746136258,1746136305,1746136305.930167,-18000,,
com.apple.findmy,67,1746136080,1746136147,1746136147.333056,-18000,EB445137-D7F5-57EC-87DA-1DB460D64046,"iPhone13,2"
com.google.Chrome,223,1746136035,1746136258,1746136258.365011,-18000,,
com.microsoft.Powerpoint,91,1746135944,1746136035,1746136035.2577338,-18000,,
com.google.Chrome,3,1746135941,1746135944,1746135944.747711,-18000,,
com.microsoft.Powerpoint,4,1746135937,1746135941,1746135941.670501,-18000,,
com.google.Chrome,2,1746135935,1746135937,1746135937.554109,-18000,,
com.microsoft.Powerpoint,2,1746135933,1746135935,1746135935.59029,-18000,,
com.google.Chrome,1,1746135932,1746135933,1746135933.813665,-18000,,
com.microsoft.Powerpoint,12,1746135920,1746135932,1746135932.322116,-18000,,
com.google.Chrome,38,1746135882,1746135920,1746135920.877355,-18000,,
com.microsoft.Powerpoint,2,1746135880,1746135882,1746135882.1006641,-18000,,
com.google.Chrome,12,1746135868,1746135880,1746135880.1583009,-18000,,
com.microsoft.Powerpoint,2,1746135866,1746135868,1746135868.993686,-18000,,
com.google.Chrome,57,1746135809,1746135866,1746135867.0012488,-18000,,
com.microsoft.Powerpoint,96,1746135713,1746135809,1746135809.8154411,-18000,,
com.google.Chrome,6,1746135707,1746135713,1746135713.654892,-18000,,
com.microsoft.Powerpoint,1,1746135706,1746135707,1746135707.1905599,-18000,,
com.google.Chrome,6,1746135700,1746135706,1746135706.277762,-18000,,
com.microsoft.Powerpoint,2,1746135698,1746135700,1746135700.843989,-18000,,
com.google.Chrome,21,1746135677,1746135698,1746135698.1669989,-18000,,
com.microsoft.Powerpoint,1,1746135676,1746135677,1746135677.800241,-18000,,
com.google.Chrome,44,1746135632,1746135676,1746135676.3362,-18000,,
com.microsoft.Powerpoint,41,1746135591,1746135632,1746135632.793333,-18000,,
com.apple.finder,6,1746135585,1746135591,1746135591.1181479,-18000,,
com.microsoft.Powerpoint,41,1746135544,1746135585,1746135585.407171,-18000,,
com.google.Chrome,260,1746135284,1746135544,1746135544.517077,-18000,,
com.microsoft.Powerpoint,709,1746134575,1746135284,1746135284.7540421,-18000,,
com.google.Chrome,29,1746134546,1746134575,1746134575.126462,-18000,,
com.microsoft.Powerpoint,165,1746134381,1746134546,1746134546.4611049,-18000,,
com.google.Chrome,18,1746134363,1746134381,1746134381.824294,-18000,,
com.microsoft.Powerpoint,75,1746134288,1746134363,1746134363.227748,-18000,,
com.google.Chrome,15,1746134273,1746134288,1746134288.41201,-18000,,
com.leomehlig.today,119,1746134154,1746134273,1746134273.496419,-18000,,
com.google.Chrome,5,1746134149,1746134154,1746134154.146819,-18000,,
com.toyopagroup.picaboo,21,1746132583,1746132604,1746132605.03938,-18000,EB445137-D7F5-57EC-87DA-1DB460D64046,"iPhone13,2"
com.apple.mobiletimer,1,1746132582,1746132583,1746132583.121014,-18000,EB445137-D7F5-57EC-87DA-1DB460D64046,"iPhone13,2"
com.google.Chrome,126,1746132272,1746132398,1746132398.8976321,-18000,,
com.apple.mobiletimer,869,1746131240,1746132109,1746132110.186596,-18000,EB445137-D7F5-57EC-87DA-1DB460D64046,"iPhone13,2"
com.apple.mobiletimer,96,1746131022,1746131118,1746131118.6622949,-18000,EB445137-D7F5-57EC-87DA-1DB460D64046,"iPhone13,2"
com.google.Chrome,300,1746130685,1746130985,1746130985.584521,-18000,,
com.microsoft.Powerpoint,49,1746130636,1746130685,1746130685.651406,-18000,,
com.google.Chrome,225,1746130411,1746130636,1746130636.47739,-18000,,
com.google.Chrome,315,1746129758,1746130073,1746130073.434082,-18000,,
com.apple.mobiletimer,795,1746129274,1746130069,1746130069.758163,-18000,EB445137-D7F5-57EC-87DA-1DB460D64046,"iPhone13,2"
com.google.Chrome,438,1746129042,1746129480,1746129480.82192,-18000,,
com.apple.mobiletimer,62,1746128943,1746129005,1746129005.305408,-18000,EB445137-D7F5-57EC-87DA-1DB460D64046,"iPhone13,2"
com.apple.mobiletimer,448,1746127603,1746128051,1746128051.781004,-18000,EB445137-D7F5-57EC-87DA-1DB460D64046,"iPhone13,2"
com.apple.mobiletimer,60,1746127516,1746127576,1746127576.690557,-18000,EB445137-D7F5-57EC-87DA-1DB460D64046,"iPhone13,2"
com.google.Chrome,300,1746126413,1746126713,1746126713.205021,-18000,,
com.microsoft.Office.Outlook,5,1746126177,1746126182,1746126183.213161,-18000,EB445137-D7F5-57EC-87DA-1DB460D64046,"iPhone13,2"
com.intsig.CamScannerLite,2,1746126175,1746126177,1746126177.1544452,-18000,EB445137-D7F5-57EC-87DA-1DB460D64046,"iPhone13,2"
com.google.Chrome,325,1746126086,1746126411,1746126411.76679,-18000,,
com.microsoft.Powerpoint,12,1746126074,1746126086,1746126086.169167,-18000,,
com.google.Chrome,1,1746126073,1746126074,1746126074.34958,-18000,,
com.microsoft.Powerpoint,4,1746126069,1746126073,1746126073.0826669,-18000,,
com.google.Chrome,58,1746126011,1746126069,1746126069.852878,-18000,,
com.apple.Passwords,7,1746126004,1746126011,1746126011.534778,-18000,,
com.google.Chrome,10,1746125994,1746126004,1746126004.342311,-18000,,
com.microsoft.Powerpoint,1,1746125993,1746125994,1746125994.821727,-18000,,
com.microsoft.Powerpoint,77,1746125401,1746125478,1746125478.310857,-18000,,
com.apple.finder,23,1746125378,1746125401,1746125401.41146,-18000,,
com.intsig.CamScannerLite,109,1746125290,1746125399,1746125399.589143,-18000,EB445137-D7F5-57EC-87DA-1DB460D64046,"iPhone13,2"
com.apple.calculator,7,1746125283,1746125290,1746125290.13456,-18000,EB445137-D7F5-57EC-87DA-1DB460D64046,"iPhone13,2"
com.microsoft.Powerpoint,592,1746124786,1746125378,1746125378.5364308,-18000,,
com.apple.calculator,84,1746124744,1746124828,1746124829.1708841,-18000,EB445137-D7F5-57EC-87DA-1DB460D64046,"iPhone13,2"
com.apple.calculator,109,1746124572,1746124681,1746124681.6455898,-18000,EB445137-D7F5-57EC-87DA-1DB460D64046,"iPhone13,2"
com.apple.calculator,63,1746124290,1746124353,1746124353.5158858,-18000,EB445137-D7F5-57EC-87DA-1DB460D64046,"iPhone13,2"
com.apple.calculator,77,1746124205,1746124282,1746124282.181261,-18000,EB445137-D7F5-57EC-87DA-1DB460D64046,"iPhone13,2"
com.microsoft.Powerpoint,7,1746124110,1746124117,1746124118.2721539,-18000,,
com.google.Chrome,3,1746124107,1746124110,1746124110.1158009,-18000,,
com.apple.calculator,112,1746123959,1746124071,1746124071.5170078,-18000,EB445137-D7F5-57EC-87DA-1DB460D64046,"iPhone13,2"
com.apple.calculator,91,1746123821,1746123912,1746123912.858582,-18000,EB445137-D7F5-57EC-87DA-1DB460D64046,"iPhone13,2"
com.apple.calculator,98,1746123672,1746123770,1746123770.19879,-18000,EB445137-D7F5-57EC-87DA-1DB460D64046,"iPhone13,2"
com.apple.calculator,65,1746123472,1746123537,1746123537.4535031,-18000,EB445137-D7F5-57EC-87DA-1DB460D64046,"iPhone13,2"
com.apple.calculator,64,1746123381,1746123445,1746123445.8681579,-18000,EB445137-D7F5-57EC-87DA-1DB460D64046,"iPhone13,2"
com.apple.calculator,42,1746123024,1746123066,1746123066.809362,-18000,EB445137-D7F5-57EC-87DA-1DB460D64046,"iPhone13,2"
com.apple.Music,15,1746122403,1746122418,1746122419.059053,-18000,EB445137-D7F5-57EC-87DA-1DB460D64046,"iPhone13,2"
com.apple.Music,17,1746121514,1746121531,1746121532.348314,-18000,EB445137-D7F5-57EC-87DA-1DB460D64046,"iPhone13,2"
com.intsig.CamScannerLite,3,1746121511,1746121514,1746121514.1285992,-18000,EB445137-D7F5-57EC-87DA-1DB460D64046,"iPhone13,2"
com.google.Chrome,54,1746121046,1746121100,1746121100.626883,-18000,,
com.leomehlig.today,11,1746121035,1746121046,1746121046.078504,-18000,,
com.microsoft.Powerpoint,393,1746120642,1746121035,1746121035.20385,-18000,,
com.apple.finder,7,1746120635,1746120642,1746120642.344915,-18000,,
com.intsig.CamScannerLite,313,1746120379,1746120692,1746120692.552901,-18000,EB445137-D7F5-57EC-87DA-1DB460D64046,"iPhone13,2"
com.microsoft.Powerpoint,496,1746120132,1746120628,1746120628.158823,-18000,,
com.google.Chrome,7,1746120125,1746120132,1746120132.316313,-18000,,
com.microsoft.Powerpoint,8,1746120117,1746120125,1746120125.6739058,-18000,,
com.google.Chrome,23,1746120094,1746120117,1746120117.9866881,-18000,,
com.microsoft.Powerpoint,8,1746120086,1746120094,1746120094.2674909,-18000,,
com.google.Chrome,53,1746120033,1746120086,1746120087.0084019,-18000,,
com.microsoft.Powerpoint,15,1746120018,1746120033,1746120033.582484,-18000,,
com.google.Chrome,112,1746119906,1746120018,1746120018.230105,-18000,,
com.microsoft.Powerpoint,34,1746119872,1746119906,1746119906.701505,-18000,,
com.google.Chrome,4,1746119868,1746119872,1746119872.3755631,-18000,,
com.apple.Notes,20,1746119848,1746119868,1746119868.972031,-18000,,
com.google.Chrome,198,1746119650,1746119848,1746119848.665206,-18000,,
com.microsoft.Powerpoint,821,1746118811,1746119632,1746119632.412456,-18000,,
com.apple.finder,127,1746118684,1746118811,1746118811.392692,-18000,,
com.google.Chrome,78,1746118606,1746118684,1746118684.9294748,-18000,,
com.microsoft.Powerpoint,219,1746118387,1746118606,1746118606.130917,-18000,,
com.apple.finder,2,1746118385,1746118387,1746118387.800538,-18000,,
com.microsoft.Powerpoint,0,1746118385,1746118385,1746118385.6244922,-18000,,
com.apple.finder,8,1746118377,1746118385,1746118385.3234282,-18000,,
com.google.Chrome,1,1746118376,1746118377,1746118378.110464,-18000,,
com.microsoft.Powerpoint,249,1746118127,1746118376,1746118376.7969341,-18000,,
com.google.Chrome,35,1746118092,1746118127,1746118127.925572,-18000,,
com.microsoft.Powerpoint,2,1746118090,1746118092,1746118092.293745,-18000,,
com.google.Chrome,42,1746118048,1746118090,1746118090.676241,-18000,,
com.microsoft.Powerpoint,68,1746117980,1746118048,1746118048.669135,-18000,,
com.apple.finder,14,1746117966,1746117980,1746117980.82787,-18000,,
com.microsoft.Powerpoint,19,1746117947,1746117966,1746117966.220934,-18000,,
com.google.Chrome,2,1746117945,1746117947,1746117947.2741299,-18000,,
com.leomehlig.today,57,1746117888,1746117945,1746117945.416613,-18000,,
com.google.Chrome,305,1746117583,1746117888,1746117889.1871328,-18000,,
com.google.Chrome,311,1746117272,1746117583,1746117583.544063,-18000,,
com.leomehlig.today,2,1746117270,1746117272,1746117272.677188,-18000,,
com.leomehlig.today,6,1746117191,1746117197,1746117197.439855,-18000,,
com.apple.news,497,1746116614,1746117111,1746117111.830714,-18000,EB445137-D7F5-57EC-87DA-1DB460D64046,"iPhone13,2"
com.apple.findmy,2,1746116607,1746116609,1746116609.624206,-18000,EB445137-D7F5-57EC-87DA-1DB460D64046,"iPhone13,2"
com.apple.findmy,11,1746116270,1746116281,1746116282.04358,-18000,EB445137-D7F5-57EC-87DA-1DB460D64046,"iPhone13,2"
com.strava.stravaride,224,1746116035,1746116259,1746116259.2958322,-18000,EB445137-D7F5-57EC-87DA-1DB460D64046,"iPhone13,2"
com.apple.news,300,1746115733,1746116033,1746116033.3429031,-18000,EB445137-D7F5-57EC-87DA-1DB460D64046,"iPhone13,2"
com.microsoft.Office.Outlook,2,1746115717,1746115719,1746115719.457337,-18000,EB445137-D7F5-57EC-87DA-1DB460D64046,"iPhone13,2"
com.microsoft.Office.Outlook,24,1746115526,1746115550,1746115551.0002232,-18000,EB445137-D7F5-57EC-87DA-1DB460D64046,"iPhone13,2"
com.renpho.health,1,1746115525,1746115526,1746115526.29814,-18000,EB445137-D7F5-57EC-87DA-1DB460D64046,"iPhone13,2"
com.renpho.health,23,1746114703,1746114726,1746114726.78214,-18000,EB445137-D7F5-57EC-87DA-1DB460D64046,"iPhone13,2"
com.apple.weather,6,1746111428,1746111434,1746111435.836255,-18000,EB445137-D7F5-57EC-87DA-1DB460D64046,"iPhone13,2"
com.apple.weather,5,1746110778,1746110783,1746110783.5777369,-18000,EB445137-D7F5-57EC-87DA-1DB460D64046,"iPhone13,2"
com.apple.Music,18,1746110759,1746110777,1746110778.024078,-18000,EB445137-D7F5-57EC-87DA-1DB460D64046,"iPhone13,2"
com.apple.weather,2,1746110757,1746110759,1746110759.793673,-18000,EB445137-D7F5-57EC-87DA-1DB460D64046,"iPhone13,2"
com.leomehlig.today,34,1746110531,1746110565,1746110565.5238829,-18000,,
com.google.Chrome,2,1746110529,1746110531,1746110531.102627,-18000,,
com.google.Chrome,333,1746109946,1746110279,1746110279.330775,-18000,,
com.microsoft.Powerpoint,179,1746109767,1746109946,1746109946.328072,-18000,,
com.google.Chrome,120,1746109647,1746109767,1746109767.092647,-18000,,
com.microsoft.Powerpoint,5,1746109642,1746109647,1746109647.547487,-18000,,
com.google.Chrome,166,1746109476,1746109642,1746109642.427922,-18000,,
com.microsoft.Powerpoint,108,1746109368,1746109476,1746109476.444439,-18000,,
com.apple.Notes,5,1746109363,1746109368,1746109368.243072,-18000,,
com.apple.Notes,300,1746108897,1746109197,1746109197.1106172,-18000,,
com.microsoft.Powerpoint,3,1746108894,1746108897,1746108897.2537751,-18000,,
com.microsoft.Powerpoint,430,1746108336,1746108766,1746108766.038888,-18000,,
com.microsoft.Powerpoint,591,1746106582,1746107173,1746107173.519691,-18000,,
com.microsoft.Powerpoint,301,1746105906,1746106207,1746106207.135731,-18000,,
com.microsoft.Powerpoint,321,1746105338,1746105659,1746105659.884382,-18000,,
com.google.Chrome,3,1746105335,1746105338,1746105338.707277,-18000,,
com.apple.finder,8,1746105327,1746105335,1746105338.3133879,-18000,,
com.apple.weather,11,1746104429,1746104440,1746104440.2635179,-18000,EB445137-D7F5-57EC-87DA-1DB460D64046,"iPhone13,2"
com.apple.news,307,1746103374,1746103681,1746103681.472338,-18000,EB445137-D7F5-57EC-87DA-1DB460D64046,"iPhone13,2"
com.apple.mobiletimer,8,1746100573,1746100581,1746100581.96139,-18000,EB445137-D7F5-57EC-87DA-1DB460D64046,"iPhone13,2"
com.apple.weather,2,1746100569,1746100571,1746100572.130892,-18000,EB445137-D7F5-57EC-87DA-1DB460D64046,"iPhone13,2"
com.apple.weather,4,1746071749,1746071753,1746071753.513345,-18000,EB445137-D7F5-57EC-87DA-1DB460D64046,"iPhone13,2"
com.apple.CoreAuthUI,3,1746069880,1746069883,1746069883.894782,-18000,EB445137-D7F5-57EC-87DA-1DB460D64046,"iPhone13,2"
com.apple.journal,4,1746069879,1746069883,1746069883.747556,-18000,EB445137-D7F5-57EC-87DA-1DB460D64046,"iPhone13,2"
com.apple.Health,38,1746069814,1746069852,1746069852.589133,-18000,EB445137-D7F5-57EC-87DA-1DB460D64046,"iPhone13,2"
com.instructure.icanvas,32,1746069777,1746069809,1746069809.2428,-18000,EB445137-D7F5-57EC-87DA-1DB460D64046,"iPhone13,2"
com.apple.weather,1,1746069776,1746069777,1746069777.648948,-18000,EB445137-D7F5-57EC-87DA-1DB460D64046,"iPhone13,2"
com.apple.finder,38,1746069647,1746069685,1746069685.907387,-18000,,
com.apple.shortcuts,1,1746069646,1746069647,1746069647.608386,-18000,,
com.google.Chrome,307,1746069339,1746069646,1746069646.740828,-18000,,
com.apple.finder,1,1746069012,1746069013,1746069013.54664,-18000,,
com.microsoft.VSCode,313,1746068699,1746069012,1746069012.360179,-18000,,
com.apple.shortcuts,1,1746068698,1746068699,1746068699.975953,-18000,,
com.microsoft.VSCode,13,1746068646,1746068659,1746068659.279311,-18000,,
com.leomehlig.today,154,1746068492,1746068646,1746068646.217924,-18000,,
com.microsoft.VSCode,678,1746067814,1746068492,1746068492.60766,-18000,,
com.apple.shortcuts,3,1746067811,1746067814,1746067814.636471,-18000,,
com.microsoft.VSCode,12,1746067757,1746067769,1746067770.477797,-18000,,
com.apple.finder,2,1746067755,1746067757,1746067757.3704891,-18000,,
com.leomehlig.today,54,1746067701,1746067755,1746067755.9143171,-18000,,
com.google.Chrome,5,1746067696,1746067701,1746067701.8284302,-18000,,
com.apple.iCal,72,1746067624,1746067696,1746067696.890456,-18000,,
com.google.Chrome,2,1746067622,1746067624,1746067624.307468,-18000,,
com.apple.iCal,0,1746067622,1746067622,1746067622.655451,-18000,,
com.google.Chrome,2,1746067620,1746067622,1746067622.123465,-18000,,
com.apple.iCal,5,1746067615,1746067620,1746067620.803959,-18000,,
com.google.Chrome,4,1746067611,1746067615,1746067615.705807,-18000,,
com.apple.iCal,39,1746067572,1746067611,1746067611.90842,-18000,,
com.google.Chrome,12,1746067560,1746067572,1746067572.749701,-18000,,
com.apple.weather,11,1746067542,1746067553,1746067554.3400211,-18000,EB445137-D7F5-57EC-87DA-1DB460D64046,"iPhone13,2"
com.google.Chrome,552,1746066035,1746066587,1746066587.868288,-18000,,
com.thestorygraph.thestorygraph,121,1746064993,1746065114,1746065114.420292,-18000,EB445137-D7F5-57EC-87DA-1DB460D64046,"iPhone13,2"
com.instructure.icanvas,27,1746064942,1746064969,1746064969.666784,-18000,EB445137-D7F5-57EC-87DA-1DB460D64046,"iPhone13,2"
com.apple.MobileSMS,0,1746064942,1746064942,1746064942.696093,-18000,EB445137-D7F5-57EC-87DA-1DB460D64046,"iPhone13,2"
com.google.Chrome,73,1746064900,1746064973,1746064973.061932,-18000,,
com.apple.iCal,24,1746064876,1746064900,1746064900.363862,-18000,,
com.google.Chrome,13,1746064863,1746064876,1746064876.796763,-18000,,
com.apple.iCal,21,1746064842,1746064863,1746064863.852055,-18000,,
com.google.Chrome,2,1746064840,1746064842,1746064842.8035321,-18000,,
com.apple.iCal,1,1746064839,1746064840,1746064840.5104709,-18000,,
com.google.Chrome,5,1746064834,1746064839,1746064839.2474132,-18000,,
com.apple.iCal,3,1746064831,1746064834,1746064834.563647,-18000,,
com.google.Chrome,620,1746064211,1746064831,1746064831.3390121,-18000,,
com.apple.iCal,10,1746064201,1746064211,1746064212.0242848,-18000,,
com.google.Chrome,6,1746064195,1746064201,1746064201.7035089,-18000,,
com.apple.iCal,5,1746064190,1746064195,1746064195.484727,-18000,,
com.google.Chrome,13,1746064177,1746064190,1746064190.9984698,-18000,,
com.apple.iCal,8,1746064169,1746064177,1746064177.8699841,-18000,,
com.google.Chrome,1,1746064168,1746064169,1746064169.442529,-18000,,
com.apple.iCal,4,1746064164,1746064168,1746064168.222999,-18000,,
com.google.Chrome,8,1746064156,1746064164,1746064164.962353,-18000,,
com.apple.iCal,1,1746064155,1746064156,1746064157.0205998,-18000,,
com.google.Chrome,3,1746064152,1746064155,1746064155.386229,-18000,,
com.apple.iCal,3,1746064149,1746064152,1746064152.245216,-18000,,
com.google.Chrome,2,1746064147,1746064149,1746064149.929708,-18000,,
com.apple.iCal,11,1746064136,1746064147,1746064147.563508,-18000,,
com.google.Chrome,102,1746064034,1746064136,1746064136.239126,-18000,,
com.apple.MobileSMS,41,1746063976,1746064017,1746064017.803345,-18000,EB445137-D7F5-57EC-87DA-1DB460D64046,"iPhone13,2"
com.apple.iCal,22,1746063944,1746063966,1746063966.762253,-18000,,
com.apple.MobileSMS,62,1746063902,1746063964,1746063965.032326,-18000,EB445137-D7F5-57EC-87DA-1DB460D64046,"iPhone13,2"
com.apple.MobileSMS,82,1746063820,1746063902,1746063902.5523272,-18000,EB445137-D7F5-57EC-87DA-1DB460D64046,"iPhone13,2"
com.google.Chrome,144,1746063800,1746063944,1746063944.902341,-18000,,
com.apple.iCal,18,1746063768,1746063786,1746063786.870727,-18000,,
com.google.Chrome,2,1746063766,1746063768,1746063768.442913,-18000,,
com.apple.MobileSMS,126,1746063638,1746063764,1746063764.22823,-18000,EB445137-D7F5-57EC-87DA-1DB460D64046,"iPhone13,2"
com.apple.finder,132,1746063634,1746063766,1746063766.497164,-18000,,
com.leomehlig.today,3,1746063631,1746063634,1746063634.63734,-18000,,
com.google.Chrome,13,1746063618,1746063631,1746063631.046564,-18000,,
com.leomehlig.today,29,1746063589,1746063618,1746063618.113398,-18000,,
com.google.Chrome,88,1746063501,1746063589,1746063589.672982,-18000,,
com.apple.MobileSMS,598,1746062967,1746063565,1746063566.0069451,-18000,EB445137-D7F5-57EC-87DA-1DB460D64046,"iPhone13,2"
com.apple.MobileSMS,26,1746062936,1746062962,1746062963.065576,-18000,EB445137-D7F5-57EC-87DA-1DB460D64046,"iPhone13,2"
com.apple.MobileSMS,49,1746062885,1746062934,1746062934.886005,-18000,EB445137-D7F5-57EC-87DA-1DB460D64046,"iPhone13,2"
com.ryansponzilli.DeepSkyCatalog,78,1746062807,1746062885,1746062885.66827,-18000,EB445137-D7F5-57EC-87DA-1DB460D64046,"iPhone13,2"
com.apple.MobileSMS,2,1746062804,1746062806,1746062806.4667392,-18000,EB445137-D7F5-57EC-87DA-1DB460D64046,"iPhone13,2"
com.apple.MobileSMS,150,1746062645,1746062795,1746062795.7819319,-18000,EB445137-D7F5-57EC-87DA-1DB460D64046,"iPhone13,2"
com.apple.MobileSMS,20,1746062603,1746062623,1746062623.3296971,-18000,EB445137-D7F5-57EC-87DA-1DB460D64046,"iPhone13,2"
com.apple.CoreAuthUI,2,1746062542,1746062544,1746062544.5324469,-18000,EB445137-D7F5-57EC-87DA-1DB460D64046,"iPhone13,2"
com.apple.AppStore,70,1746062529,1746062599,1746062599.6050858,-18000,EB445137-D7F5-57EC-87DA-1DB460D64046,"iPhone13,2"
com.apple.MobileSMS,24,1746062440,1746062464,1746062464.1776319,-18000,EB445137-D7F5-57EC-87DA-1DB460D64046,"iPhone13,2"
com.google.Gmail,21,1746062419,1746062440,1746062440.232091,-18000,EB445137-D7F5-57EC-87DA-1DB460D64046,"iPhone13,2"
com.apple.MobileSMS,0,1746062419,1746062419,1746062419.574662,-18000,EB445137-D7F5-57EC-87DA-1DB460D64046,"iPhone13,2"
com.apple.MobileSMS,51,1746062363,1746062414,1746062414.588882,-18000,EB445137-D7F5-57EC-87DA-1DB460D64046,"iPhone13,2"
com.apple.AppStore,5,1746062358,1746062363,1746062364.085723,-18000,EB445137-D7F5-57EC-87DA-1DB460D64046,"iPhone13,2"
com.apple.MobileSMS,30,1746062328,1746062358,1746062358.666535,-18000,EB445137-D7F5-57EC-87DA-1DB460D64046,"iPhone13,2"
com.apple.AppStore,13,1746062315,1746062328,1746062328.552123,-18000,EB445137-D7F5-57EC-87DA-1DB460D64046,"iPhone13,2"
com.apple.MobileSMS,11,1746062304,1746062315,1746062315.348806,-18000,EB445137-D7F5-57EC-87DA-1DB460D64046,"iPhone13,2"
com.google.Chrome,1188,1746062186,1746063374,1746063374.732469,-18000,,
com.apple.MobileSMS,147,1746062139,1746062286,1746062286.6183782,-18000,EB445137-D7F5-57EC-87DA-1DB460D64046,"iPhone13,2"
com.apple.AppStore,17,1746062122,1746062139,1746062139.774869,-18000,EB445137-D7F5-57EC-87DA-1DB460D64046,"iPhone13,2"
com.apple.MobileSMS,13,1746062109,1746062122,1746062122.660511,-18000,EB445137-D7F5-57EC-87DA-1DB460D64046,"iPhone13,2"
com.apple.AppStore,21,1746062088,1746062109,1746062109.422889,-18000,EB445137-D7F5-57EC-87DA-1DB460D64046,"iPhone13,2"
com.microsoft.Office.Outlook,16,1746061864,1746061880,1746061880.875914,-18000,EB445137-D7F5-57EC-87DA-1DB460D64046,"iPhone13,2"
com.instructure.icanvas,28,1746061833,1746061861,1746061861.067699,-18000,EB445137-D7F5-57EC-87DA-1DB460D64046,"iPhone13,2"
com.leomehlig.today,9,1746061774,1746061783,1746061783.208158,-18000,,
com.google.Chrome,381,1746061393,1746061774,1746061774.558042,-18000,,
com.leomehlig.today,101,1746061292,1746061393,1746061393.6913419,-18000,,
com.google.Chrome,1182,1746060110,1746061292,1746061292.297147,-18000,,
com.hammerandchisel.discord,3,1746057694,1746057697,1746057697.5411139,-18000,EB445137-D7F5-57EC-87DA-1DB460D64046,"iPhone13,2"
com.hammerandchisel.discord,12,1746057676,1746057688,1746057688.2931008,-18000,EB445137-D7F5-57EC-87DA-1DB460D64046,"iPhone13,2"
com.apple.news,340,1746057332,1746057672,1746057672.935886,-18000,EB445137-D7F5-57EC-87DA-1DB460D64046,"iPhone13,2"
com.google.Chrome,349,1746057274,1746057623,1746057623.626744,-18000,,
com.apple.finder,1,1746057257,1746057258,1746057258.927856,-18000,,
com.leomehlig.today,145,1746057112,1746057257,1746057257.960853,-18000,,
com.apple.MobileSMS,20,1746057090,1746057110,1746057110.817628,-18000,EB445137-D7F5-57EC-87DA-1DB460D64046,"iPhone13,2"
com.apple.finder,31,1746057081,1746057112,1746057112.084656,-18000,,
com.apple.MobileSMS,5,1746056041,1746056046,1746056046.1154141,-18000,EB445137-D7F5-57EC-87DA-1DB460D64046,"iPhone13,2"
com.instructure.icanvas,0,1746056041,1746056041,1746056041.935245,-18000,EB445137-D7F5-57EC-87DA-1DB460D64046,"iPhone13,2"
com.apple.finder,5,1746055504,1746055509,1746055509.435988,-18000,,
com.microsoft.VSCode,1,1746055503,1746055504,1746055505.05826,-18000,,
com.apple.finder,1,1746055502,1746055503,1746055503.73435,-18000,,
com.microsoft.Powerpoint,1,1746055501,1746055502,1746055502.68221,-18000,,
com.google.Chrome,14,1746055487,1746055501,1746055501.052676,-18000,,
com.leomehlig.today,147,1746055340,1746055487,1746055487.594057,-18000,,
com.google.Chrome,5,1746055335,1746055340,1746055340.949007,-18000,,
com.apple.finder,8,1746055327,1746055335,1746055335.3078241,-18000,,
com.google.Chrome,1011,1746054316,1746055327,1746055327.7693129,-18000,,
com.instructure.icanvas,67,1746054182,1746054249,1746054249.81937,-18000,EB445137-D7F5-57EC-87DA-1DB460D64046,"iPhone13,2"
com.leomehlig.today,150,1746054152,1746054302,1746054304.07422,-18000,,
com.apple.finder,2,1746054150,1746054152,1746054152.807046,-18000,,
com.apple.Notes,5,1746054145,1746054150,1746054150.79109,-18000,,
com.google.Chrome,6,1746054139,1746054145,1746054145.6174998,-18000,,
com.apple.finder,17,1746054122,1746054139,1746054139.778393,-18000,,
com.microsoft.Powerpoint,8,1746054114,1746054122,1746054122.998777,-18000,,
com.apple.finder,6,1746054108,1746054114,1746054114.3497128,-18000,,
com.microsoft.Powerpoint,256,1746053852,1746054108,1746054108.948882,-18000,,
com.google.Chrome,114,1746053738,1746053852,1746053852.40696,-18000,,
com.microsoft.Powerpoint,1,1746053737,1746053738,1746053738.743307,-18000,,
com.google.Chrome,53,1746053684,1746053737,1746053737.3174539,-18000,,
com.microsoft.Powerpoint,76,1746053608,1746053684,1746053684.948724,-18000,,
com.google.Chrome,1,1746053607,1746053608,1746053608.957488,-18000,,
com.apple.Notes,52,1746053555,1746053607,1746053607.256844,-18000,,
com.google.Chrome,25,1746053530,1746053555,1746053555.442236,-18000,,
com.apple.Notes,6,1746053524,1746053530,1746053530.739701,-18000,,
com.google.Chrome,1,1746053523,1746053524,1746053524.379233,-18000,,
com.leomehlig.today,3,1746053520,1746053523,1746053523.0646272,-18000,,
com.microsoft.Powerpoint,21,1746053499,1746053520,1746053520.90223,-18000,,
com.leomehlig.today,0,1746053499,1746053499,1746053499.795779,-18000,,
com.apple.Notes,2,1746053497,1746053499,1746053499.090153,-18000,,
com.google.Chrome,34,1746053463,1746053497,1746053497.474712,-18000,,
com.apple.Notes,13,1746053450,1746053463,1746053463.533925,-18000,,
com.google.Chrome,6,1746053444,1746053450,1746053450.832255,-18000,,
com.apple.Notes,76,1746053368,1746053444,1746053445.0394301,-18000,,
com.leomehlig.today,5,1746053363,1746053368,1746053368.255937,-18000,,
com.apple.Notes,90,1746053273,1746053363,1746053364.0192451,-18000,,
com.google.Chrome,12,1746053261,1746053273,1746053273.463756,-18000,,
com.microsoft.Powerpoint,7,1746053254,1746053261,1746053261.069768,-18000,,
com.microsoft.Powerpoint,706,1746052465,1746053171,1746053171.39271,-18000,,
com.google.Chrome,9,1746052456,1746052465,1746052465.108244,-18000,,
com.microsoft.Powerpoint,62,1746052394,1746052456,1746052456.406313,-18000,,
com.google.Chrome,1,1746052393,1746052394,1746052394.863575,-18000,,
com.microsoft.Powerpoint,3,1746052390,1746052393,1746052393.772182,-18000,,
com.google.Chrome,2,1746052388,1746052390,1746052390.34766,-18000,,
com.microsoft.Powerpoint,7,1746052381,1746052388,1746052388.434176,-18000,,
com.google.Chrome,5,1746052376,1746052381,1746052381.46685,-18000,,
com.microsoft.Powerpoint,74,1746052302,1746052376,1746052376.092135,-18000,,
com.google.Chrome,1,1746052301,1746052302,1746052302.986814,-18000,,
com.apple.Notes,1,1746052300,1746052301,1746052301.846978,-18000,,
com.google.Chrome,20,1746052280,1746052300,1746052300.247582,-18000,,
com.apple.Notes,4,1746052276,1746052280,1746052280.881201,-18000,,
com.microsoft.Powerpoint,72,1746052204,1746052276,1746052276.789686,-18000,,
com.apple.Notes,5,1746052199,1746052204,1746052204.5524101,-18000,,
com.google.Chrome,10,1746052189,1746052199,1746052199.830925,-18000,,
com.microsoft.Powerpoint,115,1746052074,1746052189,1746052189.614249,-18000,,
com.apple.Notes,2,1746052072,1746052074,1746052074.834632,-18000,,
com.microsoft.Powerpoint,2,1746052070,1746052072,1746052072.205615,-18000,,
com.apple.Notes,10,1746052060,1746052070,1746052070.463081,-18000,,
com.microsoft.Powerpoint,118,1746051942,1746052060,1746052060.652343,-18000,,
com.apple.Notes,11,1746051931,1746051942,1746051942.149919,-18000,,
com.microsoft.Powerpoint,32,1746051899,1746051931,1746051931.4484348,-18000,,
com.apple.Notes,71,1746051828,1746051899,1746051899.1060529,-18000,,
com.google.Chrome,3,1746051825,1746051828,1746051828.119632,-18000,,
com.microsoft.Powerpoint,24,1746051801,1746051825,1746051825.116856,-18000,,
com.google.Chrome,4,1746051797,1746051801,1746051801.44538,-18000,,
com.microsoft.Powerpoint,1,1746051796,1746051797,1746051797.333307,-18000,,
com.google.Chrome,102,1746051694,1746051796,1746051796.1958709,-18000,,
com.microsoft.Powerpoint,11,1746051683,1746051694,1746051694.324764,-18000,,
com.microsoft.Office.Outlook,2,1746051668,1746051670,1746051670.8458881,-18000,EB445137-D7F5-57EC-87DA-1DB460D64046,"iPhone13,2"
com.apple.iCal,152,1746051531,1746051683,1746051683.7039309,-18000,,
com.microsoft.Office.Outlook,147,1746051519,1746051666,1746051666.2416759,-18000,EB445137-D7F5-57EC-87DA-1DB460D64046,"iPhone13,2"
com.apple.news,0,1746051519,1746051519,1746051520.5539699,-18000,EB445137-D7F5-57EC-87DA-1DB460D64046,"iPhone13,2"
com.microsoft.Powerpoint,240,1746051291,1746051531,1746051531.187323,-18000,,
com.google.Chrome,37,1746051254,1746051291,1746051291.992285,-18000,,
com.microsoft.Powerpoint,36,1746051218,1746051254,1746051254.425596,-18000,,
com.google.Chrome,78,1746051140,1746051218,1746051218.466346,-18000,,
com.microsoft.Powerpoint,137,1746051003,1746051140,1746051140.588441,-18000,,
com.apple.Notes,87,1746050916,1746051003,1746051003.411109,-18000,,
com.microsoft.Powerpoint,193,1746050723,1746050916,1746050916.552575,-18000,,
com.apple.Notes,1,1746050722,1746050723,1746050723.612335,-18000,,
com.microsoft.Powerpoint,34,1746050688,1746050722,1746050722.546788,-18000,,
com.apple.Notes,21,1746050667,1746050688,1746050688.345899,-18000,,
com.google.Chrome,43,1746050624,1746050667,1746050667.553069,-18000,,
com.microsoft.Powerpoint,215,1746050409,1746050624,1746050624.273104,-18000,,
com.apple.Notes,79,1746050330,1746050409,1746050409.888895,-18000,,
com.microsoft.Powerpoint,28,1746050302,1746050330,1746050330.9939132,-18000,,
com.apple.Notes,71,1746050231,1746050302,1746050302.94957,-18000,,
com.microsoft.Powerpoint,2,1746050229,1746050231,1746050231.8932738,-18000,,
com.apple.Notes,21,1746050208,1746050229,1746050229.364503,-18000,,
com.microsoft.Powerpoint,784,1746049424,1746050208,1746050208.412472,-18000,,
com.apple.finder,4,1746049420,1746049424,1746049424.4905949,-18000,,
com.microsoft.Powerpoint,1,1746049419,1746049420,1746049420.49979,-18000,,
com.apple.finder,6,1746049413,1746049419,1746049419.375586,-18000,,
com.microsoft.Powerpoint,9,1746049404,1746049413,1746049413.8566298,-18000,,
com.apple.finder,19,1746049385,1746049404,1746049404.932236,-18000,,
com.microsoft.Powerpoint,20,1746049365,1746049385,1746049385.030137,-18000,,
com.apple.finder,11,1746049354,1746049365,1746049365.304616,-18000,,
com.microsoft.Powerpoint,54,1746049300,1746049354,1746049354.111689,-18000,,
com.apple.finder,3,1746049297,1746049300,1746049300.929357,-18000,,
com.microsoft.Powerpoint,37,1746049260,1746049297,1746049297.404058,-18000,,
com.apple.finder,4,1746049256,1746049260,1746049260.8843179,-18000,,
com.microsoft.Powerpoint,39,1746049217,1746049256,1746049256.437477,-18000,,
com.apple.finder,4,1746049213,1746049217,1746049217.510192,-18000,,
com.microsoft.Powerpoint,25,1746049188,1746049213,1746049213.430952,-18000,,
com.apple.finder,6,1746049182,1746049188,1746049188.860447,-18000,,
com.microsoft.Powerpoint,44,1746049138,1746049182,1746049182.7571979,-18000,,
com.apple.finder,4,1746049134,1746049138,1746049138.50159,-18000,,
com.microsoft.Powerpoint,24,1746049110,1746049134,1746049134.0338101,-18000,,
com.apple.finder,4,1746049106,1746049110,1746049110.659205,-18000,,
com.microsoft.Powerpoint,41,1746049065,1746049106,1746049106.468974,-18000,,
com.apple.finder,35,1746049030,1746049065,1746049066.004928,-18000,,
com.microsoft.Powerpoint,61,1746048969,1746049030,1746049030.029004,-18000,,
com.apple.finder,5,1746048964,1746048969,1746048969.792167,-18000,,
com.microsoft.Powerpoint,173,1746048791,1746048964,1746048964.2369819,-18000,,
com.apple.finder,16,1746048775,1746048791,1746048791.309299,-18000,,
com.microsoft.Powerpoint,44,1746048731,1746048775,1746048775.7491379,-18000,,
com.apple.finder,5,1746048726,1746048731,1746048731.2524061,-18000,,
com.microsoft.Powerpoint,53,1746048673,1746048726,1746048726.952289,-18000,,
com.apple.finder,15,1746048658,1746048673,1746048673.76599,-18000,,
com.microsoft.Powerpoint,8,1746048650,1746048658,1746048658.986001,-18000,,
com.apple.finder,1,1746048649,1746048650,1746048650.272752,-18000,,
com.microsoft.Powerpoint,63,1746048586,1746048649,1746048649.62786,-18000,,
com.apple.finder,3,1746048583,1746048586,1746048586.5085402,-18000,,
com.microsoft.Powerpoint,58,1746048525,1746048583,1746048583.068157,-18000,,
com.apple.finder,13,1746048512,1746048525,1746048525.5444689,-18000,,
com.microsoft.Powerpoint,12,1746048500,1746048512,1746048512.4128299,-18000,,
com.apple.finder,4,1746048496,1746048500,1746048501.008297,-18000,,
com.leomehlig.today,292,1746048204,1746048496,1746048496.6742802,-18000,,
com.google.Chrome,2,1746048202,1746048204,1746048204.4970489,-18000,,
com.apple.news,185,1746047677,1746047862,1746047862.593468,-18000,EB445137-D7F5-57EC-87DA-1DB460D64046,"iPhone13,2"
com.openai.chat,3,1746047623,1746047626,1746047626.0259209,-18000,EB445137-D7F5-57EC-87DA-1DB460D64046,"iPhone13,2"
com.openai.chat,63,1746047028,1746047091,1746047092.1847692,-18000,EB445137-D7F5-57EC-87DA-1DB460D64046,"iPhone13,2"
com.apple.findmy,4,1746047024,1746047028,1746047028.742058,-18000,EB445137-D7F5-57EC-87DA-1DB460D64046,"iPhone13,2"
com.google.Chrome,799,1746046827,1746047626,1746047626.242158,-18000,,
com.google.Chrome,447,1746046260,1746046707,1746046707.249298,-18000,,
com.leomehlig.today,1,1746046259,1746046260,1746046261.507694,-18000,,
com.apple.findmy,9,1746045410,1746045419,1746045419.990849,-18000,EB445137-D7F5-57EC-87DA-1DB460D64046,"iPhone13,2"
com.apple.mobilecal,2,1746045355,1746045357,1746045357.742985,-18000,EB445137-D7F5-57EC-87DA-1DB460D64046,"iPhone13,2"
com.apple.mobilecal,27,1746044995,1746045022,1746045023.00877,-18000,EB445137-D7F5-57EC-87DA-1DB460D64046,"iPhone13,2"
com.microsoft.Office.Outlook,19,1746044972,1746044991,1746044991.6993098,-18000,EB445137-D7F5-57EC-87DA-1DB460D64046,"iPhone13,2"
com.apple.weather,2,1746044970,1746044972,1746044972.824825,-18000,EB445137-D7F5-57EC-87DA-1DB460D64046,"iPhone13,2"
com.apple.news,2,1746044968,1746044970,1746044970.392885,-18000,EB445137-D7F5-57EC-87DA-1DB460D64046,"iPhone13,2"
com.apple.news,11,1746043185,1746043196,1746043196.583051,-18000,EB445137-D7F5-57EC-87DA-1DB460D64046,"iPhone13,2"
com.apple.CoreAuthUI,2,1746043172,1746043174,1746043174.323509,-18000,EB445137-D7F5-57EC-87DA-1DB460D64046,"iPhone13,2"
com.robinhood.release.Robinhood,14,1746043169,1746043183,1746043183.042547,-18000,EB445137-D7F5-57EC-87DA-1DB460D64046,"iPhone13,2"
com.tinyspeck.chatlyio,4,1746043135,1746043139,1746043139.313607,-18000,EB445137-D7F5-57EC-87DA-1DB460D64046,"iPhone13,2"
com.instructure.icanvas,4,1746042585,1746042589,1746042589.138653,-18000,EB445137-D7F5-57EC-87DA-1DB460D64046,"iPhone13,2"
com.tinyspeck.chatlyio,9,1746042573,1746042582,1746042582.542999,-18000,EB445137-D7F5-57EC-87DA-1DB460D64046,"iPhone13,2"
com.apple.news,0,1746042573,1746042573,1746042574.69737,-18000,EB445137-D7F5-57EC-87DA-1DB460D64046,"iPhone13,2"
com.apple.news,16,1746039513,1746039529,1746039529.116352,-18000,EB445137-D7F5-57EC-87DA-1DB460D64046,"iPhone13,2"
com.google.chrome.ios,2,1746039505,1746039507,1746039507.778751,-18000,EB445137-D7F5-57EC-87DA-1DB460D64046,"iPhone13,2"
com.google.chrome.ios,37,1746038907,1746038944,1746038945.60853,-18000,EB445137-D7F5-57EC-87DA-1DB460D64046,"iPhone13,2"
com.apple.news,2,1746038905,1746038907,1746038907.58562,-18000,EB445137-D7F5-57EC-87DA-1DB460D64046,"iPhone13,2"
com.apple.news,476,1746036963,1746037439,1746037440.291339,-18000,EB445137-D7F5-57EC-87DA-1DB460D64046,"iPhone13,2"
com.apple.weather,20,1746036933,1746036953,1746036953.836681,-18000,EB445137-D7F5-57EC-87DA-1DB460D64046,"iPhone13,2"
com.microsoft.Office.Outlook,38,1746036224,1746036262,1746036262.566484,-18000,EB445137-D7F5-57EC-87DA-1DB460D64046,"iPhone13,2"
com.apple.mobilecal,2,1746036133,1746036135,1746036135.402946,-18000,EB445137-D7F5-57EC-87DA-1DB460D64046,"iPhone13,2"
com.microsoft.Office.Outlook,104,1746036029,1746036133,1746036133.763519,-18000,EB445137-D7F5-57EC-87DA-1DB460D64046,"iPhone13,2"
com.apple.mobilecal,30,1746035999,1746036029,1746036029.747422,-18000,EB445137-D7F5-57EC-87DA-1DB460D64046,"iPhone13,2"
com.microsoft.Office.Outlook,14,1746035982,1746035996,1746035997.158999,-18000,EB445137-D7F5-57EC-87DA-1DB460D64046,"iPhone13,2"
com.apple.mobilecal,16,1746035964,1746035980,1746035980.244474,-18000,EB445137-D7F5-57EC-87DA-1DB460D64046,"iPhone13,2"
com.apple.weather,6,1746035953,1746035959,1746035959.793009,-18000,EB445137-D7F5-57EC-87DA-1DB460D64046,"iPhone13,2"
com.instructure.icanvas,49,1746035904,1746035953,1746035953.406992,-18000,EB445137-D7F5-57EC-87DA-1DB460D64046,"iPhone13,2"
com.apple.news,0,1746035904,1746035904,1746035905.4861732,-18000,EB445137-D7F5-57EC-87DA-1DB460D64046,"iPhone13,2"
com.leomehlig.today,121,1746035766,1746035887,1746035887.355612,-18000,,
com.google.Chrome,181,1746035585,1746035766,1746035766.085929,-18000,,
com.microsoft.VSCode,25,1746035560,1746035585,1746035585.417376,-18000,,
com.apple.finder,5,1746035555,1746035560,1746035560.857463,-18000,,
com.google.Chrome,5,1746035550,1746035555,1746035555.837758,-18000,,
com.google.Chrome,68,1746034623,1746034691,1746034691.410162,-18000,,
com.google.Chrome,483,1746034027,1746034510,1746034510.640935,-18000,,
com.apple.finder,15,1746034012,1746034027,1746034027.9138942,-18000,,
com.google.Chrome,108,1746033904,1746034012,1746034012.431534,-18000,,
com.apple.finder,599,1746033305,1746033904,1746033904.593355,-18000,,
com.apple.news,23,1746031718,1746031741,1746031742.371824,-18000,EB445137-D7F5-57EC-87DA-1DB460D64046,"iPhone13,2"
com.apple.CoreAuthUI,2,1746031709,1746031711,1746031711.568612,-18000,EB445137-D7F5-57EC-87DA-1DB460D64046,"iPhone13,2"
com.robinhood.release.Robinhood,12,1746031706,1746031718,1746031718.477968,-18000,EB445137-D7F5-57EC-87DA-1DB460D64046,"iPhone13,2"
com.apple.news,66,1746031637,1746031703,1746031703.548438,-18000,EB445137-D7F5-57EC-87DA-1DB460D64046,"iPhone13,2"
com.apple.mobilecal,9,1746028983,1746028992,1746028992.593245,-18000,EB445137-D7F5-57EC-87DA-1DB460D64046,"iPhone13,2"
com.openai.chat,120,1746028761,1746028881,1746028881.270019,-18000,EB445137-D7F5-57EC-87DA-1DB460D64046,"iPhone13,2"
com.apple.AuthenticationServicesUI,5,1746028718,1746028723,1746028723.946192,-18000,EB445137-D7F5-57EC-87DA-1DB460D64046,"iPhone13,2"
com.openai.chat,44,1746028696,1746028740,1746028740.503463,-18000,EB445137-D7F5-57EC-87DA-1DB460D64046,"iPhone13,2"
com.apple.PassbookUIService,6,1746028676,1746028682,1746028682.8882189,-18000,EB445137-D7F5-57EC-87DA-1DB460D64046,"iPhone13,2"
com.apple.AppStore,31,1746028665,1746028696,1746028696.9620662,-18000,EB445137-D7F5-57EC-87DA-1DB460D64046,"iPhone13,2"
com.microsoft.Office.Outlook,3,1746028658,1746028661,1746028664.179961,-18000,EB445137-D7F5-57EC-87DA-1DB460D64046,"iPhone13,2"
com.apple.finder,20,1746028372,1746028392,1746028392.972121,-18000,,
com.google.Chrome,181,1746028191,1746028372,1746028372.206787,-18000,,
com.apple.Notes,3,1746028188,1746028191,1746028191.739105,-18000,,
com.microsoft.Powerpoint,79,1746028109,1746028188,1746028188.1709309,-18000,,
com.apple.finder,4,1746028105,1746028109,1746028109.9763498,-18000,,
com.microsoft.Powerpoint,121,1746027984,1746028105,1746028105.1655412,-18000,,
com.apple.finder,4,1746027980,1746027984,1746027984.649547,-18000,,
com.microsoft.Powerpoint,33,1746027947,1746027980,1746027980.271951,-18000,,
com.apple.finder,3,1746027944,1746027947,1746027947.114787,-18000,,
com.microsoft.Powerpoint,12,1746027932,1746027944,1746027944.6598902,-18000,,
com.apple.finder,9,1746027923,1746027932,1746027932.4115272,-18000,,
com.microsoft.Powerpoint,61,1746027862,1746027923,1746027923.8488731,-18000,,
com.apple.finder,6,1746027856,1746027862,1746027862.033512,-18000,,
com.microsoft.Powerpoint,85,1746027771,1746027856,1746027856.858029,-18000,,
com.apple.finder,10,1746027761,1746027771,1746027771.111367,-18000,,
com.microsoft.Powerpoint,38,1746027723,1746027761,1746027762.003065,-18000,,
com.apple.finder,2,1746027721,1746027723,1746027723.8487349,-18000,,
com.apple.iCal,0,1746027721,1746027721,1746027721.753084,-18000,,
com.google.Chrome,5,1746027716,1746027721,1746027721.412287,-18000,,
com.google.Chrome,2,1746026930,1746026932,1746026932.920916,-18000,,
com.microsoft.Outlook,12,1746026918,1746026930,1746026930.6141229,-18000,,
com.google.Chrome,14,1746026904,1746026918,1746026918.667681,-18000,,
com.microsoft.Outlook,1,1746026903,1746026904,1746026904.9238381,-18000,,
com.google.Chrome,50,1746026853,1746026903,1746026903.422329,-18000,,
com.apple.iCal,10,1746026843,1746026853,1746026853.783174,-18000,,
com.google.Chrome,19,1746026824,1746026843,1746026843.419931,-18000,,
com.apple.iCal,5,1746026819,1746026824,1746026824.440191,-18000,,
com.google.Chrome,5,1746026814,1746026819,1746026819.9620051,-18000,,
com.apple.iCal,7,1746026807,1746026814,1746026815.002204,-18000,,
com.google.Chrome,3,1746026804,1746026807,1746026807.257988,-18000,,
com.apple.iCal,1,1746026803,1746026804,1746026804.12566,-18000,,
com.google.Chrome,1,1746026802,1746026803,1746026803.258347,-18000,,
com.apple.iCal,4,1746026798,1746026802,1746026802.127048,-18000,,
com.google.Chrome,5,1746026793,1746026798,1746026798.0495682,-18000,,
com.apple.iCal,2,1746026791,1746026793,1746026793.862489,-18000,,
com.google.Chrome,5,1746026786,1746026791,1746026791.968754,-18000,,
com.apple.iCal,2,1746026784,1746026786,1746026786.4298239,-18000,,
com.google.Chrome,7,1746026777,1746026784,1746026784.565587,-18000,,
com.apple.iCal,2,1746026775,1746026777,1746026777.5372329,-18000,,
com.google.Chrome,3,1746026772,1746026775,1746026775.1109838,-18000,,
com.apple.iCal,2,1746026770,1746026772,1746026773.013731,-18000,,
com.google.Chrome,1,1746026769,1746026770,1746026770.656455,-18000,,
com.apple.iCal,3,1746026766,1746026769,1746026769.184046,-18000,,
com.google.Chrome,13,1746026753,1746026766,1746026766.62774,-18000,,
com.apple.iCal,1,1746026752,1746026753,1746026753.3814979,-18000,,
com.google.Chrome,3,1746026749,1746026752,1746026752.5715141,-18000,,
com.apple.iCal,6,1746026743,1746026749,1746026749.398491,-18000,,
com.google.Chrome,8,1746026735,1746026743,1746026743.54634,-18000,,
com.apple.iCal,5,1746026730,1746026735,1746026735.2593699,-18000,,
com.google.Chrome,28,1746026702,1746026730,1746026730.379754,-18000,,
com.apple.iCal,0,1746026702,1746026702,1746026702.83818,-18000,,
com.google.Chrome,2,1746026700,1746026702,1746026702.3980079,-18000,,
com.apple.iCal,11,1746026689,1746026700,1746026700.519028,-18000,,
com.google.Chrome,11,1746026678,1746026689,1746026689.38651,-18000,,
com.apple.iCal,2,1746026676,1746026678,1746026678.4617848,-18000,,
com.google.Chrome,9,1746026667,1746026676,1746026676.301518,-18000,,
com.microsoft.Outlook,9,1746026658,1746026667,1746026667.286893,-18000,,
com.google.Chrome,4,1746026654,1746026658,1746026659.14119,-18000,,
com.apple.finder,2,1746026652,1746026654,1746026654.151551,-18000,,
com.microsoft.Office.Outlook,42,1746026609,1746026651,1746026651.5223498,-18000,EB445137-D7F5-57EC-87DA-1DB460D64046,"iPhone13,2"
com.toyopagroup.picaboo,42,1746026566,1746026608,1746026608.876494,-18000,EB445137-D7F5-57EC-87DA-1DB460D64046,"iPhone13,2"
com.apple.finder,17,1746023801,1746023818,1746023818.840759,-18000,,
com.leomehlig.today,39,1746023762,1746023801,1746023801.1574678,-18000,,
com.google.Chrome,31,1746023731,1746023762,1746023762.958767,-18000,,
com.apple.finder,296,1746023435,1746023731,1746023731.411353,-18000,,
com.apple.finder,497,1746022519,1746023016,1746023016.338485,-18000,,
com.apple.Notes,98,1746022421,1746022519,1746022519.427995,-18000,,
com.apple.finder,16,1746022405,1746022421,1746022421.6415548,-18000,,
com.apple.Notes,49,1746022356,1746022405,1746022405.954334,-18000,,
com.google.Chrome,101,1746022255,1746022356,1746022356.128453,-18000,,
com.apple.Notes,1,1746022254,1746022255,1746022256.0903502,-18000,,
com.apple.Notes,300,1746021272,1746021572,1746021572.7185001,-18000,,
com.google.Chrome,269,1746021003,1746021272,1746021272.726466,-18000,,
com.apple.Notes,281,1746020722,1746021003,1746021003.722423,-18000,,
com.apple.Notes,525,1746019873,1746020398,1746020398.6587682,-18000,,
com.apple.Notes,303,1746018831,1746019134,1746019134.045638,-18000,,
com.google.Chrome,282,1746018549,1746018831,1746018831.156427,-18000,,
com.apple.finder,199,1746018334,1746018533,1746018534.371314,-18000,,
com.google.Chrome,0,1746018334,1746018334,1746018335.042592,-18000,,
com.apple.weather,6,1746017013,1746017019,1746017019.26965,-18000,EB445137-D7F5-57EC-87DA-1DB460D64046,"iPhone13,2"
com.renpho.health,78,1746016934,1746017012,1746017012.094746,-18000,EB445137-D7F5-57EC-87DA-1DB460D64046,"iPhone13,2"
com.apple.news,1,1746016927,1746016928,1746016928.878403,-18000,EB445137-D7F5-57EC-87DA-1DB460D64046,"iPhone13,2"
com.apple.news,192,1746015909,1746016101,1746016102.007664,-18000,EB445137-D7F5-57EC-87DA-1DB460D64046,"iPhone13,2"
com.apple.CoreAuthUI,4,1745982943,1745982947,1745982947.9524431,-18000,EB445137-D7F5-57EC-87DA-1DB460D64046,"iPhone13,2"
com.apple.journal,1343,1745982942,1745984285,1745984285.351417,-18000,EB445137-D7F5-57EC-87DA-1DB460D64046,"iPhone13,2"
com.apple.Health,99,1745982837,1745982936,1745982936.402149,-18000,EB445137-D7F5-57EC-87DA-1DB460D64046,"iPhone13,2"
com.google.Chrome,486,1745982045,1745982531,1745982531.5783339,-18000,,
com.apple.finder,2,1745982043,1745982045,1745982046.4055839,-18000,,
com.apple.finder,302,1745980478,1745980780,1745980780.2025208,-18000,,
com.leomehlig.today,17,1745980461,1745980478,1745980478.556416,-18000,,
com.apple.finder,2,1745980459,1745980461,1745980461.7636142,-18000,,
com.google.Chrome,1,1745980458,1745980459,1745980459.5809422,-18000,,
com.leomehlig.today,184,1745980274,1745980458,1745980458.304216,-18000,,
com.google.Chrome,991,1745979283,1745980274,1745980274.431138,-18000,,
com.apple.news,0,1745979283,1745979283,1745979283.9367619,-18000,,
com.google.Chrome,7,1745979276,1745979283,1745979283.115479,-18000,,
com.apple.news,47,1745979229,1745979276,1745979276.798182,-18000,,
com.google.Chrome,118,1745979111,1745979229,1745979229.9531279,-18000,,
com.google.Chrome,1236,1745977692,1745978928,1745978928.752928,-18000,,
com.google.Chrome,309,1745977307,1745977616,1745977616.480661,-18000,,
com.leomehlig.today,4,1745977303,1745977307,1745977307.559361,-18000,,
com.apple.iCal,5,1745977298,1745977303,1745977303.361021,-18000,,
com.leomehlig.today,46,1745977252,1745977298,1745977298.694886,-18000,,
com.google.Chrome,23,1745977229,1745977252,1745977252.5436869,-18000,,
com.leomehlig.today,11,1745977218,1745977229,1745977229.626285,-18000,,
com.google.Chrome,89,1745977129,1745977218,1745977218.186352,-18000,,
com.apple.finder,2,1745977127,1745977129,1745977130.0070949,-18000,,
com.google.Chrome,1134,1745975993,1745977127,1745977127.036638,-18000,,
com.toyopagroup.picaboo,22,1745975332,1745975354,1745975354.286123,-18000,EB445137-D7F5-57EC-87DA-1DB460D64046,"iPhone13,2"
com.google.chrome.ios,0,1745975332,1745975332,1745975333.351656,-18000,EB445137-D7F5-57EC-87DA-1DB460D64046,"iPhone13,2"
com.google.chrome.ios,29,1745973454,1745973483,1745973483.812406,-18000,EB445137-D7F5-57EC-87DA-1DB460D64046,"iPhone13,2"
com.google.chrome.ios,26,1745971879,1745971905,1745971905.342987,-18000,EB445137-D7F5-57EC-87DA-1DB460D64046,"iPhone13,2"
com.google.Chrome,690,1745968643,1745969333,1745969333.359803,-18000,,
com.google.Chrome,310,1745968320,1745968630,1745968630.6301742,-18000,,
com.leomehlig.today,46,1745968274,1745968320,1745968320.856538,-18000,,
com.google.Chrome,11,1745968263,1745968274,1745968274.585981,-18000,,
com.instructure.icanvas,7,1745967797,1745967804,1745967804.922347,-18000,EB445137-D7F5-57EC-87DA-1DB460D64046,"iPhone13,2"
com.instructure.icanvas,29,1745967763,1745967792,1745967792.309001,-18000,EB445137-D7F5-57EC-87DA-1DB460D64046,"iPhone13,2"
com.apple.MobileSMS,4,1745967752,1745967756,1745967756.430556,-18000,EB445137-D7F5-57EC-87DA-1DB460D64046,"iPhone13,2"
com.intsig.CamScannerLite,0,1745967752,1745967752,1745967752.597266,-18000,EB445137-D7F5-57EC-87DA-1DB460D64046,"iPhone13,2"
com.google.Chrome,450,1745967646,1745968096,1745968097.00882,-18000,,
com.apple.finder,5,1745967619,1745967624,1745967625.407833,-18000,,
com.apple.Passwords,0,1745967619,1745967619,1745967620.546691,-18000,,
com.google.Chrome,255,1745967364,1745967619,1745967619.256837,-18000,,
com.apple.Passwords,8,1745967356,1745967364,1745967364.265563,-18000,,
com.google.Chrome,1,1745967355,1745967356,1745967356.793095,-18000,,
com.apple.finder,67,1745967260,1745967327,1745967328.0084538,-18000,,
com.intsig.CamScannerLite,92,1745967249,1745967341,1745967341.766101,-18000,EB445137-D7F5-57EC-87DA-1DB460D64046,"iPhone13,2"
com.apple.mobiletimer,1,1745967243,1745967244,1745967244.698048,-18000,EB445137-D7F5-57EC-87DA-1DB460D64046,"iPhone13,2"
com.apple.mobiletimer,8,1745967134,1745967142,1745967142.843425,-18000,EB445137-D7F5-57EC-87DA-1DB460D64046,"iPhone13,2"
com.apple.Music,24,1745965478,1745965502,1745965502.22359,-18000,EB445137-D7F5-57EC-87DA-1DB460D64046,"iPhone13,2"
com.apple.finder,3,1745965188,1745965191,1745965191.597518,-18000,,
com.google.Chrome,2,1745965186,1745965188,1745965188.739101,-18000,,
com.apple.finder,2,1745965184,1745965186,1745965186.080018,-18000,,
com.leomehlig.today,41,1745965143,1745965184,1745965184.234782,-18000,,
com.apple.finder,84,1745965059,1745965143,1745965143.260807,-18000,,
com.google.Chrome,86,1745964973,1745965059,1745965059.058048,-18000,,
com.apple.finder,18,1745964948,1745964966,1745964966.304871,-18000,,
com.google.Chrome,3,1745964945,1745964948,1745964948.6585178,-18000,,
com.leomehlig.today,99,1745964846,1745964945,1745964946.8815432,-18000,,
com.apple.finder,15,1745964831,1745964846,1745964846.469779,-18000,,
com.leomehlig.today,1,1745964830,1745964831,1745964831.8533812,-18000,,
com.microsoft.VSCode,2,1745964828,1745964830,1745964830.904571,-18000,,
com.google.Chrome,42,1745964786,1745964828,1745964828.207129,-18000,,
com.leomehlig.today,7,1745964779,1745964786,1745964786.3477411,-18000,,
com.google.Chrome,1,1745964778,1745964779,1745964780.0465178,-18000,,
com.microsoft.Powerpoint,1,1745964770,1745964771,1745964771.6619139,-18000,,
com.apple.Notes,34,1745964736,1745964770,1745964770.182006,-18000,,
com.microsoft.Powerpoint,3,1745964733,1745964736,1745964736.975779,-18000,,
com.apple.Notes,19,1745964714,1745964733,1745964733.123143,-18000,,
com.microsoft.Powerpoint,33,1745964681,1745964714,1745964714.2038422,-18000,,
com.apple.Notes,27,1745964654,1745964681,1745964681.2125669,-18000,,
com.google.Chrome,111,1745964543,1745964654,1745964654.621428,-18000,,
com.microsoft.VSCode,16,1745964506,1745964522,1745964522.024437,-18000,,
com.tinyspeck.chatlyio,6,1745964173,1745964179,1745964180.018409,-18000,EB445137-D7F5-57EC-87DA-1DB460D64046,"iPhone13,2"
com.groupme.iphone-app,0,1745964173,1745964173,1745964174.528202,-18000,EB445137-D7F5-57EC-87DA-1DB460D64046,"iPhone13,2"
com.apple.Terminal,350,1745964156,1745964506,1745964506.8647761,-18000,,
com.microsoft.VSCode,2,1745964154,1745964156,1745964156.302993,-18000,,
com.apple.Terminal,14,1745964140,1745964154,1745964154.564414,-18000,,
com.microsoft.VSCode,82,1745964058,1745964140,1745964140.833919,-18000,,
com.apple.Notes,7,1745964051,1745964058,1745964058.475724,-18000,,
com.microsoft.VSCode,75,1745963976,1745964051,1745964051.75509,-18000,,
com.google.Chrome,7,1745963969,1745963976,1745963977.0327911,-18000,,
com.microsoft.VSCode,22,1745963947,1745963969,1745963969.709038,-18000,,
com.microsoft.Powerpoint,6,1745963941,1745963947,1745963947.074105,-18000,,
com.microsoft.VSCode,35,1745963906,1745963941,1745963941.14929,-18000,,
com.microsoft.Powerpoint,2,1745963904,1745963906,1745963906.2886891,-18000,,
com.microsoft.VSCode,1,1745963903,1745963904,1745963904.962579,-18000,,
com.microsoft.Powerpoint,1,1745963902,1745963903,1745963903.542636,-18000,,
com.microsoft.VSCode,2,1745963900,1745963902,1745963902.3605309,-18000,,
com.microsoft.Powerpoint,1,1745963899,1745963900,1745963900.693569,-18000,,
com.microsoft.VSCode,3,1745963896,1745963899,1745963899.246368,-18000,,
com.microsoft.Powerpoint,9,1745963887,1745963896,1745963896.103442,-18000,,
com.microsoft.VSCode,44,1745963843,1745963887,1745963887.0524712,-18000,,
com.google.Chrome,1,1745963842,1745963843,1745963843.2936568,-18000,,
com.apple.Notes,6,1745963836,1745963842,1745963842.105942,-18000,,
com.microsoft.VSCode,160,1745963676,1745963836,1745963836.9198089,-18000,,
com.google.Chrome,14,1745963662,1745963676,1745963676.3560262,-18000,,
com.apple.finder,5,1745963657,1745963662,1745963662.942838,-18000,,
com.google.Chrome,2,1745963655,1745963657,1745963657.170603,-18000,,
com.apple.finder,1,1745963654,1745963655,1745963656.009978,-18000,,
com.google.Chrome,2,1745963652,1745963654,1745963654.392887,-18000,,
com.apple.finder,1,1745963651,1745963652,1745963652.670689,-18000,,
com.google.Chrome,2,1745963649,1745963651,1745963651.483426,-18000,,
com.apple.finder,1,1745963648,1745963649,1745963649.986858,-18000,,
com.google.Chrome,1,1745963647,1745963648,1745963648.864207,-18000,,
com.apple.finder,4,1745963643,1745963647,1745963647.196385,-18000,,
com.google.Chrome,1,1745963642,1745963643,1745963643.222856,-18000,,
com.apple.finder,5,1745963637,1745963642,1745963642.601042,-18000,,
com.google.Chrome,12,1745963625,1745963637,1745963637.33925,-18000,,
com.apple.finder,13,1745963612,1745963625,1745963625.204245,-18000,,
com.google.Chrome,31,1745963581,1745963612,1745963612.17311,-18000,,
com.apple.finder,12,1745963569,1745963581,1745963582.021564,-18000,,
com.google.Chrome,9,1745963560,1745963569,1745963569.600933,-18000,,
com.apple.Notes,3,1745963557,1745963560,1745963561.773263,-18000,,
com.microsoft.VSCode,35,1745963522,1745963557,1745963558.016097,-18000,,
com.apple.Notes,11,1745963511,1745963522,1745963522.403863,-18000,,
com.apple.finder,3,1745963508,1745963511,1745963511.3564758,-18000,,
com.groupme.iphone-app,64,1745963240,1745963304,1745963304.4299579,-18000,EB445137-D7F5-57EC-87DA-1DB460D64046,"iPhone13,2"
com.microsoft.VSCode,511,1745962997,1745963508,1745963508.450117,-18000,,
com.apple.finder,39,1745962958,1745962997,1745962997.8001819,-18000,,
com.apple.Terminal,46,1745962912,1745962958,1745962958.88033,-18000,,
com.apple.finder,2,1745962910,1745962912,1745962912.08243,-18000,,
com.apple.Terminal,42,1745962868,1745962910,1745962910.914104,-18000,,
com.apple.finder,29,1745962839,1745962868,1745962868.45966,-18000,,
com.microsoft.VSCode,5,1745962834,1745962839,1745962839.475266,-18000,,
com.apple.finder,17,1745962817,1745962834,1745962834.555345,-18000,,
com.microsoft.VSCode,18,1745962799,1745962817,1745962817.546472,-18000,,
com.apple.finder,3,1745962796,1745962799,1745962799.941647,-18000,,
com.microsoft.VSCode,6,1745962790,1745962796,1745962796.29218,-18000,,
com.apple.finder,6,1745962784,1745962790,1745962790.462748,-18000,,
com.microsoft.VSCode,3,1745962781,1745962784,1745962784.291652,-18000,,
com.apple.finder,14,1745962767,1745962781,1745962781.337237,-18000,,
com.microsoft.VSCode,4,1745962763,1745962767,1745962767.7425199,-18000,,
com.apple.finder,13,1745962750,1745962763,1745962763.1699982,-18000,,
com.microsoft.VSCode,45,1745962705,1745962750,1745962750.104185,-18000,,
com.apple.finder,23,1745962682,1745962705,1745962706.029654,-18000,,
com.microsoft.VSCode,4,1745962678,1745962682,1745962682.47122,-18000,,
com.apple.finder,39,1745962639,1745962678,1745962678.230403,-18000,,
com.microsoft.VSCode,23,1745962616,1745962639,1745962639.2387872,-18000,,
com.apple.finder,9,1745962607,1745962616,1745962616.1282082,-18000,,
com.microsoft.VSCode,110,1745962497,1745962607,1745962607.343638,-18000,,
com.apple.finder,9,1745962488,1745962497,1745962497.285002,-18000,,
com.microsoft.VSCode,13,1745962475,1745962488,1745962488.644584,-18000,,
com.apple.finder,29,1745962446,1745962475,1745962475.337963,-18000,,
com.microsoft.VSCode,24,1745962422,1745962446,1745962446.2378821,-18000,,
com.apple.finder,42,1745962380,1745962422,1745962422.356863,-18000,,
com.microsoft.VSCode,27,1745962353,1745962380,1745962380.125315,-18000,,
com.google.Chrome,17,1745962336,1745962353,1745962353.93049,-18000,,
com.leomehlig.today,70,1745962266,1745962336,1745962336.086371,-18000,,
com.google.Chrome,9,1745962257,1745962266,1745962267.034208,-18000,,
com.apple.CoreAuthUI,2,1745962061,1745962063,1745962063.838142,-18000,EB445137-D7F5-57EC-87DA-1DB460D64046,"iPhone13,2"
com.truebill.truebillnative,89,1745962058,1745962147,1745962147.588717,-18000,EB445137-D7F5-57EC-87DA-1DB460D64046,"iPhone13,2"
com.apple.weather,16,1745962032,1745962048,1745962048.520945,-18000,EB445137-D7F5-57EC-87DA-1DB460D64046,"iPhone13,2"
com.leomehlig.today,353,1745961904,1745962257,1745962257.866615,-18000,,
com.google.Chrome,267,1745961637,1745961904,1745961904.253986,-18000,,
com.leomehlig.today,15,1745961622,1745961637,1745961637.9680228,-18000,,
com.google.Chrome,758,1745960864,1745961622,1745961622.161727,-18000,,
com.google.Chrome,350,1745960266,1745960616,1745960616.489674,-18000,,
com.leomehlig.today,19,1745960247,1745960266,1745960266.134955,-18000,,
com.apple.weather,67,1745960227,1745960294,1745960294.8156981,-18000,EB445137-D7F5-57EC-87DA-1DB460D64046,"iPhone13,2"
com.instructure.icanvas,3,1745960219,1745960222,1745960222.597159,-18000,EB445137-D7F5-57EC-87DA-1DB460D64046,"iPhone13,2"
com.instructure.icanvas,18,1745960198,1745960216,1745960216.7749171,-18000,EB445137-D7F5-57EC-87DA-1DB460D64046,"iPhone13,2"
com.instructure.icanvas,8,1745960188,1745960196,1745960196.806735,-18000,EB445137-D7F5-57EC-87DA-1DB460D64046,"iPhone13,2"
com.apple.news,0,1745960188,1745960188,1745960188.874682,-18000,EB445137-D7F5-57EC-87DA-1DB460D64046,"iPhone13,2"
com.google.Chrome,223,1745960024,1745960247,1745960247.3933702,-18000,,
com.leomehlig.today,8,1745960016,1745960024,1745960024.363655,-18000,,
com.google.Chrome,3248,1745956768,1745960016,1745960016.803819,-18000,,
com.leomehlig.today,27,1745956741,1745956768,1745956768.277296,-18000,,
com.google.Chrome,12,1745956729,1745956741,1745956741.203089,-18000,,
com.apple.finder,74,1745956634,1745956708,1745956709.396394,-18000,,
com.apple.Preview,0,1745956634,1745956634,1745956634.570924,-18000,,
com.apple.finder,2,1745956632,1745956634,1745956634.275738,-18000,,
com.apple.Notes,2,1745956630,1745956632,1745956633.0013928,-18000,,
com.leomehlig.today,2,1745956628,1745956630,1745956630.7726002,-18000,,
com.apple.Notes,2,1745956626,1745956628,1745956629.0332751,-18000,,
com.google.Chrome,31,1745956595,1745956626,1745956627.5923572,-18000,,
com.apple.Notes,13,1745956582,1745956595,1745956595.64417,-18000,,
com.google.Chrome,6,1745956576,1745956582,1745956582.6540298,-18000,,
com.apple.Notes,2,1745956574,1745956576,1745956576.782548,-18000,,
com.google.Chrome,10,1745956564,1745956574,1745956574.851639,-18000,,
com.leomehlig.today,60,1745956504,1745956564,1745956564.980537,-18000,,
com.apple.iCal,14,1745956490,1745956504,1745956504.335555,-18000,,
com.leomehlig.today,2,1745956488,1745956490,1745956491.0175428,-18000,,
com.google.Chrome,39,1745956449,1745956488,1745956488.186154,-18000,,
com.apple.news,41,1745953271,1745953312,1745953312.352551,-18000,EB445137-D7F5-57EC-87DA-1DB460D64046,"iPhone13,2"
com.apple.news,40,1745953206,1745953246,1745953247.0540938,-18000,EB445137-D7F5-57EC-87DA-1DB460D64046,"iPhone13,2"
com.apple.news,221,1745952947,1745953168,1745953169.818404,-18000,EB445137-D7F5-57EC-87DA-1DB460D64046,"iPhone13,2"
com.apple.news,125,1745952817,1745952942,1745952942.469099,-18000,EB445137-D7F5-57EC-87DA-1DB460D64046,"iPhone13,2"
com.instructure.icanvas,74,1745952739,1745952813,1745952813.797209,-18000,EB445137-D7F5-57EC-87DA-1DB460D64046,"iPhone13,2"
com.apple.news,493,1745951884,1745952377,1745952377.8659248,-18000,EB445137-D7F5-57EC-87DA-1DB460D64046,"iPhone13,2"
com.microsoft.Office.Outlook,7,1745951876,1745951883,1745951883.273305,-18000,EB445137-D7F5-57EC-87DA-1DB460D64046,"iPhone13,2"
com.google.chrome.ios,151,1745951724,1745951875,1745951876.232605,-18000,EB445137-D7F5-57EC-87DA-1DB460D64046,"iPhone13,2"
com.microsoft.Office.Outlook,5,1745951719,1745951724,1745951724.262119,-18000,EB445137-D7F5-57EC-87DA-1DB460D64046,"iPhone13,2"
com.hammerandchisel.discord,53,1745951662,1745951715,1745951715.7329168,-18000,EB445137-D7F5-57EC-87DA-1DB460D64046,"iPhone13,2"
com.microsoft.Office.Outlook,0,1745951662,1745951662,1745951662.912291,-18000,EB445137-D7F5-57EC-87DA-1DB460D64046,"iPhone13,2"
com.microsoft.Office.Outlook,114,1745951375,1745951489,1745951490.327376,-18000,EB445137-D7F5-57EC-87DA-1DB460D64046,"iPhone13,2"
com.apple.mobilecal,33,1745951342,1745951375,1745951375.684935,-18000,EB445137-D7F5-57EC-87DA-1DB460D64046,"iPhone13,2"
com.microsoft.Office.Outlook,25,1745951312,1745951337,1745951337.9298449,-18000,EB445137-D7F5-57EC-87DA-1DB460D64046,"iPhone13,2"
com.microsoft.Office.Outlook,19,1745951292,1745951311,1745951311.7125401,-18000,EB445137-D7F5-57EC-87DA-1DB460D64046,"iPhone13,2"
com.instructure.icanvas,23,1745951260,1745951283,1745951283.388843,-18000,EB445137-D7F5-57EC-87DA-1DB460D64046,"iPhone13,2"
com.google.Chrome,260,1745950929,1745951189,1745951189.656456,-18000,,
com.apple.news,16,1745950913,1745950929,1745950929.554438,-18000,,
com.google.Chrome,30,1745950883,1745950913,1745950913.56118,-18000,,
com.leomehlig.today,13,1745950870,1745950883,1745950883.6149778,-18000,,
com.google.Chrome,367,1745950503,1745950870,1745950870.227423,-18000,,
com.apple.Notes,3,1745950500,1745950503,1745950503.335178,-18000,,
com.microsoft.Powerpoint,2,1745950498,1745950500,1745950500.999778,-18000,,
com.apple.Notes,34,1745950464,1745950498,1745950498.556504,-18000,,
com.google.Chrome,21,1745950443,1745950464,1745950464.46378,-18000,,
com.leomehlig.today,157,1745950286,1745950443,1745950443.662856,-18000,,
com.microsoft.Powerpoint,15,1745950271,1745950286,1745950286.446924,-18000,,
com.leomehlig.today,54,1745950217,1745950271,1745950271.846174,-18000,,
com.microsoft.Powerpoint,136,1745950081,1745950217,1745950217.778274,-18000,,
com.apple.Notes,4,1745950077,1745950081,1745950081.76847,-18000,,
com.google.Chrome,1,1745950076,1745950077,1745950077.12588,-18000,,
com.microsoft.Powerpoint,65,1745950011,1745950076,1745950076.091782,-18000,,
com.google.Chrome,72,1745949939,1745950011,1745950011.269813,-18000,,
com.microsoft.Powerpoint,229,1745949710,1745949939,1745949939.847635,-18000,,
com.apple.Notes,13,1745949697,1745949710,1745949710.952897,-18000,,
com.microsoft.Powerpoint,2,1745949695,1745949697,1745949698.035555,-18000,,
com.apple.Notes,9,1745949686,1745949695,1745949695.82065,-18000,,
com.microsoft.Powerpoint,1,1745949685,1745949686,1745949686.892703,-18000,,
com.apple.Notes,7,1745949678,1745949685,1745949685.5711741,-18000,,
com.microsoft.Powerpoint,3,1745949675,1745949678,1745949678.704544,-18000,,
com.apple.Notes,7,1745949668,1745949675,1745949675.119473,-18000,,
com.microsoft.Powerpoint,1,1745949667,1745949668,1745949668.348017,-18000,,
com.apple.Notes,3,1745949664,1745949667,1745949667.464604,-18000,,
com.microsoft.Powerpoint,1,1745949663,1745949664,1745949664.375898,-18000,,
com.apple.Notes,14,1745949649,1745949663,1745949663.6522288,-18000,,
com.microsoft.Powerpoint,9,1745949640,1745949649,1745949649.3935041,-18000,,
com.apple.Notes,1,1745949639,1745949640,1745949641.036745,-18000,,
com.microsoft.Powerpoint,1,1745949638,1745949639,1745949639.28855,-18000,,
com.apple.Notes,4,1745949634,1745949638,1745949638.306123,-18000,,
com.microsoft.Powerpoint,4,1745949630,1745949634,1745949634.908,-18000,,
com.apple.Notes,19,1745949611,1745949630,1745949630.417593,-18000,,
com.microsoft.Powerpoint,3,1745949608,1745949611,1745949611.40207,-18000,,
com.apple.Notes,18,1745949590,1745949608,1745949608.8495169,-18000,,
com.microsoft.Powerpoint,4,1745949586,1745949590,1745949590.4063,-18000,,
com.apple.Notes,14,1745949572,1745949586,1745949586.8128982,-18000,,
com.microsoft.Powerpoint,84,1745949488,1745949572,1745949572.761158,-18000,,
com.apple.finder,4,1745949484,1745949488,1745949488.6441522,-18000,,
com.microsoft.Powerpoint,1,1745949483,1745949484,1745949484.233152,-18000,,
com.apple.finder,5,1745949478,1745949483,1745949483.654152,-18000,,
com.apple.archiveutility,0,1745949478,1745949478,1745949478.4583778,-18000,,
com.apple.finder,8,1745949470,1745949478,1745949478.112432,-18000,,
com.google.Chrome,23,1745949447,1745949470,1745949470.4107199,-18000,,
com.microsoft.Powerpoint,40,1745949407,1745949447,1745949448.027302,-18000,,
com.google.Chrome,6,1745949401,1745949407,1745949407.368061,-18000,,
com.microsoft.Powerpoint,4,1745949397,1745949401,1745949401.174808,-18000,,
com.google.Chrome,3,1745949394,1745949397,1745949397.912436,-18000,,
com.microsoft.Powerpoint,6,1745949388,1745949394,1745949394.504315,-18000,,
com.google.Chrome,4,1745949384,1745949388,1745949388.130647,-18000,,
com.microsoft.Powerpoint,6,1745949378,1745949384,1745949384.988278,-18000,,
com.google.Chrome,1,1745949377,1745949378,1745949378.902864,-18000,,
com.microsoft.Powerpoint,10,1745949367,1745949377,1745949377.2819061,-18000,,
com.google.Chrome,7,1745949360,1745949367,1745949367.10283,-18000,,
com.microsoft.Powerpoint,5,1745949355,1745949360,1745949360.24938,-18000,,
com.google.Chrome,3,1745949352,1745949355,1745949355.8185658,-18000,,
com.microsoft.Powerpoint,2,1745949350,1745949352,1745949352.2801561,-18000,,
com.google.Chrome,3,1745949347,1745949350,1745949350.606966,-18000,,
com.microsoft.Powerpoint,3,1745949344,1745949347,1745949347.692126,-18000,,
com.google.Chrome,2,1745949342,1745949344,1745949344.7526941,-18000,,
com.microsoft.Powerpoint,5,1745949337,1745949342,1745949342.886111,-18000,,
com.google.Chrome,3,1745949334,1745949337,1745949337.779629,-18000,,
com.microsoft.Powerpoint,3,1745949331,1745949334,1745949334.811171,-18000,,
com.google.Chrome,2,1745949329,1745949331,1745949331.262773,-18000,,
com.microsoft.Powerpoint,3,1745949326,1745949329,1745949329.748495,-18000,,
com.google.Chrome,4,1745949322,1745949326,1745949326.864892,-18000,,
com.leomehlig.today,1,1745949321,1745949322,1745949322.801824,-18000,,
com.microsoft.Powerpoint,20,1745949301,1745949321,1745949321.6086578,-18000,,
com.leomehlig.today,1,1745949300,1745949301,1745949301.64788,-18000,,
com.google.Chrome,6,1745949294,1745949300,1745949300.78037,-18000,,
com.microsoft.Powerpoint,1,1745949293,1745949294,1745949294.345546,-18000,,
com.google.Chrome,3,1745949290,1745949293,1745949293.441658,-18000,,
com.microsoft.Powerpoint,2,1745949288,1745949290,1745949290.279566,-18000,,
com.google.Chrome,53,1745949235,1745949288,1745949288.900868,-18000,,
com.microsoft.Powerpoint,31,1745949204,1745949235,1745949235.051893,-18000,,
com.google.Chrome,9,1745949195,1745949204,1745949204.991879,-18000,,
com.microsoft.Powerpoint,62,1745949133,1745949195,1745949195.704705,-18000,,
com.google.Chrome,5,1745949128,1745949133,1745949134.005116,-18000,,
com.microsoft.Powerpoint,42,1745949086,1745949128,1745949128.572866,-18000,,
com.google.Chrome,36,1745949050,1745949086,1745949086.845866,-18000,,
com.microsoft.Powerpoint,2,1745949048,1745949050,1745949050.950732,-18000,,
com.google.Chrome,5,1745949043,1745949048,1745949048.629163,-18000,,
com.google.Chrome,302,1745948416,1745948718,1745948718.703614,-18000,,
com.google.Chrome,511,1745947426,1745947937,1745947937.7305,-18000,,
com.leomehlig.today,147,1745947279,1745947426,1745947426.2664452,-18000,,
com.google.Chrome,32,1745947247,1745947279,1745947279.442594,-18000,,
com.apple.news,411,1745945945,1745946356,1745946356.925111,-18000,EB445137-D7F5-57EC-87DA-1DB460D64046,"iPhone13,2"
com.leomehlig.today,73,1745945867,1745945940,1745945940.54385,-18000,EB445137-D7F5-57EC-87DA-1DB460D64046,"iPhone13,2"
com.apple.mobilecal,23,1745945844,1745945867,1745945867.9527822,-18000,EB445137-D7F5-57EC-87DA-1DB460D64046,"iPhone13,2"
com.leomehlig.today,17,1745945822,1745945839,1745945839.969099,-18000,EB445137-D7F5-57EC-87DA-1DB460D64046,"iPhone13,2"
com.strava.stravaride,62,1745945750,1745945812,1745945813.0630789,-18000,EB445137-D7F5-57EC-87DA-1DB460D64046,"iPhone13,2"
com.apple.Music,0,1745945750,1745945750,1745945751.310999,-18000,EB445137-D7F5-57EC-87DA-1DB460D64046,"iPhone13,2"
com.apple.Music,40,1745944389,1745944429,1745944433.252383,-18000,EB445137-D7F5-57EC-87DA-1DB460D64046,"iPhone13,2"
com.google.chrome.ios,0,1745944389,1745944389,1745944390.458455,-18000,EB445137-D7F5-57EC-87DA-1DB460D64046,"iPhone13,2"
com.google.chrome.ios,26,1745941930,1745941956,1745941957.228397,-18000,EB445137-D7F5-57EC-87DA-1DB460D64046,"iPhone13,2"
com.apple.MobileSMS,2,1745941928,1745941930,1745941930.210867,-18000,EB445137-D7F5-57EC-87DA-1DB460D64046,"iPhone13,2"
com.google.Chrome,947,1745940862,1745941809,1745941809.395148,-18000,,
com.leomehlig.today,18,1745940844,1745940862,1745940862.363267,-18000,,
com.google.Chrome,5,1745940839,1745940844,1745940844.417537,-18000,,
com.leomehlig.today,25,1745940814,1745940839,1745940839.473779,-18000,,
com.google.Chrome,48,1745940766,1745940814,1745940814.978683,-18000,,
com.google.Chrome,317,1745939947,1745940264,1745940264.80275,-18000,,
com.leomehlig.today,20,1745939927,1745939947,1745939947.837963,-18000,,
com.google.Chrome,119,1745939808,1745939927,1745939927.54466,-18000,,
com.leomehlig.today,7,1745939801,1745939808,1745939808.531842,-18000,,
com.google.Chrome,26,1745939775,1745939801,1745939801.898841,-18000,,
com.apple.Preview,2,1745939773,1745939775,1745939775.4872742,-18000,,
com.google.Chrome,14,1745939759,1745939773,1745939773.959877,-18000,,
com.apple.Preview,1,1745939758,1745939759,1745939759.278137,-18000,,
com.google.Chrome,1,1745939757,1745939758,1745939758.260532,-18000,,
com.apple.Preview,3,1745939754,1745939757,1745939757.292212,-18000,,
com.google.Chrome,10,1745939744,1745939754,1745939754.556507,-18000,,
com.apple.Preview,3,1745939741,1745939744,1745939744.933502,-18000,,
com.google.Chrome,1,1745939740,1745939741,1745939741.899139,-18000,,
com.apple.Preview,1,1745939739,1745939740,1745939741.020103,-18000,,
com.google.Chrome,4,1745939735,1745939739,1745939739.669507,-18000,,
com.apple.Preview,3,1745939732,1745939735,1745939735.751906,-18000,,
com.google.Chrome,21,1745939711,1745939732,1745939732.164314,-18000,,
com.apple.Preview,0,1745939711,1745939711,1745939711.967037,-18000,,
com.google.Chrome,3,1745939708,1745939711,1745939711.211767,-18000,,
com.apple.Preview,2,1745939706,1745939708,1745939708.776478,-18000,,
com.google.Chrome,24,1745939682,1745939706,1745939706.887332,-18000,,
com.apple.Preview,1,1745939681,1745939682,1745939682.094048,-18000,,
com.google.Chrome,5,1745939676,1745939681,1745939681.249692,-18000,,
com.apple.Preview,1,1745939675,1745939676,1745939676.787436,-18000,,
com.google.Chrome,7,1745939668,1745939675,1745939675.716219,-18000,,
com.apple.Preview,1,1745939667,1745939668,1745939668.157624,-18000,,
com.google.Chrome,1,1745939666,1745939667,1745939667.442236,-18000,,
com.apple.Preview,3,1745939663,1745939666,1745939666.648283,-18000,,
com.google.Chrome,38,1745939625,1745939663,1745939663.1737618,-18000,,
com.apple.Preview,2,1745939623,1745939625,1745939626.033879,-18000,,
com.google.Chrome,26,1745939597,1745939623,1745939623.393093,-18000,,
com.apple.Preview,5,1745939592,1745939597,1745939597.845279,-18000,,
com.google.Chrome,14,1745939578,1745939592,1745939592.2915468,-18000,,
com.apple.Preview,1,1745939577,1745939578,1745939578.424258,-18000,,
com.google.Chrome,2,1745939575,1745939577,1745939577.3587089,-18000,,
com.apple.Preview,1,1745939574,1745939575,1745939575.246721,-18000,,
com.google.Chrome,4,1745939570,1745939574,1745939574.114135,-18000,,
com.apple.Preview,1,1745939569,1745939570,1745939571.044709,-18000,,
com.google.Chrome,4,1745939565,1745939569,1745939569.2473578,-18000,,
com.apple.Preview,0,1745939565,1745939565,1745939566.025264,-18000,,
com.google.Chrome,11,1745939554,1745939565,1745939565.099009,-18000,,
com.apple.Preview,3,1745939551,1745939554,1745939554.899564,-18000,,
com.google.Chrome,132,1745939419,1745939551,1745939551.376042,-18000,,
com.apple.Preview,231,1745939188,1745939419,1745939419.096319,-18000,,
com.leomehlig.today,2,1745939186,1745939188,1745939188.0949612,-18000,,
com.apple.Preview,566,1745938620,1745939186,1745939186.545567,-18000,,
com.google.Chrome,35,1745938585,1745938620,1745938621.006942,-18000,,
com.apple.Preview,82,1745938503,1745938585,1745938585.257379,-18000,,
com.leomehlig.today,83,1745938420,1745938503,1745938503.861631,-18000,,
com.apple.Preview,48,1745938372,1745938420,1745938420.847688,-18000,,
com.apple.finder,7,1745938365,1745938372,1745938373.046054,-18000,,
com.google.Chrome,2,1745938363,1745938365,1745938365.506247,-18000,,
com.apple.MobileSMS,2,1745938312,1745938314,1745938314.370875,-18000,EB445137-D7F5-57EC-87DA-1DB460D64046,"iPhone13,2"
com.renpho.health,0,1745938312,1745938312,1745938313.2742438,-18000,EB445137-D7F5-57EC-87DA-1DB460D64046,"iPhone13,2"
com.renpho.health,26,1745936731,1745936757,1745936757.341389,-18000,EB445137-D7F5-57EC-87DA-1DB460D64046,"iPhone13,2"
com.apple.news,4,1745936725,1745936729,1745936729.9257421,-18000,EB445137-D7F5-57EC-87DA-1DB460D64046,"iPhone13,2"
com.apple.news,406,1745935498,1745935904,1745935904.2392058,-18000,EB445137-D7F5-57EC-87DA-1DB460D64046,"iPhone13,2"
com.apple.Health,41,1745935452,1745935493,1745935493.78777,-18000,EB445137-D7F5-57EC-87DA-1DB460D64046,"iPhone13,2"
com.strava.stravaride,74,1745935374,1745935448,1745935449.014113,-18000,EB445137-D7F5-57EC-87DA-1DB460D64046,"iPhone13,2"
com.apple.Health,6,1745935367,1745935373,1745935373.835695,-18000,EB445137-D7F5-57EC-87DA-1DB460D64046,"iPhone13,2"
com.apple.weather,89,1745931929,1745932018,1745932018.599566,-18000,EB445137-D7F5-57EC-87DA-1DB460D64046,"iPhone13,2"
com.microsoft.Office.Outlook,136,1745931778,1745931914,1745931914.565088,-18000,EB445137-D7F5-57EC-87DA-1DB460D64046,"iPhone13,2"
com.instructure.icanvas,11,1745931766,1745931777,1745931777.482967,-18000,EB445137-D7F5-57EC-87DA-1DB460D64046,"iPhone13,2"
com.apple.Health,5,1745931754,1745931759,1745931759.771688,-18000,EB445137-D7F5-57EC-87DA-1DB460D64046,"iPhone13,2"
com.apple.Health,17,1745898249,1745898266,1745898267.28456,-18000,EB445137-D7F5-57EC-87DA-1DB460D64046,"iPhone13,2"
com.instructure.icanvas,0,1745898249,1745898249,1745898250.4537601,-18000,EB445137-D7F5-57EC-87DA-1DB460D64046,"iPhone13,2"
com.instructure.icanvas,1,1745898247,1745898248,1745898248.883607,-18000,EB445137-D7F5-57EC-87DA-1DB460D64046,"iPhone13,2"
com.google.Chrome,1127,1745897010,1745898137,1745898137.1532369,-18000,,
com.google.Chrome,1369,1745895412,1745896781,1745896781.4324489,-18000,,
com.apple.news,777,1745894635,1745895412,1745895412.378683,-18000,,
com.google.Chrome,1,1745894634,1745894635,1745894635.201377,-18000,,
com.apple.news,2,1745894632,1745894634,1745894634.196182,-18000,,
com.google.Chrome,1,1745894631,1745894632,1745894632.6724849,-18000,,
com.apple.news,1,1745894630,1745894631,1745894632.045706,-18000,,
com.google.Chrome,2,1745894628,1745894630,1745894630.046661,-18000,,
com.apple.news,5,1745894623,1745894628,1745894628.512367,-18000,,
com.google.Chrome,21,1745894602,1745894623,1745894624.056493,-18000,,
com.instructure.icanvas,18,1745894564,1745894582,1745894582.701848,-18000,EB445137-D7F5-57EC-87DA-1DB460D64046,"iPhone13,2"
com.microsoft.Office.Outlook,0,1745894564,1745894564,1745894565.3340611,-18000,EB445137-D7F5-57EC-87DA-1DB460D64046,"iPhone13,2"
com.google.Chrome,736,1745893739,1745894475,1745894475.5807,-18000,,
com.google.Chrome,302,1745892905,1745893207,1745893207.113688,-18000,,
com.leomehlig.today,119,1745892786,1745892905,1745892905.381895,-18000,,
com.google.Chrome,1,1745892785,1745892786,1745892786.623503,-18000,,
com.apple.finder,5,1745892780,1745892785,1745892785.529994,-18000,,
com.microsoft.Office.Outlook,7,1745888692,1745888699,1745888700.0723228,-18000,EB445137-D7F5-57EC-87DA-1DB460D64046,"iPhone13,2"
com.google.chrome.ios,45,1745886142,1745886187,1745886187.272531,-18000,EB445137-D7F5-57EC-87DA-1DB460D64046,"iPhone13,2"
com.leomehlig.today,40,1745883930,1745883970,1745883970.490294,-18000,EB445137-D7F5-57EC-87DA-1DB460D64046,"iPhone13,2"
com.apple.weather,4,1745883924,1745883928,1745883928.238855,-18000,EB445137-D7F5-57EC-87DA-1DB460D64046,"iPhone13,2"
com.instructure.icanvas,28,1745883890,1745883918,1745883918.331444,-18000,EB445137-D7F5-57EC-87DA-1DB460D64046,"iPhone13,2"
com.google.Drive,32,1745883845,1745883877,1745883877.152462,-18000,EB445137-D7F5-57EC-87DA-1DB460D64046,"iPhone13,2"
com.leomehlig.today,22,1745883776,1745883798,1745883798.8639278,-18000,EB445137-D7F5-57EC-87DA-1DB460D64046,"iPhone13,2"
com.leomehlig.today,92,1745883680,1745883772,1745883772.256182,-18000,EB445137-D7F5-57EC-87DA-1DB460D64046,"iPhone13,2"
com.leomehlig.today,89,1745883589,1745883678,1745883678.298612,-18000,EB445137-D7F5-57EC-87DA-1DB460D64046,"iPhone13,2"
com.microsoft.Office.Outlook,3,1745883579,1745883582,1745883582.9292579,-18000,EB445137-D7F5-57EC-87DA-1DB460D64046,"iPhone13,2"
com.microsoft.Office.Outlook,68,1745883507,1745883575,1745883575.32382,-18000,EB445137-D7F5-57EC-87DA-1DB460D64046,"iPhone13,2"
com.groupme.iphone-app,1,1745883506,1745883507,1745883507.370976,-18000,EB445137-D7F5-57EC-87DA-1DB460D64046,"iPhone13,2"
com.groupme.iphone-app,11,1745883093,1745883104,1745883104.876741,-18000,EB445137-D7F5-57EC-87DA-1DB460D64046,"iPhone13,2"
com.groupme.iphone-app,9,1745882598,1745882607,1745882607.8334808,-18000,EB445137-D7F5-57EC-87DA-1DB460D64046,"iPhone13,2"
com.google.chrome.ios,1,1745882597,1745882598,1745882598.738991,-18000,EB445137-D7F5-57EC-87DA-1DB460D64046,"iPhone13,2"
com.google.chrome.ios,3,1745882274,1745882277,1745882277.3632479,-18000,EB445137-D7F5-57EC-87DA-1DB460D64046,"iPhone13,2"
com.apple.finder,46,1745882157,1745882203,1745882203.126665,-18000,,
com.google.Chrome,177,1745881980,1745882157,1745882157.7041988,-18000,,
com.google.Chrome,329,1745881603,1745881932,1745881932.693696,-18000,,
com.google.Chrome,16,1745880083,1745880099,1745880099.870224,-18000,,
com.google.Chrome,302,1745879774,1745880076,1745880076.96867,-18000,,
com.google.Chrome,310,1745879447,1745879757,1745879757.596637,-18000,,
com.google.Chrome,302,1745878741,1745879043,1745879043.651653,-18000,,
com.apple.CoreAuthUI,2,1745877965,1745877967,1745877967.844058,-18000,EB445137-D7F5-57EC-87DA-1DB460D64046,"iPhone13,2"
com.apple.CoreAuthUI,2,1745877961,1745877963,1745877963.659453,-18000,EB445137-D7F5-57EC-87DA-1DB460D64046,"iPhone13,2"
com.google.chrome.ios,22,1745877955,1745877977,1745877977.8787808,-18000,EB445137-D7F5-57EC-87DA-1DB460D64046,"iPhone13,2"
com.apple.camera,4,1745877951,1745877955,1745877955.415587,-18000,EB445137-D7F5-57EC-87DA-1DB460D64046,"iPhone13,2"
com.google.chrome.ios,27,1745877916,1745877943,1745877943.25219,-18000,EB445137-D7F5-57EC-87DA-1DB460D64046,"iPhone13,2"
com.google.Chrome,57,1745877776,1745877833,1745877833.601789,-18000,,
com.leomehlig.today,4,1745877772,1745877776,1745877776.356482,-18000,,
com.apple.news,266,1745877399,1745877665,1745877665.5503879,-18000,EB445137-D7F5-57EC-87DA-1DB460D64046,"iPhone13,2"
com.leomehlig.today,8,1745877345,1745877353,1745877353.497408,-18000,,
com.apple.iCal,8,1745877337,1745877345,1745877345.170747,-18000,,
com.leomehlig.today,1,1745877336,1745877337,1745877337.469576,-18000,,
com.google.Chrome,36,1745877300,1745877336,1745877336.263702,-18000,,
com.leomehlig.today,12,1745877288,1745877300,1745877300.267128,-18000,,
com.google.Chrome,12,1745877276,1745877288,1745877288.120908,-18000,,
com.apple.iCal,24,1745877252,1745877276,1745877276.2453918,-18000,,
com.google.Chrome,10,1745877242,1745877252,1745877252.373258,-18000,,
com.leomehlig.today,30,1745877212,1745877242,1745877242.9169269,-18000,,
com.apple.news,4,1745875840,1745875844,1745875844.9483008,-18000,EB445137-D7F5-57EC-87DA-1DB460D64046,"iPhone13,2"
com.google.Chrome,1573,1745875639,1745877212,1745877212.10927,-18000,,
com.leomehlig.today,47,1745875592,1745875639,1745875639.148047,-18000,,
com.google.Chrome,1268,1745874324,1745875592,1745875593.1170158,-18000,,
com.apple.news,116,1745874099,1745874215,1745874215.767339,-18000,EB445137-D7F5-57EC-87DA-1DB460D64046,"iPhone13,2"
com.microsoft.Office.Outlook,47,1745874041,1745874088,1745874089.09066,-18000,EB445137-D7F5-57EC-87DA-1DB460D64046,"iPhone13,2"
com.apple.weather,1,1745874040,1745874041,1745874041.6642141,-18000,EB445137-D7F5-57EC-87DA-1DB460D64046,"iPhone13,2"
com.google.Chrome,303,1745873989,1745874292,1745874292.2948751,-18000,,
com.leomehlig.today,17,1745873972,1745873989,1745873989.25073,-18000,,
com.apple.weather,38,1745871126,1745871164,1745871164.954793,-18000,EB445137-D7F5-57EC-87DA-1DB460D64046,"iPhone13,2"
com.google.Chrome,2858,1745871114,1745873972,1745873973.0420551,-18000,,
com.leomehlig.today,55,1745871059,1745871114,1745871114.838657,-18000,,
com.google.Chrome,6,1745871053,1745871059,1745871059.988603,-18000,,
com.apple.mobilephone,3,1745870880,1745870883,1745870883.3082619,-18000,EB445137-D7F5-57EC-87DA-1DB460D64046,"iPhone13,2"
com.apple.InCallService,1,1745870879,1745870880,1745870880.8554401,-18000,EB445137-D7F5-57EC-87DA-1DB460D64046,"iPhone13,2"
com.apple.InCallService,2,1745870126,1745870128,1745870128.362663,-18000,EB445137-D7F5-57EC-87DA-1DB460D64046,"iPhone13,2"
com.apple.mobilephone,4,1745870122,1745870126,1745870127.027992,-18000,EB445137-D7F5-57EC-87DA-1DB460D64046,"iPhone13,2"
com.apple.findmy,20,1745870101,1745870121,1745870122.0388079,-18000,EB445137-D7F5-57EC-87DA-1DB460D64046,"iPhone13,2"
com.apple.news,2,1745870099,1745870101,1745870101.462534,-18000,EB445137-D7F5-57EC-87DA-1DB460D64046,"iPhone13,2"
com.apple.news,29,1745866774,1745866803,1745866803.739527,-18000,EB445137-D7F5-57EC-87DA-1DB460D64046,"iPhone13,2"
com.instructure.icanvas,21,1745866749,1745866770,1745866770.47702,-18000,EB445137-D7F5-57EC-87DA-1DB460D64046,"iPhone13,2"
com.apple.news,479,1745865163,1745865642,1745865642.8488688,-18000,EB445137-D7F5-57EC-87DA-1DB460D64046,"iPhone13,2"
com.google.Chrome,550,1745862710,1745863260,1745863260.211362,-18000,,
com.apple.news,296,1745861288,1745861584,1745861584.17188,-18000,EB445137-D7F5-57EC-87DA-1DB460D64046,"iPhone13,2"
com.instructure.icanvas,59,1745861216,1745861275,1745861275.334961,-18000,EB445137-D7F5-57EC-87DA-1DB460D64046,"iPhone13,2"
com.groupme.iphone-app,7,1745861182,1745861189,1745861189.9661388,-18000,EB445137-D7F5-57EC-87DA-1DB460D64046,"iPhone13,2"
com.apple.news,317,1745860848,1745861165,1745861166.0150208,-18000,EB445137-D7F5-57EC-87DA-1DB460D64046,"iPhone13,2"
com.apple.news,115,1745860661,1745860776,1745860777.303117,-18000,EB445137-D7F5-57EC-87DA-1DB460D64046,"iPhone13,2"
com.instructure.icanvas,53,1745856018,1745856071,1745856071.816197,-18000,EB445137-D7F5-57EC-87DA-1DB460D64046,"iPhone13,2"
com.instructure.icanvas,190,1745855703,1745855893,1745855893.474977,-18000,EB445137-D7F5-57EC-87DA-1DB460D64046,"iPhone13,2"
com.apple.Health,101,1745855586,1745855687,1745855687.212615,-18000,EB445137-D7F5-57EC-87DA-1DB460D64046,"iPhone13,2"
com.apple.CoreAuthUI,4,1745855115,1745855119,1745855119.2902331,-18000,EB445137-D7F5-57EC-87DA-1DB460D64046,"iPhone13,2"
com.robinhood.release.Robinhood,30,1745855109,1745855139,1745855139.55344,-18000,EB445137-D7F5-57EC-87DA-1DB460D64046,"iPhone13,2"
com.hammerandchisel.discord,192,1745854913,1745855105,1745855105.253108,-18000,EB445137-D7F5-57EC-87DA-1DB460D64046,"iPhone13,2"
com.apple.Health,18,1745854861,1745854879,1745854879.6325588,-18000,EB445137-D7F5-57EC-87DA-1DB460D64046,"iPhone13,2"
com.groupme.iphone-app,3,1745854852,1745854855,1745854855.436435,-18000,EB445137-D7F5-57EC-87DA-1DB460D64046,"iPhone13,2"
com.leomehlig.today,115,1745854737,1745854852,1745854853.020277,-18000,EB445137-D7F5-57EC-87DA-1DB460D64046,"iPhone13,2"
com.microsoft.Office.Outlook,9,1745854721,1745854730,1745854730.1097121,-18000,EB445137-D7F5-57EC-87DA-1DB460D64046,"iPhone13,2"
com.apple.news,375,1745854344,1745854719,1745854719.097584,-18000,EB445137-D7F5-57EC-87DA-1DB460D64046,"iPhone13,2"
com.groupme.iphone-app,2,1745854342,1745854344,1745854345.0966702,-18000,EB445137-D7F5-57EC-87DA-1DB460D64046,"iPhone13,2"
com.apple.news,40,1745854302,1745854342,1745854343.059171,-18000,EB445137-D7F5-57EC-87DA-1DB460D64046,"iPhone13,2"
com.groupme.iphone-app,4,1745854298,1745854302,1745854302.4083462,-18000,EB445137-D7F5-57EC-87DA-1DB460D64046,"iPhone13,2"
com.apple.news,7,1745854291,1745854298,1745854300.320374,-18000,EB445137-D7F5-57EC-87DA-1DB460D64046,"iPhone13,2"
com.groupme.iphone-app,10,1745854278,1745854288,1745854288.0249891,-18000,EB445137-D7F5-57EC-87DA-1DB460D64046,"iPhone13,2"
com.leomehlig.today,30,1745854248,1745854278,1745854278.188426,-18000,EB445137-D7F5-57EC-87DA-1DB460D64046,"iPhone13,2"
com.google.Gmail,15,1745854224,1745854239,1745854239.171979,-18000,EB445137-D7F5-57EC-87DA-1DB460D64046,"iPhone13,2"
com.groupme.iphone-app,1,1745854223,1745854224,1745854224.189147,-18000,EB445137-D7F5-57EC-87DA-1DB460D64046,"iPhone13,2"
com.google.Chrome,192,1745853877,1745854069,1745854070.021222,-18000,,
com.google.Chrome,1405,1745852320,1745853725,1745853725.396515,-18000,,
com.groupme.iphone-app,25,1745851387,1745851412,1745851413.226609,-18000,EB445137-D7F5-57EC-87DA-1DB460D64046,"iPhone13,2"
com.instructure.icanvas,1,1745851382,1745851383,1745851383.972218,-18000,EB445137-D7F5-57EC-87DA-1DB460D64046,"iPhone13,2"
com.instructure.icanvas,10,1745851325,1745851335,1745851335.524685,-18000,EB445137-D7F5-57EC-87DA-1DB460D64046,"iPhone13,2"
com.instructure.icanvas,47,1745851268,1745851315,1745851315.941207,-18000,EB445137-D7F5-57EC-87DA-1DB460D64046,"iPhone13,2"
com.google.Chrome,1987,1745850306,1745852293,1745852293.68431,-18000,,
com.google.Chrome,324,1745849451,1745849775,1745849775.43175,-18000,,
com.google.Chrome,349,1745848774,1745849123,1745849123.273944,-18000,,
com.google.chrome.ios,181,1745847239,1745847420,1745847421.3706279,-18000,EB445137-D7F5-57EC-87DA-1DB460D64046,"iPhone13,2"
com.renpho.health,2,1745847237,1745847239,1745847239.460747,-18000,EB445137-D7F5-57EC-87DA-1DB460D64046,"iPhone13,2"
com.renpho.health,93,1745844565,1745844658,1745844659.3352919,-18000,EB445137-D7F5-57EC-87DA-1DB460D64046,"iPhone13,2"
com.apple.news,2,1745844563,1745844565,1745844565.085095,-18000,EB445137-D7F5-57EC-87DA-1DB460D64046,"iPhone13,2"
com.apple.news,496,1745843126,1745843622,1745843623.1487741,-18000,EB445137-D7F5-57EC-87DA-1DB460D64046,"iPhone13,2"
com.apple.mobiletimer,9,1745812291,1745812300,1745812300.254875,-18000,EB445137-D7F5-57EC-87DA-1DB460D64046,"iPhone13,2"
com.google.Chrome,733,1745811349,1745812082,1745812082.533842,-18000,,
com.leomehlig.today,1,1745811348,1745811349,1745811349.2988272,-18000,,
com.google.Chrome,7,1745811341,1745811348,1745811348.336484,-18000,,
com.google.chrome.ios,11,1745807190,1745807201,1745807201.7295241,-18000,EB445137-D7F5-57EC-87DA-1DB460D64046,"iPhone13,2"
com.google.chrome.ios,12,1745805415,1745805427,1745805427.56548,-18000,EB445137-D7F5-57EC-87DA-1DB460D64046,"iPhone13,2"
com.apple.news,2,1745805412,1745805414,1745805414.9631371,-18000,EB445137-D7F5-57EC-87DA-1DB460D64046,"iPhone13,2"
com.google.Chrome,5157,1745797040,1745802197,1745802197.857205,-18000,,
com.apple.finder,7,1745797033,1745797040,1745797040.3327188,-18000,,
com.apple.news,80,1745795669,1745795749,1745795749.63385,-18000,EB445137-D7F5-57EC-87DA-1DB460D64046,"iPhone13,2"
com.apple.Health,23,1745793824,1745793847,1745793847.451709,-18000,EB445137-D7F5-57EC-87DA-1DB460D64046,"iPhone13,2"
com.strava.stravaride,21,1745793802,1745793823,1745793823.374615,-18000,EB445137-D7F5-57EC-87DA-1DB460D64046,"iPhone13,2"
com.strava.stravaride,30,1745789614,1745789644,1745789644.8054528,-18000,EB445137-D7F5-57EC-87DA-1DB460D64046,"iPhone13,2"
com.strava.stravaride,41,1745789536,1745789577,1745789577.376114,-18000,EB445137-D7F5-57EC-87DA-1DB460D64046,"iPhone13,2"
com.apple.news,20,1745788221,1745788241,1745788241.978235,-18000,EB445137-D7F5-57EC-87DA-1DB460D64046,"iPhone13,2"
com.apple.news,11,1745785565,1745785576,1745785576.992887,-18000,EB445137-D7F5-57EC-87DA-1DB460D64046,"iPhone13,2"
com.apple.finder,5,1745780155,1745780160,1745780160.5589619,-18000,,
com.apple.Notes,2,1745780153,1745780155,1745780155.1000361,-18000,,
com.google.Chrome,15,1745780138,1745780153,1745780153.625348,-18000,,
com.apple.finder,2,1745780136,1745780138,1745780138.069827,-18000,,
com.leomehlig.today,7,1745780129,1745780136,1745780136.267137,-18000,,
com.apple.finder,14,1745780115,1745780129,1745780129.976958,-18000,,
com.google.Chrome,33,1745780082,1745780115,1745780115.923835,-18000,,
com.apple.Notes,37,1745780034,1745780071,1745780071.195818,-18000,,
com.apple.finder,3,1745780031,1745780034,1745780034.47493,-18000,,
com.leomehlig.today,111,1745779920,1745780031,1745780031.6140919,-18000,,
com.google.Chrome,31,1745779889,1745779920,1745779920.6728668,-18000,,
com.strava.stravaride,214,1745779674,1745779888,1745779888.778924,-18000,EB445137-D7F5-57EC-87DA-1DB460D64046,"iPhone13,2"
com.google.Chrome,365,1745779247,1745779612,1745779612.817719,-18000,,
com.leomehlig.today,25,1745779066,1745779091,1745779091.980202,-18000,,
com.google.Chrome,1,1745779065,1745779066,1745779066.7414532,-18000,,
com.leomehlig.today,5,1745779060,1745779065,1745779065.307095,-18000,,
com.google.Chrome,7,1745779053,1745779060,1745779060.404869,-18000,,
com.leomehlig.today,1,1745779052,1745779053,1745779053.893353,-18000,,
com.microsoft.VSCode,5,1745779047,1745779052,1745779052.350885,-18000,,
com.leomehlig.today,27,1745779020,1745779047,1745779047.9495149,-18000,,
com.google.Chrome,49,1745778971,1745779020,1745779020.433583,-18000,,
com.leomehlig.today,0,1745778971,1745778971,1745778971.8623261,-18000,,
com.apple.finder,2,1745778969,1745778971,1745778971.154944,-18000,,
com.microsoft.VSCode,20,1745778949,1745778969,1745778970.032615,-18000,,
com.leomehlig.today,1,1745778948,1745778949,1745778949.258553,-18000,,
com.microsoft.VSCode,41,1745778907,1745778948,1745778948.9091349,-18000,,
com.leomehlig.today,2,1745778905,1745778907,1745778907.6657429,-18000,,
com.microsoft.VSCode,14,1745778891,1745778905,1745778905.637119,-18000,,
com.google.Chrome,48,1745778843,1745778891,1745778891.13801,-18000,,
com.microsoft.VSCode,318,1745778514,1745778832,1745778832.46482,-18000,,
com.leomehlig.today,36,1745778478,1745778514,1745778514.1720371,-18000,,
com.google.Chrome,161,1745778317,1745778478,1745778478.344068,-18000,,
com.microsoft.VSCode,9,1745778308,1745778317,1745778317.5862598,-18000,,
com.google.Chrome,21,1745778287,1745778308,1745778308.089637,-18000,,
com.strava.stravaride,214,1745778273,1745778487,1745778487.729202,-18000,EB445137-D7F5-57EC-87DA-1DB460D64046,"iPhone13,2"
com.microsoft.VSCode,54,1745778233,1745778287,1745778287.872139,-18000,,
com.google.Chrome,5,1745778228,1745778233,1745778233.439515,-18000,,
com.microsoft.VSCode,9,1745778219,1745778228,1745778228.737337,-18000,,
com.google.Chrome,26,1745778193,1745778219,1745778219.436047,-18000,,
com.microsoft.VSCode,46,1745778147,1745778193,1745778193.849227,-18000,,
com.google.Chrome,10,1745778137,1745778147,1745778147.18228,-18000,,
com.microsoft.VSCode,1,1745778136,1745778137,1745778137.1915689,-18000,,
com.google.Chrome,2,1745778134,1745778136,1745778136.1289082,-18000,,
com.microsoft.VSCode,4,1745778130,1745778134,1745778134.718374,-18000,,
com.google.Chrome,15,1745778115,1745778130,1745778131.032926,-18000,,
com.microsoft.VSCode,35,1745778080,1745778115,1745778115.8909512,-18000,,
com.google.Chrome,7,1745778073,1745778080,1745778081.0041962,-18000,,
com.microsoft.VSCode,7,1745778066,1745778073,1745778073.87567,-18000,,
com.google.Chrome,1,1745778065,1745778066,1745778066.304556,-18000,,
com.microsoft.VSCode,12,1745778053,1745778065,1745778065.614172,-18000,,
com.google.Chrome,95,1745777958,1745778053,1745778053.2141972,-18000,,
com.microsoft.VSCode,274,1745777684,1745777958,1745777958.49735,-18000,,
com.google.Chrome,3,1745777681,1745777684,1745777684.603722,-18000,,
com.microsoft.VSCode,4,1745777677,1745777681,1745777681.432759,-18000,,
com.google.Chrome,1,1745777676,1745777677,1745777677.719654,-18000,,
com.microsoft.VSCode,5,1745777671,1745777676,1745777676.128273,-18000,,
com.google.Chrome,6,1745777665,1745777671,1745777671.544308,-18000,,
com.microsoft.VSCode,13,1745777652,1745777665,1745777665.8224978,-18000,,
com.google.Chrome,2,1745777650,1745777652,1745777652.672288,-18000,,
com.microsoft.VSCode,6,1745777644,1745777650,1745777650.3407679,-18000,,
com.google.Chrome,68,1745777576,1745777644,1745777644.3980432,-18000,,
com.microsoft.VSCode,136,1745777440,1745777576,1745777576.387288,-18000,,
com.google.Chrome,3,1745777437,1745777440,1745777440.622315,-18000,,
com.microsoft.VSCode,34,1745777403,1745777437,1745777437.280827,-18000,,
com.google.Chrome,13,1745777390,1745777403,1745777403.570082,-18000,,
com.microsoft.VSCode,4,1745777386,1745777390,1745777390.140565,-18000,,
com.leomehlig.today,1,1745777385,1745777386,1745777386.9264011,-18000,,
com.google.Chrome,126,1745777259,1745777385,1745777385.412508,-18000,,
com.leomehlig.today,1,1745777258,1745777259,1745777259.4664621,-18000,,
com.google.Chrome,15,1745777243,1745777258,1745777258.676893,-18000,,
com.microsoft.VSCode,4,1745777239,1745777243,1745777244.017103,-18000,,
com.google.Chrome,2,1745777237,1745777239,1745777239.899194,-18000,,
com.microsoft.VSCode,126,1745777111,1745777237,1745777237.856505,-18000,,
com.google.Chrome,1,1745777110,1745777111,1745777111.7822828,-18000,,
com.microsoft.VSCode,127,1745776983,1745777110,1745777110.090541,-18000,,
com.google.Chrome,6,1745776977,1745776983,1745776983.54333,-18000,,
com.microsoft.VSCode,39,1745776938,1745776977,1745776977.6921,-18000,,
com.google.Chrome,25,1745776913,1745776938,1745776938.060488,-18000,,
com.microsoft.VSCode,19,1745776894,1745776913,1745776913.577241,-18000,,
com.google.Chrome,27,1745776867,1745776894,1745776894.9619699,-18000,,
com.microsoft.VSCode,20,1745776847,1745776867,1745776868.0330791,-18000,,
com.google.Chrome,12,1745776835,1745776847,1745776847.1770911,-18000,,
com.microsoft.VSCode,1,1745776834,1745776835,1745776835.170537,-18000,,
com.google.Chrome,3,1745776831,1745776834,1745776834.2048779,-18000,,
com.microsoft.VSCode,35,1745776796,1745776831,1745776831.20638,-18000,,
com.google.Chrome,5,1745776791,1745776796,1745776796.4031281,-18000,,
com.microsoft.VSCode,1,1745776790,1745776791,1745776791.907037,-18000,,
com.google.Chrome,1,1745776789,1745776790,1745776790.336699,-18000,,
com.microsoft.VSCode,31,1745776758,1745776789,1745776789.4771662,-18000,,
com.google.Chrome,4,1745776754,1745776758,1745776758.508624,-18000,,
com.microsoft.VSCode,5,1745776749,1745776754,1745776754.6398911,-18000,,
com.google.Chrome,18,1745776731,1745776749,1745776749.667964,-18000,,
com.microsoft.VSCode,189,1745776542,1745776731,1745776731.95254,-18000,,
com.google.Chrome,3,1745776539,1745776542,1745776542.2120872,-18000,,
com.microsoft.VSCode,41,1745776498,1745776539,1745776539.576057,-18000,,
com.google.Chrome,6,1745776492,1745776498,1745776498.108161,-18000,,
com.microsoft.VSCode,31,1745776461,1745776492,1745776492.51102,-18000,,
com.google.Chrome,12,1745776449,1745776461,1745776461.735084,-18000,,
com.microsoft.VSCode,370,1745776079,1745776449,1745776449.482084,-18000,,
com.apple.news,227,1745775850,1745776077,1745776077.804443,-18000,EB445137-D7F5-57EC-87DA-1DB460D64046,"iPhone13,2"
com.microsoft.Office.Outlook,41,1745775792,1745775833,1745775833.5538821,-18000,EB445137-D7F5-57EC-87DA-1DB460D64046,"iPhone13,2"
com.apple.Health,1,1745775791,1745775792,1745775792.816097,-18000,EB445137-D7F5-57EC-87DA-1DB460D64046,"iPhone13,2"
com.microsoft.VSCode,302,1745775754,1745776056,1745776056.255766,-18000,,
com.google.Chrome,7,1745775747,1745775754,1745775754.320976,-18000,,
com.microsoft.VSCode,2,1745775745,1745775747,1745775747.48702,-18000,,
com.google.Chrome,1,1745775744,1745775745,1745775745.686151,-18000,,
com.microsoft.VSCode,2,1745775742,1745775744,1745775744.6193352,-18000,,
com.google.Chrome,1,1745775741,1745775742,1745775742.884303,-18000,,
com.microsoft.VSCode,1,1745775740,1745775741,1745775741.817237,-18000,,
com.google.Chrome,2,1745775738,1745775740,1745775740.1252751,-18000,,
com.microsoft.VSCode,2,1745775736,1745775738,1745775738.6802611,-18000,,
com.google.Chrome,1,1745775735,1745775736,1745775736.565959,-18000,,
com.microsoft.VSCode,34,1745775701,1745775735,1745775735.227531,-18000,,
com.google.Chrome,2,1745775699,1745775701,1745775702.012772,-18000,,
com.microsoft.VSCode,9,1745775690,1745775699,1745775699.232829,-18000,,
com.google.Chrome,1,1745775689,1745775690,1745775690.701798,-18000,,
com.microsoft.VSCode,79,1745775610,1745775689,1745775689.218093,-18000,,
com.google.Chrome,4,1745775606,1745775610,1745775610.191855,-18000,,
com.microsoft.VSCode,2,1745775604,1745775606,1745775606.699139,-18000,,
com.google.Chrome,8,1745775596,1745775604,1745775604.4199162,-18000,,
com.microsoft.VSCode,1,1745775595,1745775596,1745775596.76573,-18000,,
com.google.Chrome,3,1745775592,1745775595,1745775595.59062,-18000,,
com.microsoft.VSCode,1,1745775591,1745775592,1745775592.77324,-18000,,
com.google.Chrome,2,1745775589,1745775591,1745775591.903452,-18000,,
com.microsoft.VSCode,43,1745775546,1745775589,1745775589.444477,-18000,,
com.google.Chrome,2,1745775544,1745775546,1745775546.339912,-18000,,
com.microsoft.VSCode,19,1745775525,1745775544,1745775544.987153,-18000,,
com.google.Chrome,2,1745775523,1745775525,1745775525.964607,-18000,,
com.microsoft.VSCode,9,1745775514,1745775523,1745775523.444061,-18000,,
com.google.Chrome,3,1745775511,1745775514,1745775514.1948109,-18000,,
com.microsoft.VSCode,15,1745775496,1745775511,1745775512.0056682,-18000,,
com.google.Chrome,4,1745775492,1745775496,1745775496.493866,-18000,,
com.microsoft.VSCode,3,1745775489,1745775492,1745775492.535606,-18000,,
com.google.Chrome,3,1745775486,1745775489,1745775489.291071,-18000,,
com.microsoft.VSCode,7,1745775479,1745775486,1745775486.587432,-18000,,
com.google.Chrome,1,1745775478,1745775479,1745775479.489115,-18000,,
com.microsoft.VSCode,7,1745775471,1745775478,1745775478.216055,-18000,,
com.google.Chrome,18,1745775453,1745775471,1745775471.112434,-18000,,
com.microsoft.VSCode,17,1745775436,1745775453,1745775453.07286,-18000,,
com.google.Chrome,6,1745775430,1745775436,1745775436.093484,-18000,,
com.microsoft.VSCode,3,1745775427,1745775430,1745775430.523398,-18000,,
com.google.Chrome,1,1745775426,1745775427,1745775427.6589599,-18000,,
com.microsoft.VSCode,15,1745775411,1745775426,1745775426.409807,-18000,,
com.google.Chrome,11,1745775400,1745775411,1745775411.531925,-18000,,
com.microsoft.VSCode,40,1745775360,1745775400,1745775400.5616689,-18000,,
com.google.Chrome,4,1745775356,1745775360,1745775360.095924,-18000,,
com.microsoft.VSCode,9,1745775347,1745775356,1745775356.4206328,-18000,,
com.google.Chrome,12,1745775335,1745775347,1745775348.03568,-18000,,
com.microsoft.VSCode,39,1745775296,1745775335,1745775335.760165,-18000,,
com.google.Chrome,3,1745775293,1745775296,1745775297.005507,-18000,,
com.microsoft.VSCode,7,1745775286,1745775293,1745775294.0326428,-18000,,
com.google.Chrome,2,1745775284,1745775286,1745775286.636662,-18000,,
com.microsoft.VSCode,13,1745775271,1745775284,1745775284.87926,-18000,,
com.google.Chrome,3,1745775268,1745775271,1745775271.7688909,-18000,,
com.microsoft.VSCode,1,1745775267,1745775268,1745775268.135545,-18000,,
com.google.Chrome,1,1745775266,1745775267,1745775267.850146,-18000,,
com.microsoft.VSCode,1,1745775265,1745775266,1745775266.8905149,-18000,,
com.leomehlig.today,1,1745775264,1745775265,1745775265.534735,-18000,,
com.microsoft.VSCode,9,1745775255,1745775264,1745775264.744663,-18000,,
com.leomehlig.today,1,1745775254,1745775255,1745775255.875368,-18000,,
com.google.Chrome,3,1745775251,1745775254,1745775254.804885,-18000,,
com.leomehlig.today,0,1745775251,1745775251,1745775251.909198,-18000,,
com.microsoft.VSCode,23,1745775228,1745775251,1745775251.085071,-18000,,
com.leomehlig.today,3,1745775225,1745775228,1745775228.448413,-18000,,
com.microsoft.VSCode,17,1745775208,1745775225,1745775225.9274879,-18000,,
com.google.Chrome,5,1745775203,1745775208,1745775208.431845,-18000,,
com.microsoft.VSCode,7,1745775196,1745775203,1745775203.506985,-18000,,
com.google.Chrome,2,1745775194,1745775196,1745775196.290185,-18000,,
com.microsoft.VSCode,51,1745775143,1745775194,1745775194.741565,-18000,,
com.google.Chrome,5,1745775138,1745775143,1745775143.578668,-18000,,
com.microsoft.VSCode,5,1745775133,1745775138,1745775138.647573,-18000,,
com.google.Chrome,1,1745775132,1745775133,1745775133.610437,-18000,,
com.microsoft.VSCode,28,1745775104,1745775132,1745775132.6741939,-18000,,
com.google.Chrome,1,1745775103,1745775104,1745775104.81166,-18000,,
com.microsoft.VSCode,3,1745775100,1745775103,1745775103.6641788,-18000,,
com.google.Chrome,3,1745775097,1745775100,1745775100.18186,-18000,,
com.microsoft.VSCode,1,1745775096,1745775097,1745775097.5731769,-18000,,
com.google.Chrome,1,1745775095,1745775096,1745775096.1786652,-18000,,
com.microsoft.VSCode,2,1745775093,1745775095,1745775095.477509,-18000,,
com.google.Chrome,92,1745775001,1745775093,1745775093.830142,-18000,,
com.microsoft.VSCode,3,1745774998,1745775001,1745775001.123114,-18000,,
com.google.Chrome,1,1745774997,1745774998,1745774998.3552132,-18000,,
com.microsoft.VSCode,27,1745774970,1745774997,1745774997.500808,-18000,,
com.google.Chrome,43,1745774927,1745774970,1745774970.741335,-18000,,
com.microsoft.VSCode,18,1745774909,1745774927,1745774927.8259192,-18000,,
com.google.Chrome,3,1745774906,1745774909,1745774909.359535,-18000,,
com.microsoft.VSCode,2,1745774904,1745774906,1745774906.878149,-18000,,
com.google.Chrome,10,1745774894,1745774904,1745774904.256818,-18000,,
com.microsoft.VSCode,99,1745774795,1745774894,1745774894.2170172,-18000,,
com.google.Chrome,125,1745774670,1745774795,1745774795.304512,-18000,,
com.leomehlig.today,12,1745774658,1745774670,1745774670.7661638,-18000,,
com.google.Chrome,2156,1745772502,1745774658,1745774658.321529,-18000,,
com.apple.iCal,15,1745772487,1745772502,1745772502.796139,-18000,,
com.google.Chrome,6,1745772481,1745772487,1745772487.8001518,-18000,,
com.apple.iCal,9,1745772472,1745772481,1745772481.065164,-18000,,
com.google.Chrome,12,1745772460,1745772472,1745772472.090644,-18000,,
com.leomehlig.today,140,1745772320,1745772460,1745772461.037359,-18000,,
com.google.Chrome,36,1745772284,1745772320,1745772320.981158,-18000,,
com.apple.Health,119,1745772098,1745772217,1745772218.172538,-18000,EB445137-D7F5-57EC-87DA-1DB460D64046,"iPhone13,2"
com.renpho.health,0,1745772098,1745772098,1745772099.337578,-18000,EB445137-D7F5-57EC-87DA-1DB460D64046,"iPhone13,2"
com.renpho.health,22,1745771280,1745771302,1745771303.3077831,-18000,EB445137-D7F5-57EC-87DA-1DB460D64046,"iPhone13,2"
com.apple.Health,6,1745771271,1745771277,1745771277.9792309,-18000,EB445137-D7F5-57EC-87DA-1DB460D64046,"iPhone13,2"
com.apple.news,2,1745771266,1745771268,1745771269.1379929,-18000,EB445137-D7F5-57EC-87DA-1DB460D64046,"iPhone13,2"
com.apple.news,1771,1745764796,1745766567,1745766568.225655,-18000,EB445137-D7F5-57EC-87DA-1DB460D64046,"iPhone13,2"
com.apple.Preferences,50,1745764738,1745764788,1745764788.050472,-18000,EB445137-D7F5-57EC-87DA-1DB460D64046,"iPhone13,2"
com.toyopagroup.picaboo,0,1745764738,1745764738,1745764738.7458858,-18000,EB445137-D7F5-57EC-87DA-1DB460D64046,"iPhone13,2"
com.toyopagroup.picaboo,42,1745764685,1745764727,1745764727.187399,-18000,EB445137-D7F5-57EC-87DA-1DB460D64046,"iPhone13,2"
com.apple.mobiletimer,0,1745764685,1745764685,1745764685.611134,-18000,EB445137-D7F5-57EC-87DA-1DB460D64046,"iPhone13,2"
com.apple.mobiletimer,2,1745764677,1745764679,1745764680.355196,-18000,EB445137-D7F5-57EC-87DA-1DB460D64046,"iPhone13,2"
com.apple.mobiletimer,17,1745728823,1745728840,1745728840.3742042,-18000,EB445137-D7F5-57EC-87DA-1DB460D64046,"iPhone13,2"
com.google.chrome.ios,4,1745728819,1745728823,1745728823.228163,-18000,EB445137-D7F5-57EC-87DA-1DB460D64046,"iPhone13,2"
com.google.Chrome,18,1745728161,1745728179,1745728180.243267,-18000,,
com.google.Chrome,338,1745726836,1745727174,1745727174.593955,-18000,,
com.google.Chrome,302,1745725669,1745725971,1745725971.638897,-18000,,
com.google.Chrome,407,1745721558,1745721965,1745721965.83559,-18000,,
com.google.chrome.ios,197,1745720834,1745721031,1745721033.267205,-18000,EB445137-D7F5-57EC-87DA-1DB460D64046,"iPhone13,2"
com.google.chrome.ios,26,1745720752,1745720778,1745720778.9595032,-18000,EB445137-D7F5-57EC-87DA-1DB460D64046,"iPhone13,2"
com.apple.news,1,1745720751,1745720752,1745720752.891722,-18000,EB445137-D7F5-57EC-87DA-1DB460D64046,"iPhone13,2"
com.apple.news,703,1745720023,1745720726,1745720726.472059,-18000,EB445137-D7F5-57EC-87DA-1DB460D64046,"iPhone13,2"
com.apple.Preferences,1,1745720009,1745720010,1745720010.981244,-18000,EB445137-D7F5-57EC-87DA-1DB460D64046,"iPhone13,2"
com.toyopagroup.picaboo,33,1745719821,1745719854,1745719854.719936,-18000,EB445137-D7F5-57EC-87DA-1DB460D64046,"iPhone13,2"
com.apple.news,417,1745701548,1745701965,1745701965.09552,-18000,EB445137-D7F5-57EC-87DA-1DB460D64046,"iPhone13,2"
com.tinyspeck.chatlyio,2,1745701499,1745701501,1745701501.065242,-18000,EB445137-D7F5-57EC-87DA-1DB460D64046,"iPhone13,2"
com.apple.MobileSMS,10,1745701483,1745701493,1745701493.4398699,-18000,EB445137-D7F5-57EC-87DA-1DB460D64046,"iPhone13,2"
com.apple.MobileSMS,1,1745701480,1745701481,1745701481.901639,-18000,EB445137-D7F5-57EC-87DA-1DB460D64046,"iPhone13,2"
com.apple.PassbookUIService,7,1745701463,1745701470,1745701470.886808,-18000,EB445137-D7F5-57EC-87DA-1DB460D64046,"iPhone13,2"
com.apple.MobileSMS,44,1745701434,1745701478,1745701478.7409348,-18000,EB445137-D7F5-57EC-87DA-1DB460D64046,"iPhone13,2"
com.toyopagroup.picaboo,53,1745701379,1745701432,1745701432.518986,-18000,EB445137-D7F5-57EC-87DA-1DB460D64046,"iPhone13,2"
com.google.chrome.ios,1,1745701378,1745701379,1745701379.567926,-18000,EB445137-D7F5-57EC-87DA-1DB460D64046,"iPhone13,2"
com.google.chrome.ios,103,1745699019,1745699122,1745699122.831799,-18000,EB445137-D7F5-57EC-87DA-1DB460D64046,"iPhone13,2"
com.toyopagroup.picaboo,16,1745697322,1745697338,1745697338.8035002,-18000,EB445137-D7F5-57EC-87DA-1DB460D64046,"iPhone13,2"
com.apple.MobileSMS,31,1745694873,1745694904,1745694904.148438,-18000,EB445137-D7F5-57EC-87DA-1DB460D64046,"iPhone13,2"
com.supercell.magic,208,1745694665,1745694873,1745694873.647884,-18000,EB445137-D7F5-57EC-87DA-1DB460D64046,"iPhone13,2"
com.apple.news,403,1745694201,1745694604,1745694604.792222,-18000,EB445137-D7F5-57EC-87DA-1DB460D64046,"iPhone13,2"
com.apple.MobileSMS,4,1745694197,1745694201,1745694201.550209,-18000,EB445137-D7F5-57EC-87DA-1DB460D64046,"iPhone13,2"
com.apple.news,150,1745694046,1745694196,1745694196.662957,-18000,EB445137-D7F5-57EC-87DA-1DB460D64046,"iPhone13,2"
com.toyopagroup.picaboo,14,1745694029,1745694043,1745694043.421248,-18000,EB445137-D7F5-57EC-87DA-1DB460D64046,"iPhone13,2"
com.apple.MobileSMS,8,1745694018,1745694026,1745694026.4526172,-18000,EB445137-D7F5-57EC-87DA-1DB460D64046,"iPhone13,2"
com.apple.MobileSMS,8,1745694009,1745694017,1745694017.121217,-18000,EB445137-D7F5-57EC-87DA-1DB460D64046,"iPhone13,2"
com.apple.MobileSMS,2,1745693014,1745693016,1745693016.2545419,-18000,EB445137-D7F5-57EC-87DA-1DB460D64046,"iPhone13,2"
com.apple.MobileSMS,9,1745692751,1745692760,1745692760.349627,-18000,EB445137-D7F5-57EC-87DA-1DB460D64046,"iPhone13,2"
com.apple.MobileSMS,24,1745692531,1745692555,1745692555.9906878,-18000,EB445137-D7F5-57EC-87DA-1DB460D64046,"iPhone13,2"
com.toyopagroup.picaboo,7,1745692524,1745692531,1745692531.600081,-18000,EB445137-D7F5-57EC-87DA-1DB460D64046,"iPhone13,2"
com.toyopagroup.picaboo,11,1745692104,1745692115,1745692115.8222651,-18000,EB445137-D7F5-57EC-87DA-1DB460D64046,"iPhone13,2"
com.toyopagroup.picaboo,7,1745689091,1745689098,1745689099.198492,-18000,EB445137-D7F5-57EC-87DA-1DB460D64046,"iPhone13,2"
com.toyopagroup.picaboo,4,1745689085,1745689089,1745689090.1160069,-18000,EB445137-D7F5-57EC-87DA-1DB460D64046,"iPhone13,2"
com.toyopagroup.picaboo,24,1745688232,1745688256,1745688256.804226,-18000,EB445137-D7F5-57EC-87DA-1DB460D64046,"iPhone13,2"
com.apple.Music,0,1745688232,1745688232,1745688233.5117269,-18000,EB445137-D7F5-57EC-87DA-1DB460D64046,"iPhone13,2"
com.apple.Music,30,1745687375,1745687405,1745687406.114399,-18000,EB445137-D7F5-57EC-87DA-1DB460D64046,"iPhone13,2"
com.toyopagroup.picaboo,42,1745685340,1745685382,1745685382.2371511,-18000,EB445137-D7F5-57EC-87DA-1DB460D64046,"iPhone13,2"
com.apple.Maps,2,1745685336,1745685338,1745685338.084583,-18000,EB445137-D7F5-57EC-87DA-1DB460D64046,"iPhone13,2"
com.apple.Maps,15,1745685200,1745685215,1745685216.147287,-18000,EB445137-D7F5-57EC-87DA-1DB460D64046,"iPhone13,2"
com.apple.news,1,1745685198,1745685199,1745685199.900368,-18000,EB445137-D7F5-57EC-87DA-1DB460D64046,"iPhone13,2"
com.apple.news,238,1745684094,1745684332,1745684333.158584,-18000,EB445137-D7F5-57EC-87DA-1DB460D64046,"iPhone13,2"
com.apple.MobileSMS,4,1745684085,1745684089,1745684090.035781,-18000,EB445137-D7F5-57EC-87DA-1DB460D64046,"iPhone13,2"
com.hammerandchisel.discord,11,1745682489,1745682500,1745682500.435736,-18000,EB445137-D7F5-57EC-87DA-1DB460D64046,"iPhone13,2"
com.apple.weather,2,1745682487,1745682489,1745682489.110646,-18000,EB445137-D7F5-57EC-87DA-1DB460D64046,"iPhone13,2"
com.apple.weather,14,1745681431,1745681445,1745681445.912527,-18000,EB445137-D7F5-57EC-87DA-1DB460D64046,"iPhone13,2"
com.apple.weather,5,1745681105,1745681110,1745681110.5428991,-18000,EB445137-D7F5-57EC-87DA-1DB460D64046,"iPhone13,2"
com.renpho.health,2,1745681103,1745681105,1745681105.216467,-18000,EB445137-D7F5-57EC-87DA-1DB460D64046,"iPhone13,2"
com.renpho.health,28,1745678881,1745678909,1745678909.920263,-18000,EB445137-D7F5-57EC-87DA-1DB460D64046,"iPhone13,2"
com.apple.weather,2,1745678878,1745678880,1745678880.88336,-18000,EB445137-D7F5-57EC-87DA-1DB460D64046,"iPhone13,2"
com.apple.weather,27,1745678813,1745678840,1745678840.663103,-18000,EB445137-D7F5-57EC-87DA-1DB460D64046,"iPhone13,2"
com.apple.news,597,1745678213,1745678810,1745678810.728591,-18000,EB445137-D7F5-57EC-87DA-1DB460D64046,"iPhone13,2"
com.apple.mobiletimer,2,1745678202,1745678204,1745678204.516669,-18000,EB445137-D7F5-57EC-87DA-1DB460D64046,"iPhone13,2"
com.apple.mobiletimer,8,1745669731,1745669739,1745669739.8207622,-18000,EB445137-D7F5-57EC-87DA-1DB460D64046,"iPhone13,2"
com.apple.weather,7,1745641357,1745641364,1745641364.827457,-18000,EB445137-D7F5-57EC-87DA-1DB460D64046,"iPhone13,2"
com.apple.mobiletimer,1,1745641356,1745641357,1745641357.482971,-18000,EB445137-D7F5-57EC-87DA-1DB460D64046,"iPhone13,2"
com.apple.mobiletimer,11,1745641341,1745641352,1745641352.287685,-18000,EB445137-D7F5-57EC-87DA-1DB460D64046,"iPhone13,2"
com.apple.MobileSMS,6,1745641270,1745641276,1745641276.488082,-18000,EB445137-D7F5-57EC-87DA-1DB460D64046,"iPhone13,2"
com.microsoft.Office.Outlook,0,1745641270,1745641270,1745641271.292129,-18000,EB445137-D7F5-57EC-87DA-1DB460D64046,"iPhone13,2"
com.microsoft.Office.Outlook,48,1745641221,1745641269,1745641269.482964,-18000,EB445137-D7F5-57EC-87DA-1DB460D64046,"iPhone13,2"
com.toyopagroup.picaboo,39,1745641011,1745641050,1745641050.251946,-18000,EB445137-D7F5-57EC-87DA-1DB460D64046,"iPhone13,2"
com.google.chrome.ios,0,1745641011,1745641011,1745641012.802016,-18000,EB445137-D7F5-57EC-87DA-1DB460D64046,"iPhone13,2"
com.google.Chrome,4,1745633943,1745633947,1745633947.426111,-18000,,
com.google.Chrome,350,1745632569,1745632919,1745632919.262868,-18000,,
com.google.Chrome,323,1745631062,1745631385,1745631385.5709429,-18000,,
com.google.Chrome,311,1745630390,1745630701,1745630701.343137,-18000,,
com.google.Chrome,495,1745629522,1745630017,1745630017.987773,-18000,,
com.google.Chrome,359,1745628098,1745628457,1745628457.075386,-18000,,
com.google.Chrome,474,1745626560,1745627034,1745627034.029835,-18000,,
com.apple.finder,1,1745626559,1745626560,1745626564.143077,-18000,,
com.google.chrome.ios,53,1745623965,1745624018,1745624019.213702,-18000,EB445137-D7F5-57EC-87DA-1DB460D64046,"iPhone13,2"
com.google.chrome.ios,25,1745623830,1745623855,1745623856.0552092,-18000,EB445137-D7F5-57EC-87DA-1DB460D64046,"iPhone13,2"
com.apple.mobilecal,15,1745621321,1745621336,1745621336.875149,-18000,EB445137-D7F5-57EC-87DA-1DB460D64046,"iPhone13,2"
com.microsoft.Office.Outlook,12,1745621304,1745621316,1745621317.039408,-18000,EB445137-D7F5-57EC-87DA-1DB460D64046,"iPhone13,2"
com.google.Gmail,27,1745621261,1745621288,1745621288.733933,-18000,EB445137-D7F5-57EC-87DA-1DB460D64046,"iPhone13,2"
com.microsoft.Office.Outlook,0,1745621261,1745621261,1745621263.855787,-18000,EB445137-D7F5-57EC-87DA-1DB460D64046,"iPhone13,2"
com.microsoft.Office.Outlook,18,1745620940,1745620958,1745620959.0976958,-18000,EB445137-D7F5-57EC-87DA-1DB460D64046,"iPhone13,2"
com.toyopagroup.picaboo,16,1745620498,1745620514,1745620514.5693002,-18000,EB445137-D7F5-57EC-87DA-1DB460D64046,"iPhone13,2"
com.apple.MobileSMS,18,1745617360,1745617378,1745617378.710445,-18000,EB445137-D7F5-57EC-87DA-1DB460D64046,"iPhone13,2"
com.google.chrome.ios,8,1745616931,1745616939,1745616939.0494552,-18000,EB445137-D7F5-57EC-87DA-1DB460D64046,"iPhone13,2"
com.toyopagroup.picaboo,5,1745616061,1745616066,1745616067.222362,-18000,EB445137-D7F5-57EC-87DA-1DB460D64046,"iPhone13,2"
com.google.chrome.ios,6,1745616038,1745616044,1745616044.599564,-18000,EB445137-D7F5-57EC-87DA-1DB460D64046,"iPhone13,2"
com.toyopagroup.picaboo,5,1745611373,1745611378,1745611379.067408,-18000,EB445137-D7F5-57EC-87DA-1DB460D64046,"iPhone13,2"
com.microsoft.Office.Outlook,0,1745611373,1745611373,1745611373.9414659,-18000,EB445137-D7F5-57EC-87DA-1DB460D64046,"iPhone13,2"
com.microsoft.Office.Outlook,31,1745611336,1745611367,1745611369.150914,-18000,EB445137-D7F5-57EC-87DA-1DB460D64046,"iPhone13,2"
com.apple.MobileSMS,7,1745611329,1745611336,1745611336.36313,-18000,EB445137-D7F5-57EC-87DA-1DB460D64046,"iPhone13,2"
com.apple.Maps,0,1745611329,1745611329,1745611331.136502,-18000,EB445137-D7F5-57EC-87DA-1DB460D64046,"iPhone13,2"
com.apple.Maps,4,1745605878,1745605882,1745605883.1220388,-18000,EB445137-D7F5-57EC-87DA-1DB460D64046,"iPhone13,2"
com.apple.Maps,11,1745605480,1745605491,1745605491.984216,-18000,EB445137-D7F5-57EC-87DA-1DB460D64046,"iPhone13,2"
com.apple.Maps,13,1745605466,1745605479,1745605479.305444,-18000,EB445137-D7F5-57EC-87DA-1DB460D64046,"iPhone13,2"
Astrospheric.Astrospheric,1,1745605464,1745605465,1745605465.954403,-18000,EB445137-D7F5-57EC-87DA-1DB460D64046,"iPhone13,2"
Astrospheric.Astrospheric,9,1745605216,1745605225,1745605225.509839,-18000,EB445137-D7F5-57EC-87DA-1DB460D64046,"iPhone13,2"
com.apple.weather,5,1745604495,1745604500,1745604500.862304,-18000,EB445137-D7F5-57EC-87DA-1DB460D64046,"iPhone13,2"
com.apple.finder,69,1745604289,1745604358,1745604358.681171,-18000,,
com.google.Chrome,652,1745603637,1745604289,1745604289.543363,-18000,,
com.apple.finder,1,1745603636,1745603637,1745603637.31184,-18000,,
com.leomehlig.today,107,1745603529,1745603636,1745603636.491788,-18000,,
com.apple.finder,23,1745603506,1745603529,1745603529.411611,-18000,,
com.google.Chrome,18,1745603488,1745603506,1745603506.6263518,-18000,,
com.leomehlig.today,30,1745603458,1745603488,1745603488.937731,-18000,,
com.apple.iCal,7,1745603451,1745603458,1745603459.051556,-18000,,
com.leomehlig.today,17,1745603434,1745603451,1745603451.6079311,-18000,,
com.google.Chrome,8,1745603426,1745603434,1745603434.602707,-18000,,
com.apple.news,73,1745603031,1745603104,1745603105.029416,-18000,EB445137-D7F5-57EC-87DA-1DB460D64046,"iPhone13,2"
com.google.chrome.ios,54,1745602971,1745603025,1745603026.0400271,-18000,EB445137-D7F5-57EC-87DA-1DB460D64046,"iPhone13,2"
com.apple.news,862,1745601711,1745602573,1745602573.525333,-18000,EB445137-D7F5-57EC-87DA-1DB460D64046,"iPhone13,2"
com.google.chrome.ios,159,1745601550,1745601709,1745601709.175189,-18000,EB445137-D7F5-57EC-87DA-1DB460D64046,"iPhone13,2"
com.microsoft.Office.Outlook,5,1745601541,1745601546,1745601546.713434,-18000,EB445137-D7F5-57EC-87DA-1DB460D64046,"iPhone13,2"
com.apple.MobileSMS,62,1745601478,1745601540,1745601541.0527859,-18000,EB445137-D7F5-57EC-87DA-1DB460D64046,"iPhone13,2"
com.google.chrome.ios,0,1745601478,1745601478,1745601479.908445,-18000,EB445137-D7F5-57EC-87DA-1DB460D64046,"iPhone13,2"
com.google.chrome.ios,9,1745600368,1745600377,1745600378.264701,-18000,EB445137-D7F5-57EC-87DA-1DB460D64046,"iPhone13,2"
com.google.chrome.ios,9,1745599811,1745599820,1745599820.5561619,-18000,EB445137-D7F5-57EC-87DA-1DB460D64046,"iPhone13,2"
com.google.chrome.ios,10,1745598217,1745598227,1745598227.6827111,-18000,EB445137-D7F5-57EC-87DA-1DB460D64046,"iPhone13,2"
com.apple.news,3,1745598214,1745598217,1745598217.534006,-18000,EB445137-D7F5-57EC-87DA-1DB460D64046,"iPhone13,2"
com.apple.news,211,1745597376,1745597587,1745597588.245157,-18000,EB445137-D7F5-57EC-87DA-1DB460D64046,"iPhone13,2"
com.google.chrome.ios,7,1745597366,1745597373,1745597373.975157,-18000,EB445137-D7F5-57EC-87DA-1DB460D64046,"iPhone13,2"
com.google.chrome.ios,39,1745597059,1745597098,1745597099.775851,-18000,EB445137-D7F5-57EC-87DA-1DB460D64046,"iPhone13,2"
com.apple.news,2,1745597054,1745597056,1745597056.435546,-18000,EB445137-D7F5-57EC-87DA-1DB460D64046,"iPhone13,2"
com.apple.news,165,1745596707,1745596872,1745596872.8949351,-18000,EB445137-D7F5-57EC-87DA-1DB460D64046,"iPhone13,2"
com.apple.Health,20,1745596678,1745596698,1745596698.616075,-18000,EB445137-D7F5-57EC-87DA-1DB460D64046,"iPhone13,2"
com.google.Chrome,88,1745596578,1745596666,1745596666.7937589,-18000,,
com.leomehlig.today,2,1745596501,1745596503,1745596504.250895,-18000,,
com.google.Chrome,20,1745596481,1745596501,1745596501.247066,-18000,,
com.leomehlig.today,2,1745596479,1745596481,1745596482.4344,-18000,,
com.apple.CoreAuthUI,2,1745591923,1745591925,1745591925.149108,-18000,EB445137-D7F5-57EC-87DA-1DB460D64046,"iPhone13,2"
com.apple.Passwords,17,1745591921,1745591938,1745591938.332243,-18000,EB445137-D7F5-57EC-87DA-1DB460D64046,"iPhone13,2"
com.apple.weather,2,1745591915,1745591917,1745591917.454908,-18000,EB445137-D7F5-57EC-87DA-1DB460D64046,"iPhone13,2"
com.apple.weather,5,1745591892,1745591897,1745591897.691488,-18000,EB445137-D7F5-57EC-87DA-1DB460D64046,"iPhone13,2"
com.leomehlig.today,12,1745591713,1745591725,1745591725.106454,-18000,,
com.google.Chrome,44,1745591669,1745591713,1745591713.9967818,-18000,,
com.leomehlig.today,1,1745591668,1745591669,1745591669.797606,-18000,,
com.google.Chrome,35,1745591633,1745591668,1745591668.2925792,-18000,,
com.apple.finder,89,1745591544,1745591633,1745591633.133184,-18000,,
com.microsoft.Office.Outlook,21,1745590613,1745590634,1745590634.4698029,-18000,EB445137-D7F5-57EC-87DA-1DB460D64046,"iPhone13,2"
com.renpho.health,1,1745590612,1745590613,1745590613.2438579,-18000,EB445137-D7F5-57EC-87DA-1DB460D64046,"iPhone13,2"
com.google.Chrome,2012,1745589532,1745591544,1745591544.078991,-18000,,
com.leomehlig.today,19,1745589513,1745589532,1745589532.9651918,-18000,,
com.apple.MobileSMS,9,1745589504,1745589513,1745589513.554072,-18000,,
com.leomehlig.today,2,1745589502,1745589504,1745589504.551978,-18000,,
com.google.Chrome,417,1745589085,1745589502,1745589502.915049,-18000,,
com.google.Chrome,374,1745588083,1745588457,1745588457.3440518,-18000,,
com.apple.news,72,1745588011,1745588083,1745588083.453905,-18000,,
com.google.Chrome,39,1745587972,1745588011,1745588011.70998,-18000,,
com.leomehlig.today,4,1745587968,1745587972,1745587972.053025,-18000,,
com.renpho.health,11,1745587709,1745587720,1745587720.419369,-18000,EB445137-D7F5-57EC-87DA-1DB460D64046,"iPhone13,2"
com.renpho.health,48,1745587131,1745587179,1745587179.804943,-18000,EB445137-D7F5-57EC-87DA-1DB460D64046,"iPhone13,2"
com.apple.weather,9,1745586026,1745586035,1745586035.385853,-18000,EB445137-D7F5-57EC-87DA-1DB460D64046,"iPhone13,2"
com.toyopagroup.picaboo,11,1745551694,1745551705,1745551705.950803,-18000,EB445137-D7F5-57EC-87DA-1DB460D64046,"iPhone13,2"
com.leomehlig.today,2,1745551277,1745551279,1745551279.107314,-18000,,
com.google.Chrome,184,1745551093,1745551277,1745551277.987128,-18000,,
com.google.Chrome,302,1745550734,1745551036,1745551036.339025,-18000,,
com.google.Chrome,564,1745549850,1745550414,1745550414.1312819,-18000,,
com.google.Chrome,2133,1745547563,1745549696,1745549696.547868,-18000,,
com.google.Chrome,18,1745547466,1745547484,1745547484.1881418,-18000,,
com.apple.MobileSMS,4,1745547462,1745547466,1745547466.393464,-18000,,
com.google.Chrome,4,1745547458,1745547462,1745547462.736764,-18000,,
com.leomehlig.today,54,1745547404,1745547458,1745547458.1866388,-18000,,
com.google.Chrome,80,1745547324,1745547404,1745547405.015431,-18000,,
com.apple.MobileSMS,8,1745546855,1745546863,1745546863.947989,-18000,EB445137-D7F5-57EC-87DA-1DB460D64046,"iPhone13,2"
com.apple.news,48,1745546800,1745546848,1745546848.565184,-18000,EB445137-D7F5-57EC-87DA-1DB460D64046,"iPhone13,2"
Astrospheric.Astrospheric,15,1745546772,1745546787,1745546788.027135,-18000,EB445137-D7F5-57EC-87DA-1DB460D64046,"iPhone13,2"
com.hammerandchisel.discord,30,1745546740,1745546770,1745546770.245887,-18000,EB445137-D7F5-57EC-87DA-1DB460D64046,"iPhone13,2"
com.apple.MobileSMS,16,1745546712,1745546728,1745546728.22466,-18000,EB445137-D7F5-57EC-87DA-1DB460D64046,"iPhone13,2"
com.toyopagroup.picaboo,16,1745545129,1745545145,1745545145.3263788,-18000,EB445137-D7F5-57EC-87DA-1DB460D64046,"iPhone13,2"
com.hammerandchisel.discord,1,1745545128,1745545129,1745545129.752775,-18000,EB445137-D7F5-57EC-87DA-1DB460D64046,"iPhone13,2"
com.hammerandchisel.discord,13,1745544269,1745544282,1745544283.2532291,-18000,EB445137-D7F5-57EC-87DA-1DB460D64046,"iPhone13,2"
com.apple.news,173,1745537907,1745538080,1745538080.671698,-18000,EB445137-D7F5-57EC-87DA-1DB460D64046,"iPhone13,2"
com.apple.news,166,1745537685,1745537851,1745537852.589902,-18000,EB445137-D7F5-57EC-87DA-1DB460D64046,"iPhone13,2"
com.apple.MobileSMS,36,1745537510,1745537546,1745537546.246273,-18000,EB445137-D7F5-57EC-87DA-1DB460D64046,"iPhone13,2"
com.apple.mobileslideshow,4,1745537506,1745537510,1745537511.437426,-18000,EB445137-D7F5-57EC-87DA-1DB460D64046,"iPhone13,2"
com.apple.MobileSMS,28,1745537475,1745537503,1745537503.083431,-18000,EB445137-D7F5-57EC-87DA-1DB460D64046,"iPhone13,2"
com.microsoft.Office.Outlook,13,1745537462,1745537475,1745537475.784669,-18000,EB445137-D7F5-57EC-87DA-1DB460D64046,"iPhone13,2"
com.hammerandchisel.discord,17,1745537442,1745537459,1745537459.4109359,-18000,EB445137-D7F5-57EC-87DA-1DB460D64046,"iPhone13,2"
com.apple.mobiletimer,0,1745537442,1745537442,1745537442.852442,-18000,EB445137-D7F5-57EC-87DA-1DB460D64046,"iPhone13,2"
com.apple.mobiletimer,8,1745537172,1745537180,1745537180.281724,-18000,EB445137-D7F5-57EC-87DA-1DB460D64046,"iPhone13,2"
com.apple.calculator,3,1745537169,1745537172,1745537172.774901,-18000,EB445137-D7F5-57EC-87DA-1DB460D64046,"iPhone13,2"
com.myfitnesspal.mfp,61,1745535997,1745536058,1745536058.5732288,-18000,EB445137-D7F5-57EC-87DA-1DB460D64046,"iPhone13,2"
com.myfitnesspal.mfp,106,1745535777,1745535883,1745535884.251497,-18000,EB445137-D7F5-57EC-87DA-1DB460D64046,"iPhone13,2"
com.myfitnesspal.mfp,97,1745535419,1745535516,1745535516.298625,-18000,EB445137-D7F5-57EC-87DA-1DB460D64046,"iPhone13,2"
com.toyopagroup.picaboo,3,1745535414,1745535417,1745535417.0413399,-18000,EB445137-D7F5-57EC-87DA-1DB460D64046,"iPhone13,2"
com.toyopagroup.picaboo,15,1745534639,1745534654,1745534654.7068582,-18000,EB445137-D7F5-57EC-87DA-1DB460D64046,"iPhone13,2"
com.apple.InCallService,3,1745533404,1745533407,1745533407.460229,-18000,EB445137-D7F5-57EC-87DA-1DB460D64046,"iPhone13,2"
com.apple.mobilephone,11,1745533393,1745533404,1745533405.505252,-18000,EB445137-D7F5-57EC-87DA-1DB460D64046,"iPhone13,2"
com.apple.findmy,6,1745533386,1745533392,1745533392.988913,-18000,EB445137-D7F5-57EC-87DA-1DB460D64046,"iPhone13,2"
com.google.Chrome,2,1745533264,1745533266,1745533267.026227,-18000,,
com.leomehlig.today,65,1745533199,1745533264,1745533264.594544,-18000,,
com.apple.findmy,15,1745532833,1745532848,1745532849.862406,-18000,EB445137-D7F5-57EC-87DA-1DB460D64046,"iPhone13,2"
com.apple.news,2,1745532831,1745532833,1745532837.360729,-18000,EB445137-D7F5-57EC-87DA-1DB460D64046,"iPhone13,2"
com.google.Chrome,591,1745532608,1745533199,1745533200.013546,-18000,,
com.google.Chrome,540,1745531962,1745532502,1745532502.270062,-18000,,
com.apple.news,261,1745531472,1745531733,1745531734.703515,-18000,EB445137-D7F5-57EC-87DA-1DB460D64046,"iPhone13,2"
com.apple.findmy,0,1745531472,1745531472,1745531473.322578,-18000,EB445137-D7F5-57EC-87DA-1DB460D64046,"iPhone13,2"
com.apple.findmy,13,1745531425,1745531438,1745531439.382038,-18000,EB445137-D7F5-57EC-87DA-1DB460D64046,"iPhone13,2"
com.google.Chrome,303,1745531410,1745531713,1745531713.1120439,-18000,,
com.apple.Music,6,1745531404,1745531410,1745531410.673881,-18000,,
com.microsoft.Office.Outlook,5,1745530682,1745530687,1745530687.616379,-18000,EB445137-D7F5-57EC-87DA-1DB460D64046,"iPhone13,2"
com.hammerandchisel.discord,0,1745530682,1745530682,1745530682.9621692,-18000,EB445137-D7F5-57EC-87DA-1DB460D64046,"iPhone13,2"
com.hammerandchisel.discord,28,1745530654,1745530682,1745530682.180128,-18000,EB445137-D7F5-57EC-87DA-1DB460D64046,"iPhone13,2"
com.apple.MobileSMS,2,1745530652,1745530654,1745530654.106048,-18000,EB445137-D7F5-57EC-87DA-1DB460D64046,"iPhone13,2"
com.google.Chrome,1270,1745530134,1745531404,1745531404.92186,-18000,,
com.apple.MobileSMS,8,1745530126,1745530134,1745530134.143009,-18000,,
com.google.Chrome,7,1745530119,1745530126,1745530126.9860148,-18000,,
com.apple.MobileSMS,28,1745530091,1745530119,1745530119.2199001,-18000,,
com.apple.MobileSMS,7,1745529324,1745529331,1745529332.410048,-18000,EB445137-D7F5-57EC-87DA-1DB460D64046,"iPhone13,2"
com.google.Chrome,1153,1745528938,1745530091,1745530091.859781,-18000,,
com.apple.Passwords,1,1745528937,1745528938,1745528938.34323,-18000,,
com.google.Chrome,108,1745528829,1745528937,1745528937.836402,-18000,,
com.leomehlig.today,95,1745528734,1745528829,1745528829.829619,-18000,,
com.apple.MobileSMS,25,1745528446,1745528471,1745528471.64037,-18000,EB445137-D7F5-57EC-87DA-1DB460D64046,"iPhone13,2"
com.apple.findmy,12,1745528352,1745528364,1745528364.82752,-18000,EB445137-D7F5-57EC-87DA-1DB460D64046,"iPhone13,2"
com.google.Chrome,491,1745528243,1745528734,1745528734.1907601,-18000,,
com.apple.MobileSMS,116,1745528063,1745528179,1745528179.965366,-18000,,
com.apple.CoreAuthUI,2,1745528033,1745528035,1745528035.1304069,-18000,EB445137-D7F5-57EC-87DA-1DB460D64046,"iPhone13,2"
com.truebill.truebillnative,17,1745528030,1745528047,1745528048.242632,-18000,EB445137-D7F5-57EC-87DA-1DB460D64046,"iPhone13,2"
com.microsoft.Office.Outlook,14,1745528003,1745528017,1745528018.1127481,-18000,EB445137-D7F5-57EC-87DA-1DB460D64046,"iPhone13,2"
com.instructure.icanvas,3,1745528000,1745528003,1745528003.087867,-18000,EB445137-D7F5-57EC-87DA-1DB460D64046,"iPhone13,2"
com.instructure.icanvas,2,1745527994,1745527996,1745527996.984785,-18000,EB445137-D7F5-57EC-87DA-1DB460D64046,"iPhone13,2"
com.strava.stravaride,21,1745527968,1745527989,1745527989.899585,-18000,EB445137-D7F5-57EC-87DA-1DB460D64046,"iPhone13,2"
com.apple.weather,0,1745527968,1745527968,1745527969.1627479,-18000,EB445137-D7F5-57EC-87DA-1DB460D64046,"iPhone13,2"
com.google.Chrome,104,1745527959,1745528063,1745528063.085352,-18000,,
com.leomehlig.today,26,1745527933,1745527959,1745527959.1375709,-18000,,
com.google.Chrome,4,1745527929,1745527933,1745527933.370915,-18000,,
com.apple.weather,6,1745527521,1745527527,1745527527.79164,-18000,EB445137-D7F5-57EC-87DA-1DB460D64046,"iPhone13,2"
com.apple.MobileSMS,129,1745527245,1745527374,1745527374.9718242,-18000,EB445137-D7F5-57EC-87DA-1DB460D64046,"iPhone13,2"
com.google.Chrome,260,1745526765,1745527025,1745527025.0311499,-18000,,
com.google.Chrome,613,1745526147,1745526760,1745526760.899029,-18000,,
com.apple.MobileSMS,19,1745526128,1745526147,1745526147.459307,-18000,,
com.google.Chrome,5,1745526123,1745526128,1745526128.4768028,-18000,,
com.apple.Passwords,6,1745526117,1745526123,1745526123.591403,-18000,,
com.google.Chrome,5,1745526112,1745526117,1745526117.480732,-18000,,
com.google.Chrome,320,1745521331,1745521651,1745521651.498637,-18000,,
com.apple.Passwords,7,1745521324,1745521331,1745521331.638319,-18000,,
com.google.Chrome,12,1745521312,1745521324,1745521326.487454,-18000,,
com.apple.finder,1,1745521311,1745521312,1745521312.368721,-18000,,
com.leomehlig.today,2,1745521309,1745521311,1745521311.412132,-18000,,
com.apple.MobileSMS,16,1745514625,1745514641,1745514641.861489,-18000,EB445137-D7F5-57EC-87DA-1DB460D64046,"iPhone13,2"
com.apple.MobileSMS,6,1745514607,1745514613,1745514613.359632,-18000,EB445137-D7F5-57EC-87DA-1DB460D64046,"iPhone13,2"
com.apple.MobileSMS,4,1745514023,1745514027,1745514028.17023,-18000,EB445137-D7F5-57EC-87DA-1DB460D64046,"iPhone13,2"
com.apple.MobileSMS,197,1745512956,1745513153,1745513154.313029,-18000,EB445137-D7F5-57EC-87DA-1DB460D64046,"iPhone13,2"
com.apple.Maps,1,1745512955,1745512956,1745512956.43334,-18000,EB445137-D7F5-57EC-87DA-1DB460D64046,"iPhone13,2"
com.apple.Maps,89,1745510493,1745510582,1745510582.4376678,-18000,EB445137-D7F5-57EC-87DA-1DB460D64046,"iPhone13,2"
com.apple.Maps,4,1745510484,1745510488,1745510488.997936,-18000,EB445137-D7F5-57EC-87DA-1DB460D64046,"iPhone13,2"
com.apple.Maps,8,1745510446,1745510454,1745510454.945218,-18000,EB445137-D7F5-57EC-87DA-1DB460D64046,"iPhone13,2"
com.apple.Maps,15,1745510077,1745510092,1745510092.857023,-18000,EB445137-D7F5-57EC-87DA-1DB460D64046,"iPhone13,2"
com.apple.findmy,3,1745510069,1745510072,1745510072.321295,-18000,EB445137-D7F5-57EC-87DA-1DB460D64046,"iPhone13,2"
com.apple.findmy,36,1745509595,1745509631,1745509631.5272288,-18000,EB445137-D7F5-57EC-87DA-1DB460D64046,"iPhone13,2"
com.apple.findmy,34,1745509551,1745509585,1745509586.233815,-18000,EB445137-D7F5-57EC-87DA-1DB460D64046,"iPhone13,2"
com.apple.findmy,3,1745509492,1745509495,1745509495.7040548,-18000,EB445137-D7F5-57EC-87DA-1DB460D64046,"iPhone13,2"
com.apple.findmy,1,1745509489,1745509490,1745509490.484634,-18000,EB445137-D7F5-57EC-87DA-1DB460D64046,"iPhone13,2"
com.apple.findmy,43,1745509409,1745509452,1745509452.0631251,-18000,EB445137-D7F5-57EC-87DA-1DB460D64046,"iPhone13,2"
com.apple.findmy,128,1745509279,1745509407,1745509408.206428,-18000,EB445137-D7F5-57EC-87DA-1DB460D64046,"iPhone13,2"
com.apple.findmy,94,1745509184,1745509278,1745509278.456671,-18000,EB445137-D7F5-57EC-87DA-1DB460D64046,"iPhone13,2"
com.apple.findmy,11,1745509052,1745509063,1745509064.1058621,-18000,EB445137-D7F5-57EC-87DA-1DB460D64046,"iPhone13,2"
com.apple.MobileSMS,5,1745509047,1745509052,1745509053.535217,-18000,EB445137-D7F5-57EC-87DA-1DB460D64046,"iPhone13,2"
com.apple.findmy,10,1745509037,1745509047,1745509047.248736,-18000,EB445137-D7F5-57EC-87DA-1DB460D64046,"iPhone13,2"
com.apple.news,199,1745508838,1745509037,1745509038.2167048,-18000,EB445137-D7F5-57EC-87DA-1DB460D64046,"iPhone13,2"
com.apple.findmy,28,1745508810,1745508838,1745508838.635021,-18000,EB445137-D7F5-57EC-87DA-1DB460D64046,"iPhone13,2"
com.apple.news,348,1745508460,1745508808,1745508808.502602,-18000,EB445137-D7F5-57EC-87DA-1DB460D64046,"iPhone13,2"
com.apple.Health,8,1745508450,1745508458,1745508458.704746,-18000,EB445137-D7F5-57EC-87DA-1DB460D64046,"iPhone13,2"
com.apple.MobileSMS,2,1745508444,1745508446,1745508446.656085,-18000,EB445137-D7F5-57EC-87DA-1DB460D64046,"iPhone13,2"
com.leomehlig.today,301,1745508438,1745508739,1745508739.783368,-18000,,
com.apple.finder,3,1745508435,1745508438,1745508438.824685,-18000,,
com.microsoft.VSCode,3,1745508432,1745508435,1745508435.825762,-18000,,
com.google.Chrome,7,1745508425,1745508432,1745508433.04319,-18000,,
com.apple.iCal,67,1745508358,1745508425,1745508425.14879,-18000,,
com.google.Chrome,16,1745508342,1745508358,1745508358.671747,-18000,,
com.apple.iCal,53,1745508289,1745508342,1745508342.515712,-18000,,
com.google.Chrome,29,1745508260,1745508289,1745508289.820972,-18000,,
com.apple.iCal,2,1745508258,1745508260,1745508260.3696861,-18000,,
com.google.Chrome,3,1745508255,1745508258,1745508258.4255881,-18000,,
com.apple.iCal,2,1745508253,1745508255,1745508255.9862862,-18000,,
com.google.Chrome,1,1745508252,1745508253,1745508253.66237,-18000,,
com.apple.iCal,2,1745508250,1745508252,1745508252.500535,-18000,,
com.google.Chrome,29,1745508221,1745508250,1745508250.63758,-18000,,
com.apple.iCal,20,1745508201,1745508221,1745508221.774884,-18000,,
com.google.Chrome,3,1745508198,1745508201,1745508201.376802,-18000,,
com.apple.iCal,2,1745508196,1745508198,1745508198.4129992,-18000,,
com.google.Chrome,4,1745508192,1745508196,1745508196.069448,-18000,,
com.apple.iCal,14,1745508178,1745508192,1745508192.586564,-18000,,
com.google.Chrome,9,1745508169,1745508178,1745508178.256464,-18000,,
com.apple.iCal,22,1745508147,1745508169,1745508169.440449,-18000,,
com.google.Chrome,4,1745508143,1745508147,1745508147.606936,-18000,,
com.apple.iCal,6,1745508137,1745508143,1745508143.659011,-18000,,
com.google.Chrome,6,1745508131,1745508137,1745508137.168015,-18000,,
com.apple.iCal,12,1745508119,1745508131,1745508131.719378,-18000,,
com.google.Chrome,2,1745508117,1745508119,1745508119.8659282,-18000,,
com.apple.iCal,0,1745508117,1745508117,1745508117.90908,-18000,,
com.google.Chrome,2,1745508115,1745508117,1745508117.234005,-18000,,
com.apple.iCal,17,1745508098,1745508115,1745508115.8771992,-18000,,
com.google.Chrome,6,1745508092,1745508098,1745508098.768404,-18000,,
com.apple.iCal,10,1745508082,1745508092,1745508092.342149,-18000,,
com.google.Chrome,4,1745508078,1745508082,1745508082.137659,-18000,,
com.apple.iCal,27,1745508051,1745508078,1745508078.4806619,-18000,,
com.google.Chrome,3,1745508048,1745508051,1745508051.899578,-18000,,
com.apple.iCal,10,1745508038,1745508048,1745508048.4421139,-18000,,
com.google.Chrome,12,1745508026,1745508038,1745508038.5829659,-18000,,
com.apple.iCal,17,1745508009,1745508026,1745508026.209687,-18000,,
com.google.Chrome,4,1745508005,1745508009,1745508009.8885999,-18000,,
com.apple.iCal,8,1745507997,1745508005,1745508005.257958,-18000,,
com.google.Chrome,1,1745507996,1745507997,1745507997.79499,-18000,,
com.apple.iCal,4,1745507992,1745507996,1745507996.56078,-18000,,
com.google.Chrome,12,1745507980,1745507992,1745507992.9028668,-18000,,
com.apple.iCal,20,1745507960,1745507980,1745507980.374731,-18000,,
com.google.Chrome,4,1745507956,1745507960,1745507960.435307,-18000,,
com.apple.iCal,14,1745507942,1745507956,1745507956.860677,-18000,,
com.google.Chrome,11,1745507931,1745507942,1745507942.693996,-18000,,
com.apple.iCal,7,1745507924,1745507931,1745507931.359157,-18000,,
com.google.Chrome,1,1745507923,1745507924,1745507924.344936,-18000,,
com.apple.iCal,13,1745507910,1745507923,1745507923.3273869,-18000,,
com.google.Chrome,12,1745507898,1745507910,1745507910.715084,-18000,,
com.apple.iCal,14,1745507884,1745507898,1745507898.172487,-18000,,
com.google.Chrome,7,1745507877,1745507884,1745507885.0288692,-18000,,
com.apple.iCal,9,1745507868,1745507877,1745507877.216992,-18000,,
com.google.Chrome,18,1745507850,1745507868,1745507868.413352,-18000,,
com.apple.iCal,13,1745507837,1745507850,1745507850.415802,-18000,,
com.google.Chrome,12,1745507825,1745507837,1745507837.174667,-18000,,
com.apple.iCal,32,1745507793,1745507825,1745507825.4901009,-18000,,
com.google.Chrome,9,1745507784,1745507793,1745507793.484795,-18000,,
com.apple.iCal,6,1745507778,1745507784,1745507784.8214989,-18000,,
com.google.Chrome,12,1745507766,1745507778,1745507778.4886,-18000,,
com.apple.iCal,4,1745507762,1745507766,1745507767.0084062,-18000,,
com.google.Chrome,2,1745507760,1745507762,1745507762.531477,-18000,,
com.apple.iCal,15,1745507745,1745507760,1745507760.223119,-18000,,
com.google.Chrome,64,1745507681,1745507745,1745507745.406975,-18000,,
com.leomehlig.today,53,1745507566,1745507619,1745507620.031839,-18000,,
com.apple.MobileSMS,6,1745507560,1745507566,1745507567.024008,-18000,,
com.leomehlig.today,21,1745507539,1745507560,1745507560.065189,-18000,,
com.apple.MobileSMS,61,1745507456,1745507517,1745507517.7942781,-18000,EB445137-D7F5-57EC-87DA-1DB460D64046,"iPhone13,2"
com.google.Chrome,87,1745507452,1745507539,1745507539.877167,-18000,,
com.apple.MobileSMS,5,1745507389,1745507394,1745507394.60519,-18000,EB445137-D7F5-57EC-87DA-1DB460D64046,"iPhone13,2"
com.apple.MobileSMS,57,1745507328,1745507385,1745507385.75893,-18000,EB445137-D7F5-57EC-87DA-1DB460D64046,"iPhone13,2"
com.apple.MobileSMS,24,1745507078,1745507102,1745507102.7790751,-18000,EB445137-D7F5-57EC-87DA-1DB460D64046,"iPhone13,2"
com.apple.MobileSMS,91,1745506980,1745507071,1745507071.2711492,-18000,EB445137-D7F5-57EC-87DA-1DB460D64046,"iPhone13,2"
com.apple.findmy,35,1745506732,1745506767,1745506767.2675471,-18000,EB445137-D7F5-57EC-87DA-1DB460D64046,"iPhone13,2"
com.apple.mobilenotes,2,1745506729,1745506731,1745506731.178035,-18000,EB445137-D7F5-57EC-87DA-1DB460D64046,"iPhone13,2"
com.apple.mobilenotes,70,1745506308,1745506378,1745506378.28883,-18000,EB445137-D7F5-57EC-87DA-1DB460D64046,"iPhone13,2"
com.apple.Health,12,1745506158,1745506170,1745506170.5993528,-18000,EB445137-D7F5-57EC-87DA-1DB460D64046,"iPhone13,2"
com.strava.stravaride,14,1745506144,1745506158,1745506158.493703,-18000,EB445137-D7F5-57EC-87DA-1DB460D64046,"iPhone13,2"
com.hammerandchisel.discord,27,1745506115,1745506142,1745506142.8508182,-18000,EB445137-D7F5-57EC-87DA-1DB460D64046,"iPhone13,2"
com.microsoft.Office.Outlook,29,1745506086,1745506115,1745506115.5839071,-18000,EB445137-D7F5-57EC-87DA-1DB460D64046,"iPhone13,2"
com.apple.findmy,13,1745506073,1745506086,1745506086.6476588,-18000,EB445137-D7F5-57EC-87DA-1DB460D64046,"iPhone13,2"
com.google.Chrome,59,1745506006,1745506065,1745506065.1063619,-18000,,
com.microsoft.VSCode,65,1745505941,1745506006,1745506006.943297,-18000,,
com.apple.news,32,1745505909,1745505941,1745505941.780198,-18000,,
com.microsoft.VSCode,7,1745505902,1745505909,1745505909.467236,-18000,,
com.google.Chrome,156,1745505746,1745505902,1745505902.447641,-18000,,
com.apple.findmy,13,1745505459,1745505472,1745505472.674127,-18000,EB445137-D7F5-57EC-87DA-1DB460D64046,"iPhone13,2"
com.apple.findmy,13,1745503904,1745503917,1745503917.759159,-18000,EB445137-D7F5-57EC-87DA-1DB460D64046,"iPhone13,2"
com.strava.stravaride,158,1745503746,1745503904,1745503904.341814,-18000,EB445137-D7F5-57EC-87DA-1DB460D64046,"iPhone13,2"
com.renpho.health,1,1745503737,1745503738,1745503739.003443,-18000,EB445137-D7F5-57EC-87DA-1DB460D64046,"iPhone13,2"
com.google.Chrome,352,1745503607,1745503959,1745503959.1136131,-18000,,
com.renpho.health,62,1745503037,1745503099,1745503099.738371,-18000,EB445137-D7F5-57EC-87DA-1DB460D64046,"iPhone13,2"
com.apple.findmy,14,1745503022,1745503036,1745503036.9642959,-18000,EB445137-D7F5-57EC-87DA-1DB460D64046,"iPhone13,2"
com.apple.findmy,2,1745503019,1745503021,1745503021.439033,-18000,EB445137-D7F5-57EC-87DA-1DB460D64046,"iPhone13,2"
com.google.Chrome,345,1745502968,1745503313,1745503313.221088,-18000,,
com.apple.findmy,21,1745502174,1745502195,1745502195.8067331,-18000,EB445137-D7F5-57EC-87DA-1DB460D64046,"iPhone13,2"
com.google.Chrome,354,1745502092,1745502446,1745502446.849039,-18000,,
com.google.Chrome,3,1745499548,1745499551,1745499551.214366,-18000,,
com.google.Chrome,97,1745499451,1745499548,1745499548.066154,-18000,,
com.apple.weather,45,1745499310,1745499355,1745499355.677369,-18000,EB445137-D7F5-57EC-87DA-1DB460D64046,"iPhone13,2"
com.apple.news,314,1745498993,1745499307,1745499307.380735,-18000,EB445137-D7F5-57EC-87DA-1DB460D64046,"iPhone13,2"
com.apple.CoreAuthUI,4,1745464879,1745464883,1745464883.873302,-18000,EB445137-D7F5-57EC-87DA-1DB460D64046,"iPhone13,2"
com.apple.journal,900,1745464877,1745465777,1745465777.246851,-18000,EB445137-D7F5-57EC-87DA-1DB460D64046,"iPhone13,2"
com.apple.Health,22,1745464851,1745464873,1745464874.1122131,-18000,EB445137-D7F5-57EC-87DA-1DB460D64046,"iPhone13,2"
com.instructure.icanvas,4,1745464843,1745464847,1745464847.340393,-18000,EB445137-D7F5-57EC-87DA-1DB460D64046,"iPhone13,2"
com.google.Chrome,2619,1745462040,1745464659,1745464659.403737,-18000,,
com.leomehlig.today,123,1745461917,1745462040,1745462040.3955,-18000,,
com.apple.reminders,17,1745461900,1745461917,1745461918.076046,-18000,,
com.leomehlig.today,22,1745461878,1745461900,1745461900.088262,-18000,,
com.google.Chrome,10,1745461868,1745461878,1745461878.277252,-18000,,
com.google.Chrome,26,1745460236,1745460262,1745460262.734346,-18000,,
com.google.Chrome,305,1745456476,1745456781,1745456781.4197788,-18000,,
com.google.Chrome,405,1745452465,1745452870,1745452870.8799539,-18000,,
com.microsoft.Office.Outlook,32,1745452133,1745452165,1745452165.8903341,-18000,EB445137-D7F5-57EC-87DA-1DB460D64046,"iPhone13,2"
com.google.Chrome,10,1745451655,1745451665,1745451665.279292,-18000,,
com.leomehlig.today,39,1745451616,1745451655,1745451655.448108,-18000,,
com.google.Chrome,260,1745451356,1745451616,1745451616.269422,-18000,,
com.leomehlig.today,2,1745451354,1745451356,1745451356.196934,-18000,,
com.google.Chrome,201,1745451153,1745451354,1745451355.112791,-18000,,
com.leomehlig.today,2,1745451151,1745451153,1745451153.543995,-18000,,
com.google.Chrome,132,1745451019,1745451151,1745451151.270704,-18000,,
com.leomehlig.today,5,1745451014,1745451019,1745451019.90383,-18000,,
com.apple.finder,2,1745451012,1745451014,1745451014.3812551,-18000,,
com.microsoft.VSCode,3,1745451009,1745451012,1745451012.5284781,-18000,,
com.apple.finder,6,1745451003,1745451009,1745451009.944994,-18000,,
com.microsoft.Powerpoint,3,1745451000,1745451003,1745451003.75392,-18000,,
com.google.Chrome,45,1745450955,1745451000,1745451000.7845268,-18000,,
com.apple.finder,22,1745450933,1745450955,1745450955.575748,-18000,,
com.google.Chrome,53,1745450880,1745450933,1745450933.232382,-18000,,
com.apple.finder,145,1745450735,1745450880,1745450880.313832,-18000,,
com.apple.Preview,2,1745450733,1745450735,1745450735.2804708,-18000,,
com.apple.finder,34,1745450699,1745450733,1745450733.6948981,-18000,,
com.apple.Preview,90,1745450609,1745450699,1745450699.8842912,-18000,,
com.apple.finder,9,1745450600,1745450609,1745450609.9661021,-18000,,
com.google.Chrome,48,1745450552,1745450600,1745450600.052691,-18000,,
com.microsoft.Powerpoint,15,1745450537,1745450552,1745450552.546383,-18000,,
com.google.Chrome,23,1745450514,1745450537,1745450537.619133,-18000,,
com.microsoft.Powerpoint,1,1745450513,1745450514,1745450514.493174,-18000,,
com.google.Chrome,1,1745450512,1745450513,1745450513.598089,-18000,,
com.microsoft.Powerpoint,5,1745450507,1745450512,1745450512.0455089,-18000,,
com.google.Chrome,1,1745450506,1745450507,1745450507.97666,-18000,,
com.microsoft.Powerpoint,1,1745450505,1745450506,1745450506.920062,-18000,,
com.google.Chrome,1,1745450504,1745450505,1745450505.5523481,-18000,,
com.microsoft.Powerpoint,1,1745450503,1745450504,1745450504.818591,-18000,,
com.google.Chrome,1,1745450502,1745450503,1745450503.4935188,-18000,,
com.microsoft.Powerpoint,1,1745450501,1745450502,1745450502.492975,-18000,,
com.google.Chrome,9,1745450492,1745450501,1745450501.9848208,-18000,,
com.microsoft.Powerpoint,195,1745450297,1745450492,1745450492.077292,-18000,,
com.apple.finder,6,1745450291,1745450297,1745450297.4749289,-18000,,
com.microsoft.Powerpoint,22,1745450269,1745450291,1745450291.271899,-18000,,
com.apple.finder,5,1745450264,1745450269,1745450269.10148,-18000,,
com.microsoft.Powerpoint,2,1745450262,1745450264,1745450264.847728,-18000,,
com.apple.finder,1,1745450261,1745450262,1745450262.588375,-18000,,
com.microsoft.Powerpoint,3,1745450258,1745450261,1745450261.053283,-18000,,
com.apple.finder,5,1745450253,1745450258,1745450259.0640821,-18000,,
com.microsoft.Powerpoint,32,1745450221,1745450253,1745450253.227662,-18000,,
com.apple.finder,6,1745450215,1745450221,1745450221.5331569,-18000,,
com.microsoft.Powerpoint,6,1745450209,1745450215,1745450215.668926,-18000,,
com.google.Chrome,55,1745450154,1745450209,1745450209.134604,-18000,,
com.apple.finder,3,1745450151,1745450154,1745450155.013073,-18000,,
com.google.Chrome,3,1745450148,1745450151,1745450151.599104,-18000,,
com.apple.finder,7,1745450141,1745450148,1745450148.960541,-18000,,
com.google.Chrome,63,1745450078,1745450141,1745450141.37936,-18000,,
com.apple.finder,3,1745450075,1745450078,1745450078.3892732,-18000,,
com.google.Chrome,4,1745450071,1745450075,1745450075.345298,-18000,,
com.apple.finder,2,1745450069,1745450071,1745450071.525419,-18000,,
com.google.Chrome,1,1745450068,1745450069,1745450069.936572,-18000,,
com.apple.finder,14,1745450054,1745450068,1745450068.575706,-18000,,
com.microsoft.VSCode,85,1745449969,1745450054,1745450054.437943,-18000,,
com.google.Chrome,35,1745449934,1745449969,1745449969.467842,-18000,,
com.apple.MobileSMS,2,1745449421,1745449423,1745449423.726887,-18000,EB445137-D7F5-57EC-87DA-1DB460D64046,"iPhone13,2"
com.google.Chrome,16,1745449309,1745449325,1745449325.7081819,-18000,,
com.apple.finder,18,1745449291,1745449309,1745449309.0743341,-18000,,
com.google.Chrome,33,1745449258,1745449291,1745449291.264965,-18000,,
com.apple.MobileSMS,1,1745449257,1745449258,1745449258.622386,-18000,,
com.google.Chrome,53,1745449204,1745449257,1745449257.227381,-18000,,
com.apple.MobileSMS,2,1745449202,1745449204,1745449204.191869,-18000,,
com.google.Chrome,30,1745449172,1745449202,1745449202.7993,-18000,,
com.apple.MobileSMS,2,1745449170,1745449172,1745449172.8038101,-18000,,
com.google.Chrome,1,1745449169,1745449170,1745449170.4096022,-18000,,
com.apple.MobileSMS,6,1745449163,1745449169,1745449169.400583,-18000,,
com.google.Chrome,117,1745449046,1745449163,1745449163.489763,-18000,,
com.apple.finder,7,1745449039,1745449046,1745449046.758861,-18000,,
com.google.Chrome,11,1745449028,1745449039,1745449039.0389261,-18000,,
com.apple.finder,12,1745449016,1745449028,1745449028.6773849,-18000,,
com.google.Chrome,20,1745448996,1745449016,1745449016.5020099,-18000,,
com.apple.finder,13,1745448983,1745448996,1745448996.219337,-18000,,
com.google.Chrome,264,1745448719,1745448983,1745448983.323091,-18000,,
com.apple.iCal,3,1745448716,1745448719,1745448719.161672,-18000,,
com.leomehlig.today,2,1745448714,1745448716,1745448716.314945,-18000,,
com.google.Chrome,22,1745448692,1745448714,1745448714.405443,-18000,,
com.leomehlig.today,100,1745448592,1745448692,1745448692.149907,-18000,,
com.apple.iCal,7,1745448585,1745448592,1745448592.937886,-18000,,
com.leomehlig.today,57,1745448528,1745448585,1745448585.792352,-18000,,
com.apple.news,41,1745448487,1745448528,1745448528.8345761,-18000,,
com.leomehlig.today,5,1745448482,1745448487,1745448489.423753,-18000,,
com.apple.finder,2,1745448480,1745448482,1745448485.5196528,-18000,,
com.apple.MobileSMS,5,1745448475,1745448480,1745448483.3698149,-18000,,
com.apple.finder,3,1745448472,1745448475,1745448475.370333,-18000,,
com.apple.MobileSMS,11,1745447745,1745447756,1745447756.7219682,-18000,EB445137-D7F5-57EC-87DA-1DB460D64046,"iPhone13,2"
com.apple.MobileSMS,139,1745447577,1745447716,1745447716.476464,-18000,EB445137-D7F5-57EC-87DA-1DB460D64046,"iPhone13,2"
com.apple.weather,2,1745447575,1745447577,1745447577.593849,-18000,EB445137-D7F5-57EC-87DA-1DB460D64046,"iPhone13,2"
com.apple.weather,1,1745446799,1745446800,1745446801.029213,-18000,EB445137-D7F5-57EC-87DA-1DB460D64046,"iPhone13,2"
com.apple.finder,1,1745446705,1745446706,1745446706.830339,-18000,,
com.leomehlig.today,2,1745446703,1745446705,1745446705.1819649,-18000,,
com.google.Chrome,30,1745446673,1745446703,1745446703.116272,-18000,,
com.leomehlig.today,3,1745446670,1745446673,1745446673.965986,-18000,,
com.google.Chrome,3,1745446667,1745446670,1745446670.0587978,-18000,,
com.leomehlig.today,51,1745446616,1745446667,1745446667.09766,-18000,,
com.google.Chrome,2,1745446614,1745446616,1745446616.090703,-18000,,
com.apple.iCal,14,1745446600,1745446614,1745446614.903013,-18000,,
com.google.Chrome,25,1745446575,1745446600,1745446600.8118482,-18000,,
com.leomehlig.today,8,1745446567,1745446575,1745446575.1699529,-18000,,
com.google.Chrome,4,1745446563,1745446567,1745446567.050379,-18000,,
com.leomehlig.today,6,1745446557,1745446563,1745446563.788567,-18000,,
com.google.Chrome,6,1745446551,1745446557,1745446557.7920399,-18000,,
com.leomehlig.today,158,1745446393,1745446551,1745446551.937848,-18000,,
com.google.Chrome,208,1745446185,1745446393,1745446393.755046,-18000,,
com.google.Chrome,1365,1745444793,1745446158,1745446158.1765962,-18000,,
com.leomehlig.today,2,1745444791,1745444793,1745444793.8268518,-18000,,
com.google.Chrome,850,1745443941,1745444791,1745444791.117949,-18000,,
com.google.Chrome,610,1745443316,1745443926,1745443926.539526,-18000,,
com.leomehlig.today,7,1745443309,1745443316,1745443316.1200309,-18000,,
com.google.Chrome,816,1745442493,1745443309,1745443309.081242,-18000,,
com.apple.weather,34,1745442476,1745442510,1745442510.202642,-18000,EB445137-D7F5-57EC-87DA-1DB460D64046,"iPhone13,2"
com.apple.news,182,1745442222,1745442404,1745442404.6152081,-18000,EB445137-D7F5-57EC-87DA-1DB460D64046,"iPhone13,2"
com.apple.CoreAuthUI,2,1745442087,1745442089,1745442089.389204,-18000,EB445137-D7F5-57EC-87DA-1DB460D64046,"iPhone13,2"
com.truebill.truebillnative,133,1745442083,1745442216,1745442216.5924249,-18000,EB445137-D7F5-57EC-87DA-1DB460D64046,"iPhone13,2"
com.truebill.truebillnative,3,1745442075,1745442078,1745442079.6301332,-18000,EB445137-D7F5-57EC-87DA-1DB460D64046,"iPhone13,2"
com.instructure.icanvas,21,1745441197,1745441218,1745441218.761907,-18000,EB445137-D7F5-57EC-87DA-1DB460D64046,"iPhone13,2"
com.google.Chrome,2922,1745439378,1745442300,1745442300.2701821,-18000,,
com.apple.HeadphoneProxService,4,1745439103,1745439107,1745439107.311578,-18000,EB445137-D7F5-57EC-87DA-1DB460D64046,"iPhone13,2"
com.apple.HeadphoneProxService,4,1745439097,1745439101,1745439101.508338,-18000,EB445137-D7F5-57EC-87DA-1DB460D64046,"iPhone13,2"
com.google.Chrome,300,1745439064,1745439364,1745439364.776606,-18000,,
com.apple.news,571,1745438795,1745439366,1745439366.768486,-18000,EB445137-D7F5-57EC-87DA-1DB460D64046,"iPhone13,2"
com.apple.MobileSMS,2,1745438788,1745438790,1745438790.449219,-18000,EB445137-D7F5-57EC-87DA-1DB460D64046,"iPhone13,2"
com.apple.MobileSMS,4,1745438784,1745438788,1745438788.781949,-18000,EB445137-D7F5-57EC-87DA-1DB460D64046,"iPhone13,2"
com.google.Chrome,316,1745438745,1745439061,1745439061.3000069,-18000,,
com.instructure.icanvas,4,1745438018,1745438022,1745438023.84847,-18000,EB445137-D7F5-57EC-87DA-1DB460D64046,"iPhone13,2"
com.apple.Health,40,1745434794,1745434834,1745434835.033337,-18000,EB445137-D7F5-57EC-87DA-1DB460D64046,"iPhone13,2"
com.apple.news,0,1745434794,1745434794,1745434798.68113,-18000,EB445137-D7F5-57EC-87DA-1DB460D64046,"iPhone13,2"
com.apple.news,219,1745433159,1745433378,1745433378.881433,-18000,EB445137-D7F5-57EC-87DA-1DB460D64046,"iPhone13,2"
com.apple.MobileSMS,20,1745433137,1745433157,1745433157.555962,-18000,EB445137-D7F5-57EC-87DA-1DB460D64046,"iPhone13,2"
com.strava.stravaride,45,1745431128,1745431173,1745431173.410492,-18000,EB445137-D7F5-57EC-87DA-1DB460D64046,"iPhone13,2"
com.google.Chrome,197,1745430872,1745431069,1745431069.45301,-18000,,
com.apple.iCal,35,1745430798,1745430833,1745430833.20042,-18000,,
com.google.Chrome,1,1745430797,1745430798,1745430799.001873,-18000,,
com.microsoft.Outlook,26,1745430771,1745430797,1745430797.733295,-18000,,
com.google.Chrome,135,1745430636,1745430771,1745430771.5690908,-18000,,
com.microsoft.Outlook,24,1745430612,1745430636,1745430636.990099,-18000,,
com.google.Chrome,6,1745430606,1745430612,1745430613.06421,-18000,,
com.microsoft.Outlook,3,1745430603,1745430606,1745430606.3025532,-18000,,
com.google.Chrome,55,1745430548,1745430603,1745430603.223092,-18000,,
com.leomehlig.today,48,1745430500,1745430548,1745430548.573175,-18000,,
com.google.Chrome,3,1745430497,1745430500,1745430500.669965,-18000,,
com.microsoft.VSCode,2,1745430495,1745430497,1745430497.5205421,-18000,,
com.google.Chrome,137,1745430358,1745430495,1745430495.3424149,-18000,,
com.apple.news,185,1745429281,1745429466,1745429466.553287,-18000,EB445137-D7F5-57EC-87DA-1DB460D64046,"iPhone13,2"
com.hammerandchisel.discord,15,1745429260,1745429275,1745429275.712802,-18000,EB445137-D7F5-57EC-87DA-1DB460D64046,"iPhone13,2"
com.hammerandchisel.discord,102,1745429108,1745429210,1745429211.7216558,-18000,EB445137-D7F5-57EC-87DA-1DB460D64046,"iPhone13,2"
com.apple.news,800,1745428057,1745428857,1745428857.294244,-18000,EB445137-D7F5-57EC-87DA-1DB460D64046,"iPhone13,2"
com.microsoft.Office.Outlook,101,1745427952,1745428053,1745428054.041915,-18000,EB445137-D7F5-57EC-87DA-1DB460D64046,"iPhone13,2"
com.apple.MobileSMS,2,1745427948,1745427950,1745427950.439127,-18000,EB445137-D7F5-57EC-87DA-1DB460D64046,"iPhone13,2"
com.apple.MobileSMS,7,1745427006,1745427013,1745427014.421422,-18000,EB445137-D7F5-57EC-87DA-1DB460D64046,"iPhone13,2"
com.apple.MobileSMS,12,1745426522,1745426534,1745426534.8134398,-18000,EB445137-D7F5-57EC-87DA-1DB460D64046,"iPhone13,2"
com.apple.MobileAddressBook,44,1745426478,1745426522,1745426522.900274,-18000,EB445137-D7F5-57EC-87DA-1DB460D64046,"iPhone13,2"
com.apple.MobileSMS,2,1745426474,1745426476,1745426476.502373,-18000,EB445137-D7F5-57EC-87DA-1DB460D64046,"iPhone13,2"
com.apple.MobileSMS,3,1745426450,1745426453,1745426454.077579,-18000,EB445137-D7F5-57EC-87DA-1DB460D64046,"iPhone13,2"
com.apple.InCallService,1,1745426449,1745426450,1745426451.7787461,-18000,EB445137-D7F5-57EC-87DA-1DB460D64046,"iPhone13,2"
com.apple.InCallService,2,1745426310,1745426312,1745426312.6676822,-18000,EB445137-D7F5-57EC-87DA-1DB460D64046,"iPhone13,2"
com.apple.MobileSMS,18,1745426292,1745426310,1745426310.43863,-18000,EB445137-D7F5-57EC-87DA-1DB460D64046,"iPhone13,2"
com.apple.findmy,12,1745426280,1745426292,1745426292.7069001,-18000,EB445137-D7F5-57EC-87DA-1DB460D64046,"iPhone13,2"
com.toyopagroup.picaboo,27,1745426248,1745426275,1745426276.130807,-18000,EB445137-D7F5-57EC-87DA-1DB460D64046,"iPhone13,2"
com.google.Chrome,175,1745422943,1745423118,1745423118.127464,-18000,,
com.apple.news,218,1745422725,1745422943,1745422944.174864,-18000,,
com.google.Chrome,23,1745422702,1745422725,1745422726.155336,-18000,,
com.leomehlig.today,1,1745422701,1745422702,1745422702.675592,-18000,,
com.google.Chrome,41,1745422660,1745422701,1745422701.471257,-18000,,
com.apple.news,49,1745422611,1745422660,1745422660.603539,-18000,,
com.google.Chrome,302,1745422309,1745422611,1745422611.396424,-18000,,
com.apple.iCal,0,1745422309,1745422309,1745422309.812942,-18000,,
com.google.Chrome,438,1745421871,1745422309,1745422309.0937781,-18000,,
com.apple.iCal,29,1745421842,1745421871,1745421871.108263,-18000,,
com.microsoft.VSCode,2,1745421840,1745421842,1745421843.3678808,-18000,,
com.microsoft.VSCode,393,1745421077,1745421470,1745421470.139329,-18000,,
com.google.Chrome,2,1745421075,1745421077,1745421077.2744951,-18000,,
com.microsoft.VSCode,1,1745421074,1745421075,1745421075.605346,-18000,,
com.google.Chrome,21,1745421053,1745421074,1745421074.138274,-18000,,
com.microsoft.VSCode,152,1745420901,1745421053,1745421053.0667481,-18000,,
com.google.Chrome,9,1745420892,1745420901,1745420901.257481,-18000,,
com.google.Chrome,1243,1745418791,1745420034,1745420034.3229132,-18000,,
com.leomehlig.today,107,1745418684,1745418791,1745418791.758915,-18000,,
com.apple.iCal,23,1745418661,1745418684,1745418684.9711618,-18000,,
com.leomehlig.today,87,1745418574,1745418661,1745418661.1883368,-18000,,
com.google.Chrome,1629,1745416945,1745418574,1745418574.351112,-18000,,
com.apple.iCal,17,1745416928,1745416945,1745416945.447201,-18000,,
com.google.Chrome,144,1745416784,1745416928,1745416929.006072,-18000,,
com.apple.iCal,3,1745416781,1745416784,1745416784.518532,-18000,,
com.google.Chrome,52,1745416729,1745416781,1745416781.580756,-18000,,
com.tinyspeck.chatlyio,19,1745416687,1745416706,1745416706.435936,-18000,EB445137-D7F5-57EC-87DA-1DB460D64046,"iPhone13,2"
com.apple.weather,1,1745416686,1745416687,1745416687.6606212,-18000,EB445137-D7F5-57EC-87DA-1DB460D64046,"iPhone13,2"
com.apple.weather,70,1745414732,1745414802,1745414803.069093,-18000,EB445137-D7F5-57EC-87DA-1DB460D64046,"iPhone13,2"
com.apple.news,1,1745414731,1745414732,1745414732.847353,-18000,EB445137-D7F5-57EC-87DA-1DB460D64046,"iPhone13,2"
com.apple.news,30,1745414531,1745414561,1745414562.035499,-18000,EB445137-D7F5-57EC-87DA-1DB460D64046,"iPhone13,2"
com.apple.Health,16,1745414511,1745414527,1745414528.106163,-18000,EB445137-D7F5-57EC-87DA-1DB460D64046,"iPhone13,2"
com.microsoft.Office.Outlook,62,1745414447,1745414509,1745414509.677662,-18000,EB445137-D7F5-57EC-87DA-1DB460D64046,"iPhone13,2"
com.instructure.icanvas,5,1745414441,1745414446,1745414447.028971,-18000,EB445137-D7F5-57EC-87DA-1DB460D64046,"iPhone13,2"
com.hammerandchisel.discord,9,1745414430,1745414439,1745414439.329873,-18000,EB445137-D7F5-57EC-87DA-1DB460D64046,"iPhone13,2"
com.renpho.health,140,1745414288,1745414428,1745414428.521606,-18000,EB445137-D7F5-57EC-87DA-1DB460D64046,"iPhone13,2"
com.google.Chrome,3605,1745376025,1745379630,1745379631.6005778,-18000,,
com.apple.finder,1,1745376024,1745376025,1745376025.93407,-18000,,
com.microsoft.Outlook,15,1745376009,1745376024,1745376024.6346831,-18000,,
com.apple.finder,4,1745376005,1745376009,1745376009.602633,-18000,,
com.google.Chrome,1,1745376004,1745376005,1745376005.327107,-18000,,
com.apple.finder,0,1745376004,1745376004,1745376005.0064712,-18000,,
com.google.Chrome,9,1745375995,1745376004,1745376004.078512,-18000,,
com.google.Chrome,270,1745375231,1745375501,1745375501.935158,-18000,,
Astrospheric.Astrospheric,17,1745374901,1745374918,1745374918.65618,-18000,EB445137-D7F5-57EC-87DA-1DB460D64046,"iPhone13,2"
com.apple.weather,17,1745374539,1745374556,1745374556.8265839,-18000,EB445137-D7F5-57EC-87DA-1DB460D64046,"iPhone13,2"
com.toyopagroup.picaboo,30,1745374503,1745374533,1745374533.84146,-18000,EB445137-D7F5-57EC-87DA-1DB460D64046,"iPhone13,2"
com.instructure.icanvas,27,1745374473,1745374500,1745374500.413912,-18000,EB445137-D7F5-57EC-87DA-1DB460D64046,"iPhone13,2"
com.instructure.icanvas,8,1745374464,1745374472,1745374472.971449,-18000,EB445137-D7F5-57EC-87DA-1DB460D64046,"iPhone13,2"
com.apple.news,0,1745374464,1745374464,1745374465.523793,-18000,EB445137-D7F5-57EC-87DA-1DB460D64046,"iPhone13,2"
com.google.Chrome,2,1745373966,1745373968,1745373968.678296,-18000,,
com.apple.finder,2,1745373964,1745373966,1745373966.4245791,-18000,,
com.leomehlig.today,29,1745373935,1745373964,1745373964.6453109,-18000,,
com.google.Chrome,9,1745373926,1745373935,1745373935.6145449,-18000,,
com.leomehlig.today,6,1745373920,1745373926,1745373926.184938,-18000,,
com.google.Chrome,6,1745373914,1745373920,1745373920.473023,-18000,,
com.leomehlig.today,2,1745373912,1745373914,1745373914.474825,-18000,,
com.google.Chrome,2,1745373910,1745373912,1745373912.791819,-18000,,
com.leomehlig.today,13,1745373897,1745373910,1745373910.077125,-18000,,
com.google.Chrome,13,1745373884,1745373897,1745373897.866302,-18000,,
com.leomehlig.today,16,1745373868,1745373884,1745373884.4509568,-18000,,
com.google.Chrome,4,1745373864,1745373868,1745373868.7866,-18000,,
com.leomehlig.today,42,1745373822,1745373864,1745373864.8879762,-18000,,
com.google.Chrome,9,1745373813,1745373822,1745373822.309417,-18000,,
com.leomehlig.today,4,1745373809,1745373813,1745373813.5169358,-18000,,
com.google.Chrome,16,1745373793,1745373809,1745373810.034437,-18000,,
com.apple.Notes,1,1745373792,1745373793,1745373793.3698878,-18000,,
com.leomehlig.today,58,1745373734,1745373792,1745373792.131995,-18000,,
com.apple.Notes,116,1745373618,1745373734,1745373734.5197248,-18000,,
com.google.Chrome,17,1745373601,1745373618,1745373618.132921,-18000,,
com.apple.Notes,102,1745373499,1745373601,1745373602.023885,-18000,,
com.leomehlig.today,56,1745373443,1745373499,1745373499.158414,-18000,,
com.google.Chrome,1258,1745372185,1745373443,1745373444.01019,-18000,,
com.apple.finder,6,1745372179,1745372185,1745372185.588614,-18000,,
com.leomehlig.today,1,1745372178,1745372179,1745372179.9813151,-18000,,
com.google.Chrome,1032,1745371146,1745372178,1745372178.6796288,-18000,,
com.leomehlig.today,9,1745371137,1745371146,1745371146.73034,-18000,,
com.apple.news,62,1745370700,1745370762,1745370763.119608,-18000,EB445137-D7F5-57EC-87DA-1DB460D64046,"iPhone13,2"
com.facebook.Facebook,42,1745370655,1745370697,1745370697.680131,-18000,EB445137-D7F5-57EC-87DA-1DB460D64046,"iPhone13,2"
com.facebook.Facebook,310,1745369848,1745370158,1745370159.3648372,-18000,EB445137-D7F5-57EC-87DA-1DB460D64046,"iPhone13,2"
com.apple.Health,2,1745369843,1745369845,1745369845.730875,-18000,EB445137-D7F5-57EC-87DA-1DB460D64046,"iPhone13,2"
com.google.Chrome,1522,1745369615,1745371137,1745371137.853249,-18000,,
com.apple.Health,26,1745369105,1745369131,1745369131.7939448,-18000,EB445137-D7F5-57EC-87DA-1DB460D64046,"iPhone13,2"
com.truebill.truebillnative,7,1745369096,1745369103,1745369103.935668,-18000,EB445137-D7F5-57EC-87DA-1DB460D64046,"iPhone13,2"
com.apple.CoreAuthUI,7,1745369096,1745369103,1745369103.939694,-18000,EB445137-D7F5-57EC-87DA-1DB460D64046,"iPhone13,2"
com.google.Chrome,413,1745369066,1745369479,1745369479.385582,-18000,,
com.truebill.truebillnative,13,1745368823,1745368836,1745368837.266437,-18000,EB445137-D7F5-57EC-87DA-1DB460D64046,"iPhone13,2"
com.apple.CoreAuthUI,2,1745368769,1745368771,1745368771.674728,-18000,EB445137-D7F5-57EC-87DA-1DB460D64046,"iPhone13,2"
com.discoverfinancial.mobile,62,1745368759,1745368821,1745368821.946172,-18000,EB445137-D7F5-57EC-87DA-1DB460D64046,"iPhone13,2"
com.truebill.truebillnative,3,1745368752,1745368755,1745368755.515008,-18000,EB445137-D7F5-57EC-87DA-1DB460D64046,"iPhone13,2"
com.apple.CoreAuthUI,2,1745368735,1745368737,1745368737.8530269,-18000,EB445137-D7F5-57EC-87DA-1DB460D64046,"iPhone13,2"
com.truebill.truebillnative,20,1745368732,1745368752,1745368753.241168,-18000,EB445137-D7F5-57EC-87DA-1DB460D64046,"iPhone13,2"
com.apple.CoreAuthUI,2,1745368716,1745368718,1745368718.796813,-18000,EB445137-D7F5-57EC-87DA-1DB460D64046,"iPhone13,2"
com.apple.CoreAuthUI,2,1745368710,1745368712,1745368712.879843,-18000,EB445137-D7F5-57EC-87DA-1DB460D64046,"iPhone13,2"
com.apple.Preferences,27,1745368693,1745368720,1745368720.507473,-18000,EB445137-D7F5-57EC-87DA-1DB460D64046,"iPhone13,2"
co.hinge.mobile.ios,7,1745368686,1745368693,1745368693.259107,-18000,EB445137-D7F5-57EC-87DA-1DB460D64046,"iPhone13,2"
com.apple.CoreAuthUI,2,1745368686,1745368688,1745368688.359937,-18000,EB445137-D7F5-57EC-87DA-1DB460D64046,"iPhone13,2"
co.hinge.mobile.ios,13,1745368671,1745368684,1745368684.176178,-18000,EB445137-D7F5-57EC-87DA-1DB460D64046,"iPhone13,2"
com.apple.CoreAuthUI,1,1745368671,1745368672,1745368672.511425,-18000,EB445137-D7F5-57EC-87DA-1DB460D64046,"iPhone13,2"
com.robinhood.release.Robinhood,2,1745368669,1745368671,1745368671.4754992,-18000,EB445137-D7F5-57EC-87DA-1DB460D64046,"iPhone13,2"
com.google.Chrome,349,1745368602,1745368951,1745368951.37504,-18000,,
com.leomehlig.today,13,1745368589,1745368602,1745368602.459943,-18000,,
com.google.Chrome,1137,1745367452,1745368589,1745368589.438439,-18000,,
com.apple.news,235,1745367217,1745367452,1745367452.3529959,-18000,,
com.google.Chrome,526,1745366691,1745367217,1745367217.466185,-18000,,
com.google.Chrome,813,1745365871,1745366684,1745366684.951098,-18000,,
com.google.Chrome,952,1745364584,1745365536,1745365536.040945,-18000,,
com.leomehlig.today,9,1745364575,1745364584,1745364584.2505689,-18000,,
com.apple.CoreAuthUI,8,1745364349,1745364357,1745364357.556097,-18000,EB445137-D7F5-57EC-87DA-1DB460D64046,"iPhone13,2"
com.robinhood.release.Robinhood,186,1745364347,1745364533,1745364534.7058501,-18000,EB445137-D7F5-57EC-87DA-1DB460D64046,"iPhone13,2"
com.microsoft.Office.Outlook,79,1745364260,1745364339,1745364340.028863,-18000,EB445137-D7F5-57EC-87DA-1DB460D64046,"iPhone13,2"
com.strava.stravaride,36,1745364222,1745364258,1745364258.031132,-18000,EB445137-D7F5-57EC-87DA-1DB460D64046,"iPhone13,2"
com.hammerandchisel.discord,16,1745364206,1745364222,1745364222.895944,-18000,EB445137-D7F5-57EC-87DA-1DB460D64046,"iPhone13,2"
com.strava.stravaride,14,1745364192,1745364206,1745364206.204977,-18000,EB445137-D7F5-57EC-87DA-1DB460D64046,"iPhone13,2"
com.hammerandchisel.discord,57,1745364120,1745364177,1745364177.366673,-18000,EB445137-D7F5-57EC-87DA-1DB460D64046,"iPhone13,2"
com.apple.news,423,1745363689,1745364112,1745364112.224817,-18000,EB445137-D7F5-57EC-87DA-1DB460D64046,"iPhone13,2"
com.apple.news,1,1745363688,1745363689,1745363689.499689,-18000,EB445137-D7F5-57EC-87DA-1DB460D64046,"iPhone13,2"
com.leomehlig.today,334,1745363155,1745363489,1745363489.899993,-18000,,
com.apple.news,38,1745361933,1745361971,1745361971.6020188,-18000,EB445137-D7F5-57EC-87DA-1DB460D64046,"iPhone13,2"
com.google.Chrome,1714,1745361441,1745363155,1745363156.068959,-18000,,
com.leomehlig.today,2,1745361439,1745361441,1745361441.980047,-18000,,
com.apple.iCal,8,1745361431,1745361439,1745361439.94524,-18000,,
com.leomehlig.today,59,1745361372,1745361431,1745361431.140504,-18000,,
com.google.Chrome,18,1745361354,1745361372,1745361372.943119,-18000,,
com.leomehlig.today,9,1745361336,1745361345,1745361345.659803,-18000,,
com.google.Chrome,207,1745361129,1745361336,1745361336.250622,-18000,,
com.google.Chrome,762,1745360140,1745360902,1745360902.7364779,-18000,,
com.leomehlig.today,14,1745360126,1745360140,1745360140.3863049,-18000,,
com.google.Chrome,204,1745359922,1745360126,1745360126.160897,-18000,,
com.intsig.CamScannerLite,125,1745357926,1745358051,1745358051.974215,-18000,EB445137-D7F5-57EC-87DA-1DB460D64046,"iPhone13,2"
com.apple.news,3,1745357923,1745357926,1745357926.371993,-18000,EB445137-D7F5-57EC-87DA-1DB460D64046,"iPhone13,2"
com.apple.news,5,1745357655,1745357660,1745357661.1612492,-18000,EB445137-D7F5-57EC-87DA-1DB460D64046,"iPhone13,2"
com.microsoft.Office.Outlook,2,1745357652,1745357654,1745357654.5798821,-18000,EB445137-D7F5-57EC-87DA-1DB460D64046,"iPhone13,2"
com.microsoft.Office.Outlook,18,1745357052,1745357070,1745357071.003704,-18000,EB445137-D7F5-57EC-87DA-1DB460D64046,"iPhone13,2"
com.microsoft.Office.Outlook,14,1745356218,1745356232,1745356232.910042,-18000,EB445137-D7F5-57EC-87DA-1DB460D64046,"iPhone13,2"
com.instructure.icanvas,6,1745354516,1745354522,1745354522.572546,-18000,EB445137-D7F5-57EC-87DA-1DB460D64046,"iPhone13,2"
com.google.Gmail,0,1745354516,1745354516,1745354517.3812242,-18000,EB445137-D7F5-57EC-87DA-1DB460D64046,"iPhone13,2"
com.google.Gmail,8,1745354507,1745354515,1745354516.1264172,-18000,EB445137-D7F5-57EC-87DA-1DB460D64046,"iPhone13,2"
com.apple.MobileSMS,14,1745354486,1745354500,1745354500.963912,-18000,EB445137-D7F5-57EC-87DA-1DB460D64046,"iPhone13,2"
com.google.Chrome,159,1745354436,1745354595,1745354595.955874,-18000,,
com.google.Chrome,503,1745353789,1745354292,1745354292.596436,-18000,,
com.apple.finder,17,1745353772,1745353789,1745353789.9652781,-18000,,
com.google.Chrome,126,1745353646,1745353772,1745353772.373286,-18000,,
com.apple.finder,168,1745353478,1745353646,1745353646.854502,-18000,,
com.google.Chrome,333,1745353145,1745353478,1745353478.936489,-18000,,
com.apple.finder,186,1745352959,1745353145,1745353145.6862879,-18000,,
com.google.Chrome,552,1745352407,1745352959,1745352959.564749,-18000,,
com.apple.finder,197,1745352210,1745352407,1745352407.750799,-18000,,
com.google.Chrome,5,1745352205,1745352210,1745352211.079648,-18000,,
com.google.Chrome,5,1745350951,1745350956,1745350956.774972,-18000,,
com.google.Chrome,278,1745350673,1745350951,1745350951.717435,-18000,,
com.apple.finder,238,1745350435,1745350673,1745350673.871612,-18000,,
com.google.Chrome,5,1745350430,1745350435,1745350435.278102,-18000,,
com.google.Chrome,373,1745349890,1745350263,1745350263.366344,-18000,,
com.apple.news,97,1745349525,1745349622,1745349622.52136,-18000,EB445137-D7F5-57EC-87DA-1DB460D64046,"iPhone13,2"
com.apple.MobileSMS,3,1745349511,1745349514,1745349514.1335878,-18000,EB445137-D7F5-57EC-87DA-1DB460D64046,"iPhone13,2"
com.toyopagroup.picaboo,41,1745349468,1745349509,1745349509.468312,-18000,EB445137-D7F5-57EC-87DA-1DB460D64046,"iPhone13,2"
com.apple.news,1,1745349467,1745349468,1745349468.815454,-18000,EB445137-D7F5-57EC-87DA-1DB460D64046,"iPhone13,2"
com.apple.news,6,1745348405,1745348411,1745348412.736582,-18000,EB445137-D7F5-57EC-87DA-1DB460D64046,"iPhone13,2"
com.apple.news,44,1745348357,1745348401,1745348402.130772,-18000,EB445137-D7F5-57EC-87DA-1DB460D64046,"iPhone13,2"
com.hammerandchisel.discord,25,1745348322,1745348347,1745348347.239022,-18000,EB445137-D7F5-57EC-87DA-1DB460D64046,"iPhone13,2"
com.microsoft.Office.Outlook,64,1745348257,1745348321,1745348321.778668,-18000,EB445137-D7F5-57EC-87DA-1DB460D64046,"iPhone13,2"
com.microsoft.Office.Outlook,2,1745348243,1745348245,1745348245.895893,-18000,EB445137-D7F5-57EC-87DA-1DB460D64046,"iPhone13,2"
com.microsoft.Office.Outlook,27,1745348164,1745348191,1745348191.916786,-18000,EB445137-D7F5-57EC-87DA-1DB460D64046,"iPhone13,2"
com.apple.MobileSMS,60,1745347908,1745347968,1745347968.327568,-18000,EB445137-D7F5-57EC-87DA-1DB460D64046,"iPhone13,2"
com.apple.MobileSMS,7,1745347901,1745347908,1745347908.542502,-18000,EB445137-D7F5-57EC-87DA-1DB460D64046,"iPhone13,2"
com.google.Chrome,3,1745347848,1745347851,1745347851.629293,-18000,,
com.leomehlig.today,108,1745347740,1745347848,1745347848.84169,-18000,,
com.google.Chrome,29,1745347711,1745347740,1745347740.713142,-18000,,
com.leomehlig.today,6,1745347705,1745347711,1745347711.41277,-18000,,
com.apple.MobileSMS,6,1745347699,1745347705,1745347705.419392,-18000,,
com.leomehlig.today,1,1745347698,1745347699,1745347699.353108,-18000,,
com.google.Chrome,1,1745347697,1745347698,1745347698.7774649,-18000,,
com.apple.Preview,28,1745347669,1745347697,1745347697.193666,-18000,,
com.apple.MobileSMS,300,1745347369,1745347669,1745347669.3871012,-18000,,
com.apple.Preview,40,1745347329,1745347369,1745347369.729131,-18000,,
com.apple.finder,5,1745347324,1745347329,1745347329.0747252,-18000,,
com.google.Chrome,4,1745347320,1745347324,1745347324.804553,-18000,,
com.apple.finder,7,1745347313,1745347320,1745347320.494092,-18000,,
com.google.Chrome,63,1745347250,1745347313,1745347313.1995049,-18000,,
com.apple.finder,23,1745347227,1745347250,1745347250.768285,-18000,,
com.apple.MobileSMS,28,1745347012,1745347040,1745347040.582786,-18000,EB445137-D7F5-57EC-87DA-1DB460D64046,"iPhone13,2"
com.hammerandchisel.discord,90,1745346922,1745347012,1745347012.30353,-18000,EB445137-D7F5-57EC-87DA-1DB460D64046,"iPhone13,2"
com.microsoft.Office.Outlook,2,1745346920,1745346922,1745346922.272756,-18000,EB445137-D7F5-57EC-87DA-1DB460D64046,"iPhone13,2"
com.microsoft.Office.Outlook,61,1745346859,1745346920,1745346920.466716,-18000,EB445137-D7F5-57EC-87DA-1DB460D64046,"iPhone13,2"
com.apple.Preview,618,1745346609,1745347227,1745347227.0971742,-18000,,
com.apple.finder,1,1745346608,1745346609,1745346609.894816,-18000,,
com.google.Chrome,3,1745346605,1745346608,1745346608.1862469,-18000,,
com.hammerandchisel.discord,114,1745346391,1745346505,1745346505.3015928,-18000,EB445137-D7F5-57EC-87DA-1DB460D64046,"iPhone13,2"
com.hammerandchisel.discord,69,1745345236,1745345305,1745345305.338875,-18000,EB445137-D7F5-57EC-87DA-1DB460D64046,"iPhone13,2"
com.microsoft.Office.Outlook,2,1745345234,1745345236,1745345236.827292,-18000,EB445137-D7F5-57EC-87DA-1DB460D64046,"iPhone13,2"
com.microsoft.Office.Outlook,102,1745344996,1745345098,1745345099.1592999,-18000,EB445137-D7F5-57EC-87DA-1DB460D64046,"iPhone13,2"
com.google.Chrome,1496,1745344730,1745346226,1745346226.1493921,-18000,,
com.leomehlig.today,0,1745344730,1745344730,1745344730.8744268,-18000,,
com.google.Chrome,34,1745344696,1745344730,1745344730.0544128,-18000,,
com.leomehlig.today,24,1745344672,1745344696,1745344696.630252,-18000,,
com.google.Chrome,19,1745344653,1745344672,1745344672.569981,-18000,,
com.google.Chrome,310,1745344269,1745344579,1745344579.878213,-18000,,
com.apple.Preview,3,1745344266,1745344269,1745344269.8216472,-18000,,
com.google.Chrome,28,1745344238,1745344266,1745344266.671784,-18000,,
com.apple.Preview,0,1745344238,1745344238,1745344238.971446,-18000,,
com.google.Chrome,18,1745344220,1745344238,1745344238.463677,-18000,,
com.apple.Preview,0,1745344220,1745344220,1745344220.694376,-18000,,
com.google.Chrome,5,1745344215,1745344220,1745344220.2415729,-18000,,
com.apple.Preview,2,1745344213,1745344215,1745344215.427267,-18000,,
com.google.Chrome,7,1745344206,1745344213,1745344213.404432,-18000,,
com.apple.Preview,4,1745344202,1745344206,1745344206.903802,-18000,,
com.google.Chrome,23,1745344179,1745344202,1745344203.031079,-18000,,
com.apple.Preview,1,1745344178,1745344179,1745344179.842119,-18000,,
com.google.Chrome,7,1745344171,1745344178,1745344178.8048968,-18000,,
com.apple.Preview,3,1745344168,1745344171,1745344171.985897,-18000,,
com.google.Chrome,1,1745344167,1745344168,1745344168.496216,-18000,,
com.apple.Preview,2,1745344165,1745344167,1745344167.397025,-18000,,
com.google.Chrome,19,1745344146,1745344165,1745344165.217939,-18000,,
com.apple.Preview,2,1745344144,1745344146,1745344146.939044,-18000,,
com.google.Chrome,7,1745344137,1745344144,1745344144.4764729,-18000,,
com.apple.Preview,4,1745344133,1745344137,1745344137.151013,-18000,,
com.google.Chrome,42,1745344091,1745344133,1745344133.637731,-18000,,
com.apple.Preview,2,1745344089,1745344091,1745344091.43861,-18000,,
com.google.Chrome,1,1745344088,1745344089,1745344089.999549,-18000,,
com.apple.Preview,2,1745344086,1745344088,1745344088.2421222,-18000,,
com.google.Chrome,21,1745344065,1745344086,1745344086.387244,-18000,,
com.apple.Preview,2,1745344063,1745344065,1745344065.619528,-18000,,
com.google.Chrome,99,1745343964,1745344063,1745344063.2810159,-18000,,
com.apple.Preview,2,1745343962,1745343964,1745343964.239678,-18000,,
com.google.Chrome,35,1745343927,1745343962,1745343962.276573,-18000,,
com.apple.Preview,1,1745343926,1745343927,1745343927.4607968,-18000,,
com.google.Chrome,3,1745343923,1745343926,1745343926.433532,-18000,,
com.apple.Preview,1,1745343922,1745343923,1745343923.857833,-18000,,
com.google.Chrome,4,1745343918,1745343922,1745343922.549151,-18000,,
com.apple.Preview,2,1745343916,1745343918,1745343918.147454,-18000,,
com.google.Chrome,39,1745343877,1745343916,1745343916.7378569,-18000,,
com.apple.Preview,4,1745343873,1745343877,1745343877.5427752,-18000,,
com.apple.finder,5,1745343868,1745343873,1745343873.522327,-18000,,
com.google.Chrome,36,1745343832,1745343868,1745343868.6543732,-18000,,
com.leomehlig.today,3,1745343829,1745343832,1745343834.487004,-18000,,
com.microsoft.Office.Outlook,1,1745342723,1745342724,1745342725.305645,-18000,EB445137-D7F5-57EC-87DA-1DB460D64046,"iPhone13,2"
com.google.chrome.ios,7,1745342716,1745342723,1745342723.612669,-18000,EB445137-D7F5-57EC-87DA-1DB460D64046,"iPhone13,2"
com.microsoft.Office.Outlook,11,1745342705,1745342716,1745342716.5883799,-18000,EB445137-D7F5-57EC-87DA-1DB460D64046,"iPhone13,2"
com.hammerandchisel.discord,38,1745342667,1745342705,1745342705.621025,-18000,EB445137-D7F5-57EC-87DA-1DB460D64046,"iPhone13,2"
com.google.chrome.ios,34,1745342633,1745342667,1745342667.383071,-18000,EB445137-D7F5-57EC-87DA-1DB460D64046,"iPhone13,2"
com.google.chrome.ios,91,1745342047,1745342138,1745342139.575212,-18000,EB445137-D7F5-57EC-87DA-1DB460D64046,"iPhone13,2"
com.strava.stravaride,1,1745342046,1745342047,1745342047.827261,-18000,EB445137-D7F5-57EC-87DA-1DB460D64046,"iPhone13,2"
com.strava.stravaride,56,1745341903,1745341959,1745341959.254518,-18000,EB445137-D7F5-57EC-87DA-1DB460D64046,"iPhone13,2"
com.strava.stravaride,3,1745341839,1745341842,1745341842.7712998,-18000,EB445137-D7F5-57EC-87DA-1DB460D64046,"iPhone13,2"
com.leomehlig.today,21,1745340090,1745340111,1745340111.07788,-18000,,
com.apple.finder,2,1745340088,1745340090,1745340090.479063,-18000,,
com.apple.iCal,14,1745340074,1745340088,1745340089.025743,-18000,,
com.google.Chrome,88,1745339986,1745340074,1745340074.0696568,-18000,,
com.google.Chrome,718,1745339260,1745339978,1745339978.069865,-18000,,
com.apple.Preview,196,1745339064,1745339260,1745339260.394681,-18000,,
com.apple.finder,4,1745339060,1745339064,1745339064.210922,-18000,,
com.apple.Preview,2,1745339058,1745339060,1745339060.465297,-18000,,
com.google.Chrome,251,1745338807,1745339058,1745339058.478133,-18000,,
com.leomehlig.today,83,1745338724,1745338807,1745338807.821466,-18000,,
com.google.Chrome,1687,1745337037,1745338724,1745338724.373407,-18000,,
com.apple.news,441,1745336574,1745337015,1745337016.143451,-18000,EB445137-D7F5-57EC-87DA-1DB460D64046,"iPhone13,2"
com.apple.Health,202,1745336366,1745336568,1745336568.784929,-18000,EB445137-D7F5-57EC-87DA-1DB460D64046,"iPhone13,2"
com.google.Chrome,714,1745336230,1745336944,1745336944.450333,-18000,,
com.apple.Preview,4,1745335261,1745335265,1745335265.281518,-18000,,
com.google.Chrome,53,1745335208,1745335261,1745335261.406797,-18000,,
com.apple.Preview,222,1745334986,1745335208,1745335208.636966,-18000,,
com.apple.finder,9,1745334977,1745334986,1745334986.780778,-18000,,
com.google.Chrome,661,1745334316,1745334977,1745334977.616198,-18000,,
com.hammerandchisel.discord,115,1745334196,1745334311,1745334311.62575,-18000,EB445137-D7F5-57EC-87DA-1DB460D64046,"iPhone13,2"
Astrospheric.Astrospheric,35,1745334160,1745334195,1745334195.534461,-18000,EB445137-D7F5-57EC-87DA-1DB460D64046,"iPhone13,2"
com.tinyspeck.chatlyio,4,1745334146,1745334150,1745334150.346843,-18000,EB445137-D7F5-57EC-87DA-1DB460D64046,"iPhone13,2"
com.google.Chrome,347,1745333963,1745334310,1745334310.225576,-18000,,
com.google.Chrome,301,1745333662,1745333963,1745333963.052813,-18000,,
com.google.Chrome,394,1745333266,1745333660,1745333660.652966,-18000,,
com.leomehlig.today,87,1745333179,1745333266,1745333266.708606,-18000,,
com.google.Chrome,48,1745333131,1745333179,1745333179.70765,-18000,,
com.apple.finder,2,1745333129,1745333131,1745333131.233897,-18000,,
com.tinyspeck.chatlyio,39,1745333055,1745333094,1745333094.82075,-18000,EB445137-D7F5-57EC-87DA-1DB460D64046,"iPhone13,2"
com.leomehlig.today,93,1745333036,1745333129,1745333129.7934098,-18000,,
com.apple.finder,8,1745333028,1745333036,1745333036.622186,-18000,,
com.microsoft.Powerpoint,2,1745333026,1745333028,1745333028.1009011,-18000,,
com.tinyspeck.chatlyio,76,1745332936,1745333012,1745333012.8001409,-18000,EB445137-D7F5-57EC-87DA-1DB460D64046,"iPhone13,2"
com.apple.finder,113,1745332913,1745333026,1745333026.960491,-18000,,
com.microsoft.Powerpoint,46,1745332867,1745332913,1745332913.494278,-18000,,
com.google.Chrome,3,1745332864,1745332867,1745332867.559011,-18000,,
com.apple.mobileslideshow,106,1745332827,1745332933,1745332933.712679,-18000,EB445137-D7F5-57EC-87DA-1DB460D64046,"iPhone13,2"
com.microsoft.Office.Outlook,34,1745332791,1745332825,1745332825.84263,-18000,EB445137-D7F5-57EC-87DA-1DB460D64046,"iPhone13,2"
com.google.chrome.ios,49,1745332742,1745332791,1745332791.630865,-18000,EB445137-D7F5-57EC-87DA-1DB460D64046,"iPhone13,2"
com.microsoft.Office.Outlook,41,1745332701,1745332742,1745332742.3357902,-18000,EB445137-D7F5-57EC-87DA-1DB460D64046,"iPhone13,2"
com.google.chrome.ios,1,1745332700,1745332701,1745332701.772924,-18000,EB445137-D7F5-57EC-87DA-1DB460D64046,"iPhone13,2"
com.google.chrome.ios,38,1745332661,1745332699,1745332699.540732,-18000,EB445137-D7F5-57EC-87DA-1DB460D64046,"iPhone13,2"
com.microsoft.Office.Outlook,33,1745332628,1745332661,1745332661.0307322,-18000,EB445137-D7F5-57EC-87DA-1DB460D64046,"iPhone13,2"
com.strava.stravaride,164,1745332456,1745332620,1745332620.377619,-18000,EB445137-D7F5-57EC-87DA-1DB460D64046,"iPhone13,2"
com.apple.weather,9,1745329670,1745329679,1745329679.870146,-18000,EB445137-D7F5-57EC-87DA-1DB460D64046,"iPhone13,2"
com.renpho.health,2,1745329667,1745329669,1745329669.583185,-18000,EB445137-D7F5-57EC-87DA-1DB460D64046,"iPhone13,2"
com.renpho.health,23,1745329615,1745329638,1745329638.799886,-18000,EB445137-D7F5-57EC-87DA-1DB460D64046,"iPhone13,2"
com.apple.weather,2,1745329611,1745329613,1745329613.326332,-18000,EB445137-D7F5-57EC-87DA-1DB460D64046,"iPhone13,2"
com.apple.weather,44,1745326042,1745326086,1745326086.351896,-18000,EB445137-D7F5-57EC-87DA-1DB460D64046,"iPhone13,2"
com.apple.Health,30,1745326009,1745326039,1745326039.349066,-18000,EB445137-D7F5-57EC-87DA-1DB460D64046,"iPhone13,2"
com.apple.news,280,1745325727,1745326007,1745326007.229908,-18000,EB445137-D7F5-57EC-87DA-1DB460D64046,"iPhone13,2"
com.instructure.icanvas,89,1745325632,1745325721,1745325721.4758859,-18000,EB445137-D7F5-57EC-87DA-1DB460D64046,"iPhone13,2"
com.instructure.icanvas,12,1745325619,1745325631,1745325631.576346,-18000,EB445137-D7F5-57EC-87DA-1DB460D64046,"iPhone13,2"
com.google.Chrome,471,1745292224,1745292695,1745292695.82522,-18000,,
com.apple.finder,2,1745292222,1745292224,1745292224.227489,-18000,,
com.leomehlig.today,14,1745292208,1745292222,1745292222.543122,-18000,,
com.hammerandchisel.discord,12,1745292151,1745292163,1745292163.305176,-18000,EB445137-D7F5-57EC-87DA-1DB460D64046,"iPhone13,2"
com.toyopagroup.picaboo,22,1745292075,1745292097,1745292097.8787498,-18000,EB445137-D7F5-57EC-87DA-1DB460D64046,"iPhone13,2"
com.apple.news,0,1745292075,1745292075,1745292075.710885,-18000,EB445137-D7F5-57EC-87DA-1DB460D64046,"iPhone13,2"
com.apple.news,105,1745289177,1745289282,1745289282.683981,-18000,EB445137-D7F5-57EC-87DA-1DB460D64046,"iPhone13,2"
com.apple.mobilecal,29,1745289140,1745289169,1745289169.686379,-18000,EB445137-D7F5-57EC-87DA-1DB460D64046,"iPhone13,2"
com.instructure.icanvas,34,1745289101,1745289135,1745289135.433381,-18000,EB445137-D7F5-57EC-87DA-1DB460D64046,"iPhone13,2"
com.burbn.instagram,0,1745289101,1745289101,1745289102.3450708,-18000,EB445137-D7F5-57EC-87DA-1DB460D64046,"iPhone13,2"
com.burbn.instagram,29,1745287962,1745287991,1745287991.9533072,-18000,EB445137-D7F5-57EC-87DA-1DB460D64046,"iPhone13,2"
com.toyopagroup.picaboo,2,1745287957,1745287959,1745287959.221601,-18000,EB445137-D7F5-57EC-87DA-1DB460D64046,"iPhone13,2"
com.toyopagroup.picaboo,14,1745285889,1745285903,1745285904.297993,-18000,EB445137-D7F5-57EC-87DA-1DB460D64046,"iPhone13,2"
com.toyopagroup.picaboo,72,1745284644,1745284716,1745284716.3643599,-18000,EB445137-D7F5-57EC-87DA-1DB460D64046,"iPhone13,2"
com.hammerandchisel.discord,14,1745280242,1745280256,1745280256.420096,-18000,EB445137-D7F5-57EC-87DA-1DB460D64046,"iPhone13,2"
com.apple.Health,42,1745279920,1745279962,1745279962.49152,-18000,EB445137-D7F5-57EC-87DA-1DB460D64046,"iPhone13,2"
com.hammerandchisel.discord,8,1745279470,1745279478,1745279478.31277,-18000,EB445137-D7F5-57EC-87DA-1DB460D64046,"iPhone13,2"
com.microsoft.Office.Outlook,0,1745279470,1745279470,1745279470.983111,-18000,EB445137-D7F5-57EC-87DA-1DB460D64046,"iPhone13,2"
com.microsoft.Office.Outlook,11,1745278249,1745278260,1745278260.675799,-18000,EB445137-D7F5-57EC-87DA-1DB460D64046,"iPhone13,2"
com.hammerandchisel.discord,4,1745278245,1745278249,1745278250.084228,-18000,EB445137-D7F5-57EC-87DA-1DB460D64046,"iPhone13,2"
com.hammerandchisel.discord,16,1745277407,1745277423,1745277423.653985,-18000,EB445137-D7F5-57EC-87DA-1DB460D64046,"iPhone13,2"
com.apple.news,1044,1745275497,1745276541,1745276541.908901,-18000,EB445137-D7F5-57EC-87DA-1DB460D64046,"iPhone13,2"
com.apple.news,6,1745275463,1745275469,1745275469.227356,-18000,EB445137-D7F5-57EC-87DA-1DB460D64046,"iPhone13,2"
com.apple.news,242,1745275027,1745275269,1745275269.703726,-18000,EB445137-D7F5-57EC-87DA-1DB460D64046,"iPhone13,2"
com.apple.mobiletimer,2,1745275024,1745275026,1745275026.394081,-18000,EB445137-D7F5-57EC-87DA-1DB460D64046,"iPhone13,2"
com.apple.mobiletimer,146,1745274096,1745274242,1745274242.401365,-18000,EB445137-D7F5-57EC-87DA-1DB460D64046,"iPhone13,2"
com.apple.mobiletimer,5,1745274088,1745274093,1745274093.373508,-18000,EB445137-D7F5-57EC-87DA-1DB460D64046,"iPhone13,2"
com.leomehlig.today,301,1745274075,1745274376,1745274376.8722591,-18000,,
com.hnc.Discord,4,1745274071,1745274075,1745274075.248193,-18000,,
com.leomehlig.today,5,1745274066,1745274071,1745274071.7947001,-18000,,
com.apple.Preview,15,1745274051,1745274066,1745274066.313524,-18000,,
com.apple.finder,8,1745274043,1745274051,1745274051.428231,-18000,,
com.apple.Preview,971,1745273072,1745274043,1745274043.282345,-18000,,
com.apple.finder,8,1745273064,1745273072,1745273072.8629231,-18000,,
com.leomehlig.today,34,1745273030,1745273064,1745273064.8842602,-18000,,
com.microsoft.Outlook,3,1745273022,1745273025,1745273025.52986,-18000,,
com.google.Chrome,65,1745272957,1745273022,1745273022.8966498,-18000,,
com.microsoft.Outlook,2,1745272955,1745272957,1745272957.511698,-18000,,
com.google.Chrome,0,1745272955,1745272955,1745272956.022406,-18000,,
com.microsoft.Outlook,42,1745272913,1745272955,1745272955.572418,-18000,,
com.leomehlig.today,2,1745272911,1745272913,1745272913.811929,-18000,,
com.leomehlig.today,24,1745272696,1745272720,1745272720.6725059,-18000,,
com.google.Chrome,3,1745272693,1745272696,1745272696.665642,-18000,,
com.apple.Notes,4,1745272689,1745272693,1745272693.328452,-18000,,
com.apple.mobiletimer,255,1745272432,1745272687,1745272687.220547,-18000,EB445137-D7F5-57EC-87DA-1DB460D64046,"iPhone13,2"
com.apple.mobiletimer,186,1745271122,1745271308,1745271308.705862,-18000,EB445137-D7F5-57EC-87DA-1DB460D64046,"iPhone13,2"
com.apple.Notes,1564,1745270883,1745272447,1745272447.030562,-18000,,
com.google.Chrome,19,1745270864,1745270883,1745270883.376097,-18000,,
com.apple.Notes,74,1745270790,1745270864,1745270864.504047,-18000,,
com.microsoft.Outlook,57,1745270733,1745270790,1745270790.0918322,-18000,,
com.apple.Notes,3,1745270730,1745270733,1745270733.9597979,-18000,,
com.google.Chrome,3,1745270727,1745270730,1745270730.678671,-18000,,
com.apple.Notes,1,1745270726,1745270727,1745270727.767054,-18000,,
com.google.Chrome,6,1745270720,1745270726,1745270726.259819,-18000,,
com.apple.Notes,13,1745270707,1745270720,1745270720.4321299,-18000,,
com.google.Chrome,207,1745270500,1745270707,1745270707.9936152,-18000,,
com.hnc.Discord,187,1745270313,1745270500,1745270500.3053222,-18000,,
com.google.Chrome,17,1745270296,1745270313,1745270313.585373,-18000,,
com.hnc.Discord,7,1745270289,1745270296,1745270296.9110231,-18000,,
com.google.Chrome,16,1745270273,1745270289,1745270289.352538,-18000,,
com.apple.finder,5,1745270268,1745270273,1745270273.1222548,-18000,,
com.leomehlig.today,10,1745270258,1745270268,1745270268.748642,-18000,,
com.google.Chrome,43,1745270215,1745270258,1745270258.948114,-18000,,
com.leomehlig.today,13,1745270202,1745270215,1745270215.7832,-18000,,
com.google.Chrome,14,1745270188,1745270202,1745270202.829564,-18000,,
com.leomehlig.today,5,1745270183,1745270188,1745270188.963032,-18000,,
com.google.Chrome,7,1745270176,1745270183,1745270183.171366,-18000,,
com.apple.Preview,210,1745269966,1745270176,1745270176.422023,-18000,,
com.apple.Notes,1,1745269965,1745269966,1745269966.721271,-18000,,
com.apple.Preview,293,1745269672,1745269965,1745269965.100764,-18000,,
com.apple.Notes,3,1745269669,1745269672,1745269672.784246,-18000,,
com.apple.Preview,32,1745269637,1745269669,1745269669.136362,-18000,,
com.apple.Notes,2,1745269635,1745269637,1745269637.9943218,-18000,,
com.apple.Preview,1,1745269634,1745269635,1745269635.7957869,-18000,,
com.apple.mobiletimer,550,1745269616,1745270166,1745270166.386152,-18000,EB445137-D7F5-57EC-87DA-1DB460D64046,"iPhone13,2"
com.apple.Notes,197,1745269437,1745269634,1745269634.120915,-18000,,
com.apple.Preview,2,1745269435,1745269437,1745269437.174868,-18000,,
com.apple.Notes,157,1745269278,1745269435,1745269435.411502,-18000,,
com.apple.Preview,25,1745269253,1745269278,1745269278.141639,-18000,,
com.apple.Notes,1,1745269252,1745269253,1745269253.892538,-18000,,
com.google.Chrome,9,1745269243,1745269252,1745269252.258743,-18000,,
com.apple.Preview,1,1745269242,1745269243,1745269243.881332,-18000,,
com.apple.Notes,20,1745269222,1745269242,1745269242.3430882,-18000,,
com.apple.Preview,3,1745269219,1745269222,1745269222.518296,-18000,,
com.apple.Notes,1062,1745268157,1745269219,1745269219.077358,-18000,,
com.apple.Preview,2,1745268155,1745268157,1745268157.991391,-18000,,
com.apple.Notes,19,1745268136,1745268155,1745268155.151201,-18000,,
com.google.Chrome,0,1745268136,1745268136,1745268136.939035,-18000,,
com.apple.Notes,24,1745268112,1745268136,1745268136.234957,-18000,,
com.google.Chrome,2,1745268110,1745268112,1745268112.143508,-18000,,
com.apple.Preview,1,1745268109,1745268110,1745268110.57101,-18000,,
com.google.Chrome,1,1745268108,1745268109,1745268109.546771,-18000,,
com.apple.Preview,26,1745268082,1745268108,1745268108.856482,-18000,,
com.apple.finder,17,1745268065,1745268082,1745268082.086904,-18000,,
com.apple.Notes,3,1745268062,1745268065,1745268066.023323,-18000,,
com.google.Chrome,1,1745268061,1745268062,1745268062.9842029,-18000,,
com.apple.Notes,75,1745267986,1745268061,1745268061.7332258,-18000,,
com.google.Chrome,7,1745267979,1745267986,1745267986.6728911,-18000,,
com.apple.Notes,65,1745267914,1745267979,1745267979.828588,-18000,,
com.leomehlig.today,9,1745267905,1745267914,1745267914.366139,-18000,,
com.google.Chrome,14,1745267891,1745267905,1745267905.8281078,-18000,,
com.apple.Preferences,12,1745266025,1745266037,1745266037.760628,-18000,EB445137-D7F5-57EC-87DA-1DB460D64046,"iPhone13,2"
com.apple.news,146,1745265875,1745266021,1745266021.7456388,-18000,EB445137-D7F5-57EC-87DA-1DB460D64046,"iPhone13,2"
com.apple.CoreAuthUI,3,1745265851,1745265854,1745265854.427981,-18000,EB445137-D7F5-57EC-87DA-1DB460D64046,"iPhone13,2"
com.robinhood.release.Robinhood,24,1745265846,1745265870,1745265870.721428,-18000,EB445137-D7F5-57EC-87DA-1DB460D64046,"iPhone13,2"
com.google.Gmail,16,1745265704,1745265720,1745265720.227133,-18000,EB445137-D7F5-57EC-87DA-1DB460D64046,"iPhone13,2"
com.apple.news,1,1745265703,1745265704,1745265704.63277,-18000,EB445137-D7F5-57EC-87DA-1DB460D64046,"iPhone13,2"
com.apple.news,176,1745261984,1745262160,1745262160.954262,-18000,EB445137-D7F5-57EC-87DA-1DB460D64046,"iPhone13,2"
com.instructure.icanvas,29,1745261952,1745261981,1745261981.513427,-18000,EB445137-D7F5-57EC-87DA-1DB460D64046,"iPhone13,2"
com.apple.mobilecal,8,1745261933,1745261941,1745261941.630095,-18000,EB445137-D7F5-57EC-87DA-1DB460D64046,"iPhone13,2"
com.apple.weather,2,1745261927,1745261929,1745261929.289346,-18000,EB445137-D7F5-57EC-87DA-1DB460D64046,"iPhone13,2"
com.apple.weather,30,1745261777,1745261807,1745261808.472914,-18000,EB445137-D7F5-57EC-87DA-1DB460D64046,"iPhone13,2"
com.microsoft.Office.Outlook,3,1745261772,1745261775,1745261775.75772,-18000,EB445137-D7F5-57EC-87DA-1DB460D64046,"iPhone13,2"
com.microsoft.Office.Outlook,2,1745261769,1745261771,1745261771.594002,-18000,EB445137-D7F5-57EC-87DA-1DB460D64046,"iPhone13,2"
com.microsoft.Office.Outlook,34,1745261118,1745261152,1745261153.183693,-18000,EB445137-D7F5-57EC-87DA-1DB460D64046,"iPhone13,2"
com.apple.MobileSMS,0,1745261118,1745261118,1745261119.1792111,-18000,EB445137-D7F5-57EC-87DA-1DB460D64046,"iPhone13,2"
com.google.Chrome,52,1745258361,1745258413,1745258413.402987,-18000,,
com.apple.iCal,20,1745258279,1745258299,1745258299.110805,-18000,,
com.google.Chrome,129,1745258150,1745258279,1745258279.979813,-18000,,
com.google.Chrome,9,1745258063,1745258072,1745258072.615752,-18000,,
com.apple.Notes,15,1745258048,1745258063,1745258063.572005,-18000,,
com.google.Chrome,141,1745257907,1745258048,1745258048.8743072,-18000,,
com.apple.Notes,4,1745257903,1745257907,1745257908.360297,-18000,,
com.leomehlig.today,6,1745257897,1745257903,1745257903.993691,-18000,,
com.apple.news,10,1745257887,1745257897,1745257897.943791,-18000,,
com.leomehlig.today,2,1745257885,1745257887,1745257887.6380491,-18000,,
com.microsoft.Outlook,8,1745257877,1745257885,1745257885.4565449,-18000,,
com.leomehlig.today,6,1745257871,1745257877,1745257878.024312,-18000,,
com.apple.Preview,0,1745257871,1745257871,1745257871.925447,-18000,,
com.leomehlig.today,4,1745257867,1745257871,1745257871.6241698,-18000,,
com.microsoft.Powerpoint,8,1745257859,1745257867,1745257867.809207,-18000,,
com.apple.MobileSMS,2,1745257844,1745257846,1745257847.104881,-18000,EB445137-D7F5-57EC-87DA-1DB460D64046,"iPhone13,2"
com.apple.MobileSMS,67,1745257739,1745257806,1745257806.5020661,-18000,EB445137-D7F5-57EC-87DA-1DB460D64046,"iPhone13,2"
com.apple.news,0,1745257739,1745257739,1745257740.972342,-18000,EB445137-D7F5-57EC-87DA-1DB460D64046,"iPhone13,2"
com.apple.news,112,1745256745,1745256857,1745256858.2149448,-18000,EB445137-D7F5-57EC-87DA-1DB460D64046,"iPhone13,2"
com.apple.news,17,1745256704,1745256721,1745256721.395227,-18000,EB445137-D7F5-57EC-87DA-1DB460D64046,"iPhone13,2"
com.hammerandchisel.discord,26,1745256607,1745256633,1745256633.347405,-18000,EB445137-D7F5-57EC-87DA-1DB460D64046,"iPhone13,2"
com.apple.MobileSMS,8,1745256599,1745256607,1745256607.806036,-18000,EB445137-D7F5-57EC-87DA-1DB460D64046,"iPhone13,2"
com.hammerandchisel.discord,24,1745256575,1745256599,1745256599.068497,-18000,EB445137-D7F5-57EC-87DA-1DB460D64046,"iPhone13,2"
com.apple.MobileSMS,14,1745256560,1745256574,1745256574.2465348,-18000,EB445137-D7F5-57EC-87DA-1DB460D64046,"iPhone13,2"
com.google.chrome.ios,8,1745256552,1745256560,1745256560.819911,-18000,EB445137-D7F5-57EC-87DA-1DB460D64046,"iPhone13,2"
com.apple.MobileSMS,4,1745256548,1745256552,1745256552.27351,-18000,EB445137-D7F5-57EC-87DA-1DB460D64046,"iPhone13,2"
com.apple.Preferences,206,1745256160,1745256366,1745256366.914836,-18000,EB445137-D7F5-57EC-87DA-1DB460D64046,"iPhone13,2"
com.apple.mobileslideshow,94,1745256065,1745256159,1745256159.475986,-18000,EB445137-D7F5-57EC-87DA-1DB460D64046,"iPhone13,2"
com.tinyspeck.chatlyio,3,1745256006,1745256009,1745256009.691616,-18000,EB445137-D7F5-57EC-87DA-1DB460D64046,"iPhone13,2"
com.tinyspeck.chatlyio,1,1745256005,1745256006,1745256006.1511421,-18000,EB445137-D7F5-57EC-87DA-1DB460D64046,"iPhone13,2"
com.tinyspeck.chatlyio,1,1745256004,1745256005,1745256005.480208,-18000,EB445137-D7F5-57EC-87DA-1DB460D64046,"iPhone13,2"
com.microsoft.Powerpoint,16,1745255863,1745255879,1745255879.836584,-18000,,
com.leomehlig.today,4,1745255859,1745255863,1745255863.127415,-18000,,
com.tinyspeck.chatlyio,13,1745255203,1745255216,1745255216.273261,-18000,EB445137-D7F5-57EC-87DA-1DB460D64046,"iPhone13,2"
com.tinyspeck.chatlyio,7,1745254941,1745254948,1745254948.9303231,-18000,EB445137-D7F5-57EC-87DA-1DB460D64046,"iPhone13,2"
com.tinyspeck.chatlyio,16,1745254832,1745254848,1745254849.014573,-18000,EB445137-D7F5-57EC-87DA-1DB460D64046,"iPhone13,2"
com.microsoft.Office.Outlook,4,1745254825,1745254829,1745254829.549018,-18000,EB445137-D7F5-57EC-87DA-1DB460D64046,"iPhone13,2"
com.microsoft.Office.Outlook,2,1745254823,1745254825,1745254825.433358,-18000,EB445137-D7F5-57EC-87DA-1DB460D64046,"iPhone13,2"
com.microsoft.Office.Outlook,11,1745254249,1745254260,1745254260.8800368,-18000,EB445137-D7F5-57EC-87DA-1DB460D64046,"iPhone13,2"
com.apple.news,2,1745254246,1745254248,1745254248.286975,-18000,EB445137-D7F5-57EC-87DA-1DB460D64046,"iPhone13,2"
com.apple.news,452,1745250781,1745251233,1745251234.569916,-18000,EB445137-D7F5-57EC-87DA-1DB460D64046,"iPhone13,2"
com.microsoft.Office.Outlook,46,1745250725,1745250771,1745250771.7781482,-18000,EB445137-D7F5-57EC-87DA-1DB460D64046,"iPhone13,2"
com.apple.Health,58,1745250428,1745250486,1745250486.505089,-18000,EB445137-D7F5-57EC-87DA-1DB460D64046,"iPhone13,2"
com.microsoft.Office.Outlook,0,1745250428,1745250428,1745250429.594108,-18000,EB445137-D7F5-57EC-87DA-1DB460D64046,"iPhone13,2"
com.leomehlig.today,31,1745250347,1745250378,1745250378.724834,-18000,,
com.apple.iCal,11,1745250336,1745250347,1745250347.787109,-18000,,
com.leomehlig.today,4,1745250332,1745250336,1745250336.2767339,-18000,,
com.apple.Preview,3,1745250329,1745250332,1745250332.1683369,-18000,,
com.apple.Preview,301,1745250009,1745250310,1745250310.240572,-18000,,
com.microsoft.Outlook,32,1745249977,1745250009,1745250009.440432,-18000,,
com.apple.Preview,334,1745249643,1745249977,1745249977.544522,-18000,,
com.apple.finder,2,1745249641,1745249643,1745249643.691711,-18000,,
com.apple.Preview,0,1745249641,1745249641,1745249642.0185509,-18000,,
com.apple.Preview,299,1745249341,1745249640,1745249640.846658,-18000,,
com.apple.finder,7,1745249334,1745249341,1745249341.0620751,-18000,,
com.leomehlig.today,1,1745249333,1745249334,1745249334.0779881,-18000,,
com.apple.finder,2,1745249331,1745249333,1745249333.1425729,-18000,,
com.microsoft.VSCode,1,1745249330,1745249331,1745249332.03201,-18000,,
com.google.Chrome,1,1745249329,1745249330,1745249330.646497,-18000,,
com.apple.finder,19,1745249310,1745249329,1745249329.637484,-18000,,
com.apple.iCal,19,1745249291,1745249310,1745249310.235913,-18000,,
com.apple.shortcuts,2,1745249289,1745249291,1745249291.196634,-18000,,
com.microsoft.Office.Outlook,23,1745249244,1745249267,1745249267.8441439,-18000,EB445137-D7F5-57EC-87DA-1DB460D64046,"iPhone13,2"
Astrospheric.Astrospheric,16,1745249228,1745249244,1745249245.071086,-18000,EB445137-D7F5-57EC-87DA-1DB460D64046,"iPhone13,2"
com.apple.iCal,102,1745249187,1745249289,1745249289.88349,-18000,,
com.microsoft.Office.Outlook,56,1745249163,1745249219,1745249220.1643271,-18000,EB445137-D7F5-57EC-87DA-1DB460D64046,"iPhone13,2"
com.instructure.icanvas,0,1745249163,1745249163,1745249163.992378,-18000,EB445137-D7F5-57EC-87DA-1DB460D64046,"iPhone13,2"
com.apple.finder,122,1745249065,1745249187,1745249187.366096,-18000,,
com.google.Chrome,356,1745248709,1745249065,1745249066.0916471,-18000,,
com.microsoft.VSCode,153,1745248556,1745248709,1745248709.370455,-18000,,
com.apple.finder,60,1745248496,1745248556,1745248556.328764,-18000,,
com.apple.shortcuts,6,1745248490,1745248496,1745248496.50389,-18000,,
com.leomehlig.today,2,1745248439,1745248441,1745248441.861934,-18000,,
com.apple.iCal,413,1745248026,1745248439,1745248439.750019,-18000,,
com.google.Chrome,7,1745248019,1745248026,1745248026.911386,-18000,,
com.leomehlig.today,111,1745247908,1745248019,1745248020.0395942,-18000,,
com.apple.iCal,10,1745247898,1745247908,1745247908.14625,-18000,,
com.leomehlig.today,42,1745247856,1745247898,1745247898.931467,-18000,,
com.google.Chrome,152,1745247704,1745247856,1745247856.2142692,-18000,,
com.apple.news,10,1745247647,1745247657,1745247657.569464,-18000,,
com.instructure.icanvas,17,1745247264,1745247281,1745247282.113508,-18000,EB445137-D7F5-57EC-87DA-1DB460D64046,"iPhone13,2"
com.apple.news,1214,1745246020,1745247234,1745247234.972923,-18000,,
com.renpho.health,2,1745246016,1745246018,1745246018.720543,-18000,EB445137-D7F5-57EC-87DA-1DB460D64046,"iPhone13,2"
com.google.Chrome,210,1745245810,1745246020,1745246020.358464,-18000,,
com.leomehlig.today,11,1745245781,1745245792,1745245792.857438,-18000,,
com.apple.finder,1,1745245780,1745245781,1745245781.479097,-18000,,
com.microsoft.VSCode,2,1745245778,1745245780,1745245780.691409,-18000,,
com.google.Chrome,6,1745245772,1745245778,1745245778.539163,-18000,,
com.microsoft.Outlook,59,1745245713,1745245772,1745245772.631783,-18000,,
com.google.Chrome,30,1745245683,1745245713,1745245713.43766,-18000,,
com.microsoft.Outlook,35,1745245648,1745245683,1745245683.8779259,-18000,,
com.google.Chrome,3,1745245645,1745245648,1745245648.516742,-18000,,
com.microsoft.Outlook,10,1745245635,1745245645,1745245645.5719461,-18000,,
com.google.Chrome,1,1745245634,1745245635,1745245635.879556,-18000,,
com.microsoft.Outlook,6,1745245628,1745245634,1745245634.11747,-18000,,
com.google.Chrome,62,1745245566,1745245628,1745245628.62134,-18000,,
com.microsoft.Outlook,105,1745245461,1745245566,1745245566.2342548,-18000,,
com.google.Chrome,35,1745245426,1745245461,1745245461.126989,-18000,,
com.microsoft.Outlook,9,1745245417,1745245426,1745245426.779968,-18000,,
com.google.Chrome,3,1745245414,1745245417,1745245417.618006,-18000,,
com.microsoft.Outlook,10,1745245404,1745245414,1745245414.231021,-18000,,
com.google.Chrome,2,1745245402,1745245404,1745245404.834962,-18000,,
com.microsoft.Outlook,2,1745245400,1745245402,1745245402.1552138,-18000,,
com.google.Chrome,3,1745245397,1745245400,1745245400.985258,-18000,,
com.microsoft.Outlook,4,1745245393,1745245397,1745245397.936308,-18000,,
com.google.Chrome,4,1745245389,1745245393,1745245393.613137,-18000,,
com.microsoft.Outlook,6,1745245383,1745245389,1745245389.720986,-18000,,
com.google.Chrome,4,1745245379,1745245383,1745245383.739356,-18000,,
com.apple.mail,2,1745245377,1745245379,1745245379.992463,-18000,,
com.google.Chrome,32,1745245345,1745245377,1745245377.601846,-18000,,
com.apple.Preview,124,1745245221,1745245345,1745245345.3051128,-18000,,
com.apple.finder,9,1745245212,1745245221,1745245221.973002,-18000,,
com.google.Chrome,12,1745245200,1745245212,1745245212.26754,-18000,,
com.microsoft.Powerpoint,99,1745245101,1745245200,1745245200.348202,-18000,,
com.google.Chrome,2,1745245099,1745245101,1745245101.194721,-18000,,
com.microsoft.Powerpoint,34,1745245065,1745245099,1745245099.35144,-18000,,
com.google.Chrome,36,1745245029,1745245065,1745245065.3331099,-18000,,
com.microsoft.Outlook,76,1745244953,1745245029,1745245029.5543342,-18000,,
com.leomehlig.today,29,1745244924,1745244953,1745244953.263475,-18000,,
com.google.Chrome,179,1745244745,1745244924,1745244924.640473,-18000,,
com.apple.calculator,18,1745244727,1745244745,1745244745.3505058,-18000,,
com.google.Chrome,21,1745244706,1745244727,1745244727.302555,-18000,,
com.microsoft.VSCode,34,1745244672,1745244706,1745244706.642159,-18000,,
com.google.Chrome,9,1745244663,1745244672,1745244675.233862,-18000,,
com.renpho.health,32,1745242638,1745242670,1745242670.621014,-18000,EB445137-D7F5-57EC-87DA-1DB460D64046,"iPhone13,2"
com.google.Chrome,679,1745207275,1745207954,1745207954.1475291,-18000,,
com.apple.finder,3,1745207272,1745207275,1745207275.0988169,-18000,,
com.apple.weather,25,1745207091,1745207116,1745207116.274658,-18000,EB445137-D7F5-57EC-87DA-1DB460D64046,"iPhone13,2"
com.apple.MobileSMS,183,1745206886,1745207069,1745207069.390501,-18000,EB445137-D7F5-57EC-87DA-1DB460D64046,"iPhone13,2"
com.apple.weather,10,1745202451,1745202461,1745202461.2312179,-18000,EB445137-D7F5-57EC-87DA-1DB460D64046,"iPhone13,2"
com.google.chrome.ios,2,1745202449,1745202451,1745202451.410291,-18000,EB445137-D7F5-57EC-87DA-1DB460D64046,"iPhone13,2"
com.google.chrome.ios,41,1745202382,1745202423,1745202423.804498,-18000,EB445137-D7F5-57EC-87DA-1DB460D64046,"iPhone13,2"
com.apple.Maps,2,1745202380,1745202382,1745202382.218806,-18000,EB445137-D7F5-57EC-87DA-1DB460D64046,"iPhone13,2"
com.apple.Maps,8,1745196455,1745196463,1745196464.7524428,-18000,EB445137-D7F5-57EC-87DA-1DB460D64046,"iPhone13,2"
com.apple.Maps,1352,1745195081,1745196433,1745196433.6048179,-18000,EB445137-D7F5-57EC-87DA-1DB460D64046,"iPhone13,2"
com.apple.Maps,77,1745194974,1745195051,1745195052.119452,-18000,EB445137-D7F5-57EC-87DA-1DB460D64046,"iPhone13,2"
com.apple.podcasts,19,1745194955,1745194974,1745194974.6150079,-18000,EB445137-D7F5-57EC-87DA-1DB460D64046,"iPhone13,2"
com.apple.Maps,66,1745194889,1745194955,1745194955.749052,-18000,EB445137-D7F5-57EC-87DA-1DB460D64046,"iPhone13,2"
com.apple.podcasts,1,1745194887,1745194888,1745194888.5423288,-18000,EB445137-D7F5-57EC-87DA-1DB460D64046,"iPhone13,2"
com.apple.podcasts,93,1745191256,1745191349,1745191349.931097,-18000,EB445137-D7F5-57EC-87DA-1DB460D64046,"iPhone13,2"
com.apple.podcasts,103,1745190825,1745190928,1745190928.998008,-18000,EB445137-D7F5-57EC-87DA-1DB460D64046,"iPhone13,2"
com.apple.MobileSMS,41,1745190699,1745190740,1745190740.8912668,-18000,EB445137-D7F5-57EC-87DA-1DB460D64046,"iPhone13,2"
com.apple.MobileSMS,14,1745190684,1745190698,1745190698.6592379,-18000,EB445137-D7F5-57EC-87DA-1DB460D64046,"iPhone13,2"
com.apple.podcasts,1,1745190682,1745190683,1745190683.852099,-18000,EB445137-D7F5-57EC-87DA-1DB460D64046,"iPhone13,2"
com.apple.podcasts,65,1745190122,1745190187,1745190188.4169722,-18000,EB445137-D7F5-57EC-87DA-1DB460D64046,"iPhone13,2"
com.apple.Music,3,1745190115,1745190118,1745190118.634723,-18000,EB445137-D7F5-57EC-87DA-1DB460D64046,"iPhone13,2"
com.apple.Music,2,1745189687,1745189689,1745189690.3088121,-18000,EB445137-D7F5-57EC-87DA-1DB460D64046,"iPhone13,2"
com.apple.MobileSMS,7,1745189671,1745189678,1745189678.065549,-18000,EB445137-D7F5-57EC-87DA-1DB460D64046,"iPhone13,2"
com.apple.MobileSMS,14,1745189647,1745189661,1745189661.1571732,-18000,EB445137-D7F5-57EC-87DA-1DB460D64046,"iPhone13,2"
com.apple.MobileSMS,2,1745188344,1745188346,1745188346.86301,-18000,EB445137-D7F5-57EC-87DA-1DB460D64046,"iPhone13,2"
com.apple.MobileSMS,2,1745188300,1745188302,1745188302.738779,-18000,EB445137-D7F5-57EC-87DA-1DB460D64046,"iPhone13,2"
com.apple.Health,26,1745187749,1745187775,1745187775.78363,-18000,EB445137-D7F5-57EC-87DA-1DB460D64046,"iPhone13,2"
com.apple.MobileSMS,8,1745187738,1745187746,1745187746.325688,-18000,EB445137-D7F5-57EC-87DA-1DB460D64046,"iPhone13,2"
com.apple.MobileSMS,2,1745187497,1745187499,1745187499.99924,-18000,EB445137-D7F5-57EC-87DA-1DB460D64046,"iPhone13,2"
com.apple.MobileSMS,17,1745187451,1745187468,1745187468.857442,-18000,EB445137-D7F5-57EC-87DA-1DB460D64046,"iPhone13,2"
com.apple.mobilecal,2,1745187449,1745187451,1745187451.382659,-18000,EB445137-D7F5-57EC-87DA-1DB460D64046,"iPhone13,2"
com.apple.mobilecal,9,1745186698,1745186707,1745186708.538043,-18000,EB445137-D7F5-57EC-87DA-1DB460D64046,"iPhone13,2"
com.apple.finder,6,1745184931,1745184937,1745184937.141953,-18000,,
com.apple.Preview,15,1745184916,1745184931,1745184931.383215,-18000,,
com.apple.Preview,624,1745183976,1745184600,1745184600.253134,-18000,,
com.apple.Preview,321,1745183445,1745183766,1745183766.649226,-18000,,
com.apple.finder,2,1745183443,1745183445,1745183445.92887,-18000,,
com.truebill.truebillnative,3,1745183370,1745183373,1745183373.821869,-18000,EB445137-D7F5-57EC-87DA-1DB460D64046,"iPhone13,2"
com.apple.MobileSMS,27,1745183329,1745183356,1745183356.856863,-18000,EB445137-D7F5-57EC-87DA-1DB460D64046,"iPhone13,2"
com.apple.weather,0,1745183329,1745183329,1745183330.1688619,-18000,EB445137-D7F5-57EC-87DA-1DB460D64046,"iPhone13,2"
com.apple.finder,8,1745182179,1745182187,1745182187.429827,-18000,,
com.apple.finder,4,1745182170,1745182174,1745182174.621762,-18000,,
com.apple.Notes,2,1745182168,1745182170,1745182170.523371,-18000,,
com.apple.Preview,178,1745181990,1745182168,1745182168.650066,-18000,,
com.apple.Notes,471,1745181519,1745181990,1745181990.678237,-18000,,
com.apple.Preview,5,1745181514,1745181519,1745181519.497581,-18000,,
com.apple.finder,11,1745181503,1745181514,1745181514.290402,-18000,,
com.apple.Notes,6,1745181497,1745181503,1745181503.535233,-18000,,
com.google.Chrome,14,1745181483,1745181497,1745181498.007688,-18000,,
com.apple.weather,12,1745180947,1745180959,1745180960.043478,-18000,EB445137-D7F5-57EC-87DA-1DB460D64046,"iPhone13,2"
com.microsoft.Office.Outlook,1,1745180946,1745180947,1745180948.564509,-18000,EB445137-D7F5-57EC-87DA-1DB460D64046,"iPhone13,2"
com.microsoft.Office.Outlook,44,1745177989,1745178033,1745178033.949012,-18000,EB445137-D7F5-57EC-87DA-1DB460D64046,"iPhone13,2"
com.apple.findmy,1,1745177988,1745177989,1745177989.886424,-18000,EB445137-D7F5-57EC-87DA-1DB460D64046,"iPhone13,2"
com.apple.findmy,9,1745175758,1745175767,1745175768.038093,-18000,EB445137-D7F5-57EC-87DA-1DB460D64046,"iPhone13,2"
com.apple.findmy,36,1745175178,1745175214,1745175214.893086,-18000,EB445137-D7F5-57EC-87DA-1DB460D64046,"iPhone13,2"
com.google.Chrome,622,1745173821,1745174443,1745174443.982143,-18000,,
com.apple.finder,2,1745173819,1745173821,1745173821.0591369,-18000,,
com.microsoft.Outlook,0,1745173819,1745173819,1745173820.2595448,-18000,,
com.google.Chrome,6,1745173813,1745173819,1745173820.168851,-18000,,
com.apple.finder,449,1745173364,1745173813,1745173813.680575,-18000,,
com.microsoft.VSCode,5,1745173359,1745173364,1745173364.9307141,-18000,,
com.apple.finder,1,1745173358,1745173359,1745173359.4513679,-18000,,
com.google.Chrome,14,1745173321,1745173335,1745173335.7370381,-18000,,
com.apple.iCal,36,1745173285,1745173321,1745173321.154819,-18000,,
com.leomehlig.today,61,1745173224,1745173285,1745173285.8808851,-18000,,
com.apple.iCal,7,1745173217,1745173224,1745173224.3793988,-18000,,
com.google.Chrome,3,1745173214,1745173217,1745173217.215939,-18000,,
com.apple.iCal,6,1745173208,1745173214,1745173214.8675098,-18000,,
com.google.Chrome,7,1745173201,1745173208,1745173208.577846,-18000,,
com.apple.iCal,7,1745173194,1745173201,1745173201.958678,-18000,,
com.google.Chrome,21,1745173173,1745173194,1745173194.833894,-18000,,
com.microsoft.Outlook,34,1745173139,1745173173,1745173173.8444939,-18000,,
com.google.Chrome,48,1745173091,1745173139,1745173139.244162,-18000,,
com.leomehlig.today,259,1745172832,1745173091,1745173091.73493,-18000,,
com.google.Chrome,2,1745172830,1745172832,1745172832.879926,-18000,,
com.microsoft.Powerpoint,2,1745172828,1745172830,1745172830.839442,-18000,,
com.leomehlig.today,14,1745172814,1745172828,1745172828.578765,-18000,,
com.microsoft.Powerpoint,22,1745172792,1745172814,1745172814.494319,-18000,,
com.google.Chrome,2,1745172790,1745172792,1745172792.3035889,-18000,,
com.microsoft.VSCode,6,1745172784,1745172790,1745172790.33611,-18000,,
com.google.Chrome,15,1745172769,1745172784,1745172784.8297482,-18000,,
com.microsoft.VSCode,62,1745172707,1745172769,1745172769.404535,-18000,,
com.microsoft.Powerpoint,2,1745172705,1745172707,1745172707.114903,-18000,,
com.microsoft.VSCode,26,1745172679,1745172705,1745172705.700674,-18000,,
com.google.Chrome,64,1745172615,1745172679,1745172679.228663,-18000,,
com.microsoft.Powerpoint,1,1745172614,1745172615,1745172615.510535,-18000,,
com.google.Chrome,4,1745172610,1745172614,1745172614.6000671,-18000,,
com.microsoft.VSCode,5,1745172605,1745172610,1745172610.2160149,-18000,,
com.microsoft.Powerpoint,1,1745172604,1745172605,1745172605.965897,-18000,,
com.microsoft.VSCode,0,1745172604,1745172604,1745172604.909738,-18000,,
com.google.Chrome,11,1745172593,1745172604,1745172604.13875,-18000,,
com.microsoft.VSCode,7,1745172586,1745172593,1745172594.004826,-18000,,
com.google.Chrome,48,1745172538,1745172586,1745172587.0170631,-18000,,
com.apple.finder,12,1745172526,1745172538,1745172538.628067,-18000,,
com.google.Chrome,21,1745172505,1745172526,1745172526.877365,-18000,,
com.microsoft.Powerpoint,181,1745172324,1745172505,1745172505.1873322,-18000,,
com.google.Chrome,7,1745172317,1745172324,1745172324.340492,-18000,,
com.microsoft.Powerpoint,80,1745172237,1745172317,1745172317.801445,-18000,,
com.google.Chrome,7,1745172230,1745172237,1745172237.626894,-18000,,
com.microsoft.Powerpoint,3,1745172227,1745172230,1745172230.297488,-18000,,
com.apple.finder,0,1745172227,1745172227,1745172227.855643,-18000,,
com.microsoft.Powerpoint,11,1745172216,1745172227,1745172227.540331,-18000,,
com.apple.finder,14,1745172202,1745172216,1745172216.4367309,-18000,,
com.google.Chrome,2,1745172200,1745172202,1745172202.870875,-18000,,
com.microsoft.Powerpoint,4,1745172196,1745172200,1745172200.755817,-18000,,
com.google.Chrome,8,1745172188,1745172196,1745172196.237718,-18000,,
com.microsoft.Powerpoint,3,1745172185,1745172188,1745172188.372504,-18000,,
com.google.Chrome,1,1745172184,1745172185,1745172185.681149,-18000,,
com.microsoft.Powerpoint,1,1745172183,1745172184,1745172184.5750089,-18000,,
com.google.Chrome,1,1745172182,1745172183,1745172183.688064,-18000,,
com.microsoft.Powerpoint,1,1745172181,1745172182,1745172182.8007588,-18000,,
com.google.Chrome,2,1745172179,1745172181,1745172181.728889,-18000,,
com.microsoft.Powerpoint,22,1745172157,1745172179,1745172179.974123,-18000,,
com.google.Chrome,12,1745172145,1745172157,1745172157.552373,-18000,,
com.apple.finder,25,1745172120,1745172145,1745172145.8654552,-18000,,
com.google.Chrome,20,1745172100,1745172120,1745172121.008747,-18000,,
com.microsoft.Powerpoint,32,1745172068,1745172100,1745172100.9239202,-18000,,
com.google.Chrome,9,1745172059,1745172068,1745172068.090908,-18000,,
com.microsoft.VSCode,17,1745172042,1745172059,1745172060.0335789,-18000,,
com.google.Chrome,27,1745172015,1745172042,1745172042.398316,-18000,,
com.microsoft.VSCode,136,1745171879,1745172015,1745172015.246664,-18000,,
com.google.Chrome,58,1745171821,1745171879,1745171879.671805,-18000,,
com.microsoft.VSCode,3,1745171818,1745171821,1745171821.214872,-18000,,
com.leomehlig.today,6,1745171812,1745171818,1745171818.8196092,-18000,,
com.apple.news,454,1745171158,1745171612,1745171612.2656078,-18000,EB445137-D7F5-57EC-87DA-1DB460D64046,"iPhone13,2"
com.apple.news,31,1745171118,1745171149,1745171149.966289,-18000,EB445137-D7F5-57EC-87DA-1DB460D64046,"iPhone13,2"
com.apple.MobileSMS,5,1745171106,1745171111,1745171111.894638,-18000,EB445137-D7F5-57EC-87DA-1DB460D64046,"iPhone13,2"
com.leomehlig.today,7,1745171062,1745171069,1745171069.641934,-18000,,
com.google.Chrome,217,1745170845,1745171062,1745171062.4863229,-18000,,
com.google.Chrome,2080,1745168694,1745170774,1745170774.532702,-18000,,
com.leomehlig.today,37,1745168657,1745168694,1745168694.560756,-18000,,
com.google.Chrome,253,1745168404,1745168657,1745168657.61009,-18000,,
com.apple.MobileSMS,25,1745168379,1745168404,1745168404.3597898,-18000,,
com.google.Chrome,51,1745168328,1745168379,1745168379.1741061,-18000,,
com.apple.MobileSMS,7,1745167763,1745167770,1745167770.808783,-18000,EB445137-D7F5-57EC-87DA-1DB460D64046,"iPhone13,2"
com.apple.MobileSMS,218,1745167481,1745167699,1745167699.867323,-18000,EB445137-D7F5-57EC-87DA-1DB460D64046,"iPhone13,2"
com.apple.Health,2,1745167477,1745167479,1745167479.2208462,-18000,EB445137-D7F5-57EC-87DA-1DB460D64046,"iPhone13,2"
com.google.Chrome,1015,1745167042,1745168057,1745168057.414372,-18000,,
com.apple.finder,2,1745166616,1745166618,1745166618.980505,-18000,,
com.apple.Health,10,1745163965,1745163975,1745163975.833559,-18000,EB445137-D7F5-57EC-87DA-1DB460D64046,"iPhone13,2"
com.apple.Preferences,79,1745163885,1745163964,1745163964.813353,-18000,EB445137-D7F5-57EC-87DA-1DB460D64046,"iPhone13,2"
com.apple.news,223,1745156937,1745157160,1745157160.609982,-18000,EB445137-D7F5-57EC-87DA-1DB460D64046,"iPhone13,2"
com.apple.news,1099,1745155836,1745156935,1745156935.451441,-18000,EB445137-D7F5-57EC-87DA-1DB460D64046,"iPhone13,2"
com.apple.Health,33,1745155795,1745155828,1745155828.249584,-18000,EB445137-D7F5-57EC-87DA-1DB460D64046,"iPhone13,2"
com.apple.finder,20,1745120591,1745120611,1745120611.616353,-18000,,
com.apple.news,73,1745120518,1745120591,1745120591.199195,-18000,,
com.apple.finder,15,1745120503,1745120518,1745120518.551906,-18000,,
com.apple.MobileSMS,9,1745120494,1745120503,1745120503.42451,-18000,,
com.apple.finder,3,1745120491,1745120494,1745120494.420673,-18000,,
com.apple.systempreferences,3,1745120488,1745120491,1745120491.916358,-18000,,
com.google.Chrome,5157,1745115331,1745120488,1745120488.7927861,-18000,,
com.google.Chrome,794,1745113973,1745114767,1745114767.059507,-18000,,
com.google.Chrome,439,1745113422,1745113861,1745113861.535356,-18000,,
com.leomehlig.today,68,1745113354,1745113422,1745113422.586266,-18000,,
com.apple.iCal,40,1745113314,1745113354,1745113354.673697,-18000,,
com.leomehlig.today,16,1745113298,1745113314,1745113314.5754108,-18000,,
com.google.Chrome,2,1745113296,1745113298,1745113298.9581861,-18000,,
com.microsoft.VSCode,8,1745113288,1745113296,1745113296.187145,-18000,,
com.google.Chrome,18,1745113270,1745113288,1745113289.019185,-18000,,
com.microsoft.VSCode,2,1745113268,1745113270,1745113270.185626,-18000,,
com.google.Chrome,31,1745113237,1745113268,1745113268.688766,-18000,,
com.microsoft.VSCode,93,1745113130,1745113223,1745113223.730875,-18000,,
com.google.Chrome,1,1745113129,1745113130,1745113131.038096,-18000,,
com.microsoft.VSCode,4,1745113125,1745113129,1745113129.8137589,-18000,,
com.google.Chrome,0,1745113125,1745113125,1745113125.977734,-18000,,
com.microsoft.VSCode,11,1745113114,1745113125,1745113125.47366,-18000,,
com.google.Chrome,1,1745113113,1745113114,1745113114.966759,-18000,,
com.microsoft.VSCode,4,1745113109,1745113113,1745113113.197155,-18000,,
com.google.Chrome,7,1745113102,1745113109,1745113109.081816,-18000,,
com.leomehlig.today,1,1745113101,1745113102,1745113102.457185,-18000,,
com.google.Chrome,34,1745113067,1745113101,1745113101.6106539,-18000,,
com.leomehlig.today,1,1745113066,1745113067,1745113067.8638592,-18000,,
com.microsoft.VSCode,219,1745112847,1745113066,1745113067.030658,-18000,,
com.leomehlig.today,51,1745112796,1745112847,1745112847.5317822,-18000,,
com.microsoft.VSCode,352,1745112444,1745112796,1745112796.7022948,-18000,,
com.google.Chrome,105,1745112339,1745112444,1745112444.715349,-18000,,
com.apple.finder,6,1745112333,1745112339,1745112339.117367,-18000,,
com.microsoft.VSCode,13,1745112320,1745112333,1745112333.104886,-18000,,
com.apple.finder,1,1745112319,1745112320,1745112320.9977221,-18000,,
com.microsoft.VSCode,12,1745112307,1745112319,1745112319.7360091,-18000,,
com.apple.finder,5,1745112302,1745112307,1745112307.276227,-18000,,
com.microsoft.VSCode,15,1745112287,1745112302,1745112302.211257,-18000,,
com.apple.finder,5,1745112282,1745112287,1745112287.76189,-18000,,
com.microsoft.VSCode,154,1745112128,1745112282,1745112283.008572,-18000,,
com.apple.finder,2,1745112126,1745112128,1745112128.284565,-18000,,
com.microsoft.VSCode,6,1745112120,1745112126,1745112126.0429978,-18000,,
com.apple.finder,15,1745112105,1745112120,1745112120.545712,-18000,,
com.microsoft.VSCode,5,1745112100,1745112105,1745112105.226217,-18000,,
com.apple.finder,3,1745112097,1745112100,1745112100.894686,-18000,,
com.microsoft.VSCode,1,1745112096,1745112097,1745112097.7816792,-18000,,
com.apple.finder,6,1745112090,1745112096,1745112096.807225,-18000,,
com.microsoft.VSCode,27,1745112063,1745112090,1745112090.9771,-18000,,
com.apple.finder,1,1745112062,1745112063,1745112063.4822268,-18000,,
com.microsoft.VSCode,1,1745112061,1745112062,1745112062.1063561,-18000,,
com.apple.finder,9,1745112052,1745112061,1745112061.392535,-18000,,
com.microsoft.VSCode,57,1745111995,1745112052,1745112052.3046231,-18000,,
com.apple.finder,6,1745111989,1745111995,1745111995.632705,-18000,,
com.microsoft.VSCode,15,1745111974,1745111989,1745111989.199195,-18000,,
com.apple.finder,5,1745111969,1745111974,1745111974.5600939,-18000,,
com.microsoft.VSCode,28,1745111941,1745111969,1745111969.570226,-18000,,
com.apple.finder,17,1745111924,1745111941,1745111942.008827,-18000,,
com.microsoft.VSCode,1,1745111923,1745111924,1745111924.032463,-18000,,
com.apple.finder,4,1745111919,1745111923,1745111923.05484,-18000,,
com.microsoft.VSCode,3,1745111916,1745111919,1745111919.827148,-18000,,
com.apple.finder,5,1745111911,1745111916,1745111916.246265,-18000,,
com.microsoft.VSCode,15,1745111896,1745111911,1745111911.891634,-18000,,
com.google.Chrome,7,1745111889,1745111896,1745111896.6642652,-18000,,
com.microsoft.VSCode,0,1745111889,1745111889,1745111889.844626,-18000,,
com.apple.finder,11,1745111878,1745111889,1745111889.1479201,-18000,,
com.microsoft.VSCode,2,1745111876,1745111878,1745111878.5983372,-18000,,
com.google.Chrome,174,1745111702,1745111876,1745111876.131987,-18000,,
com.microsoft.VSCode,8,1745111694,1745111702,1745111702.953559,-18000,,
com.google.Chrome,40,1745111654,1745111694,1745111694.433339,-18000,,
com.microsoft.VSCode,31,1745111623,1745111654,1745111654.142436,-18000,,
com.google.Chrome,0,1745111623,1745111623,1745111624.073032,-18000,,
com.microsoft.VSCode,2,1745111621,1745111623,1745111623.675764,-18000,,
com.google.Chrome,17,1745111604,1745111621,1745111621.662997,-18000,,
com.microsoft.VSCode,76,1745111528,1745111604,1745111604.422673,-18000,,
com.google.Chrome,34,1745111494,1745111528,1745111529.041202,-18000,,
com.microsoft.VSCode,3,1745111491,1745111494,1745111494.5909529,-18000,,
com.google.Chrome,41,1745111450,1745111491,1745111491.996633,-18000,,
com.microsoft.VSCode,1,1745111449,1745111450,1745111450.7971,-18000,,
com.google.Chrome,21,1745111428,1745111449,1745111449.7988338,-18000,,
com.microsoft.VSCode,69,1745111359,1745111428,1745111428.355248,-18000,,
com.google.Chrome,15,1745111344,1745111359,1745111359.550758,-18000,,
com.microsoft.VSCode,0,1745111344,1745111344,1745111344.545531,-18000,,
com.google.Chrome,43,1745111301,1745111344,1745111344.114847,-18000,,
com.microsoft.VSCode,1,1745111300,1745111301,1745111301.795642,-18000,,
com.google.Chrome,1,1745111299,1745111300,1745111300.169221,-18000,,
com.microsoft.VSCode,1,1745111298,1745111299,1745111299.443946,-18000,,
com.google.Chrome,77,1745111221,1745111298,1745111298.982316,-18000,,
com.microsoft.VSCode,6,1745111215,1745111221,1745111221.0790548,-18000,,
com.google.Chrome,1,1745111214,1745111215,1745111215.393858,-18000,,
com.microsoft.VSCode,4,1745111210,1745111214,1745111214.058023,-18000,,
com.google.Chrome,2,1745111208,1745111210,1745111210.125454,-18000,,
com.microsoft.VSCode,1,1745111207,1745111208,1745111208.969064,-18000,,
com.google.Chrome,1,1745111206,1745111207,1745111207.110229,-18000,,
com.microsoft.VSCode,11,1745111195,1745111206,1745111206.180357,-18000,,
com.google.Chrome,10,1745111185,1745111195,1745111195.3727942,-18000,,
com.microsoft.VSCode,1,1745111184,1745111185,1745111185.273834,-18000,,
com.google.Chrome,32,1745111152,1745111184,1745111184.510304,-18000,,
com.microsoft.VSCode,25,1745111127,1745111152,1745111152.668621,-18000,,
com.google.chrome.ios,1,1745110878,1745110879,1745110879.980435,-18000,EB445137-D7F5-57EC-87DA-1DB460D64046,"iPhone13,2"
com.google.chrome.ios,2,1745110853,1745110855,1745110855.808875,-18000,EB445137-D7F5-57EC-87DA-1DB460D64046,"iPhone13,2"
com.google.chrome.ios,116,1745110695,1745110811,1745110811.698375,-18000,EB445137-D7F5-57EC-87DA-1DB460D64046,"iPhone13,2"
com.google.chrome.ios,29,1745103661,1745103690,1745103690.7658072,-18000,EB445137-D7F5-57EC-87DA-1DB460D64046,"iPhone13,2"
com.apple.findmy,1,1745103660,1745103661,1745103662.380883,-18000,EB445137-D7F5-57EC-87DA-1DB460D64046,"iPhone13,2"
com.apple.findmy,65,1745103375,1745103440,1745103440.802906,-18000,EB445137-D7F5-57EC-87DA-1DB460D64046,"iPhone13,2"
com.apple.weather,15,1745103360,1745103375,1745103375.344971,-18000,EB445137-D7F5-57EC-87DA-1DB460D64046,"iPhone13,2"
com.wbd.stream,2,1745103358,1745103360,1745103360.597104,-18000,EB445137-D7F5-57EC-87DA-1DB460D64046,"iPhone13,2"
com.wbd.stream,111,1745102964,1745103075,1745103076.105855,-18000,EB445137-D7F5-57EC-87DA-1DB460D64046,"iPhone13,2"
com.wbd.stream,111,1745102718,1745102829,1745102829.817501,-18000,EB445137-D7F5-57EC-87DA-1DB460D64046,"iPhone13,2"
com.google.chrome.ios,55,1745102663,1745102718,1745102718.74317,-18000,EB445137-D7F5-57EC-87DA-1DB460D64046,"iPhone13,2"
com.wbd.stream,43,1745102620,1745102663,1745102663.826325,-18000,EB445137-D7F5-57EC-87DA-1DB460D64046,"iPhone13,2"
com.google.chrome.ios,33,1745102213,1745102246,1745102246.991932,-18000,EB445137-D7F5-57EC-87DA-1DB460D64046,"iPhone13,2"
com.facebook.Facebook,89,1745102061,1745102150,1745102150.232798,-18000,EB445137-D7F5-57EC-87DA-1DB460D64046,"iPhone13,2"
com.google.chrome.ios,13,1745102046,1745102059,1745102059.714579,-18000,EB445137-D7F5-57EC-87DA-1DB460D64046,"iPhone13,2"
com.google.chrome.ios,114,1745101702,1745101816,1745101816.8527389,-18000,EB445137-D7F5-57EC-87DA-1DB460D64046,"iPhone13,2"
com.google.chrome.ios,197,1745101359,1745101556,1745101556.953909,-18000,EB445137-D7F5-57EC-87DA-1DB460D64046,"iPhone13,2"
com.letterboxd.LetterboxdApp,106,1745101246,1745101352,1745101352.7625,-18000,EB445137-D7F5-57EC-87DA-1DB460D64046,"iPhone13,2"
com.google.chrome.ios,18,1745101228,1745101246,1745101247.10411,-18000,EB445137-D7F5-57EC-87DA-1DB460D64046,"iPhone13,2"
com.google.chrome.ios,211,1745101013,1745101224,1745101224.766024,-18000,EB445137-D7F5-57EC-87DA-1DB460D64046,"iPhone13,2"
com.letterboxd.LetterboxdApp,87,1745100926,1745101013,1745101013.784161,-18000,EB445137-D7F5-57EC-87DA-1DB460D64046,"iPhone13,2"
com.google.chrome.ios,2,1745100924,1745100926,1745100926.2839499,-18000,EB445137-D7F5-57EC-87DA-1DB460D64046,"iPhone13,2"
com.letterboxd.LetterboxdApp,392,1745100532,1745100924,1745100924.4423761,-18000,EB445137-D7F5-57EC-87DA-1DB460D64046,"iPhone13,2"
com.google.chrome.ios,3,1745100526,1745100529,1745100529.108938,-18000,EB445137-D7F5-57EC-87DA-1DB460D64046,"iPhone13,2"
com.google.chrome.ios,55,1745100471,1745100526,1745100526.639138,-18000,EB445137-D7F5-57EC-87DA-1DB460D64046,"iPhone13,2"
com.google.chrome.ios,133,1745100101,1745100234,1745100236.0957289,-18000,EB445137-D7F5-57EC-87DA-1DB460D64046,"iPhone13,2"
com.letterboxd.LetterboxdApp,151,1745099950,1745100101,1745100101.685628,-18000,EB445137-D7F5-57EC-87DA-1DB460D64046,"iPhone13,2"
com.strava.stravaride,59,1745099792,1745099851,1745099851.270797,-18000,EB445137-D7F5-57EC-87DA-1DB460D64046,"iPhone13,2"
com.toyopagroup.picaboo,17,1745098478,1745098495,1745098495.105773,-18000,EB445137-D7F5-57EC-87DA-1DB460D64046,"iPhone13,2"
com.apple.weather,2,1745098476,1745098478,1745098478.41677,-18000,EB445137-D7F5-57EC-87DA-1DB460D64046,"iPhone13,2"
com.apple.weather,6,1745090826,1745090832,1745090832.597382,-18000,EB445137-D7F5-57EC-87DA-1DB460D64046,"iPhone13,2"
com.apple.MobileSMS,1,1745090825,1745090826,1745090827.055778,-18000,EB445137-D7F5-57EC-87DA-1DB460D64046,"iPhone13,2"
com.apple.MobileSMS,2,1745089712,1745089714,1745089714.751472,-18000,EB445137-D7F5-57EC-87DA-1DB460D64046,"iPhone13,2"
com.apple.MobileSMS,27,1745089645,1745089672,1745089672.74916,-18000,EB445137-D7F5-57EC-87DA-1DB460D64046,"iPhone13,2"
com.apple.weather,1,1745089644,1745089645,1745089646.08143,-18000,EB445137-D7F5-57EC-87DA-1DB460D64046,"iPhone13,2"
com.apple.weather,4,1745089502,1745089506,1745089507.138664,-18000,EB445137-D7F5-57EC-87DA-1DB460D64046,"iPhone13,2"
com.apple.MobileSMS,2,1745089500,1745089502,1745089502.531546,-18000,EB445137-D7F5-57EC-87DA-1DB460D64046,"iPhone13,2"
com.apple.MobileSMS,22,1745089475,1745089497,1745089497.1866322,-18000,EB445137-D7F5-57EC-87DA-1DB460D64046,"iPhone13,2"
com.apple.MobileSMS,60,1745089394,1745089454,1745089455.0293,-18000,EB445137-D7F5-57EC-87DA-1DB460D64046,"iPhone13,2"
com.apple.MobileSMS,20,1745089367,1745089387,1745089387.264288,-18000,EB445137-D7F5-57EC-87DA-1DB460D64046,"iPhone13,2"
com.apple.MobileSMS,5,1745086486,1745086491,1745086491.4503422,-18000,EB445137-D7F5-57EC-87DA-1DB460D64046,"iPhone13,2"
com.apple.findmy,2,1745086483,1745086485,1745086485.889865,-18000,EB445137-D7F5-57EC-87DA-1DB460D64046,"iPhone13,2"
com.apple.findmy,13,1745086466,1745086479,1745086480.134788,-18000,EB445137-D7F5-57EC-87DA-1DB460D64046,"iPhone13,2"
co.hinge.mobile.ios,5,1745086130,1745086135,1745086135.938146,-18000,EB445137-D7F5-57EC-87DA-1DB460D64046,"iPhone13,2"
com.apple.CoreAuthUI,2,1745086130,1745086132,1745086132.133641,-18000,EB445137-D7F5-57EC-87DA-1DB460D64046,"iPhone13,2"
com.apple.Music,1,1745086129,1745086130,1745086130.407079,-18000,EB445137-D7F5-57EC-87DA-1DB460D64046,"iPhone13,2"
com.apple.Music,1,1745084651,1745084652,1745084653.384625,-18000,EB445137-D7F5-57EC-87DA-1DB460D64046,"iPhone13,2"
com.apple.Music,1,1745075459,1745075460,1745075461.310478,-18000,EB445137-D7F5-57EC-87DA-1DB460D64046,"iPhone13,2"
com.apple.Music,19,1745075332,1745075351,1745075352.455194,-18000,EB445137-D7F5-57EC-87DA-1DB460D64046,"iPhone13,2"
com.apple.podcasts,1,1745075330,1745075331,1745075331.767363,-18000,EB445137-D7F5-57EC-87DA-1DB460D64046,"iPhone13,2"
com.apple.podcasts,137,1745075036,1745075173,1745075173.5996342,-18000,EB445137-D7F5-57EC-87DA-1DB460D64046,"iPhone13,2"
com.apple.news,27,1745075009,1745075036,1745075036.35462,-18000,EB445137-D7F5-57EC-87DA-1DB460D64046,"iPhone13,2"
com.apple.news,250,1745074703,1745074953,1745074954.339181,-18000,EB445137-D7F5-57EC-87DA-1DB460D64046,"iPhone13,2"
com.apple.podcasts,23,1745074670,1745074693,1745074693.044481,-18000,EB445137-D7F5-57EC-87DA-1DB460D64046,"iPhone13,2"
com.apple.MobileSMS,16,1745074561,1745074577,1745074577.5135798,-18000,EB445137-D7F5-57EC-87DA-1DB460D64046,"iPhone13,2"
com.apple.calculator,7,1745074554,1745074561,1745074561.883956,-18000,EB445137-D7F5-57EC-87DA-1DB460D64046,"iPhone13,2"
com.apple.MobileSMS,18,1745074536,1745074554,1745074554.396618,-18000,EB445137-D7F5-57EC-87DA-1DB460D64046,"iPhone13,2"
com.apple.calculator,11,1745074525,1745074536,1745074536.590485,-18000,EB445137-D7F5-57EC-87DA-1DB460D64046,"iPhone13,2"
com.apple.weather,10,1745074400,1745074410,1745074410.419465,-18000,EB445137-D7F5-57EC-87DA-1DB460D64046,"iPhone13,2"
com.apple.Health,49,1745074086,1745074135,1745074135.469444,-18000,EB445137-D7F5-57EC-87DA-1DB460D64046,"iPhone13,2"
com.apple.MobileSMS,0,1745074086,1745074086,1745074087.4265618,-18000,EB445137-D7F5-57EC-87DA-1DB460D64046,"iPhone13,2"
com.apple.MobileSMS,56,1745074030,1745074086,1745074086.114785,-18000,EB445137-D7F5-57EC-87DA-1DB460D64046,"iPhone13,2"
com.apple.podcasts,0,1745074030,1745074030,1745074030.542461,-18000,EB445137-D7F5-57EC-87DA-1DB460D64046,"iPhone13,2"
com.apple.podcasts,100,1745073851,1745073951,1745073951.532145,-18000,EB445137-D7F5-57EC-87DA-1DB460D64046,"iPhone13,2"
com.apple.MobileSMS,38,1745073750,1745073788,1745073788.476787,-18000,EB445137-D7F5-57EC-87DA-1DB460D64046,"iPhone13,2"
com.apple.weather,18,1745073731,1745073749,1745073749.544352,-18000,EB445137-D7F5-57EC-87DA-1DB460D64046,"iPhone13,2"
com.apple.MobileSMS,28,1745073692,1745073720,1745073720.859931,-18000,EB445137-D7F5-57EC-87DA-1DB460D64046,"iPhone13,2"
com.google.chrome.ios,35,1745073656,1745073691,1745073692.214373,-18000,EB445137-D7F5-57EC-87DA-1DB460D64046,"iPhone13,2"
com.apple.MobileSMS,9,1745073647,1745073656,1745073656.933119,-18000,EB445137-D7F5-57EC-87DA-1DB460D64046,"iPhone13,2"
com.apple.weather,1,1745073646,1745073647,1745073647.771572,-18000,EB445137-D7F5-57EC-87DA-1DB460D64046,"iPhone13,2"
com.apple.weather,8,1745073021,1745073029,1745073029.686125,-18000,EB445137-D7F5-57EC-87DA-1DB460D64046,"iPhone13,2"
com.apple.weather,4,1745072306,1745072310,1745072310.470511,-18000,EB445137-D7F5-57EC-87DA-1DB460D64046,"iPhone13,2"
com.renpho.health,1,1745072305,1745072306,1745072307.1727428,-18000,EB445137-D7F5-57EC-87DA-1DB460D64046,"iPhone13,2"
com.renpho.health,80,1745072192,1745072272,1745072273.0166922,-18000,EB445137-D7F5-57EC-87DA-1DB460D64046,"iPhone13,2"
com.apple.mobiletimer,2,1745072189,1745072191,1745072191.6758919,-18000,EB445137-D7F5-57EC-87DA-1DB460D64046,"iPhone13,2"
com.apple.mobiletimer,1,1745072187,1745072188,1745072188.911495,-18000,EB445137-D7F5-57EC-87DA-1DB460D64046,"iPhone13,2"
com.apple.mobiletimer,8,1745068166,1745068174,1745068174.740065,-18000,EB445137-D7F5-57EC-87DA-1DB460D64046,"iPhone13,2"
com.apple.weather,8,1745068154,1745068162,1745068163.2404342,-18000,EB445137-D7F5-57EC-87DA-1DB460D64046,"iPhone13,2"
com.apple.findmy,7,1745038074,1745038081,1745038081.423491,-18000,EB445137-D7F5-57EC-87DA-1DB460D64046,"iPhone13,2"
com.toyopagroup.picaboo,36,1745037547,1745037583,1745037583.997195,-18000,EB445137-D7F5-57EC-87DA-1DB460D64046,"iPhone13,2"
com.apple.weather,1,1745037543,1745037544,1745037544.991863,-18000,EB445137-D7F5-57EC-87DA-1DB460D64046,"iPhone13,2"
com.microsoft.VSCode,14,1745037451,1745037465,1745037465.5580912,-18000,,
com.apple.weather,2,1745037254,1745037256,1745037256.730022,-18000,EB445137-D7F5-57EC-87DA-1DB460D64046,"iPhone13,2"
com.apple.weather,6,1745027943,1745027949,1745027949.226447,-18000,EB445137-D7F5-57EC-87DA-1DB460D64046,"iPhone13,2"
com.google.chrome.ios,1,1745027942,1745027943,1745027943.51119,-18000,EB445137-D7F5-57EC-87DA-1DB460D64046,"iPhone13,2"
com.apple.CoreAuthUI,2,1745025176,1745025178,1745025178.332191,-18000,EB445137-D7F5-57EC-87DA-1DB460D64046,"iPhone13,2"
com.apple.CoreAuthUI,2,1745025167,1745025169,1745025169.4954891,-18000,EB445137-D7F5-57EC-87DA-1DB460D64046,"iPhone13,2"
com.google.chrome.ios,57,1745025137,1745025194,1745025194.68454,-18000,EB445137-D7F5-57EC-87DA-1DB460D64046,"iPhone13,2"
com.google.chrome.ios,21,1745025081,1745025102,1745025103.3332438,-18000,EB445137-D7F5-57EC-87DA-1DB460D64046,"iPhone13,2"
com.google.chrome.ios,2,1745024876,1745024878,1745024878.833261,-18000,EB445137-D7F5-57EC-87DA-1DB460D64046,"iPhone13,2"
com.google.chrome.ios,30,1745024427,1745024457,1745024458.730993,-18000,EB445137-D7F5-57EC-87DA-1DB460D64046,"iPhone13,2"
com.supercell.magic,8,1745024419,1745024427,1745024427.500318,-18000,EB445137-D7F5-57EC-87DA-1DB460D64046,"iPhone13,2"
com.supercell.magic,233,1745022678,1745022911,1745022912.118949,-18000,EB445137-D7F5-57EC-87DA-1DB460D64046,"iPhone13,2"
com.google.chrome.ios,2,1745022673,1745022675,1745022675.7029161,-18000,EB445137-D7F5-57EC-87DA-1DB460D64046,"iPhone13,2"
com.google.chrome.ios,20,1745022160,1745022180,1745022181.063527,-18000,EB445137-D7F5-57EC-87DA-1DB460D64046,"iPhone13,2"
com.microsoft.VSCode,343,1745021612,1745021955,1745021955.193227,-18000,,
com.tinyspeck.chatlyio,6,1745020007,1745020013,1745020013.5870929,-18000,EB445137-D7F5-57EC-87DA-1DB460D64046,"iPhone13,2"
com.tinyspeck.chatlyio,23,1745017547,1745017570,1745017571.240803,-18000,EB445137-D7F5-57EC-87DA-1DB460D64046,"iPhone13,2"
com.microsoft.Office.Outlook,0,1745017547,1745017547,1745017548.3157902,-18000,EB445137-D7F5-57EC-87DA-1DB460D64046,"iPhone13,2"
com.microsoft.Office.Outlook,9,1745017479,1745017488,1745017489.0722132,-18000,EB445137-D7F5-57EC-87DA-1DB460D64046,"iPhone13,2"
com.tinyspeck.chatlyio,35,1745017433,1745017468,1745017468.207615,-18000,EB445137-D7F5-57EC-87DA-1DB460D64046,"iPhone13,2"
com.apple.Preferences,2,1745017427,1745017429,1745017430.953076,-18000,EB445137-D7F5-57EC-87DA-1DB460D64046,"iPhone13,2"
com.apple.news,279,1745010214,1745010493,1745010493.674748,-18000,EB445137-D7F5-57EC-87DA-1DB460D64046,"iPhone13,2"
com.toyopagroup.picaboo,16,1745010194,1745010210,1745010210.631077,-18000,EB445137-D7F5-57EC-87DA-1DB460D64046,"iPhone13,2"
com.microsoft.VSCode,308,1745009795,1745010103,1745010103.82563,-18000,,
com.apple.systempreferences,4,1745009791,1745009795,1745009795.262701,-18000,,
com.google.Chrome,1,1745009784,1745009785,1745009785.205449,-18000,,
com.google.Chrome,938,1745008815,1745009753,1745009753.617988,-18000,,
com.microsoft.VSCode,145,1745008670,1745008815,1745008815.553197,-18000,,
com.toyopagroup.picaboo,27,1745008629,1745008656,1745008657.402127,-18000,EB445137-D7F5-57EC-87DA-1DB460D64046,"iPhone13,2"
com.instructure.icanvas,1,1745008628,1745008629,1745008629.375665,-18000,EB445137-D7F5-57EC-87DA-1DB460D64046,"iPhone13,2"
com.apple.finder,55,1745008615,1745008670,1745008671.009265,-18000,,
com.leomehlig.today,6,1745008609,1745008615,1745008615.3753881,-18000,,
com.google.Chrome,50,1745008559,1745008609,1745008609.4150162,-18000,,
com.leomehlig.today,12,1745008539,1745008551,1745008552.03424,-18000,,
com.google.Chrome,5,1745008534,1745008539,1745008539.596107,-18000,,
com.apple.Preview,18,1745008516,1745008534,1745008535.016154,-18000,,
com.apple.finder,1,1745008515,1745008516,1745008517.125533,-18000,,
com.apple.Preview,18,1745008497,1745008515,1745008516.041072,-18000,,
com.apple.finder,1,1745008496,1745008497,1745008497.389966,-18000,,
com.apple.Preview,1,1745008495,1745008496,1745008496.532428,-18000,,
com.apple.finder,10,1745008485,1745008495,1745008495.71388,-18000,,
com.google.Chrome,308,1745008177,1745008485,1745008485.352515,-18000,,
com.apple.Preview,2,1745008175,1745008177,1745008177.813643,-18000,,
com.google.Chrome,7,1745008168,1745008175,1745008175.189396,-18000,,
com.apple.Preview,9,1745008159,1745008168,1745008168.971051,-18000,,
com.google.Chrome,616,1745007543,1745008159,1745008159.716957,-18000,,
com.apple.Preview,10,1745007533,1745007543,1745007543.134448,-18000,,
com.google.Chrome,90,1745007443,1745007533,1745007533.469037,-18000,,
com.apple.Preview,91,1745007352,1745007443,1745007443.686557,-18000,,
com.apple.finder,7,1745007345,1745007352,1745007352.561454,-18000,,
com.leomehlig.today,13,1745007332,1745007345,1745007345.944421,-18000,,
com.apple.finder,3,1745007329,1745007332,1745007332.272287,-18000,,
com.apple.Photos,1,1745007328,1745007329,1745007329.9692202,-18000,,
com.microsoft.VSCode,11,1745007317,1745007328,1745007328.600678,-18000,,
com.instructure.icanvas,52,1745000826,1745000878,1745000878.6855521,-18000,EB445137-D7F5-57EC-87DA-1DB460D64046,"iPhone13,2"
com.apple.weather,0,1745000826,1745000826,1745000827.058426,-18000,EB445137-D7F5-57EC-87DA-1DB460D64046,"iPhone13,2"
com.microsoft.VSCode,61,1744998942,1744999003,1744999003.512218,-18000,,
com.apple.news,333,1744998609,1744998942,1744998942.615896,-18000,,
com.microsoft.VSCode,11,1744998598,1744998609,1744998614.307076,-18000,,
com.leomehlig.today,51,1744998547,1744998598,1744998598.772228,-18000,,
com.google.Chrome,82,1744998465,1744998547,1744998550.182383,-18000,,
com.apple.iCal,13,1744998452,1744998465,1744998465.66096,-18000,,
com.google.Chrome,119,1744998333,1744998452,1744998453.074461,-18000,,
com.microsoft.VSCode,67,1744998266,1744998333,1744998333.332951,-18000,,
com.apple.weather,25,1744997465,1744997490,1744997490.45467,-18000,EB445137-D7F5-57EC-87DA-1DB460D64046,"iPhone13,2"
com.microsoft.VSCode,142,1744997311,1744997453,1744997453.4665399,-18000,,
com.google.Chrome,13,1744997298,1744997311,1744997311.436739,-18000,,
com.apple.Photos,3,1744997295,1744997298,1744997298.748519,-18000,,
com.google.Chrome,0,1744997295,1744997295,1744997296.266568,-18000,,
com.apple.Photos,4,1744997291,1744997295,1744997295.37556,-18000,,
com.google.Chrome,4,1744997287,1744997291,1744997291.64287,-18000,,
com.apple.Photos,4,1744997283,1744997287,1744997288.2565389,-18000,,
com.google.Chrome,3,1744997280,1744997283,1744997283.572397,-18000,,
com.apple.Photos,6,1744997274,1744997280,1744997281.347842,-18000,,
com.google.Chrome,2,1744997272,1744997274,1744997275.232572,-18000,,
com.apple.Photos,4,1744997268,1744997272,1744997272.196725,-18000,,
com.google.Chrome,2,1744997266,1744997268,1744997269.504951,-18000,,
com.apple.Photos,21,1744997245,1744997266,1744997266.870504,-18000,,
com.google.Chrome,57,1744997188,1744997245,1744997245.856978,-18000,,
com.microsoft.VSCode,149,1744997028,1744997177,1744997178.781673,-18000,,
com.instructure.icanvas,20,1744996982,1744997002,1744997002.599122,-18000,EB445137-D7F5-57EC-87DA-1DB460D64046,"iPhone13,2"
com.microsoft.Office.Outlook,30,1744996948,1744996978,1744996978.390009,-18000,EB445137-D7F5-57EC-87DA-1DB460D64046,"iPhone13,2"
com.google.Chrome,63,1744996720,1744996783,1744996783.247479,-18000,,
com.microsoft.VSCode,1,1744996719,1744996720,1744996720.932344,-18000,,
com.google.Chrome,253,1744996466,1744996719,1744996719.850253,-18000,,
com.microsoft.VSCode,74,1744996392,1744996466,1744996466.648948,-18000,,
com.microsoft.VSCode,309,1744996008,1744996317,1744996317.204778,-18000,,
com.google.Chrome,4,1744996004,1744996008,1744996008.450976,-18000,,
com.microsoft.VSCode,2,1744996002,1744996004,1744996004.09183,-18000,,
com.leomehlig.today,4,1744995998,1744996002,1744996002.72029,-18000,,
com.apple.weather,16,1744993858,1744993874,1744993874.2198892,-18000,EB445137-D7F5-57EC-87DA-1DB460D64046,"iPhone13,2"
com.apple.mobileslideshow,73,1744993520,1744993593,1744993593.22746,-18000,EB445137-D7F5-57EC-87DA-1DB460D64046,"iPhone13,2"
com.apple.MobileSMS,2,1744993496,1744993498,1744993498.7907128,-18000,EB445137-D7F5-57EC-87DA-1DB460D64046,"iPhone13,2"
com.hammerandchisel.discord,207,1744993287,1744993494,1744993494.4639711,-18000,EB445137-D7F5-57EC-87DA-1DB460D64046,"iPhone13,2"
com.facebook.Facebook,57,1744991785,1744991842,1744991842.3708029,-18000,EB445137-D7F5-57EC-87DA-1DB460D64046,"iPhone13,2"
com.hammerandchisel.discord,73,1744991705,1744991778,1744991778.225568,-18000,EB445137-D7F5-57EC-87DA-1DB460D64046,"iPhone13,2"
com.google.Gmail,7,1744991698,1744991705,1744991705.4979591,-18000,EB445137-D7F5-57EC-87DA-1DB460D64046,"iPhone13,2"
com.apple.AuthenticationServicesUI,4,1744991687,1744991691,1744991691.872242,-18000,EB445137-D7F5-57EC-87DA-1DB460D64046,"iPhone13,2"
com.apple.CoreAuthUI,1,1744991685,1744991686,1744991687.044732,-18000,EB445137-D7F5-57EC-87DA-1DB460D64046,"iPhone13,2"
com.apple.CoreAuthUI,2,1744991658,1744991660,1744991660.1218472,-18000,EB445137-D7F5-57EC-87DA-1DB460D64046,"iPhone13,2"
com.hammerandchisel.discord,59,1744991639,1744991698,1744991698.4303632,-18000,EB445137-D7F5-57EC-87DA-1DB460D64046,"iPhone13,2"
com.toyopagroup.picaboo,15,1744991353,1744991368,1744991369.224876,-18000,EB445137-D7F5-57EC-87DA-1DB460D64046,"iPhone13,2"
com.toyopagroup.picaboo,6,1744991346,1744991352,1744991352.389322,-18000,EB445137-D7F5-57EC-87DA-1DB460D64046,"iPhone13,2"
com.microsoft.Office.Outlook,26,1744991319,1744991345,1744991346.4427838,-18000,EB445137-D7F5-57EC-87DA-1DB460D64046,"iPhone13,2"
com.apple.MobileSMS,2,1744991317,1744991319,1744991319.130471,-18000,EB445137-D7F5-57EC-87DA-1DB460D64046,"iPhone13,2"
com.leomehlig.today,2,1744991283,1744991285,1744991285.893677,-18000,,
com.google.Chrome,4,1744991279,1744991283,1744991283.562614,-18000,,
com.apple.finder,5,1744991274,1744991279,1744991279.360777,-18000,,
com.google.Chrome,8,1744991266,1744991274,1744991274.475425,-18000,,
com.microsoft.VSCode,138,1744991128,1744991266,1744991266.603329,-18000,,
com.apple.news,114,1744991014,1744991128,1744991128.641333,-18000,,
com.microsoft.VSCode,99,1744990915,1744991014,1744991015.052628,-18000,,
com.google.Chrome,10,1744990905,1744990915,1744990915.8132339,-18000,,
com.apple.news,398,1744990507,1744990905,1744990907.752441,-18000,,
com.microsoft.VSCode,84,1744990423,1744990507,1744990510.270159,-18000,,
com.google.Chrome,25,1744990398,1744990423,1744990424.221937,-18000,,
com.microsoft.VSCode,4,1744990394,1744990398,1744990399.1354299,-18000,,
com.microsoft.Powerpoint,2,1744990392,1744990394,1744990398.013982,-18000,,
com.microsoft.VSCode,61,1744990331,1744990392,1744990394.541376,-18000,,
com.apple.MobileSMS,43,1744990288,1744990331,1744990331.544862,-18000,,
com.microsoft.VSCode,23,1744990265,1744990288,1744990289.227411,-18000,,
com.google.Chrome,5,1744990260,1744990265,1744990266.44169,-18000,,
com.microsoft.VSCode,87,1744990173,1744990260,1744990261.0883908,-18000,,
com.google.Chrome,6,1744990167,1744990173,1744990174.368866,-18000,,
com.microsoft.VSCode,19,1744990148,1744990167,1744990167.999281,-18000,,
com.apple.MobileSMS,183,1744989965,1744990148,1744990148.192277,-18000,,
com.microsoft.VSCode,1,1744989964,1744989965,1744989974.79628,-18000,,
com.apple.news,14,1744989950,1744989964,1744989967.070622,-18000,,
com.microsoft.VSCode,19,1744989931,1744989950,1744989951.100791,-18000,,
com.google.Chrome,127,1744989804,1744989931,1744989931.8851318,-18000,,
com.apple.finder,8,1744989796,1744989804,1744989804.7858682,-18000,,
com.google.Chrome,75,1744989721,1744989796,1744989796.7128448,-18000,,
com.apple.finder,53,1744989668,1744989721,1744989721.250076,-18000,,
com.google.Chrome,6,1744989662,1744989668,1744989669.111201,-18000,,
com.microsoft.Powerpoint,25,1744989637,1744989662,1744989662.999195,-18000,,
com.google.Chrome,36,1744989601,1744989637,1744989637.907977,-18000,,
com.microsoft.Powerpoint,33,1744989568,1744989601,1744989601.501495,-18000,,
com.google.Chrome,9,1744989559,1744989568,1744989568.837181,-18000,,
com.microsoft.Powerpoint,41,1744989518,1744989559,1744989559.485361,-18000,,
com.google.Chrome,4,1744989514,1744989518,1744989518.963193,-18000,,
com.apple.finder,28,1744989486,1744989514,1744989515.101746,-18000,,
com.microsoft.VSCode,2,1744989484,1744989486,1744989486.712121,-18000,,
com.apple.finder,1,1744989483,1744989484,1744989484.52487,-18000,,
com.microsoft.Powerpoint,78,1744989405,1744989483,1744989484.024082,-18000,,
com.apple.finder,15,1744989390,1744989405,1744989405.373293,-18000,,
com.microsoft.Powerpoint,1,1744989389,1744989390,1744989391.2082949,-18000,,
com.microsoft.VSCode,2,1744989387,1744989389,1744989390.453304,-18000,,
com.microsoft.Powerpoint,6,1744989381,1744989387,1744989388.0292392,-18000,,
com.apple.finder,49,1744989332,1744989381,1744989381.788521,-18000,,
com.microsoft.VSCode,48,1744989284,1744989332,1744989332.886057,-18000,,
com.apple.finder,18,1744989266,1744989284,1744989284.5887918,-18000,,
com.microsoft.VSCode,4,1744989262,1744989266,1744989266.561431,-18000,,
com.apple.finder,2,1744989260,1744989262,1744989263.086282,-18000,,
com.microsoft.VSCode,4,1744989256,1744989260,1744989260.412576,-18000,,
com.apple.finder,0,1744989256,1744989256,1744989258.261819,-18000,,
com.microsoft.VSCode,19,1744989237,1744989256,1744989256.6653972,-18000,,
com.apple.finder,7,1744989230,1744989237,1744989238.088235,-18000,,
com.microsoft.VSCode,65,1744989165,1744989230,1744989231.409233,-18000,,
com.apple.MobileSMS,44,1744989121,1744989165,1744989165.695435,-18000,,
com.microsoft.VSCode,39,1744989082,1744989121,1744989122.233007,-18000,,
com.google.Chrome,2,1744989080,1744989082,1744989082.991516,-18000,,
com.microsoft.VSCode,19,1744989061,1744989080,1744989080.0692248,-18000,,
com.google.Chrome,6,1744989055,1744989061,1744989061.6211538,-18000,,
com.microsoft.VSCode,7,1744989048,1744989055,1744989055.400519,-18000,,
com.google.Chrome,26,1744989022,1744989048,1744989048.161251,-18000,,
com.microsoft.VSCode,4,1744989018,1744989022,1744989022.219839,-18000,,
com.google.Chrome,2,1744989016,1744989018,1744989018.1975698,-18000,,
com.microsoft.VSCode,3,1744989013,1744989016,1744989016.06074,-18000,,
com.google.Chrome,3,1744989010,1744989013,1744989013.834676,-18000,,
com.microsoft.VSCode,27,1744988983,1744989010,1744989010.435965,-18000,,
com.google.Chrome,5,1744988978,1744988983,1744988983.706047,-18000,,
com.microsoft.VSCode,148,1744988830,1744988978,1744988979.256726,-18000,,
com.apple.finder,8,1744988822,1744988830,1744988831.010826,-18000,,
com.microsoft.VSCode,54,1744988768,1744988822,1744988822.4265509,-18000,,
com.google.Chrome,26,1744988742,1744988768,1744988768.9651198,-18000,,
com.microsoft.VSCode,1,1744988741,1744988742,1744988742.666123,-18000,,
com.google.Chrome,18,1744988723,1744988741,1744988741.544627,-18000,,
com.microsoft.VSCode,14,1744988709,1744988723,1744988723.633936,-18000,,
com.google.Chrome,27,1744988682,1744988709,1744988709.096113,-18000,,
com.microsoft.VSCode,9,1744988673,1744988682,1744988682.950366,-18000,,
com.google.Chrome,4,1744988669,1744988673,1744988673.65498,-18000,,
com.microsoft.VSCode,45,1744988624,1744988669,1744988669.17646,-18000,,
com.google.Chrome,28,1744988596,1744988624,1744988624.195983,-18000,,
com.microsoft.VSCode,3,1744988593,1744988596,1744988596.059787,-18000,,
com.google.Chrome,1,1744988592,1744988593,1744988593.417498,-18000,,
com.microsoft.VSCode,6,1744988586,1744988592,1744988592.729117,-18000,,
com.google.Chrome,17,1744988569,1744988586,1744988586.231271,-18000,,
com.microsoft.VSCode,340,1744988229,1744988569,1744988569.111198,-18000,,
com.apple.MobileSMS,72,1744988157,1744988229,1744988229.260799,-18000,,
com.microsoft.VSCode,63,1744988094,1744988157,1744988157.672851,-18000,,
com.google.Chrome,14,1744988080,1744988094,1744988094.724224,-18000,,
com.microsoft.VSCode,105,1744987975,1744988080,1744988081.024152,-18000,,
com.google.Chrome,18,1744987957,1744987975,1744987975.388043,-18000,,
com.microsoft.VSCode,39,1744987918,1744987957,1744987957.152987,-18000,,
com.apple.finder,20,1744987898,1744987918,1744987918.659871,-18000,,
com.microsoft.VSCode,74,1744987824,1744987898,1744987898.626766,-18000,,
com.apple.finder,23,1744987801,1744987824,1744987824.924388,-18000,,
com.microsoft.VSCode,112,1744987689,1744987801,1744987801.438379,-18000,,
com.google.Chrome,24,1744987665,1744987689,1744987689.8733768,-18000,,
com.microsoft.VSCode,14,1744987651,1744987665,1744987665.141343,-18000,,
com.google.Chrome,64,1744987587,1744987651,1744987651.585565,-18000,,
com.microsoft.VSCode,6,1744987581,1744987587,1744987587.214167,-18000,,
com.google.Chrome,22,1744987559,1744987581,1744987581.419989,-18000,,
com.microsoft.VSCode,1,1744987558,1744987559,1744987560.035809,-18000,,
com.google.Chrome,5,1744987553,1744987558,1744987558.888534,-18000,,
com.microsoft.VSCode,71,1744987482,1744987553,1744987553.728283,-18000,,
com.google.Chrome,6,1744987476,1744987482,1744987482.466311,-18000,,
com.microsoft.VSCode,14,1744987462,1744987476,1744987476.794805,-18000,,
com.google.Chrome,18,1744987444,1744987462,1744987462.9215431,-18000,,
com.microsoft.VSCode,74,1744987370,1744987444,1744987444.7933521,-18000,,
com.google.Chrome,85,1744987285,1744987370,1744987371.07968,-18000,,
com.microsoft.VSCode,49,1744987236,1744987285,1744987285.2073,-18000,,
com.apple.Preview,130,1744987106,1744987236,1744987236.705812,-18000,,
com.apple.finder,35,1744987071,1744987106,1744987106.669174,-18000,,
com.microsoft.VSCode,299,1744986772,1744987071,1744987071.507416,-18000,,
com.google.Chrome,35,1744986737,1744986772,1744986772.4284859,-18000,,
com.microsoft.VSCode,107,1744986630,1744986737,1744986737.3067431,-18000,,
com.google.Chrome,2,1744986628,1744986630,1744986630.743421,-18000,,
com.apple.news,374,1744986254,1744986628,1744986628.410322,-18000,,
com.google.Chrome,22,1744986232,1744986254,1744986254.718995,-18000,,
com.microsoft.VSCode,18,1744986214,1744986232,1744986232.404749,-18000,,
com.apple.finder,49,1744986165,1744986214,1744986214.753203,-18000,,
com.microsoft.VSCode,8,1744986157,1744986165,1744986165.869505,-18000,,
com.leomehlig.today,19,1744986138,1744986157,1744986157.065734,-18000,,
com.microsoft.VSCode,4,1744986134,1744986138,1744986138.8611379,-18000,,
com.apple.MobileSMS,6,1744985813,1744985819,1744985819.469065,-18000,EB445137-D7F5-57EC-87DA-1DB460D64046,"iPhone13,2"
com.apple.Health,12,1744981986,1744981998,1744981998.0794458,-18000,EB445137-D7F5-57EC-87DA-1DB460D64046,"iPhone13,2"
com.apple.MobileSMS,12,1744981973,1744981985,1744981985.493579,-18000,EB445137-D7F5-57EC-87DA-1DB460D64046,"iPhone13,2"
com.apple.weather,0,1744981973,1744981973,1744981974.427309,-18000,EB445137-D7F5-57EC-87DA-1DB460D64046,"iPhone13,2"
com.apple.weather,4,1744981717,1744981721,1744981722.419471,-18000,EB445137-D7F5-57EC-87DA-1DB460D64046,"iPhone13,2"
com.hammerandchisel.discord,2,1744981715,1744981717,1744981717.481391,-18000,EB445137-D7F5-57EC-87DA-1DB460D64046,"iPhone13,2"
com.hammerandchisel.discord,6,1744981706,1744981712,1744981713.207124,-18000,EB445137-D7F5-57EC-87DA-1DB460D64046,"iPhone13,2"
com.apple.MobileSMS,1,1744981705,1744981706,1744981706.57726,-18000,EB445137-D7F5-57EC-87DA-1DB460D64046,"iPhone13,2"
com.apple.MobileSMS,29,1744981673,1744981702,1744981703.046473,-18000,EB445137-D7F5-57EC-87DA-1DB460D64046,"iPhone13,2"
com.renpho.health,0,1744981673,1744981673,1744981674.300008,-18000,EB445137-D7F5-57EC-87DA-1DB460D64046,"iPhone13,2"
com.renpho.health,101,1744981099,1744981200,1744981201.127956,-18000,EB445137-D7F5-57EC-87DA-1DB460D64046,"iPhone13,2"
com.toyopagroup.picaboo,24,1744981065,1744981089,1744981089.195302,-18000,EB445137-D7F5-57EC-87DA-1DB460D64046,"iPhone13,2"
com.apple.Bridge,124,1744947447,1744947571,1744947571.790864,-18000,EB445137-D7F5-57EC-87DA-1DB460D64046,"iPhone13,2"
com.apple.journal,937,1744946508,1744947445,1744947445.745264,-18000,EB445137-D7F5-57EC-87DA-1DB460D64046,"iPhone13,2"
com.apple.CoreAuthUI,2,1744946384,1744946386,1744946386.416312,-18000,EB445137-D7F5-57EC-87DA-1DB460D64046,"iPhone13,2"
com.apple.journal,124,1744946383,1744946507,1744946507.779458,-18000,EB445137-D7F5-57EC-87DA-1DB460D64046,"iPhone13,2"
com.apple.Health,155,1744946225,1744946380,1744946380.210875,-18000,EB445137-D7F5-57EC-87DA-1DB460D64046,"iPhone13,2"
com.microsoft.VSCode,7,1744946119,1744946126,1744946126.860595,-18000,,
com.apple.finder,23,1744946096,1744946119,1744946119.375107,-18000,,
com.microsoft.VSCode,2,1744946094,1744946096,1744946096.949884,-18000,,
com.microsoft.VSCode,301,1744945109,1744945410,1744945410.410557,-18000,,
com.apple.news,134,1744944975,1744945109,1744945109.366436,-18000,,
com.microsoft.VSCode,9,1744944966,1744944975,1744944975.2034621,-18000,,
com.google.Chrome,7,1744944959,1744944966,1744944966.5567021,-18000,,
com.microsoft.Outlook,2,1744944957,1744944959,1744944959.5324268,-18000,,
com.google.Chrome,1,1744944956,1744944957,1744944957.63817,-18000,,
com.microsoft.VSCode,19,1744944937,1744944956,1744944956.304913,-18000,,
com.apple.finder,8,1744944929,1744944937,1744944938.031878,-18000,,
com.microsoft.VSCode,2,1744944927,1744944929,1744944929.56643,-18000,,
com.apple.finder,10,1744944917,1744944927,1744944927.8457808,-18000,,
com.microsoft.VSCode,1,1744944916,1744944917,1744944917.857957,-18000,,
com.apple.finder,2,1744944914,1744944916,1744944916.734795,-18000,,
com.microsoft.VSCode,1,1744944913,1744944914,1744944914.6267781,-18000,,
com.apple.finder,2,1744944911,1744944913,1744944913.742498,-18000,,
com.microsoft.VSCode,6,1744944905,1744944911,1744944911.276727,-18000,,
com.apple.finder,34,1744944871,1744944905,1744944905.083943,-18000,,
com.microsoft.VSCode,4,1744944867,1744944871,1744944871.307149,-18000,,
com.apple.news,186,1744944681,1744944867,1744944867.337699,-18000,,
com.microsoft.VSCode,11,1744944670,1744944681,1744944682.002191,-18000,,
com.google.Chrome,2,1744944668,1744944670,1744944671.0220618,-18000,,
com.apple.finder,2,1744944666,1744944668,1744944668.762416,-18000,,
com.leomehlig.today,30,1744944636,1744944666,1744944666.476824,-18000,,
com.apple.finder,53,1744944583,1744944636,1744944636.797349,-18000,,
com.leomehlig.today,17,1744944566,1744944583,1744944583.927264,-18000,,
com.google.Chrome,1,1744944565,1744944566,1744944566.8773751,-18000,,
com.apple.iCal,16,1744944549,1744944565,1744944565.636983,-18000,,
com.google.Chrome,3,1744944546,1744944549,1744944549.992276,-18000,,
com.apple.iCal,7,1744944539,1744944546,1744944546.547302,-18000,,
com.google.Chrome,5,1744944534,1744944539,1744944539.703319,-18000,,
com.apple.iCal,2,1744944532,1744944534,1744944534.3736959,-18000,,
com.google.Chrome,61,1744944471,1744944532,1744944532.277238,-18000,,
com.microsoft.VSCode,3,1744944468,1744944471,1744944471.152529,-18000,,
com.microsoft.VSCode,552,1744943665,1744944217,1744944217.9503531,-18000,,
com.apple.finder,2,1744943663,1744943665,1744943665.4115171,-18000,,
com.microsoft.VSCode,137,1744943526,1744943663,1744943663.586237,-18000,,
com.microsoft.Powerpoint,16,1744943510,1744943526,1744943526.356721,-18000,,
com.microsoft.VSCode,9,1744943501,1744943510,1744943510.728302,-18000,,
com.google.Chrome,3,1744943498,1744943501,1744943501.9843569,-18000,,
com.microsoft.VSCode,13,1744943485,1744943498,1744943498.071745,-18000,,
com.google.Chrome,18,1744943467,1744943485,1744943485.247252,-18000,,
com.microsoft.VSCode,67,1744943400,1744943467,1744943468.0685349,-18000,,
com.google.Chrome,3,1744943397,1744943400,1744943400.6361752,-18000,,
com.google.Chrome,91,1744942957,1744943048,1744943048.4268951,-18000,,
com.google.chrome.ios,6,1744942945,1744942951,1744942952.121145,-18000,EB445137-D7F5-57EC-87DA-1DB460D64046,"iPhone13,2"
com.apple.weather,2,1744942943,1744942945,1744942945.4152489,-18000,EB445137-D7F5-57EC-87DA-1DB460D64046,"iPhone13,2"
com.apple.weather,87,1744942072,1744942159,1744942159.500241,-18000,EB445137-D7F5-57EC-87DA-1DB460D64046,"iPhone13,2"
com.google.chrome.ios,2,1744942070,1744942072,1744942072.2981029,-18000,EB445137-D7F5-57EC-87DA-1DB460D64046,"iPhone13,2"
com.google.Chrome,346,1744940471,1744940817,1744940817.683301,-18000,,
com.google.chrome.ios,90,1744939376,1744939466,1744939467.293158,-18000,EB445137-D7F5-57EC-87DA-1DB460D64046,"iPhone13,2"
com.instructure.icanvas,9,1744939367,1744939376,1744939376.572682,-18000,EB445137-D7F5-57EC-87DA-1DB460D64046,"iPhone13,2"
com.google.Chrome,414,1744936509,1744936923,1744936923.402283,-18000,,
com.instructure.icanvas,2,1744936478,1744936480,1744936480.540948,-18000,EB445137-D7F5-57EC-87DA-1DB460D64046,"iPhone13,2"
com.instructure.icanvas,19,1744936458,1744936477,1744936477.5338311,-18000,EB445137-D7F5-57EC-87DA-1DB460D64046,"iPhone13,2"
com.instructure.icanvas,39,1744936418,1744936457,1744936457.879578,-18000,EB445137-D7F5-57EC-87DA-1DB460D64046,"iPhone13,2"
com.instructure.icanvas,23,1744936106,1744936129,1744936129.9370089,-18000,EB445137-D7F5-57EC-87DA-1DB460D64046,"iPhone13,2"
com.letterboxd.LetterboxdApp,1,1744936105,1744936106,1744936106.518458,-18000,EB445137-D7F5-57EC-87DA-1DB460D64046,"iPhone13,2"
com.letterboxd.LetterboxdApp,82,1744934738,1744934820,1744934820.92857,-18000,EB445137-D7F5-57EC-87DA-1DB460D64046,"iPhone13,2"
com.truebill.truebillnative,2,1744934735,1744934737,1744934737.708715,-18000,EB445137-D7F5-57EC-87DA-1DB460D64046,"iPhone13,2"
com.apple.CoreAuthUI,2,1744934477,1744934479,1744934479.272645,-18000,EB445137-D7F5-57EC-87DA-1DB460D64046,"iPhone13,2"
com.truebill.truebillnative,174,1744934474,1744934648,1744934648.987356,-18000,EB445137-D7F5-57EC-87DA-1DB460D64046,"iPhone13,2"
com.hammerandchisel.discord,14,1744930566,1744930580,1744930580.054837,-18000,EB445137-D7F5-57EC-87DA-1DB460D64046,"iPhone13,2"
com.instructure.icanvas,42,1744930521,1744930563,1744930563.053072,-18000,EB445137-D7F5-57EC-87DA-1DB460D64046,"iPhone13,2"
com.instructure.icanvas,78,1744930442,1744930520,1744930520.6374621,-18000,EB445137-D7F5-57EC-87DA-1DB460D64046,"iPhone13,2"
com.google.Chrome,57,1744930125,1744930182,1744930183.214336,-18000,,
com.apple.iCal,40,1744930085,1744930125,1744930125.4696798,-18000,,
com.google.Chrome,40,1744930045,1744930085,1744930085.735752,-18000,,
com.apple.iCal,26,1744930019,1744930045,1744930045.861865,-18000,,
com.google.Chrome,16,1744930003,1744930019,1744930019.963695,-18000,,
com.apple.iCal,17,1744929986,1744930003,1744930003.11477,-18000,,
com.google.Chrome,6,1744929980,1744929986,1744929986.5229301,-18000,,
com.apple.iCal,35,1744929945,1744929980,1744929980.226526,-18000,,
com.leomehlig.today,25,1744929920,1744929945,1744929945.081293,-18000,,
com.google.Chrome,12,1744929908,1744929920,1744929920.3670158,-18000,,
com.leomehlig.today,74,1744929834,1744929908,1744929908.978496,-18000,,
com.google.Chrome,1774,1744928060,1744929834,1744929834.907428,-18000,,
com.microsoft.Powerpoint,3,1744928057,1744928060,1744928061.042968,-18000,,
com.google.Chrome,505,1744927552,1744928057,1744928057.990018,-18000,,
com.microsoft.Outlook,71,1744927481,1744927552,1744927552.27666,-18000,,
com.google.Chrome,5,1744927476,1744927481,1744927481.169888,-18000,,
com.leomehlig.today,3,1744927473,1744927476,1744927476.519318,-18000,,
com.google.Chrome,8,1744927465,1744927473,1744927473.591877,-18000,,
com.microsoft.Powerpoint,22,1744927443,1744927465,1744927465.209549,-18000,,
com.google.Chrome,13,1744927430,1744927443,1744927443.5110059,-18000,,
com.apple.finder,21,1744927409,1744927430,1744927430.539995,-18000,,
com.microsoft.Powerpoint,75,1744927334,1744927409,1744927409.337363,-18000,,
com.google.Chrome,5,1744927329,1744927334,1744927334.800611,-18000,,
com.microsoft.Powerpoint,1,1744927328,1744927329,1744927330.055963,-18000,,
com.apple.news,102,1744927226,1744927328,1744927329.144881,-18000,,
com.microsoft.Powerpoint,139,1744927087,1744927226,1744927226.089428,-18000,,
com.google.Chrome,102,1744926985,1744927087,1744927087.515676,-18000,,
com.microsoft.Powerpoint,40,1744926945,1744926985,1744926985.988356,-18000,,
com.google.Chrome,11,1744926934,1744926945,1744926945.422182,-18000,,
com.microsoft.Powerpoint,66,1744926868,1744926934,1744926934.6984,-18000,,
com.google.Chrome,7,1744926861,1744926868,1744926868.4349189,-18000,,
com.microsoft.Powerpoint,4,1744926857,1744926861,1744926861.450542,-18000,,
com.google.Chrome,3,1744926854,1744926857,1744926857.712703,-18000,,
com.microsoft.Powerpoint,32,1744926822,1744926854,1744926854.9571261,-18000,,
com.google.Chrome,5,1744926817,1744926822,1744926822.556685,-18000,,
com.microsoft.Powerpoint,47,1744926770,1744926817,1744926817.477425,-18000,,
com.google.Chrome,36,1744926734,1744926770,1744926770.453356,-18000,,
com.microsoft.Powerpoint,4,1744926730,1744926734,1744926734.208956,-18000,,
com.google.Chrome,56,1744926674,1744926730,1744926730.3291721,-18000,,
com.leomehlig.today,21,1744926637,1744926658,1744926658.665594,-18000,,
com.microsoft.Powerpoint,11,1744926626,1744926637,1744926637.7092528,-18000,,
com.google.Chrome,2,1744926624,1744926626,1744926626.840872,-18000,,
com.microsoft.Powerpoint,61,1744926563,1744926624,1744926624.53933,-18000,,
com.google.Chrome,4,1744926559,1744926563,1744926563.976119,-18000,,
com.microsoft.VSCode,1,1744926558,1744926559,1744926559.139182,-18000,,
com.microsoft.Powerpoint,59,1744926499,1744926558,1744926558.142864,-18000,,
com.microsoft.VSCode,1,1744926498,1744926499,1744926499.983162,-18000,,
com.microsoft.Powerpoint,1,1744926497,1744926498,1744926498.3683162,-18000,,
com.microsoft.VSCode,2,1744926495,1744926497,1744926497.3635201,-18000,,
com.microsoft.Powerpoint,45,1744926450,1744926495,1744926495.8301349,-18000,,
com.microsoft.VSCode,2,1744926448,1744926450,1744926450.069469,-18000,,
com.google.Chrome,2,1744926446,1744926448,1744926448.605322,-18000,,
com.microsoft.VSCode,1,1744926445,1744926446,1744926446.4227428,-18000,,
com.microsoft.Powerpoint,26,1744926419,1744926445,1744926445.430604,-18000,,
com.microsoft.VSCode,41,1744926378,1744926419,1744926419.871995,-18000,,
com.google.Chrome,2,1744926376,1744926378,1744926378.518107,-18000,,
com.microsoft.VSCode,40,1744926336,1744926376,1744926376.979082,-18000,,
com.google.Chrome,3,1744926333,1744926336,1744926336.4731069,-18000,,
com.microsoft.VSCode,9,1744926324,1744926333,1744926333.178379,-18000,,
com.google.Chrome,68,1744926256,1744926324,1744926324.315676,-18000,,
com.microsoft.VSCode,2,1744926254,1744926256,1744926256.17998,-18000,,
com.google.Chrome,3,1744926251,1744926254,1744926254.136123,-18000,,
com.microsoft.VSCode,27,1744926224,1744926251,1744926251.218502,-18000,,
com.google.Chrome,462,1744925762,1744926224,1744926224.344773,-18000,,
com.microsoft.VSCode,2,1744925760,1744925762,1744925762.464755,-18000,,
com.google.Chrome,0,1744925760,1744925760,1744925760.946492,-18000,,
com.microsoft.VSCode,1,1744925759,1744925760,1744925760.239627,-18000,,
com.google.Chrome,4,1744925755,1744925759,1744925759.166854,-18000,,
com.microsoft.VSCode,99,1744925656,1744925755,1744925755.9121928,-18000,,
com.apple.finder,32,1744925624,1744925656,1744925656.232769,-18000,,
com.microsoft.VSCode,1,1744925623,1744925624,1744925624.166523,-18000,,
com.apple.finder,5,1744925618,1744925623,1744925623.43858,-18000,,
com.google.Chrome,6,1744925612,1744925618,1744925618.661015,-18000,,
com.microsoft.Outlook,1,1744925611,1744925612,1744925612.8288789,-18000,,
com.leomehlig.today,2,1744925609,1744925611,1744925611.10506,-18000,,
com.google.Chrome,18,1744925591,1744925609,1744925610.053049,-18000,,
com.apple.Preferences,90,1744925343,1744925433,1744925433.324144,-18000,EB445137-D7F5-57EC-87DA-1DB460D64046,"iPhone13,2"
com.apple.news,19,1744925323,1744925342,1744925342.36862,-18000,EB445137-D7F5-57EC-87DA-1DB460D64046,"iPhone13,2"
com.apple.news,52,1744925258,1744925310,1744925310.937223,-18000,EB445137-D7F5-57EC-87DA-1DB460D64046,"iPhone13,2"
com.intsig.CamScannerLite,3,1744925250,1744925253,1744925253.679497,-18000,EB445137-D7F5-57EC-87DA-1DB460D64046,"iPhone13,2"
com.google.Chrome,406,1744925117,1744925523,1744925523.219606,-18000,,
com.microsoft.Outlook,0,1744925117,1744925117,1744925117.586086,-18000,,
com.google.Chrome,1,1744925116,1744925117,1744925117.2449698,-18000,,
com.microsoft.Outlook,22,1744925094,1744925116,1744925116.228337,-18000,,
com.google.Chrome,58,1744925036,1744925094,1744925094.479076,-18000,,
com.microsoft.Outlook,18,1744925018,1744925036,1744925036.7908669,-18000,,
com.google.Chrome,29,1744924989,1744925018,1744925018.398792,-18000,,
com.leomehlig.today,13,1744924976,1744924989,1744924990.0063381,-18000,,
com.google.Chrome,10,1744924966,1744924976,1744924976.644836,-18000,,
com.leomehlig.today,5,1744924961,1744924966,1744924966.617031,-18000,,
com.apple.iCal,7,1744924954,1744924961,1744924961.3965201,-18000,,
com.leomehlig.today,50,1744924904,1744924954,1744924954.701407,-18000,,
com.google.Chrome,1574,1744923330,1744924904,1744924904.212874,-18000,,
com.apple.finder,2,1744923328,1744923330,1744923330.1238298,-18000,,
com.google.Chrome,3,1744923325,1744923328,1744923328.662662,-18000,,
com.apple.finder,5,1744923320,1744923325,1744923325.42384,-18000,,
com.intsig.CamScannerLite,58,1744923262,1744923320,1744923321.636662,-18000,EB445137-D7F5-57EC-87DA-1DB460D64046,"iPhone13,2"
com.instructure.icanvas,7,1744923088,1744923095,1744923095.597389,-18000,EB445137-D7F5-57EC-87DA-1DB460D64046,"iPhone13,2"
com.instructure.icanvas,6,1744923082,1744923088,1744923088.273016,-18000,EB445137-D7F5-57EC-87DA-1DB460D64046,"iPhone13,2"
com.google.Chrome,253,1744923067,1744923320,1744923320.060378,-18000,,
com.apple.camera,6,1744922106,1744922112,1744922113.174611,-18000,EB445137-D7F5-57EC-87DA-1DB460D64046,"iPhone13,2"
com.instructure.icanvas,31,1744921722,1744921753,1744921753.112262,-18000,EB445137-D7F5-57EC-87DA-1DB460D64046,"iPhone13,2"
com.apple.mobiletimer,0,1744921722,1744921722,1744921723.425507,-18000,EB445137-D7F5-57EC-87DA-1DB460D64046,"iPhone13,2"
com.google.Chrome,258,1744921702,1744921960,1744921960.1080499,-18000,,
com.apple.Passwords,9,1744921693,1744921702,1744921702.90766,-18000,,
com.google.Chrome,2,1744921691,1744921693,1744921694.020996,-18000,,
com.apple.Passwords,2,1744921689,1744921691,1744921691.167266,-18000,,
com.google.Chrome,3,1744921686,1744921689,1744921690.0279,-18000,,
com.google.Chrome,342,1744921166,1744921508,1744921508.683362,-18000,,
com.apple.mobiletimer,7,1744920717,1744920724,1744920724.336807,-18000,EB445137-D7F5-57EC-87DA-1DB460D64046,"iPhone13,2"
com.apple.calculator,5,1744920712,1744920717,1744920717.34451,-18000,EB445137-D7F5-57EC-87DA-1DB460D64046,"iPhone13,2"
com.apple.calculator,5,1744920703,1744920708,1744920708.069902,-18000,EB445137-D7F5-57EC-87DA-1DB460D64046,"iPhone13,2"
com.apple.mobiletimer,245,1744920458,1744920703,1744920703.243058,-18000,EB445137-D7F5-57EC-87DA-1DB460D64046,"iPhone13,2"
com.apple.calculator,2,1744920456,1744920458,1744920458.204792,-18000,EB445137-D7F5-57EC-87DA-1DB460D64046,"iPhone13,2"
com.apple.calculator,10,1744919793,1744919803,1744919803.817481,-18000,EB445137-D7F5-57EC-87DA-1DB460D64046,"iPhone13,2"
com.apple.calculator,8,1744919784,1744919792,1744919792.3627229,-18000,EB445137-D7F5-57EC-87DA-1DB460D64046,"iPhone13,2"
com.apple.mobiletimer,410,1744919359,1744919769,1744919770.074512,-18000,EB445137-D7F5-57EC-87DA-1DB460D64046,"iPhone13,2"
com.google.Chrome,316,1744916390,1744916706,1744916706.6618829,-18000,,
com.apple.Passwords,6,1744916384,1744916390,1744916390.924134,-18000,,
com.google.Chrome,1,1744916383,1744916384,1744916384.54256,-18000,,
com.microsoft.Office.Outlook,10,1744915807,1744915817,1744915817.364564,-18000,EB445137-D7F5-57EC-87DA-1DB460D64046,"iPhone13,2"
com.microsoft.Office.Outlook,19,1744915787,1744915806,1744915806.189989,-18000,EB445137-D7F5-57EC-87DA-1DB460D64046,"iPhone13,2"
com.google.Chrome,868,1744913903,1744914771,1744914771.663768,-18000,,
com.google.Chrome,490,1744913289,1744913779,1744913779.870092,-18000,,
com.apple.finder,14,1744913275,1744913289,1744913289.283781,-18000,,
com.microsoft.Office.Outlook,8,1744912548,1744912556,1744912556.57745,-18000,EB445137-D7F5-57EC-87DA-1DB460D64046,"iPhone13,2"
com.microsoft.Office.Outlook,32,1744908104,1744908136,1744908136.286715,-18000,EB445137-D7F5-57EC-87DA-1DB460D64046,"iPhone13,2"
com.apple.finder,24,1744907751,1744907775,1744907776.183631,-18000,,
com.leomehlig.today,9,1744907742,1744907751,1744907751.80716,-18000,,
com.google.Chrome,2017,1744905725,1744907742,1744907743.0251431,-18000,,
com.leomehlig.today,362,1744905363,1744905725,1744905725.8590531,-18000,,
com.google.Chrome,967,1744904396,1744905363,1744905363.196025,-18000,,
com.leomehlig.today,3,1744904393,1744904396,1744904396.7351,-18000,,
com.google.Chrome,1,1744904392,1744904393,1744904393.657836,-18000,,
com.leomehlig.today,25,1744904367,1744904392,1744904392.130548,-18000,,
com.google.Chrome,1217,1744903150,1744904367,1744904367.251357,-18000,,
com.leomehlig.today,14,1744903136,1744903150,1744903150.485414,-18000,,
com.google.Chrome,872,1744902264,1744903136,1744903137.038266,-18000,,
com.leomehlig.today,1,1744902263,1744902264,1744902264.927652,-18000,,
com.apple.MobileSMS,3,1744901773,1744901776,1744901776.7211971,-18000,EB445137-D7F5-57EC-87DA-1DB460D64046,"iPhone13,2"
com.apple.MobileSMS,58,1744901708,1744901766,1744901766.806316,-18000,EB445137-D7F5-57EC-87DA-1DB460D64046,"iPhone13,2"
com.instructure.icanvas,6,1744901702,1744901708,1744901708.5860639,-18000,EB445137-D7F5-57EC-87DA-1DB460D64046,"iPhone13,2"
com.apple.MobileSMS,36,1744901663,1744901699,1744901699.36404,-18000,EB445137-D7F5-57EC-87DA-1DB460D64046,"iPhone13,2"
com.google.Chrome,917,1744901346,1744902263,1744902263.47875,-18000,,
com.google.Chrome,314,1744900872,1744901186,1744901186.423932,-18000,,
com.google.Chrome,374,1744900254,1744900628,1744900628.293964,-18000,,
com.leomehlig.today,14,1744900228,1744900242,1744900242.237792,-18000,,
com.apple.finder,7,1744900221,1744900228,1744900228.768712,-18000,,
com.google.Chrome,34,1744900187,1744900221,1744900222.0296888,-18000,,
com.apple.Preview,15,1744900159,1744900174,1744900175.667293,-18000,,
com.leomehlig.today,25,1744900134,1744900159,1744900159.8443398,-18000,,
com.apple.Preview,3,1744900131,1744900134,1744900134.3051949,-18000,,
com.apple.finder,3,1744900128,1744900131,1744900131.687461,-18000,,
com.leomehlig.today,1,1744900127,1744900128,1744900128.345271,-18000,,
com.google.Chrome,3,1744900124,1744900127,1744900127.969423,-18000,,
com.leomehlig.today,377,1744899747,1744900124,1744900124.454576,-18000,,
com.apple.finder,20,1744899727,1744899747,1744899748.02601,-18000,,
com.google.Chrome,49,1744899678,1744899727,1744899728.017169,-18000,,
com.apple.finder,10,1744899654,1744899664,1744899664.371278,-18000,,
com.apple.Preview,12,1744899642,1744899654,1744899654.9750829,-18000,,
com.apple.finder,34,1744899608,1744899642,1744899642.425529,-18000,,
com.apple.Preview,11,1744899597,1744899608,1744899608.996846,-18000,,
com.google.Chrome,1,1744899596,1744899597,1744899597.526486,-18000,,
com.apple.Preview,4,1744899592,1744899596,1744899596.3458261,-18000,,
com.google.Chrome,31,1744899561,1744899592,1744899592.489417,-18000,,
com.apple.Preview,68,1744899493,1744899561,1744899561.6010818,-18000,,
com.google.Chrome,88,1744899405,1744899493,1744899493.998437,-18000,,
com.apple.Preview,27,1744899378,1744899405,1744899405.072527,-18000,,
com.google.Chrome,67,1744899311,1744899378,1744899379.022869,-18000,,
com.apple.Preview,127,1744899184,1744899311,1744899311.925105,-18000,,
com.google.Chrome,31,1744899153,1744899184,1744899184.2984838,-18000,,
com.apple.Preview,3,1744899150,1744899153,1744899153.974884,-18000,,
com.google.Chrome,11,1744899139,1744899150,1744899150.623538,-18000,,
com.apple.Preview,735,1744898404,1744899139,1744899139.737269,-18000,,
com.apple.Preview,968,1744897428,1744898396,1744898396.7596989,-18000,,
com.google.Chrome,60,1744897368,1744897428,1744897428.1776729,-18000,,
com.apple.Preview,67,1744897301,1744897368,1744897368.7683501,-18000,,
com.apple.finder,2,1744897299,1744897301,1744897301.3842301,-18000,,
com.apple.Preview,48,1744897251,1744897299,1744897299.97911,-18000,,
com.google.Chrome,411,1744896840,1744897251,1744897251.035249,-18000,,
com.apple.Preview,71,1744896769,1744896840,1744896840.1596699,-18000,,
com.apple.finder,14,1744896755,1744896769,1744896769.257489,-18000,,
com.leomehlig.today,6,1744896749,1744896755,1744896755.404268,-18000,,
com.microsoft.VSCode,4,1744896745,1744896749,1744896749.784908,-18000,,
com.leomehlig.today,11,1744896734,1744896745,1744896745.8073301,-18000,,
com.apple.Health,105,1744896050,1744896155,1744896155.607929,-18000,EB445137-D7F5-57EC-87DA-1DB460D64046,"iPhone13,2"
com.apple.MobileSMS,4,1744896044,1744896048,1744896048.683134,-18000,EB445137-D7F5-57EC-87DA-1DB460D64046,"iPhone13,2"
com.instructure.icanvas,10,1744896030,1744896040,1744896040.094315,-18000,EB445137-D7F5-57EC-87DA-1DB460D64046,"iPhone13,2"
com.apple.Health,0,1744896030,1744896030,1744896030.9143538,-18000,EB445137-D7F5-57EC-87DA-1DB460D64046,"iPhone13,2"
com.apple.Health,43,1744895651,1744895694,1744895694.481297,-18000,EB445137-D7F5-57EC-87DA-1DB460D64046,"iPhone13,2"
com.apple.Health,47,1744895179,1744895226,1744895226.697716,-18000,EB445137-D7F5-57EC-87DA-1DB460D64046,"iPhone13,2"
com.apple.weather,6,1744895172,1744895178,1744895178.77319,-18000,EB445137-D7F5-57EC-87DA-1DB460D64046,"iPhone13,2"
com.renpho.health,2,1744895170,1744895172,1744895172.2361832,-18000,EB445137-D7F5-57EC-87DA-1DB460D64046,"iPhone13,2"
com.renpho.health,1,1744895169,1744895170,1744895170.111613,-18000,EB445137-D7F5-57EC-87DA-1DB460D64046,"iPhone13,2"
com.renpho.health,90,1744895061,1744895151,1744895151.5490441,-18000,EB445137-D7F5-57EC-87DA-1DB460D64046,"iPhone13,2"
com.leomehlig.today,90,1744860076,1744860166,1744860166.494256,-18000,,
com.microsoft.Outlook,18,1744860058,1744860076,1744860076.218741,-18000,,
com.google.Chrome,222,1744859836,1744860058,1744860058.558127,-18000,,
com.google.Chrome,670,1744859139,1744859809,1744859809.561405,-18000,,
com.google.Chrome,1477,1744857599,1744859076,1744859076.366457,-18000,,
com.google.chrome.ios,51,1744856675,1744856726,1744856727.118991,-18000,EB445137-D7F5-57EC-87DA-1DB460D64046,"iPhone13,2"
com.facebook.Facebook,638,1744856036,1744856674,1744856674.982702,-18000,EB445137-D7F5-57EC-87DA-1DB460D64046,"iPhone13,2"
com.google.chrome.ios,22,1744856014,1744856036,1744856036.282588,-18000,EB445137-D7F5-57EC-87DA-1DB460D64046,"iPhone13,2"
com.apple.MobileSMS,2,1744856012,1744856014,1744856014.5928721,-18000,EB445137-D7F5-57EC-87DA-1DB460D64046,"iPhone13,2"
com.facebook.Facebook,216,1744855796,1744856012,1744856013.0468612,-18000,EB445137-D7F5-57EC-87DA-1DB460D64046,"iPhone13,2"
com.apple.MobileSMS,239,1744855552,1744855791,1744855791.768811,-18000,EB445137-D7F5-57EC-87DA-1DB460D64046,"iPhone13,2"
com.google.chrome.ios,9,1744855542,1744855551,1744855551.513482,-18000,EB445137-D7F5-57EC-87DA-1DB460D64046,"iPhone13,2"
com.google.chrome.ios,17,1744855152,1744855169,1744855169.789804,-18000,EB445137-D7F5-57EC-87DA-1DB460D64046,"iPhone13,2"
com.google.Chrome,300,1744854494,1744854794,1744854794.994802,-18000,,
com.apple.systempreferences,27,1744854467,1744854494,1744854494.203835,-18000,,
com.google.Chrome,1,1744854466,1744854467,1744854467.809061,-18000,,
com.apple.systempreferences,2,1744854461,1744854463,1744854463.291823,-18000,,
com.google.Chrome,2,1744854455,1744854457,1744854457.8654819,-18000,,
com.google.chrome.ios,14,1744854369,1744854383,1744854383.772783,-18000,EB445137-D7F5-57EC-87DA-1DB460D64046,"iPhone13,2"
com.apple.news,821,1744853509,1744854330,1744854331.1394691,-18000,EB445137-D7F5-57EC-87DA-1DB460D64046,"iPhone13,2"
com.letterboxd.LetterboxdApp,3,1744853496,1744853499,1744853499.4726682,-18000,EB445137-D7F5-57EC-87DA-1DB460D64046,"iPhone13,2"
com.google.Chrome,529,1744853204,1744853733,1744853733.8266602,-18000,,
com.leomehlig.today,9,1744853195,1744853204,1744853204.924522,-18000,,
com.letterboxd.LetterboxdApp,52,1744852841,1744852893,1744852893.391753,-18000,EB445137-D7F5-57EC-87DA-1DB460D64046,"iPhone13,2"
com.hammerandchisel.discord,2,1744852625,1744852627,1744852627.533014,-18000,EB445137-D7F5-57EC-87DA-1DB460D64046,"iPhone13,2"
com.google.Chrome,1288,1744851907,1744853195,1744853195.40499,-18000,,
com.hammerandchisel.discord,14,1744851583,1744851597,1744851597.802445,-18000,EB445137-D7F5-57EC-87DA-1DB460D64046,"iPhone13,2"
com.google.Chrome,253,1744848595,1744848848,1744848848.3557339,-18000,,
com.microsoft.Outlook,1,1744848584,1744848585,1744848585.416033,-18000,,
com.google.Chrome,2,1744848582,1744848584,1744848584.4076781,-18000,,
com.microsoft.Outlook,10,1744848572,1744848582,1744848582.947844,-18000,,
com.leomehlig.today,34,1744848538,1744848572,1744848572.283252,-18000,,
com.microsoft.Outlook,2,1744848536,1744848538,1744848538.851688,-18000,,
com.google.Chrome,23,1744848513,1744848536,1744848536.057128,-18000,,
com.leomehlig.today,7,1744848506,1744848513,1744848514.654815,-18000,,
com.google.chrome.ios,258,1744848180,1744848438,1744848439.0935988,-18000,EB445137-D7F5-57EC-87DA-1DB460D64046,"iPhone13,2"
com.apple.news,364,1744847816,1744848180,1744848180.8037019,-18000,EB445137-D7F5-57EC-87DA-1DB460D64046,"iPhone13,2"
com.google.chrome.ios,272,1744847538,1744847810,1744847811.159027,-18000,EB445137-D7F5-57EC-87DA-1DB460D64046,"iPhone13,2"
com.apple.news,416,1744847104,1744847520,1744847520.580007,-18000,EB445137-D7F5-57EC-87DA-1DB460D64046,"iPhone13,2"
com.google.chrome.ios,76,1744847028,1744847104,1744847105.152751,-18000,EB445137-D7F5-57EC-87DA-1DB460D64046,"iPhone13,2"
com.apple.news,486,1744846542,1744847028,1744847028.494422,-18000,EB445137-D7F5-57EC-87DA-1DB460D64046,"iPhone13,2"
com.apple.news,330,1744846196,1744846526,1744846526.8141,-18000,EB445137-D7F5-57EC-87DA-1DB460D64046,"iPhone13,2"
com.google.chrome.ios,17,1744846175,1744846192,1744846192.7001739,-18000,EB445137-D7F5-57EC-87DA-1DB460D64046,"iPhone13,2"
com.microsoft.Office.Outlook,1,1744846174,1744846175,1744846175.580225,-18000,EB445137-D7F5-57EC-87DA-1DB460D64046,"iPhone13,2"
com.microsoft.Office.Outlook,22,1744845924,1744845946,1744845946.828649,-18000,EB445137-D7F5-57EC-87DA-1DB460D64046,"iPhone13,2"
com.hammerandchisel.discord,0,1744845924,1744845924,1744845925.094341,-18000,EB445137-D7F5-57EC-87DA-1DB460D64046,"iPhone13,2"
com.hammerandchisel.discord,0,1744843658,1744843658,1744843658.9713311,-18000,EB445137-D7F5-57EC-87DA-1DB460D64046,"iPhone13,2"
com.hammerandchisel.discord,18,1744842322,1744842340,1744842340.2557101,-18000,EB445137-D7F5-57EC-87DA-1DB460D64046,"iPhone13,2"
com.microsoft.Office.Outlook,41,1744842230,1744842271,1744842271.809814,-18000,EB445137-D7F5-57EC-87DA-1DB460D64046,"iPhone13,2"
com.instructure.icanvas,16,1744842206,1744842222,1744842222.826849,-18000,EB445137-D7F5-57EC-87DA-1DB460D64046,"iPhone13,2"
com.toyopagroup.picaboo,6,1744842197,1744842203,1744842203.235423,-18000,EB445137-D7F5-57EC-87DA-1DB460D64046,"iPhone13,2"
com.toyopagroup.picaboo,21,1744842173,1744842194,1744842195.21664,-18000,EB445137-D7F5-57EC-87DA-1DB460D64046,"iPhone13,2"
com.leomehlig.today,2,1744841479,1744841481,1744841481.3297138,-18000,,
com.apple.news,22,1744841457,1744841479,1744841479.823707,-18000,,
com.leomehlig.today,8,1744841449,1744841457,1744841457.993614,-18000,,
com.microsoft.VSCode,4,1744841445,1744841449,1744841449.783437,-18000,,
com.leomehlig.today,10,1744841435,1744841445,1744841445.668486,-18000,,
com.google.Chrome,1833,1744839602,1744841435,1744841435.578825,-18000,,
com.google.Chrome,614,1744838895,1744839509,1744839509.072612,-18000,,
com.google.Chrome,455,1744838277,1744838732,1744838732.441252,-18000,,
com.leomehlig.today,31,1744838235,1744838266,1744838266.5311441,-18000,,
com.google.Chrome,8,1744838227,1744838235,1744838235.380837,-18000,,
com.apple.news,568,1744837659,1744838227,1744838227.9224858,-18000,,
com.google.Chrome,103,1744837556,1744837659,1744837659.0884361,-18000,,
com.apple.finder,53,1744837503,1744837556,1744837556.6327438,-18000,,
com.google.Chrome,50,1744837453,1744837503,1744837503.0798779,-18000,,
com.google.Chrome,302,1744835236,1744835538,1744835538.5196152,-18000,,
com.google.Chrome,542,1744834671,1744835213,1744835213.7743502,-18000,,
com.leomehlig.today,10,1744834652,1744834662,1744834662.358416,-18000,,
com.google.Chrome,1,1744834651,1744834652,1744834653.0256171,-18000,,
com.apple.iCal,5,1744834646,1744834651,1744834652.047797,-18000,,
com.google.Chrome,24,1744834622,1744834646,1744834646.577595,-18000,,
com.apple.Health,16,1744834215,1744834231,1744834231.693438,-18000,EB445137-D7F5-57EC-87DA-1DB460D64046,"iPhone13,2"
com.tinyspeck.chatlyio,2,1744834213,1744834215,1744834216.177668,-18000,EB445137-D7F5-57EC-87DA-1DB460D64046,"iPhone13,2"
com.google.Chrome,7,1744830040,1744830047,1744830047.276968,-18000,,
com.microsoft.VSCode,60,1744829980,1744830040,1744830040.521137,-18000,,
com.google.Chrome,15,1744829965,1744829980,1744829980.320236,-18000,,
com.microsoft.VSCode,123,1744829842,1744829965,1744829966.447702,-18000,,
com.tinyspeck.chatlyio,27,1744829456,1744829483,1744829483.277729,-18000,EB445137-D7F5-57EC-87DA-1DB460D64046,"iPhone13,2"
com.toyopagroup.picaboo,12,1744829427,1744829439,1744829440.2627811,-18000,EB445137-D7F5-57EC-87DA-1DB460D64046,"iPhone13,2"
com.tinyspeck.chatlyio,23,1744829401,1744829424,1744829424.67739,-18000,EB445137-D7F5-57EC-87DA-1DB460D64046,"iPhone13,2"
com.microsoft.VSCode,424,1744826067,1744826491,1744826491.165843,-18000,,
com.google.Chrome,90,1744825977,1744826067,1744826068.013057,-18000,,
com.leomehlig.today,38,1744825926,1744825964,1744825965.596662,-18000,,
com.microsoft.Powerpoint,121,1744825805,1744825926,1744825926.448237,-18000,,
com.apple.finder,1,1744825804,1744825805,1744825805.848269,-18000,,
com.apple.Preview,10,1744825794,1744825804,1744825804.350946,-18000,,
com.apple.finder,1,1744825793,1744825794,1744825794.948635,-18000,,
com.microsoft.Powerpoint,7,1744825786,1744825793,1744825793.5095901,-18000,,
com.apple.finder,1,1744825785,1744825786,1744825786.745018,-18000,,
com.microsoft.Powerpoint,27,1744825758,1744825785,1744825785.6999931,-18000,,
com.apple.finder,2,1744825756,1744825758,1744825758.506343,-18000,,
com.apple.Preview,17,1744825739,1744825756,1744825756.05585,-18000,,
com.apple.finder,1,1744825738,1744825739,1744825739.983561,-18000,,
com.microsoft.Powerpoint,40,1744825698,1744825738,1744825738.78762,-18000,,
com.apple.finder,10,1744825688,1744825698,1744825698.4983702,-18000,,
com.apple.Preview,4,1744825684,1744825688,1744825688.162204,-18000,,
com.apple.finder,1,1744825683,1744825684,1744825684.635127,-18000,,
com.microsoft.Excel,1,1744825682,1744825683,1744825683.412352,-18000,,
com.apple.finder,2,1744825680,1744825682,1744825682.394711,-18000,,
com.apple.Preview,16,1744825664,1744825680,1744825680.814869,-18000,,
com.apple.finder,10,1744825654,1744825664,1744825664.2893991,-18000,,
com.google.Chrome,15,1744825639,1744825654,1744825654.911546,-18000,,
com.apple.finder,6,1744825633,1744825639,1744825640.620717,-18000,,
com.google.Chrome,22,1744825611,1744825633,1744825633.607779,-18000,,
com.microsoft.VSCode,15,1744825596,1744825611,1744825611.705089,-18000,,
com.apple.MobileSMS,2,1744825582,1744825584,1744825585.365272,-18000,EB445137-D7F5-57EC-87DA-1DB460D64046,"iPhone13,2"
com.microsoft.Office.Outlook,60,1744825521,1744825581,1744825581.545527,-18000,EB445137-D7F5-57EC-87DA-1DB460D64046,"iPhone13,2"
com.instructure.icanvas,62,1744819324,1744819386,1744819386.747513,-18000,EB445137-D7F5-57EC-87DA-1DB460D64046,"iPhone13,2"
com.apple.MobileSMS,20,1744819137,1744819157,1744819157.127178,-18000,EB445137-D7F5-57EC-87DA-1DB460D64046,"iPhone13,2"
com.apple.MobileSMS,39,1744819062,1744819101,1744819101.716558,-18000,EB445137-D7F5-57EC-87DA-1DB460D64046,"iPhone13,2"
com.apple.Health,3,1744818969,1744818972,1744818972.621856,-18000,EB445137-D7F5-57EC-87DA-1DB460D64046,"iPhone13,2"
com.apple.CoreAuthUI,2,1744818952,1744818954,1744818954.6871471,-18000,EB445137-D7F5-57EC-87DA-1DB460D64046,"iPhone13,2"
com.robinhood.release.Robinhood,4,1744818951,1744818955,1744818955.659926,-18000,EB445137-D7F5-57EC-87DA-1DB460D64046,"iPhone13,2"
com.apple.CoreAuthUI,2,1744818945,1744818947,1744818947.982456,-18000,EB445137-D7F5-57EC-87DA-1DB460D64046,"iPhone13,2"
com.apple.journal,3,1744818944,1744818947,1744818947.98034,-18000,EB445137-D7F5-57EC-87DA-1DB460D64046,"iPhone13,2"
com.apple.CoreAuthUI,1,1744818940,1744818941,1744818941.699902,-18000,EB445137-D7F5-57EC-87DA-1DB460D64046,"iPhone13,2"
co.hinge.mobile.ios,4,1744818939,1744818943,1744818943.8481631,-18000,EB445137-D7F5-57EC-87DA-1DB460D64046,"iPhone13,2"
com.apple.CoreAuthUI,2,1744818935,1744818937,1744818937.0663218,-18000,EB445137-D7F5-57EC-87DA-1DB460D64046,"iPhone13,2"
com.apple.AppProtectionUIHost,9,1744818927,1744818936,1744818936.375386,-18000,EB445137-D7F5-57EC-87DA-1DB460D64046,"iPhone13,2"
com.apple.mobileslideshow,12,1744818786,1744818798,1744818798.35233,-18000,EB445137-D7F5-57EC-87DA-1DB460D64046,"iPhone13,2"
com.microsoft.Office.Outlook,16,1744818448,1744818464,1744818464.5157151,-18000,EB445137-D7F5-57EC-87DA-1DB460D64046,"iPhone13,2"
com.toyopagroup.picaboo,61,1744818386,1744818447,1744818447.659233,-18000,EB445137-D7F5-57EC-87DA-1DB460D64046,"iPhone13,2"
com.microsoft.VSCode,182,1744818288,1744818470,1744818470.804998,-18000,,
com.google.Chrome,38,1744818250,1744818288,1744818288.343951,-18000,,
com.microsoft.VSCode,1,1744818249,1744818250,1744818250.663569,-18000,,
com.google.Chrome,17,1744818232,1744818249,1744818249.493034,-18000,,
com.microsoft.VSCode,66,1744818166,1744818232,1744818232.3115911,-18000,,
com.google.Chrome,108,1744818058,1744818166,1744818167.039309,-18000,,
com.microsoft.VSCode,438,1744817620,1744818058,1744818058.757718,-18000,,
com.apple.finder,20,1744817600,1744817620,1744817620.264731,-18000,,
com.microsoft.VSCode,2331,1744815269,1744817600,1744817600.536614,-18000,,
com.apple.finder,185,1744815084,1744815269,1744815269.817493,-18000,,
com.apple.Health,973,1744814103,1744815076,1744815076.9902449,-18000,EB445137-D7F5-57EC-87DA-1DB460D64046,"iPhone13,2"
com.microsoft.Excel,982,1744814102,1744815084,1744815085.026812,-18000,,
com.apple.ScreenContinuity,23,1744814079,1744814102,1744814102.4324431,-18000,,
com.microsoft.Excel,38,1744814041,1744814079,1744814079.288446,-18000,,
com.apple.finder,29,1744814012,1744814041,1744814041.320956,-18000,,
com.leomehlig.today,295,1744813717,1744814012,1744814012.840205,-18000,,
com.apple.news,576,1744813427,1744814003,1744814003.051879,-18000,EB445137-D7F5-57EC-87DA-1DB460D64046,"iPhone13,2"
com.leomehlig.today,342,1744813372,1744813714,1744813714.53743,-18000,,
com.google.Chrome,184,1744813188,1744813372,1744813372.373262,-18000,,
com.apple.Photos,66,1744813122,1744813188,1744813188.843765,-18000,,
com.google.Chrome,2984,1744810138,1744813122,1744813122.145392,-18000,,
com.apple.Health,40,1744808809,1744808849,1744808849.937053,-18000,EB445137-D7F5-57EC-87DA-1DB460D64046,"iPhone13,2"
com.apple.Health,68,1744808732,1744808800,1744808801.002421,-18000,EB445137-D7F5-57EC-87DA-1DB460D64046,"iPhone13,2"
com.apple.Health,9,1744808718,1744808727,1744808727.323426,-18000,EB445137-D7F5-57EC-87DA-1DB460D64046,"iPhone13,2"
com.instructure.icanvas,7,1744808694,1744808701,1744808702.014147,-18000,EB445137-D7F5-57EC-87DA-1DB460D64046,"iPhone13,2"
com.apple.weather,0,1744808694,1744808694,1744808695.8857899,-18000,EB445137-D7F5-57EC-87DA-1DB460D64046,"iPhone13,2"
com.apple.weather,19,1744807968,1744807987,1744807988.311507,-18000,EB445137-D7F5-57EC-87DA-1DB460D64046,"iPhone13,2"
com.renpho.health,93,1744807875,1744807968,1744807968.441917,-18000,EB445137-D7F5-57EC-87DA-1DB460D64046,"iPhone13,2"
com.apple.journal,535,1744777641,1744778176,1744778176.163872,-18000,EB445137-D7F5-57EC-87DA-1DB460D64046,"iPhone13,2"
com.apple.journal,62,1744777576,1744777638,1744777638.261643,-18000,EB445137-D7F5-57EC-87DA-1DB460D64046,"iPhone13,2"
com.apple.CoreAuthUI,4,1744775774,1744775778,1744775778.7335548,-18000,EB445137-D7F5-57EC-87DA-1DB460D64046,"iPhone13,2"
com.apple.journal,1801,1744775773,1744777574,1744777574.968711,-18000,EB445137-D7F5-57EC-87DA-1DB460D64046,"iPhone13,2"
com.google.Chrome,546,1744774875,1744775421,1744775421.165626,-18000,,
com.google.Chrome,1436,1744773229,1744774665,1744774665.970397,-18000,,
com.google.Chrome,1000,1744771865,1744772865,1744772865.764071,-18000,,
com.apple.finder,3,1744771862,1744771865,1744771865.275953,-18000,,
com.apple.finder,2,1744771333,1744771335,1744771335.658381,-18000,,
com.google.Chrome,3,1744771330,1744771333,1744771333.332615,-18000,,
com.google.Chrome,857,1744768095,1744768952,1744768952.4072971,-18000,,
com.apple.finder,2,1744768093,1744768095,1744768095.315505,-18000,,
com.instructure.icanvas,8,1744758474,1744758482,1744758482.817056,-18000,EB445137-D7F5-57EC-87DA-1DB460D64046,"iPhone13,2"
com.intsig.CamScannerLite,0,1744758474,1744758474,1744758474.8998919,-18000,EB445137-D7F5-57EC-87DA-1DB460D64046,"iPhone13,2"
com.apple.finder,2,1744757749,1744757751,1744757751.984972,-18000,,
com.leomehlig.today,78,1744757671,1744757749,1744757749.424646,-18000,,
com.google.Chrome,60,1744757611,1744757671,1744757671.378838,-18000,,
com.apple.finder,28,1744757571,1744757599,1744757599.304383,-18000,,
com.apple.Preview,19,1744757552,1744757571,1744757571.851573,-18000,,
com.apple.finder,1,1744757551,1744757552,1744757552.267181,-18000,,
com.apple.Preview,1,1744757550,1744757551,1744757551.6256208,-18000,,
com.apple.finder,14,1744757536,1744757550,1744757551.009021,-18000,,
com.leomehlig.today,5,1744757531,1744757536,1744757536.17139,-18000,,
com.apple.finder,0,1744757531,1744757531,1744757531.70743,-18000,,
com.intsig.CamScannerLite,126,1744757462,1744757588,1744757588.740557,-18000,EB445137-D7F5-57EC-87DA-1DB460D64046,"iPhone13,2"
com.leomehlig.today,89,1744757442,1744757531,1744757531.57886,-18000,,
com.google.Chrome,9,1744757433,1744757442,1744757442.135126,-18000,,
com.apple.Preview,3,1744757430,1744757433,1744757433.571584,-18000,,
com.google.Chrome,2,1744757428,1744757430,1744757430.56721,-18000,,
com.microsoft.VSCode,12,1744757416,1744757428,1744757428.394258,-18000,,
com.google.Chrome,13,1744757403,1744757416,1744757416.642888,-18000,,
com.microsoft.VSCode,12,1744757391,1744757403,1744757403.546629,-18000,,
com.google.Chrome,11,1744757380,1744757391,1744757391.0867329,-18000,,
com.microsoft.VSCode,18,1744757362,1744757380,1744757380.639052,-18000,,
com.google.Chrome,48,1744757314,1744757362,1744757362.842021,-18000,,
com.microsoft.VSCode,10,1744757304,1744757314,1744757314.7738872,-18000,,
com.google.Chrome,80,1744757224,1744757304,1744757304.774032,-18000,,
com.microsoft.VSCode,76,1744757148,1744757224,1744757224.437751,-18000,,
com.google.Chrome,1,1744757147,1744757148,1744757148.342533,-18000,,
com.microsoft.VSCode,3,1744757144,1744757147,1744757147.155707,-18000,,
com.google.Chrome,19,1744757125,1744757144,1744757144.586955,-18000,,
com.microsoft.VSCode,75,1744757050,1744757125,1744757125.728919,-18000,,
com.google.Chrome,15,1744757035,1744757050,1744757051.031702,-18000,,
com.microsoft.VSCode,68,1744756967,1744757035,1744757035.956409,-18000,,
com.google.Chrome,1,1744756966,1744756967,1744756967.955011,-18000,,
com.microsoft.VSCode,7,1744756959,1744756966,1744756966.131923,-18000,,
com.google.Chrome,3,1744756956,1744756959,1744756959.232943,-18000,,
com.microsoft.VSCode,4,1744756952,1744756956,1744756956.7493691,-18000,,
com.google.Chrome,1,1744756951,1744756952,1744756952.960383,-18000,,
com.microsoft.VSCode,1,1744756950,1744756951,1744756951.5281649,-18000,,
com.google.Chrome,4,1744756946,1744756950,1744756951.037229,-18000,,
com.microsoft.VSCode,212,1744756734,1744756946,1744756946.57064,-18000,,
com.google.Chrome,24,1744756710,1744756734,1744756735.018316,-18000,,
com.microsoft.VSCode,92,1744756618,1744756710,1744756710.837122,-18000,,
com.google.Chrome,13,1744756605,1744756618,1744756618.411937,-18000,,
com.microsoft.VSCode,4,1744756601,1744756605,1744756605.735372,-18000,,
com.google.Chrome,2,1744756599,1744756601,1744756601.902251,-18000,,
com.microsoft.VSCode,32,1744756567,1744756599,1744756599.171166,-18000,,
com.google.Chrome,6,1744756561,1744756567,1744756567.126229,-18000,,
com.microsoft.VSCode,26,1744756535,1744756561,1744756561.319684,-18000,,
com.google.Chrome,3,1744756532,1744756535,1744756535.830879,-18000,,
com.microsoft.VSCode,23,1744756509,1744756532,1744756532.3070722,-18000,,
com.google.Chrome,11,1744756498,1744756509,1744756509.7690659,-18000,,
com.microsoft.VSCode,7,1744756491,1744756498,1744756498.652456,-18000,,
com.google.Chrome,1,1744756490,1744756491,1744756491.754883,-18000,,
com.microsoft.VSCode,4,1744756486,1744756490,1744756490.470655,-18000,,
com.google.Chrome,5,1744756481,1744756486,1744756486.366842,-18000,,
com.microsoft.VSCode,6,1744756475,1744756481,1744756481.6850371,-18000,,
com.google.Chrome,198,1744756277,1744756475,1744756475.4829822,-18000,,
com.apple.Preview,37,1744756240,1744756277,1744756277.643255,-18000,,
com.google.Chrome,38,1744756202,1744756240,1744756240.4544048,-18000,,
com.apple.Preview,20,1744756182,1744756202,1744756202.4195561,-18000,,
com.google.Chrome,7,1744756175,1744756182,1744756182.433357,-18000,,
com.apple.Preview,2,1744756173,1744756175,1744756175.662949,-18000,,
com.google.Chrome,2,1744756171,1744756173,1744756173.324755,-18000,,
com.apple.Preview,11,1744756160,1744756171,1744756172.002798,-18000,,
com.google.Chrome,77,1744756083,1744756160,1744756160.854697,-18000,,
com.apple.Preview,80,1744756003,1744756083,1744756083.771949,-18000,,
com.google.Chrome,36,1744755967,1744756003,1744756003.546492,-18000,,
com.microsoft.VSCode,112,1744755855,1744755967,1744755967.9607902,-18000,,
com.google.Chrome,215,1744755640,1744755855,1744755856.029601,-18000,,
com.apple.Preview,5,1744755635,1744755640,1744755640.6730971,-18000,,
com.google.Chrome,44,1744755591,1744755635,1744755635.777056,-18000,,
com.apple.Preview,48,1744755543,1744755591,1744755591.737633,-18000,,
com.google.Chrome,7,1744755536,1744755543,1744755543.7738729,-18000,,
com.apple.Preview,30,1744755506,1744755536,1744755536.3128982,-18000,,
com.google.Chrome,1,1744755505,1744755506,1744755506.6017442,-18000,,
com.apple.Preview,1,1744755504,1744755505,1744755505.4586868,-18000,,
com.google.Chrome,2,1744755502,1744755504,1744755504.9229631,-18000,,
com.apple.Preview,35,1744755467,1744755502,1744755502.9928942,-18000,,
com.google.Chrome,9,1744755458,1744755467,1744755467.058217,-18000,,
com.apple.Preview,19,1744755439,1744755458,1744755458.190116,-18000,,
com.google.Chrome,1,1744755438,1744755439,1744755439.836411,-18000,,
com.apple.Preview,28,1744755410,1744755438,1744755438.167377,-18000,,
com.apple.finder,5,1744755405,1744755410,1744755410.8447928,-18000,,
com.apple.Preview,18,1744755387,1744755405,1744755405.2002559,-18000,,
com.google.Chrome,3,1744755384,1744755387,1744755387.850023,-18000,,
com.apple.Preview,42,1744755342,1744755384,1744755384.344161,-18000,,
com.apple.finder,5,1744755337,1744755342,1744755342.621783,-18000,,
com.google.Chrome,9,1744755328,1744755337,1744755337.152714,-18000,,
com.apple.Preview,110,1744755218,1744755328,1744755328.182115,-18000,,
com.google.Chrome,10,1744755208,1744755218,1744755218.080797,-18000,,
com.apple.Preview,9,1744755199,1744755208,1744755208.832121,-18000,,
com.google.Chrome,39,1744755160,1744755199,1744755199.0627708,-18000,,
com.leomehlig.today,91,1744755069,1744755160,1744755160.736701,-18000,,
com.google.Chrome,13,1744755056,1744755069,1744755069.308923,-18000,,
com.microsoft.VSCode,34,1744755022,1744755056,1744755056.782583,-18000,,
com.google.Chrome,83,1744754939,1744755022,1744755022.7064319,-18000,,
com.microsoft.VSCode,104,1744754835,1744754939,1744754939.924903,-18000,,
com.google.Chrome,125,1744754710,1744754835,1744754835.279957,-18000,,
com.apple.Preview,19,1744754691,1744754710,1744754710.524652,-18000,,
com.google.Chrome,31,1744754660,1744754691,1744754691.9333348,-18000,,
com.apple.Preview,37,1744754623,1744754660,1744754660.756432,-18000,,
com.google.Chrome,127,1744754496,1744754623,1744754623.503406,-18000,,
com.microsoft.VSCode,127,1744754369,1744754496,1744754497.010797,-18000,,
com.google.Chrome,10,1744754359,1744754369,1744754369.4115062,-18000,,
com.microsoft.VSCode,20,1744754339,1744754359,1744754359.694779,-18000,,
com.google.Chrome,11,1744754328,1744754339,1744754339.496537,-18000,,
com.microsoft.VSCode,2,1744754326,1744754328,1744754328.394922,-18000,,
com.google.Chrome,4,1744754322,1744754326,1744754326.0700688,-18000,,
com.microsoft.VSCode,9,1744754313,1744754322,1744754322.532785,-18000,,
com.google.Chrome,5,1744754308,1744754313,1744754313.134402,-18000,,
com.microsoft.VSCode,7,1744754301,1744754308,1744754308.225111,-18000,,
com.google.Chrome,8,1744754293,1744754301,1744754301.445352,-18000,,
com.microsoft.VSCode,11,1744754282,1744754293,1744754293.758111,-18000,,
com.google.Chrome,133,1744754149,1744754282,1744754283.056344,-18000,,
com.apple.Preview,28,1744754121,1744754149,1744754149.04198,-18000,,
com.google.Chrome,8,1744754113,1744754121,1744754121.033595,-18000,,
com.apple.Preview,208,1744753905,1744754113,1744754113.2680058,-18000,,
com.google.Chrome,2,1744753903,1744753905,1744753905.8427339,-18000,,
com.apple.Preview,147,1744753756,1744753903,1744753903.317202,-18000,,
com.google.Chrome,33,1744753723,1744753756,1744753756.219001,-18000,,
com.microsoft.VSCode,65,1744753658,1744753723,1744753723.138896,-18000,,
com.google.Chrome,63,1744753595,1744753658,1744753658.785114,-18000,,
com.apple.Preview,7,1744753588,1744753595,1744753595.2992492,-18000,,
com.google.Chrome,12,1744753576,1744753588,1744753588.6994228,-18000,,
com.apple.Preview,105,1744753471,1744753576,1744753576.779235,-18000,,
com.apple.finder,9,1744753462,1744753471,1744753471.8502269,-18000,,
com.apple.Preferences,122,1744753252,1744753374,1744753374.231991,-18000,EB445137-D7F5-57EC-87DA-1DB460D64046,"iPhone13,2"
com.tinyspeck.chatlyio,5,1744753247,1744753252,1744753252.183401,-18000,EB445137-D7F5-57EC-87DA-1DB460D64046,"iPhone13,2"
com.google.Chrome,318,1744753144,1744753462,1744753462.210161,-18000,,
com.leomehlig.today,21,1744753123,1744753144,1744753144.57658,-18000,,
com.apple.iCal,6,1744753117,1744753123,1744753123.432378,-18000,,
com.leomehlig.today,3,1744753114,1744753117,1744753117.9869962,-18000,,
com.google.Chrome,5,1744753109,1744753114,1744753114.2954922,-18000,,
com.apple.Preferences,6,1744752275,1744752281,1744752281.712949,-18000,EB445137-D7F5-57EC-87DA-1DB460D64046,"iPhone13,2"
com.intsig.CamScannerLite,2,1744752216,1744752218,1744752218.399805,-18000,EB445137-D7F5-57EC-87DA-1DB460D64046,"iPhone13,2"
com.google.Chrome,25,1744752049,1744752074,1744752074.77543,-18000,,
com.intsig.CamScannerLite,182,1744751837,1744752019,1744752020.110647,-18000,EB445137-D7F5-57EC-87DA-1DB460D64046,"iPhone13,2"
com.intsig.CamScannerLite,24,1744751799,1744751823,1744751824.001379,-18000,EB445137-D7F5-57EC-87DA-1DB460D64046,"iPhone13,2"
com.instructure.icanvas,1,1744751771,1744751772,1744751773.0879579,-18000,EB445137-D7F5-57EC-87DA-1DB460D64046,"iPhone13,2"
com.google.Chrome,925,1744747301,1744748226,1744748226.794837,-18000,,
com.apple.finder,39,1744747262,1744747301,1744747302.060087,-18000,,
com.google.Chrome,126,1744747136,1744747262,1744747262.30399,-18000,,
com.google.Chrome,425,1744746710,1744747135,1744747135.063704,-18000,,
com.apple.finder,46,1744746664,1744746710,1744746710.9076161,-18000,,
com.google.Chrome,250,1744746414,1744746664,1744746664.44646,-18000,,
com.apple.ScreenshotServicesService,4,1744745771,1744745775,1744745775.29966,-18000,EB445137-D7F5-57EC-87DA-1DB460D64046,"iPhone13,2"
com.instructure.icanvas,67,1744745709,1744745776,1744745777.1937962,-18000,EB445137-D7F5-57EC-87DA-1DB460D64046,"iPhone13,2"
com.apple.news,210,1744745497,1744745707,1744745707.9375691,-18000,EB445137-D7F5-57EC-87DA-1DB460D64046,"iPhone13,2"
com.microsoft.Office.Outlook,27,1744745467,1744745494,1744745494.814907,-18000,EB445137-D7F5-57EC-87DA-1DB460D64046,"iPhone13,2"
com.instructure.icanvas,12,1744743372,1744743384,1744743384.933207,-18000,EB445137-D7F5-57EC-87DA-1DB460D64046,"iPhone13,2"
com.toyopagroup.picaboo,52,1744743317,1744743369,1744743369.383537,-18000,EB445137-D7F5-57EC-87DA-1DB460D64046,"iPhone13,2"
com.google.Chrome,59,1744742342,1744742401,1744742401.3978472,-18000,,
com.apple.finder,3,1744742339,1744742342,1744742342.4979038,-18000,,
com.microsoft.Outlook,565,1744741774,1744742339,1744742340.125205,-18000,,
com.apple.finder,22,1744741752,1744741774,1744741774.45478,-18000,,
com.leomehlig.today,16,1744741736,1744741752,1744741752.222906,-18000,,
com.apple.Preview,42,1744741694,1744741736,1744741736.866243,-18000,,
com.apple.finder,0,1744741694,1744741694,1744741694.68976,-18000,,
com.apple.Preview,73,1744741621,1744741694,1744741694.3949199,-18000,,
com.apple.finder,0,1744741621,1744741621,1744741621.540741,-18000,,
com.apple.Preview,193,1744741428,1744741621,1744741621.242032,-18000,,
com.apple.finder,2,1744741426,1744741428,1744741428.096908,-18000,,
com.apple.Preview,432,1744740994,1744741426,1744741426.411639,-18000,,
com.microsoft.Outlook,5,1744740989,1744740994,1744740994.341833,-18000,,
com.apple.Preview,22,1744740967,1744740989,1744740989.968375,-18000,,
com.apple.finder,6,1744740961,1744740967,1744740967.817174,-18000,,
com.microsoft.Outlook,55,1744740906,1744740961,1744740961.088942,-18000,,
com.apple.finder,1,1744740905,1744740906,1744740906.800815,-18000,,
com.microsoft.VSCode,4,1744740901,1744740905,1744740906.032342,-18000,,
com.google.Chrome,4,1744740897,1744740901,1744740901.9489388,-18000,,
com.apple.finder,5,1744740892,1744740897,1744740897.0647302,-18000,,
com.leomehlig.today,46,1744740846,1744740892,1744740892.752236,-18000,,
com.toyopagroup.picaboo,10,1744740656,1744740666,1744740666.805314,-18000,EB445137-D7F5-57EC-87DA-1DB460D64046,"iPhone13,2"
com.apple.MobileSMS,3,1744740648,1744740651,1744740651.584424,-18000,EB445137-D7F5-57EC-87DA-1DB460D64046,"iPhone13,2"
com.apple.CoreAuthUI,1,1744736106,1744736107,1744736108.288316,-18000,EB445137-D7F5-57EC-87DA-1DB460D64046,"iPhone13,2"
com.truebill.truebillnative,79,1744736102,1744736181,1744736182.032408,-18000,EB445137-D7F5-57EC-87DA-1DB460D64046,"iPhone13,2"
com.apple.CoreAuthUI,2,1744736059,1744736061,1744736061.221623,-18000,EB445137-D7F5-57EC-87DA-1DB460D64046,"iPhone13,2"
com.robinhood.release.Robinhood,38,1744736056,1744736094,1744736094.78561,-18000,EB445137-D7F5-57EC-87DA-1DB460D64046,"iPhone13,2"
com.apple.MobileSMS,4,1744736007,1744736011,1744736011.118692,-18000,EB445137-D7F5-57EC-87DA-1DB460D64046,"iPhone13,2"
com.google.chrome.ios,12,1744735995,1744736007,1744736007.949271,-18000,EB445137-D7F5-57EC-87DA-1DB460D64046,"iPhone13,2"
com.apple.MobileSMS,15,1744735979,1744735994,1744735995.165421,-18000,EB445137-D7F5-57EC-87DA-1DB460D64046,"iPhone13,2"
com.apple.news,134,1744735786,1744735920,1744735920.559118,-18000,EB445137-D7F5-57EC-87DA-1DB460D64046,"iPhone13,2"
com.microsoft.Office.Outlook,3,1744735783,1744735786,1744735787.790657,-18000,EB445137-D7F5-57EC-87DA-1DB460D64046,"iPhone13,2"
com.microsoft.Office.Outlook,30,1744735547,1744735577,1744735578.44875,-18000,EB445137-D7F5-57EC-87DA-1DB460D64046,"iPhone13,2"
com.apple.MobileSMS,2,1744735545,1744735547,1744735547.2703,-18000,EB445137-D7F5-57EC-87DA-1DB460D64046,"iPhone13,2"
com.apple.MobileSMS,95,1744735401,1744735496,1744735496.757392,-18000,EB445137-D7F5-57EC-87DA-1DB460D64046,"iPhone13,2"
com.apple.news,0,1744735401,1744735401,1744735402.736227,-18000,EB445137-D7F5-57EC-87DA-1DB460D64046,"iPhone13,2"
com.apple.news,74,1744735327,1744735401,1744735401.243218,-18000,EB445137-D7F5-57EC-87DA-1DB460D64046,"iPhone13,2"
com.apple.MobileSMS,16,1744735311,1744735327,1744735327.462296,-18000,EB445137-D7F5-57EC-87DA-1DB460D64046,"iPhone13,2"
com.apple.news,265,1744735043,1744735308,1744735308.271816,-18000,EB445137-D7F5-57EC-87DA-1DB460D64046,"iPhone13,2"
com.leomehlig.today,66,1744734250,1744734316,1744734316.2540522,-18000,,
com.google.Chrome,69,1744734181,1744734250,1744734250.809634,-18000,,
com.apple.Preview,24,1744734157,1744734181,1744734181.7553701,-18000,,
com.google.Chrome,35,1744734122,1744734157,1744734157.394816,-18000,,
com.microsoft.VSCode,43,1744734079,1744734122,1744734122.964828,-18000,,
com.google.Chrome,110,1744733969,1744734079,1744734079.449516,-18000,,
com.microsoft.VSCode,65,1744733904,1744733969,1744733969.671737,-18000,,
com.google.Chrome,361,1744733543,1744733904,1744733904.660056,-18000,,
com.microsoft.VSCode,15,1744733528,1744733543,1744733543.2823591,-18000,,
com.google.Chrome,15,1744733513,1744733528,1744733528.957316,-18000,,
com.microsoft.VSCode,192,1744733321,1744733513,1744733513.702345,-18000,,
com.google.Chrome,412,1744732909,1744733321,1744733321.773977,-18000,,
com.apple.Preview,67,1744732842,1744732909,1744732909.163368,-18000,,
com.google.Chrome,44,1744732798,1744732842,1744732842.190264,-18000,,
com.apple.Preview,845,1744731953,1744732798,1744732798.62447,-18000,,
com.apple.finder,4,1744731949,1744731953,1744731953.58466,-18000,,
com.apple.Preview,4,1744731945,1744731949,1744731949.399695,-18000,,
com.apple.finder,7,1744731938,1744731945,1744731945.5449681,-18000,,
com.google.Chrome,135,1744731803,1744731938,1744731938.276171,-18000,,
com.leomehlig.today,125,1744731678,1744731803,1744731803.9549499,-18000,,
com.google.Chrome,43,1744731635,1744731678,1744731678.6790051,-18000,,
com.microsoft.Outlook,82,1744731267,1744731349,1744731349.61406,-18000,,
com.google.Chrome,39,1744731228,1744731267,1744731267.076137,-18000,,
com.microsoft.Outlook,128,1744731100,1744731228,1744731228.2144809,-18000,,
com.leomehlig.today,27,1744731073,1744731100,1744731100.340127,-18000,,
com.google.Chrome,390,1744730683,1744731073,1744731073.533354,-18000,,
com.apple.Preferences,48,1744729740,1744729788,1744729788.19529,-18000,EB445137-D7F5-57EC-87DA-1DB460D64046,"iPhone13,2"
com.apple.Preferences,23,1744729714,1744729737,1744729737.80445,-18000,EB445137-D7F5-57EC-87DA-1DB460D64046,"iPhone13,2"
com.apple.weather,2,1744729712,1744729714,1744729715.51339,-18000,EB445137-D7F5-57EC-87DA-1DB460D64046,"iPhone13,2"
com.google.Chrome,313,1744729581,1744729894,1744729894.537106,-18000,,
com.microsoft.Outlook,75,1744729506,1744729581,1744729581.66019,-18000,,
com.google.Chrome,117,1744729389,1744729506,1744729506.497309,-18000,,
com.microsoft.Outlook,7,1744729382,1744729389,1744729389.45593,-18000,,
com.google.Chrome,47,1744729335,1744729382,1744729382.274179,-18000,,
com.microsoft.Outlook,210,1744729125,1744729335,1744729335.908876,-18000,,
com.google.Chrome,21,1744729104,1744729125,1744729126.03317,-18000,,
com.microsoft.Outlook,10,1744729094,1744729104,1744729104.538012,-18000,,
com.leomehlig.today,51,1744729043,1744729094,1744729094.19496,-18000,,
com.google.Chrome,161,1744728882,1744729043,1744729043.276497,-18000,,
com.apple.Preview,587,1744728295,1744728882,1744728882.9013581,-18000,,
com.google.Chrome,3,1744728292,1744728295,1744728295.6865258,-18000,,
com.apple.Preview,697,1744727595,1744728292,1744728292.64987,-18000,,
com.apple.finder,6,1744727589,1744727595,1744727595.184993,-18000,,
com.google.Chrome,105,1744727484,1744727589,1744727589.1153212,-18000,,
com.leomehlig.today,2,1744727482,1744727484,1744727484.202289,-18000,,
com.leomehlig.today,13,1744726600,1744726613,1744726613.281498,-18000,,
com.google.Chrome,252,1744726348,1744726600,1744726600.411453,-18000,,
com.leomehlig.today,2,1744726346,1744726348,1744726349.045598,-18000,,
com.leomehlig.today,107,1744726130,1744726237,1744726237.5626469,-18000,,
com.google.Chrome,582,1744725548,1744726130,1744726130.636922,-18000,,
com.google.Chrome,844,1744724672,1744725516,1744725516.022126,-18000,,
com.google.Chrome,798,1744723722,1744724520,1744724520.337885,-18000,,
com.apple.finder,9,1744723674,1744723683,1744723686.436181,-18000,,
com.apple.weather,10,1744723071,1744723081,1744723082.1671019,-18000,EB445137-D7F5-57EC-87DA-1DB460D64046,"iPhone13,2"
com.renpho.health,73,1744722565,1744722638,1744722638.161778,-18000,EB445137-D7F5-57EC-87DA-1DB460D64046,"iPhone13,2"
com.apple.journal,344,1744689348,1744689692,1744689692.498996,-18000,EB445137-D7F5-57EC-87DA-1DB460D64046,"iPhone13,2"
com.apple.CoreAuthUI,3,1744689348,1744689351,1744689351.131891,-18000,EB445137-D7F5-57EC-87DA-1DB460D64046,"iPhone13,2"
com.apple.Health,19,1744689326,1744689345,1744689345.40703,-18000,EB445137-D7F5-57EC-87DA-1DB460D64046,"iPhone13,2"
com.instructure.icanvas,47,1744689272,1744689319,1744689319.1997352,-18000,EB445137-D7F5-57EC-87DA-1DB460D64046,"iPhone13,2"
com.apple.CoreAuthUI,14,1744688505,1744688519,1744688519.2420921,-18000,EB445137-D7F5-57EC-87DA-1DB460D64046,"iPhone13,2"
com.apple.journal,756,1744688504,1744689260,1744689260.2400088,-18000,EB445137-D7F5-57EC-87DA-1DB460D64046,"iPhone13,2"
com.apple.finder,2,1744688237,1744688239,1744688240.014141,-18000,,
com.apple.iCal,20,1744688217,1744688237,1744688237.73323,-18000,,
com.apple.finder,2,1744688215,1744688217,1744688217.571251,-18000,,
com.leomehlig.today,110,1744688105,1744688215,1744688215.356363,-18000,,
com.google.Chrome,567,1744687538,1744688105,1744688106.01963,-18000,,
com.google.Chrome,777,1744686542,1744687319,1744687319.958133,-18000,,
com.google.Chrome,4,1744686023,1744686027,1744686027.440546,-18000,,
com.google.Chrome,300,1744684850,1744685150,1744685150.764735,-18000,,
com.apple.finder,7,1744684648,1744684655,1744684657.230674,-18000,,
com.instructure.icanvas,4,1744682706,1744682710,1744682710.580727,-18000,EB445137-D7F5-57EC-87DA-1DB460D64046,"iPhone13,2"
com.instructure.icanvas,22,1744681641,1744681663,1744681663.617673,-18000,EB445137-D7F5-57EC-87DA-1DB460D64046,"iPhone13,2"
com.apple.news,874,1744678312,1744679186,1744679186.942513,-18000,EB445137-D7F5-57EC-87DA-1DB460D64046,"iPhone13,2"
com.apple.Preferences,15,1744678294,1744678309,1744678309.27255,-18000,EB445137-D7F5-57EC-87DA-1DB460D64046,"iPhone13,2"
com.microsoft.Office.Outlook,6,1744677227,1744677233,1744677233.1756759,-18000,EB445137-D7F5-57EC-87DA-1DB460D64046,"iPhone13,2"
com.instructure.icanvas,4,1744677194,1744677198,1744677198.067614,-18000,EB445137-D7F5-57EC-87DA-1DB460D64046,"iPhone13,2"
com.microsoft.Office.Outlook,10,1744673507,1744673517,1744673518.0432281,-18000,EB445137-D7F5-57EC-87DA-1DB460D64046,"iPhone13,2"
com.tinyspeck.chatlyio,14,1744673492,1744673506,1744673507.0184212,-18000,EB445137-D7F5-57EC-87DA-1DB460D64046,"iPhone13,2"
co.hinge.mobile.ios,15,1744672926,1744672941,1744672941.671551,-18000,EB445137-D7F5-57EC-87DA-1DB460D64046,"iPhone13,2"
com.toyopagroup.picaboo,3,1744671928,1744671931,1744671931.891848,-18000,EB445137-D7F5-57EC-87DA-1DB460D64046,"iPhone13,2"
com.microsoft.Office.Outlook,0,1744671928,1744671928,1744671929.446136,-18000,EB445137-D7F5-57EC-87DA-1DB460D64046,"iPhone13,2"
com.apple.finder,3,1744671775,1744671778,1744671778.9362159,-18000,,
com.leomehlig.today,1,1744671774,1744671775,1744671775.207649,-18000,,
com.apple.finder,2,1744671772,1744671774,1744671774.289925,-18000,,
com.leomehlig.today,78,1744671694,1744671772,1744671772.6107621,-18000,,
com.google.Chrome,1628,1744670066,1744671694,1744671694.096469,-18000,,
com.leomehlig.today,38,1744670012,1744670050,1744670050.655851,-18000,,
com.google.Chrome,246,1744669766,1744670012,1744670012.9154181,-18000,,
com.google.Chrome,703,1744669043,1744669746,1744669746.381283,-18000,,
com.leomehlig.today,11,1744669032,1744669043,1744669043.1040812,-18000,,
com.google.Chrome,1583,1744667449,1744669032,1744669032.3914099,-18000,,
com.leomehlig.today,63,1744667386,1744667449,1744667449.444339,-18000,,
com.google.Chrome,2134,1744665252,1744667386,1744667386.337817,-18000,,
com.microsoft.Office.Outlook,5,1744665194,1744665199,1744665200.213605,-18000,EB445137-D7F5-57EC-87DA-1DB460D64046,"iPhone13,2"
com.leomehlig.today,96,1744665156,1744665252,1744665252.3380198,-18000,,
com.apple.Preview,173,1744664983,1744665156,1744665156.856137,-18000,,
com.apple.news,64,1744664919,1744664983,1744664983.721564,-18000,,
com.apple.Preview,164,1744664755,1744664919,1744664919.0678349,-18000,,
com.microsoft.Office.Outlook,13,1744664431,1744664444,1744664444.917742,-18000,EB445137-D7F5-57EC-87DA-1DB460D64046,"iPhone13,2"
com.instructure.icanvas,0,1744664431,1744664431,1744664432.3187242,-18000,EB445137-D7F5-57EC-87DA-1DB460D64046,"iPhone13,2"
com.instructure.icanvas,5,1744664426,1744664431,1744664431.184169,-18000,EB445137-D7F5-57EC-87DA-1DB460D64046,"iPhone13,2"
com.instructure.icanvas,19,1744664403,1744664422,1744664422.903044,-18000,EB445137-D7F5-57EC-87DA-1DB460D64046,"iPhone13,2"
com.toyopagroup.picaboo,20,1744664374,1744664394,1744664394.893642,-18000,EB445137-D7F5-57EC-87DA-1DB460D64046,"iPhone13,2"
com.apple.Preview,538,1744664209,1744664747,1744664747.050644,-18000,,
com.apple.Preview,1135,1744663072,1744664207,1744664207.770235,-18000,,
com.google.Chrome,19,1744663053,1744663072,1744663072.829382,-18000,,
com.apple.Preview,112,1744662941,1744663053,1744663053.7250009,-18000,,
com.apple.finder,15,1744662926,1744662941,1744662941.6452541,-18000,,
com.apple.Preview,16,1744662910,1744662926,1744662926.914527,-18000,,
com.google.Chrome,1,1744662909,1744662910,1744662910.60071,-18000,,
com.apple.Preview,7,1744662902,1744662909,1744662909.374086,-18000,,
com.google.Chrome,1,1744662901,1744662902,1744662902.7686129,-18000,,
com.apple.Preview,7,1744662894,1744662901,1744662901.74229,-18000,,
com.google.Chrome,4,1744662890,1744662894,1744662894.5943599,-18000,,
com.apple.Preview,15,1744662875,1744662890,1744662891.0142732,-18000,,
com.google.Chrome,79,1744662796,1744662875,1744662875.6815891,-18000,,
com.apple.Preview,29,1744662767,1744662796,1744662796.398701,-18000,,
com.apple.Preview,473,1744662282,1744662755,1744662755.1813998,-18000,,
com.google.Chrome,8,1744662274,1744662282,1744662282.985591,-18000,,
com.apple.Preview,193,1744662081,1744662274,1744662274.424963,-18000,,
com.apple.finder,2,1744662079,1744662081,1744662081.708692,-18000,,
com.apple.Preview,5,1744662074,1744662079,1744662079.996316,-18000,,
com.apple.finder,6,1744662068,1744662074,1744662074.309442,-18000,,
com.apple.Preview,198,1744661870,1744662068,1744662068.7454948,-18000,,
com.leomehlig.today,39,1744661831,1744661870,1744661870.417934,-18000,,
com.apple.Preview,51,1744661780,1744661831,1744661831.763352,-18000,,
com.apple.finder,42,1744661738,1744661780,1744661780.257546,-18000,,
com.google.Chrome,54,1744661684,1744661738,1744661738.758544,-18000,,
com.apple.finder,11,1744661673,1744661684,1744661684.599427,-18000,,
com.google.Gmail,26,1744660735,1744660761,1744660761.272702,-18000,EB445137-D7F5-57EC-87DA-1DB460D64046,"iPhone13,2"
com.apple.news,1,1744660734,1744660735,1744660735.8811688,-18000,EB445137-D7F5-57EC-87DA-1DB460D64046,"iPhone13,2"
com.apple.news,143,1744656866,1744657009,1744657010.505578,-18000,EB445137-D7F5-57EC-87DA-1DB460D64046,"iPhone13,2"
com.microsoft.Office.Outlook,75,1744656783,1744656858,1744656858.9809961,-18000,EB445137-D7F5-57EC-87DA-1DB460D64046,"iPhone13,2"
com.hammerandchisel.discord,58,1744656712,1744656770,1744656770.797765,-18000,EB445137-D7F5-57EC-87DA-1DB460D64046,"iPhone13,2"
com.microsoft.Office.Outlook,0,1744656712,1744656712,1744656714.043624,-18000,EB445137-D7F5-57EC-87DA-1DB460D64046,"iPhone13,2"
com.microsoft.Office.Outlook,10,1744656676,1744656686,1744656686.328333,-18000,EB445137-D7F5-57EC-87DA-1DB460D64046,"iPhone13,2"
com.apple.Health,0,1744656676,1744656676,1744656677.7157001,-18000,EB445137-D7F5-57EC-87DA-1DB460D64046,"iPhone13,2"
com.apple.Health,8,1744655371,1744655379,1744655380.362212,-18000,EB445137-D7F5-57EC-87DA-1DB460D64046,"iPhone13,2"
com.apple.news,556,1744651510,1744652066,1744652067.080665,-18000,EB445137-D7F5-57EC-87DA-1DB460D64046,"iPhone13,2"
com.microsoft.Office.Outlook,39,1744651463,1744651502,1744651502.198504,-18000,EB445137-D7F5-57EC-87DA-1DB460D64046,"iPhone13,2"
com.apple.news,129,1744649235,1744649364,1744649365.065672,-18000,EB445137-D7F5-57EC-87DA-1DB460D64046,"iPhone13,2"
com.instructure.icanvas,8,1744649219,1744649227,1744649227.715636,-18000,EB445137-D7F5-57EC-87DA-1DB460D64046,"iPhone13,2"
com.google.chrome.ios,0,1744649219,1744649219,1744649220.5838242,-18000,EB445137-D7F5-57EC-87DA-1DB460D64046,"iPhone13,2"
com.google.chrome.ios,36,1744647996,1744648032,1744648033.704588,-18000,EB445137-D7F5-57EC-87DA-1DB460D64046,"iPhone13,2"
com.google.chrome.ios,29,1744647215,1744647244,1744647245.47105,-18000,EB445137-D7F5-57EC-87DA-1DB460D64046,"iPhone13,2"
com.leomehlig.today,57,1744646816,1744646873,1744646873.8598309,-18000,EB445137-D7F5-57EC-87DA-1DB460D64046,"iPhone13,2"
com.tinyspeck.chatlyio,14,1744646462,1744646476,1744646476.689086,-18000,EB445137-D7F5-57EC-87DA-1DB460D64046,"iPhone13,2"
com.microsoft.Office.Outlook,8,1744646453,1744646461,1744646461.505532,-18000,EB445137-D7F5-57EC-87DA-1DB460D64046,"iPhone13,2"
com.apple.PosterBoard,1,1744646448,1744646449,1744646449.100452,-18000,EB445137-D7F5-57EC-87DA-1DB460D64046,"iPhone13,2"
com.instructure.icanvas,32,1744646416,1744646448,1744646448.87992,-18000,EB445137-D7F5-57EC-87DA-1DB460D64046,"iPhone13,2"
com.facebook.Facebook,85,1744646325,1744646410,1744646410.286022,-18000,EB445137-D7F5-57EC-87DA-1DB460D64046,"iPhone13,2"
com.tinyspeck.chatlyio,3,1744646319,1744646322,1744646322.250257,-18000,EB445137-D7F5-57EC-87DA-1DB460D64046,"iPhone13,2"
com.apple.finder,4,1744646020,1744646024,1744646024.407855,-18000,,
com.leomehlig.today,2,1744646018,1744646020,1744646020.586039,-18000,,
com.microsoft.VSCode,79,1744645939,1744646018,1744646018.722291,-18000,,
com.leomehlig.today,24,1744645915,1744645939,1744645940.024739,-18000,,
com.microsoft.VSCode,45,1744645870,1744645915,1744645915.135168,-18000,,
com.apple.finder,11,1744645859,1744645870,1744645870.8955579,-18000,,
com.microsoft.VSCode,109,1744645750,1744645859,1744645859.926758,-18000,,
com.apple.finder,3,1744645747,1744645750,1744645750.1395679,-18000,,
com.apple.shortcuts,1,1744645746,1744645747,1744645747.4418569,-18000,,
com.apple.finder,15,1744645731,1744645746,1744645746.91052,-18000,,
com.apple.shortcuts,3,1744645703,1744645706,1744645706.6708422,-18000,,
com.google.Chrome,7,1744645685,1744645692,1744645692.1983728,-18000,,
com.apple.shortcuts,3,1744645682,1744645685,1744645685.803864,-18000,,
com.google.Chrome,33,1744645649,1744645682,1744645682.62344,-18000,,
com.apple.shortcuts,18,1744645631,1744645649,1744645649.147811,-18000,,
com.apple.finder,3,1744645628,1744645631,1744645631.670974,-18000,,
com.leomehlig.today,1,1744645627,1744645628,1744645628.407376,-18000,,
com.google.Chrome,40,1744645587,1744645627,1744645627.7583861,-18000,,
com.leomehlig.today,28,1744645534,1744645562,1744645562.8606648,-18000,,
com.google.Chrome,13,1744645521,1744645534,1744645534.043244,-18000,,
com.google.Chrome,38,1744645366,1744645404,1744645404.84955,-18000,,
com.google.Chrome,49,1744642627,1744642676,1744642676.5451741,-18000,,
com.tinyspeck.chatlyio,14,1744642133,1744642147,1744642147.785218,-18000,EB445137-D7F5-57EC-87DA-1DB460D64046,"iPhone13,2"
com.tinyspeck.chatlyio,67,1744641861,1744641928,1744641928.5172482,-18000,EB445137-D7F5-57EC-87DA-1DB460D64046,"iPhone13,2"
com.tinyspeck.chatlyio,48,1744641598,1744641646,1744641647.109705,-18000,EB445137-D7F5-57EC-87DA-1DB460D64046,"iPhone13,2"
net.kortina.labs.Venmo,24,1744641573,1744641597,1744641597.563729,-18000,EB445137-D7F5-57EC-87DA-1DB460D64046,"iPhone13,2"
com.google.Chrome,44,1744641332,1744641376,1744641376.3656979,-18000,,
com.apple.finder,24,1744641308,1744641332,1744641332.21082,-18000,,
com.google.Chrome,59,1744641249,1744641308,1744641308.7822309,-18000,,
com.apple.finder,2,1744641247,1744641249,1744641249.8467112,-18000,,
com.google.Chrome,15,1744641232,1744641247,1744641247.2988439,-18000,,
com.apple.Preview,35,1744641197,1744641232,1744641232.50322,-18000,,
com.apple.finder,8,1744641189,1744641197,1744641197.8889241,-18000,,
com.apple.news,1,1744641188,1744641189,1744641189.430325,-18000,,
com.microsoft.Powerpoint,61,1744641127,1744641188,1744641188.701138,-18000,,
com.apple.news,2,1744641125,1744641127,1744641127.51071,-18000,,
com.apple.Preview,5,1744641120,1744641125,1744641125.934499,-18000,,
com.google.Chrome,3,1744641117,1744641120,1744641121.018149,-18000,,
com.apple.news,41,1744641076,1744641117,1744641117.5267391,-18000,,
com.google.Chrome,22,1744641054,1744641076,1744641076.550298,-18000,,
com.apple.Health,68,1744640974,1744641042,1744641042.568049,-18000,EB445137-D7F5-57EC-87DA-1DB460D64046,"iPhone13,2"
com.instructure.icanvas,1,1744640973,1744640974,1744640974.44437,-18000,EB445137-D7F5-57EC-87DA-1DB460D64046,"iPhone13,2"
com.instructure.icanvas,23,1744640949,1744640972,1744640972.399853,-18000,EB445137-D7F5-57EC-87DA-1DB460D64046,"iPhone13,2"
com.microsoft.Office.Outlook,15,1744640923,1744640938,1744640938.754812,-18000,EB445137-D7F5-57EC-87DA-1DB460D64046,"iPhone13,2"
com.google.chrome.ios,27,1744640896,1744640923,1744640923.57444,-18000,EB445137-D7F5-57EC-87DA-1DB460D64046,"iPhone13,2"
com.microsoft.Office.Outlook,1,1744640895,1744640896,1744640896.680403,-18000,EB445137-D7F5-57EC-87DA-1DB460D64046,"iPhone13,2"
com.apple.mobilecal,7,1744640888,1744640895,1744640895.5257921,-18000,EB445137-D7F5-57EC-87DA-1DB460D64046,"iPhone13,2"
com.microsoft.Office.Outlook,11,1744640865,1744640876,1744640876.197006,-18000,EB445137-D7F5-57EC-87DA-1DB460D64046,"iPhone13,2"
com.hammerandchisel.discord,77,1744640779,1744640856,1744640856.462024,-18000,EB445137-D7F5-57EC-87DA-1DB460D64046,"iPhone13,2"
com.google.Gmail,75,1744640700,1744640775,1744640775.726153,-18000,EB445137-D7F5-57EC-87DA-1DB460D64046,"iPhone13,2"
com.apple.weather,0,1744640700,1744640700,1744640700.969598,-18000,EB445137-D7F5-57EC-87DA-1DB460D64046,"iPhone13,2"
com.google.Chrome,1207,1744639230,1744640437,1744640437.2843308,-18000,,
com.google.Chrome,329,1744638900,1744639229,1744639229.7216249,-18000,,
com.apple.Preview,0,1744638900,1744638900,1744638900.870863,-18000,,
com.google.Chrome,9,1744638891,1744638900,1744638900.074388,-18000,,
com.apple.Preview,1,1744638890,1744638891,1744638891.5154161,-18000,,
com.google.Chrome,4,1744638886,1744638890,1744638890.177496,-18000,,
com.apple.Preview,1,1744638885,1744638886,1744638886.9741712,-18000,,
com.google.Chrome,79,1744638806,1744638885,1744638885.900986,-18000,,
com.apple.Preview,4,1744638802,1744638806,1744638806.1690722,-18000,,
com.google.Chrome,32,1744638770,1744638802,1744638802.982712,-18000,,
com.apple.Preview,1,1744638769,1744638770,1744638770.564169,-18000,,
com.google.Chrome,12,1744638757,1744638769,1744638769.613915,-18000,,
com.apple.Preview,3,1744638754,1744638757,1744638758.017118,-18000,,
com.google.Chrome,42,1744638712,1744638754,1744638754.722861,-18000,,
com.apple.Preview,5,1744638707,1744638712,1744638712.931522,-18000,,
com.google.Chrome,248,1744638459,1744638707,1744638707.1379151,-18000,,
com.apple.Preview,76,1744638383,1744638459,1744638459.479768,-18000,,
com.apple.Preview,397,1744637983,1744638380,1744638380.716943,-18000,,
com.apple.Preview,326,1744637653,1744637979,1744637979.509149,-18000,,
com.apple.finder,2,1744637651,1744637653,1744637653.3285298,-18000,,
com.apple.Preview,222,1744637429,1744637651,1744637651.5779219,-18000,,
com.apple.finder,20,1744637409,1744637429,1744637429.927874,-18000,,
com.google.Chrome,8,1744637401,1744637409,1744637409.7416759,-18000,,
com.apple.finder,5,1744637396,1744637401,1744637401.938706,-18000,,
com.google.Chrome,5,1744637391,1744637396,1744637396.904175,-18000,,
com.apple.iCal,1,1744637390,1744637391,1744637391.3281069,-18000,,
com.leomehlig.today,28,1744637362,1744637390,1744637390.2974849,-18000,,
com.apple.iCal,20,1744637342,1744637362,1744637362.8858008,-18000,,
com.leomehlig.today,5,1744637337,1744637342,1744637342.845374,-18000,,
com.google.Chrome,32,1744637305,1744637337,1744637337.311219,-18000,,
com.leomehlig.today,13,1744637272,1744637285,1744637286.669421,-18000,,
com.apple.weather,106,1744635998,1744636104,1744636104.756732,-18000,EB445137-D7F5-57EC-87DA-1DB460D64046,"iPhone13,2"
com.apple.Health,5,1744635970,1744635975,1744635975.647584,-18000,EB445137-D7F5-57EC-87DA-1DB460D64046,"iPhone13,2"
com.renpho.health,2,1744635965,1744635967,1744635967.301485,-18000,EB445137-D7F5-57EC-87DA-1DB460D64046,"iPhone13,2"
com.renpho.health,113,1744635171,1744635284,1744635284.333262,-18000,EB445137-D7F5-57EC-87DA-1DB460D64046,"iPhone13,2"
com.apple.mobiletimer,0,1744634119,1744634119,1744634120.080254,-18000,EB445137-D7F5-57EC-87DA-1DB460D64046,"iPhone13,2"
com.apple.mobiletimer,6,1744608052,1744608058,1744608058.4588451,-18000,EB445137-D7F5-57EC-87DA-1DB460D64046,"iPhone13,2"
com.apple.CoreAuthUI,2,1744605756,1744605758,1744605758.577713,-18000,EB445137-D7F5-57EC-87DA-1DB460D64046,"iPhone13,2"
com.apple.journal,1742,1744605755,1744607497,1744607497.573508,-18000,EB445137-D7F5-57EC-87DA-1DB460D64046,"iPhone13,2"
com.instructure.icanvas,13,1744605711,1744605724,1744605724.515264,-18000,EB445137-D7F5-57EC-87DA-1DB460D64046,"iPhone13,2"
com.leomehlig.today,2,1744605518,1744605520,1744605520.102387,-18000,,
com.google.Chrome,1007,1744604511,1744605518,1744605518.376748,-18000,,
com.google.Chrome,2987,1744601219,1744604206,1744604206.530696,-18000,,
com.apple.iCal,9,1744601210,1744601219,1744601219.935594,-18000,,
com.google.Chrome,157,1744601053,1744601210,1744601210.562289,-18000,,
com.apple.iCal,45,1744600989,1744601034,1744601034.491327,-18000,,
com.google.Chrome,1,1744600988,1744600989,1744600989.58273,-18000,,
com.apple.iCal,6,1744600982,1744600988,1744600988.603708,-18000,,
com.google.Chrome,6,1744600976,1744600982,1744600982.5585551,-18000,,
com.apple.iCal,9,1744600967,1744600976,1744600976.5494828,-18000,,
com.google.Chrome,13,1744600954,1744600967,1744600968.011341,-18000,,
com.apple.iCal,5,1744600949,1744600954,1744600955.030943,-18000,,
com.google.Chrome,7,1744600942,1744600949,1744600950.002841,-18000,,
com.apple.iCal,38,1744600904,1744600942,1744600943.9590669,-18000,,
com.microsoft.Outlook,4,1744600900,1744600904,1744600904.548264,-18000,,
com.leomehlig.today,25,1744600875,1744600900,1744600900.582038,-18000,,
com.microsoft.Outlook,2,1744600873,1744600875,1744600875.3035378,-18000,,
com.leomehlig.today,6,1744600867,1744600873,1744600873.751045,-18000,,
com.microsoft.Outlook,24,1744600843,1744600867,1744600867.686905,-18000,,
com.apple.iCal,9,1744600834,1744600843,1744600843.584969,-18000,,
com.leomehlig.today,92,1744600742,1744600834,1744600834.9569101,-18000,,
com.apple.iCal,54,1744600688,1744600742,1744600742.885248,-18000,,
com.leomehlig.today,81,1744600607,1744600688,1744600688.592743,-18000,,
com.apple.finder,30,1744600577,1744600607,1744600607.520547,-18000,,
com.leomehlig.today,68,1744600509,1744600577,1744600577.704725,-18000,,
com.apple.finder,3,1744600506,1744600509,1744600509.461936,-18000,,
com.apple.Notes,1,1744600505,1744600506,1744600506.998744,-18000,,
com.google.Chrome,128,1744600377,1744600505,1744600505.038703,-18000,,
com.google.Chrome,56,1744599718,1744599774,1744599775.106535,-18000,,
com.google.Chrome,559,1744596889,1744597448,1744597448.692123,-18000,,
com.google.Chrome,500,1744592960,1744593460,1744593460.2493181,-18000,,
com.apple.news,8,1744592848,1744592856,1744592856.982121,-18000,EB445137-D7F5-57EC-87DA-1DB460D64046,"iPhone13,2"
com.google.chrome.ios,159,1744591859,1744592018,1744592019.775278,-18000,EB445137-D7F5-57EC-87DA-1DB460D64046,"iPhone13,2"
com.apple.VoiceMemos,3,1744591843,1744591846,1744591846.889079,-18000,EB445137-D7F5-57EC-87DA-1DB460D64046,"iPhone13,2"
com.google.Chrome,104,1744590015,1744590119,1744590119.6459088,-18000,,
com.apple.finder,1,1744590007,1744590008,1744590008.074111,-18000,,
com.google.Chrome,4,1744590003,1744590007,1744590007.325014,-18000,,
com.apple.finder,1,1744590002,1744590003,1744590004.5437331,-18000,,
com.google.Chrome,1,1744590001,1744590002,1744590004.461436,-18000,,
com.apple.Notes,7,1744589994,1744590001,1744590002.5780668,-18000,,
com.apple.VoiceMemos,71,1744589987,1744590058,1744590058.971288,-18000,EB445137-D7F5-57EC-87DA-1DB460D64046,"iPhone13,2"
com.apple.MobileSMS,4,1744589983,1744589987,1744589987.8127708,-18000,EB445137-D7F5-57EC-87DA-1DB460D64046,"iPhone13,2"
com.apple.MobileSMS,16,1744588906,1744588922,1744588922.4192228,-18000,EB445137-D7F5-57EC-87DA-1DB460D64046,"iPhone13,2"
com.apple.MobileSMS,4,1744588870,1744588874,1744588874.510236,-18000,EB445137-D7F5-57EC-87DA-1DB460D64046,"iPhone13,2"
com.apple.calculator,7,1744588861,1744588868,1744588868.701963,-18000,EB445137-D7F5-57EC-87DA-1DB460D64046,"iPhone13,2"
com.microsoft.Office.Outlook,15,1744587062,1744587077,1744587077.629972,-18000,EB445137-D7F5-57EC-87DA-1DB460D64046,"iPhone13,2"
com.apple.MobileSMS,21,1744587036,1744587057,1744587057.95769,-18000,EB445137-D7F5-57EC-87DA-1DB460D64046,"iPhone13,2"
com.apple.Preferences,97,1744586937,1744587034,1744587034.3896499,-18000,EB445137-D7F5-57EC-87DA-1DB460D64046,"iPhone13,2"
com.apple.Preferences,9,1744586910,1744586919,1744586919.873599,-18000,EB445137-D7F5-57EC-87DA-1DB460D64046,"iPhone13,2"
com.apple.news,34,1744586665,1744586699,1744586699.665973,-18000,EB445137-D7F5-57EC-87DA-1DB460D64046,"iPhone13,2"
com.instructure.icanvas,75,1744586582,1744586657,1744586657.283787,-18000,EB445137-D7F5-57EC-87DA-1DB460D64046,"iPhone13,2"
com.apple.VoiceMemos,8,1744586574,1744586582,1744586582.496867,-18000,EB445137-D7F5-57EC-87DA-1DB460D64046,"iPhone13,2"
com.apple.VoiceMemos,4,1744586566,1744586570,1744586570.741916,-18000,EB445137-D7F5-57EC-87DA-1DB460D64046,"iPhone13,2"
com.apple.VoiceMemos,139,1744585496,1744585635,1744585636.235734,-18000,EB445137-D7F5-57EC-87DA-1DB460D64046,"iPhone13,2"
com.instructure.icanvas,3,1744585491,1744585494,1744585495.044585,-18000,EB445137-D7F5-57EC-87DA-1DB460D64046,"iPhone13,2"
com.apple.VoiceMemos,11,1744585473,1744585484,1744585484.624504,-18000,EB445137-D7F5-57EC-87DA-1DB460D64046,"iPhone13,2"
com.apple.mobilenotes,126,1744585347,1744585473,1744585473.516626,-18000,EB445137-D7F5-57EC-87DA-1DB460D64046,"iPhone13,2"
com.apple.VoiceMemos,39,1744585308,1744585347,1744585347.470827,-18000,EB445137-D7F5-57EC-87DA-1DB460D64046,"iPhone13,2"
com.apple.VoiceMemos,3,1744585278,1744585281,1744585281.576659,-18000,EB445137-D7F5-57EC-87DA-1DB460D64046,"iPhone13,2"
com.apple.mobilenotes,10,1744585268,1744585278,1744585279.188301,-18000,EB445137-D7F5-57EC-87DA-1DB460D64046,"iPhone13,2"
com.apple.VoiceMemos,5,1744585219,1744585224,1744585224.528544,-18000,EB445137-D7F5-57EC-87DA-1DB460D64046,"iPhone13,2"
com.apple.mobilenotes,5,1744585209,1744585214,1744585214.051643,-18000,EB445137-D7F5-57EC-87DA-1DB460D64046,"iPhone13,2"
com.apple.mobilenotes,6,1744580707,1744580713,1744580714.100584,-18000,EB445137-D7F5-57EC-87DA-1DB460D64046,"iPhone13,2"
com.apple.Health,2,1744580704,1744580706,1744580706.530431,-18000,EB445137-D7F5-57EC-87DA-1DB460D64046,"iPhone13,2"
com.apple.Health,9,1744580283,1744580292,1744580292.71005,-18000,EB445137-D7F5-57EC-87DA-1DB460D64046,"iPhone13,2"
com.apple.Notes,9,1744578818,1744578827,1744578827.5682058,-18000,,
com.google.Chrome,3,1744578815,1744578818,1744578818.792459,-18000,,
com.apple.Notes,7,1744578808,1744578815,1744578815.1443,-18000,,
com.google.Chrome,3,1744578805,1744578808,1744578808.4691029,-18000,,
com.apple.Notes,1,1744578804,1744578805,1744578805.499202,-18000,,
com.google.Chrome,5,1744578799,1744578804,1744578804.6141958,-18000,,
com.apple.Notes,0,1744578799,1744578799,1744578799.8505878,-18000,,
com.google.Chrome,4,1744578795,1744578799,1744578799.127284,-18000,,
com.apple.Notes,3,1744578792,1744578795,1744578795.5915852,-18000,,
com.google.Chrome,59,1744578733,1744578792,1744578792.150569,-18000,,
com.apple.Notes,6,1744578727,1744578733,1744578733.126505,-18000,,
com.google.Chrome,3,1744578724,1744578727,1744578727.419143,-18000,,
com.apple.Notes,1,1744578723,1744578724,1744578724.270883,-18000,,
com.google.Chrome,2,1744578721,1744578723,1744578723.480425,-18000,,
com.apple.Notes,3,1744578718,1744578721,1744578721.46819,-18000,,
com.google.Chrome,42,1744578676,1744578718,1744578718.170106,-18000,,
com.apple.Notes,1,1744578675,1744578676,1744578676.3235412,-18000,,
com.google.Chrome,3,1744578672,1744578675,1744578675.087913,-18000,,
com.apple.Notes,22,1744578650,1744578672,1744578672.2634091,-18000,,
com.google.Chrome,5,1744578645,1744578650,1744578650.509451,-18000,,
com.apple.Notes,1,1744578644,1744578645,1744578646.0243049,-18000,,
com.google.Chrome,7,1744578637,1744578644,1744578644.308525,-18000,,
com.apple.Notes,4,1744578633,1744578637,1744578637.717377,-18000,,
com.google.Chrome,24,1744578609,1744578633,1744578633.670796,-18000,,
com.apple.finder,1,1744578584,1744578585,1744578585.266652,-18000,,
com.leomehlig.today,9,1744578575,1744578584,1744578584.24861,-18000,,
com.intsig.CamScannerLite,132,1744578460,1744578592,1744578592.400035,-18000,EB445137-D7F5-57EC-87DA-1DB460D64046,"iPhone13,2"
com.apple.finder,138,1744578437,1744578575,1744578575.654243,-18000,,
com.leomehlig.today,34,1744578403,1744578437,1744578437.89118,-18000,,
com.apple.finder,4,1744578399,1744578403,1744578403.362041,-18000,,
com.leomehlig.today,1,1744578398,1744578399,1744578400.0069141,-18000,,
com.apple.MobileSMS,2,1744575685,1744575687,1744575687.972395,-18000,EB445137-D7F5-57EC-87DA-1DB460D64046,"iPhone13,2"
com.apple.MobileSMS,13,1744574641,1744574654,1744574654.878906,-18000,EB445137-D7F5-57EC-87DA-1DB460D64046,"iPhone13,2"
com.apple.CoreAuthUI,2,1744571382,1744571384,1744571384.89388,-18000,EB445137-D7F5-57EC-87DA-1DB460D64046,"iPhone13,2"
com.robinhood.release.Robinhood,14,1744571379,1744571393,1744571393.5583348,-18000,EB445137-D7F5-57EC-87DA-1DB460D64046,"iPhone13,2"
com.apple.mobilephone,3,1744571361,1744571364,1744571364.5268211,-18000,EB445137-D7F5-57EC-87DA-1DB460D64046,"iPhone13,2"
com.apple.mobilephone,64,1744570506,1744570570,1744570570.263482,-18000,EB445137-D7F5-57EC-87DA-1DB460D64046,"iPhone13,2"
com.apple.findmy,9,1744570488,1744570497,1744570497.697705,-18000,EB445137-D7F5-57EC-87DA-1DB460D64046,"iPhone13,2"
com.apple.findmy,0,1744570487,1744570487,1744570488.537605,-18000,EB445137-D7F5-57EC-87DA-1DB460D64046,"iPhone13,2"
com.apple.findmy,1,1744570486,1744570487,1744570488.4697099,-18000,EB445137-D7F5-57EC-87DA-1DB460D64046,"iPhone13,2"
com.apple.findmy,7,1744568072,1744568079,1744568079.47192,-18000,EB445137-D7F5-57EC-87DA-1DB460D64046,"iPhone13,2"
com.apple.Health,33,1744567401,1744567434,1744567434.630121,-18000,EB445137-D7F5-57EC-87DA-1DB460D64046,"iPhone13,2"
com.toyopagroup.picaboo,23,1744567371,1744567394,1744567394.538461,-18000,EB445137-D7F5-57EC-87DA-1DB460D64046,"iPhone13,2"
com.toyopagroup.picaboo,18,1744567352,1744567370,1744567370.402452,-18000,EB445137-D7F5-57EC-87DA-1DB460D64046,"iPhone13,2"
com.apple.MobileSMS,9,1744567339,1744567348,1744567348.575043,-18000,EB445137-D7F5-57EC-87DA-1DB460D64046,"iPhone13,2"
com.apple.MobileSMS,4,1744565510,1744565514,1744565514.190363,-18000,EB445137-D7F5-57EC-87DA-1DB460D64046,"iPhone13,2"
com.apple.MobileSMS,23,1744565442,1744565465,1744565465.919845,-18000,EB445137-D7F5-57EC-87DA-1DB460D64046,"iPhone13,2"
co.hinge.mobile.ios,51,1744565388,1744565439,1744565439.4403071,-18000,EB445137-D7F5-57EC-87DA-1DB460D64046,"iPhone13,2"
com.apple.MobileSMS,15,1744565371,1744565386,1744565386.713121,-18000,EB445137-D7F5-57EC-87DA-1DB460D64046,"iPhone13,2"
com.leomehlig.today,3,1744563937,1744563940,1744563940.571671,-18000,,
com.apple.finder,1,1744563936,1744563937,1744563937.812409,-18000,,
com.microsoft.VSCode,2,1744563934,1744563936,1744563937.104696,-18000,,
com.apple.finder,4,1744563930,1744563934,1744563934.045562,-18000,,
com.microsoft.Powerpoint,91,1744563839,1744563930,1744563930.6165829,-18000,,
com.apple.finder,3,1744563836,1744563839,1744563839.350019,-18000,,
com.microsoft.Powerpoint,7,1744563829,1744563836,1744563836.7725868,-18000,,
com.microsoft.VSCode,3,1744563826,1744563829,1744563829.027193,-18000,,
com.leomehlig.today,12,1744563814,1744563826,1744563826.360664,-18000,,
com.google.Chrome,286,1744563528,1744563814,1744563814.623946,-18000,,
com.leomehlig.today,27,1744563501,1744563528,1744563528.290376,-18000,,
com.apple.Preferences,50,1744563442,1744563492,1744563492.6686249,-18000,EB445137-D7F5-57EC-87DA-1DB460D64046,"iPhone13,2"
com.intsig.CamScannerLite,2,1744563434,1744563436,1744563436.942421,-18000,EB445137-D7F5-57EC-87DA-1DB460D64046,"iPhone13,2"
com.google.Chrome,401,1744563100,1744563501,1744563501.2218971,-18000,,
com.google.Chrome,324,1744562749,1744563073,1744563073.686208,-18000,,
com.google.Chrome,1390,1744561275,1744562665,1744562665.6566172,-18000,,
com.microsoft.VSCode,7,1744561239,1744561246,1744561246.631177,-18000,,
com.google.Chrome,111,1744561128,1744561239,1744561239.361768,-18000,,
com.leomehlig.today,31,1744561097,1744561128,1744561128.87943,-18000,,
com.google.Chrome,1,1744561096,1744561097,1744561097.9554439,-18000,,
com.leomehlig.today,5,1744561091,1744561096,1744561096.859693,-18000,,
com.google.Chrome,14,1744561077,1744561091,1744561091.658883,-18000,,
com.microsoft.VSCode,2,1744561075,1744561077,1744561077.3717809,-18000,,
com.leomehlig.today,35,1744561040,1744561075,1744561075.839752,-18000,,
com.google.Chrome,2,1744561038,1744561040,1744561040.702594,-18000,,
com.apple.finder,8,1744561030,1744561038,1744561038.36257,-18000,,
com.intsig.CamScannerLite,56,1744560976,1744561032,1744561032.5889192,-18000,EB445137-D7F5-57EC-87DA-1DB460D64046,"iPhone13,2"
com.microsoft.Office.Outlook,38,1744560927,1744560965,1744560965.528973,-18000,EB445137-D7F5-57EC-87DA-1DB460D64046,"iPhone13,2"
com.google.Chrome,865,1744560165,1744561030,1744561030.378025,-18000,,
com.microsoft.VSCode,13,1744560152,1744560165,1744560165.915368,-18000,,
com.google.Chrome,43,1744560109,1744560152,1744560152.3480458,-18000,,
com.leomehlig.today,2,1744560107,1744560109,1744560109.6917748,-18000,,
com.google.Chrome,1664,1744558443,1744560107,1744560107.9857001,-18000,,
com.leomehlig.today,25,1744558396,1744558421,1744558421.787427,-18000,,
com.google.Chrome,5,1744558391,1744558396,1744558396.1810222,-18000,,
com.microsoft.VSCode,5,1744558386,1744558391,1744558391.55424,-18000,,
com.microsoft.Powerpoint,13,1744558373,1744558386,1744558386.511615,-18000,,
com.microsoft.VSCode,4,1744558369,1744558373,1744558373.381524,-18000,,
com.microsoft.Powerpoint,20,1744558349,1744558369,1744558369.6209111,-18000,,
com.microsoft.VSCode,1,1744558348,1744558349,1744558349.311308,-18000,,
com.apple.finder,1,1744558347,1744558348,1744558348.53455,-18000,,
com.microsoft.VSCode,5,1744558342,1744558347,1744558347.776818,-18000,,
com.apple.finder,2,1744558340,1744558342,1744558342.990257,-18000,,
com.microsoft.Powerpoint,72,1744558268,1744558340,1744558340.543592,-18000,,
com.apple.finder,12,1744558256,1744558268,1744558268.5623431,-18000,,
com.microsoft.Powerpoint,7,1744558249,1744558256,1744558257.02037,-18000,,
com.google.Chrome,13,1744558236,1744558249,1744558249.569375,-18000,,
com.google.Chrome,301,1744557805,1744558106,1744558106.042179,-18000,,
com.microsoft.VSCode,7,1744557798,1744557805,1744557806.01659,-18000,,
com.google.Chrome,240,1744557558,1744557798,1744557798.796974,-18000,,
com.microsoft.VSCode,1,1744557557,1744557558,1744557558.674464,-18000,,
com.google.Chrome,222,1744557335,1744557557,1744557557.0375881,-18000,,
com.microsoft.VSCode,2,1744557333,1744557335,1744557335.25704,-18000,,
com.google.Chrome,319,1744557014,1744557333,1744557333.888366,-18000,,
com.microsoft.VSCode,2,1744557012,1744557014,1744557014.083911,-18000,,
com.google.Chrome,177,1744556835,1744557012,1744557012.132135,-18000,,
com.microsoft.VSCode,1,1744556834,1744556835,1744556835.285653,-18000,,
com.google.Chrome,81,1744556753,1744556834,1744556834.047377,-18000,,
com.microsoft.VSCode,25,1744556728,1744556753,1744556753.0200338,-18000,,
com.microsoft.Powerpoint,24,1744556704,1744556728,1744556728.1855779,-18000,,
com.microsoft.VSCode,74,1744556630,1744556704,1744556704.244725,-18000,,
com.microsoft.Powerpoint,62,1744556568,1744556630,1744556630.840528,-18000,,
com.microsoft.VSCode,6,1744556562,1744556568,1744556568.430252,-18000,,
com.google.Chrome,3,1744556559,1744556562,1744556562.971067,-18000,,
com.renpho.health,43,1744555589,1744555632,1744555632.58422,-18000,EB445137-D7F5-57EC-87DA-1DB460D64046,"iPhone13,2"
com.google.chrome.ios,4,1744555583,1744555587,1744555587.770146,-18000,EB445137-D7F5-57EC-87DA-1DB460D64046,"iPhone13,2"
com.google.chrome.ios,1,1744555552,1744555553,1744555553.8422,-18000,EB445137-D7F5-57EC-87DA-1DB460D64046,"iPhone13,2"
com.apple.weather,3,1744555516,1744555519,1744555519.138194,-18000,EB445137-D7F5-57EC-87DA-1DB460D64046,"iPhone13,2"
com.apple.weather,109,1744554476,1744554585,1744554585.559205,-18000,EB445137-D7F5-57EC-87DA-1DB460D64046,"iPhone13,2"
com.apple.news,195,1744554098,1744554293,1744554293.654818,-18000,EB445137-D7F5-57EC-87DA-1DB460D64046,"iPhone13,2"
com.microsoft.Office.Outlook,23,1744554044,1744554067,1744554068.030324,-18000,EB445137-D7F5-57EC-87DA-1DB460D64046,"iPhone13,2"
com.apple.CoreAuthUI,1,1744553968,1744553969,1744553969.9355211,-18000,EB445137-D7F5-57EC-87DA-1DB460D64046,"iPhone13,2"
com.truebill.truebillnative,4,1744553965,1744553969,1744553969.8557649,-18000,EB445137-D7F5-57EC-87DA-1DB460D64046,"iPhone13,2"
com.apple.CoreAuthUI,5,1744527219,1744527224,1744527224.037571,-18000,EB445137-D7F5-57EC-87DA-1DB460D64046,"iPhone13,2"
com.apple.journal,2269,1744527218,1744529487,1744529487.8002381,-18000,EB445137-D7F5-57EC-87DA-1DB460D64046,"iPhone13,2"
com.google.Chrome,550,1744526608,1744527158,1744527158.576725,-18000,,
com.google.Chrome,316,1744526290,1744526606,1744526606.3825378,-18000,,
com.apple.weather,3,1744522799,1744522802,1744522802.924092,-18000,EB445137-D7F5-57EC-87DA-1DB460D64046,"iPhone13,2"
com.google.Chrome,3957,1744521996,1744525953,1744525953.311943,-18000,,
com.google.Chrome,1236,1744520621,1744521857,1744521857.8718572,-18000,,
com.google.Chrome,305,1744520160,1744520465,1744520465.4166331,-18000,,
com.apple.news,2,1744518631,1744518633,1744518633.838845,-18000,EB445137-D7F5-57EC-87DA-1DB460D64046,"iPhone13,2"
com.google.Chrome,1214,1744518548,1744519762,1744519762.197768,-18000,,
com.apple.iCal,0,1744518539,1744518539,1744518540.0168009,-18000,,
com.leomehlig.today,182,1744518357,1744518539,1744518539.11126,-18000,,
com.apple.iCal,45,1744518312,1744518357,1744518357.503443,-18000,,
com.leomehlig.today,3,1744518309,1744518312,1744518312.689404,-18000,,
com.apple.MobileSMS,10,1744518299,1744518309,1744518309.276516,-18000,,
com.leomehlig.today,1,1744518298,1744518299,1744518299.892222,-18000,,
com.google.Chrome,7,1744518291,1744518298,1744518298.096548,-18000,,
com.google.Chrome,9,1744517778,1744517787,1744517788.022027,-18000,,
com.google.Chrome,470,1744514582,1744515052,1744515053.008566,-18000,,
com.google.Chrome,314,1744507936,1744508250,1744508250.6212559,-18000,,
com.apple.news,29,1744507338,1744507367,1744507368.0906549,-18000,EB445137-D7F5-57EC-87DA-1DB460D64046,"iPhone13,2"
com.facebook.Facebook,43,1744507287,1744507330,1744507330.273083,-18000,EB445137-D7F5-57EC-87DA-1DB460D64046,"iPhone13,2"
com.apple.MobileSMS,20,1744507265,1744507285,1744507286.019983,-18000,EB445137-D7F5-57EC-87DA-1DB460D64046,"iPhone13,2"
com.google.Chrome,537,1744506924,1744507461,1744507461.101646,-18000,,
com.google.Chrome,313,1744503113,1744503426,1744503426.6713629,-18000,,
com.toyopagroup.picaboo,17,1744503030,1744503047,1744503047.860402,-18000,EB445137-D7F5-57EC-87DA-1DB460D64046,"iPhone13,2"
com.apple.Music,2,1744503028,1744503030,1744503030.089457,-18000,EB445137-D7F5-57EC-87DA-1DB460D64046,"iPhone13,2"
com.google.Chrome,842,1744501568,1744502410,1744502410.80972,-18000,,
com.google.Chrome,30,1744501350,1744501380,1744501380.822908,-18000,,
com.apple.finder,4,1744501346,1744501350,1744501350.7839332,-18000,,
com.apple.Music,11,1744498107,1744498118,1744498118.326147,-18000,EB445137-D7F5-57EC-87DA-1DB460D64046,"iPhone13,2"
com.apple.podcasts,16,1744498091,1744498107,1744498107.752057,-18000,EB445137-D7F5-57EC-87DA-1DB460D64046,"iPhone13,2"
com.apple.podcasts,36,1744490344,1744490380,1744490380.9874048,-18000,EB445137-D7F5-57EC-87DA-1DB460D64046,"iPhone13,2"
com.apple.MobileSMS,2,1744490340,1744490342,1744490342.647269,-18000,EB445137-D7F5-57EC-87DA-1DB460D64046,"iPhone13,2"
com.apple.MobileSMS,27,1744490241,1744490268,1744490268.398614,-18000,EB445137-D7F5-57EC-87DA-1DB460D64046,"iPhone13,2"
com.apple.findmy,2,1744489809,1744489811,1744489811.51053,-18000,EB445137-D7F5-57EC-87DA-1DB460D64046,"iPhone13,2"
com.apple.findmy,8,1744482637,1744482645,1744482645.842334,-18000,EB445137-D7F5-57EC-87DA-1DB460D64046,"iPhone13,2"
com.myfitnesspal.mfp,3,1744482605,1744482608,1744482608.964003,-18000,EB445137-D7F5-57EC-87DA-1DB460D64046,"iPhone13,2"
com.myfitnesspal.mfp,2,1744481508,1744481510,1744481510.4615788,-18000,EB445137-D7F5-57EC-87DA-1DB460D64046,"iPhone13,2"
com.microsoft.Office.Outlook,12,1744481401,1744481413,1744481413.742161,-18000,EB445137-D7F5-57EC-87DA-1DB460D64046,"iPhone13,2"
com.apple.findmy,3,1744472743,1744472746,1744472746.148077,-18000,EB445137-D7F5-57EC-87DA-1DB460D64046,"iPhone13,2"
com.apple.findmy,6,1744470796,1744470802,1744470802.886332,-18000,EB445137-D7F5-57EC-87DA-1DB460D64046,"iPhone13,2"
com.apple.Health,16,1744469878,1744469894,1744469894.3365312,-18000,EB445137-D7F5-57EC-87DA-1DB460D64046,"iPhone13,2"
com.apple.findmy,0,1744469878,1744469878,1744469879.086115,-18000,EB445137-D7F5-57EC-87DA-1DB460D64046,"iPhone13,2"
com.apple.findmy,9,1744469743,1744469752,1744469752.484571,-18000,EB445137-D7F5-57EC-87DA-1DB460D64046,"iPhone13,2"
com.apple.findmy,7,1744468329,1744468336,1744468336.977823,-18000,EB445137-D7F5-57EC-87DA-1DB460D64046,"iPhone13,2"
com.apple.finder,30,1744467489,1744467519,1744467519.7703118,-18000,,
com.leomehlig.today,23,1744467466,1744467489,1744467489.858389,-18000,,
com.google.Chrome,64,1744467402,1744467466,1744467466.506895,-18000,,
com.apple.finder,5,1744467384,1744467389,1744467389.14788,-18000,,
com.microsoft.VSCode,7,1744467377,1744467384,1744467384.409632,-18000,,
com.apple.finder,12,1744467365,1744467377,1744467377.6558971,-18000,,
com.google.Chrome,2,1744467363,1744467365,1744467365.553345,-18000,,
com.microsoft.Powerpoint,2,1744467361,1744467363,1744467364.020078,-18000,,
com.google.Chrome,3,1744467358,1744467361,1744467361.4977012,-18000,,
com.microsoft.Powerpoint,53,1744467305,1744467358,1744467358.257349,-18000,,
com.google.Chrome,2,1744467303,1744467305,1744467305.790032,-18000,,
com.microsoft.Powerpoint,1,1744467302,1744467303,1744467303.286931,-18000,,
com.google.Chrome,0,1744467302,1744467302,1744467303.0300179,-18000,,
com.apple.finder,1,1744467301,1744467302,1744467302.167873,-18000,,
com.microsoft.Powerpoint,15,1744467286,1744467301,1744467301.410327,-18000,,
com.apple.finder,3,1744467283,1744467286,1744467286.0813742,-18000,,
com.google.Chrome,67,1744467216,1744467283,1744467283.943671,-18000,,
com.microsoft.VSCode,160,1744467056,1744467216,1744467216.887411,-18000,,
com.apple.finder,41,1744467015,1744467056,1744467056.6369781,-18000,,
com.microsoft.Powerpoint,7,1744467008,1744467015,1744467015.054683,-18000,,
com.apple.Preview,6,1744467002,1744467008,1744467008.6052852,-18000,,
com.apple.finder,3,1744466999,1744467002,1744467002.304138,-18000,,
com.google.Chrome,44,1744466955,1744466999,1744466999.052779,-18000,,
com.apple.Preview,80,1744466875,1744466955,1744466955.968966,-18000,,
com.apple.finder,5,1744466870,1744466875,1744466875.054873,-18000,,
com.apple.Preview,2,1744466868,1744466870,1744466870.647547,-18000,,
com.apple.finder,12,1744466856,1744466868,1744466868.673295,-18000,,
com.microsoft.Powerpoint,46,1744466810,1744466856,1744466856.99136,-18000,,
com.apple.finder,5,1744466805,1744466810,1744466810.9864721,-18000,,
com.microsoft.Powerpoint,25,1744466780,1744466805,1744466805.034914,-18000,,
com.apple.finder,3,1744466777,1744466780,1744466780.5465531,-18000,,
com.microsoft.Powerpoint,18,1744466759,1744466777,1744466777.279551,-18000,,
com.apple.finder,8,1744466751,1744466759,1744466759.579145,-18000,,
com.microsoft.Powerpoint,53,1744466698,1744466751,1744466751.5170069,-18000,,
com.apple.finder,3,1744466695,1744466698,1744466698.190489,-18000,,
com.microsoft.Powerpoint,68,1744466627,1744466695,1744466695.405083,-18000,,
com.google.Chrome,10,1744466617,1744466627,1744466627.301126,-18000,,
com.apple.finder,1,1744466616,1744466617,1744466617.949611,-18000,,
com.microsoft.Powerpoint,80,1744466536,1744466616,1744466616.768939,-18000,,
com.apple.finder,3,1744466486,1744466489,1744466489.8681278,-18000,,
com.microsoft.Powerpoint,45,1744466441,1744466486,1744466486.709015,-18000,,
com.google.Chrome,39,1744466402,1744466441,1744466441.307719,-18000,,
com.apple.finder,7,1744466395,1744466402,1744466402.102223,-18000,,
com.google.Chrome,3,1744466392,1744466395,1744466395.90441,-18000,,
com.apple.finder,1,1744466391,1744466392,1744466392.3219051,-18000,,
com.google.Chrome,43,1744466348,1744466391,1744466391.8627691,-18000,,
com.apple.finder,4,1744466344,1744466348,1744466348.59325,-18000,,
com.google.Chrome,1,1744466343,1744466344,1744466345.051296,-18000,,
com.apple.finder,6,1744466337,1744466343,1744466343.678803,-18000,,
com.google.Chrome,17,1744466320,1744466337,1744466337.672011,-18000,,
com.apple.finder,2,1744466318,1744466320,1744466320.2763119,-18000,,
com.google.Chrome,0,1744466318,1744466318,1744466318.996033,-18000,,
com.apple.finder,4,1744466314,1744466318,1744466318.071302,-18000,,
com.microsoft.VSCode,40,1744466274,1744466314,1744466314.8727999,-18000,,
com.google.Chrome,3,1744466271,1744466274,1744466274.8158321,-18000,,
com.microsoft.VSCode,2,1744466269,1744466271,1744466272.003006,-18000,,
com.google.Chrome,5,1744466264,1744466269,1744466269.2153568,-18000,,
com.microsoft.VSCode,3,1744466261,1744466264,1744466264.7879329,-18000,,
com.google.Chrome,40,1744466221,1744466261,1744466261.856353,-18000,,
com.microsoft.VSCode,11,1744466210,1744466221,1744466221.766111,-18000,,
com.google.Chrome,57,1744466153,1744466210,1744466210.6075,-18000,,
com.apple.finder,1,1744466152,1744466153,1744466153.940998,-18000,,
com.google.Chrome,3,1744466149,1744466152,1744466152.7262402,-18000,,
com.apple.finder,5,1744466144,1744466149,1744466149.896097,-18000,,
com.google.Chrome,52,1744466092,1744466144,1744466144.822352,-18000,,
com.apple.finder,2,1744466090,1744466092,1744466092.839432,-18000,,
com.google.Chrome,4,1744466086,1744466090,1744466090.535809,-18000,,
com.apple.finder,26,1744466060,1744466086,1744466086.1437259,-18000,,
com.microsoft.VSCode,25,1744466035,1744466060,1744466060.951199,-18000,,
com.leomehlig.today,17,1744466018,1744466035,1744466035.637772,-18000,,
com.google.Chrome,3,1744466015,1744466018,1744466018.373234,-18000,,
com.apple.mobilecal,6,1744465977,1744465983,1744465983.180428,-18000,EB445137-D7F5-57EC-87DA-1DB460D64046,"iPhone13,2"
com.microsoft.VSCode,53,1744465962,1744466015,1744466015.1880121,-18000,,
com.apple.mobilecal,71,1744465726,1744465797,1744465797.2571359,-18000,EB445137-D7F5-57EC-87DA-1DB460D64046,"iPhone13,2"
com.google.Chrome,385,1744465577,1744465962,1744465962.603095,-18000,,
com.microsoft.VSCode,27,1744465550,1744465577,1744465577.929179,-18000,,
com.google.Chrome,8,1744465542,1744465550,1744465550.323509,-18000,,
com.apple.Preview,120,1744465422,1744465542,1744465542.488384,-18000,,
com.google.Chrome,0,1744465422,1744465422,1744465422.970127,-18000,,
com.apple.Preview,3,1744465419,1744465422,1744465422.0720248,-18000,,
com.apple.finder,1,1744465418,1744465419,1744465419.446759,-18000,,
com.apple.Preview,4,1744465414,1744465418,1744465418.5679421,-18000,,
com.apple.finder,8,1744465406,1744465414,1744465414.6607409,-18000,,
com.google.Chrome,56,1744465350,1744465406,1744465406.322723,-18000,,
com.apple.finder,5,1744465345,1744465350,1744465350.762461,-18000,,
com.google.Chrome,39,1744465306,1744465345,1744465345.579595,-18000,,
com.apple.finder,2,1744465304,1744465306,1744465306.1724858,-18000,,
com.google.Chrome,2,1744465302,1744465304,1744465304.140507,-18000,,
com.apple.finder,9,1744465293,1744465302,1744465302.6965098,-18000,,
com.microsoft.VSCode,77,1744465216,1744465293,1744465293.657311,-18000,,
com.apple.finder,5,1744465211,1744465216,1744465216.7491012,-18000,,
com.microsoft.VSCode,29,1744465182,1744465211,1744465211.428245,-18000,,
com.google.Chrome,48,1744465134,1744465182,1744465182.5207992,-18000,,
com.apple.finder,3,1744465131,1744465134,1744465134.123859,-18000,,
com.google.Chrome,7,1744465124,1744465131,1744465131.0522661,-18000,,
com.apple.finder,8,1744465116,1744465124,1744465124.555573,-18000,,
com.google.Chrome,22,1744465094,1744465116,1744465116.36104,-18000,,
com.microsoft.VSCode,347,1744464747,1744465094,1744465094.035143,-18000,,
com.apple.finder,50,1744464697,1744464747,1744464747.4405332,-18000,,
com.microsoft.VSCode,15,1744464682,1744464697,1744464697.8548222,-18000,,
com.apple.finder,14,1744464668,1744464682,1744464682.3878899,-18000,,
com.microsoft.VSCode,375,1744464293,1744464668,1744464668.191433,-18000,,
com.apple.finder,8,1744464285,1744464293,1744464293.164233,-18000,,
com.apple.iCal,42,1744464243,1744464285,1744464285.590269,-18000,,
com.apple.finder,15,1744464228,1744464243,1744464243.02983,-18000,,
com.apple.CoreAuthUI,7,1744462733,1744462740,1744462740.828655,-18000,EB445137-D7F5-57EC-87DA-1DB460D64046,"iPhone13,2"
com.robinhood.release.Robinhood,55,1744462729,1744462784,1744462784.936497,-18000,EB445137-D7F5-57EC-87DA-1DB460D64046,"iPhone13,2"
com.apple.news,1297,1744461427,1744462724,1744462724.270309,-18000,EB445137-D7F5-57EC-87DA-1DB460D64046,"iPhone13,2"
com.facebook.Facebook,39,1744461082,1744461121,1744461121.654916,-18000,EB445137-D7F5-57EC-87DA-1DB460D64046,"iPhone13,2"
com.microsoft.Office.Outlook,1,1744461081,1744461082,1744461082.689811,-18000,EB445137-D7F5-57EC-87DA-1DB460D64046,"iPhone13,2"
com.microsoft.Office.Outlook,28,1744461035,1744461063,1744461063.8136039,-18000,EB445137-D7F5-57EC-87DA-1DB460D64046,"iPhone13,2"
com.apple.finder,29,1744429113,1744429142,1744429142.679074,-18000,,
com.google.Chrome,896,1744428217,1744429113,1744429113.935355,-18000,,
com.google.Chrome,300,1744427205,1744427505,1744427505.8346949,-18000,,
com.google.Chrome,652,1744426142,1744426794,1744426794.6552238,-18000,,
com.google.Gmail,7,1744425720,1744425727,1744425727.669286,-18000,EB445137-D7F5-57EC-87DA-1DB460D64046,"iPhone13,2"
com.apple.MobileSMS,0,1744425720,1744425720,1744425720.9829612,-18000,EB445137-D7F5-57EC-87DA-1DB460D64046,"iPhone13,2"
com.google.Chrome,300,1744425401,1744425701,1744425701.893954,-18000,,
com.apple.MobileSMS,14,1744422451,1744422465,1744422466.169842,-18000,EB445137-D7F5-57EC-87DA-1DB460D64046,"iPhone13,2"
com.google.Chrome,636,1744421755,1744422391,1744422391.871587,-18000,,
co.hinge.mobile.ios,6,1744421468,1744421474,1744421474.685728,-18000,EB445137-D7F5-57EC-87DA-1DB460D64046,"iPhone13,2"
co.hinge.mobile.ios,378,1744421021,1744421399,1744421399.1737561,-18000,EB445137-D7F5-57EC-87DA-1DB460D64046,"iPhone13,2"
co.hinge.mobile.ios,3,1744421013,1744421016,1744421016.3393168,-18000,EB445137-D7F5-57EC-87DA-1DB460D64046,"iPhone13,2"
co.hinge.mobile.ios,15,1744420997,1744421012,1744421013.080373,-18000,EB445137-D7F5-57EC-87DA-1DB460D64046,"iPhone13,2"
com.apple.news,227,1744420754,1744420981,1744420981.511267,-18000,EB445137-D7F5-57EC-87DA-1DB460D64046,"iPhone13,2"
com.apple.MobileSMS,14,1744420724,1744420738,1744420738.076445,-18000,EB445137-D7F5-57EC-87DA-1DB460D64046,"iPhone13,2"
com.google.chrome.ios,45,1744420679,1744420724,1744420725.217536,-18000,EB445137-D7F5-57EC-87DA-1DB460D64046,"iPhone13,2"
com.apple.MobileSMS,2,1744420677,1744420679,1744420679.6134272,-18000,EB445137-D7F5-57EC-87DA-1DB460D64046,"iPhone13,2"
com.google.chrome.ios,32,1744420645,1744420677,1744420677.7882118,-18000,EB445137-D7F5-57EC-87DA-1DB460D64046,"iPhone13,2"
com.apple.MobileSMS,99,1744420546,1744420645,1744420645.816249,-18000,EB445137-D7F5-57EC-87DA-1DB460D64046,"iPhone13,2"
com.apple.MobileSMS,46,1744420469,1744420515,1744420515.176305,-18000,EB445137-D7F5-57EC-87DA-1DB460D64046,"iPhone13,2"
com.apple.MobileSMS,11,1744419893,1744419904,1744419905.166685,-18000,EB445137-D7F5-57EC-87DA-1DB460D64046,"iPhone13,2"
com.apple.news,0,1744419893,1744419893,1744419894.2434301,-18000,EB445137-D7F5-57EC-87DA-1DB460D64046,"iPhone13,2"
com.apple.news,35,1744417633,1744417668,1744417669.8600569,-18000,EB445137-D7F5-57EC-87DA-1DB460D64046,"iPhone13,2"
com.microsoft.Office.Outlook,20,1744417609,1744417629,1744417630.176127,-18000,EB445137-D7F5-57EC-87DA-1DB460D64046,"iPhone13,2"
com.apple.findmy,0,1744417609,1744417609,1744417610.689527,-18000,EB445137-D7F5-57EC-87DA-1DB460D64046,"iPhone13,2"
com.google.Chrome,115,1744417440,1744417555,1744417555.371187,-18000,,
com.apple.finder,3,1744417437,1744417440,1744417440.425837,-18000,,
com.google.Chrome,2,1744417435,1744417437,1744417437.029707,-18000,,
com.google.Chrome,484,1744416916,1744417400,1744417400.755198,-18000,,
com.google.Chrome,740,1744415805,1744416545,1744416545.549042,-18000,,
com.apple.findmy,17,1744412684,1744412701,1744412701.749572,-18000,EB445137-D7F5-57EC-87DA-1DB460D64046,"iPhone13,2"
com.apple.findmy,2,1744412682,1744412684,1744412684.4879122,-18000,EB445137-D7F5-57EC-87DA-1DB460D64046,"iPhone13,2"
com.apple.findmy,25,1744412532,1744412557,1744412557.982017,-18000,EB445137-D7F5-57EC-87DA-1DB460D64046,"iPhone13,2"
com.apple.Music,2,1744412527,1744412529,1744412530.2621322,-18000,EB445137-D7F5-57EC-87DA-1DB460D64046,"iPhone13,2"
com.apple.Music,64,1744412041,1744412105,1744412105.447801,-18000,EB445137-D7F5-57EC-87DA-1DB460D64046,"iPhone13,2"
com.apple.MobileSMS,4,1744412037,1744412041,1744412041.39523,-18000,EB445137-D7F5-57EC-87DA-1DB460D64046,"iPhone13,2"
com.apple.MobileSMS,10,1744407301,1744407311,1744407311.66204,-18000,EB445137-D7F5-57EC-87DA-1DB460D64046,"iPhone13,2"
com.apple.podcasts,2,1744407298,1744407300,1744407301.0251231,-18000,EB445137-D7F5-57EC-87DA-1DB460D64046,"iPhone13,2"
com.apple.podcasts,63,1744403792,1744403855,1744403855.438035,-18000,EB445137-D7F5-57EC-87DA-1DB460D64046,"iPhone13,2"
com.microsoft.Office.Outlook,2,1744403790,1744403792,1744403792.157923,-18000,EB445137-D7F5-57EC-87DA-1DB460D64046,"iPhone13,2"
com.microsoft.Office.Outlook,10,1744403717,1744403727,1744403728.064155,-18000,EB445137-D7F5-57EC-87DA-1DB460D64046,"iPhone13,2"
com.apple.podcasts,2,1744403707,1744403709,1744403709.057557,-18000,EB445137-D7F5-57EC-87DA-1DB460D64046,"iPhone13,2"
com.apple.podcasts,15,1744403392,1744403407,1744403407.453304,-18000,EB445137-D7F5-57EC-87DA-1DB460D64046,"iPhone13,2"
com.apple.MobileSMS,6,1744403386,1744403392,1744403392.937879,-18000,EB445137-D7F5-57EC-87DA-1DB460D64046,"iPhone13,2"
com.apple.Music,1,1744403385,1744403386,1744403386.689107,-18000,EB445137-D7F5-57EC-87DA-1DB460D64046,"iPhone13,2"
com.apple.Music,127,1744402340,1744402467,1744402467.966476,-18000,EB445137-D7F5-57EC-87DA-1DB460D64046,"iPhone13,2"
com.apple.MobileSMS,3,1744402331,1744402334,1744402334.1199598,-18000,EB445137-D7F5-57EC-87DA-1DB460D64046,"iPhone13,2"
com.apple.MobileSMS,7,1744402321,1744402328,1744402328.248272,-18000,EB445137-D7F5-57EC-87DA-1DB460D64046,"iPhone13,2"
com.apple.news,2,1744402311,1744402313,1744402313.713935,-18000,EB445137-D7F5-57EC-87DA-1DB460D64046,"iPhone13,2"
com.apple.news,79,1744397922,1744398001,1744398001.7046561,-18000,EB445137-D7F5-57EC-87DA-1DB460D64046,"iPhone13,2"
com.apple.news,3,1744397916,1744397919,1744397920.237656,-18000,EB445137-D7F5-57EC-87DA-1DB460D64046,"iPhone13,2"
com.apple.news,1,1744397915,1744397916,1744397916.5816898,-18000,EB445137-D7F5-57EC-87DA-1DB460D64046,"iPhone13,2"
com.apple.news,852,1744395539,1744396391,1744396391.955984,-18000,EB445137-D7F5-57EC-87DA-1DB460D64046,"iPhone13,2"
com.apple.news,252,1744394289,1744394541,1744394542.455327,-18000,EB445137-D7F5-57EC-87DA-1DB460D64046,"iPhone13,2"
com.apple.weather,22,1744394261,1744394283,1744394283.597173,-18000,EB445137-D7F5-57EC-87DA-1DB460D64046,"iPhone13,2"
com.google.Chrome,593,1744393659,1744394252,1744394252.558432,-18000,,
com.apple.finder,1,1744393658,1744393659,1744393659.858316,-18000,,
com.apple.Terminal,1,1744393657,1744393658,1744393658.328659,-18000,,
com.apple.finder,4,1744393653,1744393657,1744393657.251842,-18000,,
com.leomehlig.today,3,1744393650,1744393653,1744393653.189605,-18000,,
com.hammerandchisel.discord,65,1744393571,1744393636,1744393636.708699,-18000,EB445137-D7F5-57EC-87DA-1DB460D64046,"iPhone13,2"
com.microsoft.Office.Outlook,48,1744391114,1744391162,1744391163.433393,-18000,EB445137-D7F5-57EC-87DA-1DB460D64046,"iPhone13,2"
com.microsoft.Office.Outlook,44,1744388457,1744388501,1744388501.612323,-18000,EB445137-D7F5-57EC-87DA-1DB460D64046,"iPhone13,2"
com.apple.Health,110,1744386961,1744387071,1744387071.800777,-18000,EB445137-D7F5-57EC-87DA-1DB460D64046,"iPhone13,2"
com.leomehlig.today,6,1744386955,1744386961,1744386961.81566,-18000,EB445137-D7F5-57EC-87DA-1DB460D64046,"iPhone13,2"
com.apple.Health,19,1744386936,1744386955,1744386955.9621968,-18000,EB445137-D7F5-57EC-87DA-1DB460D64046,"iPhone13,2"
com.leomehlig.today,13,1744386923,1744386936,1744386936.5120149,-18000,EB445137-D7F5-57EC-87DA-1DB460D64046,"iPhone13,2"
com.apple.Health,12,1744386905,1744386917,1744386917.999305,-18000,EB445137-D7F5-57EC-87DA-1DB460D64046,"iPhone13,2"
com.apple.Health,2,1744386530,1744386532,1744386532.4055982,-18000,EB445137-D7F5-57EC-87DA-1DB460D64046,"iPhone13,2"
com.leomehlig.today,2,1744386513,1744386515,1744386515.824781,-18000,,
com.google.Chrome,143,1744386370,1744386513,1744386513.547735,-18000,,
com.leomehlig.today,6,1744386364,1744386370,1744386370.1224818,-18000,,
com.apple.news,89,1744386275,1744386364,1744386364.197994,-18000,,
com.leomehlig.today,12,1744386263,1744386275,1744386275.271689,-18000,,
com.apple.finder,2,1744386261,1744386263,1744386263.497915,-18000,,
com.apple.reminders,6,1744386255,1744386261,1744386261.4560552,-18000,,
com.apple.Terminal,4,1744386251,1744386255,1744386255.083626,-18000,,
com.apple.finder,10,1744386241,1744386251,1744386251.191138,-18000,,
com.apple.Terminal,30,1744386211,1744386241,1744386241.716805,-18000,,
com.apple.finder,5,1744386206,1744386211,1744386211.275595,-18000,,
com.apple.Terminal,1,1744386205,1744386206,1744386206.2068372,-18000,,
com.apple.finder,17,1744386188,1744386205,1744386205.3968139,-18000,,
com.leomehlig.today,17,1744386171,1744386188,1744386188.173245,-18000,,
com.google.Chrome,12,1744386159,1744386171,1744386171.876535,-18000,,
com.microsoft.VSCode,19,1744386140,1744386159,1744386159.872579,-18000,,
com.apple.news,129,1744386011,1744386140,1744386140.849148,-18000,,
com.microsoft.VSCode,179,1744385832,1744386011,1744386011.9529881,-18000,,
com.google.Chrome,3,1744385829,1744385832,1744385832.960496,-18000,,
com.microsoft.VSCode,23,1744385806,1744385829,1744385830.004508,-18000,,
com.google.Chrome,44,1744385762,1744385806,1744385806.9870548,-18000,,
com.microsoft.VSCode,0,1744385762,1744385762,1744385762.951651,-18000,,
com.google.Chrome,16,1744385746,1744385762,1744385762.1954079,-18000,,
com.microsoft.VSCode,410,1744385336,1744385746,1744385746.764647,-18000,,
com.google.Chrome,9,1744385327,1744385336,1744385336.257183,-18000,,
com.microsoft.VSCode,1,1744385326,1744385327,1744385327.946626,-18000,,
com.google.Chrome,1,1744385325,1744385326,1744385326.238411,-18000,,
com.microsoft.VSCode,2,1744385323,1744385325,1744385325.12457,-18000,,
com.google.Chrome,1,1744385322,1744385323,1744385323.720206,-18000,,
com.microsoft.VSCode,26,1744385296,1744385322,1744385322.433469,-18000,,
com.google.Chrome,1,1744385295,1744385296,1744385296.241672,-18000,,
com.microsoft.VSCode,2,1744385293,1744385295,1744385295.246787,-18000,,
com.google.Chrome,3,1744385290,1744385293,1744385293.191409,-18000,,
com.microsoft.VSCode,6,1744385284,1744385290,1744385291.001943,-18000,,
com.google.Chrome,1,1744385283,1744385284,1744385284.358278,-18000,,
com.microsoft.VSCode,2,1744385281,1744385283,1744385283.657603,-18000,,
com.google.Chrome,0,1744385281,1744385281,1744385281.841804,-18000,,
com.microsoft.VSCode,3,1744385278,1744385281,1744385281.101695,-18000,,
com.google.Chrome,1,1744385277,1744385278,1744385278.902951,-18000,,
com.microsoft.VSCode,2,1744385275,1744385277,1744385277.961351,-18000,,
com.google.Chrome,2,1744385273,1744385275,1744385275.277162,-18000,,
com.microsoft.VSCode,58,1744385215,1744385273,1744385273.636826,-18000,,
com.google.Chrome,3,1744385212,1744385215,1744385215.410228,-18000,,
com.microsoft.VSCode,7,1744385205,1744385212,1744385212.685272,-18000,,
com.google.Chrome,2,1744385203,1744385205,1744385206.00368,-18000,,
com.microsoft.VSCode,30,1744385173,1744385203,1744385203.181416,-18000,,
com.google.Chrome,2,1744385171,1744385173,1744385173.123931,-18000,,
com.microsoft.VSCode,1,1744385170,1744385171,1744385172.022725,-18000,,
com.google.Chrome,1,1744385169,1744385170,1744385170.292939,-18000,,
com.microsoft.VSCode,3,1744385166,1744385169,1744385169.274684,-18000,,
com.google.Chrome,2,1744385164,1744385166,1744385166.792083,-18000,,
com.microsoft.VSCode,1,1744385163,1744385164,1744385165.055654,-18000,,
com.google.Chrome,1,1744385162,1744385163,1744385163.518303,-18000,,
com.microsoft.VSCode,2,1744385160,1744385162,1744385162.481468,-18000,,
com.google.Chrome,1,1744385159,1744385160,1744385160.868085,-18000,,
com.microsoft.VSCode,1,1744385158,1744385159,1744385159.666206,-18000,,
com.google.Chrome,2,1744385156,1744385158,1744385158.316355,-18000,,
com.microsoft.VSCode,1,1744385155,1744385156,1744385156.897325,-18000,,
com.google.Chrome,1,1744385154,1744385155,1744385155.393259,-18000,,
com.microsoft.VSCode,2,1744385152,1744385154,1744385154.238395,-18000,,
com.google.Chrome,1,1744385151,1744385152,1744385152.8897018,-18000,,
com.microsoft.VSCode,2,1744385149,1744385151,1744385151.638999,-18000,,
com.google.Chrome,1,1744385148,1744385149,1744385149.847622,-18000,,
com.microsoft.VSCode,1,1744385147,1744385148,1744385148.769196,-18000,,
com.google.Chrome,2,1744385145,1744385147,1744385147.245789,-18000,,
com.microsoft.VSCode,2,1744385143,1744385145,1744385145.913008,-18000,,
com.google.Chrome,1,1744385142,1744385143,1744385143.974965,-18000,,
com.microsoft.VSCode,1,1744385141,1744385142,1744385142.832567,-18000,,
com.google.Chrome,1,1744385140,1744385141,1744385141.393635,-18000,,
com.microsoft.VSCode,27,1744385113,1744385140,1744385140.140116,-18000,,
com.google.Chrome,1,1744385112,1744385113,1744385113.514936,-18000,,
com.microsoft.VSCode,26,1744385086,1744385112,1744385112.3308659,-18000,,
com.google.Chrome,13,1744385073,1744385086,1744385086.7565222,-18000,,
com.microsoft.VSCode,1,1744385072,1744385073,1744385073.9870691,-18000,,
com.google.Chrome,3,1744385069,1744385072,1744385072.724358,-18000,,
com.microsoft.VSCode,18,1744385051,1744385069,1744385069.798286,-18000,,
com.google.Chrome,3,1744385048,1744385051,1744385051.856916,-18000,,
com.microsoft.VSCode,14,1744385034,1744385048,1744385048.418762,-18000,,
com.google.Chrome,7,1744385027,1744385034,1744385034.428146,-18000,,
com.microsoft.VSCode,75,1744384952,1744385027,1744385027.658011,-18000,,
com.google.Chrome,2,1744384950,1744384952,1744384952.463214,-18000,,
com.microsoft.VSCode,3,1744384947,1744384950,1744384950.937778,-18000,,
com.google.Chrome,2,1744384945,1744384947,1744384947.965513,-18000,,
com.microsoft.VSCode,22,1744384923,1744384945,1744384945.06763,-18000,,
com.google.Chrome,11,1744384912,1744384923,1744384923.250778,-18000,,
com.microsoft.VSCode,3,1744384909,1744384912,1744384912.9370332,-18000,,
com.google.Chrome,1,1744384908,1744384909,1744384909.470512,-18000,,
com.microsoft.VSCode,13,1744384895,1744384908,1744384908.463577,-18000,,
com.google.Chrome,4,1744384891,1744384895,1744384895.106241,-18000,,
com.microsoft.VSCode,3,1744384888,1744384891,1744384891.96067,-18000,,
com.google.Chrome,2,1744384886,1744384888,1744384888.283636,-18000,,
com.microsoft.VSCode,4,1744384882,1744384886,1744384886.651126,-18000,,
com.google.Chrome,3,1744384879,1744384882,1744384882.671551,-18000,,
com.microsoft.VSCode,6,1744384873,1744384879,1744384880.012601,-18000,,
com.google.Chrome,7,1744384866,1744384873,1744384873.788163,-18000,,
com.microsoft.VSCode,17,1744384849,1744384866,1744384866.115665,-18000,,
com.google.Chrome,31,1744384818,1744384849,1744384849.512541,-18000,,
com.microsoft.VSCode,11,1744384807,1744384818,1744384818.69269,-18000,,
com.google.Chrome,12,1744384795,1744384807,1744384807.5807629,-18000,,
com.microsoft.VSCode,60,1744384735,1744384795,1744384795.599823,-18000,,
com.google.Chrome,11,1744384724,1744384735,1744384735.186851,-18000,,
com.microsoft.VSCode,54,1744384670,1744384724,1744384724.812307,-18000,,
com.google.Chrome,107,1744384563,1744384670,1744384671.009646,-18000,,
com.google.Chrome,131,1744384429,1744384560,1744384560.47472,-18000,,
com.apple.Health,11,1744383860,1744383871,1744383871.539408,-18000,EB445137-D7F5-57EC-87DA-1DB460D64046,"iPhone13,2"
com.microsoft.VSCode,570,1744383844,1744384414,1744384414.622271,-18000,,
com.microsoft.Office.Outlook,2,1744383839,1744383841,1744383841.7807999,-18000,EB445137-D7F5-57EC-87DA-1DB460D64046,"iPhone13,2"
com.microsoft.VSCode,369,1744383473,1744383842,1744383842.6599422,-18000,,
com.google.Chrome,2,1744383471,1744383473,1744383473.919036,-18000,,
com.microsoft.VSCode,3,1744383468,1744383471,1744383471.074552,-18000,,
com.google.Chrome,15,1744383453,1744383468,1744383468.980915,-18000,,
com.microsoft.VSCode,33,1744383420,1744383453,1744383453.4680119,-18000,,
com.leomehlig.today,219,1744383201,1744383420,1744383420.380079,-18000,,
com.microsoft.VSCode,84,1744383117,1744383201,1744383201.748085,-18000,,
com.microsoft.VSCode,300,1744382809,1744383109,1744383109.4717588,-18000,,
com.microsoft.VSCode,529,1744382277,1744382806,1744382806.7018518,-18000,,
com.google.Chrome,39,1744382238,1744382277,1744382277.0792542,-18000,,
com.microsoft.VSCode,104,1744382134,1744382238,1744382238.871803,-18000,,
com.google.Chrome,0,1744382134,1744382134,1744382134.869904,-18000,,
com.microsoft.VSCode,57,1744382077,1744382134,1744382134.463933,-18000,,
com.google.Chrome,104,1744381973,1744382077,1744382078.045358,-18000,,
com.microsoft.VSCode,67,1744381906,1744381973,1744381973.41976,-18000,,
com.google.Chrome,21,1744381885,1744381906,1744381907.131767,-18000,,
com.microsoft.VSCode,2,1744381883,1744381885,1744381885.321451,-18000,,
com.google.Chrome,29,1744381854,1744381883,1744381884.02441,-18000,,
com.microsoft.VSCode,1,1744381853,1744381854,1744381855.4657211,-18000,,
com.google.Chrome,52,1744381801,1744381853,1744381853.872823,-18000,,
com.microsoft.VSCode,68,1744381733,1744381801,1744381801.881547,-18000,,
com.apple.MobileSMS,8,1744381725,1744381733,1744381733.55092,-18000,,
com.microsoft.VSCode,84,1744381641,1744381725,1744381725.445358,-18000,,
com.google.Chrome,4,1744381637,1744381641,1744381643.427125,-18000,,
com.microsoft.VSCode,189,1744381448,1744381637,1744381637.856425,-18000,,
com.google.Chrome,2,1744381446,1744381448,1744381448.64637,-18000,,
com.microsoft.Office.Outlook,127,1744381284,1744381411,1744381412.848495,-18000,EB445137-D7F5-57EC-87DA-1DB460D64046,"iPhone13,2"
com.instructure.icanvas,4,1744381280,1744381284,1744381284.487453,-18000,EB445137-D7F5-57EC-87DA-1DB460D64046,"iPhone13,2"
com.microsoft.VSCode,415,1744381031,1744381446,1744381446.54862,-18000,,
com.google.Chrome,6,1744381025,1744381031,1744381031.073535,-18000,,
com.microsoft.VSCode,45,1744380980,1744381025,1744381025.576395,-18000,,
com.google.Chrome,3,1744380977,1744380980,1744380980.673445,-18000,,
com.microsoft.VSCode,75,1744380902,1744380977,1744380977.927847,-18000,,
com.google.Chrome,67,1744380835,1744380902,1744380902.376864,-18000,,
com.microsoft.VSCode,274,1744380561,1744380835,1744380837.42234,-18000,,
com.google.Chrome,12,1744380549,1744380561,1744380561.715826,-18000,,
com.microsoft.VSCode,560,1744379989,1744380549,1744380549.970814,-18000,,
com.google.Chrome,6,1744379983,1744379989,1744379989.646765,-18000,,
com.microsoft.VSCode,23,1744379960,1744379983,1744379983.788525,-18000,,
com.google.Chrome,24,1744379936,1744379960,1744379960.5783138,-18000,,
com.microsoft.VSCode,12,1744379924,1744379936,1744379936.086697,-18000,,
com.google.Chrome,2,1744379922,1744379924,1744379924.312447,-18000,,
com.microsoft.VSCode,5,1744379917,1744379922,1744379922.885483,-18000,,
com.google.Chrome,0,1744379917,1744379917,1744379917.789287,-18000,,
com.microsoft.VSCode,3,1744379914,1744379917,1744379917.126975,-18000,,
com.google.Chrome,1,1744379913,1744379914,1744379914.354707,-18000,,
com.microsoft.VSCode,33,1744379880,1744379913,1744379913.187477,-18000,,
com.google.Chrome,11,1744379869,1744379880,1744379880.79599,-18000,,
com.microsoft.VSCode,18,1744379851,1744379869,1744379869.820838,-18000,,
com.google.Chrome,1,1744379850,1744379851,1744379851.1584148,-18000,,
com.microsoft.VSCode,139,1744379711,1744379850,1744379850.589507,-18000,,
com.google.Chrome,5,1744379706,1744379711,1744379711.1799579,-18000,,
com.microsoft.VSCode,1,1744379705,1744379706,1744379706.9695,-18000,,
com.google.Chrome,2,1744379703,1744379705,1744379706.000393,-18000,,
com.microsoft.VSCode,19,1744379684,1744379703,1744379703.848495,-18000,,
com.google.Chrome,12,1744379672,1744379684,1744379684.483855,-18000,,
com.microsoft.VSCode,17,1744379655,1744379672,1744379672.626162,-18000,,
com.google.Chrome,5,1744379650,1744379655,1744379655.1760669,-18000,,
com.microsoft.VSCode,5,1744379645,1744379650,1744379650.424674,-18000,,
com.google.Chrome,4,1744379641,1744379645,1744379645.0709782,-18000,,
com.microsoft.VSCode,4,1744379637,1744379641,1744379642.051018,-18000,,
com.google.Chrome,3,1744379634,1744379637,1744379637.350449,-18000,,
com.microsoft.VSCode,6,1744379628,1744379634,1744379634.800101,-18000,,
com.google.Chrome,4,1744379624,1744379628,1744379628.572748,-18000,,
com.microsoft.VSCode,8,1744379616,1744379624,1744379624.391862,-18000,,
com.google.Chrome,28,1744379588,1744379616,1744379616.11263,-18000,,
com.microsoft.VSCode,32,1744379556,1744379588,1744379588.538357,-18000,,
com.google.Chrome,10,1744379546,1744379556,1744379556.104816,-18000,,
com.microsoft.VSCode,6,1744379540,1744379546,1744379546.177413,-18000,,
com.google.Chrome,6,1744379534,1744379540,1744379540.273653,-18000,,
com.microsoft.VSCode,4,1744379530,1744379534,1744379534.957205,-18000,,
com.google.Chrome,85,1744379445,1744379530,1744379530.12001,-18000,,
com.microsoft.VSCode,0,1744379445,1744379445,1744379446.024481,-18000,,
com.google.Chrome,14,1744379431,1744379445,1744379445.410955,-18000,,
com.microsoft.VSCode,28,1744379403,1744379431,1744379431.837438,-18000,,
com.google.Chrome,37,1744379366,1744379403,1744379403.934513,-18000,,
com.apple.finder,1,1744379365,1744379366,1744379366.784699,-18000,,
com.instructure.icanvas,23,1744379320,1744379343,1744379344.98587,-18000,EB445137-D7F5-57EC-87DA-1DB460D64046,"iPhone13,2"
com.apple.CoreAuthUI,1,1744379310,1744379311,1744379312.248097,-18000,EB445137-D7F5-57EC-87DA-1DB460D64046,"iPhone13,2"
com.apple.journal,3,1744379308,1744379311,1744379312.065815,-18000,EB445137-D7F5-57EC-87DA-1DB460D64046,"iPhone13,2"
com.apple.MobileSMS,0,1744379308,1744379308,1744379309.113215,-18000,EB445137-D7F5-57EC-87DA-1DB460D64046,"iPhone13,2"
com.apple.MobileSMS,5,1744379293,1744379298,1744379298.81621,-18000,EB445137-D7F5-57EC-87DA-1DB460D64046,"iPhone13,2"
com.google.chrome.ios,13,1744379280,1744379293,1744379293.427631,-18000,EB445137-D7F5-57EC-87DA-1DB460D64046,"iPhone13,2"
com.apple.MobileSMS,3,1744379277,1744379280,1744379280.929101,-18000,EB445137-D7F5-57EC-87DA-1DB460D64046,"iPhone13,2"
com.renpho.health,0,1744379277,1744379277,1744379277.6857471,-18000,EB445137-D7F5-57EC-87DA-1DB460D64046,"iPhone13,2"
com.leomehlig.today,93,1744379272,1744379365,1744379365.294688,-18000,,
com.renpho.health,21,1744377533,1744377554,1744377555.576064,-18000,EB445137-D7F5-57EC-87DA-1DB460D64046,"iPhone13,2"
com.leomehlig.today,13,1744342400,1744342413,1744342414.224853,-18000,,
com.google.Chrome,2288,1744340112,1744342400,1744342400.952869,-18000,,
com.google.Chrome,660,1744338077,1744338737,1744338737.8789139,-18000,,
com.leomehlig.today,54,1744338023,1744338077,1744338078.56736,-18000,,
com.apple.finder,8,1744338015,1744338023,1744338024.050009,-18000,,
co.hinge.mobile.ios,85,1744336025,1744336110,1744336110.278945,-18000,EB445137-D7F5-57EC-87DA-1DB460D64046,"iPhone13,2"
com.instructure.icanvas,2,1744336020,1744336022,1744336022.3756099,-18000,EB445137-D7F5-57EC-87DA-1DB460D64046,"iPhone13,2"
com.instructure.icanvas,7,1744332442,1744332449,1744332450.187036,-18000,EB445137-D7F5-57EC-87DA-1DB460D64046,"iPhone13,2"
com.instructure.icanvas,3,1744332437,1744332440,1744332441.084594,-18000,EB445137-D7F5-57EC-87DA-1DB460D64046,"iPhone13,2"
com.google.chrome.ios,0,1744332437,1744332437,1744332438.5114598,-18000,EB445137-D7F5-57EC-87DA-1DB460D64046,"iPhone13,2"
com.google.chrome.ios,44,1744331992,1744332036,1744332037.833374,-18000,EB445137-D7F5-57EC-87DA-1DB460D64046,"iPhone13,2"
com.google.chrome.ios,75,1744331614,1744331689,1744331690.199459,-18000,EB445137-D7F5-57EC-87DA-1DB460D64046,"iPhone13,2"
com.apple.news,1,1744331613,1744331614,1744331614.7940001,-18000,EB445137-D7F5-57EC-87DA-1DB460D64046,"iPhone13,2"
com.apple.news,126,1744328267,1744328393,1744328393.411048,-18000,EB445137-D7F5-57EC-87DA-1DB460D64046,"iPhone13,2"
com.apple.news,95,1744327813,1744327908,1744327908.9143372,-18000,EB445137-D7F5-57EC-87DA-1DB460D64046,"iPhone13,2"
com.apple.news,57,1744327305,1744327362,1744327362.501487,-18000,EB445137-D7F5-57EC-87DA-1DB460D64046,"iPhone13,2"
com.apple.CoreAuthUI,4,1744326993,1744326997,1744326997.277098,-18000,EB445137-D7F5-57EC-87DA-1DB460D64046,"iPhone13,2"
com.robinhood.release.Robinhood,17,1744326992,1744327009,1744327009.0791879,-18000,EB445137-D7F5-57EC-87DA-1DB460D64046,"iPhone13,2"
com.apple.news,14,1744326967,1744326981,1744326982.08254,-18000,EB445137-D7F5-57EC-87DA-1DB460D64046,"iPhone13,2"
com.instructure.icanvas,7,1744326959,1744326966,1744326966.2433882,-18000,EB445137-D7F5-57EC-87DA-1DB460D64046,"iPhone13,2"
com.apple.news,104,1744326751,1744326855,1744326856.159188,-18000,EB445137-D7F5-57EC-87DA-1DB460D64046,"iPhone13,2"
com.apple.news,2,1744326717,1744326719,1744326719.573676,-18000,EB445137-D7F5-57EC-87DA-1DB460D64046,"iPhone13,2"
com.apple.news,88,1744326372,1744326460,1744326460.5939589,-18000,EB445137-D7F5-57EC-87DA-1DB460D64046,"iPhone13,2"
com.microsoft.Office.Outlook,2,1744325984,1744325986,1744325986.4111261,-18000,EB445137-D7F5-57EC-87DA-1DB460D64046,"iPhone13,2"
com.apple.finder,302,1744323645,1744323947,1744323947.185024,-18000,,
com.leomehlig.today,57,1744323588,1744323645,1744323645.176842,-18000,,
com.google.Chrome,36,1744323552,1744323588,1744323588.089767,-18000,,
com.leomehlig.today,195,1744323357,1744323552,1744323553.0044332,-18000,,
com.google.Chrome,1174,1744322183,1744323357,1744323358.037465,-18000,,
com.apple.findmy,15,1744322168,1744322183,1744322183.0559812,-18000,,
com.microsoft.Office.Outlook,7,1744322064,1744322071,1744322072.270732,-18000,EB445137-D7F5-57EC-87DA-1DB460D64046,"iPhone13,2"
com.google.Chrome,124,1744322044,1744322168,1744322168.989537,-18000,,
com.google.Chrome,371,1744321589,1744321960,1744321961.027941,-18000,,
com.google.Chrome,2509,1744318933,1744321442,1744321442.2969332,-18000,,
com.leomehlig.today,7,1744318926,1744318933,1744318933.090276,-18000,,
com.apple.finder,1,1744318925,1744318926,1744318926.9339352,-18000,,
com.apple.iCal,5,1744318920,1744318925,1744318925.648233,-18000,,
com.leomehlig.today,10,1744318910,1744318920,1744318920.056124,-18000,,
com.google.Chrome,8,1744318902,1744318910,1744318910.519115,-18000,,
com.leomehlig.today,19,1744318856,1744318875,1744318875.742268,-18000,,
com.google.Chrome,2,1744318854,1744318856,1744318859.9619598,-18000,,
com.apple.finder,0,1744318788,1744318788,1744318789.061287,-18000,,
com.google.Chrome,621,1744318167,1744318788,1744318788.399483,-18000,,
com.google.Chrome,162,1744316665,1744316827,1744316827.6568189,-18000,,
com.apple.Passwords,6,1744316659,1744316665,1744316665.965917,-18000,,
com.google.Chrome,2,1744316657,1744316659,1744316659.449222,-18000,,
com.apple.calculator,2,1744316655,1744316657,1744316657.431576,-18000,,
com.apple.calculator,303,1744315059,1744315362,1744315362.777372,-18000,,
com.google.Chrome,5,1744315054,1744315059,1744315059.520698,-18000,,
com.google.Chrome,301,1744312538,1744312839,1744312839.099307,-18000,,
com.google.Chrome,300,1744312237,1744312537,1744312537.976604,-18000,,
com.google.Chrome,318,1744311918,1744312236,1744312236.028898,-18000,,
com.google.Chrome,308,1744311519,1744311827,1744311827.688208,-18000,,
com.google.Chrome,4,1744310244,1744310248,1744310248.4689689,-18000,,
com.leomehlig.today,310,1744309934,1744310244,1744310244.118371,-18000,,
com.google.Chrome,109,1744309825,1744309934,1744309934.535851,-18000,,
com.apple.systempreferences,41,1744309784,1744309825,1744309825.920679,-18000,,
com.google.Chrome,11,1744309767,1744309778,1744309778.085763,-18000,,
com.apple.Passwords,7,1744309735,1744309742,1744309742.412046,-18000,,
com.google.Chrome,17,1744309718,1744309735,1744309735.257992,-18000,,
com.apple.iCal,68,1744309650,1744309718,1744309718.932087,-18000,,
com.google.Chrome,10,1744309640,1744309650,1744309650.269656,-18000,,
com.apple.iCal,17,1744309623,1744309640,1744309640.136187,-18000,,
com.google.Chrome,7,1744309616,1744309623,1744309623.520309,-18000,,
com.apple.iCal,62,1744309554,1744309616,1744309616.769473,-18000,,
com.google.Chrome,12,1744309542,1744309554,1744309554.840488,-18000,,
com.leomehlig.today,164,1744309378,1744309542,1744309542.614361,-18000,,
com.google.Chrome,196,1744309182,1744309378,1744309378.260281,-18000,,
com.google.Chrome,610,1744308565,1744309175,1744309175.994289,-18000,,
com.leomehlig.today,76,1744308489,1744308565,1744308565.1942801,-18000,,
com.google.Chrome,4,1744308485,1744308489,1744308490.027666,-18000,,
com.apple.finder,4,1744308278,1744308282,1744308282.74838,-18000,,
com.apple.Music,50,1744303835,1744303885,1744303885.758338,-18000,EB445137-D7F5-57EC-87DA-1DB460D64046,"iPhone13,2"
com.tinyspeck.chatlyio,2,1744303467,1744303469,1744303469.4447088,-18000,EB445137-D7F5-57EC-87DA-1DB460D64046,"iPhone13,2"
com.tinyspeck.chatlyio,26,1744303394,1744303420,1744303420.386932,-18000,EB445137-D7F5-57EC-87DA-1DB460D64046,"iPhone13,2"
com.microsoft.Office.Outlook,4,1744303368,1744303372,1744303372.318502,-18000,EB445137-D7F5-57EC-87DA-1DB460D64046,"iPhone13,2"
com.microsoft.Office.Outlook,52,1744303278,1744303330,1744303331.60696,-18000,EB445137-D7F5-57EC-87DA-1DB460D64046,"iPhone13,2"
com.apple.CoreAuthUI,2,1744303098,1744303100,1744303100.0710049,-18000,EB445137-D7F5-57EC-87DA-1DB460D64046,"iPhone13,2"
com.truebill.truebillnative,78,1744303094,1744303172,1744303173.047092,-18000,EB445137-D7F5-57EC-87DA-1DB460D64046,"iPhone13,2"
com.apple.Health,17,1744302809,1744302826,1744302826.805332,-18000,EB445137-D7F5-57EC-87DA-1DB460D64046,"iPhone13,2"
com.apple.news,2,1744302789,1744302791,1744302791.8265262,-18000,EB445137-D7F5-57EC-87DA-1DB460D64046,"iPhone13,2"
com.apple.news,131,1744302634,1744302765,1744302766.1931648,-18000,EB445137-D7F5-57EC-87DA-1DB460D64046,"iPhone13,2"
com.apple.CoreAuthUI,2,1744302605,1744302607,1744302607.933593,-18000,EB445137-D7F5-57EC-87DA-1DB460D64046,"iPhone13,2"
com.robinhood.release.Robinhood,31,1744302603,1744302634,1744302634.307112,-18000,EB445137-D7F5-57EC-87DA-1DB460D64046,"iPhone13,2"
com.apple.news,12,1744302590,1744302602,1744302603.156053,-18000,EB445137-D7F5-57EC-87DA-1DB460D64046,"iPhone13,2"
com.apple.finder,3,1744301371,1744301374,1744301374.9625359,-18000,,
com.leomehlig.today,1,1744301370,1744301371,1744301371.220368,-18000,,
com.apple.finder,38,1744301332,1744301370,1744301370.1459389,-18000,,
com.leomehlig.today,18,1744301314,1744301332,1744301332.841628,-18000,,
com.google.Chrome,47,1744301267,1744301314,1744301314.810641,-18000,,
com.apple.iCal,23,1744301132,1744301155,1744301155.232014,-18000,,
com.google.Chrome,234,1744300898,1744301132,1744301132.557664,-18000,,
com.leomehlig.today,16,1744300872,1744300888,1744300888.2570481,-18000,,
com.google.Chrome,27,1744300845,1744300872,1744300872.229364,-18000,,
co.hinge.mobile.ios,48,1744300554,1744300602,1744300602.8691401,-18000,EB445137-D7F5-57EC-87DA-1DB460D64046,"iPhone13,2"
com.microsoft.Office.Outlook,5,1744300489,1744300494,1744300494.637247,-18000,EB445137-D7F5-57EC-87DA-1DB460D64046,"iPhone13,2"
com.microsoft.Office.Outlook,10,1744300477,1744300487,1744300487.924706,-18000,EB445137-D7F5-57EC-87DA-1DB460D64046,"iPhone13,2"
com.instructure.icanvas,2,1744300442,1744300444,1744300444.557405,-18000,EB445137-D7F5-57EC-87DA-1DB460D64046,"iPhone13,2"
com.microsoft.VSCode,796,1744300049,1744300845,1744300846.855854,-18000,,
com.google.Chrome,111,1744299938,1744300049,1744300049.495006,-18000,,
com.leomehlig.today,4,1744299934,1744299938,1744299938.505902,-18000,,
com.microsoft.VSCode,2,1744299932,1744299934,1744299934.846354,-18000,,
com.leomehlig.today,7,1744299925,1744299932,1744299932.225905,-18000,,
com.microsoft.VSCode,2,1744299923,1744299925,1744299925.7502542,-18000,,
com.google.Chrome,122,1744299801,1744299923,1744299923.982676,-18000,,
com.apple.finder,2,1744299799,1744299801,1744299801.8855371,-18000,,
com.google.Chrome,2,1744299797,1744299799,1744299799.528263,-18000,,
com.apple.finder,0,1744299797,1744299797,1744299797.7982259,-18000,,
com.google.Chrome,58,1744299739,1744299797,1744299797.239616,-18000,,
com.apple.finder,4,1744299735,1744299739,1744299739.2680879,-18000,,
com.google.Chrome,1292,1744298443,1744299735,1744299735.434993,-18000,,
com.apple.finder,1,1744298442,1744298443,1744298443.4843311,-18000,,
com.google.Chrome,55,1744298387,1744298442,1744298442.489946,-18000,,
com.apple.finder,1,1744298386,1744298387,1744298387.947731,-18000,,
com.google.Chrome,448,1744297938,1744298386,1744298387.012495,-18000,,
com.apple.finder,1,1744297937,1744297938,1744297938.937525,-18000,,
com.google.Chrome,0,1744297937,1744297937,1744297937.616435,-18000,,
com.apple.finder,2,1744297935,1744297937,1744297937.269202,-18000,,
com.google.Chrome,1,1744297934,1744297935,1744297935.6469631,-18000,,
com.apple.finder,15,1744297919,1744297934,1744297934.882029,-18000,,
com.microsoft.VSCode,62,1744297857,1744297919,1744297919.458229,-18000,,
com.google.Chrome,27,1744297830,1744297857,1744297857.8431048,-18000,,
com.microsoft.VSCode,2,1744297828,1744297830,1744297830.7007608,-18000,,
com.google.Chrome,2,1744297826,1744297828,1744297828.1316261,-18000,,
com.microsoft.VSCode,118,1744297708,1744297826,1744297826.4940991,-18000,,
com.apple.finder,115,1744297593,1744297708,1744297708.2879791,-18000,,
com.google.Chrome,25,1744297568,1744297593,1744297593.715966,-18000,,
com.apple.finder,2,1744297566,1744297568,1744297568.6145759,-18000,,
com.google.Chrome,2,1744297564,1744297566,1744297566.750362,-18000,,
com.apple.finder,8,1744297556,1744297564,1744297564.074002,-18000,,
com.google.Chrome,5,1744297551,1744297556,1744297556.18849,-18000,,
com.apple.finder,2,1744297549,1744297551,1744297551.387635,-18000,,
com.google.Chrome,4,1744297545,1744297549,1744297549.38279,-18000,,
com.apple.finder,4,1744297541,1744297545,1744297545.8395329,-18000,,
com.google.Chrome,1,1744297540,1744297541,1744297541.740076,-18000,,
com.microsoft.VSCode,7,1744297533,1744297540,1744297540.972995,-18000,,
com.apple.finder,6,1744297527,1744297533,1744297533.059511,-18000,,
com.microsoft.VSCode,1,1744297526,1744297527,1744297528.022598,-18000,,
com.google.Chrome,4,1744297522,1744297526,1744297526.539592,-18000,,
com.microsoft.VSCode,1,1744297521,1744297522,1744297522.5238729,-18000,,
com.google.Chrome,0,1744297521,1744297521,1744297522.001811,-18000,,
com.microsoft.VSCode,5,1744297516,1744297521,1744297521.131609,-18000,,
com.google.Chrome,1,1744297515,1744297516,1744297516.235151,-18000,,
com.microsoft.VSCode,26,1744297489,1744297515,1744297515.213252,-18000,,
com.google.Chrome,14,1744297475,1744297489,1744297489.758006,-18000,,
com.microsoft.VSCode,29,1744297446,1744297475,1744297475.665543,-18000,,
com.google.Chrome,4,1744297442,1744297446,1744297446.383984,-18000,,
com.microsoft.VSCode,13,1744297429,1744297442,1744297442.781312,-18000,,
com.google.Chrome,1,1744297428,1744297429,1744297429.203749,-18000,,
com.microsoft.VSCode,3,1744297425,1744297428,1744297428.6645222,-18000,,
com.google.Chrome,216,1744297209,1744297425,1744297426.0047522,-18000,,
com.apple.finder,5,1744297204,1744297209,1744297209.615557,-18000,,
com.google.Chrome,563,1744296641,1744297204,1744297204.182674,-18000,,
com.apple.finder,4,1744296637,1744296641,1744296641.9359288,-18000,,
com.google.Chrome,11,1744296626,1744296637,1744296637.783094,-18000,,
com.apple.finder,2,1744296624,1744296626,1744296626.070613,-18000,,
com.google.Chrome,51,1744296573,1744296624,1744296624.750411,-18000,,
com.apple.finder,3,1744296570,1744296573,1744296573.6996288,-18000,,
com.google.Chrome,30,1744296540,1744296570,1744296570.896117,-18000,,
com.apple.Preview,35,1744296505,1744296540,1744296540.249556,-18000,,
com.apple.finder,6,1744296499,1744296505,1744296505.972445,-18000,,
com.google.Chrome,37,1744296462,1744296499,1744296499.593153,-18000,,
com.apple.finder,3,1744296459,1744296462,1744296462.5106192,-18000,,
com.google.Chrome,0,1744296459,1744296459,1744296460.017108,-18000,,
com.microsoft.VSCode,1,1744296458,1744296459,1744296459.246336,-18000,,
com.google.Chrome,15,1744296443,1744296458,1744296458.3832622,-18000,,
com.apple.finder,2,1744296441,1744296443,1744296443.933172,-18000,,
com.google.Chrome,1,1744296440,1744296441,1744296441.057413,-18000,,
com.apple.finder,12,1744296428,1744296440,1744296440.4261498,-18000,,
com.microsoft.VSCode,17,1744296411,1744296428,1744296428.419224,-18000,,
com.google.Chrome,18,1744296393,1744296411,1744296411.937131,-18000,,
com.apple.Notes,8,1744296385,1744296393,1744296393.068784,-18000,,
com.google.Chrome,95,1744296290,1744296385,1744296385.6070561,-18000,,
com.apple.Notes,6,1744296284,1744296290,1744296290.780167,-18000,,
com.google.Chrome,18,1744296266,1744296284,1744296284.484304,-18000,,
com.apple.Notes,7,1744296259,1744296266,1744296266.559701,-18000,,
com.google.Chrome,191,1744296068,1744296259,1744296259.327482,-18000,,
com.apple.Notes,2,1744296066,1744296068,1744296068.1574779,-18000,,
com.google.Chrome,17,1744296049,1744296066,1744296066.237225,-18000,,
com.apple.Notes,3,1744296046,1744296049,1744296049.831382,-18000,,
com.google.Chrome,6,1744296040,1744296046,1744296046.374361,-18000,,
com.apple.Notes,21,1744296019,1744296040,1744296040.249179,-18000,,
com.google.Chrome,4,1744296015,1744296019,1744296019.394109,-18000,,
com.apple.Notes,3,1744296012,1744296015,1744296015.969706,-18000,,
com.google.Chrome,238,1744295774,1744296012,1744296012.1422482,-18000,,
com.apple.Notes,79,1744295695,1744295774,1744295774.0720348,-18000,,
com.google.Chrome,8,1744295687,1744295695,1744295695.117243,-18000,,
com.microsoft.VSCode,3,1744295684,1744295687,1744295687.6304479,-18000,,
com.google.Chrome,74,1744295610,1744295684,1744295684.9573169,-18000,,
com.apple.finder,0,1744295610,1744295610,1744295611.0351949,-18000,,
com.google.Chrome,0,1744295610,1744295610,1744295610.759207,-18000,,
com.apple.finder,2,1744295608,1744295610,1744295610.170182,-18000,,
com.google.Chrome,43,1744295565,1744295608,1744295608.0897698,-18000,,
com.apple.finder,4,1744295561,1744295565,1744295565.080752,-18000,,
com.google.Chrome,13,1744295548,1744295561,1744295561.10292,-18000,,
com.apple.finder,16,1744295532,1744295548,1744295548.9700232,-18000,,
com.google.Chrome,1,1744295531,1744295532,1744295533.033854,-18000,,
com.apple.finder,8,1744295523,1744295531,1744295531.695115,-18000,,
com.google.Chrome,16,1744295507,1744295523,1744295523.555305,-18000,,
com.apple.finder,10,1744295497,1744295507,1744295507.196399,-18000,,
com.google.Chrome,7,1744295490,1744295497,1744295497.63763,-18000,,
com.apple.finder,3,1744295487,1744295490,1744295490.8922281,-18000,,
com.google.Chrome,9,1744295478,1744295487,1744295487.694058,-18000,,
com.apple.finder,20,1744295458,1744295478,1744295478.202013,-18000,,
com.google.Chrome,45,1744295413,1744295458,1744295458.436487,-18000,,
com.apple.finder,8,1744295405,1744295413,1744295413.4439921,-18000,,
com.google.Chrome,18,1744295387,1744295405,1744295405.581285,-18000,,
com.apple.finder,38,1744295349,1744295387,1744295387.74155,-18000,,
com.google.Chrome,213,1744295136,1744295349,1744295349.891109,-18000,,
com.apple.finder,1,1744295135,1744295136,1744295136.902616,-18000,,
com.microsoft.VSCode,1,1744295134,1744295135,1744295135.8708959,-18000,,
com.google.Chrome,15,1744295119,1744295134,1744295134.230874,-18000,,
com.apple.finder,2,1744295117,1744295119,1744295119.228181,-18000,,
com.google.Chrome,18,1744295099,1744295117,1744295117.452352,-18000,,
com.apple.finder,13,1744295086,1744295099,1744295099.377034,-18000,,
com.google.Chrome,42,1744295044,1744295086,1744295086.2708678,-18000,,
com.microsoft.VSCode,41,1744295003,1744295044,1744295044.327095,-18000,,
com.google.Chrome,420,1744294583,1744295003,1744295003.829056,-18000,,
com.apple.finder,36,1744294547,1744294583,1744294583.632256,-18000,,
com.google.Chrome,10,1744294537,1744294547,1744294547.8994331,-18000,,
com.microsoft.VSCode,1,1744294536,1744294537,1744294537.7608418,-18000,,
com.google.Chrome,124,1744294412,1744294536,1744294536.784019,-18000,,
com.microsoft.VSCode,1,1744294411,1744294412,1744294412.6790051,-18000,,
com.google.Chrome,128,1744294283,1744294411,1744294411.158777,-18000,,
com.microsoft.VSCode,18,1744294265,1744294283,1744294284.024997,-18000,,
com.google.Chrome,199,1744294066,1744294265,1744294265.190586,-18000,,
com.microsoft.VSCode,157,1744293909,1744294066,1744294066.1284308,-18000,,
com.google.Chrome,48,1744293861,1744293909,1744293909.6562119,-18000,,
com.apple.Notes,44,1744293817,1744293861,1744293861.978152,-18000,,
com.google.Chrome,169,1744293648,1744293817,1744293817.565759,-18000,,
com.microsoft.VSCode,13,1744293635,1744293648,1744293648.248033,-18000,,
com.google.Chrome,2,1744293633,1744293635,1744293635.464417,-18000,,
com.microsoft.VSCode,29,1744293604,1744293633,1744293633.403105,-18000,,
com.google.Chrome,19,1744293585,1744293604,1744293604.596336,-18000,,
com.microsoft.VSCode,88,1744293497,1744293585,1744293585.883219,-18000,,
com.google.Chrome,2,1744293495,1744293497,1744293497.975247,-18000,,
com.microsoft.VSCode,3,1744293492,1744293495,1744293495.795446,-18000,,
com.google.Chrome,108,1744293384,1744293492,1744293492.8521729,-18000,,
com.microsoft.VSCode,1,1744293383,1744293384,1744293384.9301891,-18000,,
com.google.Chrome,25,1744293358,1744293383,1744293383.544261,-18000,,
com.microsoft.VSCode,0,1744293358,1744293358,1744293358.554066,-18000,,
com.google.Chrome,3,1744293355,1744293358,1744293358.15483,-18000,,
com.microsoft.VSCode,1,1744293354,1744293355,1744293355.670776,-18000,,
com.apple.finder,1,1744293353,1744293354,1744293354.2860188,-18000,,
com.microsoft.VSCode,3,1744293350,1744293353,1744293353.216138,-18000,,
com.google.Chrome,25,1744293325,1744293350,1744293350.682153,-18000,,
com.microsoft.VSCode,6,1744293319,1744293325,1744293325.923728,-18000,,
com.google.Chrome,17,1744293302,1744293319,1744293319.116251,-18000,,
com.microsoft.VSCode,9,1744293293,1744293302,1744293302.1063519,-18000,,
com.google.Chrome,19,1744293274,1744293293,1744293293.585316,-18000,,
com.microsoft.VSCode,5,1744293269,1744293274,1744293274.912497,-18000,,
com.google.Chrome,5,1744293264,1744293269,1744293269.701007,-18000,,
com.microsoft.VSCode,4,1744293260,1744293264,1744293264.492628,-18000,,
com.google.Chrome,94,1744293166,1744293260,1744293260.902001,-18000,,
com.microsoft.VSCode,21,1744293145,1744293166,1744293166.704571,-18000,,
com.google.Chrome,54,1744293091,1744293145,1744293145.653518,-18000,,
com.apple.finder,58,1744293033,1744293091,1744293091.369304,-18000,,
com.google.Chrome,100,1744292933,1744293033,1744293033.265207,-18000,,
com.apple.finder,1,1744292932,1744292933,1744292934.073643,-18000,,
com.google.Chrome,1,1744292931,1744292932,1744292932.8049011,-18000,,
com.apple.finder,3,1744292928,1744292931,1744292931.178319,-18000,,
com.microsoft.VSCode,3,1744292925,1744292928,1744292928.140053,-18000,,
com.apple.finder,4,1744292921,1744292925,1744292925.343821,-18000,,
com.microsoft.VSCode,5,1744292916,1744292921,1744292921.693264,-18000,,
com.google.Chrome,17,1744292899,1744292916,1744292916.703874,-18000,,
com.apple.finder,8,1744292891,1744292899,1744292899.7174249,-18000,,
com.google.Chrome,1,1744292890,1744292891,1744292891.855506,-18000,,
com.apple.finder,4,1744292886,1744292890,1744292890.440521,-18000,,
com.google.Chrome,3,1744292883,1744292886,1744292886.131264,-18000,,
com.microsoft.VSCode,29,1744292854,1744292883,1744292883.2028608,-18000,,
com.apple.finder,9,1744292845,1744292854,1744292854.6253119,-18000,,
com.microsoft.VSCode,21,1744292824,1744292845,1744292845.183179,-18000,,
com.google.Chrome,1,1744292823,1744292824,1744292824.903486,-18000,,
com.microsoft.VSCode,2,1744292821,1744292823,1744292823.497057,-18000,,
com.google.Chrome,6,1744292815,1744292821,1744292821.240841,-18000,,
com.microsoft.VSCode,1,1744292814,1744292815,1744292815.59886,-18000,,
com.apple.finder,41,1744292773,1744292814,1744292814.662434,-18000,,
com.microsoft.VSCode,26,1744292747,1744292773,1744292773.3147721,-18000,,
com.google.Chrome,6,1744292741,1744292747,1744292747.108556,-18000,,
com.microsoft.VSCode,7,1744292734,1744292741,1744292741.6041188,-18000,,
com.google.Chrome,2,1744292732,1744292734,1744292734.204952,-18000,,
com.microsoft.VSCode,13,1744292719,1744292732,1744292732.765222,-18000,,
com.google.Chrome,9,1744292710,1744292719,1744292719.2740622,-18000,,
com.microsoft.VSCode,2,1744292708,1744292710,1744292710.310875,-18000,,
com.google.Chrome,2,1744292706,1744292708,1744292709.047054,-18000,,
com.microsoft.VSCode,69,1744292637,1744292706,1744292706.51407,-18000,,
com.google.Chrome,3,1744292634,1744292637,1744292638.03155,-18000,,
com.microsoft.VSCode,26,1744292608,1744292634,1744292634.2510772,-18000,,
com.google.Chrome,112,1744292496,1744292608,1744292608.687928,-18000,,
com.apple.finder,7,1744292489,1744292496,1744292496.660744,-18000,,
com.leomehlig.today,11,1744292478,1744292489,1744292489.8555799,-18000,,
com.google.Chrome,217,1744292261,1744292478,1744292479.1010861,-18000,,
com.instructure.icanvas,7,1744292128,1744292135,1744292135.914859,-18000,EB445137-D7F5-57EC-87DA-1DB460D64046,"iPhone13,2"
com.instructure.icanvas,102,1744292024,1744292126,1744292126.536464,-18000,EB445137-D7F5-57EC-87DA-1DB460D64046,"iPhone13,2"
com.apple.news,1393,1744290624,1744292017,1744292017.711118,-18000,EB445137-D7F5-57EC-87DA-1DB460D64046,"iPhone13,2"
com.apple.CoreAuthUI,3,1744290573,1744290576,1744290576.955638,-18000,EB445137-D7F5-57EC-87DA-1DB460D64046,"iPhone13,2"
com.robinhood.release.Robinhood,47,1744290569,1744290616,1744290616.4849548,-18000,EB445137-D7F5-57EC-87DA-1DB460D64046,"iPhone13,2"
com.apple.Health,40,1744290510,1744290550,1744290550.858546,-18000,EB445137-D7F5-57EC-87DA-1DB460D64046,"iPhone13,2"
com.instructure.icanvas,2,1744290507,1744290509,1744290509.045584,-18000,EB445137-D7F5-57EC-87DA-1DB460D64046,"iPhone13,2"
com.instructure.icanvas,32,1744290463,1744290495,1744290495.116901,-18000,EB445137-D7F5-57EC-87DA-1DB460D64046,"iPhone13,2"
com.renpho.health,0,1744290463,1744290463,1744290463.937695,-18000,EB445137-D7F5-57EC-87DA-1DB460D64046,"iPhone13,2"
com.renpho.health,28,1744289786,1744289814,1744289815.10133,-18000,EB445137-D7F5-57EC-87DA-1DB460D64046,"iPhone13,2"
com.apple.weather,19,1744288310,1744288329,1744288329.687537,-18000,EB445137-D7F5-57EC-87DA-1DB460D64046,"iPhone13,2"
com.thestorygraph.thestorygraph,31,1744255799,1744255830,1744255830.6324291,-18000,EB445137-D7F5-57EC-87DA-1DB460D64046,"iPhone13,2"
com.letterboxd.LetterboxdApp,2,1744255797,1744255799,1744255799.296029,-18000,EB445137-D7F5-57EC-87DA-1DB460D64046,"iPhone13,2"
com.google.chrome.ios,30,1744255767,1744255797,1744255797.559833,-18000,EB445137-D7F5-57EC-87DA-1DB460D64046,"iPhone13,2"
com.apple.Music,1,1744255766,1744255767,1744255768.044626,-18000,EB445137-D7F5-57EC-87DA-1DB460D64046,"iPhone13,2"
com.google.Chrome,386,1744253335,1744253721,1744253721.163023,-18000,,
com.apple.finder,103,1744253232,1744253335,1744253335.441914,-18000,,
com.leomehlig.today,1,1744253231,1744253232,1744253232.169666,-18000,,
com.apple.finder,2,1744253229,1744253231,1744253231.6017761,-18000,,
com.microsoft.VSCode,3,1744253226,1744253229,1744253229.8276,-18000,,
com.google.Chrome,5,1744253221,1744253226,1744253226.948228,-18000,,
com.apple.finder,1,1744253220,1744253221,1744253221.240797,-18000,,
com.google.Chrome,52,1744253168,1744253220,1744253220.8237882,-18000,,
com.apple.finder,10,1744253158,1744253168,1744253169.003491,-18000,,
com.google.Chrome,1,1744253157,1744253158,1744253158.821186,-18000,,
com.apple.finder,1,1744253156,1744253157,1744253157.871655,-18000,,
com.google.Chrome,5,1744253151,1744253156,1744253156.2253342,-18000,,
com.apple.finder,0,1744253151,1744253151,1744253152.0433521,-18000,,
com.google.Chrome,2,1744253149,1744253151,1744253151.309095,-18000,,
com.microsoft.VSCode,1,1744253148,1744253149,1744253149.828732,-18000,,
com.apple.finder,4,1744253144,1744253148,1744253148.928894,-18000,,
com.microsoft.VSCode,11,1744253133,1744253144,1744253144.786893,-18000,,
com.apple.finder,5,1744253128,1744253133,1744253133.963001,-18000,,
com.microsoft.VSCode,41,1744253087,1744253128,1744253128.053911,-18000,,
com.google.Chrome,4,1744253083,1744253087,1744253087.70385,-18000,,
com.microsoft.VSCode,6,1744253077,1744253083,1744253083.514575,-18000,,
com.google.Chrome,5,1744253072,1744253077,1744253077.3441582,-18000,,
com.microsoft.VSCode,11,1744253061,1744253072,1744253072.114633,-18000,,
com.google.Chrome,44,1744253017,1744253061,1744253061.804875,-18000,,
com.apple.finder,5,1744253012,1744253017,1744253017.892622,-18000,,
com.google.Chrome,2,1744253010,1744253012,1744253012.723269,-18000,,
com.microsoft.VSCode,1,1744253009,1744253010,1744253010.679295,-18000,,
com.apple.Music,13,1744252936,1744252949,1744252949.9310899,-18000,EB445137-D7F5-57EC-87DA-1DB460D64046,"iPhone13,2"
com.apple.Music,22,1744252090,1744252112,1744252113.226808,-18000,EB445137-D7F5-57EC-87DA-1DB460D64046,"iPhone13,2"
com.microsoft.VSCode,350,1744251922,1744252272,1744252272.836351,-18000,,
com.google.Chrome,12,1744251855,1744251867,1744251867.611792,-18000,,
com.microsoft.VSCode,9,1744251846,1744251855,1744251855.7589378,-18000,,
com.google.Chrome,209,1744251637,1744251846,1744251846.4720302,-18000,,
com.apple.finder,5,1744251632,1744251637,1744251637.104648,-18000,,
com.google.Chrome,2,1744251630,1744251632,1744251632.323472,-18000,,
com.microsoft.VSCode,3,1744251627,1744251630,1744251630.958606,-18000,,
com.microsoft.VSCode,310,1744251149,1744251459,1744251459.8370318,-18000,,
com.leomehlig.today,3,1744251146,1744251149,1744251150.044842,-18000,,
com.leomehlig.today,314,1744250471,1744250785,1744250785.6039162,-18000,,
com.microsoft.VSCode,1,1744250470,1744250471,1744250471.497342,-18000,,
com.apple.Notes,1,1744250469,1744250470,1744250470.867072,-18000,,
com.microsoft.VSCode,4,1744250465,1744250469,1744250469.413014,-18000,,
com.google.Chrome,35,1744250430,1744250465,1744250465.670014,-18000,,
com.apple.Notes,5,1744250425,1744250430,1744250430.571203,-18000,,
com.google.Chrome,180,1744250245,1744250425,1744250425.6091828,-18000,,
com.microsoft.VSCode,11,1744250234,1744250245,1744250245.68226,-18000,,
com.google.Chrome,8,1744250226,1744250234,1744250234.479677,-18000,,
com.microsoft.VSCode,7,1744250219,1744250226,1744250226.835281,-18000,,
com.google.Chrome,7,1744250212,1744250219,1744250219.105542,-18000,,
com.microsoft.VSCode,1,1744250211,1744250212,1744250212.2872849,-18000,,
com.google.Chrome,5,1744250206,1744250211,1744250211.265043,-18000,,
com.microsoft.VSCode,5,1744250201,1744250206,1744250206.127203,-18000,,
com.google.Chrome,7,1744250194,1744250201,1744250201.919167,-18000,,
com.microsoft.VSCode,91,1744250103,1744250194,1744250194.99704,-18000,,
com.google.Chrome,79,1744250024,1744250103,1744250103.675144,-18000,,
com.apple.finder,2,1744250022,1744250024,1744250024.458003,-18000,,
com.google.Chrome,0,1744250022,1744250022,1744250023.056013,-18000,,
com.apple.finder,11,1744250011,1744250022,1744250022.516119,-18000,,
com.microsoft.VSCode,6,1744250005,1744250011,1744250011.463515,-18000,,
com.apple.finder,17,1744249988,1744250005,1744250005.3367271,-18000,,
com.microsoft.VSCode,17,1744249971,1744249988,1744249988.124671,-18000,,
com.google.Chrome,75,1744249896,1744249971,1744249972.025224,-18000,,
com.microsoft.VSCode,1,1744249881,1744249882,1744249882.534995,-18000,,
com.leomehlig.today,5,1744249876,1744249881,1744249881.1058779,-18000,,
com.microsoft.VSCode,4,1744249872,1744249876,1744249876.8498769,-18000,,
com.google.Chrome,210,1744249662,1744249872,1744249872.486054,-18000,,
com.microsoft.VSCode,1,1744249661,1744249662,1744249662.879926,-18000,,
com.google.Chrome,564,1744249097,1744249661,1744249661.8350391,-18000,,
com.microsoft.VSCode,3,1744249094,1744249097,1744249097.895772,-18000,,
com.google.Chrome,6,1744249088,1744249094,1744249094.739564,-18000,,
com.microsoft.VSCode,1,1744249087,1744249088,1744249088.277618,-18000,,
com.google.Chrome,30,1744249057,1744249087,1744249087.62619,-18000,,
com.microsoft.VSCode,67,1744248990,1744249057,1744249057.7092729,-18000,,
com.google.Chrome,101,1744248889,1744248990,1744248990.53549,-18000,,
com.apple.Notes,26,1744248863,1744248889,1744248889.5635018,-18000,,
com.apple.Preview,85,1744248778,1744248863,1744248863.8660789,-18000,,
com.apple.finder,11,1744248767,1744248778,1744248778.802055,-18000,,
com.apple.Preview,1,1744248766,1744248767,1744248767.875679,-18000,,
com.apple.finder,74,1744248692,1744248766,1744248766.477816,-18000,,
com.google.Chrome,1,1744248691,1744248692,1744248692.394203,-18000,,
com.microsoft.VSCode,6,1744248685,1744248691,1744248691.3574271,-18000,,
com.google.Chrome,5,1744248680,1744248685,1744248685.792925,-18000,,
com.apple.Notes,2,1744248678,1744248680,1744248680.786117,-18000,,
com.microsoft.VSCode,2,1744248676,1744248678,1744248678.238772,-18000,,
com.google.Chrome,138,1744248538,1744248676,1744248677.0381021,-18000,,
com.apple.finder,9,1744248529,1744248538,1744248538.672021,-18000,,
com.google.Chrome,1,1744248528,1744248529,1744248529.816471,-18000,,
com.apple.finder,2,1744248526,1744248528,1744248528.694134,-18000,,
com.google.Chrome,7,1744248519,1744248526,1744248527.024969,-18000,,
com.apple.finder,2,1744248517,1744248519,1744248519.312615,-18000,,
com.microsoft.VSCode,32,1744248485,1744248517,1744248517.271006,-18000,,
com.apple.finder,1,1744248484,1744248485,1744248485.998955,-18000,,
com.google.Chrome,4,1744248480,1744248484,1744248484.795096,-18000,,
com.apple.finder,19,1744248461,1744248480,1744248480.977895,-18000,,
com.microsoft.VSCode,5,1744248456,1744248461,1744248461.365734,-18000,,
com.apple.finder,13,1744248443,1744248456,1744248456.8772578,-18000,,
com.microsoft.VSCode,28,1744248415,1744248443,1744248443.924659,-18000,,
com.apple.finder,21,1744248394,1744248415,1744248415.922779,-18000,,
com.microsoft.VSCode,18,1744248376,1744248394,1744248394.472951,-18000,,
com.apple.finder,7,1744248369,1744248376,1744248376.8006558,-18000,,
com.microsoft.VSCode,144,1744248225,1744248369,1744248369.786669,-18000,,
com.apple.finder,23,1744248202,1744248225,1744248225.121447,-18000,,
com.microsoft.VSCode,4,1744248198,1744248202,1744248202.797616,-18000,,
com.google.Chrome,33,1744248165,1744248198,1744248198.3184252,-18000,,
com.microsoft.VSCode,8,1744248157,1744248165,1744248165.160814,-18000,,
com.google.Chrome,13,1744248144,1744248157,1744248157.228143,-18000,,
com.microsoft.VSCode,5,1744248139,1744248144,1744248144.440655,-18000,,
com.apple.Dictionary,1,1744248138,1744248139,1744248140.0017,-18000,,
com.microsoft.VSCode,6,1744248132,1744248138,1744248138.258321,-18000,,
com.apple.Preview,19,1744248113,1744248132,1744248132.814107,-18000,,
com.microsoft.VSCode,21,1744248092,1744248113,1744248113.147795,-18000,,
com.apple.Preview,22,1744248070,1744248092,1744248092.231639,-18000,,
com.apple.finder,10,1744248060,1744248070,1744248070.971581,-18000,,
com.apple.Preview,7,1744248053,1744248060,1744248060.320771,-18000,,
com.apple.finder,9,1744248044,1744248053,1744248053.714849,-18000,,
com.microsoft.VSCode,108,1744247936,1744248044,1744248044.721519,-18000,,
com.apple.finder,63,1744247873,1744247936,1744247936.779076,-18000,,
com.microsoft.VSCode,7,1744247866,1744247873,1744247873.074543,-18000,,
com.apple.finder,4,1744247862,1744247866,1744247866.375998,-18000,,
com.microsoft.VSCode,14,1744247848,1744247862,1744247862.258987,-18000,,
com.apple.finder,12,1744247836,1744247848,1744247848.1822948,-18000,,
com.microsoft.VSCode,19,1744247817,1744247836,1744247836.604532,-18000,,
com.apple.finder,29,1744247788,1744247817,1744247817.0851521,-18000,,
com.microsoft.VSCode,43,1744247745,1744247788,1744247788.4368,-18000,,
com.apple.finder,2,1744247743,1744247745,1744247745.085149,-18000,,
com.microsoft.VSCode,18,1744247725,1744247743,1744247743.693503,-18000,,
com.apple.finder,8,1744247717,1744247725,1744247725.7509599,-18000,,
com.microsoft.VSCode,6,1744247711,1744247717,1744247717.927833,-18000,,
com.apple.finder,3,1744247708,1744247711,1744247711.352278,-18000,,
com.microsoft.VSCode,4,1744247704,1744247708,1744247708.203021,-18000,,
com.apple.finder,1,1744247703,1744247704,1744247704.452419,-18000,,
com.microsoft.VSCode,5,1744247698,1744247703,1744247703.62538,-18000,,
com.apple.finder,4,1744247694,1744247698,1744247698.765214,-18000,,
com.microsoft.VSCode,3,1744247691,1744247694,1744247694.54249,-18000,,
com.apple.finder,21,1744247670,1744247691,1744247691.180488,-18000,,
com.microsoft.VSCode,9,1744247661,1744247670,1744247670.257118,-18000,,
com.apple.finder,1,1744247660,1744247661,1744247662.031024,-18000,,
com.microsoft.VSCode,2,1744247658,1744247660,1744247660.918756,-18000,,
com.apple.finder,5,1744247653,1744247658,1744247659.051907,-18000,,
com.microsoft.VSCode,2,1744247651,1744247653,1744247654.006475,-18000,,
com.google.Chrome,1,1744247650,1744247651,1744247651.6510038,-18000,,
com.apple.Notes,2,1744247648,1744247650,1744247650.034358,-18000,,
com.microsoft.VSCode,22,1744247626,1744247648,1744247649.0199242,-18000,,
com.apple.Notes,2,1744247624,1744247626,1744247626.082197,-18000,,
com.google.Chrome,1,1744247623,1744247624,1744247624.9238439,-18000,,
com.apple.finder,8,1744247615,1744247623,1744247623.7630281,-18000,,
com.google.Chrome,16,1744247599,1744247615,1744247615.373334,-18000,,
com.apple.finder,32,1744247567,1744247599,1744247599.156188,-18000,,
com.microsoft.VSCode,2,1744247565,1744247567,1744247567.856698,-18000,,
com.apple.finder,3,1744247562,1744247565,1744247565.6062288,-18000,,
com.microsoft.VSCode,51,1744247511,1744247562,1744247562.205594,-18000,,
com.apple.finder,55,1744247456,1744247511,1744247511.465889,-18000,,
com.microsoft.VSCode,2,1744247454,1744247456,1744247456.7565641,-18000,,
com.apple.finder,5,1744247449,1744247454,1744247454.219274,-18000,,
com.microsoft.VSCode,17,1744247432,1744247449,1744247449.8752398,-18000,,
com.apple.finder,13,1744247419,1744247432,1744247432.593412,-18000,,
com.google.Chrome,2,1744247417,1744247419,1744247419.308151,-18000,,
com.microsoft.VSCode,33,1744247384,1744247417,1744247417.201735,-18000,,
com.apple.finder,20,1744247364,1744247384,1744247384.9568748,-18000,,
com.microsoft.VSCode,23,1744247341,1744247364,1744247364.535568,-18000,,
com.apple.finder,6,1744247335,1744247341,1744247341.2239242,-18000,,
com.microsoft.VSCode,58,1744247277,1744247335,1744247335.28375,-18000,,
com.google.Chrome,13,1744247264,1744247277,1744247277.571801,-18000,,
com.microsoft.VSCode,13,1744247251,1744247264,1744247264.49047,-18000,,
com.apple.finder,5,1744247246,1744247251,1744247251.246388,-18000,,
com.microsoft.VSCode,11,1744247235,1744247246,1744247246.640835,-18000,,
com.apple.finder,1,1744247234,1744247235,1744247235.2084808,-18000,,
com.google.Chrome,3,1744247231,1744247234,1744247234.228959,-18000,,
com.apple.finder,22,1744247209,1744247231,1744247231.339705,-18000,,
com.microsoft.VSCode,29,1744247180,1744247209,1744247209.562625,-18000,,
com.google.Chrome,31,1744247149,1744247180,1744247180.8948069,-18000,,
com.microsoft.VSCode,7,1744247142,1744247149,1744247149.47488,-18000,,
com.apple.finder,7,1744247135,1744247142,1744247143.010776,-18000,,
com.microsoft.VSCode,15,1744247120,1744247135,1744247135.772509,-18000,,
com.apple.finder,39,1744247081,1744247120,1744247120.435874,-18000,,
com.microsoft.VSCode,6,1744247075,1744247081,1744247081.707549,-18000,,
com.google.Chrome,6,1744247069,1744247075,1744247075.752544,-18000,,
com.microsoft.VSCode,4,1744247065,1744247069,1744247069.957467,-18000,,
com.google.Chrome,3,1744247062,1744247065,1744247065.739111,-18000,,
com.microsoft.VSCode,2,1744247060,1744247062,1744247062.831499,-18000,,
com.google.Chrome,3,1744247057,1744247060,1744247060.048007,-18000,,
com.microsoft.VSCode,3,1744247054,1744247057,1744247057.254939,-18000,,
com.google.Chrome,4,1744247050,1744247054,1744247054.8026671,-18000,,
com.microsoft.VSCode,3,1744247047,1744247050,1744247050.139512,-18000,,
com.google.Chrome,3,1744247044,1744247047,1744247047.8839312,-18000,,
com.microsoft.VSCode,3,1744247041,1744247044,1744247044.628694,-18000,,
com.google.Chrome,43,1744246998,1744247041,1744247041.0769482,-18000,,
com.microsoft.VSCode,2,1744246996,1744246998,1744246998.682239,-18000,,
com.google.Chrome,4,1744246992,1744246996,1744246996.0419168,-18000,,
com.microsoft.VSCode,35,1744246957,1744246992,1744246992.033737,-18000,,
com.google.Chrome,8,1744246949,1744246957,1744246957.636756,-18000,,
com.apple.Notes,8,1744246941,1744246949,1744246949.783674,-18000,,
com.google.Chrome,12,1744246929,1744246941,1744246941.233422,-18000,,
com.microsoft.VSCode,72,1744246857,1744246929,1744246929.349345,-18000,,
com.google.Chrome,5,1744246852,1744246857,1744246857.642765,-18000,,
com.microsoft.VSCode,11,1744246841,1744246852,1744246852.357205,-18000,,
com.google.Chrome,81,1744246760,1744246841,1744246841.155232,-18000,,
com.microsoft.VSCode,84,1744246676,1744246760,1744246760.874673,-18000,,
com.google.Chrome,27,1744246649,1744246676,1744246677.015812,-18000,,
com.apple.finder,4,1744246645,1744246649,1744246650.0785441,-18000,,
com.leomehlig.today,11,1744246634,1744246645,1744246645.382721,-18000,,
com.apple.Preferences,44,1744246446,1744246490,1744246490.1587849,-18000,EB445137-D7F5-57EC-87DA-1DB460D64046,"iPhone13,2"
com.apple.CoreAuthUI,2,1744246358,1744246360,1744246360.970676,-18000,EB445137-D7F5-57EC-87DA-1DB460D64046,"iPhone13,2"
com.robinhood.release.Robinhood,37,1744246355,1744246392,1744246392.4411411,-18000,EB445137-D7F5-57EC-87DA-1DB460D64046,"iPhone13,2"
com.apple.news,30,1744246321,1744246351,1744246351.2848449,-18000,EB445137-D7F5-57EC-87DA-1DB460D64046,"iPhone13,2"
com.leomehlig.today,300,1744246290,1744246590,1744246590.21915,-18000,,
com.apple.Notes,2,1744246288,1744246290,1744246290.216229,-18000,,
com.leomehlig.today,3,1744246285,1744246288,1744246288.122608,-18000,,
com.apple.news,107,1744246178,1744246285,1744246285.2693992,-18000,,
com.leomehlig.today,58,1744246120,1744246178,1744246178.410855,-18000,,
com.google.Chrome,4,1744246116,1744246120,1744246120.168731,-18000,,
com.apple.news,2,1744246091,1744246093,1744246094.1839309,-18000,EB445137-D7F5-57EC-87DA-1DB460D64046,"iPhone13,2"
com.apple.news,4,1744241631,1744241635,1744241635.806313,-18000,EB445137-D7F5-57EC-87DA-1DB460D64046,"iPhone13,2"
com.apple.weather,5,1744241626,1744241631,1744241631.7379642,-18000,EB445137-D7F5-57EC-87DA-1DB460D64046,"iPhone13,2"
com.apple.news,6,1744241618,1744241624,1744241625.116663,-18000,EB445137-D7F5-57EC-87DA-1DB460D64046,"iPhone13,2"
com.apple.MobileSMS,21,1744241461,1744241482,1744241483.050344,-18000,EB445137-D7F5-57EC-87DA-1DB460D64046,"iPhone13,2"
com.apple.CoreAuthUI,2,1744241402,1744241404,1744241404.930462,-18000,EB445137-D7F5-57EC-87DA-1DB460D64046,"iPhone13,2"
com.clairmail.fth.client,48,1744241399,1744241447,1744241447.869411,-18000,EB445137-D7F5-57EC-87DA-1DB460D64046,"iPhone13,2"
com.apple.MobileSMS,7,1744241392,1744241399,1744241399.3156571,-18000,EB445137-D7F5-57EC-87DA-1DB460D64046,"iPhone13,2"
com.apple.CoreAuthUI,2,1744241366,1744241368,1744241368.383889,-18000,EB445137-D7F5-57EC-87DA-1DB460D64046,"iPhone13,2"
com.truebill.truebillnative,20,1744241363,1744241383,1744241383.790731,-18000,EB445137-D7F5-57EC-87DA-1DB460D64046,"iPhone13,2"
com.google.chrome.ios,4,1744241339,1744241343,1744241343.399549,-18000,EB445137-D7F5-57EC-87DA-1DB460D64046,"iPhone13,2"
com.google.chrome.ios,21,1744241259,1744241280,1744241280.837611,-18000,EB445137-D7F5-57EC-87DA-1DB460D64046,"iPhone13,2"
com.letterboxd.LetterboxdApp,25,1744241234,1744241259,1744241259.9350371,-18000,EB445137-D7F5-57EC-87DA-1DB460D64046,"iPhone13,2"
com.google.Chrome,147,1744241000,1744241147,1744241147.475935,-18000,,
co.hinge.mobile.ios,9,1744240965,1744240974,1744240974.119282,-18000,EB445137-D7F5-57EC-87DA-1DB460D64046,"iPhone13,2"
com.microsoft.Outlook,59,1744240923,1744240982,1744240982.234844,-18000,,
com.google.Chrome,26,1744240897,1744240923,1744240923.818418,-18000,,
com.leomehlig.today,11,1744240886,1744240897,1744240898.260041,-18000,,
com.leomehlig.today,5,1744240771,1744240776,1744240777.32027,-18000,,
co.hinge.mobile.ios,5,1744240753,1744240758,1744240758.41064,-18000,EB445137-D7F5-57EC-87DA-1DB460D64046,"iPhone13,2"
co.hinge.mobile.ios,639,1744240110,1744240749,1744240749.8133821,-18000,EB445137-D7F5-57EC-87DA-1DB460D64046,"iPhone13,2"
com.leomehlig.today,421,1744239953,1744240374,1744240374.731378,-18000,,
com.apple.calculator,0,1744239953,1744239953,1744239953.518405,-18000,,
com.google.Chrome,1,1744239952,1744239953,1744239953.212531,-18000,,
com.apple.MobileSMS,1,1744239951,1744239952,1744239952.9272861,-18000,,
com.google.Chrome,33,1744239918,1744239951,1744239952.7992,-18000,,
com.apple.MobileSMS,3,1744239524,1744239527,1744239527.808775,-18000,,
com.google.Chrome,118,1744239406,1744239524,1744239524.581293,-18000,,
com.apple.calculator,36,1744239370,1744239406,1744239406.0784469,-18000,,
com.google.Chrome,6,1744239364,1744239370,1744239370.3030171,-18000,,
com.apple.calculator,19,1744239345,1744239364,1744239364.145158,-18000,,
