app,usage,start_time,end_time,created_at,tz,device_id,device_model
com.apple.finder,17,1718315702,1718315719,1718315719.595007,-18000,,
com.apple.Terminal,4,1718315698,1718315702,1718315702.272748,-18000,,
com.apple.finder,4,1718315694,1718315698,1718315698.3794808,-18000,,
com.google.Chrome,4,1718315690,1718315694,1718315694.586038,-18000,,
com.google.Chrome,217,1718302562,1718302779,1718302779.201338,-18000,,
com.google.Chrome,3442,1718233216,1718236658,1718236658.81245,-18000,,
com.google.Chrome,409,1718231280,1718231689,1718231689.940456,-18000,,
com.google.Chrome,556,1718230274,1718230830,1718230830.20119,-18000,,
com.google.Chrome,1300,1718228855,1718230155,1718230155.6367102,-18000,,
com.google.Chrome,893,1718222602,1718223495,1718223495.0640612,-18000,,
com.google.Chrome,840,1718217714,1718218554,1718218554.570703,-18000,,
com.google.Chrome,641,1718215274,1718215915,1718215915.197727,-18000,,
com.google.Chrome,9,1718162337,1718162346,1718162346.642642,-18000,,
com.apple.MobileSMS,6,1718162331,1718162337,1718162337.370327,-18000,,
com.google.Chrome,515,1718161816,1718162331,1718162331.948884,-18000,,
com.google.Chrome,308,1718161499,1718161807,1718161807.8708901,-18000,,
com.google.Chrome,433,1718161061,1718161494,1718161495.002315,-18000,,
com.leomehlig.today,9,1718161052,1718161061,1718161061.730861,-18000,,
com.apple.iCal,7,1718161045,1718161052,1718161052.232755,-18000,,
com.leomehlig.today,516,1718160529,1718161045,1718161045.141226,-18000,,
com.google.Chrome,226,1718160303,1718160529,1718160529.2122102,-18000,,
com.apple.finder,2,1718160301,1718160303,1718160303.790637,-18000,,
com.apple.finder,44,1718156790,1718156834,1718156834.31538,-18000,,
com.apple.keychainaccess,1,1718156789,1718156790,1718156790.5560498,-18000,,
com.apple.iCal,116,1718156673,1718156789,1718156789.723998,-18000,,
com.apple.keychainaccess,101,1718156572,1718156673,1718156673.4951792,-18000,,
com.google.Chrome,13,1718156550,1718156563,1718156563.4604,-18000,,
com.google.Chrome,349,1718154216,1718154565,1718154566.0182009,-18000,,
com.apple.AddressBook,15,1718154201,1718154216,1718154216.092623,-18000,,
com.google.Chrome,62,1718154139,1718154201,1718154201.83775,-18000,,
com.apple.MobileSMS,3,1718154136,1718154139,1718154139.827003,-18000,,
com.google.Chrome,18,1718154118,1718154136,1718154136.083208,-18000,,
com.google.Chrome,308,1718142442,1718142750,1718142750.2815208,-18000,,
com.google.Chrome,1372,1718078866,1718080238,1718080238.800287,-18000,,
com.google.Chrome,117,1718058086,1718058203,1718058204.1323972,-18000,,
com.apple.finder,209,1718057877,1718058086,1718058086.327005,-18000,,
com.google.Chrome,50,1718057827,1718057877,1718057877.975315,-18000,,
com.google.Chrome,249,1718054406,1718054655,1718054655.83409,-18000,,
com.google.Chrome,664,1718053020,1718053684,1718053684.413517,-18000,,
com.google.Chrome,301,1718052573,1718052874,1718052874.278115,-18000,,
com.google.Chrome,302,1718052091,1718052393,1718052393.046525,-18000,,
com.google.Chrome,344,1718051648,1718051992,1718051992.2110481,-18000,,
com.google.Chrome,4,1718048414,1718048418,1718048418.637193,-18000,,
com.google.Chrome,904,1718047469,1718048373,1718048373.573554,-18000,,
com.google.Chrome,380,1717990876,1717991256,1717991256.887803,-18000,,
com.google.Chrome,1819,1717988847,1717990666,1717990666.673989,-18000,,
com.google.Chrome,2938,1717985363,1717988301,1717988301.306748,-18000,,
com.google.Chrome,309,1717984936,1717985245,1717985245.866215,-18000,,
com.google.Chrome,236,1717974674,1717974910,1717974910.8558412,-18000,,
com.google.Chrome,329,1717973950,1717974279,1717974279.849906,-18000,,
com.google.Chrome,2224,1717965599,1717967823,1717967823.333111,-18000,,
com.google.Chrome,339,1717964953,1717965292,1717965293.022968,-18000,,
com.google.Chrome,720,1717963953,1717964673,1717964673.490432,-18000,,
com.google.Chrome,259,1717884044,1717884303,1717884303.3033051,-18000,,
com.google.Chrome,303,1717883580,1717883883,1717883883.003964,-18000,,
com.google.Chrome,782,1717882382,1717883164,1717883164.997313,-18000,,
com.google.Chrome,731,1717881399,1717882130,1717882130.966547,-18000,,
com.google.Chrome,737,1717807515,1717808252,1717808252.061926,-18000,,
com.google.Chrome,3814,1717802990,1717806804,1717806804.7312179,-18000,,
com.google.Chrome,439,1717802342,1717802781,1717802781.2800221,-18000,,
com.google.Chrome,685,1717801532,1717802217,1717802217.4199538,-18000,,
com.google.Chrome,2,1717781906,1717781908,1717781908.669495,-18000,,
com.apple.MobileSMS,3,1717781903,1717781906,1717781906.9350429,-18000,,
com.google.Chrome,1012,1717780891,1717781903,1717781903.199002,-18000,,
com.google.Chrome,318,1717780429,1717780747,1717780747.38548,-18000,,
com.google.Chrome,442,1717779892,1717780334,1717780334.3613238,-18000,,
com.apple.calculator,6,1717779886,1717779892,1717779892.406452,-18000,,
com.google.Chrome,1,1717779885,1717779886,1717779886.3400521,-18000,,
com.apple.calculator,6,1717779879,1717779885,1717779885.33749,-18000,,
com.google.Chrome,91,1717779788,1717779879,1717779879.942296,-18000,,
com.apple.systempreferences,1,1717779787,1717779788,1717779788.288584,-18000,,
com.google.Chrome,69,1717779712,1717779781,1717779781.211446,-18000,,
com.apple.finder,6,1717779706,1717779712,1717779713.0005069,-18000,,
com.apple.finder,7,1717778677,1717778684,1717778684.984748,-18000,,
com.apple.dt.Xcode,60,1717778617,1717778677,1717778678.139987,-18000,,
com.ryansponzilli.DeepSkyCatalogMac,9,1717778608,1717778617,1717778617.213357,-18000,,
com.apple.dt.Xcode,6,1717778602,1717778608,1717778608.242557,-18000,,
com.ryansponzilli.DeepSkyCatalogMac,2,1717778600,1717778602,1717778602.7628012,-18000,,
com.apple.dt.Xcode,2,1717778598,1717778600,1717778600.4735599,-18000,,
com.ryansponzilli.DeepSkyCatalogMac,30,1717778568,1717778598,1717778598.833249,-18000,,
com.apple.dt.Xcode,27,1717778541,1717778568,1717778568.265174,-18000,,
com.apple.finder,28,1717778513,1717778541,1717778541.56478,-18000,,
com.apple.dt.Xcode,46,1717778467,1717778513,1717778513.622941,-18000,,
com.ryansponzilli.DeepSkyCatalogMac,79,1717778388,1717778467,1717778467.689241,-18000,,
com.apple.dt.Xcode,291,1717778097,1717778388,1717778388.2352982,-18000,,
com.google.Chrome,3,1717778094,1717778097,1717778097.562622,-18000,,
com.apple.dt.Xcode,2,1717778092,1717778094,1717778095.033679,-18000,,
com.google.Chrome,8,1717778084,1717778092,1717778092.597042,-18000,,
com.apple.dt.Xcode,40,1717778044,1717778084,1717778084.911319,-18000,,
com.google.Chrome,26,1717778018,1717778044,1717778044.356659,-18000,,
com.apple.dt.Xcode,1,1717778017,1717778018,1717778018.788477,-18000,,
com.google.Chrome,22,1717777995,1717778017,1717778017.898075,-18000,,
com.apple.dt.Xcode,47,1717777948,1717777995,1717777995.988854,-18000,,
com.apple.finder,4,1717777944,1717777948,1717777948.5117822,-18000,,
com.apple.dt.Xcode,4,1717777940,1717777944,1717777944.171896,-18000,,
com.apple.finder,6,1717777934,1717777940,1717777940.629255,-18000,,
com.apple.dt.Xcode,31,1717777903,1717777934,1717777935.004682,-18000,,
com.apple.finder,13,1717777890,1717777903,1717777903.109874,-18000,,
com.apple.dt.Xcode,4,1717777886,1717777890,1717777890.6179771,-18000,,
com.apple.finder,4,1717777882,1717777886,1717777886.233053,-18000,,
com.apple.dt.Xcode,8,1717777874,1717777882,1717777882.488095,-18000,,
com.apple.finder,8,1717777866,1717777874,1717777874.328167,-18000,,
com.apple.dt.Xcode,559,1717777307,1717777866,1717777866.223799,-18000,,
com.apple.finder,42,1717777265,1717777307,1717777307.922241,-18000,,
com.apple.dt.Xcode,64,1717777201,1717777265,1717777265.6044888,-18000,,
com.apple.finder,20,1717777181,1717777201,1717777201.597283,-18000,,
com.apple.dt.Xcode,16,1717777165,1717777181,1717777181.724644,-18000,,
com.apple.dt.Xcode,266,1717776611,1717776877,1717776877.3719711,-18000,,
com.google.Chrome,84,1717776488,1717776572,1717776573.60518,-18000,,
com.apple.dt.Xcode,9,1717776479,1717776488,1717776488.119508,-18000,,
com.google.Chrome,51,1717776428,1717776479,1717776479.202697,-18000,,
com.apple.dt.Xcode,313,1717776096,1717776409,1717776409.542984,-18000,,
com.apple.finder,0,1717776096,1717776096,1717776096.931576,-18000,,
com.apple.dt.Xcode,18,1717776078,1717776096,1717776096.430548,-18000,,
com.apple.finder,429,1717775636,1717776065,1717776065.554028,-18000,,
com.apple.Preview,237,1717775399,1717775636,1717775636.4232302,-18000,,
com.apple.finder,1,1717775398,1717775399,1717775399.117521,-18000,,
com.apple.Preview,2,1717775396,1717775398,1717775398.950417,-18000,,
com.apple.finder,1,1717775395,1717775396,1717775396.273563,-18000,,
com.apple.Preview,3,1717775392,1717775395,1717775396.0280771,-18000,,
com.apple.finder,1,1717775391,1717775392,1717775392.198845,-18000,,
com.apple.Preview,5,1717775386,1717775391,1717775391.942196,-18000,,
com.apple.finder,1,1717775385,1717775386,1717775386.200619,-18000,,
com.apple.Preview,32,1717775353,1717775385,1717775385.87408,-18000,,
com.apple.finder,0,1717775353,1717775353,1717775353.699517,-18000,,
com.apple.Preview,3,1717775350,1717775353,1717775353.553179,-18000,,
com.apple.finder,0,1717775350,1717775350,1717775350.905325,-18000,,
com.apple.Preview,3,1717775347,1717775350,1717775350.791867,-18000,,
com.apple.finder,0,1717775347,1717775347,1717775347.544755,-18000,,
com.apple.Preview,3,1717775344,1717775347,1717775347.357471,-18000,,
com.apple.finder,13,1717775331,1717775344,1717775344.388599,-18000,,
com.apple.Preview,13,1717775318,1717775331,1717775331.6124148,-18000,,
com.apple.finder,141,1717775177,1717775318,1717775318.335089,-18000,,
com.apple.MobileSMS,17,1717775160,1717775177,1717775177.398179,-18000,,
com.apple.finder,245,1717774915,1717775160,1717775160.745009,-18000,,
com.apple.calculator,0,1717774915,1717774915,1717774916.020036,-18000,,
com.apple.systempreferences,2,1717774913,1717774915,1717774915.712359,-18000,,
com.google.Chrome,232,1717774681,1717774913,1717774913.710537,-18000,,
com.apple.systempreferences,3,1717774678,1717774681,1717774681.44271,-18000,,
com.google.Chrome,24,1717774654,1717774678,1717774678.046871,-18000,,
com.apple.systempreferences,1,1717774653,1717774654,1717774655.025041,-18000,,
com.google.Chrome,20,1717774633,1717774653,1717774653.996264,-18000,,
com.apple.systempreferences,7,1717774626,1717774633,1717774633.2813811,-18000,,
com.google.Chrome,7,1717774619,1717774626,1717774626.3433208,-18000,,
com.apple.systempreferences,1,1717774618,1717774619,1717774619.103884,-18000,,
com.google.Chrome,16,1717774602,1717774618,1717774618.273546,-18000,,
com.apple.systempreferences,8,1717774594,1717774602,1717774602.925446,-18000,,
com.google.Chrome,266,1717774328,1717774594,1717774594.732425,-18000,,
com.apple.calculator,3,1717774325,1717774328,1717774328.124557,-18000,,
com.apple.systempreferences,1,1717774324,1717774325,1717774325.8099241,-18000,,
com.google.Chrome,15,1717774309,1717774324,1717774324.170924,-18000,,
com.apple.systempreferences,8,1717774301,1717774309,1717774310.017617,-18000,,
com.google.Chrome,12,1717774289,1717774301,1717774301.344122,-18000,,
com.apple.systempreferences,1,1717774282,1717774283,1717774284.6864982,-18000,,
com.google.Chrome,50,1717774232,1717774282,1717774282.4390922,-18000,,
com.apple.calculator,34,1717774198,1717774232,1717774232.224269,-18000,,
com.google.Chrome,1,1717774197,1717774198,1717774199.0052261,-18000,,
com.apple.calculator,3,1717774194,1717774197,1717774198.0485458,-18000,,
com.google.Chrome,740,1717773454,1717774194,1717774194.8933,-18000,,
com.google.Chrome,763,1717731814,1717732577,1717732578.029364,-18000,,
com.google.Chrome,479,1717730457,1717730936,1717730936.7364259,-18000,,
com.google.Chrome,598,1717729722,1717730320,1717730320.3617191,-18000,,
com.google.Chrome,301,1717728936,1717729237,1717729237.62479,-18000,,
com.google.Chrome,300,1717728625,1717728925,1717728925.764781,-18000,,
com.google.Chrome,1266,1717727239,1717728505,1717728505.06538,-18000,,
com.google.Chrome,380,1717704854,1717705234,1717705234.787755,-18000,,
com.google.Chrome,1925,1717702919,1717704844,1717704844.60151,-18000,,
com.google.Chrome,2363,1717700514,1717702877,1717702877.756645,-18000,,
com.doordash.dasher,6,1717698792,1717698798,1717698798.5159879,-18000,EB445137-D7F5-57EC-87DA-1DB460D64046,"iPhone13,2"
com.apple.MobileSMS,9,1717698783,1717698792,1717698792.1912289,-18000,EB445137-D7F5-57EC-87DA-1DB460D64046,"iPhone13,2"
com.doordash.dasher,17,1717698766,1717698783,1717698783.3089151,-18000,EB445137-D7F5-57EC-87DA-1DB460D64046,"iPhone13,2"
com.apple.MobileSMS,20,1717698746,1717698766,1717698767.138764,-18000,EB445137-D7F5-57EC-87DA-1DB460D64046,"iPhone13,2"
com.doordash.dasher,9,1717698737,1717698746,1717698746.381541,-18000,EB445137-D7F5-57EC-87DA-1DB460D64046,"iPhone13,2"
com.apple.InCallService,0,1717698737,1717698737,1717698738.067225,-18000,EB445137-D7F5-57EC-87DA-1DB460D64046,"iPhone13,2"
com.apple.InCallService,2,1717698716,1717698718,1717698718.564429,-18000,EB445137-D7F5-57EC-87DA-1DB460D64046,"iPhone13,2"
com.doordash.dasher,15,1717698701,1717698716,1717698717.007549,-18000,EB445137-D7F5-57EC-87DA-1DB460D64046,"iPhone13,2"
com.apple.InCallService,1,1717698700,1717698701,1717698702.017249,-18000,EB445137-D7F5-57EC-87DA-1DB460D64046,"iPhone13,2"
com.apple.InCallService,2,1717698676,1717698678,1717698678.2385612,-18000,EB445137-D7F5-57EC-87DA-1DB460D64046,"iPhone13,2"
com.doordash.dasher,238,1717698438,1717698676,1717698676.418613,-18000,EB445137-D7F5-57EC-87DA-1DB460D64046,"iPhone13,2"
com.doordash.dasher,269,1717698158,1717698427,1717698427.264666,-18000,EB445137-D7F5-57EC-87DA-1DB460D64046,"iPhone13,2"
com.doordash.dasher,160,1717697962,1717698122,1717698122.66531,-18000,EB445137-D7F5-57EC-87DA-1DB460D64046,"iPhone13,2"
com.doordash.dasher,387,1717697567,1717697954,1717697954.2937741,-18000,EB445137-D7F5-57EC-87DA-1DB460D64046,"iPhone13,2"
com.toyopagroup.picaboo,4,1717697562,1717697566,1717697566.825972,-18000,EB445137-D7F5-57EC-87DA-1DB460D64046,"iPhone13,2"
com.doordash.dasher,648,1717696914,1717697562,1717697562.833603,-18000,EB445137-D7F5-57EC-87DA-1DB460D64046,"iPhone13,2"
com.doordash.dasher,473,1717696407,1717696880,1717696880.903553,-18000,EB445137-D7F5-57EC-87DA-1DB460D64046,"iPhone13,2"
com.apple.podcasts,6,1717696401,1717696407,1717696407.286582,-18000,EB445137-D7F5-57EC-87DA-1DB460D64046,"iPhone13,2"
com.doordash.dasher,34,1717696364,1717696398,1717696398.796649,-18000,EB445137-D7F5-57EC-87DA-1DB460D64046,"iPhone13,2"
com.google.ios.youtube,55,1717696309,1717696364,1717696364.8931708,-18000,EB445137-D7F5-57EC-87DA-1DB460D64046,"iPhone13,2"
com.doordash.dasher,4,1717696305,1717696309,1717696309.0620599,-18000,EB445137-D7F5-57EC-87DA-1DB460D64046,"iPhone13,2"
com.truebill.truebillnative,54,1717696250,1717696304,1717696304.840114,-18000,EB445137-D7F5-57EC-87DA-1DB460D64046,"iPhone13,2"
com.clairmail.fth.client,24,1717696223,1717696247,1717696247.294814,-18000,EB445137-D7F5-57EC-87DA-1DB460D64046,"iPhone13,2"
com.microsoft.Office.Outlook,30,1717696180,1717696210,1717696210.2977118,-18000,EB445137-D7F5-57EC-87DA-1DB460D64046,"iPhone13,2"
com.doordash.dasher,124,1717696052,1717696176,1717696176.054589,-18000,EB445137-D7F5-57EC-87DA-1DB460D64046,"iPhone13,2"
com.doordash.dasher,3,1717696046,1717696049,1717696049.951583,-18000,EB445137-D7F5-57EC-87DA-1DB460D64046,"iPhone13,2"
com.apple.camera,9,1717696012,1717696021,1717696025.504257,-18000,EB445137-D7F5-57EC-87DA-1DB460D64046,"iPhone13,2"
com.doordash.dasher,39,1717695973,1717696012,1717696012.930855,-18000,EB445137-D7F5-57EC-87DA-1DB460D64046,"iPhone13,2"
com.doordash.dasher,2,1717695971,1717695973,1717695973.132545,-18000,EB445137-D7F5-57EC-87DA-1DB460D64046,"iPhone13,2"
com.doordash.dasher,70,1717695850,1717695920,1717695920.794497,-18000,EB445137-D7F5-57EC-87DA-1DB460D64046,"iPhone13,2"
com.gasbuddymobile.gasbuddy,3,1717695847,1717695850,1717695851.018536,-18000,EB445137-D7F5-57EC-87DA-1DB460D64046,"iPhone13,2"
com.gasbuddymobile.gasbuddy,70,1717695658,1717695728,1717695728.3773708,-18000,EB445137-D7F5-57EC-87DA-1DB460D64046,"iPhone13,2"
com.doordash.dasher,1537,1717694117,1717695654,1717695654.8486872,-18000,EB445137-D7F5-57EC-87DA-1DB460D64046,"iPhone13,2"
com.doordash.dasher,198,1717693906,1717694104,1717694104.5082378,-18000,EB445137-D7F5-57EC-87DA-1DB460D64046,"iPhone13,2"
com.apple.InCallService,1,1717693905,1717693906,1717693906.609745,-18000,EB445137-D7F5-57EC-87DA-1DB460D64046,"iPhone13,2"
com.apple.InCallService,2,1717693879,1717693881,1717693881.172553,-18000,EB445137-D7F5-57EC-87DA-1DB460D64046,"iPhone13,2"
com.doordash.dasher,179,1717693700,1717693879,1717693879.460151,-18000,EB445137-D7F5-57EC-87DA-1DB460D64046,"iPhone13,2"
com.doordash.dasher,6,1717693660,1717693666,1717693666.536973,-18000,EB445137-D7F5-57EC-87DA-1DB460D64046,"iPhone13,2"
com.doordash.dasher,20,1717693638,1717693658,1717693658.0839849,-18000,EB445137-D7F5-57EC-87DA-1DB460D64046,"iPhone13,2"
com.doordash.dasher,1353,1717692264,1717693617,1717693617.364945,-18000,EB445137-D7F5-57EC-87DA-1DB460D64046,"iPhone13,2"
com.apple.findmy,38,1717692214,1717692252,1717692252.94028,-18000,EB445137-D7F5-57EC-87DA-1DB460D64046,"iPhone13,2"
com.doordash.dasher,611,1717691601,1717692212,1717692212.242858,-18000,EB445137-D7F5-57EC-87DA-1DB460D64046,"iPhone13,2"
com.doordash.dasher,26,1717691559,1717691585,1717691585.823842,-18000,EB445137-D7F5-57EC-87DA-1DB460D64046,"iPhone13,2"
com.doordash.dasher,262,1717691092,1717691354,1717691354.986407,-18000,EB445137-D7F5-57EC-87DA-1DB460D64046,"iPhone13,2"
com.apple.podcasts,164,1717690925,1717691089,1717691089.713352,-18000,EB445137-D7F5-57EC-87DA-1DB460D64046,"iPhone13,2"
com.apple.Music,62,1717690860,1717690922,1717690922.263185,-18000,EB445137-D7F5-57EC-87DA-1DB460D64046,"iPhone13,2"
com.apple.Preferences,40,1717690817,1717690857,1717690857.572772,-18000,EB445137-D7F5-57EC-87DA-1DB460D64046,"iPhone13,2"
com.doordash.dasher,120,1717690697,1717690817,1717690817.850822,-18000,EB445137-D7F5-57EC-87DA-1DB460D64046,"iPhone13,2"
com.myfitnesspal.mfp,3,1717690694,1717690697,1717690697.752006,-18000,EB445137-D7F5-57EC-87DA-1DB460D64046,"iPhone13,2"
com.apple.camera,0,1717690633,1717690633,1717690633.8271909,-18000,EB445137-D7F5-57EC-87DA-1DB460D64046,"iPhone13,2"
com.myfitnesspal.mfp,7,1717690632,1717690639,1717690639.835102,-18000,EB445137-D7F5-57EC-87DA-1DB460D64046,"iPhone13,2"
com.myfitnesspal.mfp,44,1717690587,1717690631,1717690631.537188,-18000,EB445137-D7F5-57EC-87DA-1DB460D64046,"iPhone13,2"
com.apple.findmy,5,1717690582,1717690587,1717690587.972398,-18000,EB445137-D7F5-57EC-87DA-1DB460D64046,"iPhone13,2"
com.google.ios.youtube,8,1717690574,1717690582,1717690582.731309,-18000,EB445137-D7F5-57EC-87DA-1DB460D64046,"iPhone13,2"
com.google.ios.youtube,367,1717690202,1717690569,1717690569.125049,-18000,EB445137-D7F5-57EC-87DA-1DB460D64046,"iPhone13,2"
com.apple.news,6,1717690195,1717690201,1717690202.0746,-18000,EB445137-D7F5-57EC-87DA-1DB460D64046,"iPhone13,2"
com.apple.findmy,16,1717690167,1717690183,1717690183.1821818,-18000,EB445137-D7F5-57EC-87DA-1DB460D64046,"iPhone13,2"
com.myfitnesspal.mfp,112,1717690055,1717690167,1717690167.4286199,-18000,EB445137-D7F5-57EC-87DA-1DB460D64046,"iPhone13,2"
com.toyopagroup.picaboo,7,1717690048,1717690055,1717690055.904996,-18000,EB445137-D7F5-57EC-87DA-1DB460D64046,"iPhone13,2"
com.myfitnesspal.mfp,5,1717690043,1717690048,1717690049.026874,-18000,EB445137-D7F5-57EC-87DA-1DB460D64046,"iPhone13,2"
com.myfitnesspal.mfp,51,1717689794,1717689845,1717689845.8730721,-18000,EB445137-D7F5-57EC-87DA-1DB460D64046,"iPhone13,2"
com.apple.findmy,3,1717689790,1717689793,1717689793.865334,-18000,EB445137-D7F5-57EC-87DA-1DB460D64046,"iPhone13,2"
com.apple.findmy,1,1717688953,1717688954,1717688954.9798121,-18000,EB445137-D7F5-57EC-87DA-1DB460D64046,"iPhone13,2"
com.apple.findmy,16,1717687866,1717687882,1717687883.040008,-18000,EB445137-D7F5-57EC-87DA-1DB460D64046,"iPhone13,2"
com.apple.findmy,4,1717687753,1717687757,1717687757.714392,-18000,EB445137-D7F5-57EC-87DA-1DB460D64046,"iPhone13,2"
com.apple.findmy,11,1717685889,1717685900,1717685900.9437451,-18000,EB445137-D7F5-57EC-87DA-1DB460D64046,"iPhone13,2"
com.apple.findmy,15,1717685869,1717685884,1717685884.8099298,-18000,EB445137-D7F5-57EC-87DA-1DB460D64046,"iPhone13,2"
com.apple.Music,4,1717685864,1717685868,1717685868.311634,-18000,EB445137-D7F5-57EC-87DA-1DB460D64046,"iPhone13,2"
com.apple.Music,15,1717685829,1717685844,1717685844.10493,-18000,EB445137-D7F5-57EC-87DA-1DB460D64046,"iPhone13,2"
com.apple.Music,6,1717685711,1717685717,1717685717.993469,-18000,EB445137-D7F5-57EC-87DA-1DB460D64046,"iPhone13,2"
com.apple.Music,8,1717685330,1717685338,1717685338.174362,-18000,EB445137-D7F5-57EC-87DA-1DB460D64046,"iPhone13,2"
com.apple.Music,62,1717684290,1717684352,1717684352.171643,-18000,EB445137-D7F5-57EC-87DA-1DB460D64046,"iPhone13,2"
com.muscleforlife.Stacked,4,1717684285,1717684289,1717684289.656619,-18000,EB445137-D7F5-57EC-87DA-1DB460D64046,"iPhone13,2"
com.muscleforlife.Stacked,36,1717684130,1717684166,1717684166.2357512,-18000,EB445137-D7F5-57EC-87DA-1DB460D64046,"iPhone13,2"
com.muscleforlife.Stacked,1,1717684119,1717684120,1717684120.625345,-18000,EB445137-D7F5-57EC-87DA-1DB460D64046,"iPhone13,2"
com.muscleforlife.Stacked,43,1717684041,1717684084,1717684084.2710009,-18000,EB445137-D7F5-57EC-87DA-1DB460D64046,"iPhone13,2"
com.muscleforlife.Stacked,64,1717683974,1717684038,1717684038.540678,-18000,EB445137-D7F5-57EC-87DA-1DB460D64046,"iPhone13,2"
com.muscleforlife.Stacked,111,1717683844,1717683955,1717683955.783885,-18000,EB445137-D7F5-57EC-87DA-1DB460D64046,"iPhone13,2"
com.muscleforlife.Stacked,3,1717683782,1717683785,1717683785.503371,-18000,EB445137-D7F5-57EC-87DA-1DB460D64046,"iPhone13,2"
com.muscleforlife.Stacked,9,1717683747,1717683756,1717683756.3161001,-18000,EB445137-D7F5-57EC-87DA-1DB460D64046,"iPhone13,2"
com.muscleforlife.Stacked,11,1717683683,1717683694,1717683694.485615,-18000,EB445137-D7F5-57EC-87DA-1DB460D64046,"iPhone13,2"
com.muscleforlife.Stacked,1,1717683675,1717683676,1717683676.942459,-18000,EB445137-D7F5-57EC-87DA-1DB460D64046,"iPhone13,2"
com.muscleforlife.Stacked,6,1717683666,1717683672,1717683672.102422,-18000,EB445137-D7F5-57EC-87DA-1DB460D64046,"iPhone13,2"
com.muscleforlife.Stacked,4,1717683588,1717683592,1717683592.858017,-18000,EB445137-D7F5-57EC-87DA-1DB460D64046,"iPhone13,2"
com.muscleforlife.Stacked,18,1717683530,1717683548,1717683548.648884,-18000,EB445137-D7F5-57EC-87DA-1DB460D64046,"iPhone13,2"
com.muscleforlife.Stacked,3,1717683509,1717683512,1717683512.736185,-18000,EB445137-D7F5-57EC-87DA-1DB460D64046,"iPhone13,2"
com.muscleforlife.Stacked,6,1717683437,1717683443,1717683443.754414,-18000,EB445137-D7F5-57EC-87DA-1DB460D64046,"iPhone13,2"
com.muscleforlife.Stacked,7,1717683359,1717683366,1717683366.068963,-18000,EB445137-D7F5-57EC-87DA-1DB460D64046,"iPhone13,2"
com.muscleforlife.Stacked,8,1717683311,1717683319,1717683319.077649,-18000,EB445137-D7F5-57EC-87DA-1DB460D64046,"iPhone13,2"
com.muscleforlife.Stacked,108,1717683173,1717683281,1717683282.013695,-18000,EB445137-D7F5-57EC-87DA-1DB460D64046,"iPhone13,2"
com.muscleforlife.Stacked,53,1717683095,1717683148,1717683148.0295281,-18000,EB445137-D7F5-57EC-87DA-1DB460D64046,"iPhone13,2"
com.apple.MobileSMS,2,1717683091,1717683093,1717683093.7948952,-18000,EB445137-D7F5-57EC-87DA-1DB460D64046,"iPhone13,2"
com.muscleforlife.Stacked,3,1717683088,1717683091,1717683091.179121,-18000,EB445137-D7F5-57EC-87DA-1DB460D64046,"iPhone13,2"
com.muscleforlife.Stacked,3,1717683035,1717683038,1717683038.856381,-18000,EB445137-D7F5-57EC-87DA-1DB460D64046,"iPhone13,2"
com.muscleforlife.Stacked,17,1717682968,1717682985,1717682985.2807698,-18000,EB445137-D7F5-57EC-87DA-1DB460D64046,"iPhone13,2"
com.muscleforlife.Stacked,3,1717682953,1717682956,1717682956.769619,-18000,EB445137-D7F5-57EC-87DA-1DB460D64046,"iPhone13,2"
com.muscleforlife.Stacked,5,1717682916,1717682921,1717682921.582969,-18000,EB445137-D7F5-57EC-87DA-1DB460D64046,"iPhone13,2"
com.muscleforlife.Stacked,6,1717682839,1717682845,1717682845.005674,-18000,EB445137-D7F5-57EC-87DA-1DB460D64046,"iPhone13,2"
com.muscleforlife.Stacked,3,1717682790,1717682793,1717682793.633323,-18000,EB445137-D7F5-57EC-87DA-1DB460D64046,"iPhone13,2"
com.muscleforlife.Stacked,3,1717682731,1717682734,1717682734.5187569,-18000,EB445137-D7F5-57EC-87DA-1DB460D64046,"iPhone13,2"
com.muscleforlife.Stacked,36,1717682650,1717682686,1717682686.384251,-18000,EB445137-D7F5-57EC-87DA-1DB460D64046,"iPhone13,2"
com.muscleforlife.Stacked,5,1717682578,1717682583,1717682583.553872,-18000,EB445137-D7F5-57EC-87DA-1DB460D64046,"iPhone13,2"
com.muscleforlife.Stacked,22,1717682474,1717682496,1717682496.2232208,-18000,EB445137-D7F5-57EC-87DA-1DB460D64046,"iPhone13,2"
com.muscleforlife.Stacked,8,1717682425,1717682433,1717682433.1194448,-18000,EB445137-D7F5-57EC-87DA-1DB460D64046,"iPhone13,2"
com.apple.Music,2,1717682422,1717682424,1717682424.297027,-18000,EB445137-D7F5-57EC-87DA-1DB460D64046,"iPhone13,2"
com.apple.Music,6,1717682328,1717682334,1717682334.178475,-18000,EB445137-D7F5-57EC-87DA-1DB460D64046,"iPhone13,2"
com.apple.Music,3,1717682295,1717682298,1717682298.562077,-18000,EB445137-D7F5-57EC-87DA-1DB460D64046,"iPhone13,2"
com.apple.Music,20,1717681588,1717681608,1717681608.142195,-18000,EB445137-D7F5-57EC-87DA-1DB460D64046,"iPhone13,2"
com.google.ios.youtube,6,1717681581,1717681587,1717681587.686974,-18000,EB445137-D7F5-57EC-87DA-1DB460D64046,"iPhone13,2"
com.apple.camera,1,1717681581,1717681582,1717681582.652281,-18000,EB445137-D7F5-57EC-87DA-1DB460D64046,"iPhone13,2"
com.google.ios.youtube,380,1717681046,1717681426,1717681426.6118078,-18000,EB445137-D7F5-57EC-87DA-1DB460D64046,"iPhone13,2"
com.google.chrome.ios,57,1717680985,1717681042,1717681042.958198,-18000,EB445137-D7F5-57EC-87DA-1DB460D64046,"iPhone13,2"
com.apple.Music,231,1717680754,1717680985,1717680985.846157,-18000,EB445137-D7F5-57EC-87DA-1DB460D64046,"iPhone13,2"
com.truebill.truebillnative,9,1717680738,1717680747,1717680747.737807,-18000,EB445137-D7F5-57EC-87DA-1DB460D64046,"iPhone13,2"
com.truebill.truebillnative,68,1717680358,1717680426,1717680426.7142081,-18000,EB445137-D7F5-57EC-87DA-1DB460D64046,"iPhone13,2"
com.clairmail.fth.client,21,1717680331,1717680352,1717680352.785841,-18000,EB445137-D7F5-57EC-87DA-1DB460D64046,"iPhone13,2"
com.apple.Health,2,1717680327,1717680329,1717680329.974825,-18000,EB445137-D7F5-57EC-87DA-1DB460D64046,"iPhone13,2"
com.apple.Health,57,1717680259,1717680316,1717680316.44629,-18000,EB445137-D7F5-57EC-87DA-1DB460D64046,"iPhone13,2"
com.apple.Preferences,3,1717679681,1717679684,1717679685.6125422,-18000,EB445137-D7F5-57EC-87DA-1DB460D64046,"iPhone13,2"
com.google.Chrome,295,1717644694,1717644989,1717644989.7028131,-18000,,
com.google.Chrome,1298,1717601578,1717602876,1717602876.300085,-18000,,
com.google.Chrome,325,1717601119,1717601444,1717601444.459382,-18000,,
com.microsoft.onenote.mac,29,1717601090,1717601119,1717601120.023339,-18000,,
com.google.Chrome,39,1717601051,1717601090,1717601090.248846,-18000,,
com.google.Chrome,16,1717551870,1717551886,1717551886.196076,-18000,,
com.google.Chrome,7,1717546733,1717546740,1717546740.0809479,-18000,,
com.apple.MobileSMS,7,1717546726,1717546733,1717546733.597759,-18000,,
com.google.Chrome,313,1717546413,1717546726,1717546726.423167,-18000,,
com.apple.systempreferences,3,1717546328,1717546331,1717546331.892194,-18000,,
com.google.Chrome,21,1717546307,1717546328,1717546328.144398,-18000,,
com.apple.systempreferences,13,1717546294,1717546307,1717546307.533598,-18000,,
com.google.Chrome,49,1717546239,1717546288,1717546288.031461,-18000,,
com.netflix.Netflix,1340,1717544514,1717545854,1717545854.830853,-18000,EB445137-D7F5-57EC-87DA-1DB460D64046,"iPhone13,2"
com.truebill.truebillnative,15,1717544495,1717544510,1717544510.396496,-18000,EB445137-D7F5-57EC-87DA-1DB460D64046,"iPhone13,2"
com.google.ios.youtube,973,1717543515,1717544488,1717544488.506023,-18000,EB445137-D7F5-57EC-87DA-1DB460D64046,"iPhone13,2"
com.google.ios.youtube,553,1717542953,1717543506,1717543506.416033,-18000,EB445137-D7F5-57EC-87DA-1DB460D64046,"iPhone13,2"
com.myfitnesspal.mfp,28,1717542921,1717542949,1717542949.350669,-18000,EB445137-D7F5-57EC-87DA-1DB460D64046,"iPhone13,2"
com.hammerandchisel.discord,3,1717542903,1717542906,1717542906.08313,-18000,EB445137-D7F5-57EC-87DA-1DB460D64046,"iPhone13,2"
com.hammerandchisel.discord,6,1717542857,1717542863,1717542863.4225311,-18000,EB445137-D7F5-57EC-87DA-1DB460D64046,"iPhone13,2"
com.myfitnesspal.mfp,2,1717542850,1717542852,1717542852.217637,-18000,EB445137-D7F5-57EC-87DA-1DB460D64046,"iPhone13,2"
com.myfitnesspal.mfp,3,1717542837,1717542840,1717542840.499642,-18000,EB445137-D7F5-57EC-87DA-1DB460D64046,"iPhone13,2"
com.myfitnesspal.mfp,1,1717542617,1717542618,1717542618.899973,-18000,EB445137-D7F5-57EC-87DA-1DB460D64046,"iPhone13,2"
com.myfitnesspal.mfp,40,1717542571,1717542611,1717542612.0832372,-18000,EB445137-D7F5-57EC-87DA-1DB460D64046,"iPhone13,2"
com.myfitnesspal.mfp,138,1717542409,1717542547,1717542548.039031,-18000,EB445137-D7F5-57EC-87DA-1DB460D64046,"iPhone13,2"
com.apple.weather,11,1717542395,1717542406,1717542406.551146,-18000,EB445137-D7F5-57EC-87DA-1DB460D64046,"iPhone13,2"
com.apple.MobileSMS,7,1717542388,1717542395,1717542395.478456,-18000,EB445137-D7F5-57EC-87DA-1DB460D64046,"iPhone13,2"
com.apple.MobileSMS,7,1717541912,1717541919,1717541919.037801,-18000,EB445137-D7F5-57EC-87DA-1DB460D64046,"iPhone13,2"
com.apple.MobileSMS,105,1717541428,1717541533,1717541533.6240149,-18000,EB445137-D7F5-57EC-87DA-1DB460D64046,"iPhone13,2"
com.apple.Preferences,2,1717541426,1717541428,1717541428.268239,-18000,EB445137-D7F5-57EC-87DA-1DB460D64046,"iPhone13,2"
com.apple.Preferences,1,1717541424,1717541425,1717541425.672066,-18000,EB445137-D7F5-57EC-87DA-1DB460D64046,"iPhone13,2"
com.apple.Preferences,41,1717540970,1717541011,1717541011.683816,-18000,EB445137-D7F5-57EC-87DA-1DB460D64046,"iPhone13,2"
com.doordash.dasher,3,1717540964,1717540967,1717540967.20241,-18000,EB445137-D7F5-57EC-87DA-1DB460D64046,"iPhone13,2"
com.doordash.dasher,89,1717540810,1717540899,1717540899.4411159,-18000,EB445137-D7F5-57EC-87DA-1DB460D64046,"iPhone13,2"
com.apple.news,6,1717540767,1717540773,1717540773.9467049,-18000,EB445137-D7F5-57EC-87DA-1DB460D64046,"iPhone13,2"
com.apple.Maps,2,1717539955,1717539957,1717539957.478046,-18000,EB445137-D7F5-57EC-87DA-1DB460D64046,"iPhone13,2"
com.apple.InCallService,1021,1717538934,1717539955,1717539955.4990048,-18000,EB445137-D7F5-57EC-87DA-1DB460D64046,"iPhone13,2"
com.apple.Maps,6,1717538928,1717538934,1717538934.4334621,-18000,EB445137-D7F5-57EC-87DA-1DB460D64046,"iPhone13,2"
com.apple.InCallService,297,1717538631,1717538928,1717538928.951257,-18000,EB445137-D7F5-57EC-87DA-1DB460D64046,"iPhone13,2"
com.apple.Maps,23,1717538608,1717538631,1717538631.5028272,-18000,EB445137-D7F5-57EC-87DA-1DB460D64046,"iPhone13,2"
com.apple.InCallService,512,1717538096,1717538608,1717538608.406961,-18000,EB445137-D7F5-57EC-87DA-1DB460D64046,"iPhone13,2"
com.apple.podcasts,1,1717538095,1717538096,1717538096.946484,-18000,EB445137-D7F5-57EC-87DA-1DB460D64046,"iPhone13,2"
com.apple.MobileSMS,2,1717538082,1717538084,1717538084.928813,-18000,EB445137-D7F5-57EC-87DA-1DB460D64046,"iPhone13,2"
com.apple.InCallService,15,1717538067,1717538082,1717538082.45358,-18000,EB445137-D7F5-57EC-87DA-1DB460D64046,"iPhone13,2"
com.apple.InCallService,18,1717538048,1717538066,1717538066.245717,-18000,EB445137-D7F5-57EC-87DA-1DB460D64046,"iPhone13,2"
com.apple.MobileSMS,5,1717538043,1717538048,1717538048.893996,-18000,EB445137-D7F5-57EC-87DA-1DB460D64046,"iPhone13,2"
com.apple.findmy,5,1717538037,1717538042,1717538043.0511842,-18000,EB445137-D7F5-57EC-87DA-1DB460D64046,"iPhone13,2"
com.hammerandchisel.discord,3,1717538034,1717538037,1717538037.35245,-18000,EB445137-D7F5-57EC-87DA-1DB460D64046,"iPhone13,2"
com.hammerandchisel.discord,6,1717538028,1717538034,1717538034.184318,-18000,EB445137-D7F5-57EC-87DA-1DB460D64046,"iPhone13,2"
com.apple.MobileSMS,14,1717538011,1717538025,1717538025.7606192,-18000,EB445137-D7F5-57EC-87DA-1DB460D64046,"iPhone13,2"
com.apple.MobileSMS,1,1717533489,1717533490,1717533490.821838,-18000,EB445137-D7F5-57EC-87DA-1DB460D64046,"iPhone13,2"
com.apple.MobileSMS,3,1717532463,1717532466,1717532466.252742,-18000,EB445137-D7F5-57EC-87DA-1DB460D64046,"iPhone13,2"
com.apple.news,3,1717532460,1717532463,1717532463.556746,-18000,EB445137-D7F5-57EC-87DA-1DB460D64046,"iPhone13,2"
com.apple.news,48,1717532406,1717532454,1717532454.645824,-18000,EB445137-D7F5-57EC-87DA-1DB460D64046,"iPhone13,2"
com.apple.MobileSMS,22,1717532382,1717532404,1717532404.145946,-18000,EB445137-D7F5-57EC-87DA-1DB460D64046,"iPhone13,2"
com.apple.findmy,6,1717532375,1717532381,1717532381.754168,-18000,EB445137-D7F5-57EC-87DA-1DB460D64046,"iPhone13,2"
com.google.ios.youtube,325,1717532040,1717532365,1717532365.422766,-18000,EB445137-D7F5-57EC-87DA-1DB460D64046,"iPhone13,2"
com.apple.findmy,5,1717532027,1717532032,1717532032.446443,-18000,EB445137-D7F5-57EC-87DA-1DB460D64046,"iPhone13,2"
com.apple.findmy,42,1717531941,1717531983,1717531983.5096478,-18000,EB445137-D7F5-57EC-87DA-1DB460D64046,"iPhone13,2"
com.apple.findmy,12,1717531927,1717531939,1717531939.3671908,-18000,EB445137-D7F5-57EC-87DA-1DB460D64046,"iPhone13,2"
com.google.ios.youtube,2,1717531925,1717531927,1717531927.528413,-18000,EB445137-D7F5-57EC-87DA-1DB460D64046,"iPhone13,2"
com.google.ios.youtube,837,1717531086,1717531923,1717531923.688818,-18000,EB445137-D7F5-57EC-87DA-1DB460D64046,"iPhone13,2"
com.apple.MobileAddressBook,32,1717531054,1717531086,1717531086.155338,-18000,EB445137-D7F5-57EC-87DA-1DB460D64046,"iPhone13,2"
com.google.ios.youtube,135,1717530915,1717531050,1717531051.813297,-18000,EB445137-D7F5-57EC-87DA-1DB460D64046,"iPhone13,2"
com.google.chrome.ios,46,1717530303,1717530349,1717530349.222781,-18000,EB445137-D7F5-57EC-87DA-1DB460D64046,"iPhone13,2"
com.google.Gmail,10,1717530293,1717530303,1717530303.69633,-18000,EB445137-D7F5-57EC-87DA-1DB460D64046,"iPhone13,2"
com.apple.InCallService,178,1717529889,1717530067,1717530067.748002,-18000,EB445137-D7F5-57EC-87DA-1DB460D64046,"iPhone13,2"
com.apple.InCallService,28,1717529860,1717529888,1717529888.1163568,-18000,EB445137-D7F5-57EC-87DA-1DB460D64046,"iPhone13,2"
com.apple.MobileSMS,2,1717529858,1717529860,1717529860.4604821,-18000,EB445137-D7F5-57EC-87DA-1DB460D64046,"iPhone13,2"
com.apple.InCallService,85,1717529772,1717529857,1717529857.213307,-18000,EB445137-D7F5-57EC-87DA-1DB460D64046,"iPhone13,2"
com.apple.MobileSMS,9,1717529763,1717529772,1717529772.1823149,-18000,EB445137-D7F5-57EC-87DA-1DB460D64046,"iPhone13,2"
com.apple.InCallService,8,1717529755,1717529763,1717529763.118731,-18000,EB445137-D7F5-57EC-87DA-1DB460D64046,"iPhone13,2"
com.apple.MobileSMS,65,1717529690,1717529755,1717529755.81042,-18000,EB445137-D7F5-57EC-87DA-1DB460D64046,"iPhone13,2"
com.myfitnesspal.mfp,1,1717529689,1717529690,1717529691.3910851,-18000,EB445137-D7F5-57EC-87DA-1DB460D64046,"iPhone13,2"
com.myfitnesspal.mfp,35,1717529055,1717529090,1717529090.673172,-18000,EB445137-D7F5-57EC-87DA-1DB460D64046,"iPhone13,2"
com.apple.news,2,1717529052,1717529054,1717529054.798552,-18000,EB445137-D7F5-57EC-87DA-1DB460D64046,"iPhone13,2"
com.apple.news,6,1717529023,1717529029,1717529029.827399,-18000,EB445137-D7F5-57EC-87DA-1DB460D64046,"iPhone13,2"
com.apple.news,548,1717528475,1717529023,1717529023.12851,-18000,EB445137-D7F5-57EC-87DA-1DB460D64046,"iPhone13,2"
com.google.Chrome,7,1717467050,1717467057,1717467057.863474,-18000,,
com.google.Chrome,115,1717466933,1717467048,1717467048.1934571,-18000,,
com.google.Chrome,657,1717465771,1717466428,1717466428.817236,-18000,,
com.google.Chrome,2041,1717463655,1717465696,1717465696.5026531,-18000,,
com.google.Chrome,23,1717447077,1717447100,1717447100.556635,-18000,,
com.apple.MobileSMS,2,1717447075,1717447077,1717447077.866665,-18000,,
com.google.Chrome,299,1717446776,1717447075,1717447075.129039,-18000,,
com.google.Chrome,745,1717445923,1717446668,1717446668.366531,-18000,,
com.apple.systempreferences,4,1717445919,1717445923,1717445923.732893,-18000,,
com.google.Chrome,26,1717445893,1717445919,1717445919.618068,-18000,,
com.apple.systempreferences,6,1717445887,1717445893,1717445893.924378,-18000,,
com.google.Chrome,20,1717445867,1717445887,1717445887.429717,-18000,,
com.apple.systempreferences,0,1717445860,1717445860,1717445860.8468618,-18000,,
com.google.Chrome,519,1717445341,1717445860,1717445860.54495,-18000,,
com.google.Chrome,802,1717443995,1717444797,1717444797.253099,-18000,,
com.google.Chrome,6,1717443979,1717443985,1717443985.449301,-18000,,
com.google.Chrome,616,1717443175,1717443791,1717443791.7777948,-18000,,
com.apple.MobileSMS,7,1717426795,1717426802,1717426802.0863519,-18000,EB445137-D7F5-57EC-87DA-1DB460D64046,"iPhone13,2"
com.apple.Music,7,1717426788,1717426795,1717426795.7108378,-18000,EB445137-D7F5-57EC-87DA-1DB460D64046,"iPhone13,2"
com.apple.Music,10,1717426178,1717426188,1717426188.705656,-18000,EB445137-D7F5-57EC-87DA-1DB460D64046,"iPhone13,2"
com.apple.Music,6,1717426062,1717426068,1717426069.18121,-18000,EB445137-D7F5-57EC-87DA-1DB460D64046,"iPhone13,2"
com.hammerandchisel.discord,34,1717426027,1717426061,1717426061.486933,-18000,EB445137-D7F5-57EC-87DA-1DB460D64046,"iPhone13,2"
com.apple.MobileSMS,4,1717426022,1717426026,1717426026.874923,-18000,EB445137-D7F5-57EC-87DA-1DB460D64046,"iPhone13,2"
com.apple.MobileSMS,36,1717425985,1717426021,1717426021.087357,-18000,EB445137-D7F5-57EC-87DA-1DB460D64046,"iPhone13,2"
com.apple.weather,21,1717425964,1717425985,1717425985.802754,-18000,EB445137-D7F5-57EC-87DA-1DB460D64046,"iPhone13,2"
com.apple.MobileSMS,2,1717425962,1717425964,1717425964.464479,-18000,EB445137-D7F5-57EC-87DA-1DB460D64046,"iPhone13,2"
com.apple.MobileSMS,10,1717425952,1717425962,1717425962.9120579,-18000,EB445137-D7F5-57EC-87DA-1DB460D64046,"iPhone13,2"
com.apple.weather,14,1717425937,1717425951,1717425952.079756,-18000,EB445137-D7F5-57EC-87DA-1DB460D64046,"iPhone13,2"
com.apple.MobileSMS,1,1717425936,1717425937,1717425937.546489,-18000,EB445137-D7F5-57EC-87DA-1DB460D64046,"iPhone13,2"
com.apple.MobileSMS,3,1717425933,1717425936,1717425936.573684,-18000,EB445137-D7F5-57EC-87DA-1DB460D64046,"iPhone13,2"
com.apple.mobiletimer,4,1717425929,1717425933,1717425933.136876,-18000,EB445137-D7F5-57EC-87DA-1DB460D64046,"iPhone13,2"
com.muscleforlife.Stacked,3,1717425925,1717425928,1717425928.692885,-18000,EB445137-D7F5-57EC-87DA-1DB460D64046,"iPhone13,2"
com.muscleforlife.Stacked,33,1717425858,1717425891,1717425891.578018,-18000,EB445137-D7F5-57EC-87DA-1DB460D64046,"iPhone13,2"
com.toyopagroup.picaboo,3,1717425855,1717425858,1717425858.487218,-18000,EB445137-D7F5-57EC-87DA-1DB460D64046,"iPhone13,2"
com.toyopagroup.picaboo,10,1717425774,1717425784,1717425784.211436,-18000,EB445137-D7F5-57EC-87DA-1DB460D64046,"iPhone13,2"
com.toyopagroup.picaboo,7,1717425766,1717425773,1717425773.422682,-18000,EB445137-D7F5-57EC-87DA-1DB460D64046,"iPhone13,2"
com.muscleforlife.Stacked,5,1717425761,1717425766,1717425766.3882399,-18000,EB445137-D7F5-57EC-87DA-1DB460D64046,"iPhone13,2"
com.muscleforlife.Stacked,7,1717425607,1717425614,1717425614.728251,-18000,EB445137-D7F5-57EC-87DA-1DB460D64046,"iPhone13,2"
com.muscleforlife.Stacked,111,1717425456,1717425567,1717425567.074095,-18000,EB445137-D7F5-57EC-87DA-1DB460D64046,"iPhone13,2"
com.muscleforlife.Stacked,112,1717425293,1717425405,1717425405.005153,-18000,EB445137-D7F5-57EC-87DA-1DB460D64046,"iPhone13,2"
com.muscleforlife.Stacked,17,1717425222,1717425239,1717425239.729484,-18000,EB445137-D7F5-57EC-87DA-1DB460D64046,"iPhone13,2"
com.muscleforlife.Stacked,14,1717425047,1717425061,1717425061.216978,-18000,EB445137-D7F5-57EC-87DA-1DB460D64046,"iPhone13,2"
com.apple.Music,2,1717425045,1717425047,1717425047.482059,-18000,EB445137-D7F5-57EC-87DA-1DB460D64046,"iPhone13,2"
com.apple.Music,4,1717424881,1717424885,1717424885.8577151,-18000,EB445137-D7F5-57EC-87DA-1DB460D64046,"iPhone13,2"
com.apple.Music,6,1717424563,1717424569,1717424569.7144551,-18000,EB445137-D7F5-57EC-87DA-1DB460D64046,"iPhone13,2"
com.apple.Music,62,1717424482,1717424544,1717424544.592352,-18000,EB445137-D7F5-57EC-87DA-1DB460D64046,"iPhone13,2"
com.apple.Music,164,1717424267,1717424431,1717424431.5724192,-18000,EB445137-D7F5-57EC-87DA-1DB460D64046,"iPhone13,2"
com.apple.news,3,1717424258,1717424261,1717424261.551985,-18000,EB445137-D7F5-57EC-87DA-1DB460D64046,"iPhone13,2"
com.apple.news,23,1717424163,1717424186,1717424186.094557,-18000,EB445137-D7F5-57EC-87DA-1DB460D64046,"iPhone13,2"
com.google.ios.youtube,584,1717423550,1717424134,1717424134.69541,-18000,EB445137-D7F5-57EC-87DA-1DB460D64046,"iPhone13,2"
com.doordash.dasher,2,1717423548,1717423550,1717423550.826222,-18000,EB445137-D7F5-57EC-87DA-1DB460D64046,"iPhone13,2"
com.apple.news,38,1717423286,1717423324,1717423324.048145,-18000,EB445137-D7F5-57EC-87DA-1DB460D64046,"iPhone13,2"
com.truebill.truebillnative,3,1717423258,1717423261,1717423261.045347,-18000,EB445137-D7F5-57EC-87DA-1DB460D64046,"iPhone13,2"
com.truebill.truebillnative,12,1717423178,1717423190,1717423190.018779,-18000,EB445137-D7F5-57EC-87DA-1DB460D64046,"iPhone13,2"
com.truebill.truebillnative,13,1717423162,1717423175,1717423175.867459,-18000,EB445137-D7F5-57EC-87DA-1DB460D64046,"iPhone13,2"
com.fis.513iPhoneSUB,21,1717423141,1717423162,1717423162.071861,-18000,EB445137-D7F5-57EC-87DA-1DB460D64046,"iPhone13,2"
com.truebill.truebillnative,82,1717423056,1717423138,1717423138.212434,-18000,EB445137-D7F5-57EC-87DA-1DB460D64046,"iPhone13,2"
com.clairmail.fth.client,20,1717423033,1717423053,1717423053.9805899,-18000,EB445137-D7F5-57EC-87DA-1DB460D64046,"iPhone13,2"
com.apple.Health,91,1717422606,1717422697,1717422697.860639,-18000,EB445137-D7F5-57EC-87DA-1DB460D64046,"iPhone13,2"
com.apple.findmy,85,1717422505,1717422590,1717422590.5578442,-18000,EB445137-D7F5-57EC-87DA-1DB460D64046,"iPhone13,2"
com.apple.findmy,20,1717420938,1717420958,1717420958.920351,-18000,EB445137-D7F5-57EC-87DA-1DB460D64046,"iPhone13,2"
com.apple.Preferences,121,1717420797,1717420918,1717420918.5784678,-18000,EB445137-D7F5-57EC-87DA-1DB460D64046,"iPhone13,2"
com.myfitnesspal.mfp,168,1717390156,1717390324,1717390324.2244391,-18000,EB445137-D7F5-57EC-87DA-1DB460D64046,"iPhone13,2"
com.google.chrome.ios,14,1717390142,1717390156,1717390156.899157,-18000,EB445137-D7F5-57EC-87DA-1DB460D64046,"iPhone13,2"
com.myfitnesspal.mfp,166,1717389976,1717390142,1717390142.77392,-18000,EB445137-D7F5-57EC-87DA-1DB460D64046,"iPhone13,2"
com.apple.Health,5,1717389964,1717389969,1717389969.653297,-18000,EB445137-D7F5-57EC-87DA-1DB460D64046,"iPhone13,2"
com.apple.Health,13,1717388848,1717388861,1717388861.733635,-18000,EB445137-D7F5-57EC-87DA-1DB460D64046,"iPhone13,2"
com.apple.Health,34,1717388809,1717388843,1717388843.14289,-18000,EB445137-D7F5-57EC-87DA-1DB460D64046,"iPhone13,2"
com.apple.MobileSMS,3,1717388802,1717388805,1717388805.947979,-18000,EB445137-D7F5-57EC-87DA-1DB460D64046,"iPhone13,2"
com.apple.Health,2,1717388800,1717388802,1717388802.1987062,-18000,EB445137-D7F5-57EC-87DA-1DB460D64046,"iPhone13,2"
com.apple.findmy,8,1717388792,1717388800,1717388801.21504,-18000,EB445137-D7F5-57EC-87DA-1DB460D64046,"iPhone13,2"
com.apple.findmy,15,1717388776,1717388791,1717388791.670788,-18000,EB445137-D7F5-57EC-87DA-1DB460D64046,"iPhone13,2"
com.google.Chrome,1183,1717387383,1717388566,1717388566.943074,-18000,,
com.google.Chrome,339,1717386830,1717387169,1717387169.519731,-18000,,
com.google.Chrome,335,1717386368,1717386703,1717386703.010023,-18000,,
com.apple.findmy,10,1717385401,1717385411,1717385411.354811,-18000,EB445137-D7F5-57EC-87DA-1DB460D64046,"iPhone13,2"
com.google.Chrome,1440,1717384880,1717386320,1717386320.762367,-18000,,
com.apple.findmy,13,1717384683,1717384696,1717384696.04269,-18000,EB445137-D7F5-57EC-87DA-1DB460D64046,"iPhone13,2"
com.apple.findmy,6,1717384675,1717384681,1717384681.063671,-18000,EB445137-D7F5-57EC-87DA-1DB460D64046,"iPhone13,2"
com.apple.findmy,12,1717380387,1717380399,1717380399.817312,-18000,EB445137-D7F5-57EC-87DA-1DB460D64046,"iPhone13,2"
com.apple.MobileSMS,2,1717378776,1717378778,1717378778.287718,-18000,EB445137-D7F5-57EC-87DA-1DB460D64046,"iPhone13,2"
com.google.ios.youtube,2862,1717375872,1717378734,1717378734.4482899,-18000,EB445137-D7F5-57EC-87DA-1DB460D64046,"iPhone13,2"
com.apple.weather,3,1717375869,1717375872,1717375872.391165,-18000,EB445137-D7F5-57EC-87DA-1DB460D64046,"iPhone13,2"
com.apple.weather,11,1717375778,1717375789,1717375789.436573,-18000,EB445137-D7F5-57EC-87DA-1DB460D64046,"iPhone13,2"
com.apple.weather,9,1717375767,1717375776,1717375776.6775289,-18000,EB445137-D7F5-57EC-87DA-1DB460D64046,"iPhone13,2"
com.apple.camera,1,1717375767,1717375768,1717375768.015414,-18000,EB445137-D7F5-57EC-87DA-1DB460D64046,"iPhone13,2"
com.apple.weather,1,1717375619,1717375620,1717375620.8627582,-18000,EB445137-D7F5-57EC-87DA-1DB460D64046,"iPhone13,2"
com.apple.weather,11,1717375386,1717375397,1717375397.261036,-18000,EB445137-D7F5-57EC-87DA-1DB460D64046,"iPhone13,2"
com.google.chrome.ios,77,1717375216,1717375293,1717375293.456336,-18000,EB445137-D7F5-57EC-87DA-1DB460D64046,"iPhone13,2"
com.apple.mobiletimer,2,1717375214,1717375216,1717375216.915936,-18000,EB445137-D7F5-57EC-87DA-1DB460D64046,"iPhone13,2"
com.apple.mobiletimer,12,1717374893,1717374905,1717374905.153733,-18000,EB445137-D7F5-57EC-87DA-1DB460D64046,"iPhone13,2"
com.apple.MobileSMS,8,1717374879,1717374887,1717374887.2620602,-18000,EB445137-D7F5-57EC-87DA-1DB460D64046,"iPhone13,2"
com.apple.MobileSMS,3,1717374541,1717374544,1717374544.3960938,-18000,EB445137-D7F5-57EC-87DA-1DB460D64046,"iPhone13,2"
com.apple.MobileSMS,32,1717372666,1717372698,1717372698.061039,-18000,EB445137-D7F5-57EC-87DA-1DB460D64046,"iPhone13,2"
com.apple.MobileSMS,8,1717372609,1717372617,1717372617.10777,-18000,EB445137-D7F5-57EC-87DA-1DB460D64046,"iPhone13,2"
com.toyopagroup.picaboo,11,1717372367,1717372378,1717372378.4217129,-18000,EB445137-D7F5-57EC-87DA-1DB460D64046,"iPhone13,2"
com.apple.MobileSMS,4,1717372363,1717372367,1717372367.924955,-18000,EB445137-D7F5-57EC-87DA-1DB460D64046,"iPhone13,2"
com.apple.MobileSMS,12,1717372242,1717372254,1717372254.243093,-18000,EB445137-D7F5-57EC-87DA-1DB460D64046,"iPhone13,2"
com.apple.MobileSMS,154,1717372082,1717372236,1717372236.744693,-18000,EB445137-D7F5-57EC-87DA-1DB460D64046,"iPhone13,2"
com.apple.mobileslideshow,2,1717372080,1717372082,1717372082.223083,-18000,EB445137-D7F5-57EC-87DA-1DB460D64046,"iPhone13,2"
com.apple.camera,6,1717370603,1717370609,1717370614.4930038,-18000,EB445137-D7F5-57EC-87DA-1DB460D64046,"iPhone13,2"
com.apple.mobileslideshow,8,1717370601,1717370609,1717370614.468587,-18000,EB445137-D7F5-57EC-87DA-1DB460D64046,"iPhone13,2"
com.apple.mobileslideshow,63,1717370532,1717370595,1717370595.837511,-18000,EB445137-D7F5-57EC-87DA-1DB460D64046,"iPhone13,2"
com.apple.MobileSMS,13,1717368176,1717368189,1717368189.435507,-18000,EB445137-D7F5-57EC-87DA-1DB460D64046,"iPhone13,2"
com.apple.MobileSMS,39,1717367286,1717367325,1717367325.395926,-18000,EB445137-D7F5-57EC-87DA-1DB460D64046,"iPhone13,2"
com.apple.mobilecal,2,1717367284,1717367286,1717367286.4334068,-18000,EB445137-D7F5-57EC-87DA-1DB460D64046,"iPhone13,2"
com.apple.mobilecal,8,1717365254,1717365262,1717365262.779389,-18000,EB445137-D7F5-57EC-87DA-1DB460D64046,"iPhone13,2"
com.apple.mobileslideshow,3,1717365244,1717365247,1717365247.271302,-18000,EB445137-D7F5-57EC-87DA-1DB460D64046,"iPhone13,2"
com.apple.mobileslideshow,2,1717364811,1717364813,1717364813.5210052,-18000,EB445137-D7F5-57EC-87DA-1DB460D64046,"iPhone13,2"
com.apple.mobileslideshow,14,1717360990,1717361004,1717361004.625571,-18000,EB445137-D7F5-57EC-87DA-1DB460D64046,"iPhone13,2"
com.apple.news,355,1717358691,1717359046,1717359046.2041621,-18000,EB445137-D7F5-57EC-87DA-1DB460D64046,"iPhone13,2"
com.apple.Health,19,1717358665,1717358684,1717358684.818451,-18000,EB445137-D7F5-57EC-87DA-1DB460D64046,"iPhone13,2"
com.apple.findmy,6,1717358653,1717358659,1717358659.5931091,-18000,EB445137-D7F5-57EC-87DA-1DB460D64046,"iPhone13,2"
com.google.chrome.ios,4,1717358642,1717358646,1717358646.0539808,-18000,EB445137-D7F5-57EC-87DA-1DB460D64046,"iPhone13,2"
com.google.chrome.ios,3,1717358281,1717358284,1717358284.712774,-18000,EB445137-D7F5-57EC-87DA-1DB460D64046,"iPhone13,2"
com.google.chrome.ios,91,1717357664,1717357755,1717357755.660538,-18000,EB445137-D7F5-57EC-87DA-1DB460D64046,"iPhone13,2"
com.google.chrome.ios,179,1717357470,1717357649,1717357649.972677,-18000,EB445137-D7F5-57EC-87DA-1DB460D64046,"iPhone13,2"
com.apple.news,19,1717357449,1717357468,1717357468.665584,-18000,EB445137-D7F5-57EC-87DA-1DB460D64046,"iPhone13,2"
com.apple.news,3,1717357420,1717357423,1717357423.13132,-18000,EB445137-D7F5-57EC-87DA-1DB460D64046,"iPhone13,2"
com.apple.news,8,1717357405,1717357413,1717357413.90345,-18000,EB445137-D7F5-57EC-87DA-1DB460D64046,"iPhone13,2"
com.apple.news,58,1717356593,1717356651,1717356651.489814,-18000,EB445137-D7F5-57EC-87DA-1DB460D64046,"iPhone13,2"
com.myfitnesspal.mfp,7,1717356582,1717356589,1717356589.168386,-18000,EB445137-D7F5-57EC-87DA-1DB460D64046,"iPhone13,2"
com.myfitnesspal.mfp,131,1717356058,1717356189,1717356189.7777228,-18000,EB445137-D7F5-57EC-87DA-1DB460D64046,"iPhone13,2"
com.toyopagroup.picaboo,6,1717356052,1717356058,1717356058.947612,-18000,EB445137-D7F5-57EC-87DA-1DB460D64046,"iPhone13,2"
com.google.Chrome,156,1717355165,1717355321,1717355321.755887,-18000,,
com.toyopagroup.picaboo,11,1717354799,1717354810,1717354810.61621,-18000,EB445137-D7F5-57EC-87DA-1DB460D64046,"iPhone13,2"
com.toyopagroup.picaboo,12,1717354757,1717354769,1717354769.919672,-18000,EB445137-D7F5-57EC-87DA-1DB460D64046,"iPhone13,2"
com.toyopagroup.picaboo,9,1717354553,1717354562,1717354562.292665,-18000,EB445137-D7F5-57EC-87DA-1DB460D64046,"iPhone13,2"
com.toyopagroup.picaboo,19,1717353918,1717353937,1717353937.5543509,-18000,EB445137-D7F5-57EC-87DA-1DB460D64046,"iPhone13,2"
com.apple.news,5,1717353913,1717353918,1717353919.038019,-18000,EB445137-D7F5-57EC-87DA-1DB460D64046,"iPhone13,2"
com.apple.news,58,1717353717,1717353775,1717353775.830587,-18000,EB445137-D7F5-57EC-87DA-1DB460D64046,"iPhone13,2"
com.hammerandchisel.discord,6,1717353690,1717353696,1717353696.72021,-18000,EB445137-D7F5-57EC-87DA-1DB460D64046,"iPhone13,2"
com.hammerandchisel.discord,21,1717353653,1717353674,1717353674.0847301,-18000,EB445137-D7F5-57EC-87DA-1DB460D64046,"iPhone13,2"
com.apple.findmy,5,1717353648,1717353653,1717353653.93432,-18000,EB445137-D7F5-57EC-87DA-1DB460D64046,"iPhone13,2"
com.doordash.dasher,23,1717353412,1717353435,1717353435.498791,-18000,EB445137-D7F5-57EC-87DA-1DB460D64046,"iPhone13,2"
com.apple.MobileSMS,3,1717353404,1717353407,1717353407.095227,-18000,EB445137-D7F5-57EC-87DA-1DB460D64046,"iPhone13,2"
com.hammerandchisel.discord,6,1717353397,1717353403,1717353403.960005,-18000,EB445137-D7F5-57EC-87DA-1DB460D64046,"iPhone13,2"
com.hammerandchisel.discord,1,1717353266,1717353267,1717353267.7406979,-18000,EB445137-D7F5-57EC-87DA-1DB460D64046,"iPhone13,2"
com.hammerandchisel.discord,6,1717353150,1717353156,1717353156.236126,-18000,EB445137-D7F5-57EC-87DA-1DB460D64046,"iPhone13,2"
com.hammerandchisel.discord,2,1717353144,1717353146,1717353146.645565,-18000,EB445137-D7F5-57EC-87DA-1DB460D64046,"iPhone13,2"
com.hammerandchisel.discord,9,1717353108,1717353117,1717353118.023192,-18000,EB445137-D7F5-57EC-87DA-1DB460D64046,"iPhone13,2"
com.doordash.dasher,1429,1717350947,1717352376,1717352376.746331,-18000,EB445137-D7F5-57EC-87DA-1DB460D64046,"iPhone13,2"
com.apple.podcasts,9,1717350938,1717350947,1717350947.240792,-18000,EB445137-D7F5-57EC-87DA-1DB460D64046,"iPhone13,2"
com.doordash.dasher,34,1717350899,1717350933,1717350933.996254,-18000,EB445137-D7F5-57EC-87DA-1DB460D64046,"iPhone13,2"
com.apple.camera,19,1717350571,1717350590,1717350592.63409,-18000,EB445137-D7F5-57EC-87DA-1DB460D64046,"iPhone13,2"
com.apple.weather,22,1717350568,1717350590,1717350592.55336,-18000,EB445137-D7F5-57EC-87DA-1DB460D64046,"iPhone13,2"
com.apple.weather,7,1717350417,1717350424,1717350424.9505692,-18000,EB445137-D7F5-57EC-87DA-1DB460D64046,"iPhone13,2"
com.apple.MobileSMS,2,1717350415,1717350417,1717350417.930571,-18000,EB445137-D7F5-57EC-87DA-1DB460D64046,"iPhone13,2"
com.apple.MobileSMS,7,1717350355,1717350362,1717350362.8249831,-18000,EB445137-D7F5-57EC-87DA-1DB460D64046,"iPhone13,2"
com.apple.MobileSMS,13,1717350341,1717350354,1717350354.50039,-18000,EB445137-D7F5-57EC-87DA-1DB460D64046,"iPhone13,2"
com.doordash.dasher,20,1717350321,1717350341,1717350341.068749,-18000,EB445137-D7F5-57EC-87DA-1DB460D64046,"iPhone13,2"
com.doordash.dasher,28,1717350105,1717350133,1717350133.9065619,-18000,EB445137-D7F5-57EC-87DA-1DB460D64046,"iPhone13,2"
com.google.chrome.ios,7,1717350095,1717350102,1717350103.441413,-18000,EB445137-D7F5-57EC-87DA-1DB460D64046,"iPhone13,2"
com.google.chrome.ios,11,1717349979,1717349990,1717349990.0059428,-18000,EB445137-D7F5-57EC-87DA-1DB460D64046,"iPhone13,2"
com.google.chrome.ios,26,1717349644,1717349670,1717349670.918295,-18000,EB445137-D7F5-57EC-87DA-1DB460D64046,"iPhone13,2"
com.google.chrome.ios,76,1717349562,1717349638,1717349638.333053,-18000,EB445137-D7F5-57EC-87DA-1DB460D64046,"iPhone13,2"
com.apple.Music,3,1717349559,1717349562,1717349562.3821368,-18000,EB445137-D7F5-57EC-87DA-1DB460D64046,"iPhone13,2"
com.apple.Music,13,1717347635,1717347648,1717347648.816125,-18000,EB445137-D7F5-57EC-87DA-1DB460D64046,"iPhone13,2"
com.apple.Music,15,1717345626,1717345641,1717345641.534411,-18000,EB445137-D7F5-57EC-87DA-1DB460D64046,"iPhone13,2"
com.apple.Music,27,1717344838,1717344865,1717344865.3063421,-18000,EB445137-D7F5-57EC-87DA-1DB460D64046,"iPhone13,2"
com.apple.Music,40,1717343630,1717343670,1717343670.4364638,-18000,EB445137-D7F5-57EC-87DA-1DB460D64046,"iPhone13,2"
com.apple.findmy,3,1717343625,1717343628,1717343629.1703649,-18000,EB445137-D7F5-57EC-87DA-1DB460D64046,"iPhone13,2"
com.apple.findmy,10,1717342517,1717342527,1717342527.519903,-18000,EB445137-D7F5-57EC-87DA-1DB460D64046,"iPhone13,2"
com.apple.findmy,37,1717342479,1717342516,1717342516.039978,-18000,EB445137-D7F5-57EC-87DA-1DB460D64046,"iPhone13,2"
com.apple.findmy,25,1717341692,1717341717,1717341717.7275949,-18000,EB445137-D7F5-57EC-87DA-1DB460D64046,"iPhone13,2"
com.truebill.truebillnative,38,1717341654,1717341692,1717341692.803519,-18000,EB445137-D7F5-57EC-87DA-1DB460D64046,"iPhone13,2"
com.apple.findmy,8,1717341646,1717341654,1717341654.48981,-18000,EB445137-D7F5-57EC-87DA-1DB460D64046,"iPhone13,2"
com.truebill.truebillnative,63,1717341583,1717341646,1717341646.279042,-18000,EB445137-D7F5-57EC-87DA-1DB460D64046,"iPhone13,2"
com.apple.findmy,31,1717341551,1717341582,1717341582.7130919,-18000,EB445137-D7F5-57EC-87DA-1DB460D64046,"iPhone13,2"
com.myfitnesspal.mfp,40,1717341511,1717341551,1717341552.413762,-18000,EB445137-D7F5-57EC-87DA-1DB460D64046,"iPhone13,2"
com.apple.findmy,183,1717341328,1717341511,1717341511.9630299,-18000,EB445137-D7F5-57EC-87DA-1DB460D64046,"iPhone13,2"
com.apple.Music,4,1717341323,1717341327,1717341327.9856892,-18000,EB445137-D7F5-57EC-87DA-1DB460D64046,"iPhone13,2"
com.apple.Music,18,1717341207,1717341225,1717341225.738122,-18000,EB445137-D7F5-57EC-87DA-1DB460D64046,"iPhone13,2"
com.myfitnesspal.mfp,4,1717341199,1717341203,1717341204.774781,-18000,EB445137-D7F5-57EC-87DA-1DB460D64046,"iPhone13,2"
com.myfitnesspal.mfp,57,1717341009,1717341066,1717341066.9142609,-18000,EB445137-D7F5-57EC-87DA-1DB460D64046,"iPhone13,2"
com.apple.news,7,1717340900,1717340907,1717340907.044588,-18000,EB445137-D7F5-57EC-87DA-1DB460D64046,"iPhone13,2"
com.apple.news,188,1717340621,1717340809,1717340809.263815,-18000,EB445137-D7F5-57EC-87DA-1DB460D64046,"iPhone13,2"
com.apple.MobileSMS,11,1717340601,1717340612,1717340612.918247,-18000,EB445137-D7F5-57EC-87DA-1DB460D64046,"iPhone13,2"
com.apple.weather,23,1717340578,1717340601,1717340601.8119512,-18000,EB445137-D7F5-57EC-87DA-1DB460D64046,"iPhone13,2"
com.apple.weather,6,1717339951,1717339957,1717339957.5287561,-18000,EB445137-D7F5-57EC-87DA-1DB460D64046,"iPhone13,2"
com.apple.Health,7,1717339941,1717339948,1717339948.2728171,-18000,EB445137-D7F5-57EC-87DA-1DB460D64046,"iPhone13,2"
com.apple.Health,24,1717339915,1717339939,1717339940.2760382,-18000,EB445137-D7F5-57EC-87DA-1DB460D64046,"iPhone13,2"
com.apple.findmy,3,1717339912,1717339915,1717339915.5494561,-18000,EB445137-D7F5-57EC-87DA-1DB460D64046,"iPhone13,2"
com.apple.findmy,10,1717339568,1717339578,1717339578.7088099,-18000,EB445137-D7F5-57EC-87DA-1DB460D64046,"iPhone13,2"
com.apple.findmy,5,1717338524,1717338529,1717338529.718179,-18000,EB445137-D7F5-57EC-87DA-1DB460D64046,"iPhone13,2"
com.apple.Health,109,1717310974,1717311083,1717311083.3116689,-18000,EB445137-D7F5-57EC-87DA-1DB460D64046,"iPhone13,2"
com.apple.mobiletimer,4,1717310964,1717310968,1717310968.062346,-18000,EB445137-D7F5-57EC-87DA-1DB460D64046,"iPhone13,2"
com.apple.mobiletimer,13,1717310540,1717310553,1717310553.480118,-18000,EB445137-D7F5-57EC-87DA-1DB460D64046,"iPhone13,2"
com.apple.mobiletimer,21,1717310515,1717310536,1717310536.417351,-18000,EB445137-D7F5-57EC-87DA-1DB460D64046,"iPhone13,2"
com.apple.mobiletimer,2,1717310097,1717310099,1717310099.7891479,-18000,EB445137-D7F5-57EC-87DA-1DB460D64046,"iPhone13,2"
com.apple.mobiletimer,26,1717310049,1717310075,1717310075.4262428,-18000,EB445137-D7F5-57EC-87DA-1DB460D64046,"iPhone13,2"
com.google.Sheets,13,1717310036,1717310049,1717310050.090106,-18000,EB445137-D7F5-57EC-87DA-1DB460D64046,"iPhone13,2"
com.google.Sheets,21,1717309979,1717310000,1717310000.875175,-18000,EB445137-D7F5-57EC-87DA-1DB460D64046,"iPhone13,2"
com.toyopagroup.picaboo,16,1717309959,1717309975,1717309975.307485,-18000,EB445137-D7F5-57EC-87DA-1DB460D64046,"iPhone13,2"
com.apple.MobileSMS,8,1717309951,1717309959,1717309959.879488,-18000,EB445137-D7F5-57EC-87DA-1DB460D64046,"iPhone13,2"
com.apple.MobileSMS,3,1717309244,1717309247,1717309247.147006,-18000,EB445137-D7F5-57EC-87DA-1DB460D64046,"iPhone13,2"
com.apple.MobileSMS,4,1717304313,1717304317,1717304317.390523,-18000,EB445137-D7F5-57EC-87DA-1DB460D64046,"iPhone13,2"
com.apple.MobileSMS,4,1717300676,1717300680,1717300680.397752,-18000,EB445137-D7F5-57EC-87DA-1DB460D64046,"iPhone13,2"
com.apple.MobileSMS,3,1717296882,1717296885,1717296885.742564,-18000,EB445137-D7F5-57EC-87DA-1DB460D64046,"iPhone13,2"
com.apple.MobileSMS,15,1717292387,1717292402,1717292402.147911,-18000,EB445137-D7F5-57EC-87DA-1DB460D64046,"iPhone13,2"
com.google.Chrome,3,1717281257,1717281260,1717281260.864649,-18000,,
com.google.Chrome,826,1717280431,1717281257,1717281257.945634,-18000,,
com.google.Chrome,896,1717277924,1717278820,1717278820.7005548,-18000,,
com.google.Chrome,304,1717277175,1717277479,1717277479.7407808,-18000,,
com.google.Chrome,420,1717276508,1717276928,1717276928.07055,-18000,,
com.google.Chrome,482,1717275864,1717276346,1717276346.099272,-18000,,
com.google.Chrome,547,1717274729,1717275276,1717275276.793621,-18000,,
com.google.Chrome,197,1717265131,1717265328,1717265328.565376,-18000,,
com.google.Chrome,300,1717264711,1717265011,1717265011.948765,-18000,,
com.google.Chrome,465,1717264161,1717264626,1717264626.3758879,-18000,,
com.google.Chrome,1241,1717262891,1717264132,1717264132.271676,-18000,,
com.google.Chrome,864,1717260015,1717260879,1717260879.901266,-18000,,
com.google.Chrome,1088,1717258871,1717259959,1717259959.902184,-18000,,
com.google.Chrome,209,1717257392,1717257601,1717257601.692554,-18000,,
com.apple.finder,3,1717257389,1717257392,1717257392.3356562,-18000,,
com.apple.finder,1,1717189877,1717189878,1717189878.9482632,-18000,,
com.apple.finder,1,1717189862,1717189863,1717189863.548503,-18000,,
com.google.Chrome,765,1717189097,1717189862,1717189862.365957,-18000,,
com.google.Chrome,805,1717187982,1717188787,1717188787.424526,-18000,,
com.google.Chrome,516,1717187163,1717187679,1717187679.323715,-18000,,
com.apple.MobileSMS,3,1717187160,1717187163,1717187163.4712439,-18000,,
com.google.Chrome,14,1717187146,1717187160,1717187160.7652059,-18000,,
com.google.Chrome,286,1717179507,1717179793,1717179793.4496078,-18000,,
com.toyopagroup.picaboo,28,1717176725,1717176753,1717176753.969713,-18000,EB445137-D7F5-57EC-87DA-1DB460D64046,"iPhone13,2"
com.apple.findmy,3,1717176722,1717176725,1717176725.8522239,-18000,EB445137-D7F5-57EC-87DA-1DB460D64046,"iPhone13,2"
com.apple.findmy,3,1717176378,1717176381,1717176381.893702,-18000,EB445137-D7F5-57EC-87DA-1DB460D64046,"iPhone13,2"
com.apple.findmy,17,1717176298,1717176315,1717176315.44425,-18000,EB445137-D7F5-57EC-87DA-1DB460D64046,"iPhone13,2"
com.hammerandchisel.discord,4,1717176292,1717176296,1717176296.5903301,-18000,EB445137-D7F5-57EC-87DA-1DB460D64046,"iPhone13,2"
com.apple.MobileSMS,11,1717176281,1717176292,1717176292.285217,-18000,EB445137-D7F5-57EC-87DA-1DB460D64046,"iPhone13,2"
com.apple.MobileSMS,7,1717175940,1717175947,1717175947.779189,-18000,EB445137-D7F5-57EC-87DA-1DB460D64046,"iPhone13,2"
com.apple.MobileSMS,68,1717175681,1717175749,1717175749.077601,-18000,EB445137-D7F5-57EC-87DA-1DB460D64046,"iPhone13,2"
com.apple.findmy,1,1717175680,1717175681,1717175682.487337,-18000,EB445137-D7F5-57EC-87DA-1DB460D64046,"iPhone13,2"
com.google.Chrome,1021,1717174938,1717175959,1717175959.5455232,-18000,,
com.google.Chrome,376,1717174475,1717174851,1717174851.4346619,-18000,,
com.apple.finder,1,1717174474,1717174475,1717174475.629593,-18000,,
com.microsoft.rdc.macos,8,1717174466,1717174474,1717174475.016732,-18000,,
com.apple.findmy,14,1717174366,1717174380,1717174380.628964,-18000,EB445137-D7F5-57EC-87DA-1DB460D64046,"iPhone13,2"
com.doordash.dasher,33,1717174315,1717174348,1717174348.2732549,-18000,EB445137-D7F5-57EC-87DA-1DB460D64046,"iPhone13,2"
com.ubercab.UberPartner,66,1717174247,1717174313,1717174313.2346869,-18000,EB445137-D7F5-57EC-87DA-1DB460D64046,"iPhone13,2"
com.google.chrome.ios,167,1717174079,1717174246,1717174246.589991,-18000,EB445137-D7F5-57EC-87DA-1DB460D64046,"iPhone13,2"
com.apple.MobileSMS,3,1717174073,1717174076,1717174076.24933,-18000,EB445137-D7F5-57EC-87DA-1DB460D64046,"iPhone13,2"
com.apple.reminders,4,1717174069,1717174073,1717174073.108346,-18000,EB445137-D7F5-57EC-87DA-1DB460D64046,"iPhone13,2"
com.apple.reminders,41,1717174012,1717174053,1717174053.081918,-18000,EB445137-D7F5-57EC-87DA-1DB460D64046,"iPhone13,2"
com.apple.mobileslideshow,166,1717173843,1717174009,1717174009.6045709,-18000,EB445137-D7F5-57EC-87DA-1DB460D64046,"iPhone13,2"
com.apple.camera,14,1717173807,1717173821,1717173822.079132,-18000,EB445137-D7F5-57EC-87DA-1DB460D64046,"iPhone13,2"
com.apple.mobileslideshow,34,1717173771,1717173805,1717173805.719417,-18000,EB445137-D7F5-57EC-87DA-1DB460D64046,"iPhone13,2"
com.apple.camera,2,1717173765,1717173767,1717173768.11218,-18000,EB445137-D7F5-57EC-87DA-1DB460D64046,"iPhone13,2"
com.apple.camera,1,1717173708,1717173709,1717173709.082371,-18000,EB445137-D7F5-57EC-87DA-1DB460D64046,"iPhone13,2"
com.myfitnesspal.mfp,69,1717173637,1717173706,1717173706.487601,-18000,EB445137-D7F5-57EC-87DA-1DB460D64046,"iPhone13,2"
com.apple.findmy,9,1717173628,1717173637,1717173637.811926,-18000,EB445137-D7F5-57EC-87DA-1DB460D64046,"iPhone13,2"
com.myfitnesspal.mfp,18,1717173610,1717173628,1717173629.001524,-18000,EB445137-D7F5-57EC-87DA-1DB460D64046,"iPhone13,2"
com.hammerandchisel.discord,9,1717173590,1717173599,1717173599.2396579,-18000,EB445137-D7F5-57EC-87DA-1DB460D64046,"iPhone13,2"
com.doordash.dasher,11,1717173579,1717173590,1717173590.643882,-18000,EB445137-D7F5-57EC-87DA-1DB460D64046,"iPhone13,2"
com.microsoft.rdc.macos,2,1717172903,1717172905,1717172905.974005,-18000,,
com.doordash.dasher,31,1717172621,1717172652,1717172652.660256,-18000,EB445137-D7F5-57EC-87DA-1DB460D64046,"iPhone13,2"
com.apple.calculator,5,1717172616,1717172621,1717172621.629626,-18000,EB445137-D7F5-57EC-87DA-1DB460D64046,"iPhone13,2"
com.doordash.dasher,93,1717172523,1717172616,1717172616.447473,-18000,EB445137-D7F5-57EC-87DA-1DB460D64046,"iPhone13,2"
com.doordash.dasher,7,1717172471,1717172478,1717172478.793462,-18000,EB445137-D7F5-57EC-87DA-1DB460D64046,"iPhone13,2"
com.doordash.dasher,11,1717172432,1717172443,1717172443.285495,-18000,EB445137-D7F5-57EC-87DA-1DB460D64046,"iPhone13,2"
com.doordash.dasher,2,1717172429,1717172431,1717172431.8208199,-18000,EB445137-D7F5-57EC-87DA-1DB460D64046,"iPhone13,2"
com.doordash.dasher,8,1717172373,1717172381,1717172381.95385,-18000,EB445137-D7F5-57EC-87DA-1DB460D64046,"iPhone13,2"
com.doordash.dasher,59,1717172310,1717172369,1717172369.162859,-18000,EB445137-D7F5-57EC-87DA-1DB460D64046,"iPhone13,2"
com.doordash.dasher,27,1717172259,1717172286,1717172286.156955,-18000,EB445137-D7F5-57EC-87DA-1DB460D64046,"iPhone13,2"
com.doordash.dasher,1,1717172165,1717172166,1717172166.2434,-18000,EB445137-D7F5-57EC-87DA-1DB460D64046,"iPhone13,2"
com.apple.InCallService,1,1717172164,1717172165,1717172165.576483,-18000,EB445137-D7F5-57EC-87DA-1DB460D64046,"iPhone13,2"
com.apple.InCallService,2,1717172128,1717172130,1717172130.554019,-18000,EB445137-D7F5-57EC-87DA-1DB460D64046,"iPhone13,2"
com.doordash.dasher,410,1717171718,1717172128,1717172128.809161,-18000,EB445137-D7F5-57EC-87DA-1DB460D64046,"iPhone13,2"
com.apple.MobileSMS,6,1717171712,1717171718,1717171718.6256309,-18000,EB445137-D7F5-57EC-87DA-1DB460D64046,"iPhone13,2"
com.doordash.dasher,81,1717171631,1717171712,1717171712.164877,-18000,EB445137-D7F5-57EC-87DA-1DB460D64046,"iPhone13,2"
com.doordash.dasher,28,1717171591,1717171619,1717171619.1884642,-18000,EB445137-D7F5-57EC-87DA-1DB460D64046,"iPhone13,2"
com.apple.MobileSMS,11,1717171580,1717171591,1717171591.4331799,-18000,EB445137-D7F5-57EC-87DA-1DB460D64046,"iPhone13,2"
com.doordash.dasher,22,1717171558,1717171580,1717171580.791267,-18000,EB445137-D7F5-57EC-87DA-1DB460D64046,"iPhone13,2"
com.apple.MobileSMS,32,1717171526,1717171558,1717171558.6718268,-18000,EB445137-D7F5-57EC-87DA-1DB460D64046,"iPhone13,2"
com.doordash.dasher,7,1717171519,1717171526,1717171526.668602,-18000,EB445137-D7F5-57EC-87DA-1DB460D64046,"iPhone13,2"
com.apple.InCallService,0,1717171519,1717171519,1717171520.087912,-18000,EB445137-D7F5-57EC-87DA-1DB460D64046,"iPhone13,2"
com.apple.InCallService,2,1717171516,1717171518,1717171518.906332,-18000,EB445137-D7F5-57EC-87DA-1DB460D64046,"iPhone13,2"
com.doordash.dasher,30,1717171486,1717171516,1717171516.6825938,-18000,EB445137-D7F5-57EC-87DA-1DB460D64046,"iPhone13,2"
com.apple.InCallService,2,1717171484,1717171486,1717171487.029152,-18000,EB445137-D7F5-57EC-87DA-1DB460D64046,"iPhone13,2"
com.doordash.dasher,470,1717171014,1717171484,1717171484.461688,-18000,EB445137-D7F5-57EC-87DA-1DB460D64046,"iPhone13,2"
com.doordash.dasher,336,1717170669,1717171005,1717171005.829113,-18000,EB445137-D7F5-57EC-87DA-1DB460D64046,"iPhone13,2"
com.apple.MobileSMS,10,1717170659,1717170669,1717170669.680468,-18000,EB445137-D7F5-57EC-87DA-1DB460D64046,"iPhone13,2"
com.doordash.dasher,502,1717170157,1717170659,1717170659.655205,-18000,EB445137-D7F5-57EC-87DA-1DB460D64046,"iPhone13,2"
com.markhambly.APOD,7,1717170133,1717170140,1717170140.124032,-18000,EB445137-D7F5-57EC-87DA-1DB460D64046,"iPhone13,2"
Astrospheric.Astrospheric,25,1717170105,1717170130,1717170130.911706,-18000,EB445137-D7F5-57EC-87DA-1DB460D64046,"iPhone13,2"
com.apple.findmy,6,1717170091,1717170097,1717170097.7343779,-18000,EB445137-D7F5-57EC-87DA-1DB460D64046,"iPhone13,2"
com.apple.MobileSMS,2,1717170082,1717170084,1717170084.0803962,-18000,EB445137-D7F5-57EC-87DA-1DB460D64046,"iPhone13,2"
com.doordash.dasher,464,1717169616,1717170080,1717170080.789967,-18000,EB445137-D7F5-57EC-87DA-1DB460D64046,"iPhone13,2"
com.apple.podcasts,136,1717169480,1717169616,1717169616.770002,-18000,EB445137-D7F5-57EC-87DA-1DB460D64046,"iPhone13,2"
com.doordash.dasher,49,1717169419,1717169468,1717169468.547553,-18000,EB445137-D7F5-57EC-87DA-1DB460D64046,"iPhone13,2"
com.apple.findmy,2,1717169415,1717169417,1717169418.103998,-18000,EB445137-D7F5-57EC-87DA-1DB460D64046,"iPhone13,2"
com.apple.findmy,13,1717169398,1717169411,1717169411.449527,-18000,EB445137-D7F5-57EC-87DA-1DB460D64046,"iPhone13,2"
com.apple.weather,3,1717169394,1717169397,1717169397.7772632,-18000,EB445137-D7F5-57EC-87DA-1DB460D64046,"iPhone13,2"
com.apple.weather,3,1717169373,1717169376,1717169376.361736,-18000,EB445137-D7F5-57EC-87DA-1DB460D64046,"iPhone13,2"
com.microsoft.rdc.macos,7,1717169122,1717169129,1717169129.4568238,-18000,,
com.apple.weather,7,1717169041,1717169048,1717169048.452314,-18000,EB445137-D7F5-57EC-87DA-1DB460D64046,"iPhone13,2"
com.apple.findmy,6,1717169032,1717169038,1717169038.804775,-18000,EB445137-D7F5-57EC-87DA-1DB460D64046,"iPhone13,2"
com.apple.findmy,4,1717169027,1717169031,1717169031.915643,-18000,EB445137-D7F5-57EC-87DA-1DB460D64046,"iPhone13,2"
com.apple.findmy,2,1717168831,1717168833,1717168833.7219338,-18000,EB445137-D7F5-57EC-87DA-1DB460D64046,"iPhone13,2"
com.apple.findmy,6,1717168741,1717168747,1717168747.04037,-18000,EB445137-D7F5-57EC-87DA-1DB460D64046,"iPhone13,2"
com.apple.findmy,8,1717167338,1717167346,1717167346.785658,-18000,EB445137-D7F5-57EC-87DA-1DB460D64046,"iPhone13,2"
com.apple.findmy,9,1717167302,1717167311,1717167311.409364,-18000,EB445137-D7F5-57EC-87DA-1DB460D64046,"iPhone13,2"
com.apple.Music,2,1717167300,1717167302,1717167302.432224,-18000,EB445137-D7F5-57EC-87DA-1DB460D64046,"iPhone13,2"
com.apple.Music,8,1717166968,1717166976,1717166976.072184,-18000,EB445137-D7F5-57EC-87DA-1DB460D64046,"iPhone13,2"
com.apple.Music,6,1717166944,1717166950,1717166950.913192,-18000,EB445137-D7F5-57EC-87DA-1DB460D64046,"iPhone13,2"
com.apple.Music,66,1717166524,1717166590,1717166590.6632009,-18000,EB445137-D7F5-57EC-87DA-1DB460D64046,"iPhone13,2"
com.doordash.dasher,56,1717166456,1717166512,1717166512.914952,-18000,EB445137-D7F5-57EC-87DA-1DB460D64046,"iPhone13,2"
com.hammerandchisel.discord,6,1717166449,1717166455,1717166455.3854241,-18000,EB445137-D7F5-57EC-87DA-1DB460D64046,"iPhone13,2"
com.muscleforlife.Stacked,66,1717166382,1717166448,1717166448.1131501,-18000,EB445137-D7F5-57EC-87DA-1DB460D64046,"iPhone13,2"
com.muscleforlife.Stacked,3,1717166376,1717166379,1717166379.006964,-18000,EB445137-D7F5-57EC-87DA-1DB460D64046,"iPhone13,2"
com.muscleforlife.Stacked,6,1717166357,1717166363,1717166363.722687,-18000,EB445137-D7F5-57EC-87DA-1DB460D64046,"iPhone13,2"
com.muscleforlife.Stacked,6,1717166301,1717166307,1717166307.4749599,-18000,EB445137-D7F5-57EC-87DA-1DB460D64046,"iPhone13,2"
com.muscleforlife.Stacked,10,1717166289,1717166299,1717166299.517622,-18000,EB445137-D7F5-57EC-87DA-1DB460D64046,"iPhone13,2"
com.muscleforlife.Stacked,16,1717166272,1717166288,1717166288.810184,-18000,EB445137-D7F5-57EC-87DA-1DB460D64046,"iPhone13,2"
com.muscleforlife.Stacked,79,1717166131,1717166210,1717166210.9532452,-18000,EB445137-D7F5-57EC-87DA-1DB460D64046,"iPhone13,2"
com.muscleforlife.Stacked,5,1717166104,1717166109,1717166109.332498,-18000,EB445137-D7F5-57EC-87DA-1DB460D64046,"iPhone13,2"
com.muscleforlife.Stacked,68,1717166005,1717166073,1717166073.05716,-18000,EB445137-D7F5-57EC-87DA-1DB460D64046,"iPhone13,2"
com.muscleforlife.Stacked,8,1717165961,1717165969,1717165969.7412782,-18000,EB445137-D7F5-57EC-87DA-1DB460D64046,"iPhone13,2"
com.muscleforlife.Stacked,6,1717165899,1717165905,1717165905.849568,-18000,EB445137-D7F5-57EC-87DA-1DB460D64046,"iPhone13,2"
com.muscleforlife.Stacked,8,1717165890,1717165898,1717165898.511704,-18000,EB445137-D7F5-57EC-87DA-1DB460D64046,"iPhone13,2"
com.muscleforlife.Stacked,5,1717165861,1717165866,1717165866.07815,-18000,EB445137-D7F5-57EC-87DA-1DB460D64046,"iPhone13,2"
com.muscleforlife.Stacked,10,1717165837,1717165847,1717165847.090363,-18000,EB445137-D7F5-57EC-87DA-1DB460D64046,"iPhone13,2"
com.muscleforlife.Stacked,60,1717165738,1717165798,1717165798.32869,-18000,EB445137-D7F5-57EC-87DA-1DB460D64046,"iPhone13,2"
com.muscleforlife.Stacked,7,1717165689,1717165696,1717165696.2439098,-18000,EB445137-D7F5-57EC-87DA-1DB460D64046,"iPhone13,2"
com.muscleforlife.Stacked,109,1717165529,1717165638,1717165638.6858811,-18000,EB445137-D7F5-57EC-87DA-1DB460D64046,"iPhone13,2"
com.muscleforlife.Stacked,4,1717165452,1717165456,1717165456.533905,-18000,EB445137-D7F5-57EC-87DA-1DB460D64046,"iPhone13,2"
com.muscleforlife.Stacked,11,1717165410,1717165421,1717165421.352026,-18000,EB445137-D7F5-57EC-87DA-1DB460D64046,"iPhone13,2"
com.muscleforlife.Stacked,43,1717165313,1717165356,1717165356.806849,-18000,EB445137-D7F5-57EC-87DA-1DB460D64046,"iPhone13,2"
com.muscleforlife.Stacked,4,1717165290,1717165294,1717165294.278335,-18000,EB445137-D7F5-57EC-87DA-1DB460D64046,"iPhone13,2"
com.muscleforlife.Stacked,4,1717165251,1717165255,1717165255.495064,-18000,EB445137-D7F5-57EC-87DA-1DB460D64046,"iPhone13,2"
com.muscleforlife.Stacked,35,1717165184,1717165219,1717165219.043913,-18000,EB445137-D7F5-57EC-87DA-1DB460D64046,"iPhone13,2"
com.muscleforlife.Stacked,3,1717165154,1717165157,1717165157.8352451,-18000,EB445137-D7F5-57EC-87DA-1DB460D64046,"iPhone13,2"
com.muscleforlife.Stacked,10,1717165110,1717165120,1717165120.37834,-18000,EB445137-D7F5-57EC-87DA-1DB460D64046,"iPhone13,2"
com.muscleforlife.Stacked,16,1717165048,1717165064,1717165064.7986321,-18000,EB445137-D7F5-57EC-87DA-1DB460D64046,"iPhone13,2"
com.muscleforlife.Stacked,4,1717165023,1717165027,1717165027.542324,-18000,EB445137-D7F5-57EC-87DA-1DB460D64046,"iPhone13,2"
com.muscleforlife.Stacked,9,1717165001,1717165010,1717165010.715293,-18000,EB445137-D7F5-57EC-87DA-1DB460D64046,"iPhone13,2"
com.muscleforlife.Stacked,5,1717164960,1717164965,1717164965.891123,-18000,EB445137-D7F5-57EC-87DA-1DB460D64046,"iPhone13,2"
com.muscleforlife.Stacked,112,1717164806,1717164918,1717164918.252181,-18000,EB445137-D7F5-57EC-87DA-1DB460D64046,"iPhone13,2"
com.muscleforlife.Stacked,111,1717164641,1717164752,1717164752.854183,-18000,EB445137-D7F5-57EC-87DA-1DB460D64046,"iPhone13,2"
com.muscleforlife.Stacked,6,1717164584,1717164590,1717164590.8251839,-18000,EB445137-D7F5-57EC-87DA-1DB460D64046,"iPhone13,2"
com.muscleforlife.Stacked,5,1717164553,1717164558,1717164558.993431,-18000,EB445137-D7F5-57EC-87DA-1DB460D64046,"iPhone13,2"
com.muscleforlife.Stacked,5,1717164476,1717164481,1717164481.907435,-18000,EB445137-D7F5-57EC-87DA-1DB460D64046,"iPhone13,2"
com.muscleforlife.Stacked,7,1717164441,1717164448,1717164448.687207,-18000,EB445137-D7F5-57EC-87DA-1DB460D64046,"iPhone13,2"
com.muscleforlife.Stacked,28,1717164379,1717164407,1717164407.7273002,-18000,EB445137-D7F5-57EC-87DA-1DB460D64046,"iPhone13,2"
com.apple.Music,3,1717164376,1717164379,1717164379.442744,-18000,EB445137-D7F5-57EC-87DA-1DB460D64046,"iPhone13,2"
com.apple.Music,4,1717164332,1717164336,1717164336.5106921,-18000,EB445137-D7F5-57EC-87DA-1DB460D64046,"iPhone13,2"
com.apple.Music,8,1717164088,1717164096,1717164096.3621988,-18000,EB445137-D7F5-57EC-87DA-1DB460D64046,"iPhone13,2"
com.apple.Music,68,1717163665,1717163733,1717163733.776247,-18000,EB445137-D7F5-57EC-87DA-1DB460D64046,"iPhone13,2"
com.apple.MobileSMS,3,1717163661,1717163664,1717163664.801426,-18000,EB445137-D7F5-57EC-87DA-1DB460D64046,"iPhone13,2"
com.robinhood.release.Robinhood,13,1717163264,1717163277,1717163277.195492,-18000,EB445137-D7F5-57EC-87DA-1DB460D64046,"iPhone13,2"
com.google.chrome.ios,178,1717163086,1717163264,1717163264.648734,-18000,EB445137-D7F5-57EC-87DA-1DB460D64046,"iPhone13,2"
com.robinhood.release.Robinhood,143,1717162942,1717163085,1717163085.556436,-18000,EB445137-D7F5-57EC-87DA-1DB460D64046,"iPhone13,2"
com.fis.513iPhoneSUB,121,1717162814,1717162935,1717162935.885755,-18000,EB445137-D7F5-57EC-87DA-1DB460D64046,"iPhone13,2"
com.truebill.truebillnative,89,1717162724,1717162813,1717162813.8263469,-18000,EB445137-D7F5-57EC-87DA-1DB460D64046,"iPhone13,2"
com.clairmail.fth.client,44,1717162678,1717162722,1717162722.4835,-18000,EB445137-D7F5-57EC-87DA-1DB460D64046,"iPhone13,2"
com.google.chrome.ios,35,1717162632,1717162667,1717162668.127702,-18000,EB445137-D7F5-57EC-87DA-1DB460D64046,"iPhone13,2"
com.apple.shortcuts,3,1717162613,1717162616,1717162616.4661589,-18000,EB445137-D7F5-57EC-87DA-1DB460D64046,"iPhone13,2"
com.apple.shortcuts,23,1717162392,1717162415,1717162415.2456598,-18000,EB445137-D7F5-57EC-87DA-1DB460D64046,"iPhone13,2"
com.apple.MobileSMS,3,1717162383,1717162386,1717162386.214795,-18000,EB445137-D7F5-57EC-87DA-1DB460D64046,"iPhone13,2"
com.microsoft.Office.Outlook,28,1717162353,1717162381,1717162381.866149,-18000,EB445137-D7F5-57EC-87DA-1DB460D64046,"iPhone13,2"
Astrospheric.Astrospheric,11,1717162342,1717162353,1717162353.55357,-18000,EB445137-D7F5-57EC-87DA-1DB460D64046,"iPhone13,2"
Astrospheric.Astrospheric,6,1717162068,1717162074,1717162074.962538,-18000,EB445137-D7F5-57EC-87DA-1DB460D64046,"iPhone13,2"
com.apple.findmy,2,1717162064,1717162066,1717162066.791569,-18000,EB445137-D7F5-57EC-87DA-1DB460D64046,"iPhone13,2"
com.microsoft.rdc.macos,192,1717161935,1717162127,1717162127.637763,-18000,,
com.microsoft.rdc.macos,28,1717161729,1717161757,1717161757.501421,-18000,,
com.google.Chrome,2,1717161727,1717161729,1717161729.921195,-18000,,
com.apple.findmy,4,1717161599,1717161603,1717161603.330875,-18000,EB445137-D7F5-57EC-87DA-1DB460D64046,"iPhone13,2"
com.apple.MobileSMS,35,1717161324,1717161359,1717161359.030778,-18000,EB445137-D7F5-57EC-87DA-1DB460D64046,"iPhone13,2"
com.apple.weather,11,1717160732,1717160743,1717160743.4535952,-18000,EB445137-D7F5-57EC-87DA-1DB460D64046,"iPhone13,2"
com.apple.Health,0,1717160659,1717160659,1717160659.88807,-18000,EB445137-D7F5-57EC-87DA-1DB460D64046,"iPhone13,2"
com.apple.Health,25,1717160400,1717160425,1717160425.913357,-18000,EB445137-D7F5-57EC-87DA-1DB460D64046,"iPhone13,2"
com.google.Chrome,7,1717128681,1717128688,1717128688.1561608,-18000,,
com.google.Chrome,92,1717128587,1717128679,1717128679.681851,-18000,,
com.google.Chrome,333,1717127250,1717127583,1717127583.79111,-18000,,
com.apple.finder,5,1717127245,1717127250,1717127250.837827,-18000,,
com.apple.finder,2,1717126409,1717126411,1717126411.921742,-18000,,
com.microsoft.rdc.macos,21,1717126388,1717126409,1717126409.3780398,-18000,,
com.apple.finder,2,1717126386,1717126388,1717126388.606525,-18000,,
com.apple.iCal,1,1717126385,1717126386,1717126386.64508,-18000,,
com.microsoft.onenote.mac,272,1717126113,1717126385,1717126385.663794,-18000,,
com.apple.iCal,142,1717125971,1717126113,1717126113.958014,-18000,,
com.microsoft.onenote.mac,773,1717125198,1717125971,1717125971.2793121,-18000,,
com.microsoft.rdc.macos,12,1717125186,1717125198,1717125198.929933,-18000,,
com.microsoft.rdc.macos,250,1717123028,1717123278,1717123278.870977,-18000,,
com.microsoft.rdc.macos,1823,1717121191,1717123014,1717123014.758057,-18000,,
org.stellarium.Stellarium,22,1717121169,1717121191,1717121191.985355,-18000,,
com.microsoft.rdc.macos,24,1717121145,1717121169,1717121169.050959,-18000,,
com.google.Chrome,7,1717121138,1717121145,1717121145.3777928,-18000,,
com.google.Chrome,314,1717108937,1717109251,1717109251.710089,-18000,,
com.apple.MobileSMS,3,1717108934,1717108937,1717108937.211323,-18000,,
com.apple.MobileSMS,3,1717108474,1717108477,1717108477.082168,-18000,,
com.google.Chrome,148,1717108326,1717108474,1717108474.5598478,-18000,,
com.apple.MobileSMS,180,1717097441,1717097621,1717097621.768762,-18000,EB445137-D7F5-57EC-87DA-1DB460D64046,"iPhone13,2"
com.apple.camera,78,1717097362,1717097440,1717097440.604696,-18000,EB445137-D7F5-57EC-87DA-1DB460D64046,"iPhone13,2"
com.google.chrome.ios,9,1717097361,1717097370,1717097372.58455,-18000,EB445137-D7F5-57EC-87DA-1DB460D64046,"iPhone13,2"
com.google.chrome.ios,2,1717097290,1717097292,1717097292.721807,-18000,EB445137-D7F5-57EC-87DA-1DB460D64046,"iPhone13,2"
com.google.chrome.ios,1,1717097280,1717097281,1717097281.887049,-18000,EB445137-D7F5-57EC-87DA-1DB460D64046,"iPhone13,2"
com.google.chrome.ios,43,1717097206,1717097249,1717097249.5506248,-18000,EB445137-D7F5-57EC-87DA-1DB460D64046,"iPhone13,2"
com.clairmail.fth.client,3,1717097201,1717097204,1717097204.254786,-18000,EB445137-D7F5-57EC-87DA-1DB460D64046,"iPhone13,2"
com.clairmail.fth.client,4,1717096671,1717096675,1717096675.787621,-18000,EB445137-D7F5-57EC-87DA-1DB460D64046,"iPhone13,2"
com.clairmail.fth.client,2,1717096473,1717096475,1717096475.9424381,-18000,EB445137-D7F5-57EC-87DA-1DB460D64046,"iPhone13,2"
com.clairmail.fth.client,6,1717096442,1717096448,1717096448.9745522,-18000,EB445137-D7F5-57EC-87DA-1DB460D64046,"iPhone13,2"
com.clairmail.fth.client,3,1717095547,1717095550,1717095550.509933,-18000,EB445137-D7F5-57EC-87DA-1DB460D64046,"iPhone13,2"
com.clairmail.fth.client,7,1717095502,1717095509,1717095509.594863,-18000,EB445137-D7F5-57EC-87DA-1DB460D64046,"iPhone13,2"
com.clairmail.fth.client,11,1717095207,1717095218,1717095218.592866,-18000,EB445137-D7F5-57EC-87DA-1DB460D64046,"iPhone13,2"
com.clairmail.fth.client,14,1717094177,1717094191,1717094191.940006,-18000,EB445137-D7F5-57EC-87DA-1DB460D64046,"iPhone13,2"
com.toyopagroup.picaboo,7,1717092144,1717092151,1717092151.992451,-18000,EB445137-D7F5-57EC-87DA-1DB460D64046,"iPhone13,2"
com.toyopagroup.picaboo,8,1717092066,1717092074,1717092074.384465,-18000,EB445137-D7F5-57EC-87DA-1DB460D64046,"iPhone13,2"
com.ubercab.UberPartner,3,1717092063,1717092066,1717092067.00472,-18000,EB445137-D7F5-57EC-87DA-1DB460D64046,"iPhone13,2"
com.ubercab.UberPartner,167,1717091717,1717091884,1717091884.615549,-18000,EB445137-D7F5-57EC-87DA-1DB460D64046,"iPhone13,2"
com.doordash.dasher,9,1717091708,1717091717,1717091717.7123451,-18000,EB445137-D7F5-57EC-87DA-1DB460D64046,"iPhone13,2"
com.apple.MobileSMS,4,1717091702,1717091706,1717091706.55088,-18000,EB445137-D7F5-57EC-87DA-1DB460D64046,"iPhone13,2"
com.apple.Music,3,1717091698,1717091701,1717091701.6258101,-18000,EB445137-D7F5-57EC-87DA-1DB460D64046,"iPhone13,2"
com.apple.Music,72,1717091399,1717091471,1717091471.514566,-18000,EB445137-D7F5-57EC-87DA-1DB460D64046,"iPhone13,2"
com.apple.Maps,4,1717091394,1717091398,1717091398.225134,-18000,EB445137-D7F5-57EC-87DA-1DB460D64046,"iPhone13,2"
com.apple.Maps,770,1717090577,1717091347,1717091347.498928,-18000,EB445137-D7F5-57EC-87DA-1DB460D64046,"iPhone13,2"
com.apple.calculator,9,1717090564,1717090573,1717090573.163176,-18000,EB445137-D7F5-57EC-87DA-1DB460D64046,"iPhone13,2"
com.doordash.dasher,35,1717090529,1717090564,1717090564.9609041,-18000,EB445137-D7F5-57EC-87DA-1DB460D64046,"iPhone13,2"
com.apple.MobileSMS,34,1717090488,1717090522,1717090522.2338638,-18000,EB445137-D7F5-57EC-87DA-1DB460D64046,"iPhone13,2"
com.apple.mobilecal,8,1717090480,1717090488,1717090488.0756521,-18000,EB445137-D7F5-57EC-87DA-1DB460D64046,"iPhone13,2"
com.apple.MobileSMS,35,1717090444,1717090479,1717090479.154827,-18000,EB445137-D7F5-57EC-87DA-1DB460D64046,"iPhone13,2"
com.doordash.dasher,68,1717090372,1717090440,1717090440.955842,-18000,EB445137-D7F5-57EC-87DA-1DB460D64046,"iPhone13,2"
com.doordash.dasher,317,1717090029,1717090346,1717090346.9204721,-18000,EB445137-D7F5-57EC-87DA-1DB460D64046,"iPhone13,2"
com.doordash.dasher,2142,1717087886,1717090028,1717090028.951726,-18000,EB445137-D7F5-57EC-87DA-1DB460D64046,"iPhone13,2"
com.doordash.dasher,663,1717087194,1717087857,1717087857.811338,-18000,EB445137-D7F5-57EC-87DA-1DB460D64046,"iPhone13,2"
org.name.serializdmobile,14,1717087179,1717087193,1717087193.405832,-18000,EB445137-D7F5-57EC-87DA-1DB460D64046,"iPhone13,2"
com.google.chrome.ios,21,1717087157,1717087178,1717087178.5544639,-18000,EB445137-D7F5-57EC-87DA-1DB460D64046,"iPhone13,2"
com.doordash.dasher,1020,1717086137,1717087157,1717087158.067079,-18000,EB445137-D7F5-57EC-87DA-1DB460D64046,"iPhone13,2"
com.apple.podcasts,73,1717086064,1717086137,1717086137.352675,-18000,EB445137-D7F5-57EC-87DA-1DB460D64046,"iPhone13,2"
com.doordash.dasher,508,1717085554,1717086062,1717086062.394186,-18000,EB445137-D7F5-57EC-87DA-1DB460D64046,"iPhone13,2"
com.doordash.dasher,381,1717085162,1717085543,1717085543.782751,-18000,EB445137-D7F5-57EC-87DA-1DB460D64046,"iPhone13,2"
com.truebill.truebillnative,159,1717085003,1717085162,1717085162.141113,-18000,EB445137-D7F5-57EC-87DA-1DB460D64046,"iPhone13,2"
com.doordash.dasher,73,1717084917,1717084990,1717084990.176229,-18000,EB445137-D7F5-57EC-87DA-1DB460D64046,"iPhone13,2"
com.apple.findmy,52,1717084865,1717084917,1717084917.926213,-18000,EB445137-D7F5-57EC-87DA-1DB460D64046,"iPhone13,2"
com.doordash.dasher,133,1717084725,1717084858,1717084858.3147469,-18000,EB445137-D7F5-57EC-87DA-1DB460D64046,"iPhone13,2"
com.apple.MobileSMS,53,1717084672,1717084725,1717084725.557208,-18000,EB445137-D7F5-57EC-87DA-1DB460D64046,"iPhone13,2"
com.doordash.dasher,418,1717084249,1717084667,1717084667.732593,-18000,EB445137-D7F5-57EC-87DA-1DB460D64046,"iPhone13,2"
com.doordash.dasher,38,1717084208,1717084246,1717084246.609436,-18000,EB445137-D7F5-57EC-87DA-1DB460D64046,"iPhone13,2"
com.apple.MobileSMS,2,1717084205,1717084207,1717084207.150068,-18000,EB445137-D7F5-57EC-87DA-1DB460D64046,"iPhone13,2"
com.google.Chrome,3,1717084161,1717084164,1717084164.341103,-18000,,
com.google.Chrome,443,1717083614,1717084057,1717084057.168662,-18000,,
com.robinhood.release.Robinhood,167,1717083578,1717083745,1717083745.850944,-18000,EB445137-D7F5-57EC-87DA-1DB460D64046,"iPhone13,2"
com.truebill.truebillnative,3,1717083573,1717083576,1717083576.389927,-18000,EB445137-D7F5-57EC-87DA-1DB460D64046,"iPhone13,2"
com.apple.calculator,52,1717083562,1717083614,1717083614.750565,-18000,,
com.google.Chrome,6,1717083556,1717083562,1717083562.126625,-18000,,
com.apple.calculator,71,1717083485,1717083556,1717083556.593502,-18000,,
com.google.Chrome,129,1717083356,1717083485,1717083485.2732239,-18000,,
com.apple.calculator,0,1717083356,1717083356,1717083356.923639,-18000,,
com.google.Chrome,12,1717083344,1717083356,1717083356.198317,-18000,,
com.apple.calculator,12,1717083332,1717083344,1717083344.787616,-18000,,
com.google.Chrome,4,1717083328,1717083332,1717083332.593204,-18000,,
com.apple.calculator,4,1717083324,1717083328,1717083328.683148,-18000,,
com.google.Chrome,2,1717083322,1717083324,1717083324.2702808,-18000,,
com.apple.calculator,15,1717083307,1717083322,1717083322.417496,-18000,,
com.google.Chrome,36,1717083271,1717083307,1717083307.6397371,-18000,,
com.apple.calculator,27,1717083244,1717083271,1717083271.4183831,-18000,,
com.truebill.truebillnative,109,1717083198,1717083307,1717083307.2700372,-18000,EB445137-D7F5-57EC-87DA-1DB460D64046,"iPhone13,2"
com.apple.MobileSMS,5,1717083193,1717083198,1717083198.24312,-18000,EB445137-D7F5-57EC-87DA-1DB460D64046,"iPhone13,2"
com.google.Chrome,168,1717083076,1717083244,1717083244.063847,-18000,,
com.apple.systempreferences,2,1717083074,1717083076,1717083076.0756478,-18000,,
com.myfitnesspal.mfp,45,1717083040,1717083085,1717083085.722456,-18000,EB445137-D7F5-57EC-87DA-1DB460D64046,"iPhone13,2"
com.google.Chrome,44,1717083024,1717083068,1717083068.2991219,-18000,,
com.apple.MobileSMS,4,1717083020,1717083024,1717083025.992625,-18000,,
com.apple.finder,5,1717083015,1717083020,1717083020.8370361,-18000,,
com.myfitnesspal.mfp,1,1717082989,1717082990,1717082990.029561,-18000,EB445137-D7F5-57EC-87DA-1DB460D64046,"iPhone13,2"
com.myfitnesspal.mfp,100,1717082882,1717082982,1717082982.900275,-18000,EB445137-D7F5-57EC-87DA-1DB460D64046,"iPhone13,2"
com.apple.weather,2,1717082880,1717082882,1717082882.246943,-18000,EB445137-D7F5-57EC-87DA-1DB460D64046,"iPhone13,2"
com.apple.weather,19,1717082483,1717082502,1717082502.390363,-18000,EB445137-D7F5-57EC-87DA-1DB460D64046,"iPhone13,2"
com.gasbuddymobile.gasbuddy,38,1717081029,1717081067,1717081067.760309,-18000,EB445137-D7F5-57EC-87DA-1DB460D64046,"iPhone13,2"
com.apple.Music,3,1717081024,1717081027,1717081027.731158,-18000,EB445137-D7F5-57EC-87DA-1DB460D64046,"iPhone13,2"
com.apple.Music,6,1717080662,1717080668,1717080668.971537,-18000,EB445137-D7F5-57EC-87DA-1DB460D64046,"iPhone13,2"
com.apple.Music,69,1717080401,1717080470,1717080470.5516238,-18000,EB445137-D7F5-57EC-87DA-1DB460D64046,"iPhone13,2"
com.ubercab.UberPartner,53,1717080343,1717080396,1717080396.9460402,-18000,EB445137-D7F5-57EC-87DA-1DB460D64046,"iPhone13,2"
com.apple.stocks,15,1717080323,1717080338,1717080338.550754,-18000,EB445137-D7F5-57EC-87DA-1DB460D64046,"iPhone13,2"
com.muscleforlife.Stacked,4,1717080282,1717080286,1717080286.623653,-18000,EB445137-D7F5-57EC-87DA-1DB460D64046,"iPhone13,2"
com.muscleforlife.Stacked,21,1717080226,1717080247,1717080247.330065,-18000,EB445137-D7F5-57EC-87DA-1DB460D64046,"iPhone13,2"
com.muscleforlife.Stacked,15,1717080159,1717080174,1717080174.920117,-18000,EB445137-D7F5-57EC-87DA-1DB460D64046,"iPhone13,2"
com.apple.MobileSMS,1,1717080158,1717080159,1717080159.4348369,-18000,EB445137-D7F5-57EC-87DA-1DB460D64046,"iPhone13,2"
com.muscleforlife.Stacked,45,1717080113,1717080158,1717080158.145644,-18000,EB445137-D7F5-57EC-87DA-1DB460D64046,"iPhone13,2"
com.muscleforlife.Stacked,8,1717080072,1717080080,1717080080.440918,-18000,EB445137-D7F5-57EC-87DA-1DB460D64046,"iPhone13,2"
com.muscleforlife.Stacked,46,1717079982,1717080028,1717080028.701834,-18000,EB445137-D7F5-57EC-87DA-1DB460D64046,"iPhone13,2"
com.muscleforlife.Stacked,5,1717079879,1717079884,1717079884.512435,-18000,EB445137-D7F5-57EC-87DA-1DB460D64046,"iPhone13,2"
com.muscleforlife.Stacked,39,1717079820,1717079859,1717079859.763115,-18000,EB445137-D7F5-57EC-87DA-1DB460D64046,"iPhone13,2"
com.apple.MobileSMS,16,1717079804,1717079820,1717079820.1236892,-18000,EB445137-D7F5-57EC-87DA-1DB460D64046,"iPhone13,2"
com.muscleforlife.Stacked,59,1717079745,1717079804,1717079805.076851,-18000,EB445137-D7F5-57EC-87DA-1DB460D64046,"iPhone13,2"
com.muscleforlife.Stacked,65,1717079653,1717079718,1717079718.635529,-18000,EB445137-D7F5-57EC-87DA-1DB460D64046,"iPhone13,2"
com.google.chrome.ios,21,1717079632,1717079653,1717079654.060471,-18000,EB445137-D7F5-57EC-87DA-1DB460D64046,"iPhone13,2"
com.muscleforlife.Stacked,14,1717079618,1717079632,1717079632.5604892,-18000,EB445137-D7F5-57EC-87DA-1DB460D64046,"iPhone13,2"
com.muscleforlife.Stacked,28,1717079553,1717079581,1717079581.203927,-18000,EB445137-D7F5-57EC-87DA-1DB460D64046,"iPhone13,2"
com.muscleforlife.Stacked,4,1717079480,1717079484,1717079484.7895908,-18000,EB445137-D7F5-57EC-87DA-1DB460D64046,"iPhone13,2"
com.apple.MobileSMS,2,1717079478,1717079480,1717079480.563661,-18000,EB445137-D7F5-57EC-87DA-1DB460D64046,"iPhone13,2"
com.muscleforlife.Stacked,3,1717079475,1717079478,1717079478.0257878,-18000,EB445137-D7F5-57EC-87DA-1DB460D64046,"iPhone13,2"
com.muscleforlife.Stacked,2,1717079456,1717079458,1717079458.463059,-18000,EB445137-D7F5-57EC-87DA-1DB460D64046,"iPhone13,2"
com.apple.MobileSMS,21,1717079435,1717079456,1717079456.507653,-18000,EB445137-D7F5-57EC-87DA-1DB460D64046,"iPhone13,2"
com.muscleforlife.Stacked,55,1717079380,1717079435,1717079435.927789,-18000,EB445137-D7F5-57EC-87DA-1DB460D64046,"iPhone13,2"
com.muscleforlife.Stacked,29,1717079283,1717079312,1717079312.1126199,-18000,EB445137-D7F5-57EC-87DA-1DB460D64046,"iPhone13,2"
com.muscleforlife.Stacked,7,1717079195,1717079202,1717079202.467208,-18000,EB445137-D7F5-57EC-87DA-1DB460D64046,"iPhone13,2"
com.muscleforlife.Stacked,88,1717079025,1717079113,1717079113.607131,-18000,EB445137-D7F5-57EC-87DA-1DB460D64046,"iPhone13,2"
com.muscleforlife.Stacked,108,1717078885,1717078993,1717078993.871666,-18000,EB445137-D7F5-57EC-87DA-1DB460D64046,"iPhone13,2"
com.muscleforlife.Stacked,36,1717078815,1717078851,1717078851.104207,-18000,EB445137-D7F5-57EC-87DA-1DB460D64046,"iPhone13,2"
com.doordash.dasher,17,1717078798,1717078815,1717078815.626563,-18000,EB445137-D7F5-57EC-87DA-1DB460D64046,"iPhone13,2"
com.apple.Health,16,1717078776,1717078792,1717078792.1501942,-18000,EB445137-D7F5-57EC-87DA-1DB460D64046,"iPhone13,2"
com.muscleforlife.Stacked,30,1717078742,1717078772,1717078772.494508,-18000,EB445137-D7F5-57EC-87DA-1DB460D64046,"iPhone13,2"
com.muscleforlife.Stacked,6,1717078605,1717078611,1717078611.881561,-18000,EB445137-D7F5-57EC-87DA-1DB460D64046,"iPhone13,2"
com.muscleforlife.Stacked,8,1717078596,1717078604,1717078604.604484,-18000,EB445137-D7F5-57EC-87DA-1DB460D64046,"iPhone13,2"
com.muscleforlife.Stacked,15,1717078581,1717078596,1717078596.306334,-18000,EB445137-D7F5-57EC-87DA-1DB460D64046,"iPhone13,2"
com.muscleforlife.Stacked,11,1717078524,1717078535,1717078535.0187979,-18000,EB445137-D7F5-57EC-87DA-1DB460D64046,"iPhone13,2"
com.apple.camera,6,1717078511,1717078517,1717078517.337997,-18000,EB445137-D7F5-57EC-87DA-1DB460D64046,"iPhone13,2"
com.apple.Music,3,1717078458,1717078461,1717078462.004407,-18000,EB445137-D7F5-57EC-87DA-1DB460D64046,"iPhone13,2"
com.apple.Music,7,1717078310,1717078317,1717078317.184379,-18000,EB445137-D7F5-57EC-87DA-1DB460D64046,"iPhone13,2"
com.apple.Music,5,1717077847,1717077852,1717077852.6024718,-18000,EB445137-D7F5-57EC-87DA-1DB460D64046,"iPhone13,2"
com.google.ios.youtube,7,1717077838,1717077845,1717077845.362997,-18000,EB445137-D7F5-57EC-87DA-1DB460D64046,"iPhone13,2"
com.google.ios.youtube,432,1717077300,1717077732,1717077732.507617,-18000,EB445137-D7F5-57EC-87DA-1DB460D64046,"iPhone13,2"
com.truebill.truebillnative,213,1717077080,1717077293,1717077293.8390079,-18000,EB445137-D7F5-57EC-87DA-1DB460D64046,"iPhone13,2"
com.google.Sheets,3,1717077075,1717077078,1717077078.38884,-18000,EB445137-D7F5-57EC-87DA-1DB460D64046,"iPhone13,2"
com.google.Sheets,34,1717076888,1717076922,1717076922.325824,-18000,EB445137-D7F5-57EC-87DA-1DB460D64046,"iPhone13,2"
com.clairmail.fth.client,15,1717076872,1717076887,1717076887.2697291,-18000,EB445137-D7F5-57EC-87DA-1DB460D64046,"iPhone13,2"
com.apple.camera,2,1717076867,1717076869,1717076869.1892118,-18000,EB445137-D7F5-57EC-87DA-1DB460D64046,"iPhone13,2"
com.apple.calculator,12,1717076860,1717076872,1717076872.399087,-18000,EB445137-D7F5-57EC-87DA-1DB460D64046,"iPhone13,2"
com.apple.calculator,15,1717076806,1717076821,1717076821.296572,-18000,EB445137-D7F5-57EC-87DA-1DB460D64046,"iPhone13,2"
com.apple.mobilecal,40,1717076766,1717076806,1717076806.1506472,-18000,EB445137-D7F5-57EC-87DA-1DB460D64046,"iPhone13,2"
com.clairmail.fth.client,21,1717076743,1717076764,1717076764.1594548,-18000,EB445137-D7F5-57EC-87DA-1DB460D64046,"iPhone13,2"
com.apple.findmy,7,1717076236,1717076243,1717076243.488031,-18000,EB445137-D7F5-57EC-87DA-1DB460D64046,"iPhone13,2"
com.apple.Preferences,19,1717076216,1717076235,1717076235.179586,-18000,EB445137-D7F5-57EC-87DA-1DB460D64046,"iPhone13,2"
com.apple.findmy,16,1717076190,1717076206,1717076206.4429312,-18000,EB445137-D7F5-57EC-87DA-1DB460D64046,"iPhone13,2"
com.microsoft.Office.Outlook,38,1717076151,1717076189,1717076189.840559,-18000,EB445137-D7F5-57EC-87DA-1DB460D64046,"iPhone13,2"
com.clairmail.fth.client,11,1717076133,1717076144,1717076144.938274,-18000,EB445137-D7F5-57EC-87DA-1DB460D64046,"iPhone13,2"
com.apple.finder,2,1717039769,1717039771,1717039772.115607,-18000,,
com.google.Chrome,4,1717039765,1717039769,1717039769.145477,-18000,,
com.apple.MobileSMS,1,1717039764,1717039765,1717039765.4484792,-18000,,
com.google.Chrome,712,1717039052,1717039764,1717039764.8374019,-18000,,
com.apple.MobileSMS,2,1717039050,1717039052,1717039053.052925,-18000,,
com.google.Chrome,432,1717038618,1717039050,1717039050.0758882,-18000,,
com.google.Chrome,1255,1717037193,1717038448,1717038448.935042,-18000,,
com.google.Chrome,1205,1717035686,1717036891,1717036891.128419,-18000,,
com.microsoft.Excel,2,1717035684,1717035686,1717035686.858121,-18000,,
com.apple.MobileSMS,3,1717035681,1717035684,1717035685.0050712,-18000,,
com.microsoft.Excel,5,1717035676,1717035681,1717035681.7024832,-18000,,
com.microsoft.Excel,226,1717022360,1717022586,1717022586.027063,-18000,,
com.apple.finder,17,1717022343,1717022360,1717022360.8744102,-18000,,
com.google.Chrome,2,1717022341,1717022343,1717022343.110104,-18000,,
com.google.Chrome,328,1717018807,1717019135,1717019135.881172,-18000,,
com.google.Chrome,2720,1717015142,1717017862,1717017862.997709,-18000,,
com.apple.finder,7,1717015135,1717015142,1717015142.097105,-18000,,
com.apple.finder,3,1716955355,1716955358,1716955358.9011211,-18000,,
com.apple.iCal,2,1716955353,1716955355,1716955355.083544,-18000,,
com.google.Chrome,102,1716955251,1716955353,1716955353.67332,-18000,,
com.google.Chrome,2198,1716935275,1716937473,1716937473.921345,-18000,,
com.google.Chrome,538,1716934528,1716935066,1716935066.257193,-18000,,
com.google.Chrome,2412,1716931948,1716934360,1716934360.556041,-18000,,
com.google.Chrome,815,1716930650,1716931465,1716931465.698318,-18000,,
com.google.Chrome,396,1716930067,1716930463,1716930463.024743,-18000,,
com.google.Chrome,456,1716929331,1716929787,1716929787.641319,-18000,,
com.google.Chrome,524,1716928650,1716929174,1716929175.0036569,-18000,,
com.google.Chrome,1192,1716923347,1716924539,1716924539.774187,-18000,,
com.google.Chrome,207,1716916328,1716916535,1716916535.475237,-18000,,
com.google.Chrome,557,1716915679,1716916236,1716916236.102872,-18000,,
com.apple.iCal,39,1716915640,1716915679,1716915679.7832642,-18000,,
com.google.Chrome,45,1716915595,1716915640,1716915640.7056432,-18000,,
com.google.chrome.ios,83,1716913898,1716913981,1716913981.787467,-18000,EB445137-D7F5-57EC-87DA-1DB460D64046,"iPhone13,2"
com.apple.MobileSMS,2,1716913896,1716913898,1716913898.321124,-18000,EB445137-D7F5-57EC-87DA-1DB460D64046,"iPhone13,2"
com.truebill.truebillnative,5,1716913891,1716913896,1716913896.8987079,-18000,EB445137-D7F5-57EC-87DA-1DB460D64046,"iPhone13,2"
com.google.Chrome,771,1716913623,1716914394,1716914394.9791532,-18000,,
com.truebill.truebillnative,14,1716913586,1716913600,1716913600.642684,-18000,EB445137-D7F5-57EC-87DA-1DB460D64046,"iPhone13,2"
com.clairmail.fth.client,22,1716913563,1716913585,1716913585.595609,-18000,EB445137-D7F5-57EC-87DA-1DB460D64046,"iPhone13,2"
com.apple.MobileSMS,13,1716913501,1716913514,1716913514.972879,-18000,EB445137-D7F5-57EC-87DA-1DB460D64046,"iPhone13,2"
com.doordash.dasher,36,1716913464,1716913500,1716913500.996585,-18000,EB445137-D7F5-57EC-87DA-1DB460D64046,"iPhone13,2"
com.doordash.dasher,742,1716912715,1716913457,1716913457.883768,-18000,EB445137-D7F5-57EC-87DA-1DB460D64046,"iPhone13,2"
com.apple.podcasts,22,1716912693,1716912715,1716912716.076015,-18000,EB445137-D7F5-57EC-87DA-1DB460D64046,"iPhone13,2"
com.doordash.dasher,21,1716912668,1716912689,1716912689.99477,-18000,EB445137-D7F5-57EC-87DA-1DB460D64046,"iPhone13,2"
com.apple.MobileSMS,13,1716912655,1716912668,1716912668.492605,-18000,EB445137-D7F5-57EC-87DA-1DB460D64046,"iPhone13,2"
com.doordash.dasher,162,1716912493,1716912655,1716912655.2693958,-18000,EB445137-D7F5-57EC-87DA-1DB460D64046,"iPhone13,2"
com.apple.MobileSMS,3,1716912490,1716912493,1716912493.149621,-18000,EB445137-D7F5-57EC-87DA-1DB460D64046,"iPhone13,2"
com.apple.MobileSMS,7,1716912483,1716912490,1716912490.3834782,-18000,EB445137-D7F5-57EC-87DA-1DB460D64046,"iPhone13,2"
com.apple.MobileSMS,6,1716912450,1716912456,1716912456.673759,-18000,EB445137-D7F5-57EC-87DA-1DB460D64046,"iPhone13,2"
com.apple.MobileSMS,121,1716912329,1716912450,1716912450.011692,-18000,EB445137-D7F5-57EC-87DA-1DB460D64046,"iPhone13,2"
com.doordash.dasher,25,1716912304,1716912329,1716912329.3096251,-18000,EB445137-D7F5-57EC-87DA-1DB460D64046,"iPhone13,2"
com.apple.MobileSMS,6,1716912298,1716912304,1716912304.1682181,-18000,EB445137-D7F5-57EC-87DA-1DB460D64046,"iPhone13,2"
com.doordash.dasher,4,1716912294,1716912298,1716912298.600371,-18000,EB445137-D7F5-57EC-87DA-1DB460D64046,"iPhone13,2"
com.apple.MobileSMS,49,1716912245,1716912294,1716912294.173143,-18000,EB445137-D7F5-57EC-87DA-1DB460D64046,"iPhone13,2"
com.doordash.dasher,1977,1716910268,1716912245,1716912245.923933,-18000,EB445137-D7F5-57EC-87DA-1DB460D64046,"iPhone13,2"
com.apple.podcasts,15,1716910253,1716910268,1716910268.4335399,-18000,EB445137-D7F5-57EC-87DA-1DB460D64046,"iPhone13,2"
com.apple.MobileSMS,2,1716910249,1716910251,1716910252.01304,-18000,EB445137-D7F5-57EC-87DA-1DB460D64046,"iPhone13,2"
com.apple.Music,1,1716910245,1716910246,1716910246.672659,-18000,EB445137-D7F5-57EC-87DA-1DB460D64046,"iPhone13,2"
com.doordash.dasher,59,1716910183,1716910242,1716910242.510097,-18000,EB445137-D7F5-57EC-87DA-1DB460D64046,"iPhone13,2"
com.doordash.dasher,19,1716910162,1716910181,1716910181.993747,-18000,EB445137-D7F5-57EC-87DA-1DB460D64046,"iPhone13,2"
com.doordash.dasher,32,1716910128,1716910160,1716910160.830974,-18000,EB445137-D7F5-57EC-87DA-1DB460D64046,"iPhone13,2"
com.apple.camera,0,1716908349,1716908349,1716908349.67622,-18000,EB445137-D7F5-57EC-87DA-1DB460D64046,"iPhone13,2"
com.truebill.truebillnative,124,1716908216,1716908340,1716908341.004218,-18000,EB445137-D7F5-57EC-87DA-1DB460D64046,"iPhone13,2"
com.apple.Music,3,1716908189,1716908192,1716908192.695129,-18000,EB445137-D7F5-57EC-87DA-1DB460D64046,"iPhone13,2"
com.apple.Music,16,1716907981,1716907997,1716907997.995877,-18000,EB445137-D7F5-57EC-87DA-1DB460D64046,"iPhone13,2"
com.apple.Music,8,1716907789,1716907797,1716907797.139643,-18000,EB445137-D7F5-57EC-87DA-1DB460D64046,"iPhone13,2"
com.apple.Music,7,1716907699,1716907706,1716907706.004868,-18000,EB445137-D7F5-57EC-87DA-1DB460D64046,"iPhone13,2"
com.apple.Music,63,1716907601,1716907664,1716907664.38138,-18000,EB445137-D7F5-57EC-87DA-1DB460D64046,"iPhone13,2"
com.doordash.dasher,1,1716907596,1716907597,1716907597.868764,-18000,EB445137-D7F5-57EC-87DA-1DB460D64046,"iPhone13,2"
com.doordash.dasher,30,1716907561,1716907591,1716907591.5983481,-18000,EB445137-D7F5-57EC-87DA-1DB460D64046,"iPhone13,2"
com.muscleforlife.Stacked,5,1716907555,1716907560,1716907560.154911,-18000,EB445137-D7F5-57EC-87DA-1DB460D64046,"iPhone13,2"
com.muscleforlife.Stacked,40,1716907479,1716907519,1716907519.410112,-18000,EB445137-D7F5-57EC-87DA-1DB460D64046,"iPhone13,2"
com.muscleforlife.Stacked,6,1716907468,1716907474,1716907474.34933,-18000,EB445137-D7F5-57EC-87DA-1DB460D64046,"iPhone13,2"
com.muscleforlife.Stacked,27,1716907440,1716907467,1716907467.1510792,-18000,EB445137-D7F5-57EC-87DA-1DB460D64046,"iPhone13,2"
com.muscleforlife.Stacked,111,1716907254,1716907365,1716907365.07557,-18000,EB445137-D7F5-57EC-87DA-1DB460D64046,"iPhone13,2"
com.muscleforlife.Stacked,113,1716907104,1716907217,1716907217.217216,-18000,EB445137-D7F5-57EC-87DA-1DB460D64046,"iPhone13,2"
com.muscleforlife.Stacked,4,1716907037,1716907041,1716907041.701652,-18000,EB445137-D7F5-57EC-87DA-1DB460D64046,"iPhone13,2"
com.muscleforlife.Stacked,14,1716907023,1716907037,1716907037.323853,-18000,EB445137-D7F5-57EC-87DA-1DB460D64046,"iPhone13,2"
com.muscleforlife.Stacked,250,1716906707,1716906957,1716906957.27301,-18000,EB445137-D7F5-57EC-87DA-1DB460D64046,"iPhone13,2"
com.muscleforlife.Stacked,7,1716906650,1716906657,1716906657.206966,-18000,EB445137-D7F5-57EC-87DA-1DB460D64046,"iPhone13,2"
com.doordash.dasher,30,1716906575,1716906605,1716906605.539022,-18000,EB445137-D7F5-57EC-87DA-1DB460D64046,"iPhone13,2"
com.muscleforlife.Stacked,5,1716906567,1716906572,1716906572.0366821,-18000,EB445137-D7F5-57EC-87DA-1DB460D64046,"iPhone13,2"
com.muscleforlife.Stacked,4,1716906546,1716906550,1716906550.040333,-18000,EB445137-D7F5-57EC-87DA-1DB460D64046,"iPhone13,2"
com.muscleforlife.Stacked,13,1716906506,1716906519,1716906519.0524359,-18000,EB445137-D7F5-57EC-87DA-1DB460D64046,"iPhone13,2"
com.muscleforlife.Stacked,2,1716906499,1716906501,1716906501.543942,-18000,EB445137-D7F5-57EC-87DA-1DB460D64046,"iPhone13,2"
com.muscleforlife.Stacked,16,1716906469,1716906485,1716906485.599889,-18000,EB445137-D7F5-57EC-87DA-1DB460D64046,"iPhone13,2"
com.google.ios.youtube,2,1716906466,1716906468,1716906468.604727,-18000,EB445137-D7F5-57EC-87DA-1DB460D64046,"iPhone13,2"
com.google.ios.youtube,6,1716906327,1716906333,1716906333.408228,-18000,EB445137-D7F5-57EC-87DA-1DB460D64046,"iPhone13,2"
com.google.ios.youtube,94,1716906207,1716906301,1716906301.25144,-18000,EB445137-D7F5-57EC-87DA-1DB460D64046,"iPhone13,2"
com.apple.Music,2,1716906205,1716906207,1716906207.536528,-18000,EB445137-D7F5-57EC-87DA-1DB460D64046,"iPhone13,2"
com.apple.Music,76,1716905545,1716905621,1716905621.394827,-18000,EB445137-D7F5-57EC-87DA-1DB460D64046,"iPhone13,2"
com.microsoft.Office.Outlook,3,1716905537,1716905540,1716905540.91124,-18000,EB445137-D7F5-57EC-87DA-1DB460D64046,"iPhone13,2"
com.microsoft.onenote,2,1716905535,1716905537,1716905538.2829661,-18000,EB445137-D7F5-57EC-87DA-1DB460D64046,"iPhone13,2"
com.microsoft.onenote,6,1716904991,1716904997,1716904997.7873,-18000,EB445137-D7F5-57EC-87DA-1DB460D64046,"iPhone13,2"
com.microsoft.onenote,61,1716904884,1716904945,1716904945.5308619,-18000,EB445137-D7F5-57EC-87DA-1DB460D64046,"iPhone13,2"
com.apple.findmy,109,1716903994,1716904103,1716904103.9543881,-18000,EB445137-D7F5-57EC-87DA-1DB460D64046,"iPhone13,2"
com.apple.MobileSMS,17,1716903553,1716903570,1716903570.058826,-18000,EB445137-D7F5-57EC-87DA-1DB460D64046,"iPhone13,2"
com.apple.MobileSMS,10,1716903308,1716903318,1716903318.879653,-18000,EB445137-D7F5-57EC-87DA-1DB460D64046,"iPhone13,2"
com.apple.MobileSMS,17,1716903230,1716903247,1716903247.738754,-18000,EB445137-D7F5-57EC-87DA-1DB460D64046,"iPhone13,2"
com.apple.MobileSMS,23,1716903000,1716903023,1716903023.5682669,-18000,EB445137-D7F5-57EC-87DA-1DB460D64046,"iPhone13,2"
com.apple.MobileSMS,13,1716874849,1716874862,1716874862.6183891,-18000,EB445137-D7F5-57EC-87DA-1DB460D64046,"iPhone13,2"
com.apple.MobileSMS,8,1716874839,1716874847,1716874847.362591,-18000,EB445137-D7F5-57EC-87DA-1DB460D64046,"iPhone13,2"
com.google.Chrome,1,1716874731,1716874732,1716874733.0402908,-18000,,
com.google.Chrome,1513,1716873214,1716874727,1716874727.6735249,-18000,,
com.google.Chrome,811,1716871615,1716872426,1716872426.649646,-18000,,
com.google.Chrome,1730,1716869263,1716870993,1716870993.231073,-18000,,
com.google.Chrome,2,1716869112,1716869114,1716869114.507595,-18000,,
com.google.Chrome,370,1716868738,1716869108,1716869108.9414,-18000,,
com.apple.MobileSMS,4,1716867528,1716867532,1716867532.30449,-18000,EB445137-D7F5-57EC-87DA-1DB460D64046,"iPhone13,2"
com.apple.MobileSMS,24,1716866403,1716866427,1716866427.796412,-18000,EB445137-D7F5-57EC-87DA-1DB460D64046,"iPhone13,2"
com.apple.MobileSMS,4,1716866388,1716866392,1716866392.5005422,-18000,EB445137-D7F5-57EC-87DA-1DB460D64046,"iPhone13,2"
com.google.Chrome,2273,1716866381,1716868654,1716868654.857966,-18000,,
com.apple.iCal,178,1716866203,1716866381,1716866381.731283,-18000,,
com.apple.MobileSMS,289,1716866077,1716866366,1716866366.047766,-18000,EB445137-D7F5-57EC-87DA-1DB460D64046,"iPhone13,2"
com.google.Chrome,449,1716865754,1716866203,1716866203.5173059,-18000,,
com.apple.news,426,1716865376,1716865802,1716865802.49592,-18000,EB445137-D7F5-57EC-87DA-1DB460D64046,"iPhone13,2"
com.google.Chrome,2375,1716863366,1716865741,1716865741.534271,-18000,,
com.google.Chrome,974,1716862302,1716863276,1716863276.976016,-18000,,
com.apple.news,35,1716861314,1716861349,1716861349.390228,-18000,EB445137-D7F5-57EC-87DA-1DB460D64046,"iPhone13,2"
com.google.Chrome,474,1716861033,1716861507,1716861507.121036,-18000,,
com.apple.news,2,1716861011,1716861013,1716861013.323368,-18000,EB445137-D7F5-57EC-87DA-1DB460D64046,"iPhone13,2"
com.apple.news,7,1716860943,1716860950,1716860950.638808,-18000,EB445137-D7F5-57EC-87DA-1DB460D64046,"iPhone13,2"
com.apple.news,7,1716860929,1716860936,1716860936.878388,-18000,EB445137-D7F5-57EC-87DA-1DB460D64046,"iPhone13,2"
com.apple.camera,0,1716860709,1716860709,1716860709.853576,-18000,EB445137-D7F5-57EC-87DA-1DB460D64046,"iPhone13,2"
com.apple.camera,0,1716860706,1716860706,1716860706.914527,-18000,EB445137-D7F5-57EC-87DA-1DB460D64046,"iPhone13,2"
com.apple.news,10,1716860705,1716860715,1716860715.8520079,-18000,EB445137-D7F5-57EC-87DA-1DB460D64046,"iPhone13,2"
com.apple.news,5,1716860694,1716860699,1716860699.3908,-18000,EB445137-D7F5-57EC-87DA-1DB460D64046,"iPhone13,2"
com.apple.news,2,1716860427,1716860429,1716860429.132577,-18000,EB445137-D7F5-57EC-87DA-1DB460D64046,"iPhone13,2"
com.toyopagroup.picaboo,10,1716860401,1716860411,1716860411.933117,-18000,EB445137-D7F5-57EC-87DA-1DB460D64046,"iPhone13,2"
com.apple.MobileSMS,15,1716860385,1716860400,1716860400.810059,-18000,EB445137-D7F5-57EC-87DA-1DB460D64046,"iPhone13,2"
com.apple.MobileSMS,1,1716859720,1716859721,1716859721.5986872,-18000,EB445137-D7F5-57EC-87DA-1DB460D64046,"iPhone13,2"
com.google.chrome.ios,14,1716859435,1716859449,1716859449.8089828,-18000,EB445137-D7F5-57EC-87DA-1DB460D64046,"iPhone13,2"
com.apple.MobileSMS,2,1716859433,1716859435,1716859435.739921,-18000,EB445137-D7F5-57EC-87DA-1DB460D64046,"iPhone13,2"
com.apple.MobileSMS,2,1716859373,1716859375,1716859375.377689,-18000,EB445137-D7F5-57EC-87DA-1DB460D64046,"iPhone13,2"
com.apple.MobileSMS,23,1716859284,1716859307,1716859307.808805,-18000,EB445137-D7F5-57EC-87DA-1DB460D64046,"iPhone13,2"
com.google.Chrome,636,1716857961,1716858597,1716858597.7835898,-18000,,
com.truebill.truebillnative,207,1716856789,1716856996,1716856996.102757,-18000,EB445137-D7F5-57EC-87DA-1DB460D64046,"iPhone13,2"
com.google.Chrome,2906,1716854594,1716857500,1716857500.901902,-18000,,
com.apple.MobileSMS,6,1716854512,1716854518,1716854518.552563,-18000,EB445137-D7F5-57EC-87DA-1DB460D64046,"iPhone13,2"
com.myfitnesspal.mfp,62,1716854437,1716854499,1716854499.710579,-18000,EB445137-D7F5-57EC-87DA-1DB460D64046,"iPhone13,2"
com.apple.mobiletimer,1,1716854436,1716854437,1716854437.6942701,-18000,EB445137-D7F5-57EC-87DA-1DB460D64046,"iPhone13,2"
com.myfitnesspal.mfp,102,1716854334,1716854436,1716854436.362249,-18000,EB445137-D7F5-57EC-87DA-1DB460D64046,"iPhone13,2"
com.apple.news,4,1716854330,1716854334,1716854334.22324,-18000,EB445137-D7F5-57EC-87DA-1DB460D64046,"iPhone13,2"
com.apple.news,442,1716853875,1716854317,1716854318.0264049,-18000,EB445137-D7F5-57EC-87DA-1DB460D64046,"iPhone13,2"
com.apple.MobileAddressBook,11,1716853098,1716853109,1716853109.344544,-18000,EB445137-D7F5-57EC-87DA-1DB460D64046,"iPhone13,2"
com.apple.mobiletimer,3,1716853092,1716853095,1716853095.1858501,-18000,EB445137-D7F5-57EC-87DA-1DB460D64046,"iPhone13,2"
com.apple.mobiletimer,1,1716852580,1716852581,1716852581.983673,-18000,EB445137-D7F5-57EC-87DA-1DB460D64046,"iPhone13,2"
com.apple.mobiletimer,2,1716852577,1716852579,1716852579.15458,-18000,EB445137-D7F5-57EC-87DA-1DB460D64046,"iPhone13,2"
com.apple.mobiletimer,6,1716851900,1716851906,1716851906.063801,-18000,EB445137-D7F5-57EC-87DA-1DB460D64046,"iPhone13,2"
com.apple.mobiletimer,5,1716851130,1716851135,1716851135.2458692,-18000,EB445137-D7F5-57EC-87DA-1DB460D64046,"iPhone13,2"
com.google.chrome.ios,3,1716851127,1716851130,1716851130.070972,-18000,EB445137-D7F5-57EC-87DA-1DB460D64046,"iPhone13,2"
com.google.chrome.ios,1038,1716850073,1716851111,1716851111.8155298,-18000,EB445137-D7F5-57EC-87DA-1DB460D64046,"iPhone13,2"
com.apple.MobileSMS,2,1716850071,1716850073,1716850073.157002,-18000,EB445137-D7F5-57EC-87DA-1DB460D64046,"iPhone13,2"
com.amazon.Amazon,42,1716849871,1716849913,1716849913.9810638,-18000,EB445137-D7F5-57EC-87DA-1DB460D64046,"iPhone13,2"
com.google.chrome.ios,2,1716849865,1716849867,1716849868.0523338,-18000,EB445137-D7F5-57EC-87DA-1DB460D64046,"iPhone13,2"
com.google.chrome.ios,5,1716849827,1716849832,1716849832.5136719,-18000,EB445137-D7F5-57EC-87DA-1DB460D64046,"iPhone13,2"
com.google.chrome.ios,93,1716849550,1716849643,1716849643.4096088,-18000,EB445137-D7F5-57EC-87DA-1DB460D64046,"iPhone13,2"
com.letterboxd.LetterboxdApp,13,1716848000,1716848013,1716848013.258292,-18000,EB445137-D7F5-57EC-87DA-1DB460D64046,"iPhone13,2"
com.apple.Music,3,1716847997,1716848000,1716848000.030417,-18000,EB445137-D7F5-57EC-87DA-1DB460D64046,"iPhone13,2"
com.apple.Music,65,1716846936,1716847001,1716847001.971755,-18000,EB445137-D7F5-57EC-87DA-1DB460D64046,"iPhone13,2"
com.apple.Music,8,1716846833,1716846841,1716846841.124682,-18000,EB445137-D7F5-57EC-87DA-1DB460D64046,"iPhone13,2"
com.apple.Music,1,1716846812,1716846813,1716846813.8795428,-18000,EB445137-D7F5-57EC-87DA-1DB460D64046,"iPhone13,2"
com.apple.Music,20,1716846773,1716846793,1716846793.384742,-18000,EB445137-D7F5-57EC-87DA-1DB460D64046,"iPhone13,2"
com.apple.Music,35,1716846726,1716846761,1716846761.536658,-18000,EB445137-D7F5-57EC-87DA-1DB460D64046,"iPhone13,2"
com.apple.Music,6,1716846685,1716846691,1716846691.792911,-18000,EB445137-D7F5-57EC-87DA-1DB460D64046,"iPhone13,2"
com.apple.Music,265,1716846414,1716846679,1716846679.920876,-18000,EB445137-D7F5-57EC-87DA-1DB460D64046,"iPhone13,2"
com.apple.weather,2,1716846412,1716846414,1716846414.2121081,-18000,EB445137-D7F5-57EC-87DA-1DB460D64046,"iPhone13,2"
com.apple.weather,7,1716844171,1716844178,1716844178.19649,-18000,EB445137-D7F5-57EC-87DA-1DB460D64046,"iPhone13,2"
com.google.Chrome,177,1716840327,1716840504,1716840504.16384,-18000,,
com.google.Chrome,597,1716839486,1716840083,1716840083.21695,-18000,,
com.google.Chrome,3426,1716835910,1716839336,1716839336.927188,-18000,,
com.apple.finder,18,1716835892,1716835910,1716835910.3612719,-18000,,
com.apple.finder,2,1716770560,1716770562,1716770562.4208221,-18000,,
com.google.Chrome,7,1716770553,1716770560,1716770560.64727,-18000,,
com.google.Chrome,1052,1716769241,1716770293,1716770293.120209,-18000,,
com.google.Chrome,760,1716768207,1716768967,1716768967.45689,-18000,,
com.google.Chrome,405,1716767692,1716768097,1716768097.285603,-18000,,
com.google.Chrome,311,1716767166,1716767477,1716767477.829958,-18000,,
com.google.Chrome,268,1716766787,1716767055,1716767055.544674,-18000,,
com.google.Chrome,580,1716766056,1716766636,1716766636.792862,-18000,,
com.google.Chrome,396,1716765654,1716766050,1716766050.407562,-18000,,
com.google.Chrome,3490,1716756357,1716759847,1716759847.112778,-18000,,
com.google.Chrome,612,1716755608,1716756220,1716756220.961082,-18000,,
com.google.Chrome,2897,1716752409,1716755306,1716755306.3110309,-18000,,
com.google.Chrome,436,1716751632,1716752068,1716752068.2751741,-18000,,
com.google.Chrome,1219,1716749520,1716750739,1716750739.3401818,-18000,,
com.google.Chrome,477,1716749027,1716749504,1716749504.121114,-18000,,
com.google.Chrome,300,1716748600,1716748900,1716748900.516707,-18000,,
com.google.Chrome,523,1716747615,1716748138,1716748138.218586,-18000,,
com.google.Chrome,513,1716746589,1716747102,1716747102.170147,-18000,,
com.google.Chrome,420,1716745963,1716746383,1716746383.937813,-18000,,
com.google.Chrome,617,1716745107,1716745724,1716745724.3966799,-18000,,
com.apple.finder,1,1716745106,1716745107,1716745107.702441,-18000,,
com.apple.Photos,3,1716745103,1716745106,1716745106.265908,-18000,,
com.google.Chrome,6,1716745097,1716745103,1716745103.776003,-18000,,
com.google.Chrome,284,1716742587,1716742871,1716742872.072011,-18000,,
com.google.Chrome,362,1716741842,1716742204,1716742204.7003021,-18000,,
com.apple.finder,1,1716741841,1716741842,1716741842.069057,-18000,,
com.apple.MobileSMS,4,1716741837,1716741841,1716741841.42518,-18000,,
com.apple.finder,2,1716741835,1716741837,1716741837.994701,-18000,,
com.google.Chrome,501,1716741334,1716741835,1716741835.933426,-18000,,
com.apple.finder,1,1716741333,1716741334,1716741335.4674048,-18000,,
com.google.Chrome,30,1716741303,1716741333,1716741334.363498,-18000,,
com.google.Chrome,1406,1716674370,1716675776,1716675776.412609,-18000,,
com.google.Chrome,304,1716673493,1716673797,1716673797.880033,-18000,,
com.google.Chrome,329,1716673149,1716673478,1716673478.859787,-18000,,
com.gasbuddymobile.gasbuddy,110,1716672911,1716673021,1716673022.3129392,-18000,EB445137-D7F5-57EC-87DA-1DB460D64046,"iPhone13,2"
com.google.chrome.ios,38,1716672873,1716672911,1716672912.1177611,-18000,EB445137-D7F5-57EC-87DA-1DB460D64046,"iPhone13,2"
com.gasbuddymobile.gasbuddy,53,1716672820,1716672873,1716672873.2758331,-18000,EB445137-D7F5-57EC-87DA-1DB460D64046,"iPhone13,2"
com.letterboxd.LetterboxdApp,105,1716672704,1716672809,1716672809.1912742,-18000,EB445137-D7F5-57EC-87DA-1DB460D64046,"iPhone13,2"
com.truebill.truebillnative,100,1716672580,1716672680,1716672680.2320561,-18000,EB445137-D7F5-57EC-87DA-1DB460D64046,"iPhone13,2"
com.clairmail.fth.client,85,1716672486,1716672571,1716672571.437327,-18000,EB445137-D7F5-57EC-87DA-1DB460D64046,"iPhone13,2"
com.myfitnesspal.mfp,53,1716672419,1716672472,1716672472.995357,-18000,EB445137-D7F5-57EC-87DA-1DB460D64046,"iPhone13,2"
com.apple.findmy,38,1716672375,1716672413,1716672413.208494,-18000,EB445137-D7F5-57EC-87DA-1DB460D64046,"iPhone13,2"
com.apple.findmy,9,1716671503,1716671512,1716671512.665691,-18000,EB445137-D7F5-57EC-87DA-1DB460D64046,"iPhone13,2"
com.toyopagroup.picaboo,20,1716670927,1716670947,1716670947.467232,-18000,EB445137-D7F5-57EC-87DA-1DB460D64046,"iPhone13,2"
com.apple.measure,4,1716670923,1716670927,1716670927.235784,-18000,EB445137-D7F5-57EC-87DA-1DB460D64046,"iPhone13,2"
com.apple.measure,25,1716667991,1716668016,1716668016.727584,-18000,EB445137-D7F5-57EC-87DA-1DB460D64046,"iPhone13,2"
com.apple.news,3,1716667986,1716667989,1716667989.5968518,-18000,EB445137-D7F5-57EC-87DA-1DB460D64046,"iPhone13,2"
com.apple.news,3,1716655862,1716655865,1716655865.180869,-18000,EB445137-D7F5-57EC-87DA-1DB460D64046,"iPhone13,2"
com.apple.news,247,1716652324,1716652571,1716652571.408725,-18000,EB445137-D7F5-57EC-87DA-1DB460D64046,"iPhone13,2"
com.robinhood.release.Robinhood,19,1716652300,1716652319,1716652319.213955,-18000,EB445137-D7F5-57EC-87DA-1DB460D64046,"iPhone13,2"
com.truebill.truebillnative,196,1716652102,1716652298,1716652299.017761,-18000,EB445137-D7F5-57EC-87DA-1DB460D64046,"iPhone13,2"
com.clairmail.fth.client,25,1716652070,1716652095,1716652096.123024,-18000,EB445137-D7F5-57EC-87DA-1DB460D64046,"iPhone13,2"
com.apple.news,180,1716651889,1716652069,1716652070.095139,-18000,EB445137-D7F5-57EC-87DA-1DB460D64046,"iPhone13,2"
com.myfitnesspal.mfp,67,1716651788,1716651855,1716651856.6293988,-18000,EB445137-D7F5-57EC-87DA-1DB460D64046,"iPhone13,2"
com.google.chrome.ios,24,1716651764,1716651788,1716651788.947295,-18000,EB445137-D7F5-57EC-87DA-1DB460D64046,"iPhone13,2"
com.myfitnesspal.mfp,3,1716651760,1716651763,1716651764.075786,-18000,EB445137-D7F5-57EC-87DA-1DB460D64046,"iPhone13,2"
com.apple.MobileSMS,4,1716651740,1716651744,1716651744.389229,-18000,EB445137-D7F5-57EC-87DA-1DB460D64046,"iPhone13,2"
com.apple.Music,2,1716642010,1716642012,1716642012.2313871,-18000,EB445137-D7F5-57EC-87DA-1DB460D64046,"iPhone13,2"
com.apple.MobileSMS,2,1716642008,1716642010,1716642011.797717,-18000,EB445137-D7F5-57EC-87DA-1DB460D64046,"iPhone13,2"
com.apple.MobileSMS,2,1716641999,1716642001,1716642001.126457,-18000,EB445137-D7F5-57EC-87DA-1DB460D64046,"iPhone13,2"
com.apple.MobileSMS,9,1716641839,1716641848,1716641848.5597448,-18000,EB445137-D7F5-57EC-87DA-1DB460D64046,"iPhone13,2"
com.apple.MobileSMS,15,1716641818,1716641833,1716641833.835105,-18000,EB445137-D7F5-57EC-87DA-1DB460D64046,"iPhone13,2"
com.apple.Music,3,1716641815,1716641818,1716641818.404434,-18000,EB445137-D7F5-57EC-87DA-1DB460D64046,"iPhone13,2"
com.apple.Music,72,1716641540,1716641612,1716641612.5786629,-18000,EB445137-D7F5-57EC-87DA-1DB460D64046,"iPhone13,2"
com.apple.news,125,1716641128,1716641253,1716641253.915601,-18000,EB445137-D7F5-57EC-87DA-1DB460D64046,"iPhone13,2"
com.myfitnesspal.mfp,42,1716641080,1716641122,1716641122.6362228,-18000,EB445137-D7F5-57EC-87DA-1DB460D64046,"iPhone13,2"
com.apple.news,100,1716640728,1716640828,1716640828.118019,-18000,EB445137-D7F5-57EC-87DA-1DB460D64046,"iPhone13,2"
com.apple.news,118,1716640573,1716640691,1716640691.441236,-18000,EB445137-D7F5-57EC-87DA-1DB460D64046,"iPhone13,2"
com.apple.findmy,4,1716640423,1716640427,1716640427.456768,-18000,EB445137-D7F5-57EC-87DA-1DB460D64046,"iPhone13,2"
com.myfitnesspal.mfp,5,1716640418,1716640423,1716640423.2178478,-18000,EB445137-D7F5-57EC-87DA-1DB460D64046,"iPhone13,2"
com.myfitnesspal.mfp,48,1716640330,1716640378,1716640378.9052439,-18000,EB445137-D7F5-57EC-87DA-1DB460D64046,"iPhone13,2"
com.apple.findmy,3,1716640326,1716640329,1716640329.9503632,-18000,EB445137-D7F5-57EC-87DA-1DB460D64046,"iPhone13,2"
com.apple.findmy,6,1716640295,1716640301,1716640301.158416,-18000,EB445137-D7F5-57EC-87DA-1DB460D64046,"iPhone13,2"
com.apple.findmy,6,1716640287,1716640293,1716640293.370122,-18000,EB445137-D7F5-57EC-87DA-1DB460D64046,"iPhone13,2"
com.apple.findmy,16,1716640176,1716640192,1716640192.72372,-18000,EB445137-D7F5-57EC-87DA-1DB460D64046,"iPhone13,2"
com.apple.findmy,30,1716640060,1716640090,1716640090.672086,-18000,EB445137-D7F5-57EC-87DA-1DB460D64046,"iPhone13,2"
com.apple.mobiletimer,7,1716638299,1716638306,1716638306.932734,-18000,EB445137-D7F5-57EC-87DA-1DB460D64046,"iPhone13,2"
com.hammerandchisel.discord,25,1716638260,1716638285,1716638285.986537,-18000,EB445137-D7F5-57EC-87DA-1DB460D64046,"iPhone13,2"
com.apple.news,340,1716637910,1716638250,1716638250.524238,-18000,EB445137-D7F5-57EC-87DA-1DB460D64046,"iPhone13,2"
com.apple.mobiletimer,10,1716637892,1716637902,1716637902.778387,-18000,EB445137-D7F5-57EC-87DA-1DB460D64046,"iPhone13,2"
com.apple.Preferences,2,1716637878,1716637880,1716637880.28366,-18000,EB445137-D7F5-57EC-87DA-1DB460D64046,"iPhone13,2"
com.apple.findmy,7,1716637846,1716637853,1716637853.731977,-18000,EB445137-D7F5-57EC-87DA-1DB460D64046,"iPhone13,2"
com.apple.mobiletimer,0,1716637751,1716637751,1716637751.6955152,-18000,EB445137-D7F5-57EC-87DA-1DB460D64046,"iPhone13,2"
com.apple.mobiletimer,13,1716632148,1716632161,1716632161.776264,-18000,EB445137-D7F5-57EC-87DA-1DB460D64046,"iPhone13,2"
com.apple.mobiletimer,10,1716632136,1716632146,1716632146.01332,-18000,EB445137-D7F5-57EC-87DA-1DB460D64046,"iPhone13,2"
com.apple.MobileSMS,13,1716610522,1716610535,1716610535.540286,-18000,EB445137-D7F5-57EC-87DA-1DB460D64046,"iPhone13,2"
com.apple.mobiletimer,13,1716610508,1716610521,1716610521.626068,-18000,EB445137-D7F5-57EC-87DA-1DB460D64046,"iPhone13,2"
com.apple.mobiletimer,13,1716610374,1716610387,1716610387.5964332,-18000,EB445137-D7F5-57EC-87DA-1DB460D64046,"iPhone13,2"
com.apple.mobiletimer,2,1716610370,1716610372,1716610372.241514,-18000,EB445137-D7F5-57EC-87DA-1DB460D64046,"iPhone13,2"
com.apple.mobiletimer,5,1716610365,1716610370,1716610370.3470821,-18000,EB445137-D7F5-57EC-87DA-1DB460D64046,"iPhone13,2"
com.apple.camera,3,1716610269,1716610272,1716610273.8548021,-18000,EB445137-D7F5-57EC-87DA-1DB460D64046,"iPhone13,2"
com.toyopagroup.picaboo,6,1716610248,1716610254,1716610254.989108,-18000,EB445137-D7F5-57EC-87DA-1DB460D64046,"iPhone13,2"
com.apple.Health,56,1716610188,1716610244,1716610244.865109,-18000,EB445137-D7F5-57EC-87DA-1DB460D64046,"iPhone13,2"
com.letterboxd.LetterboxdApp,3,1716610185,1716610188,1716610188.572573,-18000,EB445137-D7F5-57EC-87DA-1DB460D64046,"iPhone13,2"
com.letterboxd.LetterboxdApp,13,1716609655,1716609668,1716609668.9459028,-18000,EB445137-D7F5-57EC-87DA-1DB460D64046,"iPhone13,2"
com.letterboxd.LetterboxdApp,51,1716609498,1716609549,1716609549.578913,-18000,EB445137-D7F5-57EC-87DA-1DB460D64046,"iPhone13,2"
com.thestorygraph.thestorygraph,1,1716609497,1716609498,1716609498.3493052,-18000,EB445137-D7F5-57EC-87DA-1DB460D64046,"iPhone13,2"
com.google.chrome.ios,17,1716609245,1716609262,1716609262.912519,-18000,EB445137-D7F5-57EC-87DA-1DB460D64046,"iPhone13,2"
com.letterboxd.LetterboxdApp,4,1716609241,1716609245,1716609245.770385,-18000,EB445137-D7F5-57EC-87DA-1DB460D64046,"iPhone13,2"
com.letterboxd.LetterboxdApp,46,1716608659,1716608705,1716608705.612403,-18000,EB445137-D7F5-57EC-87DA-1DB460D64046,"iPhone13,2"
com.apple.findmy,11,1716607841,1716607852,1716607853.3377938,-18000,EB445137-D7F5-57EC-87DA-1DB460D64046,"iPhone13,2"
com.google.chrome.ios,32,1716607519,1716607551,1716607551.319977,-18000,EB445137-D7F5-57EC-87DA-1DB460D64046,"iPhone13,2"
com.apple.findmy,3,1716607516,1716607519,1716607519.801134,-18000,EB445137-D7F5-57EC-87DA-1DB460D64046,"iPhone13,2"
com.apple.findmy,3,1716607363,1716607366,1716607366.788841,-18000,EB445137-D7F5-57EC-87DA-1DB460D64046,"iPhone13,2"
com.apple.findmy,7,1716606420,1716606427,1716606427.499078,-18000,EB445137-D7F5-57EC-87DA-1DB460D64046,"iPhone13,2"
com.letterboxd.LetterboxdApp,3,1716606416,1716606419,1716606419.78659,-18000,EB445137-D7F5-57EC-87DA-1DB460D64046,"iPhone13,2"
com.letterboxd.LetterboxdApp,19,1716606256,1716606275,1716606275.802007,-18000,EB445137-D7F5-57EC-87DA-1DB460D64046,"iPhone13,2"
com.letterboxd.LetterboxdApp,58,1716606170,1716606228,1716606228.183881,-18000,EB445137-D7F5-57EC-87DA-1DB460D64046,"iPhone13,2"
com.apple.camera,2,1716606166,1716606168,1716606169.0944219,-18000,EB445137-D7F5-57EC-87DA-1DB460D64046,"iPhone13,2"
com.myfitnesspal.mfp,7,1716606163,1716606170,1716606171.041532,-18000,EB445137-D7F5-57EC-87DA-1DB460D64046,"iPhone13,2"
com.myfitnesspal.mfp,55,1716604566,1716604621,1716604621.730684,-18000,EB445137-D7F5-57EC-87DA-1DB460D64046,"iPhone13,2"
com.apple.news,2,1716604563,1716604565,1716604565.954695,-18000,EB445137-D7F5-57EC-87DA-1DB460D64046,"iPhone13,2"
com.apple.news,45,1716604381,1716604426,1716604426.319944,-18000,EB445137-D7F5-57EC-87DA-1DB460D64046,"iPhone13,2"
com.google.chrome.ios,6,1716604356,1716604362,1716604362.377408,-18000,EB445137-D7F5-57EC-87DA-1DB460D64046,"iPhone13,2"
com.google.chrome.ios,15,1716604148,1716604163,1716604163.4935942,-18000,EB445137-D7F5-57EC-87DA-1DB460D64046,"iPhone13,2"
com.letterboxd.LetterboxdApp,216,1716603932,1716604148,1716604148.754147,-18000,EB445137-D7F5-57EC-87DA-1DB460D64046,"iPhone13,2"
com.apple.mobiletimer,13,1716603912,1716603925,1716603925.79003,-18000,EB445137-D7F5-57EC-87DA-1DB460D64046,"iPhone13,2"
com.microsoft.onenote,1,1716603908,1716603909,1716603909.655514,-18000,EB445137-D7F5-57EC-87DA-1DB460D64046,"iPhone13,2"
com.apple.MobileSMS,7,1716603900,1716603907,1716603907.110219,-18000,EB445137-D7F5-57EC-87DA-1DB460D64046,"iPhone13,2"
Astrospheric.Astrospheric,4,1716603896,1716603900,1716603900.2917972,-18000,EB445137-D7F5-57EC-87DA-1DB460D64046,"iPhone13,2"
Astrospheric.Astrospheric,18,1716603026,1716603044,1716603044.7564,-18000,EB445137-D7F5-57EC-87DA-1DB460D64046,"iPhone13,2"
com.t11.celeste,7,1716603015,1716603022,1716603022.278858,-18000,EB445137-D7F5-57EC-87DA-1DB460D64046,"iPhone13,2"
com.myfitnesspal.mfp,2,1716603010,1716603012,1716603012.939692,-18000,EB445137-D7F5-57EC-87DA-1DB460D64046,"iPhone13,2"
com.myfitnesspal.mfp,234,1716602695,1716602929,1716602929.087534,-18000,EB445137-D7F5-57EC-87DA-1DB460D64046,"iPhone13,2"
com.apple.news,3,1716602692,1716602695,1716602695.295848,-18000,EB445137-D7F5-57EC-87DA-1DB460D64046,"iPhone13,2"
com.apple.news,10,1716602679,1716602689,1716602689.659943,-18000,EB445137-D7F5-57EC-87DA-1DB460D64046,"iPhone13,2"
com.apple.news,64,1716602343,1716602407,1716602407.7133799,-18000,EB445137-D7F5-57EC-87DA-1DB460D64046,"iPhone13,2"
com.myfitnesspal.mfp,2,1716602326,1716602328,1716602328.98615,-18000,EB445137-D7F5-57EC-87DA-1DB460D64046,"iPhone13,2"
com.myfitnesspal.mfp,12,1716602186,1716602198,1716602198.168902,-18000,EB445137-D7F5-57EC-87DA-1DB460D64046,"iPhone13,2"
com.google.Chrome,797,1716602138,1716602935,1716602935.691033,-18000,,
com.myfitnesspal.mfp,67,1716602118,1716602185,1716602185.085006,-18000,EB445137-D7F5-57EC-87DA-1DB460D64046,"iPhone13,2"
com.myfitnesspal.mfp,6,1716601804,1716601810,1716601810.204123,-18000,EB445137-D7F5-57EC-87DA-1DB460D64046,"iPhone13,2"
com.myfitnesspal.mfp,305,1716601485,1716601790,1716601790.6562839,-18000,EB445137-D7F5-57EC-87DA-1DB460D64046,"iPhone13,2"
com.hammerandchisel.discord,3,1716601480,1716601483,1716601483.1332989,-18000,EB445137-D7F5-57EC-87DA-1DB460D64046,"iPhone13,2"
com.google.Chrome,306,1716601470,1716601776,1716601776.841793,-18000,,
com.hammerandchisel.discord,6,1716601432,1716601438,1716601438.735673,-18000,EB445137-D7F5-57EC-87DA-1DB460D64046,"iPhone13,2"
com.apple.findmy,3,1716601429,1716601432,1716601432.329307,-18000,EB445137-D7F5-57EC-87DA-1DB460D64046,"iPhone13,2"
com.apple.findmy,6,1716601242,1716601248,1716601248.2674809,-18000,EB445137-D7F5-57EC-87DA-1DB460D64046,"iPhone13,2"
com.apple.findmy,6,1716601234,1716601240,1716601240.763943,-18000,EB445137-D7F5-57EC-87DA-1DB460D64046,"iPhone13,2"
com.hammerandchisel.discord,44,1716600970,1716601014,1716601014.58585,-18000,EB445137-D7F5-57EC-87DA-1DB460D64046,"iPhone13,2"
com.apple.MobileSMS,4,1716600966,1716600970,1716600971.006524,-18000,EB445137-D7F5-57EC-87DA-1DB460D64046,"iPhone13,2"
com.apple.podcasts,2,1716600964,1716600966,1716600967.213119,-18000,EB445137-D7F5-57EC-87DA-1DB460D64046,"iPhone13,2"
com.apple.podcasts,1,1716600656,1716600657,1716600658.62888,-18000,EB445137-D7F5-57EC-87DA-1DB460D64046,"iPhone13,2"
com.apple.findmy,6,1716600650,1716600656,1716600656.345066,-18000,EB445137-D7F5-57EC-87DA-1DB460D64046,"iPhone13,2"
com.hammerandchisel.discord,83,1716600483,1716600566,1716600566.947238,-18000,EB445137-D7F5-57EC-87DA-1DB460D64046,"iPhone13,2"
com.apple.calculator,3,1716600480,1716600483,1716600484.002157,-18000,EB445137-D7F5-57EC-87DA-1DB460D64046,"iPhone13,2"
com.apple.calculator,11,1716600163,1716600174,1716600174.3606,-18000,EB445137-D7F5-57EC-87DA-1DB460D64046,"iPhone13,2"
com.apple.findmy,3,1716600160,1716600163,1716600163.2465858,-18000,EB445137-D7F5-57EC-87DA-1DB460D64046,"iPhone13,2"
com.apple.findmy,5,1716597768,1716597773,1716597773.147911,-18000,EB445137-D7F5-57EC-87DA-1DB460D64046,"iPhone13,2"
com.hammerandchisel.discord,2,1716597766,1716597768,1716597768.897749,-18000,EB445137-D7F5-57EC-87DA-1DB460D64046,"iPhone13,2"
com.hammerandchisel.discord,8,1716597751,1716597759,1716597759.583232,-18000,EB445137-D7F5-57EC-87DA-1DB460D64046,"iPhone13,2"
com.apple.mobilenotes,3,1716597748,1716597751,1716597751.572268,-18000,EB445137-D7F5-57EC-87DA-1DB460D64046,"iPhone13,2"
com.apple.mobilenotes,6,1716597500,1716597506,1716597506.671039,-18000,EB445137-D7F5-57EC-87DA-1DB460D64046,"iPhone13,2"
com.google.Chrome,110,1716565870,1716565980,1716565981.11659,-18000,,
com.apple.finder,180,1716565690,1716565870,1716565870.4857302,-18000,,
com.microsoft.rdc.macos,2,1716565688,1716565690,1716565691.010216,-18000,,
com.microsoft.rdc.macos,5,1716559781,1716559786,1716559786.67208,-18000,,
com.microsoft.rdc.macos,367,1716559367,1716559734,1716559734.702808,-18000,,
com.microsoft.rdc.macos,418,1716558948,1716559366,1716559366.452224,-18000,,
com.microsoft.rdc.macos,531,1716558325,1716558856,1716558856.7137032,-18000,,
com.microsoft.rdc.macos,51,1716529109,1716529160,1716529160.841991,-18000,,
com.apple.finder,5,1716529104,1716529109,1716529110.017206,-18000,,
com.apple.finder,2,1716526531,1716526533,1716526533.1470098,-18000,,
com.microsoft.rdc.macos,106,1716526425,1716526531,1716526531.585361,-18000,,
com.microsoft.rdc.macos,66,1716518726,1716518792,1716518792.639381,-18000,,
com.microsoft.rdc.macos,6,1716518563,1716518569,1716518569.250215,-18000,,
com.microsoft.rdc.macos,644,1716517657,1716518301,1716518301.951519,-18000,,
com.microsoft.rdc.macos,29,1716517598,1716517627,1716517627.8793612,-18000,,
com.apple.finder,4,1716517594,1716517598,1716517598.608295,-18000,,
com.microsoft.rdc.macos,1041,1716516553,1716517594,1716517594.515166,-18000,,
com.microsoft.rdc.macos,258,1716513255,1716513513,1716513513.898861,-18000,,
com.google.Chrome,16,1716513239,1716513255,1716513255.749704,-18000,,
com.google.Chrome,239,1716512313,1716512552,1716512552.183455,-18000,,
com.google.Chrome,806,1716511461,1716512267,1716512267.3252969,-18000,,
com.apple.finder,42,1716511419,1716511461,1716511461.526394,-18000,,
com.apple.FaceTime,6,1716511413,1716511419,1716511420.0912418,-18000,,
com.google.Chrome,449,1716510964,1716511413,1716511413.942569,-18000,,
com.apple.finder,4,1716510960,1716510964,1716510965.334947,-18000,,
com.apple.finder,2,1716510032,1716510034,1716510034.601143,-18000,,
com.apple.Photos,45,1716509987,1716510032,1716510032.8699532,-18000,,
com.google.Chrome,128,1716509859,1716509987,1716509987.044506,-18000,,
com.google.Chrome,609,1716509209,1716509818,1716509819.015105,-18000,,
com.google.Chrome,433,1716508644,1716509077,1716509077.944669,-18000,,
com.google.Chrome,1580,1716506226,1716507806,1716507806.457109,-18000,,
com.google.Chrome,342,1716505840,1716506182,1716506182.251296,-18000,,
com.google.Chrome,545,1716505073,1716505618,1716505619.002928,-18000,,
com.apple.systempreferences,5,1716505068,1716505073,1716505073.403368,-18000,,
com.google.Chrome,2,1716505063,1716505065,1716505065.734127,-18000,,
com.google.Chrome,623,1716498369,1716498992,1716498992.3739839,-18000,,
com.google.Chrome,448,1716497864,1716498312,1716498312.08399,-18000,,
com.apple.MobileSMS,33,1716497831,1716497864,1716497864.0750241,-18000,,
com.google.Chrome,1350,1716496481,1716497831,1716497831.301416,-18000,,
com.apple.MobileSMS,7,1716496474,1716496481,1716496481.744657,-18000,,
com.google.Chrome,574,1716495900,1716496474,1716496474.0766602,-18000,,
com.apple.finder,2,1716495898,1716495900,1716495900.1131458,-18000,,
com.google.Chrome,2,1716495896,1716495898,1716495898.360633,-18000,,
com.apple.systempreferences,3,1716495893,1716495896,1716495896.888391,-18000,,
com.google.Chrome,5,1716495888,1716495893,1716495893.797821,-18000,,
com.google.Chrome,523,1716490115,1716490638,1716490638.619779,-18000,,
com.apple.keychainaccess,2,1716490110,1716490112,1716490112.839892,-18000,,
com.apple.keychainaccess,300,1716489152,1716489452,1716489452.59972,-18000,,
com.apple.keychainaccess,305,1716488844,1716489149,1716489149.092205,-18000,,
com.google.Chrome,2,1716488836,1716488838,1716488838.212296,-18000,,
com.apple.Photos,1,1716488835,1716488836,1716488836.954597,-18000,,
com.google.Chrome,95,1716488740,1716488835,1716488835.2522578,-18000,,
com.apple.systempreferences,9,1716488731,1716488740,1716488740.45576,-18000,,
com.google.Chrome,5,1716488726,1716488731,1716488731.9265609,-18000,,
com.apple.finder,63,1716488151,1716488214,1716488214.198637,-18000,,
com.google.Chrome,64,1716488087,1716488151,1716488151.753134,-18000,,
com.apple.systempreferences,11,1716488002,1716488013,1716488013.5684938,-18000,,
com.google.Chrome,10,1716487992,1716488002,1716488002.6006188,-18000,,
com.apple.systempreferences,2,1716487990,1716487992,1716487992.1143851,-18000,,
com.hammerandchisel.discord,1,1716487888,1716487889,1716487889.482277,-18000,EB445137-D7F5-57EC-87DA-1DB460D64046,"iPhone13,2"
com.google.Chrome,650,1716487333,1716487983,1716487984.020128,-18000,,
com.hammerandchisel.discord,2,1716487246,1716487248,1716487248.8213,-18000,EB445137-D7F5-57EC-87DA-1DB460D64046,"iPhone13,2"
com.hammerandchisel.discord,39,1716487182,1716487221,1716487221.789098,-18000,EB445137-D7F5-57EC-87DA-1DB460D64046,"iPhone13,2"
com.hammerandchisel.discord,6,1716486350,1716486356,1716486356.543155,-18000,EB445137-D7F5-57EC-87DA-1DB460D64046,"iPhone13,2"
com.hammerandchisel.discord,1,1716486345,1716486346,1716486347.00266,-18000,EB445137-D7F5-57EC-87DA-1DB460D64046,"iPhone13,2"
com.hammerandchisel.discord,68,1716486264,1716486332,1716486332.018001,-18000,EB445137-D7F5-57EC-87DA-1DB460D64046,"iPhone13,2"
com.hammerandchisel.discord,9,1716486238,1716486247,1716486247.2397609,-18000,EB445137-D7F5-57EC-87DA-1DB460D64046,"iPhone13,2"
com.hammerandchisel.discord,6,1716486216,1716486222,1716486222.433749,-18000,EB445137-D7F5-57EC-87DA-1DB460D64046,"iPhone13,2"
com.hammerandchisel.discord,9,1716485711,1716485720,1716485720.4477792,-18000,EB445137-D7F5-57EC-87DA-1DB460D64046,"iPhone13,2"
com.hammerandchisel.discord,15,1716484521,1716484536,1716484536.5593119,-18000,EB445137-D7F5-57EC-87DA-1DB460D64046,"iPhone13,2"
com.hammerandchisel.discord,11,1716484471,1716484482,1716484482.48964,-18000,EB445137-D7F5-57EC-87DA-1DB460D64046,"iPhone13,2"
com.google.chrome.ios,7,1716484464,1716484471,1716484471.934448,-18000,EB445137-D7F5-57EC-87DA-1DB460D64046,"iPhone13,2"
com.google.chrome.ios,1,1716484463,1716484464,1716484464.6313381,-18000,EB445137-D7F5-57EC-87DA-1DB460D64046,"iPhone13,2"
com.google.chrome.ios,19,1716484192,1716484211,1716484211.190024,-18000,EB445137-D7F5-57EC-87DA-1DB460D64046,"iPhone13,2"
com.apple.Music,2,1716484190,1716484192,1716484192.70182,-18000,EB445137-D7F5-57EC-87DA-1DB460D64046,"iPhone13,2"
com.apple.Music,63,1716483503,1716483566,1716483566.892123,-18000,EB445137-D7F5-57EC-87DA-1DB460D64046,"iPhone13,2"
com.apple.MobileSMS,2,1716483500,1716483502,1716483502.514535,-18000,EB445137-D7F5-57EC-87DA-1DB460D64046,"iPhone13,2"
com.apple.MobileSMS,9,1716483484,1716483493,1716483493.8140888,-18000,EB445137-D7F5-57EC-87DA-1DB460D64046,"iPhone13,2"
com.apple.MobileSMS,2,1716483300,1716483302,1716483302.1304421,-18000,EB445137-D7F5-57EC-87DA-1DB460D64046,"iPhone13,2"
com.google.ios.youtube,3,1716483297,1716483300,1716483300.926132,-18000,EB445137-D7F5-57EC-87DA-1DB460D64046,"iPhone13,2"
com.google.ios.youtube,15,1716483196,1716483211,1716483211.881741,-18000,EB445137-D7F5-57EC-87DA-1DB460D64046,"iPhone13,2"
com.apple.MobileSMS,26,1716483169,1716483195,1716483195.1894999,-18000,EB445137-D7F5-57EC-87DA-1DB460D64046,"iPhone13,2"
com.google.ios.youtube,254,1716482915,1716483169,1716483169.1728082,-18000,EB445137-D7F5-57EC-87DA-1DB460D64046,"iPhone13,2"
com.apple.findmy,7,1716482908,1716482915,1716482915.608397,-18000,EB445137-D7F5-57EC-87DA-1DB460D64046,"iPhone13,2"
com.google.ios.youtube,396,1716482512,1716482908,1716482909.270039,-18000,EB445137-D7F5-57EC-87DA-1DB460D64046,"iPhone13,2"
com.apple.findmy,6,1716482506,1716482512,1716482512.470928,-18000,EB445137-D7F5-57EC-87DA-1DB460D64046,"iPhone13,2"
com.google.ios.youtube,907,1716481599,1716482506,1716482506.185512,-18000,EB445137-D7F5-57EC-87DA-1DB460D64046,"iPhone13,2"
com.apple.findmy,6,1716481593,1716481599,1716481599.590663,-18000,EB445137-D7F5-57EC-87DA-1DB460D64046,"iPhone13,2"
com.google.ios.youtube,451,1716481140,1716481591,1716481591.999294,-18000,EB445137-D7F5-57EC-87DA-1DB460D64046,"iPhone13,2"
com.google.ios.youtube,6,1716481091,1716481097,1716481097.549728,-18000,EB445137-D7F5-57EC-87DA-1DB460D64046,"iPhone13,2"
com.google.ios.youtube,47,1716481032,1716481079,1716481079.730322,-18000,EB445137-D7F5-57EC-87DA-1DB460D64046,"iPhone13,2"
com.apple.Maps,2,1716481008,1716481010,1716481010.914822,-18000,EB445137-D7F5-57EC-87DA-1DB460D64046,"iPhone13,2"
com.apple.findmy,13,1716480995,1716481008,1716481008.326395,-18000,EB445137-D7F5-57EC-87DA-1DB460D64046,"iPhone13,2"
com.apple.findmy,12,1716480933,1716480945,1716480945.4961948,-18000,EB445137-D7F5-57EC-87DA-1DB460D64046,"iPhone13,2"
com.apple.findmy,12,1716480765,1716480777,1716480777.802541,-18000,EB445137-D7F5-57EC-87DA-1DB460D64046,"iPhone13,2"
com.truebill.truebillnative,2,1716480763,1716480765,1716480765.430484,-18000,EB445137-D7F5-57EC-87DA-1DB460D64046,"iPhone13,2"
com.truebill.truebillnative,186,1716480508,1716480694,1716480694.797,-18000,EB445137-D7F5-57EC-87DA-1DB460D64046,"iPhone13,2"
com.apple.findmy,5,1716480295,1716480300,1716480300.168211,-18000,EB445137-D7F5-57EC-87DA-1DB460D64046,"iPhone13,2"
com.apple.news,5,1716480290,1716480295,1716480295.707706,-18000,EB445137-D7F5-57EC-87DA-1DB460D64046,"iPhone13,2"
com.apple.news,3,1716480226,1716480229,1716480229.516628,-18000,EB445137-D7F5-57EC-87DA-1DB460D64046,"iPhone13,2"
com.apple.news,4,1716480220,1716480224,1716480224.96116,-18000,EB445137-D7F5-57EC-87DA-1DB460D64046,"iPhone13,2"
com.apple.news,12,1716480203,1716480215,1716480215.448011,-18000,EB445137-D7F5-57EC-87DA-1DB460D64046,"iPhone13,2"
com.apple.news,5,1716480193,1716480198,1716480198.5780292,-18000,EB445137-D7F5-57EC-87DA-1DB460D64046,"iPhone13,2"
com.apple.news,81,1716480030,1716480111,1716480111.626996,-18000,EB445137-D7F5-57EC-87DA-1DB460D64046,"iPhone13,2"
com.apple.Health,14,1716479887,1716479901,1716479901.506052,-18000,EB445137-D7F5-57EC-87DA-1DB460D64046,"iPhone13,2"
com.hammerandchisel.discord,6,1716479880,1716479886,1716479886.071568,-18000,EB445137-D7F5-57EC-87DA-1DB460D64046,"iPhone13,2"
com.truebill.truebillnative,142,1716479683,1716479825,1716479825.228146,-18000,EB445137-D7F5-57EC-87DA-1DB460D64046,"iPhone13,2"
com.truebill.truebillnative,226,1716479439,1716479665,1716479665.824201,-18000,EB445137-D7F5-57EC-87DA-1DB460D64046,"iPhone13,2"
com.clairmail.fth.client,13,1716479414,1716479427,1716479427.7563891,-18000,EB445137-D7F5-57EC-87DA-1DB460D64046,"iPhone13,2"
com.apple.findmy,4,1716479407,1716479411,1716479411.2762709,-18000,EB445137-D7F5-57EC-87DA-1DB460D64046,"iPhone13,2"
com.apple.MobileSMS,2,1716479405,1716479407,1716479407.824558,-18000,EB445137-D7F5-57EC-87DA-1DB460D64046,"iPhone13,2"
com.apple.findmy,2,1716479403,1716479405,1716479406.035223,-18000,EB445137-D7F5-57EC-87DA-1DB460D64046,"iPhone13,2"
com.apple.MobileSMS,2,1716479401,1716479403,1716479403.762084,-18000,EB445137-D7F5-57EC-87DA-1DB460D64046,"iPhone13,2"
com.apple.MobileSMS,22,1716478947,1716478969,1716478969.933136,-18000,EB445137-D7F5-57EC-87DA-1DB460D64046,"iPhone13,2"
com.google.chrome.ios,89,1716478858,1716478947,1716478947.923118,-18000,EB445137-D7F5-57EC-87DA-1DB460D64046,"iPhone13,2"
com.apple.news,433,1716478424,1716478857,1716478858.147938,-18000,EB445137-D7F5-57EC-87DA-1DB460D64046,"iPhone13,2"
com.myfitnesspal.mfp,33,1716478378,1716478411,1716478411.888027,-18000,EB445137-D7F5-57EC-87DA-1DB460D64046,"iPhone13,2"
com.apple.MobileSMS,10,1716478364,1716478374,1716478374.437199,-18000,EB445137-D7F5-57EC-87DA-1DB460D64046,"iPhone13,2"
com.apple.findmy,9,1716478355,1716478364,1716478364.883213,-18000,EB445137-D7F5-57EC-87DA-1DB460D64046,"iPhone13,2"
com.apple.MobileSMS,3,1716478352,1716478355,1716478355.816961,-18000,EB445137-D7F5-57EC-87DA-1DB460D64046,"iPhone13,2"
com.apple.MobileSMS,19,1716478331,1716478350,1716478350.963252,-18000,EB445137-D7F5-57EC-87DA-1DB460D64046,"iPhone13,2"
com.apple.findmy,3,1716478328,1716478331,1716478331.5448909,-18000,EB445137-D7F5-57EC-87DA-1DB460D64046,"iPhone13,2"
com.apple.findmy,8,1716477988,1716477996,1716477996.4241772,-18000,EB445137-D7F5-57EC-87DA-1DB460D64046,"iPhone13,2"
com.apple.Music,4,1716477984,1716477988,1716477988.8921719,-18000,EB445137-D7F5-57EC-87DA-1DB460D64046,"iPhone13,2"
com.apple.Music,2,1716477979,1716477981,1716477981.52408,-18000,EB445137-D7F5-57EC-87DA-1DB460D64046,"iPhone13,2"
com.apple.Music,8,1716476767,1716476775,1716476775.777333,-18000,EB445137-D7F5-57EC-87DA-1DB460D64046,"iPhone13,2"
com.apple.Music,1,1716476763,1716476764,1716476764.9141688,-18000,EB445137-D7F5-57EC-87DA-1DB460D64046,"iPhone13,2"
com.apple.Music,6,1716476572,1716476578,1716476578.257362,-18000,EB445137-D7F5-57EC-87DA-1DB460D64046,"iPhone13,2"
com.apple.Music,3,1716476555,1716476558,1716476558.2840629,-18000,EB445137-D7F5-57EC-87DA-1DB460D64046,"iPhone13,2"
com.apple.Music,25,1716476528,1716476553,1716476553.0818071,-18000,EB445137-D7F5-57EC-87DA-1DB460D64046,"iPhone13,2"
com.apple.Music,2,1716476526,1716476528,1716476528.122051,-18000,EB445137-D7F5-57EC-87DA-1DB460D64046,"iPhone13,2"
com.apple.Music,63,1716476077,1716476140,1716476140.64367,-18000,EB445137-D7F5-57EC-87DA-1DB460D64046,"iPhone13,2"
com.apple.Maps,3,1716476072,1716476075,1716476075.479207,-18000,EB445137-D7F5-57EC-87DA-1DB460D64046,"iPhone13,2"
com.apple.Maps,22,1716475799,1716475821,1716475821.7264628,-18000,EB445137-D7F5-57EC-87DA-1DB460D64046,"iPhone13,2"
com.toyopagroup.picaboo,2,1716475796,1716475798,1716475799.1727118,-18000,EB445137-D7F5-57EC-87DA-1DB460D64046,"iPhone13,2"
com.toyopagroup.picaboo,14,1716475747,1716475761,1716475761.3597832,-18000,EB445137-D7F5-57EC-87DA-1DB460D64046,"iPhone13,2"
com.muscleforlife.Stacked,25,1716475715,1716475740,1716475740.437243,-18000,EB445137-D7F5-57EC-87DA-1DB460D64046,"iPhone13,2"
com.muscleforlife.Stacked,6,1716475643,1716475649,1716475649.7412481,-18000,EB445137-D7F5-57EC-87DA-1DB460D64046,"iPhone13,2"
com.muscleforlife.Stacked,4,1716475515,1716475519,1716475519.2240949,-18000,EB445137-D7F5-57EC-87DA-1DB460D64046,"iPhone13,2"
com.muscleforlife.Stacked,111,1716475381,1716475492,1716475492.125412,-18000,EB445137-D7F5-57EC-87DA-1DB460D64046,"iPhone13,2"
com.muscleforlife.Stacked,110,1716475243,1716475353,1716475353.380371,-18000,EB445137-D7F5-57EC-87DA-1DB460D64046,"iPhone13,2"
com.muscleforlife.Stacked,10,1716475158,1716475168,1716475168.9437342,-18000,EB445137-D7F5-57EC-87DA-1DB460D64046,"iPhone13,2"
com.muscleforlife.Stacked,4,1716475125,1716475129,1716475129.32517,-18000,EB445137-D7F5-57EC-87DA-1DB460D64046,"iPhone13,2"
com.muscleforlife.Stacked,6,1716475046,1716475052,1716475052.177381,-18000,EB445137-D7F5-57EC-87DA-1DB460D64046,"iPhone13,2"
com.muscleforlife.Stacked,58,1716474987,1716475045,1716475045.436594,-18000,EB445137-D7F5-57EC-87DA-1DB460D64046,"iPhone13,2"
com.apple.Health,10,1716474977,1716474987,1716474987.670916,-18000,EB445137-D7F5-57EC-87DA-1DB460D64046,"iPhone13,2"
com.apple.MobileSMS,2,1716474975,1716474977,1716474977.774204,-18000,EB445137-D7F5-57EC-87DA-1DB460D64046,"iPhone13,2"
com.muscleforlife.Stacked,3,1716474972,1716474975,1716474975.3605251,-18000,EB445137-D7F5-57EC-87DA-1DB460D64046,"iPhone13,2"
com.muscleforlife.Stacked,3,1716474923,1716474926,1716474926.500108,-18000,EB445137-D7F5-57EC-87DA-1DB460D64046,"iPhone13,2"
com.muscleforlife.Stacked,5,1716474900,1716474905,1716474905.198308,-18000,EB445137-D7F5-57EC-87DA-1DB460D64046,"iPhone13,2"
com.muscleforlife.Stacked,55,1716474785,1716474840,1716474840.8323479,-18000,EB445137-D7F5-57EC-87DA-1DB460D64046,"iPhone13,2"
com.apple.MobileSMS,2,1716474783,1716474785,1716474785.466423,-18000,EB445137-D7F5-57EC-87DA-1DB460D64046,"iPhone13,2"
com.apple.MobileSMS,31,1716474748,1716474779,1716474780.03117,-18000,EB445137-D7F5-57EC-87DA-1DB460D64046,"iPhone13,2"
com.muscleforlife.Stacked,38,1716474710,1716474748,1716474748.23426,-18000,EB445137-D7F5-57EC-87DA-1DB460D64046,"iPhone13,2"
com.muscleforlife.Stacked,8,1716474620,1716474628,1716474628.224608,-18000,EB445137-D7F5-57EC-87DA-1DB460D64046,"iPhone13,2"
com.muscleforlife.Stacked,27,1716474503,1716474530,1716474530.284339,-18000,EB445137-D7F5-57EC-87DA-1DB460D64046,"iPhone13,2"
com.apple.Music,2,1716474500,1716474502,1716474502.901703,-18000,EB445137-D7F5-57EC-87DA-1DB460D64046,"iPhone13,2"
com.apple.Music,3,1716474357,1716474360,1716474360.114266,-18000,EB445137-D7F5-57EC-87DA-1DB460D64046,"iPhone13,2"
com.apple.Music,69,1716473725,1716473794,1716473794.134711,-18000,EB445137-D7F5-57EC-87DA-1DB460D64046,"iPhone13,2"
com.apple.camera,1,1716473710,1716473711,1716473711.4232569,-18000,EB445137-D7F5-57EC-87DA-1DB460D64046,"iPhone13,2"
com.google.Chrome,777,1716472814,1716473591,1716473591.620486,-18000,,
com.apple.Preview,3,1716472811,1716472814,1716472814.7042542,-18000,,
com.microsoft.onenote.mac,2,1716472809,1716472811,1716472811.774273,-18000,,
com.apple.Preview,2,1716472807,1716472809,1716472809.150212,-18000,,
com.google.Chrome,9,1716472798,1716472807,1716472807.843828,-18000,,
com.apple.Preview,10,1716472788,1716472798,1716472798.1973581,-18000,,
com.microsoft.onenote.mac,5,1716472783,1716472788,1716472788.707521,-18000,,
com.apple.Preview,3,1716472780,1716472783,1716472783.135715,-18000,,
com.google.Chrome,26,1716472754,1716472780,1716472780.651188,-18000,,
com.apple.Preview,6,1716472748,1716472754,1716472754.9271579,-18000,,
com.microsoft.onenote.mac,7,1716472741,1716472748,1716472748.147197,-18000,,
com.apple.Preview,1,1716472740,1716472741,1716472741.941206,-18000,,
com.apple.finder,10,1716472730,1716472740,1716472740.40289,-18000,,
com.google.Chrome,1,1716472729,1716472730,1716472730.783077,-18000,,
com.apple.findmy,5,1716472720,1716472725,1716472725.414431,-18000,EB445137-D7F5-57EC-87DA-1DB460D64046,"iPhone13,2"
com.apple.camera,46,1716472521,1716472567,1716472567.8749819,-18000,EB445137-D7F5-57EC-87DA-1DB460D64046,"iPhone13,2"
com.apple.findmy,11,1716472519,1716472530,1716472530.782185,-18000,EB445137-D7F5-57EC-87DA-1DB460D64046,"iPhone13,2"
com.apple.findmy,6,1716472512,1716472518,1716472518.3382158,-18000,EB445137-D7F5-57EC-87DA-1DB460D64046,"iPhone13,2"
com.apple.findmy,10,1716472289,1716472299,1716472299.311238,-18000,EB445137-D7F5-57EC-87DA-1DB460D64046,"iPhone13,2"
com.apple.findmy,259,1716471741,1716472000,1716472000.453296,-18000,EB445137-D7F5-57EC-87DA-1DB460D64046,"iPhone13,2"
com.apple.findmy,5,1716471734,1716471739,1716471739.536827,-18000,EB445137-D7F5-57EC-87DA-1DB460D64046,"iPhone13,2"
com.apple.weather,0,1716471734,1716471734,1716471736.2233372,-18000,EB445137-D7F5-57EC-87DA-1DB460D64046,"iPhone13,2"
com.apple.Health,30,1716438181,1716438211,1716438211.0956612,-18000,EB445137-D7F5-57EC-87DA-1DB460D64046,"iPhone13,2"
com.google.Chrome,108,1716438036,1716438144,1716438144.6467838,-18000,,
com.google.Chrome,1086,1716436150,1716437236,1716437236.546277,-18000,,
com.google.Chrome,829,1716435194,1716436023,1716436024.021953,-18000,,
com.google.Chrome,0,1716435193,1716435193,1716435193.983007,-18000,,
com.facebook.Facebook,849,1716433758,1716434607,1716434607.676525,-18000,EB445137-D7F5-57EC-87DA-1DB460D64046,"iPhone13,2"
com.apple.findmy,18,1716433186,1716433204,1716433205.663587,-18000,EB445137-D7F5-57EC-87DA-1DB460D64046,"iPhone13,2"
com.google.Chrome,1165,1716433090,1716434255,1716434255.454032,-18000,,
com.google.Chrome,301,1716432738,1716433039,1716433039.1931,-18000,,
com.clairmail.fth.client,22,1716432493,1716432515,1716432515.537807,-18000,EB445137-D7F5-57EC-87DA-1DB460D64046,"iPhone13,2"
com.truebill.truebillnative,48,1716432175,1716432223,1716432223.242013,-18000,EB445137-D7F5-57EC-87DA-1DB460D64046,"iPhone13,2"
com.google.Chrome,909,1716431693,1716432602,1716432602.978571,-18000,,
com.google.Chrome,300,1716431363,1716431663,1716431663.7949882,-18000,,
com.truebill.truebillnative,69,1716431000,1716431069,1716431069.0552468,-18000,EB445137-D7F5-57EC-87DA-1DB460D64046,"iPhone13,2"
com.google.Chrome,499,1716430836,1716431335,1716431335.761242,-18000,,
com.truebill.truebillnative,248,1716430673,1716430921,1716430921.735509,-18000,EB445137-D7F5-57EC-87DA-1DB460D64046,"iPhone13,2"
com.markhambly.APOD,2,1716430668,1716430670,1716430670.284902,-18000,EB445137-D7F5-57EC-87DA-1DB460D64046,"iPhone13,2"
com.apple.MobileSMS,67,1716429057,1716429124,1716429124.950086,-18000,EB445137-D7F5-57EC-87DA-1DB460D64046,"iPhone13,2"
com.apple.findmy,8,1716429049,1716429057,1716429057.394568,-18000,EB445137-D7F5-57EC-87DA-1DB460D64046,"iPhone13,2"
com.apple.MobileSMS,15,1716429021,1716429036,1716429036.461415,-18000,EB445137-D7F5-57EC-87DA-1DB460D64046,"iPhone13,2"
com.apple.findmy,8,1716429013,1716429021,1716429021.743105,-18000,EB445137-D7F5-57EC-87DA-1DB460D64046,"iPhone13,2"
com.apple.MobileSMS,84,1716428928,1716429012,1716429012.578352,-18000,EB445137-D7F5-57EC-87DA-1DB460D64046,"iPhone13,2"
com.apple.findmy,16,1716428911,1716428927,1716428927.531073,-18000,EB445137-D7F5-57EC-87DA-1DB460D64046,"iPhone13,2"
com.google.ios.youtube,10,1716428833,1716428843,1716428843.702348,-18000,EB445137-D7F5-57EC-87DA-1DB460D64046,"iPhone13,2"
com.google.ios.youtube,17,1716428815,1716428832,1716428832.697411,-18000,EB445137-D7F5-57EC-87DA-1DB460D64046,"iPhone13,2"
com.google.Chrome,1931,1716428812,1716430743,1716430743.025131,-18000,,
com.google.ios.youtube,137,1716428553,1716428690,1716428690.2473512,-18000,EB445137-D7F5-57EC-87DA-1DB460D64046,"iPhone13,2"
com.google.Chrome,300,1716425779,1716426079,1716426079.2727032,-18000,,
com.google.Chrome,1868,1716423898,1716425766,1716425766.6599422,-18000,,
com.google.Chrome,567,1716422888,1716423455,1716423455.879432,-18000,,
com.microsoft.onenote.mac,34,1716422854,1716422888,1716422888.521832,-18000,,
com.google.Chrome,16,1716422838,1716422854,1716422854.4018822,-18000,,
com.google.Chrome,123,1716412211,1716412334,1716412334.5682878,-18000,,
com.google.Chrome,397,1716410869,1716411266,1716411266.2073622,-18000,,
com.google.Chrome,630,1716386453,1716387083,1716387083.844188,-18000,,
com.microsoft.onenote.mac,101,1716386352,1716386453,1716386453.447073,-18000,,
com.apple.Preview,1,1716386351,1716386352,1716386352.304689,-18000,,
com.google.Chrome,40,1716386311,1716386351,1716386351.075618,-18000,,
com.apple.Preview,4,1716386307,1716386311,1716386311.771549,-18000,,
com.google.Chrome,9,1716386298,1716386307,1716386307.210855,-18000,,
com.apple.Preview,4,1716386294,1716386298,1716386298.565844,-18000,,
com.google.Chrome,1,1716386293,1716386294,1716386294.659113,-18000,,
com.microsoft.onenote.mac,3,1716386290,1716386293,1716386293.784851,-18000,,
com.google.Chrome,1,1716386289,1716386290,1716386290.92353,-18000,,
com.apple.Preview,7,1716386282,1716386289,1716386289.310837,-18000,,
com.google.Chrome,163,1716386119,1716386282,1716386282.659977,-18000,,
com.apple.Preview,4,1716386115,1716386119,1716386119.188826,-18000,,
com.microsoft.onenote.mac,3,1716386112,1716386115,1716386115.049964,-18000,,
com.apple.Preview,1,1716386111,1716386112,1716386112.596205,-18000,,
com.microsoft.onenote.mac,21,1716386090,1716386111,1716386111.149785,-18000,,
com.apple.Preview,3,1716386087,1716386090,1716386090.860299,-18000,,
com.apple.finder,0,1716386087,1716386087,1716386087.6962662,-18000,,
com.microsoft.onenote.mac,14,1716386073,1716386087,1716386087.317841,-18000,,
com.apple.camera,0,1716328761,1716328761,1716328761.747788,-18000,EB445137-D7F5-57EC-87DA-1DB460D64046,"iPhone13,2"
com.microsoft.onenote.mac,3,1716328744,1716328747,1716328747.72685,-18000,,
com.apple.Photos,1,1716328743,1716328744,1716328744.511571,-18000,,
com.microsoft.onenote.mac,1,1716328742,1716328743,1716328743.1601791,-18000,,
com.apple.Preview,1,1716328741,1716328742,1716328742.6380901,-18000,,
com.microsoft.onenote.mac,123,1716328618,1716328741,1716328741.352572,-18000,,
com.google.Chrome,1,1716328617,1716328618,1716328618.634033,-18000,,
com.microsoft.onenote.mac,12,1716328605,1716328617,1716328617.5746899,-18000,,
com.google.Chrome,37,1716328568,1716328605,1716328605.484359,-18000,,
com.apple.MobileSMS,3,1716328559,1716328562,1716328562.651557,-18000,EB445137-D7F5-57EC-87DA-1DB460D64046,"iPhone13,2"
com.hammerandchisel.discord,10,1716328545,1716328555,1716328555.555556,-18000,EB445137-D7F5-57EC-87DA-1DB460D64046,"iPhone13,2"
com.hammerandchisel.discord,25,1716328465,1716328490,1716328490.678605,-18000,EB445137-D7F5-57EC-87DA-1DB460D64046,"iPhone13,2"
com.apple.findmy,5,1716328460,1716328465,1716328465.492645,-18000,EB445137-D7F5-57EC-87DA-1DB460D64046,"iPhone13,2"
com.apple.findmy,2,1716328453,1716328455,1716328455.68335,-18000,EB445137-D7F5-57EC-87DA-1DB460D64046,"iPhone13,2"
com.apple.findmy,1,1716327862,1716327863,1716327863.7168279,-18000,EB445137-D7F5-57EC-87DA-1DB460D64046,"iPhone13,2"
com.apple.findmy,14,1716326898,1716326912,1716326912.319131,-18000,EB445137-D7F5-57EC-87DA-1DB460D64046,"iPhone13,2"
com.google.Chrome,884,1716326634,1716327518,1716327518.64642,-18000,,
com.google.Chrome,686,1716325222,1716325908,1716325908.371505,-18000,,
com.microsoft.onenote.mac,166,1716325056,1716325222,1716325222.31831,-18000,,
com.google.Chrome,5,1716325051,1716325056,1716325056.1798391,-18000,,
com.myfitnesspal.mfp,3,1716325027,1716325030,1716325031.113128,-18000,EB445137-D7F5-57EC-87DA-1DB460D64046,"iPhone13,2"
com.myfitnesspal.mfp,32,1716324926,1716324958,1716324958.0726418,-18000,EB445137-D7F5-57EC-87DA-1DB460D64046,"iPhone13,2"
com.apple.Maps,3,1716324922,1716324925,1716324925.809492,-18000,EB445137-D7F5-57EC-87DA-1DB460D64046,"iPhone13,2"
com.apple.Maps,3,1716324850,1716324853,1716324853.134218,-18000,EB445137-D7F5-57EC-87DA-1DB460D64046,"iPhone13,2"
com.apple.Maps,2,1716324744,1716324746,1716324746.61644,-18000,EB445137-D7F5-57EC-87DA-1DB460D64046,"iPhone13,2"
com.apple.Maps,20,1716324711,1716324731,1716324731.085912,-18000,EB445137-D7F5-57EC-87DA-1DB460D64046,"iPhone13,2"
com.apple.findmy,3,1716324708,1716324711,1716324711.6790872,-18000,EB445137-D7F5-57EC-87DA-1DB460D64046,"iPhone13,2"
com.apple.news,2,1716324705,1716324707,1716324707.2533998,-18000,EB445137-D7F5-57EC-87DA-1DB460D64046,"iPhone13,2"
com.apple.news,93,1716324578,1716324671,1716324671.814217,-18000,EB445137-D7F5-57EC-87DA-1DB460D64046,"iPhone13,2"
com.google.ios.youtube,106,1716324472,1716324578,1716324578.286117,-18000,EB445137-D7F5-57EC-87DA-1DB460D64046,"iPhone13,2"
com.apple.findmy,13,1716324459,1716324472,1716324472.2224789,-18000,EB445137-D7F5-57EC-87DA-1DB460D64046,"iPhone13,2"
com.google.ios.youtube,12,1716324447,1716324459,1716324459.872051,-18000,EB445137-D7F5-57EC-87DA-1DB460D64046,"iPhone13,2"
com.apple.news,144,1716324302,1716324446,1716324447.027209,-18000,EB445137-D7F5-57EC-87DA-1DB460D64046,"iPhone13,2"
com.myfitnesspal.mfp,22,1716324269,1716324291,1716324291.5631309,-18000,EB445137-D7F5-57EC-87DA-1DB460D64046,"iPhone13,2"
com.google.ios.youtube,5,1716324264,1716324269,1716324269.622205,-18000,EB445137-D7F5-57EC-87DA-1DB460D64046,"iPhone13,2"
com.apple.findmy,8,1716324255,1716324263,1716324263.607775,-18000,EB445137-D7F5-57EC-87DA-1DB460D64046,"iPhone13,2"
com.apple.findmy,5,1716324250,1716324255,1716324255.248992,-18000,EB445137-D7F5-57EC-87DA-1DB460D64046,"iPhone13,2"
com.apple.findmy,6,1716324147,1716324153,1716324153.720814,-18000,EB445137-D7F5-57EC-87DA-1DB460D64046,"iPhone13,2"
com.apple.findmy,4,1716324140,1716324144,1716324145.199963,-18000,EB445137-D7F5-57EC-87DA-1DB460D64046,"iPhone13,2"
com.apple.findmy,11,1716323500,1716323511,1716323511.574616,-18000,EB445137-D7F5-57EC-87DA-1DB460D64046,"iPhone13,2"
com.google.Chrome,611,1716322887,1716323498,1716323498.395495,-18000,,
com.apple.findmy,8,1716322806,1716322814,1716322814.48136,-18000,EB445137-D7F5-57EC-87DA-1DB460D64046,"iPhone13,2"
com.apple.findmy,6,1716322795,1716322801,1716322801.9605231,-18000,EB445137-D7F5-57EC-87DA-1DB460D64046,"iPhone13,2"
com.apple.findmy,7,1716322671,1716322678,1716322678.9088511,-18000,EB445137-D7F5-57EC-87DA-1DB460D64046,"iPhone13,2"
com.apple.Music,3,1716322668,1716322671,1716322671.953239,-18000,EB445137-D7F5-57EC-87DA-1DB460D64046,"iPhone13,2"
com.apple.Music,6,1716320967,1716320973,1716320973.4247751,-18000,EB445137-D7F5-57EC-87DA-1DB460D64046,"iPhone13,2"
com.apple.Music,8,1716320953,1716320961,1716320961.3039489,-18000,EB445137-D7F5-57EC-87DA-1DB460D64046,"iPhone13,2"
com.apple.Music,1,1716320949,1716320950,1716320950.858983,-18000,EB445137-D7F5-57EC-87DA-1DB460D64046,"iPhone13,2"
com.apple.Music,3,1716320927,1716320930,1716320930.4206638,-18000,EB445137-D7F5-57EC-87DA-1DB460D64046,"iPhone13,2"
com.apple.Music,7,1716320708,1716320715,1716320715.61689,-18000,EB445137-D7F5-57EC-87DA-1DB460D64046,"iPhone13,2"
com.apple.Music,10,1716320465,1716320475,1716320475.801125,-18000,EB445137-D7F5-57EC-87DA-1DB460D64046,"iPhone13,2"
com.apple.Music,6,1716320177,1716320183,1716320183.546762,-18000,EB445137-D7F5-57EC-87DA-1DB460D64046,"iPhone13,2"
com.apple.Music,65,1716319703,1716319768,1716319768.040412,-18000,EB445137-D7F5-57EC-87DA-1DB460D64046,"iPhone13,2"
com.robinhood.release.Robinhood,3,1716319699,1716319702,1716319702.302648,-18000,EB445137-D7F5-57EC-87DA-1DB460D64046,"iPhone13,2"
com.robinhood.release.Robinhood,7,1716319690,1716319697,1716319697.156544,-18000,EB445137-D7F5-57EC-87DA-1DB460D64046,"iPhone13,2"
com.robinhood.release.Robinhood,7,1716319268,1716319275,1716319275.280603,-18000,EB445137-D7F5-57EC-87DA-1DB460D64046,"iPhone13,2"
com.truebill.truebillnative,143,1716319125,1716319268,1716319268.0667539,-18000,EB445137-D7F5-57EC-87DA-1DB460D64046,"iPhone13,2"
com.apple.findmy,25,1716319082,1716319107,1716319107.6404428,-18000,EB445137-D7F5-57EC-87DA-1DB460D64046,"iPhone13,2"
com.apple.weather,9,1716319071,1716319080,1716319080.846535,-18000,EB445137-D7F5-57EC-87DA-1DB460D64046,"iPhone13,2"
com.thestorygraph.thestorygraph,12,1716319050,1716319062,1716319062.7869968,-18000,EB445137-D7F5-57EC-87DA-1DB460D64046,"iPhone13,2"
com.apple.Music,15,1716319000,1716319015,1716319015.7688851,-18000,EB445137-D7F5-57EC-87DA-1DB460D64046,"iPhone13,2"
com.apple.Music,1,1716318544,1716318545,1716318545.429443,-18000,EB445137-D7F5-57EC-87DA-1DB460D64046,"iPhone13,2"
com.apple.Music,1,1716316774,1716316775,1716316775.4417539,-18000,EB445137-D7F5-57EC-87DA-1DB460D64046,"iPhone13,2"
com.myfitnesspal.mfp,54,1716316720,1716316774,1716316775.0186691,-18000,EB445137-D7F5-57EC-87DA-1DB460D64046,"iPhone13,2"
com.myfitnesspal.mfp,12,1716314856,1716314868,1716314868.11202,-18000,EB445137-D7F5-57EC-87DA-1DB460D64046,"iPhone13,2"
com.myfitnesspal.mfp,69,1716314552,1716314621,1716314621.9348788,-18000,EB445137-D7F5-57EC-87DA-1DB460D64046,"iPhone13,2"
com.truebill.truebillnative,5,1716314547,1716314552,1716314552.392992,-18000,EB445137-D7F5-57EC-87DA-1DB460D64046,"iPhone13,2"
com.truebill.truebillnative,6,1716314502,1716314508,1716314508.263418,-18000,EB445137-D7F5-57EC-87DA-1DB460D64046,"iPhone13,2"
com.truebill.truebillnative,7,1716314481,1716314488,1716314488.1777701,-18000,EB445137-D7F5-57EC-87DA-1DB460D64046,"iPhone13,2"
com.truebill.truebillnative,263,1716314120,1716314383,1716314383.5001302,-18000,EB445137-D7F5-57EC-87DA-1DB460D64046,"iPhone13,2"
com.apple.podcasts,9,1716314111,1716314120,1716314121.0534859,-18000,EB445137-D7F5-57EC-87DA-1DB460D64046,"iPhone13,2"
com.truebill.truebillnative,82,1716314026,1716314108,1716314108.491957,-18000,EB445137-D7F5-57EC-87DA-1DB460D64046,"iPhone13,2"
com.myfitnesspal.mfp,132,1716313894,1716314026,1716314026.232677,-18000,EB445137-D7F5-57EC-87DA-1DB460D64046,"iPhone13,2"
com.truebill.truebillnative,4,1716313890,1716313894,1716313894.200825,-18000,EB445137-D7F5-57EC-87DA-1DB460D64046,"iPhone13,2"
com.truebill.truebillnative,75,1716313612,1716313687,1716313687.994859,-18000,EB445137-D7F5-57EC-87DA-1DB460D64046,"iPhone13,2"
com.truebill.truebillnative,50,1716313383,1716313433,1716313433.14975,-18000,EB445137-D7F5-57EC-87DA-1DB460D64046,"iPhone13,2"
com.clairmail.fth.client,28,1716313353,1716313381,1716313381.8768702,-18000,EB445137-D7F5-57EC-87DA-1DB460D64046,"iPhone13,2"
com.apple.findmy,11,1716313328,1716313339,1716313339.907823,-18000,EB445137-D7F5-57EC-87DA-1DB460D64046,"iPhone13,2"
com.hammerandchisel.discord,20,1716313308,1716313328,1716313328.089024,-18000,EB445137-D7F5-57EC-87DA-1DB460D64046,"iPhone13,2"
com.apple.podcasts,4,1716313304,1716313308,1716313309.528843,-18000,EB445137-D7F5-57EC-87DA-1DB460D64046,"iPhone13,2"
com.apple.podcasts,9,1716313078,1716313087,1716313087.502757,-18000,EB445137-D7F5-57EC-87DA-1DB460D64046,"iPhone13,2"
com.apple.podcasts,8,1716312992,1716313000,1716313000.468478,-18000,EB445137-D7F5-57EC-87DA-1DB460D64046,"iPhone13,2"
com.apple.podcasts,11,1716311850,1716311861,1716311861.0968142,-18000,EB445137-D7F5-57EC-87DA-1DB460D64046,"iPhone13,2"
com.apple.podcasts,2,1716311611,1716311613,1716311613.440104,-18000,EB445137-D7F5-57EC-87DA-1DB460D64046,"iPhone13,2"
com.apple.podcasts,9,1716311602,1716311611,1716311611.2601318,-18000,EB445137-D7F5-57EC-87DA-1DB460D64046,"iPhone13,2"
com.apple.podcasts,6,1716310313,1716310319,1716310319.2663221,-18000,EB445137-D7F5-57EC-87DA-1DB460D64046,"iPhone13,2"
com.apple.podcasts,6,1716310147,1716310153,1716310153.1264591,-18000,EB445137-D7F5-57EC-87DA-1DB460D64046,"iPhone13,2"
com.apple.podcasts,71,1716308904,1716308975,1716308975.354881,-18000,EB445137-D7F5-57EC-87DA-1DB460D64046,"iPhone13,2"
com.apple.podcasts,6,1716308812,1716308818,1716308818.484737,-18000,EB445137-D7F5-57EC-87DA-1DB460D64046,"iPhone13,2"
com.apple.podcasts,2,1716308809,1716308811,1716308811.575935,-18000,EB445137-D7F5-57EC-87DA-1DB460D64046,"iPhone13,2"
com.apple.podcasts,8,1716308275,1716308283,1716308283.1301699,-18000,EB445137-D7F5-57EC-87DA-1DB460D64046,"iPhone13,2"
com.apple.podcasts,9,1716308266,1716308275,1716308275.389765,-18000,EB445137-D7F5-57EC-87DA-1DB460D64046,"iPhone13,2"
com.apple.podcasts,9,1716306386,1716306395,1716306395.477854,-18000,EB445137-D7F5-57EC-87DA-1DB460D64046,"iPhone13,2"
com.apple.podcasts,11,1716304947,1716304958,1716304958.135494,-18000,EB445137-D7F5-57EC-87DA-1DB460D64046,"iPhone13,2"
com.apple.podcasts,5,1716304911,1716304916,1716304916.8670979,-18000,EB445137-D7F5-57EC-87DA-1DB460D64046,"iPhone13,2"
com.apple.podcasts,40,1716304589,1716304629,1716304629.442436,-18000,EB445137-D7F5-57EC-87DA-1DB460D64046,"iPhone13,2"
com.apple.Music,9,1716304577,1716304586,1716304586.826659,-18000,EB445137-D7F5-57EC-87DA-1DB460D64046,"iPhone13,2"
com.apple.Music,6,1716304570,1716304576,1716304576.561651,-18000,EB445137-D7F5-57EC-87DA-1DB460D64046,"iPhone13,2"
com.apple.Music,63,1716303776,1716303839,1716303839.105009,-18000,EB445137-D7F5-57EC-87DA-1DB460D64046,"iPhone13,2"
com.muscleforlife.Stacked,50,1716303697,1716303747,1716303747.582718,-18000,EB445137-D7F5-57EC-87DA-1DB460D64046,"iPhone13,2"
com.muscleforlife.Stacked,70,1716303606,1716303676,1716303676.5870252,-18000,EB445137-D7F5-57EC-87DA-1DB460D64046,"iPhone13,2"
com.muscleforlife.Stacked,171,1716303376,1716303547,1716303547.3625832,-18000,EB445137-D7F5-57EC-87DA-1DB460D64046,"iPhone13,2"
com.muscleforlife.Stacked,23,1716303346,1716303369,1716303369.1366448,-18000,EB445137-D7F5-57EC-87DA-1DB460D64046,"iPhone13,2"
com.muscleforlife.Stacked,9,1716303304,1716303313,1716303313.131229,-18000,EB445137-D7F5-57EC-87DA-1DB460D64046,"iPhone13,2"
com.muscleforlife.Stacked,93,1716303090,1716303183,1716303183.19353,-18000,EB445137-D7F5-57EC-87DA-1DB460D64046,"iPhone13,2"
com.muscleforlife.Stacked,5,1716303021,1716303026,1716303026.2418451,-18000,EB445137-D7F5-57EC-87DA-1DB460D64046,"iPhone13,2"
com.muscleforlife.Stacked,6,1716302987,1716302993,1716302993.8876781,-18000,EB445137-D7F5-57EC-87DA-1DB460D64046,"iPhone13,2"
com.muscleforlife.Stacked,44,1716302943,1716302987,1716302987.385438,-18000,EB445137-D7F5-57EC-87DA-1DB460D64046,"iPhone13,2"
com.muscleforlife.Stacked,70,1716302870,1716302940,1716302940.0374398,-18000,EB445137-D7F5-57EC-87DA-1DB460D64046,"iPhone13,2"
com.muscleforlife.Stacked,112,1716302722,1716302834,1716302834.900885,-18000,EB445137-D7F5-57EC-87DA-1DB460D64046,"iPhone13,2"
com.muscleforlife.Stacked,6,1716302684,1716302690,1716302690.8766332,-18000,EB445137-D7F5-57EC-87DA-1DB460D64046,"iPhone13,2"
com.muscleforlife.Stacked,4,1716302677,1716302681,1716302681.201108,-18000,EB445137-D7F5-57EC-87DA-1DB460D64046,"iPhone13,2"
com.muscleforlife.Stacked,22,1716302640,1716302662,1716302662.2743158,-18000,EB445137-D7F5-57EC-87DA-1DB460D64046,"iPhone13,2"
com.muscleforlife.Stacked,4,1716302610,1716302614,1716302614.948494,-18000,EB445137-D7F5-57EC-87DA-1DB460D64046,"iPhone13,2"
com.muscleforlife.Stacked,69,1716302485,1716302554,1716302554.7673411,-18000,EB445137-D7F5-57EC-87DA-1DB460D64046,"iPhone13,2"
com.apple.MobileSMS,9,1716302476,1716302485,1716302485.488734,-18000,EB445137-D7F5-57EC-87DA-1DB460D64046,"iPhone13,2"
com.muscleforlife.Stacked,5,1716302471,1716302476,1716302476.409923,-18000,EB445137-D7F5-57EC-87DA-1DB460D64046,"iPhone13,2"
com.muscleforlife.Stacked,9,1716302436,1716302445,1716302445.517576,-18000,EB445137-D7F5-57EC-87DA-1DB460D64046,"iPhone13,2"
com.muscleforlife.Stacked,72,1716302324,1716302396,1716302396.960324,-18000,EB445137-D7F5-57EC-87DA-1DB460D64046,"iPhone13,2"
com.google.ios.youtube,18,1716302306,1716302324,1716302324.312752,-18000,EB445137-D7F5-57EC-87DA-1DB460D64046,"iPhone13,2"
com.muscleforlife.Stacked,3,1716302303,1716302306,1716302306.0545402,-18000,EB445137-D7F5-57EC-87DA-1DB460D64046,"iPhone13,2"
com.muscleforlife.Stacked,12,1716302268,1716302280,1716302280.26187,-18000,EB445137-D7F5-57EC-87DA-1DB460D64046,"iPhone13,2"
com.google.ios.youtube,3,1716302265,1716302268,1716302268.522228,-18000,EB445137-D7F5-57EC-87DA-1DB460D64046,"iPhone13,2"
com.google.ios.youtube,54,1716302167,1716302221,1716302221.222352,-18000,EB445137-D7F5-57EC-87DA-1DB460D64046,"iPhone13,2"
com.muscleforlife.Stacked,2,1716302165,1716302167,1716302167.950954,-18000,EB445137-D7F5-57EC-87DA-1DB460D64046,"iPhone13,2"
com.muscleforlife.Stacked,4,1716302132,1716302136,1716302136.527128,-18000,EB445137-D7F5-57EC-87DA-1DB460D64046,"iPhone13,2"
com.muscleforlife.Stacked,43,1716302035,1716302078,1716302078.3577452,-18000,EB445137-D7F5-57EC-87DA-1DB460D64046,"iPhone13,2"
com.google.ios.youtube,55,1716301980,1716302035,1716302035.0684261,-18000,EB445137-D7F5-57EC-87DA-1DB460D64046,"iPhone13,2"
com.muscleforlife.Stacked,10,1716301970,1716301980,1716301980.896054,-18000,EB445137-D7F5-57EC-87DA-1DB460D64046,"iPhone13,2"
com.muscleforlife.Stacked,25,1716301885,1716301910,1716301910.584415,-18000,EB445137-D7F5-57EC-87DA-1DB460D64046,"iPhone13,2"
com.apple.MobileSMS,2,1716301883,1716301885,1716301885.59549,-18000,EB445137-D7F5-57EC-87DA-1DB460D64046,"iPhone13,2"
com.apple.weather,4,1716301879,1716301883,1716301883.9618158,-18000,EB445137-D7F5-57EC-87DA-1DB460D64046,"iPhone13,2"
com.apple.MobileSMS,11,1716301868,1716301879,1716301879.1439981,-18000,EB445137-D7F5-57EC-87DA-1DB460D64046,"iPhone13,2"
com.muscleforlife.Stacked,36,1716301832,1716301868,1716301868.482657,-18000,EB445137-D7F5-57EC-87DA-1DB460D64046,"iPhone13,2"
com.muscleforlife.Stacked,10,1716301796,1716301806,1716301806.0415158,-18000,EB445137-D7F5-57EC-87DA-1DB460D64046,"iPhone13,2"
com.muscleforlife.Stacked,5,1716301731,1716301736,1716301736.9083328,-18000,EB445137-D7F5-57EC-87DA-1DB460D64046,"iPhone13,2"
com.muscleforlife.Stacked,36,1716301620,1716301656,1716301656.119645,-18000,EB445137-D7F5-57EC-87DA-1DB460D64046,"iPhone13,2"
com.apple.Music,4,1716301608,1716301612,1716301612.5792089,-18000,EB445137-D7F5-57EC-87DA-1DB460D64046,"iPhone13,2"
com.apple.Music,2,1716301568,1716301570,1716301570.7476969,-18000,EB445137-D7F5-57EC-87DA-1DB460D64046,"iPhone13,2"
com.apple.Music,13,1716301230,1716301243,1716301243.1998138,-18000,EB445137-D7F5-57EC-87DA-1DB460D64046,"iPhone13,2"
com.apple.Music,65,1716300961,1716301026,1716301026.292258,-18000,EB445137-D7F5-57EC-87DA-1DB460D64046,"iPhone13,2"
com.toyopagroup.picaboo,6,1716300857,1716300863,1716300863.7854419,-18000,EB445137-D7F5-57EC-87DA-1DB460D64046,"iPhone13,2"
com.apple.MobileSMS,7,1716300850,1716300857,1716300857.142832,-18000,EB445137-D7F5-57EC-87DA-1DB460D64046,"iPhone13,2"
com.myfitnesspal.mfp,3,1716300847,1716300850,1716300851.028986,-18000,EB445137-D7F5-57EC-87DA-1DB460D64046,"iPhone13,2"
com.google.Chrome,6,1716300599,1716300605,1716300605.383325,-18000,,
com.myfitnesspal.mfp,430,1716300169,1716300599,1716300599.2746248,-18000,EB445137-D7F5-57EC-87DA-1DB460D64046,"iPhone13,2"
com.muscleforlife.Stacked,39,1716300130,1716300169,1716300169.107355,-18000,EB445137-D7F5-57EC-87DA-1DB460D64046,"iPhone13,2"
com.apple.MobileSMS,11,1716300108,1716300119,1716300119.385643,-18000,EB445137-D7F5-57EC-87DA-1DB460D64046,"iPhone13,2"
com.apple.findmy,5,1716300102,1716300107,1716300107.562037,-18000,EB445137-D7F5-57EC-87DA-1DB460D64046,"iPhone13,2"
com.google.Chrome,798,1716299650,1716300448,1716300448.9214602,-18000,,
com.apple.Preview,32,1716299618,1716299650,1716299650.4743261,-18000,,
com.apple.finder,13,1716299605,1716299618,1716299618.783609,-18000,,
com.google.Chrome,2,1716299603,1716299605,1716299605.717188,-18000,,
com.apple.findmy,88,1716299303,1716299391,1716299391.154562,-18000,EB445137-D7F5-57EC-87DA-1DB460D64046,"iPhone13,2"
com.apple.camera,1,1716299303,1716299304,1716299304.320559,-18000,EB445137-D7F5-57EC-87DA-1DB460D64046,"iPhone13,2"
com.apple.findmy,7,1716298776,1716298783,1716298783.572232,-18000,EB445137-D7F5-57EC-87DA-1DB460D64046,"iPhone13,2"
com.apple.PosterBoard,0,1716298773,1716298773,1716298773.919095,-18000,EB445137-D7F5-57EC-87DA-1DB460D64046,"iPhone13,2"
com.apple.mobiletimer,2,1716298772,1716298774,1716298774.9167938,-18000,EB445137-D7F5-57EC-87DA-1DB460D64046,"iPhone13,2"
com.apple.mobiletimer,11,1716298752,1716298763,1716298763.7893481,-18000,EB445137-D7F5-57EC-87DA-1DB460D64046,"iPhone13,2"
com.apple.mobiletimer,27,1716298201,1716298228,1716298228.34054,-18000,EB445137-D7F5-57EC-87DA-1DB460D64046,"iPhone13,2"
com.google.Chrome,428,1716258100,1716258528,1716258528.839826,-18000,,
com.apple.Photos,1,1716258099,1716258100,1716258100.568478,-18000,,
com.google.Chrome,145,1716257954,1716258099,1716258099.787002,-18000,,
com.apple.Photos,1,1716257953,1716257954,1716257954.8302531,-18000,,
com.google.Chrome,3,1716257950,1716257953,1716257953.645391,-18000,,
com.apple.Photos,2,1716257948,1716257950,1716257950.150341,-18000,,
com.google.Chrome,5,1716257943,1716257948,1716257948.600319,-18000,,
com.apple.Photos,1,1716257942,1716257943,1716257943.64297,-18000,,
com.google.Chrome,4,1716257938,1716257942,1716257942.7738461,-18000,,
com.apple.Photos,1,1716257937,1716257938,1716257939.01614,-18000,,
com.google.Chrome,1,1716257936,1716257937,1716257937.52037,-18000,,
com.apple.Photos,13,1716257923,1716257936,1716257936.946691,-18000,,
com.google.Chrome,151,1716257772,1716257923,1716257923.299135,-18000,,
com.apple.finder,9,1716257763,1716257772,1716257772.541389,-18000,,
com.apple.finder,87,1716256940,1716257027,1716257027.198978,-18000,,
com.google.Chrome,2,1716256938,1716256940,1716256940.041302,-18000,,
com.google.Chrome,812,1716253453,1716254265,1716254265.291699,-18000,,
com.google.Chrome,312,1716253054,1716253366,1716253366.913307,-18000,,
com.google.Chrome,402,1716252140,1716252542,1716252542.3557281,-18000,,
com.google.Chrome,462,1716251318,1716251780,1716251781.128942,-18000,,
com.apple.finder,146,1716251172,1716251318,1716251318.231876,-18000,,
com.microsoft.onenote.mac,1,1716251171,1716251172,1716251172.630669,-18000,,
com.google.Chrome,2111,1716249060,1716251171,1716251171.9686131,-18000,,
com.google.Chrome,524,1716248369,1716248893,1716248893.303689,-18000,,
com.google.Chrome,580,1716247673,1716248253,1716248253.937923,-18000,,
com.microsoft.onenote.mac,23,1716247650,1716247673,1716247673.550782,-18000,,
com.letterboxd.LetterboxdApp,17,1716245694,1716245711,1716245711.816931,-18000,EB445137-D7F5-57EC-87DA-1DB460D64046,"iPhone13,2"
com.apple.calculator,5,1716245684,1716245689,1716245689.8066769,-18000,EB445137-D7F5-57EC-87DA-1DB460D64046,"iPhone13,2"
com.apple.MobileSMS,11,1716245606,1716245617,1716245617.941132,-18000,EB445137-D7F5-57EC-87DA-1DB460D64046,"iPhone13,2"
com.apple.MobileSMS,59,1716245487,1716245546,1716245546.8029342,-18000,EB445137-D7F5-57EC-87DA-1DB460D64046,"iPhone13,2"
com.apple.MobileSMS,266,1716245089,1716245355,1716245355.5374498,-18000,EB445137-D7F5-57EC-87DA-1DB460D64046,"iPhone13,2"
com.apple.camera,0,1716244692,1716244692,1716244692.726986,-18000,EB445137-D7F5-57EC-87DA-1DB460D64046,"iPhone13,2"
com.apple.findmy,4,1716242353,1716242357,1716242357.909439,-18000,EB445137-D7F5-57EC-87DA-1DB460D64046,"iPhone13,2"
com.microsoft.onenote.mac,130,1716242231,1716242361,1716242361.574068,-18000,,
com.google.Chrome,6,1716242225,1716242231,1716242231.575753,-18000,,
com.apple.MobileSMS,2,1716242223,1716242225,1716242225.665681,-18000,,
com.zhiliaoapp.musically,186,1716241925,1716242111,1716242112.561091,-18000,EB445137-D7F5-57EC-87DA-1DB460D64046,"iPhone13,2"
com.apple.AppStore,2,1716241923,1716241925,1716241925.527396,-18000,EB445137-D7F5-57EC-87DA-1DB460D64046,"iPhone13,2"
com.apple.AppStore,6,1716241902,1716241908,1716241908.364486,-18000,EB445137-D7F5-57EC-87DA-1DB460D64046,"iPhone13,2"
com.apple.AppStore,64,1716241837,1716241901,1716241901.537963,-18000,EB445137-D7F5-57EC-87DA-1DB460D64046,"iPhone13,2"
com.google.Chrome,482,1716241741,1716242223,1716242223.8824039,-18000,,
com.apple.MobileSMS,2,1716241739,1716241741,1716241743.595722,-18000,,
com.truebill.truebillnative,446,1716241170,1716241616,1716241616.113957,-18000,EB445137-D7F5-57EC-87DA-1DB460D64046,"iPhone13,2"
com.apple.MobileSMS,6,1716241162,1716241168,1716241168.537586,-18000,EB445137-D7F5-57EC-87DA-1DB460D64046,"iPhone13,2"
com.google.chrome.ios,141,1716241021,1716241162,1716241162.431229,-18000,EB445137-D7F5-57EC-87DA-1DB460D64046,"iPhone13,2"
com.apple.MobileSMS,5,1716241016,1716241021,1716241021.4889278,-18000,EB445137-D7F5-57EC-87DA-1DB460D64046,"iPhone13,2"
com.google.Gmail,4,1716241011,1716241015,1716241015.020076,-18000,EB445137-D7F5-57EC-87DA-1DB460D64046,"iPhone13,2"
com.google.Gmail,21,1716240847,1716240868,1716240868.296952,-18000,EB445137-D7F5-57EC-87DA-1DB460D64046,"iPhone13,2"
com.apple.mobilephone,17,1716240828,1716240845,1716240846.002455,-18000,EB445137-D7F5-57EC-87DA-1DB460D64046,"iPhone13,2"
com.apple.InCallService,72,1716240756,1716240828,1716240828.768433,-18000,EB445137-D7F5-57EC-87DA-1DB460D64046,"iPhone13,2"
com.apple.mobilephone,40,1716240716,1716240756,1716240756.080467,-18000,EB445137-D7F5-57EC-87DA-1DB460D64046,"iPhone13,2"
com.apple.InCallService,31,1716240685,1716240716,1716240716.7985082,-18000,EB445137-D7F5-57EC-87DA-1DB460D64046,"iPhone13,2"
com.apple.mobilephone,17,1716240668,1716240685,1716240685.6267262,-18000,EB445137-D7F5-57EC-87DA-1DB460D64046,"iPhone13,2"
com.apple.MobileSMS,3,1716240665,1716240668,1716240668.242943,-18000,EB445137-D7F5-57EC-87DA-1DB460D64046,"iPhone13,2"
com.apple.mobilephone,4,1716240661,1716240665,1716240665.856967,-18000,EB445137-D7F5-57EC-87DA-1DB460D64046,"iPhone13,2"
com.apple.MobileSMS,4,1716240657,1716240661,1716240661.966213,-18000,EB445137-D7F5-57EC-87DA-1DB460D64046,"iPhone13,2"
com.apple.mobilephone,2,1716240655,1716240657,1716240657.938266,-18000,EB445137-D7F5-57EC-87DA-1DB460D64046,"iPhone13,2"
com.apple.MobileSMS,1,1716240654,1716240655,1716240655.7794209,-18000,EB445137-D7F5-57EC-87DA-1DB460D64046,"iPhone13,2"
com.apple.mobilephone,4,1716240650,1716240654,1716240654.075048,-18000,EB445137-D7F5-57EC-87DA-1DB460D64046,"iPhone13,2"
com.apple.MobileSMS,9,1716240640,1716240649,1716240650.3862262,-18000,EB445137-D7F5-57EC-87DA-1DB460D64046,"iPhone13,2"
com.apple.findmy,5,1716240635,1716240640,1716240640.25405,-18000,EB445137-D7F5-57EC-87DA-1DB460D64046,"iPhone13,2"
com.hammerandchisel.discord,11,1716240620,1716240631,1716240631.681717,-18000,EB445137-D7F5-57EC-87DA-1DB460D64046,"iPhone13,2"
com.apple.Music,4,1716240616,1716240620,1716240620.4228811,-18000,EB445137-D7F5-57EC-87DA-1DB460D64046,"iPhone13,2"
com.apple.Music,11,1716240241,1716240252,1716240252.602438,-18000,EB445137-D7F5-57EC-87DA-1DB460D64046,"iPhone13,2"
com.apple.Music,12,1716240082,1716240094,1716240094.26972,-18000,EB445137-D7F5-57EC-87DA-1DB460D64046,"iPhone13,2"
com.apple.Music,10,1716239450,1716239460,1716239460.34479,-18000,EB445137-D7F5-57EC-87DA-1DB460D64046,"iPhone13,2"
com.apple.Music,65,1716239367,1716239432,1716239432.821739,-18000,EB445137-D7F5-57EC-87DA-1DB460D64046,"iPhone13,2"
com.apple.Maps,18,1716239348,1716239366,1716239366.575249,-18000,EB445137-D7F5-57EC-87DA-1DB460D64046,"iPhone13,2"
com.apple.MobileSMS,4,1716239343,1716239347,1716239347.780438,-18000,EB445137-D7F5-57EC-87DA-1DB460D64046,"iPhone13,2"
com.google.chrome.ios,377,1716238770,1716239147,1716239147.905853,-18000,EB445137-D7F5-57EC-87DA-1DB460D64046,"iPhone13,2"
com.google.chrome.ios,6,1716238764,1716238770,1716238770.233285,-18000,EB445137-D7F5-57EC-87DA-1DB460D64046,"iPhone13,2"
com.google.chrome.ios,6,1716238750,1716238756,1716238756.244071,-18000,EB445137-D7F5-57EC-87DA-1DB460D64046,"iPhone13,2"
com.google.chrome.ios,78,1716238580,1716238658,1716238658.51071,-18000,EB445137-D7F5-57EC-87DA-1DB460D64046,"iPhone13,2"
com.myfitnesspal.mfp,2,1716238578,1716238580,1716238581.203141,-18000,EB445137-D7F5-57EC-87DA-1DB460D64046,"iPhone13,2"
com.myfitnesspal.mfp,29,1716236636,1716236665,1716236666.294592,-18000,EB445137-D7F5-57EC-87DA-1DB460D64046,"iPhone13,2"
com.burbn.instagram,28,1716236603,1716236631,1716236631.621341,-18000,EB445137-D7F5-57EC-87DA-1DB460D64046,"iPhone13,2"
com.amazon.Amazon,2,1716236599,1716236601,1716236601.3113708,-18000,EB445137-D7F5-57EC-87DA-1DB460D64046,"iPhone13,2"
com.amazon.Amazon,10,1716232838,1716232848,1716232849.8006458,-18000,EB445137-D7F5-57EC-87DA-1DB460D64046,"iPhone13,2"
com.google.chrome.ios,16,1716232822,1716232838,1716232839.071136,-18000,EB445137-D7F5-57EC-87DA-1DB460D64046,"iPhone13,2"
com.apple.Music,3,1716232819,1716232822,1716232822.1127892,-18000,EB445137-D7F5-57EC-87DA-1DB460D64046,"iPhone13,2"
com.apple.Music,22,1716225371,1716225393,1716225393.762391,-18000,EB445137-D7F5-57EC-87DA-1DB460D64046,"iPhone13,2"
com.apple.Music,11,1716225352,1716225363,1716225363.9098601,-18000,EB445137-D7F5-57EC-87DA-1DB460D64046,"iPhone13,2"
com.apple.Music,93,1716225253,1716225346,1716225346.826325,-18000,EB445137-D7F5-57EC-87DA-1DB460D64046,"iPhone13,2"
com.apple.Music,44,1716224953,1716224997,1716224997.4805899,-18000,EB445137-D7F5-57EC-87DA-1DB460D64046,"iPhone13,2"
com.myfitnesspal.mfp,38,1716224882,1716224920,1716224920.1012712,-18000,EB445137-D7F5-57EC-87DA-1DB460D64046,"iPhone13,2"
com.google.ios.youtube,3,1716224878,1716224881,1716224882.06334,-18000,EB445137-D7F5-57EC-87DA-1DB460D64046,"iPhone13,2"
com.google.ios.youtube,458,1716224284,1716224742,1716224743.07241,-18000,EB445137-D7F5-57EC-87DA-1DB460D64046,"iPhone13,2"
com.apple.MobileSMS,3,1716223961,1716223964,1716223964.42378,-18000,EB445137-D7F5-57EC-87DA-1DB460D64046,"iPhone13,2"
com.apple.Fitness,6,1716223955,1716223961,1716223961.596303,-18000,EB445137-D7F5-57EC-87DA-1DB460D64046,"iPhone13,2"
com.apple.Fitness,6,1716223923,1716223929,1716223929.7203388,-18000,EB445137-D7F5-57EC-87DA-1DB460D64046,"iPhone13,2"
com.apple.Fitness,68,1716223789,1716223857,1716223857.1037369,-18000,EB445137-D7F5-57EC-87DA-1DB460D64046,"iPhone13,2"
com.apple.weather,53,1716223730,1716223783,1716223783.13223,-18000,EB445137-D7F5-57EC-87DA-1DB460D64046,"iPhone13,2"
com.apple.mobilecal,31,1716223696,1716223727,1716223727.450955,-18000,EB445137-D7F5-57EC-87DA-1DB460D64046,"iPhone13,2"
com.microsoft.onenote,51,1716223641,1716223692,1716223692.5429559,-18000,EB445137-D7F5-57EC-87DA-1DB460D64046,"iPhone13,2"
com.leomehlig.today,3,1716223633,1716223636,1716223637.018075,-18000,EB445137-D7F5-57EC-87DA-1DB460D64046,"iPhone13,2"
org.name.serializdmobile,19,1716223438,1716223457,1716223457.863486,-18000,EB445137-D7F5-57EC-87DA-1DB460D64046,"iPhone13,2"
org.name.serializdmobile,115,1716223293,1716223408,1716223408.850596,-18000,EB445137-D7F5-57EC-87DA-1DB460D64046,"iPhone13,2"
com.apple.findmy,4,1716223273,1716223277,1716223277.0214849,-18000,EB445137-D7F5-57EC-87DA-1DB460D64046,"iPhone13,2"
com.apple.findmy,12,1716223134,1716223146,1716223146.821635,-18000,EB445137-D7F5-57EC-87DA-1DB460D64046,"iPhone13,2"
com.apple.MobileSMS,8,1716223101,1716223109,1716223109.358563,-18000,EB445137-D7F5-57EC-87DA-1DB460D64046,"iPhone13,2"
com.hammerandchisel.discord,43,1716223051,1716223094,1716223094.783467,-18000,EB445137-D7F5-57EC-87DA-1DB460D64046,"iPhone13,2"
com.hammerandchisel.discord,90,1716222548,1716222638,1716222638.5043101,-18000,EB445137-D7F5-57EC-87DA-1DB460D64046,"iPhone13,2"
com.myfitnesspal.mfp,155,1716222291,1716222446,1716222446.221964,-18000,EB445137-D7F5-57EC-87DA-1DB460D64046,"iPhone13,2"
com.myfitnesspal.mfp,7,1716222222,1716222229,1716222229.651222,-18000,EB445137-D7F5-57EC-87DA-1DB460D64046,"iPhone13,2"
com.myfitnesspal.mfp,146,1716222036,1716222182,1716222182.919582,-18000,EB445137-D7F5-57EC-87DA-1DB460D64046,"iPhone13,2"
com.facebook.Facebook,2,1716222034,1716222036,1716222036.486695,-18000,EB445137-D7F5-57EC-87DA-1DB460D64046,"iPhone13,2"
com.letterboxd.LetterboxdApp,3,1716222031,1716222034,1716222034.936892,-18000,EB445137-D7F5-57EC-87DA-1DB460D64046,"iPhone13,2"
com.letterboxd.LetterboxdApp,8,1716221779,1716221787,1716221787.168571,-18000,EB445137-D7F5-57EC-87DA-1DB460D64046,"iPhone13,2"
com.letterboxd.LetterboxdApp,65,1716221590,1716221655,1716221655.514299,-18000,EB445137-D7F5-57EC-87DA-1DB460D64046,"iPhone13,2"
com.facebook.Facebook,34,1716221226,1716221260,1716221260.748904,-18000,EB445137-D7F5-57EC-87DA-1DB460D64046,"iPhone13,2"
com.myfitnesspal.mfp,37,1716221163,1716221200,1716221200.316656,-18000,EB445137-D7F5-57EC-87DA-1DB460D64046,"iPhone13,2"
com.myfitnesspal.mfp,165,1716220997,1716221162,1716221162.369084,-18000,EB445137-D7F5-57EC-87DA-1DB460D64046,"iPhone13,2"
com.apple.MobileSMS,5,1716220986,1716220991,1716220991.737329,-18000,EB445137-D7F5-57EC-87DA-1DB460D64046,"iPhone13,2"
com.apple.MobileSMS,16,1716220629,1716220645,1716220645.509989,-18000,EB445137-D7F5-57EC-87DA-1DB460D64046,"iPhone13,2"
com.apple.findmy,8,1716220602,1716220610,1716220610.747717,-18000,EB445137-D7F5-57EC-87DA-1DB460D64046,"iPhone13,2"
com.hammerandchisel.discord,14,1716220587,1716220601,1716220601.6233869,-18000,EB445137-D7F5-57EC-87DA-1DB460D64046,"iPhone13,2"
com.truebill.truebillnative,6,1716220581,1716220587,1716220587.5067759,-18000,EB445137-D7F5-57EC-87DA-1DB460D64046,"iPhone13,2"
com.truebill.truebillnative,12,1716220568,1716220580,1716220580.219335,-18000,EB445137-D7F5-57EC-87DA-1DB460D64046,"iPhone13,2"
com.truebill.truebillnative,113,1716220421,1716220534,1716220534.7449489,-18000,EB445137-D7F5-57EC-87DA-1DB460D64046,"iPhone13,2"
com.google.chrome.ios,26,1716220393,1716220419,1716220419.928344,-18000,EB445137-D7F5-57EC-87DA-1DB460D64046,"iPhone13,2"
com.truebill.truebillnative,102,1716220288,1716220390,1716220391.237801,-18000,EB445137-D7F5-57EC-87DA-1DB460D64046,"iPhone13,2"
com.clairmail.fth.client,24,1716220260,1716220284,1716220284.985115,-18000,EB445137-D7F5-57EC-87DA-1DB460D64046,"iPhone13,2"
com.apple.findmy,15,1716220243,1716220258,1716220258.956915,-18000,EB445137-D7F5-57EC-87DA-1DB460D64046,"iPhone13,2"
com.apple.MobileSMS,52,1716219831,1716219883,1716219883.774729,-18000,,
com.apple.finder,2,1716219829,1716219831,1716219831.2029529,-18000,,
com.apple.Photos,81,1716219748,1716219829,1716219829.954016,-18000,,
com.google.Chrome,48,1716219700,1716219748,1716219748.562525,-18000,,
com.microsoft.onenote.mac,3,1716219697,1716219700,1716219700.5559402,-18000,,
com.microsoft.Office.Outlook,71,1716219595,1716219666,1716219666.198956,-18000,EB445137-D7F5-57EC-87DA-1DB460D64046,"iPhone13,2"
com.toyopagroup.picaboo,5,1716219590,1716219595,1716219595.9609032,-18000,EB445137-D7F5-57EC-87DA-1DB460D64046,"iPhone13,2"
com.toyopagroup.picaboo,10,1716218055,1716218065,1716218065.012861,-18000,EB445137-D7F5-57EC-87DA-1DB460D64046,"iPhone13,2"
com.toyopagroup.picaboo,9,1716217889,1716217898,1716217898.004899,-18000,EB445137-D7F5-57EC-87DA-1DB460D64046,"iPhone13,2"
com.toyopagroup.picaboo,23,1716217765,1716217788,1716217788.538291,-18000,EB445137-D7F5-57EC-87DA-1DB460D64046,"iPhone13,2"
com.apple.news,113,1716217648,1716217761,1716217761.8391109,-18000,EB445137-D7F5-57EC-87DA-1DB460D64046,"iPhone13,2"
com.apple.Music,7,1716217473,1716217480,1716217480.107939,-18000,EB445137-D7F5-57EC-87DA-1DB460D64046,"iPhone13,2"
com.apple.Music,7,1716216950,1716216957,1716216957.6356049,-18000,EB445137-D7F5-57EC-87DA-1DB460D64046,"iPhone13,2"
com.apple.Music,64,1716216746,1716216810,1716216810.4273171,-18000,EB445137-D7F5-57EC-87DA-1DB460D64046,"iPhone13,2"
com.muscleforlife.Stacked,70,1716216671,1716216741,1716216741.3407211,-18000,EB445137-D7F5-57EC-87DA-1DB460D64046,"iPhone13,2"
com.muscleforlife.Stacked,17,1716216559,1716216576,1716216576.2057428,-18000,EB445137-D7F5-57EC-87DA-1DB460D64046,"iPhone13,2"
com.muscleforlife.Stacked,4,1716216500,1716216504,1716216504.6007872,-18000,EB445137-D7F5-57EC-87DA-1DB460D64046,"iPhone13,2"
com.muscleforlife.Stacked,42,1716216422,1716216464,1716216464.412002,-18000,EB445137-D7F5-57EC-87DA-1DB460D64046,"iPhone13,2"
com.muscleforlife.Stacked,5,1716216395,1716216400,1716216400.097127,-18000,EB445137-D7F5-57EC-87DA-1DB460D64046,"iPhone13,2"
com.muscleforlife.Stacked,5,1716216354,1716216359,1716216359.117343,-18000,EB445137-D7F5-57EC-87DA-1DB460D64046,"iPhone13,2"
com.muscleforlife.Stacked,24,1716216262,1716216286,1716216286.713414,-18000,EB445137-D7F5-57EC-87DA-1DB460D64046,"iPhone13,2"
com.google.ios.youtube,1,1716216261,1716216262,1716216262.473916,-18000,EB445137-D7F5-57EC-87DA-1DB460D64046,"iPhone13,2"
com.muscleforlife.Stacked,40,1716216221,1716216261,1716216261.00885,-18000,EB445137-D7F5-57EC-87DA-1DB460D64046,"iPhone13,2"
com.google.ios.youtube,39,1716216182,1716216221,1716216221.352184,-18000,EB445137-D7F5-57EC-87DA-1DB460D64046,"iPhone13,2"
com.muscleforlife.Stacked,8,1716216174,1716216182,1716216182.295274,-18000,EB445137-D7F5-57EC-87DA-1DB460D64046,"iPhone13,2"
com.muscleforlife.Stacked,99,1716216026,1716216125,1716216125.726773,-18000,EB445137-D7F5-57EC-87DA-1DB460D64046,"iPhone13,2"
com.muscleforlife.Stacked,61,1716215926,1716215987,1716215987.179202,-18000,EB445137-D7F5-57EC-87DA-1DB460D64046,"iPhone13,2"
com.google.ios.youtube,44,1716215882,1716215926,1716215926.245604,-18000,EB445137-D7F5-57EC-87DA-1DB460D64046,"iPhone13,2"
com.muscleforlife.Stacked,6,1716215876,1716215882,1716215882.881042,-18000,EB445137-D7F5-57EC-87DA-1DB460D64046,"iPhone13,2"
com.muscleforlife.Stacked,71,1716215769,1716215840,1716215840.9548612,-18000,EB445137-D7F5-57EC-87DA-1DB460D64046,"iPhone13,2"
com.microsoft.onenote,6,1716215760,1716215766,1716215766.596612,-18000,EB445137-D7F5-57EC-87DA-1DB460D64046,"iPhone13,2"
com.muscleforlife.Stacked,30,1716215728,1716215758,1716215758.827773,-18000,EB445137-D7F5-57EC-87DA-1DB460D64046,"iPhone13,2"
com.muscleforlife.Stacked,65,1716215420,1716215485,1716215485.439052,-18000,EB445137-D7F5-57EC-87DA-1DB460D64046,"iPhone13,2"
com.muscleforlife.Stacked,163,1716215175,1716215338,1716215338.480044,-18000,EB445137-D7F5-57EC-87DA-1DB460D64046,"iPhone13,2"
com.muscleforlife.Stacked,121,1716214998,1716215119,1716215119.53882,-18000,EB445137-D7F5-57EC-87DA-1DB460D64046,"iPhone13,2"
com.muscleforlife.Stacked,6,1716214949,1716214955,1716214955.5575938,-18000,EB445137-D7F5-57EC-87DA-1DB460D64046,"iPhone13,2"
com.muscleforlife.Stacked,14,1716214875,1716214889,1716214889.4996681,-18000,EB445137-D7F5-57EC-87DA-1DB460D64046,"iPhone13,2"
com.myfitnesspal.mfp,3,1716214872,1716214875,1716214875.918416,-18000,EB445137-D7F5-57EC-87DA-1DB460D64046,"iPhone13,2"
com.myfitnesspal.mfp,14,1716214105,1716214119,1716214119.574955,-18000,EB445137-D7F5-57EC-87DA-1DB460D64046,"iPhone13,2"
com.myfitnesspal.mfp,131,1716213845,1716213976,1716213977.012052,-18000,EB445137-D7F5-57EC-87DA-1DB460D64046,"iPhone13,2"
com.muscleforlife.Stacked,3,1716213841,1716213844,1716213844.771991,-18000,EB445137-D7F5-57EC-87DA-1DB460D64046,"iPhone13,2"
com.microsoft.onenote.mac,295,1716213806,1716214101,1716214101.825975,-18000,,
com.google.Chrome,63,1716213743,1716213806,1716213806.680655,-18000,,
com.apple.Preview,6,1716213737,1716213743,1716213743.3538299,-18000,,
com.muscleforlife.Stacked,62,1716213732,1716213794,1716213794.894489,-18000,EB445137-D7F5-57EC-87DA-1DB460D64046,"iPhone13,2"
com.google.Chrome,65,1716213672,1716213737,1716213737.2065701,-18000,,
com.apple.Preview,2,1716213670,1716213672,1716213673.016358,-18000,,
com.google.Chrome,43,1716213627,1716213670,1716213670.9836469,-18000,,
com.apple.Preview,1,1716213626,1716213627,1716213627.4604049,-18000,,
com.google.Chrome,43,1716213583,1716213626,1716213626.042636,-18000,,
com.muscleforlife.Stacked,118,1716213566,1716213684,1716213684.519651,-18000,EB445137-D7F5-57EC-87DA-1DB460D64046,"iPhone13,2"
com.apple.MobileSMS,5,1716213559,1716213564,1716213564.96246,-18000,EB445137-D7F5-57EC-87DA-1DB460D64046,"iPhone13,2"
com.apple.Preview,25,1716213558,1716213583,1716213583.3923821,-18000,,
com.apple.MobileSMS,10,1716213530,1716213540,1716213540.7782369,-18000,EB445137-D7F5-57EC-87DA-1DB460D64046,"iPhone13,2"
com.apple.finder,33,1716213525,1716213558,1716213559.030528,-18000,,
com.apple.MobileSMS,48,1716213342,1716213390,1716213390.684029,-18000,EB445137-D7F5-57EC-87DA-1DB460D64046,"iPhone13,2"
com.apple.Preferences,11,1716212617,1716212628,1716212628.967215,-18000,EB445137-D7F5-57EC-87DA-1DB460D64046,"iPhone13,2"
com.apple.findmy,22,1716212595,1716212617,1716212617.695815,-18000,EB445137-D7F5-57EC-87DA-1DB460D64046,"iPhone13,2"
com.apple.finder,7,1716181938,1716181945,1716181945.561037,-18000,,
com.apple.Preview,0,1716181938,1716181938,1716181938.3159509,-18000,,
com.google.Chrome,908,1716181030,1716181938,1716181938.1454911,-18000,,
com.google.Chrome,1293,1716179465,1716180758,1716180758.226633,-18000,,
com.google.Chrome,1114,1716178311,1716179425,1716179425.8045402,-18000,,
com.google.Chrome,303,1716177906,1716178209,1716178209.504685,-18000,,
com.google.Chrome,1189,1716176454,1716177643,1716177643.961355,-18000,,
com.google.Chrome,595,1716175692,1716176287,1716176287.3093371,-18000,,
com.google.Chrome,389,1716175194,1716175583,1716175583.349699,-18000,,
com.google.Chrome,837,1716174217,1716175054,1716175054.788454,-18000,,
com.google.Chrome,302,1716173325,1716173627,1716173627.738501,-18000,,
com.google.Chrome,372,1716172903,1716173275,1716173275.9547548,-18000,,
com.google.Chrome,300,1716172525,1716172825,1716172825.4659739,-18000,,
com.google.Chrome,300,1716172144,1716172444,1716172444.59672,-18000,,
com.google.Chrome,577,1716171469,1716172046,1716172046.196,-18000,,
com.google.Chrome,6,1716170797,1716170803,1716170803.331173,-18000,,
com.apple.MobileSMS,89,1716170708,1716170797,1716170797.190402,-18000,,
com.apple.iCal,31,1716170677,1716170708,1716170708.786885,-18000,,
com.apple.MobileSMS,1,1716170676,1716170677,1716170677.489771,-18000,,
com.apple.iCal,5,1716170671,1716170676,1716170676.624161,-18000,,
com.apple.MobileSMS,3,1716170668,1716170671,1716170671.2010589,-18000,,
com.apple.iCal,12,1716170656,1716170668,1716170668.342976,-18000,,
com.apple.MobileSMS,5,1716170651,1716170656,1716170656.466445,-18000,,
com.apple.iCal,12,1716170639,1716170651,1716170651.446316,-18000,,
com.apple.MobileSMS,6,1716170633,1716170639,1716170639.5753741,-18000,,
com.apple.iCal,3,1716170630,1716170633,1716170633.9251199,-18000,,
com.apple.MobileSMS,4,1716170626,1716170630,1716170630.772547,-18000,,
com.google.Chrome,11,1716170615,1716170626,1716170626.6060781,-18000,,
com.google.Chrome,404,1716168298,1716168702,1716168702.373975,-18000,,
com.google.Chrome,623,1716166795,1716167418,1716167418.54511,-18000,,
com.google.Chrome,1620,1716164444,1716166064,1716166064.551142,-18000,,
com.google.Chrome,711,1716160640,1716161351,1716161351.9578009,-18000,,
com.google.Chrome,331,1716160292,1716160623,1716160623.77954,-18000,,
com.google.Chrome,382,1716159619,1716160001,1716160001.333236,-18000,,
com.apple.finder,1,1716159618,1716159619,1716159619.478108,-18000,,
com.apple.Preview,34,1716159584,1716159618,1716159618.538074,-18000,,
com.apple.finder,3,1716159581,1716159584,1716159584.497103,-18000,,
com.apple.Preview,296,1716159285,1716159581,1716159581.146658,-18000,,
com.apple.finder,35,1716159250,1716159285,1716159285.353293,-18000,,
com.google.Chrome,746,1716158504,1716159250,1716159250.8753982,-18000,,
com.google.Chrome,1172,1716154399,1716155571,1716155571.661467,-18000,,
com.google.Chrome,927,1716153471,1716154398,1716154398.8652291,-18000,,
com.google.Chrome,240,1716146177,1716146417,1716146417.9677072,-18000,,
com.google.Chrome,293,1716142793,1716143086,1716143086.215585,-18000,,
com.google.Chrome,498,1716142222,1716142720,1716142720.583013,-18000,,
com.google.Chrome,810,1716141206,1716142016,1716142016.6667318,-18000,,
com.google.ios.youtube,1608,1716128017,1716129625,1716129625.546348,-18000,EB445137-D7F5-57EC-87DA-1DB460D64046,"iPhone13,2"
com.apple.findmy,15,1716128001,1716128016,1716128017.144274,-18000,EB445137-D7F5-57EC-87DA-1DB460D64046,"iPhone13,2"
com.apple.findmy,6,1716127467,1716127473,1716127473.861539,-18000,EB445137-D7F5-57EC-87DA-1DB460D64046,"iPhone13,2"
com.apple.findmy,67,1716127240,1716127307,1716127307.8031502,-18000,EB445137-D7F5-57EC-87DA-1DB460D64046,"iPhone13,2"
com.apple.MobileSMS,6,1716100502,1716100508,1716100508.599801,-18000,EB445137-D7F5-57EC-87DA-1DB460D64046,"iPhone13,2"
com.toyopagroup.picaboo,36,1716100462,1716100498,1716100498.8080459,-18000,EB445137-D7F5-57EC-87DA-1DB460D64046,"iPhone13,2"
com.apple.mobiletimer,10,1716100452,1716100462,1716100462.510931,-18000,EB445137-D7F5-57EC-87DA-1DB460D64046,"iPhone13,2"
com.apple.mobiletimer,8,1716100444,1716100452,1716100452.429809,-18000,EB445137-D7F5-57EC-87DA-1DB460D64046,"iPhone13,2"
com.apple.calculator,4,1716100378,1716100382,1716100382.6573582,-18000,EB445137-D7F5-57EC-87DA-1DB460D64046,"iPhone13,2"
com.apple.calculator,17,1716099214,1716099231,1716099231.445039,-18000,EB445137-D7F5-57EC-87DA-1DB460D64046,"iPhone13,2"
com.google.chrome.ios,7,1716090507,1716090514,1716090514.800956,-18000,EB445137-D7F5-57EC-87DA-1DB460D64046,"iPhone13,2"
com.instructure.icanvas,21,1716090486,1716090507,1716090507.235927,-18000,EB445137-D7F5-57EC-87DA-1DB460D64046,"iPhone13,2"
com.instructure.icanvas,34,1716090450,1716090484,1716090484.598778,-18000,EB445137-D7F5-57EC-87DA-1DB460D64046,"iPhone13,2"
com.google.chrome.ios,10,1716090440,1716090450,1716090450.350941,-18000,EB445137-D7F5-57EC-87DA-1DB460D64046,"iPhone13,2"
com.google.chrome.ios,99,1716090204,1716090303,1716090304.0166879,-18000,EB445137-D7F5-57EC-87DA-1DB460D64046,"iPhone13,2"
com.google.chrome.ios,13,1716090025,1716090038,1716090038.421505,-18000,EB445137-D7F5-57EC-87DA-1DB460D64046,"iPhone13,2"
com.instructure.icanvas,3,1716090021,1716090024,1716090024.406712,-18000,EB445137-D7F5-57EC-87DA-1DB460D64046,"iPhone13,2"
com.instructure.icanvas,2,1716089967,1716089969,1716089969.085239,-18000,EB445137-D7F5-57EC-87DA-1DB460D64046,"iPhone13,2"
com.instructure.icanvas,3,1716089900,1716089903,1716089903.921514,-18000,EB445137-D7F5-57EC-87DA-1DB460D64046,"iPhone13,2"
com.instructure.icanvas,14,1716089602,1716089616,1716089616.4522882,-18000,EB445137-D7F5-57EC-87DA-1DB460D64046,"iPhone13,2"
com.apple.mobilecal,4,1716089598,1716089602,1716089602.4805,-18000,EB445137-D7F5-57EC-87DA-1DB460D64046,"iPhone13,2"
com.instructure.icanvas,5,1716089589,1716089594,1716089594.91559,-18000,EB445137-D7F5-57EC-87DA-1DB460D64046,"iPhone13,2"
com.hammerandchisel.discord,13,1716089574,1716089587,1716089587.54839,-18000,EB445137-D7F5-57EC-87DA-1DB460D64046,"iPhone13,2"
com.hammerandchisel.discord,15,1716089528,1716089543,1716089543.822063,-18000,EB445137-D7F5-57EC-87DA-1DB460D64046,"iPhone13,2"
com.apple.findmy,17,1716086889,1716086906,1716086906.3421001,-18000,EB445137-D7F5-57EC-87DA-1DB460D64046,"iPhone13,2"
com.apple.findmy,2,1716078808,1716078810,1716078810.360241,-18000,EB445137-D7F5-57EC-87DA-1DB460D64046,"iPhone13,2"
com.apple.findmy,6,1716065899,1716065905,1716065905.092704,-18000,EB445137-D7F5-57EC-87DA-1DB460D64046,"iPhone13,2"
com.apple.findmy,4,1716065894,1716065898,1716065898.756733,-18000,EB445137-D7F5-57EC-87DA-1DB460D64046,"iPhone13,2"
com.apple.findmy,10,1716065883,1716065893,1716065893.326915,-18000,EB445137-D7F5-57EC-87DA-1DB460D64046,"iPhone13,2"
com.apple.findmy,10,1716065315,1716065325,1716065325.898695,-18000,EB445137-D7F5-57EC-87DA-1DB460D64046,"iPhone13,2"
com.goodreads.Goodreads,37,1716064795,1716064832,1716064832.961493,-18000,EB445137-D7F5-57EC-87DA-1DB460D64046,"iPhone13,2"
com.thestorygraph.thestorygraph,11,1716064783,1716064794,1716064794.143153,-18000,EB445137-D7F5-57EC-87DA-1DB460D64046,"iPhone13,2"
com.google.ios.youtube,210,1716063979,1716064189,1716064189.4728189,-18000,EB445137-D7F5-57EC-87DA-1DB460D64046,"iPhone13,2"
com.apple.findmy,6,1716063973,1716063979,1716063979.5925,-18000,EB445137-D7F5-57EC-87DA-1DB460D64046,"iPhone13,2"
com.google.ios.youtube,3,1716063970,1716063973,1716063973.419502,-18000,EB445137-D7F5-57EC-87DA-1DB460D64046,"iPhone13,2"
com.google.ios.youtube,75,1716063786,1716063861,1716063861.138483,-18000,EB445137-D7F5-57EC-87DA-1DB460D64046,"iPhone13,2"
com.google.ios.youtube,628,1716063045,1716063673,1716063673.922049,-18000,EB445137-D7F5-57EC-87DA-1DB460D64046,"iPhone13,2"
com.myfitnesspal.mfp,3,1716063042,1716063045,1716063045.487956,-18000,EB445137-D7F5-57EC-87DA-1DB460D64046,"iPhone13,2"
com.myfitnesspal.mfp,29,1716063005,1716063034,1716063034.4600182,-18000,EB445137-D7F5-57EC-87DA-1DB460D64046,"iPhone13,2"
com.apple.news,4,1716063000,1716063004,1716063004.780078,-18000,EB445137-D7F5-57EC-87DA-1DB460D64046,"iPhone13,2"
com.apple.news,33,1716062766,1716062799,1716062799.493964,-18000,EB445137-D7F5-57EC-87DA-1DB460D64046,"iPhone13,2"
com.apple.findmy,8,1716062749,1716062757,1716062757.859833,-18000,EB445137-D7F5-57EC-87DA-1DB460D64046,"iPhone13,2"
com.apple.findmy,6,1716062615,1716062621,1716062621.490272,-18000,EB445137-D7F5-57EC-87DA-1DB460D64046,"iPhone13,2"
com.apple.findmy,17,1716062593,1716062610,1716062610.432313,-18000,EB445137-D7F5-57EC-87DA-1DB460D64046,"iPhone13,2"
com.apple.camera,1,1716062583,1716062584,1716062584.290776,-18000,EB445137-D7F5-57EC-87DA-1DB460D64046,"iPhone13,2"
com.google.Chrome,518,1716062034,1716062552,1716062552.4453712,-18000,,
com.apple.Health,105,1716061465,1716061570,1716061570.524272,-18000,EB445137-D7F5-57EC-87DA-1DB460D64046,"iPhone13,2"
com.google.Chrome,581,1716061425,1716062006,1716062006.8335671,-18000,,
com.google.Chrome,545,1716060803,1716061348,1716061348.665669,-18000,,
com.google.Chrome,579,1716059763,1716060342,1716060342.136797,-18000,,
com.google.Chrome,524,1716059073,1716059597,1716059597.636512,-18000,,
com.google.Chrome,1513,1716057433,1716058946,1716058946.400237,-18000,,
com.apple.MobileSMS,11,1716057003,1716057014,1716057015.068079,-18000,EB445137-D7F5-57EC-87DA-1DB460D64046,"iPhone13,2"
com.toyopagroup.picaboo,11,1716056645,1716056656,1716056656.628252,-18000,EB445137-D7F5-57EC-87DA-1DB460D64046,"iPhone13,2"
com.google.chrome.ios,18,1716056622,1716056640,1716056640.641752,-18000,EB445137-D7F5-57EC-87DA-1DB460D64046,"iPhone13,2"
com.google.Chrome,982,1716056163,1716057145,1716057145.6097531,-18000,,
com.google.Chrome,898,1716055146,1716056044,1716056044.843014,-18000,,
com.apple.MobileSMS,6,1716055140,1716055146,1716055146.583366,-18000,,
com.google.Chrome,45,1716055095,1716055140,1716055140.903407,-18000,,
com.google.chrome.ios,2,1716055058,1716055060,1716055060.957137,-18000,EB445137-D7F5-57EC-87DA-1DB460D64046,"iPhone13,2"
com.apple.MobileSMS,4,1716055054,1716055058,1716055059.042073,-18000,EB445137-D7F5-57EC-87DA-1DB460D64046,"iPhone13,2"
com.myfitnesspal.mfp,4,1716055049,1716055053,1716055053.714298,-18000,EB445137-D7F5-57EC-87DA-1DB460D64046,"iPhone13,2"
com.myfitnesspal.mfp,45,1716054973,1716055018,1716055018.772321,-18000,EB445137-D7F5-57EC-87DA-1DB460D64046,"iPhone13,2"
com.apple.MobileSMS,139,1716054834,1716054973,1716054973.6110039,-18000,EB445137-D7F5-57EC-87DA-1DB460D64046,"iPhone13,2"
com.google.chrome.ios,100,1716054734,1716054834,1716054834.8584461,-18000,EB445137-D7F5-57EC-87DA-1DB460D64046,"iPhone13,2"
com.apple.news,136,1716054597,1716054733,1716054733.5333772,-18000,EB445137-D7F5-57EC-87DA-1DB460D64046,"iPhone13,2"
com.myfitnesspal.mfp,80,1716054499,1716054579,1716054579.431936,-18000,EB445137-D7F5-57EC-87DA-1DB460D64046,"iPhone13,2"
com.apple.MobileSMS,3,1716053844,1716053847,1716053847.9559689,-18000,EB445137-D7F5-57EC-87DA-1DB460D64046,"iPhone13,2"
com.apple.MobileSMS,10,1716053784,1716053794,1716053794.0373878,-18000,EB445137-D7F5-57EC-87DA-1DB460D64046,"iPhone13,2"
com.apple.MobileSMS,2,1716053773,1716053775,1716053775.8427181,-18000,EB445137-D7F5-57EC-87DA-1DB460D64046,"iPhone13,2"
com.google.ios.youtube,877,1716052896,1716053773,1716053773.9131641,-18000,EB445137-D7F5-57EC-87DA-1DB460D64046,"iPhone13,2"
com.apple.MobileSMS,37,1716052858,1716052895,1716052895.312393,-18000,EB445137-D7F5-57EC-87DA-1DB460D64046,"iPhone13,2"
com.thestorygraph.thestorygraph,9,1716052848,1716052857,1716052857.702194,-18000,EB445137-D7F5-57EC-87DA-1DB460D64046,"iPhone13,2"
com.thestorygraph.thestorygraph,30,1716052810,1716052840,1716052840.248348,-18000,EB445137-D7F5-57EC-87DA-1DB460D64046,"iPhone13,2"
com.apple.findmy,5,1716052799,1716052804,1716052804.170928,-18000,EB445137-D7F5-57EC-87DA-1DB460D64046,"iPhone13,2"
com.apple.findmy,5,1716050668,1716050673,1716050673.030472,-18000,EB445137-D7F5-57EC-87DA-1DB460D64046,"iPhone13,2"
com.google.ios.youtube,2,1716050666,1716050668,1716050668.871789,-18000,EB445137-D7F5-57EC-87DA-1DB460D64046,"iPhone13,2"
com.google.ios.youtube,10,1716050636,1716050646,1716050646.68146,-18000,EB445137-D7F5-57EC-87DA-1DB460D64046,"iPhone13,2"
com.google.ios.youtube,413,1716050204,1716050617,1716050617.627696,-18000,EB445137-D7F5-57EC-87DA-1DB460D64046,"iPhone13,2"
com.google.ios.youtube,7,1716050197,1716050204,1716050204.1225119,-18000,EB445137-D7F5-57EC-87DA-1DB460D64046,"iPhone13,2"
com.google.ios.youtube,662,1716048296,1716048958,1716048958.921327,-18000,EB445137-D7F5-57EC-87DA-1DB460D64046,"iPhone13,2"
com.google.chrome.ios,8,1716048269,1716048277,1716048277.951127,-18000,EB445137-D7F5-57EC-87DA-1DB460D64046,"iPhone13,2"
com.apple.Maps,40,1716048229,1716048269,1716048269.4946198,-18000,EB445137-D7F5-57EC-87DA-1DB460D64046,"iPhone13,2"
com.google.chrome.ios,17,1716048212,1716048229,1716048229.9822001,-18000,EB445137-D7F5-57EC-87DA-1DB460D64046,"iPhone13,2"
com.google.Sheets,92,1716048120,1716048212,1716048212.6490211,-18000,EB445137-D7F5-57EC-87DA-1DB460D64046,"iPhone13,2"
com.apple.mobilecal,35,1716048083,1716048118,1716048118.738142,-18000,EB445137-D7F5-57EC-87DA-1DB460D64046,"iPhone13,2"
com.apple.mobilecal,12,1716048071,1716048083,1716048083.3719559,-18000,EB445137-D7F5-57EC-87DA-1DB460D64046,"iPhone13,2"
com.apple.mobilecal,322,1716047611,1716047933,1716047933.196218,-18000,EB445137-D7F5-57EC-87DA-1DB460D64046,"iPhone13,2"
com.tier9digital.sundial,8,1716047603,1716047611,1716047611.361444,-18000,EB445137-D7F5-57EC-87DA-1DB460D64046,"iPhone13,2"
com.apple.mobilecal,21,1716047582,1716047603,1716047603.534745,-18000,EB445137-D7F5-57EC-87DA-1DB460D64046,"iPhone13,2"
com.tier9digital.sundial,29,1716047553,1716047582,1716047582.326319,-18000,EB445137-D7F5-57EC-87DA-1DB460D64046,"iPhone13,2"
com.apple.mobilecal,14,1716047539,1716047553,1716047553.929352,-18000,EB445137-D7F5-57EC-87DA-1DB460D64046,"iPhone13,2"
com.tier9digital.sundial,14,1716047525,1716047539,1716047539.440752,-18000,EB445137-D7F5-57EC-87DA-1DB460D64046,"iPhone13,2"
com.apple.mobilecal,7,1716047518,1716047525,1716047525.838418,-18000,EB445137-D7F5-57EC-87DA-1DB460D64046,"iPhone13,2"
com.google.chrome.ios,24,1716047494,1716047518,1716047518.907933,-18000,EB445137-D7F5-57EC-87DA-1DB460D64046,"iPhone13,2"
com.apple.mobilecal,15,1716047479,1716047494,1716047494.518806,-18000,EB445137-D7F5-57EC-87DA-1DB460D64046,"iPhone13,2"
com.google.chrome.ios,9,1716047470,1716047479,1716047479.717632,-18000,EB445137-D7F5-57EC-87DA-1DB460D64046,"iPhone13,2"
com.robinhood.release.Robinhood,1,1716047469,1716047470,1716047470.1537561,-18000,EB445137-D7F5-57EC-87DA-1DB460D64046,"iPhone13,2"
com.apple.Maps,123,1716047346,1716047469,1716047469.450479,-18000,EB445137-D7F5-57EC-87DA-1DB460D64046,"iPhone13,2"
com.apple.mobilecal,10,1716047333,1716047343,1716047343.329184,-18000,EB445137-D7F5-57EC-87DA-1DB460D64046,"iPhone13,2"
com.tier9digital.sundial,16,1716047317,1716047333,1716047333.537499,-18000,EB445137-D7F5-57EC-87DA-1DB460D64046,"iPhone13,2"
com.apple.mobilecal,13,1716047301,1716047314,1716047314.183737,-18000,EB445137-D7F5-57EC-87DA-1DB460D64046,"iPhone13,2"
com.apple.Maps,6,1716047292,1716047298,1716047299.004519,-18000,EB445137-D7F5-57EC-87DA-1DB460D64046,"iPhone13,2"
com.tier9digital.sundial,3,1716047260,1716047263,1716047263.25455,-18000,EB445137-D7F5-57EC-87DA-1DB460D64046,"iPhone13,2"
com.facebook.Facebook,2,1716047255,1716047257,1716047257.056127,-18000,EB445137-D7F5-57EC-87DA-1DB460D64046,"iPhone13,2"
com.facebook.Facebook,1128,1716045723,1716046851,1716046851.597511,-18000,EB445137-D7F5-57EC-87DA-1DB460D64046,"iPhone13,2"
com.apple.weather,8,1716045695,1716045703,1716045703.637909,-18000,EB445137-D7F5-57EC-87DA-1DB460D64046,"iPhone13,2"
com.truebill.truebillnative,4,1716045684,1716045688,1716045688.1477509,-18000,EB445137-D7F5-57EC-87DA-1DB460D64046,"iPhone13,2"
com.truebill.truebillnative,27,1716045280,1716045307,1716045307.00511,-18000,EB445137-D7F5-57EC-87DA-1DB460D64046,"iPhone13,2"
com.myfitnesspal.mfp,42,1716045236,1716045278,1716045278.377849,-18000,EB445137-D7F5-57EC-87DA-1DB460D64046,"iPhone13,2"
com.apple.Health,8,1716045218,1716045226,1716045226.259583,-18000,EB445137-D7F5-57EC-87DA-1DB460D64046,"iPhone13,2"
com.google.ios.youtube,13,1716045204,1716045217,1716045217.618655,-18000,EB445137-D7F5-57EC-87DA-1DB460D64046,"iPhone13,2"
com.google.ios.youtube,9,1716043639,1716043648,1716043648.2186651,-18000,EB445137-D7F5-57EC-87DA-1DB460D64046,"iPhone13,2"
com.google.ios.youtube,8,1716043552,1716043560,1716043560.8036032,-18000,EB445137-D7F5-57EC-87DA-1DB460D64046,"iPhone13,2"
com.google.ios.youtube,548,1716042943,1716043491,1716043491.838011,-18000,EB445137-D7F5-57EC-87DA-1DB460D64046,"iPhone13,2"
com.apple.news,157,1716042786,1716042943,1716042943.326075,-18000,EB445137-D7F5-57EC-87DA-1DB460D64046,"iPhone13,2"
com.google.chrome.ios,42,1716042525,1716042567,1716042567.288688,-18000,EB445137-D7F5-57EC-87DA-1DB460D64046,"iPhone13,2"
com.google.chrome.ios,71,1716042431,1716042502,1716042502.8544102,-18000,EB445137-D7F5-57EC-87DA-1DB460D64046,"iPhone13,2"
com.google.ios.youtube,987,1716040686,1716041673,1716041673.558975,-18000,EB445137-D7F5-57EC-87DA-1DB460D64046,"iPhone13,2"
com.apple.Preferences,17,1716040669,1716040686,1716040686.4804,-18000,EB445137-D7F5-57EC-87DA-1DB460D64046,"iPhone13,2"
com.google.ios.youtube,2,1716040667,1716040669,1716040669.308841,-18000,EB445137-D7F5-57EC-87DA-1DB460D64046,"iPhone13,2"
com.apple.findmy,6,1716040658,1716040664,1716040664.411322,-18000,EB445137-D7F5-57EC-87DA-1DB460D64046,"iPhone13,2"
com.apple.camera,2,1716040651,1716040653,1716040653.261142,-18000,EB445137-D7F5-57EC-87DA-1DB460D64046,"iPhone13,2"
com.apple.mobiletimer,8,1716040649,1716040657,1716040657.339127,-18000,EB445137-D7F5-57EC-87DA-1DB460D64046,"iPhone13,2"
com.apple.mobiletimer,6,1716040608,1716040614,1716040614.5816631,-18000,EB445137-D7F5-57EC-87DA-1DB460D64046,"iPhone13,2"
com.apple.mobiletimer,284,1716040264,1716040548,1716040548.223866,-18000,EB445137-D7F5-57EC-87DA-1DB460D64046,"iPhone13,2"
com.google.Chrome,1,1716007262,1716007263,1716007263.422184,-18000,,
com.google.Chrome,112,1716007082,1716007194,1716007195.102591,-18000,,
com.google.Chrome,504,1716006337,1716006841,1716006841.3600268,-18000,,
com.google.Chrome,463,1716005739,1716006202,1716006202.542173,-18000,,
com.google.Chrome,421,1716004995,1716005416,1716005416.118448,-18000,,
com.google.Chrome,372,1716003606,1716003978,1716003978.2335138,-18000,,
com.google.Chrome,305,1716003287,1716003592,1716003592.70772,-18000,,
com.google.Chrome,847,1716002012,1716002859,1716002859.1454139,-18000,,
com.apple.MobileSMS,2,1716002010,1716002012,1716002012.7813091,-18000,,
com.google.Chrome,3,1716002007,1716002010,1716002010.143598,-18000,,
com.apple.finder,1,1716002006,1716002007,1716002007.781959,-18000,,
com.microsoft.rdc.macos,6,1716002000,1716002006,1716002006.946085,-18000,,
com.microsoft.rdc.macos,1138,1715999691,1716000829,1716000830.073437,-18000,,
com.microsoft.rdc.macos,189,1715997233,1715997422,1715997422.781763,-18000,,
com.microsoft.rdc.macos,282,1715996263,1715996545,1715996545.135886,-18000,,
com.apple.FaceTime,5,1715996258,1715996263,1715996263.6395621,-18000,,
com.microsoft.rdc.macos,350,1715995908,1715996258,1715996258.250417,-18000,,
org.stellarium.Stellarium,42,1715995866,1715995908,1715995908.262927,-18000,,
com.microsoft.rdc.macos,20,1715995846,1715995866,1715995866.113085,-18000,,
org.stellarium.Stellarium,1,1715995845,1715995846,1715995846.200264,-18000,,
com.microsoft.rdc.macos,3,1715995842,1715995845,1715995845.555049,-18000,,
org.stellarium.Stellarium,9,1715995833,1715995842,1715995842.436211,-18000,,
com.microsoft.rdc.macos,15,1715995818,1715995833,1715995833.891969,-18000,,
org.stellarium.Stellarium,26,1715995792,1715995818,1715995818.459093,-18000,,
com.microsoft.rdc.macos,40,1715995752,1715995792,1715995792.433659,-18000,,
org.stellarium.Stellarium,11,1715995741,1715995752,1715995752.423339,-18000,,
com.microsoft.rdc.macos,22,1715995719,1715995741,1715995741.6716971,-18000,,
org.stellarium.Stellarium,15,1715995704,1715995719,1715995719.199436,-18000,,
com.microsoft.rdc.macos,52,1715995652,1715995704,1715995704.365612,-18000,,
org.stellarium.Stellarium,43,1715995609,1715995652,1715995652.0679379,-18000,,
com.microsoft.rdc.macos,35,1715995574,1715995609,1715995609.886539,-18000,,
org.stellarium.Stellarium,2,1715995572,1715995574,1715995574.1611052,-18000,,
com.microsoft.rdc.macos,4,1715995568,1715995572,1715995572.592478,-18000,,
org.stellarium.Stellarium,75,1715995493,1715995568,1715995568.185048,-18000,,
com.microsoft.rdc.macos,55,1715995438,1715995493,1715995493.703649,-18000,,
org.stellarium.Stellarium,93,1715995345,1715995438,1715995438.80332,-18000,,
com.google.Chrome,51,1715995294,1715995345,1715995345.587611,-18000,,
org.stellarium.Stellarium,9,1715995285,1715995294,1715995294.611192,-18000,,
com.microsoft.rdc.macos,137,1715995148,1715995285,1715995285.557523,-18000,,
com.google.Chrome,27,1715995121,1715995148,1715995148.3805299,-18000,,
com.microsoft.rdc.macos,50,1715995071,1715995121,1715995121.081737,-18000,,
com.google.Chrome,22,1715995049,1715995071,1715995071.9242449,-18000,,
com.microsoft.rdc.macos,24,1715995025,1715995049,1715995049.173933,-18000,,
com.google.Chrome,32,1715994993,1715995025,1715995025.556994,-18000,,
com.apple.MobileSMS,1,1715994417,1715994418,1715994418.6683989,-18000,,
com.google.Chrome,11,1715994406,1715994417,1715994418.082244,-18000,,
com.google.Chrome,1434,1715992803,1715994237,1715994237.997071,-18000,,
com.google.Chrome,797,1715991105,1715991902,1715991902.5903711,-18000,,
com.google.Chrome,321,1715990628,1715990949,1715990949.354867,-18000,,
com.google.Chrome,449,1715990038,1715990487,1715990487.8092809,-18000,,
com.apple.MobileSMS,21,1715990017,1715990038,1715990038.5866551,-18000,,
com.google.Chrome,150,1715989867,1715990017,1715990017.257225,-18000,,
com.apple.MobileSMS,26,1715989841,1715989867,1715989867.7773728,-18000,,
com.google.Chrome,135,1715989706,1715989841,1715989841.263099,-18000,,
com.apple.MobileSMS,61,1715989645,1715989706,1715989706.3942409,-18000,,
com.google.Chrome,168,1715989477,1715989645,1715989645.399121,-18000,,
com.apple.MobileSMS,8,1715989469,1715989477,1715989477.865588,-18000,,
com.google.Chrome,373,1715989096,1715989469,1715989469.6147199,-18000,,
com.google.Chrome,377,1715988260,1715988637,1715988637.493041,-18000,,
com.google.chrome.ios,214,1715984628,1715984842,1715984842.123769,-18000,EB445137-D7F5-57EC-87DA-1DB460D64046,"iPhone13,2"
com.apple.Maps,7,1715984621,1715984628,1715984628.309365,-18000,EB445137-D7F5-57EC-87DA-1DB460D64046,"iPhone13,2"
com.apple.Maps,7,1715984466,1715984473,1715984473.351324,-18000,EB445137-D7F5-57EC-87DA-1DB460D64046,"iPhone13,2"
com.apple.Maps,501,1715983950,1715984451,1715984451.521503,-18000,EB445137-D7F5-57EC-87DA-1DB460D64046,"iPhone13,2"
com.google.chrome.ios,35,1715983915,1715983950,1715983950.455612,-18000,EB445137-D7F5-57EC-87DA-1DB460D64046,"iPhone13,2"
com.apple.Maps,33,1715983882,1715983915,1715983915.9670448,-18000,EB445137-D7F5-57EC-87DA-1DB460D64046,"iPhone13,2"
com.google.chrome.ios,70,1715983812,1715983882,1715983883.4125628,-18000,EB445137-D7F5-57EC-87DA-1DB460D64046,"iPhone13,2"
com.ryansponzilli.DeepSkyCatalog,2,1715983810,1715983812,1715983812.415278,-18000,EB445137-D7F5-57EC-87DA-1DB460D64046,"iPhone13,2"
com.apple.Maps,52,1715983758,1715983810,1715983810.419931,-18000,EB445137-D7F5-57EC-87DA-1DB460D64046,"iPhone13,2"
com.ryansponzilli.DeepSkyCatalog,8,1715983750,1715983758,1715983758.345305,-18000,EB445137-D7F5-57EC-87DA-1DB460D64046,"iPhone13,2"
Astrospheric.Astrospheric,10,1715983737,1715983747,1715983748.0856009,-18000,EB445137-D7F5-57EC-87DA-1DB460D64046,"iPhone13,2"
com.apple.Maps,25,1715983710,1715983735,1715983735.948237,-18000,EB445137-D7F5-57EC-87DA-1DB460D64046,"iPhone13,2"
com.google.chrome.ios,8,1715983702,1715983710,1715983710.312772,-18000,EB445137-D7F5-57EC-87DA-1DB460D64046,"iPhone13,2"
com.apple.Maps,53,1715983649,1715983702,1715983703.0433059,-18000,EB445137-D7F5-57EC-87DA-1DB460D64046,"iPhone13,2"
com.google.chrome.ios,133,1715983516,1715983649,1715983650.2613258,-18000,EB445137-D7F5-57EC-87DA-1DB460D64046,"iPhone13,2"
com.apple.Maps,15,1715983501,1715983516,1715983517.016362,-18000,EB445137-D7F5-57EC-87DA-1DB460D64046,"iPhone13,2"
com.google.chrome.ios,8,1715983493,1715983501,1715983501.727738,-18000,EB445137-D7F5-57EC-87DA-1DB460D64046,"iPhone13,2"
com.apple.Maps,9,1715983484,1715983493,1715983493.2093282,-18000,EB445137-D7F5-57EC-87DA-1DB460D64046,"iPhone13,2"
com.google.chrome.ios,141,1715983343,1715983484,1715983484.927154,-18000,EB445137-D7F5-57EC-87DA-1DB460D64046,"iPhone13,2"
com.apple.Maps,58,1715983285,1715983343,1715983343.849268,-18000,EB445137-D7F5-57EC-87DA-1DB460D64046,"iPhone13,2"
com.google.chrome.ios,7,1715983278,1715983285,1715983285.15065,-18000,EB445137-D7F5-57EC-87DA-1DB460D64046,"iPhone13,2"
com.apple.Maps,87,1715983191,1715983278,1715983278.6771421,-18000,EB445137-D7F5-57EC-87DA-1DB460D64046,"iPhone13,2"
com.google.chrome.ios,13,1715983178,1715983191,1715983191.1295319,-18000,EB445137-D7F5-57EC-87DA-1DB460D64046,"iPhone13,2"
com.apple.MobileSMS,34,1715983144,1715983178,1715983178.060567,-18000,EB445137-D7F5-57EC-87DA-1DB460D64046,"iPhone13,2"
com.google.chrome.ios,26,1715983118,1715983144,1715983144.366715,-18000,EB445137-D7F5-57EC-87DA-1DB460D64046,"iPhone13,2"
com.apple.MobileSMS,55,1715983063,1715983118,1715983118.90715,-18000,EB445137-D7F5-57EC-87DA-1DB460D64046,"iPhone13,2"
com.google.chrome.ios,370,1715982693,1715983063,1715983063.463073,-18000,EB445137-D7F5-57EC-87DA-1DB460D64046,"iPhone13,2"
com.apple.Maps,50,1715982643,1715982693,1715982693.971101,-18000,EB445137-D7F5-57EC-87DA-1DB460D64046,"iPhone13,2"
com.google.chrome.ios,40,1715982603,1715982643,1715982644.056581,-18000,EB445137-D7F5-57EC-87DA-1DB460D64046,"iPhone13,2"
com.apple.Maps,20,1715982583,1715982603,1715982603.123445,-18000,EB445137-D7F5-57EC-87DA-1DB460D64046,"iPhone13,2"
com.google.chrome.ios,8,1715982575,1715982583,1715982583.963492,-18000,EB445137-D7F5-57EC-87DA-1DB460D64046,"iPhone13,2"
com.apple.MobileSMS,2,1715982573,1715982575,1715982576.918741,-18000,EB445137-D7F5-57EC-87DA-1DB460D64046,"iPhone13,2"
com.apple.Maps,26,1715982547,1715982573,1715982573.983928,-18000,EB445137-D7F5-57EC-87DA-1DB460D64046,"iPhone13,2"
com.google.Sheets,6,1715982541,1715982547,1715982547.58877,-18000,EB445137-D7F5-57EC-87DA-1DB460D64046,"iPhone13,2"
com.google.Sheets,7,1715982490,1715982497,1715982497.284668,-18000,EB445137-D7F5-57EC-87DA-1DB460D64046,"iPhone13,2"
com.google.Sheets,23,1715982466,1715982489,1715982489.200162,-18000,EB445137-D7F5-57EC-87DA-1DB460D64046,"iPhone13,2"
com.google.Drive,12,1715982454,1715982466,1715982466.97666,-18000,EB445137-D7F5-57EC-87DA-1DB460D64046,"iPhone13,2"
com.apple.MobileSMS,3,1715982449,1715982452,1715982452.9147391,-18000,EB445137-D7F5-57EC-87DA-1DB460D64046,"iPhone13,2"
com.apple.Maps,88,1715982359,1715982447,1715982447.567764,-18000,EB445137-D7F5-57EC-87DA-1DB460D64046,"iPhone13,2"
com.google.chrome.ios,3,1715982356,1715982359,1715982359.408413,-18000,EB445137-D7F5-57EC-87DA-1DB460D64046,"iPhone13,2"
com.apple.Maps,187,1715982169,1715982356,1715982356.707133,-18000,EB445137-D7F5-57EC-87DA-1DB460D64046,"iPhone13,2"
com.google.chrome.ios,49,1715982120,1715982169,1715982169.6658359,-18000,EB445137-D7F5-57EC-87DA-1DB460D64046,"iPhone13,2"
com.apple.Maps,147,1715981973,1715982120,1715982120.095438,-18000,EB445137-D7F5-57EC-87DA-1DB460D64046,"iPhone13,2"
com.google.chrome.ios,5,1715981968,1715981973,1715981973.8954968,-18000,EB445137-D7F5-57EC-87DA-1DB460D64046,"iPhone13,2"
com.apple.Maps,83,1715981885,1715981968,1715981968.6028562,-18000,EB445137-D7F5-57EC-87DA-1DB460D64046,"iPhone13,2"
com.google.chrome.ios,37,1715981848,1715981885,1715981885.7420468,-18000,EB445137-D7F5-57EC-87DA-1DB460D64046,"iPhone13,2"
com.apple.Maps,5,1715981843,1715981848,1715981848.805882,-18000,EB445137-D7F5-57EC-87DA-1DB460D64046,"iPhone13,2"
com.google.chrome.ios,77,1715981766,1715981843,1715981843.796311,-18000,EB445137-D7F5-57EC-87DA-1DB460D64046,"iPhone13,2"
com.apple.Maps,60,1715981706,1715981766,1715981766.220048,-18000,EB445137-D7F5-57EC-87DA-1DB460D64046,"iPhone13,2"
com.google.chrome.ios,33,1715981673,1715981706,1715981706.717108,-18000,EB445137-D7F5-57EC-87DA-1DB460D64046,"iPhone13,2"
com.apple.Maps,135,1715981538,1715981673,1715981673.8645391,-18000,EB445137-D7F5-57EC-87DA-1DB460D64046,"iPhone13,2"
com.google.chrome.ios,219,1715981316,1715981535,1715981535.910558,-18000,EB445137-D7F5-57EC-87DA-1DB460D64046,"iPhone13,2"
com.apple.MobileSMS,2,1715981311,1715981313,1715981313.8010201,-18000,EB445137-D7F5-57EC-87DA-1DB460D64046,"iPhone13,2"
com.google.chrome.ios,51,1715981260,1715981311,1715981311.412503,-18000,EB445137-D7F5-57EC-87DA-1DB460D64046,"iPhone13,2"
com.apple.Maps,7,1715981253,1715981260,1715981260.537212,-18000,EB445137-D7F5-57EC-87DA-1DB460D64046,"iPhone13,2"
com.google.chrome.ios,123,1715981126,1715981249,1715981249.748026,-18000,EB445137-D7F5-57EC-87DA-1DB460D64046,"iPhone13,2"
com.google.Chrome,703,1715978628,1715979331,1715979331.6597052,-18000,,
com.google.Chrome,320,1715977707,1715978027,1715978027.88447,-18000,,
com.goodreads.Goodreads,94,1715977438,1715977532,1715977532.802391,-18000,EB445137-D7F5-57EC-87DA-1DB460D64046,"iPhone13,2"
com.thestorygraph.thestorygraph,90,1715977346,1715977436,1715977436.8475242,-18000,EB445137-D7F5-57EC-87DA-1DB460D64046,"iPhone13,2"
com.google.chrome.ios,4,1715977342,1715977346,1715977346.775913,-18000,EB445137-D7F5-57EC-87DA-1DB460D64046,"iPhone13,2"
com.google.chrome.ios,3,1715977339,1715977342,1715977342.472897,-18000,EB445137-D7F5-57EC-87DA-1DB460D64046,"iPhone13,2"
com.google.chrome.ios,2,1715977324,1715977326,1715977326.06377,-18000,EB445137-D7F5-57EC-87DA-1DB460D64046,"iPhone13,2"
com.google.chrome.ios,1,1715976484,1715976485,1715976485.829129,-18000,EB445137-D7F5-57EC-87DA-1DB460D64046,"iPhone13,2"
com.google.chrome.ios,1,1715975175,1715975176,1715975176.9080648,-18000,EB445137-D7F5-57EC-87DA-1DB460D64046,"iPhone13,2"
com.google.chrome.ios,18,1715975093,1715975111,1715975111.823594,-18000,EB445137-D7F5-57EC-87DA-1DB460D64046,"iPhone13,2"
com.google.chrome.ios,13,1715974925,1715974938,1715974938.41045,-18000,EB445137-D7F5-57EC-87DA-1DB460D64046,"iPhone13,2"
com.myfitnesspal.mfp,4,1715974921,1715974925,1715974925.772203,-18000,EB445137-D7F5-57EC-87DA-1DB460D64046,"iPhone13,2"
com.google.Chrome,2,1715973804,1715973806,1715973806.648643,-18000,,
com.myfitnesspal.mfp,87,1715973300,1715973387,1715973387.357552,-18000,EB445137-D7F5-57EC-87DA-1DB460D64046,"iPhone13,2"
com.myfitnesspal.mfp,2,1715973202,1715973204,1715973204.487142,-18000,EB445137-D7F5-57EC-87DA-1DB460D64046,"iPhone13,2"
com.myfitnesspal.mfp,2,1715973175,1715973177,1715973177.626504,-18000,EB445137-D7F5-57EC-87DA-1DB460D64046,"iPhone13,2"
com.google.Chrome,632,1715973171,1715973803,1715973804.372978,-18000,,
com.myfitnesspal.mfp,233,1715972908,1715973141,1715973141.2505898,-18000,EB445137-D7F5-57EC-87DA-1DB460D64046,"iPhone13,2"
com.apple.calculator,3,1715972904,1715972907,1715972908.00892,-18000,EB445137-D7F5-57EC-87DA-1DB460D64046,"iPhone13,2"
com.google.Chrome,302,1715972783,1715973085,1715973085.698065,-18000,,
com.apple.calculator,81,1715972492,1715972573,1715972573.445531,-18000,EB445137-D7F5-57EC-87DA-1DB460D64046,"iPhone13,2"
com.apple.calculator,85,1715972326,1715972411,1715972411.0881371,-18000,EB445137-D7F5-57EC-87DA-1DB460D64046,"iPhone13,2"
com.apple.mobileslideshow,2,1715972323,1715972325,1715972325.6505132,-18000,EB445137-D7F5-57EC-87DA-1DB460D64046,"iPhone13,2"
com.apple.mobileslideshow,116,1715972132,1715972248,1715972248.711913,-18000,EB445137-D7F5-57EC-87DA-1DB460D64046,"iPhone13,2"
com.apple.calculator,2,1715972130,1715972132,1715972132.999316,-18000,EB445137-D7F5-57EC-87DA-1DB460D64046,"iPhone13,2"
com.apple.calculator,78,1715972039,1715972117,1715972117.086506,-18000,EB445137-D7F5-57EC-87DA-1DB460D64046,"iPhone13,2"
com.apple.mobileslideshow,5,1715972034,1715972039,1715972039.5313668,-18000,EB445137-D7F5-57EC-87DA-1DB460D64046,"iPhone13,2"
com.apple.mobileslideshow,14,1715972006,1715972020,1715972020.537146,-18000,EB445137-D7F5-57EC-87DA-1DB460D64046,"iPhone13,2"
com.apple.podcasts,4,1715972002,1715972006,1715972006.2579541,-18000,EB445137-D7F5-57EC-87DA-1DB460D64046,"iPhone13,2"
com.apple.podcasts,10,1715971895,1715971905,1715971905.060255,-18000,EB445137-D7F5-57EC-87DA-1DB460D64046,"iPhone13,2"
com.apple.podcasts,71,1715970959,1715971030,1715971030.825563,-18000,EB445137-D7F5-57EC-87DA-1DB460D64046,"iPhone13,2"
com.apple.MobileSMS,3,1715970955,1715970958,1715970958.42274,-18000,EB445137-D7F5-57EC-87DA-1DB460D64046,"iPhone13,2"
com.apple.MobileSMS,5,1715970624,1715970629,1715970629.49094,-18000,EB445137-D7F5-57EC-87DA-1DB460D64046,"iPhone13,2"
com.google.Chrome,601,1715970517,1715971118,1715971118.429237,-18000,,
com.myfitnesspal.mfp,113,1715970510,1715970623,1715970623.657584,-18000,EB445137-D7F5-57EC-87DA-1DB460D64046,"iPhone13,2"
com.apple.calculator,7,1715970502,1715970509,1715970509.127603,-18000,EB445137-D7F5-57EC-87DA-1DB460D64046,"iPhone13,2"
com.google.Chrome,336,1715970096,1715970432,1715970432.791595,-18000,,
com.apple.calculator,62,1715969966,1715970028,1715970028.7635689,-18000,EB445137-D7F5-57EC-87DA-1DB460D64046,"iPhone13,2"
com.apple.camera,7,1715969672,1715969679,1715969679.805664,-18000,EB445137-D7F5-57EC-87DA-1DB460D64046,"iPhone13,2"
com.google.ios.youtube,871,1715968072,1715968943,1715968943.131555,-18000,EB445137-D7F5-57EC-87DA-1DB460D64046,"iPhone13,2"
com.google.ios.youtube,1521,1715965790,1715967311,1715967311.4345322,-18000,EB445137-D7F5-57EC-87DA-1DB460D64046,"iPhone13,2"
com.myfitnesspal.mfp,273,1715965496,1715965769,1715965769.841731,-18000,EB445137-D7F5-57EC-87DA-1DB460D64046,"iPhone13,2"
com.instructure.icanvas,17,1715965474,1715965491,1715965491.440481,-18000,EB445137-D7F5-57EC-87DA-1DB460D64046,"iPhone13,2"
com.apple.news,6,1715965468,1715965474,1715965475.009272,-18000,EB445137-D7F5-57EC-87DA-1DB460D64046,"iPhone13,2"
com.apple.news,720,1715964655,1715965375,1715965375.0950541,-18000,EB445137-D7F5-57EC-87DA-1DB460D64046,"iPhone13,2"
com.apple.MobileSMS,1,1715964654,1715964655,1715964656.8031502,-18000,EB445137-D7F5-57EC-87DA-1DB460D64046,"iPhone13,2"
com.apple.news,15,1715964639,1715964654,1715964655.2014,-18000,EB445137-D7F5-57EC-87DA-1DB460D64046,"iPhone13,2"
com.apple.MobileSMS,3,1715964636,1715964639,1715964640.000896,-18000,EB445137-D7F5-57EC-87DA-1DB460D64046,"iPhone13,2"
com.apple.findmy,3,1715964632,1715964635,1715964635.633122,-18000,EB445137-D7F5-57EC-87DA-1DB460D64046,"iPhone13,2"
com.apple.findmy,12,1715963880,1715963892,1715963892.268414,-18000,EB445137-D7F5-57EC-87DA-1DB460D64046,"iPhone13,2"
com.google.chrome.ios,6,1715963873,1715963879,1715963879.923616,-18000,EB445137-D7F5-57EC-87DA-1DB460D64046,"iPhone13,2"
com.google.chrome.ios,11,1715962437,1715962448,1715962448.735925,-18000,EB445137-D7F5-57EC-87DA-1DB460D64046,"iPhone13,2"
com.google.chrome.ios,14,1715961987,1715962001,1715962001.163186,-18000,EB445137-D7F5-57EC-87DA-1DB460D64046,"iPhone13,2"
com.google.chrome.ios,5,1715960635,1715960640,1715960640.792959,-18000,EB445137-D7F5-57EC-87DA-1DB460D64046,"iPhone13,2"
com.google.chrome.ios,16,1715960617,1715960633,1715960634.961462,-18000,EB445137-D7F5-57EC-87DA-1DB460D64046,"iPhone13,2"
com.apple.podcasts,34,1715960582,1715960616,1715960617.141014,-18000,EB445137-D7F5-57EC-87DA-1DB460D64046,"iPhone13,2"
com.myfitnesspal.mfp,3,1715960575,1715960578,1715960578.145293,-18000,EB445137-D7F5-57EC-87DA-1DB460D64046,"iPhone13,2"
com.myfitnesspal.mfp,54,1715960196,1715960250,1715960250.1761398,-18000,EB445137-D7F5-57EC-87DA-1DB460D64046,"iPhone13,2"
com.apple.Music,3,1715960191,1715960194,1715960194.9607491,-18000,EB445137-D7F5-57EC-87DA-1DB460D64046,"iPhone13,2"
com.apple.Music,3,1715959589,1715959592,1715959592.0579782,-18000,EB445137-D7F5-57EC-87DA-1DB460D64046,"iPhone13,2"
com.apple.Music,7,1715959555,1715959562,1715959562.582735,-18000,EB445137-D7F5-57EC-87DA-1DB460D64046,"iPhone13,2"
com.apple.Music,63,1715958905,1715958968,1715958968.8700309,-18000,EB445137-D7F5-57EC-87DA-1DB460D64046,"iPhone13,2"
com.apple.mobileslideshow,5,1715958900,1715958905,1715958905.562364,-18000,EB445137-D7F5-57EC-87DA-1DB460D64046,"iPhone13,2"
com.apple.mobileslideshow,9,1715958696,1715958705,1715958705.6025991,-18000,EB445137-D7F5-57EC-87DA-1DB460D64046,"iPhone13,2"
com.apple.mobileslideshow,2,1715958468,1715958470,1715958470.765872,-18000,EB445137-D7F5-57EC-87DA-1DB460D64046,"iPhone13,2"
com.apple.mobileslideshow,12,1715958452,1715958464,1715958464.0419888,-18000,EB445137-D7F5-57EC-87DA-1DB460D64046,"iPhone13,2"
com.apple.mobileslideshow,15,1715958124,1715958139,1715958139.046777,-18000,EB445137-D7F5-57EC-87DA-1DB460D64046,"iPhone13,2"
com.apple.Music,2,1715958118,1715958120,1715958120.890173,-18000,EB445137-D7F5-57EC-87DA-1DB460D64046,"iPhone13,2"
com.apple.Music,12,1715958091,1715958103,1715958103.496594,-18000,EB445137-D7F5-57EC-87DA-1DB460D64046,"iPhone13,2"
com.muscleforlife.Stacked,2,1715958087,1715958089,1715958089.320955,-18000,EB445137-D7F5-57EC-87DA-1DB460D64046,"iPhone13,2"
com.muscleforlife.Stacked,226,1715957858,1715958084,1715958084.523354,-18000,EB445137-D7F5-57EC-87DA-1DB460D64046,"iPhone13,2"
com.muscleforlife.Stacked,3,1715957782,1715957785,1715957785.2486758,-18000,EB445137-D7F5-57EC-87DA-1DB460D64046,"iPhone13,2"
com.muscleforlife.Stacked,8,1715957692,1715957700,1715957700.03656,-18000,EB445137-D7F5-57EC-87DA-1DB460D64046,"iPhone13,2"
com.muscleforlife.Stacked,111,1715957530,1715957641,1715957641.235065,-18000,EB445137-D7F5-57EC-87DA-1DB460D64046,"iPhone13,2"
com.muscleforlife.Stacked,93,1715957399,1715957492,1715957492.3325071,-18000,EB445137-D7F5-57EC-87DA-1DB460D64046,"iPhone13,2"
com.muscleforlife.Stacked,37,1715957361,1715957398,1715957399.004736,-18000,EB445137-D7F5-57EC-87DA-1DB460D64046,"iPhone13,2"
com.muscleforlife.Stacked,6,1715957303,1715957309,1715957309.3838449,-18000,EB445137-D7F5-57EC-87DA-1DB460D64046,"iPhone13,2"
com.muscleforlife.Stacked,1,1715957300,1715957301,1715957301.824312,-18000,EB445137-D7F5-57EC-87DA-1DB460D64046,"iPhone13,2"
com.google.ios.youtube,19,1715957281,1715957300,1715957300.822572,-18000,EB445137-D7F5-57EC-87DA-1DB460D64046,"iPhone13,2"
com.muscleforlife.Stacked,2,1715957279,1715957281,1715957281.5806499,-18000,EB445137-D7F5-57EC-87DA-1DB460D64046,"iPhone13,2"
com.muscleforlife.Stacked,6,1715957221,1715957227,1715957227.0187001,-18000,EB445137-D7F5-57EC-87DA-1DB460D64046,"iPhone13,2"
com.muscleforlife.Stacked,23,1715957161,1715957184,1715957184.62692,-18000,EB445137-D7F5-57EC-87DA-1DB460D64046,"iPhone13,2"
com.google.ios.youtube,54,1715957107,1715957161,1715957161.710846,-18000,EB445137-D7F5-57EC-87DA-1DB460D64046,"iPhone13,2"
com.muscleforlife.Stacked,33,1715957074,1715957107,1715957107.379256,-18000,EB445137-D7F5-57EC-87DA-1DB460D64046,"iPhone13,2"
com.muscleforlife.Stacked,22,1715957019,1715957041,1715957041.865524,-18000,EB445137-D7F5-57EC-87DA-1DB460D64046,"iPhone13,2"
com.google.ios.youtube,14,1715957005,1715957019,1715957019.601701,-18000,EB445137-D7F5-57EC-87DA-1DB460D64046,"iPhone13,2"
com.muscleforlife.Stacked,77,1715956928,1715957005,1715957005.418364,-18000,EB445137-D7F5-57EC-87DA-1DB460D64046,"iPhone13,2"
com.google.ios.youtube,2,1715956926,1715956928,1715956929.0171041,-18000,EB445137-D7F5-57EC-87DA-1DB460D64046,"iPhone13,2"
com.google.ios.youtube,76,1715956777,1715956853,1715956853.726989,-18000,EB445137-D7F5-57EC-87DA-1DB460D64046,"iPhone13,2"
com.muscleforlife.Stacked,33,1715956744,1715956777,1715956777.315258,-18000,EB445137-D7F5-57EC-87DA-1DB460D64046,"iPhone13,2"
com.muscleforlife.Stacked,8,1715956695,1715956703,1715956703.180214,-18000,EB445137-D7F5-57EC-87DA-1DB460D64046,"iPhone13,2"
com.muscleforlife.Stacked,38,1715956656,1715956694,1715956694.869623,-18000,EB445137-D7F5-57EC-87DA-1DB460D64046,"iPhone13,2"
com.google.ios.youtube,28,1715956628,1715956656,1715956656.843931,-18000,EB445137-D7F5-57EC-87DA-1DB460D64046,"iPhone13,2"
com.muscleforlife.Stacked,48,1715956580,1715956628,1715956628.253777,-18000,EB445137-D7F5-57EC-87DA-1DB460D64046,"iPhone13,2"
com.muscleforlife.Stacked,105,1715956431,1715956536,1715956536.5143409,-18000,EB445137-D7F5-57EC-87DA-1DB460D64046,"iPhone13,2"
com.google.ios.youtube,2,1715956429,1715956431,1715956431.5085711,-18000,EB445137-D7F5-57EC-87DA-1DB460D64046,"iPhone13,2"
com.google.ios.youtube,40,1715956312,1715956352,1715956352.5041618,-18000,EB445137-D7F5-57EC-87DA-1DB460D64046,"iPhone13,2"
com.muscleforlife.Stacked,5,1715956307,1715956312,1715956312.367203,-18000,EB445137-D7F5-57EC-87DA-1DB460D64046,"iPhone13,2"
com.muscleforlife.Stacked,47,1715956164,1715956211,1715956211.806812,-18000,EB445137-D7F5-57EC-87DA-1DB460D64046,"iPhone13,2"
com.microsoft.onenote,5,1715956159,1715956164,1715956164.793323,-18000,EB445137-D7F5-57EC-87DA-1DB460D64046,"iPhone13,2"
com.muscleforlife.Stacked,24,1715956135,1715956159,1715956159.5053492,-18000,EB445137-D7F5-57EC-87DA-1DB460D64046,"iPhone13,2"
com.muscleforlife.Stacked,275,1715955817,1715956092,1715956092.1654801,-18000,EB445137-D7F5-57EC-87DA-1DB460D64046,"iPhone13,2"
com.muscleforlife.Stacked,6,1715955771,1715955777,1715955777.200567,-18000,EB445137-D7F5-57EC-87DA-1DB460D64046,"iPhone13,2"
com.muscleforlife.Stacked,59,1715955634,1715955693,1715955693.632472,-18000,EB445137-D7F5-57EC-87DA-1DB460D64046,"iPhone13,2"
com.apple.Music,3,1715955627,1715955630,1715955630.8517342,-18000,EB445137-D7F5-57EC-87DA-1DB460D64046,"iPhone13,2"
com.apple.camera,0,1715955520,1715955520,1715955520.8969631,-18000,EB445137-D7F5-57EC-87DA-1DB460D64046,"iPhone13,2"
com.apple.Music,4,1715955516,1715955520,1715955520.8412971,-18000,EB445137-D7F5-57EC-87DA-1DB460D64046,"iPhone13,2"
com.apple.Music,10,1715955130,1715955140,1715955140.616959,-18000,EB445137-D7F5-57EC-87DA-1DB460D64046,"iPhone13,2"
com.apple.Music,76,1715954817,1715954893,1715954893.7458801,-18000,EB445137-D7F5-57EC-87DA-1DB460D64046,"iPhone13,2"
com.apple.MobileSMS,12,1715954790,1715954802,1715954802.248458,-18000,EB445137-D7F5-57EC-87DA-1DB460D64046,"iPhone13,2"
com.apple.findmy,4,1715954786,1715954790,1715954790.955851,-18000,EB445137-D7F5-57EC-87DA-1DB460D64046,"iPhone13,2"
com.google.Chrome,238,1715954402,1715954640,1715954640.886102,-18000,,
com.apple.Preview,6,1715954396,1715954402,1715954402.407562,-18000,,
com.microsoft.onenote.mac,2,1715954394,1715954396,1715954396.48728,-18000,,
com.apple.Preview,1,1715954393,1715954394,1715954394.679868,-18000,,
com.google.Chrome,60,1715954333,1715954393,1715954393.7330499,-18000,,
com.apple.Preview,2,1715954331,1715954333,1715954333.443763,-18000,,
com.microsoft.onenote.mac,2,1715954329,1715954331,1715954331.517565,-18000,,
com.apple.Preview,1,1715954328,1715954329,1715954329.789073,-18000,,
com.google.Chrome,88,1715954240,1715954328,1715954328.519249,-18000,,
com.apple.Preview,3,1715954237,1715954240,1715954240.295351,-18000,,
com.microsoft.onenote.mac,4,1715954233,1715954237,1715954238.010706,-18000,,
com.apple.Preview,1,1715954232,1715954233,1715954234.0208158,-18000,,
com.google.Chrome,141,1715954091,1715954232,1715954232.168194,-18000,,
com.apple.Preview,4,1715954087,1715954091,1715954091.274143,-18000,,
com.google.Chrome,2,1715954085,1715954087,1715954087.362988,-18000,,
com.microsoft.onenote.mac,2,1715954083,1715954085,1715954085.7276402,-18000,,
com.google.Chrome,238,1715953845,1715954083,1715954083.51761,-18000,,
com.apple.Preview,7,1715953838,1715953845,1715953845.464283,-18000,,
com.microsoft.onenote.mac,2,1715953836,1715953838,1715953838.160499,-18000,,
com.apple.Preview,15,1715953821,1715953836,1715953836.58607,-18000,,
com.microsoft.onenote.mac,3,1715953818,1715953821,1715953821.595129,-18000,,
com.apple.Preview,5,1715953813,1715953818,1715953818.269479,-18000,,
com.apple.finder,8,1715953805,1715953813,1715953813.556421,-18000,,
com.apple.MobileSMS,1,1715953804,1715953805,1715953805.8522348,-18000,,
com.google.Chrome,5,1715953799,1715953804,1715953804.176128,-18000,,
com.apple.findmy,37,1715953317,1715953354,1715953354.422853,-18000,EB445137-D7F5-57EC-87DA-1DB460D64046,"iPhone13,2"
com.apple.findmy,22,1715953223,1715953245,1715953245.360145,-18000,EB445137-D7F5-57EC-87DA-1DB460D64046,"iPhone13,2"
com.apple.findmy,47,1715953096,1715953143,1715953143.1792278,-18000,EB445137-D7F5-57EC-87DA-1DB460D64046,"iPhone13,2"
com.google.Chrome,25,1715917214,1715917239,1715917239.3128529,-18000,,
com.google.Chrome,430,1715916720,1715917150,1715917150.054102,-18000,,
com.google.Chrome,741,1715915449,1715916190,1715916190.553637,-18000,,
com.google.Chrome,304,1715914944,1715915248,1715915248.5291939,-18000,,
com.apple.MobileSMS,12,1715914932,1715914944,1715914944.8264651,-18000,,
com.google.Chrome,4,1715914928,1715914932,1715914932.070146,-18000,,
com.google.Chrome,544,1715914177,1715914721,1715914721.355638,-18000,,
com.google.Chrome,522,1715912992,1715913514,1715913514.563539,-18000,,
com.apple.MobileSMS,22,1715912970,1715912992,1715912992.99244,-18000,,
com.google.Chrome,11,1715912959,1715912970,1715912970.284205,-18000,,
com.google.Chrome,705,1715909851,1715910556,1715910556.76966,-18000,,
com.google.Chrome,445,1715908757,1715909202,1715909202.800955,-18000,,
com.apple.MobileSMS,114,1715908643,1715908757,1715908757.301118,-18000,,
com.google.Chrome,10,1715908633,1715908643,1715908643.434545,-18000,,
com.apple.MobileSMS,18,1715908615,1715908633,1715908633.421801,-18000,,
com.google.Chrome,1,1715908614,1715908615,1715908615.379271,-18000,,
com.apple.MobileSMS,33,1715908581,1715908614,1715908614.5216389,-18000,,
com.google.Chrome,10,1715908571,1715908581,1715908581.6857328,-18000,,
com.apple.MobileSMS,61,1715908510,1715908571,1715908571.778469,-18000,,
com.google.Chrome,15,1715908495,1715908510,1715908510.6052399,-18000,,
com.apple.MobileSMS,153,1715908342,1715908495,1715908495.1088228,-18000,,
com.google.Chrome,1,1715908341,1715908342,1715908342.553055,-18000,,
com.apple.MobileSMS,2,1715908339,1715908341,1715908341.116138,-18000,,
com.google.Chrome,1,1715908338,1715908339,1715908339.459388,-18000,,
com.apple.MobileSMS,1,1715908337,1715908338,1715908338.464309,-18000,,
com.google.Chrome,0,1715908337,1715908337,1715908337.975576,-18000,,
com.apple.MobileSMS,181,1715908156,1715908337,1715908337.4366179,-18000,,
com.google.Chrome,2,1715908154,1715908156,1715908156.373272,-18000,,
com.apple.MobileSMS,20,1715908134,1715908154,1715908154.865473,-18000,,
com.google.Chrome,3,1715908131,1715908134,1715908134.483059,-18000,,
com.apple.MobileSMS,0,1715908131,1715908131,1715908131.994463,-18000,,
com.google.Chrome,4,1715908127,1715908131,1715908131.034683,-18000,,
com.apple.MobileSMS,1,1715908126,1715908127,1715908127.719736,-18000,,
com.google.Chrome,1,1715908125,1715908126,1715908126.3849468,-18000,,
com.apple.MobileSMS,3,1715908122,1715908125,1715908125.314684,-18000,,
com.google.Chrome,2,1715908120,1715908122,1715908122.616272,-18000,,
com.apple.MobileSMS,51,1715908069,1715908120,1715908120.074578,-18000,,
com.google.Chrome,8,1715908061,1715908069,1715908069.507277,-18000,,
com.apple.MobileSMS,48,1715908013,1715908061,1715908061.563576,-18000,,
com.google.Chrome,1,1715908012,1715908013,1715908013.093641,-18000,,
com.apple.MobileSMS,6,1715908006,1715908012,1715908012.4220319,-18000,,
com.google.Chrome,5,1715908001,1715908006,1715908006.1006641,-18000,,
com.apple.MobileSMS,2,1715907999,1715908001,1715908001.850511,-18000,,
com.google.Chrome,5,1715907994,1715907999,1715907999.581018,-18000,,
com.apple.MobileSMS,19,1715907975,1715907994,1715907994.870285,-18000,,
com.google.Chrome,5,1715907970,1715907975,1715907975.149385,-18000,,
com.apple.MobileSMS,32,1715907938,1715907970,1715907970.346365,-18000,,
com.google.Chrome,10,1715907928,1715907938,1715907938.409879,-18000,,
com.apple.MobileSMS,11,1715907917,1715907928,1715907928.3021321,-18000,,
com.google.Chrome,15,1715907902,1715907917,1715907917.950288,-18000,,
com.apple.MobileSMS,2,1715907900,1715907902,1715907902.152505,-18000,,
com.google.Chrome,14,1715907886,1715907900,1715907900.583549,-18000,,
com.apple.MobileSMS,8,1715907878,1715907886,1715907886.5534549,-18000,,
com.google.Chrome,8,1715907870,1715907878,1715907879.024246,-18000,,
com.apple.MobileSMS,5,1715907865,1715907870,1715907870.4523559,-18000,,
com.google.Chrome,10,1715907855,1715907865,1715907865.8525171,-18000,,
com.apple.MobileSMS,10,1715907845,1715907855,1715907855.157984,-18000,,
com.google.Chrome,68,1715907777,1715907845,1715907845.530045,-18000,,
com.google.Chrome,1847,1715905688,1715907535,1715907535.825251,-18000,,
com.google.Chrome,546,1715904987,1715905533,1715905533.288739,-18000,,
com.apple.finder,0,1715904987,1715904987,1715904987.762176,-18000,,
com.microsoft.onenote.mac,2,1715904985,1715904987,1715904987.251734,-18000,,
com.apple.finder,2,1715904983,1715904985,1715904985.938591,-18000,,
com.apple.Preview,0,1715904983,1715904983,1715904983.742508,-18000,,
com.apple.finder,2,1715904981,1715904983,1715904983.4448218,-18000,,
com.apple.iCal,0,1715904981,1715904981,1715904981.8110871,-18000,,
com.google.Chrome,2,1715904979,1715904981,1715904981.153782,-18000,,
com.apple.MobileSMS,3,1715904976,1715904979,1715904979.395286,-18000,,
com.google.Chrome,733,1715904243,1715904976,1715904976.0999088,-18000,,
com.google.Chrome,1143,1715902117,1715903260,1715903260.6864982,-18000,,
com.apple.MobileSMS,2,1715902115,1715902117,1715902117.297463,-18000,,
com.google.Chrome,25,1715902090,1715902115,1715902115.8887901,-18000,,
com.apple.MobileSMS,12,1715902078,1715902090,1715902090.758138,-18000,,
com.google.Chrome,38,1715902040,1715902078,1715902078.328085,-18000,,
com.apple.MobileSMS,3,1715902037,1715902040,1715902040.934752,-18000,,
com.google.Chrome,36,1715902001,1715902037,1715902037.989605,-18000,,
com.apple.MobileSMS,3,1715901998,1715902001,1715902001.447762,-18000,,
com.google.Chrome,18,1715901980,1715901998,1715901998.782675,-18000,,
com.apple.MobileSMS,11,1715901969,1715901980,1715901980.918155,-18000,,
com.google.Chrome,3,1715901966,1715901969,1715901969.414456,-18000,,
com.apple.MobileSMS,55,1715901911,1715901966,1715901966.532992,-18000,,
com.google.Chrome,2,1715901909,1715901911,1715901911.348109,-18000,,
com.apple.MobileSMS,12,1715901897,1715901909,1715901909.4810472,-18000,,
com.google.Chrome,2,1715901895,1715901897,1715901897.239524,-18000,,
com.apple.MobileSMS,3,1715901892,1715901895,1715901895.756444,-18000,,
com.google.Chrome,1,1715901891,1715901892,1715901892.191218,-18000,,
com.apple.MobileSMS,3,1715901888,1715901891,1715901891.307203,-18000,,
com.google.Chrome,1,1715901887,1715901888,1715901888.420963,-18000,,
com.apple.MobileSMS,2,1715901885,1715901887,1715901887.3445349,-18000,,
com.google.Chrome,11,1715901874,1715901885,1715901885.184925,-18000,,
com.apple.MobileSMS,2,1715901872,1715901874,1715901874.40694,-18000,,
com.google.Chrome,0,1715901872,1715901872,1715901872.8666549,-18000,,
com.apple.MobileSMS,0,1715901872,1715901872,1715901872.8198729,-18000,,
com.google.Chrome,5,1715901867,1715901872,1715901872.1548982,-18000,,
com.google.Chrome,5,1715897724,1715897729,1715897729.7636209,-18000,,
com.google.Chrome,410,1715897284,1715897694,1715897694.207766,-18000,,
com.google.Chrome,564,1715895907,1715896471,1715896471.1453838,-18000,,
com.google.Chrome,1342,1715894449,1715895791,1715895792.022316,-18000,,
com.google.Chrome,7,1715893194,1715893201,1715893201.493824,-18000,,
com.google.Chrome,124,1715889558,1715889682,1715889682.573204,-18000,,
com.google.Chrome,1303,1715888254,1715889557,1715889557.86592,-18000,,
com.google.Chrome,569,1715887559,1715888128,1715888128.3874931,-18000,,
com.google.Chrome,197,1715886220,1715886417,1715886417.773607,-18000,,
com.google.Chrome,66,1715885688,1715885754,1715885754.245099,-18000,,
com.apple.finder,73,1715885615,1715885688,1715885688.9434528,-18000,,
com.microsoft.Outlook,1,1715885614,1715885615,1715885615.0976,-18000,,
com.apple.finder,1,1715885613,1715885614,1715885614.2863889,-18000,,
com.google.Chrome,40,1715885573,1715885613,1715885613.438323,-18000,,
com.apple.MobileSMS,9,1715885564,1715885573,1715885573.140259,-18000,,
com.google.Chrome,6,1715885558,1715885564,1715885564.866674,-18000,,
com.google.Chrome,10,1715883786,1715883796,1715883797.189711,-18000,,
com.apple.MobileSMS,41,1715883745,1715883786,1715883786.478561,-18000,,
com.google.Chrome,18,1715883727,1715883745,1715883745.571669,-18000,,
com.apple.MobileSMS,28,1715883699,1715883727,1715883727.468761,-18000,,
com.google.Chrome,113,1715883586,1715883699,1715883699.9902291,-18000,,
com.apple.MobileSMS,11,1715883575,1715883586,1715883586.7306662,-18000,,
com.google.Chrome,8,1715883567,1715883575,1715883575.6158152,-18000,,
com.apple.MobileSMS,2,1715883565,1715883567,1715883567.137105,-18000,,
com.google.Chrome,9,1715883556,1715883565,1715883565.605299,-18000,,
com.apple.MobileSMS,11,1715883545,1715883556,1715883556.5949202,-18000,,
com.google.Chrome,432,1715883113,1715883545,1715883545.4114041,-18000,,
com.apple.MobileSMS,25,1715883088,1715883113,1715883114.00979,-18000,,
com.google.Chrome,53,1715883035,1715883088,1715883088.9279752,-18000,,
com.apple.MobileSMS,2,1715883033,1715883035,1715883035.83672,-18000,,
com.google.Chrome,5,1715883028,1715883033,1715883033.360429,-18000,,
com.apple.MobileSMS,6,1715883022,1715883028,1715883028.83515,-18000,,
com.google.Chrome,26,1715882996,1715883022,1715883022.2844648,-18000,,
com.apple.MobileSMS,2,1715882994,1715882996,1715882996.589682,-18000,,
com.google.Chrome,549,1715882445,1715882994,1715882994.440959,-18000,,
com.apple.MobileSMS,6,1715882439,1715882445,1715882445.3993468,-18000,,
com.google.Chrome,338,1715882101,1715882439,1715882439.7177382,-18000,,
com.apple.MobileSMS,2,1715882099,1715882101,1715882101.0724258,-18000,,
com.google.Chrome,6,1715882093,1715882099,1715882099.054708,-18000,,
com.apple.MobileSMS,5,1715882088,1715882093,1715882093.2670522,-18000,,
com.google.Chrome,1,1715882087,1715882088,1715882088.3012118,-18000,,
com.apple.MobileSMS,33,1715882054,1715882087,1715882087.797155,-18000,,
com.google.Chrome,1,1715882053,1715882054,1715882054.186621,-18000,,
com.apple.MobileSMS,4,1715882049,1715882053,1715882053.6713629,-18000,,
com.google.Chrome,10,1715882039,1715882049,1715882049.3045878,-18000,,
com.apple.MobileSMS,12,1715882027,1715882039,1715882039.563031,-18000,,
com.google.Chrome,7,1715882020,1715882027,1715882027.065402,-18000,,
com.apple.MobileSMS,2,1715882018,1715882020,1715882020.78035,-18000,,
com.google.Chrome,17,1715882001,1715882018,1715882018.389708,-18000,,
com.apple.MobileSMS,4,1715881997,1715882001,1715882001.5410628,-18000,,
com.google.Chrome,106,1715881891,1715881997,1715881997.719689,-18000,,
com.apple.MobileSMS,1,1715881890,1715881891,1715881892.055462,-18000,,
com.google.Chrome,1,1715881889,1715881890,1715881890.703003,-18000,,
com.apple.MobileSMS,20,1715881869,1715881889,1715881889.1005569,-18000,,
com.google.Chrome,702,1715881167,1715881869,1715881869.281251,-18000,,
com.google.Chrome,10,1715880756,1715880766,1715880766.9490361,-18000,,
com.apple.MobileSMS,4,1715880752,1715880756,1715880756.772132,-18000,,
com.google.Chrome,163,1715880589,1715880752,1715880752.322596,-18000,,
com.apple.MobileSMS,13,1715880576,1715880589,1715880589.356472,-18000,,
com.google.Chrome,236,1715880340,1715880576,1715880576.305748,-18000,,
com.apple.MobileSMS,7,1715880333,1715880340,1715880340.163437,-18000,,
com.google.Chrome,13,1715880320,1715880333,1715880333.502839,-18000,,
com.apple.MobileSMS,4,1715880316,1715880320,1715880320.5849671,-18000,,
com.google.Chrome,76,1715880240,1715880316,1715880316.8592381,-18000,,
com.apple.MobileSMS,4,1715880236,1715880240,1715880240.92257,-18000,,
com.google.Chrome,30,1715880206,1715880236,1715880236.48484,-18000,,
com.apple.MobileSMS,4,1715880202,1715880206,1715880206.217427,-18000,,
com.google.Chrome,1,1715880201,1715880202,1715880202.3287559,-18000,,
com.apple.MobileSMS,5,1715880196,1715880201,1715880201.592469,-18000,,
com.google.Chrome,2,1715880194,1715880196,1715880196.602061,-18000,,
com.apple.MobileSMS,49,1715880145,1715880194,1715880194.26386,-18000,,
com.google.Chrome,63,1715880082,1715880145,1715880146.0104508,-18000,,
com.apple.iCal,2,1715880080,1715880082,1715880082.552882,-18000,,
com.google.Chrome,15,1715880065,1715880080,1715880080.957114,-18000,,
com.apple.iCal,3,1715880062,1715880065,1715880065.849205,-18000,,
com.google.Chrome,23,1715880039,1715880062,1715880062.285455,-18000,,
com.apple.iCal,3,1715880036,1715880039,1715880039.152755,-18000,,
com.google.Chrome,134,1715879902,1715880036,1715880036.320308,-18000,,
com.apple.iCal,7,1715879895,1715879902,1715879902.4320421,-18000,,
com.google.Chrome,64,1715879831,1715879895,1715879895.2405329,-18000,,
com.apple.iCal,7,1715879824,1715879831,1715879831.894536,-18000,,
com.google.Chrome,6,1715879818,1715879824,1715879824.206147,-18000,,
com.apple.iCal,14,1715879804,1715879818,1715879818.679534,-18000,,
com.google.Chrome,117,1715879687,1715879804,1715879804.52274,-18000,,
com.google.Chrome,50,1715875105,1715875155,1715875156.187084,-18000,,
com.microsoft.onenote.mac,19,1715874697,1715874716,1715874716.17843,-18000,,
