app,usage,start_time,end_time,created_at,tz,device_id,device_model
com.apple.finder,19,1732381469,1732381488,1732381489.006818,-21600,,
com.apple.reminders,12,1732381457,1732381469,1732381469.78439,-21600,,
com.leomehlig.today,47,1732381410,1732381457,1732381457.300003,-21600,,
com.apple.systempreferences,14,1732381396,1732381410,1732381410.6384192,-21600,,
com.google.Chrome,7,1732381383,1732381390,1732381390.0576339,-21600,,
com.leomehlig.today,37,1732381346,1732381383,1732381383.278331,-21600,,
com.apple.reminders,32,1732381314,1732381346,1732381346.2412639,-21600,,
com.leomehlig.today,51,1732381263,1732381314,1732381314.281307,-21600,,
com.apple.finder,2,1732381261,1732381263,1732381263.9233909,-21600,,
com.leomehlig.today,144,1732381117,1732381261,1732381261.853428,-21600,,
com.apple.finder,2,1732381115,1732381117,1732381117.724592,-21600,,
com.leomehlig.today,26,1732381089,1732381115,1732381115.9510422,-21600,,
com.apple.finder,4,1732381085,1732381089,1732381089.491662,-21600,,
com.microsoft.VSCode,6,1732381079,1732381085,1732381085.76633,-21600,,
com.google.Chrome,4,1732381075,1732381079,1732381079.6313992,-21600,,
com.google.Chrome,1545,1732345090,1732346635,1732346635.691464,-21600,,
com.google.Chrome,310,1732343594,1732343904,1732343905.039456,-21600,,
com.google.Chrome,501,1732342889,1732343390,1732343390.49022,-21600,,
com.google.Chrome,812,1732342008,1732342820,1732342820.267767,-21600,,
com.google.Chrome,300,1732341094,1732341394,1732341394.352673,-21600,,
com.google.Chrome,413,1732340293,1732340706,1732340706.1885319,-21600,,
com.apple.finder,1,1732340292,1732340293,1732340293.529218,-21600,,
com.microsoft.Excel,3,1732340289,1732340292,1732340292.0770202,-21600,,
com.microsoft.VSCode,15,1732340274,1732340289,1732340289.854387,-21600,,
com.microsoft.VSCode,563,1732321287,1732321850,1732321850.952575,-21600,,
com.microsoft.Excel,9,1732321278,1732321287,1732321287.068526,-21600,,
com.apple.finder,16,1732321262,1732321278,1732321278.1594958,-21600,,
com.microsoft.Excel,19,1732321243,1732321262,1732321262.788902,-21600,,
com.microsoft.VSCode,13,1732321230,1732321243,1732321243.888758,-21600,,
com.leomehlig.today,25,1732321205,1732321230,1732321230.388746,-21600,,
com.microsoft.VSCode,339,1732320866,1732321205,1732321205.607826,-21600,,
com.microsoft.VSCode,171,1732250289,1732250460,1732250460.324111,-21600,,
com.google.Chrome,2,1732250287,1732250289,1732250292.374741,-21600,,
com.google.Chrome,3,1732247209,1732247212,1732247212.7020988,-21600,,
com.microsoft.VSCode,811,1732246390,1732247201,1732247201.5448,-21600,,
com.microsoft.VSCode,623,1732245748,1732246371,1732246371.792745,-21600,,
com.google.Chrome,1,1732245747,1732245748,1732245748.7223349,-21600,,
com.microsoft.VSCode,126,1732245621,1732245747,1732245747.9399838,-21600,,
com.google.Chrome,1,1732245620,1732245621,1732245621.9536982,-21600,,
com.microsoft.VSCode,351,1732245269,1732245620,1732245620.941428,-21600,,
com.google.Chrome,105,1732245164,1732245269,1732245269.467413,-21600,,
com.microsoft.VSCode,582,1732244582,1732245164,1732245164.405507,-21600,,
com.google.Chrome,138,1732244444,1732244582,1732244582.170501,-21600,,
com.google.Chrome,472,1732243887,1732244359,1732244360.320302,-21600,,
com.apple.MobileSMS,1,1732243886,1732243887,1732243887.5612922,-21600,,
com.google.Chrome,26,1732243860,1732243886,1732243886.3997412,-21600,,
com.apple.MobileSMS,2,1732243858,1732243860,1732243860.425105,-21600,,
com.google.Chrome,7,1732243851,1732243858,1732243858.374806,-21600,,
com.apple.MobileSMS,2,1732243849,1732243851,1732243851.6227589,-21600,,
com.google.Chrome,1,1732243848,1732243849,1732243849.499944,-21600,,
com.apple.MobileSMS,3,1732243845,1732243848,1732243849.0233731,-21600,,
com.google.Chrome,5,1732243840,1732243845,1732243845.154633,-21600,,
com.apple.MobileSMS,9,1732243831,1732243840,1732243840.775063,-21600,,
com.google.Chrome,66,1732243765,1732243831,1732243831.6428041,-21600,,
com.apple.MobileSMS,3,1732243762,1732243765,1732243765.185832,-21600,,
com.google.Chrome,6,1732243756,1732243762,1732243762.119698,-21600,,
com.apple.MobileSMS,0,1732243756,1732243756,1732243756.4842029,-21600,,
com.google.Chrome,6,1732243750,1732243756,1732243756.054431,-21600,,
com.apple.MobileSMS,3,1732243747,1732243750,1732243750.054315,-21600,,
com.google.Chrome,6,1732243741,1732243747,1732243747.657547,-21600,,
com.apple.MobileSMS,48,1732243693,1732243741,1732243741.2681289,-21600,,
com.google.Chrome,12,1732243681,1732243693,1732243693.9379,-21600,,
com.apple.MobileSMS,19,1732243662,1732243681,1732243681.146566,-21600,,
com.google.Chrome,12,1732243650,1732243662,1732243662.5974789,-21600,,
com.apple.Music,4,1732243646,1732243650,1732243650.3477612,-21600,,
com.google.Chrome,69,1732243577,1732243646,1732243646.2838922,-21600,,
com.google.Chrome,404,1732240181,1732240585,1732240585.989373,-21600,,
com.apple.iCal,0,1732240149,1732240149,1732240149.9199572,-21600,,
com.google.Chrome,1,1732240148,1732240149,1732240149.459919,-21600,,
com.apple.iCal,2,1732240146,1732240148,1732240148.405474,-21600,,
com.google.Chrome,16,1732240130,1732240146,1732240146.867775,-21600,,
com.apple.iCal,1,1732240129,1732240130,1732240130.1406531,-21600,,
com.google.Chrome,5,1732240124,1732240129,1732240129.1446772,-21600,,
com.apple.iCal,1,1732240123,1732240124,1732240124.915477,-21600,,
com.google.Chrome,14,1732240109,1732240123,1732240123.474536,-21600,,
com.apple.iCal,2,1732240107,1732240109,1732240109.598975,-21600,,
com.google.Chrome,4,1732240103,1732240107,1732240107.740613,-21600,,
com.apple.iCal,3,1732240100,1732240103,1732240103.6653252,-21600,,
com.google.Chrome,11,1732240089,1732240100,1732240100.981055,-21600,,
com.apple.iCal,2,1732240087,1732240089,1732240089.261454,-21600,,
com.google.Chrome,1,1732240086,1732240087,1732240087.452431,-21600,,
com.apple.iCal,7,1732240079,1732240086,1732240086.5959659,-21600,,
com.google.Chrome,5,1732240074,1732240079,1732240079.362467,-21600,,
com.apple.iCal,2,1732240072,1732240074,1732240074.529244,-21600,,
com.google.Chrome,8,1732240064,1732240072,1732240072.5056648,-21600,,
com.apple.iCal,6,1732240058,1732240064,1732240064.560038,-21600,,
com.google.Chrome,17,1732240041,1732240058,1732240058.144188,-21600,,
com.apple.iCal,1,1732239996,1732239997,1732239998.037535,-21600,,
com.google.Chrome,15,1732239981,1732239996,1732239996.308974,-21600,,
com.apple.iCal,0,1732239981,1732239981,1732239981.763112,-21600,,
com.google.Chrome,1,1732239980,1732239981,1732239981.285455,-21600,,
com.apple.iCal,4,1732239976,1732239980,1732239980.704822,-21600,,
com.google.Chrome,5,1732239971,1732239976,1732239976.2444391,-21600,,
com.apple.iCal,7,1732239964,1732239971,1732239971.258556,-21600,,
com.google.Chrome,169,1732239795,1732239964,1732239964.713984,-21600,,
com.apple.Terminal,3,1732239369,1732239372,1732239372.1870599,-21600,,
com.google.Chrome,5,1732239364,1732239369,1732239369.786108,-21600,,
com.apple.Terminal,1,1732239363,1732239364,1732239364.5847402,-21600,,
com.microsoft.VSCode,8,1732239355,1732239363,1732239363.277361,-21600,,
com.apple.Terminal,3,1732239352,1732239355,1732239355.11706,-21600,,
com.microsoft.VSCode,13,1732239339,1732239352,1732239352.933723,-21600,,
com.google.Chrome,11,1732239328,1732239339,1732239339.4952931,-21600,,
com.microsoft.VSCode,22,1732239306,1732239328,1732239328.535754,-21600,,
com.google.Chrome,2,1732239304,1732239306,1732239306.053955,-21600,,
com.microsoft.VSCode,35,1732239269,1732239304,1732239304.52211,-21600,,
com.google.Chrome,17,1732239252,1732239269,1732239269.835144,-21600,,
com.microsoft.VSCode,4,1732239248,1732239252,1732239252.931155,-21600,,
com.google.Chrome,81,1732239167,1732239248,1732239248.5754352,-21600,,
com.microsoft.VSCode,2,1732239165,1732239167,1732239167.273588,-21600,,
com.google.Chrome,7,1732239158,1732239165,1732239165.4214,-21600,,
com.microsoft.VSCode,0,1732239158,1732239158,1732239158.97889,-21600,,
com.google.Chrome,174,1732238984,1732239158,1732239158.283877,-21600,,
com.microsoft.VSCode,5,1732238979,1732238984,1732238984.287965,-21600,,
com.google.Chrome,5,1732238974,1732238979,1732238979.490943,-21600,,
com.microsoft.VSCode,14,1732238960,1732238974,1732238974.988525,-21600,,
com.google.Chrome,55,1732238905,1732238960,1732238960.537943,-21600,,
com.microsoft.VSCode,1,1732238904,1732238905,1732238905.7801142,-21600,,
com.google.Chrome,11,1732238893,1732238904,1732238904.472643,-21600,,
com.microsoft.VSCode,0,1732238893,1732238893,1732238893.622863,-21600,,
com.google.Chrome,255,1732238638,1732238893,1732238893.0468569,-21600,,
com.microsoft.VSCode,4,1732238634,1732238638,1732238638.2753,-21600,,
com.google.Chrome,6,1732238628,1732238634,1732238634.31153,-21600,,
com.microsoft.VSCode,16,1732238612,1732238628,1732238628.282586,-21600,,
com.google.Chrome,104,1732238508,1732238612,1732238612.911979,-21600,,
com.microsoft.VSCode,474,1732238034,1732238508,1732238508.285355,-21600,,
com.apple.iCal,89,1732237945,1732238034,1732238034.803256,-21600,,
com.microsoft.VSCode,23,1732237922,1732237945,1732237945.835143,-21600,,
com.google.Chrome,221,1732237701,1732237922,1732237922.084231,-21600,,
com.microsoft.VSCode,145,1732237556,1732237701,1732237701.807595,-21600,,
com.google.Chrome,6,1732237550,1732237556,1732237556.2303128,-21600,,
com.google.Chrome,303,1732235801,1732236104,1732236104.623666,-21600,,
com.microsoft.VSCode,2,1732235799,1732235801,1732235801.83385,-21600,,
com.google.Chrome,167,1732235632,1732235799,1732235799.1650949,-21600,,
com.apple.MobileSMS,4,1732235628,1732235632,1732235632.939775,-21600,,
com.google.Chrome,483,1732235145,1732235628,1732235628.599199,-21600,,
com.apple.MobileSMS,57,1732235088,1732235145,1732235146.035876,-21600,,
com.google.Chrome,6,1732235082,1732235088,1732235088.944262,-21600,,
com.apple.MobileSMS,35,1732235047,1732235082,1732235082.237803,-21600,,
com.microsoft.VSCode,482,1732234565,1732235047,1732235047.734105,-21600,,
com.google.Chrome,3,1732234562,1732234565,1732234565.753693,-21600,,
com.leomehlig.today,10,1732234552,1732234562,1732234562.237258,-21600,,
com.google.Chrome,68,1732234484,1732234552,1732234552.683796,-21600,,
com.google.Chrome,566,1732232087,1732232653,1732232653.829122,-21600,,
com.google.Chrome,590,1732231331,1732231921,1732231921.162358,-21600,,
com.google.Chrome,430,1732230531,1732230961,1732230961.3089871,-21600,,
com.google.Chrome,675,1732229791,1732230466,1732230466.135045,-21600,,
com.google.Chrome,304,1732229445,1732229749,1732229749.252986,-21600,,
com.google.Chrome,580,1732228789,1732229369,1732229369.3485808,-21600,,
com.leomehlig.today,44,1732228745,1732228789,1732228791.623431,-21600,,
com.leomehlig.today,101,1732228449,1732228550,1732228551.0241961,-21600,,
com.google.Chrome,6,1732228443,1732228449,1732228449.609507,-21600,,
us.zoom.xos,9,1732228434,1732228443,1732228443.337246,-21600,,
com.google.Chrome,142,1732228292,1732228434,1732228434.816763,-21600,,
us.zoom.xos,4,1732228288,1732228292,1732228292.489855,-21600,,
com.google.Chrome,3,1732228285,1732228288,1732228288.3515549,-21600,,
com.apple.news,65,1732228139,1732228204,1732228204.474498,-21600,EB445137-D7F5-57EC-87DA-1DB460D64046,"iPhone13,2"
com.instructure.icanvas,7,1732228118,1732228125,1732228125.3701348,-21600,EB445137-D7F5-57EC-87DA-1DB460D64046,"iPhone13,2"
com.toyopagroup.picaboo,3,1732228114,1732228117,1732228117.321018,-21600,EB445137-D7F5-57EC-87DA-1DB460D64046,"iPhone13,2"
com.toyopagroup.picaboo,11,1732228098,1732228109,1732228109.840414,-21600,EB445137-D7F5-57EC-87DA-1DB460D64046,"iPhone13,2"
us.zoom.xos,1,1732228043,1732228044,1732228044.6116781,-21600,,
com.google.Chrome,1,1732228042,1732228043,1732228043.034625,-21600,,
us.zoom.xos,3,1732228039,1732228042,1732228042.387644,-21600,,
com.google.Chrome,269,1732227770,1732228039,1732228039.7474709,-21600,,
us.zoom.xos,1,1732227769,1732227770,1732227770.851217,-21600,,
com.toyopagroup.picaboo,16,1732227757,1732227773,1732227773.161093,-21600,EB445137-D7F5-57EC-87DA-1DB460D64046,"iPhone13,2"
com.google.Chrome,37,1732227732,1732227769,1732227769.652509,-21600,,
com.toyopagroup.picaboo,82,1732227675,1732227757,1732227757.992636,-21600,EB445137-D7F5-57EC-87DA-1DB460D64046,"iPhone13,2"
us.zoom.xos,67,1732227665,1732227732,1732227732.1770601,-21600,,
com.google.Chrome,4,1732227661,1732227665,1732227665.77417,-21600,,
us.zoom.xos,198,1732227463,1732227661,1732227661.764152,-21600,,
com.google.Chrome,5,1732227458,1732227463,1732227463.167505,-21600,,
us.zoom.xos,0,1732227458,1732227458,1732227458.887636,-21600,,
us.zoom.xos,300,1732226992,1732227292,1732227292.087501,-21600,,
com.google.Chrome,5,1732226987,1732226992,1732226992.090528,-21600,,
us.zoom.xos,255,1732226732,1732226987,1732226987.608372,-21600,,
com.google.Chrome,2,1732226730,1732226732,1732226732.5176039,-21600,,
com.apple.ScreenContinuity,1,1732226729,1732226730,1732226730.932281,-21600,,
com.toyopagroup.picaboo,14,1732226689,1732226703,1732226703.566409,-21600,EB445137-D7F5-57EC-87DA-1DB460D64046,"iPhone13,2"
com.google.Chrome,161,1732226568,1732226729,1732226729.727442,-21600,,
com.toyopagroup.picaboo,11,1732226553,1732226564,1732226564.5871701,-21600,EB445137-D7F5-57EC-87DA-1DB460D64046,"iPhone13,2"
com.microsoft.VSCode,40,1732226528,1732226568,1732226568.1717238,-21600,,
com.toyopagroup.picaboo,30,1732226499,1732226529,1732226529.280365,-21600,EB445137-D7F5-57EC-87DA-1DB460D64046,"iPhone13,2"
com.facebook.Facebook,3,1732226496,1732226499,1732226499.414454,-21600,EB445137-D7F5-57EC-87DA-1DB460D64046,"iPhone13,2"
com.google.Chrome,70,1732226458,1732226528,1732226528.693654,-21600,,
com.apple.finder,1,1732226457,1732226458,1732226458.367845,-21600,,
com.google.Chrome,22,1732226435,1732226457,1732226457.996904,-21600,,
com.microsoft.VSCode,12,1732226423,1732226435,1732226436.43217,-21600,,
com.google.Chrome,5,1732226418,1732226423,1732226423.931087,-21600,,
com.microsoft.VSCode,15,1732226403,1732226418,1732226418.1643128,-21600,,
com.google.Chrome,2,1732226401,1732226403,1732226403.854622,-21600,,
com.apple.finder,44,1732226357,1732226401,1732226401.949883,-21600,,
com.apple.archiveutility,0,1732226357,1732226357,1732226357.720343,-21600,,
com.apple.finder,19,1732226338,1732226357,1732226357.349918,-21600,,
com.google.Chrome,13,1732226325,1732226338,1732226338.5678701,-21600,,
com.apple.finder,3,1732226322,1732226325,1732226325.1366072,-21600,,
com.google.Chrome,5,1732226317,1732226322,1732226322.346167,-21600,,
us.zoom.xos,2,1732226315,1732226317,1732226318.006006,-21600,,
com.google.Chrome,35,1732226280,1732226315,1732226315.544959,-21600,,
com.facebook.Facebook,29,1732226280,1732226309,1732226309.659261,-21600,EB445137-D7F5-57EC-87DA-1DB460D64046,"iPhone13,2"
com.toyopagroup.picaboo,15,1732226254,1732226269,1732226269.907258,-21600,EB445137-D7F5-57EC-87DA-1DB460D64046,"iPhone13,2"
com.toyopagroup.picaboo,47,1732226202,1732226249,1732226249.1902928,-21600,EB445137-D7F5-57EC-87DA-1DB460D64046,"iPhone13,2"
com.microsoft.Office.Outlook,11,1732226179,1732226190,1732226190.848701,-21600,EB445137-D7F5-57EC-87DA-1DB460D64046,"iPhone13,2"
us.zoom.xos,124,1732226156,1732226280,1732226281.008462,-21600,,
com.google.Chrome,22,1732226134,1732226156,1732226156.908694,-21600,,
us.zoom.xos,1,1732226133,1732226134,1732226134.074654,-21600,,
com.google.Chrome,9,1732226124,1732226133,1732226133.566766,-21600,,
us.zoom.xos,64,1732226060,1732226124,1732226124.372905,-21600,,
com.google.Chrome,22,1732226038,1732226060,1732226060.494108,-21600,,
us.zoom.xos,1,1732226037,1732226038,1732226038.5767999,-21600,,
com.google.Chrome,237,1732225800,1732226037,1732226037.7917209,-21600,,
us.zoom.xos,2,1732225798,1732225800,1732225800.239166,-21600,,
com.google.Chrome,6,1732225792,1732225798,1732225798.752986,-21600,,
us.zoom.xos,16,1732225776,1732225792,1732225792.490769,-21600,,
com.google.Chrome,521,1732225255,1732225776,1732225776.994776,-21600,,
com.apple.finder,3,1732225252,1732225255,1732225255.106485,-21600,,
com.apple.archiveutility,0,1732225252,1732225252,1732225252.922615,-21600,,
com.apple.finder,4,1732225248,1732225252,1732225252.499233,-21600,,
com.google.Chrome,25,1732225223,1732225248,1732225248.458868,-21600,,
us.zoom.xos,5,1732225218,1732225223,1732225223.733193,-21600,,
com.google.Chrome,12,1732225206,1732225218,1732225218.9582949,-21600,,
us.zoom.xos,5,1732225201,1732225206,1732225206.07441,-21600,,
com.apple.Passwords,7,1732225194,1732225201,1732225201.751116,-21600,,
us.zoom.xos,4,1732225190,1732225194,1732225194.551396,-21600,,
com.microsoft.Outlook,1,1732225189,1732225190,1732225190.152489,-21600,,
com.google.Chrome,155,1732225034,1732225189,1732225189.538343,-21600,,
com.microsoft.Outlook,8,1732225026,1732225034,1732225034.271237,-21600,,
com.google.Chrome,13,1732225013,1732225026,1732225026.643968,-21600,,
us.zoom.xos,7,1732225006,1732225013,1732225013.417047,-21600,,
com.google.Chrome,30,1732224976,1732225006,1732225006.5992122,-21600,,
com.apple.Passwords,15,1732224961,1732224976,1732224976.43965,-21600,,
com.google.Chrome,105,1732224856,1732224961,1732224961.301377,-21600,,
us.zoom.xos,84,1732224772,1732224856,1732224856.5845919,-21600,,
com.google.Chrome,23,1732224749,1732224772,1732224772.324339,-21600,,
com.microsoft.VSCode,3,1732224733,1732224736,1732224736.7158651,-21600,,
com.google.Chrome,6,1732224727,1732224733,1732224733.679395,-21600,,
com.apple.camera,6,1732224555,1732224561,1732224562.252615,-21600,EB445137-D7F5-57EC-87DA-1DB460D64046,"iPhone13,2"
com.toyopagroup.picaboo,5,1732224554,1732224559,1732224561.08362,-21600,EB445137-D7F5-57EC-87DA-1DB460D64046,"iPhone13,2"
com.toyopagroup.picaboo,18,1732223917,1732223935,1732223935.6939359,-21600,EB445137-D7F5-57EC-87DA-1DB460D64046,"iPhone13,2"
com.toyopagroup.picaboo,3,1732223912,1732223915,1732223915.77196,-21600,EB445137-D7F5-57EC-87DA-1DB460D64046,"iPhone13,2"
com.toyopagroup.picaboo,5,1732223890,1732223895,1732223895.792558,-21600,EB445137-D7F5-57EC-87DA-1DB460D64046,"iPhone13,2"
com.toyopagroup.picaboo,19,1732223869,1732223888,1732223888.68384,-21600,EB445137-D7F5-57EC-87DA-1DB460D64046,"iPhone13,2"
com.facebook.Facebook,4,1732223865,1732223869,1732223869.435056,-21600,EB445137-D7F5-57EC-87DA-1DB460D64046,"iPhone13,2"
com.google.Chrome,3858,1732218781,1732222639,1732222639.427517,-21600,,
com.google.Chrome,337,1732217132,1732217469,1732217469.0589662,-21600,,
com.facebook.Facebook,33,1732216434,1732216467,1732216467.6883202,-21600,EB445137-D7F5-57EC-87DA-1DB460D64046,"iPhone13,2"
com.hammerandchisel.discord,7,1732216425,1732216432,1732216432.308319,-21600,EB445137-D7F5-57EC-87DA-1DB460D64046,"iPhone13,2"
com.google.Chrome,770,1732216115,1732216885,1732216885.731416,-21600,,
com.leomehlig.today,9,1732216106,1732216115,1732216115.590496,-21600,,
com.apple.iCal,14,1732216092,1732216106,1732216106.385573,-21600,,
com.leomehlig.today,8,1732216084,1732216092,1732216092.424391,-21600,,
com.apple.weather,33,1732215673,1732215706,1732215706.14801,-21600,EB445137-D7F5-57EC-87DA-1DB460D64046,"iPhone13,2"
com.apple.news,51,1732215621,1732215672,1732215672.9788551,-21600,EB445137-D7F5-57EC-87DA-1DB460D64046,"iPhone13,2"
com.apple.camera,5,1732215608,1732215613,1732215613.348445,-21600,EB445137-D7F5-57EC-87DA-1DB460D64046,"iPhone13,2"
com.apple.news,48,1732215556,1732215604,1732215604.62992,-21600,EB445137-D7F5-57EC-87DA-1DB460D64046,"iPhone13,2"
com.google.ios.youtube,411,1732214110,1732214521,1732214521.419609,-21600,EB445137-D7F5-57EC-87DA-1DB460D64046,"iPhone13,2"
com.instructure.icanvas,17,1732214093,1732214110,1732214110.921825,-21600,EB445137-D7F5-57EC-87DA-1DB460D64046,"iPhone13,2"
com.google.ios.youtube,3,1732214090,1732214093,1732214093.47421,-21600,EB445137-D7F5-57EC-87DA-1DB460D64046,"iPhone13,2"
com.google.ios.youtube,6,1732213981,1732213987,1732213987.373111,-21600,EB445137-D7F5-57EC-87DA-1DB460D64046,"iPhone13,2"
com.google.ios.youtube,555,1732212807,1732213362,1732213362.510006,-21600,EB445137-D7F5-57EC-87DA-1DB460D64046,"iPhone13,2"
com.truebill.truebillnative,3,1732212802,1732212805,1732212806.1390362,-21600,EB445137-D7F5-57EC-87DA-1DB460D64046,"iPhone13,2"
com.truebill.truebillnative,3,1732212772,1732212775,1732212775.7525759,-21600,EB445137-D7F5-57EC-87DA-1DB460D64046,"iPhone13,2"
com.apple.camera,1,1732212070,1732212071,1732212072.848871,-21600,EB445137-D7F5-57EC-87DA-1DB460D64046,"iPhone13,2"
com.truebill.truebillnative,3,1732212068,1732212071,1732212072.8418012,-21600,EB445137-D7F5-57EC-87DA-1DB460D64046,"iPhone13,2"
com.truebill.truebillnative,67,1732211999,1732212066,1732212067.5946,-21600,EB445137-D7F5-57EC-87DA-1DB460D64046,"iPhone13,2"
com.hammerandchisel.discord,77,1732211859,1732211936,1732211936.861568,-21600,EB445137-D7F5-57EC-87DA-1DB460D64046,"iPhone13,2"
com.microsoft.Office.Outlook,6,1732211841,1732211847,1732211847.1729732,-21600,EB445137-D7F5-57EC-87DA-1DB460D64046,"iPhone13,2"
com.apple.news,5,1732211827,1732211832,1732211832.705509,-21600,EB445137-D7F5-57EC-87DA-1DB460D64046,"iPhone13,2"
com.apple.news,91,1732211653,1732211744,1732211744.752924,-21600,EB445137-D7F5-57EC-87DA-1DB460D64046,"iPhone13,2"
com.apple.weather,16,1732211631,1732211647,1732211647.0975099,-21600,EB445137-D7F5-57EC-87DA-1DB460D64046,"iPhone13,2"
com.apple.weather,5,1732211625,1732211630,1732211630.6802669,-21600,EB445137-D7F5-57EC-87DA-1DB460D64046,"iPhone13,2"
com.google.ios.youtube,254,1732211370,1732211624,1732211625.4968371,-21600,EB445137-D7F5-57EC-87DA-1DB460D64046,"iPhone13,2"
com.google.ios.youtube,155,1732211195,1732211350,1732211351.247922,-21600,EB445137-D7F5-57EC-87DA-1DB460D64046,"iPhone13,2"
com.instructure.icanvas,24,1732211165,1732211189,1732211189.959974,-21600,EB445137-D7F5-57EC-87DA-1DB460D64046,"iPhone13,2"
com.google.chrome.ios,9,1732211145,1732211154,1732211154.818932,-21600,EB445137-D7F5-57EC-87DA-1DB460D64046,"iPhone13,2"
com.google.chrome.ios,5,1732210613,1732210618,1732210618.897691,-21600,EB445137-D7F5-57EC-87DA-1DB460D64046,"iPhone13,2"
com.google.chrome.ios,11,1732209981,1732209992,1732209992.1215138,-21600,EB445137-D7F5-57EC-87DA-1DB460D64046,"iPhone13,2"
com.google.chrome.ios,168,1732208966,1732209134,1732209134.2603679,-21600,EB445137-D7F5-57EC-87DA-1DB460D64046,"iPhone13,2"
com.google.chrome.ios,3,1732208961,1732208964,1732208964.9654021,-21600,EB445137-D7F5-57EC-87DA-1DB460D64046,"iPhone13,2"
com.google.chrome.ios,127,1732208756,1732208883,1732208884.087356,-21600,EB445137-D7F5-57EC-87DA-1DB460D64046,"iPhone13,2"
com.apple.Maps,4,1732208750,1732208754,1732208755.163712,-21600,EB445137-D7F5-57EC-87DA-1DB460D64046,"iPhone13,2"
com.apple.Maps,33,1732208705,1732208738,1732208739.219444,-21600,EB445137-D7F5-57EC-87DA-1DB460D64046,"iPhone13,2"
com.apple.weather,21,1732208643,1732208664,1732208664.3201761,-21600,EB445137-D7F5-57EC-87DA-1DB460D64046,"iPhone13,2"
com.apple.weather,35,1732208600,1732208635,1732208635.325661,-21600,EB445137-D7F5-57EC-87DA-1DB460D64046,"iPhone13,2"
com.hammerandchisel.discord,2,1732208598,1732208600,1732208600.7114038,-21600,EB445137-D7F5-57EC-87DA-1DB460D64046,"iPhone13,2"
com.instructure.icanvas,5,1732208571,1732208576,1732208576.26492,-21600,EB445137-D7F5-57EC-87DA-1DB460D64046,"iPhone13,2"
com.instructure.icanvas,2,1732207489,1732207491,1732207491.886106,-21600,EB445137-D7F5-57EC-87DA-1DB460D64046,"iPhone13,2"
com.leomehlig.today,21,1732207462,1732207483,1732207484.387258,-21600,,
com.google.Chrome,1,1732207461,1732207462,1732207462.7827768,-21600,,
com.leomehlig.today,12,1732207449,1732207461,1732207461.9238548,-21600,,
com.google.Chrome,1,1732207448,1732207449,1732207449.577458,-21600,,
com.leomehlig.today,9,1732207439,1732207448,1732207448.914124,-21600,,
com.google.Chrome,3,1732207436,1732207439,1732207439.675698,-21600,,
com.leomehlig.today,7,1732207429,1732207436,1732207436.53271,-21600,,
com.apple.iCal,5,1732207424,1732207429,1732207429.156518,-21600,,
com.leomehlig.today,8,1732207416,1732207424,1732207424.835143,-21600,,
com.google.Chrome,1,1732207415,1732207416,1732207416.7318091,-21600,,
com.leomehlig.today,1,1732207414,1732207415,1732207415.1301432,-21600,,
com.google.Chrome,27,1732207387,1732207414,1732207414.5931349,-21600,,
com.leomehlig.today,27,1732207360,1732207387,1732207387.426762,-21600,,
com.google.Chrome,22,1732207338,1732207360,1732207360.18926,-21600,,
com.leomehlig.today,11,1732207320,1732207331,1732207331.36605,-21600,,
com.apple.iCal,5,1732207315,1732207320,1732207320.2741718,-21600,,
com.leomehlig.today,22,1732207293,1732207315,1732207315.11448,-21600,,
com.google.Chrome,1,1732207292,1732207293,1732207293.681237,-21600,,
com.leomehlig.today,13,1732207279,1732207292,1732207292.5405211,-21600,,
com.google.Chrome,226,1732207053,1732207279,1732207279.8085241,-21600,,
com.microsoft.VSCode,0,1732207053,1732207053,1732207053.54419,-21600,,
com.apple.Preview,10,1732207043,1732207053,1732207053.2281299,-21600,,
com.instructure.icanvas,36,1732206981,1732207017,1732207018.411432,-21600,EB445137-D7F5-57EC-87DA-1DB460D64046,"iPhone13,2"
com.apple.news,9,1732206972,1732206981,1732206981.627139,-21600,EB445137-D7F5-57EC-87DA-1DB460D64046,"iPhone13,2"
com.microsoft.VSCode,323,1732206720,1732207043,1732207043.465708,-21600,,
com.google.Chrome,1,1732206719,1732206720,1732206720.983252,-21600,,
com.microsoft.VSCode,86,1732206633,1732206719,1732206719.9812999,-21600,,
com.google.Chrome,3,1732206630,1732206633,1732206633.531503,-21600,,
com.microsoft.VSCode,10,1732206620,1732206630,1732206631.012536,-21600,,
com.google.Chrome,1,1732206619,1732206620,1732206620.995967,-21600,,
com.microsoft.VSCode,62,1732206557,1732206619,1732206619.3269649,-21600,,
com.google.Chrome,3,1732206554,1732206557,1732206557.8447518,-21600,,
com.microsoft.VSCode,3,1732206551,1732206554,1732206554.3776531,-21600,,
com.google.Chrome,1,1732206550,1732206551,1732206551.8562841,-21600,,
com.microsoft.VSCode,0,1732206550,1732206550,1732206551.013513,-21600,,
com.google.Chrome,1,1732206549,1732206550,1732206550.5362802,-21600,,
com.microsoft.VSCode,1,1732206548,1732206549,1732206549.7905369,-21600,,
com.google.Chrome,12,1732206536,1732206548,1732206548.530407,-21600,,
com.microsoft.VSCode,12,1732206524,1732206536,1732206536.289567,-21600,,
com.google.Chrome,55,1732206469,1732206524,1732206524.531851,-21600,,
com.apple.news,281,1732206157,1732206438,1732206439.651726,-21600,EB445137-D7F5-57EC-87DA-1DB460D64046,"iPhone13,2"
com.microsoft.VSCode,362,1732206107,1732206469,1732206469.554865,-21600,,
com.google.Chrome,18,1732206089,1732206107,1732206107.46835,-21600,,
com.microsoft.VSCode,56,1732206033,1732206089,1732206089.669838,-21600,,
com.google.Chrome,1,1732206032,1732206033,1732206033.905737,-21600,,
com.microsoft.VSCode,51,1732205981,1732206032,1732206032.1189651,-21600,,
com.google.Chrome,2,1732205979,1732205981,1732205981.9691439,-21600,,
com.microsoft.VSCode,18,1732205961,1732205979,1732205979.950897,-21600,,
com.google.Chrome,1,1732205960,1732205961,1732205961.835062,-21600,,
com.microsoft.VSCode,1,1732205959,1732205960,1732205960.7597818,-21600,,
com.google.Chrome,2,1732205957,1732205959,1732205959.938603,-21600,,
com.microsoft.VSCode,1,1732205956,1732205957,1732205957.5822349,-21600,,
com.google.Chrome,2,1732205954,1732205956,1732205956.799072,-21600,,
com.microsoft.VSCode,1,1732205953,1732205954,1732205954.7413921,-21600,,
com.google.Chrome,2,1732205951,1732205953,1732205953.803592,-21600,,
com.microsoft.VSCode,3,1732205948,1732205951,1732205951.701066,-21600,,
com.google.Chrome,50,1732205898,1732205948,1732205948.7458901,-21600,,
com.microsoft.VSCode,28,1732205870,1732205898,1732205898.966864,-21600,,
com.google.Chrome,19,1732205851,1732205870,1732205870.4800959,-21600,,
com.microsoft.VSCode,1,1732205850,1732205851,1732205851.4704142,-21600,,
com.google.Chrome,52,1732205798,1732205850,1732205850.275535,-21600,,
com.microsoft.VSCode,7,1732205791,1732205798,1732205798.586275,-21600,,
com.google.Chrome,2,1732205789,1732205791,1732205791.559263,-21600,,
com.apple.news,96,1732205266,1732205362,1732205363.051527,-21600,EB445137-D7F5-57EC-87DA-1DB460D64046,"iPhone13,2"
com.renpho.health,3,1732205261,1732205264,1732205264.118763,-21600,EB445137-D7F5-57EC-87DA-1DB460D64046,"iPhone13,2"
com.microsoft.VSCode,827,1732204962,1732205789,1732205789.937325,-21600,,
com.google.Chrome,45,1732204917,1732204962,1732204962.925558,-21600,,
com.microsoft.VSCode,3,1732204914,1732204917,1732204917.512238,-21600,,
com.google.Chrome,3,1732204911,1732204914,1732204914.970416,-21600,,
com.microsoft.VSCode,30,1732204881,1732204911,1732204911.113998,-21600,,
com.google.Chrome,58,1732204823,1732204881,1732204881.106278,-21600,,
com.microsoft.VSCode,8,1732204815,1732204823,1732204823.768219,-21600,,
com.google.Chrome,3,1732204812,1732204815,1732204815.852135,-21600,,
com.microsoft.VSCode,70,1732204742,1732204812,1732204812.46189,-21600,,
com.google.Chrome,127,1732204615,1732204742,1732204742.2994308,-21600,,
com.microsoft.VSCode,22,1732204593,1732204615,1732204615.1421819,-21600,,
com.google.Chrome,3,1732204590,1732204593,1732204593.2165651,-21600,,
com.microsoft.VSCode,44,1732204546,1732204590,1732204590.140854,-21600,,
com.google.Chrome,19,1732204527,1732204546,1732204546.287897,-21600,,
com.microsoft.VSCode,4,1732204523,1732204527,1732204527.272141,-21600,,
com.google.Chrome,1,1732204522,1732204523,1732204523.61826,-21600,,
com.microsoft.VSCode,5,1732204517,1732204522,1732204522.106267,-21600,,
com.google.Chrome,6,1732204511,1732204517,1732204517.805692,-21600,,
com.microsoft.VSCode,14,1732204497,1732204511,1732204511.682248,-21600,,
com.google.Chrome,4,1732204493,1732204497,1732204497.9780378,-21600,,
com.microsoft.VSCode,7,1732204486,1732204493,1732204493.418576,-21600,,
com.google.Chrome,9,1732204477,1732204486,1732204486.124078,-21600,,
com.microsoft.VSCode,4,1732204473,1732204477,1732204477.944985,-21600,,
com.google.Chrome,4,1732204469,1732204473,1732204473.1702862,-21600,,
com.microsoft.VSCode,4,1732204465,1732204469,1732204469.389357,-21600,,
com.google.Chrome,1,1732204464,1732204465,1732204465.968992,-21600,,
com.microsoft.VSCode,2,1732204462,1732204464,1732204464.120987,-21600,,
com.google.Chrome,1,1732204461,1732204462,1732204462.8005872,-21600,,
com.microsoft.VSCode,145,1732204316,1732204461,1732204461.598995,-21600,,
com.google.Chrome,8,1732204308,1732204316,1732204316.4417682,-21600,,
com.microsoft.VSCode,48,1732204260,1732204308,1732204308.620568,-21600,,
com.google.Chrome,43,1732204217,1732204260,1732204260.423551,-21600,,
com.microsoft.VSCode,23,1732204194,1732204217,1732204217.076982,-21600,,
com.google.Chrome,167,1732204027,1732204194,1732204194.335484,-21600,,
com.microsoft.VSCode,279,1732203748,1732204027,1732204027.9334512,-21600,,
com.google.Chrome,259,1732203489,1732203748,1732203748.8444672,-21600,,
com.apple.finder,28,1732203461,1732203489,1732203489.837502,-21600,,
com.google.Chrome,32,1732203429,1732203461,1732203461.412389,-21600,,
com.apple.camera,9,1732203273,1732203282,1732203282.878632,-21600,EB445137-D7F5-57EC-87DA-1DB460D64046,"iPhone13,2"
com.renpho.health,14,1732203268,1732203282,1732203282.875766,-21600,EB445137-D7F5-57EC-87DA-1DB460D64046,"iPhone13,2"
com.renpho.health,0,1732203045,1732203045,1732203046.010288,-21600,EB445137-D7F5-57EC-87DA-1DB460D64046,"iPhone13,2"
com.renpho.health,1,1732202803,1732202804,1732202804.311263,-21600,EB445137-D7F5-57EC-87DA-1DB460D64046,"iPhone13,2"
com.renpho.health,1,1732202798,1732202799,1732202800.36731,-21600,EB445137-D7F5-57EC-87DA-1DB460D64046,"iPhone13,2"
com.renpho.health,79,1732201827,1732201906,1732201906.988997,-21600,EB445137-D7F5-57EC-87DA-1DB460D64046,"iPhone13,2"
com.renpho.health,73,1732201220,1732201293,1732201293.533514,-21600,EB445137-D7F5-57EC-87DA-1DB460D64046,"iPhone13,2"
com.apple.weather,6,1732201213,1732201219,1732201219.435838,-21600,EB445137-D7F5-57EC-87DA-1DB460D64046,"iPhone13,2"
com.apple.weather,11,1732201191,1732201202,1732201202.4891992,-21600,EB445137-D7F5-57EC-87DA-1DB460D64046,"iPhone13,2"
com.google.Chrome,3,1732169491,1732169494,1732169494.205336,-21600,,
com.google.Chrome,396,1732167574,1732167970,1732167970.060266,-21600,,
com.google.Chrome,505,1732166801,1732167306,1732167306.2605019,-21600,,
com.google.Chrome,352,1732166248,1732166600,1732166600.7535481,-21600,,
com.google.Chrome,1551,1732164551,1732166102,1732166102.2435942,-21600,,
com.google.Chrome,314,1732164144,1732164458,1732164458.777879,-21600,,
com.google.Chrome,309,1732163546,1732163855,1732163855.119113,-21600,,
com.google.Chrome,313,1732162877,1732163190,1732163190.3830419,-21600,,
com.google.Chrome,552,1732162225,1732162777,1732162777.4388242,-21600,,
com.google.Chrome,518,1732161471,1732161989,1732161989.427959,-21600,,
com.leomehlig.today,2,1732161469,1732161471,1732161471.1246982,-21600,,
com.goodreads.Goodreads,50,1732161409,1732161459,1732161459.168951,-21600,EB445137-D7F5-57EC-87DA-1DB460D64046,"iPhone13,2"
com.apple.MobileSMS,3,1732161403,1732161406,1732161406.594863,-21600,EB445137-D7F5-57EC-87DA-1DB460D64046,"iPhone13,2"
com.google.Chrome,93,1732161376,1732161469,1732161469.72291,-21600,,
com.leomehlig.today,93,1732161283,1732161376,1732161376.5765672,-21600,,
com.apple.MobileSMS,5,1732161276,1732161281,1732161282.0080872,-21600,EB445137-D7F5-57EC-87DA-1DB460D64046,"iPhone13,2"
com.apple.news,3,1732161272,1732161275,1732161275.823669,-21600,EB445137-D7F5-57EC-87DA-1DB460D64046,"iPhone13,2"
com.apple.finder,23,1732161260,1732161283,1732161283.977864,-21600,,
com.apple.MobileSMS,25,1732161235,1732161260,1732161260.9353352,-21600,,
com.apple.finder,58,1732161177,1732161235,1732161235.3302379,-21600,,
com.google.Chrome,78,1732161099,1732161177,1732161177.347971,-21600,,
com.apple.news,2,1732161036,1732161038,1732161038.667855,-21600,EB445137-D7F5-57EC-87DA-1DB460D64046,"iPhone13,2"
com.apple.news,2,1732161014,1732161016,1732161017.096033,-21600,EB445137-D7F5-57EC-87DA-1DB460D64046,"iPhone13,2"
com.apple.news,2,1732161011,1732161013,1732161013.553494,-21600,EB445137-D7F5-57EC-87DA-1DB460D64046,"iPhone13,2"
com.apple.news,2,1732160417,1732160419,1732160419.917769,-21600,EB445137-D7F5-57EC-87DA-1DB460D64046,"iPhone13,2"
com.apple.news,2,1732160320,1732160322,1732160322.5148501,-21600,EB445137-D7F5-57EC-87DA-1DB460D64046,"iPhone13,2"
com.apple.news,3,1732160314,1732160317,1732160317.618137,-21600,EB445137-D7F5-57EC-87DA-1DB460D64046,"iPhone13,2"
com.apple.news,6,1732159191,1732159197,1732159197.556281,-21600,EB445137-D7F5-57EC-87DA-1DB460D64046,"iPhone13,2"
com.apple.news,42,1732159040,1732159082,1732159083.052143,-21600,EB445137-D7F5-57EC-87DA-1DB460D64046,"iPhone13,2"
com.apple.news,3,1732159034,1732159037,1732159037.5451589,-21600,EB445137-D7F5-57EC-87DA-1DB460D64046,"iPhone13,2"
com.google.chrome.ios,21,1732157489,1732157510,1732157510.898416,-21600,EB445137-D7F5-57EC-87DA-1DB460D64046,"iPhone13,2"
com.google.chrome.ios,6,1732157272,1732157278,1732157278.018764,-21600,EB445137-D7F5-57EC-87DA-1DB460D64046,"iPhone13,2"
com.google.chrome.ios,31,1732157140,1732157171,1732157171.247489,-21600,EB445137-D7F5-57EC-87DA-1DB460D64046,"iPhone13,2"
com.facebook.Facebook,5,1732157135,1732157140,1732157140.197921,-21600,EB445137-D7F5-57EC-87DA-1DB460D64046,"iPhone13,2"
com.facebook.Facebook,3,1732156884,1732156887,1732156887.6469269,-21600,EB445137-D7F5-57EC-87DA-1DB460D64046,"iPhone13,2"
com.facebook.Facebook,6,1732156491,1732156497,1732156497.754909,-21600,EB445137-D7F5-57EC-87DA-1DB460D64046,"iPhone13,2"
com.facebook.Facebook,6,1732156436,1732156442,1732156442.317768,-21600,EB445137-D7F5-57EC-87DA-1DB460D64046,"iPhone13,2"
com.facebook.Facebook,12,1732155245,1732155257,1732155258.894398,-21600,EB445137-D7F5-57EC-87DA-1DB460D64046,"iPhone13,2"
com.apple.MobileSMS,19,1732155202,1732155221,1732155222.242296,-21600,EB445137-D7F5-57EC-87DA-1DB460D64046,"iPhone13,2"
com.apple.mobileslideshow,2,1732155200,1732155202,1732155204.058652,-21600,EB445137-D7F5-57EC-87DA-1DB460D64046,"iPhone13,2"
com.google.Chrome,15,1732155024,1732155039,1732155039.964507,-21600,,
com.google.Chrome,300,1732154067,1732154367,1732154367.253015,-21600,,
com.google.Chrome,310,1732153712,1732154022,1732154022.5067139,-21600,,
com.google.Chrome,315,1732152399,1732152714,1732152714.7448869,-21600,,
com.google.Chrome,300,1732151284,1732151584,1732151584.247905,-21600,,
com.google.Chrome,307,1732149742,1732150049,1732150049.623213,-21600,,
com.apple.mobileslideshow,4,1732148579,1732148583,1732148583.420374,-21600,EB445137-D7F5-57EC-87DA-1DB460D64046,"iPhone13,2"
com.google.Chrome,409,1732148333,1732148742,1732148742.307745,-21600,,
com.leomehlig.today,24,1732148309,1732148333,1732148333.729872,-21600,,
com.apple.mobileslideshow,3,1732147699,1732147702,1732147702.950525,-21600,EB445137-D7F5-57EC-87DA-1DB460D64046,"iPhone13,2"
com.apple.mobileslideshow,3,1732146530,1732146533,1732146533.276983,-21600,EB445137-D7F5-57EC-87DA-1DB460D64046,"iPhone13,2"
com.apple.mobileslideshow,368,1732145867,1732146235,1732146235.0992022,-21600,EB445137-D7F5-57EC-87DA-1DB460D64046,"iPhone13,2"
com.apple.mobileslideshow,294,1732145543,1732145837,1732145837.430808,-21600,EB445137-D7F5-57EC-87DA-1DB460D64046,"iPhone13,2"
com.apple.mobileslideshow,2,1732145379,1732145381,1732145381.721446,-21600,EB445137-D7F5-57EC-87DA-1DB460D64046,"iPhone13,2"
com.apple.mobileslideshow,55,1732145261,1732145316,1732145316.909803,-21600,EB445137-D7F5-57EC-87DA-1DB460D64046,"iPhone13,2"
com.apple.mobileslideshow,2,1732145207,1732145209,1732145209.805222,-21600,EB445137-D7F5-57EC-87DA-1DB460D64046,"iPhone13,2"
com.apple.mobileslideshow,193,1732145012,1732145205,1732145205.7283258,-21600,EB445137-D7F5-57EC-87DA-1DB460D64046,"iPhone13,2"
com.apple.MobileSMS,60,1732144952,1732145012,1732145012.349293,-21600,EB445137-D7F5-57EC-87DA-1DB460D64046,"iPhone13,2"
com.renpho.health,3,1732144922,1732144925,1732144925.4518042,-21600,EB445137-D7F5-57EC-87DA-1DB460D64046,"iPhone13,2"
com.apple.news,55,1732144850,1732144905,1732144905.22007,-21600,EB445137-D7F5-57EC-87DA-1DB460D64046,"iPhone13,2"
com.apple.news,136,1732144683,1732144819,1732144819.7335858,-21600,EB445137-D7F5-57EC-87DA-1DB460D64046,"iPhone13,2"
com.microsoft.Office.Outlook,8,1732144669,1732144677,1732144677.370549,-21600,EB445137-D7F5-57EC-87DA-1DB460D64046,"iPhone13,2"
com.tinyspeck.chatlyio,30,1732144608,1732144638,1732144638.884272,-21600,EB445137-D7F5-57EC-87DA-1DB460D64046,"iPhone13,2"
com.apple.Health,39,1732144569,1732144608,1732144608.25415,-21600,EB445137-D7F5-57EC-87DA-1DB460D64046,"iPhone13,2"
com.apple.news,190,1732144374,1732144564,1732144564.8987541,-21600,EB445137-D7F5-57EC-87DA-1DB460D64046,"iPhone13,2"
com.apple.weather,46,1732144323,1732144369,1732144369.8503652,-21600,EB445137-D7F5-57EC-87DA-1DB460D64046,"iPhone13,2"
com.hammerandchisel.discord,23,1732144288,1732144311,1732144311.434598,-21600,EB445137-D7F5-57EC-87DA-1DB460D64046,"iPhone13,2"
com.hammerandchisel.discord,1,1732144252,1732144253,1732144253.962506,-21600,EB445137-D7F5-57EC-87DA-1DB460D64046,"iPhone13,2"
com.hammerandchisel.discord,45,1732144193,1732144238,1732144238.3968282,-21600,EB445137-D7F5-57EC-87DA-1DB460D64046,"iPhone13,2"
com.hammerandchisel.discord,2,1732144116,1732144118,1732144118.625649,-21600,EB445137-D7F5-57EC-87DA-1DB460D64046,"iPhone13,2"
com.hammerandchisel.discord,32,1732143561,1732143593,1732143594.250361,-21600,EB445137-D7F5-57EC-87DA-1DB460D64046,"iPhone13,2"
com.apple.weather,33,1732143502,1732143535,1732143535.058696,-21600,EB445137-D7F5-57EC-87DA-1DB460D64046,"iPhone13,2"
com.apple.MobileSMS,13,1732143457,1732143470,1732143470.769408,-21600,EB445137-D7F5-57EC-87DA-1DB460D64046,"iPhone13,2"
com.apple.Music,53,1732143393,1732143446,1732143446.537734,-21600,EB445137-D7F5-57EC-87DA-1DB460D64046,"iPhone13,2"
com.toyopagroup.picaboo,17,1732143364,1732143381,1732143382.0493999,-21600,EB445137-D7F5-57EC-87DA-1DB460D64046,"iPhone13,2"
com.apple.weather,12,1732142531,1732142543,1732142543.335501,-21600,EB445137-D7F5-57EC-87DA-1DB460D64046,"iPhone13,2"
com.toyopagroup.picaboo,4,1732142524,1732142528,1732142528.4596171,-21600,EB445137-D7F5-57EC-87DA-1DB460D64046,"iPhone13,2"
com.google.ios.youtube,225,1732142299,1732142524,1732142524.996231,-21600,EB445137-D7F5-57EC-87DA-1DB460D64046,"iPhone13,2"
com.toyopagroup.picaboo,6,1732142265,1732142271,1732142271.563472,-21600,EB445137-D7F5-57EC-87DA-1DB460D64046,"iPhone13,2"
com.robinhood.release.Robinhood,4,1732142249,1732142253,1732142253.555785,-21600,EB445137-D7F5-57EC-87DA-1DB460D64046,"iPhone13,2"
com.leomehlig.today,301,1732142246,1732142547,1732142547.473967,-21600,,
com.apple.finder,2,1732142244,1732142246,1732142246.521048,-21600,,
com.microsoft.VSCode,3,1732142241,1732142244,1732142244.314857,-21600,,
com.google.Chrome,9,1732142232,1732142241,1732142241.3098788,-21600,,
us.zoom.xos,6,1732142226,1732142232,1732142232.508696,-21600,,
com.robinhood.release.Robinhood,11,1732141881,1732141892,1732141892.873636,-21600,EB445137-D7F5-57EC-87DA-1DB460D64046,"iPhone13,2"
com.robinhood.release.Robinhood,1,1732141779,1732141780,1732141780.5678449,-21600,EB445137-D7F5-57EC-87DA-1DB460D64046,"iPhone13,2"
com.google.Chrome,448,1732141778,1732142226,1732142226.728301,-21600,,
com.microsoft.Outlook,4,1732141774,1732141778,1732141778.222619,-21600,,
com.robinhood.release.Robinhood,45,1732141726,1732141771,1732141772.205265,-21600,EB445137-D7F5-57EC-87DA-1DB460D64046,"iPhone13,2"
us.zoom.xos,59,1732141715,1732141774,1732141774.3822598,-21600,,
com.microsoft.Outlook,24,1732141691,1732141715,1732141715.2690601,-21600,,
com.apple.MobileSMS,12,1732141671,1732141683,1732141683.971705,-21600,EB445137-D7F5-57EC-87DA-1DB460D64046,"iPhone13,2"
us.zoom.xos,38,1732141653,1732141691,1732141691.7977052,-21600,,
com.microsoft.VSCode,73,1732141580,1732141653,1732141653.962298,-21600,,
us.zoom.xos,19,1732141561,1732141580,1732141580.076923,-21600,,
com.toyopagroup.picaboo,240,1732141407,1732141647,1732141647.830927,-21600,EB445137-D7F5-57EC-87DA-1DB460D64046,"iPhone13,2"
com.toyopagroup.picaboo,43,1732141359,1732141402,1732141402.255206,-21600,EB445137-D7F5-57EC-87DA-1DB460D64046,"iPhone13,2"
com.apple.MobileSMS,3,1732141356,1732141359,1732141360.068448,-21600,EB445137-D7F5-57EC-87DA-1DB460D64046,"iPhone13,2"
com.microsoft.VSCode,451,1732141110,1732141561,1732141561.9153628,-21600,,
us.zoom.xos,14,1732141096,1732141110,1732141110.224467,-21600,,
com.google.Chrome,2,1732141094,1732141096,1732141096.856327,-21600,,
com.microsoft.VSCode,367,1732140727,1732141094,1732141094.721126,-21600,,
com.google.Chrome,63,1732140664,1732140727,1732140727.48945,-21600,,
com.microsoft.VSCode,55,1732140609,1732140664,1732140664.4168792,-21600,,
com.google.Chrome,9,1732140600,1732140609,1732140609.786831,-21600,,
com.microsoft.VSCode,20,1732140580,1732140600,1732140600.227207,-21600,,
com.google.Chrome,30,1732140550,1732140580,1732140580.840116,-21600,,
com.microsoft.VSCode,1,1732140549,1732140550,1732140550.726013,-21600,,
com.google.Chrome,5,1732140544,1732140549,1732140549.167676,-21600,,
com.microsoft.VSCode,440,1732140104,1732140544,1732140544.782768,-21600,,
com.google.Chrome,1,1732140103,1732140104,1732140104.449404,-21600,,
us.zoom.xos,2,1732140101,1732140103,1732140103.272738,-21600,,
com.apple.iCal,21,1732140080,1732140101,1732140101.956736,-21600,,
us.zoom.xos,2,1732140078,1732140080,1732140080.084861,-21600,,
com.google.Chrome,20,1732140058,1732140078,1732140078.512344,-21600,,
us.zoom.xos,4,1732140054,1732140058,1732140058.9789948,-21600,,
com.microsoft.VSCode,4,1732140050,1732140054,1732140054.417355,-21600,,
com.google.Chrome,6,1732140044,1732140050,1732140051.069273,-21600,,
us.zoom.xos,7,1732140037,1732140044,1732140044.709621,-21600,,
com.google.Chrome,5,1732140032,1732140037,1732140037.812417,-21600,,
com.microsoft.VSCode,161,1732139871,1732140032,1732140032.7956529,-21600,,
com.google.Chrome,10,1732139861,1732139871,1732139871.372645,-21600,,
com.microsoft.VSCode,299,1732139562,1732139861,1732139861.51511,-21600,,
com.apple.finder,1,1732139561,1732139562,1732139562.690392,-21600,,
com.google.Chrome,38,1732139523,1732139561,1732139561.72081,-21600,,
com.microsoft.Outlook,16,1732139507,1732139523,1732139523.291889,-21600,,
com.google.Chrome,13,1732139494,1732139507,1732139507.555378,-21600,,
com.apple.finder,3,1732139491,1732139494,1732139494.082777,-21600,,
com.microsoft.VSCode,765,1732138726,1732139491,1732139491.936331,-21600,,
com.google.Chrome,2,1732138724,1732138726,1732138726.668092,-21600,,
com.apple.Passwords,1,1732138723,1732138724,1732138724.244801,-21600,,
com.google.Chrome,48,1732138675,1732138723,1732138723.424464,-21600,,
com.leomehlig.today,37,1732138638,1732138675,1732138675.177678,-21600,,
com.apple.finder,7,1732138631,1732138638,1732138638.225985,-21600,,
com.leomehlig.today,22,1732138609,1732138631,1732138631.114028,-21600,,
com.apple.finder,13,1732138596,1732138609,1732138609.466686,-21600,,
com.leomehlig.today,21,1732138575,1732138596,1732138596.640949,-21600,,
com.google.Chrome,7,1732138568,1732138575,1732138576.243541,-21600,,
com.apple.MobileSMS,56,1732138504,1732138560,1732138560.7262158,-21600,EB445137-D7F5-57EC-87DA-1DB460D64046,"iPhone13,2"
com.apple.MobileSMS,24,1732138472,1732138496,1732138496.911397,-21600,EB445137-D7F5-57EC-87DA-1DB460D64046,"iPhone13,2"
com.google.Chrome,588,1732136624,1732137212,1732137212.498598,-21600,,
com.apple.news,14,1732132805,1732132819,1732132819.54357,-21600,EB445137-D7F5-57EC-87DA-1DB460D64046,"iPhone13,2"
com.apple.news,1,1732132561,1732132562,1732132562.650763,-21600,EB445137-D7F5-57EC-87DA-1DB460D64046,"iPhone13,2"
com.google.Chrome,20,1732131768,1732131788,1732131788.867313,-21600,,
com.apple.Passwords,7,1732131761,1732131768,1732131768.0787,-21600,,
com.google.Chrome,2,1732131759,1732131761,1732131761.894768,-21600,,
com.apple.news,4,1732131051,1732131055,1732131055.134855,-21600,EB445137-D7F5-57EC-87DA-1DB460D64046,"iPhone13,2"
com.google.Chrome,711,1732129697,1732130408,1732130408.444821,-21600,,
com.apple.news,3,1732129393,1732129396,1732129396.485537,-21600,EB445137-D7F5-57EC-87DA-1DB460D64046,"iPhone13,2"
com.apple.news,12,1732129318,1732129330,1732129330.478756,-21600,EB445137-D7F5-57EC-87DA-1DB460D64046,"iPhone13,2"
com.apple.news,303,1732129014,1732129317,1732129317.392735,-21600,EB445137-D7F5-57EC-87DA-1DB460D64046,"iPhone13,2"
com.google.Chrome,275,1732128118,1732128393,1732128393.487041,-21600,,
com.leomehlig.today,8,1732128110,1732128118,1732128118.6934772,-21600,,
com.apple.iCal,6,1732128104,1732128110,1732128110.849288,-21600,,
com.apple.mobilecal,35,1732128096,1732128131,1732128131.185307,-21600,EB445137-D7F5-57EC-87DA-1DB460D64046,"iPhone13,2"
com.apple.news,5,1732128082,1732128087,1732128087.9884892,-21600,EB445137-D7F5-57EC-87DA-1DB460D64046,"iPhone13,2"
com.apple.weather,7,1732128066,1732128073,1732128073.703401,-21600,EB445137-D7F5-57EC-87DA-1DB460D64046,"iPhone13,2"
com.apple.weather,48,1732128015,1732128063,1732128063.165726,-21600,EB445137-D7F5-57EC-87DA-1DB460D64046,"iPhone13,2"
com.microsoft.Office.Outlook,8,1732127996,1732128004,1732128004.899173,-21600,EB445137-D7F5-57EC-87DA-1DB460D64046,"iPhone13,2"
com.instructure.icanvas,22,1732127938,1732127960,1732127960.519131,-21600,EB445137-D7F5-57EC-87DA-1DB460D64046,"iPhone13,2"
com.apple.MobileSMS,8,1732127930,1732127938,1732127938.872665,-21600,EB445137-D7F5-57EC-87DA-1DB460D64046,"iPhone13,2"
com.google.Chrome,237,1732127867,1732128104,1732128104.358993,-21600,,
com.google.Chrome,433,1732127372,1732127805,1732127805.934325,-21600,,
com.google.Chrome,301,1732126837,1732127138,1732127138.635956,-21600,,
com.apple.MobileSMS,38,1732124643,1732124681,1732124681.627571,-21600,EB445137-D7F5-57EC-87DA-1DB460D64046,"iPhone13,2"
com.hammerandchisel.discord,1,1732124642,1732124643,1732124643.820921,-21600,EB445137-D7F5-57EC-87DA-1DB460D64046,"iPhone13,2"
com.google.Chrome,840,1732124288,1732125128,1732125128.226655,-21600,,
com.apple.Health,36,1732123968,1732124004,1732124004.1376781,-21600,EB445137-D7F5-57EC-87DA-1DB460D64046,"iPhone13,2"
com.apple.MobileSMS,3,1732123965,1732123968,1732123969.261704,-21600,EB445137-D7F5-57EC-87DA-1DB460D64046,"iPhone13,2"
com.google.Chrome,444,1732123818,1732124262,1732124262.807822,-21600,,
com.google.Chrome,460,1732123349,1732123809,1732123809.571094,-21600,,
com.apple.MobileSMS,33,1732123316,1732123349,1732123349.306258,-21600,,
com.apple.MobileSMS,91,1732123311,1732123402,1732123402.1480021,-21600,EB445137-D7F5-57EC-87DA-1DB460D64046,"iPhone13,2"
com.apple.journal,4,1732123307,1732123311,1732123311.8516889,-21600,EB445137-D7F5-57EC-87DA-1DB460D64046,"iPhone13,2"
com.google.Chrome,12,1732123304,1732123316,1732123317.002048,-21600,,
com.apple.MobileSMS,2,1732123302,1732123304,1732123304.233708,-21600,,
com.google.Chrome,2,1732123300,1732123302,1732123302.179618,-21600,,
com.apple.MobileSMS,7,1732123293,1732123300,1732123300.49516,-21600,,
com.google.Chrome,3,1732123290,1732123293,1732123293.923614,-21600,,
com.apple.MobileSMS,35,1732123255,1732123290,1732123290.964522,-21600,,
com.google.Chrome,79,1732123176,1732123255,1732123255.545473,-21600,,
com.leomehlig.today,3,1732123173,1732123176,1732123177.144328,-21600,,
com.apple.journal,8,1732123137,1732123145,1732123145.956547,-21600,EB445137-D7F5-57EC-87DA-1DB460D64046,"iPhone13,2"
com.apple.journal,9,1732121825,1732121834,1732121834.88427,-21600,EB445137-D7F5-57EC-87DA-1DB460D64046,"iPhone13,2"
com.apple.journal,4,1732121331,1732121335,1732121335.649149,-21600,EB445137-D7F5-57EC-87DA-1DB460D64046,"iPhone13,2"
com.apple.journal,1,1732118401,1732118402,1732118402.759945,-21600,EB445137-D7F5-57EC-87DA-1DB460D64046,"iPhone13,2"
com.apple.camera,12,1732118385,1732118397,1732118398.323364,-21600,EB445137-D7F5-57EC-87DA-1DB460D64046,"iPhone13,2"
com.apple.journal,15,1732118383,1732118398,1732118398.499926,-21600,EB445137-D7F5-57EC-87DA-1DB460D64046,"iPhone13,2"
com.apple.journal,3,1732118355,1732118358,1732118358.120944,-21600,EB445137-D7F5-57EC-87DA-1DB460D64046,"iPhone13,2"
com.apple.journal,2,1732118318,1732118320,1732118320.1007152,-21600,EB445137-D7F5-57EC-87DA-1DB460D64046,"iPhone13,2"
com.apple.journal,3,1732118221,1732118224,1732118224.9946861,-21600,EB445137-D7F5-57EC-87DA-1DB460D64046,"iPhone13,2"
com.apple.journal,1,1732118220,1732118221,1732118221.5413451,-21600,EB445137-D7F5-57EC-87DA-1DB460D64046,"iPhone13,2"
com.leomehlig.today,3,1732117539,1732117542,1732117542.524152,-21600,,
com.apple.iCal,26,1732117513,1732117539,1732117539.116373,-21600,,
com.leomehlig.today,94,1732117419,1732117513,1732117513.383851,-21600,,
com.apple.journal,315,1732117162,1732117477,1732117477.821831,-21600,EB445137-D7F5-57EC-87DA-1DB460D64046,"iPhone13,2"
com.apple.Health,2,1732117156,1732117158,1732117158.752009,-21600,EB445137-D7F5-57EC-87DA-1DB460D64046,"iPhone13,2"
com.apple.iCal,327,1732117092,1732117419,1732117419.6109638,-21600,,
com.apple.Health,10,1732117090,1732117100,1732117100.159687,-21600,EB445137-D7F5-57EC-87DA-1DB460D64046,"iPhone13,2"
com.leomehlig.today,15,1732117077,1732117092,1732117093.0171819,-21600,,
com.google.Chrome,2,1732117075,1732117077,1732117077.329376,-21600,,
com.leomehlig.today,6,1732117069,1732117075,1732117075.155561,-21600,,
com.apple.Health,10,1732117058,1732117068,1732117068.919106,-21600,EB445137-D7F5-57EC-87DA-1DB460D64046,"iPhone13,2"
com.toyopagroup.picaboo,30,1732117026,1732117056,1732117056.137371,-21600,EB445137-D7F5-57EC-87DA-1DB460D64046,"iPhone13,2"
com.microsoft.Office.Outlook,20,1732116342,1732116362,1732116362.317275,-21600,EB445137-D7F5-57EC-87DA-1DB460D64046,"iPhone13,2"
com.apple.news,4,1732116338,1732116342,1732116343.7688642,-21600,EB445137-D7F5-57EC-87DA-1DB460D64046,"iPhone13,2"
com.apple.news,1,1732116337,1732116338,1732116338.3316169,-21600,EB445137-D7F5-57EC-87DA-1DB460D64046,"iPhone13,2"
com.leomehlig.today,318,1732116194,1732116512,1732116512.70473,-21600,,
com.apple.news,46,1732116142,1732116188,1732116189.1594028,-21600,EB445137-D7F5-57EC-87DA-1DB460D64046,"iPhone13,2"
com.facebook.Facebook,47,1732116043,1732116090,1732116090.133936,-21600,EB445137-D7F5-57EC-87DA-1DB460D64046,"iPhone13,2"
com.facebook.Facebook,39,1732115998,1732116037,1732116037.6615682,-21600,EB445137-D7F5-57EC-87DA-1DB460D64046,"iPhone13,2"
com.apple.weather,7,1732115991,1732115998,1732115998.9948401,-21600,EB445137-D7F5-57EC-87DA-1DB460D64046,"iPhone13,2"
com.apple.weather,64,1732115442,1732115506,1732115506.715891,-21600,EB445137-D7F5-57EC-87DA-1DB460D64046,"iPhone13,2"
com.renpho.health,3,1732115439,1732115442,1732115442.433405,-21600,EB445137-D7F5-57EC-87DA-1DB460D64046,"iPhone13,2"
com.renpho.health,66,1732115357,1732115423,1732115423.781225,-21600,EB445137-D7F5-57EC-87DA-1DB460D64046,"iPhone13,2"
com.thestorygraph.thestorygraph,65,1732081215,1732081280,1732081280.249641,-21600,EB445137-D7F5-57EC-87DA-1DB460D64046,"iPhone13,2"
com.thestorygraph.thestorygraph,12,1732079981,1732079993,1732079993.8937712,-21600,EB445137-D7F5-57EC-87DA-1DB460D64046,"iPhone13,2"
com.apple.camera,1,1732079978,1732079979,1732079980.940964,-21600,EB445137-D7F5-57EC-87DA-1DB460D64046,"iPhone13,2"
com.thestorygraph.thestorygraph,12,1732079967,1732079979,1732079980.995019,-21600,EB445137-D7F5-57EC-87DA-1DB460D64046,"iPhone13,2"
com.thestorygraph.thestorygraph,13,1732079831,1732079844,1732079845.3325639,-21600,EB445137-D7F5-57EC-87DA-1DB460D64046,"iPhone13,2"
com.thestorygraph.thestorygraph,11,1732079794,1732079805,1732079805.759831,-21600,EB445137-D7F5-57EC-87DA-1DB460D64046,"iPhone13,2"
com.apple.news,4,1732079790,1732079794,1732079794.096514,-21600,EB445137-D7F5-57EC-87DA-1DB460D64046,"iPhone13,2"
com.leomehlig.today,6,1732079652,1732079658,1732079658.611771,-21600,,
com.google.Chrome,881,1732078771,1732079652,1732079652.281224,-21600,,
com.google.Chrome,488,1732078275,1732078763,1732078763.109867,-21600,,
com.google.Chrome,563,1732077510,1732078073,1732078073.521914,-21600,,
com.apple.news,11,1732077001,1732077012,1732077012.0449219,-21600,EB445137-D7F5-57EC-87DA-1DB460D64046,"iPhone13,2"
com.google.Chrome,424,1732076809,1732077233,1732077233.480407,-21600,,
com.apple.news,42,1732075983,1732076025,1732076025.818851,-21600,EB445137-D7F5-57EC-87DA-1DB460D64046,"iPhone13,2"
com.google.Chrome,592,1732075945,1732076537,1732076537.34267,-21600,,
com.apple.news,10,1732075802,1732075812,1732075812.279408,-21600,EB445137-D7F5-57EC-87DA-1DB460D64046,"iPhone13,2"
com.google.Chrome,650,1732075188,1732075838,1732075838.377814,-21600,,
com.apple.news,6,1732074848,1732074854,1732074854.422533,-21600,EB445137-D7F5-57EC-87DA-1DB460D64046,"iPhone13,2"
com.google.Chrome,313,1732074266,1732074579,1732074579.963959,-21600,,
com.google.Chrome,354,1732073901,1732074255,1732074255.610602,-21600,,
com.google.Chrome,312,1732073577,1732073889,1732073889.2509499,-21600,,
com.google.Chrome,313,1732072849,1732073162,1732073162.644257,-21600,,
com.google.Chrome,477,1732072019,1732072496,1732072496.085311,-21600,,
com.apple.news,85,1732071084,1732071169,1732071170.079986,-21600,EB445137-D7F5-57EC-87DA-1DB460D64046,"iPhone13,2"
com.google.Chrome,2596,1732069401,1732071997,1732071997.3310971,-21600,,
com.microsoft.Outlook,6,1732069395,1732069401,1732069401.756717,-21600,,
com.google.Chrome,33,1732069362,1732069395,1732069395.513408,-21600,,
com.leomehlig.today,15,1732069347,1732069362,1732069362.9647331,-21600,,
com.apple.iCal,2,1732069345,1732069347,1732069347.901253,-21600,,
com.leomehlig.today,20,1732069325,1732069345,1732069345.04446,-21600,,
com.google.Chrome,5,1732069320,1732069325,1732069325.773024,-21600,,
com.microsoft.VSCode,11,1732069309,1732069320,1732069321.442692,-21600,,
com.google.Chrome,452,1732068857,1732069309,1732069309.219544,-21600,,
com.apple.news,11,1732067727,1732067738,1732067738.943293,-21600,EB445137-D7F5-57EC-87DA-1DB460D64046,"iPhone13,2"
com.apple.news,2,1732067679,1732067681,1732067682.0045938,-21600,EB445137-D7F5-57EC-87DA-1DB460D64046,"iPhone13,2"
com.toyopagroup.picaboo,15,1732067652,1732067667,1732067667.926834,-21600,EB445137-D7F5-57EC-87DA-1DB460D64046,"iPhone13,2"
com.apple.news,2,1732067650,1732067652,1732067653.154595,-21600,EB445137-D7F5-57EC-87DA-1DB460D64046,"iPhone13,2"
com.google.Chrome,304,1732067270,1732067574,1732067575.257196,-21600,,
com.apple.news,6,1732066784,1732066790,1732066790.1956449,-21600,EB445137-D7F5-57EC-87DA-1DB460D64046,"iPhone13,2"
com.apple.news,6,1732066758,1732066764,1732066764.473071,-21600,EB445137-D7F5-57EC-87DA-1DB460D64046,"iPhone13,2"
com.apple.news,6,1732066623,1732066629,1732066629.2858438,-21600,EB445137-D7F5-57EC-87DA-1DB460D64046,"iPhone13,2"
com.microsoft.VSCode,940,1732066330,1732067270,1732067270.942288,-21600,,
com.apple.news,6,1732066180,1732066186,1732066186.328412,-21600,EB445137-D7F5-57EC-87DA-1DB460D64046,"iPhone13,2"
com.apple.news,188,1732065896,1732066084,1732066085.370188,-21600,EB445137-D7F5-57EC-87DA-1DB460D64046,"iPhone13,2"
com.apple.news,90,1732065755,1732065845,1732065845.985975,-21600,EB445137-D7F5-57EC-87DA-1DB460D64046,"iPhone13,2"
com.apple.news,1,1732065753,1732065754,1732065755.030549,-21600,EB445137-D7F5-57EC-87DA-1DB460D64046,"iPhone13,2"
com.microsoft.Office.Outlook,6,1732065744,1732065750,1732065750.029948,-21600,EB445137-D7F5-57EC-87DA-1DB460D64046,"iPhone13,2"
com.hammerandchisel.discord,3,1732065741,1732065744,1732065744.836566,-21600,EB445137-D7F5-57EC-87DA-1DB460D64046,"iPhone13,2"
com.microsoft.VSCode,304,1732065731,1732066035,1732066035.33062,-21600,,
com.google.Chrome,33,1732065698,1732065731,1732065731.4186192,-21600,,
com.microsoft.VSCode,24,1732065674,1732065698,1732065698.396519,-21600,,
com.hammerandchisel.discord,39,1732065632,1732065671,1732065671.963728,-21600,EB445137-D7F5-57EC-87DA-1DB460D64046,"iPhone13,2"
com.microsoft.Office.Outlook,5,1732065627,1732065632,1732065632.428345,-21600,EB445137-D7F5-57EC-87DA-1DB460D64046,"iPhone13,2"
com.toyopagroup.picaboo,20,1732065605,1732065625,1732065625.229187,-21600,EB445137-D7F5-57EC-87DA-1DB460D64046,"iPhone13,2"
com.microsoft.VSCode,578,1732064759,1732065337,1732065337.7994518,-21600,,
com.google.Chrome,3,1732064756,1732064759,1732064759.1374888,-21600,,
com.toyopagroup.picaboo,1,1732064447,1732064448,1732064448.442647,-21600,EB445137-D7F5-57EC-87DA-1DB460D64046,"iPhone13,2"
com.toyopagroup.picaboo,6,1732064440,1732064446,1732064447.185421,-21600,EB445137-D7F5-57EC-87DA-1DB460D64046,"iPhone13,2"
com.tinyspeck.chatlyio,4,1732064436,1732064440,1732064440.9908729,-21600,EB445137-D7F5-57EC-87DA-1DB460D64046,"iPhone13,2"
com.tinyspeck.chatlyio,6,1732064084,1732064090,1732064090.435267,-21600,EB445137-D7F5-57EC-87DA-1DB460D64046,"iPhone13,2"
com.tinyspeck.chatlyio,2,1732064081,1732064083,1732064083.439493,-21600,EB445137-D7F5-57EC-87DA-1DB460D64046,"iPhone13,2"
com.tinyspeck.chatlyio,7,1732064046,1732064053,1732064053.635006,-21600,EB445137-D7F5-57EC-87DA-1DB460D64046,"iPhone13,2"
com.microsoft.Office.Outlook,16,1732063703,1732063719,1732063719.813941,-21600,EB445137-D7F5-57EC-87DA-1DB460D64046,"iPhone13,2"
com.toyopagroup.picaboo,12,1732063686,1732063698,1732063698.186496,-21600,EB445137-D7F5-57EC-87DA-1DB460D64046,"iPhone13,2"
com.tinyspeck.chatlyio,15,1732063668,1732063683,1732063683.872457,-21600,EB445137-D7F5-57EC-87DA-1DB460D64046,"iPhone13,2"
com.google.Chrome,423,1732063376,1732063799,1732063799.67905,-21600,,
com.google.Chrome,309,1732062966,1732063275,1732063275.128875,-21600,,
com.google.Chrome,590,1732062263,1732062853,1732062853.65036,-21600,,
com.toyopagroup.picaboo,15,1732061161,1732061176,1732061176.6684952,-21600,EB445137-D7F5-57EC-87DA-1DB460D64046,"iPhone13,2"
com.google.Chrome,1148,1732060828,1732061976,1732061976.339396,-21600,,
com.google.Chrome,675,1732060000,1732060675,1732060675.083074,-21600,,
com.microsoft.Outlook,10,1732059990,1732060000,1732060000.650841,-21600,,
com.google.Chrome,105,1732059885,1732059990,1732059990.070901,-21600,,
com.toyopagroup.picaboo,14,1732059819,1732059833,1732059833.399699,-21600,EB445137-D7F5-57EC-87DA-1DB460D64046,"iPhone13,2"
com.toyopagroup.picaboo,72,1732059695,1732059767,1732059767.554597,-21600,EB445137-D7F5-57EC-87DA-1DB460D64046,"iPhone13,2"
com.google.chrome.ios,8,1732059687,1732059695,1732059696.288827,-21600,EB445137-D7F5-57EC-87DA-1DB460D64046,"iPhone13,2"
com.google.Chrome,253,1732058462,1732058715,1732058715.573674,-21600,,
com.leomehlig.today,19,1732058443,1732058462,1732058462.7594051,-21600,,
com.google.Chrome,277,1732058166,1732058443,1732058443.748699,-21600,,
com.google.Chrome,311,1732057834,1732058145,1732058145.5120091,-21600,,
com.google.Chrome,313,1732057515,1732057828,1732057828.313946,-21600,,
com.google.chrome.ios,22,1732057191,1732057213,1732057214.070232,-21600,EB445137-D7F5-57EC-87DA-1DB460D64046,"iPhone13,2"
com.google.Chrome,312,1732056986,1732057298,1732057298.235791,-21600,,
com.toyopagroup.picaboo,37,1732056660,1732056697,1732056697.991148,-21600,EB445137-D7F5-57EC-87DA-1DB460D64046,"iPhone13,2"
com.apple.news,4,1732056656,1732056660,1732056660.990394,-21600,EB445137-D7F5-57EC-87DA-1DB460D64046,"iPhone13,2"
com.google.Chrome,3,1732056197,1732056200,1732056200.522538,-21600,,
com.microsoft.VSCode,986,1732055211,1732056197,1732056197.2015262,-21600,,
com.google.Chrome,144,1732055067,1732055211,1732055211.486648,-21600,,
com.microsoft.VSCode,439,1732054628,1732055067,1732055067.702626,-21600,,
com.google.Chrome,2,1732054626,1732054628,1732054628.905015,-21600,,
com.microsoft.VSCode,3,1732054623,1732054626,1732054626.431325,-21600,,
com.google.Chrome,1,1732054622,1732054623,1732054623.5636601,-21600,,
com.microsoft.VSCode,5,1732054617,1732054622,1732054622.193972,-21600,,
com.google.Chrome,17,1732054600,1732054617,1732054617.701324,-21600,,
com.microsoft.VSCode,9,1732054591,1732054600,1732054600.773664,-21600,,
com.google.Chrome,9,1732054582,1732054591,1732054591.941873,-21600,,
com.microsoft.VSCode,6,1732054576,1732054582,1732054582.228819,-21600,,
com.google.Chrome,4,1732054572,1732054576,1732054576.371584,-21600,,
com.microsoft.VSCode,16,1732054556,1732054572,1732054572.343889,-21600,,
com.google.Chrome,6,1732054550,1732054556,1732054556.7646651,-21600,,
com.microsoft.VSCode,23,1732054527,1732054550,1732054550.132043,-21600,,
com.google.Chrome,56,1732054471,1732054527,1732054527.511334,-21600,,
com.leomehlig.today,16,1732054455,1732054471,1732054471.0689259,-21600,,
com.google.Chrome,87,1732054368,1732054455,1732054455.3128629,-21600,,
com.microsoft.VSCode,268,1732054100,1732054368,1732054368.873999,-21600,,
com.google.Chrome,152,1732053948,1732054100,1732054100.217317,-21600,,
com.microsoft.VSCode,439,1732053509,1732053948,1732053948.1644,-21600,,
com.leomehlig.today,5,1732053504,1732053509,1732053509.232603,-21600,,
com.microsoft.Excel,10,1732053494,1732053504,1732053504.793637,-21600,,
com.leomehlig.today,8,1732053486,1732053494,1732053494.670687,-21600,,
com.microsoft.Excel,2,1732053484,1732053486,1732053486.607895,-21600,,
com.leomehlig.today,1,1732053483,1732053484,1732053484.7215672,-21600,,
com.microsoft.Excel,1,1732053482,1732053483,1732053483.967485,-21600,,
com.leomehlig.today,0,1732053482,1732053482,1732053482.959635,-21600,,
com.microsoft.Excel,3,1732053479,1732053482,1732053482.314147,-21600,,
com.leomehlig.today,2,1732053477,1732053479,1732053479.750601,-21600,,
com.microsoft.Excel,2,1732053475,1732053477,1732053477.325875,-21600,,
com.leomehlig.today,1,1732053474,1732053475,1732053476.0358949,-21600,,
com.microsoft.Excel,2,1732053472,1732053474,1732053474.7730598,-21600,,
com.leomehlig.today,4,1732053468,1732053472,1732053472.9554539,-21600,,
com.microsoft.Excel,3,1732053465,1732053468,1732053468.611702,-21600,,
com.leomehlig.today,4,1732053461,1732053465,1732053465.2674599,-21600,,
com.microsoft.Excel,3,1732053458,1732053461,1732053461.0449371,-21600,,
com.leomehlig.today,6,1732053452,1732053458,1732053458.547443,-21600,,
com.microsoft.Excel,3,1732053449,1732053452,1732053452.4348202,-21600,,
com.leomehlig.today,7,1732053442,1732053449,1732053449.604333,-21600,,
com.microsoft.Excel,3,1732053439,1732053442,1732053442.727953,-21600,,
com.leomehlig.today,5,1732053434,1732053439,1732053439.685481,-21600,,
com.microsoft.Excel,3,1732053431,1732053434,1732053434.507484,-21600,,
com.leomehlig.today,8,1732053423,1732053431,1732053431.160413,-21600,,
com.microsoft.Excel,1,1732053422,1732053423,1732053423.819933,-21600,,
com.leomehlig.today,1,1732053421,1732053422,1732053422.9769402,-21600,,
com.microsoft.Excel,1,1732053420,1732053421,1732053421.180165,-21600,,
com.leomehlig.today,5,1732053415,1732053420,1732053420.420497,-21600,,
com.microsoft.Excel,1,1732053414,1732053415,1732053415.533657,-21600,,
com.leomehlig.today,5,1732053409,1732053414,1732053414.285581,-21600,,
com.microsoft.Excel,3,1732053406,1732053409,1732053409.798902,-21600,,
com.leomehlig.today,1,1732053405,1732053406,1732053406.7763581,-21600,,
com.microsoft.Excel,3,1732053402,1732053405,1732053405.776854,-21600,,
com.leomehlig.today,7,1732053395,1732053402,1732053402.8694391,-21600,,
com.microsoft.Excel,2,1732053393,1732053395,1732053395.442224,-21600,,
com.leomehlig.today,6,1732053387,1732053393,1732053393.393626,-21600,,
com.microsoft.Excel,1,1732053386,1732053387,1732053387.9919,-21600,,
com.leomehlig.today,11,1732053375,1732053386,1732053386.3100882,-21600,,
com.microsoft.Excel,2,1732053373,1732053375,1732053375.901093,-21600,,
com.leomehlig.today,4,1732053369,1732053373,1732053373.762504,-21600,,
com.microsoft.Excel,1,1732053368,1732053369,1732053369.3825932,-21600,,
com.leomehlig.today,1,1732053367,1732053368,1732053369.0220451,-21600,,
com.microsoft.VSCode,1,1732053366,1732053367,1732053367.920693,-21600,,
com.apple.finder,1,1732053365,1732053366,1732053366.962946,-21600,,
com.microsoft.Excel,13,1732053352,1732053365,1732053365.9905891,-21600,,
com.apple.finder,23,1732053329,1732053352,1732053352.5710359,-21600,,
com.microsoft.VSCode,3,1732053326,1732053329,1732053329.338448,-21600,,
com.apple.finder,13,1732053313,1732053326,1732053326.539618,-21600,,
com.leomehlig.today,89,1732053224,1732053313,1732053313.124258,-21600,,
com.apple.iCal,23,1732053201,1732053224,1732053224.766974,-21600,,
com.leomehlig.today,37,1732053164,1732053201,1732053201.766083,-21600,,
com.apple.iCal,8,1732053156,1732053164,1732053164.671651,-21600,,
com.leomehlig.today,1,1732053155,1732053156,1732053156.5892801,-21600,,
com.apple.iCal,5,1732053150,1732053155,1732053155.211647,-21600,,
com.leomehlig.today,21,1732053129,1732053150,1732053150.186369,-21600,,
com.apple.iCal,5,1732053124,1732053129,1732053129.799492,-21600,,
com.leomehlig.today,39,1732053085,1732053124,1732053124.719832,-21600,,
com.google.Chrome,221,1732052864,1732053085,1732053085.503738,-21600,,
com.apple.finder,12,1732052852,1732052864,1732052864.267863,-21600,,
com.google.Chrome,29,1732052823,1732052852,1732052852.974666,-21600,,
com.apple.finder,1,1732052822,1732052823,1732052823.945403,-21600,,
com.google.Chrome,10,1732052812,1732052822,1732052822.7777991,-21600,,
com.apple.finder,18,1732052794,1732052812,1732052812.878809,-21600,,
com.google.Chrome,211,1732052583,1732052794,1732052794.411419,-21600,,
com.apple.finder,17,1732052566,1732052583,1732052583.305194,-21600,,
com.leomehlig.today,73,1732052493,1732052566,1732052566.926332,-21600,,
com.apple.finder,6,1732052487,1732052493,1732052493.8873792,-21600,,
com.google.Chrome,390,1732052097,1732052487,1732052487.617962,-21600,,
com.leomehlig.today,1,1732052096,1732052097,1732052097.280478,-21600,,
com.apple.iCal,2,1732052094,1732052096,1732052096.189533,-21600,,
com.leomehlig.today,21,1732052073,1732052094,1732052094.647005,-21600,,
com.apple.iCal,7,1732052066,1732052073,1732052073.4638329,-21600,,
com.leomehlig.today,21,1732052045,1732052066,1732052066.549556,-21600,,
com.google.Chrome,10,1732052035,1732052045,1732052045.465272,-21600,,
com.apple.news,20,1732051265,1732051285,1732051285.807867,-21600,EB445137-D7F5-57EC-87DA-1DB460D64046,"iPhone13,2"
com.microsoft.Office.Outlook,5,1732051217,1732051222,1732051222.924866,-21600,EB445137-D7F5-57EC-87DA-1DB460D64046,"iPhone13,2"
com.instructure.icanvas,36,1732051177,1732051213,1732051213.0611072,-21600,EB445137-D7F5-57EC-87DA-1DB460D64046,"iPhone13,2"
com.apple.news,114,1732051058,1732051172,1732051172.0071669,-21600,EB445137-D7F5-57EC-87DA-1DB460D64046,"iPhone13,2"
com.hammerandchisel.discord,121,1732050926,1732051047,1732051047.400848,-21600,EB445137-D7F5-57EC-87DA-1DB460D64046,"iPhone13,2"
com.apple.Health,41,1732050885,1732050926,1732050926.302812,-21600,EB445137-D7F5-57EC-87DA-1DB460D64046,"iPhone13,2"
com.google.chrome.ios,55,1732050828,1732050883,1732050883.387439,-21600,EB445137-D7F5-57EC-87DA-1DB460D64046,"iPhone13,2"
us.parkmobile.ParkMobile,45,1732045746,1732045791,1732045791.829793,-21600,EB445137-D7F5-57EC-87DA-1DB460D64046,"iPhone13,2"
com.apple.Music,2,1732045736,1732045738,1732045738.4911819,-21600,EB445137-D7F5-57EC-87DA-1DB460D64046,"iPhone13,2"
com.apple.Music,4,1732045359,1732045363,1732045363.984673,-21600,EB445137-D7F5-57EC-87DA-1DB460D64046,"iPhone13,2"
com.apple.Music,19,1732045205,1732045224,1732045224.523633,-21600,EB445137-D7F5-57EC-87DA-1DB460D64046,"iPhone13,2"
com.apple.Music,13,1732044844,1732044857,1732044857.3718739,-21600,EB445137-D7F5-57EC-87DA-1DB460D64046,"iPhone13,2"
com.apple.camera,3,1732044844,1732044847,1732044847.0978,-21600,EB445137-D7F5-57EC-87DA-1DB460D64046,"iPhone13,2"
com.apple.Music,2,1732044834,1732044836,1732044836.506058,-21600,EB445137-D7F5-57EC-87DA-1DB460D64046,"iPhone13,2"
com.apple.Music,11,1732044501,1732044512,1732044512.102001,-21600,EB445137-D7F5-57EC-87DA-1DB460D64046,"iPhone13,2"
com.apple.Music,9,1732043976,1732043985,1732043990.47086,-21600,EB445137-D7F5-57EC-87DA-1DB460D64046,"iPhone13,2"
com.google.Chrome,3,1732043746,1732043749,1732043749.811002,-21600,,
com.apple.Health,26,1732043602,1732043628,1732043628.393664,-21600,EB445137-D7F5-57EC-87DA-1DB460D64046,"iPhone13,2"
com.apple.Health,11,1732043585,1732043596,1732043596.2250628,-21600,EB445137-D7F5-57EC-87DA-1DB460D64046,"iPhone13,2"
com.apple.news,94,1732043480,1732043574,1732043574.974162,-21600,EB445137-D7F5-57EC-87DA-1DB460D64046,"iPhone13,2"
com.apple.news,17,1732043458,1732043475,1732043475.3558831,-21600,EB445137-D7F5-57EC-87DA-1DB460D64046,"iPhone13,2"
com.apple.news,5,1732043432,1732043437,1732043437.238151,-21600,EB445137-D7F5-57EC-87DA-1DB460D64046,"iPhone13,2"
com.apple.news,1,1732043429,1732043430,1732043430.485929,-21600,EB445137-D7F5-57EC-87DA-1DB460D64046,"iPhone13,2"
com.apple.news,3,1732043032,1732043035,1732043035.3209891,-21600,EB445137-D7F5-57EC-87DA-1DB460D64046,"iPhone13,2"
com.apple.news,55,1732042615,1732042670,1732042671.192017,-21600,EB445137-D7F5-57EC-87DA-1DB460D64046,"iPhone13,2"
com.microsoft.Office.Outlook,16,1732042593,1732042609,1732042609.48623,-21600,EB445137-D7F5-57EC-87DA-1DB460D64046,"iPhone13,2"
com.hammerandchisel.discord,4,1732042589,1732042593,1732042593.94629,-21600,EB445137-D7F5-57EC-87DA-1DB460D64046,"iPhone13,2"
com.hammerandchisel.discord,10,1732042482,1732042492,1732042492.727983,-21600,EB445137-D7F5-57EC-87DA-1DB460D64046,"iPhone13,2"
com.hammerandchisel.discord,10,1732042339,1732042349,1732042349.459893,-21600,EB445137-D7F5-57EC-87DA-1DB460D64046,"iPhone13,2"
com.hammerandchisel.discord,47,1732041882,1732041929,1732041929.3474889,-21600,EB445137-D7F5-57EC-87DA-1DB460D64046,"iPhone13,2"
com.toyopagroup.picaboo,1,1732041875,1732041876,1732041877.226438,-21600,EB445137-D7F5-57EC-87DA-1DB460D64046,"iPhone13,2"
com.apple.news,2,1732041873,1732041875,1732041875.974376,-21600,EB445137-D7F5-57EC-87DA-1DB460D64046,"iPhone13,2"
com.apple.news,17,1732041183,1732041200,1732041200.492803,-21600,EB445137-D7F5-57EC-87DA-1DB460D64046,"iPhone13,2"
com.microsoft.Office.Outlook,28,1732041128,1732041156,1732041156.8516111,-21600,EB445137-D7F5-57EC-87DA-1DB460D64046,"iPhone13,2"
com.apple.news,4,1732041124,1732041128,1732041128.539248,-21600,EB445137-D7F5-57EC-87DA-1DB460D64046,"iPhone13,2"
com.apple.news,10,1732040411,1732040421,1732040421.345759,-21600,EB445137-D7F5-57EC-87DA-1DB460D64046,"iPhone13,2"
com.apple.news,46,1732040364,1732040410,1732040410.3713899,-21600,EB445137-D7F5-57EC-87DA-1DB460D64046,"iPhone13,2"
com.google.Chrome,580,1732038926,1732039506,1732039506.1230168,-21600,,
com.leomehlig.today,9,1732038917,1732038926,1732038926.212369,-21600,,
com.google.Chrome,2,1732038915,1732038917,1732038917.7700992,-21600,,
com.leomehlig.today,13,1732038902,1732038915,1732038915.1656241,-21600,,
com.google.Chrome,17,1732038885,1732038902,1732038902.349183,-21600,,
com.google.Chrome,226,1732037767,1732037993,1732037993.094358,-21600,,
com.apple.finder,44,1732037723,1732037767,1732037767.10177,-21600,,
com.google.Chrome,1012,1732036711,1732037723,1732037723.3934479,-21600,,
com.apple.iCal,77,1732036634,1732036711,1732036712.038857,-21600,,
com.google.Chrome,21,1732036613,1732036634,1732036634.61523,-21600,,
com.apple.finder,39,1732036574,1732036613,1732036613.365819,-21600,,
com.google.Chrome,629,1732035945,1732036574,1732036574.385013,-21600,,
com.apple.iCal,63,1732035882,1732035945,1732035945.968503,-21600,,
com.google.Chrome,50,1732035832,1732035882,1732035882.138941,-21600,,
com.google.Chrome,144,1732034429,1732034573,1732034573.4099112,-21600,,
com.microsoft.Office.Outlook,11,1732034201,1732034212,1732034212.198762,-21600,EB445137-D7F5-57EC-87DA-1DB460D64046,"iPhone13,2"
com.robinhood.release.Robinhood,34,1732034091,1732034125,1732034125.319572,-21600,EB445137-D7F5-57EC-87DA-1DB460D64046,"iPhone13,2"
com.hammerandchisel.discord,9,1732033994,1732034003,1732034003.449542,-21600,EB445137-D7F5-57EC-87DA-1DB460D64046,"iPhone13,2"
com.google.Chrome,498,1732033728,1732034226,1732034226.46647,-21600,,
com.truebill.truebillnative,330,1732033447,1732033777,1732033777.345032,-21600,EB445137-D7F5-57EC-87DA-1DB460D64046,"iPhone13,2"
com.apple.news,45,1732033369,1732033414,1732033414.9572868,-21600,EB445137-D7F5-57EC-87DA-1DB460D64046,"iPhone13,2"
com.apple.MobileSMS,2,1732033325,1732033327,1732033327.671437,-21600,EB445137-D7F5-57EC-87DA-1DB460D64046,"iPhone13,2"
com.apple.Health,4,1732033313,1732033317,1732033317.275525,-21600,EB445137-D7F5-57EC-87DA-1DB460D64046,"iPhone13,2"
com.google.Chrome,865,1732032849,1732033714,1732033714.929234,-21600,,
com.apple.Photos,2,1732032847,1732032849,1732032849.647546,-21600,,
com.google.Chrome,2,1732032845,1732032847,1732032847.5705361,-21600,,
com.apple.Photos,10,1732032835,1732032845,1732032845.521661,-21600,,
com.google.Chrome,136,1732032699,1732032835,1732032835.191893,-21600,,
com.leomehlig.today,32,1732032667,1732032699,1732032699.1381469,-21600,,
com.google.Chrome,8,1732032659,1732032667,1732032667.570506,-21600,,
com.hnc.Discord,1,1732032658,1732032659,1732032659.8163118,-21600,,
com.microsoft.VSCode,47,1732032611,1732032658,1732032658.120995,-21600,,
com.hnc.Discord,1,1732032610,1732032611,1732032611.53025,-21600,,
com.microsoft.VSCode,5,1732032605,1732032610,1732032610.2404919,-21600,,
com.google.Chrome,1,1732032604,1732032605,1732032605.253432,-21600,,
com.microsoft.VSCode,5,1732032599,1732032604,1732032604.465738,-21600,,
com.google.Chrome,0,1732032599,1732032599,1732032600.0132818,-21600,,
com.microsoft.VSCode,4,1732032595,1732032599,1732032599.131448,-21600,,
com.google.Chrome,1,1732032594,1732032595,1732032595.68275,-21600,,
com.microsoft.VSCode,1,1732032593,1732032594,1732032594.6588778,-21600,,
com.google.Chrome,1,1732032592,1732032593,1732032593.362176,-21600,,
com.microsoft.VSCode,4,1732032588,1732032592,1732032592.714388,-21600,,
com.google.Chrome,2,1732032586,1732032588,1732032588.763824,-21600,,
com.microsoft.VSCode,1,1732032585,1732032586,1732032586.874337,-21600,,
com.google.Chrome,2,1732032583,1732032585,1732032585.832199,-21600,,
com.microsoft.VSCode,3,1732032580,1732032583,1732032583.754229,-21600,,
com.google.Chrome,1,1732032579,1732032580,1732032580.247967,-21600,,
com.microsoft.VSCode,2,1732032577,1732032579,1732032579.536384,-21600,,
com.google.Chrome,4,1732032573,1732032577,1732032577.444411,-21600,,
com.microsoft.VSCode,11,1732032562,1732032573,1732032573.087528,-21600,,
com.google.Chrome,1,1732032561,1732032562,1732032562.9316812,-21600,,
com.microsoft.VSCode,5,1732032556,1732032561,1732032561.891398,-21600,,
com.google.Chrome,1,1732032555,1732032556,1732032556.461684,-21600,,
com.microsoft.VSCode,10,1732032545,1732032555,1732032555.628862,-21600,,
com.google.Chrome,1,1732032544,1732032545,1732032545.699885,-21600,,
com.microsoft.VSCode,4,1732032540,1732032544,1732032544.830426,-21600,,
com.google.Chrome,0,1732032540,1732032540,1732032541.003261,-21600,,
com.microsoft.VSCode,4,1732032536,1732032540,1732032540.178948,-21600,,
com.google.Chrome,1,1732032535,1732032536,1732032536.8683639,-21600,,
com.microsoft.VSCode,4,1732032531,1732032535,1732032535.868962,-21600,,
com.google.Chrome,2,1732032529,1732032531,1732032532.072369,-21600,,
com.microsoft.VSCode,3,1732032526,1732032529,1732032529.802017,-21600,,
com.google.Chrome,1,1732032525,1732032526,1732032527.0109801,-21600,,
com.microsoft.VSCode,6,1732032519,1732032525,1732032525.6348948,-21600,,
com.google.Chrome,1,1732032518,1732032519,1732032519.1254249,-21600,,
com.microsoft.VSCode,1,1732032517,1732032518,1732032518.455096,-21600,,
com.google.Chrome,1,1732032516,1732032517,1732032517.737205,-21600,,
com.microsoft.VSCode,2,1732032514,1732032516,1732032516.6596498,-21600,,
com.google.Chrome,1,1732032513,1732032514,1732032514.438638,-21600,,
com.microsoft.VSCode,3,1732032510,1732032513,1732032513.190658,-21600,,
com.google.Chrome,1,1732032509,1732032510,1732032510.1594281,-21600,,
com.microsoft.VSCode,1,1732032508,1732032509,1732032509.3886719,-21600,,
com.google.Chrome,4,1732032504,1732032508,1732032508.143412,-21600,,
com.microsoft.VSCode,1,1732032503,1732032504,1732032504.915297,-21600,,
com.google.Chrome,1,1732032502,1732032503,1732032503.776226,-21600,,
com.microsoft.VSCode,0,1732032502,1732032502,1732032502.867923,-21600,,
com.google.Chrome,2,1732032500,1732032502,1732032502.1356301,-21600,,
com.microsoft.VSCode,3,1732032497,1732032500,1732032500.7751632,-21600,,
com.google.Chrome,0,1732032497,1732032497,1732032497.733494,-21600,,
com.microsoft.VSCode,16,1732032481,1732032497,1732032497.156539,-21600,,
com.google.Chrome,4,1732032477,1732032481,1732032481.174063,-21600,,
com.microsoft.VSCode,9,1732032468,1732032477,1732032477.8689098,-21600,,
com.google.Chrome,7,1732032461,1732032468,1732032468.758064,-21600,,
com.microsoft.VSCode,2,1732032459,1732032461,1732032461.905345,-21600,,
com.google.Chrome,10,1732032449,1732032459,1732032459.839335,-21600,,
com.microsoft.VSCode,495,1732031954,1732032449,1732032449.549464,-21600,,
com.google.Chrome,1,1732031953,1732031954,1732031954.312879,-21600,,
com.hnc.Discord,1,1732031952,1732031953,1732031953.811489,-21600,,
com.google.Chrome,4,1732031948,1732031952,1732031952.67033,-21600,,
com.hnc.Discord,1,1732031947,1732031948,1732031948.5406709,-21600,,
com.google.Chrome,40,1732031907,1732031947,1732031947.456352,-21600,,
com.hnc.Discord,2,1732031905,1732031907,1732031907.348123,-21600,,
com.microsoft.VSCode,374,1732031531,1732031905,1732031905.1089048,-21600,,
com.hnc.Discord,15,1732031516,1732031531,1732031531.708466,-21600,,
com.microsoft.VSCode,14,1732031502,1732031516,1732031516.988387,-21600,,
com.google.Chrome,1,1732031501,1732031502,1732031502.5466928,-21600,,
com.microsoft.VSCode,12,1732031489,1732031501,1732031501.556653,-21600,,
com.google.Chrome,21,1732031468,1732031489,1732031489.459224,-21600,,
com.hnc.Discord,5,1732031463,1732031468,1732031468.579002,-21600,,
com.microsoft.VSCode,121,1732031342,1732031463,1732031463.1739368,-21600,,
com.google.Chrome,11,1732031331,1732031342,1732031342.937763,-21600,,
com.microsoft.VSCode,176,1732031155,1732031331,1732031331.43918,-21600,,
com.google.Chrome,1,1732031154,1732031155,1732031155.344586,-21600,,
com.microsoft.VSCode,1,1732031153,1732031154,1732031154.2948909,-21600,,
com.google.Chrome,1,1732031152,1732031153,1732031153.1938019,-21600,,
com.microsoft.VSCode,6,1732031146,1732031152,1732031152.584402,-21600,,
com.google.Chrome,1,1732031145,1732031146,1732031146.809815,-21600,,
com.microsoft.VSCode,5,1732031140,1732031145,1732031146.012197,-21600,,
com.google.Chrome,1,1732031139,1732031140,1732031140.674677,-21600,,
com.microsoft.VSCode,7,1732031132,1732031139,1732031139.566617,-21600,,
com.google.Chrome,0,1732031132,1732031132,1732031132.732521,-21600,,
com.microsoft.VSCode,2,1732031130,1732031132,1732031132.161866,-21600,,
com.google.Chrome,1,1732031129,1732031130,1732031130.779767,-21600,,
com.microsoft.VSCode,1,1732031128,1732031129,1732031129.6990352,-21600,,
com.google.Chrome,2,1732031126,1732031128,1732031128.6523972,-21600,,
com.microsoft.VSCode,1,1732031125,1732031126,1732031126.995656,-21600,,
com.google.Chrome,2,1732031123,1732031125,1732031125.926677,-21600,,
com.microsoft.VSCode,7,1732031116,1732031123,1732031123.928124,-21600,,
com.google.Chrome,0,1732031116,1732031116,1732031117.041203,-21600,,
com.microsoft.VSCode,11,1732031105,1732031116,1732031116.378806,-21600,,
com.google.Chrome,4,1732031101,1732031105,1732031105.742677,-21600,,
com.microsoft.VSCode,7,1732031094,1732031101,1732031101.178883,-21600,,
com.google.Chrome,0,1732031094,1732031094,1732031096.6244369,-21600,,
com.microsoft.VSCode,11,1732031083,1732031094,1732031094.152786,-21600,,
com.google.Chrome,1,1732031082,1732031083,1732031083.577419,-21600,,
com.microsoft.VSCode,8,1732031074,1732031082,1732031082.836906,-21600,,
com.google.Chrome,1,1732031073,1732031074,1732031074.5423908,-21600,,
com.microsoft.VSCode,2,1732031071,1732031073,1732031073.6161098,-21600,,
com.google.Chrome,1,1732031070,1732031071,1732031071.727684,-21600,,
com.microsoft.VSCode,8,1732031062,1732031070,1732031070.77614,-21600,,
com.google.Chrome,1,1732031061,1732031062,1732031062.949726,-21600,,
com.microsoft.VSCode,2,1732031059,1732031061,1732031061.542616,-21600,,
com.google.Chrome,1,1732031058,1732031059,1732031059.1509252,-21600,,
com.microsoft.VSCode,3,1732031055,1732031058,1732031058.567563,-21600,,
com.google.Chrome,0,1732031055,1732031055,1732031055.8741841,-21600,,
com.microsoft.VSCode,1,1732031054,1732031055,1732031055.2670069,-21600,,
com.google.Chrome,2,1732031052,1732031054,1732031054.309679,-21600,,
com.microsoft.VSCode,3,1732031049,1732031052,1732031052.780007,-21600,,
com.google.Chrome,5,1732031044,1732031049,1732031049.2047582,-21600,,
com.microsoft.VSCode,1,1732031043,1732031044,1732031044.497428,-21600,,
com.google.Chrome,1,1732031042,1732031043,1732031043.109847,-21600,,
com.microsoft.VSCode,4,1732031038,1732031042,1732031042.148438,-21600,,
com.google.Chrome,2,1732031036,1732031038,1732031038.5473418,-21600,,
com.microsoft.VSCode,2,1732031034,1732031036,1732031036.982575,-21600,,
com.google.Chrome,1,1732031033,1732031034,1732031034.301629,-21600,,
com.microsoft.VSCode,5,1732031028,1732031033,1732031033.483232,-21600,,
com.google.Chrome,1,1732031027,1732031028,1732031028.186192,-21600,,
com.microsoft.VSCode,22,1732031005,1732031027,1732031027.511965,-21600,,
com.google.Chrome,13,1732030992,1732031005,1732031005.943533,-21600,,
com.microsoft.VSCode,413,1732030579,1732030992,1732030992.969778,-21600,,
com.google.Chrome,6,1732030573,1732030579,1732030579.531141,-21600,,
com.microsoft.VSCode,7,1732030566,1732030573,1732030573.8055658,-21600,,
com.google.Chrome,2,1732030564,1732030566,1732030566.6844149,-21600,,
com.microsoft.VSCode,5,1732030559,1732030564,1732030565.026187,-21600,,
com.google.Chrome,2,1732030557,1732030559,1732030559.3220549,-21600,,
com.microsoft.VSCode,7,1732030550,1732030557,1732030557.5057302,-21600,,
com.google.Chrome,2,1732030548,1732030550,1732030550.8437319,-21600,,
com.microsoft.VSCode,11,1732030537,1732030548,1732030548.991216,-21600,,
com.google.Chrome,1,1732030536,1732030537,1732030537.854671,-21600,,
com.microsoft.VSCode,6,1732030530,1732030536,1732030536.336711,-21600,,
com.google.Chrome,22,1732030508,1732030530,1732030531.014429,-21600,,
com.microsoft.VSCode,131,1732030377,1732030508,1732030508.3693252,-21600,,
com.google.Chrome,31,1732030346,1732030377,1732030377.849245,-21600,,
com.microsoft.VSCode,354,1732029992,1732030346,1732030346.314156,-21600,,
com.google.Chrome,3,1732029989,1732029992,1732029992.277251,-21600,,
com.microsoft.VSCode,44,1732029945,1732029989,1732029989.509649,-21600,,
com.google.Chrome,18,1732029927,1732029945,1732029945.5852752,-21600,,
com.microsoft.VSCode,31,1732029896,1732029927,1732029927.720152,-21600,,
com.google.Chrome,1,1732029895,1732029896,1732029897.047052,-21600,,
com.microsoft.VSCode,4,1732029891,1732029895,1732029895.800331,-21600,,
com.google.Chrome,32,1732029859,1732029891,1732029891.182416,-21600,,
com.microsoft.VSCode,393,1732029466,1732029859,1732029859.057376,-21600,,
com.apple.finder,1,1732029465,1732029466,1732029467.551245,-21600,,
com.microsoft.VSCode,1,1732029464,1732029465,1732029465.751601,-21600,,
com.apple.finder,27,1732029437,1732029464,1732029464.402492,-21600,,
com.google.Chrome,24,1732029413,1732029437,1732029437.4977741,-21600,,
com.google.Chrome,466,1732028570,1732029036,1732029036.095027,-21600,,
com.apple.finder,4,1732028554,1732028558,1732028559.509503,-21600,,
com.renpho.health,59,1732028468,1732028527,1732028527.669451,-21600,EB445137-D7F5-57EC-87DA-1DB460D64046,"iPhone13,2"
com.apple.mobiletimer,27,1732028437,1732028464,1732028464.466759,-21600,EB445137-D7F5-57EC-87DA-1DB460D64046,"iPhone13,2"
com.apple.mobiletimer,17,1732027410,1732027427,1732027427.707087,-21600,EB445137-D7F5-57EC-87DA-1DB460D64046,"iPhone13,2"
com.apple.mobiletimer,17,1732026863,1732026880,1732026880.993763,-21600,EB445137-D7F5-57EC-87DA-1DB460D64046,"iPhone13,2"
com.apple.mobiletimer,32,1732026301,1732026333,1732026333.802446,-21600,EB445137-D7F5-57EC-87DA-1DB460D64046,"iPhone13,2"
com.apple.mobiletimer,13,1731995774,1731995787,1731995787.5210562,-21600,EB445137-D7F5-57EC-87DA-1DB460D64046,"iPhone13,2"
com.apple.mobiletimer,6,1731995765,1731995771,1731995771.523432,-21600,EB445137-D7F5-57EC-87DA-1DB460D64046,"iPhone13,2"
com.thestorygraph.thestorygraph,11,1731995748,1731995759,1731995759.279295,-21600,EB445137-D7F5-57EC-87DA-1DB460D64046,"iPhone13,2"
com.apple.journal,7,1731995741,1731995748,1731995748.445984,-21600,EB445137-D7F5-57EC-87DA-1DB460D64046,"iPhone13,2"
com.apple.journal,13,1731995725,1731995738,1731995738.6376882,-21600,EB445137-D7F5-57EC-87DA-1DB460D64046,"iPhone13,2"
com.apple.journal,10,1731995688,1731995698,1731995698.856744,-21600,EB445137-D7F5-57EC-87DA-1DB460D64046,"iPhone13,2"
com.apple.journal,22,1731995659,1731995681,1731995681.55716,-21600,EB445137-D7F5-57EC-87DA-1DB460D64046,"iPhone13,2"
com.apple.journal,93,1731995555,1731995648,1731995649.312316,-21600,EB445137-D7F5-57EC-87DA-1DB460D64046,"iPhone13,2"
com.thestorygraph.thestorygraph,2,1731995553,1731995555,1731995555.768602,-21600,EB445137-D7F5-57EC-87DA-1DB460D64046,"iPhone13,2"
com.apple.news,21,1731993120,1731993141,1731993141.469713,-21600,EB445137-D7F5-57EC-87DA-1DB460D64046,"iPhone13,2"
com.apple.Health,24,1731993079,1731993103,1731993103.322814,-21600,EB445137-D7F5-57EC-87DA-1DB460D64046,"iPhone13,2"
com.apple.journal,747,1731992327,1731993074,1731993074.360312,-21600,EB445137-D7F5-57EC-87DA-1DB460D64046,"iPhone13,2"
com.instructure.icanvas,9,1731992316,1731992325,1731992325.566818,-21600,EB445137-D7F5-57EC-87DA-1DB460D64046,"iPhone13,2"
com.apple.news,12,1731992304,1731992316,1731992316.9914188,-21600,EB445137-D7F5-57EC-87DA-1DB460D64046,"iPhone13,2"
com.apple.finder,21,1731992283,1731992304,1731992304.508584,-21600,,
com.apple.Photos,297,1731991986,1731992283,1731992283.082838,-21600,,
com.google.Chrome,21,1731991965,1731991986,1731991986.675734,-21600,,
com.leomehlig.today,11,1731991954,1731991965,1731991965.4851441,-21600,,
com.google.Chrome,25,1731991929,1731991954,1731991954.095804,-21600,,
com.google.Chrome,60,1731991243,1731991303,1731991303.5819058,-21600,,
com.google.Chrome,353,1731990876,1731991229,1731991229.989553,-21600,,
com.apple.news,72,1731990440,1731990512,1731990513.018599,-21600,EB445137-D7F5-57EC-87DA-1DB460D64046,"iPhone13,2"
com.apple.news,10,1731989633,1731989643,1731989644.1340818,-21600,EB445137-D7F5-57EC-87DA-1DB460D64046,"iPhone13,2"
com.apple.news,54,1731989524,1731989578,1731989579.2696218,-21600,EB445137-D7F5-57EC-87DA-1DB460D64046,"iPhone13,2"
com.google.Chrome,554,1731989392,1731989946,1731989946.020601,-21600,,
com.apple.news,51,1731988765,1731988816,1731988816.7229052,-21600,EB445137-D7F5-57EC-87DA-1DB460D64046,"iPhone13,2"
com.apple.news,3,1731988564,1731988567,1731988568.0728421,-21600,EB445137-D7F5-57EC-87DA-1DB460D64046,"iPhone13,2"
com.google.Chrome,613,1731988495,1731989108,1731989108.404691,-21600,,
com.apple.news,4,1731987897,1731987901,1731987901.265759,-21600,EB445137-D7F5-57EC-87DA-1DB460D64046,"iPhone13,2"
com.apple.news,57,1731987838,1731987895,1731987895.3799062,-21600,EB445137-D7F5-57EC-87DA-1DB460D64046,"iPhone13,2"
com.microsoft.Office.Outlook,11,1731987812,1731987823,1731987823.401699,-21600,EB445137-D7F5-57EC-87DA-1DB460D64046,"iPhone13,2"
com.google.Chrome,872,1731986872,1731987744,1731987744.434167,-21600,,
com.microsoft.Office.Outlook,23,1731986427,1731986450,1731986451.212466,-21600,EB445137-D7F5-57EC-87DA-1DB460D64046,"iPhone13,2"
com.apple.Music,10,1731986417,1731986427,1731986428.0268989,-21600,EB445137-D7F5-57EC-87DA-1DB460D64046,"iPhone13,2"
com.google.Chrome,615,1731986136,1731986751,1731986751.1808782,-21600,,
com.apple.Music,4,1731984911,1731984915,1731984915.112701,-21600,EB445137-D7F5-57EC-87DA-1DB460D64046,"iPhone13,2"
com.google.Chrome,937,1731984861,1731985798,1731985798.6009731,-21600,,
com.google.Chrome,1118,1731983600,1731984718,1731984718.866414,-21600,,
com.google.Chrome,596,1731982864,1731983460,1731983460.445897,-21600,,
com.apple.Music,3,1731982125,1731982128,1731982128.509711,-21600,EB445137-D7F5-57EC-87DA-1DB460D64046,"iPhone13,2"
com.apple.Music,10,1731981798,1731981808,1731981808.0506458,-21600,EB445137-D7F5-57EC-87DA-1DB460D64046,"iPhone13,2"
com.apple.Music,2,1731981793,1731981795,1731981795.470065,-21600,EB445137-D7F5-57EC-87DA-1DB460D64046,"iPhone13,2"
com.apple.Music,28,1731981160,1731981188,1731981188.9548988,-21600,EB445137-D7F5-57EC-87DA-1DB460D64046,"iPhone13,2"
com.apple.weather,5,1731981143,1731981148,1731981148.284109,-21600,EB445137-D7F5-57EC-87DA-1DB460D64046,"iPhone13,2"
com.apple.weather,14,1731981061,1731981075,1731981075.254198,-21600,EB445137-D7F5-57EC-87DA-1DB460D64046,"iPhone13,2"
com.google.Chrome,771,1731980136,1731980907,1731980907.0585861,-21600,,
com.google.Chrome,325,1731978594,1731978919,1731978919.421437,-21600,,
com.leomehlig.today,4,1731978590,1731978594,1731978594.116427,-21600,,
com.google.Chrome,3,1731978587,1731978590,1731978590.341501,-21600,,
com.leomehlig.today,7,1731978580,1731978587,1731978589.112355,-21600,,
com.google.Chrome,11,1731978569,1731978580,1731978580.563891,-21600,,
com.google.ios.youtube,1761,1731976512,1731978273,1731978273.6819801,-21600,EB445137-D7F5-57EC-87DA-1DB460D64046,"iPhone13,2"
com.google.chrome.ios,7,1731976501,1731976508,1731976508.944646,-21600,EB445137-D7F5-57EC-87DA-1DB460D64046,"iPhone13,2"
com.google.Chrome,2,1731976489,1731976491,1731976491.974035,-21600,,
com.leomehlig.today,0,1731976489,1731976489,1731976489.604992,-21600,,
com.microsoft.VSCode,5,1731976484,1731976489,1731976489.14716,-21600,,
com.google.Chrome,8,1731976476,1731976484,1731976484.393964,-21600,,
com.microsoft.VSCode,140,1731976336,1731976476,1731976477.003319,-21600,,
com.google.Chrome,102,1731976234,1731976336,1731976336.1810489,-21600,,
com.microsoft.VSCode,6,1731976228,1731976234,1731976234.057934,-21600,,
com.google.Chrome,38,1731976190,1731976228,1731976228.596412,-21600,,
com.microsoft.VSCode,3,1731976187,1731976190,1731976190.1766028,-21600,,
com.google.Chrome,2,1731976185,1731976187,1731976187.309513,-21600,,
com.microsoft.VSCode,53,1731976132,1731976185,1731976185.35928,-21600,,
com.google.Chrome,0,1731976132,1731976132,1731976133.035084,-21600,,
com.microsoft.VSCode,98,1731976034,1731976132,1731976132.491908,-21600,,
com.google.Chrome,2,1731976032,1731976034,1731976034.500489,-21600,,
com.microsoft.VSCode,130,1731975902,1731976032,1731976032.620215,-21600,,
com.google.Chrome,2,1731975900,1731975902,1731975902.259934,-21600,,
com.microsoft.VSCode,11,1731975889,1731975900,1731975900.346298,-21600,,
com.google.Chrome,10,1731975879,1731975889,1731975889.265799,-21600,,
com.microsoft.VSCode,56,1731975823,1731975879,1731975879.878223,-21600,,
com.apple.Dictionary,1,1731975822,1731975823,1731975823.751287,-21600,,
com.google.Chrome,3,1731975819,1731975822,1731975822.849041,-21600,,
com.apple.Dictionary,1,1731975818,1731975819,1731975819.267587,-21600,,
com.google.Chrome,4,1731975814,1731975818,1731975818.5232658,-21600,,
com.microsoft.VSCode,2,1731975812,1731975814,1731975814.569696,-21600,,
com.google.Chrome,49,1731975763,1731975812,1731975812.766387,-21600,,
com.microsoft.VSCode,149,1731975614,1731975763,1731975764.016861,-21600,,
com.google.Chrome,4,1731975610,1731975614,1731975614.298147,-21600,,
com.apple.iCal,1,1731975609,1731975610,1731975610.804147,-21600,,
com.microsoft.VSCode,16,1731975593,1731975609,1731975609.6240401,-21600,,
com.apple.iCal,0,1731975593,1731975593,1731975594.012675,-21600,,
com.google.Chrome,4,1731975589,1731975593,1731975593.297128,-21600,,
com.apple.iCal,1,1731975588,1731975589,1731975589.780383,-21600,,
com.microsoft.VSCode,11,1731975577,1731975588,1731975588.924501,-21600,,
com.apple.iCal,1,1731975576,1731975577,1731975577.863275,-21600,,
com.google.Chrome,16,1731975560,1731975576,1731975576.925822,-21600,,
com.apple.iCal,1,1731975559,1731975560,1731975560.637282,-21600,,
com.microsoft.VSCode,6,1731975553,1731975559,1731975559.686733,-21600,,
com.apple.iCal,6,1731975547,1731975553,1731975553.234181,-21600,,
com.google.Chrome,11,1731975536,1731975547,1731975547.168329,-21600,,
com.apple.iCal,0,1731975536,1731975536,1731975536.832973,-21600,,
com.microsoft.VSCode,28,1731975508,1731975536,1731975536.092008,-21600,,
com.apple.iCal,1,1731975507,1731975508,1731975508.357774,-21600,,
com.google.Chrome,3,1731975504,1731975507,1731975507.572248,-21600,,
com.apple.iCal,1,1731975503,1731975504,1731975504.321893,-21600,,
com.microsoft.VSCode,7,1731975496,1731975503,1731975503.3832932,-21600,,
com.apple.iCal,1,1731975495,1731975496,1731975496.368377,-21600,,
com.google.Chrome,193,1731975302,1731975495,1731975495.559885,-21600,,
com.microsoft.VSCode,4,1731975298,1731975302,1731975302.7286181,-21600,,
com.google.Chrome,1,1731975297,1731975298,1731975298.7730389,-21600,,
com.apple.iCal,2,1731975295,1731975297,1731975297.3109632,-21600,,
com.google.Chrome,3,1731975292,1731975295,1731975295.462425,-21600,,
com.apple.iCal,1,1731975291,1731975292,1731975292.987824,-21600,,
com.leomehlig.today,1,1731975290,1731975291,1731975291.196784,-21600,,
com.google.Chrome,7,1731975283,1731975290,1731975290.311712,-21600,,
com.microsoft.VSCode,4,1731975279,1731975283,1731975283.254682,-21600,,
com.google.Chrome,25,1731975254,1731975279,1731975279.5192928,-21600,,
com.google.chrome.ios,14,1731975015,1731975029,1731975029.95438,-21600,EB445137-D7F5-57EC-87DA-1DB460D64046,"iPhone13,2"
com.microsoft.Office.Outlook,132,1731974882,1731975014,1731975016.149314,-21600,EB445137-D7F5-57EC-87DA-1DB460D64046,"iPhone13,2"
com.google.chrome.ios,22,1731974860,1731974882,1731974882.727669,-21600,EB445137-D7F5-57EC-87DA-1DB460D64046,"iPhone13,2"
com.microsoft.Office.Outlook,8,1731974852,1731974860,1731974860.174468,-21600,EB445137-D7F5-57EC-87DA-1DB460D64046,"iPhone13,2"
com.apple.MobileSMS,17,1731974835,1731974852,1731974852.374666,-21600,EB445137-D7F5-57EC-87DA-1DB460D64046,"iPhone13,2"
com.clairmail.fth.client,135,1731974700,1731974835,1731974835.4750772,-21600,EB445137-D7F5-57EC-87DA-1DB460D64046,"iPhone13,2"
com.apple.MobileSMS,3,1731974696,1731974699,1731974699.833582,-21600,EB445137-D7F5-57EC-87DA-1DB460D64046,"iPhone13,2"
com.google.ios.youtube,3,1731974693,1731974696,1731974696.559968,-21600,EB445137-D7F5-57EC-87DA-1DB460D64046,"iPhone13,2"
com.google.ios.youtube,205,1731974085,1731974290,1731974290.812089,-21600,EB445137-D7F5-57EC-87DA-1DB460D64046,"iPhone13,2"
com.microsoft.Office.Outlook,50,1731974030,1731974080,1731974080.171507,-21600,EB445137-D7F5-57EC-87DA-1DB460D64046,"iPhone13,2"
com.google.chrome.ios,27,1731974003,1731974030,1731974030.664916,-21600,EB445137-D7F5-57EC-87DA-1DB460D64046,"iPhone13,2"
com.microsoft.Office.Outlook,58,1731973945,1731974003,1731974003.880605,-21600,EB445137-D7F5-57EC-87DA-1DB460D64046,"iPhone13,2"
com.google.Chrome,322,1731973044,1731973366,1731973366.340862,-21600,,
com.microsoft.VSCode,5,1731973039,1731973044,1731973044.854621,-21600,,
com.google.Chrome,7,1731973032,1731973039,1731973039.857903,-21600,,
com.microsoft.VSCode,313,1731972719,1731973032,1731973032.642328,-21600,,
com.google.Chrome,2,1731972717,1731972719,1731972719.4388041,-21600,,
com.microsoft.VSCode,2,1731972715,1731972717,1731972717.0421329,-21600,,
com.google.Chrome,24,1731972691,1731972715,1731972715.4342818,-21600,,
com.microsoft.VSCode,6,1731972685,1731972691,1731972691.0579228,-21600,,
com.google.Chrome,0,1731972685,1731972685,1731972685.903151,-21600,,
com.microsoft.VSCode,3,1731972682,1731972685,1731972685.258037,-21600,,
com.google.Chrome,7,1731972675,1731972682,1731972682.334307,-21600,,
com.microsoft.VSCode,25,1731972650,1731972675,1731972675.235548,-21600,,
com.google.Chrome,5,1731972645,1731972650,1731972650.9009871,-21600,,
com.microsoft.VSCode,40,1731972605,1731972645,1731972645.81031,-21600,,
com.google.Chrome,24,1731972581,1731972605,1731972605.938637,-21600,,
com.microsoft.VSCode,10,1731972571,1731972581,1731972581.166082,-21600,,
com.google.Chrome,1,1731972570,1731972571,1731972571.632633,-21600,,
com.microsoft.VSCode,11,1731972559,1731972570,1731972570.6968222,-21600,,
com.google.Chrome,5,1731972554,1731972559,1731972559.652516,-21600,,
com.microsoft.VSCode,17,1731972537,1731972554,1731972554.914699,-21600,,
com.google.Chrome,17,1731972520,1731972537,1731972537.5144691,-21600,,
com.microsoft.VSCode,3,1731972517,1731972520,1731972520.080394,-21600,,
com.google.Chrome,5,1731972512,1731972517,1731972517.522029,-21600,,
com.microsoft.VSCode,2,1731972510,1731972512,1731972512.10285,-21600,,
com.google.Chrome,3,1731972507,1731972510,1731972510.873856,-21600,,
com.microsoft.VSCode,40,1731972467,1731972507,1731972507.948328,-21600,,
com.google.Chrome,9,1731972458,1731972467,1731972467.621502,-21600,,
com.microsoft.VSCode,2,1731972456,1731972458,1731972458.815217,-21600,,
com.google.Chrome,5,1731972451,1731972456,1731972456.651799,-21600,,
com.microsoft.VSCode,11,1731972440,1731972451,1731972451.851328,-21600,,
com.google.Chrome,30,1731972410,1731972440,1731972441.01599,-21600,,
com.microsoft.VSCode,28,1731972382,1731972410,1731972410.829102,-21600,,
com.google.Chrome,3,1731972379,1731972382,1731972382.2937531,-21600,,
com.microsoft.VSCode,2,1731972377,1731972379,1731972379.5649052,-21600,,
com.google.Chrome,1,1731972376,1731972377,1731972377.779062,-21600,,
com.microsoft.VSCode,9,1731972367,1731972376,1731972376.30723,-21600,,
com.google.Chrome,3,1731972364,1731972367,1731972367.503669,-21600,,
com.microsoft.VSCode,6,1731972358,1731972364,1731972364.560763,-21600,,
com.google.Chrome,8,1731972350,1731972358,1731972358.383636,-21600,,
com.microsoft.VSCode,13,1731972337,1731972350,1731972350.304491,-21600,,
com.google.Chrome,18,1731972319,1731972337,1731972337.85047,-21600,,
com.microsoft.VSCode,12,1731972307,1731972319,1731972319.456235,-21600,,
com.google.Chrome,2,1731972305,1731972307,1731972307.843093,-21600,,
com.microsoft.VSCode,89,1731972216,1731972305,1731972305.407164,-21600,,
com.google.Chrome,22,1731972194,1731972216,1731972216.309767,-21600,,
com.microsoft.VSCode,1,1731972193,1731972194,1731972194.6407099,-21600,,
com.google.Chrome,2,1731972191,1731972193,1731972193.5465388,-21600,,
com.microsoft.VSCode,13,1731972178,1731972191,1731972191.417993,-21600,,
com.google.Chrome,5,1731972173,1731972178,1731972178.8807921,-21600,,
com.microsoft.VSCode,2,1731972171,1731972173,1731972173.6689239,-21600,,
com.google.Chrome,3,1731972168,1731972171,1731972171.4100718,-21600,,
com.microsoft.VSCode,5,1731972163,1731972168,1731972168.428817,-21600,,
com.google.Chrome,0,1731972163,1731972163,1731972164.030875,-21600,,
com.microsoft.VSCode,4,1731972159,1731972163,1731972163.1337981,-21600,,
com.google.Chrome,19,1731972140,1731972159,1731972159.50709,-21600,,
com.microsoft.VSCode,19,1731972121,1731972140,1731972140.7908978,-21600,,
com.google.Chrome,103,1731972018,1731972121,1731972121.362916,-21600,,
com.microsoft.VSCode,28,1731971990,1731972018,1731972018.814683,-21600,,
com.google.Chrome,0,1731971990,1731971990,1731971991.013874,-21600,,
com.microsoft.VSCode,2,1731971988,1731971990,1731971990.195416,-21600,,
com.google.Chrome,1,1731971987,1731971988,1731971988.469497,-21600,,
com.microsoft.VSCode,11,1731971976,1731971987,1731971987.563459,-21600,,
com.google.Chrome,3,1731971973,1731971976,1731971976.68011,-21600,,
com.microsoft.VSCode,45,1731971928,1731971973,1731971973.790034,-21600,,
com.google.Chrome,25,1731971903,1731971928,1731971928.838512,-21600,,
com.microsoft.VSCode,35,1731971868,1731971903,1731971903.407676,-21600,,
com.google.Chrome,7,1731971861,1731971868,1731971868.356042,-21600,,
com.microsoft.VSCode,110,1731971751,1731971861,1731971861.242383,-21600,,
com.google.Chrome,7,1731971744,1731971751,1731971751.7165852,-21600,,
com.microsoft.VSCode,1,1731971743,1731971744,1731971744.620106,-21600,,
com.leomehlig.today,3,1731971740,1731971743,1731971743.914562,-21600,,
com.leomehlig.today,2,1731971284,1731971286,1731971286.973043,-21600,,
com.google.Chrome,1078,1731970206,1731971284,1731971284.704616,-21600,,
com.leomehlig.today,6,1731970200,1731970206,1731970206.3409948,-21600,,
com.microsoft.Office.Outlook,7,1731970150,1731970157,1731970157.138513,-21600,EB445137-D7F5-57EC-87DA-1DB460D64046,"iPhone13,2"
com.microsoft.Office.Outlook,61,1731970015,1731970076,1731970077.194097,-21600,EB445137-D7F5-57EC-87DA-1DB460D64046,"iPhone13,2"
com.google.Chrome,187,1731970013,1731970200,1731970200.070971,-21600,,
com.google.chrome.ios,6,1731970009,1731970015,1731970016.026949,-21600,EB445137-D7F5-57EC-87DA-1DB460D64046,"iPhone13,2"
com.apple.iCal,47,1731969966,1731970013,1731970013.7484279,-21600,,
com.microsoft.Office.Outlook,57,1731969952,1731970009,1731970009.682407,-21600,EB445137-D7F5-57EC-87DA-1DB460D64046,"iPhone13,2"
com.leomehlig.today,29,1731969937,1731969966,1731969966.266073,-21600,,
com.apple.MobileSMS,2,1731969790,1731969792,1731969792.735986,-21600,EB445137-D7F5-57EC-87DA-1DB460D64046,"iPhone13,2"
com.google.Chrome,385,1731969552,1731969937,1731969937.413848,-21600,,
com.apple.InCallService,433,1731969357,1731969790,1731969790.721359,-21600,EB445137-D7F5-57EC-87DA-1DB460D64046,"iPhone13,2"
com.apple.MobileSMS,31,1731969326,1731969357,1731969357.670315,-21600,EB445137-D7F5-57EC-87DA-1DB460D64046,"iPhone13,2"
com.apple.InCallService,139,1731969187,1731969326,1731969326.028595,-21600,EB445137-D7F5-57EC-87DA-1DB460D64046,"iPhone13,2"
com.leomehlig.today,2,1731969186,1731969188,1731969188.8038568,-21600,,
com.apple.InCallService,24,1731969047,1731969071,1731969071.0517712,-21600,EB445137-D7F5-57EC-87DA-1DB460D64046,"iPhone13,2"
com.leomehlig.today,322,1731968799,1731969121,1731969121.547361,-21600,,
com.apple.InCallService,1,1731968584,1731968585,1731968586.6926641,-21600,EB445137-D7F5-57EC-87DA-1DB460D64046,"iPhone13,2"
com.apple.MobileSMS,14,1731968570,1731968584,1731968585.1951509,-21600,EB445137-D7F5-57EC-87DA-1DB460D64046,"iPhone13,2"
com.instructure.icanvas,8,1731968560,1731968568,1731968569.071584,-21600,EB445137-D7F5-57EC-87DA-1DB460D64046,"iPhone13,2"
com.google.Chrome,259,1731968540,1731968799,1731968799.2219582,-21600,,
com.google.Chrome,4064,1731964428,1731968492,1731968492.975644,-21600,,
com.google.Chrome,314,1731964043,1731964357,1731964357.4340482,-21600,,
com.google.Chrome,300,1731963430,1731963730,1731963730.492992,-21600,,
com.google.Chrome,300,1731962693,1731962993,1731962993.301727,-21600,,
com.google.Chrome,301,1731962352,1731962653,1731962653.185573,-21600,,
com.google.Chrome,300,1731961771,1731962071,1731962071.727391,-21600,,
com.hammerandchisel.discord,14,1731961289,1731961303,1731961303.528831,-21600,EB445137-D7F5-57EC-87DA-1DB460D64046,"iPhone13,2"
com.google.Chrome,868,1731960543,1731961411,1731961411.026383,-21600,,
com.leomehlig.today,2,1731960541,1731960543,1731960543.483433,-21600,,
com.apple.Health,46,1731959076,1731959122,1731959122.765224,-21600,EB445137-D7F5-57EC-87DA-1DB460D64046,"iPhone13,2"
com.apple.camera,0,1731958726,1731958726,1731958726.4281049,-21600,EB445137-D7F5-57EC-87DA-1DB460D64046,"iPhone13,2"
com.apple.news,237,1731958469,1731958706,1731958706.395977,-21600,EB445137-D7F5-57EC-87DA-1DB460D64046,"iPhone13,2"
com.apple.news,121,1731958273,1731958394,1731958395.058168,-21600,EB445137-D7F5-57EC-87DA-1DB460D64046,"iPhone13,2"
com.apple.news,268,1731957953,1731958221,1731958221.813644,-21600,EB445137-D7F5-57EC-87DA-1DB460D64046,"iPhone13,2"
com.apple.camera,1,1731957953,1731957954,1731957954.2313619,-21600,EB445137-D7F5-57EC-87DA-1DB460D64046,"iPhone13,2"
com.apple.news,91,1731957700,1731957791,1731957791.521527,-21600,EB445137-D7F5-57EC-87DA-1DB460D64046,"iPhone13,2"
com.truebill.truebillnative,120,1731957309,1731957429,1731957429.328298,-21600,EB445137-D7F5-57EC-87DA-1DB460D64046,"iPhone13,2"
com.apple.mobileslideshow,2,1731957280,1731957282,1731957282.762913,-21600,EB445137-D7F5-57EC-87DA-1DB460D64046,"iPhone13,2"
com.apple.mobileslideshow,82,1731957070,1731957152,1731957152.188181,-21600,EB445137-D7F5-57EC-87DA-1DB460D64046,"iPhone13,2"
com.apple.news,3,1731957064,1731957067,1731957067.018492,-21600,EB445137-D7F5-57EC-87DA-1DB460D64046,"iPhone13,2"
com.apple.news,3,1731957042,1731957045,1731957045.608638,-21600,EB445137-D7F5-57EC-87DA-1DB460D64046,"iPhone13,2"
com.apple.camera,0,1731957039,1731957039,1731957039.5746598,-21600,EB445137-D7F5-57EC-87DA-1DB460D64046,"iPhone13,2"
com.apple.news,14,1731957027,1731957041,1731957041.624845,-21600,EB445137-D7F5-57EC-87DA-1DB460D64046,"iPhone13,2"
com.apple.news,18,1731956909,1731956927,1731956928.099782,-21600,EB445137-D7F5-57EC-87DA-1DB460D64046,"iPhone13,2"
com.apple.news,111,1731956685,1731956796,1731956796.226414,-21600,EB445137-D7F5-57EC-87DA-1DB460D64046,"iPhone13,2"
com.apple.news,3,1731956469,1731956472,1731956472.835001,-21600,EB445137-D7F5-57EC-87DA-1DB460D64046,"iPhone13,2"
com.apple.news,7,1731956393,1731956400,1731956400.4120111,-21600,EB445137-D7F5-57EC-87DA-1DB460D64046,"iPhone13,2"
com.leomehlig.today,4,1731956369,1731956373,1731956373.350916,-21600,,
com.google.Chrome,7,1731956362,1731956369,1731956369.2028608,-21600,,
com.leomehlig.today,38,1731956324,1731956362,1731956362.2667,-21600,,
com.google.Chrome,279,1731956045,1731956324,1731956324.183825,-21600,,
com.leomehlig.today,2,1731955547,1731955549,1731955549.276546,-21600,,
com.google.Chrome,7,1731955540,1731955547,1731955547.837998,-21600,,
com.leomehlig.today,16,1731955518,1731955534,1731955534.911869,-21600,,
com.apple.finder,18,1731955500,1731955518,1731955518.3251982,-21600,,
com.leomehlig.today,18,1731955482,1731955500,1731955500.7935681,-21600,,
com.google.Chrome,19,1731955463,1731955482,1731955482.290056,-21600,,
com.apple.news,2,1731955161,1731955163,1731955163.277914,-21600,EB445137-D7F5-57EC-87DA-1DB460D64046,"iPhone13,2"
com.apple.news,2,1731954967,1731954969,1731954969.9062839,-21600,EB445137-D7F5-57EC-87DA-1DB460D64046,"iPhone13,2"
com.apple.news,112,1731954704,1731954816,1731954817.1207051,-21600,EB445137-D7F5-57EC-87DA-1DB460D64046,"iPhone13,2"
com.apple.news,226,1731954476,1731954702,1731954702.708812,-21600,EB445137-D7F5-57EC-87DA-1DB460D64046,"iPhone13,2"
com.apple.news,81,1731953810,1731953891,1731953892.083842,-21600,EB445137-D7F5-57EC-87DA-1DB460D64046,"iPhone13,2"
com.apple.news,6,1731953794,1731953800,1731953800.950021,-21600,EB445137-D7F5-57EC-87DA-1DB460D64046,"iPhone13,2"
com.apple.news,4,1731953788,1731953792,1731953793.437424,-21600,EB445137-D7F5-57EC-87DA-1DB460D64046,"iPhone13,2"
com.google.ios.youtube,4,1731953777,1731953781,1731953781.5060282,-21600,EB445137-D7F5-57EC-87DA-1DB460D64046,"iPhone13,2"
com.google.ios.youtube,286,1731952963,1731953249,1731953250.1010442,-21600,EB445137-D7F5-57EC-87DA-1DB460D64046,"iPhone13,2"
com.apple.weather,37,1731952926,1731952963,1731952963.444429,-21600,EB445137-D7F5-57EC-87DA-1DB460D64046,"iPhone13,2"
com.apple.weather,6,1731952916,1731952922,1731952922.719868,-21600,EB445137-D7F5-57EC-87DA-1DB460D64046,"iPhone13,2"
com.google.Chrome,528,1731952644,1731953172,1731953172.188041,-21600,,
com.google.ios.youtube,1493,1731951149,1731952642,1731952643.500177,-21600,EB445137-D7F5-57EC-87DA-1DB460D64046,"iPhone13,2"
com.hammerandchisel.discord,107,1731951040,1731951147,1731951147.412118,-21600,EB445137-D7F5-57EC-87DA-1DB460D64046,"iPhone13,2"
com.apple.MobileSMS,2,1731951036,1731951038,1731951038.6999068,-21600,EB445137-D7F5-57EC-87DA-1DB460D64046,"iPhone13,2"
com.apple.PeopleViewService,3,1731951032,1731951035,1731951036.332089,-21600,EB445137-D7F5-57EC-87DA-1DB460D64046,"iPhone13,2"
com.google.chrome.ios,55,1731950940,1731950995,1731950995.32202,-21600,EB445137-D7F5-57EC-87DA-1DB460D64046,"iPhone13,2"
com.apple.mobilenotes,3,1731950930,1731950933,1731950933.976011,-21600,EB445137-D7F5-57EC-87DA-1DB460D64046,"iPhone13,2"
com.apple.mobilenotes,10,1731950848,1731950858,1731950858.2221851,-21600,EB445137-D7F5-57EC-87DA-1DB460D64046,"iPhone13,2"
com.apple.Health,58,1731950785,1731950843,1731950843.9883142,-21600,EB445137-D7F5-57EC-87DA-1DB460D64046,"iPhone13,2"
com.microsoft.Office.Outlook,5,1731950772,1731950777,1731950777.38286,-21600,EB445137-D7F5-57EC-87DA-1DB460D64046,"iPhone13,2"
com.microsoft.Office.Outlook,3,1731950760,1731950763,1731950763.52109,-21600,EB445137-D7F5-57EC-87DA-1DB460D64046,"iPhone13,2"
com.hammerandchisel.discord,54,1731950706,1731950760,1731950760.361114,-21600,EB445137-D7F5-57EC-87DA-1DB460D64046,"iPhone13,2"
com.clairmail.fth.client,2,1731950704,1731950706,1731950707.0637522,-21600,EB445137-D7F5-57EC-87DA-1DB460D64046,"iPhone13,2"
com.google.Chrome,311,1731950691,1731951002,1731951002.96704,-21600,,
com.apple.MobileSMS,8,1731950683,1731950691,1731950691.225235,-21600,,
com.google.Chrome,80,1731950603,1731950683,1731950683.4028978,-21600,,
com.apple.MobileSMS,5,1731950598,1731950603,1731950603.821395,-21600,,
com.leomehlig.today,38,1731950560,1731950598,1731950598.052082,-21600,,
com.apple.news,3,1731950557,1731950560,1731950560.363576,-21600,,
com.google.Chrome,8,1731950549,1731950557,1731950557.532196,-21600,,
com.clairmail.fth.client,37,1731949751,1731949788,1731949788.891418,-21600,EB445137-D7F5-57EC-87DA-1DB460D64046,"iPhone13,2"
com.apple.MobileSMS,2,1731949748,1731949750,1731949751.0214539,-21600,EB445137-D7F5-57EC-87DA-1DB460D64046,"iPhone13,2"
com.apple.MobileSMS,3,1731949386,1731949389,1731949389.823147,-21600,EB445137-D7F5-57EC-87DA-1DB460D64046,"iPhone13,2"
com.apple.MobileSMS,3,1731949248,1731949251,1731949251.758688,-21600,EB445137-D7F5-57EC-87DA-1DB460D64046,"iPhone13,2"
com.apple.weather,3,1731949245,1731949248,1731949249.648885,-21600,EB445137-D7F5-57EC-87DA-1DB460D64046,"iPhone13,2"
com.apple.weather,8,1731948623,1731948631,1731948632.165148,-21600,EB445137-D7F5-57EC-87DA-1DB460D64046,"iPhone13,2"
com.apple.weather,6,1731945384,1731945390,1731945390.088376,-21600,EB445137-D7F5-57EC-87DA-1DB460D64046,"iPhone13,2"
com.apple.weather,2,1731945381,1731945383,1731945383.434132,-21600,EB445137-D7F5-57EC-87DA-1DB460D64046,"iPhone13,2"
com.apple.weather,1,1731945222,1731945223,1731945224.0506802,-21600,EB445137-D7F5-57EC-87DA-1DB460D64046,"iPhone13,2"
com.apple.weather,7,1731943954,1731943961,1731943961.92267,-21600,EB445137-D7F5-57EC-87DA-1DB460D64046,"iPhone13,2"
com.renpho.health,2,1731943952,1731943954,1731943954.771471,-21600,EB445137-D7F5-57EC-87DA-1DB460D64046,"iPhone13,2"
com.renpho.health,56,1731943893,1731943949,1731943949.592938,-21600,EB445137-D7F5-57EC-87DA-1DB460D64046,"iPhone13,2"
com.apple.news,169,1731943049,1731943218,1731943218.8438702,-21600,EB445137-D7F5-57EC-87DA-1DB460D64046,"iPhone13,2"
com.apple.weather,3,1731943034,1731943037,1731943037.533566,-21600,EB445137-D7F5-57EC-87DA-1DB460D64046,"iPhone13,2"
com.apple.news,285,1731942709,1731942994,1731942994.880944,-21600,EB445137-D7F5-57EC-87DA-1DB460D64046,"iPhone13,2"
com.apple.mobiletimer,56,1731941669,1731941725,1731941725.293294,-21600,EB445137-D7F5-57EC-87DA-1DB460D64046,"iPhone13,2"
com.apple.mobiletimer,10,1731941133,1731941143,1731941143.1600652,-21600,EB445137-D7F5-57EC-87DA-1DB460D64046,"iPhone13,2"
com.apple.mobiletimer,24,1731941102,1731941126,1731941126.2660651,-21600,EB445137-D7F5-57EC-87DA-1DB460D64046,"iPhone13,2"
com.apple.mobiletimer,13,1731911869,1731911882,1731911882.474117,-21600,EB445137-D7F5-57EC-87DA-1DB460D64046,"iPhone13,2"
com.apple.mobiletimer,2,1731911864,1731911866,1731911866.412767,-21600,EB445137-D7F5-57EC-87DA-1DB460D64046,"iPhone13,2"
com.apple.mobiletimer,13,1731911851,1731911864,1731911864.468886,-21600,EB445137-D7F5-57EC-87DA-1DB460D64046,"iPhone13,2"
com.apple.Music,4,1731911847,1731911851,1731911851.6071692,-21600,EB445137-D7F5-57EC-87DA-1DB460D64046,"iPhone13,2"
com.apple.Music,44,1731911595,1731911639,1731911639.6801639,-21600,EB445137-D7F5-57EC-87DA-1DB460D64046,"iPhone13,2"
com.apple.Music,17,1731911331,1731911348,1731911348.89171,-21600,EB445137-D7F5-57EC-87DA-1DB460D64046,"iPhone13,2"
com.apple.Music,18,1731910970,1731910988,1731910988.350737,-21600,EB445137-D7F5-57EC-87DA-1DB460D64046,"iPhone13,2"
com.apple.Music,28,1731910915,1731910943,1731910943.751553,-21600,EB445137-D7F5-57EC-87DA-1DB460D64046,"iPhone13,2"
com.apple.Music,39,1731910695,1731910734,1731910735.0176911,-21600,EB445137-D7F5-57EC-87DA-1DB460D64046,"iPhone13,2"
com.apple.Music,22,1731910300,1731910322,1731910322.515625,-21600,EB445137-D7F5-57EC-87DA-1DB460D64046,"iPhone13,2"
com.apple.Music,2,1731910290,1731910292,1731910292.6085181,-21600,EB445137-D7F5-57EC-87DA-1DB460D64046,"iPhone13,2"
com.apple.Music,9,1731910154,1731910163,1731910164.0385752,-21600,EB445137-D7F5-57EC-87DA-1DB460D64046,"iPhone13,2"
com.apple.Music,30,1731910096,1731910126,1731910128.4066381,-21600,EB445137-D7F5-57EC-87DA-1DB460D64046,"iPhone13,2"
com.apple.news,4,1731910089,1731910093,1731910093.8671799,-21600,EB445137-D7F5-57EC-87DA-1DB460D64046,"iPhone13,2"
com.google.Chrome,2864,1731907015,1731909879,1731909880.2451859,-21600,,
com.google.Chrome,1002,1731905736,1731906738,1731906738.825015,-21600,,
com.apple.news,10,1731905715,1731905725,1731905725.870802,-21600,EB445137-D7F5-57EC-87DA-1DB460D64046,"iPhone13,2"
com.apple.news,1,1731905175,1731905176,1731905177.0238729,-21600,EB445137-D7F5-57EC-87DA-1DB460D64046,"iPhone13,2"
com.apple.news,81,1731904648,1731904729,1731904729.278222,-21600,EB445137-D7F5-57EC-87DA-1DB460D64046,"iPhone13,2"
com.apple.news,61,1731904190,1731904251,1731904251.782548,-21600,EB445137-D7F5-57EC-87DA-1DB460D64046,"iPhone13,2"
com.apple.news,16,1731903764,1731903780,1731903781.086357,-21600,EB445137-D7F5-57EC-87DA-1DB460D64046,"iPhone13,2"
com.apple.news,6,1731902619,1731902625,1731902625.062221,-21600,EB445137-D7F5-57EC-87DA-1DB460D64046,"iPhone13,2"
com.apple.news,5,1731902233,1731902238,1731902238.451957,-21600,EB445137-D7F5-57EC-87DA-1DB460D64046,"iPhone13,2"
com.apple.news,12,1731902219,1731902231,1731902231.830124,-21600,EB445137-D7F5-57EC-87DA-1DB460D64046,"iPhone13,2"
com.apple.news,67,1731901839,1731901906,1731901906.678149,-21600,EB445137-D7F5-57EC-87DA-1DB460D64046,"iPhone13,2"
com.apple.news,5,1731901466,1731901471,1731901471.621605,-21600,EB445137-D7F5-57EC-87DA-1DB460D64046,"iPhone13,2"
com.apple.news,2,1731901385,1731901387,1731901387.147665,-21600,EB445137-D7F5-57EC-87DA-1DB460D64046,"iPhone13,2"
com.apple.news,10,1731901373,1731901383,1731901383.8107228,-21600,EB445137-D7F5-57EC-87DA-1DB460D64046,"iPhone13,2"
com.apple.news,48,1731901264,1731901312,1731901312.462709,-21600,EB445137-D7F5-57EC-87DA-1DB460D64046,"iPhone13,2"
com.apple.camera,1,1731895715,1731895716,1731895716.279811,-21600,EB445137-D7F5-57EC-87DA-1DB460D64046,"iPhone13,2"
com.apple.camera,6,1731895602,1731895608,1731895608.477417,-21600,EB445137-D7F5-57EC-87DA-1DB460D64046,"iPhone13,2"
com.ally.MobileBanking,15,1731894269,1731894284,1731894284.922742,-21600,EB445137-D7F5-57EC-87DA-1DB460D64046,"iPhone13,2"
com.google.chrome.ios,17,1731894245,1731894262,1731894262.785573,-21600,EB445137-D7F5-57EC-87DA-1DB460D64046,"iPhone13,2"
com.google.chrome.ios,83,1731893970,1731894053,1731894053.285569,-21600,EB445137-D7F5-57EC-87DA-1DB460D64046,"iPhone13,2"
com.google.chrome.ios,3,1731892976,1731892979,1731892979.250468,-21600,EB445137-D7F5-57EC-87DA-1DB460D64046,"iPhone13,2"
com.google.chrome.ios,2,1731892973,1731892975,1731892975.2417068,-21600,EB445137-D7F5-57EC-87DA-1DB460D64046,"iPhone13,2"
com.google.chrome.ios,56,1731892771,1731892827,1731892828.129074,-21600,EB445137-D7F5-57EC-87DA-1DB460D64046,"iPhone13,2"
com.google.chrome.ios,29,1731892559,1731892588,1731892588.795563,-21600,EB445137-D7F5-57EC-87DA-1DB460D64046,"iPhone13,2"
com.google.chrome.ios,68,1731891873,1731891941,1731891941.608728,-21600,EB445137-D7F5-57EC-87DA-1DB460D64046,"iPhone13,2"
com.google.chrome.ios,13,1731891294,1731891307,1731891307.144751,-21600,EB445137-D7F5-57EC-87DA-1DB460D64046,"iPhone13,2"
com.google.Chrome,108,1731889650,1731889758,1731889759.181,-21600,,
com.apple.news,183,1731889467,1731889650,1731889651.013606,-21600,,
com.google.Chrome,1028,1731888439,1731889467,1731889467.575553,-21600,,
com.apple.news,81,1731888358,1731888439,1731888439.897462,-21600,,
com.google.Chrome,17,1731888341,1731888358,1731888358.3188791,-21600,,
com.apple.iCal,18,1731888323,1731888341,1731888341.976156,-21600,,
com.google.Chrome,1,1731888322,1731888323,1731888323.2091951,-21600,,
com.apple.iCal,1,1731888321,1731888322,1731888322.468452,-21600,,
com.google.Chrome,2,1731888319,1731888321,1731888321.891355,-21600,,
com.apple.iCal,13,1731888306,1731888319,1731888319.349802,-21600,,
com.google.Chrome,2,1731888304,1731888306,1731888306.9014769,-21600,,
com.apple.iCal,2,1731888302,1731888304,1731888304.1419458,-21600,,
com.google.Chrome,7,1731888295,1731888302,1731888302.139947,-21600,,
com.apple.iCal,11,1731888284,1731888295,1731888295.900907,-21600,,
com.google.Chrome,94,1731888190,1731888284,1731888284.8980641,-21600,,
com.apple.iCal,26,1731888159,1731888185,1731888186.062797,-21600,,
com.google.Chrome,575,1731887584,1731888159,1731888159.693215,-21600,,
com.apple.news,28,1731887556,1731887584,1731887584.4645329,-21600,,
com.google.Chrome,10,1731887546,1731887556,1731887556.922358,-21600,,
com.leomehlig.today,24,1731887522,1731887546,1731887546.6227531,-21600,,
com.google.Chrome,23,1731887499,1731887522,1731887522.5047379,-21600,,
com.apple.MobileSMS,4,1731887495,1731887499,1731887499.253156,-21600,,
com.google.Chrome,314,1731887181,1731887495,1731887495.066063,-21600,,
com.leomehlig.today,4,1731887177,1731887181,1731887182.573689,-21600,,
com.google.Chrome,5,1731887172,1731887177,1731887177.37094,-21600,,
com.apple.MobileSMS,2,1731885525,1731885527,1731885527.361508,-21600,EB445137-D7F5-57EC-87DA-1DB460D64046,"iPhone13,2"
com.burbn.instagram,9,1731885516,1731885525,1731885525.348851,-21600,EB445137-D7F5-57EC-87DA-1DB460D64046,"iPhone13,2"
com.burbn.instagram,8,1731885464,1731885472,1731885473.227539,-21600,EB445137-D7F5-57EC-87DA-1DB460D64046,"iPhone13,2"
com.google.Chrome,240,1731885197,1731885437,1731885437.557294,-21600,,
com.microsoft.VSCode,470,1731884727,1731885197,1731885197.0874782,-21600,,
com.google.Chrome,1,1731884726,1731884727,1731884727.186691,-21600,,
com.microsoft.VSCode,13,1731884713,1731884726,1731884726.421175,-21600,,
com.google.Chrome,1,1731884712,1731884713,1731884713.463087,-21600,,
com.microsoft.VSCode,2,1731884710,1731884712,1731884712.514544,-21600,,
com.google.Chrome,2,1731884708,1731884710,1731884710.263564,-21600,,
com.microsoft.VSCode,3,1731884705,1731884708,1731884708.8658109,-21600,,
com.google.Chrome,3,1731884702,1731884705,1731884705.2871141,-21600,,
com.microsoft.VSCode,5,1731884697,1731884702,1731884702.256689,-21600,,
com.google.Chrome,19,1731884678,1731884697,1731884697.608204,-21600,,
com.microsoft.VSCode,782,1731883896,1731884678,1731884678.743774,-21600,,
com.burbn.instagram,958,1731882861,1731883819,1731883820.232929,-21600,EB445137-D7F5-57EC-87DA-1DB460D64046,"iPhone13,2"
com.microsoft.VSCode,736,1731882336,1731883072,1731883072.241914,-21600,,
com.google.Chrome,49,1731882287,1731882336,1731882336.1145859,-21600,,
com.google.Chrome,701,1731881060,1731881761,1731881761.82249,-21600,,
com.leomehlig.today,3,1731881042,1731881045,1731881045.359527,-21600,,
com.leomehlig.today,11,1731880801,1731880812,1731880813.341598,-21600,,
com.apple.news,35,1731880766,1731880801,1731880801.595827,-21600,,
com.leomehlig.today,13,1731880753,1731880766,1731880766.990457,-21600,,
com.google.Chrome,1,1731880752,1731880753,1731880753.819854,-21600,,
com.apple.MobileSMS,1,1731880751,1731880752,1731880752.538846,-21600,,
com.google.Chrome,5,1731880746,1731880751,1731880751.34656,-21600,,
com.leomehlig.today,15,1731880731,1731880746,1731880746.709894,-21600,,
com.google.Chrome,6,1731880725,1731880731,1731880731.3387961,-21600,,
com.leomehlig.today,19,1731880706,1731880725,1731880725.4744139,-21600,,
com.apple.MobileSMS,2,1731879189,1731879191,1731879191.610909,-21600,EB445137-D7F5-57EC-87DA-1DB460D64046,"iPhone13,2"
com.apple.MobileSMS,14,1731879167,1731879181,1731879181.3598862,-21600,EB445137-D7F5-57EC-87DA-1DB460D64046,"iPhone13,2"
com.apple.camera,4,1731879131,1731879135,1731879135.420288,-21600,EB445137-D7F5-57EC-87DA-1DB460D64046,"iPhone13,2"
com.apple.camera,2,1731879129,1731879131,1731879134.157446,-21600,EB445137-D7F5-57EC-87DA-1DB460D64046,"iPhone13,2"
com.clairmail.fth.client,39,1731879125,1731879164,1731879164.332304,-21600,EB445137-D7F5-57EC-87DA-1DB460D64046,"iPhone13,2"
com.google.Chrome,2211,1731878495,1731880706,1731880706.7856379,-21600,,
com.apple.MobileSMS,22,1731878473,1731878495,1731878495.195579,-21600,,
com.google.Chrome,1056,1731877417,1731878473,1731878473.516953,-21600,,
com.leomehlig.today,1,1731877416,1731877417,1731877417.4591432,-21600,,
com.burbn.instagram,31,1731877324,1731877355,1731877355.51164,-21600,EB445137-D7F5-57EC-87DA-1DB460D64046,"iPhone13,2"
com.google.Chrome,249,1731877167,1731877416,1731877416.714888,-21600,,
com.leomehlig.today,23,1731877132,1731877155,1731877156.520366,-21600,,
com.google.Chrome,8,1731877124,1731877132,1731877133.045432,-21600,,
com.apple.finder,3,1731877121,1731877124,1731877124.707309,-21600,,
com.leomehlig.today,9,1731877112,1731877121,1731877121.258014,-21600,,
com.apple.finder,46,1731877066,1731877112,1731877112.386451,-21600,,
com.google.Chrome,80,1731876986,1731877066,1731877066.655686,-21600,,
com.leomehlig.today,43,1731876823,1731876866,1731876867.07974,-21600,,
com.apple.MobileSMS,4,1731876819,1731876823,1731876823.662668,-21600,,
com.microsoft.VSCode,8,1731876811,1731876819,1731876819.2291899,-21600,,
com.google.Chrome,87,1731876724,1731876811,1731876811.762862,-21600,,
com.microsoft.VSCode,1126,1731875598,1731876724,1731876724.524993,-21600,,
com.facebook.Facebook,128,1731875378,1731875506,1731875506.647634,-21600,EB445137-D7F5-57EC-87DA-1DB460D64046,"iPhone13,2"
com.apple.news,13,1731875344,1731875357,1731875357.7775822,-21600,EB445137-D7F5-57EC-87DA-1DB460D64046,"iPhone13,2"
edu.illinois.rokwire.ios,8,1731875307,1731875315,1731875315.838336,-21600,EB445137-D7F5-57EC-87DA-1DB460D64046,"iPhone13,2"
edu.illinois.rokwire.ios,8,1731875293,1731875301,1731875301.273869,-21600,EB445137-D7F5-57EC-87DA-1DB460D64046,"iPhone13,2"
com.microsoft.VSCode,479,1731875107,1731875586,1731875586.4992719,-21600,,
com.google.Chrome,8,1731875099,1731875107,1731875107.949582,-21600,,
com.microsoft.VSCode,9,1731875090,1731875099,1731875099.1258311,-21600,,
com.google.Chrome,27,1731875063,1731875090,1731875090.5751781,-21600,,
com.microsoft.VSCode,77,1731874986,1731875063,1731875063.2846289,-21600,,
com.google.Chrome,11,1731874975,1731874986,1731874986.916782,-21600,,
com.microsoft.VSCode,3,1731874972,1731874975,1731874975.184535,-21600,,
com.google.Chrome,9,1731874963,1731874972,1731874972.206769,-21600,,
com.microsoft.VSCode,1027,1731873936,1731874963,1731874963.222282,-21600,,
com.google.Chrome,1,1731873935,1731873936,1731873936.404554,-21600,,
com.microsoft.VSCode,74,1731873861,1731873935,1731873935.645646,-21600,,
com.google.Chrome,2,1731873859,1731873861,1731873861.880906,-21600,,
com.microsoft.VSCode,19,1731873840,1731873859,1731873859.883956,-21600,,
com.google.Chrome,8,1731873832,1731873840,1731873840.8320808,-21600,,
com.microsoft.VSCode,279,1731873553,1731873832,1731873832.3921208,-21600,,
com.google.Chrome,6,1731873547,1731873553,1731873553.149982,-21600,,
com.microsoft.VSCode,245,1731873302,1731873547,1731873547.344521,-21600,,
com.google.Chrome,4,1731873298,1731873302,1731873302.2007608,-21600,,
com.microsoft.VSCode,2,1731873296,1731873298,1731873298.061625,-21600,,
com.google.Chrome,2,1731873294,1731873296,1731873296.618398,-21600,,
com.microsoft.VSCode,10,1731873284,1731873294,1731873294.036644,-21600,,
com.google.Chrome,5,1731873279,1731873284,1731873284.1868339,-21600,,
com.microsoft.VSCode,0,1731873279,1731873279,1731873279.625081,-21600,,
com.google.Chrome,1,1731873278,1731873279,1731873279.198549,-21600,,
com.microsoft.VSCode,8,1731873270,1731873278,1731873278.545943,-21600,,
com.google.Chrome,6,1731873264,1731873270,1731873271.074832,-21600,,
com.microsoft.VSCode,6,1731873258,1731873264,1731873264.9513988,-21600,,
com.google.Chrome,5,1731873253,1731873258,1731873258.3179212,-21600,,
com.microsoft.VSCode,1,1731873252,1731873253,1731873253.2436938,-21600,,
com.google.Chrome,9,1731873243,1731873252,1731873252.614194,-21600,,
com.microsoft.VSCode,2,1731873241,1731873243,1731873243.684513,-21600,,
com.google.Chrome,6,1731873235,1731873241,1731873241.860249,-21600,,
com.microsoft.VSCode,17,1731873218,1731873235,1731873235.696179,-21600,,
com.google.Chrome,2,1731873216,1731873218,1731873218.869773,-21600,,
com.microsoft.VSCode,4,1731873212,1731873216,1731873216.897557,-21600,,
com.google.Chrome,64,1731873148,1731873212,1731873212.194526,-21600,,
com.microsoft.VSCode,515,1731872633,1731873148,1731873148.5803509,-21600,,
com.google.Chrome,9,1731872624,1731872633,1731872633.459714,-21600,,
com.microsoft.VSCode,1,1731872623,1731872624,1731872624.118532,-21600,,
com.google.Chrome,16,1731872607,1731872623,1731872623.08736,-21600,,
com.microsoft.VSCode,120,1731872487,1731872607,1731872607.648108,-21600,,
com.google.Chrome,3,1731872484,1731872487,1731872487.6607242,-21600,,
com.microsoft.VSCode,60,1731872424,1731872484,1731872484.2667189,-21600,,
com.google.Chrome,3,1731872421,1731872424,1731872424.576847,-21600,,
com.microsoft.VSCode,4,1731872417,1731872421,1731872421.416125,-21600,,
com.google.Chrome,2,1731872415,1731872417,1731872417.924155,-21600,,
com.microsoft.VSCode,32,1731872383,1731872415,1731872415.30345,-21600,,
com.google.Chrome,1,1731872382,1731872383,1731872383.609216,-21600,,
com.microsoft.VSCode,6,1731872376,1731872382,1731872382.6992722,-21600,,
com.google.Chrome,1,1731872375,1731872376,1731872376.48252,-21600,,
com.microsoft.VSCode,9,1731872366,1731872375,1731872375.662462,-21600,,
com.google.Chrome,5,1731872361,1731872366,1731872366.542268,-21600,,
com.microsoft.VSCode,0,1731872361,1731872361,1731872361.713557,-21600,,
com.google.Chrome,7,1731872354,1731872361,1731872361.309202,-21600,,
com.microsoft.VSCode,4,1731872350,1731872354,1731872354.527601,-21600,,
com.google.Chrome,2,1731872348,1731872350,1731872350.3591251,-21600,,
com.microsoft.VSCode,17,1731872331,1731872348,1731872348.870223,-21600,,
com.google.Chrome,3,1731872328,1731872331,1731872331.26055,-21600,,
com.microsoft.VSCode,6,1731872322,1731872328,1731872328.829053,-21600,,
com.google.Chrome,0,1731872322,1731872322,1731872322.886123,-21600,,
com.microsoft.VSCode,5,1731872317,1731872322,1731872322.3103309,-21600,,
com.google.Chrome,3,1731872314,1731872317,1731872318.014801,-21600,,
com.microsoft.VSCode,17,1731872297,1731872314,1731872315.032446,-21600,,
com.google.Chrome,68,1731872229,1731872297,1731872297.423437,-21600,,
com.microsoft.VSCode,14,1731872215,1731872229,1731872229.702955,-21600,,
com.google.Chrome,4,1731872211,1731872215,1731872215.702416,-21600,,
com.microsoft.VSCode,83,1731872128,1731872211,1731872211.559517,-21600,,
com.google.Chrome,1,1731872127,1731872128,1731872128.709508,-21600,,
com.microsoft.VSCode,3,1731872124,1731872127,1731872127.634862,-21600,,
com.google.Chrome,1,1731872123,1731872124,1731872124.246901,-21600,,
com.microsoft.VSCode,3,1731872120,1731872123,1731872123.10902,-21600,,
com.google.Chrome,1,1731872119,1731872120,1731872120.977057,-21600,,
com.microsoft.VSCode,6,1731872113,1731872119,1731872119.732518,-21600,,
com.google.Chrome,4,1731872109,1731872113,1731872113.8095841,-21600,,
com.microsoft.VSCode,2,1731872107,1731872109,1731872109.591137,-21600,,
com.google.Chrome,4,1731872103,1731872107,1731872107.5398011,-21600,,
com.microsoft.VSCode,20,1731872083,1731872103,1731872103.1010761,-21600,,
com.google.Chrome,117,1731871966,1731872083,1731872083.428261,-21600,,
com.microsoft.VSCode,141,1731871825,1731871966,1731871967.030143,-21600,,
com.apple.iCal,22,1731871803,1731871825,1731871825.233666,-21600,,
edu.illinois.rokwire.ios,6,1731871085,1731871091,1731871091.1000671,-21600,EB445137-D7F5-57EC-87DA-1DB460D64046,"iPhone13,2"
edu.illinois.rokwire.ios,8,1731871076,1731871084,1731871084.40323,-21600,EB445137-D7F5-57EC-87DA-1DB460D64046,"iPhone13,2"
edu.illinois.rokwire.ios,21,1731870603,1731870624,1731870625.729214,-21600,EB445137-D7F5-57EC-87DA-1DB460D64046,"iPhone13,2"
com.apple.MobileSMS,2,1731869804,1731869806,1731869806.435324,-21600,EB445137-D7F5-57EC-87DA-1DB460D64046,"iPhone13,2"
com.instructure.icanvas,12,1731869792,1731869804,1731869804.7437758,-21600,EB445137-D7F5-57EC-87DA-1DB460D64046,"iPhone13,2"
com.apple.MobileSMS,6,1731869786,1731869792,1731869792.054965,-21600,EB445137-D7F5-57EC-87DA-1DB460D64046,"iPhone13,2"
com.instructure.icanvas,19,1731869767,1731869786,1731869786.601793,-21600,EB445137-D7F5-57EC-87DA-1DB460D64046,"iPhone13,2"
com.microsoft.Office.Outlook,22,1731869744,1731869766,1731869766.055059,-21600,EB445137-D7F5-57EC-87DA-1DB460D64046,"iPhone13,2"
com.apple.MobileSMS,36,1731869707,1731869743,1731869743.91402,-21600,EB445137-D7F5-57EC-87DA-1DB460D64046,"iPhone13,2"
edu.illinois.rokwire.ios,2,1731869705,1731869707,1731869707.983423,-21600,EB445137-D7F5-57EC-87DA-1DB460D64046,"iPhone13,2"
edu.illinois.rokwire.ios,23,1731868211,1731868234,1731868234.930179,-21600,EB445137-D7F5-57EC-87DA-1DB460D64046,"iPhone13,2"
com.apple.news,2,1731868207,1731868209,1731868209.227529,-21600,EB445137-D7F5-57EC-87DA-1DB460D64046,"iPhone13,2"
com.apple.news,2,1731867612,1731867614,1731867614.379778,-21600,EB445137-D7F5-57EC-87DA-1DB460D64046,"iPhone13,2"
com.apple.news,3,1731867520,1731867523,1731867523.4604049,-21600,EB445137-D7F5-57EC-87DA-1DB460D64046,"iPhone13,2"
com.apple.iCal,62,1731867183,1731867245,1731867245.798449,-21600,,
com.google.Chrome,69,1731867114,1731867183,1731867183.685554,-21600,,
com.microsoft.VSCode,50,1731867064,1731867114,1731867114.5886059,-21600,,
com.apple.finder,5,1731867059,1731867064,1731867064.749268,-21600,,
com.apple.archiveutility,0,1731867059,1731867059,1731867059.40514,-21600,,
com.apple.finder,14,1731867045,1731867059,1731867059.157449,-21600,,
com.microsoft.VSCode,12,1731867033,1731867045,1731867046.028194,-21600,,
com.apple.finder,21,1731867012,1731867033,1731867033.080494,-21600,,
com.google.Chrome,1,1731867011,1731867012,1731867012.7194052,-21600,,
com.microsoft.VSCode,1,1731867010,1731867011,1731867011.4771218,-21600,,
com.google.Chrome,47,1731866963,1731867010,1731867010.831608,-21600,,
com.microsoft.VSCode,322,1731866641,1731866963,1731866963.39944,-21600,,
com.apple.MobileSMS,17,1731866624,1731866641,1731866641.832498,-21600,,
com.microsoft.VSCode,7,1731866617,1731866624,1731866624.803421,-21600,,
com.apple.news,2,1731866576,1731866578,1731866578.927316,-21600,EB445137-D7F5-57EC-87DA-1DB460D64046,"iPhone13,2"
com.apple.news,7,1731866394,1731866401,1731866401.926021,-21600,EB445137-D7F5-57EC-87DA-1DB460D64046,"iPhone13,2"
com.apple.news,217,1731866134,1731866351,1731866351.426083,-21600,EB445137-D7F5-57EC-87DA-1DB460D64046,"iPhone13,2"
com.hammerandchisel.discord,8,1731866063,1731866071,1731866071.96452,-21600,EB445137-D7F5-57EC-87DA-1DB460D64046,"iPhone13,2"
com.apple.MobileSMS,5,1731866046,1731866051,1731866052.0046868,-21600,EB445137-D7F5-57EC-87DA-1DB460D64046,"iPhone13,2"
com.apple.MobileSMS,136,1731865869,1731866005,1731866005.368544,-21600,EB445137-D7F5-57EC-87DA-1DB460D64046,"iPhone13,2"
com.apple.mobilecal,16,1731865853,1731865869,1731865870.057588,-21600,EB445137-D7F5-57EC-87DA-1DB460D64046,"iPhone13,2"
com.apple.MobileSMS,14,1731865833,1731865847,1731865847.383414,-21600,EB445137-D7F5-57EC-87DA-1DB460D64046,"iPhone13,2"
com.renpho.health,0,1731864841,1731864841,1731864841.7526178,-21600,EB445137-D7F5-57EC-87DA-1DB460D64046,"iPhone13,2"
com.renpho.health,23,1731864776,1731864799,1731864799.547574,-21600,EB445137-D7F5-57EC-87DA-1DB460D64046,"iPhone13,2"
com.google.ios.youtube,2145,1731861671,1731863816,1731863816.921111,-21600,EB445137-D7F5-57EC-87DA-1DB460D64046,"iPhone13,2"
com.apple.weather,29,1731825563,1731825592,1731825592.912119,-21600,EB445137-D7F5-57EC-87DA-1DB460D64046,"iPhone13,2"
com.apple.Music,7,1731825555,1731825562,1731825562.907723,-21600,EB445137-D7F5-57EC-87DA-1DB460D64046,"iPhone13,2"
com.google.ios.youtube,1,1731824034,1731824035,1731824035.914608,-21600,EB445137-D7F5-57EC-87DA-1DB460D64046,"iPhone13,2"
com.apple.Music,200,1731824033,1731824233,1731824234.257107,-21600,EB445137-D7F5-57EC-87DA-1DB460D64046,"iPhone13,2"
com.google.ios.youtube,330,1731823703,1731824033,1731824033.148491,-21600,EB445137-D7F5-57EC-87DA-1DB460D64046,"iPhone13,2"
com.apple.Music,6,1731823692,1731823698,1731823698.887272,-21600,EB445137-D7F5-57EC-87DA-1DB460D64046,"iPhone13,2"
com.apple.camera,0,1731823653,1731823653,1731823653.878103,-21600,EB445137-D7F5-57EC-87DA-1DB460D64046,"iPhone13,2"
com.apple.Music,15,1731823649,1731823664,1731823664.137299,-21600,EB445137-D7F5-57EC-87DA-1DB460D64046,"iPhone13,2"
com.apple.Music,1,1731823633,1731823634,1731823634.910307,-21600,EB445137-D7F5-57EC-87DA-1DB460D64046,"iPhone13,2"
com.apple.Music,41,1731823586,1731823627,1731823628.09687,-21600,EB445137-D7F5-57EC-87DA-1DB460D64046,"iPhone13,2"
com.apple.news,14,1731823570,1731823584,1731823585.422863,-21600,EB445137-D7F5-57EC-87DA-1DB460D64046,"iPhone13,2"
com.apple.news,2213,1731820761,1731822974,1731822975.595615,-21600,EB445137-D7F5-57EC-87DA-1DB460D64046,"iPhone13,2"
com.apple.news,1560,1731819172,1731820732,1731820733.0933928,-21600,EB445137-D7F5-57EC-87DA-1DB460D64046,"iPhone13,2"
com.apple.news,529,1731818504,1731819033,1731819033.6416368,-21600,EB445137-D7F5-57EC-87DA-1DB460D64046,"iPhone13,2"
com.apple.news,158,1731818343,1731818501,1731818502.8009748,-21600,EB445137-D7F5-57EC-87DA-1DB460D64046,"iPhone13,2"
com.apple.news,26,1731818264,1731818290,1731818291.3035998,-21600,EB445137-D7F5-57EC-87DA-1DB460D64046,"iPhone13,2"
com.apple.news,23,1731818223,1731818246,1731818246.4311972,-21600,EB445137-D7F5-57EC-87DA-1DB460D64046,"iPhone13,2"
com.apple.camera,1,1731816375,1731816376,1731816376.0340571,-21600,EB445137-D7F5-57EC-87DA-1DB460D64046,"iPhone13,2"
com.google.chrome.ios,13,1731816331,1731816344,1731816344.154259,-21600,EB445137-D7F5-57EC-87DA-1DB460D64046,"iPhone13,2"
com.apple.MobileSMS,13,1731816302,1731816315,1731816315.274191,-21600,EB445137-D7F5-57EC-87DA-1DB460D64046,"iPhone13,2"
com.apple.MobileSMS,2,1731813972,1731813974,1731813974.807616,-21600,EB445137-D7F5-57EC-87DA-1DB460D64046,"iPhone13,2"
com.apple.MobileSMS,5,1731813965,1731813970,1731813970.739074,-21600,EB445137-D7F5-57EC-87DA-1DB460D64046,"iPhone13,2"
com.apple.MobileSMS,69,1731813840,1731813909,1731813909.527139,-21600,EB445137-D7F5-57EC-87DA-1DB460D64046,"iPhone13,2"
com.google.chrome.ios,62,1731813778,1731813840,1731813840.948968,-21600,EB445137-D7F5-57EC-87DA-1DB460D64046,"iPhone13,2"
com.apple.Passwords,13,1731813765,1731813778,1731813778.845635,-21600,EB445137-D7F5-57EC-87DA-1DB460D64046,"iPhone13,2"
com.google.chrome.ios,35,1731813729,1731813764,1731813764.202489,-21600,EB445137-D7F5-57EC-87DA-1DB460D64046,"iPhone13,2"
com.apple.camera,10,1731813719,1731813729,1731813729.496165,-21600,EB445137-D7F5-57EC-87DA-1DB460D64046,"iPhone13,2"
com.apple.news,292,1731813405,1731813697,1731813697.6628342,-21600,EB445137-D7F5-57EC-87DA-1DB460D64046,"iPhone13,2"
com.apple.mobileslideshow,10,1731813378,1731813388,1731813388.305654,-21600,EB445137-D7F5-57EC-87DA-1DB460D64046,"iPhone13,2"
com.toyopagroup.picaboo,7,1731813371,1731813378,1731813378.1896129,-21600,EB445137-D7F5-57EC-87DA-1DB460D64046,"iPhone13,2"
com.google.chrome.ios,4,1731813367,1731813371,1731813372.2934,-21600,EB445137-D7F5-57EC-87DA-1DB460D64046,"iPhone13,2"
com.google.chrome.ios,2,1731809146,1731809148,1731809148.398905,-21600,EB445137-D7F5-57EC-87DA-1DB460D64046,"iPhone13,2"
com.google.chrome.ios,19,1731809122,1731809141,1731809141.625465,-21600,EB445137-D7F5-57EC-87DA-1DB460D64046,"iPhone13,2"
com.google.chrome.ios,36,1731801744,1731801780,1731801780.257708,-21600,EB445137-D7F5-57EC-87DA-1DB460D64046,"iPhone13,2"
com.apple.camera,19,1731800756,1731800775,1731800775.512433,-21600,EB445137-D7F5-57EC-87DA-1DB460D64046,"iPhone13,2"
com.apple.mobileslideshow,29,1731800496,1731800525,1731800525.658467,-21600,EB445137-D7F5-57EC-87DA-1DB460D64046,"iPhone13,2"
com.google.chrome.ios,6,1731800483,1731800489,1731800489.849743,-21600,EB445137-D7F5-57EC-87DA-1DB460D64046,"iPhone13,2"
com.google.chrome.ios,26,1731800260,1731800286,1731800286.985198,-21600,EB445137-D7F5-57EC-87DA-1DB460D64046,"iPhone13,2"
com.apple.news,3,1731800242,1731800245,1731800245.9436169,-21600,EB445137-D7F5-57EC-87DA-1DB460D64046,"iPhone13,2"
com.apple.news,3,1731798227,1731798230,1731798230.936563,-21600,EB445137-D7F5-57EC-87DA-1DB460D64046,"iPhone13,2"
com.microsoft.VSCode,37,1731796896,1731796933,1731796933.612334,-21600,,
com.google.Chrome,23,1731796873,1731796896,1731796896.166821,-21600,,
com.microsoft.VSCode,35,1731796838,1731796873,1731796873.802089,-21600,,
com.apple.MobileSMS,21,1731796817,1731796838,1731796838.396106,-21600,,
com.microsoft.VSCode,317,1731796500,1731796817,1731796817.524127,-21600,,
com.google.Chrome,7,1731796493,1731796500,1731796500.404986,-21600,,
com.microsoft.VSCode,27,1731796466,1731796493,1731796493.150782,-21600,,
com.google.Chrome,21,1731796445,1731796466,1731796466.1095319,-21600,,
com.microsoft.VSCode,168,1731796277,1731796445,1731796445.2826672,-21600,,
com.google.Chrome,1,1731796276,1731796277,1731796277.325145,-21600,,
com.microsoft.VSCode,5,1731796271,1731796276,1731796276.1355739,-21600,,
com.google.Chrome,24,1731796247,1731796271,1731796271.316258,-21600,,
com.microsoft.VSCode,259,1731795988,1731796247,1731796247.089504,-21600,,
com.leomehlig.today,45,1731795943,1731795988,1731795988.2306619,-21600,,
com.google.Chrome,43,1731795900,1731795943,1731795943.455801,-21600,,
com.leomehlig.today,0,1731795900,1731795900,1731795900.5756211,-21600,,
com.google.Chrome,2,1731795898,1731795900,1731795900.311236,-21600,,
com.leomehlig.today,3,1731795895,1731795898,1731795898.835761,-21600,,
com.google.Chrome,1,1731795894,1731795895,1731795895.490505,-21600,,
com.leomehlig.today,33,1731795861,1731795894,1731795894.873849,-21600,,
com.google.Chrome,20,1731795841,1731795861,1731795861.939413,-21600,,
com.apple.Preview,70,1731795771,1731795841,1731795841.3108969,-21600,,
com.microsoft.VSCode,86,1731795685,1731795771,1731795771.371994,-21600,,
com.leomehlig.today,1,1731795684,1731795685,1731795685.6083689,-21600,,
com.hnc.Discord,28,1731795656,1731795684,1731795684.224323,-21600,,
com.leomehlig.today,37,1731795619,1731795656,1731795656.949645,-21600,,
com.microsoft.VSCode,824,1731794795,1731795619,1731795619.785733,-21600,,
com.google.Chrome,20,1731794775,1731794795,1731794795.931644,-21600,,
com.microsoft.VSCode,80,1731794695,1731794775,1731794775.074171,-21600,,
com.google.Chrome,2,1731794693,1731794695,1731794695.424058,-21600,,
com.microsoft.VSCode,16,1731794677,1731794693,1731794693.712157,-21600,,
com.google.Chrome,1,1731794676,1731794677,1731794677.900573,-21600,,
com.microsoft.VSCode,3,1731794673,1731794676,1731794676.383584,-21600,,
com.google.Chrome,4,1731794669,1731794673,1731794673.8437018,-21600,,
com.microsoft.VSCode,0,1731794669,1731794669,1731794669.71101,-21600,,
com.google.Chrome,1,1731794668,1731794669,1731794669.255571,-21600,,
com.microsoft.VSCode,4,1731794664,1731794668,1731794668.866219,-21600,,
com.google.Chrome,1,1731794663,1731794664,1731794664.659052,-21600,,
com.microsoft.VSCode,0,1731794663,1731794663,1731794663.965692,-21600,,
com.google.Chrome,15,1731794648,1731794663,1731794663.5338159,-21600,,
com.microsoft.VSCode,423,1731794225,1731794648,1731794648.138984,-21600,,
com.google.Chrome,1,1731794224,1731794225,1731794225.219641,-21600,,
com.microsoft.VSCode,91,1731794133,1731794224,1731794224.810282,-21600,,
com.google.Chrome,1,1731794132,1731794133,1731794133.446523,-21600,,
com.microsoft.VSCode,2,1731794130,1731794132,1731794132.611206,-21600,,
com.google.Chrome,1,1731794129,1731794130,1731794130.5295758,-21600,,
com.microsoft.VSCode,2,1731794127,1731794129,1731794129.704692,-21600,,
com.google.Chrome,1,1731794126,1731794127,1731794127.108156,-21600,,
com.microsoft.VSCode,3,1731794123,1731794126,1731794126.142142,-21600,,
com.google.Chrome,1,1731794122,1731794123,1731794123.480125,-21600,,
com.microsoft.VSCode,6,1731794116,1731794122,1731794122.2923799,-21600,,
com.google.Chrome,1,1731794115,1731794116,1731794116.274584,-21600,,
com.microsoft.VSCode,3,1731794112,1731794115,1731794115.076643,-21600,,
com.google.Chrome,2,1731794110,1731794112,1731794112.228075,-21600,,
com.microsoft.VSCode,3,1731794107,1731794110,1731794110.771789,-21600,,
com.google.Chrome,1,1731794106,1731794107,1731794107.777,-21600,,
com.microsoft.VSCode,2,1731794104,1731794106,1731794106.212199,-21600,,
com.google.Chrome,1,1731794103,1731794104,1731794104.485429,-21600,,
com.microsoft.VSCode,3,1731794100,1731794103,1731794103.12609,-21600,,
com.google.Chrome,1,1731794099,1731794100,1731794100.4153,-21600,,
com.microsoft.VSCode,1,1731794098,1731794099,1731794099.433712,-21600,,
com.google.Chrome,1,1731794097,1731794098,1731794098.396563,-21600,,
com.microsoft.VSCode,6,1731794091,1731794097,1731794097.5786839,-21600,,
com.google.Chrome,2,1731794089,1731794091,1731794091.86162,-21600,,
com.microsoft.VSCode,6,1731794083,1731794089,1731794089.775455,-21600,,
com.google.Chrome,2,1731794081,1731794083,1731794083.2076669,-21600,,
com.microsoft.VSCode,3,1731794078,1731794081,1731794081.351255,-21600,,
com.google.Chrome,1,1731794077,1731794078,1731794079.031208,-21600,,
com.microsoft.VSCode,2,1731794075,1731794077,1731794078.006347,-21600,,
com.google.Chrome,1,1731794074,1731794075,1731794075.876944,-21600,,
com.microsoft.VSCode,1,1731794073,1731794074,1731794074.87004,-21600,,
com.google.Chrome,1,1731794072,1731794073,1731794073.9463701,-21600,,
com.microsoft.VSCode,4,1731794068,1731794072,1731794072.788317,-21600,,
com.google.Chrome,2,1731794066,1731794068,1731794068.608663,-21600,,
com.microsoft.VSCode,2,1731794064,1731794066,1731794066.9870381,-21600,,
com.google.Chrome,2,1731794062,1731794064,1731794064.721221,-21600,,
com.microsoft.VSCode,3,1731794059,1731794062,1731794062.981466,-21600,,
com.google.Chrome,1,1731794058,1731794059,1731794059.783107,-21600,,
com.microsoft.VSCode,8,1731794050,1731794058,1731794058.3061938,-21600,,
com.microsoft.VSCode,2,1731794039,1731794041,1731794041.2940311,-21600,,
com.google.Chrome,2,1731794037,1731794039,1731794039.5711532,-21600,,
com.microsoft.VSCode,2,1731794035,1731794037,1731794038.0163798,-21600,,
com.google.Chrome,3,1731794032,1731794035,1731794035.161092,-21600,,
com.microsoft.VSCode,1,1731794031,1731794032,1731794032.900547,-21600,,
com.google.Chrome,1,1731794030,1731794031,1731794031.737321,-21600,,
com.microsoft.VSCode,1,1731794029,1731794030,1731794030.4566178,-21600,,
com.google.Chrome,3,1731794026,1731794029,1731794029.201225,-21600,,
com.microsoft.VSCode,1,1731794025,1731794026,1731794026.997428,-21600,,
com.google.Chrome,1,1731794024,1731794025,1731794025.664762,-21600,,
com.microsoft.VSCode,3,1731794021,1731794024,1731794024.3252969,-21600,,
com.google.Chrome,1,1731794020,1731794021,1731794021.658125,-21600,,
com.microsoft.VSCode,1,1731794019,1731794020,1731794020.5612102,-21600,,
com.google.Chrome,2,1731794017,1731794019,1731794019.101046,-21600,,
com.microsoft.VSCode,0,1731794017,1731794017,1731794017.8363929,-21600,,
com.google.Chrome,1,1731794016,1731794017,1731794017.164658,-21600,,
com.microsoft.VSCode,2,1731794014,1731794016,1731794016.113656,-21600,,
com.google.Chrome,1,1731794013,1731794014,1731794014.830365,-21600,,
com.microsoft.VSCode,0,1731794013,1731794013,1731794014.003145,-21600,,
com.google.Chrome,3,1731794010,1731794013,1731794013.182744,-21600,,
com.microsoft.VSCode,1,1731794009,1731794010,1731794010.5377622,-21600,,
com.google.Chrome,1,1731794008,1731794009,1731794009.239643,-21600,,
com.microsoft.VSCode,2,1731794006,1731794008,1731794008.108747,-21600,,
com.google.Chrome,1,1731794005,1731794006,1731794006.771399,-21600,,
com.microsoft.VSCode,0,1731794005,1731794005,1731794005.838097,-21600,,
com.google.Chrome,1,1731794004,1731794005,1731794005.261561,-21600,,
com.microsoft.VSCode,5,1731793999,1731794004,1731794004.2702842,-21600,,
com.google.Chrome,1,1731793998,1731793999,1731793999.516648,-21600,,
com.microsoft.VSCode,1,1731793997,1731793998,1731793998.71475,-21600,,
com.google.Chrome,3,1731793994,1731793997,1731793997.0841079,-21600,,
com.microsoft.VSCode,2,1731793992,1731793994,1731793994.874104,-21600,,
com.google.Chrome,1,1731793991,1731793992,1731793992.9308581,-21600,,
com.microsoft.VSCode,1,1731793990,1731793991,1731793991.519727,-21600,,
com.google.Chrome,7,1731793983,1731793990,1731793990.070209,-21600,,
com.microsoft.VSCode,3,1731793980,1731793983,1731793983.292101,-21600,,
com.google.Chrome,3,1731793977,1731793980,1731793980.164734,-21600,,
com.microsoft.VSCode,1,1731793976,1731793977,1731793977.57346,-21600,,
com.google.Chrome,3,1731793973,1731793976,1731793976.166312,-21600,,
com.microsoft.VSCode,0,1731793973,1731793973,1731793973.618215,-21600,,
com.google.Chrome,3,1731793970,1731793973,1731793973.17596,-21600,,
com.microsoft.VSCode,1,1731793969,1731793970,1731793970.8684158,-21600,,
com.google.Chrome,2,1731793967,1731793969,1731793969.453785,-21600,,
com.microsoft.VSCode,1,1731793966,1731793967,1731793967.31212,-21600,,
com.google.Chrome,1,1731793965,1731793966,1731793966.572232,-21600,,
com.microsoft.VSCode,1,1731793964,1731793965,1731793965.408122,-21600,,
com.google.Chrome,2,1731793962,1731793964,1731793964.4024339,-21600,,
com.microsoft.VSCode,6,1731793956,1731793962,1731793962.090651,-21600,,
com.google.Chrome,3,1731793953,1731793956,1731793956.8783789,-21600,,
com.microsoft.VSCode,2,1731793951,1731793953,1731793953.587708,-21600,,
com.google.Chrome,2,1731793949,1731793951,1731793951.110899,-21600,,
com.microsoft.VSCode,2,1731793947,1731793949,1731793949.222408,-21600,,
com.google.Chrome,3,1731793944,1731793947,1731793947.755083,-21600,,
com.microsoft.VSCode,3,1731793941,1731793944,1731793944.3765302,-21600,,
com.google.Chrome,2,1731793939,1731793941,1731793941.4349508,-21600,,
com.microsoft.VSCode,3,1731793936,1731793939,1731793939.0861769,-21600,,
com.google.Chrome,1,1731793935,1731793936,1731793936.470824,-21600,,
com.microsoft.VSCode,3,1731793932,1731793935,1731793935.216488,-21600,,
com.google.Chrome,15,1731793917,1731793932,1731793932.791535,-21600,,
com.microsoft.VSCode,1,1731793916,1731793917,1731793917.83515,-21600,,
com.google.Chrome,1,1731793915,1731793916,1731793916.797268,-21600,,
com.microsoft.VSCode,1,1731793914,1731793915,1731793915.717071,-21600,,
com.google.Chrome,2,1731793912,1731793914,1731793914.0947552,-21600,,
com.microsoft.VSCode,2,1731793910,1731793912,1731793912.711107,-21600,,
com.google.Chrome,1,1731793909,1731793910,1731793910.9832358,-21600,,
com.microsoft.VSCode,2,1731793907,1731793909,1731793909.068753,-21600,,
com.google.Chrome,3,1731793904,1731793907,1731793907.655795,-21600,,
com.microsoft.VSCode,4,1731793900,1731793904,1731793904.47303,-21600,,
com.google.Chrome,3,1731793897,1731793900,1731793900.5701199,-21600,,
com.microsoft.VSCode,1,1731793896,1731793897,1731793897.5728111,-21600,,
com.google.Chrome,2,1731793894,1731793896,1731793896.443104,-21600,,
com.microsoft.VSCode,2,1731793892,1731793894,1731793894.9759278,-21600,,
com.google.Chrome,1,1731793891,1731793892,1731793892.753417,-21600,,
com.microsoft.VSCode,1,1731793890,1731793891,1731793891.441205,-21600,,
com.google.Chrome,2,1731793888,1731793890,1731793890.48885,-21600,,
com.microsoft.VSCode,2,1731793886,1731793888,1731793888.184298,-21600,,
com.google.Chrome,3,1731793883,1731793886,1731793886.398758,-21600,,
com.microsoft.VSCode,3,1731793880,1731793883,1731793883.198266,-21600,,
com.google.Chrome,5,1731793875,1731793880,1731793880.8920588,-21600,,
com.microsoft.VSCode,2,1731793873,1731793875,1731793875.0781898,-21600,,
com.google.Chrome,3,1731793870,1731793873,1731793873.633696,-21600,,
com.microsoft.VSCode,1,1731793869,1731793870,1731793870.3834229,-21600,,
com.google.Chrome,3,1731793866,1731793869,1731793869.0562968,-21600,,
com.microsoft.VSCode,2,1731793864,1731793866,1731793867.0148559,-21600,,
com.google.Chrome,9,1731793855,1731793864,1731793864.254163,-21600,,
com.microsoft.VSCode,3,1731793852,1731793855,1731793855.467793,-21600,,
com.google.Chrome,1,1731793851,1731793852,1731793852.5940552,-21600,,
com.microsoft.VSCode,1,1731793850,1731793851,1731793851.084974,-21600,,
com.google.Chrome,1,1731793849,1731793850,1731793850.270937,-21600,,
com.microsoft.VSCode,3,1731793846,1731793849,1731793849.569736,-21600,,
com.google.Chrome,1,1731793845,1731793846,1731793846.871582,-21600,,
com.microsoft.VSCode,2,1731793843,1731793845,1731793845.506669,-21600,,
com.google.Chrome,5,1731793838,1731793843,1731793843.942048,-21600,,
com.microsoft.VSCode,2,1731793836,1731793838,1731793838.858151,-21600,,
com.google.Chrome,5,1731793831,1731793836,1731793836.804657,-21600,,
com.microsoft.VSCode,3,1731793828,1731793831,1731793831.526681,-21600,,
com.google.Chrome,2,1731793826,1731793828,1731793828.706873,-21600,,
com.microsoft.VSCode,2,1731793824,1731793826,1731793826.234973,-21600,,
com.google.Chrome,1,1731793823,1731793824,1731793824.991832,-21600,,
com.microsoft.VSCode,1,1731793822,1731793823,1731793823.553354,-21600,,
com.google.Chrome,3,1731793819,1731793822,1731793822.474077,-21600,,
com.microsoft.VSCode,3,1731793816,1731793819,1731793819.515483,-21600,,
com.google.Chrome,1,1731793815,1731793816,1731793816.682662,-21600,,
com.microsoft.VSCode,1,1731793814,1731793815,1731793815.246691,-21600,,
com.google.Chrome,3,1731793811,1731793814,1731793814.313568,-21600,,
com.microsoft.VSCode,3,1731793808,1731793811,1731793811.8270059,-21600,,
com.google.Chrome,2,1731793806,1731793808,1731793808.4341931,-21600,,
com.microsoft.VSCode,2,1731793804,1731793806,1731793806.124703,-21600,,
com.google.Chrome,1,1731793803,1731793804,1731793804.124298,-21600,,
com.microsoft.VSCode,8,1731793795,1731793803,1731793803.7193398,-21600,,
com.google.Chrome,2,1731793793,1731793795,1731793795.276414,-21600,,
com.microsoft.VSCode,2,1731793791,1731793793,1731793793.5811481,-21600,,
com.google.Chrome,1,1731793790,1731793791,1731793791.912935,-21600,,
com.microsoft.VSCode,1,1731793789,1731793790,1731793790.4157438,-21600,,
com.google.Chrome,2,1731793787,1731793789,1731793789.200273,-21600,,
com.microsoft.VSCode,1,1731793786,1731793787,1731793787.563353,-21600,,
com.google.Chrome,1,1731793785,1731793786,1731793786.250448,-21600,,
com.microsoft.VSCode,3,1731793782,1731793785,1731793785.115103,-21600,,
com.google.Chrome,4,1731793778,1731793782,1731793782.9082189,-21600,,
com.microsoft.VSCode,2,1731793776,1731793778,1731793778.3442721,-21600,,
com.google.Chrome,2,1731793774,1731793776,1731793776.279839,-21600,,
com.microsoft.VSCode,2,1731793772,1731793774,1731793774.128621,-21600,,
com.google.Chrome,1,1731793771,1731793772,1731793772.553029,-21600,,
com.microsoft.VSCode,2,1731793769,1731793771,1731793771.2258759,-21600,,
com.google.Chrome,4,1731793765,1731793769,1731793769.753396,-21600,,
com.microsoft.VSCode,11,1731793754,1731793765,1731793765.224433,-21600,,
com.google.Chrome,1,1731793753,1731793754,1731793754.981822,-21600,,
com.microsoft.VSCode,2,1731793751,1731793753,1731793753.19293,-21600,,
com.google.Chrome,4,1731793747,1731793751,1731793751.276795,-21600,,
com.microsoft.VSCode,2,1731793745,1731793747,1731793747.3917398,-21600,,
com.google.Chrome,2,1731793743,1731793745,1731793745.972337,-21600,,
com.microsoft.VSCode,2,1731793741,1731793743,1731793743.504076,-21600,,
com.google.Chrome,0,1731793741,1731793741,1731793741.6128988,-21600,,
com.microsoft.VSCode,3,1731793738,1731793741,1731793741.2424622,-21600,,
com.google.Chrome,2,1731793736,1731793738,1731793738.528079,-21600,,
com.microsoft.VSCode,21,1731793715,1731793736,1731793736.3297172,-21600,,
com.google.Chrome,3,1731793712,1731793715,1731793715.444182,-21600,,
com.microsoft.VSCode,3,1731793709,1731793712,1731793712.0952148,-21600,,
com.google.Chrome,3,1731793706,1731793709,1731793709.383826,-21600,,
com.microsoft.VSCode,3,1731793703,1731793706,1731793706.52859,-21600,,
com.google.Chrome,1,1731793702,1731793703,1731793703.948679,-21600,,
com.microsoft.VSCode,2,1731793700,1731793702,1731793702.4187222,-21600,,
com.google.Chrome,1,1731793699,1731793700,1731793701.034699,-21600,,
com.microsoft.VSCode,1,1731793698,1731793699,1731793699.161617,-21600,,
com.google.Chrome,1,1731793697,1731793698,1731793698.120539,-21600,,
com.microsoft.VSCode,3,1731793694,1731793697,1731793697.077281,-21600,,
com.google.Chrome,1,1731793693,1731793694,1731793695.048788,-21600,,
com.microsoft.VSCode,5,1731793688,1731793693,1731793693.392066,-21600,,
com.google.Chrome,3,1731793685,1731793688,1731793688.8717651,-21600,,
com.microsoft.VSCode,1,1731793684,1731793685,1731793685.8112411,-21600,,
com.google.Chrome,3,1731793681,1731793684,1731793684.375341,-21600,,
com.microsoft.VSCode,7,1731793674,1731793681,1731793681.492118,-21600,,
com.google.Chrome,1,1731793673,1731793674,1731793674.9108539,-21600,,
com.microsoft.VSCode,4,1731793669,1731793673,1731793673.245481,-21600,,
com.google.Chrome,1,1731793668,1731793669,1731793669.587669,-21600,,
com.microsoft.VSCode,3,1731793665,1731793668,1731793668.939598,-21600,,
com.google.Chrome,14,1731793651,1731793665,1731793665.5583181,-21600,,
com.microsoft.VSCode,20,1731793631,1731793651,1731793652.0278559,-21600,,
com.google.Chrome,3,1731793628,1731793631,1731793631.202818,-21600,,
com.microsoft.VSCode,3,1731793625,1731793628,1731793628.8874989,-21600,,
com.google.Chrome,290,1731793335,1731793625,1731793626.052645,-21600,,
com.microsoft.VSCode,4,1731793331,1731793335,1731793335.865493,-21600,,
com.google.Chrome,12,1731793319,1731793331,1731793331.691117,-21600,,
com.microsoft.VSCode,56,1731793263,1731793319,1731793319.7307692,-21600,,
com.leomehlig.today,6,1731793257,1731793263,1731793263.318715,-21600,,
com.apple.news,298,1731792959,1731793257,1731793258.5561771,-21600,EB445137-D7F5-57EC-87DA-1DB460D64046,"iPhone13,2"
com.leomehlig.today,301,1731792953,1731793254,1731793254.3461561,-21600,,
com.apple.news,7,1731792780,1731792787,1731792787.294286,-21600,EB445137-D7F5-57EC-87DA-1DB460D64046,"iPhone13,2"
com.apple.news,4,1731792322,1731792326,1731792326.040762,-21600,EB445137-D7F5-57EC-87DA-1DB460D64046,"iPhone13,2"
com.apple.news,6,1731792283,1731792289,1731792289.31815,-21600,EB445137-D7F5-57EC-87DA-1DB460D64046,"iPhone13,2"
com.apple.news,57,1731792226,1731792283,1731792283.749829,-21600,EB445137-D7F5-57EC-87DA-1DB460D64046,"iPhone13,2"
com.apple.news,8,1731792083,1731792091,1731792091.3031569,-21600,EB445137-D7F5-57EC-87DA-1DB460D64046,"iPhone13,2"
com.apple.news,74,1731791419,1731791493,1731791493.739128,-21600,EB445137-D7F5-57EC-87DA-1DB460D64046,"iPhone13,2"
com.apple.Health,130,1731790725,1731790855,1731790855.399369,-21600,EB445137-D7F5-57EC-87DA-1DB460D64046,"iPhone13,2"
com.apple.news,4,1731790721,1731790725,1731790725.631825,-21600,EB445137-D7F5-57EC-87DA-1DB460D64046,"iPhone13,2"
com.apple.news,1,1731790715,1731790716,1731790716.978339,-21600,EB445137-D7F5-57EC-87DA-1DB460D64046,"iPhone13,2"
com.apple.news,57,1731790637,1731790694,1731790695.0953279,-21600,EB445137-D7F5-57EC-87DA-1DB460D64046,"iPhone13,2"
com.burbn.instagram,58,1731790510,1731790568,1731790568.945723,-21600,EB445137-D7F5-57EC-87DA-1DB460D64046,"iPhone13,2"
com.toyopagroup.picaboo,19,1731790486,1731790505,1731790506.051754,-21600,EB445137-D7F5-57EC-87DA-1DB460D64046,"iPhone13,2"
com.apple.news,8,1731790478,1731790486,1731790486.427623,-21600,EB445137-D7F5-57EC-87DA-1DB460D64046,"iPhone13,2"
com.apple.news,10,1731790348,1731790358,1731790358.255938,-21600,EB445137-D7F5-57EC-87DA-1DB460D64046,"iPhone13,2"
com.apple.news,2,1731790189,1731790191,1731790191.509221,-21600,EB445137-D7F5-57EC-87DA-1DB460D64046,"iPhone13,2"
com.apple.news,5,1731790037,1731790042,1731790042.832036,-21600,EB445137-D7F5-57EC-87DA-1DB460D64046,"iPhone13,2"
com.apple.news,39,1731789920,1731789959,1731789960.112002,-21600,EB445137-D7F5-57EC-87DA-1DB460D64046,"iPhone13,2"
com.google.chrome.ios,18,1731789898,1731789916,1731789916.4419,-21600,EB445137-D7F5-57EC-87DA-1DB460D64046,"iPhone13,2"
com.google.chrome.ios,46,1731789684,1731789730,1731789730.627631,-21600,EB445137-D7F5-57EC-87DA-1DB460D64046,"iPhone13,2"
com.google.ios.youtube,961,1731787205,1731788166,1731788166.861534,-21600,EB445137-D7F5-57EC-87DA-1DB460D64046,"iPhone13,2"
com.apple.news,4,1731787198,1731787202,1731787202.322091,-21600,EB445137-D7F5-57EC-87DA-1DB460D64046,"iPhone13,2"
com.apple.news,6,1731787182,1731787188,1731787188.974029,-21600,EB445137-D7F5-57EC-87DA-1DB460D64046,"iPhone13,2"
com.leomehlig.today,21,1731787160,1731787181,1731787181.401535,-21600,,
com.microsoft.VSCode,7,1731787153,1731787160,1731787160.59626,-21600,,
com.google.Chrome,121,1731787032,1731787153,1731787153.600621,-21600,,
com.microsoft.VSCode,22,1731787010,1731787032,1731787032.197634,-21600,,
com.google.Chrome,1,1731787009,1731787010,1731787010.4996161,-21600,,
com.microsoft.VSCode,25,1731786970,1731786995,1731786996.003428,-21600,,
com.google.Chrome,16,1731786954,1731786970,1731786970.785952,-21600,,
com.microsoft.VSCode,4,1731786950,1731786954,1731786954.582331,-21600,,
com.google.Chrome,3,1731786947,1731786950,1731786950.804233,-21600,,
com.microsoft.VSCode,1,1731786946,1731786947,1731786947.565802,-21600,,
com.google.Chrome,1,1731786945,1731786946,1731786946.7580528,-21600,,
com.microsoft.VSCode,2,1731786943,1731786945,1731786945.075089,-21600,,
com.google.Chrome,3,1731786940,1731786943,1731786943.931477,-21600,,
com.microsoft.VSCode,2,1731786938,1731786940,1731786940.051069,-21600,,
com.google.Chrome,4,1731786934,1731786938,1731786938.8435931,-21600,,
com.microsoft.VSCode,3,1731786931,1731786934,1731786934.093666,-21600,,
com.google.Chrome,4,1731786927,1731786931,1731786931.832573,-21600,,
com.microsoft.VSCode,3,1731786924,1731786927,1731786927.6971111,-21600,,
com.google.Chrome,1,1731786923,1731786924,1731786924.452049,-21600,,
com.microsoft.VSCode,1,1731786922,1731786923,1731786923.868916,-21600,,
com.google.Chrome,5,1731786917,1731786922,1731786922.6325831,-21600,,
com.microsoft.VSCode,27,1731786890,1731786917,1731786917.773621,-21600,,
com.google.Chrome,19,1731786871,1731786890,1731786890.607181,-21600,,
com.microsoft.VSCode,4,1731786867,1731786871,1731786872.0567389,-21600,,
com.google.Chrome,5,1731786862,1731786867,1731786867.196667,-21600,,
com.microsoft.VSCode,132,1731786730,1731786862,1731786862.3517098,-21600,,
com.google.Chrome,8,1731786722,1731786730,1731786730.602325,-21600,,
com.apple.finder,33,1731786689,1731786722,1731786722.576895,-21600,,
com.google.Chrome,48,1731786641,1731786689,1731786689.512222,-21600,,
com.leomehlig.today,8,1731786615,1731786623,1731786623.253193,-21600,,
com.google.Chrome,544,1731786071,1731786615,1731786615.155065,-21600,,
com.apple.mobileslideshow,66,1731785892,1731785958,1731785958.421002,-21600,EB445137-D7F5-57EC-87DA-1DB460D64046,"iPhone13,2"
com.leomehlig.today,204,1731785867,1731786071,1731786071.904499,-21600,,
com.google.Chrome,1068,1731784799,1731785867,1731785867.850144,-21600,,
com.leomehlig.today,7,1731784792,1731784799,1731784799.471905,-21600,,
com.google.Chrome,46,1731784746,1731784792,1731784792.6547961,-21600,,
com.apple.finder,2,1731784744,1731784746,1731784746.299643,-21600,,
com.google.Chrome,2,1731784742,1731784744,1731784744.774763,-21600,,
com.apple.finder,5,1731784737,1731784742,1731784742.476777,-21600,,
com.apple.mobileslideshow,51,1731784727,1731784778,1731784779.127775,-21600,EB445137-D7F5-57EC-87DA-1DB460D64046,"iPhone13,2"
com.apple.camera,24,1731784703,1731784727,1731784728.266001,-21600,EB445137-D7F5-57EC-87DA-1DB460D64046,"iPhone13,2"
com.google.Chrome,1118,1731783619,1731784737,1731784738.0880861,-21600,,
com.leomehlig.today,71,1731783534,1731783605,1731783605.331696,-21600,,
edu.illinois.rokwire.ios,4,1731783182,1731783186,1731783186.756971,-21600,EB445137-D7F5-57EC-87DA-1DB460D64046,"iPhone13,2"
edu.illinois.rokwire.ios,2,1731783060,1731783062,1731783062.788361,-21600,EB445137-D7F5-57EC-87DA-1DB460D64046,"iPhone13,2"
edu.illinois.rokwire.ios,6,1731782814,1731782820,1731782820.154783,-21600,EB445137-D7F5-57EC-87DA-1DB460D64046,"iPhone13,2"
edu.illinois.rokwire.ios,1,1731782812,1731782813,1731782813.460794,-21600,EB445137-D7F5-57EC-87DA-1DB460D64046,"iPhone13,2"
edu.illinois.rokwire.ios,20,1731782180,1731782200,1731782200.743239,-21600,EB445137-D7F5-57EC-87DA-1DB460D64046,"iPhone13,2"
com.apple.news,2,1731782178,1731782180,1731782180.442966,-21600,EB445137-D7F5-57EC-87DA-1DB460D64046,"iPhone13,2"
com.apple.news,2,1731782078,1731782080,1731782080.716899,-21600,EB445137-D7F5-57EC-87DA-1DB460D64046,"iPhone13,2"
com.apple.news,16,1731781846,1731781862,1731781862.212326,-21600,EB445137-D7F5-57EC-87DA-1DB460D64046,"iPhone13,2"
com.apple.news,113,1731781674,1731781787,1731781787.760387,-21600,EB445137-D7F5-57EC-87DA-1DB460D64046,"iPhone13,2"
com.apple.news,6,1731781588,1731781594,1731781594.131257,-21600,EB445137-D7F5-57EC-87DA-1DB460D64046,"iPhone13,2"
com.apple.news,49,1731781535,1731781584,1731781585.251861,-21600,EB445137-D7F5-57EC-87DA-1DB460D64046,"iPhone13,2"
com.apple.MobileSMS,4,1731780835,1731780839,1731780839.482791,-21600,EB445137-D7F5-57EC-87DA-1DB460D64046,"iPhone13,2"
edu.illinois.rokwire.ios,4,1731780012,1731780016,1731780016.637914,-21600,EB445137-D7F5-57EC-87DA-1DB460D64046,"iPhone13,2"
edu.illinois.rokwire.ios,31,1731778651,1731778682,1731778683.012546,-21600,EB445137-D7F5-57EC-87DA-1DB460D64046,"iPhone13,2"
com.google.chrome.ios,2,1731778647,1731778649,1731778650.010067,-21600,EB445137-D7F5-57EC-87DA-1DB460D64046,"iPhone13,2"
com.google.chrome.ios,12,1731777575,1731777587,1731777587.8202271,-21600,EB445137-D7F5-57EC-87DA-1DB460D64046,"iPhone13,2"
com.google.chrome.ios,3,1731777572,1731777575,1731777575.5599031,-21600,EB445137-D7F5-57EC-87DA-1DB460D64046,"iPhone13,2"
com.google.ios.youtube,3,1731777569,1731777572,1731777572.4792938,-21600,EB445137-D7F5-57EC-87DA-1DB460D64046,"iPhone13,2"
com.google.ios.youtube,5,1731777551,1731777556,1731777556.624094,-21600,EB445137-D7F5-57EC-87DA-1DB460D64046,"iPhone13,2"
com.google.ios.youtube,615,1731776909,1731777524,1731777524.691715,-21600,EB445137-D7F5-57EC-87DA-1DB460D64046,"iPhone13,2"
com.apple.weather,63,1731776843,1731776906,1731776906.300191,-21600,EB445137-D7F5-57EC-87DA-1DB460D64046,"iPhone13,2"
Astrospheric.Astrospheric,3,1731776836,1731776839,1731776839.211985,-21600,EB445137-D7F5-57EC-87DA-1DB460D64046,"iPhone13,2"
Astrospheric.Astrospheric,9,1731776726,1731776735,1731776736.034183,-21600,EB445137-D7F5-57EC-87DA-1DB460D64046,"iPhone13,2"
com.hammerandchisel.discord,8,1731776717,1731776725,1731776725.151144,-21600,EB445137-D7F5-57EC-87DA-1DB460D64046,"iPhone13,2"
com.truebill.truebillnative,3,1731776587,1731776590,1731776590.932725,-21600,EB445137-D7F5-57EC-87DA-1DB460D64046,"iPhone13,2"
com.truebill.truebillnative,35,1731776551,1731776586,1731776586.560822,-21600,EB445137-D7F5-57EC-87DA-1DB460D64046,"iPhone13,2"
com.apple.calculator,2,1731776548,1731776550,1731776550.8452768,-21600,EB445137-D7F5-57EC-87DA-1DB460D64046,"iPhone13,2"
com.apple.calculator,61,1731776482,1731776543,1731776543.581643,-21600,EB445137-D7F5-57EC-87DA-1DB460D64046,"iPhone13,2"
com.renpho.health,2,1731776476,1731776478,1731776478.927997,-21600,EB445137-D7F5-57EC-87DA-1DB460D64046,"iPhone13,2"
com.renpho.health,12,1731776251,1731776263,1731776263.680616,-21600,EB445137-D7F5-57EC-87DA-1DB460D64046,"iPhone13,2"
com.renpho.health,2,1731775634,1731775636,1731775636.677054,-21600,EB445137-D7F5-57EC-87DA-1DB460D64046,"iPhone13,2"
com.renpho.health,21,1731775604,1731775625,1731775625.6274772,-21600,EB445137-D7F5-57EC-87DA-1DB460D64046,"iPhone13,2"
com.google.ios.youtube,1,1731775597,1731775598,1731775598.23567,-21600,EB445137-D7F5-57EC-87DA-1DB460D64046,"iPhone13,2"
com.google.ios.youtube,12,1731774605,1731774617,1731774618.027607,-21600,EB445137-D7F5-57EC-87DA-1DB460D64046,"iPhone13,2"
com.google.ios.youtube,2919,1731771682,1731774601,1731774601.999048,-21600,EB445137-D7F5-57EC-87DA-1DB460D64046,"iPhone13,2"
com.hammerandchisel.discord,26,1731771650,1731771676,1731771676.938751,-21600,EB445137-D7F5-57EC-87DA-1DB460D64046,"iPhone13,2"
com.apple.mobiletimer,0,1731771592,1731771592,1731771592.820559,-21600,EB445137-D7F5-57EC-87DA-1DB460D64046,"iPhone13,2"
com.apple.mobiletimer,25,1731771559,1731771584,1731771584.8134089,-21600,EB445137-D7F5-57EC-87DA-1DB460D64046,"iPhone13,2"
com.apple.mobiletimer,28,1731771001,1731771029,1731771029.667251,-21600,EB445137-D7F5-57EC-87DA-1DB460D64046,"iPhone13,2"
com.apple.mobiletimer,1,1731743806,1731743807,1731743820.510674,-21600,EB445137-D7F5-57EC-87DA-1DB460D64046,"iPhone13,2"
com.apple.mobiletimer,0,1731743803,1731743803,1731743820.482528,-21600,EB445137-D7F5-57EC-87DA-1DB460D64046,"iPhone13,2"
com.apple.camera,1,1731743802,1731743803,1731743820.302572,-21600,EB445137-D7F5-57EC-87DA-1DB460D64046,"iPhone13,2"
com.leomehlig.today,6,1731743598,1731743604,1731743604.592135,-21600,,
com.apple.finder,3,1731743595,1731743598,1731743598.384393,-21600,,
com.apple.Photos,1233,1731742362,1731743595,1731743595.288522,-21600,,
com.apple.QuickTimePlayerX,8,1731742354,1731742362,1731742362.495985,-21600,,
com.apple.QuickTimePlayerX,596,1731741038,1731741634,1731741634.156705,-21600,,
com.apple.finder,1,1731741037,1731741038,1731741038.162535,-21600,,
com.apple.QuickTimePlayerX,2,1731741035,1731741037,1731741038.024891,-21600,,
com.apple.finder,2,1731741033,1731741035,1731741035.113503,-21600,,
com.apple.QuickTimePlayerX,2,1731741031,1731741033,1731741033.583487,-21600,,
com.apple.finder,1,1731741030,1731741031,1731741031.846463,-21600,,
com.apple.QuickTimePlayerX,5,1731741025,1731741030,1731741030.109765,-21600,,
com.apple.finder,17,1731741008,1731741025,1731741025.621512,-21600,,
com.google.Chrome,510,1731740498,1731741008,1731741008.75043,-21600,,
com.apple.Music,4,1731740470,1731740474,1731740481.2899818,-21600,EB445137-D7F5-57EC-87DA-1DB460D64046,"iPhone13,2"
com.apple.Music,30,1731740418,1731740448,1731740450.465486,-21600,EB445137-D7F5-57EC-87DA-1DB460D64046,"iPhone13,2"
com.burbn.instagram,52,1731740326,1731740378,1731740385.19593,-21600,EB445137-D7F5-57EC-87DA-1DB460D64046,"iPhone13,2"
com.apple.Music,26,1731740300,1731740326,1731740331.9902148,-21600,EB445137-D7F5-57EC-87DA-1DB460D64046,"iPhone13,2"
com.apple.Music,15,1731739767,1731739782,1731739782.794282,-21600,EB445137-D7F5-57EC-87DA-1DB460D64046,"iPhone13,2"
com.apple.Music,10,1731738659,1731738669,1731738669.3650331,-21600,EB445137-D7F5-57EC-87DA-1DB460D64046,"iPhone13,2"
com.apple.Music,53,1731738503,1731738556,1731738556.7338371,-21600,EB445137-D7F5-57EC-87DA-1DB460D64046,"iPhone13,2"
com.apple.weather,4,1731738498,1731738502,1731738502.932469,-21600,EB445137-D7F5-57EC-87DA-1DB460D64046,"iPhone13,2"
com.apple.weather,4,1731738434,1731738438,1731738438.520226,-21600,EB445137-D7F5-57EC-87DA-1DB460D64046,"iPhone13,2"
com.apple.camera,470,1731737898,1731738368,1731738368.45644,-21600,EB445137-D7F5-57EC-87DA-1DB460D64046,"iPhone13,2"
com.google.Chrome,9,1731736462,1731736471,1731736471.673349,-21600,,
com.burbn.instagram,4,1731735446,1731735450,1731735450.8549,-21600,EB445137-D7F5-57EC-87DA-1DB460D64046,"iPhone13,2"
com.burbn.instagram,648,1731734747,1731735395,1731735396.449191,-21600,EB445137-D7F5-57EC-87DA-1DB460D64046,"iPhone13,2"
com.burbn.instagram,32,1731734626,1731734658,1731734660.0501142,-21600,EB445137-D7F5-57EC-87DA-1DB460D64046,"iPhone13,2"
com.apple.news,10,1731734610,1731734620,1731734620.652322,-21600,EB445137-D7F5-57EC-87DA-1DB460D64046,"iPhone13,2"
com.apple.news,37,1731734244,1731734281,1731734281.704627,-21600,EB445137-D7F5-57EC-87DA-1DB460D64046,"iPhone13,2"
com.apple.news,34,1731733946,1731733980,1731733980.9848099,-21600,EB445137-D7F5-57EC-87DA-1DB460D64046,"iPhone13,2"
com.google.Chrome,846,1731733448,1731734294,1731734294.519834,-21600,,
com.apple.news,25,1731733120,1731733145,1731733146.029645,-21600,EB445137-D7F5-57EC-87DA-1DB460D64046,"iPhone13,2"
com.google.Chrome,433,1731732264,1731732697,1731732697.6370878,-21600,,
com.apple.news,2,1731731209,1731731211,1731731211.888629,-21600,EB445137-D7F5-57EC-87DA-1DB460D64046,"iPhone13,2"
com.apple.news,23,1731731154,1731731177,1731731177.705258,-21600,EB445137-D7F5-57EC-87DA-1DB460D64046,"iPhone13,2"
com.google.chrome.ios,10,1731731134,1731731144,1731731145.314321,-21600,EB445137-D7F5-57EC-87DA-1DB460D64046,"iPhone13,2"
com.google.chrome.ios,82,1731731043,1731731125,1731731126.248672,-21600,EB445137-D7F5-57EC-87DA-1DB460D64046,"iPhone13,2"
com.apple.MobileSMS,3,1731731039,1731731042,1731731042.990102,-21600,EB445137-D7F5-57EC-87DA-1DB460D64046,"iPhone13,2"
com.apple.MobileSMS,2,1731730968,1731730970,1731730970.701226,-21600,EB445137-D7F5-57EC-87DA-1DB460D64046,"iPhone13,2"
com.apple.MobileSMS,105,1731730745,1731730850,1731730850.7719421,-21600,EB445137-D7F5-57EC-87DA-1DB460D64046,"iPhone13,2"
com.apple.MobileSMS,6,1731730733,1731730739,1731730739.9721541,-21600,EB445137-D7F5-57EC-87DA-1DB460D64046,"iPhone13,2"
com.google.Chrome,1195,1731730687,1731731882,1731731882.725923,-21600,,
com.leomehlig.today,1,1731730686,1731730687,1731730690.151294,-21600,,
com.apple.MobileSMS,39,1731730614,1731730653,1731730654.6614199,-21600,EB445137-D7F5-57EC-87DA-1DB460D64046,"iPhone13,2"
com.apple.MobileSMS,3,1731722912,1731722915,1731722915.912508,-21600,EB445137-D7F5-57EC-87DA-1DB460D64046,"iPhone13,2"
com.apple.MobileSMS,70,1731722838,1731722908,1731722908.717268,-21600,EB445137-D7F5-57EC-87DA-1DB460D64046,"iPhone13,2"
com.toyopagroup.picaboo,2,1731722196,1731722198,1731722198.56299,-21600,EB445137-D7F5-57EC-87DA-1DB460D64046,"iPhone13,2"
com.google.chrome.ios,3,1731722193,1731722196,1731722197.350188,-21600,EB445137-D7F5-57EC-87DA-1DB460D64046,"iPhone13,2"
com.google.chrome.ios,21,1731720188,1731720209,1731720225.223915,-21600,EB445137-D7F5-57EC-87DA-1DB460D64046,"iPhone13,2"
com.apple.camera,21,1731720188,1731720209,1731720225.122289,-21600,EB445137-D7F5-57EC-87DA-1DB460D64046,"iPhone13,2"
com.google.chrome.ios,108,1731717296,1731717404,1731717404.577205,-21600,EB445137-D7F5-57EC-87DA-1DB460D64046,"iPhone13,2"
com.apple.Music,3,1731717293,1731717296,1731717297.411484,-21600,EB445137-D7F5-57EC-87DA-1DB460D64046,"iPhone13,2"
com.apple.Music,12,1731715514,1731715526,1731715526.556164,-21600,EB445137-D7F5-57EC-87DA-1DB460D64046,"iPhone13,2"
com.instructure.icanvas,3,1731715503,1731715506,1731715506.9996572,-21600,EB445137-D7F5-57EC-87DA-1DB460D64046,"iPhone13,2"
com.apple.MobileSMS,8,1731715491,1731715499,1731715499.713941,-21600,EB445137-D7F5-57EC-87DA-1DB460D64046,"iPhone13,2"
com.apple.news,14,1731715428,1731715442,1731715442.7269058,-21600,EB445137-D7F5-57EC-87DA-1DB460D64046,"iPhone13,2"
com.apple.weather,8,1731715419,1731715427,1731715427.848133,-21600,EB445137-D7F5-57EC-87DA-1DB460D64046,"iPhone13,2"
com.apple.news,4,1731715414,1731715418,1731715418.374078,-21600,EB445137-D7F5-57EC-87DA-1DB460D64046,"iPhone13,2"
com.apple.weather,12,1731715401,1731715413,1731715413.841373,-21600,EB445137-D7F5-57EC-87DA-1DB460D64046,"iPhone13,2"
com.apple.MobileSMS,3,1731715388,1731715391,1731715391.7137918,-21600,EB445137-D7F5-57EC-87DA-1DB460D64046,"iPhone13,2"
com.apple.MobileSMS,6,1731715342,1731715348,1731715348.364657,-21600,EB445137-D7F5-57EC-87DA-1DB460D64046,"iPhone13,2"
com.apple.MobileSMS,6,1731715206,1731715212,1731715212.854591,-21600,EB445137-D7F5-57EC-87DA-1DB460D64046,"iPhone13,2"
com.apple.MobileSMS,5,1731715182,1731715187,1731715187.279379,-21600,EB445137-D7F5-57EC-87DA-1DB460D64046,"iPhone13,2"
com.apple.MobileSMS,3,1731715171,1731715174,1731715174.6568952,-21600,EB445137-D7F5-57EC-87DA-1DB460D64046,"iPhone13,2"
com.burbn.instagram,123,1731715048,1731715171,1731715171.959388,-21600,EB445137-D7F5-57EC-87DA-1DB460D64046,"iPhone13,2"
com.apple.MobileSMS,3,1731715042,1731715045,1731715045.490912,-21600,EB445137-D7F5-57EC-87DA-1DB460D64046,"iPhone13,2"
com.apple.MobileSMS,41,1731714997,1731715038,1731715038.756304,-21600,EB445137-D7F5-57EC-87DA-1DB460D64046,"iPhone13,2"
com.apple.MobileSMS,3,1731714978,1731714981,1731714981.9484138,-21600,EB445137-D7F5-57EC-87DA-1DB460D64046,"iPhone13,2"
com.apple.Music,1,1731714977,1731714978,1731714978.765928,-21600,EB445137-D7F5-57EC-87DA-1DB460D64046,"iPhone13,2"
com.apple.Music,10,1731714965,1731714975,1731714975.854494,-21600,EB445137-D7F5-57EC-87DA-1DB460D64046,"iPhone13,2"
com.apple.Music,17,1731714945,1731714962,1731714962.81159,-21600,EB445137-D7F5-57EC-87DA-1DB460D64046,"iPhone13,2"
com.apple.Music,17,1731714691,1731714708,1731714708.2832608,-21600,EB445137-D7F5-57EC-87DA-1DB460D64046,"iPhone13,2"
com.apple.MobileSMS,2,1731714673,1731714675,1731714675.68834,-21600,EB445137-D7F5-57EC-87DA-1DB460D64046,"iPhone13,2"
com.apple.MobileSMS,19,1731714327,1731714346,1731714346.74159,-21600,EB445137-D7F5-57EC-87DA-1DB460D64046,"iPhone13,2"
com.apple.MobileSMS,6,1731714181,1731714187,1731714188.009684,-21600,EB445137-D7F5-57EC-87DA-1DB460D64046,"iPhone13,2"
com.apple.mobilenotes,2,1731714179,1731714181,1731714181.765359,-21600,EB445137-D7F5-57EC-87DA-1DB460D64046,"iPhone13,2"
com.apple.mobilenotes,2,1731713835,1731713837,1731713837.5297232,-21600,EB445137-D7F5-57EC-87DA-1DB460D64046,"iPhone13,2"
com.apple.mobilenotes,5,1731713494,1731713499,1731713499.3688998,-21600,EB445137-D7F5-57EC-87DA-1DB460D64046,"iPhone13,2"
com.apple.mobilenotes,9,1731713071,1731713080,1731713080.267344,-21600,EB445137-D7F5-57EC-87DA-1DB460D64046,"iPhone13,2"
com.apple.mobilenotes,3,1731712656,1731712659,1731712659.2006469,-21600,EB445137-D7F5-57EC-87DA-1DB460D64046,"iPhone13,2"
com.apple.mobilenotes,6,1731712176,1731712182,1731712182.923053,-21600,EB445137-D7F5-57EC-87DA-1DB460D64046,"iPhone13,2"
com.apple.mobilenotes,8,1731711874,1731711882,1731711882.259027,-21600,EB445137-D7F5-57EC-87DA-1DB460D64046,"iPhone13,2"
com.apple.mobilenotes,8,1731711865,1731711873,1731711874.0423,-21600,EB445137-D7F5-57EC-87DA-1DB460D64046,"iPhone13,2"
com.apple.MobileSMS,6,1731711859,1731711865,1731711865.680799,-21600,EB445137-D7F5-57EC-87DA-1DB460D64046,"iPhone13,2"
com.apple.MobileSMS,3,1731709664,1731709667,1731709667.794859,-21600,EB445137-D7F5-57EC-87DA-1DB460D64046,"iPhone13,2"
com.apple.Maps,2,1731709662,1731709664,1731709665.1711888,-21600,EB445137-D7F5-57EC-87DA-1DB460D64046,"iPhone13,2"
com.apple.Maps,3,1731709310,1731709313,1731709313.470756,-21600,EB445137-D7F5-57EC-87DA-1DB460D64046,"iPhone13,2"
com.apple.Maps,1,1731709304,1731709305,1731709305.239608,-21600,EB445137-D7F5-57EC-87DA-1DB460D64046,"iPhone13,2"
com.apple.Maps,49,1731709247,1731709296,1731709296.391247,-21600,EB445137-D7F5-57EC-87DA-1DB460D64046,"iPhone13,2"
com.apple.weather,2,1731709238,1731709240,1731709240.0495,-21600,EB445137-D7F5-57EC-87DA-1DB460D64046,"iPhone13,2"
com.apple.MobileSMS,8,1731709223,1731709231,1731709231.049478,-21600,EB445137-D7F5-57EC-87DA-1DB460D64046,"iPhone13,2"
com.apple.MobileSMS,16,1731709205,1731709221,1731709221.436209,-21600,EB445137-D7F5-57EC-87DA-1DB460D64046,"iPhone13,2"
com.apple.MobileSMS,7,1731709196,1731709203,1731709203.537775,-21600,EB445137-D7F5-57EC-87DA-1DB460D64046,"iPhone13,2"
com.apple.MobileSMS,9,1731709185,1731709194,1731709194.971789,-21600,EB445137-D7F5-57EC-87DA-1DB460D64046,"iPhone13,2"
com.apple.MobileSMS,21,1731709154,1731709175,1731709175.434205,-21600,EB445137-D7F5-57EC-87DA-1DB460D64046,"iPhone13,2"
com.apple.MobileSMS,5,1731709101,1731709106,1731709106.406269,-21600,EB445137-D7F5-57EC-87DA-1DB460D64046,"iPhone13,2"
com.supercell.magic,2,1731709099,1731709101,1731709101.223088,-21600,EB445137-D7F5-57EC-87DA-1DB460D64046,"iPhone13,2"
com.leomehlig.today,35,1731709033,1731709068,1731709068.395585,-21600,,
com.google.Chrome,10,1731709023,1731709033,1731709033.573903,-21600,,
com.microsoft.VSCode,457,1731708566,1731709023,1731709023.926096,-21600,,
com.supercell.magic,458,1731708100,1731708558,1731708559.8416529,-21600,EB445137-D7F5-57EC-87DA-1DB460D64046,"iPhone13,2"
com.apple.MobileSMS,11,1731708089,1731708100,1731708100.835438,-21600,EB445137-D7F5-57EC-87DA-1DB460D64046,"iPhone13,2"
com.supercell.magic,9,1731708080,1731708089,1731708090.146747,-21600,EB445137-D7F5-57EC-87DA-1DB460D64046,"iPhone13,2"
com.apple.MobileSMS,201,1731707876,1731708077,1731708077.666222,-21600,EB445137-D7F5-57EC-87DA-1DB460D64046,"iPhone13,2"
com.apple.mobilenotes,78,1731707798,1731707876,1731707876.315359,-21600,EB445137-D7F5-57EC-87DA-1DB460D64046,"iPhone13,2"
com.tinyspeck.chatlyio,41,1731707748,1731707789,1731707789.280878,-21600,EB445137-D7F5-57EC-87DA-1DB460D64046,"iPhone13,2"
com.hammerandchisel.discord,27,1731707706,1731707733,1731707733.9931579,-21600,EB445137-D7F5-57EC-87DA-1DB460D64046,"iPhone13,2"
com.hammerandchisel.discord,6,1731707698,1731707704,1731707704.395574,-21600,EB445137-D7F5-57EC-87DA-1DB460D64046,"iPhone13,2"
com.hammerandchisel.discord,29,1731707663,1731707692,1731707692.6130219,-21600,EB445137-D7F5-57EC-87DA-1DB460D64046,"iPhone13,2"
com.apple.mobilenotes,4,1731707647,1731707651,1731707652.0187101,-21600,EB445137-D7F5-57EC-87DA-1DB460D64046,"iPhone13,2"
com.apple.mobilenotes,6,1731707632,1731707638,1731707638.1640038,-21600,EB445137-D7F5-57EC-87DA-1DB460D64046,"iPhone13,2"
com.apple.mobilenotes,6,1731707544,1731707550,1731707550.780449,-21600,EB445137-D7F5-57EC-87DA-1DB460D64046,"iPhone13,2"
com.apple.mobilenotes,137,1731707406,1731707543,1731707544.740397,-21600,EB445137-D7F5-57EC-87DA-1DB460D64046,"iPhone13,2"
com.apple.news,47,1731707358,1731707405,1731707405.253542,-21600,EB445137-D7F5-57EC-87DA-1DB460D64046,"iPhone13,2"
com.apple.news,8,1731707348,1731707356,1731707356.7591949,-21600,EB445137-D7F5-57EC-87DA-1DB460D64046,"iPhone13,2"
com.apple.news,2,1731707320,1731707322,1731707322.977258,-21600,EB445137-D7F5-57EC-87DA-1DB460D64046,"iPhone13,2"
com.apple.MobileSMS,13,1731707301,1731707314,1731707315.2703671,-21600,EB445137-D7F5-57EC-87DA-1DB460D64046,"iPhone13,2"
com.apple.Health,19,1731704763,1731704782,1731704782.851297,-21600,EB445137-D7F5-57EC-87DA-1DB460D64046,"iPhone13,2"
com.apple.news,88,1731704671,1731704759,1731704759.7718658,-21600,EB445137-D7F5-57EC-87DA-1DB460D64046,"iPhone13,2"
com.apple.news,50,1731704395,1731704445,1731704445.449661,-21600,EB445137-D7F5-57EC-87DA-1DB460D64046,"iPhone13,2"
com.apple.MobileSMS,5,1731704384,1731704389,1731704389.5431728,-21600,EB445137-D7F5-57EC-87DA-1DB460D64046,"iPhone13,2"
com.apple.MobileSMS,27,1731704015,1731704042,1731704042.5134811,-21600,EB445137-D7F5-57EC-87DA-1DB460D64046,"iPhone13,2"
com.apple.MobileSMS,3,1731703820,1731703823,1731703823.999364,-21600,EB445137-D7F5-57EC-87DA-1DB460D64046,"iPhone13,2"
com.apple.MobileSMS,12,1731703707,1731703719,1731703719.9713612,-21600,EB445137-D7F5-57EC-87DA-1DB460D64046,"iPhone13,2"
com.microsoft.VSCode,433,1731702904,1731703337,1731703337.5293388,-21600,,
com.google.Chrome,80,1731702824,1731702904,1731702904.147557,-21600,,
com.microsoft.VSCode,17,1731702807,1731702824,1731702824.186665,-21600,,
com.google.Chrome,68,1731702739,1731702807,1731702807.07148,-21600,,
com.microsoft.VSCode,625,1731702114,1731702739,1731702739.2899098,-21600,,
com.leomehlig.today,42,1731702072,1731702114,1731702114.962796,-21600,,
com.google.Chrome,73,1731701999,1731702072,1731702072.79794,-21600,,
com.leomehlig.today,33,1731701951,1731701984,1731701984.736349,-21600,,
com.google.Chrome,9,1731701942,1731701951,1731701951.276496,-21600,,
com.google.chrome.ios,0,1731701896,1731701896,1731701896.6178331,-21600,EB445137-D7F5-57EC-87DA-1DB460D64046,"iPhone13,2"
com.google.chrome.ios,8,1731701029,1731701037,1731701037.487351,-21600,EB445137-D7F5-57EC-87DA-1DB460D64046,"iPhone13,2"
com.google.chrome.ios,22,1731700528,1731700550,1731700551.164863,-21600,EB445137-D7F5-57EC-87DA-1DB460D64046,"iPhone13,2"
edu.illinois.rokwire.ios,3,1731700524,1731700527,1731700527.8562942,-21600,EB445137-D7F5-57EC-87DA-1DB460D64046,"iPhone13,2"
edu.illinois.rokwire.ios,5,1731700222,1731700227,1731700227.8471432,-21600,EB445137-D7F5-57EC-87DA-1DB460D64046,"iPhone13,2"
edu.illinois.rokwire.ios,12,1731700070,1731700082,1731700082.6701999,-21600,EB445137-D7F5-57EC-87DA-1DB460D64046,"iPhone13,2"
edu.illinois.rokwire.ios,28,1731700039,1731700067,1731700067.999738,-21600,EB445137-D7F5-57EC-87DA-1DB460D64046,"iPhone13,2"
com.google.chrome.ios,3,1731700036,1731700039,1731700039.417002,-21600,EB445137-D7F5-57EC-87DA-1DB460D64046,"iPhone13,2"
com.google.chrome.ios,6,1731699946,1731699952,1731699952.2405019,-21600,EB445137-D7F5-57EC-87DA-1DB460D64046,"iPhone13,2"
com.google.chrome.ios,22,1731699262,1731699284,1731699284.725307,-21600,EB445137-D7F5-57EC-87DA-1DB460D64046,"iPhone13,2"
com.apple.mobilenotes,15,1731699247,1731699262,1731699262.55495,-21600,EB445137-D7F5-57EC-87DA-1DB460D64046,"iPhone13,2"
com.apple.news,4,1731699243,1731699247,1731699248.383256,-21600,EB445137-D7F5-57EC-87DA-1DB460D64046,"iPhone13,2"
com.apple.news,14,1731698406,1731698420,1731698420.635366,-21600,EB445137-D7F5-57EC-87DA-1DB460D64046,"iPhone13,2"
com.apple.mobilecal,41,1731698363,1731698404,1731698404.649413,-21600,EB445137-D7F5-57EC-87DA-1DB460D64046,"iPhone13,2"
com.apple.news,101,1731698258,1731698359,1731698359.406722,-21600,EB445137-D7F5-57EC-87DA-1DB460D64046,"iPhone13,2"
com.hammerandchisel.discord,11,1731698237,1731698248,1731698248.082562,-21600,EB445137-D7F5-57EC-87DA-1DB460D64046,"iPhone13,2"
com.microsoft.Office.Outlook,7,1731698212,1731698219,1731698219.58304,-21600,EB445137-D7F5-57EC-87DA-1DB460D64046,"iPhone13,2"
edu.illinois.rokwire.ios,3,1731698209,1731698212,1731698212.322019,-21600,EB445137-D7F5-57EC-87DA-1DB460D64046,"iPhone13,2"
edu.illinois.rokwire.ios,4,1731696571,1731696575,1731696575.399651,-21600,EB445137-D7F5-57EC-87DA-1DB460D64046,"iPhone13,2"
edu.illinois.rokwire.ios,27,1731696494,1731696521,1731696522.43329,-21600,EB445137-D7F5-57EC-87DA-1DB460D64046,"iPhone13,2"
com.apple.camera,1,1731696345,1731696346,1731696346.500102,-21600,EB445137-D7F5-57EC-87DA-1DB460D64046,"iPhone13,2"
com.toyopagroup.picaboo,3,1731695926,1731695929,1731695930.075594,-21600,EB445137-D7F5-57EC-87DA-1DB460D64046,"iPhone13,2"
com.apple.Music,3,1731695923,1731695926,1731695926.924693,-21600,EB445137-D7F5-57EC-87DA-1DB460D64046,"iPhone13,2"
com.apple.Music,10,1731695675,1731695685,1731695685.437948,-21600,EB445137-D7F5-57EC-87DA-1DB460D64046,"iPhone13,2"
com.apple.Music,13,1731695656,1731695669,1731695669.192605,-21600,EB445137-D7F5-57EC-87DA-1DB460D64046,"iPhone13,2"
com.apple.Music,4,1731695649,1731695653,1731695653.5665421,-21600,EB445137-D7F5-57EC-87DA-1DB460D64046,"iPhone13,2"
com.apple.Music,5,1731695634,1731695639,1731695639.9806771,-21600,EB445137-D7F5-57EC-87DA-1DB460D64046,"iPhone13,2"
com.apple.Music,3,1731695577,1731695580,1731695580.582885,-21600,EB445137-D7F5-57EC-87DA-1DB460D64046,"iPhone13,2"
com.apple.Music,6,1731695568,1731695574,1731695574.3674722,-21600,EB445137-D7F5-57EC-87DA-1DB460D64046,"iPhone13,2"
com.apple.Music,21,1731695545,1731695566,1731695566.21843,-21600,EB445137-D7F5-57EC-87DA-1DB460D64046,"iPhone13,2"
com.google.ios.youtube,2,1731695538,1731695540,1731695540.944411,-21600,EB445137-D7F5-57EC-87DA-1DB460D64046,"iPhone13,2"
com.google.ios.youtube,1,1731695157,1731695158,1731695158.969888,-21600,EB445137-D7F5-57EC-87DA-1DB460D64046,"iPhone13,2"
com.google.ios.youtube,249,1731694905,1731695154,1731695155.398254,-21600,EB445137-D7F5-57EC-87DA-1DB460D64046,"iPhone13,2"
com.google.ios.youtube,1033,1731693797,1731694830,1731694830.666302,-21600,EB445137-D7F5-57EC-87DA-1DB460D64046,"iPhone13,2"
com.microsoft.Office.Outlook,2,1731693791,1731693793,1731693794.073442,-21600,EB445137-D7F5-57EC-87DA-1DB460D64046,"iPhone13,2"
com.microsoft.Office.Outlook,47,1731693003,1731693050,1731693050.811257,-21600,EB445137-D7F5-57EC-87DA-1DB460D64046,"iPhone13,2"
com.leomehlig.today,17,1731692985,1731693002,1731693002.938298,-21600,EB445137-D7F5-57EC-87DA-1DB460D64046,"iPhone13,2"
Astrospheric.Astrospheric,26,1731692953,1731692979,1731692979.81074,-21600,EB445137-D7F5-57EC-87DA-1DB460D64046,"iPhone13,2"
com.hammerandchisel.discord,26,1731692925,1731692951,1731692951.843151,-21600,EB445137-D7F5-57EC-87DA-1DB460D64046,"iPhone13,2"
com.apple.news,7,1731691985,1731691992,1731691992.264277,-21600,EB445137-D7F5-57EC-87DA-1DB460D64046,"iPhone13,2"
com.apple.news,1,1731691984,1731691985,1731691985.501317,-21600,EB445137-D7F5-57EC-87DA-1DB460D64046,"iPhone13,2"
com.apple.news,2,1731689726,1731689728,1731689728.23418,-21600,EB445137-D7F5-57EC-87DA-1DB460D64046,"iPhone13,2"
com.google.Chrome,239,1731689207,1731689446,1731689446.4513512,-21600,,
com.google.Chrome,1223,1731687968,1731689191,1731689191.394977,-21600,,
com.google.Chrome,1285,1731686677,1731687962,1731687962.5571818,-21600,,
com.apple.news,1,1731686323,1731686324,1731686324.908825,-21600,EB445137-D7F5-57EC-87DA-1DB460D64046,"iPhone13,2"
com.apple.news,1,1731686249,1731686250,1731686250.993153,-21600,EB445137-D7F5-57EC-87DA-1DB460D64046,"iPhone13,2"
com.apple.news,5,1731686244,1731686249,1731686249.226814,-21600,EB445137-D7F5-57EC-87DA-1DB460D64046,"iPhone13,2"
com.apple.news,9,1731686173,1731686182,1731686182.104536,-21600,EB445137-D7F5-57EC-87DA-1DB460D64046,"iPhone13,2"
com.apple.news,327,1731685216,1731685543,1731685544.069623,-21600,EB445137-D7F5-57EC-87DA-1DB460D64046,"iPhone13,2"
com.hammerandchisel.discord,9,1731685194,1731685203,1731685203.810358,-21600,EB445137-D7F5-57EC-87DA-1DB460D64046,"iPhone13,2"
com.renpho.health,10,1731685139,1731685149,1731685149.465178,-21600,EB445137-D7F5-57EC-87DA-1DB460D64046,"iPhone13,2"
com.renpho.health,10,1731684813,1731684823,1731684823.5003262,-21600,EB445137-D7F5-57EC-87DA-1DB460D64046,"iPhone13,2"
com.renpho.health,20,1731684308,1731684328,1731684328.682045,-21600,EB445137-D7F5-57EC-87DA-1DB460D64046,"iPhone13,2"
com.apple.news,4,1731684304,1731684308,1731684311.1098619,-21600,EB445137-D7F5-57EC-87DA-1DB460D64046,"iPhone13,2"
com.apple.news,13,1731683378,1731683391,1731683391.396899,-21600,EB445137-D7F5-57EC-87DA-1DB460D64046,"iPhone13,2"
com.apple.news,287,1731683089,1731683376,1731683376.285653,-21600,EB445137-D7F5-57EC-87DA-1DB460D64046,"iPhone13,2"
com.apple.news,509,1731682552,1731683061,1731683062.5094519,-21600,EB445137-D7F5-57EC-87DA-1DB460D64046,"iPhone13,2"
com.instructure.icanvas,5,1731682537,1731682542,1731682542.222933,-21600,EB445137-D7F5-57EC-87DA-1DB460D64046,"iPhone13,2"
com.toyopagroup.picaboo,4,1731682453,1731682457,1731682457.501048,-21600,EB445137-D7F5-57EC-87DA-1DB460D64046,"iPhone13,2"
com.apple.Music,13,1731650370,1731650383,1731650383.7945971,-21600,EB445137-D7F5-57EC-87DA-1DB460D64046,"iPhone13,2"
com.apple.Music,63,1731649655,1731649718,1731649718.829733,-21600,EB445137-D7F5-57EC-87DA-1DB460D64046,"iPhone13,2"
com.apple.Music,21,1731648939,1731648960,1731648960.658689,-21600,EB445137-D7F5-57EC-87DA-1DB460D64046,"iPhone13,2"
com.apple.Music,23,1731648865,1731648888,1731648888.507565,-21600,EB445137-D7F5-57EC-87DA-1DB460D64046,"iPhone13,2"
com.thestorygraph.thestorygraph,31,1731648231,1731648262,1731648262.800085,-21600,EB445137-D7F5-57EC-87DA-1DB460D64046,"iPhone13,2"
com.toyopagroup.picaboo,20,1731648208,1731648228,1731648228.1191092,-21600,EB445137-D7F5-57EC-87DA-1DB460D64046,"iPhone13,2"
com.apple.camera,4,1731648203,1731648207,1731648209.774098,-21600,EB445137-D7F5-57EC-87DA-1DB460D64046,"iPhone13,2"
com.apple.Health,108,1731644423,1731644531,1731644531.178819,-21600,EB445137-D7F5-57EC-87DA-1DB460D64046,"iPhone13,2"
com.google.chrome.ios,0,1731643659,1731643659,1731643659.970258,-21600,EB445137-D7F5-57EC-87DA-1DB460D64046,"iPhone13,2"
com.google.Chrome,583,1731643368,1731643951,1731643951.755443,-21600,,
com.google.Chrome,391,1731642667,1731643058,1731643058.847408,-21600,,
com.google.chrome.ios,9,1731641705,1731641714,1731641715.385786,-21600,EB445137-D7F5-57EC-87DA-1DB460D64046,"iPhone13,2"
com.google.chrome.ios,2,1731641700,1731641702,1731641702.875149,-21600,EB445137-D7F5-57EC-87DA-1DB460D64046,"iPhone13,2"
com.google.Chrome,1750,1731640693,1731642443,1731642443.3347611,-21600,,
com.leomehlig.today,7,1731640686,1731640693,1731640693.579329,-21600,,
com.leomehlig.today,1,1731640683,1731640684,1731640684.6428719,-21600,,
com.google.chrome.ios,38,1731640302,1731640340,1731640340.427219,-21600,EB445137-D7F5-57EC-87DA-1DB460D64046,"iPhone13,2"
com.apple.news,313,1731639988,1731640301,1731640301.1609988,-21600,EB445137-D7F5-57EC-87DA-1DB460D64046,"iPhone13,2"
com.hammerandchisel.discord,4,1731639934,1731639938,1731639938.792295,-21600,EB445137-D7F5-57EC-87DA-1DB460D64046,"iPhone13,2"
com.hammerandchisel.discord,32,1731639734,1731639766,1731639766.599029,-21600,EB445137-D7F5-57EC-87DA-1DB460D64046,"iPhone13,2"
com.apple.Music,5,1731639728,1731639733,1731639733.3208551,-21600,EB445137-D7F5-57EC-87DA-1DB460D64046,"iPhone13,2"
com.apple.Music,5,1731639718,1731639723,1731639723.288867,-21600,EB445137-D7F5-57EC-87DA-1DB460D64046,"iPhone13,2"
com.leomehlig.today,312,1731639675,1731639987,1731639987.2074819,-21600,,
com.microsoft.VSCode,13,1731639662,1731639675,1731639675.12572,-21600,,
com.google.Chrome,3,1731639659,1731639662,1731639662.6757421,-21600,,
com.apple.Music,5,1731639321,1731639326,1731639326.876598,-21600,EB445137-D7F5-57EC-87DA-1DB460D64046,"iPhone13,2"
com.apple.Music,4,1731639316,1731639320,1731639320.469345,-21600,EB445137-D7F5-57EC-87DA-1DB460D64046,"iPhone13,2"
com.apple.Music,8,1731639112,1731639120,1731639120.278432,-21600,EB445137-D7F5-57EC-87DA-1DB460D64046,"iPhone13,2"
com.apple.Music,2,1731638177,1731638179,1731638179.652911,-21600,EB445137-D7F5-57EC-87DA-1DB460D64046,"iPhone13,2"
com.apple.Music,101,1731637996,1731638097,1731638097.360184,-21600,EB445137-D7F5-57EC-87DA-1DB460D64046,"iPhone13,2"
com.apple.weather,4,1731637985,1731637989,1731637989.4910989,-21600,EB445137-D7F5-57EC-87DA-1DB460D64046,"iPhone13,2"
com.apple.weather,5,1731637958,1731637963,1731637963.224921,-21600,EB445137-D7F5-57EC-87DA-1DB460D64046,"iPhone13,2"
com.google.Chrome,1191,1731637035,1731638226,1731638226.197074,-21600,,
com.microsoft.VSCode,3,1731637015,1731637018,1731637018.350966,-21600,,
com.google.chrome.ios,9,1731636857,1731636866,1731636867.004034,-21600,EB445137-D7F5-57EC-87DA-1DB460D64046,"iPhone13,2"
com.microsoft.VSCode,195,1731635708,1731635903,1731635903.94169,-21600,,
com.google.Chrome,315,1731635393,1731635708,1731635708.928406,-21600,,
com.microsoft.VSCode,297,1731635096,1731635393,1731635393.716805,-21600,,
com.apple.iCal,30,1731635066,1731635096,1731635096.717243,-21600,,
com.microsoft.VSCode,1608,1731633458,1731635066,1731635066.737505,-21600,,
com.apple.iCal,60,1731633398,1731633458,1731633458.493688,-21600,,
com.microsoft.VSCode,33,1731633365,1731633398,1731633398.1660771,-21600,,
com.google.Chrome,11,1731633354,1731633365,1731633365.75353,-21600,,
com.microsoft.VSCode,38,1731633316,1731633354,1731633354.5937428,-21600,,
com.google.Chrome,23,1731633293,1731633316,1731633316.270098,-21600,,
com.microsoft.VSCode,136,1731633157,1731633293,1731633293.97437,-21600,,
com.google.Chrome,36,1731633121,1731633157,1731633157.5002189,-21600,,
com.microsoft.VSCode,36,1731633085,1731633121,1731633121.453395,-21600,,
com.google.Chrome,12,1731633073,1731633085,1731633085.5291739,-21600,,
com.microsoft.VSCode,53,1731633020,1731633073,1731633073.577588,-21600,,
com.leomehlig.today,10,1731633010,1731633020,1731633020.318759,-21600,,
com.google.chrome.ios,2,1731632937,1731632939,1731632940.039993,-21600,EB445137-D7F5-57EC-87DA-1DB460D64046,"iPhone13,2"
com.google.chrome.ios,33,1731631822,1731631855,1731631855.7142792,-21600,EB445137-D7F5-57EC-87DA-1DB460D64046,"iPhone13,2"
com.google.Sheets,47,1731631775,1731631822,1731631822.8764281,-21600,EB445137-D7F5-57EC-87DA-1DB460D64046,"iPhone13,2"
com.google.chrome.ios,7,1731631764,1731631771,1731631771.98943,-21600,EB445137-D7F5-57EC-87DA-1DB460D64046,"iPhone13,2"
com.hammerandchisel.discord,187,1731631561,1731631748,1731631748.727097,-21600,EB445137-D7F5-57EC-87DA-1DB460D64046,"iPhone13,2"
com.hammerandchisel.discord,12,1731631545,1731631557,1731631557.9088159,-21600,EB445137-D7F5-57EC-87DA-1DB460D64046,"iPhone13,2"
com.hammerandchisel.discord,12,1731631529,1731631541,1731631542.051729,-21600,EB445137-D7F5-57EC-87DA-1DB460D64046,"iPhone13,2"
com.hammerandchisel.discord,4,1731631464,1731631468,1731631468.060091,-21600,EB445137-D7F5-57EC-87DA-1DB460D64046,"iPhone13,2"
com.hammerandchisel.discord,5,1731631448,1731631453,1731631453.83282,-21600,EB445137-D7F5-57EC-87DA-1DB460D64046,"iPhone13,2"
com.apple.mobilenotes,11,1731629353,1731629364,1731629365.0045671,-21600,EB445137-D7F5-57EC-87DA-1DB460D64046,"iPhone13,2"
com.microsoft.Office.Outlook,14,1731626698,1731626712,1731626712.151816,-21600,EB445137-D7F5-57EC-87DA-1DB460D64046,"iPhone13,2"
com.leomehlig.today,340,1731626650,1731626990,1731626990.9931278,-21600,,
com.google.Chrome,6,1731626644,1731626650,1731626651.0387158,-21600,,
us.zoom.xos,4,1731626640,1731626644,1731626644.4076319,-21600,,
com.apple.finder,3,1731626637,1731626640,1731626640.605238,-21600,,
us.zoom.xos,10,1731626627,1731626637,1731626637.5791101,-21600,,
com.microsoft.VSCode,49,1731626578,1731626627,1731626627.163418,-21600,,
com.google.Chrome,12,1731626566,1731626578,1731626578.431773,-21600,,
com.microsoft.VSCode,41,1731626525,1731626566,1731626566.884458,-21600,,
com.google.Chrome,3,1731626522,1731626525,1731626525.994506,-21600,,
com.microsoft.Office.Outlook,1,1731626186,1731626187,1731626187.67117,-21600,EB445137-D7F5-57EC-87DA-1DB460D64046,"iPhone13,2"
com.microsoft.VSCode,393,1731626129,1731626522,1731626523.0149732,-21600,,
com.apple.iCal,0,1731626129,1731626129,1731626129.957252,-21600,,
com.microsoft.VSCode,32,1731626097,1731626129,1731626129.198183,-21600,,
com.apple.iCal,2,1731626095,1731626097,1731626098.0625448,-21600,,
com.microsoft.VSCode,53,1731626042,1731626095,1731626095.333462,-21600,,
com.google.Chrome,2,1731626040,1731626042,1731626042.129622,-21600,,
com.microsoft.VSCode,3,1731626037,1731626040,1731626040.915578,-21600,,
com.google.Chrome,1,1731626036,1731626037,1731626037.830401,-21600,,
com.microsoft.VSCode,4,1731626032,1731626036,1731626036.549631,-21600,,
com.google.Chrome,0,1731626032,1731626032,1731626032.798139,-21600,,
com.microsoft.VSCode,2,1731626030,1731626032,1731626032.195174,-21600,,
com.google.Chrome,2,1731626028,1731626030,1731626030.838317,-21600,,
com.microsoft.VSCode,4,1731626024,1731626028,1731626028.839881,-21600,,
com.google.Chrome,1,1731626023,1731626024,1731626024.816903,-21600,,
com.microsoft.VSCode,4,1731626019,1731626023,1731626023.849859,-21600,,
com.google.Chrome,1,1731626018,1731626019,1731626019.377583,-21600,,
com.microsoft.VSCode,1,1731626017,1731626018,1731626018.614831,-21600,,
com.google.Chrome,2,1731626015,1731626017,1731626017.73658,-21600,,
com.microsoft.VSCode,31,1731625984,1731626015,1731626015.1363912,-21600,,
com.google.Chrome,17,1731625967,1731625984,1731625984.892586,-21600,,
com.microsoft.VSCode,9,1731625958,1731625967,1731625967.7372708,-21600,,
com.google.Chrome,6,1731625952,1731625958,1731625958.967155,-21600,,
com.microsoft.VSCode,7,1731625945,1731625952,1731625952.583012,-21600,,
com.google.Chrome,0,1731625945,1731625945,1731625945.836759,-21600,,
com.microsoft.VSCode,14,1731625931,1731625945,1731625945.336186,-21600,,
com.google.Chrome,9,1731625922,1731625931,1731625932.023899,-21600,,
com.apple.Dictionary,1,1731625921,1731625922,1731625922.40757,-21600,,
com.google.Chrome,51,1731625870,1731625921,1731625921.578055,-21600,,
com.microsoft.VSCode,231,1731625639,1731625870,1731625870.134718,-21600,,
com.google.Chrome,3,1731625636,1731625639,1731625639.137179,-21600,,
com.microsoft.VSCode,1,1731625635,1731625636,1731625636.9083362,-21600,,
com.google.Chrome,7,1731625628,1731625635,1731625635.80275,-21600,,
com.microsoft.VSCode,37,1731625591,1731625628,1731625628.6761289,-21600,,
us.zoom.xos,5,1731625586,1731625591,1731625591.3676538,-21600,,
com.microsoft.VSCode,1,1731625585,1731625586,1731625586.378855,-21600,,
us.zoom.xos,3,1731625582,1731625585,1731625585.8254151,-21600,,
com.microsoft.VSCode,2,1731625580,1731625582,1731625582.04885,-21600,,
us.zoom.xos,1,1731625579,1731625580,1731625580.6718059,-21600,,
com.microsoft.VSCode,3,1731625576,1731625579,1731625579.2700272,-21600,,
us.zoom.xos,5,1731625571,1731625576,1731625576.635669,-21600,,
com.microsoft.VSCode,19,1731625552,1731625571,1731625571.071832,-21600,,
us.zoom.xos,2,1731625550,1731625552,1731625552.204531,-21600,,
com.microsoft.VSCode,4,1731625546,1731625550,1731625550.612297,-21600,,
us.zoom.xos,4,1731625542,1731625546,1731625546.401578,-21600,,
com.microsoft.VSCode,3,1731625539,1731625542,1731625542.824956,-21600,,
us.zoom.xos,23,1731625516,1731625539,1731625539.2390718,-21600,,
com.microsoft.VSCode,15,1731625501,1731625516,1731625516.357463,-21600,,
us.zoom.xos,16,1731625485,1731625501,1731625501.783586,-21600,,
com.microsoft.VSCode,1,1731625484,1731625485,1731625485.144696,-21600,,
us.zoom.xos,32,1731625452,1731625484,1731625484.088536,-21600,,
com.microsoft.VSCode,5,1731625447,1731625452,1731625452.576304,-21600,,
us.zoom.xos,7,1731625440,1731625447,1731625447.9971929,-21600,,
com.microsoft.VSCode,10,1731625430,1731625440,1731625440.7545118,-21600,,
us.zoom.xos,8,1731625422,1731625430,1731625431.004274,-21600,,
com.microsoft.VSCode,32,1731625390,1731625422,1731625422.3618011,-21600,,
us.zoom.xos,21,1731625369,1731625390,1731625390.99513,-21600,,
com.microsoft.VSCode,59,1731625310,1731625369,1731625369.9060159,-21600,,
us.zoom.xos,6,1731625304,1731625310,1731625310.124321,-21600,,
com.microsoft.VSCode,24,1731625280,1731625304,1731625304.10761,-21600,,
us.zoom.xos,103,1731625177,1731625280,1731625280.196814,-21600,,
com.google.Chrome,3,1731625174,1731625177,1731625177.06934,-21600,,
us.zoom.xos,95,1731625079,1731625174,1731625174.317645,-21600,,
com.google.Chrome,42,1731625037,1731625079,1731625079.1206322,-21600,,
com.microsoft.VSCode,46,1731624980,1731625026,1731625026.880445,-21600,,
com.google.Chrome,23,1731624957,1731624980,1731624980.8509588,-21600,,
com.microsoft.VSCode,2,1731624955,1731624957,1731624957.710905,-21600,,
com.google.Chrome,17,1731624938,1731624955,1731624955.39568,-21600,,
us.zoom.xos,120,1731624818,1731624938,1731624938.4038382,-21600,,
com.google.Chrome,12,1731624806,1731624818,1731624819.0124068,-21600,,
com.microsoft.VSCode,6,1731624800,1731624806,1731624807.19012,-21600,,
com.google.Chrome,4,1731624796,1731624800,1731624800.263217,-21600,,
com.microsoft.VSCode,17,1731624779,1731624796,1731624796.799142,-21600,,
us.zoom.xos,1,1731624778,1731624779,1731624779.5166168,-21600,,
com.google.Chrome,2,1731624776,1731624778,1731624778.6850219,-21600,,
us.zoom.xos,2,1731624774,1731624776,1731624777.318246,-21600,,
com.microsoft.VSCode,66,1731624708,1731624774,1731624774.225636,-21600,,
com.google.Chrome,35,1731624673,1731624708,1731624708.674494,-21600,,
com.microsoft.VSCode,25,1731624648,1731624673,1731624673.2743459,-21600,,
us.zoom.xos,9,1731624639,1731624648,1731624648.609044,-21600,,
com.microsoft.VSCode,33,1731624606,1731624639,1731624639.576041,-21600,,
us.zoom.xos,2,1731624604,1731624606,1731624607.011581,-21600,,
com.microsoft.VSCode,6,1731624598,1731624604,1731624604.433138,-21600,,
com.toyopagroup.picaboo,4,1731624535,1731624539,1731624539.496149,-21600,EB445137-D7F5-57EC-87DA-1DB460D64046,"iPhone13,2"
us.zoom.xos,65,1731624533,1731624598,1731624598.901322,-21600,,
com.microsoft.VSCode,21,1731624512,1731624533,1731624533.0615702,-21600,,
us.zoom.xos,2,1731624510,1731624512,1731624512.700492,-21600,,
com.microsoft.VSCode,24,1731624486,1731624510,1731624510.634361,-21600,,
com.toyopagroup.picaboo,11,1731624470,1731624481,1731624482.177594,-21600,EB445137-D7F5-57EC-87DA-1DB460D64046,"iPhone13,2"
com.toyopagroup.picaboo,57,1731624372,1731624429,1731624430.156769,-21600,EB445137-D7F5-57EC-87DA-1DB460D64046,"iPhone13,2"
com.apple.news,2,1731624253,1731624255,1731624255.792357,-21600,EB445137-D7F5-57EC-87DA-1DB460D64046,"iPhone13,2"
com.instructure.icanvas,34,1731624219,1731624253,1731624253.813205,-21600,EB445137-D7F5-57EC-87DA-1DB460D64046,"iPhone13,2"
com.apple.news,7,1731624212,1731624219,1731624219.636467,-21600,EB445137-D7F5-57EC-87DA-1DB460D64046,"iPhone13,2"
us.zoom.xos,276,1731624210,1731624486,1731624486.223762,-21600,,
com.google.Chrome,82,1731624128,1731624210,1731624211.025315,-21600,,
com.microsoft.VSCode,19,1731624109,1731624128,1731624128.443636,-21600,,
com.google.Chrome,30,1731624079,1731624109,1731624110.419348,-21600,,
com.microsoft.VSCode,1,1731624078,1731624079,1731624079.826904,-21600,,
us.zoom.xos,4,1731624074,1731624078,1731624078.382273,-21600,,
com.microsoft.VSCode,9,1731624065,1731624074,1731624074.22001,-21600,,
us.zoom.xos,1,1731624064,1731624065,1731624065.947562,-21600,,
com.microsoft.VSCode,14,1731624050,1731624064,1731624064.588984,-21600,,
com.apple.finder,17,1731624033,1731624050,1731624050.410122,-21600,,
us.zoom.xos,5,1731624028,1731624033,1731624033.5421271,-21600,,
com.google.Chrome,5,1731624023,1731624028,1731624028.917567,-21600,,
us.zoom.xos,1,1731624022,1731624023,1731624023.800846,-21600,,
com.google.Chrome,7,1731624015,1731624022,1731624022.4842749,-21600,,
us.zoom.xos,8,1731624007,1731624015,1731624015.143182,-21600,,
com.google.Chrome,2,1731624005,1731624007,1731624007.180562,-21600,,
com.microsoft.VSCode,26,1731623979,1731624005,1731624005.9025111,-21600,,
com.google.Chrome,2,1731623977,1731623979,1731623979.6599221,-21600,,
us.zoom.xos,2,1731623975,1731623977,1731623977.939744,-21600,,
com.google.Chrome,12,1731623963,1731623975,1731623975.939323,-21600,,
us.zoom.xos,1,1731623962,1731623963,1731623963.632299,-21600,,
com.google.Chrome,7,1731623955,1731623962,1731623962.616312,-21600,,
us.zoom.xos,15,1731623940,1731623955,1731623955.281763,-21600,,
com.google.Chrome,7,1731623933,1731623940,1731623940.240642,-21600,,
us.zoom.xos,1,1731623932,1731623933,1731623933.70582,-21600,,
com.google.Chrome,3,1731623929,1731623932,1731623932.4197931,-21600,,
com.apple.news,3,1731623892,1731623895,1731623895.6423368,-21600,EB445137-D7F5-57EC-87DA-1DB460D64046,"iPhone13,2"
us.zoom.xos,60,1731623869,1731623929,1731623929.05434,-21600,,
com.google.Chrome,17,1731623852,1731623869,1731623869.823118,-21600,,
us.zoom.xos,7,1731623845,1731623852,1731623852.558759,-21600,,
com.google.Chrome,3,1731623842,1731623845,1731623845.7096,-21600,,
us.zoom.xos,1,1731623841,1731623842,1731623842.913759,-21600,,
com.google.Chrome,15,1731623826,1731623841,1731623841.380691,-21600,,
us.zoom.xos,10,1731623816,1731623826,1731623826.7277179,-21600,,
com.google.Chrome,6,1731623810,1731623816,1731623816.089509,-21600,,
us.zoom.xos,2,1731623808,1731623810,1731623810.794701,-21600,,
com.google.Chrome,4,1731623804,1731623808,1731623808.466617,-21600,,
us.zoom.xos,2,1731623802,1731623804,1731623804.110567,-21600,,
com.google.Chrome,11,1731623791,1731623802,1731623802.2107291,-21600,,
us.zoom.xos,4,1731623787,1731623791,1731623791.807203,-21600,,
com.google.Chrome,16,1731623771,1731623787,1731623787.690453,-21600,,
us.zoom.xos,55,1731623716,1731623771,1731623771.5512471,-21600,,
com.google.Chrome,7,1731623709,1731623716,1731623716.215239,-21600,,
us.zoom.xos,28,1731623681,1731623709,1731623709.236812,-21600,,
com.google.Chrome,6,1731623675,1731623681,1731623681.291074,-21600,,
us.zoom.xos,13,1731623662,1731623675,1731623675.695297,-21600,,
com.google.Chrome,20,1731623642,1731623662,1731623662.7610989,-21600,,
us.zoom.xos,19,1731623623,1731623642,1731623642.434186,-21600,,
com.google.Chrome,2,1731623621,1731623623,1731623623.737742,-21600,,
us.zoom.xos,1,1731623620,1731623621,1731623621.221123,-21600,,
com.google.Chrome,5,1731623615,1731623620,1731623620.524183,-21600,,
us.zoom.xos,1,1731623614,1731623615,1731623615.8737822,-21600,,
com.google.Chrome,4,1731623610,1731623614,1731623614.08562,-21600,,
us.zoom.xos,2,1731623608,1731623610,1731623610.604171,-21600,,
com.google.Chrome,65,1731623543,1731623608,1731623608.928749,-21600,,
us.zoom.xos,1,1731623542,1731623543,1731623543.143577,-21600,,
com.google.Chrome,8,1731623534,1731623542,1731623542.130587,-21600,,
us.zoom.xos,4,1731623530,1731623534,1731623534.5406752,-21600,,
com.google.Chrome,1,1731623529,1731623530,1731623530.440923,-21600,,
us.zoom.xos,7,1731623522,1731623529,1731623529.610755,-21600,,
com.google.Chrome,44,1731623478,1731623522,1731623522.398353,-21600,,
us.zoom.xos,2,1731623476,1731623478,1731623479.008556,-21600,,
com.google.Chrome,4,1731623472,1731623476,1731623476.201579,-21600,,
us.zoom.xos,3,1731623469,1731623472,1731623472.379393,-21600,,
com.google.Chrome,3,1731623466,1731623469,1731623469.990376,-21600,,
us.zoom.xos,2,1731623464,1731623466,1731623466.452042,-21600,,
com.google.Chrome,8,1731623456,1731623464,1731623465.0246959,-21600,,
us.zoom.xos,1,1731623455,1731623456,1731623456.7789202,-21600,,
com.google.Chrome,2,1731623453,1731623455,1731623455.6503139,-21600,,
us.zoom.xos,6,1731623447,1731623453,1731623453.5138469,-21600,,
com.google.Chrome,5,1731623442,1731623447,1731623447.9229689,-21600,,
us.zoom.xos,9,1731623433,1731623442,1731623442.709066,-21600,,
com.google.Chrome,8,1731623425,1731623433,1731623433.5229611,-21600,,
us.zoom.xos,6,1731623419,1731623425,1731623425.24704,-21600,,
com.google.Chrome,3,1731623416,1731623419,1731623419.4187999,-21600,,
us.zoom.xos,4,1731623412,1731623416,1731623416.1894588,-21600,,
com.google.Chrome,4,1731623408,1731623412,1731623412.80236,-21600,,
com.apple.finder,1,1731623407,1731623408,1731623408.666181,-21600,,
us.zoom.xos,3,1731623404,1731623407,1731623407.875725,-21600,,
com.apple.finder,2,1731623402,1731623404,1731623404.0935202,-21600,,
com.google.Chrome,1,1731623401,1731623402,1731623402.9648151,-21600,,
com.apple.finder,5,1731623396,1731623401,1731623401.076984,-21600,,
com.google.Chrome,1,1731623395,1731623396,1731623396.962027,-21600,,
us.zoom.xos,1,1731623394,1731623395,1731623395.347198,-21600,,
com.google.Chrome,4,1731623390,1731623394,1731623394.709475,-21600,,
us.zoom.xos,2,1731623388,1731623390,1731623390.423799,-21600,,
com.google.Chrome,2,1731623386,1731623388,1731623388.636866,-21600,,
us.zoom.xos,2,1731623384,1731623386,1731623386.4089088,-21600,,
com.google.Chrome,65,1731623319,1731623384,1731623384.520396,-21600,,
us.zoom.xos,5,1731623314,1731623319,1731623319.257827,-21600,,
com.google.Chrome,3,1731623311,1731623314,1731623314.197016,-21600,,
us.zoom.xos,1,1731623310,1731623311,1731623311.52231,-21600,,
com.google.Chrome,4,1731623306,1731623310,1731623310.20748,-21600,,
us.zoom.xos,3,1731623303,1731623306,1731623306.108317,-21600,,
com.google.Chrome,25,1731623278,1731623303,1731623303.523882,-21600,,
us.zoom.xos,1,1731623277,1731623278,1731623278.848346,-21600,,
com.google.Chrome,4,1731623273,1731623277,1731623278.007907,-21600,,
us.zoom.xos,2,1731623271,1731623273,1731623273.328185,-21600,,
com.google.Chrome,1,1731623270,1731623271,1731623271.433491,-21600,,
us.zoom.xos,3,1731623267,1731623270,1731623270.968749,-21600,,
com.google.Chrome,1,1731623266,1731623267,1731623267.407493,-21600,,
us.zoom.xos,0,1731623266,1731623266,1731623266.736901,-21600,,
com.google.Chrome,4,1731623262,1731623266,1731623266.637038,-21600,,
us.zoom.xos,10,1731623252,1731623262,1731623262.752274,-21600,,
com.google.Chrome,4,1731623248,1731623252,1731623252.582203,-21600,,
us.zoom.xos,0,1731623235,1731623235,1731623235.681652,-21600,,
com.google.Chrome,2,1731623233,1731623235,1731623235.1302981,-21600,,
us.zoom.xos,2,1731623231,1731623233,1731623233.36374,-21600,,
com.apple.news,189,1731623041,1731623230,1731623231.3137689,-21600,EB445137-D7F5-57EC-87DA-1DB460D64046,"iPhone13,2"
com.google.ios.youtube,59,1731622972,1731623031,1731623032.1240458,-21600,EB445137-D7F5-57EC-87DA-1DB460D64046,"iPhone13,2"
com.apple.news,17,1731622952,1731622969,1731622969.764339,-21600,EB445137-D7F5-57EC-87DA-1DB460D64046,"iPhone13,2"
us.zoom.xos,306,1731622645,1731622951,1731622951.552455,-21600,,
com.google.Chrome,77,1731622568,1731622645,1731622645.375644,-21600,,
us.zoom.xos,14,1731622554,1731622568,1731622568.9375181,-21600,,
com.google.Chrome,9,1731622545,1731622554,1731622554.198602,-21600,,
us.zoom.xos,9,1731622536,1731622545,1731622545.52881,-21600,,
com.google.Chrome,7,1731622529,1731622536,1731622536.541819,-21600,,
us.zoom.xos,4,1731622525,1731622529,1731622529.251296,-21600,,
com.google.Chrome,14,1731622511,1731622525,1731622525.855577,-21600,,
us.zoom.xos,5,1731622506,1731622511,1731622511.536133,-21600,,
com.google.Chrome,4,1731622502,1731622506,1731622506.385153,-21600,,
us.zoom.xos,2,1731622500,1731622502,1731622502.7494721,-21600,,
com.google.Chrome,21,1731622479,1731622500,1731622500.089257,-21600,,
us.zoom.xos,2,1731622477,1731622479,1731622479.9991589,-21600,,
com.apple.Health,15,1731622374,1731622389,1731622389.155375,-21600,EB445137-D7F5-57EC-87DA-1DB460D64046,"iPhone13,2"
com.burbn.instagram,495,1731621856,1731622351,1731622351.725109,-21600,EB445137-D7F5-57EC-87DA-1DB460D64046,"iPhone13,2"
com.instructure.icanvas,4,1731621689,1731621693,1731621693.429881,-21600,EB445137-D7F5-57EC-87DA-1DB460D64046,"iPhone13,2"
com.facebook.Facebook,557,1731621130,1731621687,1731621687.353177,-21600,EB445137-D7F5-57EC-87DA-1DB460D64046,"iPhone13,2"
com.robinhood.release.Robinhood,33,1731621095,1731621128,1731621128.4271588,-21600,EB445137-D7F5-57EC-87DA-1DB460D64046,"iPhone13,2"
com.tinyspeck.chatlyio,9,1731621017,1731621026,1731621026.8247108,-21600,EB445137-D7F5-57EC-87DA-1DB460D64046,"iPhone13,2"
com.tinyspeck.chatlyio,12,1731621005,1731621017,1731621017.923699,-21600,EB445137-D7F5-57EC-87DA-1DB460D64046,"iPhone13,2"
com.microsoft.Office.Outlook,10,1731620950,1731620960,1731620961.162327,-21600,EB445137-D7F5-57EC-87DA-1DB460D64046,"iPhone13,2"
us.zoom.xos,301,1731620942,1731621243,1731621243.686043,-21600,,
com.google.Chrome,83,1731620859,1731620942,1731620942.957372,-21600,,
com.toyopagroup.picaboo,2,1731620851,1731620853,1731620853.8956342,-21600,EB445137-D7F5-57EC-87DA-1DB460D64046,"iPhone13,2"
com.apple.news,3,1731620848,1731620851,1731620851.385587,-21600,EB445137-D7F5-57EC-87DA-1DB460D64046,"iPhone13,2"
us.zoom.xos,18,1731620841,1731620859,1731620859.1767511,-21600,,
com.google.Chrome,4,1731620837,1731620841,1731620841.35449,-21600,,
us.zoom.xos,0,1731620826,1731620826,1731620826.942105,-21600,,
com.google.Chrome,7,1731620819,1731620826,1731620826.192871,-21600,,
com.microsoft.VSCode,23,1731620796,1731620819,1731620819.366502,-21600,,
com.google.Chrome,3,1731620793,1731620796,1731620796.941818,-21600,,
com.leomehlig.today,11,1731620782,1731620793,1731620793.6596909,-21600,,
com.google.Chrome,48,1731620734,1731620782,1731620782.807307,-21600,,
us.zoom.xos,3,1731620731,1731620734,1731620734.308814,-21600,,
com.google.Chrome,6,1731620725,1731620731,1731620731.789978,-21600,,
us.zoom.xos,43,1731620682,1731620725,1731620725.944824,-21600,,
com.google.Chrome,34,1731620648,1731620682,1731620682.2457361,-21600,,
com.microsoft.VSCode,3,1731620645,1731620648,1731620648.236861,-21600,,
com.google.Chrome,4,1731620641,1731620645,1731620645.448802,-21600,,
us.zoom.xos,1,1731620640,1731620641,1731620641.546468,-21600,,
com.microsoft.VSCode,11,1731620629,1731620640,1731620640.72247,-21600,,
us.zoom.xos,1,1731620628,1731620629,1731620629.714514,-21600,,
com.google.Chrome,26,1731620602,1731620628,1731620628.993754,-21600,,
us.zoom.xos,0,1731620602,1731620602,1731620602.956698,-21600,,
com.microsoft.VSCode,4,1731620598,1731620602,1731620602.189712,-21600,,
us.zoom.xos,3,1731620595,1731620598,1731620598.136513,-21600,,
com.google.Chrome,1,1731620594,1731620595,1731620595.98329,-21600,,
us.zoom.xos,4,1731620590,1731620594,1731620594.211139,-21600,,
com.google.Chrome,3,1731620587,1731620590,1731620590.646161,-21600,,
us.zoom.xos,9,1731620578,1731620587,1731620587.526191,-21600,,
com.google.Chrome,7,1731620571,1731620578,1731620578.253613,-21600,,
com.microsoft.VSCode,10,1731620561,1731620571,1731620571.258028,-21600,,
com.google.Chrome,11,1731620550,1731620561,1731620561.406651,-21600,,
com.microsoft.VSCode,6,1731620544,1731620550,1731620550.7710261,-21600,,
com.google.Chrome,21,1731620523,1731620544,1731620544.11686,-21600,,
com.microsoft.VSCode,6,1731620517,1731620523,1731620524.002654,-21600,,
com.google.Chrome,7,1731620510,1731620517,1731620517.177109,-21600,,
com.microsoft.VSCode,2,1731620508,1731620510,1731620510.5568628,-21600,,
com.google.Chrome,2,1731620506,1731620508,1731620508.14122,-21600,,
com.microsoft.VSCode,1,1731620505,1731620506,1731620506.41414,-21600,,
com.google.Chrome,0,1731620505,1731620505,1731620505.908626,-21600,,
com.microsoft.VSCode,4,1731620501,1731620505,1731620505.455991,-21600,,
com.google.Chrome,1,1731620500,1731620501,1731620501.122651,-21600,,
com.microsoft.VSCode,1,1731620499,1731620500,1731620500.0656419,-21600,,
com.google.Chrome,1,1731620498,1731620499,1731620499.441424,-21600,,
com.microsoft.VSCode,1,1731620497,1731620498,1731620498.4124188,-21600,,
com.google.Chrome,1,1731620496,1731620497,1731620497.647645,-21600,,
com.microsoft.VSCode,1,1731620495,1731620496,1731620496.995267,-21600,,
com.google.Chrome,1,1731620494,1731620495,1731620495.927558,-21600,,
com.microsoft.VSCode,3,1731620491,1731620494,1731620494.373461,-21600,,
com.google.Chrome,2,1731620489,1731620491,1731620491.437474,-21600,,
com.microsoft.VSCode,1,1731620488,1731620489,1731620489.092123,-21600,,
com.google.Chrome,2,1731620486,1731620488,1731620488.0621219,-21600,,
us.zoom.xos,14,1731620472,1731620486,1731620486.099615,-21600,,
com.google.Chrome,7,1731620465,1731620472,1731620472.6306438,-21600,,
com.microsoft.VSCode,13,1731620452,1731620465,1731620465.929418,-21600,,
com.google.Chrome,14,1731620438,1731620452,1731620452.230211,-21600,,
com.microsoft.VSCode,19,1731620419,1731620438,1731620438.632777,-21600,,
com.google.Chrome,13,1731620406,1731620419,1731620419.214042,-21600,,
com.microsoft.VSCode,4,1731620402,1731620406,1731620406.189712,-21600,,
us.zoom.xos,9,1731620393,1731620402,1731620402.050247,-21600,,
com.microsoft.VSCode,387,1731620006,1731620393,1731620393.963229,-21600,,
com.google.Chrome,2,1731620004,1731620006,1731620006.325673,-21600,,
us.zoom.xos,18,1731619986,1731620004,1731620004.968435,-21600,,
com.google.Chrome,1,1731619985,1731619986,1731619986.602833,-21600,,
com.microsoft.VSCode,37,1731619948,1731619985,1731619985.5301929,-21600,,
com.google.Chrome,7,1731619941,1731619948,1731619948.307819,-21600,,
com.microsoft.VSCode,4,1731619937,1731619941,1731619941.280795,-21600,,
com.google.Chrome,14,1731619923,1731619937,1731619937.255177,-21600,,
com.microsoft.VSCode,12,1731619911,1731619923,1731619923.647913,-21600,,
us.zoom.xos,2,1731619909,1731619911,1731619911.265549,-21600,,
com.microsoft.VSCode,25,1731619884,1731619909,1731619909.206991,-21600,,
us.zoom.xos,6,1731619878,1731619884,1731619884.453805,-21600,,
com.microsoft.VSCode,3,1731619875,1731619878,1731619878.096084,-21600,,
com.google.Chrome,8,1731619867,1731619875,1731619875.2103071,-21600,,
com.microsoft.VSCode,23,1731619844,1731619867,1731619867.047389,-21600,,
com.google.Chrome,29,1731619815,1731619844,1731619844.153364,-21600,,
us.zoom.xos,3,1731619812,1731619815,1731619815.9807792,-21600,,
com.google.Chrome,1,1731619811,1731619812,1731619812.6465921,-21600,,
us.zoom.xos,3,1731619808,1731619811,1731619811.082137,-21600,,
com.google.Chrome,10,1731619798,1731619808,1731619808.242264,-21600,,
com.microsoft.VSCode,10,1731619763,1731619773,1731619773.963413,-21600,,
com.google.Chrome,2,1731619761,1731619763,1731619763.9365249,-21600,,
com.microsoft.VSCode,5,1731619756,1731619761,1731619761.783224,-21600,,
com.google.Chrome,2,1731619754,1731619756,1731619756.129875,-21600,,
com.leomehlig.today,1,1731619753,1731619754,1731619754.322619,-21600,,
com.google.Chrome,25,1731619728,1731619753,1731619753.05402,-21600,,
com.leomehlig.today,0,1731619728,1731619728,1731619728.9374552,-21600,,
com.microsoft.VSCode,216,1731619512,1731619728,1731619728.300459,-21600,,
com.microsoft.Outlook,5,1731619507,1731619512,1731619512.9956279,-21600,,
com.microsoft.VSCode,3,1731619504,1731619507,1731619508.7785702,-21600,,
com.leomehlig.today,13,1731619491,1731619504,1731619504.472759,-21600,,
com.apple.news,360,1731619047,1731619407,1731619408.076113,-21600,EB445137-D7F5-57EC-87DA-1DB460D64046,"iPhone13,2"
com.apple.news,182,1731618864,1731619046,1731619046.6140962,-21600,EB445137-D7F5-57EC-87DA-1DB460D64046,"iPhone13,2"
com.truebill.truebillnative,9,1731618844,1731618853,1731618853.589103,-21600,EB445137-D7F5-57EC-87DA-1DB460D64046,"iPhone13,2"
com.truebill.truebillnative,2,1731618466,1731618468,1731618468.612543,-21600,EB445137-D7F5-57EC-87DA-1DB460D64046,"iPhone13,2"
com.truebill.truebillnative,7,1731618458,1731618465,1731618466.044457,-21600,EB445137-D7F5-57EC-87DA-1DB460D64046,"iPhone13,2"
com.apple.camera,0,1731618458,1731618458,1731618458.9431581,-21600,EB445137-D7F5-57EC-87DA-1DB460D64046,"iPhone13,2"
com.truebill.truebillnative,35,1731618126,1731618161,1731618162.325039,-21600,EB445137-D7F5-57EC-87DA-1DB460D64046,"iPhone13,2"
com.hammerandchisel.discord,45,1731618076,1731618121,1731618121.128726,-21600,EB445137-D7F5-57EC-87DA-1DB460D64046,"iPhone13,2"
com.toyopagroup.picaboo,18,1731618053,1731618071,1731618071.797371,-21600,EB445137-D7F5-57EC-87DA-1DB460D64046,"iPhone13,2"
com.toyopagroup.picaboo,2,1731617952,1731617954,1731617954.726241,-21600,EB445137-D7F5-57EC-87DA-1DB460D64046,"iPhone13,2"
com.toyopagroup.picaboo,3,1731617511,1731617514,1731617514.9580688,-21600,EB445137-D7F5-57EC-87DA-1DB460D64046,"iPhone13,2"
com.toyopagroup.picaboo,50,1731617381,1731617431,1731617432.2222419,-21600,EB445137-D7F5-57EC-87DA-1DB460D64046,"iPhone13,2"
com.toyopagroup.picaboo,80,1731617267,1731617347,1731617348.0904799,-21600,EB445137-D7F5-57EC-87DA-1DB460D64046,"iPhone13,2"
com.toyopagroup.picaboo,7,1731617014,1731617021,1731617022.559931,-21600,EB445137-D7F5-57EC-87DA-1DB460D64046,"iPhone13,2"
com.instructure.icanvas,6,1731617003,1731617009,1731617009.861912,-21600,EB445137-D7F5-57EC-87DA-1DB460D64046,"iPhone13,2"
com.hammerandchisel.discord,98,1731616489,1731616587,1731616587.982127,-21600,EB445137-D7F5-57EC-87DA-1DB460D64046,"iPhone13,2"
com.hammerandchisel.discord,3,1731616314,1731616317,1731616318.215396,-21600,EB445137-D7F5-57EC-87DA-1DB460D64046,"iPhone13,2"
com.toyopagroup.picaboo,82,1731616231,1731616313,1731616313.222451,-21600,EB445137-D7F5-57EC-87DA-1DB460D64046,"iPhone13,2"
com.hammerandchisel.discord,5,1731616226,1731616231,1731616231.254521,-21600,EB445137-D7F5-57EC-87DA-1DB460D64046,"iPhone13,2"
com.hammerandchisel.discord,27,1731615725,1731615752,1731615753.06709,-21600,EB445137-D7F5-57EC-87DA-1DB460D64046,"iPhone13,2"
com.letterboxd.LetterboxdApp,7,1731615258,1731615265,1731615265.1440558,-21600,EB445137-D7F5-57EC-87DA-1DB460D64046,"iPhone13,2"
com.letterboxd.LetterboxdApp,43,1731615096,1731615139,1731615139.460396,-21600,EB445137-D7F5-57EC-87DA-1DB460D64046,"iPhone13,2"
com.letterboxd.LetterboxdApp,6,1731615055,1731615061,1731615062.0548291,-21600,EB445137-D7F5-57EC-87DA-1DB460D64046,"iPhone13,2"
com.letterboxd.LetterboxdApp,141,1731614894,1731615035,1731615036.400144,-21600,EB445137-D7F5-57EC-87DA-1DB460D64046,"iPhone13,2"
com.leomehlig.today,6,1731614806,1731614812,1731614812.761495,-21600,,
com.google.Chrome,4,1731614802,1731614806,1731614807.0935678,-21600,,
com.leomehlig.today,41,1731614761,1731614802,1731614802.331922,-21600,,
com.google.Chrome,3,1731614758,1731614761,1731614761.250046,-21600,,
com.toyopagroup.picaboo,477,1731613337,1731613814,1731613814.725507,-21600,EB445137-D7F5-57EC-87DA-1DB460D64046,"iPhone13,2"
com.apple.weather,28,1731613309,1731613337,1731613337.982098,-21600,EB445137-D7F5-57EC-87DA-1DB460D64046,"iPhone13,2"
com.google.Chrome,934,1731612294,1731613228,1731613229.033936,-21600,,
com.apple.Music,60,1731612217,1731612277,1731612277.5391278,-21600,,
com.apple.finder,0,1731612217,1731612217,1731612217.5834122,-21600,,
com.apple.Music,33,1731612184,1731612217,1731612217.2452068,-21600,,
com.apple.finder,2,1731612182,1731612184,1731612184.121368,-21600,,
com.apple.FinalCut,3,1731612179,1731612182,1731612182.387769,-21600,,
com.apple.finder,3,1731612176,1731612179,1731612179.593048,-21600,,
com.apple.FinalCut,11,1731612165,1731612176,1731612176.0830622,-21600,,
com.apple.finder,3,1731612162,1731612165,1731612165.7001262,-21600,,
com.apple.FinalCut,8,1731612154,1731612162,1731612162.5971,-21600,,
com.apple.Music,24,1731612130,1731612154,1731612154.539428,-21600,,
com.apple.finder,1,1731612129,1731612130,1731612130.859613,-21600,,
com.apple.Music,5,1731612124,1731612129,1731612129.580384,-21600,,
com.apple.finder,16,1731612108,1731612124,1731612124.61579,-21600,,
com.apple.FinalCut,397,1731611711,1731612108,1731612108.653892,-21600,,
com.apple.finder,13,1731611463,1731611476,1731611476.370074,-21600,,
com.apple.FinalCut,25,1731611438,1731611463,1731611463.279448,-21600,,
com.google.Chrome,4,1731611434,1731611438,1731611438.9888868,-21600,,
com.apple.weather,2,1731611103,1731611105,1731611105.340383,-21600,EB445137-D7F5-57EC-87DA-1DB460D64046,"iPhone13,2"
com.apple.weather,3,1731611033,1731611036,1731611036.4842858,-21600,EB445137-D7F5-57EC-87DA-1DB460D64046,"iPhone13,2"
com.apple.weather,5,1731610968,1731610973,1731610973.178731,-21600,EB445137-D7F5-57EC-87DA-1DB460D64046,"iPhone13,2"
com.apple.weather,2,1731610887,1731610889,1731610889.790062,-21600,EB445137-D7F5-57EC-87DA-1DB460D64046,"iPhone13,2"
com.apple.weather,6,1731610774,1731610780,1731610780.9242082,-21600,EB445137-D7F5-57EC-87DA-1DB460D64046,"iPhone13,2"
com.apple.weather,26,1731609254,1731609280,1731609280.556562,-21600,EB445137-D7F5-57EC-87DA-1DB460D64046,"iPhone13,2"
com.apple.weather,1,1731609251,1731609252,1731609252.357687,-21600,EB445137-D7F5-57EC-87DA-1DB460D64046,"iPhone13,2"
com.apple.weather,5,1731608757,1731608762,1731608762.889045,-21600,EB445137-D7F5-57EC-87DA-1DB460D64046,"iPhone13,2"
com.apple.news,2,1731608755,1731608757,1731608757.752234,-21600,EB445137-D7F5-57EC-87DA-1DB460D64046,"iPhone13,2"
com.google.Chrome,514,1731608230,1731608744,1731608744.923547,-21600,,
com.apple.news,2,1731608163,1731608165,1731608165.488603,-21600,EB445137-D7F5-57EC-87DA-1DB460D64046,"iPhone13,2"
com.apple.news,3,1731608090,1731608093,1731608093.305366,-21600,EB445137-D7F5-57EC-87DA-1DB460D64046,"iPhone13,2"
com.apple.news,10,1731607989,1731607999,1731607999.604737,-21600,EB445137-D7F5-57EC-87DA-1DB460D64046,"iPhone13,2"
com.apple.news,8,1731607975,1731607983,1731607983.449331,-21600,EB445137-D7F5-57EC-87DA-1DB460D64046,"iPhone13,2"
com.leomehlig.today,337,1731607893,1731608230,1731608231.9524941,-21600,,
com.google.Chrome,27,1731607866,1731607893,1731607893.078749,-21600,,
com.leomehlig.today,6,1731607845,1731607851,1731607851.175013,-21600,,
com.microsoft.Outlook,20,1731607825,1731607845,1731607846.012189,-21600,,
com.apple.news,25,1731607622,1731607647,1731607647.9740381,-21600,EB445137-D7F5-57EC-87DA-1DB460D64046,"iPhone13,2"
com.google.Chrome,296,1731607529,1731607825,1731607825.269228,-21600,,
com.apple.news,177,1731607351,1731607528,1731607529.0962791,-21600,EB445137-D7F5-57EC-87DA-1DB460D64046,"iPhone13,2"
com.apple.news,2,1731607338,1731607340,1731607340.795063,-21600,EB445137-D7F5-57EC-87DA-1DB460D64046,"iPhone13,2"
com.instructure.icanvas,15,1731607320,1731607335,1731607335.977606,-21600,EB445137-D7F5-57EC-87DA-1DB460D64046,"iPhone13,2"
com.microsoft.Outlook,342,1731607187,1731607529,1731607529.285569,-21600,,
com.google.Chrome,31,1731607156,1731607187,1731607187.381362,-21600,,
com.microsoft.Outlook,11,1731607145,1731607156,1731607156.905998,-21600,,
com.google.Chrome,130,1731607015,1731607145,1731607145.784981,-21600,,
com.apple.finder,51,1731606964,1731607015,1731607015.442813,-21600,,
com.google.Chrome,23,1731606941,1731606964,1731606964.646905,-21600,,
com.apple.Preview,46,1731606895,1731606941,1731606941.347477,-21600,,
com.apple.finder,1,1731606894,1731606895,1731606895.888972,-21600,,
com.apple.Preview,0,1731606894,1731606894,1731606895.0364208,-21600,,
com.apple.finder,3,1731606891,1731606894,1731606894.2815351,-21600,,
com.apple.Preview,42,1731606849,1731606891,1731606891.665903,-21600,,
com.apple.finder,4,1731606845,1731606849,1731606849.7452102,-21600,,
com.apple.Preview,1,1731606844,1731606845,1731606845.9973888,-21600,,
com.apple.finder,2,1731606842,1731606844,1731606844.785054,-21600,,
com.apple.Preview,9,1731606833,1731606842,1731606842.948091,-21600,,
com.apple.finder,2,1731606831,1731606833,1731606833.064147,-21600,,
com.apple.Preview,10,1731606821,1731606831,1731606831.613069,-21600,,
com.apple.finder,1,1731606820,1731606821,1731606821.0645251,-21600,,
com.apple.Preview,2,1731606818,1731606820,1731606820.12205,-21600,,
com.apple.finder,0,1731606818,1731606818,1731606819.0022159,-21600,,
com.apple.Preview,27,1731606791,1731606818,1731606818.726575,-21600,,
com.apple.finder,7,1731606784,1731606791,1731606791.497102,-21600,,
com.apple.Preview,2,1731606782,1731606784,1731606784.725648,-21600,,
com.apple.finder,2,1731606780,1731606782,1731606782.2834911,-21600,,
com.google.Chrome,69,1731606711,1731606780,1731606780.8637738,-21600,,
com.apple.finder,61,1731606641,1731606702,1731606702.259554,-21600,,
com.apple.Preview,32,1731606609,1731606641,1731606641.5126948,-21600,,
com.apple.finder,2,1731606607,1731606609,1731606609.404189,-21600,,
com.apple.Preview,5,1731606602,1731606607,1731606607.066125,-21600,,
com.apple.finder,6,1731606596,1731606602,1731606602.101316,-21600,,
com.google.Chrome,261,1731606335,1731606596,1731606596.945362,-21600,,
com.microsoft.Outlook,15,1731606305,1731606320,1731606321.004897,-21600,,
com.google.Chrome,20,1731606285,1731606305,1731606305.065032,-21600,,
com.leomehlig.today,18,1731606267,1731606285,1731606285.846673,-21600,,
com.google.ios.youtube,2693,1731603510,1731606203,1731606203.310148,-21600,EB445137-D7F5-57EC-87DA-1DB460D64046,"iPhone13,2"
com.leomehlig.today,31,1731602372,1731602403,1731602403.659669,-21600,,
com.google.Chrome,34,1731602338,1731602372,1731602372.1182718,-21600,,
com.microsoft.VSCode,11,1731602327,1731602338,1731602338.995173,-21600,,
com.apple.Preview,14,1731602313,1731602327,1731602327.1786962,-21600,,
com.microsoft.VSCode,93,1731602220,1731602313,1731602313.747514,-21600,,
com.google.Chrome,6,1731602214,1731602220,1731602220.98541,-21600,,
com.microsoft.VSCode,24,1731602190,1731602214,1731602214.296742,-21600,,
com.google.Chrome,2,1731602188,1731602190,1731602190.075612,-21600,,
com.microsoft.VSCode,8,1731602180,1731602188,1731602188.6748118,-21600,,
com.google.Chrome,9,1731602171,1731602180,1731602180.745973,-21600,,
com.microsoft.VSCode,35,1731602136,1731602171,1731602171.49502,-21600,,
com.google.Chrome,1,1731602135,1731602136,1731602136.397925,-21600,,
com.microsoft.VSCode,6,1731602129,1731602135,1731602135.1689181,-21600,,
com.google.Chrome,0,1731602129,1731602129,1731602129.747823,-21600,,
com.microsoft.VSCode,8,1731602121,1731602129,1731602129.071247,-21600,,
com.google.Chrome,0,1731602121,1731602121,1731602121.976104,-21600,,
com.microsoft.VSCode,10,1731602111,1731602121,1731602121.124858,-21600,,
com.google.Chrome,1,1731602110,1731602111,1731602111.805402,-21600,,
com.microsoft.VSCode,3,1731602107,1731602110,1731602110.772609,-21600,,
com.google.Chrome,1,1731602106,1731602107,1731602107.305521,-21600,,
com.microsoft.VSCode,50,1731602056,1731602106,1731602106.7316751,-21600,,
com.google.Chrome,1,1731602055,1731602056,1731602056.54425,-21600,,
com.microsoft.VSCode,15,1731602040,1731602055,1731602055.403959,-21600,,
com.google.Chrome,1,1731602039,1731602040,1731602040.582411,-21600,,
com.microsoft.VSCode,11,1731602028,1731602039,1731602039.657535,-21600,,
com.google.Chrome,1,1731602027,1731602028,1731602028.1033921,-21600,,
com.microsoft.VSCode,5,1731602022,1731602027,1731602027.0473309,-21600,,
com.google.Chrome,0,1731602022,1731602022,1731602022.9826388,-21600,,
com.microsoft.VSCode,1,1731602021,1731602022,1731602022.3069139,-21600,,
com.google.Chrome,5,1731602016,1731602021,1731602021.2194982,-21600,,
com.microsoft.VSCode,2,1731602014,1731602016,1731602016.820809,-21600,,
com.google.Chrome,4,1731602010,1731602014,1731602014.495527,-21600,,
com.microsoft.VSCode,2,1731602008,1731602010,1731602010.814167,-21600,,
com.google.Chrome,1,1731602007,1731602008,1731602008.2529202,-21600,,
com.microsoft.VSCode,2,1731602005,1731602007,1731602007.41748,-21600,,
com.google.Chrome,1,1731602004,1731602005,1731602005.115542,-21600,,
com.microsoft.VSCode,5,1731601999,1731602004,1731602004.18899,-21600,,
com.google.Chrome,1,1731601998,1731601999,1731602000.010344,-21600,,
com.microsoft.VSCode,2,1731601996,1731601998,1731601998.9661431,-21600,,
com.google.Chrome,2,1731601994,1731601996,1731601996.9036589,-21600,,
com.microsoft.VSCode,6,1731601988,1731601994,1731601994.686411,-21600,,
com.google.Chrome,1,1731601987,1731601988,1731601988.421708,-21600,,
com.microsoft.VSCode,14,1731601973,1731601987,1731601987.193842,-21600,,
com.google.Chrome,3,1731601970,1731601973,1731601973.667574,-21600,,
com.microsoft.VSCode,1,1731601969,1731601970,1731601970.988883,-21600,,
com.google.Chrome,15,1731601954,1731601969,1731601969.638582,-21600,,
com.microsoft.VSCode,472,1731601482,1731601954,1731601954.7369452,-21600,,
com.google.Chrome,1,1731601481,1731601482,1731601482.328495,-21600,,
com.microsoft.VSCode,164,1731601317,1731601481,1731601481.488908,-21600,,
com.google.Chrome,9,1731601308,1731601317,1731601318.001646,-21600,,
com.microsoft.VSCode,15,1731601293,1731601308,1731601308.55652,-21600,,
com.google.Chrome,4,1731601289,1731601293,1731601293.512424,-21600,,
com.microsoft.VSCode,4,1731601285,1731601289,1731601290.021455,-21600,,
com.google.Chrome,4,1731601281,1731601285,1731601285.945158,-21600,,
com.microsoft.VSCode,151,1731601130,1731601281,1731601281.763575,-21600,,
com.google.Chrome,11,1731601119,1731601130,1731601130.846628,-21600,,
com.microsoft.VSCode,70,1731601049,1731601119,1731601119.847074,-21600,,
com.google.Chrome,12,1731601037,1731601049,1731601049.796385,-21600,,
com.microsoft.VSCode,1,1731601036,1731601037,1731601037.77079,-21600,,
com.google.Chrome,23,1731601013,1731601036,1731601036.234632,-21600,,
com.microsoft.VSCode,155,1731600858,1731601013,1731601013.057427,-21600,,
com.google.Chrome,3,1731600855,1731600858,1731600859.056412,-21600,,
com.microsoft.VSCode,4,1731600851,1731600855,1731600855.9522572,-21600,,
com.google.Chrome,21,1731600830,1731600851,1731600852.0118551,-21600,,
com.microsoft.VSCode,29,1731600801,1731600830,1731600830.186938,-21600,,
com.google.Chrome,3,1731600798,1731600801,1731600801.533663,-21600,,
com.microsoft.VSCode,190,1731600608,1731600798,1731600798.137425,-21600,,
com.google.Chrome,31,1731600577,1731600608,1731600608.7886271,-21600,,
com.microsoft.VSCode,151,1731600426,1731600577,1731600577.4926062,-21600,,
com.google.Chrome,2,1731600424,1731600426,1731600426.9995599,-21600,,
com.microsoft.VSCode,81,1731600343,1731600424,1731600424.954897,-21600,,
com.google.Chrome,1,1731600342,1731600343,1731600343.973229,-21600,,
com.microsoft.VSCode,1,1731600341,1731600342,1731600343.010844,-21600,,
com.google.Chrome,8,1731600333,1731600341,1731600341.537049,-21600,,
com.microsoft.VSCode,113,1731600220,1731600333,1731600333.438801,-21600,,
com.google.Chrome,15,1731600205,1731600220,1731600220.181875,-21600,,
com.microsoft.VSCode,2,1731600203,1731600205,1731600205.752069,-21600,,
com.google.Chrome,26,1731600177,1731600203,1731600203.654084,-21600,,
com.microsoft.VSCode,6,1731600171,1731600177,1731600177.197334,-21600,,
com.google.Chrome,1,1731600170,1731600171,1731600171.859585,-21600,,
com.microsoft.VSCode,33,1731600137,1731600170,1731600170.293539,-21600,,
com.google.Chrome,9,1731600128,1731600137,1731600137.7539601,-21600,,
com.microsoft.VSCode,66,1731600062,1731600128,1731600128.9257221,-21600,,
com.google.Chrome,1,1731600061,1731600062,1731600062.2214289,-21600,,
com.microsoft.VSCode,9,1731600052,1731600061,1731600061.621546,-21600,,
com.google.Chrome,1,1731600051,1731600052,1731600052.455076,-21600,,
com.microsoft.VSCode,24,1731600027,1731600051,1731600051.499267,-21600,,
com.google.Chrome,1,1731600026,1731600027,1731600027.414651,-21600,,
com.microsoft.VSCode,13,1731600013,1731600026,1731600026.609828,-21600,,
com.google.Chrome,7,1731600006,1731600013,1731600013.909939,-21600,,
com.microsoft.VSCode,5,1731600001,1731600006,1731600006.203738,-21600,,
com.google.Chrome,3,1731599998,1731600001,1731600001.356516,-21600,,
com.microsoft.VSCode,6,1731599992,1731599998,1731599998.603053,-21600,,
com.google.Chrome,27,1731599965,1731599992,1731599992.8614259,-21600,,
com.microsoft.VSCode,97,1731599868,1731599965,1731599965.4607859,-21600,,
com.google.Chrome,57,1731599811,1731599868,1731599868.860362,-21600,,
com.microsoft.VSCode,281,1731599530,1731599811,1731599811.911195,-21600,,
com.google.Chrome,10,1731599520,1731599530,1731599530.450747,-21600,,
com.microsoft.VSCode,158,1731599362,1731599520,1731599520.360841,-21600,,
com.google.Chrome,9,1731599353,1731599362,1731599362.8696399,-21600,,
com.microsoft.VSCode,19,1731599334,1731599353,1731599353.1915221,-21600,,
com.google.Chrome,6,1731599328,1731599334,1731599334.1356292,-21600,,
com.microsoft.VSCode,7,1731599321,1731599328,1731599328.2104201,-21600,,
com.google.Chrome,1,1731599320,1731599321,1731599321.8824902,-21600,,
com.microsoft.VSCode,10,1731599310,1731599320,1731599320.9233809,-21600,,
com.google.Chrome,5,1731599305,1731599310,1731599310.974749,-21600,,
com.microsoft.VSCode,1,1731599304,1731599305,1731599305.224813,-21600,,
com.google.Chrome,9,1731599295,1731599304,1731599304.319203,-21600,,
com.microsoft.VSCode,7,1731599288,1731599295,1731599295.9135861,-21600,,
com.google.Chrome,11,1731599277,1731599288,1731599288.648518,-21600,,
com.microsoft.VSCode,820,1731598457,1731599277,1731599278.0393438,-21600,,
com.apple.finder,19,1731598438,1731598457,1731598457.507001,-21600,,
com.google.Chrome,52,1731598386,1731598438,1731598438.7459722,-21600,,
com.instructure.icanvas,11,1731597497,1731597508,1731597508.2082171,-21600,EB445137-D7F5-57EC-87DA-1DB460D64046,"iPhone13,2"
com.apple.weather,8,1731597489,1731597497,1731597497.666319,-21600,EB445137-D7F5-57EC-87DA-1DB460D64046,"iPhone13,2"
com.apple.weather,3,1731597263,1731597266,1731597266.199233,-21600,EB445137-D7F5-57EC-87DA-1DB460D64046,"iPhone13,2"
com.apple.weather,3,1731597259,1731597262,1731597262.375471,-21600,EB445137-D7F5-57EC-87DA-1DB460D64046,"iPhone13,2"
com.apple.weather,1,1731597244,1731597245,1731597246.037212,-21600,EB445137-D7F5-57EC-87DA-1DB460D64046,"iPhone13,2"
com.google.Chrome,567,1731596511,1731597078,1731597078.528414,-21600,,
com.apple.iCal,6,1731596505,1731596511,1731596511.3630881,-21600,,
com.leomehlig.today,6,1731596499,1731596505,1731596505.88427,-21600,,
com.apple.weather,9,1731595328,1731595337,1731595338.251669,-21600,EB445137-D7F5-57EC-87DA-1DB460D64046,"iPhone13,2"
com.apple.weather,1,1731595327,1731595328,1731595328.66945,-21600,EB445137-D7F5-57EC-87DA-1DB460D64046,"iPhone13,2"
com.renpho.health,3,1731595324,1731595327,1731595327.285647,-21600,EB445137-D7F5-57EC-87DA-1DB460D64046,"iPhone13,2"
com.renpho.health,24,1731595283,1731595307,1731595308.841807,-21600,EB445137-D7F5-57EC-87DA-1DB460D64046,"iPhone13,2"
com.thestorygraph.thestorygraph,13,1731565044,1731565057,1731565057.1079059,-21600,EB445137-D7F5-57EC-87DA-1DB460D64046,"iPhone13,2"
com.thestorygraph.thestorygraph,2,1731564969,1731564971,1731564971.508251,-21600,EB445137-D7F5-57EC-87DA-1DB460D64046,"iPhone13,2"
com.thestorygraph.thestorygraph,13,1731563297,1731563310,1731563310.154436,-21600,EB445137-D7F5-57EC-87DA-1DB460D64046,"iPhone13,2"
com.thestorygraph.thestorygraph,3,1731563193,1731563196,1731563196.170347,-21600,EB445137-D7F5-57EC-87DA-1DB460D64046,"iPhone13,2"
com.thestorygraph.thestorygraph,32,1731563144,1731563176,1731563177.087704,-21600,EB445137-D7F5-57EC-87DA-1DB460D64046,"iPhone13,2"
com.toyopagroup.picaboo,23,1731561517,1731561540,1731561540.347571,-21600,EB445137-D7F5-57EC-87DA-1DB460D64046,"iPhone13,2"
com.apple.Health,8,1731561509,1731561517,1731561518.112801,-21600,EB445137-D7F5-57EC-87DA-1DB460D64046,"iPhone13,2"
com.leomehlig.today,9,1731561302,1731561311,1731561311.9727201,-21600,,
com.google.Chrome,15,1731561287,1731561302,1731561302.774678,-21600,,
com.google.Chrome,341,1731560144,1731560485,1731560485.406928,-21600,,
com.microsoft.onenote.mac,2,1731560142,1731560144,1731560146.604672,-21600,,
com.apple.Health,14,1731559995,1731560009,1731560009.643001,-21600,EB445137-D7F5-57EC-87DA-1DB460D64046,"iPhone13,2"
com.apple.Health,178,1731558912,1731559090,1731559090.638171,-21600,EB445137-D7F5-57EC-87DA-1DB460D64046,"iPhone13,2"
com.microsoft.onenote.mac,512,1731558886,1731559398,1731559398.811322,-21600,,
com.google.Chrome,414,1731558472,1731558886,1731558886.4201078,-21600,,
com.apple.iCal,2,1731558456,1731558458,1731558459.927181,-21600,,
com.microsoft.Excel,78,1731558378,1731558456,1731558456.8584142,-21600,,
com.apple.iCal,121,1731558257,1731558378,1731558378.4478621,-21600,,
com.google.Chrome,16,1731558241,1731558257,1731558257.600497,-21600,,
com.leomehlig.today,5,1731558236,1731558241,1731558242.496665,-21600,,
com.hammerandchisel.discord,44,1731557975,1731558019,1731558020.004864,-21600,EB445137-D7F5-57EC-87DA-1DB460D64046,"iPhone13,2"
com.instructure.icanvas,4,1731557954,1731557958,1731557959.110805,-21600,EB445137-D7F5-57EC-87DA-1DB460D64046,"iPhone13,2"
com.toyopagroup.picaboo,6,1731557948,1731557954,1731557958.346624,-21600,EB445137-D7F5-57EC-87DA-1DB460D64046,"iPhone13,2"
com.leomehlig.today,5,1731557642,1731557647,1731557648.281353,-21600,,
com.google.Chrome,812,1731556830,1731557642,1731557642.670895,-21600,,
com.leomehlig.today,3,1731556827,1731556830,1731556830.262951,-21600,,
com.leomehlig.today,29,1731556766,1731556795,1731556795.8315902,-21600,,
com.google.Chrome,13,1731556753,1731556766,1731556766.4079142,-21600,,
com.microsoft.VSCode,878,1731555875,1731556753,1731556753.735491,-21600,,
com.google.Chrome,3,1731555872,1731555875,1731555875.790916,-21600,,
com.microsoft.VSCode,13,1731555859,1731555872,1731555872.748146,-21600,,
com.google.Chrome,21,1731555838,1731555859,1731555859.3013558,-21600,,
com.microsoft.VSCode,78,1731555760,1731555838,1731555838.073526,-21600,,
com.google.Chrome,5,1731555755,1731555760,1731555760.938486,-21600,,
com.microsoft.VSCode,47,1731555708,1731555755,1731555755.1436958,-21600,,
com.google.Chrome,13,1731555695,1731555708,1731555708.713161,-21600,,
com.microsoft.VSCode,96,1731555599,1731555695,1731555695.336438,-21600,,
com.google.Chrome,2,1731555597,1731555599,1731555599.803925,-21600,,
com.microsoft.VSCode,1026,1731554571,1731555597,1731555598.023299,-21600,,
com.google.Chrome,2,1731554569,1731554571,1731554571.437325,-21600,,
com.microsoft.VSCode,29,1731554540,1731554569,1731554569.7757878,-21600,,
com.google.Chrome,2,1731554538,1731554540,1731554540.517982,-21600,,
com.microsoft.VSCode,13,1731554525,1731554538,1731554538.733751,-21600,,
com.google.Chrome,45,1731554480,1731554525,1731554525.215523,-21600,,
com.microsoft.VSCode,17,1731554463,1731554480,1731554480.649671,-21600,,
com.google.Chrome,8,1731554455,1731554463,1731554463.176759,-21600,,
com.microsoft.VSCode,3,1731554452,1731554455,1731554455.9763699,-21600,,
com.google.Chrome,13,1731554439,1731554452,1731554452.035178,-21600,,
com.microsoft.VSCode,245,1731554194,1731554439,1731554439.6063309,-21600,,
com.google.Chrome,3,1731554191,1731554194,1731554194.237221,-21600,,
com.toyopagroup.picaboo,7,1731554140,1731554147,1731554148.073203,-21600,EB445137-D7F5-57EC-87DA-1DB460D64046,"iPhone13,2"
com.apple.news,170,1731553803,1731553973,1731553973.381908,-21600,EB445137-D7F5-57EC-87DA-1DB460D64046,"iPhone13,2"
com.truebill.truebillnative,903,1731552882,1731553785,1731553785.876919,-21600,EB445137-D7F5-57EC-87DA-1DB460D64046,"iPhone13,2"
com.truebill.truebillnative,6,1731552872,1731552878,1731552878.580961,-21600,EB445137-D7F5-57EC-87DA-1DB460D64046,"iPhone13,2"
com.truebill.truebillnative,6,1731552863,1731552869,1731552869.7153192,-21600,EB445137-D7F5-57EC-87DA-1DB460D64046,"iPhone13,2"
com.truebill.truebillnative,6,1731552856,1731552862,1731552862.707779,-21600,EB445137-D7F5-57EC-87DA-1DB460D64046,"iPhone13,2"
com.truebill.truebillnative,94,1731552761,1731552855,1731552855.7192168,-21600,EB445137-D7F5-57EC-87DA-1DB460D64046,"iPhone13,2"
com.discoverfinancial.mobile,21,1731552734,1731552755,1731552755.689105,-21600,EB445137-D7F5-57EC-87DA-1DB460D64046,"iPhone13,2"
com.discoverfinancial.mobile,45,1731552645,1731552690,1731552690.58547,-21600,EB445137-D7F5-57EC-87DA-1DB460D64046,"iPhone13,2"
com.truebill.truebillnative,46,1731552599,1731552645,1731552645.845907,-21600,EB445137-D7F5-57EC-87DA-1DB460D64046,"iPhone13,2"
com.discoverfinancial.mobile,124,1731552475,1731552599,1731552600.394202,-21600,EB445137-D7F5-57EC-87DA-1DB460D64046,"iPhone13,2"
com.truebill.truebillnative,32,1731552442,1731552474,1731552474.4661698,-21600,EB445137-D7F5-57EC-87DA-1DB460D64046,"iPhone13,2"
org.name.serializdmobile,51,1731552387,1731552438,1731552438.940734,-21600,EB445137-D7F5-57EC-87DA-1DB460D64046,"iPhone13,2"
org.name.serializdmobile,65,1731552223,1731552288,1731552289.204107,-21600,EB445137-D7F5-57EC-87DA-1DB460D64046,"iPhone13,2"
com.hammerandchisel.discord,64,1731551056,1731551120,1731551120.780221,-21600,EB445137-D7F5-57EC-87DA-1DB460D64046,"iPhone13,2"
com.instructure.icanvas,37,1731551008,1731551045,1731551045.197888,-21600,EB445137-D7F5-57EC-87DA-1DB460D64046,"iPhone13,2"
com.google.Chrome,1593,1731549892,1731551485,1731551485.714963,-21600,,
com.google.Chrome,307,1731549411,1731549718,1731549718.144582,-21600,,
com.google.Chrome,736,1731548539,1731549275,1731549275.708263,-21600,,
com.google.Chrome,321,1731548216,1731548537,1731548537.584579,-21600,,
com.google.Chrome,851,1731546545,1731547396,1731547396.3817558,-21600,,
com.leomehlig.today,10,1731546535,1731546545,1731546545.811454,-21600,,
com.google.Chrome,67,1731546468,1731546535,1731546535.771562,-21600,,
com.leomehlig.today,6,1731546462,1731546468,1731546469.802083,-21600,,
com.google.ios.youtube,1508,1731544770,1731546278,1731546279.105569,-21600,EB445137-D7F5-57EC-87DA-1DB460D64046,"iPhone13,2"
com.apple.weather,29,1731544738,1731544767,1731544767.349184,-21600,EB445137-D7F5-57EC-87DA-1DB460D64046,"iPhone13,2"
com.leomehlig.today,85,1731544653,1731544738,1731544738.04569,-21600,,
com.google.Chrome,22,1731544631,1731544653,1731544653.407043,-21600,,
com.microsoft.VSCode,21,1731544603,1731544624,1731544624.4533691,-21600,,
com.google.Chrome,65,1731544538,1731544603,1731544603.407779,-21600,,
com.microsoft.Outlook,3,1731544511,1731544514,1731544514.6261048,-21600,,
com.leomehlig.today,51,1731544460,1731544511,1731544511.111809,-21600,,
com.google.Chrome,5,1731544455,1731544460,1731544460.4445581,-21600,,
com.apple.finder,97,1731544358,1731544455,1731544455.755085,-21600,,
com.google.Chrome,496,1731543862,1731544358,1731544358.97032,-21600,,
com.microsoft.Outlook,30,1731543832,1731543862,1731543862.468151,-21600,,
com.google.Chrome,2190,1731541642,1731543832,1731543832.985038,-21600,,
com.apple.weather,4,1731541629,1731541633,1731541633.1434078,-21600,EB445137-D7F5-57EC-87DA-1DB460D64046,"iPhone13,2"
com.apple.weather,2,1731541603,1731541605,1731541605.776147,-21600,EB445137-D7F5-57EC-87DA-1DB460D64046,"iPhone13,2"
com.apple.weather,10,1731541587,1731541597,1731541598.289515,-21600,EB445137-D7F5-57EC-87DA-1DB460D64046,"iPhone13,2"
com.apple.news,2,1731541585,1731541587,1731541587.210937,-21600,EB445137-D7F5-57EC-87DA-1DB460D64046,"iPhone13,2"
com.apple.news,49,1731541529,1731541578,1731541579.259731,-21600,EB445137-D7F5-57EC-87DA-1DB460D64046,"iPhone13,2"
com.apple.news,20,1731539956,1731539976,1731539976.490131,-21600,EB445137-D7F5-57EC-87DA-1DB460D64046,"iPhone13,2"
com.microsoft.Office.Outlook,9,1731539938,1731539947,1731539947.883613,-21600,EB445137-D7F5-57EC-87DA-1DB460D64046,"iPhone13,2"
com.apple.camera,0,1731539677,1731539677,1731539677.938552,-21600,EB445137-D7F5-57EC-87DA-1DB460D64046,"iPhone13,2"
com.google.Chrome,473,1731539470,1731539943,1731539943.901763,-21600,,
com.leomehlig.today,2,1731539468,1731539470,1731539470.562927,-21600,,
com.google.ios.youtube,1880,1731537555,1731539435,1731539435.308557,-21600,EB445137-D7F5-57EC-87DA-1DB460D64046,"iPhone13,2"
com.toyopagroup.picaboo,5,1731537539,1731537544,1731537544.726702,-21600,EB445137-D7F5-57EC-87DA-1DB460D64046,"iPhone13,2"
com.leomehlig.today,310,1731537502,1731537812,1731537812.9814448,-21600,,
com.google.Chrome,1,1731537501,1731537502,1731537502.655875,-21600,,
us.zoom.xos,5,1731537496,1731537501,1731537501.793614,-21600,,
com.google.Chrome,629,1731536867,1731537496,1731537496.103663,-21600,,
us.zoom.xos,1,1731536866,1731536867,1731536867.960048,-21600,,
com.microsoft.Outlook,1,1731536865,1731536866,1731536866.572187,-21600,,
com.google.Chrome,4,1731536861,1731536865,1731536865.6579041,-21600,,
com.microsoft.Outlook,38,1731536823,1731536861,1731536861.731851,-21600,,
com.google.Chrome,6,1731536817,1731536823,1731536823.96385,-21600,,
com.microsoft.Outlook,6,1731536811,1731536817,1731536817.978032,-21600,,
us.zoom.xos,1,1731536810,1731536811,1731536811.531798,-21600,,
com.apple.news,244,1731536281,1731536525,1731536526.002094,-21600,EB445137-D7F5-57EC-87DA-1DB460D64046,"iPhone13,2"
com.apple.news,308,1731535968,1731536276,1731536276.703816,-21600,EB445137-D7F5-57EC-87DA-1DB460D64046,"iPhone13,2"
com.apple.news,335,1731535576,1731535911,1731535911.34897,-21600,EB445137-D7F5-57EC-87DA-1DB460D64046,"iPhone13,2"
us.zoom.xos,372,1731535550,1731535922,1731535922.625185,-21600,,
com.google.Chrome,10,1731535540,1731535550,1731535550.539742,-21600,,
us.zoom.xos,10,1731535530,1731535540,1731535540.502979,-21600,,
com.google.Chrome,143,1731535387,1731535530,1731535530.2331161,-21600,,
us.zoom.xos,27,1731535360,1731535387,1731535387.9333491,-21600,,
com.google.Chrome,523,1731534837,1731535360,1731535360.880192,-21600,,
com.toyopagroup.picaboo,11,1731534812,1731534823,1731534823.309,-21600,EB445137-D7F5-57EC-87DA-1DB460D64046,"iPhone13,2"
com.google.ios.youtube,833,1731533976,1731534809,1731534810.136306,-21600,EB445137-D7F5-57EC-87DA-1DB460D64046,"iPhone13,2"
com.toyopagroup.picaboo,34,1731533925,1731533959,1731533959.3213859,-21600,EB445137-D7F5-57EC-87DA-1DB460D64046,"iPhone13,2"
com.toyopagroup.picaboo,33,1731533377,1731533410,1731533410.964078,-21600,EB445137-D7F5-57EC-87DA-1DB460D64046,"iPhone13,2"
com.myfitnesspal.mfp,5,1731533372,1731533377,1731533377.381856,-21600,EB445137-D7F5-57EC-87DA-1DB460D64046,"iPhone13,2"
com.myfitnesspal.mfp,1,1731533371,1731533372,1731533372.287558,-21600,EB445137-D7F5-57EC-87DA-1DB460D64046,"iPhone13,2"
com.myfitnesspal.mfp,16,1731533196,1731533212,1731533213.105947,-21600,EB445137-D7F5-57EC-87DA-1DB460D64046,"iPhone13,2"
com.google.Chrome,147,1731532477,1731532624,1731532624.4309978,-21600,,
com.google.Chrome,401,1731531294,1731531695,1731531695.530293,-21600,,
com.apple.camera,9,1731529841,1731529850,1731529861.313538,-21600,EB445137-D7F5-57EC-87DA-1DB460D64046,"iPhone13,2"
com.apple.news,53,1731527756,1731527809,1731527809.1660929,-21600,EB445137-D7F5-57EC-87DA-1DB460D64046,"iPhone13,2"
com.google.chrome.ios,13,1731527743,1731527756,1731527757.044246,-21600,EB445137-D7F5-57EC-87DA-1DB460D64046,"iPhone13,2"
com.apple.news,151,1731527592,1731527743,1731527743.1694489,-21600,EB445137-D7F5-57EC-87DA-1DB460D64046,"iPhone13,2"
com.toyopagroup.picaboo,24,1731527543,1731527567,1731527567.5518909,-21600,EB445137-D7F5-57EC-87DA-1DB460D64046,"iPhone13,2"
com.apple.news,5,1731527538,1731527543,1731527543.762827,-21600,EB445137-D7F5-57EC-87DA-1DB460D64046,"iPhone13,2"
com.apple.news,2,1731527125,1731527127,1731527127.4152288,-21600,EB445137-D7F5-57EC-87DA-1DB460D64046,"iPhone13,2"
com.apple.news,300,1731526734,1731527034,1731527034.981381,-21600,EB445137-D7F5-57EC-87DA-1DB460D64046,"iPhone13,2"
com.apple.news,6,1731526351,1731526357,1731526357.457358,-21600,EB445137-D7F5-57EC-87DA-1DB460D64046,"iPhone13,2"
com.apple.news,152,1731526197,1731526349,1731526350.149681,-21600,EB445137-D7F5-57EC-87DA-1DB460D64046,"iPhone13,2"
com.apple.news,6,1731525932,1731525938,1731525938.476644,-21600,EB445137-D7F5-57EC-87DA-1DB460D64046,"iPhone13,2"
com.apple.news,86,1731525842,1731525928,1731525929.58707,-21600,EB445137-D7F5-57EC-87DA-1DB460D64046,"iPhone13,2"
com.apple.news,187,1731524896,1731525083,1731525084.765841,-21600,EB445137-D7F5-57EC-87DA-1DB460D64046,"iPhone13,2"
com.apple.news,2,1731524361,1731524363,1731524363.02742,-21600,EB445137-D7F5-57EC-87DA-1DB460D64046,"iPhone13,2"
com.apple.news,4,1731524318,1731524322,1731524322.5920959,-21600,EB445137-D7F5-57EC-87DA-1DB460D64046,"iPhone13,2"
com.google.Chrome,444,1731524238,1731524682,1731524682.997611,-21600,,
com.microsoft.Outlook,70,1731524168,1731524238,1731524238.3382,-21600,,
com.google.Chrome,39,1731524129,1731524168,1731524168.862103,-21600,,
com.apple.finder,20,1731524109,1731524129,1731524129.617484,-21600,,
com.apple.news,93,1731523976,1731524069,1731524069.506168,-21600,EB445137-D7F5-57EC-87DA-1DB460D64046,"iPhone13,2"
com.apple.MobileSMS,3,1731523894,1731523897,1731523897.591007,-21600,EB445137-D7F5-57EC-87DA-1DB460D64046,"iPhone13,2"
com.apple.DocumentsApp,5,1731523889,1731523894,1731523895.219348,-21600,EB445137-D7F5-57EC-87DA-1DB460D64046,"iPhone13,2"
com.apple.DocumentsApp,7,1731523183,1731523190,1731523190.475613,-21600,EB445137-D7F5-57EC-87DA-1DB460D64046,"iPhone13,2"
com.apple.DocumentsApp,7,1731523073,1731523080,1731523080.928946,-21600,EB445137-D7F5-57EC-87DA-1DB460D64046,"iPhone13,2"
com.apple.DocumentsApp,8,1731523030,1731523038,1731523038.309132,-21600,EB445137-D7F5-57EC-87DA-1DB460D64046,"iPhone13,2"
com.apple.weather,3,1731523027,1731523030,1731523032.974189,-21600,EB445137-D7F5-57EC-87DA-1DB460D64046,"iPhone13,2"
com.apple.weather,3,1731522872,1731522875,1731522875.2486691,-21600,EB445137-D7F5-57EC-87DA-1DB460D64046,"iPhone13,2"
com.apple.weather,7,1731522864,1731522871,1731522871.9425201,-21600,EB445137-D7F5-57EC-87DA-1DB460D64046,"iPhone13,2"
com.apple.DocumentsApp,1,1731522862,1731522863,1731522864.064357,-21600,EB445137-D7F5-57EC-87DA-1DB460D64046,"iPhone13,2"
com.apple.finder,1,1731522835,1731522836,1731522837.036765,-21600,,
com.microsoft.VSCode,2,1731522833,1731522835,1731522835.760106,-21600,,
com.apple.DocumentsApp,43,1731522785,1731522828,1731522828.862493,-21600,EB445137-D7F5-57EC-87DA-1DB460D64046,"iPhone13,2"
com.microsoft.Office.Outlook,7,1731522778,1731522785,1731522785.19997,-21600,EB445137-D7F5-57EC-87DA-1DB460D64046,"iPhone13,2"
com.apple.finder,67,1731522766,1731522833,1731522833.674487,-21600,,
com.google.Chrome,13,1731522753,1731522766,1731522767.021544,-21600,,
com.apple.finder,18,1731522735,1731522753,1731522753.848964,-21600,,
com.google.Chrome,31,1731522704,1731522735,1731522735.80615,-21600,,
com.microsoft.Office.Outlook,64,1731521578,1731521642,1731521642.6744661,-21600,EB445137-D7F5-57EC-87DA-1DB460D64046,"iPhone13,2"
com.apple.MobileSMS,6,1731521572,1731521578,1731521579.2438068,-21600,EB445137-D7F5-57EC-87DA-1DB460D64046,"iPhone13,2"
com.google.Chrome,1237,1731521141,1731522378,1731522378.654042,-21600,,
com.apple.MobileSMS,7,1731520557,1731520564,1731520564.286551,-21600,EB445137-D7F5-57EC-87DA-1DB460D64046,"iPhone13,2"
com.apple.MobileSMS,1,1731520555,1731520556,1731520556.8497481,-21600,EB445137-D7F5-57EC-87DA-1DB460D64046,"iPhone13,2"
com.google.Chrome,503,1731520553,1731521056,1731521056.807355,-21600,,
com.leomehlig.today,19,1731520534,1731520553,1731520554.00157,-21600,,
com.apple.finder,34,1731520500,1731520534,1731520534.716765,-21600,,
com.leomehlig.today,32,1731520468,1731520500,1731520500.186856,-21600,,
com.google.Chrome,168,1731520300,1731520468,1731520468.90972,-21600,,
com.apple.finder,6,1731520294,1731520300,1731520300.565871,-21600,,
com.google.Chrome,758,1731519536,1731520294,1731520294.587134,-21600,,
com.leomehlig.today,13,1731519523,1731519536,1731519536.689399,-21600,,
com.apple.iCal,1,1731519522,1731519523,1731519523.2161021,-21600,,
com.google.Chrome,6,1731519516,1731519522,1731519522.7649221,-21600,,
com.microsoft.VSCode,398,1731519118,1731519516,1731519516.609949,-21600,,
com.google.Chrome,2,1731519116,1731519118,1731519118.881944,-21600,,
com.microsoft.VSCode,4,1731519112,1731519116,1731519116.464329,-21600,,
com.google.Chrome,13,1731519099,1731519112,1731519112.198485,-21600,,
com.microsoft.VSCode,248,1731518851,1731519099,1731519099.983945,-21600,,
com.google.Chrome,74,1731518777,1731518851,1731518851.189811,-21600,,
com.microsoft.VSCode,149,1731518628,1731518777,1731518777.542963,-21600,,
com.google.Chrome,16,1731518612,1731518628,1731518628.082703,-21600,,
com.leomehlig.today,20,1731518592,1731518612,1731518612.734895,-21600,,
com.google.Chrome,236,1731518356,1731518592,1731518593.0501862,-21600,,
com.leomehlig.today,0,1731517672,1731517672,1731517672.958448,-21600,,
com.google.Chrome,1,1731517671,1731517672,1731517672.125263,-21600,,
com.leomehlig.today,8,1731517626,1731517634,1731517635.209367,-21600,,
com.apple.finder,2,1731517624,1731517626,1731517626.526869,-21600,,
com.leomehlig.today,9,1731517615,1731517624,1731517624.3650951,-21600,,
com.apple.finder,13,1731517602,1731517615,1731517615.200248,-21600,,
com.leomehlig.today,21,1731517581,1731517602,1731517602.131383,-21600,,
com.apple.MobileSMS,9,1731517576,1731517585,1731517585.932784,-21600,EB445137-D7F5-57EC-87DA-1DB460D64046,"iPhone13,2"
com.google.Chrome,7,1731517574,1731517581,1731517581.433358,-21600,,
com.apple.MobileSMS,1,1731517571,1731517572,1731517572.825737,-21600,EB445137-D7F5-57EC-87DA-1DB460D64046,"iPhone13,2"
com.apple.MobileSMS,36,1731517529,1731517565,1731517566.277679,-21600,EB445137-D7F5-57EC-87DA-1DB460D64046,"iPhone13,2"
com.apple.Health,2,1731517527,1731517529,1731517529.877198,-21600,EB445137-D7F5-57EC-87DA-1DB460D64046,"iPhone13,2"
com.apple.Health,4,1731517346,1731517350,1731517350.887366,-21600,EB445137-D7F5-57EC-87DA-1DB460D64046,"iPhone13,2"
com.google.Chrome,1115,1731515525,1731516640,1731516640.204547,-21600,,
com.leomehlig.today,3,1731515505,1731515508,1731515508.789572,-21600,,
com.apple.Health,19,1731513623,1731513642,1731513642.892706,-21600,EB445137-D7F5-57EC-87DA-1DB460D64046,"iPhone13,2"
com.microsoft.Office.Outlook,2,1731513621,1731513623,1731513627.321984,-21600,EB445137-D7F5-57EC-87DA-1DB460D64046,"iPhone13,2"
com.apple.camera,2,1731513444,1731513446,1731513446.8317518,-21600,EB445137-D7F5-57EC-87DA-1DB460D64046,"iPhone13,2"
com.microsoft.Office.Outlook,8,1731513438,1731513446,1731513446.827224,-21600,EB445137-D7F5-57EC-87DA-1DB460D64046,"iPhone13,2"
com.leomehlig.today,10,1731512397,1731512407,1731512407.883986,-21600,,
com.microsoft.Office.Outlook,81,1731512205,1731512286,1731512287.390748,-21600,EB445137-D7F5-57EC-87DA-1DB460D64046,"iPhone13,2"
com.renpho.health,7,1731512192,1731512199,1731512199.197609,-21600,EB445137-D7F5-57EC-87DA-1DB460D64046,"iPhone13,2"
com.renpho.health,12,1731512179,1731512191,1731512191.849594,-21600,EB445137-D7F5-57EC-87DA-1DB460D64046,"iPhone13,2"
com.google.Chrome,274,1731512123,1731512397,1731512397.0957742,-21600,,
com.apple.camera,1,1731510820,1731510821,1731510821.727973,-21600,EB445137-D7F5-57EC-87DA-1DB460D64046,"iPhone13,2"
com.renpho.health,13,1731510819,1731510832,1731510832.080482,-21600,EB445137-D7F5-57EC-87DA-1DB460D64046,"iPhone13,2"
com.renpho.health,109,1731510709,1731510818,1731510819.238899,-21600,EB445137-D7F5-57EC-87DA-1DB460D64046,"iPhone13,2"
com.apple.camera,0,1731510696,1731510696,1731510696.653524,-21600,EB445137-D7F5-57EC-87DA-1DB460D64046,"iPhone13,2"
com.apple.news,123,1731509735,1731509858,1731509859.259093,-21600,EB445137-D7F5-57EC-87DA-1DB460D64046,"iPhone13,2"
com.google.chrome.ios,59,1731476832,1731476891,1731476891.5213509,-21600,EB445137-D7F5-57EC-87DA-1DB460D64046,"iPhone13,2"
com.thestorygraph.thestorygraph,167,1731476664,1731476831,1731476832.236839,-21600,EB445137-D7F5-57EC-87DA-1DB460D64046,"iPhone13,2"
com.thestorygraph.thestorygraph,27,1731476636,1731476663,1731476664.039885,-21600,EB445137-D7F5-57EC-87DA-1DB460D64046,"iPhone13,2"
com.google.chrome.ios,4,1731476631,1731476635,1731476635.792016,-21600,EB445137-D7F5-57EC-87DA-1DB460D64046,"iPhone13,2"
com.google.chrome.ios,13,1731474545,1731474558,1731474558.52018,-21600,EB445137-D7F5-57EC-87DA-1DB460D64046,"iPhone13,2"
com.google.chrome.ios,10,1731474437,1731474447,1731474447.911241,-21600,EB445137-D7F5-57EC-87DA-1DB460D64046,"iPhone13,2"
com.google.chrome.ios,12,1731474308,1731474320,1731474320.694344,-21600,EB445137-D7F5-57EC-87DA-1DB460D64046,"iPhone13,2"
com.google.Chrome,792,1731473110,1731473902,1731473902.017174,-21600,,
com.leomehlig.today,5,1731473105,1731473110,1731473110.578304,-21600,,
com.google.Chrome,13,1731473092,1731473105,1731473106.010867,-21600,,
com.google.Chrome,324,1731471603,1731471927,1731471927.813623,-21600,,
com.google.chrome.ios,13,1731471466,1731471479,1731471479.239828,-21600,EB445137-D7F5-57EC-87DA-1DB460D64046,"iPhone13,2"
com.google.chrome.ios,2,1731471462,1731471464,1731471464.365946,-21600,EB445137-D7F5-57EC-87DA-1DB460D64046,"iPhone13,2"
com.google.Chrome,218,1731470738,1731470956,1731470956.2695642,-21600,,
com.leomehlig.today,2,1731470736,1731470738,1731470738.482269,-21600,,
com.apple.iCal,41,1731470695,1731470736,1731470736.9807181,-21600,,
com.leomehlig.today,6,1731470689,1731470695,1731470695.394373,-21600,,
com.microsoft.VSCode,18,1731470671,1731470689,1731470689.9190822,-21600,,
com.google.Chrome,7,1731470664,1731470671,1731470672.382474,-21600,,
com.leomehlig.today,117,1731470547,1731470664,1731470664.7647638,-21600,,
com.google.Chrome,2,1731470545,1731470547,1731470547.19504,-21600,,
com.google.chrome.ios,6,1731470243,1731470249,1731470249.4106221,-21600,EB445137-D7F5-57EC-87DA-1DB460D64046,"iPhone13,2"
com.google.chrome.ios,3,1731470239,1731470242,1731470242.144565,-21600,EB445137-D7F5-57EC-87DA-1DB460D64046,"iPhone13,2"
com.google.chrome.ios,36,1731469874,1731469910,1731469911.373774,-21600,EB445137-D7F5-57EC-87DA-1DB460D64046,"iPhone13,2"
com.thestorygraph.thestorygraph,8,1731469861,1731469869,1731469869.867426,-21600,EB445137-D7F5-57EC-87DA-1DB460D64046,"iPhone13,2"
com.thestorygraph.thestorygraph,2,1731469802,1731469804,1731469804.644197,-21600,EB445137-D7F5-57EC-87DA-1DB460D64046,"iPhone13,2"
com.thestorygraph.thestorygraph,4,1731469562,1731469566,1731469566.323915,-21600,EB445137-D7F5-57EC-87DA-1DB460D64046,"iPhone13,2"
com.thestorygraph.thestorygraph,1,1731469111,1731469112,1731469112.962988,-21600,EB445137-D7F5-57EC-87DA-1DB460D64046,"iPhone13,2"
com.thestorygraph.thestorygraph,1,1731468858,1731468859,1731468859.667681,-21600,EB445137-D7F5-57EC-87DA-1DB460D64046,"iPhone13,2"
com.thestorygraph.thestorygraph,4,1731468808,1731468812,1731468813.4071,-21600,EB445137-D7F5-57EC-87DA-1DB460D64046,"iPhone13,2"
com.thestorygraph.thestorygraph,6,1731467642,1731467648,1731467648.6649709,-21600,EB445137-D7F5-57EC-87DA-1DB460D64046,"iPhone13,2"
com.thestorygraph.thestorygraph,4,1731467398,1731467402,1731467402.227768,-21600,EB445137-D7F5-57EC-87DA-1DB460D64046,"iPhone13,2"
com.apple.camera,0,1731467325,1731467325,1731467325.9342961,-21600,EB445137-D7F5-57EC-87DA-1DB460D64046,"iPhone13,2"
com.thestorygraph.thestorygraph,15,1731467323,1731467338,1731467338.642031,-21600,EB445137-D7F5-57EC-87DA-1DB460D64046,"iPhone13,2"
com.thestorygraph.thestorygraph,41,1731466496,1731466537,1731466537.312883,-21600,EB445137-D7F5-57EC-87DA-1DB460D64046,"iPhone13,2"
com.supercell.magic,728,1731461686,1731462414,1731462414.204701,-21600,EB445137-D7F5-57EC-87DA-1DB460D64046,"iPhone13,2"
com.toyopagroup.picaboo,7,1731461679,1731461686,1731461687.206336,-21600,EB445137-D7F5-57EC-87DA-1DB460D64046,"iPhone13,2"
com.supercell.magic,6,1731461673,1731461679,1731461679.871193,-21600,EB445137-D7F5-57EC-87DA-1DB460D64046,"iPhone13,2"
com.supercell.magic,156,1731461304,1731461460,1731461461.2363439,-21600,EB445137-D7F5-57EC-87DA-1DB460D64046,"iPhone13,2"
com.instructure.icanvas,3,1731461297,1731461300,1731461300.902633,-21600,EB445137-D7F5-57EC-87DA-1DB460D64046,"iPhone13,2"
com.instructure.icanvas,6,1731460254,1731460260,1731460260.985497,-21600,EB445137-D7F5-57EC-87DA-1DB460D64046,"iPhone13,2"
com.instructure.icanvas,26,1731460208,1731460234,1731460234.850346,-21600,EB445137-D7F5-57EC-87DA-1DB460D64046,"iPhone13,2"
com.apple.mobilecal,24,1731459259,1731459283,1731459284.0112839,-21600,EB445137-D7F5-57EC-87DA-1DB460D64046,"iPhone13,2"
com.tinyspeck.chatlyio,34,1731459219,1731459253,1731459253.969516,-21600,EB445137-D7F5-57EC-87DA-1DB460D64046,"iPhone13,2"
com.hammerandchisel.discord,7,1731458651,1731458658,1731458658.940392,-21600,EB445137-D7F5-57EC-87DA-1DB460D64046,"iPhone13,2"
com.hammerandchisel.discord,1,1731458637,1731458638,1731458638.932127,-21600,EB445137-D7F5-57EC-87DA-1DB460D64046,"iPhone13,2"
com.hammerandchisel.discord,7,1731458545,1731458552,1731458552.666825,-21600,EB445137-D7F5-57EC-87DA-1DB460D64046,"iPhone13,2"
com.hammerandchisel.discord,22,1731458321,1731458343,1731458344.0619779,-21600,EB445137-D7F5-57EC-87DA-1DB460D64046,"iPhone13,2"
com.apple.news,42,1731456865,1731456907,1731456907.821507,-21600,EB445137-D7F5-57EC-87DA-1DB460D64046,"iPhone13,2"
com.apple.news,3,1731455664,1731455667,1731455667.068433,-21600,EB445137-D7F5-57EC-87DA-1DB460D64046,"iPhone13,2"
com.apple.news,4,1731455559,1731455563,1731455563.304784,-21600,EB445137-D7F5-57EC-87DA-1DB460D64046,"iPhone13,2"
com.apple.news,3,1731455404,1731455407,1731455407.5664759,-21600,EB445137-D7F5-57EC-87DA-1DB460D64046,"iPhone13,2"
com.apple.news,73,1731455312,1731455385,1731455385.968834,-21600,EB445137-D7F5-57EC-87DA-1DB460D64046,"iPhone13,2"
com.apple.calculator,5,1731455303,1731455308,1731455308.295131,-21600,EB445137-D7F5-57EC-87DA-1DB460D64046,"iPhone13,2"
com.apple.calculator,3,1731455038,1731455041,1731455041.191248,-21600,EB445137-D7F5-57EC-87DA-1DB460D64046,"iPhone13,2"
com.truebill.truebillnative,15,1731455023,1731455038,1731455038.679051,-21600,EB445137-D7F5-57EC-87DA-1DB460D64046,"iPhone13,2"
com.apple.calculator,21,1731455002,1731455023,1731455023.046073,-21600,EB445137-D7F5-57EC-87DA-1DB460D64046,"iPhone13,2"
com.truebill.truebillnative,2,1731455000,1731455002,1731455002.406326,-21600,EB445137-D7F5-57EC-87DA-1DB460D64046,"iPhone13,2"
com.apple.calculator,4,1731454996,1731455000,1731455000.718025,-21600,EB445137-D7F5-57EC-87DA-1DB460D64046,"iPhone13,2"
com.truebill.truebillnative,2,1731454994,1731454996,1731454996.9485059,-21600,EB445137-D7F5-57EC-87DA-1DB460D64046,"iPhone13,2"
com.apple.calculator,6,1731454988,1731454994,1731454994.163635,-21600,EB445137-D7F5-57EC-87DA-1DB460D64046,"iPhone13,2"
com.truebill.truebillnative,3,1731454985,1731454988,1731454988.840313,-21600,EB445137-D7F5-57EC-87DA-1DB460D64046,"iPhone13,2"
com.apple.calculator,5,1731454980,1731454985,1731454985.566292,-21600,EB445137-D7F5-57EC-87DA-1DB460D64046,"iPhone13,2"
com.truebill.truebillnative,12,1731454968,1731454980,1731454980.9494848,-21600,EB445137-D7F5-57EC-87DA-1DB460D64046,"iPhone13,2"
com.apple.calculator,4,1731454964,1731454968,1731454968.824181,-21600,EB445137-D7F5-57EC-87DA-1DB460D64046,"iPhone13,2"
com.truebill.truebillnative,22,1731454942,1731454964,1731454964.635274,-21600,EB445137-D7F5-57EC-87DA-1DB460D64046,"iPhone13,2"
com.toyopagroup.picaboo,26,1731454411,1731454437,1731454437.725295,-21600,EB445137-D7F5-57EC-87DA-1DB460D64046,"iPhone13,2"
com.toyopagroup.picaboo,65,1731454279,1731454344,1731454344.7008882,-21600,EB445137-D7F5-57EC-87DA-1DB460D64046,"iPhone13,2"
com.apple.news,3,1731454276,1731454279,1731454280.040794,-21600,EB445137-D7F5-57EC-87DA-1DB460D64046,"iPhone13,2"
com.apple.news,3,1731454246,1731454249,1731454249.254453,-21600,EB445137-D7F5-57EC-87DA-1DB460D64046,"iPhone13,2"
com.apple.news,28,1731454216,1731454244,1731454244.861395,-21600,EB445137-D7F5-57EC-87DA-1DB460D64046,"iPhone13,2"
com.toyopagroup.picaboo,15,1731454190,1731454205,1731454206.146834,-21600,EB445137-D7F5-57EC-87DA-1DB460D64046,"iPhone13,2"
com.microsoft.Office.Outlook,3,1731454187,1731454190,1731454190.564334,-21600,EB445137-D7F5-57EC-87DA-1DB460D64046,"iPhone13,2"
com.microsoft.Office.Outlook,25,1731453307,1731453332,1731453333.6184092,-21600,EB445137-D7F5-57EC-87DA-1DB460D64046,"iPhone13,2"
com.robinhood.release.Robinhood,74,1731453202,1731453276,1731453276.214007,-21600,EB445137-D7F5-57EC-87DA-1DB460D64046,"iPhone13,2"
org.name.serializdmobile,31,1731453164,1731453195,1731453196.038292,-21600,EB445137-D7F5-57EC-87DA-1DB460D64046,"iPhone13,2"
org.name.serializdmobile,25,1731453098,1731453123,1731453123.766355,-21600,EB445137-D7F5-57EC-87DA-1DB460D64046,"iPhone13,2"
org.name.serializdmobile,119,1731452837,1731452956,1731452957.191288,-21600,EB445137-D7F5-57EC-87DA-1DB460D64046,"iPhone13,2"
com.google.chrome.ios,16,1731452821,1731452837,1731452837.954746,-21600,EB445137-D7F5-57EC-87DA-1DB460D64046,"iPhone13,2"
org.name.serializdmobile,292,1731452529,1731452821,1731452821.175002,-21600,EB445137-D7F5-57EC-87DA-1DB460D64046,"iPhone13,2"
com.google.chrome.ios,34,1731452495,1731452529,1731452529.98026,-21600,EB445137-D7F5-57EC-87DA-1DB460D64046,"iPhone13,2"
org.name.serializdmobile,154,1731452341,1731452495,1731452495.419015,-21600,EB445137-D7F5-57EC-87DA-1DB460D64046,"iPhone13,2"
com.google.chrome.ios,23,1731452317,1731452340,1731452340.6595001,-21600,EB445137-D7F5-57EC-87DA-1DB460D64046,"iPhone13,2"
org.name.serializdmobile,5,1731452312,1731452317,1731452317.246708,-21600,EB445137-D7F5-57EC-87DA-1DB460D64046,"iPhone13,2"
org.name.serializdmobile,40,1731452237,1731452277,1731452277.361371,-21600,EB445137-D7F5-57EC-87DA-1DB460D64046,"iPhone13,2"
com.robinhood.release.Robinhood,2,1731452235,1731452237,1731452237.674168,-21600,EB445137-D7F5-57EC-87DA-1DB460D64046,"iPhone13,2"
org.name.serializdmobile,23,1731452212,1731452235,1731452235.4528332,-21600,EB445137-D7F5-57EC-87DA-1DB460D64046,"iPhone13,2"
org.name.serializdmobile,24,1731452184,1731452208,1731452208.547701,-21600,EB445137-D7F5-57EC-87DA-1DB460D64046,"iPhone13,2"
com.microsoft.Office.Outlook,5,1731452179,1731452184,1731452184.977715,-21600,EB445137-D7F5-57EC-87DA-1DB460D64046,"iPhone13,2"
org.name.serializdmobile,4,1731452175,1731452179,1731452179.960844,-21600,EB445137-D7F5-57EC-87DA-1DB460D64046,"iPhone13,2"
org.name.serializdmobile,3,1731451813,1731451816,1731451816.954427,-21600,EB445137-D7F5-57EC-87DA-1DB460D64046,"iPhone13,2"
com.apple.Preferences,4,1731451793,1731451797,1731451797.6717858,-21600,EB445137-D7F5-57EC-87DA-1DB460D64046,"iPhone13,2"
com.hammerandchisel.discord,48,1731451742,1731451790,1731451790.365663,-21600,EB445137-D7F5-57EC-87DA-1DB460D64046,"iPhone13,2"
com.toyopagroup.picaboo,20,1731451261,1731451281,1731451281.363888,-21600,EB445137-D7F5-57EC-87DA-1DB460D64046,"iPhone13,2"
com.google.Chrome,300,1731451035,1731451335,1731451335.8552809,-21600,,
com.leomehlig.today,14,1731451021,1731451035,1731451035.759017,-21600,,
com.apple.iCal,5,1731451016,1731451021,1731451021.7924309,-21600,,
com.leomehlig.today,3,1731451013,1731451016,1731451016.7860708,-21600,,
com.google.Chrome,31,1731450982,1731451013,1731451014.022396,-21600,,
com.leomehlig.today,15,1731450967,1731450982,1731450982.8838248,-21600,,
com.toyopagroup.picaboo,4,1731450954,1731450958,1731450958.834317,-21600,EB445137-D7F5-57EC-87DA-1DB460D64046,"iPhone13,2"
com.google.Chrome,134,1731450833,1731450967,1731450967.088033,-21600,,
com.leomehlig.today,11,1731450822,1731450833,1731450833.959152,-21600,,
com.toyopagroup.picaboo,225,1731450723,1731450948,1731450948.937412,-21600,EB445137-D7F5-57EC-87DA-1DB460D64046,"iPhone13,2"
com.instructure.icanvas,34,1731450683,1731450717,1731450718.178951,-21600,EB445137-D7F5-57EC-87DA-1DB460D64046,"iPhone13,2"
com.toyopagroup.picaboo,4,1731450678,1731450682,1731450682.933576,-21600,EB445137-D7F5-57EC-87DA-1DB460D64046,"iPhone13,2"
com.apple.news,11,1731450667,1731450678,1731450679.2668371,-21600,EB445137-D7F5-57EC-87DA-1DB460D64046,"iPhone13,2"
com.google.Chrome,176,1731450646,1731450822,1731450822.555272,-21600,,
com.microsoft.VSCode,31,1731450615,1731450646,1731450646.1362529,-21600,,
com.google.Chrome,20,1731450595,1731450615,1731450615.420152,-21600,,
com.microsoft.VSCode,1,1731450594,1731450595,1731450595.8639941,-21600,,
com.google.Chrome,8,1731450586,1731450594,1731450594.475593,-21600,,
com.microsoft.VSCode,154,1731450432,1731450586,1731450586.572614,-21600,,
com.google.Chrome,24,1731450408,1731450432,1731450433.053427,-21600,,
com.microsoft.VSCode,22,1731450386,1731450408,1731450408.872929,-21600,,
com.google.Chrome,4,1731450382,1731450386,1731450386.117622,-21600,,
com.microsoft.VSCode,4,1731450378,1731450382,1731450382.71765,-21600,,
com.google.Chrome,2,1731450376,1731450378,1731450378.265621,-21600,,
com.microsoft.VSCode,10,1731450366,1731450376,1731450376.775806,-21600,,
com.google.Chrome,4,1731450362,1731450366,1731450366.5062408,-21600,,
com.microsoft.VSCode,3,1731450359,1731450362,1731450362.949832,-21600,,
com.google.Chrome,47,1731450312,1731450359,1731450359.429789,-21600,,
com.microsoft.VSCode,885,1731449427,1731450312,1731450312.726058,-21600,,
com.google.Chrome,0,1731449427,1731449427,1731449427.583163,-21600,,
com.microsoft.VSCode,84,1731449343,1731449427,1731449427.109282,-21600,,
com.google.Chrome,1,1731449342,1731449343,1731449343.340708,-21600,,
com.microsoft.VSCode,10,1731449332,1731449342,1731449342.086045,-21600,,
com.google.Chrome,3,1731449329,1731449332,1731449333.0049329,-21600,,
com.microsoft.VSCode,17,1731449312,1731449329,1731449329.9602141,-21600,,
com.google.Chrome,49,1731449263,1731449312,1731449312.091214,-21600,,
com.microsoft.VSCode,337,1731448926,1731449263,1731449264.00367,-21600,,
com.google.Chrome,19,1731448907,1731448926,1731448926.965557,-21600,,
com.microsoft.VSCode,314,1731448593,1731448907,1731448907.1319761,-21600,,
com.google.Chrome,10,1731448583,1731448593,1731448593.2558432,-21600,,
com.microsoft.VSCode,26,1731448557,1731448583,1731448583.996361,-21600,,
com.google.Chrome,3,1731448554,1731448557,1731448557.639482,-21600,,
com.microsoft.VSCode,4,1731448550,1731448554,1731448554.7780972,-21600,,
com.google.Chrome,7,1731448543,1731448550,1731448550.195487,-21600,,
com.microsoft.VSCode,8,1731448535,1731448543,1731448543.555736,-21600,,
com.google.Chrome,30,1731448505,1731448535,1731448535.391171,-21600,,
com.microsoft.VSCode,79,1731448426,1731448505,1731448505.245678,-21600,,
com.google.Chrome,31,1731448395,1731448426,1731448426.068235,-21600,,
com.microsoft.VSCode,384,1731448011,1731448395,1731448395.573818,-21600,,
com.google.Chrome,2,1731448009,1731448011,1731448011.803228,-21600,,
com.leomehlig.today,14,1731447995,1731448009,1731448009.4388661,-21600,,
com.google.Chrome,3,1731447992,1731447995,1731447995.751764,-21600,,
com.apple.iCal,2,1731447990,1731447992,1731447992.6940641,-21600,,
com.apple.news,224,1731447766,1731447990,1731447991.2385411,-21600,EB445137-D7F5-57EC-87DA-1DB460D64046,"iPhone13,2"
com.apple.news,206,1731446711,1731446917,1731446918.041092,-21600,EB445137-D7F5-57EC-87DA-1DB460D64046,"iPhone13,2"
com.toyopagroup.picaboo,37,1731446665,1731446702,1731446702.712687,-21600,EB445137-D7F5-57EC-87DA-1DB460D64046,"iPhone13,2"
com.thestorygraph.thestorygraph,5,1731446660,1731446665,1731446665.618499,-21600,EB445137-D7F5-57EC-87DA-1DB460D64046,"iPhone13,2"
com.thestorygraph.thestorygraph,23,1731445607,1731445630,1731445631.372868,-21600,EB445137-D7F5-57EC-87DA-1DB460D64046,"iPhone13,2"
us.parkmobile.ParkMobile,2,1731445600,1731445602,1731445602.065062,-21600,EB445137-D7F5-57EC-87DA-1DB460D64046,"iPhone13,2"
us.parkmobile.ParkMobile,119,1731442507,1731442626,1731442626.601685,-21600,EB445137-D7F5-57EC-87DA-1DB460D64046,"iPhone13,2"
com.apple.weather,3,1731442500,1731442503,1731442503.899541,-21600,EB445137-D7F5-57EC-87DA-1DB460D64046,"iPhone13,2"
com.apple.weather,8,1731441713,1731441721,1731441722.060343,-21600,EB445137-D7F5-57EC-87DA-1DB460D64046,"iPhone13,2"
com.instructure.icanvas,2,1731441706,1731441708,1731441708.633532,-21600,EB445137-D7F5-57EC-87DA-1DB460D64046,"iPhone13,2"
com.apple.iCal,12,1731441686,1731441698,1731441698.40154,-21600,,
com.leomehlig.today,3,1731441683,1731441686,1731441686.5811892,-21600,,
com.instructure.icanvas,23,1731441618,1731441641,1731441642.796798,-21600,EB445137-D7F5-57EC-87DA-1DB460D64046,"iPhone13,2"
com.google.ios.youtube,1610,1731439977,1731441587,1731441588.336484,-21600,EB445137-D7F5-57EC-87DA-1DB460D64046,"iPhone13,2"
com.apple.weather,9,1731439965,1731439974,1731439974.9261742,-21600,EB445137-D7F5-57EC-87DA-1DB460D64046,"iPhone13,2"
com.apple.weather,16,1731439935,1731439951,1731439951.829093,-21600,EB445137-D7F5-57EC-87DA-1DB460D64046,"iPhone13,2"
com.leomehlig.today,382,1731439839,1731440221,1731440221.973654,-21600,,
com.google.Chrome,864,1731438975,1731439839,1731439839.375798,-21600,,
com.toyopagroup.picaboo,31,1731438485,1731438516,1731438517.052579,-21600,EB445137-D7F5-57EC-87DA-1DB460D64046,"iPhone13,2"
com.google.Chrome,784,1731437988,1731438772,1731438772.106127,-21600,,
com.instructure.icanvas,28,1731437694,1731437722,1731437723.349833,-21600,EB445137-D7F5-57EC-87DA-1DB460D64046,"iPhone13,2"
com.toyopagroup.picaboo,10,1731437684,1731437694,1731437694.971587,-21600,EB445137-D7F5-57EC-87DA-1DB460D64046,"iPhone13,2"
com.toyopagroup.picaboo,77,1731437550,1731437627,1731437628.6268082,-21600,EB445137-D7F5-57EC-87DA-1DB460D64046,"iPhone13,2"
com.leomehlig.today,154,1731437522,1731437676,1731437676.415553,-21600,,
com.google.chrome.ios,35,1731437455,1731437490,1731437491.199041,-21600,EB445137-D7F5-57EC-87DA-1DB460D64046,"iPhone13,2"
com.google.chrome.ios,4,1731437329,1731437333,1731437335.097097,-21600,EB445137-D7F5-57EC-87DA-1DB460D64046,"iPhone13,2"
com.apple.weather,3,1731437326,1731437329,1731437329.953109,-21600,EB445137-D7F5-57EC-87DA-1DB460D64046,"iPhone13,2"
com.leomehlig.today,465,1731435328,1731435793,1731435793.609202,-21600,,
com.apple.finder,6,1731435322,1731435328,1731435328.064208,-21600,,
com.google.Chrome,43,1731435279,1731435322,1731435322.1091352,-21600,,
com.apple.finder,1,1731435278,1731435279,1731435279.2322788,-21600,,
com.apple.QuickTimePlayerX,38,1731435240,1731435278,1731435278.136204,-21600,,
com.apple.finder,6,1731435234,1731435240,1731435241.176414,-21600,,
com.google.Chrome,23,1731435211,1731435234,1731435234.815774,-21600,,
us.zoom.xos,21,1731435185,1731435206,1731435206.446893,-21600,,
com.google.Chrome,9,1731435176,1731435185,1731435185.874876,-21600,,
com.apple.finder,45,1731435131,1731435176,1731435176.859603,-21600,,
com.google.Chrome,412,1731434719,1731435131,1731435131.963523,-21600,,
us.zoom.xos,37,1731434682,1731434719,1731434719.873565,-21600,,
com.google.Chrome,344,1731434338,1731434682,1731434682.3708181,-21600,,
us.zoom.xos,14,1731434324,1731434338,1731434338.200076,-21600,,
com.google.Chrome,9,1731434315,1731434324,1731434324.4083471,-21600,,
us.zoom.xos,6,1731434309,1731434315,1731434315.953134,-21600,,
com.google.Chrome,44,1731434265,1731434309,1731434309.4751148,-21600,,
us.zoom.xos,3,1731434262,1731434265,1731434265.32706,-21600,,
com.google.Chrome,23,1731434239,1731434262,1731434263.075551,-21600,,
com.apple.news,17,1731434222,1731434239,1731434239.653662,-21600,,
com.apple.weather,2,1731434046,1731434048,1731434048.2967482,-21600,EB445137-D7F5-57EC-87DA-1DB460D64046,"iPhone13,2"
com.apple.weather,5,1731433879,1731433884,1731433884.087707,-21600,EB445137-D7F5-57EC-87DA-1DB460D64046,"iPhone13,2"
com.apple.weather,9,1731433605,1731433614,1731433614.84849,-21600,EB445137-D7F5-57EC-87DA-1DB460D64046,"iPhone13,2"
com.apple.weather,33,1731433557,1731433590,1731433592.023371,-21600,EB445137-D7F5-57EC-87DA-1DB460D64046,"iPhone13,2"
Astrospheric.Astrospheric,4,1731433553,1731433557,1731433557.103702,-21600,EB445137-D7F5-57EC-87DA-1DB460D64046,"iPhone13,2"
com.apple.news,229,1731433084,1731433313,1731433313.189186,-21600,,
com.apple.finder,4,1731433080,1731433084,1731433084.45381,-21600,,
com.apple.news,393,1731432687,1731433080,1731433080.9948258,-21600,,
Astrospheric.Astrospheric,4,1731430868,1731430872,1731430872.271344,-21600,EB445137-D7F5-57EC-87DA-1DB460D64046,"iPhone13,2"
com.google.Chrome,1853,1731430834,1731432687,1731432687.468657,-21600,,
com.google.Chrome,4,1731430188,1731430192,1731430193.319483,-21600,,
com.microsoft.VSCode,2,1731430186,1731430188,1731430188.719468,-21600,,
com.google.Chrome,66,1731430120,1731430186,1731430186.4885368,-21600,,
com.hnc.Discord,1,1731430119,1731430120,1731430120.900481,-21600,,
com.microsoft.VSCode,1,1731430118,1731430119,1731430119.7848392,-21600,,
com.apple.Preview,9,1731430109,1731430118,1731430119.049887,-21600,,
com.microsoft.VSCode,1,1731430108,1731430109,1731430109.290009,-21600,,
com.google.Chrome,7,1731430101,1731430108,1731430108.786542,-21600,,
com.microsoft.VSCode,32,1731430069,1731430101,1731430101.513362,-21600,,
com.apple.Preview,17,1731430052,1731430069,1731430069.328038,-21600,,
com.microsoft.VSCode,6,1731430046,1731430052,1731430052.524517,-21600,,
com.microsoft.Outlook,3,1731430043,1731430046,1731430046.890358,-21600,,
com.microsoft.VSCode,128,1731429915,1731430043,1731430043.380724,-21600,,
com.apple.PhotoBooth,12,1731429903,1731429915,1731429915.4329329,-21600,,
Astrospheric.Astrospheric,9,1731429877,1731429886,1731429886.281642,-21600,EB445137-D7F5-57EC-87DA-1DB460D64046,"iPhone13,2"
Astrospheric.Astrospheric,10,1731429748,1731429758,1731429758.510402,-21600,EB445137-D7F5-57EC-87DA-1DB460D64046,"iPhone13,2"
com.microsoft.VSCode,172,1731429731,1731429903,1731429903.57511,-21600,,
Astrospheric.Astrospheric,10,1731429717,1731429727,1731429727.38588,-21600,EB445137-D7F5-57EC-87DA-1DB460D64046,"iPhone13,2"
com.hnc.Discord,34,1731429697,1731429731,1731429731.931532,-21600,,
com.microsoft.VSCode,425,1731429272,1731429697,1731429697.215694,-21600,,
com.hnc.Discord,10,1731429262,1731429272,1731429272.665791,-21600,,
com.google.Chrome,6,1731429256,1731429262,1731429262.8926802,-21600,,
com.microsoft.VSCode,42,1731429214,1731429256,1731429256.882132,-21600,,
com.google.Chrome,47,1731429167,1731429214,1731429214.845516,-21600,,
com.microsoft.VSCode,105,1731429062,1731429167,1731429167.172042,-21600,,
com.google.Chrome,25,1731429037,1731429062,1731429063.052407,-21600,,
com.microsoft.VSCode,0,1731429037,1731429037,1731429037.777855,-21600,,
com.google.Chrome,28,1731429009,1731429037,1731429037.104608,-21600,,
com.microsoft.VSCode,18,1731428991,1731429009,1731429009.404276,-21600,,
com.google.Chrome,3,1731428988,1731428991,1731428991.858742,-21600,,
com.microsoft.VSCode,8,1731428980,1731428988,1731428988.915966,-21600,,
com.google.Chrome,8,1731428972,1731428980,1731428980.7204661,-21600,,
com.hnc.Discord,1,1731428971,1731428972,1731428972.55778,-21600,,
com.google.Chrome,54,1731428917,1731428971,1731428971.5024219,-21600,,
com.hnc.Discord,1,1731428916,1731428917,1731428917.412004,-21600,,
Astrospheric.Astrospheric,13,1731428881,1731428894,1731428894.934208,-21600,EB445137-D7F5-57EC-87DA-1DB460D64046,"iPhone13,2"
com.apple.news,2,1731428877,1731428879,1731428879.9286242,-21600,EB445137-D7F5-57EC-87DA-1DB460D64046,"iPhone13,2"
com.microsoft.VSCode,44,1731428872,1731428916,1731428916.1799068,-21600,,
com.hnc.Discord,43,1731428829,1731428872,1731428872.975528,-21600,,
com.microsoft.VSCode,1,1731428828,1731428829,1731428829.940537,-21600,,
com.hnc.Discord,32,1731428796,1731428828,1731428828.84301,-21600,,
com.microsoft.VSCode,23,1731428773,1731428796,1731428796.545929,-21600,,
com.google.Chrome,5,1731428768,1731428773,1731428773.977658,-21600,,
com.microsoft.VSCode,13,1731428755,1731428768,1731428768.300863,-21600,,
com.google.Chrome,9,1731428746,1731428755,1731428755.697878,-21600,,
com.microsoft.VSCode,2,1731428744,1731428746,1731428746.323103,-21600,,
com.google.Chrome,18,1731428726,1731428744,1731428744.494622,-21600,,
com.microsoft.VSCode,4,1731428722,1731428726,1731428726.268959,-21600,,
com.google.Chrome,9,1731428713,1731428722,1731428722.1431808,-21600,,
com.microsoft.VSCode,10,1731428703,1731428713,1731428713.5849009,-21600,,
com.google.Chrome,15,1731428688,1731428703,1731428703.437422,-21600,,
com.microsoft.VSCode,2,1731428686,1731428688,1731428688.2406921,-21600,,
com.google.Chrome,10,1731428676,1731428686,1731428686.334249,-21600,,
com.microsoft.VSCode,2,1731428674,1731428676,1731428676.274689,-21600,,
com.google.Chrome,4,1731428670,1731428674,1731428674.6038141,-21600,,
com.microsoft.VSCode,23,1731428647,1731428670,1731428670.764001,-21600,,
com.google.Chrome,3,1731428644,1731428647,1731428647.3359752,-21600,,
com.microsoft.VSCode,2,1731428642,1731428644,1731428644.572335,-21600,,
com.google.Chrome,23,1731428619,1731428642,1731428642.578054,-21600,,
com.microsoft.VSCode,3,1731428616,1731428619,1731428619.275272,-21600,,
com.google.Chrome,2,1731428614,1731428616,1731428616.335515,-21600,,
com.microsoft.VSCode,2,1731428612,1731428614,1731428614.516663,-21600,,
com.google.Chrome,2,1731428610,1731428612,1731428612.9784698,-21600,,
com.microsoft.VSCode,4,1731428606,1731428610,1731428610.302442,-21600,,
com.google.Chrome,19,1731428587,1731428606,1731428606.449786,-21600,,
com.microsoft.VSCode,13,1731428574,1731428587,1731428587.1818628,-21600,,
com.google.Chrome,5,1731428569,1731428574,1731428574.142085,-21600,,
com.microsoft.VSCode,3,1731428566,1731428569,1731428569.163434,-21600,,
com.google.Chrome,9,1731428557,1731428566,1731428566.954252,-21600,,
com.microsoft.VSCode,9,1731428548,1731428557,1731428557.9770179,-21600,,
com.google.Chrome,12,1731428536,1731428548,1731428548.604111,-21600,,
com.microsoft.VSCode,1,1731428535,1731428536,1731428536.717428,-21600,,
com.google.Chrome,7,1731428528,1731428535,1731428535.25724,-21600,,
com.microsoft.VSCode,1381,1731427147,1731428528,1731428528.731337,-21600,,
com.google.Chrome,8,1731427139,1731427147,1731427147.2444072,-21600,,
com.microsoft.VSCode,6,1731427133,1731427139,1731427139.622047,-21600,,
com.google.Chrome,4,1731427129,1731427133,1731427133.8407001,-21600,,
com.microsoft.VSCode,73,1731427056,1731427129,1731427130.034286,-21600,,
com.google.Chrome,1,1731427055,1731427056,1731427056.322013,-21600,,
com.microsoft.VSCode,8,1731427047,1731427055,1731427055.529088,-21600,,
com.google.Chrome,2,1731427045,1731427047,1731427047.765264,-21600,,
com.microsoft.VSCode,2,1731427043,1731427045,1731427045.500099,-21600,,
com.google.Chrome,1,1731427042,1731427043,1731427043.756239,-21600,,
com.microsoft.VSCode,2,1731427040,1731427042,1731427042.192628,-21600,,
com.google.Chrome,3,1731427037,1731427040,1731427041.0688581,-21600,,
com.microsoft.VSCode,7,1731427030,1731427037,1731427037.80446,-21600,,
com.google.Chrome,42,1731426988,1731427030,1731427030.763143,-21600,,
com.microsoft.VSCode,493,1731426495,1731426988,1731426989.0040588,-21600,,
com.google.Chrome,1,1731426494,1731426495,1731426495.5127912,-21600,,
com.microsoft.VSCode,2,1731426492,1731426494,1731426494.378268,-21600,,
com.google.Chrome,1,1731426491,1731426492,1731426492.8449678,-21600,,
com.microsoft.VSCode,18,1731426473,1731426491,1731426491.1685128,-21600,,
com.google.Chrome,4,1731426469,1731426473,1731426473.211792,-21600,,
com.microsoft.VSCode,13,1731426456,1731426469,1731426469.2733579,-21600,,
com.google.Chrome,45,1731426411,1731426456,1731426456.877451,-21600,,
com.microsoft.VSCode,986,1731425425,1731426411,1731426412.009986,-21600,,
com.apple.finder,29,1731425396,1731425425,1731425425.702277,-21600,,
com.google.Chrome,37,1731425359,1731425396,1731425396.793958,-21600,,
com.apple.camera,1,1731425299,1731425300,1731425301.610596,-21600,EB445137-D7F5-57EC-87DA-1DB460D64046,"iPhone13,2"
com.apple.news,1,1731425299,1731425300,1731425301.608217,-21600,EB445137-D7F5-57EC-87DA-1DB460D64046,"iPhone13,2"
com.apple.news,2,1731424334,1731424336,1731424336.353687,-21600,EB445137-D7F5-57EC-87DA-1DB460D64046,"iPhone13,2"
com.apple.news,1,1731424332,1731424333,1731424333.945774,-21600,EB445137-D7F5-57EC-87DA-1DB460D64046,"iPhone13,2"
com.apple.news,294,1731424009,1731424303,1731424303.496855,-21600,EB445137-D7F5-57EC-87DA-1DB460D64046,"iPhone13,2"
com.renpho.health,9,1731423986,1731423995,1731423996.0379992,-21600,EB445137-D7F5-57EC-87DA-1DB460D64046,"iPhone13,2"
com.google.Chrome,288,1731423968,1731424256,1731424256.360327,-21600,,
com.leomehlig.today,11,1731423957,1731423968,1731423968.272564,-21600,,
com.google.Chrome,421,1731423536,1731423957,1731423957.9328709,-21600,,
com.apple.finder,3,1731423533,1731423536,1731423536.3913522,-21600,,
com.apple.camera,1,1731423532,1731423533,1731423533.98451,-21600,EB445137-D7F5-57EC-87DA-1DB460D64046,"iPhone13,2"
com.renpho.health,3,1731423530,1731423533,1731423533.882621,-21600,EB445137-D7F5-57EC-87DA-1DB460D64046,"iPhone13,2"
com.renpho.health,12,1731423332,1731423344,1731423344.179205,-21600,EB445137-D7F5-57EC-87DA-1DB460D64046,"iPhone13,2"
com.renpho.health,2,1731423327,1731423329,1731423329.8066669,-21600,EB445137-D7F5-57EC-87DA-1DB460D64046,"iPhone13,2"
com.renpho.health,28,1731422586,1731422614,1731422615.459786,-21600,EB445137-D7F5-57EC-87DA-1DB460D64046,"iPhone13,2"
com.apple.weather,6,1731422580,1731422586,1731422587.026315,-21600,EB445137-D7F5-57EC-87DA-1DB460D64046,"iPhone13,2"
com.renpho.health,2,1731422578,1731422580,1731422580.4771252,-21600,EB445137-D7F5-57EC-87DA-1DB460D64046,"iPhone13,2"
com.instructure.icanvas,31,1731422545,1731422576,1731422576.86886,-21600,EB445137-D7F5-57EC-87DA-1DB460D64046,"iPhone13,2"
com.thestorygraph.thestorygraph,17,1731391175,1731391192,1731391192.749095,-21600,EB445137-D7F5-57EC-87DA-1DB460D64046,"iPhone13,2"
com.apple.mobiletimer,6,1731391169,1731391175,1731391175.934618,-21600,EB445137-D7F5-57EC-87DA-1DB460D64046,"iPhone13,2"
com.apple.mobiletimer,13,1731388454,1731388467,1731388467.331983,-21600,EB445137-D7F5-57EC-87DA-1DB460D64046,"iPhone13,2"
com.apple.mobiletimer,6,1731388445,1731388451,1731388452.11265,-21600,EB445137-D7F5-57EC-87DA-1DB460D64046,"iPhone13,2"
com.apple.Health,16,1731388421,1731388437,1731388437.754008,-21600,EB445137-D7F5-57EC-87DA-1DB460D64046,"iPhone13,2"
com.apple.journal,681,1731387739,1731388420,1731388420.401153,-21600,EB445137-D7F5-57EC-87DA-1DB460D64046,"iPhone13,2"
com.apple.Health,100,1731387639,1731387739,1731387739.9373999,-21600,EB445137-D7F5-57EC-87DA-1DB460D64046,"iPhone13,2"
com.apple.journal,43,1731387596,1731387639,1731387639.414372,-21600,EB445137-D7F5-57EC-87DA-1DB460D64046,"iPhone13,2"
com.apple.news,7,1731387589,1731387596,1731387597.0974169,-21600,EB445137-D7F5-57EC-87DA-1DB460D64046,"iPhone13,2"
com.apple.news,13,1731387571,1731387584,1731387585.013812,-21600,EB445137-D7F5-57EC-87DA-1DB460D64046,"iPhone13,2"
com.apple.finder,3,1731387559,1731387562,1731387562.5344439,-21600,,
com.leomehlig.today,136,1731387423,1731387559,1731387559.0675812,-21600,,
com.microsoft.VSCode,234,1731387189,1731387423,1731387423.5592089,-21600,,
com.microsoft.Excel,5,1731387184,1731387189,1731387189.383582,-21600,,
com.leomehlig.today,2,1731387182,1731387184,1731387184.870554,-21600,,
com.microsoft.Excel,2,1731387180,1731387182,1731387182.571356,-21600,,
com.leomehlig.today,1,1731387179,1731387180,1731387180.9313989,-21600,,
com.microsoft.Excel,5,1731387174,1731387179,1731387179.040612,-21600,,
com.leomehlig.today,6,1731387168,1731387174,1731387174.377831,-21600,,
com.microsoft.Excel,2,1731387166,1731387168,1731387168.033334,-21600,,
com.leomehlig.today,2,1731387164,1731387166,1731387166.41448,-21600,,
com.microsoft.Excel,3,1731387161,1731387164,1731387164.503494,-21600,,
com.leomehlig.today,15,1731387146,1731387161,1731387161.736896,-21600,,
com.microsoft.Excel,3,1731387143,1731387146,1731387146.602473,-21600,,
com.leomehlig.today,4,1731387139,1731387143,1731387143.704081,-21600,,
com.microsoft.Excel,3,1731387136,1731387139,1731387139.538415,-21600,,
com.leomehlig.today,7,1731387129,1731387136,1731387136.812922,-21600,,
com.microsoft.Excel,3,1731387126,1731387129,1731387129.0484529,-21600,,
com.leomehlig.today,4,1731387122,1731387126,1731387126.585073,-21600,,
com.microsoft.Excel,3,1731387119,1731387122,1731387123.043662,-21600,,
com.leomehlig.today,7,1731387112,1731387119,1731387119.118442,-21600,,
com.microsoft.Excel,4,1731387108,1731387112,1731387112.872342,-21600,,
com.leomehlig.today,6,1731387102,1731387108,1731387108.5525088,-21600,,
com.microsoft.Excel,6,1731387096,1731387102,1731387102.137357,-21600,,
com.leomehlig.today,6,1731387090,1731387096,1731387096.318505,-21600,,
com.microsoft.Excel,2,1731387088,1731387090,1731387090.83892,-21600,,
com.leomehlig.today,6,1731387082,1731387088,1731387088.7298,-21600,,
com.microsoft.Excel,3,1731387079,1731387082,1731387082.572712,-21600,,
com.leomehlig.today,17,1731387062,1731387079,1731387079.3394551,-21600,,
com.microsoft.Excel,2,1731387060,1731387062,1731387062.381968,-21600,,
com.leomehlig.today,9,1731387051,1731387060,1731387060.619812,-21600,,
com.microsoft.Excel,2,1731387049,1731387051,1731387051.387288,-21600,,
com.leomehlig.today,6,1731387043,1731387049,1731387049.027637,-21600,,
com.microsoft.Excel,6,1731387037,1731387043,1731387043.416103,-21600,,
com.leomehlig.today,10,1731387027,1731387037,1731387037.961499,-21600,,
com.microsoft.Excel,1,1731387026,1731387027,1731387027.6448221,-21600,,
com.leomehlig.today,2,1731387024,1731387026,1731387026.520853,-21600,,
com.microsoft.VSCode,1,1731387023,1731387024,1731387024.476212,-21600,,
com.leomehlig.today,1,1731387022,1731387023,1731387023.893359,-21600,,
com.microsoft.Excel,3,1731387019,1731387022,1731387022.058982,-21600,,
com.leomehlig.today,3,1731387016,1731387019,1731387019.998193,-21600,,
com.microsoft.Excel,3,1731387013,1731387016,1731387016.833633,-21600,,
com.leomehlig.today,15,1731386998,1731387013,1731387013.140228,-21600,,
com.microsoft.Excel,4,1731386994,1731386998,1731386998.335188,-21600,,
com.leomehlig.today,3,1731386991,1731386994,1731386994.757069,-21600,,
com.microsoft.Excel,3,1731386988,1731386991,1731386991.474792,-21600,,
com.leomehlig.today,4,1731386984,1731386988,1731386988.769007,-21600,,
com.microsoft.Excel,7,1731386977,1731386984,1731386984.035517,-21600,,
com.leomehlig.today,4,1731386973,1731386977,1731386977.692214,-21600,,
com.microsoft.Excel,7,1731386966,1731386973,1731386973.870823,-21600,,
com.leomehlig.today,9,1731386957,1731386966,1731386966.078759,-21600,,
com.microsoft.Excel,8,1731386949,1731386957,1731386957.819759,-21600,,
com.leomehlig.today,7,1731386942,1731386949,1731386949.4831119,-21600,,
com.microsoft.Excel,1,1731386941,1731386942,1731386942.095536,-21600,,
com.leomehlig.today,3,1731386938,1731386941,1731386941.539752,-21600,,
com.microsoft.Excel,1,1731386937,1731386938,1731386938.376443,-21600,,
com.leomehlig.today,1,1731386936,1731386937,1731386937.9697409,-21600,,
com.microsoft.VSCode,5,1731386931,1731386936,1731386936.753065,-21600,,
com.apple.finder,1,1731386930,1731386931,1731386931.529258,-21600,,
com.microsoft.Excel,10,1731386920,1731386930,1731386930.233296,-21600,,
com.apple.finder,16,1731386904,1731386920,1731386920.919013,-21600,,
com.microsoft.VSCode,6,1731386898,1731386904,1731386904.232414,-21600,,
com.apple.finder,3,1731386895,1731386898,1731386898.376919,-21600,,
com.google.Chrome,279,1731386616,1731386895,1731386895.882035,-21600,,
com.google.Chrome,349,1731385326,1731385675,1731385675.075574,-21600,,
com.apple.news,98,1731382122,1731382220,1731382221.2415729,-21600,EB445137-D7F5-57EC-87DA-1DB460D64046,"iPhone13,2"
com.apple.news,2,1731382114,1731382116,1731382116.7159328,-21600,EB445137-D7F5-57EC-87DA-1DB460D64046,"iPhone13,2"
com.discoverfinancial.mobile,63,1731382047,1731382110,1731382111.155463,-21600,EB445137-D7F5-57EC-87DA-1DB460D64046,"iPhone13,2"
com.google.Chrome,3183,1731381821,1731385004,1731385004.5994592,-21600,,
com.google.Chrome,768,1731380973,1731381741,1731381741.816989,-21600,,
com.microsoft.VSCode,3,1731380970,1731380973,1731380973.787642,-21600,,
com.google.Chrome,2,1731380968,1731380970,1731380970.1078591,-21600,,
com.leomehlig.today,39,1731380929,1731380968,1731380968.4232202,-21600,,
com.google.Chrome,1,1731380928,1731380929,1731380929.8977442,-21600,,
com.apple.Notes,9,1731380919,1731380928,1731380928.946168,-21600,,
com.google.Chrome,0,1731380919,1731380919,1731380919.980437,-21600,,
com.leomehlig.today,2,1731380917,1731380919,1731380919.094819,-21600,,
com.apple.Notes,7,1731380910,1731380917,1731380917.438953,-21600,,
com.apple.Music,13,1731380330,1731380343,1731380343.272258,-21600,EB445137-D7F5-57EC-87DA-1DB460D64046,"iPhone13,2"
com.apple.Music,38,1731379440,1731379478,1731379478.9252,-21600,EB445137-D7F5-57EC-87DA-1DB460D64046,"iPhone13,2"
com.apple.Maps,6,1731379434,1731379440,1731379440.888088,-21600,EB445137-D7F5-57EC-87DA-1DB460D64046,"iPhone13,2"
com.apple.Maps,471,1731378534,1731379005,1731379006.979629,-21600,EB445137-D7F5-57EC-87DA-1DB460D64046,"iPhone13,2"
com.apple.Music,30,1731378504,1731378534,1731378534.58686,-21600,EB445137-D7F5-57EC-87DA-1DB460D64046,"iPhone13,2"
com.apple.Maps,31,1731378469,1731378500,1731378500.993829,-21600,EB445137-D7F5-57EC-87DA-1DB460D64046,"iPhone13,2"
com.walmart.electronics,3,1731378461,1731378464,1731378465.03363,-21600,EB445137-D7F5-57EC-87DA-1DB460D64046,"iPhone13,2"
com.walmart.electronics,108,1731377366,1731377474,1731377475.190913,-21600,EB445137-D7F5-57EC-87DA-1DB460D64046,"iPhone13,2"
com.apple.mobilenotes,10,1731377356,1731377366,1731377366.771183,-21600,EB445137-D7F5-57EC-87DA-1DB460D64046,"iPhone13,2"
com.walmart.electronics,1,1731377349,1731377350,1731377351.06705,-21600,EB445137-D7F5-57EC-87DA-1DB460D64046,"iPhone13,2"
com.apple.DocumentsApp,4,1731377335,1731377339,1731377339.9256392,-21600,EB445137-D7F5-57EC-87DA-1DB460D64046,"iPhone13,2"
com.apple.DocumentsApp,2,1731377083,1731377085,1731377085.519905,-21600,EB445137-D7F5-57EC-87DA-1DB460D64046,"iPhone13,2"
com.apple.DocumentsApp,9,1731375811,1731375820,1731375821.0178308,-21600,EB445137-D7F5-57EC-87DA-1DB460D64046,"iPhone13,2"
com.apple.news,3,1731375803,1731375806,1731375806.797019,-21600,EB445137-D7F5-57EC-87DA-1DB460D64046,"iPhone13,2"
com.apple.news,6,1731375432,1731375438,1731375438.9499059,-21600,EB445137-D7F5-57EC-87DA-1DB460D64046,"iPhone13,2"
com.apple.news,3,1731375424,1731375427,1731375427.8224,-21600,EB445137-D7F5-57EC-87DA-1DB460D64046,"iPhone13,2"
com.apple.Notes,302,1731375372,1731375674,1731375675.141759,-21600,,
com.google.Chrome,54,1731375318,1731375372,1731375372.703744,-21600,,
com.apple.news,476,1731374900,1731375376,1731375377.0942621,-21600,EB445137-D7F5-57EC-87DA-1DB460D64046,"iPhone13,2"
com.google.Chrome,1072,1731374125,1731375197,1731375197.971792,-21600,,
com.leomehlig.today,18,1731374107,1731374125,1731374126.017144,-21600,,
com.google.Chrome,5,1731374102,1731374107,1731374107.098417,-21600,,
com.apple.camera,0,1731373941,1731373941,1731373941.928987,-21600,EB445137-D7F5-57EC-87DA-1DB460D64046,"iPhone13,2"
com.apple.news,8,1731373940,1731373948,1731373948.2207341,-21600,EB445137-D7F5-57EC-87DA-1DB460D64046,"iPhone13,2"
com.apple.news,4,1731373927,1731373931,1731373931.306979,-21600,EB445137-D7F5-57EC-87DA-1DB460D64046,"iPhone13,2"
com.apple.news,6,1731373908,1731373914,1731373914.600261,-21600,EB445137-D7F5-57EC-87DA-1DB460D64046,"iPhone13,2"
com.apple.camera,0,1731373337,1731373337,1731373337.4149709,-21600,EB445137-D7F5-57EC-87DA-1DB460D64046,"iPhone13,2"
com.apple.news,4,1731373336,1731373340,1731373340.2570438,-21600,EB445137-D7F5-57EC-87DA-1DB460D64046,"iPhone13,2"
com.apple.news,6,1731373215,1731373221,1731373221.756815,-21600,EB445137-D7F5-57EC-87DA-1DB460D64046,"iPhone13,2"
com.apple.news,9,1731373181,1731373190,1731373190.059422,-21600,EB445137-D7F5-57EC-87DA-1DB460D64046,"iPhone13,2"
com.apple.news,6,1731373163,1731373169,1731373169.3117461,-21600,EB445137-D7F5-57EC-87DA-1DB460D64046,"iPhone13,2"
com.apple.news,4,1731373157,1731373161,1731373161.338873,-21600,EB445137-D7F5-57EC-87DA-1DB460D64046,"iPhone13,2"
com.apple.news,4,1731373013,1731373017,1731373017.478739,-21600,EB445137-D7F5-57EC-87DA-1DB460D64046,"iPhone13,2"
com.apple.news,19,1731372860,1731372879,1731372879.4631891,-21600,EB445137-D7F5-57EC-87DA-1DB460D64046,"iPhone13,2"
com.apple.news,1,1731372791,1731372792,1731372792.407764,-21600,EB445137-D7F5-57EC-87DA-1DB460D64046,"iPhone13,2"
com.apple.news,8,1731372779,1731372787,1731372787.2424312,-21600,EB445137-D7F5-57EC-87DA-1DB460D64046,"iPhone13,2"
com.apple.mobiletimer,6,1731370100,1731370106,1731370106.499896,-21600,EB445137-D7F5-57EC-87DA-1DB460D64046,"iPhone13,2"
com.apple.mobiletimer,3,1731368800,1731368803,1731368803.552198,-21600,EB445137-D7F5-57EC-87DA-1DB460D64046,"iPhone13,2"
com.apple.mobiletimer,3,1731367973,1731367976,1731367976.9413362,-21600,EB445137-D7F5-57EC-87DA-1DB460D64046,"iPhone13,2"
com.google.Chrome,958,1731367421,1731368379,1731368379.1144,-21600,,
com.leomehlig.today,28,1731367393,1731367421,1731367421.695041,-21600,,
com.google.Chrome,488,1731366905,1731367393,1731367393.413966,-21600,,
com.apple.mobiletimer,2,1731366895,1731366897,1731366897.484477,-21600,EB445137-D7F5-57EC-87DA-1DB460D64046,"iPhone13,2"
com.apple.mobiletimer,3,1731366854,1731366857,1731366857.522169,-21600,EB445137-D7F5-57EC-87DA-1DB460D64046,"iPhone13,2"
com.apple.mobiletimer,5,1731366740,1731366745,1731366746.968849,-21600,EB445137-D7F5-57EC-87DA-1DB460D64046,"iPhone13,2"
com.google.Chrome,518,1731366317,1731366835,1731366835.7806091,-21600,,
com.leomehlig.today,3,1731366314,1731366317,1731366317.9513478,-21600,,
com.apple.DocumentsApp,9,1731365233,1731365242,1731365242.5257192,-21600,EB445137-D7F5-57EC-87DA-1DB460D64046,"iPhone13,2"
com.apple.DocumentsApp,1,1731365077,1731365078,1731365078.959086,-21600,EB445137-D7F5-57EC-87DA-1DB460D64046,"iPhone13,2"
com.apple.DocumentsApp,0,1731365076,1731365076,1731365077.415689,-21600,EB445137-D7F5-57EC-87DA-1DB460D64046,"iPhone13,2"
com.apple.DocumentsApp,6,1731364776,1731364782,1731364782.810369,-21600,EB445137-D7F5-57EC-87DA-1DB460D64046,"iPhone13,2"
com.apple.DocumentsApp,2,1731364773,1731364775,1731364775.482708,-21600,EB445137-D7F5-57EC-87DA-1DB460D64046,"iPhone13,2"
com.apple.DocumentsApp,1,1731364772,1731364773,1731364774.0694609,-21600,EB445137-D7F5-57EC-87DA-1DB460D64046,"iPhone13,2"
com.apple.DocumentsApp,10,1731364285,1731364295,1731364295.826957,-21600,EB445137-D7F5-57EC-87DA-1DB460D64046,"iPhone13,2"
com.leomehlig.today,53,1731364122,1731364175,1731364175.877981,-21600,,
com.google.Chrome,300,1731363822,1731364122,1731364122.209159,-21600,,
com.apple.DocumentsApp,61,1731363807,1731363868,1731363869.0585861,-21600,EB445137-D7F5-57EC-87DA-1DB460D64046,"iPhone13,2"
com.microsoft.Office.Outlook,13,1731363786,1731363799,1731363799.852195,-21600,EB445137-D7F5-57EC-87DA-1DB460D64046,"iPhone13,2"
com.apple.finder,51,1731363771,1731363822,1731363822.332582,-21600,,
com.microsoft.Office.Outlook,61,1731363613,1731363674,1731363675.186312,-21600,EB445137-D7F5-57EC-87DA-1DB460D64046,"iPhone13,2"
com.toyopagroup.picaboo,26,1731363581,1731363607,1731363608.72313,-21600,EB445137-D7F5-57EC-87DA-1DB460D64046,"iPhone13,2"
com.toyopagroup.picaboo,27,1731363093,1731363120,1731363121.079836,-21600,EB445137-D7F5-57EC-87DA-1DB460D64046,"iPhone13,2"
com.google.Chrome,679,1731363092,1731363771,1731363771.913859,-21600,,
com.leomehlig.today,27,1731363065,1731363092,1731363092.391793,-21600,,
com.google.Chrome,4,1731363061,1731363065,1731363065.838945,-21600,,
com.toyopagroup.picaboo,120,1731362911,1731363031,1731363031.700305,-21600,EB445137-D7F5-57EC-87DA-1DB460D64046,"iPhone13,2"
com.microsoft.VSCode,209,1731362852,1731363061,1731363061.74752,-21600,,
com.google.Chrome,44,1731362808,1731362852,1731362852.983504,-21600,,
com.microsoft.VSCode,659,1731362149,1731362808,1731362808.112516,-21600,,
com.google.Chrome,21,1731362128,1731362149,1731362149.4137359,-21600,,
com.microsoft.VSCode,266,1731361862,1731362128,1731362128.599057,-21600,,
com.google.Chrome,15,1731361847,1731361862,1731361862.612766,-21600,,
com.microsoft.VSCode,33,1731361814,1731361847,1731361847.466887,-21600,,
com.google.Chrome,2,1731361812,1731361814,1731361814.930876,-21600,,
com.microsoft.VSCode,13,1731361799,1731361812,1731361812.834497,-21600,,
com.google.Chrome,1,1731361798,1731361799,1731361799.55371,-21600,,
com.microsoft.VSCode,3,1731361795,1731361798,1731361798.051165,-21600,,
com.google.Chrome,5,1731361790,1731361795,1731361795.124846,-21600,,
com.microsoft.VSCode,35,1731361755,1731361790,1731361790.695303,-21600,,
com.google.Chrome,2,1731361753,1731361755,1731361755.626607,-21600,,
com.microsoft.VSCode,26,1731361727,1731361753,1731361753.119498,-21600,,
com.google.Chrome,2,1731361725,1731361727,1731361727.353424,-21600,,
com.leomehlig.today,1,1731361724,1731361725,1731361725.928083,-21600,,
com.google.Chrome,45,1731361679,1731361724,1731361724.6784859,-21600,,
com.leomehlig.today,7,1731361672,1731361679,1731361679.349988,-21600,,
com.apple.finder,3,1731361669,1731361672,1731361672.8084822,-21600,,
com.microsoft.VSCode,13,1731361656,1731361669,1731361669.876107,-21600,,
com.google.Chrome,7,1731361649,1731361656,1731361656.2610521,-21600,,
com.microsoft.VSCode,16,1731361633,1731361649,1731361649.9097319,-21600,,
com.google.Chrome,10,1731361623,1731361633,1731361633.458541,-21600,,
com.microsoft.VSCode,42,1731361581,1731361623,1731361623.393839,-21600,,
com.google.Chrome,1,1731361580,1731361581,1731361581.564271,-21600,,
com.microsoft.VSCode,4,1731361576,1731361580,1731361580.679016,-21600,,
com.google.Chrome,5,1731361571,1731361576,1731361576.844712,-21600,,
com.microsoft.VSCode,23,1731361548,1731361571,1731361571.990133,-21600,,
com.google.Chrome,4,1731361544,1731361548,1731361548.9730558,-21600,,
com.microsoft.VSCode,45,1731361499,1731361544,1731361544.659193,-21600,,
com.google.Chrome,3,1731361496,1731361499,1731361499.840054,-21600,,
com.microsoft.VSCode,1,1731361495,1731361496,1731361496.591743,-21600,,
com.google.Chrome,9,1731361486,1731361495,1731361496.052144,-21600,,
com.microsoft.VSCode,10,1731361476,1731361486,1731361486.9701571,-21600,,
com.google.Chrome,19,1731361457,1731361476,1731361476.399519,-21600,,
com.microsoft.VSCode,82,1731361375,1731361457,1731361457.9009151,-21600,,
com.google.Chrome,34,1731361341,1731361375,1731361375.89488,-21600,,
com.microsoft.VSCode,6,1731361335,1731361341,1731361341.1815739,-21600,,
com.google.Chrome,2,1731361333,1731361335,1731361335.3625278,-21600,,
com.microsoft.VSCode,7,1731361326,1731361333,1731361333.531338,-21600,,
com.google.Chrome,1,1731361325,1731361326,1731361326.435127,-21600,,
com.microsoft.VSCode,6,1731361319,1731361325,1731361325.330497,-21600,,
com.google.Chrome,18,1731361301,1731361319,1731361319.48216,-21600,,
com.microsoft.VSCode,3,1731361298,1731361301,1731361301.686952,-21600,,
com.google.Chrome,8,1731361290,1731361298,1731361298.627452,-21600,,
com.microsoft.VSCode,32,1731361258,1731361290,1731361290.793292,-21600,,
com.google.Chrome,4,1731361254,1731361258,1731361258.695775,-21600,,
com.microsoft.VSCode,21,1731361233,1731361254,1731361254.107758,-21600,,
com.google.Chrome,17,1731361216,1731361233,1731361233.941935,-21600,,
com.microsoft.VSCode,23,1731361193,1731361216,1731361216.145663,-21600,,
com.google.Chrome,5,1731361188,1731361193,1731361193.830812,-21600,,
com.microsoft.VSCode,27,1731361161,1731361188,1731361188.8393621,-21600,,
com.google.Chrome,6,1731361155,1731361161,1731361161.748327,-21600,,
com.microsoft.VSCode,32,1731361123,1731361155,1731361155.730401,-21600,,
com.google.Chrome,3,1731361120,1731361123,1731361123.45643,-21600,,
com.microsoft.VSCode,6,1731361114,1731361120,1731361120.61398,-21600,,
com.google.Chrome,3,1731361111,1731361114,1731361114.6383939,-21600,,
com.microsoft.VSCode,20,1731361091,1731361111,1731361111.1853309,-21600,,
com.google.Chrome,1,1731361090,1731361091,1731361091.749803,-21600,,
com.microsoft.VSCode,6,1731361084,1731361090,1731361090.163477,-21600,,
com.google.Chrome,111,1731360973,1731361084,1731361084.958307,-21600,,
com.microsoft.VSCode,53,1731360920,1731360973,1731360973.480063,-21600,,
com.google.Chrome,6,1731360914,1731360920,1731360920.789105,-21600,,
com.microsoft.VSCode,145,1731360769,1731360914,1731360914.6634789,-21600,,
com.google.Chrome,5,1731360764,1731360769,1731360769.6099901,-21600,,
com.microsoft.VSCode,389,1731360375,1731360764,1731360764.3163362,-21600,,
com.google.Chrome,27,1731360348,1731360375,1731360376.02969,-21600,,
com.microsoft.VSCode,92,1731360256,1731360348,1731360348.59124,-21600,,
com.apple.finder,5,1731360251,1731360256,1731360256.708391,-21600,,
com.microsoft.VSCode,21,1731360230,1731360251,1731360251.4001698,-21600,,
com.apple.finder,12,1731360218,1731360230,1731360230.605624,-21600,,
com.microsoft.VSCode,389,1731359829,1731360218,1731360218.280774,-21600,,
com.google.Chrome,2,1731359827,1731359829,1731359829.437069,-21600,,
com.microsoft.VSCode,2,1731359825,1731359827,1731359827.307969,-21600,,
com.google.Chrome,3,1731359822,1731359825,1731359825.703727,-21600,,
com.microsoft.VSCode,20,1731359802,1731359822,1731359822.5776439,-21600,,
com.google.Chrome,58,1731359744,1731359802,1731359802.555653,-21600,,
com.microsoft.VSCode,14,1731359714,1731359728,1731359728.690603,-21600,,
com.leomehlig.today,2,1731359712,1731359714,1731359714.7182899,-21600,,
com.microsoft.VSCode,152,1731359560,1731359712,1731359712.5778642,-21600,,
com.leomehlig.today,7,1731359553,1731359560,1731359560.874954,-21600,,
com.google.Chrome,138,1731359415,1731359553,1731359553.5136142,-21600,,
com.apple.finder,2,1731359413,1731359415,1731359415.832004,-21600,,
com.apple.camera,6,1731358951,1731358957,1731358957.9126801,-21600,EB445137-D7F5-57EC-87DA-1DB460D64046,"iPhone13,2"
com.instructure.icanvas,4,1731358950,1731358954,1731358955.203192,-21600,EB445137-D7F5-57EC-87DA-1DB460D64046,"iPhone13,2"
com.instructure.icanvas,6,1731358930,1731358936,1731358936.9785972,-21600,EB445137-D7F5-57EC-87DA-1DB460D64046,"iPhone13,2"
com.google.Chrome,490,1731358923,1731359413,1731359413.416153,-21600,,
com.leomehlig.today,27,1731358896,1731358923,1731358923.695413,-21600,,
com.google.Chrome,1027,1731357869,1731358896,1731358896.9993858,-21600,,
com.apple.iCal,10,1731357859,1731357869,1731357869.423514,-21600,,
com.instructure.icanvas,9,1731357856,1731357865,1731357865.320243,-21600,EB445137-D7F5-57EC-87DA-1DB460D64046,"iPhone13,2"
com.google.Chrome,404,1731357455,1731357859,1731357859.923126,-21600,,
com.leomehlig.today,18,1731357437,1731357455,1731357455.506528,-21600,,
com.apple.iCal,22,1731357415,1731357437,1731357437.74476,-21600,,
com.leomehlig.today,2,1731357413,1731357415,1731357415.106408,-21600,,
com.instructure.icanvas,73,1731357391,1731357464,1731357465.312465,-21600,EB445137-D7F5-57EC-87DA-1DB460D64046,"iPhone13,2"
com.google.Gmail,4,1731357387,1731357391,1731357392.23786,-21600,EB445137-D7F5-57EC-87DA-1DB460D64046,"iPhone13,2"
com.google.Chrome,1981,1731355432,1731357413,1731357413.3576078,-21600,,
com.leomehlig.today,4,1731355383,1731355387,1731355389.024194,-21600,,
com.google.Chrome,6,1731355377,1731355383,1731355383.7942882,-21600,,
com.microsoft.VSCode,5,1731355372,1731355377,1731355377.434459,-21600,,
com.google.Gmail,37,1731355324,1731355361,1731355362.277389,-21600,EB445137-D7F5-57EC-87DA-1DB460D64046,"iPhone13,2"
com.apple.news,10,1731355314,1731355324,1731355325.483543,-21600,EB445137-D7F5-57EC-87DA-1DB460D64046,"iPhone13,2"
com.apple.news,2,1731354386,1731354388,1731354388.01798,-21600,EB445137-D7F5-57EC-87DA-1DB460D64046,"iPhone13,2"
com.apple.news,2,1731354377,1731354379,1731354379.282944,-21600,EB445137-D7F5-57EC-87DA-1DB460D64046,"iPhone13,2"
com.apple.news,158,1731354182,1731354340,1731354341.044337,-21600,EB445137-D7F5-57EC-87DA-1DB460D64046,"iPhone13,2"
com.apple.news,6,1731354077,1731354083,1731354083.369178,-21600,EB445137-D7F5-57EC-87DA-1DB460D64046,"iPhone13,2"
com.apple.news,324,1731353710,1731354034,1731354035.090565,-21600,EB445137-D7F5-57EC-87DA-1DB460D64046,"iPhone13,2"
com.google.chrome.ios,39,1731353671,1731353710,1731353710.5951838,-21600,EB445137-D7F5-57EC-87DA-1DB460D64046,"iPhone13,2"
com.apple.news,12,1731353534,1731353546,1731353548.10703,-21600,EB445137-D7F5-57EC-87DA-1DB460D64046,"iPhone13,2"
com.apple.MobileSMS,3,1731353531,1731353534,1731353534.17552,-21600,EB445137-D7F5-57EC-87DA-1DB460D64046,"iPhone13,2"
com.apple.news,7,1731353524,1731353531,1731353532.3156052,-21600,EB445137-D7F5-57EC-87DA-1DB460D64046,"iPhone13,2"
com.apple.news,88,1731353179,1731353267,1731353267.91904,-21600,EB445137-D7F5-57EC-87DA-1DB460D64046,"iPhone13,2"
com.apple.news,326,1731352704,1731353030,1731353030.761769,-21600,EB445137-D7F5-57EC-87DA-1DB460D64046,"iPhone13,2"
com.toyopagroup.picaboo,18,1731352248,1731352266,1731352266.758055,-21600,EB445137-D7F5-57EC-87DA-1DB460D64046,"iPhone13,2"
com.hammerandchisel.discord,7,1731352234,1731352241,1731352241.733008,-21600,EB445137-D7F5-57EC-87DA-1DB460D64046,"iPhone13,2"
com.apple.MobileSMS,8,1731352226,1731352234,1731352234.239363,-21600,EB445137-D7F5-57EC-87DA-1DB460D64046,"iPhone13,2"
com.microsoft.VSCode,444,1731352010,1731352454,1731352454.14188,-21600,,
com.apple.iCal,166,1731351844,1731352010,1731352010.846148,-21600,,
com.hnc.Discord,50,1731351794,1731351844,1731351844.593539,-21600,,
com.apple.iCal,22,1731351772,1731351794,1731351794.318985,-21600,,
com.google.Chrome,29,1731351743,1731351772,1731351772.429095,-21600,,
com.apple.iCal,49,1731351694,1731351743,1731351745.2483702,-21600,,
com.google.Chrome,249,1731351445,1731351694,1731351694.105657,-21600,,
com.leomehlig.today,18,1731351284,1731351302,1731351302.246717,-21600,,
com.apple.iCal,55,1731351229,1731351284,1731351284.346791,-21600,,
com.apple.MobileSMS,12,1731351202,1731351214,1731351214.960178,-21600,EB445137-D7F5-57EC-87DA-1DB460D64046,"iPhone13,2"
com.google.Chrome,221,1731351008,1731351229,1731351229.9392118,-21600,,
com.apple.finder,2,1731351001,1731351003,1731351004.5906591,-21600,,
com.apple.MobileSMS,57,1731350933,1731350990,1731350990.2258902,-21600,EB445137-D7F5-57EC-87DA-1DB460D64046,"iPhone13,2"
com.microsoft.Office.Outlook,5,1731350928,1731350933,1731350934.4196072,-21600,EB445137-D7F5-57EC-87DA-1DB460D64046,"iPhone13,2"
com.microsoft.Office.Outlook,2,1731350779,1731350781,1731350781.633007,-21600,EB445137-D7F5-57EC-87DA-1DB460D64046,"iPhone13,2"
com.microsoft.Office.Outlook,1,1731350778,1731350779,1731350779.0606852,-21600,EB445137-D7F5-57EC-87DA-1DB460D64046,"iPhone13,2"
com.microsoft.Office.Outlook,5,1731350511,1731350516,1731350517.0813231,-21600,EB445137-D7F5-57EC-87DA-1DB460D64046,"iPhone13,2"
com.microsoft.Office.Outlook,60,1731350448,1731350508,1731350508.498155,-21600,EB445137-D7F5-57EC-87DA-1DB460D64046,"iPhone13,2"
com.apple.finder,304,1731348600,1731348904,1731348904.04872,-21600,,
com.google.Chrome,3,1731348597,1731348600,1731348600.757796,-21600,,
com.leomehlig.today,60,1731348537,1731348597,1731348597.466031,-21600,,
com.google.Chrome,4,1731348533,1731348537,1731348537.899582,-21600,,
com.apple.Notes,1,1731348532,1731348533,1731348534.013455,-21600,,
com.google.Chrome,0,1731348532,1731348532,1731348532.6582298,-21600,,
us.zoom.xos,4,1731348528,1731348532,1731348532.431817,-21600,,
com.microsoft.Outlook,68,1731348460,1731348528,1731348528.9555922,-21600,,
us.zoom.xos,16,1731348444,1731348460,1731348460.7242289,-21600,,
com.microsoft.Outlook,13,1731348431,1731348444,1731348444.258791,-21600,,
us.zoom.xos,38,1731348393,1731348431,1731348431.583643,-21600,,
com.microsoft.Outlook,51,1731348342,1731348393,1731348393.688982,-21600,,
com.google.Chrome,5,1731348337,1731348342,1731348342.0973,-21600,,
com.microsoft.Outlook,2,1731348335,1731348337,1731348337.642194,-21600,,
com.google.Chrome,3,1731348332,1731348335,1731348335.218113,-21600,,
com.microsoft.Outlook,7,1731348325,1731348332,1731348332.203796,-21600,,
com.google.Chrome,12,1731348313,1731348325,1731348325.8037481,-21600,,
com.microsoft.Outlook,1,1731348312,1731348313,1731348313.9475322,-21600,,
com.google.Chrome,31,1731348281,1731348312,1731348312.268893,-21600,,
com.leomehlig.today,16,1731348265,1731348281,1731348281.244516,-21600,,
com.google.Chrome,248,1731348017,1731348265,1731348265.448137,-21600,,
com.leomehlig.today,2,1731347988,1731347990,1731347990.077079,-21600,,
com.google.Chrome,463,1731347525,1731347988,1731347988.187056,-21600,,
com.leomehlig.today,5,1731347520,1731347525,1731347525.42003,-21600,,
com.google.Chrome,8,1731347512,1731347520,1731347520.2869,-21600,,
com.leomehlig.today,61,1731347386,1731347447,1731347447.441663,-21600,,
com.apple.finder,11,1731347375,1731347386,1731347386.924182,-21600,,
com.leomehlig.today,2,1731347373,1731347375,1731347375.3609362,-21600,,
com.apple.finder,3,1731347370,1731347373,1731347373.11567,-21600,,
com.apple.Photos,39,1731347331,1731347370,1731347370.114536,-21600,,
com.google.Chrome,69,1731347262,1731347331,1731347331.810179,-21600,,
com.apple.mobilephone,8,1731346503,1731346511,1731346512.430214,-21600,EB445137-D7F5-57EC-87DA-1DB460D64046,"iPhone13,2"
com.apple.Health,6,1731346493,1731346499,1731346499.576631,-21600,EB445137-D7F5-57EC-87DA-1DB460D64046,"iPhone13,2"
com.google.Docs,35,1731346458,1731346493,1731346493.6709142,-21600,EB445137-D7F5-57EC-87DA-1DB460D64046,"iPhone13,2"
com.google.Drive,14,1731346444,1731346458,1731346458.5290918,-21600,EB445137-D7F5-57EC-87DA-1DB460D64046,"iPhone13,2"
com.apple.MobileSMS,9,1731346433,1731346442,1731346442.969307,-21600,EB445137-D7F5-57EC-87DA-1DB460D64046,"iPhone13,2"
com.apple.MobileSMS,48,1731343928,1731343976,1731343976.442236,-21600,EB445137-D7F5-57EC-87DA-1DB460D64046,"iPhone13,2"
com.apple.Health,10,1731343918,1731343928,1731343929.395452,-21600,EB445137-D7F5-57EC-87DA-1DB460D64046,"iPhone13,2"
com.apple.Health,10,1731340636,1731340646,1731340647.106606,-21600,EB445137-D7F5-57EC-87DA-1DB460D64046,"iPhone13,2"
com.apple.weather,4,1731340631,1731340635,1731340635.3417401,-21600,EB445137-D7F5-57EC-87DA-1DB460D64046,"iPhone13,2"
com.google.Chrome,2,1731339998,1731340000,1731340000.56921,-21600,,
com.apple.news,473,1731339525,1731339998,1731339998.2819529,-21600,,
com.google.Chrome,7,1731339518,1731339525,1731339525.526869,-21600,,
com.apple.weather,2,1731339411,1731339413,1731339413.3383698,-21600,EB445137-D7F5-57EC-87DA-1DB460D64046,"iPhone13,2"
com.apple.weather,6,1731339015,1731339021,1731339021.163974,-21600,EB445137-D7F5-57EC-87DA-1DB460D64046,"iPhone13,2"
com.renpho.health,2,1731339013,1731339015,1731339015.596453,-21600,EB445137-D7F5-57EC-87DA-1DB460D64046,"iPhone13,2"
com.renpho.health,35,1731338954,1731338989,1731338989.108602,-21600,EB445137-D7F5-57EC-87DA-1DB460D64046,"iPhone13,2"
com.apple.camera,0,1731337982,1731337982,1731337982.9908671,-21600,EB445137-D7F5-57EC-87DA-1DB460D64046,"iPhone13,2"
com.apple.news,91,1731337817,1731337908,1731337908.695492,-21600,EB445137-D7F5-57EC-87DA-1DB460D64046,"iPhone13,2"
com.apple.news,324,1731337491,1731337815,1731337815.980941,-21600,EB445137-D7F5-57EC-87DA-1DB460D64046,"iPhone13,2"
com.thestorygraph.thestorygraph,21,1731337448,1731337469,1731337470.00403,-21600,EB445137-D7F5-57EC-87DA-1DB460D64046,"iPhone13,2"
com.thestorygraph.thestorygraph,25,1731337409,1731337434,1731337434.109301,-21600,EB445137-D7F5-57EC-87DA-1DB460D64046,"iPhone13,2"
com.thestorygraph.thestorygraph,24,1731336854,1731336878,1731336878.949812,-21600,EB445137-D7F5-57EC-87DA-1DB460D64046,"iPhone13,2"
com.thestorygraph.thestorygraph,23,1731336301,1731336324,1731336324.874003,-21600,EB445137-D7F5-57EC-87DA-1DB460D64046,"iPhone13,2"
com.thestorygraph.thestorygraph,13,1731304747,1731304760,1731304760.805814,-21600,EB445137-D7F5-57EC-87DA-1DB460D64046,"iPhone13,2"
com.thestorygraph.thestorygraph,3,1731304741,1731304744,1731304744.787133,-21600,EB445137-D7F5-57EC-87DA-1DB460D64046,"iPhone13,2"
com.thestorygraph.thestorygraph,10,1731304559,1731304569,1731304569.594214,-21600,EB445137-D7F5-57EC-87DA-1DB460D64046,"iPhone13,2"
com.thestorygraph.thestorygraph,13,1731304545,1731304558,1731304559.061777,-21600,EB445137-D7F5-57EC-87DA-1DB460D64046,"iPhone13,2"
com.apple.mobiletimer,5,1731304540,1731304545,1731304545.848845,-21600,EB445137-D7F5-57EC-87DA-1DB460D64046,"iPhone13,2"
com.apple.mobiletimer,13,1731301899,1731301912,1731301912.168548,-21600,EB445137-D7F5-57EC-87DA-1DB460D64046,"iPhone13,2"
com.apple.mobiletimer,12,1731301884,1731301896,1731301896.575876,-21600,EB445137-D7F5-57EC-87DA-1DB460D64046,"iPhone13,2"
com.apple.mobiletimer,1,1731301879,1731301880,1731301880.265489,-21600,EB445137-D7F5-57EC-87DA-1DB460D64046,"iPhone13,2"
com.toyopagroup.picaboo,45,1731301831,1731301876,1731301876.259982,-21600,EB445137-D7F5-57EC-87DA-1DB460D64046,"iPhone13,2"
com.google.Chrome,100,1731301805,1731301905,1731301905.212374,-21600,,
com.microsoft.VSCode,23,1731301782,1731301805,1731301805.5553498,-21600,,
com.google.Chrome,1,1731301781,1731301782,1731301782.242459,-21600,,
com.microsoft.VSCode,165,1731301616,1731301781,1731301781.4748359,-21600,,
com.google.Chrome,32,1731301584,1731301616,1731301616.7133389,-21600,,
com.microsoft.VSCode,108,1731301476,1731301584,1731301584.6860042,-21600,,
com.google.Chrome,29,1731301447,1731301476,1731301476.832789,-21600,,
com.thestorygraph.thestorygraph,65,1731301345,1731301410,1731301410.937807,-21600,EB445137-D7F5-57EC-87DA-1DB460D64046,"iPhone13,2"
com.toyopagroup.picaboo,64,1731301264,1731301328,1731301328.8613648,-21600,EB445137-D7F5-57EC-87DA-1DB460D64046,"iPhone13,2"
com.apple.news,10,1731301254,1731301264,1731301264.786447,-21600,EB445137-D7F5-57EC-87DA-1DB460D64046,"iPhone13,2"
com.apple.news,2,1731301119,1731301121,1731301121.669396,-21600,EB445137-D7F5-57EC-87DA-1DB460D64046,"iPhone13,2"
com.apple.news,2,1731300414,1731300416,1731300417.07159,-21600,EB445137-D7F5-57EC-87DA-1DB460D64046,"iPhone13,2"
com.apple.news,12,1731299401,1731299413,1731299413.918145,-21600,EB445137-D7F5-57EC-87DA-1DB460D64046,"iPhone13,2"
com.apple.news,9,1731298797,1731298806,1731298806.992451,-21600,EB445137-D7F5-57EC-87DA-1DB460D64046,"iPhone13,2"
com.apple.news,123,1731297989,1731298112,1731298112.873225,-21600,EB445137-D7F5-57EC-87DA-1DB460D64046,"iPhone13,2"
com.apple.Health,135,1731297846,1731297981,1731297982.246863,-21600,EB445137-D7F5-57EC-87DA-1DB460D64046,"iPhone13,2"
com.toyopagroup.picaboo,59,1731297785,1731297844,1731297844.234055,-21600,EB445137-D7F5-57EC-87DA-1DB460D64046,"iPhone13,2"
com.hammerandchisel.discord,7,1731297778,1731297785,1731297786.6390638,-21600,EB445137-D7F5-57EC-87DA-1DB460D64046,"iPhone13,2"
com.google.Chrome,167,1731297505,1731297672,1731297672.423681,-21600,,
com.apple.Notes,4,1731296586,1731296590,1731296590.8874068,-21600,,
com.google.Chrome,204,1731296357,1731296561,1731296561.171111,-21600,,
com.apple.Notes,48,1731296309,1731296357,1731296357.222303,-21600,,
com.google.Chrome,1104,1731295205,1731296309,1731296309.6194692,-21600,,
com.google.Chrome,5,1731294763,1731294768,1731294768.608625,-21600,,
com.apple.MobileSMS,4,1731294759,1731294763,1731294763.197945,-21600,,
com.google.Chrome,3,1731294756,1731294759,1731294759.468766,-21600,,
com.leomehlig.today,109,1731294647,1731294756,1731294756.737272,-21600,,
com.hammerandchisel.discord,15,1731294047,1731294062,1731294062.605411,-21600,EB445137-D7F5-57EC-87DA-1DB460D64046,"iPhone13,2"
com.google.Chrome,762,1731293885,1731294647,1731294647.461407,-21600,,
com.leomehlig.today,19,1731293866,1731293885,1731293885.480541,-21600,,
com.hammerandchisel.discord,13,1731293598,1731293611,1731293611.860527,-21600,EB445137-D7F5-57EC-87DA-1DB460D64046,"iPhone13,2"
Astrospheric.Astrospheric,10,1731293588,1731293598,1731293598.715118,-21600,EB445137-D7F5-57EC-87DA-1DB460D64046,"iPhone13,2"
com.toyopagroup.picaboo,11,1731293567,1731293578,1731293580.03238,-21600,EB445137-D7F5-57EC-87DA-1DB460D64046,"iPhone13,2"
com.toyopagroup.picaboo,85,1731289747,1731289832,1731289833.308495,-21600,EB445137-D7F5-57EC-87DA-1DB460D64046,"iPhone13,2"
com.toyopagroup.picaboo,38,1731289456,1731289494,1731289495.3848839,-21600,EB445137-D7F5-57EC-87DA-1DB460D64046,"iPhone13,2"
com.google.Chrome,4420,1731289446,1731293866,1731293866.027417,-21600,,
com.leomehlig.today,16,1731289430,1731289446,1731289447.0208359,-21600,,
com.leomehlig.today,328,1731288550,1731288878,1731288878.324201,-21600,,
com.google.Chrome,496,1731288054,1731288550,1731288550.7258449,-21600,,
com.apple.MobileSMS,5,1731288049,1731288054,1731288054.206357,-21600,,
com.google.Chrome,30,1731288019,1731288049,1731288049.8299851,-21600,,
com.apple.MobileSMS,133,1731287886,1731288019,1731288019.411768,-21600,,
com.apple.FaceTime,3,1731287883,1731287886,1731287886.740542,-21600,,
com.apple.MobileSMS,5,1731287878,1731287883,1731287883.5306048,-21600,,
com.apple.FaceTime,4,1731287874,1731287878,1731287878.463396,-21600,,
com.apple.MobileSMS,6,1731287868,1731287874,1731287875.011323,-21600,,
com.microsoft.VSCode,2,1731287866,1731287868,1731287868.877976,-21600,,
com.apple.MobileSMS,17,1731286690,1731286707,1731286708.3656158,-21600,EB445137-D7F5-57EC-87DA-1DB460D64046,"iPhone13,2"
com.apple.mobiletimer,3,1731286686,1731286689,1731286690.092736,-21600,EB445137-D7F5-57EC-87DA-1DB460D64046,"iPhone13,2"
com.microsoft.VSCode,248,1731286078,1731286326,1731286326.775254,-21600,,
com.apple.MobileSMS,1,1731286077,1731286078,1731286078.854346,-21600,,
com.apple.mobiletimer,2,1731285639,1731285641,1731285641.424272,-21600,EB445137-D7F5-57EC-87DA-1DB460D64046,"iPhone13,2"
com.apple.mobiletimer,4,1731285634,1731285638,1731285638.918289,-21600,EB445137-D7F5-57EC-87DA-1DB460D64046,"iPhone13,2"
com.apple.mobiletimer,15,1731285524,1731285539,1731285539.713286,-21600,EB445137-D7F5-57EC-87DA-1DB460D64046,"iPhone13,2"
com.microsoft.VSCode,982,1731285095,1731286077,1731286077.214627,-21600,,
com.apple.MobileSMS,1,1731285094,1731285095,1731285095.93734,-21600,,
com.microsoft.VSCode,160,1731284934,1731285094,1731285094.690928,-21600,,
com.apple.MobileSMS,9,1731284925,1731284934,1731284934.640964,-21600,,
com.apple.mobiletimer,2,1731284913,1731284915,1731284915.9118319,-21600,EB445137-D7F5-57EC-87DA-1DB460D64046,"iPhone13,2"
com.microsoft.VSCode,39,1731284886,1731284925,1731284925.64063,-21600,,
com.apple.MobileSMS,9,1731284877,1731284886,1731284886.269768,-21600,,
com.microsoft.VSCode,123,1731284754,1731284877,1731284877.068722,-21600,,
com.leomehlig.today,18,1731284736,1731284754,1731284754.272594,-21600,,
com.apple.mobiletimer,11,1731284643,1731284654,1731284654.237228,-21600,EB445137-D7F5-57EC-87DA-1DB460D64046,"iPhone13,2"
com.apple.mobiletimer,17,1731284418,1731284435,1731284435.910503,-21600,EB445137-D7F5-57EC-87DA-1DB460D64046,"iPhone13,2"
com.myfitnesspal.mfp,8,1731283970,1731283978,1731283978.1569772,-21600,EB445137-D7F5-57EC-87DA-1DB460D64046,"iPhone13,2"
com.myfitnesspal.mfp,6,1731283963,1731283969,1731283969.7674809,-21600,EB445137-D7F5-57EC-87DA-1DB460D64046,"iPhone13,2"
com.myfitnesspal.mfp,153,1731283656,1731283809,1731283809.6341372,-21600,EB445137-D7F5-57EC-87DA-1DB460D64046,"iPhone13,2"
com.myfitnesspal.mfp,65,1731283588,1731283653,1731283653.4931269,-21600,EB445137-D7F5-57EC-87DA-1DB460D64046,"iPhone13,2"
com.myfitnesspal.mfp,216,1731283363,1731283579,1731283579.928883,-21600,EB445137-D7F5-57EC-87DA-1DB460D64046,"iPhone13,2"
com.toyopagroup.picaboo,37,1731281754,1731281791,1731281791.7091532,-21600,EB445137-D7F5-57EC-87DA-1DB460D64046,"iPhone13,2"
com.discoverfinancial.mobile,6,1731281748,1731281754,1731281755.302411,-21600,EB445137-D7F5-57EC-87DA-1DB460D64046,"iPhone13,2"
com.leomehlig.today,67,1731281475,1731281542,1731281542.449359,-21600,,
com.microsoft.VSCode,71,1731281404,1731281475,1731281475.22773,-21600,,
com.google.Chrome,3,1731281401,1731281404,1731281405.057722,-21600,,
com.microsoft.VSCode,37,1731281364,1731281401,1731281401.321645,-21600,,
com.google.Chrome,4,1731281360,1731281364,1731281364.301714,-21600,,
com.microsoft.VSCode,11,1731281349,1731281360,1731281360.642523,-21600,,
com.google.Chrome,3,1731281346,1731281349,1731281349.61343,-21600,,
com.microsoft.VSCode,7,1731281339,1731281346,1731281346.886056,-21600,,
com.google.Chrome,1,1731281338,1731281339,1731281340.0180879,-21600,,
com.microsoft.VSCode,1,1731281337,1731281338,1731281338.833221,-21600,,
com.google.Chrome,3,1731281334,1731281337,1731281337.63406,-21600,,
com.microsoft.VSCode,4,1731281330,1731281334,1731281334.577239,-21600,,
com.google.Chrome,1,1731281329,1731281330,1731281330.476023,-21600,,
com.microsoft.VSCode,6,1731281323,1731281329,1731281329.476667,-21600,,
com.google.Chrome,3,1731281320,1731281323,1731281323.648166,-21600,,
com.microsoft.VSCode,6,1731281314,1731281320,1731281320.750988,-21600,,
com.google.Chrome,1,1731281313,1731281314,1731281314.9995599,-21600,,
com.microsoft.VSCode,2,1731281311,1731281313,1731281313.262559,-21600,,
com.google.Chrome,3,1731281308,1731281311,1731281311.3577151,-21600,,
com.microsoft.VSCode,3,1731281305,1731281308,1731281308.814517,-21600,,
com.google.Chrome,52,1731281253,1731281305,1731281305.457452,-21600,,
com.microsoft.VSCode,389,1731280864,1731281253,1731281253.356807,-21600,,
com.apple.MobileSMS,11,1731280853,1731280864,1731280864.169389,-21600,,
com.microsoft.VSCode,102,1731280751,1731280853,1731280853.672476,-21600,,
com.google.Chrome,3,1731280748,1731280751,1731280751.289102,-21600,,
com.microsoft.VSCode,148,1731280600,1731280748,1731280748.292614,-21600,,
com.apple.finder,9,1731280591,1731280600,1731280600.8797998,-21600,,
com.microsoft.VSCode,51,1731280540,1731280591,1731280591.679924,-21600,,
com.apple.MobileSMS,39,1731280501,1731280540,1731280540.6311522,-21600,,
com.microsoft.VSCode,6,1731280495,1731280501,1731280501.364863,-21600,,
com.leomehlig.today,20,1731280475,1731280495,1731280495.600435,-21600,,
com.microsoft.VSCode,37,1731280438,1731280475,1731280475.8951988,-21600,,
com.google.Chrome,1,1731280437,1731280438,1731280438.904941,-21600,,
com.apple.finder,3,1731280434,1731280437,1731280437.120106,-21600,,
com.microsoft.VSCode,4,1731280430,1731280434,1731280434.278753,-21600,,
com.apple.finder,2,1731280428,1731280430,1731280430.798224,-21600,,
com.apple.Preview,11,1731280417,1731280428,1731280428.681964,-21600,,
com.apple.finder,11,1731280406,1731280417,1731280418.1035209,-21600,,
com.microsoft.VSCode,2,1731280404,1731280406,1731280406.295038,-21600,,
com.apple.finder,6,1731280398,1731280404,1731280404.873369,-21600,,
com.google.Chrome,12,1731280386,1731280398,1731280398.7860498,-21600,,
com.microsoft.VSCode,222,1731280164,1731280386,1731280386.647465,-21600,,
com.google.Chrome,24,1731280140,1731280164,1731280164.181581,-21600,,
com.microsoft.VSCode,21,1731280119,1731280140,1731280140.5562649,-21600,,
com.google.Chrome,10,1731280109,1731280119,1731280119.775457,-21600,,
com.microsoft.VSCode,16,1731280093,1731280109,1731280109.632522,-21600,,
com.google.Chrome,5,1731280088,1731280093,1731280093.9109411,-21600,,
com.microsoft.VSCode,93,1731279995,1731280088,1731280088.149755,-21600,,
com.google.Chrome,7,1731279988,1731279995,1731279995.346318,-21600,,
com.microsoft.VSCode,2,1731279986,1731279988,1731279988.481834,-21600,,
com.google.Chrome,17,1731279969,1731279986,1731279986.336729,-21600,,
com.microsoft.VSCode,1291,1731278678,1731279969,1731279969.9009352,-21600,,
com.google.Chrome,9,1731278669,1731278678,1731278678.496836,-21600,,
com.microsoft.VSCode,13,1731278656,1731278669,1731278669.710649,-21600,,
com.google.Chrome,24,1731278632,1731278656,1731278656.995156,-21600,,
com.microsoft.VSCode,2,1731278630,1731278632,1731278632.5397558,-21600,,
com.google.Chrome,10,1731278620,1731278630,1731278630.684263,-21600,,
com.microsoft.VSCode,6,1731278614,1731278620,1731278620.476929,-21600,,
com.google.Chrome,2,1731278612,1731278614,1731278614.373837,-21600,,
com.microsoft.VSCode,6,1731278606,1731278612,1731278612.184128,-21600,,
com.google.Chrome,4,1731278602,1731278606,1731278606.732782,-21600,,
com.microsoft.VSCode,696,1731277906,1731278602,1731278602.329167,-21600,,
com.google.Chrome,12,1731277894,1731277906,1731277906.539428,-21600,,
com.microsoft.VSCode,1,1731277893,1731277894,1731277894.6581268,-21600,,
com.apple.finder,1,1731277892,1731277893,1731277893.922346,-21600,,
com.microsoft.VSCode,15,1731277877,1731277892,1731277892.9629369,-21600,,
com.apple.finder,1,1731277876,1731277877,1731277877.84392,-21600,,
com.google.Chrome,20,1731277856,1731277876,1731277876.911878,-21600,,
com.apple.finder,1,1731277855,1731277856,1731277856.562927,-21600,,
com.microsoft.VSCode,16,1731277839,1731277855,1731277855.2974591,-21600,,
com.apple.finder,10,1731277829,1731277839,1731277839.131266,-21600,,
com.microsoft.VSCode,23,1731277806,1731277829,1731277829.707293,-21600,,
com.google.Chrome,4,1731277802,1731277806,1731277806.433391,-21600,,
com.microsoft.VSCode,23,1731277779,1731277802,1731277802.9628491,-21600,,
com.google.Chrome,1,1731277778,1731277779,1731277779.1194549,-21600,,
com.microsoft.VSCode,4,1731277774,1731277778,1731277778.080391,-21600,,
com.google.Chrome,0,1731277774,1731277774,1731277774.938789,-21600,,
com.microsoft.VSCode,3,1731277771,1731277774,1731277774.1264849,-21600,,
com.google.Chrome,1,1731277770,1731277771,1731277771.5702748,-21600,,
com.microsoft.VSCode,1,1731277769,1731277770,1731277770.8040361,-21600,,
com.google.Chrome,0,1731277769,1731277769,1731277769.838031,-21600,,
com.microsoft.VSCode,4,1731277765,1731277769,1731277769.075249,-21600,,
com.google.Chrome,1,1731277764,1731277765,1731277765.863281,-21600,,
com.microsoft.VSCode,8,1731277756,1731277764,1731277764.7602,-21600,,
com.google.Chrome,1,1731277755,1731277756,1731277756.696491,-21600,,
com.microsoft.VSCode,9,1731277746,1731277755,1731277755.592081,-21600,,
com.google.Chrome,2,1731277744,1731277746,1731277746.215753,-21600,,
com.microsoft.VSCode,2,1731277742,1731277744,1731277744.945541,-21600,,
com.google.Chrome,1,1731277741,1731277742,1731277742.3784251,-21600,,
com.microsoft.VSCode,1,1731277740,1731277741,1731277741.830235,-21600,,
com.google.Chrome,1,1731277739,1731277740,1731277740.488451,-21600,,
com.microsoft.VSCode,4,1731277735,1731277739,1731277739.4930348,-21600,,
com.google.Chrome,1,1731277734,1731277735,1731277735.641951,-21600,,
com.microsoft.VSCode,2,1731277732,1731277734,1731277734.458426,-21600,,
com.google.Chrome,1,1731277731,1731277732,1731277732.810703,-21600,,
com.microsoft.VSCode,1,1731277730,1731277731,1731277732.012589,-21600,,
com.google.Chrome,1,1731277729,1731277730,1731277730.716137,-21600,,
com.microsoft.VSCode,4,1731277725,1731277729,1731277729.942877,-21600,,
com.google.Chrome,39,1731277686,1731277725,1731277725.3825312,-21600,,
com.microsoft.VSCode,41,1731277645,1731277686,1731277686.907895,-21600,,
com.google.Chrome,2,1731277643,1731277645,1731277645.630224,-21600,,
com.microsoft.VSCode,7,1731277636,1731277643,1731277643.992769,-21600,,
com.google.Chrome,1,1731277635,1731277636,1731277636.809276,-21600,,
com.microsoft.VSCode,6,1731277629,1731277635,1731277635.74643,-21600,,
com.google.Chrome,12,1731277617,1731277629,1731277629.5913038,-21600,,
com.microsoft.VSCode,31,1731277586,1731277617,1731277617.527958,-21600,,
com.google.Chrome,5,1731277581,1731277586,1731277586.8536859,-21600,,
com.microsoft.VSCode,24,1731277557,1731277581,1731277581.881969,-21600,,
com.google.Chrome,1,1731277556,1731277557,1731277557.451633,-21600,,
com.microsoft.VSCode,25,1731277531,1731277556,1731277556.4652638,-21600,,
com.google.Chrome,1,1731277530,1731277531,1731277531.8673592,-21600,,
com.microsoft.VSCode,6,1731277524,1731277530,1731277530.861172,-21600,,
com.google.Chrome,0,1731277524,1731277524,1731277524.8938951,-21600,,
com.microsoft.VSCode,6,1731277518,1731277524,1731277524.241276,-21600,,
com.google.Chrome,1,1731277517,1731277518,1731277518.248557,-21600,,
com.microsoft.VSCode,4,1731277513,1731277517,1731277517.0940719,-21600,,
com.google.Chrome,1,1731277512,1731277513,1731277513.740165,-21600,,
com.microsoft.VSCode,3,1731277509,1731277512,1731277512.808364,-21600,,
com.google.Chrome,0,1731277509,1731277509,1731277509.947315,-21600,,
com.microsoft.VSCode,7,1731277502,1731277509,1731277509.088093,-21600,,
com.google.Chrome,1,1731277501,1731277502,1731277502.676373,-21600,,
com.microsoft.VSCode,6,1731277495,1731277501,1731277501.4267368,-21600,,
com.google.Chrome,27,1731277468,1731277495,1731277495.588951,-21600,,
com.microsoft.VSCode,6,1731277462,1731277468,1731277468.6794271,-21600,,
com.google.Chrome,31,1731277431,1731277462,1731277462.2393088,-21600,,
com.microsoft.VSCode,374,1731277057,1731277431,1731277432.021325,-21600,,
com.google.Chrome,4,1731277053,1731277057,1731277057.3894901,-21600,,
com.apple.finder,13,1731277040,1731277053,1731277053.833973,-21600,,
com.apple.archiveutility,1,1731277039,1731277040,1731277040.285018,-21600,,
com.apple.finder,19,1731277020,1731277039,1731277039.83758,-21600,,
com.google.Chrome,34,1731276986,1731277020,1731277020.899352,-21600,,
com.microsoft.VSCode,7,1731276979,1731276986,1731276986.478245,-21600,,
com.google.Chrome,3,1731276976,1731276979,1731276979.3835402,-21600,,
com.leomehlig.today,41,1731276935,1731276976,1731276976.681984,-21600,,
com.google.Chrome,444,1731276491,1731276935,1731276935.40622,-21600,,
com.apple.MobileSMS,12,1731276479,1731276491,1731276491.6614819,-21600,,
com.google.Chrome,486,1731275993,1731276479,1731276479.70747,-21600,,
com.google.Chrome,1102,1731274890,1731275992,1731275992.8515038,-21600,,
com.discoverfinancial.mobile,56,1731274757,1731274813,1731274813.7747002,-21600,EB445137-D7F5-57EC-87DA-1DB460D64046,"iPhone13,2"
com.truebill.truebillnative,18,1731274737,1731274755,1731274755.122549,-21600,EB445137-D7F5-57EC-87DA-1DB460D64046,"iPhone13,2"
com.microsoft.Office.Outlook,13,1731274718,1731274731,1731274731.365252,-21600,EB445137-D7F5-57EC-87DA-1DB460D64046,"iPhone13,2"
com.letterboxd.LetterboxdApp,216,1731274500,1731274716,1731274716.418929,-21600,EB445137-D7F5-57EC-87DA-1DB460D64046,"iPhone13,2"
com.apple.news,3,1731274493,1731274496,1731274496.6348162,-21600,EB445137-D7F5-57EC-87DA-1DB460D64046,"iPhone13,2"
com.apple.news,2,1731274451,1731274453,1731274453.18591,-21600,EB445137-D7F5-57EC-87DA-1DB460D64046,"iPhone13,2"
com.apple.camera,1,1731274448,1731274449,1731274449.3396459,-21600,EB445137-D7F5-57EC-87DA-1DB460D64046,"iPhone13,2"
com.apple.camera,0,1731274447,1731274447,1731274447.771513,-21600,EB445137-D7F5-57EC-87DA-1DB460D64046,"iPhone13,2"
com.apple.news,7,1731274443,1731274450,1731274450.216553,-21600,EB445137-D7F5-57EC-87DA-1DB460D64046,"iPhone13,2"
com.apple.news,5,1731273830,1731273835,1731273835.89889,-21600,EB445137-D7F5-57EC-87DA-1DB460D64046,"iPhone13,2"
com.apple.news,377,1731273443,1731273820,1731273820.997144,-21600,EB445137-D7F5-57EC-87DA-1DB460D64046,"iPhone13,2"
com.google.Chrome,2093,1731272632,1731274725,1731274725.692559,-21600,,
com.leomehlig.today,12,1731272620,1731272632,1731272632.8296142,-21600,,
com.google.Chrome,532,1731272088,1731272620,1731272620.653338,-21600,,
com.leomehlig.today,171,1731271917,1731272088,1731272088.42922,-21600,,
com.apple.news,444,1731271642,1731272086,1731272087.401053,-21600,EB445137-D7F5-57EC-87DA-1DB460D64046,"iPhone13,2"
com.leomehlig.today,323,1731271589,1731271912,1731271912.580546,-21600,,
com.google.Chrome,316,1731271273,1731271589,1731271589.383628,-21600,,
com.leomehlig.today,17,1731271256,1731271273,1731271273.602181,-21600,,
com.google.Chrome,698,1731270558,1731271256,1731271256.789352,-21600,,
com.apple.camera,0,1731270314,1731270314,1731270314.551825,-21600,EB445137-D7F5-57EC-87DA-1DB460D64046,"iPhone13,2"
com.apple.MobileSMS,12,1731270180,1731270192,1731270192.876462,-21600,EB445137-D7F5-57EC-87DA-1DB460D64046,"iPhone13,2"
com.apple.MobileSMS,10,1731269261,1731269271,1731269271.301306,-21600,EB445137-D7F5-57EC-87DA-1DB460D64046,"iPhone13,2"
com.apple.camera,7,1731269117,1731269124,1731269125.3081942,-21600,EB445137-D7F5-57EC-87DA-1DB460D64046,"iPhone13,2"
com.apple.MobileSMS,10,1731269114,1731269124,1731269125.305002,-21600,EB445137-D7F5-57EC-87DA-1DB460D64046,"iPhone13,2"
com.apple.MobileSMS,41,1731269067,1731269108,1731269108.531505,-21600,EB445137-D7F5-57EC-87DA-1DB460D64046,"iPhone13,2"
com.apple.MobileSMS,3,1731269061,1731269064,1731269064.6046839,-21600,EB445137-D7F5-57EC-87DA-1DB460D64046,"iPhone13,2"
com.apple.MobileSMS,11,1731268668,1731268679,1731268679.65454,-21600,EB445137-D7F5-57EC-87DA-1DB460D64046,"iPhone13,2"
com.apple.MobileSMS,89,1731268543,1731268632,1731268633.206204,-21600,EB445137-D7F5-57EC-87DA-1DB460D64046,"iPhone13,2"
com.apple.MobileSMS,6,1731268530,1731268536,1731268536.795028,-21600,EB445137-D7F5-57EC-87DA-1DB460D64046,"iPhone13,2"
com.apple.calculator,7,1731268523,1731268530,1731268530.2333078,-21600,EB445137-D7F5-57EC-87DA-1DB460D64046,"iPhone13,2"
com.apple.MobileSMS,9,1731268514,1731268523,1731268523.315143,-21600,EB445137-D7F5-57EC-87DA-1DB460D64046,"iPhone13,2"
com.apple.calculator,24,1731268490,1731268514,1731268514.463344,-21600,EB445137-D7F5-57EC-87DA-1DB460D64046,"iPhone13,2"
com.apple.MobileSMS,18,1731268472,1731268490,1731268490.646069,-21600,EB445137-D7F5-57EC-87DA-1DB460D64046,"iPhone13,2"
com.apple.calculator,15,1731268457,1731268472,1731268472.129307,-21600,EB445137-D7F5-57EC-87DA-1DB460D64046,"iPhone13,2"
com.apple.MobileSMS,13,1731268444,1731268457,1731268457.3403149,-21600,EB445137-D7F5-57EC-87DA-1DB460D64046,"iPhone13,2"
com.apple.calculator,6,1731268438,1731268444,1731268444.811211,-21600,EB445137-D7F5-57EC-87DA-1DB460D64046,"iPhone13,2"
com.truebill.truebillnative,15,1731268423,1731268438,1731268438.880898,-21600,EB445137-D7F5-57EC-87DA-1DB460D64046,"iPhone13,2"
com.apple.calculator,66,1731268357,1731268423,1731268424.001755,-21600,EB445137-D7F5-57EC-87DA-1DB460D64046,"iPhone13,2"
com.truebill.truebillnative,14,1731268339,1731268353,1731268354.085157,-21600,EB445137-D7F5-57EC-87DA-1DB460D64046,"iPhone13,2"
com.google.Chrome,656,1731267918,1731268574,1731268574.7225208,-21600,,
com.leomehlig.today,127,1731267791,1731267918,1731267918.86149,-21600,,
com.google.Chrome,28,1731267763,1731267791,1731267791.9429731,-21600,,
com.toyopagroup.picaboo,34,1731266874,1731266908,1731266908.6334949,-21600,EB445137-D7F5-57EC-87DA-1DB460D64046,"iPhone13,2"
com.letterboxd.LetterboxdApp,7,1731266867,1731266874,1731266875.5347009,-21600,EB445137-D7F5-57EC-87DA-1DB460D64046,"iPhone13,2"
com.apple.camera,1,1731266866,1731266867,1731266867.154481,-21600,EB445137-D7F5-57EC-87DA-1DB460D64046,"iPhone13,2"
com.letterboxd.LetterboxdApp,2,1731266865,1731266867,1731266867.558218,-21600,EB445137-D7F5-57EC-87DA-1DB460D64046,"iPhone13,2"
com.letterboxd.LetterboxdApp,6,1731266808,1731266814,1731266814.310704,-21600,EB445137-D7F5-57EC-87DA-1DB460D64046,"iPhone13,2"
com.letterboxd.LetterboxdApp,5,1731265836,1731265841,1731265842.009647,-21600,EB445137-D7F5-57EC-87DA-1DB460D64046,"iPhone13,2"
com.letterboxd.LetterboxdApp,17,1731261227,1731261244,1731261244.974636,-21600,EB445137-D7F5-57EC-87DA-1DB460D64046,"iPhone13,2"
com.letterboxd.LetterboxdApp,69,1731260686,1731260755,1731260757.33742,-21600,EB445137-D7F5-57EC-87DA-1DB460D64046,"iPhone13,2"
com.apple.news,2,1731260680,1731260682,1731260682.8760018,-21600,EB445137-D7F5-57EC-87DA-1DB460D64046,"iPhone13,2"
com.apple.news,6,1731260190,1731260196,1731260196.691227,-21600,EB445137-D7F5-57EC-87DA-1DB460D64046,"iPhone13,2"
com.apple.news,116,1731260064,1731260180,1731260181.1480742,-21600,EB445137-D7F5-57EC-87DA-1DB460D64046,"iPhone13,2"
com.apple.news,7,1731260012,1731260019,1731260019.210079,-21600,EB445137-D7F5-57EC-87DA-1DB460D64046,"iPhone13,2"
com.apple.news,252,1731259759,1731260011,1731260012.489713,-21600,EB445137-D7F5-57EC-87DA-1DB460D64046,"iPhone13,2"
com.toyopagroup.picaboo,6,1731259753,1731259759,1731259759.440696,-21600,EB445137-D7F5-57EC-87DA-1DB460D64046,"iPhone13,2"
com.apple.news,115,1731259638,1731259753,1731259753.743154,-21600,EB445137-D7F5-57EC-87DA-1DB460D64046,"iPhone13,2"
com.apple.weather,5,1731259633,1731259638,1731259638.124665,-21600,EB445137-D7F5-57EC-87DA-1DB460D64046,"iPhone13,2"
com.apple.news,215,1731259416,1731259631,1731259632.003438,-21600,EB445137-D7F5-57EC-87DA-1DB460D64046,"iPhone13,2"
com.microsoft.Office.Outlook,32,1731259375,1731259407,1731259407.809303,-21600,EB445137-D7F5-57EC-87DA-1DB460D64046,"iPhone13,2"
com.toyopagroup.picaboo,6,1731259369,1731259375,1731259376.0169601,-21600,EB445137-D7F5-57EC-87DA-1DB460D64046,"iPhone13,2"
com.apple.camera,1,1731259207,1731259208,1731259209.95128,-21600,EB445137-D7F5-57EC-87DA-1DB460D64046,"iPhone13,2"
com.toyopagroup.picaboo,42,1731259202,1731259244,1731259244.8718529,-21600,EB445137-D7F5-57EC-87DA-1DB460D64046,"iPhone13,2"
com.toyopagroup.picaboo,3,1731259057,1731259060,1731259060.474341,-21600,EB445137-D7F5-57EC-87DA-1DB460D64046,"iPhone13,2"
com.toyopagroup.picaboo,11,1731259045,1731259056,1731259056.732584,-21600,EB445137-D7F5-57EC-87DA-1DB460D64046,"iPhone13,2"
com.toyopagroup.picaboo,17,1731259021,1731259038,1731259038.444834,-21600,EB445137-D7F5-57EC-87DA-1DB460D64046,"iPhone13,2"
com.toyopagroup.picaboo,12,1731258843,1731258855,1731258855.3657532,-21600,EB445137-D7F5-57EC-87DA-1DB460D64046,"iPhone13,2"
com.toyopagroup.picaboo,127,1731258548,1731258675,1731258676.4335651,-21600,EB445137-D7F5-57EC-87DA-1DB460D64046,"iPhone13,2"
com.renpho.health,16,1731258532,1731258548,1731258548.453881,-21600,EB445137-D7F5-57EC-87DA-1DB460D64046,"iPhone13,2"
com.renpho.health,11,1731258384,1731258395,1731258395.905628,-21600,EB445137-D7F5-57EC-87DA-1DB460D64046,"iPhone13,2"
com.renpho.health,12,1731257842,1731257854,1731257854.102623,-21600,EB445137-D7F5-57EC-87DA-1DB460D64046,"iPhone13,2"
com.google.Chrome,1609,1731257836,1731259445,1731259445.698771,-21600,,
com.renpho.health,3,1731257752,1731257755,1731257755.961141,-21600,EB445137-D7F5-57EC-87DA-1DB460D64046,"iPhone13,2"
com.renpho.health,20,1731257330,1731257350,1731257350.496756,-21600,EB445137-D7F5-57EC-87DA-1DB460D64046,"iPhone13,2"
com.google.ios.youtube,128,1731255999,1731256127,1731256127.5301762,-21600,EB445137-D7F5-57EC-87DA-1DB460D64046,"iPhone13,2"
com.toyopagroup.picaboo,30,1731255966,1731255996,1731255997.1959028,-21600,EB445137-D7F5-57EC-87DA-1DB460D64046,"iPhone13,2"
com.apple.journal,2,1731255960,1731255962,1731255962.197052,-21600,EB445137-D7F5-57EC-87DA-1DB460D64046,"iPhone13,2"
com.google.ios.youtube,1665,1731254295,1731255960,1731255961.1967092,-21600,EB445137-D7F5-57EC-87DA-1DB460D64046,"iPhone13,2"
com.google.ios.youtube,501,1731253785,1731254286,1731254286.469331,-21600,EB445137-D7F5-57EC-87DA-1DB460D64046,"iPhone13,2"
com.apple.camera,0,1731253761,1731253761,1731253761.902025,-21600,EB445137-D7F5-57EC-87DA-1DB460D64046,"iPhone13,2"
com.google.ios.youtube,13,1731253760,1731253773,1731253773.591648,-21600,EB445137-D7F5-57EC-87DA-1DB460D64046,"iPhone13,2"
com.google.ios.youtube,17,1731253454,1731253471,1731253471.658331,-21600,EB445137-D7F5-57EC-87DA-1DB460D64046,"iPhone13,2"
com.google.ios.youtube,11,1731253143,1731253154,1731253154.85673,-21600,EB445137-D7F5-57EC-87DA-1DB460D64046,"iPhone13,2"
com.google.ios.youtube,830,1731252095,1731252925,1731252925.455573,-21600,EB445137-D7F5-57EC-87DA-1DB460D64046,"iPhone13,2"
com.apple.camera,0,1731252038,1731252038,1731252038.769284,-21600,EB445137-D7F5-57EC-87DA-1DB460D64046,"iPhone13,2"
com.apple.camera,1,1731252037,1731252038,1731252038.0203261,-21600,EB445137-D7F5-57EC-87DA-1DB460D64046,"iPhone13,2"
com.google.ios.youtube,21,1731250801,1731250822,1731250822.846096,-21600,EB445137-D7F5-57EC-87DA-1DB460D64046,"iPhone13,2"
com.google.ios.youtube,15,1731222585,1731222600,1731222600.973465,-21600,EB445137-D7F5-57EC-87DA-1DB460D64046,"iPhone13,2"
com.google.Chrome,3179,1731219342,1731222521,1731222521.693126,-21600,,
com.leomehlig.today,4,1731219338,1731219342,1731219342.943002,-21600,,
com.google.ios.youtube,438,1731218482,1731218920,1731218921.865762,-21600,EB445137-D7F5-57EC-87DA-1DB460D64046,"iPhone13,2"
com.apple.news,16,1731218453,1731218469,1731218469.274046,-21600,EB445137-D7F5-57EC-87DA-1DB460D64046,"iPhone13,2"
com.apple.camera,1,1731218449,1731218450,1731218450.226841,-21600,EB445137-D7F5-57EC-87DA-1DB460D64046,"iPhone13,2"
com.apple.news,8,1731218443,1731218451,1731218451.715186,-21600,EB445137-D7F5-57EC-87DA-1DB460D64046,"iPhone13,2"
com.apple.news,390,1731217825,1731218215,1731218216.14354,-21600,EB445137-D7F5-57EC-87DA-1DB460D64046,"iPhone13,2"
com.apple.news,5,1731217755,1731217760,1731217760.456084,-21600,EB445137-D7F5-57EC-87DA-1DB460D64046,"iPhone13,2"
com.apple.news,58,1731217446,1731217504,1731217504.726026,-21600,EB445137-D7F5-57EC-87DA-1DB460D64046,"iPhone13,2"
com.apple.news,158,1731217285,1731217443,1731217444.134552,-21600,EB445137-D7F5-57EC-87DA-1DB460D64046,"iPhone13,2"
com.apple.news,193,1731216836,1731217029,1731217029.889834,-21600,EB445137-D7F5-57EC-87DA-1DB460D64046,"iPhone13,2"
com.apple.news,41,1731216304,1731216345,1731216346.056371,-21600,EB445137-D7F5-57EC-87DA-1DB460D64046,"iPhone13,2"
com.apple.news,333,1731215757,1731216090,1731216090.934268,-21600,EB445137-D7F5-57EC-87DA-1DB460D64046,"iPhone13,2"
com.apple.news,58,1731215688,1731215746,1731215747.435443,-21600,EB445137-D7F5-57EC-87DA-1DB460D64046,"iPhone13,2"
com.apple.news,10,1731215670,1731215680,1731215680.934037,-21600,EB445137-D7F5-57EC-87DA-1DB460D64046,"iPhone13,2"
com.apple.news,90,1731215576,1731215666,1731215667.595192,-21600,EB445137-D7F5-57EC-87DA-1DB460D64046,"iPhone13,2"
com.google.ios.youtube,40,1731215526,1731215566,1731215567.078648,-21600,EB445137-D7F5-57EC-87DA-1DB460D64046,"iPhone13,2"
com.google.ios.youtube,14,1731215508,1731215522,1731215522.90875,-21600,EB445137-D7F5-57EC-87DA-1DB460D64046,"iPhone13,2"
com.google.ios.youtube,3,1731215383,1731215386,1731215386.792657,-21600,EB445137-D7F5-57EC-87DA-1DB460D64046,"iPhone13,2"
com.google.ios.youtube,6,1731215320,1731215326,1731215326.556103,-21600,EB445137-D7F5-57EC-87DA-1DB460D64046,"iPhone13,2"
com.google.ios.youtube,3,1731215277,1731215280,1731215280.921211,-21600,EB445137-D7F5-57EC-87DA-1DB460D64046,"iPhone13,2"
com.google.ios.youtube,62,1731215022,1731215084,1731215084.834941,-21600,EB445137-D7F5-57EC-87DA-1DB460D64046,"iPhone13,2"
com.google.chrome.ios,8,1731215011,1731215019,1731215019.305049,-21600,EB445137-D7F5-57EC-87DA-1DB460D64046,"iPhone13,2"
com.google.chrome.ios,6,1731214767,1731214773,1731214773.3510141,-21600,EB445137-D7F5-57EC-87DA-1DB460D64046,"iPhone13,2"
com.google.chrome.ios,88,1731214664,1731214752,1731214752.8455238,-21600,EB445137-D7F5-57EC-87DA-1DB460D64046,"iPhone13,2"
com.google.chrome.ios,120,1731214540,1731214660,1731214661.087903,-21600,EB445137-D7F5-57EC-87DA-1DB460D64046,"iPhone13,2"
com.google.chrome.ios,11,1731214398,1731214409,1731214409.5096111,-21600,EB445137-D7F5-57EC-87DA-1DB460D64046,"iPhone13,2"
com.google.chrome.ios,117,1731213985,1731214102,1731214103.15221,-21600,EB445137-D7F5-57EC-87DA-1DB460D64046,"iPhone13,2"
com.toyopagroup.picaboo,5,1731213945,1731213950,1731213950.568584,-21600,EB445137-D7F5-57EC-87DA-1DB460D64046,"iPhone13,2"
com.hammerandchisel.discord,147,1731212865,1731213012,1731213012.264411,-21600,EB445137-D7F5-57EC-87DA-1DB460D64046,"iPhone13,2"
com.toyopagroup.picaboo,62,1731212768,1731212830,1731212830.749762,-21600,EB445137-D7F5-57EC-87DA-1DB460D64046,"iPhone13,2"
com.apple.weather,6,1731211792,1731211798,1731211798.734253,-21600,EB445137-D7F5-57EC-87DA-1DB460D64046,"iPhone13,2"
com.google.chrome.ios,3,1731211789,1731211792,1731211792.3654618,-21600,EB445137-D7F5-57EC-87DA-1DB460D64046,"iPhone13,2"
com.google.chrome.ios,24,1731210658,1731210682,1731210682.773837,-21600,EB445137-D7F5-57EC-87DA-1DB460D64046,"iPhone13,2"
com.apple.news,2,1731210656,1731210658,1731210658.4634,-21600,EB445137-D7F5-57EC-87DA-1DB460D64046,"iPhone13,2"
com.apple.news,445,1731202651,1731203096,1731203096.879705,-21600,EB445137-D7F5-57EC-87DA-1DB460D64046,"iPhone13,2"
com.google.chrome.ios,180,1731202394,1731202574,1731202574.465487,-21600,EB445137-D7F5-57EC-87DA-1DB460D64046,"iPhone13,2"
com.apple.weather,4,1731202390,1731202394,1731202394.220635,-21600,EB445137-D7F5-57EC-87DA-1DB460D64046,"iPhone13,2"
com.apple.weather,3,1731200987,1731200990,1731200990.46165,-21600,EB445137-D7F5-57EC-87DA-1DB460D64046,"iPhone13,2"
com.apple.weather,2,1731200984,1731200986,1731200986.655083,-21600,EB445137-D7F5-57EC-87DA-1DB460D64046,"iPhone13,2"
com.apple.weather,6,1731196725,1731196731,1731196731.691077,-21600,EB445137-D7F5-57EC-87DA-1DB460D64046,"iPhone13,2"
com.apple.weather,6,1731195990,1731195996,1731195996.359239,-21600,EB445137-D7F5-57EC-87DA-1DB460D64046,"iPhone13,2"
com.apple.weather,25,1731195962,1731195987,1731195988.061411,-21600,EB445137-D7F5-57EC-87DA-1DB460D64046,"iPhone13,2"
com.apple.weather,13,1731195938,1731195951,1731195951.889807,-21600,EB445137-D7F5-57EC-87DA-1DB460D64046,"iPhone13,2"
com.apple.weather,17,1731192413,1731192430,1731192430.262473,-21600,EB445137-D7F5-57EC-87DA-1DB460D64046,"iPhone13,2"
com.leomehlig.today,73,1731192052,1731192125,1731192125.636819,-21600,,
com.google.Chrome,32,1731192020,1731192052,1731192052.268965,-21600,,
com.apple.Preview,63,1731191957,1731192020,1731192020.0569658,-21600,,
com.microsoft.VSCode,6,1731191951,1731191957,1731191957.414124,-21600,,
com.leomehlig.today,3,1731191948,1731191951,1731191951.6099749,-21600,,
com.microsoft.VSCode,364,1731191584,1731191948,1731191949.059725,-21600,,
com.google.Chrome,53,1731191531,1731191584,1731191584.678685,-21600,,
com.microsoft.VSCode,273,1731191258,1731191531,1731191531.923919,-21600,,
com.apple.finder,12,1731191246,1731191258,1731191258.2283812,-21600,,
com.microsoft.VSCode,163,1731191083,1731191246,1731191246.321114,-21600,,
com.google.Chrome,18,1731191065,1731191083,1731191083.738398,-21600,,
com.microsoft.VSCode,22,1731191043,1731191065,1731191065.393124,-21600,,
com.google.Chrome,73,1731190970,1731191043,1731191043.150138,-21600,,
com.microsoft.VSCode,7,1731190963,1731190970,1731190970.654042,-21600,,
com.google.Chrome,9,1731190954,1731190963,1731190963.7932692,-21600,,
com.microsoft.VSCode,13,1731190941,1731190954,1731190955.019263,-21600,,
com.google.Chrome,24,1731190917,1731190941,1731190942.035273,-21600,,
com.microsoft.VSCode,146,1731190771,1731190917,1731190917.1461148,-21600,,
com.google.Chrome,16,1731190755,1731190771,1731190771.05402,-21600,,
com.microsoft.VSCode,33,1731190722,1731190755,1731190755.847035,-21600,,
com.google.Chrome,1,1731190721,1731190722,1731190722.7619061,-21600,,
com.microsoft.VSCode,4,1731190717,1731190721,1731190721.568372,-21600,,
com.google.Chrome,0,1731190717,1731190717,1731190718.067611,-21600,,
com.microsoft.VSCode,2,1731190715,1731190717,1731190717.176262,-21600,,
com.google.Chrome,1,1731190714,1731190715,1731190715.271713,-21600,,
com.microsoft.VSCode,1,1731190713,1731190714,1731190714.7957292,-21600,,
com.google.Chrome,1,1731190712,1731190713,1731190713.3630672,-21600,,
com.microsoft.VSCode,3,1731190709,1731190712,1731190712.566031,-21600,,
com.google.Chrome,2,1731190707,1731190709,1731190709.9275842,-21600,,
com.microsoft.VSCode,7,1731190700,1731190707,1731190707.716131,-21600,,
com.google.Chrome,36,1731190664,1731190700,1731190701.036117,-21600,,
com.microsoft.VSCode,175,1731190489,1731190664,1731190664.2133331,-21600,,
com.leomehlig.today,4,1731190485,1731190489,1731190489.1152968,-21600,,
com.apple.news,117,1731190242,1731190359,1731190359.120059,-21600,EB445137-D7F5-57EC-87DA-1DB460D64046,"iPhone13,2"
com.hammerandchisel.discord,70,1731190166,1731190236,1731190236.392918,-21600,EB445137-D7F5-57EC-87DA-1DB460D64046,"iPhone13,2"
com.apple.camera,0,1731190132,1731190132,1731190132.9563541,-21600,EB445137-D7F5-57EC-87DA-1DB460D64046,"iPhone13,2"
com.leomehlig.today,301,1731190118,1731190419,1731190419.6848001,-21600,,
com.microsoft.VSCode,1,1731190117,1731190118,1731190118.477161,-21600,,
com.google.Chrome,3,1731189947,1731189950,1731189950.190936,-21600,,
com.microsoft.VSCode,5,1731189942,1731189947,1731189947.577767,-21600,,
com.google.Chrome,32,1731189910,1731189942,1731189942.235989,-21600,,
com.microsoft.VSCode,10,1731189900,1731189910,1731189910.4799929,-21600,,
com.google.Chrome,16,1731189884,1731189900,1731189900.687934,-21600,,
com.microsoft.VSCode,7,1731189877,1731189884,1731189884.395582,-21600,,
com.google.Chrome,29,1731189848,1731189877,1731189877.127538,-21600,,
com.microsoft.VSCode,364,1731189484,1731189848,1731189848.095864,-21600,,
com.google.Chrome,48,1731189436,1731189484,1731189484.865175,-21600,,
com.microsoft.VSCode,1153,1731188283,1731189436,1731189436.353998,-21600,,
com.google.Chrome,15,1731188268,1731188283,1731188283.138452,-21600,,
com.microsoft.VSCode,120,1731188148,1731188268,1731188268.3066192,-21600,,
com.google.Chrome,54,1731188094,1731188148,1731188148.500802,-21600,,
com.microsoft.VSCode,32,1731188050,1731188082,1731188082.674766,-21600,,
com.leomehlig.today,45,1731188005,1731188050,1731188050.9431782,-21600,,
com.google.Chrome,958,1731187047,1731188005,1731188005.337574,-21600,,
com.leomehlig.today,7,1731187040,1731187047,1731187047.189818,-21600,,
com.google.Chrome,20,1731187020,1731187040,1731187040.907866,-21600,,
com.leomehlig.today,2,1731187018,1731187020,1731187020.1857939,-21600,,
com.google.ios.youtube,1195,1731185801,1731186996,1731186999.430254,-21600,EB445137-D7F5-57EC-87DA-1DB460D64046,"iPhone13,2"
com.leomehlig.today,340,1731185533,1731185873,1731185873.595948,-21600,,
com.intsig.CamScannerLite,150,1731185377,1731185527,1731185528.0354571,-21600,EB445137-D7F5-57EC-87DA-1DB460D64046,"iPhone13,2"
com.hammerandchisel.discord,10,1731185359,1731185369,1731185370.065939,-21600,EB445137-D7F5-57EC-87DA-1DB460D64046,"iPhone13,2"
com.apple.mobiletimer,6,1731185353,1731185359,1731185360.452424,-21600,EB445137-D7F5-57EC-87DA-1DB460D64046,"iPhone13,2"
com.google.Chrome,208,1731185325,1731185533,1731185533.9198189,-21600,,
com.google.Chrome,323,1731184995,1731185318,1731185318.733873,-21600,,
com.google.Chrome,730,1731184240,1731184970,1731184970.625098,-21600,,
com.leomehlig.today,17,1731184212,1731184229,1731184229.893054,-21600,,
com.google.Chrome,1501,1731182711,1731184212,1731184212.070524,-21600,,
com.leomehlig.today,31,1731182671,1731182702,1731182702.219562,-21600,,
com.google.Chrome,1908,1731180763,1731182671,1731182671.752149,-21600,,
com.leomehlig.today,107,1731180656,1731180763,1731180763.95365,-21600,,
com.google.Chrome,68,1731180588,1731180656,1731180656.445929,-21600,,
com.apple.mobiletimer,2,1731178861,1731178863,1731178863.1859488,-21600,EB445137-D7F5-57EC-87DA-1DB460D64046,"iPhone13,2"
com.apple.news,183,1731178678,1731178861,1731178861.295923,-21600,EB445137-D7F5-57EC-87DA-1DB460D64046,"iPhone13,2"
com.apple.mobiletimer,3,1731178675,1731178678,1731178678.622566,-21600,EB445137-D7F5-57EC-87DA-1DB460D64046,"iPhone13,2"
com.apple.mobiletimer,2,1731178615,1731178617,1731178617.532741,-21600,EB445137-D7F5-57EC-87DA-1DB460D64046,"iPhone13,2"
com.apple.news,117,1731178498,1731178615,1731178615.204282,-21600,EB445137-D7F5-57EC-87DA-1DB460D64046,"iPhone13,2"
com.apple.mobiletimer,5,1731178493,1731178498,1731178498.304669,-21600,EB445137-D7F5-57EC-87DA-1DB460D64046,"iPhone13,2"
com.apple.mobiletimer,20,1731178407,1731178427,1731178427.6463928,-21600,EB445137-D7F5-57EC-87DA-1DB460D64046,"iPhone13,2"
com.apple.weather,3,1731178403,1731178406,1731178407.042243,-21600,EB445137-D7F5-57EC-87DA-1DB460D64046,"iPhone13,2"
com.apple.mobiletimer,3,1731178400,1731178403,1731178404.1546512,-21600,EB445137-D7F5-57EC-87DA-1DB460D64046,"iPhone13,2"
com.apple.mobiletimer,2,1731178270,1731178272,1731178272.349683,-21600,EB445137-D7F5-57EC-87DA-1DB460D64046,"iPhone13,2"
com.apple.news,30,1731178240,1731178270,1731178270.647234,-21600,EB445137-D7F5-57EC-87DA-1DB460D64046,"iPhone13,2"
com.apple.mobiletimer,2,1731178238,1731178240,1731178240.057343,-21600,EB445137-D7F5-57EC-87DA-1DB460D64046,"iPhone13,2"
com.apple.news,93,1731178145,1731178238,1731178238.486233,-21600,EB445137-D7F5-57EC-87DA-1DB460D64046,"iPhone13,2"
com.apple.mobiletimer,5,1731178140,1731178145,1731178145.8852382,-21600,EB445137-D7F5-57EC-87DA-1DB460D64046,"iPhone13,2"
com.apple.mobiletimer,1,1731178090,1731178091,1731178092.15501,-21600,EB445137-D7F5-57EC-87DA-1DB460D64046,"iPhone13,2"
com.apple.news,50,1731178040,1731178090,1731178090.5728168,-21600,EB445137-D7F5-57EC-87DA-1DB460D64046,"iPhone13,2"
com.apple.mobiletimer,1,1731178039,1731178040,1731178040.9955301,-21600,EB445137-D7F5-57EC-87DA-1DB460D64046,"iPhone13,2"
com.apple.news,76,1731177963,1731178039,1731178039.659082,-21600,EB445137-D7F5-57EC-87DA-1DB460D64046,"iPhone13,2"
com.apple.mobiletimer,14,1731177945,1731177959,1731177959.584042,-21600,EB445137-D7F5-57EC-87DA-1DB460D64046,"iPhone13,2"
com.apple.mobiletimer,28,1731177885,1731177913,1731177913.858447,-21600,EB445137-D7F5-57EC-87DA-1DB460D64046,"iPhone13,2"
com.apple.mobiletimer,3,1731177826,1731177829,1731177829.945163,-21600,EB445137-D7F5-57EC-87DA-1DB460D64046,"iPhone13,2"
com.apple.news,109,1731177717,1731177826,1731177826.810233,-21600,EB445137-D7F5-57EC-87DA-1DB460D64046,"iPhone13,2"
com.apple.mobiletimer,6,1731177696,1731177702,1731177702.900651,-21600,EB445137-D7F5-57EC-87DA-1DB460D64046,"iPhone13,2"
com.apple.mobiletimer,15,1731177638,1731177653,1731177653.3682609,-21600,EB445137-D7F5-57EC-87DA-1DB460D64046,"iPhone13,2"
Astrospheric.Astrospheric,19,1731177598,1731177617,1731177617.6848521,-21600,EB445137-D7F5-57EC-87DA-1DB460D64046,"iPhone13,2"
com.hammerandchisel.discord,44,1731177552,1731177596,1731177596.507975,-21600,EB445137-D7F5-57EC-87DA-1DB460D64046,"iPhone13,2"
com.apple.Music,18,1731177533,1731177551,1731177551.254565,-21600,EB445137-D7F5-57EC-87DA-1DB460D64046,"iPhone13,2"
com.apple.mobiletimer,3,1731177530,1731177533,1731177533.9024792,-21600,EB445137-D7F5-57EC-87DA-1DB460D64046,"iPhone13,2"
com.apple.Music,6,1731177524,1731177530,1731177530.701429,-21600,EB445137-D7F5-57EC-87DA-1DB460D64046,"iPhone13,2"
com.apple.Music,8,1731177035,1731177043,1731177043.1789799,-21600,EB445137-D7F5-57EC-87DA-1DB460D64046,"iPhone13,2"
com.apple.Music,20,1731177014,1731177034,1731177034.312729,-21600,EB445137-D7F5-57EC-87DA-1DB460D64046,"iPhone13,2"
com.apple.Music,26,1731176638,1731176664,1731176665.078701,-21600,EB445137-D7F5-57EC-87DA-1DB460D64046,"iPhone13,2"
com.apple.camera,7,1731176516,1731176523,1731176523.510762,-21600,EB445137-D7F5-57EC-87DA-1DB460D64046,"iPhone13,2"
com.apple.Music,8,1731176515,1731176523,1731176523.3424559,-21600,EB445137-D7F5-57EC-87DA-1DB460D64046,"iPhone13,2"
com.apple.Music,8,1731176425,1731176433,1731176433.895155,-21600,EB445137-D7F5-57EC-87DA-1DB460D64046,"iPhone13,2"
com.apple.weather,0,1731176425,1731176425,1731176426.783737,-21600,EB445137-D7F5-57EC-87DA-1DB460D64046,"iPhone13,2"
com.apple.weather,8,1731176288,1731176296,1731176296.12661,-21600,EB445137-D7F5-57EC-87DA-1DB460D64046,"iPhone13,2"
com.apple.weather,2,1731176163,1731176165,1731176166.0026631,-21600,EB445137-D7F5-57EC-87DA-1DB460D64046,"iPhone13,2"
com.google.ios.youtube,3,1731176159,1731176162,1731176162.201778,-21600,EB445137-D7F5-57EC-87DA-1DB460D64046,"iPhone13,2"
com.google.ios.youtube,1260,1731174884,1731176144,1731176145.3771539,-21600,EB445137-D7F5-57EC-87DA-1DB460D64046,"iPhone13,2"
com.apple.Music,11,1731174873,1731174884,1731174885.123903,-21600,EB445137-D7F5-57EC-87DA-1DB460D64046,"iPhone13,2"
com.google.ios.youtube,924,1731173946,1731174870,1731174870.874154,-21600,EB445137-D7F5-57EC-87DA-1DB460D64046,"iPhone13,2"
com.apple.weather,3,1731173939,1731173942,1731173942.714809,-21600,EB445137-D7F5-57EC-87DA-1DB460D64046,"iPhone13,2"
com.apple.weather,9,1731173879,1731173888,1731173888.2342858,-21600,EB445137-D7F5-57EC-87DA-1DB460D64046,"iPhone13,2"
com.apple.weather,2,1731173677,1731173679,1731173679.145463,-21600,EB445137-D7F5-57EC-87DA-1DB460D64046,"iPhone13,2"
com.apple.weather,7,1731173666,1731173673,1731173673.572787,-21600,EB445137-D7F5-57EC-87DA-1DB460D64046,"iPhone13,2"
com.renpho.health,17,1731173623,1731173640,1731173640.716529,-21600,EB445137-D7F5-57EC-87DA-1DB460D64046,"iPhone13,2"
com.google.ios.youtube,1661,1731170972,1731172633,1731172633.973326,-21600,EB445137-D7F5-57EC-87DA-1DB460D64046,"iPhone13,2"
com.apple.news,75,1731170891,1731170966,1731170966.9734201,-21600,EB445137-D7F5-57EC-87DA-1DB460D64046,"iPhone13,2"
com.apple.news,12,1731166618,1731166630,1731166630.190433,-21600,EB445137-D7F5-57EC-87DA-1DB460D64046,"iPhone13,2"
com.apple.news,35,1731166053,1731166088,1731166088.176908,-21600,EB445137-D7F5-57EC-87DA-1DB460D64046,"iPhone13,2"
com.apple.news,18,1731165505,1731165523,1731165523.5029922,-21600,EB445137-D7F5-57EC-87DA-1DB460D64046,"iPhone13,2"
com.apple.news,20,1731164954,1731164974,1731164974.870748,-21600,EB445137-D7F5-57EC-87DA-1DB460D64046,"iPhone13,2"
com.apple.news,23,1731164401,1731164424,1731164424.033087,-21600,EB445137-D7F5-57EC-87DA-1DB460D64046,"iPhone13,2"
com.apple.news,13,1731137076,1731137089,1731137089.5145311,-21600,EB445137-D7F5-57EC-87DA-1DB460D64046,"iPhone13,2"
com.apple.news,16,1731137057,1731137073,1731137073.867422,-21600,EB445137-D7F5-57EC-87DA-1DB460D64046,"iPhone13,2"
com.apple.news,11,1731137045,1731137056,1731137056.5601711,-21600,EB445137-D7F5-57EC-87DA-1DB460D64046,"iPhone13,2"
com.apple.news,10,1731136991,1731137001,1731137001.733217,-21600,EB445137-D7F5-57EC-87DA-1DB460D64046,"iPhone13,2"
com.apple.news,4,1731136985,1731136989,1731136990.0076818,-21600,EB445137-D7F5-57EC-87DA-1DB460D64046,"iPhone13,2"
com.google.Chrome,3579,1731133377,1731136956,1731136956.828573,-21600,,
com.google.Chrome,1638,1731131115,1731132753,1731132753.5014548,-21600,,
com.apple.news,13,1731131055,1731131068,1731131068.5995579,-21600,EB445137-D7F5-57EC-87DA-1DB460D64046,"iPhone13,2"
com.google.Chrome,220,1731130406,1731130626,1731130627.054106,-21600,,
com.google.Chrome,319,1731129963,1731130282,1731130282.482424,-21600,,
com.google.Chrome,374,1731129569,1731129943,1731129943.6460118,-21600,,
com.apple.news,2,1731129376,1731129378,1731129378.7118,-21600,EB445137-D7F5-57EC-87DA-1DB460D64046,"iPhone13,2"
com.apple.news,15,1731129358,1731129373,1731129374.067353,-21600,EB445137-D7F5-57EC-87DA-1DB460D64046,"iPhone13,2"
com.apple.news,60,1731129297,1731129357,1731129357.7982202,-21600,EB445137-D7F5-57EC-87DA-1DB460D64046,"iPhone13,2"
com.burbn.instagram,66,1731126695,1731126761,1731126761.553709,-21600,EB445137-D7F5-57EC-87DA-1DB460D64046,"iPhone13,2"
com.google.chrome.ios,136,1731125444,1731125580,1731125581.155054,-21600,EB445137-D7F5-57EC-87DA-1DB460D64046,"iPhone13,2"
com.google.chrome.ios,81,1731125352,1731125433,1731125433.7148519,-21600,EB445137-D7F5-57EC-87DA-1DB460D64046,"iPhone13,2"
com.google.chrome.ios,2,1731124467,1731124469,1731124469.686778,-21600,EB445137-D7F5-57EC-87DA-1DB460D64046,"iPhone13,2"
com.google.chrome.ios,3,1731124354,1731124357,1731124357.257643,-21600,EB445137-D7F5-57EC-87DA-1DB460D64046,"iPhone13,2"
com.google.chrome.ios,109,1731124241,1731124350,1731124351.196271,-21600,EB445137-D7F5-57EC-87DA-1DB460D64046,"iPhone13,2"
com.hammerandchisel.discord,18,1731119219,1731119237,1731119237.636512,-21600,EB445137-D7F5-57EC-87DA-1DB460D64046,"iPhone13,2"
com.hammerandchisel.discord,6,1731119201,1731119207,1731119207.1604319,-21600,EB445137-D7F5-57EC-87DA-1DB460D64046,"iPhone13,2"
com.hammerandchisel.discord,21,1731119177,1731119198,1731119198.2346768,-21600,EB445137-D7F5-57EC-87DA-1DB460D64046,"iPhone13,2"
com.hammerandchisel.discord,3,1731119074,1731119077,1731119077.836609,-21600,EB445137-D7F5-57EC-87DA-1DB460D64046,"iPhone13,2"
com.hammerandchisel.discord,20,1731119030,1731119050,1731119051.025574,-21600,EB445137-D7F5-57EC-87DA-1DB460D64046,"iPhone13,2"
com.microsoft.Office.Outlook,38,1731118990,1731119028,1731119028.301162,-21600,EB445137-D7F5-57EC-87DA-1DB460D64046,"iPhone13,2"
com.apple.mobiletimer,7,1731118003,1731118010,1731118010.264085,-21600,EB445137-D7F5-57EC-87DA-1DB460D64046,"iPhone13,2"
com.apple.mobiletimer,4,1731115295,1731115299,1731115299.306957,-21600,EB445137-D7F5-57EC-87DA-1DB460D64046,"iPhone13,2"
com.apple.mobiletimer,2,1731115243,1731115245,1731115245.5302181,-21600,EB445137-D7F5-57EC-87DA-1DB460D64046,"iPhone13,2"
com.apple.mobiletimer,13,1731114729,1731114742,1731114742.336081,-21600,EB445137-D7F5-57EC-87DA-1DB460D64046,"iPhone13,2"
com.apple.mobiletimer,5,1731114090,1731114095,1731114095.531427,-21600,EB445137-D7F5-57EC-87DA-1DB460D64046,"iPhone13,2"
com.google.chrome.ios,4,1731114086,1731114090,1731114090.692915,-21600,EB445137-D7F5-57EC-87DA-1DB460D64046,"iPhone13,2"
com.google.chrome.ios,18,1731113810,1731113828,1731113828.634251,-21600,EB445137-D7F5-57EC-87DA-1DB460D64046,"iPhone13,2"
com.google.chrome.ios,20,1731113470,1731113490,1731113491.086985,-21600,EB445137-D7F5-57EC-87DA-1DB460D64046,"iPhone13,2"
com.google.chrome.ios,23,1731113369,1731113392,1731113392.675442,-21600,EB445137-D7F5-57EC-87DA-1DB460D64046,"iPhone13,2"
com.google.chrome.ios,4,1731113357,1731113361,1731113362.148046,-21600,EB445137-D7F5-57EC-87DA-1DB460D64046,"iPhone13,2"
com.google.chrome.ios,8,1731113158,1731113166,1731113166.023716,-21600,EB445137-D7F5-57EC-87DA-1DB460D64046,"iPhone13,2"
com.google.chrome.ios,25,1731113119,1731113144,1731113145.128617,-21600,EB445137-D7F5-57EC-87DA-1DB460D64046,"iPhone13,2"
com.google.chrome.ios,4,1731113045,1731113049,1731113049.7168179,-21600,EB445137-D7F5-57EC-87DA-1DB460D64046,"iPhone13,2"
com.google.chrome.ios,68,1731112967,1731113035,1731113036.8006968,-21600,EB445137-D7F5-57EC-87DA-1DB460D64046,"iPhone13,2"
com.google.chrome.ios,327,1731112615,1731112942,1731112943.723401,-21600,EB445137-D7F5-57EC-87DA-1DB460D64046,"iPhone13,2"
com.apple.PosterBoard,2,1731112450,1731112452,1731112452.1232638,-21600,EB445137-D7F5-57EC-87DA-1DB460D64046,"iPhone13,2"
com.google.chrome.ios,122,1731112449,1731112571,1731112571.587645,-21600,EB445137-D7F5-57EC-87DA-1DB460D64046,"iPhone13,2"
com.google.chrome.ios,14,1731112435,1731112449,1731112450.037167,-21600,EB445137-D7F5-57EC-87DA-1DB460D64046,"iPhone13,2"
com.google.chrome.ios,7,1731112200,1731112207,1731112207.8728728,-21600,EB445137-D7F5-57EC-87DA-1DB460D64046,"iPhone13,2"
com.google.chrome.ios,101,1731112012,1731112113,1731112114.776937,-21600,EB445137-D7F5-57EC-87DA-1DB460D64046,"iPhone13,2"
com.google.chrome.ios,2,1731111801,1731111803,1731111803.384066,-21600,EB445137-D7F5-57EC-87DA-1DB460D64046,"iPhone13,2"
com.google.chrome.ios,15,1731111653,1731111668,1731111669.082551,-21600,EB445137-D7F5-57EC-87DA-1DB460D64046,"iPhone13,2"
com.google.chrome.ios,7,1731111450,1731111457,1731111457.966795,-21600,EB445137-D7F5-57EC-87DA-1DB460D64046,"iPhone13,2"
com.google.chrome.ios,31,1731111348,1731111379,1731111379.587754,-21600,EB445137-D7F5-57EC-87DA-1DB460D64046,"iPhone13,2"
com.google.chrome.ios,8,1731111338,1731111346,1731111347.610815,-21600,EB445137-D7F5-57EC-87DA-1DB460D64046,"iPhone13,2"
com.toyopagroup.picaboo,4,1731111334,1731111338,1731111338.562305,-21600,EB445137-D7F5-57EC-87DA-1DB460D64046,"iPhone13,2"
com.google.chrome.ios,3,1731111331,1731111334,1731111334.50859,-21600,EB445137-D7F5-57EC-87DA-1DB460D64046,"iPhone13,2"
com.google.chrome.ios,7,1731111119,1731111126,1731111127.08886,-21600,EB445137-D7F5-57EC-87DA-1DB460D64046,"iPhone13,2"
com.google.chrome.ios,39,1731110961,1731111000,1731111000.9558291,-21600,EB445137-D7F5-57EC-87DA-1DB460D64046,"iPhone13,2"
com.google.chrome.ios,27,1731110858,1731110885,1731110887.416946,-21600,EB445137-D7F5-57EC-87DA-1DB460D64046,"iPhone13,2"
com.google.chrome.ios,45,1731110762,1731110807,1731110807.678207,-21600,EB445137-D7F5-57EC-87DA-1DB460D64046,"iPhone13,2"
com.google.chrome.ios,18,1731110676,1731110694,1731110695.1297011,-21600,EB445137-D7F5-57EC-87DA-1DB460D64046,"iPhone13,2"
com.apple.mobileslideshow,2,1731110674,1731110676,1731110678.8918738,-21600,EB445137-D7F5-57EC-87DA-1DB460D64046,"iPhone13,2"
com.google.chrome.ios,17,1731110657,1731110674,1731110675.1903129,-21600,EB445137-D7F5-57EC-87DA-1DB460D64046,"iPhone13,2"
com.apple.mobileslideshow,2,1731110653,1731110655,1731110655.2935781,-21600,EB445137-D7F5-57EC-87DA-1DB460D64046,"iPhone13,2"
com.apple.mobileslideshow,13,1731109506,1731109519,1731109520.652267,-21600,EB445137-D7F5-57EC-87DA-1DB460D64046,"iPhone13,2"
com.apple.Music,2,1731109500,1731109502,1731109503.515338,-21600,EB445137-D7F5-57EC-87DA-1DB460D64046,"iPhone13,2"
com.apple.Music,47,1731107607,1731107654,1731107655.792632,-21600,EB445137-D7F5-57EC-87DA-1DB460D64046,"iPhone13,2"
com.google.chrome.ios,6,1731107592,1731107598,1731107598.624696,-21600,EB445137-D7F5-57EC-87DA-1DB460D64046,"iPhone13,2"
com.google.chrome.ios,60,1731107289,1731107349,1731107350.13469,-21600,EB445137-D7F5-57EC-87DA-1DB460D64046,"iPhone13,2"
com.google.chrome.ios,133,1731106408,1731106541,1731106542.722148,-21600,EB445137-D7F5-57EC-87DA-1DB460D64046,"iPhone13,2"
com.google.chrome.ios,9,1731106357,1731106366,1731106366.624034,-21600,EB445137-D7F5-57EC-87DA-1DB460D64046,"iPhone13,2"
com.google.chrome.ios,71,1731106279,1731106350,1731106352.824957,-21600,EB445137-D7F5-57EC-87DA-1DB460D64046,"iPhone13,2"
com.google.chrome.ios,11,1731106255,1731106266,1731106266.5070171,-21600,EB445137-D7F5-57EC-87DA-1DB460D64046,"iPhone13,2"
com.google.chrome.ios,49,1731106086,1731106135,1731106135.426628,-21600,EB445137-D7F5-57EC-87DA-1DB460D64046,"iPhone13,2"
com.google.chrome.ios,7,1731105986,1731105993,1731105993.6281781,-21600,EB445137-D7F5-57EC-87DA-1DB460D64046,"iPhone13,2"
com.google.chrome.ios,47,1731105884,1731105931,1731105931.5672379,-21600,EB445137-D7F5-57EC-87DA-1DB460D64046,"iPhone13,2"
com.google.chrome.ios,6,1731105863,1731105869,1731105869.1317039,-21600,EB445137-D7F5-57EC-87DA-1DB460D64046,"iPhone13,2"
com.google.chrome.ios,10,1731105846,1731105856,1731105856.591329,-21600,EB445137-D7F5-57EC-87DA-1DB460D64046,"iPhone13,2"
com.google.chrome.ios,9,1731105836,1731105845,1731105845.533551,-21600,EB445137-D7F5-57EC-87DA-1DB460D64046,"iPhone13,2"
com.google.chrome.ios,16,1731105621,1731105637,1731105637.4152188,-21600,EB445137-D7F5-57EC-87DA-1DB460D64046,"iPhone13,2"
com.apple.mobilenotes,12,1731105609,1731105621,1731105621.212607,-21600,EB445137-D7F5-57EC-87DA-1DB460D64046,"iPhone13,2"
com.apple.mobilenotes,7,1731105533,1731105540,1731105540.1587238,-21600,EB445137-D7F5-57EC-87DA-1DB460D64046,"iPhone13,2"
com.apple.mobilenotes,4,1731105426,1731105430,1731105430.3828511,-21600,EB445137-D7F5-57EC-87DA-1DB460D64046,"iPhone13,2"
com.apple.mobilenotes,4,1731105045,1731105049,1731105049.221506,-21600,EB445137-D7F5-57EC-87DA-1DB460D64046,"iPhone13,2"
com.apple.mobilenotes,7,1731104354,1731104361,1731104362.373637,-21600,EB445137-D7F5-57EC-87DA-1DB460D64046,"iPhone13,2"
com.apple.MobileSMS,2,1731104352,1731104354,1731104354.4995131,-21600,EB445137-D7F5-57EC-87DA-1DB460D64046,"iPhone13,2"
com.apple.MobileSMS,7,1731102451,1731102458,1731102459.474368,-21600,EB445137-D7F5-57EC-87DA-1DB460D64046,"iPhone13,2"
com.google.chrome.ios,66,1731102384,1731102450,1731102451.673378,-21600,EB445137-D7F5-57EC-87DA-1DB460D64046,"iPhone13,2"
com.apple.mobilenotes,14,1731102370,1731102384,1731102384.494728,-21600,EB445137-D7F5-57EC-87DA-1DB460D64046,"iPhone13,2"
com.apple.Health,33,1731102334,1731102367,1731102367.835799,-21600,EB445137-D7F5-57EC-87DA-1DB460D64046,"iPhone13,2"
com.apple.MobileSMS,8,1731102309,1731102317,1731102318.078302,-21600,EB445137-D7F5-57EC-87DA-1DB460D64046,"iPhone13,2"
com.apple.mobilenotes,7,1731102301,1731102308,1731102309.471043,-21600,EB445137-D7F5-57EC-87DA-1DB460D64046,"iPhone13,2"
com.apple.mobilenotes,86,1731102188,1731102274,1731102274.382011,-21600,EB445137-D7F5-57EC-87DA-1DB460D64046,"iPhone13,2"
com.apple.MobileSMS,4,1731102174,1731102178,1731102178.331583,-21600,EB445137-D7F5-57EC-87DA-1DB460D64046,"iPhone13,2"
com.apple.MobileSMS,6,1731102149,1731102155,1731102155.559105,-21600,EB445137-D7F5-57EC-87DA-1DB460D64046,"iPhone13,2"
com.apple.news,245,1731101904,1731102149,1731102149.379461,-21600,EB445137-D7F5-57EC-87DA-1DB460D64046,"iPhone13,2"
Astrospheric.Astrospheric,22,1731101879,1731101901,1731101901.533194,-21600,EB445137-D7F5-57EC-87DA-1DB460D64046,"iPhone13,2"
com.instructure.icanvas,10,1731101862,1731101872,1731101872.9438272,-21600,EB445137-D7F5-57EC-87DA-1DB460D64046,"iPhone13,2"
com.microsoft.Office.Outlook,10,1731101848,1731101858,1731101858.8436952,-21600,EB445137-D7F5-57EC-87DA-1DB460D64046,"iPhone13,2"
com.toyopagroup.picaboo,80,1731101767,1731101847,1731101847.591404,-21600,EB445137-D7F5-57EC-87DA-1DB460D64046,"iPhone13,2"
com.microsoft.Office.Outlook,8,1731101759,1731101767,1731101767.193341,-21600,EB445137-D7F5-57EC-87DA-1DB460D64046,"iPhone13,2"
com.google.Chrome,3,1731101747,1731101750,1731101751.027956,-21600,,
com.leomehlig.today,4,1731101743,1731101747,1731101747.456483,-21600,,
com.google.Chrome,264,1731101479,1731101743,1731101743.750447,-21600,,
com.apple.Passwords,6,1731101464,1731101470,1731101470.586582,-21600,,
com.google.Chrome,20,1731101444,1731101464,1731101464.301059,-21600,,
com.microsoft.Office.Outlook,61,1731101384,1731101445,1731101445.929564,-21600,EB445137-D7F5-57EC-87DA-1DB460D64046,"iPhone13,2"
com.hammerandchisel.discord,48,1731101329,1731101377,1731101377.598033,-21600,EB445137-D7F5-57EC-87DA-1DB460D64046,"iPhone13,2"
com.apple.mobileslideshow,5,1731101324,1731101329,1731101330.474025,-21600,EB445137-D7F5-57EC-87DA-1DB460D64046,"iPhone13,2"
com.apple.finder,125,1731101274,1731101399,1731101399.427651,-21600,,
com.leomehlig.today,1,1731101273,1731101274,1731101274.734159,-21600,,
com.apple.Photos,1,1731101272,1731101273,1731101273.5927382,-21600,,
com.google.Chrome,26,1731101246,1731101272,1731101272.455289,-21600,,
com.leomehlig.today,24,1731101222,1731101246,1731101246.7387738,-21600,,
com.apple.mobileslideshow,10,1731101006,1731101016,1731101016.839253,-21600,EB445137-D7F5-57EC-87DA-1DB460D64046,"iPhone13,2"
com.google.Chrome,350,1731100872,1731101222,1731101222.615361,-21600,,
com.leomehlig.today,19,1731100853,1731100872,1731100873.051063,-21600,,
com.google.Chrome,24,1731100829,1731100853,1731100853.337171,-21600,,
com.apple.Photos,59,1731100770,1731100829,1731100829.5589972,-21600,,
com.apple.mobileslideshow,10,1731100667,1731100677,1731100677.313942,-21600,EB445137-D7F5-57EC-87DA-1DB460D64046,"iPhone13,2"
com.google.Chrome,149,1731100621,1731100770,1731100770.466871,-21600,,
com.microsoft.Excel,1,1731100620,1731100621,1731100621.8116322,-21600,,
com.google.Chrome,148,1731100472,1731100620,1731100620.727188,-21600,,
com.apple.finder,1,1731100471,1731100472,1731100472.6469312,-21600,,
com.apple.mobileslideshow,58,1731100466,1731100524,1731100525.662494,-21600,EB445137-D7F5-57EC-87DA-1DB460D64046,"iPhone13,2"
com.apple.camera,33,1731100431,1731100464,1731100472.505599,-21600,EB445137-D7F5-57EC-87DA-1DB460D64046,"iPhone13,2"
com.google.Chrome,349,1731100122,1731100471,1731100471.10397,-21600,,
com.apple.Photos,7,1731100115,1731100122,1731100122.675747,-21600,,
com.google.Chrome,161,1731099954,1731100115,1731100115.610606,-21600,,
com.apple.Photos,96,1731099858,1731099954,1731099954.909373,-21600,,
com.google.Chrome,1477,1731098381,1731099858,1731099858.351108,-21600,,
com.leomehlig.today,8,1731098361,1731098369,1731098369.083991,-21600,,
com.leomehlig.today,340,1731097857,1731098197,1731098197.2758179,-21600,,
com.microsoft.Excel,331,1731097526,1731097857,1731097857.4051862,-21600,,
com.apple.iCal,0,1731097526,1731097526,1731097526.747875,-21600,,
com.microsoft.Excel,28,1731097498,1731097526,1731097526.1614509,-21600,,
com.apple.iCal,1,1731097497,1731097498,1731097498.327662,-21600,,
com.microsoft.Excel,0,1731097497,1731097497,1731097497.986558,-21600,,
com.apple.iCal,3,1731097494,1731097497,1731097497.234966,-21600,,
com.apple.finder,3,1731097491,1731097494,1731097494.1532369,-21600,,
com.leomehlig.today,1,1731097490,1731097491,1731097491.545224,-21600,,
com.microsoft.Excel,43,1731097447,1731097490,1731097490.569047,-21600,,
com.leomehlig.today,1,1731097446,1731097447,1731097447.604181,-21600,,
com.apple.finder,1,1731097445,1731097446,1731097446.116881,-21600,,
com.apple.iCal,2,1731097443,1731097445,1731097445.391968,-21600,,
com.apple.finder,5,1731097438,1731097443,1731097443.140918,-21600,,
com.leomehlig.today,2,1731097436,1731097438,1731097438.308004,-21600,,
com.microsoft.Excel,189,1731097247,1731097436,1731097436.7161632,-21600,,
com.leomehlig.today,17,1731097230,1731097247,1731097247.158368,-21600,,
com.microsoft.Excel,144,1731097086,1731097230,1731097230.1545072,-21600,,
com.apple.finder,4,1731097082,1731097086,1731097086.799045,-21600,,
com.microsoft.Excel,0,1731097082,1731097082,1731097082.8526301,-21600,,
com.apple.finder,20,1731097062,1731097082,1731097082.1531901,-21600,,
com.apple.iCal,42,1731097020,1731097062,1731097062.821142,-21600,,
com.google.Chrome,11,1731097009,1731097020,1731097020.5103579,-21600,,
com.apple.iCal,66,1731096943,1731097009,1731097009.925025,-21600,,
com.google.Chrome,2,1731096941,1731096943,1731096943.405027,-21600,,
com.apple.iCal,4,1731096937,1731096941,1731096942.001071,-21600,,
com.google.Chrome,1,1731096936,1731096937,1731096937.5730329,-21600,,
com.apple.iCal,2,1731096934,1731096936,1731096936.22084,-21600,,
com.google.Chrome,2,1731096932,1731096934,1731096934.167976,-21600,,
com.apple.iCal,10,1731096922,1731096932,1731096932.0997338,-21600,,
com.google.Chrome,9,1731096913,1731096922,1731096922.838865,-21600,,
com.apple.iCal,48,1731096865,1731096913,1731096913.538176,-21600,,
com.google.Chrome,1,1731096864,1731096865,1731096865.5269,-21600,,
com.apple.iCal,5,1731096859,1731096864,1731096864.3660579,-21600,,
com.google.Chrome,2,1731096857,1731096859,1731096859.122278,-21600,,
com.apple.iCal,4,1731096853,1731096857,1731096857.8095322,-21600,,
com.google.Chrome,26,1731096827,1731096853,1731096854.051097,-21600,,
com.apple.iCal,25,1731096802,1731096827,1731096827.856135,-21600,,
com.google.Chrome,7,1731096795,1731096802,1731096802.111058,-21600,,
com.apple.iCal,25,1731096770,1731096795,1731096795.714637,-21600,,
com.google.Chrome,7,1731096763,1731096770,1731096770.940577,-21600,,
com.apple.iCal,3,1731096760,1731096763,1731096763.573731,-21600,,
com.google.Chrome,1,1731096759,1731096760,1731096760.67011,-21600,,
com.apple.iCal,10,1731096749,1731096759,1731096759.3522491,-21600,,
com.google.Chrome,6,1731096743,1731096749,1731096749.471827,-21600,,
com.apple.iCal,158,1731096585,1731096743,1731096743.216687,-21600,,
com.google.Chrome,3,1731096582,1731096585,1731096585.737417,-21600,,
com.apple.iCal,19,1731096563,1731096582,1731096582.148604,-21600,,
com.google.Chrome,1,1731096562,1731096563,1731096563.662372,-21600,,
com.apple.iCal,2,1731096560,1731096562,1731096562.0821261,-21600,,
com.google.Chrome,9,1731096551,1731096560,1731096560.543816,-21600,,
com.apple.iCal,11,1731096540,1731096551,1731096551.88658,-21600,,
com.google.Chrome,6,1731096534,1731096540,1731096540.946399,-21600,,
com.apple.iCal,21,1731096513,1731096534,1731096534.456818,-21600,,
com.google.Chrome,1,1731096512,1731096513,1731096513.7875829,-21600,,
com.apple.iCal,12,1731096500,1731096512,1731096512.243225,-21600,,
com.google.Chrome,11,1731096489,1731096500,1731096500.101079,-21600,,
com.apple.iCal,1,1731096488,1731096489,1731096489.5101418,-21600,,
com.google.Chrome,1,1731096487,1731096488,1731096488.674423,-21600,,
com.apple.iCal,43,1731096444,1731096487,1731096487.323004,-21600,,
com.google.Chrome,10,1731096434,1731096444,1731096444.397927,-21600,,
com.apple.iCal,75,1731096359,1731096434,1731096434.9367461,-21600,,
com.google.Chrome,1,1731096358,1731096359,1731096359.9013782,-21600,,
com.apple.iCal,15,1731096343,1731096358,1731096358.584494,-21600,,
com.google.Chrome,2,1731096341,1731096343,1731096343.4360828,-21600,,
com.apple.iCal,7,1731096334,1731096341,1731096341.763856,-21600,,
com.google.Chrome,4,1731096330,1731096334,1731096334.211825,-21600,,
com.apple.iCal,15,1731096315,1731096330,1731096330.7275481,-21600,,
com.google.Chrome,1,1731096314,1731096315,1731096315.2086859,-21600,,
com.apple.iCal,3,1731096311,1731096314,1731096314.714683,-21600,,
com.google.Chrome,1,1731096310,1731096311,1731096311.932405,-21600,,
com.apple.iCal,2,1731096308,1731096310,1731096310.862216,-21600,,
com.google.Chrome,6,1731096302,1731096308,1731096308.6976418,-21600,,
com.apple.iCal,11,1731096291,1731096302,1731096302.7227669,-21600,,
com.google.Chrome,11,1731096280,1731096291,1731096291.490724,-21600,,
com.apple.iCal,2,1731096278,1731096280,1731096280.352731,-21600,,
com.google.Chrome,506,1731095772,1731096278,1731096278.5207,-21600,,
com.leomehlig.today,8,1731093524,1731093532,1731093532.327019,-21600,,
com.google.Chrome,2,1731093522,1731093524,1731093524.835102,-21600,,
com.leomehlig.today,49,1731093473,1731093522,1731093522.183636,-21600,,
com.google.Chrome,91,1731093382,1731093473,1731093473.178082,-21600,,
com.apple.camera,344,1731092732,1731093076,1731093076.684938,-21600,EB445137-D7F5-57EC-87DA-1DB460D64046,"iPhone13,2"
com.apple.MobileSMS,4,1731092541,1731092545,1731092545.9495878,-21600,EB445137-D7F5-57EC-87DA-1DB460D64046,"iPhone13,2"
com.apple.news,0,1731092541,1731092541,1731092543.1412559,-21600,EB445137-D7F5-57EC-87DA-1DB460D64046,"iPhone13,2"
com.apple.camera,1,1731092058,1731092059,1731092059.161879,-21600,EB445137-D7F5-57EC-87DA-1DB460D64046,"iPhone13,2"
com.apple.news,15,1731092054,1731092069,1731092069.492635,-21600,EB445137-D7F5-57EC-87DA-1DB460D64046,"iPhone13,2"
com.apple.news,2,1731092051,1731092053,1731092053.281173,-21600,EB445137-D7F5-57EC-87DA-1DB460D64046,"iPhone13,2"
com.apple.news,115,1731091897,1731092012,1731092012.388544,-21600,EB445137-D7F5-57EC-87DA-1DB460D64046,"iPhone13,2"
com.apple.news,135,1731091725,1731091860,1731091861.7757359,-21600,EB445137-D7F5-57EC-87DA-1DB460D64046,"iPhone13,2"
com.apple.news,10,1731091479,1731091489,1731091489.110379,-21600,EB445137-D7F5-57EC-87DA-1DB460D64046,"iPhone13,2"
com.apple.news,52,1731091333,1731091385,1731091385.408585,-21600,EB445137-D7F5-57EC-87DA-1DB460D64046,"iPhone13,2"
com.microsoft.Office.Outlook,45,1731091277,1731091322,1731091322.554147,-21600,EB445137-D7F5-57EC-87DA-1DB460D64046,"iPhone13,2"
com.apple.news,6,1731091271,1731091277,1731091277.4692721,-21600,EB445137-D7F5-57EC-87DA-1DB460D64046,"iPhone13,2"
com.apple.news,184,1731090996,1731091180,1731091180.770307,-21600,EB445137-D7F5-57EC-87DA-1DB460D64046,"iPhone13,2"
com.apple.news,9,1731090800,1731090809,1731090809.5832129,-21600,EB445137-D7F5-57EC-87DA-1DB460D64046,"iPhone13,2"
com.microsoft.Office.Outlook,11,1731090786,1731090797,1731090798.110014,-21600,EB445137-D7F5-57EC-87DA-1DB460D64046,"iPhone13,2"
com.apple.news,15,1731090757,1731090772,1731090772.687735,-21600,EB445137-D7F5-57EC-87DA-1DB460D64046,"iPhone13,2"
com.apple.Preferences,41,1731090715,1731090756,1731090756.433824,-21600,EB445137-D7F5-57EC-87DA-1DB460D64046,"iPhone13,2"
com.apple.Preferences,30,1731090673,1731090703,1731090703.985488,-21600,EB445137-D7F5-57EC-87DA-1DB460D64046,"iPhone13,2"
com.apple.Preferences,4,1731090668,1731090672,1731090672.5285249,-21600,EB445137-D7F5-57EC-87DA-1DB460D64046,"iPhone13,2"
com.apple.Music,21,1731090643,1731090664,1731090664.543659,-21600,EB445137-D7F5-57EC-87DA-1DB460D64046,"iPhone13,2"
com.apple.Music,10,1731090053,1731090063,1731090063.2134418,-21600,EB445137-D7F5-57EC-87DA-1DB460D64046,"iPhone13,2"
com.apple.Music,40,1731088386,1731088426,1731088426.987598,-21600,EB445137-D7F5-57EC-87DA-1DB460D64046,"iPhone13,2"
com.apple.podcasts,29,1731088357,1731088386,1731088387.053441,-21600,EB445137-D7F5-57EC-87DA-1DB460D64046,"iPhone13,2"
com.apple.Music,7,1731088350,1731088357,1731088357.663072,-21600,EB445137-D7F5-57EC-87DA-1DB460D64046,"iPhone13,2"
com.apple.Health,10,1731088340,1731088350,1731088350.402219,-21600,EB445137-D7F5-57EC-87DA-1DB460D64046,"iPhone13,2"
com.apple.Health,23,1731088267,1731088290,1731088291.205344,-21600,EB445137-D7F5-57EC-87DA-1DB460D64046,"iPhone13,2"
com.apple.MobileSMS,15,1731088252,1731088267,1731088268.4082599,-21600,EB445137-D7F5-57EC-87DA-1DB460D64046,"iPhone13,2"
com.google.Chrome,130,1731088174,1731088304,1731088304.647603,-21600,,
com.apple.MobileSMS,8,1731087973,1731087981,1731087981.918231,-21600,EB445137-D7F5-57EC-87DA-1DB460D64046,"iPhone13,2"
com.apple.weather,10,1731087963,1731087973,1731087973.896446,-21600,EB445137-D7F5-57EC-87DA-1DB460D64046,"iPhone13,2"
com.google.Chrome,935,1731086328,1731087263,1731087264.00985,-21600,,
com.google.Chrome,739,1731085527,1731086266,1731086266.365936,-21600,,
com.leomehlig.today,2,1731085503,1731085505,1731085505.795164,-21600,,
com.apple.weather,11,1731080900,1731080911,1731080911.671062,-21600,EB445137-D7F5-57EC-87DA-1DB460D64046,"iPhone13,2"
com.apple.weather,1,1731080606,1731080607,1731080607.7080312,-21600,EB445137-D7F5-57EC-87DA-1DB460D64046,"iPhone13,2"
com.apple.weather,2,1731080413,1731080415,1731080415.803374,-21600,EB445137-D7F5-57EC-87DA-1DB460D64046,"iPhone13,2"
com.apple.weather,7,1731080144,1731080151,1731080151.8919911,-21600,EB445137-D7F5-57EC-87DA-1DB460D64046,"iPhone13,2"
com.renpho.health,2,1731080142,1731080144,1731080144.819308,-21600,EB445137-D7F5-57EC-87DA-1DB460D64046,"iPhone13,2"
com.renpho.health,25,1731080000,1731080025,1731080025.781083,-21600,EB445137-D7F5-57EC-87DA-1DB460D64046,"iPhone13,2"
com.instructure.icanvas,3,1731079997,1731080000,1731080000.5505009,-21600,EB445137-D7F5-57EC-87DA-1DB460D64046,"iPhone13,2"
com.instructure.icanvas,13,1731079160,1731079173,1731079173.167557,-21600,EB445137-D7F5-57EC-87DA-1DB460D64046,"iPhone13,2"
com.instructure.icanvas,10,1731079137,1731079147,1731079147.700333,-21600,EB445137-D7F5-57EC-87DA-1DB460D64046,"iPhone13,2"
com.instructure.icanvas,10,1731078958,1731078968,1731078969.144678,-21600,EB445137-D7F5-57EC-87DA-1DB460D64046,"iPhone13,2"
com.instructure.icanvas,213,1731078742,1731078955,1731078955.8184218,-21600,EB445137-D7F5-57EC-87DA-1DB460D64046,"iPhone13,2"
com.google.chrome.ios,271,1731051013,1731051284,1731051285.088025,-21600,EB445137-D7F5-57EC-87DA-1DB460D64046,"iPhone13,2"
com.apple.mobiletimer,6,1731049394,1731049400,1731049400.033694,-21600,EB445137-D7F5-57EC-87DA-1DB460D64046,"iPhone13,2"
com.apple.mobiletimer,4,1731049387,1731049391,1731049392.02968,-21600,EB445137-D7F5-57EC-87DA-1DB460D64046,"iPhone13,2"
com.apple.mobiletimer,13,1731049374,1731049387,1731049387.9034429,-21600,EB445137-D7F5-57EC-87DA-1DB460D64046,"iPhone13,2"
com.leomehlig.today,3,1731049325,1731049328,1731049328.369798,-21600,,
com.microsoft.Outlook,1,1731049324,1731049325,1731049325.492135,-21600,,
com.google.Chrome,167,1731049157,1731049324,1731049324.8488479,-21600,,
com.google.Chrome,591,1731048373,1731048964,1731048964.179062,-21600,,
com.apple.camera,0,1731048335,1731048335,1731048335.7866101,-21600,EB445137-D7F5-57EC-87DA-1DB460D64046,"iPhone13,2"
com.google.Chrome,1171,1731046815,1731047986,1731047986.16812,-21600,,
com.google.Chrome,350,1731046456,1731046806,1731046806.2444448,-21600,,
com.google.Chrome,303,1731045612,1731045915,1731045915.357184,-21600,,
com.apple.MobileSMS,3,1731045158,1731045161,1731045162.210791,-21600,EB445137-D7F5-57EC-87DA-1DB460D64046,"iPhone13,2"
com.hammerandchisel.discord,4,1731045129,1731045133,1731045134.0549622,-21600,EB445137-D7F5-57EC-87DA-1DB460D64046,"iPhone13,2"
com.google.Chrome,1418,1731044073,1731045491,1731045491.858702,-21600,,
com.google.Chrome,308,1731043431,1731043739,1731043739.17347,-21600,,
com.leomehlig.today,4,1731043427,1731043431,1731043431.3000789,-21600,,
com.microsoft.Outlook,4,1731043423,1731043427,1731043427.223493,-21600,,
com.google.Chrome,215,1731043208,1731043423,1731043424.3941522,-21600,,
com.google.Chrome,3134,1731040011,1731043145,1731043145.624042,-21600,,
com.google.Chrome,1527,1731038434,1731039961,1731039961.14634,-21600,,
com.hammerandchisel.discord,2,1731038404,1731038406,1731038406.489801,-21600,EB445137-D7F5-57EC-87DA-1DB460D64046,"iPhone13,2"
com.hammerandchisel.discord,6,1731036693,1731036699,1731036700.3068109,-21600,EB445137-D7F5-57EC-87DA-1DB460D64046,"iPhone13,2"
com.hammerandchisel.discord,5,1731036685,1731036690,1731036690.8610802,-21600,EB445137-D7F5-57EC-87DA-1DB460D64046,"iPhone13,2"
com.hammerandchisel.discord,2,1731036682,1731036684,1731036684.93395,-21600,EB445137-D7F5-57EC-87DA-1DB460D64046,"iPhone13,2"
com.hammerandchisel.discord,44,1731035562,1731035606,1731035607.232792,-21600,EB445137-D7F5-57EC-87DA-1DB460D64046,"iPhone13,2"
com.apple.news,2,1731035559,1731035561,1731035561.97084,-21600,EB445137-D7F5-57EC-87DA-1DB460D64046,"iPhone13,2"
com.apple.news,3,1731035547,1731035550,1731035550.4733949,-21600,EB445137-D7F5-57EC-87DA-1DB460D64046,"iPhone13,2"
com.apple.news,1,1731035545,1731035546,1731035546.488401,-21600,EB445137-D7F5-57EC-87DA-1DB460D64046,"iPhone13,2"
com.apple.news,14,1731035014,1731035028,1731035028.533505,-21600,EB445137-D7F5-57EC-87DA-1DB460D64046,"iPhone13,2"
com.apple.news,412,1731033179,1731033591,1731033591.6176229,-21600,EB445137-D7F5-57EC-87DA-1DB460D64046,"iPhone13,2"
com.microsoft.Office.Outlook,19,1731033141,1731033160,1731033160.383648,-21600,EB445137-D7F5-57EC-87DA-1DB460D64046,"iPhone13,2"
com.apple.MobileSMS,3,1731033137,1731033140,1731033140.884928,-21600,EB445137-D7F5-57EC-87DA-1DB460D64046,"iPhone13,2"
com.apple.MobileSMS,8,1731029449,1731029457,1731029457.36438,-21600,EB445137-D7F5-57EC-87DA-1DB460D64046,"iPhone13,2"
com.instructure.icanvas,51,1731029396,1731029447,1731029447.287342,-21600,EB445137-D7F5-57EC-87DA-1DB460D64046,"iPhone13,2"
com.clairmail.fth.client,42,1731029349,1731029391,1731029392.056611,-21600,EB445137-D7F5-57EC-87DA-1DB460D64046,"iPhone13,2"
com.apple.MobileSMS,25,1731029321,1731029346,1731029346.118585,-21600,EB445137-D7F5-57EC-87DA-1DB460D64046,"iPhone13,2"
com.microsoft.Office.Outlook,2,1731029319,1731029321,1731029322.3143082,-21600,EB445137-D7F5-57EC-87DA-1DB460D64046,"iPhone13,2"
com.microsoft.Office.Outlook,1,1731028436,1731028437,1731028437.989511,-21600,EB445137-D7F5-57EC-87DA-1DB460D64046,"iPhone13,2"
com.microsoft.Office.Outlook,1,1731028211,1731028212,1731028212.897598,-21600,EB445137-D7F5-57EC-87DA-1DB460D64046,"iPhone13,2"
com.microsoft.Office.Outlook,5,1731028206,1731028211,1731028211.356862,-21600,EB445137-D7F5-57EC-87DA-1DB460D64046,"iPhone13,2"
com.microsoft.Office.Outlook,16,1731026585,1731026601,1731026601.455879,-21600,EB445137-D7F5-57EC-87DA-1DB460D64046,"iPhone13,2"
com.apple.MobileSMS,21,1731026526,1731026547,1731026547.38872,-21600,EB445137-D7F5-57EC-87DA-1DB460D64046,"iPhone13,2"
com.apple.weather,6,1731026520,1731026526,1731026526.8862581,-21600,EB445137-D7F5-57EC-87DA-1DB460D64046,"iPhone13,2"
com.apple.weather,4,1731026494,1731026498,1731026498.9795852,-21600,EB445137-D7F5-57EC-87DA-1DB460D64046,"iPhone13,2"
com.instructure.icanvas,7,1731024624,1731024631,1731024631.45555,-21600,EB445137-D7F5-57EC-87DA-1DB460D64046,"iPhone13,2"
com.apple.news,7,1731024617,1731024624,1731024625.049979,-21600,EB445137-D7F5-57EC-87DA-1DB460D64046,"iPhone13,2"
com.apple.news,3,1731024613,1731024616,1731024616.667392,-21600,EB445137-D7F5-57EC-87DA-1DB460D64046,"iPhone13,2"
com.apple.news,182,1731021968,1731022150,1731022151.091655,-21600,EB445137-D7F5-57EC-87DA-1DB460D64046,"iPhone13,2"
com.instructure.icanvas,11,1731021955,1731021966,1731021966.695657,-21600,EB445137-D7F5-57EC-87DA-1DB460D64046,"iPhone13,2"
com.apple.news,7,1731021948,1731021955,1731021956.804511,-21600,EB445137-D7F5-57EC-87DA-1DB460D64046,"iPhone13,2"
com.apple.news,209,1731021681,1731021890,1731021890.8470101,-21600,EB445137-D7F5-57EC-87DA-1DB460D64046,"iPhone13,2"
com.hammerandchisel.discord,105,1731021497,1731021602,1731021602.3628058,-21600,EB445137-D7F5-57EC-87DA-1DB460D64046,"iPhone13,2"
com.instructure.icanvas,6,1731021249,1731021255,1731021255.651448,-21600,EB445137-D7F5-57EC-87DA-1DB460D64046,"iPhone13,2"
com.google.chrome.ios,8,1731021241,1731021249,1731021249.914342,-21600,EB445137-D7F5-57EC-87DA-1DB460D64046,"iPhone13,2"
com.google.chrome.ios,28,1731020116,1731020144,1731020144.655999,-21600,EB445137-D7F5-57EC-87DA-1DB460D64046,"iPhone13,2"
com.hammerandchisel.discord,117,1731019998,1731020115,1731020115.920217,-21600,EB445137-D7F5-57EC-87DA-1DB460D64046,"iPhone13,2"
com.apple.news,6,1731019992,1731019998,1731019999.332279,-21600,EB445137-D7F5-57EC-87DA-1DB460D64046,"iPhone13,2"
com.google.Chrome,301,1731019988,1731020289,1731020289.444493,-21600,,
com.leomehlig.today,70,1731019918,1731019988,1731019988.146081,-21600,,
com.google.Chrome,88,1731019830,1731019918,1731019918.218337,-21600,,
com.apple.finder,2,1731019828,1731019830,1731019830.249855,-21600,,
com.apple.MobileSMS,111,1731019717,1731019828,1731019828.048176,-21600,,
com.google.Chrome,151,1731019566,1731019717,1731019717.6091151,-21600,,
com.leomehlig.today,5,1731019561,1731019566,1731019566.6072822,-21600,,
com.apple.iCal,13,1731019548,1731019561,1731019561.563483,-21600,,
com.leomehlig.today,29,1731019519,1731019548,1731019548.9969401,-21600,,
com.google.Chrome,14,1731019505,1731019519,1731019519.137325,-21600,,
com.apple.calculator,23,1731019482,1731019505,1731019505.5364661,-21600,,
com.apple.news,13,1731019482,1731019495,1731019495.7506108,-21600,EB445137-D7F5-57EC-87DA-1DB460D64046,"iPhone13,2"
com.apple.news,11,1731019241,1731019252,1731019252.325138,-21600,EB445137-D7F5-57EC-87DA-1DB460D64046,"iPhone13,2"
com.apple.news,197,1731019006,1731019203,1731019203.21237,-21600,EB445137-D7F5-57EC-87DA-1DB460D64046,"iPhone13,2"
com.google.chrome.ios,4,1731019002,1731019006,1731019007.7667608,-21600,EB445137-D7F5-57EC-87DA-1DB460D64046,"iPhone13,2"
com.google.Chrome,499,1731018983,1731019482,1731019482.9327378,-21600,,
com.microsoft.Outlook,54,1731018900,1731018954,1731018954.833811,-21600,,
com.google.Chrome,20,1731018880,1731018900,1731018900.082577,-21600,,
com.leomehlig.today,64,1731018816,1731018880,1731018880.571125,-21600,,
com.microsoft.VSCode,2,1731018814,1731018816,1731018816.915421,-21600,,
com.google.chrome.ios,29,1731018595,1731018624,1731018625.034195,-21600,EB445137-D7F5-57EC-87DA-1DB460D64046,"iPhone13,2"
com.apple.findmy,1,1731018591,1731018592,1731018595.272203,-21600,EB445137-D7F5-57EC-87DA-1DB460D64046,"iPhone13,2"
com.apple.findmy,10,1731018537,1731018547,1731018548.158315,-21600,EB445137-D7F5-57EC-87DA-1DB460D64046,"iPhone13,2"
com.microsoft.Office.Outlook,78,1731018178,1731018256,1731018256.9223409,-21600,EB445137-D7F5-57EC-87DA-1DB460D64046,"iPhone13,2"
com.toyopagroup.picaboo,15,1731018157,1731018172,1731018173.179593,-21600,EB445137-D7F5-57EC-87DA-1DB460D64046,"iPhone13,2"
com.microsoft.VSCode,5,1731018048,1731018053,1731018053.6550078,-21600,,
com.google.Chrome,50,1731017998,1731018048,1731018048.365881,-21600,,
com.leomehlig.today,463,1731017535,1731017998,1731017998.309195,-21600,,
com.google.Chrome,1,1731017534,1731017535,1731017535.02965,-21600,,
com.leomehlig.today,1,1731017533,1731017534,1731017534.096694,-21600,,
com.google.Chrome,1,1731017532,1731017533,1731017533.237314,-21600,,
com.leomehlig.today,2,1731017530,1731017532,1731017532.322205,-21600,,
com.google.Chrome,84,1731017446,1731017530,1731017530.449545,-21600,,
com.leomehlig.today,7,1731017439,1731017446,1731017447.039304,-21600,,
com.google.Chrome,34,1731017405,1731017439,1731017439.2573829,-21600,,
com.leomehlig.today,5,1731017400,1731017405,1731017405.088737,-21600,,
com.microsoft.VSCode,54,1731017346,1731017400,1731017400.365251,-21600,,
com.apple.finder,19,1731017327,1731017346,1731017346.654453,-21600,,
com.google.Chrome,30,1731017297,1731017327,1731017327.7499619,-21600,,
com.leomehlig.today,3,1731017294,1731017297,1731017297.170953,-21600,,
com.google.Chrome,71,1731017223,1731017294,1731017294.156748,-21600,,
com.leomehlig.today,11,1731017212,1731017223,1731017223.995116,-21600,,
com.microsoft.Outlook,70,1731017142,1731017212,1731017212.5886822,-21600,,
com.microsoft.VSCode,20,1731017122,1731017142,1731017142.774829,-21600,,
com.google.Chrome,62,1731017060,1731017122,1731017122.361429,-21600,,
com.microsoft.Outlook,4,1731017056,1731017060,1731017060.709688,-21600,,
com.google.Chrome,36,1731017020,1731017056,1731017056.784416,-21600,,
com.microsoft.Outlook,3,1731017017,1731017020,1731017020.6427,-21600,,
com.google.Chrome,110,1731016907,1731017017,1731017017.5725632,-21600,,
com.microsoft.VSCode,57,1731016850,1731016907,1731016907.548295,-21600,,
com.google.Chrome,68,1731016782,1731016850,1731016850.83844,-21600,,
com.microsoft.VSCode,6,1731016776,1731016782,1731016782.104405,-21600,,
com.google.Chrome,4,1731016772,1731016776,1731016776.0782552,-21600,,
com.microsoft.VSCode,7,1731016765,1731016772,1731016772.222662,-21600,,
com.google.Chrome,30,1731016735,1731016765,1731016765.559712,-21600,,
com.microsoft.VSCode,7,1731016728,1731016735,1731016735.777313,-21600,,
com.google.Chrome,1,1731016727,1731016728,1731016728.8983989,-21600,,
com.microsoft.VSCode,28,1731016699,1731016727,1731016727.730835,-21600,,
com.google.Chrome,13,1731016686,1731016699,1731016699.967804,-21600,,
com.microsoft.VSCode,3,1731016683,1731016686,1731016686.746772,-21600,,
com.google.Chrome,13,1731016670,1731016683,1731016683.389728,-21600,,
com.microsoft.VSCode,12,1731016658,1731016670,1731016670.356289,-21600,,
com.google.Chrome,3,1731016655,1731016658,1731016658.440909,-21600,,
com.microsoft.VSCode,19,1731016636,1731016655,1731016655.82789,-21600,,
com.google.Chrome,24,1731016612,1731016636,1731016637.0373778,-21600,,
com.microsoft.VSCode,3,1731016609,1731016612,1731016612.682203,-21600,,
com.google.Chrome,8,1731016601,1731016609,1731016609.474944,-21600,,
com.microsoft.VSCode,927,1731015674,1731016601,1731016601.1814651,-21600,,
com.apple.finder,8,1731015666,1731015674,1731015674.2307029,-21600,,
com.google.Chrome,10,1731015656,1731015666,1731015666.603061,-21600,,
com.microsoft.VSCode,24,1731015632,1731015656,1731015656.424288,-21600,,
com.google.Chrome,15,1731015617,1731015632,1731015632.58364,-21600,,
com.microsoft.VSCode,8,1731015609,1731015617,1731015617.685004,-21600,,
com.google.Chrome,2,1731015607,1731015609,1731015609.173868,-21600,,
com.apple.Passwords,15,1731015592,1731015607,1731015607.3956342,-21600,,
com.google.Chrome,39,1731015553,1731015592,1731015592.854518,-21600,,
com.apple.Passwords,9,1731015544,1731015553,1731015553.427853,-21600,,
com.google.Chrome,64,1731015480,1731015544,1731015544.9178019,-21600,,
com.microsoft.VSCode,2,1731015478,1731015480,1731015480.0946531,-21600,,
com.google.Chrome,30,1731015448,1731015478,1731015478.44198,-21600,,
com.microsoft.VSCode,8,1731015440,1731015448,1731015448.354566,-21600,,
com.google.Chrome,6,1731015434,1731015440,1731015440.592448,-21600,,
com.microsoft.VSCode,3,1731015431,1731015434,1731015434.4471822,-21600,,
com.google.Chrome,31,1731015400,1731015431,1731015431.199846,-21600,,
com.microsoft.VSCode,3,1731015397,1731015400,1731015400.32646,-21600,,
com.google.Chrome,3,1731015394,1731015397,1731015397.22275,-21600,,
com.microsoft.VSCode,115,1731015279,1731015394,1731015394.413475,-21600,,
com.apple.finder,26,1731015253,1731015279,1731015279.423693,-21600,,
com.google.Chrome,62,1731015191,1731015253,1731015253.1503348,-21600,,
com.leomehlig.today,20,1731015171,1731015191,1731015191.941639,-21600,,
com.google.Chrome,421,1731014750,1731015171,1731015171.524945,-21600,,
com.leomehlig.today,1,1731014749,1731014750,1731014750.342647,-21600,,
com.google.Chrome,4,1731014745,1731014749,1731014750.062293,-21600,,
com.google.Chrome,3,1731014644,1731014647,1731014647.98566,-21600,,
com.apple.camera,1,1731013803,1731013804,1731013804.698226,-21600,EB445137-D7F5-57EC-87DA-1DB460D64046,"iPhone13,2"
com.google.Chrome,1139,1731013505,1731014644,1731014644.663405,-21600,,
com.leomehlig.today,60,1731013445,1731013505,1731013505.2477288,-21600,,
com.google.Chrome,16,1731013429,1731013445,1731013445.6531181,-21600,,
com.leomehlig.today,14,1731013404,1731013418,1731013419.654887,-21600,,
com.apple.iCal,9,1731013395,1731013404,1731013404.756813,-21600,,
com.leomehlig.today,65,1731013330,1731013395,1731013395.2551742,-21600,,
com.apple.iCal,11,1731013319,1731013330,1731013330.60012,-21600,,
com.leomehlig.today,4,1731013315,1731013319,1731013319.820689,-21600,,
com.hnc.Discord,1,1731013314,1731013315,1731013315.300263,-21600,,
com.leomehlig.today,2,1731013312,1731013314,1731013314.927783,-21600,,
com.google.Chrome,38,1731013274,1731013312,1731013312.5744228,-21600,,
com.microsoft.VSCode,6,1731013268,1731013274,1731013274.116706,-21600,,
com.apple.Preview,40,1731013228,1731013268,1731013268.114497,-21600,,
com.microsoft.VSCode,260,1731012968,1731013228,1731013228.50755,-21600,,
com.google.Chrome,1,1731012967,1731012968,1731012968.826136,-21600,,
com.microsoft.VSCode,9,1731012958,1731012967,1731012967.231306,-21600,,
com.google.Chrome,3,1731012955,1731012958,1731012958.792591,-21600,,
com.microsoft.VSCode,26,1731012929,1731012955,1731012955.421607,-21600,,
com.google.Chrome,39,1731012890,1731012929,1731012929.46172,-21600,,
com.microsoft.VSCode,39,1731012851,1731012890,1731012890.411053,-21600,,
com.google.Chrome,2,1731012849,1731012851,1731012851.057931,-21600,,
com.microsoft.VSCode,5,1731012844,1731012849,1731012849.2078,-21600,,
com.google.Chrome,2,1731012842,1731012844,1731012844.312687,-21600,,
com.microsoft.VSCode,4,1731012838,1731012842,1731012842.636126,-21600,,
com.google.Chrome,1,1731012837,1731012838,1731012838.326437,-21600,,
com.microsoft.VSCode,7,1731012830,1731012837,1731012837.108124,-21600,,
com.google.Chrome,2,1731012828,1731012830,1731012831.0888782,-21600,,
com.microsoft.VSCode,4,1731012824,1731012828,1731012828.9624228,-21600,,
com.google.Chrome,0,1731012824,1731012824,1731012824.956423,-21600,,
com.microsoft.VSCode,4,1731012820,1731012824,1731012824.418244,-21600,,
com.google.Chrome,1,1731012819,1731012820,1731012820.267437,-21600,,
com.microsoft.VSCode,6,1731012813,1731012819,1731012819.1594028,-21600,,
com.google.Chrome,31,1731012782,1731012813,1731012813.2873402,-21600,,
com.microsoft.VSCode,55,1731012727,1731012782,1731012782.731034,-21600,,
com.google.Chrome,6,1731012721,1731012727,1731012727.37919,-21600,,
com.microsoft.VSCode,24,1731012697,1731012721,1731012721.726171,-21600,,
com.google.Chrome,6,1731012691,1731012697,1731012697.126905,-21600,,
com.microsoft.VSCode,3,1731012688,1731012691,1731012691.287287,-21600,,
com.google.Chrome,1,1731012687,1731012688,1731012688.1894732,-21600,,
com.microsoft.VSCode,6,1731012681,1731012687,1731012687.0773969,-21600,,
com.google.Chrome,7,1731012674,1731012681,1731012681.8357701,-21600,,
com.microsoft.VSCode,8,1731012666,1731012674,1731012674.2877069,-21600,,
com.google.Chrome,27,1731012639,1731012666,1731012666.263289,-21600,,
Astrospheric.Astrospheric,21,1731012258,1731012279,1731012279.776157,-21600,EB445137-D7F5-57EC-87DA-1DB460D64046,"iPhone13,2"
com.microsoft.VSCode,389,1731012250,1731012639,1731012639.640913,-21600,,
com.apple.finder,2,1731012248,1731012250,1731012250.406111,-21600,,
com.hnc.Discord,25,1731012223,1731012248,1731012248.573947,-21600,,
com.apple.finder,8,1731012215,1731012223,1731012223.2365909,-21600,,
com.apple.finder,51,1731010851,1731010902,1731010902.437481,-21600,,
com.hnc.Discord,14,1731010837,1731010851,1731010851.2191792,-21600,,
com.microsoft.VSCode,149,1731010688,1731010837,1731010837.1103,-21600,,
com.google.Chrome,27,1731010661,1731010688,1731010688.169815,-21600,,
com.microsoft.VSCode,132,1731010529,1731010661,1731010661.952764,-21600,,
com.google.Chrome,29,1731010500,1731010529,1731010529.4560552,-21600,,
com.microsoft.VSCode,106,1731010394,1731010500,1731010500.158495,-21600,,
com.google.Chrome,38,1731010028,1731010066,1731010066.4927468,-21600,,
com.microsoft.VSCode,146,1731009882,1731010028,1731010028.5351439,-21600,,
com.apple.finder,3,1731009879,1731009882,1731009882.319922,-21600,,
com.google.Chrome,44,1731009835,1731009879,1731009879.606491,-21600,,
com.apple.finder,72,1731009763,1731009835,1731009835.141097,-21600,,
com.google.Chrome,5,1731009758,1731009763,1731009763.179671,-21600,,
com.google.Chrome,10,1731008923,1731008933,1731008933.894583,-21600,,
com.apple.finder,14,1731008909,1731008923,1731008923.435999,-21600,,
com.apple.finder,145,1731008265,1731008410,1731008410.75381,-21600,,
com.apple.finder,301,1731007795,1731008096,1731008096.7540898,-21600,,
com.google.Chrome,18,1731007777,1731007795,1731007795.535349,-21600,,
com.apple.finder,289,1731007488,1731007777,1731007777.8179832,-21600,,
com.google.Chrome,29,1731007459,1731007488,1731007488.946835,-21600,,
com.apple.finder,152,1731007307,1731007459,1731007459.361732,-21600,,
com.apple.archiveutility,0,1731007307,1731007307,1731007307.666595,-21600,,
com.apple.finder,4,1731007303,1731007307,1731007307.2187629,-21600,,
com.google.Chrome,61,1731007242,1731007303,1731007303.659863,-21600,,
com.google.Chrome,367,1731006526,1731006893,1731006893.578788,-21600,,
com.microsoft.VSCode,2,1731006524,1731006526,1731006526.698828,-21600,,
com.toyopagroup.picaboo,5,1731006114,1731006119,1731006119.69703,-21600,EB445137-D7F5-57EC-87DA-1DB460D64046,"iPhone13,2"
com.instructure.icanvas,44,1731006070,1731006114,1731006114.996894,-21600,EB445137-D7F5-57EC-87DA-1DB460D64046,"iPhone13,2"
com.google.chrome.ios,16,1731006054,1731006070,1731006070.3513942,-21600,EB445137-D7F5-57EC-87DA-1DB460D64046,"iPhone13,2"
com.google.chrome.ios,14,1731006039,1731006053,1731006053.424096,-21600,EB445137-D7F5-57EC-87DA-1DB460D64046,"iPhone13,2"
com.apple.camera,7,1731005951,1731005958,1731005959.2834291,-21600,EB445137-D7F5-57EC-87DA-1DB460D64046,"iPhone13,2"
com.google.chrome.ios,8,1731005950,1731005958,1731005959.5000238,-21600,EB445137-D7F5-57EC-87DA-1DB460D64046,"iPhone13,2"
com.google.chrome.ios,19,1731005645,1731005664,1731005665.331409,-21600,EB445137-D7F5-57EC-87DA-1DB460D64046,"iPhone13,2"
com.google.chrome.ios,4,1731005626,1731005630,1731005631.000148,-21600,EB445137-D7F5-57EC-87DA-1DB460D64046,"iPhone13,2"
com.apple.weather,2,1731005624,1731005626,1731005626.847402,-21600,EB445137-D7F5-57EC-87DA-1DB460D64046,"iPhone13,2"
com.apple.camera,8,1731005280,1731005288,1731005289.179687,-21600,EB445137-D7F5-57EC-87DA-1DB460D64046,"iPhone13,2"
com.apple.weather,11,1731005277,1731005288,1731005289.1305041,-21600,EB445137-D7F5-57EC-87DA-1DB460D64046,"iPhone13,2"
com.apple.weather,7,1731005072,1731005079,1731005079.9897962,-21600,EB445137-D7F5-57EC-87DA-1DB460D64046,"iPhone13,2"
com.microsoft.VSCode,91,1731004919,1731005010,1731005010.243338,-21600,,
com.google.Chrome,55,1731004864,1731004919,1731004919.636028,-21600,,
com.toyopagroup.picaboo,26,1731004837,1731004863,1731004863.7563372,-21600,EB445137-D7F5-57EC-87DA-1DB460D64046,"iPhone13,2"
com.microsoft.VSCode,344,1731004520,1731004864,1731004864.8955688,-21600,,
com.google.Chrome,42,1731004478,1731004520,1731004520.225075,-21600,,
com.microsoft.VSCode,2,1731004476,1731004478,1731004478.038014,-21600,,
com.google.Chrome,9,1731004467,1731004476,1731004476.081456,-21600,,
com.microsoft.VSCode,105,1731004362,1731004467,1731004467.825599,-21600,,
com.google.Chrome,4,1731004358,1731004362,1731004362.655223,-21600,,
com.microsoft.VSCode,1,1731004357,1731004358,1731004358.824693,-21600,,
com.google.Chrome,29,1731004328,1731004357,1731004357.771976,-21600,,
com.microsoft.VSCode,276,1731004052,1731004328,1731004328.551373,-21600,,
com.google.Chrome,4,1731004048,1731004052,1731004052.220783,-21600,,
com.microsoft.VSCode,5,1731004043,1731004048,1731004048.7475948,-21600,,
com.google.Chrome,2,1731004041,1731004043,1731004043.583637,-21600,,
com.microsoft.VSCode,11,1731004030,1731004041,1731004041.9401898,-21600,,
com.google.Chrome,59,1731003971,1731004030,1731004030.645767,-21600,,
com.microsoft.VSCode,3,1731003968,1731003971,1731003971.136374,-21600,,
com.google.Chrome,1,1731003967,1731003968,1731003968.789294,-21600,,
com.microsoft.VSCode,23,1731003944,1731003967,1731003967.129506,-21600,,
com.google.Chrome,13,1731003931,1731003944,1731003944.38785,-21600,,
com.microsoft.VSCode,47,1731003884,1731003931,1731003931.7942429,-21600,,
com.google.Chrome,19,1731003865,1731003884,1731003884.343149,-21600,,
com.microsoft.VSCode,6,1731003859,1731003865,1731003865.998985,-21600,,
com.google.Chrome,91,1731003768,1731003859,1731003859.5186691,-21600,,
com.microsoft.VSCode,23,1731003745,1731003768,1731003769.0431871,-21600,,
com.toyopagroup.picaboo,78,1731003687,1731003765,1731003765.607058,-21600,EB445137-D7F5-57EC-87DA-1DB460D64046,"iPhone13,2"
com.google.Chrome,127,1731003618,1731003745,1731003746.0107899,-21600,,
com.toyopagroup.picaboo,61,1731003616,1731003677,1731003677.621715,-21600,EB445137-D7F5-57EC-87DA-1DB460D64046,"iPhone13,2"
com.apple.camera,8,1731002337,1731002345,1731002346.331404,-21600,EB445137-D7F5-57EC-87DA-1DB460D64046,"iPhone13,2"
com.hammerandchisel.discord,7,1731002333,1731002340,1731002340.1660318,-21600,EB445137-D7F5-57EC-87DA-1DB460D64046,"iPhone13,2"
com.google.Chrome,798,1731001010,1731001808,1731001808.3304648,-21600,,
com.google.Chrome,772,1730999041,1730999813,1730999813.3370829,-21600,,
com.hammerandchisel.discord,10,1730998939,1730998949,1730998949.516118,-21600,EB445137-D7F5-57EC-87DA-1DB460D64046,"iPhone13,2"
com.hammerandchisel.discord,1,1730998555,1730998556,1730998556.731169,-21600,EB445137-D7F5-57EC-87DA-1DB460D64046,"iPhone13,2"
com.apple.camera,0,1730998544,1730998544,1730998544.446477,-21600,EB445137-D7F5-57EC-87DA-1DB460D64046,"iPhone13,2"
com.apple.camera,0,1730998536,1730998536,1730998536.7181048,-21600,EB445137-D7F5-57EC-87DA-1DB460D64046,"iPhone13,2"
com.apple.camera,0,1730998533,1730998533,1730998533.572002,-21600,EB445137-D7F5-57EC-87DA-1DB460D64046,"iPhone13,2"
com.apple.camera,1,1730998530,1730998531,1730998531.366041,-21600,EB445137-D7F5-57EC-87DA-1DB460D64046,"iPhone13,2"
com.apple.camera,1,1730998524,1730998525,1730998525.352446,-21600,EB445137-D7F5-57EC-87DA-1DB460D64046,"iPhone13,2"
com.apple.camera,0,1730998524,1730998524,1730998524.5357509,-21600,EB445137-D7F5-57EC-87DA-1DB460D64046,"iPhone13,2"
com.apple.camera,1,1730998519,1730998520,1730998520.0750751,-21600,EB445137-D7F5-57EC-87DA-1DB460D64046,"iPhone13,2"
com.apple.camera,0,1730998518,1730998518,1730998518.642416,-21600,EB445137-D7F5-57EC-87DA-1DB460D64046,"iPhone13,2"
com.apple.camera,0,1730998517,1730998517,1730998517.55344,-21600,EB445137-D7F5-57EC-87DA-1DB460D64046,"iPhone13,2"
com.apple.camera,0,1730998511,1730998511,1730998511.871897,-21600,EB445137-D7F5-57EC-87DA-1DB460D64046,"iPhone13,2"
com.apple.camera,0,1730998508,1730998508,1730998509.128092,-21600,EB445137-D7F5-57EC-87DA-1DB460D64046,"iPhone13,2"
com.apple.camera,1,1730998504,1730998505,1730998505.468046,-21600,EB445137-D7F5-57EC-87DA-1DB460D64046,"iPhone13,2"
com.apple.camera,1,1730998503,1730998504,1730998504.47193,-21600,EB445137-D7F5-57EC-87DA-1DB460D64046,"iPhone13,2"
com.apple.camera,0,1730998500,1730998500,1730998500.2541552,-21600,EB445137-D7F5-57EC-87DA-1DB460D64046,"iPhone13,2"
com.apple.camera,0,1730998499,1730998499,1730998499.948993,-21600,EB445137-D7F5-57EC-87DA-1DB460D64046,"iPhone13,2"
com.apple.camera,0,1730998498,1730998498,1730998498.20685,-21600,EB445137-D7F5-57EC-87DA-1DB460D64046,"iPhone13,2"
com.apple.camera,0,1730998490,1730998490,1730998490.153722,-21600,EB445137-D7F5-57EC-87DA-1DB460D64046,"iPhone13,2"
com.apple.camera,1,1730998488,1730998489,1730998489.3512769,-21600,EB445137-D7F5-57EC-87DA-1DB460D64046,"iPhone13,2"
com.apple.camera,0,1730998485,1730998485,1730998485.820462,-21600,EB445137-D7F5-57EC-87DA-1DB460D64046,"iPhone13,2"
com.apple.camera,0,1730998483,1730998483,1730998483.532043,-21600,EB445137-D7F5-57EC-87DA-1DB460D64046,"iPhone13,2"
com.apple.camera,1,1730998479,1730998480,1730998480.148227,-21600,EB445137-D7F5-57EC-87DA-1DB460D64046,"iPhone13,2"
com.apple.camera,1,1730998478,1730998479,1730998479.076501,-21600,EB445137-D7F5-57EC-87DA-1DB460D64046,"iPhone13,2"
com.apple.camera,0,1730998469,1730998469,1730998469.940999,-21600,EB445137-D7F5-57EC-87DA-1DB460D64046,"iPhone13,2"
com.apple.camera,0,1730998466,1730998466,1730998466.553872,-21600,EB445137-D7F5-57EC-87DA-1DB460D64046,"iPhone13,2"
com.apple.camera,0,1730998458,1730998458,1730998458.655877,-21600,EB445137-D7F5-57EC-87DA-1DB460D64046,"iPhone13,2"
com.apple.camera,0,1730998451,1730998451,1730998452.0011868,-21600,EB445137-D7F5-57EC-87DA-1DB460D64046,"iPhone13,2"
com.apple.camera,0,1730998420,1730998420,1730998420.276641,-21600,EB445137-D7F5-57EC-87DA-1DB460D64046,"iPhone13,2"
com.apple.camera,1,1730998416,1730998417,1730998417.222172,-21600,EB445137-D7F5-57EC-87DA-1DB460D64046,"iPhone13,2"
com.apple.camera,0,1730998413,1730998413,1730998413.945421,-21600,EB445137-D7F5-57EC-87DA-1DB460D64046,"iPhone13,2"
com.apple.camera,1,1730998407,1730998408,1730998408.355309,-21600,EB445137-D7F5-57EC-87DA-1DB460D64046,"iPhone13,2"
com.hammerandchisel.discord,153,1730998400,1730998553,1730998553.664437,-21600,EB445137-D7F5-57EC-87DA-1DB460D64046,"iPhone13,2"
com.hammerandchisel.discord,21,1730998375,1730998396,1730998396.8008761,-21600,EB445137-D7F5-57EC-87DA-1DB460D64046,"iPhone13,2"
com.apple.weather,16,1730998355,1730998371,1730998371.5513701,-21600,EB445137-D7F5-57EC-87DA-1DB460D64046,"iPhone13,2"
com.renpho.health,10,1730998324,1730998334,1730998334.651177,-21600,EB445137-D7F5-57EC-87DA-1DB460D64046,"iPhone13,2"
com.renpho.health,3,1730998008,1730998011,1730998011.621315,-21600,EB445137-D7F5-57EC-87DA-1DB460D64046,"iPhone13,2"
com.renpho.health,10,1730997678,1730997688,1730997688.1061292,-21600,EB445137-D7F5-57EC-87DA-1DB460D64046,"iPhone13,2"
com.renpho.health,3,1730997608,1730997611,1730997611.3812551,-21600,EB445137-D7F5-57EC-87DA-1DB460D64046,"iPhone13,2"
com.renpho.health,61,1730997511,1730997572,1730997572.780452,-21600,EB445137-D7F5-57EC-87DA-1DB460D64046,"iPhone13,2"
com.google.Chrome,303,1730996489,1730996792,1730996792.472655,-21600,,
com.microsoft.VSCode,2,1730996487,1730996489,1730996489.305904,-21600,,
com.google.Chrome,15,1730996472,1730996487,1730996487.6644301,-21600,,
com.microsoft.VSCode,5,1730996467,1730996472,1730996472.565714,-21600,,
com.google.Chrome,2,1730996465,1730996467,1730996467.852598,-21600,,
com.microsoft.VSCode,6,1730996459,1730996465,1730996465.97247,-21600,,
com.google.Chrome,24,1730996435,1730996459,1730996459.3780189,-21600,,
com.microsoft.VSCode,14,1730996421,1730996435,1730996435.515249,-21600,,
com.google.Chrome,13,1730996408,1730996421,1730996421.390314,-21600,,
com.microsoft.VSCode,29,1730996379,1730996408,1730996408.7570472,-21600,,
com.google.Chrome,3,1730996376,1730996379,1730996379.7279391,-21600,,
com.microsoft.VSCode,41,1730996335,1730996376,1730996376.63233,-21600,,
com.google.Chrome,1,1730996334,1730996335,1730996336.01774,-21600,,
com.microsoft.VSCode,4,1730996330,1730996334,1730996334.4324322,-21600,,
com.google.Chrome,1,1730996329,1730996330,1730996330.0437999,-21600,,
com.microsoft.VSCode,5,1730996324,1730996329,1730996329.1755872,-21600,,
com.google.Chrome,2,1730996322,1730996324,1730996324.8867679,-21600,,
com.microsoft.VSCode,1,1730996321,1730996322,1730996322.495914,-21600,,
com.google.Chrome,1,1730996320,1730996321,1730996321.0930228,-21600,,
com.microsoft.VSCode,2,1730996318,1730996320,1730996320.071425,-21600,,
com.google.Chrome,1,1730996317,1730996318,1730996318.482407,-21600,,
com.microsoft.VSCode,9,1730996308,1730996317,1730996317.439827,-21600,,
com.google.Chrome,0,1730996308,1730996308,1730996308.6113482,-21600,,
com.microsoft.VSCode,3,1730996305,1730996308,1730996308.245788,-21600,,
com.google.Chrome,1,1730996304,1730996305,1730996305.11233,-21600,,
com.microsoft.VSCode,2,1730996302,1730996304,1730996304.4360209,-21600,,
com.google.Chrome,122,1730996180,1730996302,1730996302.882055,-21600,,
com.microsoft.VSCode,192,1730995988,1730996180,1730996181.0387568,-21600,,
com.apple.finder,3,1730995985,1730995988,1730995988.194816,-21600,,
com.microsoft.VSCode,122,1730995863,1730995985,1730995985.461083,-21600,,
com.apple.finder,27,1730995836,1730995863,1730995863.820837,-21600,,
com.google.Chrome,29,1730995807,1730995836,1730995836.152776,-21600,,
com.microsoft.VSCode,4,1730995796,1730995800,1730995802.3471289,-21600,,
com.google.Chrome,1,1730995795,1730995796,1730995802.312093,-21600,,
com.microsoft.VSCode,2,1730995793,1730995795,1730995802.050342,-21600,,
com.google.Chrome,3,1730995790,1730995793,1730995801.071214,-21600,,
com.leomehlig.today,5,1730995785,1730995790,1730995790.586835,-21600,,
com.markhambly.APOD,34,1730995599,1730995633,1730995633.4176822,-21600,EB445137-D7F5-57EC-87DA-1DB460D64046,"iPhone13,2"
com.apple.news,377,1730995131,1730995508,1730995508.174213,-21600,EB445137-D7F5-57EC-87DA-1DB460D64046,"iPhone13,2"
com.apple.camera,1,1730995090,1730995091,1730995092.00157,-21600,EB445137-D7F5-57EC-87DA-1DB460D64046,"iPhone13,2"
Astrospheric.Astrospheric,25,1730995063,1730995088,1730995088.656652,-21600,EB445137-D7F5-57EC-87DA-1DB460D64046,"iPhone13,2"
com.apple.camera,1,1730995063,1730995064,1730995064.461693,-21600,EB445137-D7F5-57EC-87DA-1DB460D64046,"iPhone13,2"
Astrospheric.Astrospheric,35,1730995025,1730995060,1730995060.7419071,-21600,EB445137-D7F5-57EC-87DA-1DB460D64046,"iPhone13,2"
Astrospheric.Astrospheric,14,1730989501,1730989515,1730989515.495369,-21600,EB445137-D7F5-57EC-87DA-1DB460D64046,"iPhone13,2"
Astrospheric.Astrospheric,13,1730963041,1730963054,1730963054.063139,-21600,EB445137-D7F5-57EC-87DA-1DB460D64046,"iPhone13,2"
Astrospheric.Astrospheric,4,1730963034,1730963038,1730963038.179295,-21600,EB445137-D7F5-57EC-87DA-1DB460D64046,"iPhone13,2"
Astrospheric.Astrospheric,34,1730962999,1730963033,1730963033.712493,-21600,EB445137-D7F5-57EC-87DA-1DB460D64046,"iPhone13,2"
com.apple.mobiletimer,11,1730962981,1730962992,1730962992.658042,-21600,EB445137-D7F5-57EC-87DA-1DB460D64046,"iPhone13,2"
com.apple.Health,61,1730962905,1730962966,1730962966.598949,-21600,EB445137-D7F5-57EC-87DA-1DB460D64046,"iPhone13,2"
com.apple.journal,738,1730962166,1730962904,1730962904.319131,-21600,EB445137-D7F5-57EC-87DA-1DB460D64046,"iPhone13,2"
com.leomehlig.today,4,1730962129,1730962133,1730962135.307935,-21600,,
com.apple.iCal,113,1730962016,1730962129,1730962129.67585,-21600,,
com.leomehlig.today,40,1730961976,1730962016,1730962016.141474,-21600,,
com.google.Chrome,204,1730961772,1730961976,1730961976.359539,-21600,,
com.google.Chrome,703,1730960519,1730961222,1730961222.189124,-21600,,
com.google.Chrome,556,1730959940,1730960496,1730960496.759101,-21600,,
com.google.Chrome,436,1730958682,1730959118,1730959118.654053,-21600,,
com.google.Chrome,329,1730958259,1730958588,1730958588.422698,-21600,,
com.google.Chrome,583,1730957193,1730957776,1730957776.6356049,-21600,,
com.google.Chrome,1638,1730955414,1730957052,1730957052.831975,-21600,,
com.google.Chrome,668,1730954744,1730955412,1730955412.642169,-21600,,
com.leomehlig.today,9,1730954735,1730954744,1730954744.705562,-21600,,
com.google.Chrome,21,1730954714,1730954735,1730954736.042358,-21600,,
com.apple.news,73,1730954605,1730954678,1730954678.3897948,-21600,EB445137-D7F5-57EC-87DA-1DB460D64046,"iPhone13,2"
com.apple.news,4,1730954599,1730954603,1730954603.989351,-21600,EB445137-D7F5-57EC-87DA-1DB460D64046,"iPhone13,2"
com.google.ios.youtube,866,1730953725,1730954591,1730954591.675966,-21600,EB445137-D7F5-57EC-87DA-1DB460D64046,"iPhone13,2"
com.apple.news,3,1730953720,1730953723,1730953724.651402,-21600,EB445137-D7F5-57EC-87DA-1DB460D64046,"iPhone13,2"
com.google.Chrome,315,1730953623,1730953938,1730953938.746049,-21600,,
com.leomehlig.today,8,1730953615,1730953623,1730953624.256853,-21600,,
com.google.Chrome,3,1730953612,1730953615,1730953616.1209579,-21600,,
com.leomehlig.today,149,1730953463,1730953612,1730953612.488903,-21600,,
com.google.Chrome,16,1730953447,1730953463,1730953463.442343,-21600,,
com.leomehlig.today,34,1730953413,1730953447,1730953447.286882,-21600,,
com.google.Chrome,55,1730953358,1730953413,1730953413.952143,-21600,,
com.leomehlig.today,47,1730953294,1730953341,1730953341.500421,-21600,,
com.apple.news,170,1730951672,1730951842,1730951843.333714,-21600,EB445137-D7F5-57EC-87DA-1DB460D64046,"iPhone13,2"
com.apple.news,2,1730951664,1730951666,1730951666.2240891,-21600,EB445137-D7F5-57EC-87DA-1DB460D64046,"iPhone13,2"
com.google.Chrome,2950,1730950344,1730953294,1730953294.47725,-21600,,
com.leomehlig.today,46,1730950298,1730950344,1730950345.0827641,-21600,,
com.apple.news,37,1730950250,1730950287,1730950287.97716,-21600,EB445137-D7F5-57EC-87DA-1DB460D64046,"iPhone13,2"
com.apple.news,3,1730945851,1730945854,1730945854.441434,-21600,EB445137-D7F5-57EC-87DA-1DB460D64046,"iPhone13,2"
com.apple.news,5,1730945418,1730945423,1730945423.3567271,-21600,EB445137-D7F5-57EC-87DA-1DB460D64046,"iPhone13,2"
com.apple.news,538,1730944787,1730945325,1730945326.56769,-21600,EB445137-D7F5-57EC-87DA-1DB460D64046,"iPhone13,2"
com.apple.news,130,1730944558,1730944688,1730944689.295965,-21600,EB445137-D7F5-57EC-87DA-1DB460D64046,"iPhone13,2"
com.apple.news,119,1730943551,1730943670,1730943670.452856,-21600,EB445137-D7F5-57EC-87DA-1DB460D64046,"iPhone13,2"
com.google.Gmail,12,1730943526,1730943538,1730943538.3256068,-21600,EB445137-D7F5-57EC-87DA-1DB460D64046,"iPhone13,2"
com.apple.Music,14,1730943512,1730943526,1730943526.97993,-21600,EB445137-D7F5-57EC-87DA-1DB460D64046,"iPhone13,2"
com.apple.Music,32,1730936762,1730936794,1730936794.9892612,-21600,EB445137-D7F5-57EC-87DA-1DB460D64046,"iPhone13,2"
com.apple.news,97,1730936450,1730936547,1730936547.340816,-21600,EB445137-D7F5-57EC-87DA-1DB460D64046,"iPhone13,2"
com.leomehlig.today,21,1730936407,1730936428,1730936429.1472569,-21600,,
com.google.Chrome,119,1730936288,1730936407,1730936407.381022,-21600,,
com.microsoft.VSCode,866,1730935422,1730936288,1730936288.6951818,-21600,,
com.apple.finder,3,1730935419,1730935422,1730935423.0311399,-21600,,
com.leomehlig.today,5,1730935414,1730935419,1730935419.493768,-21600,,
com.microsoft.Excel,14,1730935400,1730935414,1730935414.536979,-21600,,
com.leomehlig.today,4,1730935396,1730935400,1730935400.208363,-21600,,
com.microsoft.Excel,13,1730935383,1730935396,1730935396.904448,-21600,,
com.leomehlig.today,3,1730935380,1730935383,1730935383.610929,-21600,,
com.microsoft.Excel,4,1730935376,1730935380,1730935380.226687,-21600,,
com.leomehlig.today,3,1730935373,1730935376,1730935377.031777,-21600,,
com.microsoft.Excel,7,1730935366,1730935373,1730935373.209444,-21600,,
com.leomehlig.today,5,1730935361,1730935366,1730935366.73084,-21600,,
com.microsoft.Excel,20,1730935341,1730935361,1730935362.038241,-21600,,
com.leomehlig.today,8,1730935333,1730935341,1730935341.4212952,-21600,,
com.microsoft.Excel,11,1730935322,1730935333,1730935333.1574469,-21600,,
com.leomehlig.today,6,1730935316,1730935322,1730935322.514899,-21600,,
com.microsoft.Excel,4,1730935312,1730935316,1730935316.970374,-21600,,
com.leomehlig.today,7,1730935305,1730935312,1730935313.018081,-21600,,
com.microsoft.Excel,25,1730935280,1730935305,1730935305.588665,-21600,,
com.leomehlig.today,4,1730935276,1730935280,1730935280.3206692,-21600,,
com.microsoft.Excel,22,1730935254,1730935276,1730935276.7371469,-21600,,
com.leomehlig.today,7,1730935247,1730935254,1730935254.787818,-21600,,
com.microsoft.Excel,10,1730935237,1730935247,1730935247.566351,-21600,,
com.leomehlig.today,4,1730935233,1730935237,1730935237.316793,-21600,,
com.microsoft.Excel,4,1730935229,1730935233,1730935233.616045,-21600,,
com.leomehlig.today,5,1730935224,1730935229,1730935229.7608418,-21600,,
com.microsoft.Excel,8,1730935216,1730935224,1730935225.00845,-21600,,
com.leomehlig.today,7,1730935209,1730935216,1730935216.620201,-21600,,
com.microsoft.Excel,25,1730935184,1730935209,1730935209.7571201,-21600,,
com.leomehlig.today,4,1730935180,1730935184,1730935184.157742,-21600,,
com.microsoft.Excel,21,1730935159,1730935180,1730935180.4860969,-21600,,
com.leomehlig.today,7,1730935152,1730935159,1730935159.151854,-21600,,
com.microsoft.Excel,26,1730935126,1730935152,1730935152.823185,-21600,,
com.leomehlig.today,15,1730935111,1730935126,1730935126.112555,-21600,,
com.microsoft.Excel,24,1730935087,1730935111,1730935111.0711842,-21600,,
com.leomehlig.today,8,1730935079,1730935087,1730935087.317563,-21600,,
com.microsoft.Excel,2,1730935077,1730935079,1730935079.93418,-21600,,
com.leomehlig.today,4,1730935073,1730935077,1730935077.190548,-21600,,
com.microsoft.Excel,1,1730935072,1730935073,1730935073.743572,-21600,,
com.leomehlig.today,2,1730935070,1730935072,1730935072.21576,-21600,,
com.apple.finder,24,1730935046,1730935070,1730935070.86251,-21600,,
com.leomehlig.today,3,1730935043,1730935046,1730935046.212373,-21600,,
com.apple.finder,2,1730935041,1730935043,1730935043.901554,-21600,,
com.google.Chrome,31,1730935010,1730935041,1730935041.092636,-21600,,
com.leomehlig.today,45,1730934953,1730934998,1730935000.16448,-21600,,
com.burbn.instagram,166,1730933986,1730934152,1730934152.928925,-21600,EB445137-D7F5-57EC-87DA-1DB460D64046,"iPhone13,2"
com.google.Chrome,2002,1730932951,1730934953,1730934953.666771,-21600,,
com.leomehlig.today,7,1730932944,1730932951,1730932951.123489,-21600,,
com.google.Chrome,158,1730932786,1730932944,1730932944.2804441,-21600,,
com.leomehlig.today,43,1730932743,1730932786,1730932786.995825,-21600,,
com.google.Chrome,578,1730932165,1730932743,1730932743.419565,-21600,,
com.leomehlig.today,1,1730932164,1730932165,1730932165.291753,-21600,,
com.google.Chrome,2396,1730929768,1730932164,1730932164.141971,-21600,,
com.apple.news,499,1730929501,1730930000,1730930000.905527,-21600,EB445137-D7F5-57EC-87DA-1DB460D64046,"iPhone13,2"
com.instructure.icanvas,10,1730929476,1730929486,1730929487.530612,-21600,EB445137-D7F5-57EC-87DA-1DB460D64046,"iPhone13,2"
com.google.Chrome,1597,1730928170,1730929767,1730929767.68405,-21600,,
com.leomehlig.today,5,1730928165,1730928170,1730928170.506495,-21600,,
com.apple.iCal,25,1730928140,1730928165,1730928165.815947,-21600,,
com.leomehlig.today,14,1730928126,1730928140,1730928140.220495,-21600,,
com.google.Chrome,294,1730927832,1730928126,1730928126.4908051,-21600,,
com.apple.Passwords,1,1730927831,1730927832,1730927832.153908,-21600,,
com.google.Chrome,28,1730927803,1730927831,1730927831.2116652,-21600,,
com.apple.news,25,1730927771,1730927796,1730927796.264447,-21600,EB445137-D7F5-57EC-87DA-1DB460D64046,"iPhone13,2"
com.apple.camera,7,1730927136,1730927143,1730927143.8277469,-21600,EB445137-D7F5-57EC-87DA-1DB460D64046,"iPhone13,2"
com.apple.news,9,1730927135,1730927144,1730927144.9422488,-21600,EB445137-D7F5-57EC-87DA-1DB460D64046,"iPhone13,2"
com.apple.news,21,1730927074,1730927095,1730927095.681546,-21600,EB445137-D7F5-57EC-87DA-1DB460D64046,"iPhone13,2"
com.apple.mobileslideshow,5,1730927067,1730927072,1730927072.998726,-21600,EB445137-D7F5-57EC-87DA-1DB460D64046,"iPhone13,2"
com.apple.mobileslideshow,12,1730926805,1730926817,1730926818.003772,-21600,EB445137-D7F5-57EC-87DA-1DB460D64046,"iPhone13,2"
com.google.Chrome,538,1730926380,1730926918,1730926918.798366,-21600,,
com.apple.Passwords,6,1730926374,1730926380,1730926380.676649,-21600,,
com.google.Chrome,4,1730926370,1730926374,1730926374.5209188,-21600,,
com.apple.mobileslideshow,14,1730926350,1730926364,1730926364.210064,-21600,EB445137-D7F5-57EC-87DA-1DB460D64046,"iPhone13,2"
com.apple.mobileslideshow,202,1730926121,1730926323,1730926324.242039,-21600,EB445137-D7F5-57EC-87DA-1DB460D64046,"iPhone13,2"
com.apple.news,3,1730926118,1730926121,1730926121.257134,-21600,EB445137-D7F5-57EC-87DA-1DB460D64046,"iPhone13,2"
com.apple.news,92,1730925898,1730925990,1730925990.911415,-21600,EB445137-D7F5-57EC-87DA-1DB460D64046,"iPhone13,2"
com.apple.camera,92,1730925898,1730925990,1730925990.9815102,-21600,EB445137-D7F5-57EC-87DA-1DB460D64046,"iPhone13,2"
com.apple.news,2,1730925895,1730925897,1730925897.76116,-21600,EB445137-D7F5-57EC-87DA-1DB460D64046,"iPhone13,2"
com.apple.camera,12,1730925881,1730925893,1730925893.986918,-21600,EB445137-D7F5-57EC-87DA-1DB460D64046,"iPhone13,2"
com.apple.news,12,1730925881,1730925893,1730925893.5590792,-21600,EB445137-D7F5-57EC-87DA-1DB460D64046,"iPhone13,2"
com.google.Chrome,166,1730922440,1730922606,1730922606.717152,-21600,,
com.leomehlig.today,39,1730922401,1730922440,1730922441.114536,-21600,,
com.google.Chrome,64,1730922337,1730922401,1730922401.504914,-21600,,
com.apple.Passwords,11,1730922326,1730922337,1730922337.4278579,-21600,,
com.google.Chrome,9,1730922317,1730922326,1730922326.37247,-21600,,
com.leomehlig.today,6,1730922301,1730922307,1730922307.068152,-21600,,
com.google.Chrome,1,1730922300,1730922301,1730922301.9685621,-21600,,
com.leomehlig.today,114,1730922186,1730922300,1730922300.424251,-21600,,
com.google.Chrome,510,1730921676,1730922186,1730922186.079784,-21600,,
com.google.Chrome,847,1730920646,1730921493,1730921493.447393,-21600,,
com.apple.news,269,1730920377,1730920646,1730920646.510751,-21600,,
com.google.Chrome,1319,1730919058,1730920377,1730920377.857604,-21600,,
com.apple.iCal,54,1730919004,1730919058,1730919058.943458,-21600,,
com.google.Chrome,42,1730918962,1730919004,1730919004.902022,-21600,,
com.apple.news,8,1730918236,1730918244,1730918244.541627,-21600,EB445137-D7F5-57EC-87DA-1DB460D64046,"iPhone13,2"
com.google.Chrome,342,1730917615,1730917957,1730917958.116313,-21600,,
com.google.Chrome,304,1730917233,1730917537,1730917537.049864,-21600,,
com.apple.camera,11,1730917196,1730917207,1730917208.6139998,-21600,EB445137-D7F5-57EC-87DA-1DB460D64046,"iPhone13,2"
com.hammerandchisel.discord,7,1730916926,1730916933,1730916933.496636,-21600,EB445137-D7F5-57EC-87DA-1DB460D64046,"iPhone13,2"
com.truebill.truebillnative,139,1730916450,1730916589,1730916589.969491,-21600,EB445137-D7F5-57EC-87DA-1DB460D64046,"iPhone13,2"
com.burbn.instagram,29,1730916394,1730916423,1730916424.015998,-21600,EB445137-D7F5-57EC-87DA-1DB460D64046,"iPhone13,2"
com.burbn.instagram,27,1730916366,1730916393,1730916393.726434,-21600,EB445137-D7F5-57EC-87DA-1DB460D64046,"iPhone13,2"
com.google.Chrome,693,1730916303,1730916996,1730916996.488669,-21600,,
com.burbn.instagram,61,1730915280,1730915341,1730915342.403339,-21600,EB445137-D7F5-57EC-87DA-1DB460D64046,"iPhone13,2"
com.microsoft.Office.Outlook,5,1730915269,1730915274,1730915274.185463,-21600,EB445137-D7F5-57EC-87DA-1DB460D64046,"iPhone13,2"
com.google.Chrome,742,1730915257,1730915999,1730915999.7737079,-21600,,
com.microsoft.Office.Outlook,33,1730915149,1730915182,1730915183.175858,-21600,EB445137-D7F5-57EC-87DA-1DB460D64046,"iPhone13,2"
com.apple.news,5,1730915144,1730915149,1730915150.035788,-21600,EB445137-D7F5-57EC-87DA-1DB460D64046,"iPhone13,2"
com.apple.news,96,1730914440,1730914536,1730914536.7649941,-21600,EB445137-D7F5-57EC-87DA-1DB460D64046,"iPhone13,2"
com.tinyspeck.chatlyio,13,1730914426,1730914439,1730914439.1296558,-21600,EB445137-D7F5-57EC-87DA-1DB460D64046,"iPhone13,2"
com.hammerandchisel.discord,88,1730914332,1730914420,1730914420.572773,-21600,EB445137-D7F5-57EC-87DA-1DB460D64046,"iPhone13,2"
com.google.chrome.ios,8,1730914324,1730914332,1730914332.391691,-21600,EB445137-D7F5-57EC-87DA-1DB460D64046,"iPhone13,2"
com.google.Chrome,306,1730914313,1730914619,1730914619.930894,-21600,,
com.leomehlig.today,89,1730914224,1730914313,1730914313.8481998,-21600,,
com.google.Chrome,382,1730913842,1730914224,1730914224.566755,-21600,,
com.leomehlig.today,8,1730913834,1730913842,1730913842.36082,-21600,,
com.google.Chrome,392,1730913442,1730913834,1730913834.819789,-21600,,
com.leomehlig.today,11,1730913421,1730913432,1730913433.027285,-21600,,
com.apple.finder,22,1730913399,1730913421,1730913421.783033,-21600,,
com.google.Chrome,3,1730913396,1730913399,1730913399.908531,-21600,,
com.leomehlig.today,42,1730913354,1730913396,1730913396.5529308,-21600,,
com.google.Chrome,8,1730913346,1730913354,1730913354.555184,-21600,,
com.google.chrome.ios,171,1730912807,1730912978,1730912978.965689,-21600,EB445137-D7F5-57EC-87DA-1DB460D64046,"iPhone13,2"
com.apple.news,11,1730912794,1730912805,1730912805.7481241,-21600,EB445137-D7F5-57EC-87DA-1DB460D64046,"iPhone13,2"
com.apple.news,355,1730912261,1730912616,1730912616.334248,-21600,EB445137-D7F5-57EC-87DA-1DB460D64046,"iPhone13,2"
com.apple.news,35,1730911315,1730911350,1730911350.6779141,-21600,EB445137-D7F5-57EC-87DA-1DB460D64046,"iPhone13,2"
com.microsoft.Office.Outlook,15,1730911291,1730911306,1730911306.6827168,-21600,EB445137-D7F5-57EC-87DA-1DB460D64046,"iPhone13,2"
com.microsoft.Office.Outlook,2,1730911083,1730911085,1730911086.34972,-21600,EB445137-D7F5-57EC-87DA-1DB460D64046,"iPhone13,2"
com.burbn.instagram,7,1730911076,1730911083,1730911083.770788,-21600,EB445137-D7F5-57EC-87DA-1DB460D64046,"iPhone13,2"
com.burbn.instagram,1,1730911011,1730911012,1730911013.0448751,-21600,EB445137-D7F5-57EC-87DA-1DB460D64046,"iPhone13,2"
com.burbn.instagram,10,1730908735,1730908745,1730908745.353188,-21600,EB445137-D7F5-57EC-87DA-1DB460D64046,"iPhone13,2"
com.burbn.instagram,22,1730908701,1730908723,1730908723.765679,-21600,EB445137-D7F5-57EC-87DA-1DB460D64046,"iPhone13,2"
com.apple.news,8,1730908685,1730908693,1730908693.5975041,-21600,EB445137-D7F5-57EC-87DA-1DB460D64046,"iPhone13,2"
com.apple.camera,9,1730908354,1730908363,1730908364.477148,-21600,EB445137-D7F5-57EC-87DA-1DB460D64046,"iPhone13,2"
com.apple.news,11,1730908352,1730908363,1730908364.472409,-21600,EB445137-D7F5-57EC-87DA-1DB460D64046,"iPhone13,2"
com.apple.news,26,1730908152,1730908178,1730908179.00847,-21600,EB445137-D7F5-57EC-87DA-1DB460D64046,"iPhone13,2"
com.apple.news,283,1730907804,1730908087,1730908087.534584,-21600,EB445137-D7F5-57EC-87DA-1DB460D64046,"iPhone13,2"
com.apple.weather,39,1730907227,1730907266,1730907266.354981,-21600,EB445137-D7F5-57EC-87DA-1DB460D64046,"iPhone13,2"
com.renpho.health,2,1730907225,1730907227,1730907227.633348,-21600,EB445137-D7F5-57EC-87DA-1DB460D64046,"iPhone13,2"
com.renpho.health,22,1730907180,1730907202,1730907203.699722,-21600,EB445137-D7F5-57EC-87DA-1DB460D64046,"iPhone13,2"
com.apple.news,13,1730884930,1730884943,1730884943.1985111,-21600,EB445137-D7F5-57EC-87DA-1DB460D64046,"iPhone13,2"
com.apple.news,56,1730884870,1730884926,1730884928.090241,-21600,EB445137-D7F5-57EC-87DA-1DB460D64046,"iPhone13,2"
com.apple.news,12,1730883864,1730883876,1730883876.877934,-21600,EB445137-D7F5-57EC-87DA-1DB460D64046,"iPhone13,2"
com.apple.news,9,1730883851,1730883860,1730883860.875564,-21600,EB445137-D7F5-57EC-87DA-1DB460D64046,"iPhone13,2"
com.apple.mobiletimer,12,1730883839,1730883851,1730883851.641618,-21600,EB445137-D7F5-57EC-87DA-1DB460D64046,"iPhone13,2"
com.apple.mobiletimer,15,1730883822,1730883837,1730883837.628125,-21600,EB445137-D7F5-57EC-87DA-1DB460D64046,"iPhone13,2"
com.apple.news,5,1730883817,1730883822,1730883822.744977,-21600,EB445137-D7F5-57EC-87DA-1DB460D64046,"iPhone13,2"
com.apple.news,18,1730883791,1730883809,1730883809.512226,-21600,EB445137-D7F5-57EC-87DA-1DB460D64046,"iPhone13,2"
com.apple.news,33,1730883757,1730883790,1730883791.425756,-21600,EB445137-D7F5-57EC-87DA-1DB460D64046,"iPhone13,2"
com.apple.news,8,1730883575,1730883583,1730883583.970985,-21600,EB445137-D7F5-57EC-87DA-1DB460D64046,"iPhone13,2"
com.apple.news,109,1730883346,1730883455,1730883456.298729,-21600,EB445137-D7F5-57EC-87DA-1DB460D64046,"iPhone13,2"
com.apple.news,21,1730883291,1730883312,1730883314.2563071,-21600,EB445137-D7F5-57EC-87DA-1DB460D64046,"iPhone13,2"
com.google.chrome.ios,139,1730883152,1730883291,1730883292.627228,-21600,EB445137-D7F5-57EC-87DA-1DB460D64046,"iPhone13,2"
com.google.chrome.ios,116,1730883036,1730883152,1730883152.930119,-21600,EB445137-D7F5-57EC-87DA-1DB460D64046,"iPhone13,2"
com.apple.news,12,1730883024,1730883036,1730883036.978127,-21600,EB445137-D7F5-57EC-87DA-1DB460D64046,"iPhone13,2"
com.google.chrome.ios,203,1730882821,1730883024,1730883025.130834,-21600,EB445137-D7F5-57EC-87DA-1DB460D64046,"iPhone13,2"
com.apple.news,88,1730882733,1730882821,1730882821.355938,-21600,EB445137-D7F5-57EC-87DA-1DB460D64046,"iPhone13,2"
com.google.chrome.ios,225,1730882508,1730882733,1730882735.313109,-21600,EB445137-D7F5-57EC-87DA-1DB460D64046,"iPhone13,2"
com.apple.news,62,1730882446,1730882508,1730882508.4134722,-21600,EB445137-D7F5-57EC-87DA-1DB460D64046,"iPhone13,2"
com.hammerandchisel.discord,20,1730882422,1730882442,1730882442.632498,-21600,EB445137-D7F5-57EC-87DA-1DB460D64046,"iPhone13,2"
com.apple.news,170,1730882248,1730882418,1730882418.525147,-21600,EB445137-D7F5-57EC-87DA-1DB460D64046,"iPhone13,2"
com.apple.Health,43,1730882202,1730882245,1730882246.008442,-21600,EB445137-D7F5-57EC-87DA-1DB460D64046,"iPhone13,2"
com.apple.news,5,1730882197,1730882202,1730882203.47454,-21600,EB445137-D7F5-57EC-87DA-1DB460D64046,"iPhone13,2"
com.apple.news,10,1730882096,1730882106,1730882107.029191,-21600,EB445137-D7F5-57EC-87DA-1DB460D64046,"iPhone13,2"
com.google.chrome.ios,146,1730881950,1730882096,1730882097.535191,-21600,EB445137-D7F5-57EC-87DA-1DB460D64046,"iPhone13,2"
com.apple.news,63,1730881887,1730881950,1730881950.843756,-21600,EB445137-D7F5-57EC-87DA-1DB460D64046,"iPhone13,2"
com.google.chrome.ios,94,1730881793,1730881887,1730881888.615141,-21600,EB445137-D7F5-57EC-87DA-1DB460D64046,"iPhone13,2"
com.apple.news,11,1730881782,1730881793,1730881793.8025951,-21600,EB445137-D7F5-57EC-87DA-1DB460D64046,"iPhone13,2"
com.google.chrome.ios,133,1730881649,1730881782,1730881783.045402,-21600,EB445137-D7F5-57EC-87DA-1DB460D64046,"iPhone13,2"
com.apple.news,12,1730881637,1730881649,1730881650.159286,-21600,EB445137-D7F5-57EC-87DA-1DB460D64046,"iPhone13,2"
com.google.chrome.ios,172,1730881465,1730881637,1730881638.670271,-21600,EB445137-D7F5-57EC-87DA-1DB460D64046,"iPhone13,2"
com.apple.news,143,1730881321,1730881464,1730881465.150471,-21600,EB445137-D7F5-57EC-87DA-1DB460D64046,"iPhone13,2"
com.google.chrome.ios,216,1730881105,1730881321,1730881322.866191,-21600,EB445137-D7F5-57EC-87DA-1DB460D64046,"iPhone13,2"
com.apple.news,347,1730880755,1730881102,1730881103.0572948,-21600,EB445137-D7F5-57EC-87DA-1DB460D64046,"iPhone13,2"
com.apple.news,11,1730880692,1730880703,1730880703.491013,-21600,EB445137-D7F5-57EC-87DA-1DB460D64046,"iPhone13,2"
com.apple.news,237,1730880452,1730880689,1730880689.4278688,-21600,EB445137-D7F5-57EC-87DA-1DB460D64046,"iPhone13,2"
com.apple.news,56,1730880365,1730880421,1730880421.947402,-21600,EB445137-D7F5-57EC-87DA-1DB460D64046,"iPhone13,2"
com.apple.news,85,1730880204,1730880289,1730880289.692967,-21600,EB445137-D7F5-57EC-87DA-1DB460D64046,"iPhone13,2"
com.apple.news,30,1730880081,1730880111,1730880112.063188,-21600,EB445137-D7F5-57EC-87DA-1DB460D64046,"iPhone13,2"
com.apple.news,3,1730880044,1730880047,1730880047.3920388,-21600,EB445137-D7F5-57EC-87DA-1DB460D64046,"iPhone13,2"
com.apple.news,57,1730879901,1730879958,1730879959.177834,-21600,EB445137-D7F5-57EC-87DA-1DB460D64046,"iPhone13,2"
com.apple.news,44,1730879856,1730879900,1730879900.678956,-21600,EB445137-D7F5-57EC-87DA-1DB460D64046,"iPhone13,2"
com.google.chrome.ios,114,1730879742,1730879856,1730879857.405163,-21600,EB445137-D7F5-57EC-87DA-1DB460D64046,"iPhone13,2"
com.google.chrome.ios,50,1730879652,1730879702,1730879703.909061,-21600,EB445137-D7F5-57EC-87DA-1DB460D64046,"iPhone13,2"
com.google.chrome.ios,111,1730879531,1730879642,1730879643.8197289,-21600,EB445137-D7F5-57EC-87DA-1DB460D64046,"iPhone13,2"
com.apple.weather,2,1730879529,1730879531,1730879531.083103,-21600,EB445137-D7F5-57EC-87DA-1DB460D64046,"iPhone13,2"
com.apple.news,31,1730879497,1730879528,1730879529.162765,-21600,EB445137-D7F5-57EC-87DA-1DB460D64046,"iPhone13,2"
com.apple.news,20,1730879436,1730879456,1730879457.132776,-21600,EB445137-D7F5-57EC-87DA-1DB460D64046,"iPhone13,2"
com.apple.news,199,1730879221,1730879420,1730879421.055409,-21600,EB445137-D7F5-57EC-87DA-1DB460D64046,"iPhone13,2"
com.apple.news,65,1730879121,1730879186,1730879187.404564,-21600,EB445137-D7F5-57EC-87DA-1DB460D64046,"iPhone13,2"
com.apple.news,3,1730878994,1730878997,1730878997.2881,-21600,EB445137-D7F5-57EC-87DA-1DB460D64046,"iPhone13,2"
com.apple.news,2,1730878982,1730878984,1730878984.662447,-21600,EB445137-D7F5-57EC-87DA-1DB460D64046,"iPhone13,2"
com.apple.news,21,1730878931,1730878952,1730878953.094193,-21600,EB445137-D7F5-57EC-87DA-1DB460D64046,"iPhone13,2"
com.apple.camera,0,1730878862,1730878862,1730878862.799465,-21600,EB445137-D7F5-57EC-87DA-1DB460D64046,"iPhone13,2"
com.toyopagroup.picaboo,35,1730878804,1730878839,1730878839.876374,-21600,EB445137-D7F5-57EC-87DA-1DB460D64046,"iPhone13,2"
com.hammerandchisel.discord,73,1730878725,1730878798,1730878798.17832,-21600,EB445137-D7F5-57EC-87DA-1DB460D64046,"iPhone13,2"
com.apple.news,8,1730878709,1730878717,1730878717.0690289,-21600,EB445137-D7F5-57EC-87DA-1DB460D64046,"iPhone13,2"
com.apple.news,10,1730878603,1730878613,1730878613.76932,-21600,EB445137-D7F5-57EC-87DA-1DB460D64046,"iPhone13,2"
com.apple.news,68,1730878530,1730878598,1730878599.0469851,-21600,EB445137-D7F5-57EC-87DA-1DB460D64046,"iPhone13,2"
com.apple.news,35,1730878277,1730878312,1730878313.4510589,-21600,EB445137-D7F5-57EC-87DA-1DB460D64046,"iPhone13,2"
com.robinhood.release.Robinhood,30,1730878197,1730878227,1730878227.9186769,-21600,EB445137-D7F5-57EC-87DA-1DB460D64046,"iPhone13,2"
com.robinhood.release.Robinhood,12,1730878183,1730878195,1730878195.268849,-21600,EB445137-D7F5-57EC-87DA-1DB460D64046,"iPhone13,2"
com.apple.news,4,1730878176,1730878180,1730878180.55341,-21600,EB445137-D7F5-57EC-87DA-1DB460D64046,"iPhone13,2"
com.apple.news,20,1730878042,1730878062,1730878062.940638,-21600,EB445137-D7F5-57EC-87DA-1DB460D64046,"iPhone13,2"
com.apple.news,3,1730877715,1730877718,1730877718.6005812,-21600,EB445137-D7F5-57EC-87DA-1DB460D64046,"iPhone13,2"
com.apple.news,127,1730877587,1730877714,1730877714.8833919,-21600,EB445137-D7F5-57EC-87DA-1DB460D64046,"iPhone13,2"
com.google.Chrome,7,1730876865,1730876872,1730876872.6787128,-21600,,
com.apple.news,50,1730876776,1730876826,1730876827.067281,-21600,EB445137-D7F5-57EC-87DA-1DB460D64046,"iPhone13,2"
com.apple.news,10,1730876765,1730876775,1730876775.313212,-21600,EB445137-D7F5-57EC-87DA-1DB460D64046,"iPhone13,2"
com.apple.news,154,1730876610,1730876764,1730876764.413559,-21600,EB445137-D7F5-57EC-87DA-1DB460D64046,"iPhone13,2"
com.apple.news,54,1730876185,1730876239,1730876239.423125,-21600,EB445137-D7F5-57EC-87DA-1DB460D64046,"iPhone13,2"
com.google.Chrome,1578,1730875283,1730876861,1730876861.617424,-21600,,
com.apple.news,10,1730874974,1730874984,1730874984.594145,-21600,EB445137-D7F5-57EC-87DA-1DB460D64046,"iPhone13,2"
com.apple.news,115,1730874857,1730874972,1730874973.063787,-21600,EB445137-D7F5-57EC-87DA-1DB460D64046,"iPhone13,2"
com.apple.news,3,1730874822,1730874825,1730874826.000245,-21600,EB445137-D7F5-57EC-87DA-1DB460D64046,"iPhone13,2"
com.google.Chrome,910,1730874255,1730875165,1730875165.373549,-21600,,
com.apple.news,86,1730874119,1730874205,1730874206.136214,-21600,EB445137-D7F5-57EC-87DA-1DB460D64046,"iPhone13,2"
com.apple.news,5,1730873955,1730873960,1730873960.190363,-21600,EB445137-D7F5-57EC-87DA-1DB460D64046,"iPhone13,2"
com.google.Chrome,851,1730873373,1730874224,1730874224.940378,-21600,,
com.google.Chrome,724,1730872329,1730873053,1730873053.881939,-21600,,
com.apple.news,20,1730872302,1730872322,1730872322.4584088,-21600,EB445137-D7F5-57EC-87DA-1DB460D64046,"iPhone13,2"
com.apple.news,112,1730871983,1730872095,1730872095.511405,-21600,EB445137-D7F5-57EC-87DA-1DB460D64046,"iPhone13,2"
com.google.Chrome,527,1730871740,1730872267,1730872267.380498,-21600,,
com.leomehlig.today,0,1730871740,1730871740,1730871740.689878,-21600,,
com.google.Chrome,2,1730871738,1730871740,1730871740.3846412,-21600,,
com.apple.MobileSMS,2,1730871736,1730871738,1730871738.551508,-21600,,
com.google.Chrome,66,1730871670,1730871736,1730871736.402563,-21600,,
com.burbn.instagram,217,1730870748,1730870965,1730870965.732576,-21600,EB445137-D7F5-57EC-87DA-1DB460D64046,"iPhone13,2"
com.apple.news,3,1730870740,1730870743,1730870743.4491029,-21600,EB445137-D7F5-57EC-87DA-1DB460D64046,"iPhone13,2"
com.google.Chrome,1305,1730870351,1730871656,1730871656.66243,-21600,,
com.apple.news,135,1730870014,1730870149,1730870149.767822,-21600,EB445137-D7F5-57EC-87DA-1DB460D64046,"iPhone13,2"
com.google.Chrome,674,1730869381,1730870055,1730870055.2023458,-21600,,
com.leomehlig.today,59,1730869322,1730869381,1730869381.605781,-21600,,
com.google.Chrome,34,1730869288,1730869322,1730869322.392624,-21600,,
com.apple.news,30,1730869258,1730869288,1730869288.723151,-21600,,
com.apple.news,118,1730869073,1730869191,1730869191.325378,-21600,EB445137-D7F5-57EC-87DA-1DB460D64046,"iPhone13,2"
com.google.ios.youtube,70,1730868984,1730869054,1730869054.535363,-21600,EB445137-D7F5-57EC-87DA-1DB460D64046,"iPhone13,2"
com.toyopagroup.picaboo,106,1730868875,1730868981,1730868981.213978,-21600,EB445137-D7F5-57EC-87DA-1DB460D64046,"iPhone13,2"
com.apple.news,54,1730868816,1730868870,1730868870.390163,-21600,EB445137-D7F5-57EC-87DA-1DB460D64046,"iPhone13,2"
com.apple.news,20,1730868789,1730868809,1730868809.954448,-21600,EB445137-D7F5-57EC-87DA-1DB460D64046,"iPhone13,2"
com.apple.news,204,1730867859,1730868063,1730868063.541976,-21600,EB445137-D7F5-57EC-87DA-1DB460D64046,"iPhone13,2"
com.apple.news,20,1730867835,1730867855,1730867855.786588,-21600,EB445137-D7F5-57EC-87DA-1DB460D64046,"iPhone13,2"
com.apple.news,64,1730867334,1730867398,1730867398.347259,-21600,EB445137-D7F5-57EC-87DA-1DB460D64046,"iPhone13,2"
com.apple.news,77,1730867235,1730867312,1730867312.750555,-21600,EB445137-D7F5-57EC-87DA-1DB460D64046,"iPhone13,2"
com.apple.news,12,1730867221,1730867233,1730867233.7233791,-21600,EB445137-D7F5-57EC-87DA-1DB460D64046,"iPhone13,2"
com.apple.news,207,1730866882,1730867089,1730867090.071625,-21600,EB445137-D7F5-57EC-87DA-1DB460D64046,"iPhone13,2"
com.apple.camera,1,1730866781,1730866782,1730866782.638078,-21600,EB445137-D7F5-57EC-87DA-1DB460D64046,"iPhone13,2"
com.apple.camera,6,1730865917,1730865923,1730865924.336113,-21600,EB445137-D7F5-57EC-87DA-1DB460D64046,"iPhone13,2"
com.apple.news,8,1730865916,1730865924,1730865925.483642,-21600,EB445137-D7F5-57EC-87DA-1DB460D64046,"iPhone13,2"
com.apple.news,3,1730865849,1730865852,1730865852.237578,-21600,EB445137-D7F5-57EC-87DA-1DB460D64046,"iPhone13,2"
com.apple.news,38,1730865787,1730865825,1730865826.143155,-21600,EB445137-D7F5-57EC-87DA-1DB460D64046,"iPhone13,2"
com.apple.news,3,1730865728,1730865731,1730865731.819233,-21600,EB445137-D7F5-57EC-87DA-1DB460D64046,"iPhone13,2"
com.apple.news,6,1730865464,1730865470,1730865470.369736,-21600,EB445137-D7F5-57EC-87DA-1DB460D64046,"iPhone13,2"
com.apple.news,6,1730865248,1730865254,1730865254.470197,-21600,EB445137-D7F5-57EC-87DA-1DB460D64046,"iPhone13,2"
com.apple.news,126,1730865116,1730865242,1730865242.513648,-21600,EB445137-D7F5-57EC-87DA-1DB460D64046,"iPhone13,2"
com.apple.news,5,1730865097,1730865102,1730865102.3018022,-21600,EB445137-D7F5-57EC-87DA-1DB460D64046,"iPhone13,2"
com.apple.news,69,1730864961,1730865030,1730865031.814711,-21600,EB445137-D7F5-57EC-87DA-1DB460D64046,"iPhone13,2"
com.robinhood.release.Robinhood,46,1730864879,1730864925,1730864925.897727,-21600,EB445137-D7F5-57EC-87DA-1DB460D64046,"iPhone13,2"
com.apple.news,8,1730864870,1730864878,1730864879.0798821,-21600,EB445137-D7F5-57EC-87DA-1DB460D64046,"iPhone13,2"
com.apple.news,12,1730864821,1730864833,1730864833.896378,-21600,EB445137-D7F5-57EC-87DA-1DB460D64046,"iPhone13,2"
com.apple.news,22,1730864696,1730864718,1730864719.737447,-21600,EB445137-D7F5-57EC-87DA-1DB460D64046,"iPhone13,2"
com.burbn.instagram,82,1730863773,1730863855,1730863856.074395,-21600,EB445137-D7F5-57EC-87DA-1DB460D64046,"iPhone13,2"
com.google.chrome.ios,5,1730863762,1730863767,1730863767.2135549,-21600,EB445137-D7F5-57EC-87DA-1DB460D64046,"iPhone13,2"
com.google.chrome.ios,52,1730863552,1730863604,1730863605.566722,-21600,EB445137-D7F5-57EC-87DA-1DB460D64046,"iPhone13,2"
com.apple.news,191,1730863360,1730863551,1730863551.903908,-21600,EB445137-D7F5-57EC-87DA-1DB460D64046,"iPhone13,2"
com.toyopagroup.picaboo,12,1730863348,1730863360,1730863360.1670408,-21600,EB445137-D7F5-57EC-87DA-1DB460D64046,"iPhone13,2"
com.apple.news,1089,1730862259,1730863348,1730863348.7812939,-21600,EB445137-D7F5-57EC-87DA-1DB460D64046,"iPhone13,2"
com.apple.news,3,1730861241,1730861244,1730861244.3094192,-21600,EB445137-D7F5-57EC-87DA-1DB460D64046,"iPhone13,2"
com.apple.news,17,1730861222,1730861239,1730861240.088341,-21600,EB445137-D7F5-57EC-87DA-1DB460D64046,"iPhone13,2"
com.apple.news,9,1730860849,1730860858,1730860858.87113,-21600,EB445137-D7F5-57EC-87DA-1DB460D64046,"iPhone13,2"
com.apple.news,26,1730860014,1730860040,1730860041.144137,-21600,EB445137-D7F5-57EC-87DA-1DB460D64046,"iPhone13,2"
com.apple.news,8,1730859396,1730859404,1730859404.45701,-21600,EB445137-D7F5-57EC-87DA-1DB460D64046,"iPhone13,2"
com.apple.news,60,1730859119,1730859179,1730859180.0486221,-21600,EB445137-D7F5-57EC-87DA-1DB460D64046,"iPhone13,2"
com.apple.news,28,1730859050,1730859078,1730859078.7003078,-21600,EB445137-D7F5-57EC-87DA-1DB460D64046,"iPhone13,2"
com.apple.news,6,1730858679,1730858685,1730858685.128961,-21600,EB445137-D7F5-57EC-87DA-1DB460D64046,"iPhone13,2"
com.apple.news,7,1730858637,1730858644,1730858644.403481,-21600,EB445137-D7F5-57EC-87DA-1DB460D64046,"iPhone13,2"
com.apple.MobileSMS,4,1730858628,1730858632,1730858632.493185,-21600,EB445137-D7F5-57EC-87DA-1DB460D64046,"iPhone13,2"
com.apple.news,1,1730858627,1730858628,1730858629.5210462,-21600,EB445137-D7F5-57EC-87DA-1DB460D64046,"iPhone13,2"
com.apple.news,85,1730858430,1730858515,1730858515.954967,-21600,,
com.google.Chrome,13,1730858417,1730858430,1730858430.642055,-21600,,
com.apple.MobileSMS,8,1730858409,1730858417,1730858418.0348182,-21600,,
com.apple.news,70,1730858339,1730858409,1730858409.391632,-21600,,
com.microsoft.VSCode,1,1730858338,1730858339,1730858339.7076468,-21600,,
com.apple.MobileSMS,59,1730858279,1730858338,1730858338.815075,-21600,,
com.apple.news,18,1730858261,1730858279,1730858279.993273,-21600,,
com.microsoft.VSCode,143,1730858118,1730858261,1730858261.400607,-21600,,
com.apple.news,43,1730858075,1730858118,1730858118.777139,-21600,,
com.microsoft.VSCode,543,1730857532,1730858075,1730858075.692008,-21600,,
com.apple.news,50,1730857482,1730857532,1730857532.620792,-21600,,
com.microsoft.VSCode,723,1730856759,1730857482,1730857482.569068,-21600,,
com.apple.news,24,1730856735,1730856759,1730856759.297484,-21600,,
com.microsoft.VSCode,89,1730856646,1730856735,1730856735.698494,-21600,,
com.apple.news,8,1730856638,1730856646,1730856646.112032,-21600,,
com.microsoft.VSCode,295,1730856343,1730856638,1730856638.560895,-21600,,
com.apple.finder,6,1730856337,1730856343,1730856343.455361,-21600,,
com.microsoft.VSCode,194,1730856143,1730856337,1730856337.879272,-21600,,
com.apple.news,39,1730856104,1730856143,1730856143.9162068,-21600,,
com.microsoft.VSCode,384,1730855720,1730856104,1730856104.183144,-21600,,
com.apple.news,23,1730855697,1730855720,1730855720.2011142,-21600,,
com.apple.news,6,1730855696,1730855702,1730855702.9065518,-21600,EB445137-D7F5-57EC-87DA-1DB460D64046,"iPhone13,2"
com.microsoft.VSCode,49,1730855648,1730855697,1730855697.890493,-21600,,
com.apple.news,15,1730855633,1730855648,1730855648.758597,-21600,,
com.microsoft.VSCode,206,1730855427,1730855633,1730855633.50219,-21600,,
com.google.Chrome,64,1730855363,1730855427,1730855427.717636,-21600,,
com.microsoft.VSCode,23,1730855340,1730855363,1730855363.589293,-21600,,
com.apple.news,34,1730855306,1730855340,1730855341.039315,-21600,,
com.microsoft.VSCode,91,1730855215,1730855306,1730855306.604332,-21600,,
com.apple.news,5,1730855210,1730855215,1730855215.5318918,-21600,,
com.microsoft.VSCode,11,1730855199,1730855210,1730855210.734349,-21600,,
com.apple.news,10,1730855189,1730855199,1730855199.16643,-21600,,
com.microsoft.VSCode,74,1730855115,1730855189,1730855189.721781,-21600,,
com.apple.news,56,1730855059,1730855115,1730855115.164465,-21600,,
com.google.Chrome,7,1730855052,1730855059,1730855059.208837,-21600,,
com.apple.news,83,1730854967,1730855050,1730855050.639003,-21600,EB445137-D7F5-57EC-87DA-1DB460D64046,"iPhone13,2"
com.apple.news,10,1730854956,1730854966,1730854966.1381469,-21600,EB445137-D7F5-57EC-87DA-1DB460D64046,"iPhone13,2"
com.apple.news,3,1730853898,1730853901,1730853901.191886,-21600,EB445137-D7F5-57EC-87DA-1DB460D64046,"iPhone13,2"
com.apple.news,2,1730853647,1730853649,1730853649.042949,-21600,EB445137-D7F5-57EC-87DA-1DB460D64046,"iPhone13,2"
com.apple.news,21,1730852826,1730852847,1730852848.4148679,-21600,EB445137-D7F5-57EC-87DA-1DB460D64046,"iPhone13,2"
com.toyopagroup.picaboo,3,1730852815,1730852818,1730852818.38632,-21600,EB445137-D7F5-57EC-87DA-1DB460D64046,"iPhone13,2"
com.apple.news,5,1730852810,1730852815,1730852815.412887,-21600,EB445137-D7F5-57EC-87DA-1DB460D64046,"iPhone13,2"
com.apple.news,4,1730852222,1730852226,1730852226.832605,-21600,EB445137-D7F5-57EC-87DA-1DB460D64046,"iPhone13,2"
com.apple.news,6,1730851454,1730851460,1730851460.720639,-21600,EB445137-D7F5-57EC-87DA-1DB460D64046,"iPhone13,2"
com.apple.news,82,1730851337,1730851419,1730851420.548403,-21600,EB445137-D7F5-57EC-87DA-1DB460D64046,"iPhone13,2"
com.robinhood.release.Robinhood,5,1730851327,1730851332,1730851332.967402,-21600,EB445137-D7F5-57EC-87DA-1DB460D64046,"iPhone13,2"
com.robinhood.release.Robinhood,5,1730851146,1730851151,1730851151.919821,-21600,EB445137-D7F5-57EC-87DA-1DB460D64046,"iPhone13,2"
com.google.Chrome,512,1730851113,1730851625,1730851625.8780708,-21600,,
com.microsoft.VSCode,1,1730851112,1730851113,1730851113.848264,-21600,,
com.apple.MobileSMS,4,1730851108,1730851112,1730851112.813869,-21600,,
com.robinhood.release.Robinhood,53,1730851027,1730851080,1730851081.332005,-21600,EB445137-D7F5-57EC-87DA-1DB460D64046,"iPhone13,2"
com.microsoft.VSCode,183,1730850925,1730851108,1730851108.2901049,-21600,,
com.google.Chrome,54,1730850871,1730850925,1730850925.4795,-21600,,
com.apple.news,2,1730850869,1730850871,1730850872.0326629,-21600,,
com.apple.MobileSMS,2,1730850822,1730850824,1730850825.553653,-21600,EB445137-D7F5-57EC-87DA-1DB460D64046,"iPhone13,2"
com.google.Chrome,51,1730850818,1730850869,1730850869.432306,-21600,,
com.toyopagroup.picaboo,4,1730850771,1730850775,1730850775.516155,-21600,EB445137-D7F5-57EC-87DA-1DB460D64046,"iPhone13,2"
com.apple.MobileSMS,37,1730850719,1730850756,1730850756.9070458,-21600,EB445137-D7F5-57EC-87DA-1DB460D64046,"iPhone13,2"
com.apple.mobilecal,11,1730850708,1730850719,1730850720.127119,-21600,EB445137-D7F5-57EC-87DA-1DB460D64046,"iPhone13,2"
com.apple.MobileSMS,12,1730850693,1730850705,1730850705.815126,-21600,EB445137-D7F5-57EC-87DA-1DB460D64046,"iPhone13,2"
com.apple.news,136,1730850553,1730850689,1730850689.6790109,-21600,EB445137-D7F5-57EC-87DA-1DB460D64046,"iPhone13,2"
com.toyopagroup.picaboo,6,1730850543,1730850549,1730850549.19963,-21600,EB445137-D7F5-57EC-87DA-1DB460D64046,"iPhone13,2"
com.toyopagroup.picaboo,3,1730846759,1730846762,1730846763.014626,-21600,EB445137-D7F5-57EC-87DA-1DB460D64046,"iPhone13,2"
com.apple.news,4,1730846755,1730846759,1730846759.484196,-21600,EB445137-D7F5-57EC-87DA-1DB460D64046,"iPhone13,2"
com.google.Chrome,1,1730846739,1730846740,1730846740.861448,-21600,,
com.apple.news,357,1730846382,1730846739,1730846739.3817658,-21600,,
com.google.Chrome,2,1730846380,1730846382,1730846382.356118,-21600,,
com.apple.news,6,1730846310,1730846316,1730846316.6506271,-21600,EB445137-D7F5-57EC-87DA-1DB460D64046,"iPhone13,2"
com.apple.news,6,1730846243,1730846249,1730846249.292698,-21600,EB445137-D7F5-57EC-87DA-1DB460D64046,"iPhone13,2"
com.google.Chrome,351,1730845806,1730846157,1730846157.8538141,-21600,,
com.apple.news,412,1730845394,1730845806,1730845807.07541,-21600,,
com.google.Chrome,1,1730845393,1730845394,1730845394.9151769,-21600,,
com.apple.news,62,1730845225,1730845287,1730845288.2179909,-21600,EB445137-D7F5-57EC-87DA-1DB460D64046,"iPhone13,2"
com.google.chrome.ios,39,1730845186,1730845225,1730845226.152522,-21600,EB445137-D7F5-57EC-87DA-1DB460D64046,"iPhone13,2"
com.apple.news,122,1730845063,1730845185,1730845185.524826,-21600,EB445137-D7F5-57EC-87DA-1DB460D64046,"iPhone13,2"
com.toyopagroup.picaboo,74,1730844966,1730845040,1730845040.968715,-21600,EB445137-D7F5-57EC-87DA-1DB460D64046,"iPhone13,2"
com.ally.MobileBanking,3,1730844122,1730844125,1730844125.556933,-21600,EB445137-D7F5-57EC-87DA-1DB460D64046,"iPhone13,2"
com.hammerandchisel.discord,71,1730844025,1730844096,1730844096.20782,-21600,EB445137-D7F5-57EC-87DA-1DB460D64046,"iPhone13,2"
com.truebill.truebillnative,234,1730843559,1730843793,1730843794.002633,-21600,EB445137-D7F5-57EC-87DA-1DB460D64046,"iPhone13,2"
com.google.Chrome,340,1730843343,1730843683,1730843683.1063042,-21600,,
com.apple.news,123,1730843220,1730843343,1730843343.55638,-21600,,
com.burbn.instagram,47,1730843160,1730843207,1730843207.430008,-21600,EB445137-D7F5-57EC-87DA-1DB460D64046,"iPhone13,2"
com.google.Chrome,129,1730843091,1730843220,1730843220.090101,-21600,,
com.leomehlig.today,10,1730843081,1730843091,1730843091.8390079,-21600,,
com.apple.camera,1,1730842063,1730842064,1730842064.3023381,-21600,EB445137-D7F5-57EC-87DA-1DB460D64046,"iPhone13,2"
com.google.Chrome,1037,1730842044,1730843081,1730843081.764813,-21600,,
com.burbn.instagram,47,1730842013,1730842060,1730842060.6808481,-21600,EB445137-D7F5-57EC-87DA-1DB460D64046,"iPhone13,2"
com.burbn.instagram,28,1730841395,1730841423,1730841423.881709,-21600,EB445137-D7F5-57EC-87DA-1DB460D64046,"iPhone13,2"
com.google.Chrome,451,1730840606,1730841057,1730841057.812809,-21600,,
com.leomehlig.today,2,1730840604,1730840606,1730840606.394438,-21600,,
com.leomehlig.today,96,1730840280,1730840376,1730840376.906359,-21600,,
com.google.Chrome,50,1730840230,1730840280,1730840280.7264109,-21600,,
com.burbn.instagram,133,1730839384,1730839517,1730839517.663276,-21600,EB445137-D7F5-57EC-87DA-1DB460D64046,"iPhone13,2"
Astrospheric.Astrospheric,36,1730839325,1730839361,1730839361.299573,-21600,EB445137-D7F5-57EC-87DA-1DB460D64046,"iPhone13,2"
com.apple.weather,7,1730839315,1730839322,1730839322.779361,-21600,EB445137-D7F5-57EC-87DA-1DB460D64046,"iPhone13,2"
com.burbn.instagram,10,1730839093,1730839103,1730839103.300873,-21600,EB445137-D7F5-57EC-87DA-1DB460D64046,"iPhone13,2"
com.burbn.instagram,63,1730838636,1730838699,1730838700.000677,-21600,EB445137-D7F5-57EC-87DA-1DB460D64046,"iPhone13,2"
com.microsoft.Office.Outlook,54,1730838579,1730838633,1730838633.635931,-21600,EB445137-D7F5-57EC-87DA-1DB460D64046,"iPhone13,2"
com.apple.news,6,1730838573,1730838579,1730838580.0695949,-21600,EB445137-D7F5-57EC-87DA-1DB460D64046,"iPhone13,2"
com.google.Chrome,2029,1730838026,1730840055,1730840055.1123981,-21600,,
com.apple.Passwords,7,1730838019,1730838026,1730838026.197568,-21600,,
com.google.Chrome,1,1730838018,1730838019,1730838019.787951,-21600,,
com.leomehlig.today,3,1730837995,1730837998,1730837998.6781921,-21600,,
com.apple.news,6,1730837909,1730837915,1730837916.004472,-21600,EB445137-D7F5-57EC-87DA-1DB460D64046,"iPhone13,2"
com.apple.news,5,1730837903,1730837908,1730837909.031641,-21600,EB445137-D7F5-57EC-87DA-1DB460D64046,"iPhone13,2"
com.apple.news,69,1730837832,1730837901,1730837902.045394,-21600,EB445137-D7F5-57EC-87DA-1DB460D64046,"iPhone13,2"
com.apple.InCallService,1,1730837774,1730837775,1730837775.597748,-21600,EB445137-D7F5-57EC-87DA-1DB460D64046,"iPhone13,2"
com.apple.InCallService,2,1730837733,1730837735,1730837735.0726151,-21600,EB445137-D7F5-57EC-87DA-1DB460D64046,"iPhone13,2"
com.apple.InCallService,19,1730837710,1730837729,1730837729.485474,-21600,EB445137-D7F5-57EC-87DA-1DB460D64046,"iPhone13,2"
com.apple.InCallService,334,1730837370,1730837704,1730837704.9731522,-21600,EB445137-D7F5-57EC-87DA-1DB460D64046,"iPhone13,2"
com.leomehlig.today,403,1730837159,1730837562,1730837562.9170709,-21600,,
com.apple.InCallService,227,1730837132,1730837359,1730837359.766468,-21600,EB445137-D7F5-57EC-87DA-1DB460D64046,"iPhone13,2"
com.apple.InCallService,94,1730837012,1730837106,1730837106.878954,-21600,EB445137-D7F5-57EC-87DA-1DB460D64046,"iPhone13,2"
com.apple.InCallService,65,1730836893,1730836958,1730836958.9615998,-21600,EB445137-D7F5-57EC-87DA-1DB460D64046,"iPhone13,2"
com.apple.InCallService,82,1730836735,1730836817,1730836817.9030151,-21600,EB445137-D7F5-57EC-87DA-1DB460D64046,"iPhone13,2"
com.apple.InCallService,3,1730836732,1730836735,1730836735.070977,-21600,EB445137-D7F5-57EC-87DA-1DB460D64046,"iPhone13,2"
com.apple.InCallService,2,1730836583,1730836585,1730836585.452323,-21600,EB445137-D7F5-57EC-87DA-1DB460D64046,"iPhone13,2"
com.apple.InCallService,3,1730836522,1730836525,1730836525.083528,-21600,EB445137-D7F5-57EC-87DA-1DB460D64046,"iPhone13,2"
com.apple.InCallService,3,1730836518,1730836521,1730836521.306134,-21600,EB445137-D7F5-57EC-87DA-1DB460D64046,"iPhone13,2"
com.apple.InCallService,1,1730836506,1730836507,1730836507.925411,-21600,EB445137-D7F5-57EC-87DA-1DB460D64046,"iPhone13,2"
com.leomehlig.today,365,1730836488,1730836853,1730836853.631386,-21600,,
com.apple.InCallService,0,1730836486,1730836486,1730836486.912222,-21600,EB445137-D7F5-57EC-87DA-1DB460D64046,"iPhone13,2"
com.apple.InCallService,13,1730836472,1730836485,1730836485.509326,-21600,EB445137-D7F5-57EC-87DA-1DB460D64046,"iPhone13,2"
com.apple.InCallService,2,1730836470,1730836472,1730836472.4005609,-21600,EB445137-D7F5-57EC-87DA-1DB460D64046,"iPhone13,2"
com.apple.InCallService,3,1730836380,1730836383,1730836383.11161,-21600,EB445137-D7F5-57EC-87DA-1DB460D64046,"iPhone13,2"
com.google.Chrome,173,1730836315,1730836488,1730836488.335252,-21600,,
com.apple.InCallService,2,1730836161,1730836163,1730836163.127564,-21600,EB445137-D7F5-57EC-87DA-1DB460D64046,"iPhone13,2"
com.apple.InCallService,18,1730836117,1730836135,1730836135.919498,-21600,EB445137-D7F5-57EC-87DA-1DB460D64046,"iPhone13,2"
com.apple.InCallService,2,1730835190,1730835192,1730835192.6336741,-21600,EB445137-D7F5-57EC-87DA-1DB460D64046,"iPhone13,2"
com.instructure.icanvas,16,1730835171,1730835187,1730835188.1127648,-21600,EB445137-D7F5-57EC-87DA-1DB460D64046,"iPhone13,2"
com.apple.mobilephone,3,1730835168,1730835171,1730835172.078691,-21600,EB445137-D7F5-57EC-87DA-1DB460D64046,"iPhone13,2"
com.apple.mobilephone,3,1730835058,1730835061,1730835061.310557,-21600,EB445137-D7F5-57EC-87DA-1DB460D64046,"iPhone13,2"
com.apple.InCallService,1,1730835057,1730835058,1730835058.060343,-21600,EB445137-D7F5-57EC-87DA-1DB460D64046,"iPhone13,2"
com.apple.InCallService,3,1730835024,1730835027,1730835027.141252,-21600,EB445137-D7F5-57EC-87DA-1DB460D64046,"iPhone13,2"
com.apple.mobilephone,9,1730835015,1730835024,1730835025.369611,-21600,EB445137-D7F5-57EC-87DA-1DB460D64046,"iPhone13,2"
com.apple.MobileSMS,2,1730835013,1730835015,1730835015.135757,-21600,EB445137-D7F5-57EC-87DA-1DB460D64046,"iPhone13,2"
com.apple.findmy,15,1730834997,1730835012,1730835013.162799,-21600,EB445137-D7F5-57EC-87DA-1DB460D64046,"iPhone13,2"
com.burbn.instagram,49,1730834944,1730834993,1730834993.643834,-21600,EB445137-D7F5-57EC-87DA-1DB460D64046,"iPhone13,2"
com.apple.news,4,1730834937,1730834941,1730834941.1345491,-21600,EB445137-D7F5-57EC-87DA-1DB460D64046,"iPhone13,2"
com.apple.news,6,1730834529,1730834535,1730834535.7398372,-21600,EB445137-D7F5-57EC-87DA-1DB460D64046,"iPhone13,2"
com.apple.news,130,1730833757,1730833887,1730833887.951904,-21600,EB445137-D7F5-57EC-87DA-1DB460D64046,"iPhone13,2"
com.apple.news,128,1730833573,1730833701,1730833701.479157,-21600,EB445137-D7F5-57EC-87DA-1DB460D64046,"iPhone13,2"
com.apple.news,2,1730833416,1730833418,1730833418.585711,-21600,EB445137-D7F5-57EC-87DA-1DB460D64046,"iPhone13,2"
com.apple.news,131,1730833243,1730833374,1730833374.688542,-21600,EB445137-D7F5-57EC-87DA-1DB460D64046,"iPhone13,2"
com.apple.news,63,1730833134,1730833197,1730833197.690408,-21600,EB445137-D7F5-57EC-87DA-1DB460D64046,"iPhone13,2"
com.microsoft.Office.Outlook,20,1730833090,1730833110,1730833110.479529,-21600,EB445137-D7F5-57EC-87DA-1DB460D64046,"iPhone13,2"
com.instructure.icanvas,51,1730829623,1730829674,1730829674.656266,-21600,EB445137-D7F5-57EC-87DA-1DB460D64046,"iPhone13,2"
com.instructure.icanvas,18,1730829604,1730829622,1730829622.498642,-21600,EB445137-D7F5-57EC-87DA-1DB460D64046,"iPhone13,2"
com.google.Chrome,109,1730828913,1730829022,1730829023.096801,-21600,,
com.apple.iCal,50,1730828863,1730828913,1730828913.982209,-21600,,
com.google.Chrome,69,1730828794,1730828863,1730828863.5549722,-21600,,
com.apple.news,1010,1730827784,1730828794,1730828794.1979961,-21600,,
com.google.Chrome,2,1730827782,1730827784,1730827784.154438,-21600,,
com.microsoft.VSCode,2,1730827780,1730827782,1730827782.7667332,-21600,,
com.google.Chrome,141,1730827639,1730827780,1730827780.318351,-21600,,
com.apple.news,164,1730827475,1730827639,1730827639.9553618,-21600,,
com.google.Chrome,93,1730827382,1730827475,1730827475.679656,-21600,,
com.apple.news,144,1730827238,1730827382,1730827382.3490372,-21600,,
com.google.Chrome,13,1730827225,1730827238,1730827238.146025,-21600,,
com.microsoft.Office.Outlook,28,1730826737,1730826765,1730826765.2293758,-21600,EB445137-D7F5-57EC-87DA-1DB460D64046,"iPhone13,2"
com.apple.MobileSMS,3,1730826712,1730826715,1730826715.154979,-21600,EB445137-D7F5-57EC-87DA-1DB460D64046,"iPhone13,2"
com.google.chrome.ios,3,1730826709,1730826712,1730826712.6512709,-21600,EB445137-D7F5-57EC-87DA-1DB460D64046,"iPhone13,2"
com.google.chrome.ios,2,1730826375,1730826377,1730826377.059513,-21600,EB445137-D7F5-57EC-87DA-1DB460D64046,"iPhone13,2"
com.google.chrome.ios,8,1730825684,1730825692,1730825692.7894912,-21600,EB445137-D7F5-57EC-87DA-1DB460D64046,"iPhone13,2"
com.google.Chrome,1300,1730825659,1730826959,1730826959.47176,-21600,,
com.apple.MobileSMS,14,1730825645,1730825659,1730825659.165368,-21600,,
com.google.Chrome,12,1730825633,1730825645,1730825645.12284,-21600,,
com.google.chrome.ios,27,1730825492,1730825519,1730825519.760571,-21600,EB445137-D7F5-57EC-87DA-1DB460D64046,"iPhone13,2"
com.google.chrome.ios,69,1730825409,1730825478,1730825478.943612,-21600,EB445137-D7F5-57EC-87DA-1DB460D64046,"iPhone13,2"
com.apple.camera,29,1730825178,1730825207,1730825208.969516,-21600,EB445137-D7F5-57EC-87DA-1DB460D64046,"iPhone13,2"
com.google.Chrome,476,1730824586,1730825062,1730825063.293898,-21600,,
com.microsoft.VSCode,31,1730824555,1730824586,1730824586.7176409,-21600,,
com.google.Chrome,23,1730824532,1730824555,1730824555.159158,-21600,,
com.apple.Preview,90,1730824442,1730824532,1730824532.073147,-21600,,
com.microsoft.VSCode,2,1730824440,1730824442,1730824442.7166,-21600,,
com.apple.MobileSMS,12,1730824428,1730824440,1730824440.328318,-21600,,
com.microsoft.VSCode,566,1730823862,1730824428,1730824429.009602,-21600,,
com.google.Chrome,0,1730823862,1730823862,1730823862.900032,-21600,,
com.microsoft.VSCode,1,1730823861,1730823862,1730823862.087486,-21600,,
com.google.Chrome,2,1730823859,1730823861,1730823861.4008121,-21600,,
com.microsoft.VSCode,106,1730823753,1730823859,1730823859.574932,-21600,,
com.google.Chrome,1,1730823752,1730823753,1730823753.886272,-21600,,
com.microsoft.VSCode,5,1730823747,1730823752,1730823752.9592009,-21600,,
com.google.Chrome,13,1730823734,1730823747,1730823747.479322,-21600,,
com.microsoft.VSCode,7,1730823727,1730823734,1730823734.199837,-21600,,
com.google.Chrome,8,1730823719,1730823727,1730823727.472393,-21600,,
com.microsoft.VSCode,1,1730823718,1730823719,1730823719.4584289,-21600,,
com.google.Chrome,19,1730823699,1730823718,1730823718.14234,-21600,,
com.microsoft.VSCode,1,1730823698,1730823699,1730823699.9790869,-21600,,
com.google.Chrome,1,1730823697,1730823698,1730823698.8242269,-21600,,
com.microsoft.VSCode,13,1730823684,1730823697,1730823697.914763,-21600,,
com.google.Chrome,1,1730823683,1730823684,1730823684.155633,-21600,,
com.microsoft.VSCode,2,1730823681,1730823683,1730823683.285454,-21600,,
com.google.Chrome,1,1730823680,1730823681,1730823681.700238,-21600,,
com.microsoft.VSCode,5,1730823675,1730823680,1730823680.963831,-21600,,
com.google.Chrome,0,1730823675,1730823675,1730823676.059904,-21600,,
com.microsoft.VSCode,2,1730823673,1730823675,1730823675.1183538,-21600,,
com.google.Chrome,1,1730823672,1730823673,1730823673.712733,-21600,,
com.microsoft.VSCode,8,1730823664,1730823672,1730823672.821018,-21600,,
com.google.Chrome,1,1730823663,1730823664,1730823664.4876509,-21600,,
com.microsoft.VSCode,5,1730823658,1730823663,1730823663.842185,-21600,,
com.google.Chrome,0,1730823658,1730823658,1730823658.9570541,-21600,,
com.microsoft.VSCode,1,1730823657,1730823658,1730823658.382925,-21600,,
com.google.Chrome,1,1730823656,1730823657,1730823657.6772199,-21600,,
com.microsoft.VSCode,0,1730823656,1730823656,1730823657.029704,-21600,,
com.google.Chrome,1,1730823655,1730823656,1730823656.322363,-21600,,
com.microsoft.VSCode,1,1730823654,1730823655,1730823655.65466,-21600,,
com.google.Chrome,0,1730823654,1730823654,1730823655.000577,-21600,,
com.microsoft.VSCode,10,1730823644,1730823654,1730823654.411724,-21600,,
com.google.Chrome,1,1730823643,1730823644,1730823644.5847092,-21600,,
com.microsoft.VSCode,16,1730823627,1730823643,1730823643.8078408,-21600,,
com.google.Chrome,1,1730823626,1730823627,1730823627.510625,-21600,,
com.microsoft.VSCode,1,1730823625,1730823626,1730823626.738251,-21600,,
com.google.Chrome,4,1730823621,1730823625,1730823625.781898,-21600,,
com.microsoft.VSCode,0,1730823621,1730823621,1730823621.653801,-21600,,
com.google.Chrome,2,1730823619,1730823621,1730823621.111306,-21600,,
com.microsoft.VSCode,0,1730823619,1730823619,1730823619.831266,-21600,,
com.google.Chrome,2,1730823617,1730823619,1730823619.213107,-21600,,
com.microsoft.VSCode,38,1730823579,1730823617,1730823618.018906,-21600,,
com.google.Chrome,3,1730823576,1730823579,1730823579.560226,-21600,,
com.microsoft.VSCode,141,1730823435,1730823576,1730823576.3862848,-21600,,
com.google.Chrome,1,1730823434,1730823435,1730823435.340869,-21600,,
com.microsoft.VSCode,4,1730823430,1730823434,1730823434.5296369,-21600,,
com.google.Chrome,1,1730823429,1730823430,1730823430.717618,-21600,,
com.microsoft.VSCode,33,1730823396,1730823429,1730823429.071075,-21600,,
com.google.Chrome,18,1730823378,1730823396,1730823396.973383,-21600,,
com.microsoft.VSCode,30,1730823348,1730823378,1730823378.601536,-21600,,
com.google.Chrome,7,1730823341,1730823348,1730823348.622782,-21600,,
com.microsoft.VSCode,114,1730823227,1730823341,1730823341.837276,-21600,,
com.google.Chrome,2,1730823225,1730823227,1730823227.548232,-21600,,
com.microsoft.VSCode,3,1730823222,1730823225,1730823225.753593,-21600,,
com.google.Chrome,1,1730823221,1730823222,1730823222.636332,-21600,,
com.microsoft.VSCode,7,1730823214,1730823221,1730823221.255785,-21600,,
com.google.Chrome,43,1730823171,1730823214,1730823214.4979749,-21600,,
com.microsoft.VSCode,7,1730823164,1730823171,1730823171.220409,-21600,,
com.google.Chrome,31,1730823133,1730823164,1730823164.602598,-21600,,
com.microsoft.VSCode,80,1730823053,1730823133,1730823133.71458,-21600,,
com.google.Chrome,12,1730823041,1730823053,1730823053.4762158,-21600,,
com.microsoft.VSCode,726,1730822315,1730823041,1730823041.3704572,-21600,,
com.google.Chrome,1,1730822314,1730822315,1730822315.144436,-21600,,
com.microsoft.VSCode,30,1730822284,1730822314,1730822314.053852,-21600,,
com.google.Chrome,7,1730822277,1730822284,1730822284.142751,-21600,,
com.microsoft.VSCode,42,1730822235,1730822277,1730822277.876951,-21600,,
com.google.Chrome,17,1730822218,1730822235,1730822235.073964,-21600,,
com.microsoft.VSCode,38,1730822180,1730822218,1730822218.5594049,-21600,,
com.google.Chrome,1,1730822179,1730822180,1730822180.5173988,-21600,,
com.microsoft.VSCode,2,1730822177,1730822179,1730822179.514436,-21600,,
com.google.Chrome,1,1730822176,1730822177,1730822178.009903,-21600,,
com.microsoft.VSCode,3,1730822173,1730822176,1730822176.444059,-21600,,
com.google.Chrome,3,1730822170,1730822173,1730822173.5425,-21600,,
com.microsoft.VSCode,2,1730822168,1730822170,1730822170.810468,-21600,,
com.google.Chrome,1,1730822167,1730822168,1730822168.996887,-21600,,
com.microsoft.VSCode,3,1730822164,1730822167,1730822167.272517,-21600,,
com.google.Chrome,3,1730822161,1730822164,1730822164.4414148,-21600,,
com.microsoft.VSCode,3,1730822158,1730822161,1730822161.462162,-21600,,
com.google.Chrome,1,1730822157,1730822158,1730822158.919517,-21600,,
com.microsoft.VSCode,3,1730822154,1730822157,1730822158.0200958,-21600,,
com.google.Chrome,1,1730822153,1730822154,1730822154.937377,-21600,,
com.microsoft.VSCode,23,1730822130,1730822153,1730822153.1894732,-21600,,
com.google.Chrome,3,1730822127,1730822130,1730822130.840277,-21600,,
com.microsoft.VSCode,6,1730822121,1730822127,1730822128.026394,-21600,,
com.google.Chrome,1,1730822120,1730822121,1730822121.9649282,-21600,,
com.microsoft.VSCode,4,1730822116,1730822120,1730822120.970914,-21600,,
com.google.Chrome,4,1730822112,1730822116,1730822116.171897,-21600,,
com.microsoft.VSCode,17,1730822095,1730822112,1730822113.003618,-21600,,
com.google.Chrome,1,1730822094,1730822095,1730822095.321327,-21600,,
com.microsoft.VSCode,6,1730822088,1730822094,1730822094.243355,-21600,,
com.google.Chrome,5,1730822083,1730822088,1730822089.024929,-21600,,
com.microsoft.VSCode,4,1730822079,1730822083,1730822083.4438128,-21600,,
com.google.Chrome,1,1730822078,1730822079,1730822080.037667,-21600,,
com.microsoft.VSCode,13,1730822065,1730822078,1730822078.969832,-21600,,
com.google.Chrome,41,1730822024,1730822065,1730822065.483757,-21600,,
com.microsoft.VSCode,99,1730821925,1730822024,1730822024.2348099,-21600,,
com.google.Chrome,2,1730821923,1730821925,1730821925.634064,-21600,,
com.microsoft.VSCode,2,1730821921,1730821923,1730821923.976887,-21600,,
com.google.Chrome,23,1730821898,1730821921,1730821921.4039779,-21600,,
com.microsoft.VSCode,16,1730821882,1730821898,1730821898.190397,-21600,,
com.google.Chrome,2,1730821880,1730821882,1730821882.330432,-21600,,
com.microsoft.VSCode,14,1730821866,1730821880,1730821880.320782,-21600,,
com.google.Chrome,1,1730821865,1730821866,1730821866.260623,-21600,,
com.microsoft.VSCode,2,1730821863,1730821865,1730821865.357631,-21600,,
com.google.Chrome,1,1730821862,1730821863,1730821863.044791,-21600,,
com.microsoft.VSCode,4,1730821858,1730821862,1730821862.342447,-21600,,
com.google.Chrome,1,1730821857,1730821858,1730821858.989393,-21600,,
com.microsoft.VSCode,8,1730821849,1730821857,1730821857.5803862,-21600,,
com.google.Chrome,34,1730821815,1730821849,1730821849.2629309,-21600,,
com.microsoft.VSCode,21,1730821794,1730821815,1730821815.95816,-21600,,
com.google.Chrome,2,1730821792,1730821794,1730821794.819666,-21600,,
com.microsoft.VSCode,49,1730821743,1730821792,1730821792.2061229,-21600,,
com.google.Chrome,5,1730821738,1730821743,1730821743.766512,-21600,,
com.microsoft.VSCode,7,1730821731,1730821738,1730821738.9501061,-21600,,
com.google.Chrome,4,1730821727,1730821731,1730821731.4754062,-21600,,
com.microsoft.VSCode,6,1730821721,1730821727,1730821727.4395041,-21600,,
com.google.Chrome,3,1730821718,1730821721,1730821721.702488,-21600,,
com.microsoft.VSCode,9,1730821709,1730821718,1730821718.09216,-21600,,
com.google.Chrome,1,1730821708,1730821709,1730821709.856852,-21600,,
com.microsoft.VSCode,3,1730821705,1730821708,1730821708.352038,-21600,,
com.google.Chrome,1,1730821704,1730821705,1730821705.938292,-21600,,
com.microsoft.VSCode,1,1730821703,1730821704,1730821704.989044,-21600,,
com.google.Chrome,3,1730821700,1730821703,1730821703.503529,-21600,,
com.microsoft.VSCode,5,1730821695,1730821700,1730821700.666625,-21600,,
com.google.Chrome,1,1730821694,1730821695,1730821695.472868,-21600,,
com.microsoft.VSCode,6,1730821688,1730821694,1730821694.188655,-21600,,
com.google.Chrome,1,1730821687,1730821688,1730821688.844785,-21600,,
com.microsoft.VSCode,5,1730821682,1730821687,1730821687.342908,-21600,,
com.google.Chrome,17,1730821665,1730821682,1730821682.76761,-21600,,
com.microsoft.VSCode,24,1730821641,1730821665,1730821665.4318938,-21600,,
com.google.Chrome,1,1730821640,1730821641,1730821641.88419,-21600,,
com.microsoft.VSCode,17,1730821623,1730821640,1730821640.428983,-21600,,
com.google.Chrome,1,1730821622,1730821623,1730821623.82975,-21600,,
com.microsoft.VSCode,4,1730821618,1730821622,1730821622.894349,-21600,,
com.google.Chrome,2,1730821616,1730821618,1730821618.442198,-21600,,
com.microsoft.VSCode,28,1730821588,1730821616,1730821616.173883,-21600,,
com.google.Chrome,2,1730821586,1730821588,1730821588.412966,-21600,,
com.microsoft.VSCode,3,1730821583,1730821586,1730821587.011549,-21600,,
com.google.Chrome,2,1730821581,1730821583,1730821583.3129702,-21600,,
com.microsoft.VSCode,4,1730821577,1730821581,1730821582.0339289,-21600,,
com.google.Chrome,4,1730821573,1730821577,1730821577.863447,-21600,,
com.microsoft.VSCode,20,1730821553,1730821573,1730821573.551827,-21600,,
com.google.Chrome,1,1730821552,1730821553,1730821553.5089889,-21600,,
com.microsoft.VSCode,31,1730821521,1730821552,1730821552.0582,-21600,,
com.google.Chrome,26,1730821495,1730821521,1730821521.159848,-21600,,
com.microsoft.VSCode,8,1730821487,1730821495,1730821495.954345,-21600,,
com.google.Chrome,2,1730821485,1730821487,1730821487.2461371,-21600,,
com.microsoft.VSCode,4,1730821481,1730821485,1730821485.684369,-21600,,
com.google.Chrome,2,1730821479,1730821481,1730821481.509094,-21600,,
com.microsoft.VSCode,14,1730821465,1730821479,1730821479.860235,-21600,,
com.google.Chrome,74,1730821391,1730821465,1730821465.90713,-21600,,
com.microsoft.VSCode,449,1730820942,1730821391,1730821391.3462172,-21600,,
com.apple.finder,2,1730820940,1730820942,1730820942.29326,-21600,,
com.microsoft.VSCode,11,1730820929,1730820940,1730820940.6679912,-21600,,
com.apple.finder,22,1730820907,1730820929,1730820929.782277,-21600,,
com.google.Chrome,41,1730820866,1730820907,1730820907.7788801,-21600,,
com.apple.news,18,1730819900,1730819918,1730819921.091165,-21600,EB445137-D7F5-57EC-87DA-1DB460D64046,"iPhone13,2"
com.apple.weather,5,1730819895,1730819900,1730819901.689271,-21600,EB445137-D7F5-57EC-87DA-1DB460D64046,"iPhone13,2"
com.google.Chrome,731,1730818843,1730819574,1730819575.231251,-21600,,
com.apple.weather,3,1730818489,1730818492,1730818492.321783,-21600,EB445137-D7F5-57EC-87DA-1DB460D64046,"iPhone13,2"
com.apple.weather,12,1730818446,1730818458,1730818458.018441,-21600,EB445137-D7F5-57EC-87DA-1DB460D64046,"iPhone13,2"
com.apple.weather,21,1730818411,1730818432,1730818432.7765489,-21600,EB445137-D7F5-57EC-87DA-1DB460D64046,"iPhone13,2"
com.apple.weather,10,1730818364,1730818374,1730818374.4771771,-21600,EB445137-D7F5-57EC-87DA-1DB460D64046,"iPhone13,2"
com.apple.weather,4,1730818352,1730818356,1730818356.325167,-21600,EB445137-D7F5-57EC-87DA-1DB460D64046,"iPhone13,2"
com.google.Chrome,587,1730818057,1730818644,1730818644.9221191,-21600,,
com.apple.weather,5,1730817869,1730817874,1730817874.326908,-21600,EB445137-D7F5-57EC-87DA-1DB460D64046,"iPhone13,2"
com.apple.weather,17,1730817798,1730817815,1730817816.361284,-21600,EB445137-D7F5-57EC-87DA-1DB460D64046,"iPhone13,2"
com.renpho.health,35,1730817707,1730817742,1730817742.163856,-21600,EB445137-D7F5-57EC-87DA-1DB460D64046,"iPhone13,2"
com.clairmail.fth.client,40,1730817629,1730817669,1730817669.534311,-21600,EB445137-D7F5-57EC-87DA-1DB460D64046,"iPhone13,2"
com.burbn.instagram,97,1730787673,1730787770,1730787770.1551008,-21600,EB445137-D7F5-57EC-87DA-1DB460D64046,"iPhone13,2"
com.google.chrome.ios,72,1730787597,1730787669,1730787669.189937,-21600,EB445137-D7F5-57EC-87DA-1DB460D64046,"iPhone13,2"
com.google.Chrome,104,1730785699,1730785803,1730785803.946519,-21600,,
com.leomehlig.today,38,1730785661,1730785699,1730785699.70103,-21600,,
com.google.Chrome,305,1730785356,1730785661,1730785661.157332,-21600,,
com.google.Chrome,648,1730784606,1730785254,1730785254.119297,-21600,,
com.apple.Preview,0,1730784606,1730784606,1730784606.497194,-21600,,
com.google.Chrome,570,1730784036,1730784606,1730784606.228631,-21600,,
com.google.Chrome,808,1730782846,1730783654,1730783654.56186,-21600,,
com.google.Chrome,374,1730781659,1730782033,1730782033.8584661,-21600,,
com.apple.iCal,35,1730781624,1730781659,1730781659.329042,-21600,,
com.google.Chrome,2,1730781622,1730781624,1730781624.49833,-21600,,
com.google.Chrome,904,1730780128,1730781032,1730781032.687309,-21600,,
com.google.Chrome,761,1730779362,1730780123,1730780123.248637,-21600,,
com.microsoft.VSCode,167,1730779195,1730779362,1730779362.4609718,-21600,,
com.google.Chrome,2,1730779193,1730779195,1730779195.3516831,-21600,,
com.apple.weather,5,1730777549,1730777554,1730777554.246602,-21600,EB445137-D7F5-57EC-87DA-1DB460D64046,"iPhone13,2"
com.apple.weather,1,1730777548,1730777549,1730777549.430491,-21600,EB445137-D7F5-57EC-87DA-1DB460D64046,"iPhone13,2"
com.apple.weather,10,1730777502,1730777512,1730777512.806514,-21600,EB445137-D7F5-57EC-87DA-1DB460D64046,"iPhone13,2"
com.google.Chrome,479,1730777068,1730777547,1730777547.785162,-21600,,
com.leomehlig.today,281,1730776764,1730777045,1730777045.173256,-21600,,
com.google.Chrome,64,1730776700,1730776764,1730776764.9246612,-21600,,
com.apple.Preview,90,1730776610,1730776700,1730776700.908362,-21600,,
com.microsoft.VSCode,86,1730776524,1730776610,1730776610.9619389,-21600,,
com.hnc.Discord,4,1730776520,1730776524,1730776524.589292,-21600,,
com.microsoft.VSCode,87,1730776433,1730776520,1730776520.121526,-21600,,
com.hnc.Discord,4,1730776429,1730776433,1730776434.010793,-21600,,
com.microsoft.VSCode,22,1730776407,1730776429,1730776429.4334478,-21600,,
com.hnc.Discord,3,1730776404,1730776407,1730776407.149938,-21600,,
com.microsoft.VSCode,1,1730776403,1730776404,1730776404.950251,-21600,,
com.hnc.Discord,11,1730776392,1730776403,1730776403.315782,-21600,,
com.microsoft.VSCode,121,1730776271,1730776392,1730776392.164266,-21600,,
com.hnc.Discord,2,1730776269,1730776271,1730776271.247357,-21600,,
com.microsoft.VSCode,14,1730776255,1730776269,1730776270.008181,-21600,,
com.hnc.Discord,2,1730776253,1730776255,1730776255.349654,-21600,,
com.microsoft.VSCode,18,1730776235,1730776253,1730776253.167304,-21600,,
com.hnc.Discord,47,1730776188,1730776235,1730776235.150353,-21600,,
com.microsoft.VSCode,2,1730776186,1730776188,1730776189.177271,-21600,,
com.google.Chrome,4,1730776182,1730776186,1730776186.113212,-21600,,
com.leomehlig.today,13,1730776169,1730776182,1730776182.620391,-21600,,
com.apple.iCal,7,1730776162,1730776169,1730776169.143556,-21600,,
com.leomehlig.today,11,1730776151,1730776162,1730776162.225686,-21600,,
com.toyopagroup.picaboo,6,1730776143,1730776149,1730776150.0565472,-21600,EB445137-D7F5-57EC-87DA-1DB460D64046,"iPhone13,2"
com.google.chrome.ios,12,1730776131,1730776143,1730776143.761989,-21600,EB445137-D7F5-57EC-87DA-1DB460D64046,"iPhone13,2"
com.google.chrome.ios,7,1730776029,1730776036,1730776036.479521,-21600,EB445137-D7F5-57EC-87DA-1DB460D64046,"iPhone13,2"
com.apple.camera,29,1730774937,1730774966,1730774974.0684428,-21600,EB445137-D7F5-57EC-87DA-1DB460D64046,"iPhone13,2"
com.google.chrome.ios,34,1730774932,1730774966,1730774974.082463,-21600,EB445137-D7F5-57EC-87DA-1DB460D64046,"iPhone13,2"
com.google.chrome.ios,24,1730773330,1730773354,1730773354.116513,-21600,EB445137-D7F5-57EC-87DA-1DB460D64046,"iPhone13,2"
com.google.chrome.ios,22,1730773231,1730773253,1730773254.46024,-21600,EB445137-D7F5-57EC-87DA-1DB460D64046,"iPhone13,2"
com.google.chrome.ios,38,1730771303,1730771341,1730771341.9918041,-21600,EB445137-D7F5-57EC-87DA-1DB460D64046,"iPhone13,2"
com.apple.MobileSMS,2,1730771300,1730771302,1730771303.1286979,-21600,EB445137-D7F5-57EC-87DA-1DB460D64046,"iPhone13,2"
com.apple.MobileSMS,10,1730771261,1730771271,1730771272.149117,-21600,EB445137-D7F5-57EC-87DA-1DB460D64046,"iPhone13,2"
com.google.Gmail,10,1730771250,1730771260,1730771260.47736,-21600,EB445137-D7F5-57EC-87DA-1DB460D64046,"iPhone13,2"
com.apple.MobileSMS,21,1730771229,1730771250,1730771250.959343,-21600,EB445137-D7F5-57EC-87DA-1DB460D64046,"iPhone13,2"
com.google.chrome.ios,51,1730771178,1730771229,1730771229.296762,-21600,EB445137-D7F5-57EC-87DA-1DB460D64046,"iPhone13,2"
com.apple.MobileSMS,16,1730771162,1730771178,1730771178.347993,-21600,EB445137-D7F5-57EC-87DA-1DB460D64046,"iPhone13,2"
com.google.Gmail,8,1730771154,1730771162,1730771162.391041,-21600,EB445137-D7F5-57EC-87DA-1DB460D64046,"iPhone13,2"
com.google.Gmail,3,1730771088,1730771091,1730771091.8918629,-21600,EB445137-D7F5-57EC-87DA-1DB460D64046,"iPhone13,2"
com.apple.news,150,1730768583,1730768733,1730768734.173929,-21600,EB445137-D7F5-57EC-87DA-1DB460D64046,"iPhone13,2"
com.apple.news,4,1730768553,1730768557,1730768557.862963,-21600,EB445137-D7F5-57EC-87DA-1DB460D64046,"iPhone13,2"
com.apple.news,170,1730768381,1730768551,1730768551.546896,-21600,EB445137-D7F5-57EC-87DA-1DB460D64046,"iPhone13,2"
com.hammerandchisel.discord,18,1730768358,1730768376,1730768376.5151858,-21600,EB445137-D7F5-57EC-87DA-1DB460D64046,"iPhone13,2"
com.hammerandchisel.discord,11,1730768124,1730768135,1730768136.0448508,-21600,EB445137-D7F5-57EC-87DA-1DB460D64046,"iPhone13,2"
com.google.chrome.ios,34,1730768008,1730768042,1730768043.315857,-21600,EB445137-D7F5-57EC-87DA-1DB460D64046,"iPhone13,2"
com.google.chrome.ios,13,1730767994,1730768007,1730768007.384954,-21600,EB445137-D7F5-57EC-87DA-1DB460D64046,"iPhone13,2"
com.microsoft.Office.Outlook,4,1730767990,1730767994,1730767995.10197,-21600,EB445137-D7F5-57EC-87DA-1DB460D64046,"iPhone13,2"
com.clairmail.fth.client,33,1730767957,1730767990,1730767990.8004951,-21600,EB445137-D7F5-57EC-87DA-1DB460D64046,"iPhone13,2"
com.microsoft.Office.Outlook,9,1730767948,1730767957,1730767957.621727,-21600,EB445137-D7F5-57EC-87DA-1DB460D64046,"iPhone13,2"
com.apple.MobileSMS,7,1730767941,1730767948,1730767948.682137,-21600,EB445137-D7F5-57EC-87DA-1DB460D64046,"iPhone13,2"
com.apple.MobileSMS,59,1730767749,1730767808,1730767808.29287,-21600,EB445137-D7F5-57EC-87DA-1DB460D64046,"iPhone13,2"
com.apple.MobileSMS,12,1730767737,1730767749,1730767749.571652,-21600,EB445137-D7F5-57EC-87DA-1DB460D64046,"iPhone13,2"
com.apple.MobileSMS,15,1730763586,1730763601,1730763601.5495028,-21600,EB445137-D7F5-57EC-87DA-1DB460D64046,"iPhone13,2"
com.apple.MobileSMS,0,1730763583,1730763583,1730763583.5706968,-21600,EB445137-D7F5-57EC-87DA-1DB460D64046,"iPhone13,2"
com.apple.MobileSMS,49,1730763342,1730763391,1730763391.01737,-21600,EB445137-D7F5-57EC-87DA-1DB460D64046,"iPhone13,2"
com.apple.MobileSMS,27,1730763299,1730763326,1730763327.0936651,-21600,EB445137-D7F5-57EC-87DA-1DB460D64046,"iPhone13,2"
com.apple.MobileSMS,4,1730763253,1730763257,1730763257.31234,-21600,EB445137-D7F5-57EC-87DA-1DB460D64046,"iPhone13,2"
com.apple.MobileSMS,1,1730763126,1730763127,1730763127.264847,-21600,EB445137-D7F5-57EC-87DA-1DB460D64046,"iPhone13,2"
com.apple.MobileSMS,6,1730763119,1730763125,1730763125.81525,-21600,EB445137-D7F5-57EC-87DA-1DB460D64046,"iPhone13,2"
com.apple.Maps,4,1730763115,1730763119,1730763119.594094,-21600,EB445137-D7F5-57EC-87DA-1DB460D64046,"iPhone13,2"
com.apple.Maps,1,1730763052,1730763053,1730763053.967155,-21600,EB445137-D7F5-57EC-87DA-1DB460D64046,"iPhone13,2"
com.apple.Maps,2,1730763047,1730763049,1730763049.173732,-21600,EB445137-D7F5-57EC-87DA-1DB460D64046,"iPhone13,2"
com.apple.MobileSMS,8,1730763039,1730763047,1730763047.499432,-21600,EB445137-D7F5-57EC-87DA-1DB460D64046,"iPhone13,2"
com.apple.Maps,11,1730763024,1730763035,1730763036.029552,-21600,EB445137-D7F5-57EC-87DA-1DB460D64046,"iPhone13,2"
com.apple.Maps,15,1730762886,1730762901,1730762901.61503,-21600,EB445137-D7F5-57EC-87DA-1DB460D64046,"iPhone13,2"
com.apple.weather,3,1730762618,1730762621,1730762621.777993,-21600,EB445137-D7F5-57EC-87DA-1DB460D64046,"iPhone13,2"
com.apple.weather,14,1730762385,1730762399,1730762399.677938,-21600,EB445137-D7F5-57EC-87DA-1DB460D64046,"iPhone13,2"
com.apple.news,3,1730762381,1730762384,1730762384.959312,-21600,EB445137-D7F5-57EC-87DA-1DB460D64046,"iPhone13,2"
com.apple.news,278,1730761991,1730762269,1730762269.796537,-21600,EB445137-D7F5-57EC-87DA-1DB460D64046,"iPhone13,2"
com.hammerandchisel.discord,78,1730761847,1730761925,1730761925.616261,-21600,EB445137-D7F5-57EC-87DA-1DB460D64046,"iPhone13,2"
com.google.ios.youtube,546,1730761241,1730761787,1730761788.782423,-21600,EB445137-D7F5-57EC-87DA-1DB460D64046,"iPhone13,2"
com.google.chrome.ios,29,1730761212,1730761241,1730761241.686333,-21600,EB445137-D7F5-57EC-87DA-1DB460D64046,"iPhone13,2"
com.google.ios.youtube,391,1730760821,1730761212,1730761213.338784,-21600,EB445137-D7F5-57EC-87DA-1DB460D64046,"iPhone13,2"
com.google.ios.youtube,75,1730760745,1730760820,1730760821.941708,-21600,EB445137-D7F5-57EC-87DA-1DB460D64046,"iPhone13,2"
com.facebook.Facebook,382,1730760360,1730760742,1730760742.9943619,-21600,EB445137-D7F5-57EC-87DA-1DB460D64046,"iPhone13,2"
com.leomehlig.today,317,1730760192,1730760509,1730760509.613059,-21600,,
com.google.chrome.ios,36,1730759725,1730759761,1730759762.130893,-21600,EB445137-D7F5-57EC-87DA-1DB460D64046,"iPhone13,2"
com.microsoft.Office.Outlook,28,1730759697,1730759725,1730759725.577941,-21600,EB445137-D7F5-57EC-87DA-1DB460D64046,"iPhone13,2"
Astrospheric.Astrospheric,7,1730759687,1730759694,1730759694.783855,-21600,EB445137-D7F5-57EC-87DA-1DB460D64046,"iPhone13,2"
com.google.Chrome,1553,1730758639,1730760192,1730760192.1163092,-21600,,
com.leomehlig.today,181,1730758458,1730758639,1730758639.52941,-21600,,
com.google.Chrome,6,1730758452,1730758458,1730758458.765656,-21600,,
com.apple.MobileSMS,74,1730758378,1730758452,1730758452.579077,-21600,,
Astrospheric.Astrospheric,11,1730758355,1730758366,1730758366.563939,-21600,EB445137-D7F5-57EC-87DA-1DB460D64046,"iPhone13,2"
com.google.chrome.ios,173,1730758179,1730758352,1730758352.5290341,-21600,EB445137-D7F5-57EC-87DA-1DB460D64046,"iPhone13,2"
com.google.Chrome,262,1730758116,1730758378,1730758378.2288861,-21600,,
com.apple.iCal,8,1730758108,1730758116,1730758116.641199,-21600,,
com.google.Chrome,14,1730758094,1730758108,1730758108.999912,-21600,,
com.apple.FaceTime,3,1730758091,1730758094,1730758095.68979,-21600,,
com.hammerandchisel.discord,166,1730758012,1730758178,1730758179.033774,-21600,EB445137-D7F5-57EC-87DA-1DB460D64046,"iPhone13,2"
com.google.Gmail,84,1730757928,1730758012,1730758012.531112,-21600,EB445137-D7F5-57EC-87DA-1DB460D64046,"iPhone13,2"
com.facebook.Facebook,3,1730757922,1730757925,1730757925.2675529,-21600,EB445137-D7F5-57EC-87DA-1DB460D64046,"iPhone13,2"
com.google.Chrome,201,1730757890,1730758091,1730758091.089051,-21600,,
com.apple.MobileSMS,4,1730757886,1730757890,1730757890.153033,-21600,,
com.apple.FaceTime,70,1730757816,1730757886,1730757886.527452,-21600,,
com.google.Chrome,11,1730757805,1730757816,1730757816.543705,-21600,,
com.apple.FaceTime,23,1730757782,1730757805,1730757805.466346,-21600,,
com.google.Chrome,141,1730757641,1730757782,1730757783.02019,-21600,,
com.apple.FaceTime,5,1730757636,1730757641,1730757641.7835789,-21600,,
com.google.Chrome,328,1730757308,1730757636,1730757636.4273782,-21600,,
com.apple.MobileSMS,5,1730757303,1730757308,1730757308.148271,-21600,,
com.google.Chrome,318,1730756985,1730757303,1730757303.931236,-21600,,
com.apple.MobileSMS,1,1730756984,1730756985,1730756985.8911982,-21600,,
com.apple.MobileSMS,373,1730756568,1730756941,1730756941.3900928,-21600,,
com.apple.iCal,65,1730756503,1730756568,1730756568.7139812,-21600,,
com.facebook.Facebook,19,1730756499,1730756518,1730756518.873767,-21600,EB445137-D7F5-57EC-87DA-1DB460D64046,"iPhone13,2"
com.facebook.Facebook,7,1730756365,1730756372,1730756372.5530481,-21600,EB445137-D7F5-57EC-87DA-1DB460D64046,"iPhone13,2"
com.facebook.Facebook,10,1730756349,1730756359,1730756359.112881,-21600,EB445137-D7F5-57EC-87DA-1DB460D64046,"iPhone13,2"
com.facebook.Facebook,14,1730756097,1730756111,1730756111.8103418,-21600,EB445137-D7F5-57EC-87DA-1DB460D64046,"iPhone13,2"
com.apple.findmy,14,1730756079,1730756093,1730756093.743715,-21600,EB445137-D7F5-57EC-87DA-1DB460D64046,"iPhone13,2"
com.apple.MobileSMS,462,1730756041,1730756503,1730756503.247003,-21600,,
com.apple.findmy,13,1730755435,1730755448,1730755448.2271981,-21600,EB445137-D7F5-57EC-87DA-1DB460D64046,"iPhone13,2"
com.apple.MobileSMS,462,1730755284,1730755746,1730755746.87537,-21600,,
com.apple.FaceTime,3,1730755281,1730755284,1730755284.320992,-21600,,
com.apple.findmy,15,1730755257,1730755272,1730755273.599855,-21600,EB445137-D7F5-57EC-87DA-1DB460D64046,"iPhone13,2"
com.apple.news,12,1730755245,1730755257,1730755257.6476169,-21600,EB445137-D7F5-57EC-87DA-1DB460D64046,"iPhone13,2"
com.apple.MobileSMS,150,1730755131,1730755281,1730755281.74193,-21600,,
com.google.Chrome,422,1730754709,1730755131,1730755131.2823,-21600,,
com.apple.Photos,19,1730754690,1730754709,1730754709.902515,-21600,,
com.google.Chrome,4,1730754686,1730754690,1730754690.326226,-21600,,
com.apple.Photos,43,1730754643,1730754686,1730754686.375849,-21600,,
com.google.Chrome,59,1730754584,1730754643,1730754643.661687,-21600,,
com.apple.MobileSMS,1,1730754583,1730754584,1730754584.3899388,-21600,,
com.apple.AddressBook,5,1730754578,1730754583,1730754583.6780682,-21600,,
com.apple.MobileSMS,7,1730754571,1730754578,1730754578.109593,-21600,,
com.google.Chrome,76,1730754495,1730754571,1730754571.371526,-21600,,
com.apple.keychainaccess,1,1730754494,1730754495,1730754495.7825809,-21600,,
com.google.Chrome,17,1730754462,1730754479,1730754479.70399,-21600,,
com.apple.Passwords,13,1730754396,1730754409,1730754409.762222,-21600,,
com.google.Chrome,16,1730754380,1730754396,1730754396.228092,-21600,,
com.apple.MobileSMS,1,1730754356,1730754357,1730754357.403394,-21600,,
com.leomehlig.today,1,1730754355,1730754356,1730754356.262186,-21600,,
com.apple.MobileSMS,31,1730754324,1730754355,1730754355.418024,-21600,,
com.leomehlig.today,1,1730754323,1730754324,1730754324.790063,-21600,,
com.google.Chrome,25,1730754298,1730754323,1730754324.001233,-21600,,
com.leomehlig.today,1,1730754297,1730754298,1730754298.4584498,-21600,,
com.apple.MobileSMS,6,1730754291,1730754297,1730754297.405731,-21600,,
com.leomehlig.today,1,1730754290,1730754291,1730754291.773077,-21600,,
com.google.Chrome,5,1730754285,1730754290,1730754290.355418,-21600,,
com.leomehlig.today,14,1730754271,1730754285,1730754285.976222,-21600,,
com.google.Chrome,39,1730754232,1730754271,1730754271.395067,-21600,,
com.apple.MobileSMS,14,1730754218,1730754232,1730754232.8349729,-21600,,
com.google.Chrome,13,1730754205,1730754218,1730754218.939948,-21600,,
com.apple.MobileSMS,2,1730754203,1730754205,1730754205.6615539,-21600,,
com.google.Chrome,2,1730754201,1730754203,1730754203.1993232,-21600,,
com.apple.MobileSMS,4,1730754197,1730754201,1730754201.641026,-21600,,
com.google.Chrome,1180,1730753017,1730754197,1730754197.390315,-21600,,
com.leomehlig.today,22,1730752995,1730753017,1730753017.486053,-21600,,
com.google.Chrome,5,1730752990,1730752995,1730752995.928891,-21600,,
com.leomehlig.today,24,1730752966,1730752990,1730752990.348812,-21600,,
com.google.Chrome,1,1730752965,1730752966,1730752966.8231158,-21600,,
com.leomehlig.today,2,1730752960,1730752962,1730752962.26574,-21600,,
com.google.Chrome,42,1730752918,1730752960,1730752960.47992,-21600,,
com.leomehlig.today,2,1730752916,1730752918,1730752919.291586,-21600,,
com.apple.iCal,9,1730752907,1730752916,1730752916.212831,-21600,,
com.leomehlig.today,9,1730752898,1730752907,1730752907.829658,-21600,,
com.google.Chrome,9,1730752889,1730752898,1730752898.600607,-21600,,
com.apple.news,318,1730752442,1730752760,1730752761.054757,-21600,EB445137-D7F5-57EC-87DA-1DB460D64046,"iPhone13,2"
com.apple.findmy,12,1730752430,1730752442,1730752443.425489,-21600,EB445137-D7F5-57EC-87DA-1DB460D64046,"iPhone13,2"
com.apple.news,65,1730752364,1730752429,1730752429.92244,-21600,EB445137-D7F5-57EC-87DA-1DB460D64046,"iPhone13,2"
com.hammerandchisel.discord,54,1730752308,1730752362,1730752362.1159492,-21600,EB445137-D7F5-57EC-87DA-1DB460D64046,"iPhone13,2"
com.clairmail.fth.client,38,1730752241,1730752279,1730752279.5690598,-21600,EB445137-D7F5-57EC-87DA-1DB460D64046,"iPhone13,2"
com.truebill.truebillnative,16,1730752220,1730752236,1730752236.964529,-21600,EB445137-D7F5-57EC-87DA-1DB460D64046,"iPhone13,2"
com.truebill.truebillnative,17,1730752201,1730752218,1730752218.579144,-21600,EB445137-D7F5-57EC-87DA-1DB460D64046,"iPhone13,2"
com.apple.MobileSMS,1,1730752187,1730752188,1730752189.027604,-21600,EB445137-D7F5-57EC-87DA-1DB460D64046,"iPhone13,2"
com.google.Chrome,335,1730752115,1730752450,1730752450.542727,-21600,,
com.apple.MobileSMS,13,1730751969,1730751982,1730751983.041318,-21600,EB445137-D7F5-57EC-87DA-1DB460D64046,"iPhone13,2"
com.apple.MobileSMS,14,1730751952,1730751966,1730751966.623203,-21600,EB445137-D7F5-57EC-87DA-1DB460D64046,"iPhone13,2"
com.apple.MobileSMS,19,1730751908,1730751927,1730751927.961751,-21600,EB445137-D7F5-57EC-87DA-1DB460D64046,"iPhone13,2"
com.apple.calculator,3,1730751905,1730751908,1730751909.295982,-21600,EB445137-D7F5-57EC-87DA-1DB460D64046,"iPhone13,2"
com.apple.calculator,5,1730751527,1730751532,1730751532.479007,-21600,EB445137-D7F5-57EC-87DA-1DB460D64046,"iPhone13,2"
com.apple.MobileSMS,2,1730751525,1730751527,1730751527.548753,-21600,EB445137-D7F5-57EC-87DA-1DB460D64046,"iPhone13,2"
com.apple.MobileSMS,63,1730750612,1730750675,1730750675.317284,-21600,EB445137-D7F5-57EC-87DA-1DB460D64046,"iPhone13,2"
com.apple.MobileSMS,3,1730750517,1730750520,1730750520.711484,-21600,EB445137-D7F5-57EC-87DA-1DB460D64046,"iPhone13,2"
com.apple.MobileSMS,22,1730749943,1730749965,1730749966.1854029,-21600,EB445137-D7F5-57EC-87DA-1DB460D64046,"iPhone13,2"
com.instructure.icanvas,3,1730749937,1730749940,1730749940.355077,-21600,EB445137-D7F5-57EC-87DA-1DB460D64046,"iPhone13,2"
com.instructure.icanvas,2,1730749715,1730749717,1730749717.81898,-21600,EB445137-D7F5-57EC-87DA-1DB460D64046,"iPhone13,2"
com.instructure.icanvas,55,1730749405,1730749460,1730749460.8047628,-21600,EB445137-D7F5-57EC-87DA-1DB460D64046,"iPhone13,2"
com.toyopagroup.picaboo,4,1730749401,1730749405,1730749405.957635,-21600,EB445137-D7F5-57EC-87DA-1DB460D64046,"iPhone13,2"
com.toyopagroup.picaboo,69,1730749219,1730749288,1730749289.1611052,-21600,EB445137-D7F5-57EC-87DA-1DB460D64046,"iPhone13,2"
com.google.chrome.ios,20,1730749199,1730749219,1730749219.875546,-21600,EB445137-D7F5-57EC-87DA-1DB460D64046,"iPhone13,2"
com.apple.camera,0,1730749172,1730749172,1730749172.818538,-21600,EB445137-D7F5-57EC-87DA-1DB460D64046,"iPhone13,2"
com.toyopagroup.picaboo,97,1730749040,1730749137,1730749137.568386,-21600,EB445137-D7F5-57EC-87DA-1DB460D64046,"iPhone13,2"
com.toyopagroup.picaboo,26,1730749007,1730749033,1730749033.1550221,-21600,EB445137-D7F5-57EC-87DA-1DB460D64046,"iPhone13,2"
com.google.Chrome,833,1730746579,1730747412,1730747412.463334,-21600,,
com.toyopagroup.picaboo,3,1730746544,1730746547,1730746548.1237879,-21600,EB445137-D7F5-57EC-87DA-1DB460D64046,"iPhone13,2"
com.apple.MobileSMS,2,1730746533,1730746535,1730746535.955261,-21600,EB445137-D7F5-57EC-87DA-1DB460D64046,"iPhone13,2"
com.toyopagroup.picaboo,27,1730746506,1730746533,1730746534.315232,-21600,EB445137-D7F5-57EC-87DA-1DB460D64046,"iPhone13,2"
com.apple.MobileSMS,17,1730746487,1730746504,1730746504.120061,-21600,EB445137-D7F5-57EC-87DA-1DB460D64046,"iPhone13,2"
com.apple.Maps,16,1730746471,1730746487,1730746487.609971,-21600,EB445137-D7F5-57EC-87DA-1DB460D64046,"iPhone13,2"
com.google.chrome.ios,3,1730746468,1730746471,1730746471.063981,-21600,EB445137-D7F5-57EC-87DA-1DB460D64046,"iPhone13,2"
com.apple.MobileSMS,14,1730746452,1730746466,1730746466.945057,-21600,EB445137-D7F5-57EC-87DA-1DB460D64046,"iPhone13,2"
com.google.chrome.ios,43,1730746409,1730746452,1730746452.9499931,-21600,EB445137-D7F5-57EC-87DA-1DB460D64046,"iPhone13,2"
com.apple.MobileSMS,2,1730746407,1730746409,1730746409.878953,-21600,EB445137-D7F5-57EC-87DA-1DB460D64046,"iPhone13,2"
com.apple.MobileSMS,47,1730746290,1730746337,1730746337.1473022,-21600,EB445137-D7F5-57EC-87DA-1DB460D64046,"iPhone13,2"
com.apple.MobileSMS,3,1730746193,1730746196,1730746196.469469,-21600,EB445137-D7F5-57EC-87DA-1DB460D64046,"iPhone13,2"
com.apple.MobileSMS,106,1730746059,1730746165,1730746166.027244,-21600,EB445137-D7F5-57EC-87DA-1DB460D64046,"iPhone13,2"
com.apple.MobileSMS,50,1730745976,1730746026,1730746026.61465,-21600,EB445137-D7F5-57EC-87DA-1DB460D64046,"iPhone13,2"
com.apple.mobilecal,3,1730745973,1730745976,1730745977.762891,-21600,EB445137-D7F5-57EC-87DA-1DB460D64046,"iPhone13,2"
com.apple.mobilecal,39,1730745890,1730745929,1730745929.686064,-21600,EB445137-D7F5-57EC-87DA-1DB460D64046,"iPhone13,2"
com.apple.MobileSMS,6,1730745881,1730745887,1730745888.023526,-21600,EB445137-D7F5-57EC-87DA-1DB460D64046,"iPhone13,2"
com.apple.MobileSMS,6,1730745759,1730745765,1730745765.593305,-21600,EB445137-D7F5-57EC-87DA-1DB460D64046,"iPhone13,2"
com.apple.MobileSMS,48,1730745678,1730745726,1730745727.234292,-21600,EB445137-D7F5-57EC-87DA-1DB460D64046,"iPhone13,2"
com.toyopagroup.picaboo,37,1730745640,1730745677,1730745678.050309,-21600,EB445137-D7F5-57EC-87DA-1DB460D64046,"iPhone13,2"
com.apple.MobileSMS,9,1730745578,1730745587,1730745587.5989509,-21600,EB445137-D7F5-57EC-87DA-1DB460D64046,"iPhone13,2"
com.apple.MobileSMS,6,1730745287,1730745293,1730745293.064831,-21600,EB445137-D7F5-57EC-87DA-1DB460D64046,"iPhone13,2"
com.apple.MobileSMS,9,1730745127,1730745136,1730745137.337831,-21600,EB445137-D7F5-57EC-87DA-1DB460D64046,"iPhone13,2"
com.apple.MobileSMS,18,1730745082,1730745100,1730745101.557054,-21600,EB445137-D7F5-57EC-87DA-1DB460D64046,"iPhone13,2"
com.burbn.instagram,115,1730744609,1730744724,1730744724.309252,-21600,EB445137-D7F5-57EC-87DA-1DB460D64046,"iPhone13,2"
com.google.chrome.ios,4,1730744604,1730744608,1730744608.494276,-21600,EB445137-D7F5-57EC-87DA-1DB460D64046,"iPhone13,2"
com.google.chrome.ios,68,1730744529,1730744597,1730744597.874371,-21600,EB445137-D7F5-57EC-87DA-1DB460D64046,"iPhone13,2"
com.apple.news,3,1730743037,1730743040,1730743040.0946589,-21600,EB445137-D7F5-57EC-87DA-1DB460D64046,"iPhone13,2"
com.apple.news,4,1730743032,1730743036,1730743036.802783,-21600,EB445137-D7F5-57EC-87DA-1DB460D64046,"iPhone13,2"
com.apple.news,775,1730742244,1730743019,1730743020.0787349,-21600,EB445137-D7F5-57EC-87DA-1DB460D64046,"iPhone13,2"
com.apple.news,355,1730741880,1730742235,1730742235.855983,-21600,EB445137-D7F5-57EC-87DA-1DB460D64046,"iPhone13,2"
com.hammerandchisel.discord,8,1730741837,1730741845,1730741845.320658,-21600,EB445137-D7F5-57EC-87DA-1DB460D64046,"iPhone13,2"
com.google.Chrome,720,1730741708,1730742428,1730742428.895358,-21600,,
com.hammerandchisel.discord,129,1730741700,1730741829,1730741830.483391,-21600,EB445137-D7F5-57EC-87DA-1DB460D64046,"iPhone13,2"
com.microsoft.Office.Outlook,10,1730741481,1730741491,1730741491.659018,-21600,EB445137-D7F5-57EC-87DA-1DB460D64046,"iPhone13,2"
com.apple.Health,50,1730741425,1730741475,1730741476.1415849,-21600,EB445137-D7F5-57EC-87DA-1DB460D64046,"iPhone13,2"
com.apple.Health,14,1730741405,1730741419,1730741419.3080602,-21600,EB445137-D7F5-57EC-87DA-1DB460D64046,"iPhone13,2"
com.apple.weather,9,1730741396,1730741405,1730741406.1393728,-21600,EB445137-D7F5-57EC-87DA-1DB460D64046,"iPhone13,2"
com.apple.weather,18,1730741378,1730741396,1730741396.389305,-21600,EB445137-D7F5-57EC-87DA-1DB460D64046,"iPhone13,2"
com.google.Chrome,396,1730741171,1730741567,1730741567.282352,-21600,,
com.leomehlig.today,9,1730741162,1730741171,1730741171.7811089,-21600,,
com.google.Chrome,423,1730740739,1730741162,1730741162.524534,-21600,,
com.apple.iCal,15,1730740263,1730740278,1730740278.551552,-21600,,
com.google.Chrome,6,1730740257,1730740263,1730740263.1051831,-21600,,
com.apple.iCal,32,1730740225,1730740257,1730740257.8387141,-21600,,
com.google.Chrome,35,1730740190,1730740225,1730740225.865477,-21600,,
com.apple.finder,37,1730740136,1730740173,1730740173.1078649,-21600,,
com.leomehlig.today,41,1730740095,1730740136,1730740136.504257,-21600,,
com.apple.finder,56,1730740039,1730740095,1730740095.442308,-21600,,
com.leomehlig.today,2,1730740037,1730740039,1730740043.872332,-21600,,
com.google.Chrome,1,1730740036,1730740037,1730740040.638105,-21600,,
com.apple.finder,11,1730740025,1730740036,1730740038.693949,-21600,,
com.apple.weather,10,1730734813,1730734823,1730734823.2841048,-21600,EB445137-D7F5-57EC-87DA-1DB460D64046,"iPhone13,2"
com.apple.weather,13,1730734368,1730734381,1730734381.6556082,-21600,EB445137-D7F5-57EC-87DA-1DB460D64046,"iPhone13,2"
com.renpho.health,2,1730734366,1730734368,1730734368.245233,-21600,EB445137-D7F5-57EC-87DA-1DB460D64046,"iPhone13,2"
com.renpho.health,20,1730734318,1730734338,1730734338.351785,-21600,EB445137-D7F5-57EC-87DA-1DB460D64046,"iPhone13,2"
com.google.ios.youtube,1363,1730731955,1730733318,1730733318.950562,-21600,EB445137-D7F5-57EC-87DA-1DB460D64046,"iPhone13,2"
com.apple.news,246,1730731704,1730731950,1730731950.445355,-21600,EB445137-D7F5-57EC-87DA-1DB460D64046,"iPhone13,2"
com.instructure.icanvas,15,1730731535,1730731550,1730731550.3387709,-21600,EB445137-D7F5-57EC-87DA-1DB460D64046,"iPhone13,2"
com.microsoft.Office.Outlook,73,1730731454,1730731527,1730731528.012646,-21600,EB445137-D7F5-57EC-87DA-1DB460D64046,"iPhone13,2"
com.apple.journal,114,1730700529,1730700643,1730700643.985579,-21600,EB445137-D7F5-57EC-87DA-1DB460D64046,"iPhone13,2"
com.apple.journal,585,1730699942,1730700527,1730700527.472986,-21600,EB445137-D7F5-57EC-87DA-1DB460D64046,"iPhone13,2"
com.apple.mobiletimer,8,1730699907,1730699915,1730699915.0944018,-21600,EB445137-D7F5-57EC-87DA-1DB460D64046,"iPhone13,2"
com.apple.weather,2,1730699905,1730699907,1730699907.649323,-21600,EB445137-D7F5-57EC-87DA-1DB460D64046,"iPhone13,2"
com.apple.weather,11,1730699744,1730699755,1730699755.7369099,-21600,EB445137-D7F5-57EC-87DA-1DB460D64046,"iPhone13,2"
com.apple.finder,2,1730699721,1730699723,1730699723.378233,-21600,,
com.leomehlig.today,55,1730699666,1730699721,1730699721.939095,-21600,,
com.google.Chrome,636,1730699030,1730699666,1730699666.379403,-21600,,
com.google.Chrome,475,1730698141,1730698616,1730698616.255748,-21600,,
com.apple.camera,0,1730697366,1730697366,1730697366.743299,-21600,EB445137-D7F5-57EC-87DA-1DB460D64046,"iPhone13,2"
com.google.Chrome,1052,1730696830,1730697882,1730697882.240354,-21600,,
com.apple.Health,7,1730696592,1730696599,1730696600.027139,-21600,EB445137-D7F5-57EC-87DA-1DB460D64046,"iPhone13,2"
com.google.Chrome,309,1730696491,1730696800,1730696800.065641,-21600,,
com.google.Chrome,426,1730695532,1730695958,1730695958.657608,-21600,,
com.apple.Health,6,1730695455,1730695461,1730695461.213557,-21600,EB445137-D7F5-57EC-87DA-1DB460D64046,"iPhone13,2"
com.google.Chrome,733,1730694644,1730695377,1730695377.069788,-21600,,
com.google.Chrome,301,1730693503,1730693804,1730693804.2696319,-21600,,
com.google.Chrome,357,1730693118,1730693475,1730693475.253015,-21600,,
com.microsoft.onenote.mac,190,1730692928,1730693118,1730693118.1790009,-21600,,
com.apple.Health,133,1730692924,1730693057,1730693057.335384,-21600,EB445137-D7F5-57EC-87DA-1DB460D64046,"iPhone13,2"
com.google.Chrome,19,1730692909,1730692928,1730692928.1976938,-21600,,
com.google.Chrome,324,1730691943,1730692267,1730692267.2805529,-21600,,
com.apple.MobileSMS,1,1730691942,1730691943,1730691943.720406,-21600,,
com.google.Chrome,2,1730691940,1730691942,1730691942.905318,-21600,,
com.apple.MobileSMS,1,1730691939,1730691940,1730691940.587925,-21600,,
com.google.Chrome,156,1730691783,1730691939,1730691939.539977,-21600,,
com.apple.MobileSMS,7,1730691776,1730691783,1730691783.194828,-21600,,
com.google.Chrome,21,1730691755,1730691776,1730691776.277964,-21600,,
com.apple.MobileSMS,2,1730691753,1730691755,1730691755.324666,-21600,,
com.google.Chrome,44,1730691709,1730691753,1730691753.7437649,-21600,,
com.apple.MobileSMS,9,1730691700,1730691709,1730691710.027725,-21600,,
com.google.Chrome,3,1730691697,1730691700,1730691701.016337,-21600,,
com.apple.MobileSMS,24,1730691673,1730691697,1730691697.812478,-21600,,
com.google.Chrome,2,1730691671,1730691673,1730691673.856678,-21600,,
com.apple.MobileSMS,12,1730691659,1730691671,1730691671.904711,-21600,,
com.google.Chrome,1,1730691658,1730691659,1730691659.483732,-21600,,
com.apple.MobileSMS,3,1730691655,1730691658,1730691658.101696,-21600,,
com.google.Chrome,2,1730691653,1730691655,1730691655.83494,-21600,,
com.apple.MobileSMS,31,1730691622,1730691653,1730691653.530785,-21600,,
com.google.Chrome,99,1730691523,1730691622,1730691622.2783298,-21600,,
com.apple.MobileSMS,8,1730691515,1730691523,1730691524.021749,-21600,,
com.google.Chrome,18,1730691497,1730691515,1730691515.5697331,-21600,,
com.apple.MobileSMS,0,1730691497,1730691497,1730691497.984523,-21600,,
com.google.Chrome,7,1730691490,1730691497,1730691497.182399,-21600,,
com.apple.MobileSMS,9,1730691481,1730691490,1730691490.2370381,-21600,,
com.google.Chrome,1,1730691480,1730691481,1730691481.207978,-21600,,
com.apple.MobileSMS,30,1730691450,1730691480,1730691480.7690601,-21600,,
com.google.Chrome,1,1730691449,1730691450,1730691450.078827,-21600,,
com.apple.MobileSMS,75,1730691374,1730691449,1730691449.147824,-21600,,
com.google.Chrome,30,1730691344,1730691374,1730691374.446414,-21600,,
com.leomehlig.today,2,1730691342,1730691344,1730691344.556501,-21600,,
com.google.Chrome,368,1730690974,1730691342,1730691342.855145,-21600,,
com.google.Chrome,1136,1730689159,1730690295,1730690295.953695,-21600,,
com.google.Chrome,312,1730688835,1730689147,1730689147.309474,-21600,,
com.google.Chrome,1032,1730687660,1730688692,1730688692.7594218,-21600,,
com.google.Chrome,455,1730686914,1730687369,1730687369.694119,-21600,,
com.google.Chrome,307,1730686071,1730686378,1730686378.553484,-21600,,
com.google.Chrome,377,1730685669,1730686046,1730686046.955693,-21600,,
com.google.Chrome,765,1730684815,1730685580,1730685580.151019,-21600,,
com.google.Chrome,582,1730684008,1730684590,1730684590.077633,-21600,,
com.facebook.Facebook,99,1730683824,1730683923,1730683923.4725761,-21600,EB445137-D7F5-57EC-87DA-1DB460D64046,"iPhone13,2"
Astrospheric.Astrospheric,6,1730683812,1730683818,1730683818.196702,-21600,EB445137-D7F5-57EC-87DA-1DB460D64046,"iPhone13,2"
com.google.Chrome,615,1730683353,1730683968,1730683968.3339381,-21600,,
Astrospheric.Astrospheric,10,1730682801,1730682811,1730682811.2875729,-21600,EB445137-D7F5-57EC-87DA-1DB460D64046,"iPhone13,2"
Astrospheric.Astrospheric,2,1730682668,1730682670,1730682671.00189,-21600,EB445137-D7F5-57EC-87DA-1DB460D64046,"iPhone13,2"
com.google.Chrome,722,1730682620,1730683342,1730683342.91194,-21600,,
com.leomehlig.today,8,1730682612,1730682620,1730682620.792659,-21600,,
com.google.Chrome,4,1730682608,1730682612,1730682612.72298,-21600,,
Astrospheric.Astrospheric,1,1730682183,1730682184,1730682184.6695929,-21600,EB445137-D7F5-57EC-87DA-1DB460D64046,"iPhone13,2"
Astrospheric.Astrospheric,4,1730682173,1730682177,1730682177.9191551,-21600,EB445137-D7F5-57EC-87DA-1DB460D64046,"iPhone13,2"
Astrospheric.Astrospheric,7,1730682036,1730682043,1730682043.672888,-21600,EB445137-D7F5-57EC-87DA-1DB460D64046,"iPhone13,2"
Astrospheric.Astrospheric,10,1730681406,1730681416,1730681416.843344,-21600,EB445137-D7F5-57EC-87DA-1DB460D64046,"iPhone13,2"
com.instructure.icanvas,6,1730681392,1730681398,1730681399.151542,-21600,EB445137-D7F5-57EC-87DA-1DB460D64046,"iPhone13,2"
com.google.Chrome,112,1730681194,1730681306,1730681307.496418,-21600,,
com.apple.mail,2,1730681192,1730681194,1730681194.840338,-21600,,
com.google.Chrome,181,1730681011,1730681192,1730681192.964425,-21600,,
com.leomehlig.today,2,1730681009,1730681011,1730681011.4394999,-21600,,
com.leomehlig.today,26,1730680954,1730680980,1730680981.282357,-21600,,
com.microsoft.VSCode,7,1730680947,1730680954,1730680954.902911,-21600,,
com.hnc.Discord,3,1730680944,1730680947,1730680947.214065,-21600,,
com.google.Chrome,1693,1730679251,1730680944,1730680944.662606,-21600,,
com.google.Chrome,1017,1730676298,1730677315,1730677315.275826,-21600,,
com.hnc.Discord,5,1730676293,1730676298,1730676298.503073,-21600,,
com.instructure.icanvas,89,1730676015,1730676104,1730676105.435772,-21600,EB445137-D7F5-57EC-87DA-1DB460D64046,"iPhone13,2"
com.apple.news,140,1730675852,1730675992,1730675992.5054789,-21600,EB445137-D7F5-57EC-87DA-1DB460D64046,"iPhone13,2"
com.apple.news,12,1730675776,1730675788,1730675788.931697,-21600,EB445137-D7F5-57EC-87DA-1DB460D64046,"iPhone13,2"
com.apple.news,110,1730675664,1730675774,1730675775.341618,-21600,EB445137-D7F5-57EC-87DA-1DB460D64046,"iPhone13,2"
com.ally.MobileBanking,52,1730675599,1730675651,1730675652.230918,-21600,EB445137-D7F5-57EC-87DA-1DB460D64046,"iPhone13,2"
com.truebill.truebillnative,54,1730675543,1730675597,1730675597.992496,-21600,EB445137-D7F5-57EC-87DA-1DB460D64046,"iPhone13,2"
com.hammerandchisel.discord,17,1730675518,1730675535,1730675535.950958,-21600,EB445137-D7F5-57EC-87DA-1DB460D64046,"iPhone13,2"
com.hnc.Discord,301,1730675484,1730675785,1730675785.970506,-21600,,
com.microsoft.VSCode,144,1730675340,1730675484,1730675484.90133,-21600,,
com.hnc.Discord,5,1730675335,1730675340,1730675340.903446,-21600,,
com.leomehlig.today,0,1730675335,1730675335,1730675335.9814181,-21600,,
com.microsoft.VSCode,10,1730675325,1730675335,1730675335.300729,-21600,,
com.leomehlig.today,2,1730675323,1730675325,1730675325.198859,-21600,,
com.hnc.Discord,6,1730675317,1730675323,1730675323.722455,-21600,,
com.leomehlig.today,1,1730675316,1730675317,1730675317.874263,-21600,,
com.microsoft.VSCode,16,1730675300,1730675316,1730675316.2281718,-21600,,
com.leomehlig.today,3,1730675297,1730675300,1730675300.127005,-21600,,
com.google.Chrome,16,1730675281,1730675297,1730675297.669784,-21600,,
com.leomehlig.today,1,1730675280,1730675281,1730675281.518032,-21600,,
com.google.Chrome,1,1730675279,1730675280,1730675281.006331,-21600,,
com.microsoft.VSCode,108,1730675171,1730675279,1730675279.715883,-21600,,
com.google.Chrome,21,1730675150,1730675171,1730675171.682528,-21600,,
com.leomehlig.today,88,1730675062,1730675150,1730675151.796931,-21600,,
com.leomehlig.today,208,1730673619,1730673827,1730673827.905345,-21600,,
com.hnc.Discord,26,1730673593,1730673619,1730673619.289021,-21600,,
com.google.Chrome,39,1730673554,1730673593,1730673594.0254312,-21600,,
com.leomehlig.today,0,1730673554,1730673554,1730673554.878096,-21600,,
com.microsoft.VSCode,5,1730673549,1730673554,1730673554.5031428,-21600,,
com.google.Chrome,60,1730673489,1730673549,1730673550.407263,-21600,,
com.microsoft.VSCode,362,1730673127,1730673489,1730673489.6280398,-21600,,
com.google.Chrome,17,1730673110,1730673127,1730673127.932461,-21600,,
com.microsoft.VSCode,23,1730673087,1730673110,1730673110.8733249,-21600,,
com.google.Chrome,7,1730673080,1730673087,1730673087.519977,-21600,,
com.microsoft.VSCode,241,1730672839,1730673080,1730673080.714308,-21600,,
com.apple.Dictionary,1,1730672838,1730672839,1730672839.674557,-21600,,
com.microsoft.VSCode,2,1730672836,1730672838,1730672838.0787082,-21600,,
com.apple.Dictionary,2,1730672834,1730672836,1730672836.275741,-21600,,
com.microsoft.VSCode,446,1730672388,1730672834,1730672834.422812,-21600,,
com.google.Chrome,24,1730672364,1730672388,1730672388.115824,-21600,,
com.leomehlig.today,19,1730672345,1730672364,1730672364.478486,-21600,,
com.google.Chrome,952,1730671393,1730672345,1730672345.322242,-21600,,
com.leomehlig.today,3,1730671390,1730671393,1730671393.819468,-21600,,
com.google.Chrome,1389,1730670001,1730671390,1730671390.584898,-21600,,
com.leomehlig.today,4,1730669997,1730670001,1730670001.300266,-21600,,
com.google.Chrome,1597,1730668400,1730669997,1730669997.8480492,-21600,,
com.leomehlig.today,14,1730668372,1730668386,1730668386.9450579,-21600,,
com.google.Chrome,19,1730668353,1730668372,1730668372.3278198,-21600,,
com.google.Chrome,358,1730667651,1730668009,1730668009.629727,-21600,,
com.apple.news,440,1730666925,1730667365,1730667366.1901932,-21600,EB445137-D7F5-57EC-87DA-1DB460D64046,"iPhone13,2"
com.hammerandchisel.discord,35,1730666880,1730666915,1730666915.7972322,-21600,EB445137-D7F5-57EC-87DA-1DB460D64046,"iPhone13,2"
com.google.Chrome,1699,1730665125,1730666824,1730666825.2468472,-21600,,
com.google.Chrome,322,1730664568,1730664890,1730664890.281496,-21600,,
com.robinhood.release.Robinhood,0,1730663114,1730663114,1730663114.34264,-21600,EB445137-D7F5-57EC-87DA-1DB460D64046,"iPhone13,2"
com.google.Chrome,2151,1730662225,1730664376,1730664376.162969,-21600,,
com.robinhood.release.Robinhood,299,1730661498,1730661797,1730661799.2502499,-21600,EB445137-D7F5-57EC-87DA-1DB460D64046,"iPhone13,2"
com.microsoft.Office.Outlook,3,1730661441,1730661444,1730661444.340142,-21600,EB445137-D7F5-57EC-87DA-1DB460D64046,"iPhone13,2"
com.hammerandchisel.discord,16,1730661404,1730661420,1730661420.9793382,-21600,EB445137-D7F5-57EC-87DA-1DB460D64046,"iPhone13,2"
com.google.Chrome,5521,1730656576,1730662097,1730662097.7630138,-21600,,
com.leomehlig.today,105,1730656471,1730656576,1730656576.897826,-21600,,
com.apple.weather,7,1730654331,1730654338,1730654338.3523722,-21600,EB445137-D7F5-57EC-87DA-1DB460D64046,"iPhone13,2"
com.apple.weather,6,1730654271,1730654277,1730654277.662323,-21600,EB445137-D7F5-57EC-87DA-1DB460D64046,"iPhone13,2"
com.apple.camera,9,1730653862,1730653871,1730653871.666498,-21600,EB445137-D7F5-57EC-87DA-1DB460D64046,"iPhone13,2"
com.hammerandchisel.discord,9,1730653861,1730653870,1730653871.33148,-21600,EB445137-D7F5-57EC-87DA-1DB460D64046,"iPhone13,2"
com.hammerandchisel.discord,25,1730653501,1730653526,1730653526.434237,-21600,EB445137-D7F5-57EC-87DA-1DB460D64046,"iPhone13,2"
com.apple.Health,30,1730652370,1730652400,1730652400.853791,-21600,EB445137-D7F5-57EC-87DA-1DB460D64046,"iPhone13,2"
com.apple.Health,16,1730652351,1730652367,1730652367.242886,-21600,EB445137-D7F5-57EC-87DA-1DB460D64046,"iPhone13,2"
com.hammerandchisel.discord,19,1730652324,1730652343,1730652343.571702,-21600,EB445137-D7F5-57EC-87DA-1DB460D64046,"iPhone13,2"
com.apple.MobileSMS,3,1730652309,1730652312,1730652312.5083752,-21600,EB445137-D7F5-57EC-87DA-1DB460D64046,"iPhone13,2"
com.leomehlig.today,33,1730652140,1730652173,1730652173.386685,-21600,,
com.google.Chrome,6,1730652134,1730652140,1730652140.5618172,-21600,,
com.apple.Music,256,1730651878,1730652134,1730652134.294584,-21600,,
com.google.Chrome,31,1730651847,1730651878,1730651878.613738,-21600,,
com.apple.Music,76,1730651771,1730651847,1730651847.277884,-21600,,
com.google.Chrome,3,1730651768,1730651771,1730651771.7832608,-21600,,
com.apple.MobileSMS,50,1730651596,1730651646,1730651646.6531692,-21600,EB445137-D7F5-57EC-87DA-1DB460D64046,"iPhone13,2"
com.apple.calculator,8,1730651588,1730651596,1730651596.9143128,-21600,EB445137-D7F5-57EC-87DA-1DB460D64046,"iPhone13,2"
com.truebill.truebillnative,23,1730651565,1730651588,1730651588.863781,-21600,EB445137-D7F5-57EC-87DA-1DB460D64046,"iPhone13,2"
com.clairmail.fth.client,5,1730651558,1730651563,1730651563.1653829,-21600,EB445137-D7F5-57EC-87DA-1DB460D64046,"iPhone13,2"
com.apple.calculator,30,1730651528,1730651558,1730651558.234669,-21600,EB445137-D7F5-57EC-87DA-1DB460D64046,"iPhone13,2"
com.instructure.icanvas,16,1730651506,1730651522,1730651522.8839211,-21600,EB445137-D7F5-57EC-87DA-1DB460D64046,"iPhone13,2"
com.renpho.health,7,1730651499,1730651506,1730651506.991576,-21600,EB445137-D7F5-57EC-87DA-1DB460D64046,"iPhone13,2"
com.renpho.health,2,1730651441,1730651443,1730651443.210005,-21600,EB445137-D7F5-57EC-87DA-1DB460D64046,"iPhone13,2"
com.renpho.health,10,1730651317,1730651327,1730651327.71845,-21600,EB445137-D7F5-57EC-87DA-1DB460D64046,"iPhone13,2"
com.renpho.health,30,1730651286,1730651316,1730651316.543487,-21600,EB445137-D7F5-57EC-87DA-1DB460D64046,"iPhone13,2"
com.google.ios.youtube,1096,1730649752,1730650848,1730650848.6008291,-21600,EB445137-D7F5-57EC-87DA-1DB460D64046,"iPhone13,2"
com.apple.news,188,1730649544,1730649732,1730649732.386095,-21600,EB445137-D7F5-57EC-87DA-1DB460D64046,"iPhone13,2"
com.apple.weather,16,1730649497,1730649513,1730649514.214648,-21600,EB445137-D7F5-57EC-87DA-1DB460D64046,"iPhone13,2"
com.apple.weather,12,1730649484,1730649496,1730649496.7124,-21600,EB445137-D7F5-57EC-87DA-1DB460D64046,"iPhone13,2"
com.apple.mobiletimer,10,1730649473,1730649483,1730649483.727329,-21600,EB445137-D7F5-57EC-87DA-1DB460D64046,"iPhone13,2"
com.apple.mobiletimer,14,1730649436,1730649450,1730649450.937396,-21600,EB445137-D7F5-57EC-87DA-1DB460D64046,"iPhone13,2"
com.apple.mobiletimer,10,1730649011,1730649021,1730649021.554079,-21600,EB445137-D7F5-57EC-87DA-1DB460D64046,"iPhone13,2"
com.apple.mobiletimer,13,1730648892,1730648905,1730648905.855777,-21600,EB445137-D7F5-57EC-87DA-1DB460D64046,"iPhone13,2"
com.apple.mobiletimer,14,1730648348,1730648362,1730648362.484009,-21600,EB445137-D7F5-57EC-87DA-1DB460D64046,"iPhone13,2"
com.apple.mobiletimer,17,1730647801,1730647818,1730647818.1944098,-21600,EB445137-D7F5-57EC-87DA-1DB460D64046,"iPhone13,2"
com.apple.mobiletimer,13,1730618051,1730618064,1730618064.325845,-21600,EB445137-D7F5-57EC-87DA-1DB460D64046,"iPhone13,2"
com.apple.mobiletimer,8,1730618040,1730618048,1730618048.4690108,-21600,EB445137-D7F5-57EC-87DA-1DB460D64046,"iPhone13,2"
com.apple.Music,1,1730618039,1730618040,1730618040.607479,-21600,EB445137-D7F5-57EC-87DA-1DB460D64046,"iPhone13,2"
com.apple.Music,3,1730618008,1730618011,1730618011.09712,-21600,EB445137-D7F5-57EC-87DA-1DB460D64046,"iPhone13,2"
com.apple.Music,3,1730617777,1730617780,1730617780.6722531,-21600,EB445137-D7F5-57EC-87DA-1DB460D64046,"iPhone13,2"
com.apple.Music,58,1730617595,1730617653,1730617653.2927399,-21600,EB445137-D7F5-57EC-87DA-1DB460D64046,"iPhone13,2"
com.apple.Music,19,1730617576,1730617595,1730617595.521641,-21600,EB445137-D7F5-57EC-87DA-1DB460D64046,"iPhone13,2"
com.apple.Music,48,1730616846,1730616894,1730616894.7881432,-18000,EB445137-D7F5-57EC-87DA-1DB460D64046,"iPhone13,2"
com.apple.Music,26,1730616619,1730616645,1730616646.190392,-18000,EB445137-D7F5-57EC-87DA-1DB460D64046,"iPhone13,2"
com.google.Chrome,664,1730615717,1730616381,1730616381.467263,-18000,,
com.google.Chrome,329,1730615086,1730615415,1730615415.2014651,-18000,,
com.google.Chrome,1128,1730613644,1730614772,1730614773.02733,-18000,,
com.google.Chrome,320,1730613263,1730613583,1730613583.4958239,-18000,,
com.google.Chrome,568,1730612131,1730612699,1730612699.4309921,-18000,,
com.google.Chrome,735,1730610969,1730611704,1730611704.934166,-18000,,
com.google.chrome.ios,399,1730610175,1730610574,1730610575.424819,-18000,EB445137-D7F5-57EC-87DA-1DB460D64046,"iPhone13,2"
com.google.chrome.ios,3,1730610026,1730610029,1730610029.7796211,-18000,EB445137-D7F5-57EC-87DA-1DB460D64046,"iPhone13,2"
com.google.chrome.ios,116,1730609910,1730610026,1730610026.264227,-18000,EB445137-D7F5-57EC-87DA-1DB460D64046,"iPhone13,2"
com.google.chrome.ios,202,1730609569,1730609771,1730609773.0140061,-18000,EB445137-D7F5-57EC-87DA-1DB460D64046,"iPhone13,2"
com.hammerandchisel.discord,74,1730609493,1730609567,1730609567.573586,-18000,EB445137-D7F5-57EC-87DA-1DB460D64046,"iPhone13,2"
com.apple.Preferences,8,1730609480,1730609488,1730609488.1261458,-18000,EB445137-D7F5-57EC-87DA-1DB460D64046,"iPhone13,2"
com.facebook.Facebook,11,1730608817,1730608828,1730608828.6894798,-18000,EB445137-D7F5-57EC-87DA-1DB460D64046,"iPhone13,2"
com.facebook.Facebook,3,1730608789,1730608792,1730608792.617456,-18000,EB445137-D7F5-57EC-87DA-1DB460D64046,"iPhone13,2"
com.facebook.Facebook,3,1730607309,1730607312,1730607312.795728,-18000,EB445137-D7F5-57EC-87DA-1DB460D64046,"iPhone13,2"
com.facebook.Facebook,107,1730606702,1730606809,1730606809.834213,-18000,EB445137-D7F5-57EC-87DA-1DB460D64046,"iPhone13,2"
com.facebook.Facebook,4,1730605734,1730605738,1730605738.736384,-18000,EB445137-D7F5-57EC-87DA-1DB460D64046,"iPhone13,2"
com.facebook.Facebook,79,1730604540,1730604619,1730604619.874844,-18000,EB445137-D7F5-57EC-87DA-1DB460D64046,"iPhone13,2"
com.hammerandchisel.discord,4,1730604533,1730604537,1730604537.834091,-18000,EB445137-D7F5-57EC-87DA-1DB460D64046,"iPhone13,2"
com.hammerandchisel.discord,19,1730604478,1730604497,1730604497.724082,-18000,EB445137-D7F5-57EC-87DA-1DB460D64046,"iPhone13,2"
com.apple.weather,43,1730604413,1730604456,1730604456.515095,-18000,EB445137-D7F5-57EC-87DA-1DB460D64046,"iPhone13,2"
com.apple.weather,28,1730604366,1730604394,1730604394.081071,-18000,EB445137-D7F5-57EC-87DA-1DB460D64046,"iPhone13,2"
com.apple.MobileSMS,9,1730604342,1730604351,1730604351.193747,-18000,EB445137-D7F5-57EC-87DA-1DB460D64046,"iPhone13,2"
com.hammerandchisel.discord,6,1730604326,1730604332,1730604332.355072,-18000,EB445137-D7F5-57EC-87DA-1DB460D64046,"iPhone13,2"
com.apple.stocks,3,1730604275,1730604278,1730604278.852817,-18000,EB445137-D7F5-57EC-87DA-1DB460D64046,"iPhone13,2"
com.apple.MobileSMS,3,1730604269,1730604272,1730604272.84972,-18000,EB445137-D7F5-57EC-87DA-1DB460D64046,"iPhone13,2"
com.apple.MobileSMS,1,1730603581,1730603582,1730603582.994287,-18000,EB445137-D7F5-57EC-87DA-1DB460D64046,"iPhone13,2"
com.apple.MobileSMS,2,1730603215,1730603217,1730603217.569354,-18000,EB445137-D7F5-57EC-87DA-1DB460D64046,"iPhone13,2"
com.apple.MobileSMS,11,1730603109,1730603120,1730603120.5403519,-18000,EB445137-D7F5-57EC-87DA-1DB460D64046,"iPhone13,2"
com.apple.MobileSMS,8,1730603066,1730603074,1730603074.7810779,-18000,EB445137-D7F5-57EC-87DA-1DB460D64046,"iPhone13,2"
com.apple.news,6,1730603060,1730603066,1730603066.785145,-18000,EB445137-D7F5-57EC-87DA-1DB460D64046,"iPhone13,2"
com.apple.news,15,1730603012,1730603027,1730603028.147713,-18000,EB445137-D7F5-57EC-87DA-1DB460D64046,"iPhone13,2"
com.apple.news,64,1730602818,1730602882,1730602882.876406,-18000,EB445137-D7F5-57EC-87DA-1DB460D64046,"iPhone13,2"
com.hammerandchisel.discord,17,1730602793,1730602810,1730602810.7905169,-18000,EB445137-D7F5-57EC-87DA-1DB460D64046,"iPhone13,2"
com.hammerandchisel.discord,3,1730601171,1730601174,1730601174.7536612,-18000,EB445137-D7F5-57EC-87DA-1DB460D64046,"iPhone13,2"
com.hammerandchisel.discord,2,1730600333,1730600335,1730600335.561133,-18000,EB445137-D7F5-57EC-87DA-1DB460D64046,"iPhone13,2"
com.hammerandchisel.discord,3,1730600330,1730600333,1730600333.352839,-18000,EB445137-D7F5-57EC-87DA-1DB460D64046,"iPhone13,2"
com.hammerandchisel.discord,6,1730600314,1730600320,1730600320.4798841,-18000,EB445137-D7F5-57EC-87DA-1DB460D64046,"iPhone13,2"
com.google.Sheets,36,1730600256,1730600292,1730600292.840214,-18000,EB445137-D7F5-57EC-87DA-1DB460D64046,"iPhone13,2"
com.google.Sheets,24,1730599095,1730599119,1730599119.7609549,-18000,EB445137-D7F5-57EC-87DA-1DB460D64046,"iPhone13,2"
com.google.Sheets,2,1730598795,1730598797,1730598797.6093159,-18000,EB445137-D7F5-57EC-87DA-1DB460D64046,"iPhone13,2"
com.t11.celeste,2,1730598793,1730598795,1730598795.8822389,-18000,EB445137-D7F5-57EC-87DA-1DB460D64046,"iPhone13,2"
com.t11.celeste,6,1730598783,1730598789,1730598789.094511,-18000,EB445137-D7F5-57EC-87DA-1DB460D64046,"iPhone13,2"
com.t11.celeste,4,1730598778,1730598782,1730598782.320209,-18000,EB445137-D7F5-57EC-87DA-1DB460D64046,"iPhone13,2"
com.google.Sheets,3,1730598775,1730598778,1730598778.574481,-18000,EB445137-D7F5-57EC-87DA-1DB460D64046,"iPhone13,2"
com.google.Sheets,22,1730595620,1730595642,1730595642.48542,-18000,EB445137-D7F5-57EC-87DA-1DB460D64046,"iPhone13,2"
com.noctuasoftware.stellarium-mobile-plus,9,1730595606,1730595615,1730595615.613416,-18000,EB445137-D7F5-57EC-87DA-1DB460D64046,"iPhone13,2"
com.noctuasoftware.stellarium-mobile-plus,11,1730595304,1730595315,1730595315.460727,-18000,EB445137-D7F5-57EC-87DA-1DB460D64046,"iPhone13,2"
com.noctuasoftware.stellarium-mobile-plus,18,1730595203,1730595221,1730595223.070037,-18000,EB445137-D7F5-57EC-87DA-1DB460D64046,"iPhone13,2"
com.noctuasoftware.stellarium-mobile-plus,21,1730594987,1730595008,1730595008.9726439,-18000,EB445137-D7F5-57EC-87DA-1DB460D64046,"iPhone13,2"
com.t11.celeste,2,1730594984,1730594986,1730594987.21835,-18000,EB445137-D7F5-57EC-87DA-1DB460D64046,"iPhone13,2"
com.t11.celeste,60,1730594833,1730594893,1730594893.389155,-18000,EB445137-D7F5-57EC-87DA-1DB460D64046,"iPhone13,2"
com.hammerandchisel.discord,9,1730590864,1730590873,1730590873.758253,-18000,EB445137-D7F5-57EC-87DA-1DB460D64046,"iPhone13,2"
com.apple.findmy,11,1730590716,1730590727,1730590727.3844151,-18000,EB445137-D7F5-57EC-87DA-1DB460D64046,"iPhone13,2"
com.hammerandchisel.discord,2,1730590714,1730590716,1730590716.287623,-18000,EB445137-D7F5-57EC-87DA-1DB460D64046,"iPhone13,2"
com.hammerandchisel.discord,1,1730590263,1730590264,1730590264.971302,-18000,EB445137-D7F5-57EC-87DA-1DB460D64046,"iPhone13,2"
com.hammerandchisel.discord,28,1730590142,1730590170,1730590170.413296,-18000,EB445137-D7F5-57EC-87DA-1DB460D64046,"iPhone13,2"
com.apple.camera,5,1730590134,1730590139,1730590140.122272,-18000,EB445137-D7F5-57EC-87DA-1DB460D64046,"iPhone13,2"
com.apple.weather,7,1730590061,1730590068,1730590068.760324,-18000,EB445137-D7F5-57EC-87DA-1DB460D64046,"iPhone13,2"
com.apple.weather,2,1730589863,1730589865,1730589865.632333,-18000,EB445137-D7F5-57EC-87DA-1DB460D64046,"iPhone13,2"
com.apple.weather,5,1730589622,1730589627,1730589627.53548,-18000,EB445137-D7F5-57EC-87DA-1DB460D64046,"iPhone13,2"
com.instructure.icanvas,2,1730589619,1730589621,1730589622.0771508,-18000,EB445137-D7F5-57EC-87DA-1DB460D64046,"iPhone13,2"
com.instructure.icanvas,9,1730588592,1730588601,1730588601.2503262,-18000,EB445137-D7F5-57EC-87DA-1DB460D64046,"iPhone13,2"
com.instructure.icanvas,1,1730588588,1730588589,1730588589.831695,-18000,EB445137-D7F5-57EC-87DA-1DB460D64046,"iPhone13,2"
com.instructure.icanvas,6,1730588419,1730588425,1730588425.398483,-18000,EB445137-D7F5-57EC-87DA-1DB460D64046,"iPhone13,2"
com.instructure.icanvas,89,1730588088,1730588177,1730588177.692675,-18000,EB445137-D7F5-57EC-87DA-1DB460D64046,"iPhone13,2"
com.google.chrome.ios,5,1730588083,1730588088,1730588088.99581,-18000,EB445137-D7F5-57EC-87DA-1DB460D64046,"iPhone13,2"
com.google.chrome.ios,105,1730587334,1730587439,1730587440.174872,-18000,EB445137-D7F5-57EC-87DA-1DB460D64046,"iPhone13,2"
com.google.Gmail,2,1730587332,1730587334,1730587334.992898,-18000,EB445137-D7F5-57EC-87DA-1DB460D64046,"iPhone13,2"
com.google.Gmail,3,1730587318,1730587321,1730587321.787519,-18000,EB445137-D7F5-57EC-87DA-1DB460D64046,"iPhone13,2"
com.google.Gmail,14,1730587274,1730587288,1730587288.7419062,-18000,EB445137-D7F5-57EC-87DA-1DB460D64046,"iPhone13,2"
com.google.chrome.ios,29,1730587245,1730587274,1730587274.4453878,-18000,EB445137-D7F5-57EC-87DA-1DB460D64046,"iPhone13,2"
com.google.chrome.ios,2,1730587185,1730587187,1730587187.2749429,-18000,EB445137-D7F5-57EC-87DA-1DB460D64046,"iPhone13,2"
com.google.Gmail,12,1730587173,1730587185,1730587185.304559,-18000,EB445137-D7F5-57EC-87DA-1DB460D64046,"iPhone13,2"
com.google.chrome.ios,6,1730587167,1730587173,1730587174.052212,-18000,EB445137-D7F5-57EC-87DA-1DB460D64046,"iPhone13,2"
com.google.chrome.ios,2,1730587120,1730587122,1730587122.8642359,-18000,EB445137-D7F5-57EC-87DA-1DB460D64046,"iPhone13,2"
com.google.chrome.ios,1,1730587116,1730587117,1730587117.312932,-18000,EB445137-D7F5-57EC-87DA-1DB460D64046,"iPhone13,2"
com.google.chrome.ios,1,1730586983,1730586984,1730586984.229747,-18000,EB445137-D7F5-57EC-87DA-1DB460D64046,"iPhone13,2"
com.google.chrome.ios,54,1730586881,1730586935,1730586935.919852,-18000,EB445137-D7F5-57EC-87DA-1DB460D64046,"iPhone13,2"
com.google.chrome.ios,6,1730586803,1730586809,1730586809.157339,-18000,EB445137-D7F5-57EC-87DA-1DB460D64046,"iPhone13,2"
com.google.chrome.ios,1,1730586759,1730586760,1730586760.776227,-18000,EB445137-D7F5-57EC-87DA-1DB460D64046,"iPhone13,2"
com.google.chrome.ios,0,1730586716,1730586716,1730586716.873775,-18000,EB445137-D7F5-57EC-87DA-1DB460D64046,"iPhone13,2"
com.google.chrome.ios,67,1730586589,1730586656,1730586656.292738,-18000,EB445137-D7F5-57EC-87DA-1DB460D64046,"iPhone13,2"
com.apple.Music,18,1730586212,1730586230,1730586230.45638,-18000,EB445137-D7F5-57EC-87DA-1DB460D64046,"iPhone13,2"
com.google.chrome.ios,11,1730586199,1730586210,1730586211.073334,-18000,EB445137-D7F5-57EC-87DA-1DB460D64046,"iPhone13,2"
com.google.chrome.ios,124,1730585938,1730586062,1730586063.068927,-18000,EB445137-D7F5-57EC-87DA-1DB460D64046,"iPhone13,2"
com.google.Chrome,48,1730585817,1730585865,1730585865.460007,-18000,,
com.leomehlig.today,9,1730585808,1730585817,1730585817.625113,-18000,,
com.microsoft.VSCode,122,1730585686,1730585808,1730585808.405501,-18000,,
com.google.Chrome,37,1730585649,1730585686,1730585686.425844,-18000,,
com.microsoft.VSCode,7,1730585642,1730585649,1730585649.683222,-18000,,
com.google.Chrome,2,1730585640,1730585642,1730585642.198569,-18000,,
com.microsoft.VSCode,5,1730585635,1730585640,1730585640.138897,-18000,,
com.google.Chrome,3,1730585632,1730585635,1730585635.263165,-18000,,
com.microsoft.VSCode,252,1730585380,1730585632,1730585632.468196,-18000,,
com.google.Chrome,3,1730585377,1730585380,1730585380.9994202,-18000,,
com.microsoft.VSCode,48,1730585329,1730585377,1730585377.784908,-18000,,
com.google.Chrome,2,1730585327,1730585329,1730585329.670316,-18000,,
com.microsoft.VSCode,22,1730585305,1730585327,1730585327.1537828,-18000,,
com.google.Chrome,2,1730585303,1730585305,1730585305.3020492,-18000,,
com.microsoft.VSCode,198,1730585105,1730585303,1730585303.808467,-18000,,
com.google.Chrome,1,1730585104,1730585105,1730585105.5889158,-18000,,
com.microsoft.VSCode,0,1730585104,1730585104,1730585104.828923,-18000,,
com.google.Chrome,5,1730585099,1730585104,1730585104.086592,-18000,,
com.microsoft.VSCode,1,1730585098,1730585099,1730585099.858871,-18000,,
com.google.Chrome,1,1730585097,1730585098,1730585098.183538,-18000,,
com.microsoft.VSCode,14,1730585083,1730585097,1730585097.593233,-18000,,
com.google.Chrome,1,1730585082,1730585083,1730585084.02871,-18000,,
com.microsoft.VSCode,5,1730585077,1730585082,1730585082.134385,-18000,,
com.google.Chrome,1,1730585076,1730585077,1730585077.174545,-18000,,
com.microsoft.VSCode,2,1730585074,1730585076,1730585076.4631882,-18000,,
com.google.Chrome,1,1730585073,1730585074,1730585074.076853,-18000,,
com.microsoft.VSCode,5,1730585068,1730585073,1730585073.429027,-18000,,
com.google.Chrome,1,1730585067,1730585068,1730585068.198003,-18000,,
com.microsoft.VSCode,1,1730585066,1730585067,1730585067.253881,-18000,,
com.google.Chrome,4,1730585062,1730585066,1730585066.472415,-18000,,
com.microsoft.VSCode,7,1730585055,1730585062,1730585062.710226,-18000,,
com.google.Chrome,2,1730585053,1730585055,1730585055.9158502,-18000,,
com.microsoft.VSCode,5,1730585048,1730585053,1730585053.6709619,-18000,,
com.google.Chrome,6,1730585042,1730585048,1730585048.62777,-18000,,
com.microsoft.VSCode,1,1730585041,1730585042,1730585042.900167,-18000,,
com.google.Chrome,8,1730585033,1730585041,1730585041.230017,-18000,,
com.microsoft.VSCode,6,1730585027,1730585033,1730585033.315781,-18000,,
com.google.Chrome,1,1730585026,1730585027,1730585028.058424,-18000,,
com.microsoft.VSCode,4,1730585022,1730585026,1730585026.120328,-18000,,
com.google.Chrome,0,1730585022,1730585022,1730585022.92353,-18000,,
com.microsoft.VSCode,1,1730585021,1730585022,1730585022.494411,-18000,,
com.google.Chrome,12,1730585009,1730585021,1730585021.940449,-18000,,
com.microsoft.VSCode,59,1730584950,1730585009,1730585009.697177,-18000,,
com.google.Chrome,25,1730584925,1730584950,1730584950.282788,-18000,,
com.microsoft.VSCode,5,1730584920,1730584925,1730584925.604371,-18000,,
com.google.Chrome,13,1730584907,1730584920,1730584920.7935162,-18000,,
com.microsoft.VSCode,3,1730584904,1730584907,1730584907.1012468,-18000,,
com.google.Chrome,2,1730584902,1730584904,1730584904.398252,-18000,,
com.microsoft.VSCode,6,1730584896,1730584902,1730584902.129571,-18000,,
com.google.Chrome,3,1730584893,1730584896,1730584897.022567,-18000,,
com.microsoft.VSCode,24,1730584869,1730584893,1730584893.711429,-18000,,
com.google.Chrome,8,1730584861,1730584869,1730584869.4650378,-18000,,
com.microsoft.VSCode,3,1730584858,1730584861,1730584861.247364,-18000,,
com.google.Chrome,18,1730584840,1730584858,1730584858.4802608,-18000,,
com.microsoft.VSCode,93,1730584747,1730584840,1730584840.966572,-18000,,
com.google.Chrome,2,1730584745,1730584747,1730584747.511419,-18000,,
com.microsoft.VSCode,322,1730584423,1730584745,1730584745.96103,-18000,,
com.google.Chrome,3,1730584420,1730584423,1730584423.628376,-18000,,
com.microsoft.VSCode,151,1730584269,1730584420,1730584420.420099,-18000,,
com.google.Chrome,1,1730584268,1730584269,1730584269.990844,-18000,,
com.microsoft.VSCode,5,1730584263,1730584268,1730584268.3845692,-18000,,
com.google.Chrome,2,1730584261,1730584263,1730584263.2279758,-18000,,
com.microsoft.VSCode,4,1730584257,1730584261,1730584261.9124022,-18000,,
com.google.Chrome,2,1730584255,1730584257,1730584257.540872,-18000,,
com.microsoft.VSCode,11,1730584244,1730584255,1730584255.448268,-18000,,
com.google.Chrome,36,1730584208,1730584244,1730584244.606646,-18000,,
com.microsoft.VSCode,9,1730584199,1730584208,1730584208.107257,-18000,,
com.google.Chrome,34,1730584165,1730584199,1730584199.120893,-18000,,
com.microsoft.VSCode,83,1730584082,1730584165,1730584165.039892,-18000,,
com.google.Chrome,1,1730584081,1730584082,1730584082.292927,-18000,,
com.microsoft.VSCode,33,1730584048,1730584081,1730584081.0813022,-18000,,
com.google.Chrome,6,1730584042,1730584048,1730584048.60758,-18000,,
com.microsoft.VSCode,10,1730584032,1730584042,1730584042.28203,-18000,,
com.google.Chrome,3,1730584029,1730584032,1730584032.536861,-18000,,
com.microsoft.VSCode,3,1730584026,1730584029,1730584029.851105,-18000,,
com.google.Chrome,1,1730584025,1730584026,1730584026.455995,-18000,,
com.microsoft.VSCode,2,1730584023,1730584025,1730584025.3856668,-18000,,
com.google.Chrome,1,1730584022,1730584023,1730584023.1899881,-18000,,
com.microsoft.VSCode,4,1730584018,1730584022,1730584022.30842,-18000,,
com.google.Chrome,1,1730584017,1730584018,1730584018.205816,-18000,,
com.microsoft.VSCode,15,1730584002,1730584017,1730584017.534227,-18000,,
com.google.Chrome,3,1730583999,1730584002,1730584002.511924,-18000,,
com.microsoft.VSCode,5,1730583994,1730583999,1730583999.613806,-18000,,
com.google.Chrome,15,1730583979,1730583994,1730583994.747968,-18000,,
com.microsoft.VSCode,61,1730583918,1730583979,1730583979.842452,-18000,,
com.google.Chrome,75,1730583843,1730583918,1730583918.616483,-18000,,
com.microsoft.VSCode,4,1730583839,1730583843,1730583844.065753,-18000,,
com.google.Chrome,65,1730583774,1730583839,1730583839.620377,-18000,,
com.leomehlig.today,2,1730583772,1730583774,1730583774.9092999,-18000,,
com.leomehlig.today,17,1730583624,1730583641,1730583642.258605,-18000,,
com.google.Chrome,4160,1730579464,1730583624,1730583624.765349,-18000,,
com.apple.MobileSMS,77,1730579387,1730579464,1730579464.191947,-18000,,
com.google.Chrome,9,1730579378,1730579387,1730579387.785908,-18000,,
com.leomehlig.today,1,1730579377,1730579378,1730579378.689419,-18000,,
com.google.Chrome,5,1730579372,1730579377,1730579377.4039102,-18000,,
com.leomehlig.today,22,1730579350,1730579372,1730579372.370914,-18000,,
com.google.Chrome,32,1730579318,1730579350,1730579350.97606,-18000,,
com.leomehlig.today,12,1730579306,1730579318,1730579318.184993,-18000,,
com.intsig.CamScannerLite,139,1730579159,1730579298,1730579299.97149,-18000,EB445137-D7F5-57EC-87DA-1DB460D64046,"iPhone13,2"
com.apple.camera,1,1730579157,1730579158,1730579159.375224,-18000,EB445137-D7F5-57EC-87DA-1DB460D64046,"iPhone13,2"
com.google.Chrome,1698,1730577608,1730579306,1730579306.307698,-18000,,
com.leomehlig.today,3,1730577501,1730577504,1730577504.720535,-18000,,
com.google.Chrome,4,1730577497,1730577501,1730577501.127562,-18000,,
com.apple.news,87,1730577393,1730577480,1730577480.8148289,-18000,EB445137-D7F5-57EC-87DA-1DB460D64046,"iPhone13,2"
com.google.Gmail,5,1730577376,1730577381,1730577381.873818,-18000,EB445137-D7F5-57EC-87DA-1DB460D64046,"iPhone13,2"
com.apple.Music,2,1730577374,1730577376,1730577377.32298,-18000,EB445137-D7F5-57EC-87DA-1DB460D64046,"iPhone13,2"
com.leomehlig.today,44,1730577297,1730577341,1730577341.7467752,-18000,,
com.apple.MobileSMS,20,1730577277,1730577297,1730577297.513194,-18000,,
com.google.Chrome,4,1730577273,1730577277,1730577278.0072498,-18000,,
com.apple.Music,5,1730576950,1730576955,1730576955.632482,-18000,EB445137-D7F5-57EC-87DA-1DB460D64046,"iPhone13,2"
com.apple.Music,2,1730576654,1730576656,1730576656.06665,-18000,EB445137-D7F5-57EC-87DA-1DB460D64046,"iPhone13,2"
com.apple.Music,6,1730576640,1730576646,1730576646.583101,-18000,EB445137-D7F5-57EC-87DA-1DB460D64046,"iPhone13,2"
com.apple.Music,9,1730576630,1730576639,1730576639.32184,-18000,EB445137-D7F5-57EC-87DA-1DB460D64046,"iPhone13,2"
com.apple.Music,16,1730575839,1730575855,1730575855.787152,-18000,EB445137-D7F5-57EC-87DA-1DB460D64046,"iPhone13,2"
com.google.ios.youtube,4,1730575829,1730575833,1730575833.115868,-18000,EB445137-D7F5-57EC-87DA-1DB460D64046,"iPhone13,2"
com.google.ios.youtube,14,1730575814,1730575828,1730575828.582216,-18000,EB445137-D7F5-57EC-87DA-1DB460D64046,"iPhone13,2"
com.google.ios.youtube,144,1730575490,1730575634,1730575636.252316,-18000,EB445137-D7F5-57EC-87DA-1DB460D64046,"iPhone13,2"
com.apple.news,331,1730575154,1730575485,1730575485.3894029,-18000,EB445137-D7F5-57EC-87DA-1DB460D64046,"iPhone13,2"
com.hammerandchisel.discord,16,1730575130,1730575146,1730575146.976447,-18000,EB445137-D7F5-57EC-87DA-1DB460D64046,"iPhone13,2"
com.apple.MobileSMS,18,1730575107,1730575125,1730575125.318626,-18000,EB445137-D7F5-57EC-87DA-1DB460D64046,"iPhone13,2"
com.google.chrome.ios,78,1730575029,1730575107,1730575107.600634,-18000,EB445137-D7F5-57EC-87DA-1DB460D64046,"iPhone13,2"
com.apple.MobileSMS,2,1730575027,1730575029,1730575029.815973,-18000,EB445137-D7F5-57EC-87DA-1DB460D64046,"iPhone13,2"
com.hammerandchisel.discord,3,1730574731,1730574734,1730574734.422951,-18000,EB445137-D7F5-57EC-87DA-1DB460D64046,"iPhone13,2"
com.google.Chrome,5,1730574711,1730574716,1730574716.9154701,-18000,,
com.apple.camera,1,1730574558,1730574559,1730574559.607281,-18000,EB445137-D7F5-57EC-87DA-1DB460D64046,"iPhone13,2"
com.hammerandchisel.discord,5,1730574557,1730574562,1730574562.37292,-18000,EB445137-D7F5-57EC-87DA-1DB460D64046,"iPhone13,2"
com.hammerandchisel.discord,9,1730574410,1730574419,1730574419.5742521,-18000,EB445137-D7F5-57EC-87DA-1DB460D64046,"iPhone13,2"
com.apple.MobileSMS,8,1730574396,1730574404,1730574405.1142159,-18000,EB445137-D7F5-57EC-87DA-1DB460D64046,"iPhone13,2"
com.apple.MobileSMS,10,1730573862,1730573872,1730573873.0422769,-18000,EB445137-D7F5-57EC-87DA-1DB460D64046,"iPhone13,2"
com.apple.MobileSMS,14,1730573705,1730573719,1730573719.450561,-18000,EB445137-D7F5-57EC-87DA-1DB460D64046,"iPhone13,2"
com.apple.MobileSMS,5,1730573641,1730573646,1730573646.288787,-18000,EB445137-D7F5-57EC-87DA-1DB460D64046,"iPhone13,2"
com.apple.MobileSMS,28,1730573589,1730573617,1730573617.80975,-18000,EB445137-D7F5-57EC-87DA-1DB460D64046,"iPhone13,2"
com.apple.MobileSMS,7,1730573575,1730573582,1730573582.89783,-18000,EB445137-D7F5-57EC-87DA-1DB460D64046,"iPhone13,2"
com.apple.MobileSMS,25,1730573541,1730573566,1730573567.084266,-18000,EB445137-D7F5-57EC-87DA-1DB460D64046,"iPhone13,2"
com.apple.MobileSMS,19,1730573521,1730573540,1730573541.092208,-18000,EB445137-D7F5-57EC-87DA-1DB460D64046,"iPhone13,2"
com.facebook.Facebook,74,1730572871,1730572945,1730572945.225882,-18000,EB445137-D7F5-57EC-87DA-1DB460D64046,"iPhone13,2"
Astrospheric.Astrospheric,20,1730572570,1730572590,1730572590.408029,-18000,EB445137-D7F5-57EC-87DA-1DB460D64046,"iPhone13,2"
com.google.chrome.ios,113,1730572450,1730572563,1730572563.5085158,-18000,EB445137-D7F5-57EC-87DA-1DB460D64046,"iPhone13,2"
com.toyopagroup.picaboo,25,1730572334,1730572359,1730572359.8948421,-18000,EB445137-D7F5-57EC-87DA-1DB460D64046,"iPhone13,2"
com.google.Sheets,37,1730572288,1730572325,1730572325.1669312,-18000,EB445137-D7F5-57EC-87DA-1DB460D64046,"iPhone13,2"
com.google.Drive,8,1730572280,1730572288,1730572288.945265,-18000,EB445137-D7F5-57EC-87DA-1DB460D64046,"iPhone13,2"
com.hammerandchisel.discord,17,1730572261,1730572278,1730572278.900148,-18000,EB445137-D7F5-57EC-87DA-1DB460D64046,"iPhone13,2"
com.hammerandchisel.discord,76,1730571830,1730571906,1730571906.150014,-18000,EB445137-D7F5-57EC-87DA-1DB460D64046,"iPhone13,2"
com.apple.news,55,1730571774,1730571829,1730571829.7565122,-18000,EB445137-D7F5-57EC-87DA-1DB460D64046,"iPhone13,2"
com.microsoft.Office.Outlook,6,1730571740,1730571746,1730571746.94059,-18000,EB445137-D7F5-57EC-87DA-1DB460D64046,"iPhone13,2"
com.leomehlig.today,118,1730571570,1730571688,1730571688.917612,-18000,EB445137-D7F5-57EC-87DA-1DB460D64046,"iPhone13,2"
com.instructure.icanvas,5,1730571558,1730571563,1730571563.0403461,-18000,EB445137-D7F5-57EC-87DA-1DB460D64046,"iPhone13,2"
com.apple.MobileSMS,6,1730571549,1730571555,1730571555.49178,-18000,EB445137-D7F5-57EC-87DA-1DB460D64046,"iPhone13,2"
com.apple.MobileSMS,4,1730571432,1730571436,1730571436.684329,-18000,EB445137-D7F5-57EC-87DA-1DB460D64046,"iPhone13,2"
com.apple.MobileSMS,40,1730571366,1730571406,1730571406.7872949,-18000,EB445137-D7F5-57EC-87DA-1DB460D64046,"iPhone13,2"
com.microsoft.Office.Outlook,15,1730571351,1730571366,1730571366.9347,-18000,EB445137-D7F5-57EC-87DA-1DB460D64046,"iPhone13,2"
com.apple.MobileSMS,58,1730571287,1730571345,1730571346.0333738,-18000,EB445137-D7F5-57EC-87DA-1DB460D64046,"iPhone13,2"
com.apple.MobileSMS,8,1730570823,1730570831,1730570831.9829922,-18000,EB445137-D7F5-57EC-87DA-1DB460D64046,"iPhone13,2"
com.apple.MobileSMS,40,1730570782,1730570822,1730570822.397831,-18000,EB445137-D7F5-57EC-87DA-1DB460D64046,"iPhone13,2"
com.apple.camera,41,1730570740,1730570781,1730570790.036758,-18000,EB445137-D7F5-57EC-87DA-1DB460D64046,"iPhone13,2"
com.google.chrome.ios,24,1730570739,1730570763,1730570789.978183,-18000,EB445137-D7F5-57EC-87DA-1DB460D64046,"iPhone13,2"
com.google.chrome.ios,4,1730570074,1730570078,1730570078.369223,-18000,EB445137-D7F5-57EC-87DA-1DB460D64046,"iPhone13,2"
com.google.chrome.ios,10,1730569942,1730569952,1730569952.517128,-18000,EB445137-D7F5-57EC-87DA-1DB460D64046,"iPhone13,2"
com.google.chrome.ios,44,1730569152,1730569196,1730569196.639245,-18000,EB445137-D7F5-57EC-87DA-1DB460D64046,"iPhone13,2"
com.apple.Music,3,1730569149,1730569152,1730569152.5239,-18000,EB445137-D7F5-57EC-87DA-1DB460D64046,"iPhone13,2"
com.apple.Music,23,1730569122,1730569145,1730569145.9876928,-18000,EB445137-D7F5-57EC-87DA-1DB460D64046,"iPhone13,2"
com.apple.Music,5,1730568813,1730568818,1730568818.98451,-18000,EB445137-D7F5-57EC-87DA-1DB460D64046,"iPhone13,2"
com.apple.Music,27,1730568769,1730568796,1730568796.660176,-18000,EB445137-D7F5-57EC-87DA-1DB460D64046,"iPhone13,2"
com.apple.Health,18,1730568315,1730568333,1730568334.0066109,-18000,EB445137-D7F5-57EC-87DA-1DB460D64046,"iPhone13,2"
com.meijer.mobile.Meijer,8,1730568307,1730568315,1730568315.793795,-18000,EB445137-D7F5-57EC-87DA-1DB460D64046,"iPhone13,2"
com.meijer.mobile.Meijer,1,1730568211,1730568212,1730568212.7918339,-18000,EB445137-D7F5-57EC-87DA-1DB460D64046,"iPhone13,2"
com.meijer.mobile.Meijer,10,1730567668,1730567678,1730567678.790199,-18000,EB445137-D7F5-57EC-87DA-1DB460D64046,"iPhone13,2"
com.google.Chrome,305,1730567546,1730567851,1730567851.386464,-18000,,
com.meijer.mobile.Meijer,14,1730566513,1730566527,1730566527.974637,-18000,EB445137-D7F5-57EC-87DA-1DB460D64046,"iPhone13,2"
com.meijer.mobile.Meijer,6,1730566343,1730566349,1730566349.226708,-18000,EB445137-D7F5-57EC-87DA-1DB460D64046,"iPhone13,2"
com.meijer.mobile.Meijer,54,1730566271,1730566325,1730566325.614156,-18000,EB445137-D7F5-57EC-87DA-1DB460D64046,"iPhone13,2"
com.apple.Maps,3,1730566256,1730566259,1730566259.686336,-18000,EB445137-D7F5-57EC-87DA-1DB460D64046,"iPhone13,2"
com.apple.Maps,8,1730566147,1730566155,1730566155.570759,-18000,EB445137-D7F5-57EC-87DA-1DB460D64046,"iPhone13,2"
com.apple.Maps,5,1730565991,1730565996,1730565996.7621489,-18000,EB445137-D7F5-57EC-87DA-1DB460D64046,"iPhone13,2"
com.apple.Maps,5,1730565546,1730565551,1730565551.522594,-18000,EB445137-D7F5-57EC-87DA-1DB460D64046,"iPhone13,2"
com.google.Chrome,71,1730564538,1730564609,1730564609.767846,-18000,,
com.google.Chrome,304,1730564090,1730564394,1730564394.9817429,-18000,,
com.google.Chrome,376,1730562606,1730562982,1730562982.2152019,-18000,,
com.google.ios.youtube,779,1730561638,1730562417,1730562418.0887542,-18000,EB445137-D7F5-57EC-87DA-1DB460D64046,"iPhone13,2"
com.apple.MobileSMS,16,1730561622,1730561638,1730561639.290977,-18000,EB445137-D7F5-57EC-87DA-1DB460D64046,"iPhone13,2"
com.google.ios.youtube,493,1730561129,1730561622,1730561622.759664,-18000,EB445137-D7F5-57EC-87DA-1DB460D64046,"iPhone13,2"
com.google.chrome.ios,23,1730561106,1730561129,1730561129.608346,-18000,EB445137-D7F5-57EC-87DA-1DB460D64046,"iPhone13,2"
com.google.ios.youtube,575,1730560530,1730561105,1730561106.38168,-18000,EB445137-D7F5-57EC-87DA-1DB460D64046,"iPhone13,2"
com.apple.news,598,1730559920,1730560518,1730560518.7856622,-18000,EB445137-D7F5-57EC-87DA-1DB460D64046,"iPhone13,2"
com.apple.camera,2,1730559873,1730559875,1730559875.6263208,-18000,EB445137-D7F5-57EC-87DA-1DB460D64046,"iPhone13,2"
com.apple.mobiletimer,13,1730559872,1730559885,1730559885.978883,-18000,EB445137-D7F5-57EC-87DA-1DB460D64046,"iPhone13,2"
com.apple.mobiletimer,17,1730558896,1730558913,1730558913.195934,-18000,EB445137-D7F5-57EC-87DA-1DB460D64046,"iPhone13,2"
com.apple.mobiletimer,18,1730558348,1730558366,1730558366.7643619,-18000,EB445137-D7F5-57EC-87DA-1DB460D64046,"iPhone13,2"
com.apple.mobiletimer,18,1730557801,1730557819,1730557819.21843,-18000,EB445137-D7F5-57EC-87DA-1DB460D64046,"iPhone13,2"
com.apple.mobiletimer,12,1730530243,1730530255,1730530255.244571,-18000,EB445137-D7F5-57EC-87DA-1DB460D64046,"iPhone13,2"
com.apple.mobiletimer,5,1730530237,1730530242,1730530242.570957,-18000,EB445137-D7F5-57EC-87DA-1DB460D64046,"iPhone13,2"
com.google.Chrome,105,1730529971,1730530076,1730530078.818713,-18000,,
com.google.Chrome,323,1730529553,1730529876,1730529876.21106,-18000,,
com.google.Chrome,484,1730528741,1730529225,1730529225.9748402,-18000,,
com.google.Chrome,504,1730527445,1730527949,1730527949.243819,-18000,,
com.google.Chrome,447,1730526479,1730526926,1730526926.15238,-18000,,
com.google.Chrome,323,1730526119,1730526442,1730526442.428822,-18000,,
com.google.Chrome,350,1730525285,1730525635,1730525635.913995,-18000,,
com.google.Chrome,999,1730524140,1730525139,1730525139.801816,-18000,,
com.google.Chrome,442,1730523359,1730523801,1730523802.021054,-18000,,
com.google.Chrome,360,1730522845,1730523205,1730523205.922514,-18000,,
com.google.Chrome,974,1730521290,1730522264,1730522264.391058,-18000,,
com.google.Chrome,894,1730519624,1730520518,1730520518.514298,-18000,,
com.supercell.magic,510,1730516082,1730516592,1730516592.4409041,-18000,EB445137-D7F5-57EC-87DA-1DB460D64046,"iPhone13,2"
com.supercell.magic,171,1730515878,1730516049,1730516049.611038,-18000,EB445137-D7F5-57EC-87DA-1DB460D64046,"iPhone13,2"
com.supercell.magic,496,1730515366,1730515862,1730515862.544322,-18000,EB445137-D7F5-57EC-87DA-1DB460D64046,"iPhone13,2"
com.apple.news,2,1730515303,1730515305,1730515306.047724,-18000,EB445137-D7F5-57EC-87DA-1DB460D64046,"iPhone13,2"
com.apple.news,14,1730512780,1730512794,1730512794.644026,-18000,EB445137-D7F5-57EC-87DA-1DB460D64046,"iPhone13,2"
com.apple.news,77,1730508931,1730509008,1730509008.484544,-18000,EB445137-D7F5-57EC-87DA-1DB460D64046,"iPhone13,2"
com.hammerandchisel.discord,71,1730508853,1730508924,1730508924.8165321,-18000,EB445137-D7F5-57EC-87DA-1DB460D64046,"iPhone13,2"
com.google.Chrome,420,1730505254,1730505674,1730505674.511168,-18000,,
com.google.Chrome,313,1730504311,1730504624,1730504624.175138,-18000,,
com.google.Chrome,444,1730502868,1730503312,1730503312.770747,-18000,,
com.apple.camera,331,1730501774,1730502105,1730502105.451992,-18000,EB445137-D7F5-57EC-87DA-1DB460D64046,"iPhone13,2"
com.google.chrome.ios,31,1730501774,1730501805,1730501810.544364,-18000,EB445137-D7F5-57EC-87DA-1DB460D64046,"iPhone13,2"
com.google.chrome.ios,119,1730499991,1730500110,1730500110.98209,-18000,EB445137-D7F5-57EC-87DA-1DB460D64046,"iPhone13,2"
com.google.chrome.ios,71,1730499789,1730499860,1730499861.5825639,-18000,EB445137-D7F5-57EC-87DA-1DB460D64046,"iPhone13,2"
com.google.chrome.ios,121,1730499572,1730499693,1730499694.279304,-18000,EB445137-D7F5-57EC-87DA-1DB460D64046,"iPhone13,2"
com.google.chrome.ios,330,1730499241,1730499571,1730499572.8460279,-18000,EB445137-D7F5-57EC-87DA-1DB460D64046,"iPhone13,2"
com.google.chrome.ios,164,1730499069,1730499233,1730499234.563895,-18000,EB445137-D7F5-57EC-87DA-1DB460D64046,"iPhone13,2"
com.google.chrome.ios,319,1730498737,1730499056,1730499056.727261,-18000,EB445137-D7F5-57EC-87DA-1DB460D64046,"iPhone13,2"
com.google.Gmail,1,1730498727,1730498728,1730498728.438726,-18000,EB445137-D7F5-57EC-87DA-1DB460D64046,"iPhone13,2"
com.apple.journal,1,1730498723,1730498724,1730498724.622565,-18000,EB445137-D7F5-57EC-87DA-1DB460D64046,"iPhone13,2"
com.apple.MobileSMS,14,1730498709,1730498723,1730498723.532404,-18000,EB445137-D7F5-57EC-87DA-1DB460D64046,"iPhone13,2"
com.apple.MobileSMS,8,1730498416,1730498424,1730498425.375313,-18000,EB445137-D7F5-57EC-87DA-1DB460D64046,"iPhone13,2"
com.google.chrome.ios,9,1730498407,1730498416,1730498416.963855,-18000,EB445137-D7F5-57EC-87DA-1DB460D64046,"iPhone13,2"
com.google.chrome.ios,21,1730495633,1730495654,1730495654.777076,-18000,EB445137-D7F5-57EC-87DA-1DB460D64046,"iPhone13,2"
com.google.chrome.ios,2,1730495630,1730495632,1730495633.04011,-18000,EB445137-D7F5-57EC-87DA-1DB460D64046,"iPhone13,2"
com.google.chrome.ios,13,1730495602,1730495615,1730495616.459594,-18000,EB445137-D7F5-57EC-87DA-1DB460D64046,"iPhone13,2"
com.google.Gmail,4,1730495598,1730495602,1730495602.869051,-18000,EB445137-D7F5-57EC-87DA-1DB460D64046,"iPhone13,2"
com.google.chrome.ios,10,1730495588,1730495598,1730495599.125996,-18000,EB445137-D7F5-57EC-87DA-1DB460D64046,"iPhone13,2"
com.google.Gmail,8,1730495580,1730495588,1730495588.34859,-18000,EB445137-D7F5-57EC-87DA-1DB460D64046,"iPhone13,2"
com.google.chrome.ios,3,1730495577,1730495580,1730495580.6686301,-18000,EB445137-D7F5-57EC-87DA-1DB460D64046,"iPhone13,2"
com.google.chrome.ios,2,1730495554,1730495556,1730495557.02437,-18000,EB445137-D7F5-57EC-87DA-1DB460D64046,"iPhone13,2"
com.apple.MobileSMS,15,1730495539,1730495554,1730495554.626678,-18000,EB445137-D7F5-57EC-87DA-1DB460D64046,"iPhone13,2"
com.google.chrome.ios,38,1730495500,1730495538,1730495539.0051131,-18000,EB445137-D7F5-57EC-87DA-1DB460D64046,"iPhone13,2"
com.apple.mobilenotes,3,1730495497,1730495500,1730495500.125088,-18000,EB445137-D7F5-57EC-87DA-1DB460D64046,"iPhone13,2"
com.apple.mobilenotes,5,1730495481,1730495486,1730495487.037733,-18000,EB445137-D7F5-57EC-87DA-1DB460D64046,"iPhone13,2"
com.apple.mobilenotes,10,1730495301,1730495311,1730495311.377058,-18000,EB445137-D7F5-57EC-87DA-1DB460D64046,"iPhone13,2"
com.apple.mobilenotes,23,1730495260,1730495283,1730495283.4328852,-18000,EB445137-D7F5-57EC-87DA-1DB460D64046,"iPhone13,2"
com.google.chrome.ios,2,1730495258,1730495260,1730495260.8416638,-18000,EB445137-D7F5-57EC-87DA-1DB460D64046,"iPhone13,2"
com.google.chrome.ios,29,1730493898,1730493927,1730493928.07655,-18000,EB445137-D7F5-57EC-87DA-1DB460D64046,"iPhone13,2"
com.apple.mobilenotes,2,1730493896,1730493898,1730493898.225614,-18000,EB445137-D7F5-57EC-87DA-1DB460D64046,"iPhone13,2"
com.apple.mobilenotes,53,1730493683,1730493736,1730493737.263773,-18000,EB445137-D7F5-57EC-87DA-1DB460D64046,"iPhone13,2"
com.google.ios.youtube,1968,1730488913,1730490881,1730490882.335568,-18000,EB445137-D7F5-57EC-87DA-1DB460D64046,"iPhone13,2"
com.google.Chrome,317,1730488860,1730489177,1730489177.466476,-18000,,
com.leomehlig.today,48,1730488812,1730488860,1730488860.915478,-18000,,
com.google.Chrome,4,1730488808,1730488812,1730488812.193602,-18000,,
com.google.Chrome,322,1730488209,1730488531,1730488532.321262,-18000,,
com.hammerandchisel.discord,12,1730488111,1730488123,1730488123.7564511,-18000,EB445137-D7F5-57EC-87DA-1DB460D64046,"iPhone13,2"
com.burbn.instagram,29,1730488039,1730488068,1730488069.074479,-18000,EB445137-D7F5-57EC-87DA-1DB460D64046,"iPhone13,2"
com.google.Chrome,415,1730487149,1730487564,1730487564.938616,-18000,,
com.leomehlig.today,50,1730487099,1730487149,1730487149.20064,-18000,,
com.google.Chrome,7,1730487092,1730487099,1730487100.995569,-18000,,
com.burbn.instagram,500,1730486414,1730486914,1730486916.491776,-18000,EB445137-D7F5-57EC-87DA-1DB460D64046,"iPhone13,2"
com.apple.news,142,1730486267,1730486409,1730486409.919306,-18000,EB445137-D7F5-57EC-87DA-1DB460D64046,"iPhone13,2"
com.apple.Health,15,1730486241,1730486256,1730486256.9139051,-18000,EB445137-D7F5-57EC-87DA-1DB460D64046,"iPhone13,2"
com.hammerandchisel.discord,32,1730486207,1730486239,1730486239.604572,-18000,EB445137-D7F5-57EC-87DA-1DB460D64046,"iPhone13,2"
com.hammerandchisel.discord,23,1730485374,1730485397,1730485398.285459,-18000,EB445137-D7F5-57EC-87DA-1DB460D64046,"iPhone13,2"
com.apple.news,90,1730484422,1730484512,1730484512.783155,-18000,EB445137-D7F5-57EC-87DA-1DB460D64046,"iPhone13,2"
com.microsoft.Office.Outlook,1,1730484413,1730484414,1730484414.9941192,-18000,EB445137-D7F5-57EC-87DA-1DB460D64046,"iPhone13,2"
com.microsoft.Office.Outlook,4,1730484408,1730484412,1730484412.021893,-18000,EB445137-D7F5-57EC-87DA-1DB460D64046,"iPhone13,2"
com.apple.MobileSMS,5,1730484403,1730484408,1730484408.039324,-18000,EB445137-D7F5-57EC-87DA-1DB460D64046,"iPhone13,2"
com.apple.mobilecal,7,1730484395,1730484402,1730484402.954269,-18000,EB445137-D7F5-57EC-87DA-1DB460D64046,"iPhone13,2"
com.hammerandchisel.discord,17,1730483794,1730483811,1730483811.7703562,-18000,EB445137-D7F5-57EC-87DA-1DB460D64046,"iPhone13,2"
com.google.Sheets,149,1730483645,1730483794,1730483794.5189319,-18000,EB445137-D7F5-57EC-87DA-1DB460D64046,"iPhone13,2"
com.google.Docs,4,1730483641,1730483645,1730483645.741472,-18000,EB445137-D7F5-57EC-87DA-1DB460D64046,"iPhone13,2"
com.microsoft.Office.Outlook,23,1730483617,1730483640,1730483641.087961,-18000,EB445137-D7F5-57EC-87DA-1DB460D64046,"iPhone13,2"
com.apple.MobileSMS,1,1730483585,1730483586,1730483588.4615731,-18000,EB445137-D7F5-57EC-87DA-1DB460D64046,"iPhone13,2"
com.apple.MobileSMS,15,1730483570,1730483585,1730483585.825786,-18000,EB445137-D7F5-57EC-87DA-1DB460D64046,"iPhone13,2"
com.apple.mobilecal,5,1730483564,1730483569,1730483570.065754,-18000,EB445137-D7F5-57EC-87DA-1DB460D64046,"iPhone13,2"
com.tier9digital.sundial,2,1730483553,1730483555,1730483555.212337,-18000,EB445137-D7F5-57EC-87DA-1DB460D64046,"iPhone13,2"
com.hammerandchisel.discord,10,1730483542,1730483552,1730483553.16028,-18000,EB445137-D7F5-57EC-87DA-1DB460D64046,"iPhone13,2"
com.apple.Music,1,1730483541,1730483542,1730483543.052351,-18000,EB445137-D7F5-57EC-87DA-1DB460D64046,"iPhone13,2"
com.apple.Music,1,1730482019,1730482020,1730482020.376337,-18000,EB445137-D7F5-57EC-87DA-1DB460D64046,"iPhone13,2"
com.apple.Music,4,1730481694,1730481698,1730481698.950437,-18000,EB445137-D7F5-57EC-87DA-1DB460D64046,"iPhone13,2"
com.apple.Music,50,1730481642,1730481692,1730481694.379626,-18000,EB445137-D7F5-57EC-87DA-1DB460D64046,"iPhone13,2"
Astrospheric.Astrospheric,18,1730481317,1730481335,1730481335.481581,-18000,EB445137-D7F5-57EC-87DA-1DB460D64046,"iPhone13,2"
com.apple.Music,1,1730481314,1730481315,1730481315.872679,-18000,EB445137-D7F5-57EC-87DA-1DB460D64046,"iPhone13,2"
com.apple.Music,11,1730481278,1730481289,1730481290.209523,-18000,EB445137-D7F5-57EC-87DA-1DB460D64046,"iPhone13,2"
com.google.chrome.ios,15,1730481263,1730481278,1730481278.9092832,-18000,EB445137-D7F5-57EC-87DA-1DB460D64046,"iPhone13,2"
com.apple.Music,39,1730481203,1730481242,1730481242.724617,-18000,EB445137-D7F5-57EC-87DA-1DB460D64046,"iPhone13,2"
com.apple.Music,2,1730481149,1730481151,1730481152.398076,-18000,EB445137-D7F5-57EC-87DA-1DB460D64046,"iPhone13,2"
com.apple.Music,15,1730481131,1730481146,1730481146.5972118,-18000,EB445137-D7F5-57EC-87DA-1DB460D64046,"iPhone13,2"
com.apple.weather,7,1730481120,1730481127,1730481127.816963,-18000,EB445137-D7F5-57EC-87DA-1DB460D64046,"iPhone13,2"
com.apple.weather,4,1730480859,1730480863,1730480863.9883761,-18000,EB445137-D7F5-57EC-87DA-1DB460D64046,"iPhone13,2"
com.apple.weather,6,1730480838,1730480844,1730480844.239111,-18000,EB445137-D7F5-57EC-87DA-1DB460D64046,"iPhone13,2"
com.apple.weather,6,1730480732,1730480738,1730480739.0430121,-18000,EB445137-D7F5-57EC-87DA-1DB460D64046,"iPhone13,2"
com.burbn.instagram,408,1730480313,1730480721,1730480721.462758,-18000,EB445137-D7F5-57EC-87DA-1DB460D64046,"iPhone13,2"
com.burbn.instagram,62,1730480250,1730480312,1730480312.27567,-18000,EB445137-D7F5-57EC-87DA-1DB460D64046,"iPhone13,2"
com.apple.MobileSMS,5,1730480223,1730480228,1730480228.659672,-18000,EB445137-D7F5-57EC-87DA-1DB460D64046,"iPhone13,2"
com.apple.news,3,1730480220,1730480223,1730480223.730845,-18000,EB445137-D7F5-57EC-87DA-1DB460D64046,"iPhone13,2"
com.google.Chrome,358,1730480208,1730480566,1730480566.87036,-18000,,
com.apple.news,6,1730479370,1730479376,1730479376.229066,-18000,EB445137-D7F5-57EC-87DA-1DB460D64046,"iPhone13,2"
com.apple.news,13,1730479355,1730479368,1730479368.711907,-18000,EB445137-D7F5-57EC-87DA-1DB460D64046,"iPhone13,2"
com.apple.MobileSMS,45,1730479308,1730479353,1730479353.510772,-18000,EB445137-D7F5-57EC-87DA-1DB460D64046,"iPhone13,2"
com.apple.mobileslideshow,36,1730479272,1730479308,1730479308.250134,-18000,EB445137-D7F5-57EC-87DA-1DB460D64046,"iPhone13,2"
com.apple.MobileSMS,29,1730479242,1730479271,1730479272.2627501,-18000,EB445137-D7F5-57EC-87DA-1DB460D64046,"iPhone13,2"
com.microsoft.Office.Outlook,13,1730479229,1730479242,1730479242.605628,-18000,EB445137-D7F5-57EC-87DA-1DB460D64046,"iPhone13,2"
com.apple.camera,86,1730479142,1730479228,1730479230.167093,-18000,EB445137-D7F5-57EC-87DA-1DB460D64046,"iPhone13,2"
com.apple.MobileSMS,9,1730479131,1730479140,1730479141.453727,-18000,EB445137-D7F5-57EC-87DA-1DB460D64046,"iPhone13,2"
com.google.ios.youtube,2,1730479129,1730479131,1730479131.465548,-18000,EB445137-D7F5-57EC-87DA-1DB460D64046,"iPhone13,2"
com.google.ios.youtube,7,1730479099,1730479106,1730479106.494729,-18000,EB445137-D7F5-57EC-87DA-1DB460D64046,"iPhone13,2"
com.google.ios.youtube,697,1730477609,1730478306,1730478307.030561,-18000,EB445137-D7F5-57EC-87DA-1DB460D64046,"iPhone13,2"
com.apple.MobileSMS,2,1730476344,1730476346,1730476346.693246,-18000,EB445137-D7F5-57EC-87DA-1DB460D64046,"iPhone13,2"
com.apple.MobileSMS,12,1730476308,1730476320,1730476320.672399,-18000,EB445137-D7F5-57EC-87DA-1DB460D64046,"iPhone13,2"
com.apple.MobileSMS,182,1730473214,1730473396,1730473396.8685188,-18000,EB445137-D7F5-57EC-87DA-1DB460D64046,"iPhone13,2"
com.apple.MobileSMS,1,1730473213,1730473214,1730473214.973248,-18000,EB445137-D7F5-57EC-87DA-1DB460D64046,"iPhone13,2"
com.google.Chrome,1968,1730473160,1730475128,1730475128.189842,-18000,,
com.apple.mobileslideshow,76,1730473135,1730473211,1730473212.032381,-18000,EB445137-D7F5-57EC-87DA-1DB460D64046,"iPhone13,2"
com.apple.MobileSMS,184,1730472946,1730473130,1730473130.9445791,-18000,EB445137-D7F5-57EC-87DA-1DB460D64046,"iPhone13,2"
com.apple.weather,4,1730472942,1730472946,1730472947.329368,-18000,EB445137-D7F5-57EC-87DA-1DB460D64046,"iPhone13,2"
com.apple.weather,3,1730471829,1730471832,1730471832.328728,-18000,EB445137-D7F5-57EC-87DA-1DB460D64046,"iPhone13,2"
com.apple.weather,2,1730471825,1730471827,1730471827.965898,-18000,EB445137-D7F5-57EC-87DA-1DB460D64046,"iPhone13,2"
com.apple.weather,5,1730471236,1730471241,1730471242.151325,-18000,EB445137-D7F5-57EC-87DA-1DB460D64046,"iPhone13,2"
com.google.ios.youtube,1049,1730470093,1730471142,1730471143.4009,-18000,EB445137-D7F5-57EC-87DA-1DB460D64046,"iPhone13,2"
com.hammerandchisel.discord,18,1730470062,1730470080,1730470080.5083299,-18000,EB445137-D7F5-57EC-87DA-1DB460D64046,"iPhone13,2"
com.robinhood.release.Robinhood,131,1730469904,1730470035,1730470035.898627,-18000,EB445137-D7F5-57EC-87DA-1DB460D64046,"iPhone13,2"
com.microsoft.Office.Outlook,56,1730469658,1730469714,1730469714.541109,-18000,EB445137-D7F5-57EC-87DA-1DB460D64046,"iPhone13,2"
com.apple.mobiletimer,45,1730469601,1730469646,1730469646.560934,-18000,EB445137-D7F5-57EC-87DA-1DB460D64046,"iPhone13,2"
com.apple.mobiletimer,11,1730467571,1730467582,1730467583.144125,-18000,EB445137-D7F5-57EC-87DA-1DB460D64046,"iPhone13,2"
com.google.Chrome,140,1730435749,1730435889,1730435890.268034,-18000,,
com.google.Chrome,301,1730435172,1730435473,1730435473.1742702,-18000,,
com.google.Chrome,408,1730434482,1730434890,1730434890.228598,-18000,,
com.apple.Music,1,1730432085,1730432086,1730432086.952393,-18000,EB445137-D7F5-57EC-87DA-1DB460D64046,"iPhone13,2"
com.google.ios.youtube,3,1730432078,1730432081,1730432082.144429,-18000,EB445137-D7F5-57EC-87DA-1DB460D64046,"iPhone13,2"
com.google.chrome.ios,7,1730432071,1730432078,1730432079.070413,-18000,EB445137-D7F5-57EC-87DA-1DB460D64046,"iPhone13,2"
com.google.ios.youtube,138,1730431933,1730432071,1730432071.756778,-18000,EB445137-D7F5-57EC-87DA-1DB460D64046,"iPhone13,2"
com.google.chrome.ios,9,1730431924,1730431933,1730431934.183042,-18000,EB445137-D7F5-57EC-87DA-1DB460D64046,"iPhone13,2"
com.google.ios.youtube,262,1730431662,1730431924,1730431924.819741,-18000,EB445137-D7F5-57EC-87DA-1DB460D64046,"iPhone13,2"
com.google.chrome.ios,14,1730431648,1730431662,1730431662.813019,-18000,EB445137-D7F5-57EC-87DA-1DB460D64046,"iPhone13,2"
com.google.ios.youtube,153,1730431495,1730431648,1730431648.616621,-18000,EB445137-D7F5-57EC-87DA-1DB460D64046,"iPhone13,2"
com.google.Chrome,300,1730431447,1730431747,1730431747.883544,-18000,,
com.google.chrome.ios,51,1730431438,1730431489,1730431490.0819612,-18000,EB445137-D7F5-57EC-87DA-1DB460D64046,"iPhone13,2"
com.leomehlig.today,45,1730431402,1730431447,1730431447.898573,-18000,,
com.google.chrome.ios,85,1730431352,1730431437,1730431437.4827862,-18000,EB445137-D7F5-57EC-87DA-1DB460D64046,"iPhone13,2"
com.google.Chrome,61,1730431341,1730431402,1730431402.760237,-18000,,
com.google.chrome.ios,236,1730430810,1730431046,1730431046.345769,-18000,EB445137-D7F5-57EC-87DA-1DB460D64046,"iPhone13,2"
com.google.ios.youtube,140,1730430670,1730430810,1730430811.124967,-18000,EB445137-D7F5-57EC-87DA-1DB460D64046,"iPhone13,2"
com.google.chrome.ios,5,1730430647,1730430652,1730430652.540876,-18000,EB445137-D7F5-57EC-87DA-1DB460D64046,"iPhone13,2"
com.google.chrome.ios,22,1730430616,1730430638,1730430639.017669,-18000,EB445137-D7F5-57EC-87DA-1DB460D64046,"iPhone13,2"
com.google.Chrome,81,1730430537,1730430618,1730430618.719975,-18000,,
com.google.chrome.ios,2,1730430533,1730430535,1730430535.170662,-18000,EB445137-D7F5-57EC-87DA-1DB460D64046,"iPhone13,2"
com.google.chrome.ios,10,1730429946,1730429956,1730429957.1204128,-18000,EB445137-D7F5-57EC-87DA-1DB460D64046,"iPhone13,2"
com.google.ios.youtube,2,1730429944,1730429946,1730429947.438272,-18000,EB445137-D7F5-57EC-87DA-1DB460D64046,"iPhone13,2"
com.google.ios.youtube,57,1730429721,1730429778,1730429779.968402,-18000,EB445137-D7F5-57EC-87DA-1DB460D64046,"iPhone13,2"
com.burbn.instagram,130,1730429586,1730429716,1730429716.604852,-18000,EB445137-D7F5-57EC-87DA-1DB460D64046,"iPhone13,2"
com.google.chrome.ios,4,1730429570,1730429574,1730429574.865818,-18000,EB445137-D7F5-57EC-87DA-1DB460D64046,"iPhone13,2"
com.google.chrome.ios,22,1730429422,1730429444,1730429444.5872788,-18000,EB445137-D7F5-57EC-87DA-1DB460D64046,"iPhone13,2"
com.facebook.Facebook,90,1730429316,1730429406,1730429406.284574,-18000,EB445137-D7F5-57EC-87DA-1DB460D64046,"iPhone13,2"
com.apple.news,227,1730429083,1730429310,1730429310.797329,-18000,EB445137-D7F5-57EC-87DA-1DB460D64046,"iPhone13,2"
com.google.ios.youtube,38,1730429038,1730429076,1730429076.795151,-18000,EB445137-D7F5-57EC-87DA-1DB460D64046,"iPhone13,2"
com.google.ios.youtube,10,1730429003,1730429013,1730429013.585156,-18000,EB445137-D7F5-57EC-87DA-1DB460D64046,"iPhone13,2"
com.google.ios.youtube,370,1730428631,1730429001,1730429001.915041,-18000,EB445137-D7F5-57EC-87DA-1DB460D64046,"iPhone13,2"
com.google.ios.youtube,120,1730428498,1730428618,1730428618.729412,-18000,EB445137-D7F5-57EC-87DA-1DB460D64046,"iPhone13,2"
com.google.Chrome,302,1730428478,1730428780,1730428780.838773,-18000,,
com.microsoft.VSCode,9,1730428469,1730428478,1730428478.655916,-18000,,
com.google.Chrome,13,1730428456,1730428469,1730428469.921943,-18000,,
com.hnc.Discord,106,1730428350,1730428456,1730428456.2620602,-18000,,
com.google.Chrome,7,1730428343,1730428350,1730428350.365907,-18000,,
com.leomehlig.today,46,1730428297,1730428343,1730428344.061792,-18000,,
com.apple.iCal,9,1730428288,1730428297,1730428297.2191029,-18000,,
com.leomehlig.today,3,1730428285,1730428288,1730428288.970765,-18000,,
com.microsoft.VSCode,85,1730428200,1730428285,1730428285.3226209,-18000,,
com.google.Chrome,16,1730428184,1730428200,1730428200.847556,-18000,,
com.microsoft.VSCode,506,1730427678,1730428184,1730428184.435615,-18000,,
com.google.Chrome,2,1730427676,1730427678,1730427678.617564,-18000,,
com.microsoft.VSCode,1,1730427675,1730427676,1730427676.257203,-18000,,
com.google.Chrome,11,1730427664,1730427675,1730427675.5631108,-18000,,
com.microsoft.VSCode,729,1730426935,1730427664,1730427664.2098541,-18000,,
com.google.Chrome,2,1730426933,1730426935,1730426935.108953,-18000,,
com.microsoft.VSCode,49,1730426884,1730426933,1730426934.057035,-18000,,
com.google.Chrome,12,1730426872,1730426884,1730426884.7440739,-18000,,
com.microsoft.VSCode,17,1730426855,1730426872,1730426872.831483,-18000,,
com.google.Chrome,10,1730426845,1730426855,1730426855.657738,-18000,,
com.microsoft.VSCode,395,1730426450,1730426845,1730426845.462325,-18000,,
com.hnc.Discord,23,1730426427,1730426450,1730426450.148417,-18000,,
com.microsoft.VSCode,135,1730426292,1730426427,1730426427.973747,-18000,,
com.burbn.instagram,94,1730426089,1730426183,1730426184.018614,-18000,EB445137-D7F5-57EC-87DA-1DB460D64046,"iPhone13,2"
com.google.Chrome,1,1730425892,1730425893,1730425893.727448,-18000,,
com.microsoft.VSCode,2,1730425890,1730425892,1730425892.8371181,-18000,,
com.google.Chrome,2,1730425888,1730425890,1730425890.1066399,-18000,,
com.microsoft.VSCode,2,1730425886,1730425888,1730425888.9371939,-18000,,
com.google.Chrome,4,1730425882,1730425886,1730425886.310215,-18000,,
com.microsoft.VSCode,1,1730425881,1730425882,1730425882.610729,-18000,,
com.google.Chrome,4,1730425877,1730425881,1730425881.069772,-18000,,
com.microsoft.VSCode,2,1730425875,1730425877,1730425877.145608,-18000,,
com.google.Chrome,2,1730425873,1730425875,1730425875.2280111,-18000,,
com.microsoft.VSCode,2,1730425871,1730425873,1730425873.9960818,-18000,,
com.google.Chrome,2,1730425869,1730425871,1730425871.085617,-18000,,
com.microsoft.VSCode,1,1730425868,1730425869,1730425869.152245,-18000,,
com.google.Chrome,1,1730425867,1730425868,1730425868.586632,-18000,,
com.microsoft.VSCode,1,1730425866,1730425867,1730425867.776475,-18000,,
com.google.Chrome,1,1730425865,1730425866,1730425866.289884,-18000,,
com.microsoft.VSCode,1,1730425864,1730425865,1730425865.252582,-18000,,
com.google.Chrome,1,1730425863,1730425864,1730425864.415863,-18000,,
com.microsoft.VSCode,176,1730425687,1730425863,1730425863.1343079,-18000,,
com.google.Chrome,3,1730425684,1730425687,1730425687.066299,-18000,,
com.microsoft.VSCode,2,1730425682,1730425684,1730425684.0566769,-18000,,
com.google.Chrome,15,1730425667,1730425682,1730425682.103512,-18000,,
com.microsoft.VSCode,1,1730425666,1730425667,1730425667.178032,-18000,,
com.google.Chrome,5,1730425661,1730425666,1730425666.4636521,-18000,,
com.microsoft.VSCode,157,1730425504,1730425661,1730425661.9399462,-18000,,
com.google.Chrome,1,1730425503,1730425504,1730425504.7038631,-18000,,
com.microsoft.VSCode,1,1730425502,1730425503,1730425503.9197512,-18000,,
com.google.Chrome,1,1730425501,1730425502,1730425502.800267,-18000,,
com.microsoft.VSCode,2,1730425499,1730425501,1730425501.55056,-18000,,
com.google.Chrome,1,1730425498,1730425499,1730425499.636499,-18000,,
com.microsoft.VSCode,98,1730425400,1730425498,1730425498.369699,-18000,,
com.google.Chrome,2,1730425398,1730425400,1730425400.2704859,-18000,,
com.microsoft.VSCode,1,1730425397,1730425398,1730425398.818824,-18000,,
com.google.Chrome,1,1730425396,1730425397,1730425398.027704,-18000,,
com.microsoft.VSCode,1,1730425395,1730425396,1730425396.841747,-18000,,
com.google.Chrome,0,1730425395,1730425395,1730425395.972519,-18000,,
com.microsoft.VSCode,84,1730425311,1730425395,1730425395.0666552,-18000,,
com.google.Chrome,1,1730425310,1730425311,1730425311.8922071,-18000,,
com.microsoft.VSCode,1,1730425309,1730425310,1730425310.861727,-18000,,
com.google.Chrome,2,1730425307,1730425309,1730425309.577502,-18000,,
com.microsoft.VSCode,1,1730425306,1730425307,1730425307.526363,-18000,,
com.google.Chrome,1,1730425305,1730425306,1730425306.69122,-18000,,
com.microsoft.VSCode,3,1730425302,1730425305,1730425305.9122891,-18000,,
com.google.Chrome,1,1730425301,1730425302,1730425302.9023972,-18000,,
com.microsoft.VSCode,0,1730425301,1730425301,1730425302.000893,-18000,,
com.google.Chrome,1,1730425300,1730425301,1730425301.371275,-18000,,
com.microsoft.VSCode,1,1730425299,1730425300,1730425300.639351,-18000,,
com.google.Chrome,1,1730425298,1730425299,1730425299.933608,-18000,,
com.microsoft.VSCode,0,1730425298,1730425298,1730425298.9080958,-18000,,
com.google.Chrome,1,1730425297,1730425298,1730425298.248777,-18000,,
com.microsoft.VSCode,116,1730425181,1730425297,1730425297.341975,-18000,,
com.google.Chrome,2,1730425179,1730425181,1730425181.879138,-18000,,
com.microsoft.VSCode,1,1730425178,1730425179,1730425179.8834748,-18000,,
com.google.Chrome,3,1730425175,1730425178,1730425178.701685,-18000,,
com.microsoft.VSCode,24,1730425151,1730425175,1730425175.264339,-18000,,
com.google.Chrome,51,1730425100,1730425151,1730425151.626831,-18000,,
com.microsoft.VSCode,159,1730424941,1730425100,1730425100.112019,-18000,,
com.google.Chrome,48,1730424893,1730424941,1730424941.650121,-18000,,
com.microsoft.VSCode,209,1730424684,1730424893,1730424893.5654202,-18000,,
com.google.Chrome,46,1730424638,1730424684,1730424684.636123,-18000,,
com.microsoft.VSCode,307,1730424331,1730424638,1730424638.158897,-18000,,
com.google.Chrome,2,1730424329,1730424331,1730424331.1350322,-18000,,
com.microsoft.VSCode,32,1730424297,1730424329,1730424329.805804,-18000,,
com.google.Chrome,4,1730424293,1730424297,1730424297.140106,-18000,,
com.microsoft.VSCode,90,1730424203,1730424293,1730424293.312724,-18000,,
com.google.Chrome,72,1730424131,1730424203,1730424203.766643,-18000,,
com.microsoft.VSCode,2,1730424129,1730424131,1730424131.170763,-18000,,
com.google.Chrome,9,1730424120,1730424129,1730424129.820534,-18000,,
com.microsoft.VSCode,102,1730424018,1730424120,1730424120.96451,-18000,,
com.google.Chrome,19,1730423999,1730424018,1730424018.526777,-18000,,
com.microsoft.VSCode,345,1730423654,1730423999,1730423999.446724,-18000,,
com.google.Chrome,12,1730423642,1730423654,1730423654.2458029,-18000,,
com.microsoft.VSCode,15,1730423627,1730423642,1730423642.797643,-18000,,
com.google.Chrome,44,1730423583,1730423627,1730423627.947833,-18000,,
com.microsoft.VSCode,19,1730423564,1730423583,1730423583.9436932,-18000,,
com.google.Chrome,1,1730423563,1730423564,1730423564.685497,-18000,,
com.microsoft.VSCode,5,1730423558,1730423563,1730423563.905119,-18000,,
com.google.Chrome,27,1730423531,1730423558,1730423559.042346,-18000,,
com.microsoft.VSCode,209,1730423322,1730423531,1730423531.330277,-18000,,
com.google.Chrome,38,1730423284,1730423322,1730423322.76526,-18000,,
com.burbn.instagram,24,1730423011,1730423035,1730423036.266319,-18000,EB445137-D7F5-57EC-87DA-1DB460D64046,"iPhone13,2"
com.apple.MobileSMS,4,1730423004,1730423008,1730423008.644415,-18000,EB445137-D7F5-57EC-87DA-1DB460D64046,"iPhone13,2"
com.microsoft.VSCode,399,1730422885,1730423284,1730423284.469497,-18000,,
com.google.Chrome,5,1730422880,1730422885,1730422885.5384111,-18000,,
com.microsoft.VSCode,54,1730422826,1730422880,1730422880.254925,-18000,,
com.google.Chrome,2,1730422824,1730422826,1730422826.9847112,-18000,,
com.microsoft.VSCode,23,1730422801,1730422824,1730422824.490674,-18000,,
com.google.Chrome,17,1730422784,1730422801,1730422801.960505,-18000,,
com.microsoft.VSCode,86,1730422698,1730422784,1730422784.895197,-18000,,
com.google.Chrome,15,1730422683,1730422698,1730422698.714758,-18000,,
com.apple.MobileSMS,4,1730422537,1730422541,1730422541.241143,-18000,EB445137-D7F5-57EC-87DA-1DB460D64046,"iPhone13,2"
com.hammerandchisel.discord,12,1730422525,1730422537,1730422538.09742,-18000,EB445137-D7F5-57EC-87DA-1DB460D64046,"iPhone13,2"
com.microsoft.VSCode,827,1730421856,1730422683,1730422683.492384,-18000,,
com.apple.Dictionary,2,1730421854,1730421856,1730421856.627759,-18000,,
com.microsoft.VSCode,73,1730421781,1730421854,1730421854.827155,-18000,,
com.google.Chrome,39,1730421742,1730421781,1730421781.115865,-18000,,
com.microsoft.VSCode,146,1730421596,1730421742,1730421742.6478271,-18000,,
com.google.Chrome,64,1730421532,1730421596,1730421596.474916,-18000,,
com.microsoft.VSCode,17,1730421515,1730421532,1730421532.676579,-18000,,
com.google.Chrome,40,1730421475,1730421515,1730421516.001484,-18000,,
com.microsoft.VSCode,532,1730420943,1730421475,1730421476.034268,-18000,,
com.google.Chrome,52,1730420891,1730420943,1730420943.352824,-18000,,
com.google.Chrome,313,1730419147,1730419460,1730419460.194291,-18000,,
com.google.Chrome,337,1730417807,1730418144,1730418144.309134,-18000,,
com.google.Chrome,359,1730416445,1730416804,1730416804.482918,-18000,,
com.apple.MobileSMS,124,1730415367,1730415491,1730415491.78812,-18000,EB445137-D7F5-57EC-87DA-1DB460D64046,"iPhone13,2"
com.google.chrome.ios,2,1730415365,1730415367,1730415368.459202,-18000,EB445137-D7F5-57EC-87DA-1DB460D64046,"iPhone13,2"
com.google.chrome.ios,6,1730415128,1730415134,1730415134.453885,-18000,EB445137-D7F5-57EC-87DA-1DB460D64046,"iPhone13,2"
com.google.chrome.ios,20,1730414205,1730414225,1730414225.969623,-18000,EB445137-D7F5-57EC-87DA-1DB460D64046,"iPhone13,2"
com.hammerandchisel.discord,12,1730413429,1730413441,1730413442.042676,-18000,EB445137-D7F5-57EC-87DA-1DB460D64046,"iPhone13,2"
com.apple.MobileSMS,16,1730413411,1730413427,1730413427.662284,-18000,EB445137-D7F5-57EC-87DA-1DB460D64046,"iPhone13,2"
com.tinyspeck.chatlyio,3,1730413408,1730413411,1730413411.448123,-18000,EB445137-D7F5-57EC-87DA-1DB460D64046,"iPhone13,2"
com.tinyspeck.chatlyio,33,1730413029,1730413062,1730413062.573518,-18000,EB445137-D7F5-57EC-87DA-1DB460D64046,"iPhone13,2"
com.apple.MobileSMS,4,1730413024,1730413028,1730413028.224872,-18000,EB445137-D7F5-57EC-87DA-1DB460D64046,"iPhone13,2"
com.apple.MobileSMS,2,1730411913,1730411915,1730411915.607462,-18000,EB445137-D7F5-57EC-87DA-1DB460D64046,"iPhone13,2"
com.apple.InCallService,0,1730411913,1730411913,1730411913.743953,-18000,EB445137-D7F5-57EC-87DA-1DB460D64046,"iPhone13,2"
com.apple.InCallService,3,1730410649,1730410652,1730410652.131541,-18000,EB445137-D7F5-57EC-87DA-1DB460D64046,"iPhone13,2"
com.apple.MobileSMS,14,1730410635,1730410649,1730410650.3465729,-18000,EB445137-D7F5-57EC-87DA-1DB460D64046,"iPhone13,2"
com.apple.findmy,4,1730410630,1730410634,1730410635.522417,-18000,EB445137-D7F5-57EC-87DA-1DB460D64046,"iPhone13,2"
com.apple.findmy,6,1730410586,1730410592,1730410592.377876,-18000,EB445137-D7F5-57EC-87DA-1DB460D64046,"iPhone13,2"
com.apple.findmy,7,1730410548,1730410555,1730410555.088114,-18000,EB445137-D7F5-57EC-87DA-1DB460D64046,"iPhone13,2"
com.apple.findmy,9,1730410516,1730410525,1730410525.212537,-18000,EB445137-D7F5-57EC-87DA-1DB460D64046,"iPhone13,2"
com.apple.findmy,6,1730410472,1730410478,1730410478.42515,-18000,EB445137-D7F5-57EC-87DA-1DB460D64046,"iPhone13,2"
com.apple.findmy,17,1730410452,1730410469,1730410469.8637629,-18000,EB445137-D7F5-57EC-87DA-1DB460D64046,"iPhone13,2"
com.google.Chrome,82,1730410270,1730410352,1730410352.554332,-18000,,
com.microsoft.VSCode,23,1730410247,1730410270,1730410270.098864,-18000,,
com.apple.finder,31,1730410216,1730410247,1730410247.316773,-18000,,
com.google.Chrome,15,1730410201,1730410216,1730410216.816005,-18000,,
com.apple.finder,5,1730410196,1730410201,1730410201.774218,-18000,,
com.google.Chrome,33,1730410163,1730410196,1730410196.2667,-18000,,
com.microsoft.VSCode,21,1730410142,1730410163,1730410163.264926,-18000,,
com.apple.news,2,1730410021,1730410023,1730410023.835053,-18000,EB445137-D7F5-57EC-87DA-1DB460D64046,"iPhone13,2"
com.burbn.instagram,87,1730409930,1730410017,1730410017.772131,-18000,EB445137-D7F5-57EC-87DA-1DB460D64046,"iPhone13,2"
com.google.Chrome,361,1730409781,1730410142,1730410142.11483,-18000,,
com.hammerandchisel.discord,15,1730409700,1730409715,1730409715.264504,-18000,EB445137-D7F5-57EC-87DA-1DB460D64046,"iPhone13,2"
com.facebook.Facebook,19,1730409680,1730409699,1730409699.5693731,-18000,EB445137-D7F5-57EC-87DA-1DB460D64046,"iPhone13,2"
com.hammerandchisel.discord,14,1730409662,1730409676,1730409677.057351,-18000,EB445137-D7F5-57EC-87DA-1DB460D64046,"iPhone13,2"
com.microsoft.VSCode,190,1730409591,1730409781,1730409781.371222,-18000,,
com.hammerandchisel.discord,26,1730409408,1730409434,1730409434.836503,-18000,EB445137-D7F5-57EC-87DA-1DB460D64046,"iPhone13,2"
com.apple.findmy,21,1730409382,1730409403,1730409403.728267,-18000,EB445137-D7F5-57EC-87DA-1DB460D64046,"iPhone13,2"
com.toyopagroup.picaboo,73,1730409304,1730409377,1730409377.7615519,-18000,EB445137-D7F5-57EC-87DA-1DB460D64046,"iPhone13,2"
com.microsoft.Office.Outlook,3,1730409301,1730409304,1730409304.486662,-18000,EB445137-D7F5-57EC-87DA-1DB460D64046,"iPhone13,2"
com.google.Chrome,467,1730409124,1730409591,1730409591.611175,-18000,,
com.microsoft.Office.Outlook,10,1730409120,1730409130,1730409130.291161,-18000,EB445137-D7F5-57EC-87DA-1DB460D64046,"iPhone13,2"
com.apple.finder,1,1730408989,1730408990,1730408990.826459,-18000,,
com.google.Chrome,9,1730408980,1730408989,1730408989.87704,-18000,,
com.apple.finder,7,1730408973,1730408980,1730408980.907335,-18000,,
com.google.Chrome,102,1730408871,1730408973,1730408973.1711621,-18000,,
com.apple.finder,16,1730408855,1730408871,1730408871.408515,-18000,,
com.google.Chrome,902,1730407953,1730408855,1730408855.35976,-18000,,
com.apple.finder,36,1730407917,1730407953,1730407953.438873,-18000,,
com.google.Chrome,59,1730407858,1730407917,1730407917.410146,-18000,,
com.microsoft.Outlook,2,1730407856,1730407858,1730407858.674593,-18000,,
com.google.Chrome,61,1730407795,1730407856,1730407856.6601791,-18000,,
com.microsoft.VSCode,317,1730407478,1730407795,1730407795.957199,-18000,,
com.google.Chrome,11,1730407467,1730407478,1730407478.566283,-18000,,
com.microsoft.VSCode,69,1730407398,1730407467,1730407467.8058748,-18000,,
com.google.Chrome,10,1730407388,1730407398,1730407398.9894009,-18000,,
com.microsoft.VSCode,166,1730407222,1730407388,1730407388.6319962,-18000,,
com.google.Chrome,9,1730407213,1730407222,1730407222.464518,-18000,,
com.microsoft.VSCode,1,1730407212,1730407213,1730407213.873979,-18000,,
com.google.Chrome,3,1730407209,1730407212,1730407212.6037378,-18000,,
com.microsoft.VSCode,26,1730407183,1730407209,1730407209.313354,-18000,,
com.google.Chrome,7,1730407176,1730407183,1730407183.8184829,-18000,,
com.microsoft.VSCode,175,1730407001,1730407176,1730407176.516865,-18000,,
com.apple.finder,27,1730406974,1730407001,1730407001.20262,-18000,,
com.microsoft.VSCode,157,1730406817,1730406974,1730406974.91941,-18000,,
com.google.Chrome,25,1730406792,1730406817,1730406817.86376,-18000,,
com.microsoft.VSCode,212,1730406580,1730406792,1730406793.044153,-18000,,
com.apple.finder,5,1730406575,1730406580,1730406580.742334,-18000,,
com.apple.archiveutility,0,1730406575,1730406575,1730406575.562471,-18000,,
com.apple.finder,19,1730406556,1730406575,1730406575.25208,-18000,,
com.google.Chrome,44,1730406512,1730406556,1730406556.8539639,-18000,,
com.microsoft.VSCode,2,1730406510,1730406512,1730406513.4983149,-18000,,
com.google.Chrome,5,1730406505,1730406510,1730406510.595974,-18000,,
com.google.Chrome,1630,1730404804,1730406434,1730406434.5713692,-18000,,
com.microsoft.Office.Outlook,4,1730404409,1730404413,1730404413.266473,-18000,EB445137-D7F5-57EC-87DA-1DB460D64046,"iPhone13,2"
com.instructure.icanvas,7,1730404402,1730404409,1730404410.224924,-18000,EB445137-D7F5-57EC-87DA-1DB460D64046,"iPhone13,2"
com.instructure.icanvas,40,1730403572,1730403612,1730403613.158011,-18000,EB445137-D7F5-57EC-87DA-1DB460D64046,"iPhone13,2"
com.google.chrome.ios,5,1730403567,1730403572,1730403573.326345,-18000,EB445137-D7F5-57EC-87DA-1DB460D64046,"iPhone13,2"
com.google.chrome.ios,65,1730403069,1730403134,1730403135.073592,-18000,EB445137-D7F5-57EC-87DA-1DB460D64046,"iPhone13,2"
com.instructure.icanvas,2,1730403067,1730403069,1730403069.993896,-18000,EB445137-D7F5-57EC-87DA-1DB460D64046,"iPhone13,2"
com.instructure.icanvas,319,1730402667,1730402986,1730402986.810237,-18000,EB445137-D7F5-57EC-87DA-1DB460D64046,"iPhone13,2"
com.google.chrome.ios,4,1730402663,1730402667,1730402667.83692,-18000,EB445137-D7F5-57EC-87DA-1DB460D64046,"iPhone13,2"
com.google.chrome.ios,185,1730402396,1730402581,1730402581.9824739,-18000,EB445137-D7F5-57EC-87DA-1DB460D64046,"iPhone13,2"
com.google.chrome.ios,140,1730402243,1730402383,1730402383.610496,-18000,EB445137-D7F5-57EC-87DA-1DB460D64046,"iPhone13,2"
com.google.chrome.ios,972,1730401123,1730402095,1730402095.753123,-18000,EB445137-D7F5-57EC-87DA-1DB460D64046,"iPhone13,2"
com.google.chrome.ios,117,1730400933,1730401050,1730401050.6097841,-18000,EB445137-D7F5-57EC-87DA-1DB460D64046,"iPhone13,2"
com.google.chrome.ios,0,1730400932,1730400932,1730400933.079612,-18000,EB445137-D7F5-57EC-87DA-1DB460D64046,"iPhone13,2"
com.google.chrome.ios,598,1730400240,1730400838,1730400838.297956,-18000,EB445137-D7F5-57EC-87DA-1DB460D64046,"iPhone13,2"
com.google.Chrome,357,1730399510,1730399867,1730399867.356158,-18000,,
com.google.chrome.ios,74,1730398186,1730398260,1730398261.216608,-18000,EB445137-D7F5-57EC-87DA-1DB460D64046,"iPhone13,2"
com.hammerandchisel.discord,2,1730398184,1730398186,1730398186.350533,-18000,EB445137-D7F5-57EC-87DA-1DB460D64046,"iPhone13,2"
com.hammerandchisel.discord,139,1730397477,1730397616,1730397617.1792831,-18000,EB445137-D7F5-57EC-87DA-1DB460D64046,"iPhone13,2"
com.apple.Music,8,1730397463,1730397471,1730397471.891955,-18000,EB445137-D7F5-57EC-87DA-1DB460D64046,"iPhone13,2"
com.apple.Music,1,1730397288,1730397289,1730397289.9775438,-18000,EB445137-D7F5-57EC-87DA-1DB460D64046,"iPhone13,2"
com.apple.Music,27,1730396780,1730396807,1730396808.111981,-18000,EB445137-D7F5-57EC-87DA-1DB460D64046,"iPhone13,2"
com.microsoft.Office.Outlook,46,1730396475,1730396521,1730396521.666977,-18000,EB445137-D7F5-57EC-87DA-1DB460D64046,"iPhone13,2"
com.google.Chrome,690,1730395584,1730396274,1730396274.219977,-18000,,
com.leomehlig.today,88,1730395496,1730395584,1730395584.846085,-18000,,
com.google.Chrome,4,1730395492,1730395496,1730395496.96663,-18000,,
com.microsoft.Outlook,3,1730395489,1730395492,1730395492.7101789,-18000,,
com.google.Chrome,950,1730394539,1730395489,1730395489.370397,-18000,,
com.google.Chrome,86,1730393272,1730393358,1730393358.5747972,-18000,,
com.microsoft.Outlook,35,1730393237,1730393272,1730393272.916994,-18000,,
com.google.Chrome,1193,1730392044,1730393237,1730393237.219369,-18000,,
com.apple.MobileSMS,20,1730392024,1730392044,1730392044.757492,-18000,,
com.google.Chrome,864,1730391160,1730392024,1730392024.700629,-18000,,
com.apple.MobileSMS,2,1730391158,1730391160,1730391160.104213,-18000,,
com.google.Chrome,31,1730391127,1730391158,1730391158.114757,-18000,,
com.apple.MobileSMS,5,1730391122,1730391127,1730391127.526703,-18000,,
com.google.Chrome,9,1730391113,1730391122,1730391122.8640618,-18000,,
com.apple.MobileSMS,3,1730391110,1730391113,1730391113.592372,-18000,,
com.google.Chrome,4,1730391106,1730391110,1730391110.639412,-18000,,
com.apple.MobileSMS,24,1730391082,1730391106,1730391106.511588,-18000,,
com.google.Chrome,550,1730390532,1730391082,1730391082.348456,-18000,,
com.microsoft.VSCode,4,1730390528,1730390532,1730390532.3874578,-18000,,
com.google.Chrome,37,1730390491,1730390528,1730390528.957624,-18000,,
com.apple.Preview,8,1730390469,1730390477,1730390477.1861339,-18000,,
com.microsoft.VSCode,21,1730390448,1730390469,1730390469.43398,-18000,,
com.google.Chrome,11,1730390437,1730390448,1730390448.8129292,-18000,,
com.microsoft.VSCode,5,1730390432,1730390437,1730390437.711402,-18000,,
com.microsoft.VSCode,12,1730389879,1730389891,1730389891.756568,-18000,,
com.google.Chrome,2,1730389877,1730389879,1730389879.85436,-18000,,
com.microsoft.VSCode,32,1730389845,1730389877,1730389877.764442,-18000,,
com.google.Chrome,14,1730389831,1730389845,1730389845.7796059,-18000,,
com.microsoft.VSCode,1,1730389830,1730389831,1730389831.99524,-18000,,
com.google.Chrome,2,1730389828,1730389830,1730389830.324172,-18000,,
com.microsoft.VSCode,0,1730389828,1730389828,1730389829.0201402,-18000,,
com.google.Chrome,2,1730389826,1730389828,1730389828.126419,-18000,,
com.microsoft.VSCode,1,1730389825,1730389826,1730389826.735153,-18000,,
com.google.Chrome,2,1730389823,1730389825,1730389825.072531,-18000,,
com.microsoft.VSCode,1,1730389822,1730389823,1730389823.407553,-18000,,
com.google.Chrome,3,1730389819,1730389822,1730389822.103378,-18000,,
com.microsoft.VSCode,14,1730389805,1730389819,1730389819.5457768,-18000,,
com.google.Chrome,9,1730389796,1730389805,1730389805.837657,-18000,,
com.microsoft.VSCode,70,1730389726,1730389796,1730389796.813901,-18000,,
com.google.Chrome,4,1730389722,1730389726,1730389726.2404919,-18000,,
com.microsoft.VSCode,64,1730389658,1730389722,1730389722.4839358,-18000,,
com.google.Chrome,1,1730389657,1730389658,1730389658.796519,-18000,,
com.microsoft.VSCode,19,1730389638,1730389657,1730389657.683395,-18000,,
com.google.Chrome,7,1730389631,1730389638,1730389638.575615,-18000,,
com.microsoft.VSCode,5,1730389626,1730389631,1730389631.048757,-18000,,
com.google.Chrome,2,1730389624,1730389626,1730389626.767795,-18000,,
com.microsoft.VSCode,4,1730389620,1730389624,1730389624.3306742,-18000,,
com.google.Chrome,0,1730389620,1730389620,1730389620.861455,-18000,,
com.microsoft.VSCode,10,1730389610,1730389620,1730389620.054712,-18000,,
com.google.Chrome,3,1730389607,1730389610,1730389610.120071,-18000,,
com.microsoft.VSCode,1,1730389606,1730389607,1730389607.8016891,-18000,,
com.google.Chrome,6,1730389600,1730389606,1730389606.649409,-18000,,
com.microsoft.VSCode,99,1730389501,1730389600,1730389600.5679379,-18000,,
com.google.Chrome,1,1730389500,1730389501,1730389501.464531,-18000,,
com.microsoft.VSCode,11,1730389489,1730389500,1730389500.941323,-18000,,
com.google.Chrome,3,1730389486,1730389489,1730389489.629603,-18000,,
com.microsoft.VSCode,10,1730389476,1730389486,1730389486.999891,-18000,,
com.google.Chrome,2,1730389474,1730389476,1730389476.842791,-18000,,
com.microsoft.VSCode,59,1730389415,1730389474,1730389474.196482,-18000,,
com.google.Chrome,39,1730389376,1730389415,1730389416.005965,-18000,,
com.microsoft.VSCode,21,1730389355,1730389376,1730389376.939868,-18000,,
com.google.Chrome,21,1730389334,1730389355,1730389355.8941789,-18000,,
com.microsoft.VSCode,23,1730389311,1730389334,1730389335.030782,-18000,,
com.google.Chrome,3,1730389308,1730389311,1730389311.077275,-18000,,
com.microsoft.VSCode,11,1730389297,1730389308,1730389308.87691,-18000,,
com.google.Chrome,11,1730389286,1730389297,1730389297.625503,-18000,,
com.microsoft.VSCode,137,1730389149,1730389286,1730389286.4545941,-18000,,
com.google.Chrome,30,1730389119,1730389149,1730389149.623817,-18000,,
com.microsoft.VSCode,9,1730389110,1730389119,1730389119.183189,-18000,,
com.google.Chrome,27,1730389083,1730389110,1730389110.112778,-18000,,
com.microsoft.VSCode,125,1730388958,1730389083,1730389083.56458,-18000,,
com.google.Chrome,1,1730388957,1730388958,1730388958.195883,-18000,,
com.microsoft.VSCode,37,1730388920,1730388957,1730388957.284908,-18000,,
com.google.Chrome,4,1730388916,1730388920,1730388920.5307121,-18000,,
com.microsoft.VSCode,9,1730388907,1730388916,1730388917.005845,-18000,,
com.google.Chrome,3,1730388904,1730388907,1730388907.181641,-18000,,
com.microsoft.VSCode,15,1730388889,1730388904,1730388904.87225,-18000,,
com.google.Chrome,1,1730388888,1730388889,1730388889.2485619,-18000,,
com.microsoft.VSCode,67,1730388821,1730388888,1730388888.451702,-18000,,
com.google.Chrome,30,1730388791,1730388821,1730388821.1152802,-18000,,
com.microsoft.VSCode,52,1730388739,1730388791,1730388791.697823,-18000,,
com.google.Chrome,2,1730388737,1730388739,1730388739.346086,-18000,,
com.microsoft.VSCode,10,1730388727,1730388737,1730388737.048616,-18000,,
com.google.Chrome,4,1730388723,1730388727,1730388728.043349,-18000,,
com.microsoft.VSCode,5,1730388718,1730388723,1730388723.435106,-18000,,
com.google.Chrome,24,1730388694,1730388718,1730388718.286691,-18000,,
com.microsoft.VSCode,112,1730388582,1730388694,1730388695.058751,-18000,,
com.google.Chrome,3,1730388579,1730388582,1730388583.027213,-18000,,
com.microsoft.VSCode,6,1730388573,1730388579,1730388579.927944,-18000,,
com.google.Chrome,4,1730388569,1730388573,1730388573.382321,-18000,,
com.microsoft.VSCode,10,1730388559,1730388569,1730388569.69135,-18000,,
com.google.Chrome,6,1730388553,1730388559,1730388559.595014,-18000,,
com.microsoft.VSCode,44,1730388509,1730388553,1730388553.842972,-18000,,
com.google.Chrome,10,1730388499,1730388509,1730388509.739801,-18000,,
com.microsoft.VSCode,1,1730388498,1730388499,1730388499.6509318,-18000,,
com.google.Chrome,11,1730388487,1730388498,1730388499.0059671,-18000,,
com.microsoft.VSCode,169,1730388318,1730388487,1730388487.670055,-18000,,
com.google.Chrome,1,1730388317,1730388318,1730388319.048706,-18000,,
com.microsoft.VSCode,14,1730388303,1730388317,1730388317.7889318,-18000,,
com.google.Chrome,1,1730388302,1730388303,1730388303.093602,-18000,,
com.microsoft.VSCode,1,1730388301,1730388302,1730388302.2017632,-18000,,
com.google.Chrome,1,1730388300,1730388301,1730388301.273079,-18000,,
com.microsoft.VSCode,1,1730388299,1730388300,1730388300.4548612,-18000,,
com.google.Chrome,1,1730388298,1730388299,1730388299.8011808,-18000,,
com.microsoft.VSCode,1,1730388297,1730388298,1730388298.827753,-18000,,
com.google.Chrome,0,1730388297,1730388297,1730388297.974069,-18000,,
com.microsoft.VSCode,1,1730388296,1730388297,1730388297.095364,-18000,,
com.google.Chrome,1,1730388295,1730388296,1730388296.63545,-18000,,
com.microsoft.VSCode,1,1730388294,1730388295,1730388295.525097,-18000,,
com.google.Chrome,0,1730388294,1730388294,1730388294.9300961,-18000,,
com.microsoft.VSCode,1,1730388293,1730388294,1730388294.212043,-18000,,
com.google.Chrome,1,1730388292,1730388293,1730388293.448178,-18000,,
com.microsoft.VSCode,0,1730388292,1730388292,1730388292.7292628,-18000,,
com.google.Chrome,1,1730388291,1730388292,1730388292.101245,-18000,,
com.microsoft.VSCode,1,1730388290,1730388291,1730388291.306051,-18000,,
com.google.Chrome,4,1730388286,1730388290,1730388290.596262,-18000,,
com.microsoft.VSCode,14,1730388272,1730388286,1730388286.8671808,-18000,,
com.google.Chrome,2,1730388270,1730388272,1730388272.7378469,-18000,,
com.microsoft.VSCode,3,1730388267,1730388270,1730388270.3989391,-18000,,
com.google.Chrome,15,1730388252,1730388267,1730388267.64136,-18000,,
com.microsoft.VSCode,1,1730388251,1730388252,1730388252.6292892,-18000,,
com.google.Chrome,1,1730388250,1730388251,1730388251.87429,-18000,,
com.microsoft.VSCode,0,1730388250,1730388250,1730388251.030988,-18000,,
com.google.Chrome,1,1730388249,1730388250,1730388250.419403,-18000,,
com.microsoft.VSCode,4,1730388245,1730388249,1730388249.091659,-18000,,
com.google.Chrome,7,1730388238,1730388245,1730388245.5657902,-18000,,
com.microsoft.VSCode,8,1730388230,1730388238,1730388238.648813,-18000,,
com.google.Chrome,10,1730388220,1730388230,1730388230.148097,-18000,,
com.microsoft.VSCode,3,1730388217,1730388220,1730388220.9648042,-18000,,
com.google.Chrome,10,1730388207,1730388217,1730388217.949009,-18000,,
com.microsoft.VSCode,4,1730388203,1730388207,1730388207.0828571,-18000,,
com.google.Chrome,2,1730388201,1730388203,1730388203.6256351,-18000,,
com.microsoft.VSCode,33,1730388168,1730388201,1730388201.8557281,-18000,,
com.google.Chrome,5,1730388163,1730388168,1730388168.5265331,-18000,,
com.microsoft.VSCode,749,1730387414,1730388163,1730388163.1711922,-18000,,
com.google.Chrome,1,1730387413,1730387414,1730387414.1632,-18000,,
com.microsoft.VSCode,136,1730387277,1730387413,1730387413.818707,-18000,,
com.google.Chrome,2,1730387275,1730387277,1730387277.464926,-18000,,
com.microsoft.VSCode,8,1730387267,1730387275,1730387275.544883,-18000,,
com.google.Chrome,3,1730387264,1730387267,1730387267.2467918,-18000,,
com.microsoft.VSCode,1,1730387263,1730387264,1730387265.0008821,-18000,,
com.google.Chrome,0,1730387263,1730387263,1730387264.022361,-18000,,
com.microsoft.VSCode,5,1730387258,1730387263,1730387263.6499681,-18000,,
com.google.Chrome,4,1730387254,1730387258,1730387258.083098,-18000,,
com.microsoft.VSCode,3,1730387251,1730387254,1730387254.660725,-18000,,
com.google.Chrome,3,1730387248,1730387251,1730387251.172731,-18000,,
com.microsoft.VSCode,45,1730387203,1730387248,1730387248.7900681,-18000,,
com.google.Chrome,25,1730387178,1730387203,1730387203.128714,-18000,,
com.microsoft.VSCode,27,1730387151,1730387178,1730387178.64382,-18000,,
com.google.Chrome,0,1730387151,1730387151,1730387151.54512,-18000,,
com.microsoft.VSCode,8,1730387143,1730387151,1730387151.208259,-18000,,
com.google.Chrome,1,1730387142,1730387143,1730387143.3744888,-18000,,
com.microsoft.VSCode,7,1730387135,1730387142,1730387142.176324,-18000,,
com.google.Chrome,1,1730387134,1730387135,1730387135.941565,-18000,,
com.microsoft.VSCode,1,1730387133,1730387134,1730387134.73632,-18000,,
com.google.Chrome,0,1730387133,1730387133,1730387133.73569,-18000,,
com.microsoft.VSCode,1,1730387132,1730387133,1730387133.099897,-18000,,
com.google.Chrome,3,1730387129,1730387132,1730387132.099139,-18000,,
com.microsoft.VSCode,390,1730386739,1730387129,1730387129.6710238,-18000,,
com.google.Chrome,9,1730386730,1730386739,1730386739.282398,-18000,,
com.microsoft.VSCode,57,1730386673,1730386730,1730386730.336927,-18000,,
com.google.Chrome,3,1730386670,1730386673,1730386673.642633,-18000,,
com.microsoft.VSCode,39,1730386631,1730386670,1730386670.9073439,-18000,,
com.google.Chrome,21,1730386610,1730386631,1730386631.7368932,-18000,,
com.microsoft.VSCode,10,1730386600,1730386610,1730386611.05109,-18000,,
com.google.Chrome,6,1730386594,1730386600,1730386600.639247,-18000,,
com.microsoft.VSCode,13,1730386581,1730386594,1730386594.578158,-18000,,
com.google.Chrome,6,1730386575,1730386581,1730386581.1269,-18000,,
com.microsoft.VSCode,5,1730386570,1730386575,1730386575.9348922,-18000,,
com.google.Chrome,5,1730386565,1730386570,1730386571.0274029,-18000,,
com.microsoft.VSCode,2,1730386563,1730386565,1730386565.2011771,-18000,,
com.google.Chrome,1,1730386562,1730386563,1730386563.529307,-18000,,
com.microsoft.VSCode,2,1730386560,1730386562,1730386562.579572,-18000,,
com.google.Chrome,1,1730386559,1730386560,1730386560.9689531,-18000,,
com.microsoft.VSCode,4,1730386555,1730386559,1730386559.12451,-18000,,
com.google.Chrome,23,1730386532,1730386555,1730386555.683261,-18000,,
com.microsoft.VSCode,15,1730386517,1730386532,1730386532.853313,-18000,,
com.google.Chrome,6,1730386511,1730386517,1730386517.6828408,-18000,,
com.microsoft.VSCode,48,1730386463,1730386511,1730386511.5613031,-18000,,
com.google.Chrome,2,1730386461,1730386463,1730386463.1161652,-18000,,
com.microsoft.VSCode,6,1730386455,1730386461,1730386461.698235,-18000,,
com.google.Chrome,7,1730386448,1730386455,1730386455.763077,-18000,,
com.microsoft.VSCode,68,1730386380,1730386448,1730386448.951855,-18000,,
com.google.Chrome,16,1730386364,1730386380,1730386380.902911,-18000,,
com.microsoft.VSCode,30,1730386334,1730386364,1730386364.94261,-18000,,
com.google.Chrome,6,1730386328,1730386334,1730386334.566536,-18000,,
com.microsoft.VSCode,6,1730386322,1730386328,1730386328.532775,-18000,,
com.google.Chrome,1,1730386321,1730386322,1730386322.166009,-18000,,
com.microsoft.VSCode,2,1730386319,1730386321,1730386321.481296,-18000,,
com.google.Chrome,1,1730386318,1730386319,1730386319.924683,-18000,,
com.microsoft.VSCode,2,1730386316,1730386318,1730386318.727921,-18000,,
com.google.Chrome,1,1730386315,1730386316,1730386316.691685,-18000,,
com.microsoft.VSCode,8,1730386307,1730386315,1730386315.756654,-18000,,
com.google.Chrome,3,1730386304,1730386307,1730386307.8763928,-18000,,
com.microsoft.VSCode,32,1730386272,1730386304,1730386304.134667,-18000,,
com.google.Chrome,3,1730386269,1730386272,1730386272.391872,-18000,,
com.microsoft.VSCode,3,1730386266,1730386269,1730386269.649128,-18000,,
com.google.Chrome,7,1730386259,1730386266,1730386266.14614,-18000,,
com.microsoft.VSCode,2,1730386257,1730386259,1730386259.743709,-18000,,
com.google.Chrome,2,1730386255,1730386257,1730386258.019285,-18000,,
com.microsoft.VSCode,9,1730386246,1730386255,1730386255.841867,-18000,,
com.google.Chrome,2,1730386244,1730386246,1730386246.747422,-18000,,
com.microsoft.VSCode,16,1730386228,1730386244,1730386244.603777,-18000,,
com.google.Chrome,5,1730386223,1730386228,1730386228.271486,-18000,,
com.microsoft.VSCode,4,1730386219,1730386223,1730386223.4639401,-18000,,
com.google.Chrome,2,1730386217,1730386219,1730386219.3862839,-18000,,
com.microsoft.VSCode,2,1730386215,1730386217,1730386217.869842,-18000,,
com.google.Chrome,1,1730386214,1730386215,1730386215.773957,-18000,,
com.microsoft.VSCode,2,1730386212,1730386214,1730386214.190546,-18000,,
com.google.Chrome,1,1730386211,1730386212,1730386212.694093,-18000,,
com.microsoft.VSCode,2,1730386209,1730386211,1730386211.074646,-18000,,
com.google.Chrome,10,1730386199,1730386209,1730386209.173245,-18000,,
com.microsoft.VSCode,3,1730386196,1730386199,1730386199.0471869,-18000,,
com.google.Chrome,0,1730386196,1730386196,1730386196.97189,-18000,,
com.microsoft.VSCode,3,1730386193,1730386196,1730386196.191026,-18000,,
com.google.Chrome,52,1730386141,1730386193,1730386193.8850598,-18000,,
com.microsoft.VSCode,236,1730385905,1730386141,1730386141.1591492,-18000,,
com.apple.finder,36,1730385869,1730385905,1730385905.240936,-18000,,
com.google.Chrome,36,1730385833,1730385869,1730385869.496773,-18000,,
com.microsoft.VSCode,11,1730385800,1730385811,1730385811.485306,-18000,,
com.apple.finder,3,1730385797,1730385800,1730385800.235258,-18000,,
com.apple.MobileSMS,47,1730385750,1730385797,1730385797.1166282,-18000,,
com.apple.finder,2,1730385748,1730385750,1730385750.642493,-18000,,
com.google.ios.youtube,1067,1730382943,1730384010,1730384010.8697119,-18000,EB445137-D7F5-57EC-87DA-1DB460D64046,"iPhone13,2"
com.hammerandchisel.discord,55,1730382862,1730382917,1730382917.180613,-18000,EB445137-D7F5-57EC-87DA-1DB460D64046,"iPhone13,2"
com.apple.camera,2,1730382852,1730382854,1730382854.9472342,-18000,EB445137-D7F5-57EC-87DA-1DB460D64046,"iPhone13,2"
com.apple.weather,9,1730382849,1730382858,1730382858.5985909,-18000,EB445137-D7F5-57EC-87DA-1DB460D64046,"iPhone13,2"
com.apple.weather,6,1730382838,1730382844,1730382844.79,-18000,EB445137-D7F5-57EC-87DA-1DB460D64046,"iPhone13,2"
com.apple.weather,7,1730382408,1730382415,1730382415.095212,-18000,EB445137-D7F5-57EC-87DA-1DB460D64046,"iPhone13,2"
com.apple.camera,0,1730382408,1730382408,1730382408.8676739,-18000,EB445137-D7F5-57EC-87DA-1DB460D64046,"iPhone13,2"
com.apple.weather,60,1730382307,1730382367,1730382368.304039,-18000,EB445137-D7F5-57EC-87DA-1DB460D64046,"iPhone13,2"
com.renpho.health,34,1730382272,1730382306,1730382307.097588,-18000,EB445137-D7F5-57EC-87DA-1DB460D64046,"iPhone13,2"
com.apple.Health,17,1730350815,1730350832,1730350832.371422,-18000,EB445137-D7F5-57EC-87DA-1DB460D64046,"iPhone13,2"
com.apple.journal,134,1730350680,1730350814,1730350814.1305451,-18000,EB445137-D7F5-57EC-87DA-1DB460D64046,"iPhone13,2"
com.google.chrome.ios,19,1730350661,1730350680,1730350681.270333,-18000,EB445137-D7F5-57EC-87DA-1DB460D64046,"iPhone13,2"
com.apple.journal,501,1730350160,1730350661,1730350661.166163,-18000,EB445137-D7F5-57EC-87DA-1DB460D64046,"iPhone13,2"
com.apple.finder,1,1730349906,1730349907,1730349907.9391608,-18000,,
com.microsoft.VSCode,0,1730349906,1730349906,1730349906.957866,-18000,,
com.google.Chrome,1451,1730348455,1730349906,1730349906.545984,-18000,,
com.google.Chrome,375,1730347868,1730348243,1730348243.226266,-18000,,
com.google.Chrome,843,1730346986,1730347829,1730347829.5959249,-18000,,
com.google.Chrome,300,1730346574,1730346874,1730346874.211666,-18000,,
com.google.Chrome,1820,1730344676,1730346496,1730346496.521679,-18000,,
com.google.Chrome,436,1730343974,1730344410,1730344410.4265652,-18000,,
com.google.Chrome,807,1730342725,1730343532,1730343532.755703,-18000,,
com.apple.MobileSMS,4,1730342721,1730342725,1730342725.4897208,-18000,,
com.google.Chrome,5,1730342716,1730342721,1730342721.877944,-18000,,
com.google.Chrome,877,1730341833,1730342710,1730342710.405087,-18000,,
com.apple.finder,4,1730341829,1730341833,1730341835.085524,-18000,,
com.apple.finder,2,1730341170,1730341172,1730341172.693219,-18000,,
com.apple.Photos,10,1730341160,1730341170,1730341170.557827,-18000,,
com.apple.MobileSMS,36,1730341124,1730341160,1730341160.324183,-18000,,
com.google.Chrome,4,1730341120,1730341124,1730341125.0195708,-18000,,
com.microsoft.VSCode,286,1730340834,1730341120,1730341120.894133,-18000,,
com.google.Chrome,29,1730340805,1730340834,1730340834.1106992,-18000,,
com.thestorygraph.thestorygraph,90,1730340696,1730340786,1730340786.9502978,-18000,EB445137-D7F5-57EC-87DA-1DB460D64046,"iPhone13,2"
com.google.ios.youtube,2482,1730336572,1730339054,1730339054.464253,-18000,EB445137-D7F5-57EC-87DA-1DB460D64046,"iPhone13,2"
com.apple.camera,1,1730336549,1730336550,1730336550.5405068,-18000,EB445137-D7F5-57EC-87DA-1DB460D64046,"iPhone13,2"
com.google.Chrome,371,1730336478,1730336849,1730336849.4251962,-18000,,
com.leomehlig.today,113,1730336365,1730336478,1730336478.602535,-18000,,
com.microsoft.VSCode,16,1730336349,1730336365,1730336365.220304,-18000,,
com.apple.MobileSMS,19,1730336330,1730336349,1730336349.359482,-18000,,
com.microsoft.VSCode,16,1730336314,1730336330,1730336330.313546,-18000,,
com.apple.MobileSMS,18,1730336296,1730336314,1730336314.6934872,-18000,,
com.microsoft.VSCode,10,1730336286,1730336296,1730336296.627651,-18000,,
com.apple.MobileSMS,24,1730336262,1730336286,1730336286.1250238,-18000,,
com.microsoft.VSCode,73,1730336189,1730336262,1730336262.437532,-18000,,
com.apple.MobileSMS,28,1730336161,1730336189,1730336189.9785361,-18000,,
com.microsoft.VSCode,305,1730335856,1730336161,1730336161.211053,-18000,,
com.google.Chrome,392,1730335464,1730335856,1730335856.9161038,-18000,,
com.apple.finder,6,1730335458,1730335464,1730335464.522246,-18000,,
com.apple.camera,74,1730335441,1730335515,1730335515.748919,-18000,EB445137-D7F5-57EC-87DA-1DB460D64046,"iPhone13,2"
com.google.Chrome,125,1730335333,1730335458,1730335458.560355,-18000,,
com.microsoft.VSCode,1,1730335332,1730335333,1730335333.9519238,-18000,,
com.google.Chrome,9,1730335323,1730335332,1730335332.847991,-18000,,
com.microsoft.VSCode,50,1730335273,1730335323,1730335323.943094,-18000,,
com.google.Chrome,12,1730335261,1730335273,1730335273.91132,-18000,,
com.microsoft.VSCode,19,1730335242,1730335261,1730335261.614459,-18000,,
com.google.Chrome,744,1730334498,1730335242,1730335242.388946,-18000,,
com.apple.finder,13,1730334485,1730334498,1730334498.96347,-18000,,
com.apple.camera,98,1730334446,1730334544,1730334544.710454,-18000,EB445137-D7F5-57EC-87DA-1DB460D64046,"iPhone13,2"
com.apple.weather,10,1730334444,1730334454,1730334454.750375,-18000,EB445137-D7F5-57EC-87DA-1DB460D64046,"iPhone13,2"
com.google.Chrome,93,1730334392,1730334485,1730334485.907785,-18000,,
com.apple.weather,14,1730334292,1730334306,1730334306.96461,-18000,EB445137-D7F5-57EC-87DA-1DB460D64046,"iPhone13,2"
com.clairmail.fth.client,22,1730334143,1730334165,1730334165.7021132,-18000,EB445137-D7F5-57EC-87DA-1DB460D64046,"iPhone13,2"
com.leomehlig.today,305,1730334075,1730334380,1730334381.0714478,-18000,,
com.google.Chrome,1412,1730332663,1730334075,1730334075.097297,-18000,,
com.apple.MobileSMS,150,1730332513,1730332663,1730332663.3734078,-18000,,
com.google.Chrome,1,1730332512,1730332513,1730332513.202777,-18000,,
com.apple.MobileSMS,134,1730332378,1730332512,1730332512.489891,-18000,,
com.google.Chrome,142,1730332236,1730332378,1730332378.885232,-18000,,
com.microsoft.VSCode,281,1730331955,1730332236,1730332236.043079,-18000,,
com.clairmail.fth.client,6,1730331470,1730331476,1730331476.480727,-18000,EB445137-D7F5-57EC-87DA-1DB460D64046,"iPhone13,2"
com.clairmail.fth.client,31,1730331427,1730331458,1730331459.078455,-18000,EB445137-D7F5-57EC-87DA-1DB460D64046,"iPhone13,2"
com.google.Chrome,1293,1730330662,1730331955,1730331955.7770119,-18000,,
com.leomehlig.today,9,1730330596,1730330605,1730330606.0073562,-18000,,
com.clairmail.fth.client,31,1730330354,1730330385,1730330385.8121629,-18000,EB445137-D7F5-57EC-87DA-1DB460D64046,"iPhone13,2"
com.clairmail.fth.client,76,1730330277,1730330353,1730330353.3021,-18000,EB445137-D7F5-57EC-87DA-1DB460D64046,"iPhone13,2"
com.apple.Maps,12,1730329796,1730329808,1730329808.713619,-18000,EB445137-D7F5-57EC-87DA-1DB460D64046,"iPhone13,2"
com.apple.Music,31,1730329714,1730329745,1730329746.086125,-18000,EB445137-D7F5-57EC-87DA-1DB460D64046,"iPhone13,2"
com.apple.Health,4,1730329707,1730329711,1730329711.667258,-18000,EB445137-D7F5-57EC-87DA-1DB460D64046,"iPhone13,2"
com.apple.MobileSMS,2,1730329705,1730329707,1730329707.724945,-18000,EB445137-D7F5-57EC-87DA-1DB460D64046,"iPhone13,2"
com.apple.Health,38,1730329667,1730329705,1730329705.677644,-18000,EB445137-D7F5-57EC-87DA-1DB460D64046,"iPhone13,2"
com.apple.MobileSMS,45,1730329619,1730329664,1730329664.526949,-18000,EB445137-D7F5-57EC-87DA-1DB460D64046,"iPhone13,2"
com.amazon.Amazon,44,1730329575,1730329619,1730329619.761805,-18000,EB445137-D7F5-57EC-87DA-1DB460D64046,"iPhone13,2"
com.apple.MobileSMS,18,1730329557,1730329575,1730329575.3611631,-18000,EB445137-D7F5-57EC-87DA-1DB460D64046,"iPhone13,2"
com.clairmail.fth.client,2,1730329555,1730329557,1730329558.108317,-18000,EB445137-D7F5-57EC-87DA-1DB460D64046,"iPhone13,2"
com.clairmail.fth.client,37,1730328933,1730328970,1730328971.90892,-18000,EB445137-D7F5-57EC-87DA-1DB460D64046,"iPhone13,2"
com.apple.calculator,3,1730328930,1730328933,1730328933.419384,-18000,EB445137-D7F5-57EC-87DA-1DB460D64046,"iPhone13,2"
com.clairmail.fth.client,4,1730328926,1730328930,1730328931.057708,-18000,EB445137-D7F5-57EC-87DA-1DB460D64046,"iPhone13,2"
com.apple.calculator,1,1730328922,1730328923,1730328923.171269,-18000,EB445137-D7F5-57EC-87DA-1DB460D64046,"iPhone13,2"
com.truebill.truebillnative,7,1730328915,1730328922,1730328922.172851,-18000,EB445137-D7F5-57EC-87DA-1DB460D64046,"iPhone13,2"
com.apple.calculator,4,1730328911,1730328915,1730328915.404324,-18000,EB445137-D7F5-57EC-87DA-1DB460D64046,"iPhone13,2"
com.truebill.truebillnative,3,1730328908,1730328911,1730328911.360756,-18000,EB445137-D7F5-57EC-87DA-1DB460D64046,"iPhone13,2"
com.apple.calculator,6,1730328902,1730328908,1730328908.212992,-18000,EB445137-D7F5-57EC-87DA-1DB460D64046,"iPhone13,2"
com.truebill.truebillnative,148,1730328754,1730328902,1730328902.935437,-18000,EB445137-D7F5-57EC-87DA-1DB460D64046,"iPhone13,2"
com.apple.MobileSMS,8,1730328741,1730328749,1730328749.904512,-18000,EB445137-D7F5-57EC-87DA-1DB460D64046,"iPhone13,2"
com.apple.MobileSMS,3,1730328738,1730328741,1730328741.429525,-18000,EB445137-D7F5-57EC-87DA-1DB460D64046,"iPhone13,2"
com.apple.MobileSMS,6,1730328682,1730328688,1730328688.379524,-18000,EB445137-D7F5-57EC-87DA-1DB460D64046,"iPhone13,2"
com.apple.MobileSMS,2,1730328660,1730328662,1730328662.826182,-18000,EB445137-D7F5-57EC-87DA-1DB460D64046,"iPhone13,2"
com.leomehlig.today,20,1730328640,1730328660,1730328660.416201,-18000,EB445137-D7F5-57EC-87DA-1DB460D64046,"iPhone13,2"
com.instructure.icanvas,2,1730328635,1730328637,1730328637.476362,-18000,EB445137-D7F5-57EC-87DA-1DB460D64046,"iPhone13,2"
com.apple.MobileSMS,9,1730328616,1730328625,1730328625.876477,-18000,EB445137-D7F5-57EC-87DA-1DB460D64046,"iPhone13,2"
com.apple.MobileSMS,43,1730328548,1730328591,1730328592.055331,-18000,EB445137-D7F5-57EC-87DA-1DB460D64046,"iPhone13,2"
com.google.ios.youtube,4,1730328543,1730328547,1730328547.554081,-18000,EB445137-D7F5-57EC-87DA-1DB460D64046,"iPhone13,2"
com.google.ios.youtube,7,1730327839,1730327846,1730327846.742054,-18000,EB445137-D7F5-57EC-87DA-1DB460D64046,"iPhone13,2"
com.google.ios.youtube,606,1730327094,1730327700,1730327700.45919,-18000,EB445137-D7F5-57EC-87DA-1DB460D64046,"iPhone13,2"
com.apple.news,140,1730326954,1730327094,1730327094.8656201,-18000,EB445137-D7F5-57EC-87DA-1DB460D64046,"iPhone13,2"
com.tinyspeck.chatlyio,9,1730324287,1730324296,1730324296.3575048,-18000,EB445137-D7F5-57EC-87DA-1DB460D64046,"iPhone13,2"
com.tinyspeck.chatlyio,13,1730324274,1730324287,1730324287.165029,-18000,EB445137-D7F5-57EC-87DA-1DB460D64046,"iPhone13,2"
com.tinyspeck.chatlyio,13,1730324254,1730324267,1730324267.188655,-18000,EB445137-D7F5-57EC-87DA-1DB460D64046,"iPhone13,2"
com.leomehlig.today,5,1730324241,1730324246,1730324246.438611,-18000,,
com.google.Chrome,16,1730324225,1730324241,1730324241.431711,-18000,,
us.zoom.xos,4,1730324221,1730324225,1730324225.931283,-18000,,
com.google.Chrome,522,1730323699,1730324221,1730324221.291528,-18000,,
us.zoom.xos,1,1730323698,1730323699,1730323699.895172,-18000,,
com.google.Chrome,533,1730323165,1730323698,1730323698.603983,-18000,,
us.zoom.xos,2,1730323163,1730323165,1730323165.496778,-18000,,
com.google.Chrome,3,1730323160,1730323163,1730323163.67397,-18000,,
com.microsoft.Outlook,2,1730323158,1730323160,1730323160.80831,-18000,,
com.google.Chrome,40,1730323118,1730323158,1730323158.940686,-18000,,
com.tinyspeck.chatlyio,69,1730323086,1730323155,1730323155.94214,-18000,EB445137-D7F5-57EC-87DA-1DB460D64046,"iPhone13,2"
com.microsoft.Outlook,47,1730323071,1730323118,1730323118.976694,-18000,,
us.zoom.xos,24,1730323047,1730323071,1730323071.864129,-18000,,
com.apple.iCal,57,1730322990,1730323047,1730323047.9525418,-18000,,
com.google.Chrome,16,1730322974,1730322990,1730322990.991133,-18000,,
us.zoom.xos,72,1730322902,1730322974,1730322974.994448,-18000,,
com.microsoft.Outlook,15,1730322887,1730322902,1730322902.5875092,-18000,,
com.apple.news,54,1730322824,1730322878,1730322879.082179,-18000,EB445137-D7F5-57EC-87DA-1DB460D64046,"iPhone13,2"
us.zoom.xos,101,1730322786,1730322887,1730322887.274682,-18000,,
com.leomehlig.today,51,1730322735,1730322786,1730322786.335349,-18000,,
com.apple.iCal,15,1730322720,1730322735,1730322735.133349,-18000,,
com.leomehlig.today,43,1730322677,1730322720,1730322720.195642,-18000,,
com.apple.weather,5,1730322606,1730322611,1730322611.876158,-18000,EB445137-D7F5-57EC-87DA-1DB460D64046,"iPhone13,2"
com.toyopagroup.picaboo,10,1730322582,1730322592,1730322592.229903,-18000,EB445137-D7F5-57EC-87DA-1DB460D64046,"iPhone13,2"
com.apple.news,4,1730322578,1730322582,1730322582.527421,-18000,EB445137-D7F5-57EC-87DA-1DB460D64046,"iPhone13,2"
us.zoom.xos,155,1730322522,1730322677,1730322677.992559,-18000,,
com.google.Chrome,1,1730322521,1730322522,1730322522.642401,-18000,,
com.apple.MobileSMS,32,1730322489,1730322521,1730322521.68711,-18000,,
com.google.Chrome,1,1730322488,1730322489,1730322489.552022,-18000,,
com.microsoft.VSCode,55,1730322433,1730322488,1730322488.715979,-18000,,
com.google.Chrome,2,1730322431,1730322433,1730322433.090585,-18000,,
us.zoom.xos,4,1730322427,1730322431,1730322431.444881,-18000,,
com.microsoft.VSCode,80,1730322347,1730322427,1730322427.855438,-18000,,
com.apple.MobileSMS,11,1730322336,1730322347,1730322347.7959518,-18000,,
com.microsoft.VSCode,37,1730322299,1730322336,1730322336.44446,-18000,,
us.zoom.xos,30,1730322269,1730322299,1730322299.9988608,-18000,,
com.microsoft.VSCode,12,1730322257,1730322269,1730322269.4917378,-18000,,
com.apple.MobileSMS,9,1730322248,1730322257,1730322257.4971008,-18000,,
com.microsoft.VSCode,206,1730322042,1730322248,1730322248.623406,-18000,,
com.google.Chrome,3,1730322039,1730322042,1730322042.3480911,-18000,,
us.zoom.xos,10,1730322029,1730322039,1730322039.0709062,-18000,,
com.google.Chrome,15,1730322014,1730322029,1730322029.3949409,-18000,,
com.microsoft.VSCode,239,1730321760,1730321999,1730321999.164394,-18000,,
com.google.Chrome,32,1730321728,1730321760,1730321760.8009272,-18000,,
com.microsoft.VSCode,207,1730321521,1730321728,1730321728.102464,-18000,,
com.apple.Dictionary,2,1730321519,1730321521,1730321521.065232,-18000,,
com.microsoft.VSCode,12,1730321507,1730321519,1730321519.464058,-18000,,
com.apple.Dictionary,3,1730321504,1730321507,1730321507.0622602,-18000,,
com.microsoft.VSCode,109,1730321395,1730321504,1730321504.953588,-18000,,
com.apple.MobileSMS,11,1730321384,1730321395,1730321396.0549212,-18000,,
com.microsoft.VSCode,208,1730321176,1730321384,1730321384.1109529,-18000,,
com.google.Chrome,32,1730321144,1730321176,1730321176.0657248,-18000,,
com.apple.news,82,1730320873,1730320955,1730320956.469576,-18000,EB445137-D7F5-57EC-87DA-1DB460D64046,"iPhone13,2"
com.google.chrome.ios,126,1730320743,1730320869,1730320869.368091,-18000,EB445137-D7F5-57EC-87DA-1DB460D64046,"iPhone13,2"
com.apple.MobileSMS,2,1730320740,1730320742,1730320743.016547,-18000,EB445137-D7F5-57EC-87DA-1DB460D64046,"iPhone13,2"
com.apple.MobileSMS,8,1730320207,1730320215,1730320215.943435,-18000,EB445137-D7F5-57EC-87DA-1DB460D64046,"iPhone13,2"
com.apple.MobileSMS,6,1730320124,1730320130,1730320130.681365,-18000,EB445137-D7F5-57EC-87DA-1DB460D64046,"iPhone13,2"
com.apple.MobileSMS,65,1730320027,1730320092,1730320093.1279922,-18000,EB445137-D7F5-57EC-87DA-1DB460D64046,"iPhone13,2"
com.toyopagroup.picaboo,19,1730319982,1730320001,1730320001.606044,-18000,EB445137-D7F5-57EC-87DA-1DB460D64046,"iPhone13,2"
com.apple.MobileSMS,41,1730319941,1730319982,1730319983.04287,-18000,EB445137-D7F5-57EC-87DA-1DB460D64046,"iPhone13,2"
com.apple.MobileSMS,10,1730319929,1730319939,1730319939.923205,-18000,EB445137-D7F5-57EC-87DA-1DB460D64046,"iPhone13,2"
com.microsoft.Office.Outlook,5,1730319924,1730319929,1730319930.167867,-18000,EB445137-D7F5-57EC-87DA-1DB460D64046,"iPhone13,2"
com.google.Chrome,112,1730319720,1730319832,1730319832.894433,-18000,,
com.apple.calculator,10,1730319710,1730319720,1730319720.228804,-18000,,
com.google.Chrome,1,1730319709,1730319710,1730319710.714579,-18000,,
com.apple.calculator,3,1730319706,1730319709,1730319709.725697,-18000,,
com.google.Chrome,4,1730319702,1730319706,1730319706.217447,-18000,,
com.apple.calculator,12,1730319690,1730319702,1730319702.710356,-18000,,
com.google.Chrome,1,1730319689,1730319690,1730319691.012577,-18000,,
com.apple.calculator,1,1730319688,1730319689,1730319689.780549,-18000,,
com.google.Chrome,3,1730319685,1730319688,1730319688.720899,-18000,,
com.apple.calculator,11,1730319674,1730319685,1730319685.4235501,-18000,,
com.google.Chrome,52,1730319622,1730319674,1730319674.6434422,-18000,,
com.google.Chrome,307,1730318985,1730319292,1730319292.416363,-18000,,
com.google.Chrome,307,1730318395,1730318702,1730318702.930748,-18000,,
com.google.Chrome,305,1730317307,1730317612,1730317612.968786,-18000,,
com.google.Chrome,329,1730316215,1730316544,1730316544.707745,-18000,,
com.apple.Passwords,29,1730316186,1730316215,1730316216.254754,-18000,,
com.leomehlig.today,6,1730316180,1730316186,1730316187.6339068,-18000,,
com.microsoft.Office.Outlook,2,1730314770,1730314772,1730314772.475946,-18000,EB445137-D7F5-57EC-87DA-1DB460D64046,"iPhone13,2"
com.microsoft.Office.Outlook,26,1730314743,1730314769,1730314769.636076,-18000,EB445137-D7F5-57EC-87DA-1DB460D64046,"iPhone13,2"
com.apple.news,125,1730312953,1730313078,1730313079.208147,-18000,EB445137-D7F5-57EC-87DA-1DB460D64046,"iPhone13,2"
com.instructure.icanvas,2,1730312941,1730312943,1730312943.420356,-18000,EB445137-D7F5-57EC-87DA-1DB460D64046,"iPhone13,2"
com.instructure.icanvas,7,1730312934,1730312941,1730312941.307518,-18000,EB445137-D7F5-57EC-87DA-1DB460D64046,"iPhone13,2"
com.instructure.icanvas,22,1730311346,1730311368,1730311369.785935,-18000,EB445137-D7F5-57EC-87DA-1DB460D64046,"iPhone13,2"
com.hammerandchisel.discord,14,1730311332,1730311346,1730311346.379786,-18000,EB445137-D7F5-57EC-87DA-1DB460D64046,"iPhone13,2"
com.apple.news,2,1730310980,1730310982,1730310982.2307482,-18000,EB445137-D7F5-57EC-87DA-1DB460D64046,"iPhone13,2"
com.google.chrome.ios,248,1730310731,1730310979,1730310980.148417,-18000,EB445137-D7F5-57EC-87DA-1DB460D64046,"iPhone13,2"
com.apple.weather,59,1730310609,1730310668,1730310668.555974,-18000,EB445137-D7F5-57EC-87DA-1DB460D64046,"iPhone13,2"
com.google.ios.youtube,1247,1730308294,1730309541,1730309542.136673,-18000,EB445137-D7F5-57EC-87DA-1DB460D64046,"iPhone13,2"
com.leomehlig.today,37,1730308243,1730308280,1730308280.6218781,-18000,,
com.google.Chrome,135,1730308108,1730308243,1730308243.211886,-18000,,
com.leomehlig.today,94,1730308014,1730308108,1730308108.309603,-18000,,
com.google.Chrome,1680,1730306334,1730308014,1730308014.8699632,-18000,,
com.google.ios.youtube,741,1730305376,1730306117,1730306118.410263,-18000,EB445137-D7F5-57EC-87DA-1DB460D64046,"iPhone13,2"
com.apple.news,2,1730305369,1730305371,1730305371.7256079,-18000,EB445137-D7F5-57EC-87DA-1DB460D64046,"iPhone13,2"
com.toyopagroup.picaboo,41,1730305293,1730305334,1730305335.419198,-18000,EB445137-D7F5-57EC-87DA-1DB460D64046,"iPhone13,2"
com.google.chrome.ios,7,1730305286,1730305293,1730305293.4704142,-18000,EB445137-D7F5-57EC-87DA-1DB460D64046,"iPhone13,2"
com.google.Chrome,1469,1730300711,1730302180,1730302180.667155,-18000,,
com.google.chrome.ios,6,1730299479,1730299485,1730299485.346817,-18000,EB445137-D7F5-57EC-87DA-1DB460D64046,"iPhone13,2"
com.google.chrome.ios,170,1730299122,1730299292,1730299294.1368442,-18000,EB445137-D7F5-57EC-87DA-1DB460D64046,"iPhone13,2"
com.apple.news,37,1730298809,1730298846,1730298847.100738,-18000,EB445137-D7F5-57EC-87DA-1DB460D64046,"iPhone13,2"
com.hammerandchisel.discord,19,1730298785,1730298804,1730298804.450252,-18000,EB445137-D7F5-57EC-87DA-1DB460D64046,"iPhone13,2"
com.apple.Health,59,1730298724,1730298783,1730298783.772152,-18000,EB445137-D7F5-57EC-87DA-1DB460D64046,"iPhone13,2"
com.google.Chrome,247,1730298658,1730298905,1730298905.431974,-18000,,
com.leomehlig.today,57,1730298601,1730298658,1730298658.943019,-18000,,
com.google.Chrome,789,1730297812,1730298601,1730298601.429915,-18000,,
com.leomehlig.today,2,1730297810,1730297812,1730297812.080059,-18000,,
com.google.Chrome,20,1730297790,1730297810,1730297810.788886,-18000,,
com.leomehlig.today,25,1730297765,1730297790,1730297790.182181,-18000,,
com.apple.finder,14,1730297751,1730297765,1730297765.2543778,-18000,,
com.google.Chrome,4,1730297747,1730297751,1730297751.60286,-18000,,
com.apple.weather,4,1730297716,1730297720,1730297721.153619,-18000,EB445137-D7F5-57EC-87DA-1DB460D64046,"iPhone13,2"
com.apple.news,949,1730296758,1730297707,1730297708.0894852,-18000,EB445137-D7F5-57EC-87DA-1DB460D64046,"iPhone13,2"
com.microsoft.Office.Outlook,4,1730296745,1730296749,1730296749.6739511,-18000,EB445137-D7F5-57EC-87DA-1DB460D64046,"iPhone13,2"
com.microsoft.Office.Outlook,39,1730296691,1730296730,1730296730.87672,-18000,EB445137-D7F5-57EC-87DA-1DB460D64046,"iPhone13,2"
com.renpho.health,18,1730296673,1730296691,1730296691.9909601,-18000,EB445137-D7F5-57EC-87DA-1DB460D64046,"iPhone13,2"
com.renpho.health,18,1730295961,1730295979,1730295981.133191,-18000,EB445137-D7F5-57EC-87DA-1DB460D64046,"iPhone13,2"
com.apple.mobiletimer,7,1730295934,1730295941,1730295941.817138,-18000,EB445137-D7F5-57EC-87DA-1DB460D64046,"iPhone13,2"
com.apple.mobiletimer,25,1730294701,1730294726,1730294726.685906,-18000,EB445137-D7F5-57EC-87DA-1DB460D64046,"iPhone13,2"
com.apple.mobiletimer,13,1730261925,1730261938,1730261938.205243,-18000,EB445137-D7F5-57EC-87DA-1DB460D64046,"iPhone13,2"
com.apple.mobiletimer,10,1730261892,1730261902,1730261902.35387,-18000,EB445137-D7F5-57EC-87DA-1DB460D64046,"iPhone13,2"
com.apple.mobilecal,47,1730261494,1730261541,1730261541.863436,-18000,EB445137-D7F5-57EC-87DA-1DB460D64046,"iPhone13,2"
com.instructure.icanvas,12,1730261477,1730261489,1730261489.497106,-18000,EB445137-D7F5-57EC-87DA-1DB460D64046,"iPhone13,2"
com.apple.MobileSMS,27,1730261440,1730261467,1730261467.1584492,-18000,EB445137-D7F5-57EC-87DA-1DB460D64046,"iPhone13,2"
com.google.Chrome,102,1730261244,1730261346,1730261346.326349,-18000,,
com.microsoft.Office.Outlook,11,1730261081,1730261092,1730261092.5009851,-18000,EB445137-D7F5-57EC-87DA-1DB460D64046,"iPhone13,2"
com.google.Chrome,732,1730260452,1730261184,1730261185.016602,-18000,,
com.google.Chrome,403,1730259607,1730260010,1730260010.433991,-18000,,
com.google.Chrome,721,1730257966,1730258687,1730258687.4055018,-18000,,
com.instructure.icanvas,30,1730257813,1730257843,1730257843.16367,-18000,EB445137-D7F5-57EC-87DA-1DB460D64046,"iPhone13,2"
com.google.Chrome,741,1730256358,1730257099,1730257099.310065,-18000,,
com.google.Chrome,561,1730255758,1730256319,1730256319.914013,-18000,,
com.google.Chrome,1347,1730254331,1730255678,1730255678.223851,-18000,,
com.leomehlig.today,50,1730254281,1730254331,1730254331.422281,-18000,,
com.google.ios.youtube,1064,1730252837,1730253901,1730253902.7695541,-18000,EB445137-D7F5-57EC-87DA-1DB460D64046,"iPhone13,2"
com.google.chrome.ios,61,1730252776,1730252837,1730252838.113988,-18000,EB445137-D7F5-57EC-87DA-1DB460D64046,"iPhone13,2"
com.google.ios.youtube,2221,1730250554,1730252775,1730252775.897736,-18000,EB445137-D7F5-57EC-87DA-1DB460D64046,"iPhone13,2"
com.apple.camera,0,1730250538,1730250538,1730250538.778229,-18000,EB445137-D7F5-57EC-87DA-1DB460D64046,"iPhone13,2"
com.leomehlig.today,340,1730249781,1730250121,1730250121.385243,-18000,,
com.google.Chrome,2818,1730246963,1730249781,1730249781.4932718,-18000,,
com.leomehlig.today,30,1730246613,1730246643,1730246643.664228,-18000,,
com.google.Chrome,239,1730246374,1730246613,1730246613.9440432,-18000,,
com.apple.finder,3,1730246355,1730246358,1730246358.563221,-18000,,
com.leomehlig.today,3,1730246352,1730246355,1730246355.352706,-18000,,
com.google.Chrome,8,1730246344,1730246352,1730246352.9814239,-18000,,
com.leomehlig.today,1,1730246343,1730246344,1730246344.850257,-18000,,
com.apple.AppStore,10,1730244176,1730244186,1730244187.115166,-18000,EB445137-D7F5-57EC-87DA-1DB460D64046,"iPhone13,2"
com.hammerandchisel.discord,110,1730244062,1730244172,1730244172.929411,-18000,EB445137-D7F5-57EC-87DA-1DB460D64046,"iPhone13,2"
com.apple.MobileSMS,6,1730244056,1730244062,1730244062.973675,-18000,EB445137-D7F5-57EC-87DA-1DB460D64046,"iPhone13,2"
com.google.chrome.ios,30,1730244026,1730244056,1730244057.030566,-18000,EB445137-D7F5-57EC-87DA-1DB460D64046,"iPhone13,2"
com.apple.MobileSMS,2,1730244024,1730244026,1730244026.4161448,-18000,EB445137-D7F5-57EC-87DA-1DB460D64046,"iPhone13,2"
com.hammerandchisel.discord,56,1730243968,1730244024,1730244025.58708,-18000,EB445137-D7F5-57EC-87DA-1DB460D64046,"iPhone13,2"
com.google.chrome.ios,40,1730243928,1730243968,1730243968.3366299,-18000,EB445137-D7F5-57EC-87DA-1DB460D64046,"iPhone13,2"
com.hammerandchisel.discord,43,1730243885,1730243928,1730243929.135841,-18000,EB445137-D7F5-57EC-87DA-1DB460D64046,"iPhone13,2"
com.google.chrome.ios,15,1730243870,1730243885,1730243886.160583,-18000,EB445137-D7F5-57EC-87DA-1DB460D64046,"iPhone13,2"
com.apple.MobileSMS,1,1730243869,1730243870,1730243870.4032311,-18000,EB445137-D7F5-57EC-87DA-1DB460D64046,"iPhone13,2"
com.hammerandchisel.discord,2,1730243866,1730243868,1730243869.165337,-18000,EB445137-D7F5-57EC-87DA-1DB460D64046,"iPhone13,2"
com.google.chrome.ios,11,1730243855,1730243866,1730243866.231545,-18000,EB445137-D7F5-57EC-87DA-1DB460D64046,"iPhone13,2"
com.hammerandchisel.discord,10,1730243845,1730243855,1730243856.084694,-18000,EB445137-D7F5-57EC-87DA-1DB460D64046,"iPhone13,2"
com.google.chrome.ios,109,1730243735,1730243844,1730243845.289067,-18000,EB445137-D7F5-57EC-87DA-1DB460D64046,"iPhone13,2"
com.apple.MobileSMS,22,1730243713,1730243735,1730243735.99929,-18000,EB445137-D7F5-57EC-87DA-1DB460D64046,"iPhone13,2"
com.google.chrome.ios,25,1730243688,1730243713,1730243713.523694,-18000,EB445137-D7F5-57EC-87DA-1DB460D64046,"iPhone13,2"
com.hammerandchisel.discord,20,1730243668,1730243688,1730243689.02828,-18000,EB445137-D7F5-57EC-87DA-1DB460D64046,"iPhone13,2"
com.google.chrome.ios,69,1730243598,1730243667,1730243668.242348,-18000,EB445137-D7F5-57EC-87DA-1DB460D64046,"iPhone13,2"
com.google.chrome.ios,2,1730243596,1730243598,1730243598.493626,-18000,EB445137-D7F5-57EC-87DA-1DB460D64046,"iPhone13,2"
com.apple.MobileSMS,3,1730243593,1730243596,1730243596.4765,-18000,EB445137-D7F5-57EC-87DA-1DB460D64046,"iPhone13,2"
com.leomehlig.today,34,1730241063,1730241097,1730241097.340949,-18000,,
com.google.Chrome,128,1730240935,1730241063,1730241063.445798,-18000,,
com.apple.calculator,4,1730240931,1730240935,1730240936.007255,-18000,,
com.google.Chrome,2,1730240929,1730240931,1730240931.064214,-18000,,
com.apple.calculator,25,1730240904,1730240929,1730240929.318609,-18000,,
com.google.Chrome,2,1730240902,1730240904,1730240904.44802,-18000,,
com.apple.calculator,73,1730240829,1730240902,1730240902.624882,-18000,,
com.google.Chrome,140,1730240689,1730240829,1730240829.798662,-18000,,
com.apple.calculator,12,1730240677,1730240689,1730240689.488315,-18000,,
com.google.Chrome,1,1730240676,1730240677,1730240677.940176,-18000,,
com.apple.calculator,4,1730240672,1730240676,1730240676.2858,-18000,,
com.google.Chrome,9,1730240663,1730240672,1730240672.8414268,-18000,,
com.apple.calculator,20,1730240643,1730240663,1730240663.7550669,-18000,,
com.google.Chrome,27,1730240616,1730240643,1730240643.622137,-18000,,
com.apple.finder,8,1730240608,1730240616,1730240616.189168,-18000,,
com.google.Chrome,218,1730240390,1730240608,1730240608.434682,-18000,,
com.apple.MobileSMS,10,1730239709,1730239719,1730239719.476717,-18000,EB445137-D7F5-57EC-87DA-1DB460D64046,"iPhone13,2"
com.apple.MobileSMS,5,1730239690,1730239695,1730239695.619739,-18000,EB445137-D7F5-57EC-87DA-1DB460D64046,"iPhone13,2"
com.google.Chrome,678,1730239678,1730240356,1730240356.073707,-18000,,
com.apple.Passwords,9,1730239669,1730239678,1730239678.257262,-18000,,
com.google.Chrome,4,1730239665,1730239669,1730239669.490341,-18000,,
com.apple.MobileSMS,10,1730239360,1730239370,1730239370.6705341,-18000,EB445137-D7F5-57EC-87DA-1DB460D64046,"iPhone13,2"
com.apple.MobileSMS,3,1730239357,1730239360,1730239360.60494,-18000,EB445137-D7F5-57EC-87DA-1DB460D64046,"iPhone13,2"
com.toyopagroup.picaboo,11,1730239148,1730239159,1730239160.052558,-18000,EB445137-D7F5-57EC-87DA-1DB460D64046,"iPhone13,2"
com.google.Chrome,127,1730237363,1730237490,1730237490.483828,-18000,,
com.tinyspeck.chatlyio,15,1730234430,1730234445,1730234445.43899,-18000,EB445137-D7F5-57EC-87DA-1DB460D64046,"iPhone13,2"
com.apple.news,1,1730234425,1730234426,1730234427.0155458,-18000,EB445137-D7F5-57EC-87DA-1DB460D64046,"iPhone13,2"
com.google.Chrome,107,1730234017,1730234124,1730234125.029957,-18000,,
com.leomehlig.today,27,1730233977,1730234004,1730234004.324712,-18000,,
com.google.Chrome,8,1730233969,1730233977,1730233977.849952,-18000,,
com.leomehlig.today,24,1730233945,1730233969,1730233969.871122,-18000,,
com.google.Chrome,4,1730233941,1730233945,1730233945.255734,-18000,,
com.leomehlig.today,57,1730233863,1730233920,1730233920.569206,-18000,,
com.google.Chrome,3,1730233860,1730233863,1730233863.107575,-18000,,
com.apple.news,113,1730233735,1730233848,1730233848.5522819,-18000,EB445137-D7F5-57EC-87DA-1DB460D64046,"iPhone13,2"
com.apple.news,1,1730233690,1730233691,1730233691.54458,-18000,EB445137-D7F5-57EC-87DA-1DB460D64046,"iPhone13,2"
com.apple.news,1,1730233637,1730233638,1730233638.161522,-18000,EB445137-D7F5-57EC-87DA-1DB460D64046,"iPhone13,2"
com.apple.news,48,1730233585,1730233633,1730233634.16645,-18000,EB445137-D7F5-57EC-87DA-1DB460D64046,"iPhone13,2"
com.google.ios.youtube,306,1730232391,1730232697,1730232698.0128999,-18000,EB445137-D7F5-57EC-87DA-1DB460D64046,"iPhone13,2"
com.apple.MobileSMS,3,1730232316,1730232319,1730232319.1300611,-18000,EB445137-D7F5-57EC-87DA-1DB460D64046,"iPhone13,2"
com.apple.MobileSMS,18,1730232221,1730232239,1730232240.021399,-18000,EB445137-D7F5-57EC-87DA-1DB460D64046,"iPhone13,2"
com.apple.MobileSMS,21,1730230675,1730230696,1730230696.659554,-18000,EB445137-D7F5-57EC-87DA-1DB460D64046,"iPhone13,2"
com.apple.MobileSMS,6,1730230587,1730230593,1730230593.388932,-18000,EB445137-D7F5-57EC-87DA-1DB460D64046,"iPhone13,2"
com.apple.Music,3,1730230584,1730230587,1730230588.7092419,-18000,EB445137-D7F5-57EC-87DA-1DB460D64046,"iPhone13,2"
com.apple.Music,6,1730230573,1730230579,1730230579.372271,-18000,EB445137-D7F5-57EC-87DA-1DB460D64046,"iPhone13,2"
com.apple.Music,11,1730230032,1730230043,1730230043.4487739,-18000,EB445137-D7F5-57EC-87DA-1DB460D64046,"iPhone13,2"
com.apple.camera,1,1730229654,1730229655,1730229655.167779,-18000,EB445137-D7F5-57EC-87DA-1DB460D64046,"iPhone13,2"
com.apple.Music,8,1730229653,1730229661,1730229661.4644961,-18000,EB445137-D7F5-57EC-87DA-1DB460D64046,"iPhone13,2"
com.apple.Music,9,1730229229,1730229238,1730229238.397121,-18000,EB445137-D7F5-57EC-87DA-1DB460D64046,"iPhone13,2"
com.apple.Music,3,1730228903,1730228906,1730228906.772011,-18000,EB445137-D7F5-57EC-87DA-1DB460D64046,"iPhone13,2"
com.apple.Music,10,1730228891,1730228901,1730228902.20406,-18000,EB445137-D7F5-57EC-87DA-1DB460D64046,"iPhone13,2"
Astrospheric.Astrospheric,11,1730228871,1730228882,1730228883.043014,-18000,EB445137-D7F5-57EC-87DA-1DB460D64046,"iPhone13,2"
com.google.ios.youtube,3,1730228867,1730228870,1730228871.19468,-18000,EB445137-D7F5-57EC-87DA-1DB460D64046,"iPhone13,2"
com.google.ios.youtube,4,1730228852,1730228856,1730228856.529141,-18000,EB445137-D7F5-57EC-87DA-1DB460D64046,"iPhone13,2"
com.google.ios.youtube,315,1730227680,1730227995,1730227996.0599961,-18000,EB445137-D7F5-57EC-87DA-1DB460D64046,"iPhone13,2"
com.google.chrome.ios,31,1730227645,1730227676,1730227676.9147902,-18000,EB445137-D7F5-57EC-87DA-1DB460D64046,"iPhone13,2"
com.google.chrome.ios,19,1730227187,1730227206,1730227206.560968,-18000,EB445137-D7F5-57EC-87DA-1DB460D64046,"iPhone13,2"
com.apple.Health,10,1730225975,1730225985,1730225985.2832952,-18000,EB445137-D7F5-57EC-87DA-1DB460D64046,"iPhone13,2"
com.apple.news,48,1730225923,1730225971,1730225971.590688,-18000,EB445137-D7F5-57EC-87DA-1DB460D64046,"iPhone13,2"
com.apple.news,117,1730225793,1730225910,1730225910.856266,-18000,EB445137-D7F5-57EC-87DA-1DB460D64046,"iPhone13,2"
com.apple.news,3,1730225785,1730225788,1730225788.9923549,-18000,EB445137-D7F5-57EC-87DA-1DB460D64046,"iPhone13,2"
com.apple.news,4,1730225776,1730225780,1730225780.888665,-18000,EB445137-D7F5-57EC-87DA-1DB460D64046,"iPhone13,2"
com.google.Chrome,274,1730225498,1730225772,1730225773.004249,-18000,,
com.apple.news,30,1730225467,1730225497,1730225497.913859,-18000,EB445137-D7F5-57EC-87DA-1DB460D64046,"iPhone13,2"
com.google.Chrome,300,1730224844,1730225144,1730225144.818564,-18000,,
com.hammerandchisel.discord,628,1730224800,1730225428,1730225429.066156,-18000,EB445137-D7F5-57EC-87DA-1DB460D64046,"iPhone13,2"
com.google.Chrome,301,1730224475,1730224776,1730224776.014048,-18000,,
com.instructure.icanvas,8,1730223465,1730223473,1730223473.26012,-18000,EB445137-D7F5-57EC-87DA-1DB460D64046,"iPhone13,2"
com.apple.news,32,1730223433,1730223465,1730223465.540781,-18000,EB445137-D7F5-57EC-87DA-1DB460D64046,"iPhone13,2"
com.apple.news,10,1730223318,1730223328,1730223328.974719,-18000,EB445137-D7F5-57EC-87DA-1DB460D64046,"iPhone13,2"
com.apple.news,6,1730223311,1730223317,1730223317.323153,-18000,EB445137-D7F5-57EC-87DA-1DB460D64046,"iPhone13,2"
com.apple.news,119,1730223189,1730223308,1730223308.977782,-18000,EB445137-D7F5-57EC-87DA-1DB460D64046,"iPhone13,2"
com.apple.news,70,1730223102,1730223172,1730223172.501493,-18000,EB445137-D7F5-57EC-87DA-1DB460D64046,"iPhone13,2"
com.apple.news,201,1730222762,1730222963,1730222964.0035748,-18000,EB445137-D7F5-57EC-87DA-1DB460D64046,"iPhone13,2"
com.apple.news,169,1730222501,1730222670,1730222670.559289,-18000,EB445137-D7F5-57EC-87DA-1DB460D64046,"iPhone13,2"
com.hammerandchisel.discord,23,1730222465,1730222488,1730222488.353074,-18000,EB445137-D7F5-57EC-87DA-1DB460D64046,"iPhone13,2"
com.apple.MobileSMS,5,1730222432,1730222437,1730222437.6219811,-18000,EB445137-D7F5-57EC-87DA-1DB460D64046,"iPhone13,2"
com.microsoft.Office.Outlook,10,1730222062,1730222072,1730222072.835588,-18000,EB445137-D7F5-57EC-87DA-1DB460D64046,"iPhone13,2"
com.apple.MobileSMS,5,1730222057,1730222062,1730222062.364242,-18000,EB445137-D7F5-57EC-87DA-1DB460D64046,"iPhone13,2"
com.google.Chrome,2113,1730221790,1730223903,1730223903.513201,-18000,,
com.apple.MobileSMS,6,1730221230,1730221236,1730221236.789187,-18000,EB445137-D7F5-57EC-87DA-1DB460D64046,"iPhone13,2"
com.apple.MobileSMS,6,1730221224,1730221230,1730221230.383704,-18000,EB445137-D7F5-57EC-87DA-1DB460D64046,"iPhone13,2"
com.apple.MobileSMS,1,1730220451,1730220452,1730220453.1452188,-18000,EB445137-D7F5-57EC-87DA-1DB460D64046,"iPhone13,2"
com.apple.MobileSMS,5,1730220279,1730220284,1730220284.215733,-18000,EB445137-D7F5-57EC-87DA-1DB460D64046,"iPhone13,2"
com.apple.MobileSMS,4,1730220238,1730220242,1730220242.95539,-18000,EB445137-D7F5-57EC-87DA-1DB460D64046,"iPhone13,2"
com.google.Chrome,1055,1730219153,1730220208,1730220208.201336,-18000,,
com.apple.MobileSMS,58,1730219095,1730219153,1730219153.883154,-18000,,
com.google.Chrome,442,1730218653,1730219095,1730219095.338162,-18000,,
com.apple.Passwords,3,1730218647,1730218650,1730218650.777828,-18000,,
com.google.Chrome,418,1730218229,1730218647,1730218647.7847729,-18000,,
com.apple.MobileSMS,4,1730217926,1730217930,1730217930.355686,-18000,,
com.google.Chrome,15,1730217911,1730217926,1730217926.4663801,-18000,,
com.apple.MobileSMS,4,1730217907,1730217911,1730217911.87608,-18000,,
com.apple.MobileSMS,27,1730217843,1730217870,1730217871.368061,-18000,EB445137-D7F5-57EC-87DA-1DB460D64046,"iPhone13,2"
com.apple.mobilecal,7,1730217836,1730217843,1730217843.7378001,-18000,EB445137-D7F5-57EC-87DA-1DB460D64046,"iPhone13,2"
com.apple.MobileSMS,8,1730217824,1730217832,1730217832.434785,-18000,EB445137-D7F5-57EC-87DA-1DB460D64046,"iPhone13,2"
com.google.Chrome,215,1730217692,1730217907,1730217907.5863209,-18000,,
com.microsoft.VSCode,209,1730217483,1730217692,1730217692.778213,-18000,,
com.google.Chrome,94,1730217389,1730217483,1730217483.335463,-18000,,
com.apple.MobileSMS,3,1730217310,1730217313,1730217313.1122851,-18000,EB445137-D7F5-57EC-87DA-1DB460D64046,"iPhone13,2"
com.apple.mobilecal,2,1730217308,1730217310,1730217310.691788,-18000,EB445137-D7F5-57EC-87DA-1DB460D64046,"iPhone13,2"
com.apple.MobileSMS,35,1730217273,1730217308,1730217308.497335,-18000,EB445137-D7F5-57EC-87DA-1DB460D64046,"iPhone13,2"
com.apple.mobilecal,14,1730217259,1730217273,1730217273.299395,-18000,EB445137-D7F5-57EC-87DA-1DB460D64046,"iPhone13,2"
com.apple.MobileSMS,2,1730217256,1730217258,1730217258.366373,-18000,EB445137-D7F5-57EC-87DA-1DB460D64046,"iPhone13,2"
com.apple.MobileSMS,13,1730217236,1730217249,1730217249.569265,-18000,EB445137-D7F5-57EC-87DA-1DB460D64046,"iPhone13,2"
com.apple.MobileSMS,21,1730217162,1730217183,1730217183.179021,-18000,EB445137-D7F5-57EC-87DA-1DB460D64046,"iPhone13,2"
com.apple.MobileSMS,1,1730217120,1730217121,1730217121.5864968,-18000,EB445137-D7F5-57EC-87DA-1DB460D64046,"iPhone13,2"
com.apple.MobileSMS,1,1730217114,1730217115,1730217116.306591,-18000,EB445137-D7F5-57EC-87DA-1DB460D64046,"iPhone13,2"
com.apple.MobileSMS,53,1730216955,1730217008,1730217009.153386,-18000,EB445137-D7F5-57EC-87DA-1DB460D64046,"iPhone13,2"
com.apple.weather,2,1730216953,1730216955,1730216955.75428,-18000,EB445137-D7F5-57EC-87DA-1DB460D64046,"iPhone13,2"
com.google.Chrome,30,1730216683,1730216713,1730216713.657721,-18000,,
com.apple.Preview,8,1730216675,1730216683,1730216683.28547,-18000,,
com.microsoft.VSCode,137,1730216538,1730216675,1730216675.349474,-18000,,
com.google.Chrome,17,1730216521,1730216538,1730216538.7282639,-18000,,
com.microsoft.VSCode,4,1730216517,1730216521,1730216521.809206,-18000,,
com.google.Chrome,21,1730216496,1730216517,1730216517.440408,-18000,,
com.microsoft.VSCode,1,1730216495,1730216496,1730216496.080185,-18000,,
com.google.Chrome,2,1730216493,1730216495,1730216495.148199,-18000,,
com.microsoft.VSCode,266,1730216227,1730216493,1730216493.625286,-18000,,
com.google.Chrome,10,1730216217,1730216227,1730216227.079473,-18000,,
com.microsoft.VSCode,1,1730216216,1730216217,1730216217.845134,-18000,,
com.apple.finder,0,1730216216,1730216216,1730216216.401607,-18000,,
com.microsoft.VSCode,950,1730215266,1730216216,1730216216.058066,-18000,,
com.apple.finder,13,1730215253,1730215266,1730215266.44699,-18000,,
com.apple.archiveutility,0,1730215253,1730215253,1730215254.241044,-18000,,
com.apple.finder,22,1730215231,1730215253,1730215253.4688869,-18000,,
com.google.Chrome,23,1730215208,1730215231,1730215231.508071,-18000,,
com.microsoft.VSCode,462,1730214746,1730215208,1730215208.118672,-18000,,
com.google.Chrome,8,1730214738,1730214746,1730214746.711005,-18000,,
com.microsoft.VSCode,721,1730214017,1730214738,1730214738.873626,-18000,,
com.google.Chrome,9,1730214008,1730214017,1730214017.306497,-18000,,
com.microsoft.VSCode,201,1730213807,1730214008,1730214008.558017,-18000,,
com.google.Chrome,6,1730213801,1730213807,1730213807.111174,-18000,,
com.microsoft.VSCode,33,1730213768,1730213801,1730213801.262817,-18000,,
com.google.Chrome,5,1730213763,1730213768,1730213768.846366,-18000,,
com.microsoft.VSCode,27,1730213736,1730213763,1730213763.290165,-18000,,
com.google.Chrome,45,1730213691,1730213736,1730213736.932204,-18000,,
com.microsoft.VSCode,3,1730213688,1730213691,1730213691.256318,-18000,,
com.google.Chrome,2,1730213686,1730213688,1730213688.393707,-18000,,
com.microsoft.VSCode,5,1730213681,1730213686,1730213686.44768,-18000,,
com.google.Chrome,4,1730213677,1730213681,1730213681.214303,-18000,,
com.microsoft.VSCode,7,1730213670,1730213677,1730213677.4875321,-18000,,
com.google.Chrome,49,1730213621,1730213670,1730213670.921455,-18000,,
com.microsoft.VSCode,87,1730213534,1730213621,1730213621.410908,-18000,,
com.google.Chrome,19,1730213515,1730213534,1730213534.722817,-18000,,
com.microsoft.VSCode,14,1730213501,1730213515,1730213516.03996,-18000,,
com.google.Chrome,1,1730213500,1730213501,1730213501.142129,-18000,,
com.microsoft.VSCode,51,1730213449,1730213500,1730213500.2178211,-18000,,
com.google.Chrome,1,1730213448,1730213449,1730213449.875329,-18000,,
com.microsoft.VSCode,4,1730213444,1730213448,1730213449.005155,-18000,,
com.google.Chrome,2,1730213442,1730213444,1730213444.10901,-18000,,
com.microsoft.VSCode,5,1730213437,1730213442,1730213442.294647,-18000,,
com.google.Chrome,2,1730213435,1730213437,1730213437.7350168,-18000,,
com.microsoft.VSCode,1,1730213434,1730213435,1730213435.811609,-18000,,
com.google.Chrome,1,1730213433,1730213434,1730213434.469174,-18000,,
com.microsoft.VSCode,2,1730213431,1730213433,1730213433.946161,-18000,,
com.google.Chrome,1,1730213430,1730213431,1730213431.764104,-18000,,
com.microsoft.VSCode,1,1730213429,1730213430,1730213430.7717462,-18000,,
com.google.Chrome,2,1730213427,1730213429,1730213429.209789,-18000,,
com.microsoft.VSCode,20,1730213407,1730213427,1730213427.585517,-18000,,
com.google.Chrome,98,1730213309,1730213407,1730213407.2594352,-18000,,
com.microsoft.VSCode,62,1730213247,1730213309,1730213309.697531,-18000,,
com.google.Chrome,1,1730213246,1730213247,1730213247.438682,-18000,,
com.microsoft.VSCode,8,1730213238,1730213246,1730213246.163848,-18000,,
com.google.Chrome,19,1730213219,1730213238,1730213238.1817,-18000,,
com.microsoft.VSCode,270,1730212949,1730213219,1730213220.042856,-18000,,
com.google.Chrome,6,1730212943,1730212949,1730212949.70714,-18000,,
com.microsoft.VSCode,194,1730212749,1730212943,1730212944.0338678,-18000,,
com.google.Chrome,13,1730212736,1730212749,1730212750.0159621,-18000,,
com.microsoft.VSCode,62,1730212674,1730212736,1730212736.750856,-18000,,
com.google.Chrome,33,1730212641,1730212674,1730212674.8654141,-18000,,
com.microsoft.VSCode,191,1730212450,1730212641,1730212641.1294742,-18000,,
com.apple.finder,46,1730212404,1730212450,1730212450.534646,-18000,,
com.google.Chrome,133,1730212271,1730212404,1730212404.439588,-18000,,
com.apple.weather,1,1730212203,1730212204,1730212204.9454951,-18000,EB445137-D7F5-57EC-87DA-1DB460D64046,"iPhone13,2"
com.apple.weather,2,1730211796,1730211798,1730211798.276702,-18000,EB445137-D7F5-57EC-87DA-1DB460D64046,"iPhone13,2"
com.apple.weather,14,1730211223,1730211237,1730211237.8693871,-18000,EB445137-D7F5-57EC-87DA-1DB460D64046,"iPhone13,2"
com.google.Chrome,950,1730210044,1730210994,1730210994.685909,-18000,,
com.leomehlig.today,50,1730209994,1730210044,1730210044.878732,-18000,,
com.google.Chrome,4,1730209990,1730209994,1730209994.8893762,-18000,,
com.apple.MobileSMS,69,1730209921,1730209990,1730209990.3481379,-18000,,
com.google.Chrome,21,1730209900,1730209921,1730209921.431902,-18000,,
com.apple.MobileSMS,1,1730209899,1730209900,1730209901.282903,-18000,,
com.google.Chrome,29,1730209870,1730209899,1730209899.2410889,-18000,,
com.apple.MobileSMS,45,1730209825,1730209870,1730209870.0801048,-18000,,
com.apple.finder,5,1730209820,1730209825,1730209825.751214,-18000,,
com.apple.weather,2,1730209477,1730209479,1730209479.323142,-18000,EB445137-D7F5-57EC-87DA-1DB460D64046,"iPhone13,2"
com.apple.weather,24,1730209401,1730209425,1730209426.087739,-18000,EB445137-D7F5-57EC-87DA-1DB460D64046,"iPhone13,2"
com.renpho.health,3,1730209398,1730209401,1730209401.338167,-18000,EB445137-D7F5-57EC-87DA-1DB460D64046,"iPhone13,2"
com.renpho.health,10,1730209382,1730209392,1730209392.653409,-18000,EB445137-D7F5-57EC-87DA-1DB460D64046,"iPhone13,2"
com.renpho.health,22,1730209351,1730209373,1730209374.230836,-18000,EB445137-D7F5-57EC-87DA-1DB460D64046,"iPhone13,2"
com.apple.mobiletimer,9,1730178860,1730178869,1730178869.630597,-18000,EB445137-D7F5-57EC-87DA-1DB460D64046,"iPhone13,2"
com.apple.journal,202,1730178634,1730178836,1730178836.4139361,-18000,EB445137-D7F5-57EC-87DA-1DB460D64046,"iPhone13,2"
com.apple.Health,75,1730178559,1730178634,1730178634.617197,-18000,EB445137-D7F5-57EC-87DA-1DB460D64046,"iPhone13,2"
com.apple.journal,1414,1730177140,1730178554,1730178554.27239,-18000,EB445137-D7F5-57EC-87DA-1DB460D64046,"iPhone13,2"
com.apple.camera,1,1730177038,1730177039,1730177039.122326,-18000,EB445137-D7F5-57EC-87DA-1DB460D64046,"iPhone13,2"
com.apple.finder,13,1730176775,1730176788,1730176788.811538,-18000,,
com.microsoft.VSCode,1,1730176774,1730176775,1730176775.1142259,-18000,,
com.google.Chrome,63,1730176711,1730176774,1730176774.8562799,-18000,,
com.google.Chrome,1013,1730175054,1730176067,1730176067.164175,-18000,,
com.google.Chrome,300,1730174708,1730175008,1730175008.906169,-18000,,
com.google.Chrome,521,1730173794,1730174315,1730174315.340482,-18000,,
com.google.Chrome,385,1730173400,1730173785,1730173785.4016519,-18000,,
com.google.Chrome,747,1730172419,1730173166,1730173166.5155969,-18000,,
com.google.Chrome,300,1730171794,1730172094,1730172094.830492,-18000,,
com.google.Chrome,301,1730171454,1730171755,1730171755.2260718,-18000,,
com.apple.camera,0,1730170638,1730170638,1730170638.7826838,-18000,EB445137-D7F5-57EC-87DA-1DB460D64046,"iPhone13,2"
com.google.Chrome,991,1730170168,1730171159,1730171159.7010589,-18000,,
com.truebill.truebillnative,62,1730170019,1730170081,1730170081.352964,-18000,EB445137-D7F5-57EC-87DA-1DB460D64046,"iPhone13,2"
com.google.Chrome,749,1730168744,1730169493,1730169493.124316,-18000,,
com.microsoft.VSCode,104,1730168640,1730168744,1730168744.556534,-18000,,
com.tinyspeck.chatlyio,25,1730168606,1730168631,1730168631.775488,-18000,EB445137-D7F5-57EC-87DA-1DB460D64046,"iPhone13,2"
com.tinyspeck.chatlyio,3,1730168602,1730168605,1730168605.118833,-18000,EB445137-D7F5-57EC-87DA-1DB460D64046,"iPhone13,2"
com.apple.stocks,22,1730168562,1730168584,1730168584.580319,-18000,EB445137-D7F5-57EC-87DA-1DB460D64046,"iPhone13,2"
com.microsoft.Office.Outlook,27,1730168535,1730168562,1730168563.088677,-18000,EB445137-D7F5-57EC-87DA-1DB460D64046,"iPhone13,2"
com.google.Chrome,354,1730168286,1730168640,1730168640.290759,-18000,,
com.microsoft.Office.Outlook,13,1730168251,1730168264,1730168264.581996,-18000,EB445137-D7F5-57EC-87DA-1DB460D64046,"iPhone13,2"
com.microsoft.Office.Outlook,14,1730167699,1730167713,1730167713.830934,-18000,EB445137-D7F5-57EC-87DA-1DB460D64046,"iPhone13,2"
com.google.Chrome,435,1730167531,1730167966,1730167966.4894571,-18000,,
com.google.Chrome,2411,1730164800,1730167211,1730167211.764765,-18000,,
com.leomehlig.today,24,1730164776,1730164800,1730164800.804013,-18000,,
com.microsoft.VSCode,1,1730164775,1730164776,1730164776.734356,-18000,,
com.leomehlig.today,1,1730164774,1730164775,1730164775.4070091,-18000,,
com.hnc.Discord,1,1730164773,1730164774,1730164774.5069351,-18000,,
com.leomehlig.today,3,1730164770,1730164773,1730164773.660495,-18000,,
com.hnc.Discord,19,1730164751,1730164770,1730164770.375078,-18000,,
com.microsoft.Office.Outlook,88,1730164690,1730164778,1730164778.553644,-18000,EB445137-D7F5-57EC-87DA-1DB460D64046,"iPhone13,2"
com.apple.MobileSMS,60,1730164625,1730164685,1730164685.388156,-18000,EB445137-D7F5-57EC-87DA-1DB460D64046,"iPhone13,2"
com.leomehlig.today,174,1730164577,1730164751,1730164751.997428,-18000,,
com.hnc.Discord,58,1730164519,1730164577,1730164577.448489,-18000,,
com.apple.iCal,9,1730164510,1730164519,1730164519.48731,-18000,,
com.apple.MobileSMS,5,1730164275,1730164280,1730164280.092976,-18000,EB445137-D7F5-57EC-87DA-1DB460D64046,"iPhone13,2"
com.apple.MobileSMS,26,1730163738,1730163764,1730163765.334701,-18000,EB445137-D7F5-57EC-87DA-1DB460D64046,"iPhone13,2"
com.apple.Maps,6,1730163732,1730163738,1730163743.092943,-18000,EB445137-D7F5-57EC-87DA-1DB460D64046,"iPhone13,2"
com.apple.Maps,20,1730161510,1730161530,1730161530.9459438,-18000,EB445137-D7F5-57EC-87DA-1DB460D64046,"iPhone13,2"
com.apple.Maps,1,1730160752,1730160753,1730160753.9030561,-18000,EB445137-D7F5-57EC-87DA-1DB460D64046,"iPhone13,2"
com.apple.Maps,10,1730160604,1730160614,1730160614.608974,-18000,EB445137-D7F5-57EC-87DA-1DB460D64046,"iPhone13,2"
com.apple.Maps,5,1730160598,1730160603,1730160603.405943,-18000,EB445137-D7F5-57EC-87DA-1DB460D64046,"iPhone13,2"
com.apple.Maps,5,1730160422,1730160427,1730160427.7729769,-18000,EB445137-D7F5-57EC-87DA-1DB460D64046,"iPhone13,2"
com.apple.Maps,0,1730160212,1730160212,1730160213.1170979,-18000,EB445137-D7F5-57EC-87DA-1DB460D64046,"iPhone13,2"
com.apple.Maps,4,1730160062,1730160066,1730160066.289654,-18000,EB445137-D7F5-57EC-87DA-1DB460D64046,"iPhone13,2"
com.apple.Maps,2,1730159946,1730159948,1730159948.386965,-18000,EB445137-D7F5-57EC-87DA-1DB460D64046,"iPhone13,2"
com.apple.Maps,3,1730159942,1730159945,1730159945.3557448,-18000,EB445137-D7F5-57EC-87DA-1DB460D64046,"iPhone13,2"
com.apple.Maps,19,1730159672,1730159691,1730159691.877769,-18000,EB445137-D7F5-57EC-87DA-1DB460D64046,"iPhone13,2"
com.apple.Maps,14,1730159657,1730159671,1730159671.984026,-18000,EB445137-D7F5-57EC-87DA-1DB460D64046,"iPhone13,2"
com.apple.Maps,2,1730159617,1730159619,1730159619.859904,-18000,EB445137-D7F5-57EC-87DA-1DB460D64046,"iPhone13,2"
com.apple.Maps,4,1730159476,1730159480,1730159480.270928,-18000,EB445137-D7F5-57EC-87DA-1DB460D64046,"iPhone13,2"
com.apple.Maps,3,1730159233,1730159236,1730159236.169128,-18000,EB445137-D7F5-57EC-87DA-1DB460D64046,"iPhone13,2"
com.apple.Maps,31,1730159169,1730159200,1730159200.140707,-18000,EB445137-D7F5-57EC-87DA-1DB460D64046,"iPhone13,2"
com.apple.Maps,3,1730159150,1730159153,1730159153.086376,-18000,EB445137-D7F5-57EC-87DA-1DB460D64046,"iPhone13,2"
com.apple.Maps,3,1730159049,1730159052,1730159052.379843,-18000,EB445137-D7F5-57EC-87DA-1DB460D64046,"iPhone13,2"
com.apple.Maps,27,1730158981,1730159008,1730159008.459465,-18000,EB445137-D7F5-57EC-87DA-1DB460D64046,"iPhone13,2"
com.apple.Maps,5,1730158924,1730158929,1730158929.781323,-18000,EB445137-D7F5-57EC-87DA-1DB460D64046,"iPhone13,2"
com.apple.Maps,2,1730158916,1730158918,1730158918.380832,-18000,EB445137-D7F5-57EC-87DA-1DB460D64046,"iPhone13,2"
com.apple.Maps,6,1730158909,1730158915,1730158915.8041449,-18000,EB445137-D7F5-57EC-87DA-1DB460D64046,"iPhone13,2"
com.apple.Maps,12,1730158305,1730158317,1730158317.347795,-18000,EB445137-D7F5-57EC-87DA-1DB460D64046,"iPhone13,2"
com.apple.camera,1,1730158202,1730158203,1730158203.0786161,-18000,EB445137-D7F5-57EC-87DA-1DB460D64046,"iPhone13,2"
com.apple.Maps,9,1730158200,1730158209,1730158209.5090408,-18000,EB445137-D7F5-57EC-87DA-1DB460D64046,"iPhone13,2"
com.apple.Maps,2,1730158025,1730158027,1730158027.785243,-18000,EB445137-D7F5-57EC-87DA-1DB460D64046,"iPhone13,2"
com.apple.Maps,19,1730157972,1730157991,1730157991.528545,-18000,EB445137-D7F5-57EC-87DA-1DB460D64046,"iPhone13,2"
com.apple.podcasts,2,1730157970,1730157972,1730157972.3879418,-18000,EB445137-D7F5-57EC-87DA-1DB460D64046,"iPhone13,2"
com.apple.podcasts,29,1730157910,1730157939,1730157939.960166,-18000,EB445137-D7F5-57EC-87DA-1DB460D64046,"iPhone13,2"
com.apple.podcasts,2,1730157890,1730157892,1730157892.907362,-18000,EB445137-D7F5-57EC-87DA-1DB460D64046,"iPhone13,2"
com.apple.podcasts,18,1730157850,1730157868,1730157868.953265,-18000,EB445137-D7F5-57EC-87DA-1DB460D64046,"iPhone13,2"
com.google.chrome.ios,13,1730157837,1730157850,1730157851.8583,-18000,EB445137-D7F5-57EC-87DA-1DB460D64046,"iPhone13,2"
com.apple.podcasts,24,1730157813,1730157837,1730157837.593483,-18000,EB445137-D7F5-57EC-87DA-1DB460D64046,"iPhone13,2"
com.apple.podcasts,74,1730157719,1730157793,1730157793.928926,-18000,EB445137-D7F5-57EC-87DA-1DB460D64046,"iPhone13,2"
com.apple.Maps,5,1730157699,1730157704,1730157704.9433532,-18000,EB445137-D7F5-57EC-87DA-1DB460D64046,"iPhone13,2"
com.apple.Maps,4,1730157501,1730157505,1730157506.0523438,-18000,EB445137-D7F5-57EC-87DA-1DB460D64046,"iPhone13,2"
com.apple.Maps,35,1730157377,1730157412,1730157412.7307281,-18000,EB445137-D7F5-57EC-87DA-1DB460D64046,"iPhone13,2"
com.apple.Maps,6,1730157370,1730157376,1730157376.6300058,-18000,EB445137-D7F5-57EC-87DA-1DB460D64046,"iPhone13,2"
com.apple.Maps,63,1730157306,1730157369,1730157370.099502,-18000,EB445137-D7F5-57EC-87DA-1DB460D64046,"iPhone13,2"
com.apple.news,4,1730157302,1730157306,1730157306.918289,-18000,EB445137-D7F5-57EC-87DA-1DB460D64046,"iPhone13,2"
com.apple.news,6,1730157243,1730157249,1730157249.742682,-18000,EB445137-D7F5-57EC-87DA-1DB460D64046,"iPhone13,2"
com.apple.news,3,1730157137,1730157140,1730157140.837707,-18000,EB445137-D7F5-57EC-87DA-1DB460D64046,"iPhone13,2"
com.apple.news,448,1730156397,1730156845,1730156845.554883,-18000,EB445137-D7F5-57EC-87DA-1DB460D64046,"iPhone13,2"
com.apple.news,146,1730156242,1730156388,1730156388.9407802,-18000,EB445137-D7F5-57EC-87DA-1DB460D64046,"iPhone13,2"
com.instructure.icanvas,33,1730156198,1730156231,1730156231.7950249,-18000,EB445137-D7F5-57EC-87DA-1DB460D64046,"iPhone13,2"
com.apple.Maps,7,1730156191,1730156198,1730156199.066359,-18000,EB445137-D7F5-57EC-87DA-1DB460D64046,"iPhone13,2"
com.apple.Maps,31,1730155890,1730155921,1730155921.813704,-18000,EB445137-D7F5-57EC-87DA-1DB460D64046,"iPhone13,2"
com.apple.weather,3,1730155887,1730155890,1730155890.6062431,-18000,EB445137-D7F5-57EC-87DA-1DB460D64046,"iPhone13,2"
com.apple.weather,9,1730155718,1730155727,1730155727.224043,-18000,EB445137-D7F5-57EC-87DA-1DB460D64046,"iPhone13,2"
com.apple.weather,6,1730155490,1730155496,1730155496.0672112,-18000,EB445137-D7F5-57EC-87DA-1DB460D64046,"iPhone13,2"
com.apple.weather,2,1730155362,1730155364,1730155364.122041,-18000,EB445137-D7F5-57EC-87DA-1DB460D64046,"iPhone13,2"
com.apple.weather,4,1730155305,1730155309,1730155309.122666,-18000,EB445137-D7F5-57EC-87DA-1DB460D64046,"iPhone13,2"
com.truebill.truebillnative,103,1730155184,1730155287,1730155287.271892,-18000,EB445137-D7F5-57EC-87DA-1DB460D64046,"iPhone13,2"
com.myfitnesspal.mfp,75,1730155108,1730155183,1730155184.133685,-18000,EB445137-D7F5-57EC-87DA-1DB460D64046,"iPhone13,2"
com.apple.Maps,45,1730155061,1730155106,1730155106.31306,-18000,EB445137-D7F5-57EC-87DA-1DB460D64046,"iPhone13,2"
com.microsoft.Office.Outlook,25,1730155014,1730155039,1730155039.77414,-18000,EB445137-D7F5-57EC-87DA-1DB460D64046,"iPhone13,2"
com.apple.iCal,325,1730155010,1730155335,1730155335.385171,-18000,,
com.microsoft.Office.Outlook,31,1730154971,1730155002,1730155002.961829,-18000,EB445137-D7F5-57EC-87DA-1DB460D64046,"iPhone13,2"
com.leomehlig.today,86,1730154924,1730155010,1730155010.888627,-18000,,
com.google.Chrome,134,1730154790,1730154924,1730154924.1133618,-18000,,
com.apple.iCal,29,1730154744,1730154773,1730154773.573786,-18000,,
com.google.Chrome,124,1730154620,1730154744,1730154744.42669,-18000,,
com.hnc.Discord,2,1730154618,1730154620,1730154620.7687368,-18000,,
com.google.Chrome,2,1730154616,1730154618,1730154618.50407,-18000,,
com.hnc.Discord,8,1730154608,1730154616,1730154616.1022382,-18000,,
com.microsoft.VSCode,4,1730154604,1730154608,1730154608.3977408,-18000,,
com.leomehlig.today,50,1730154554,1730154604,1730154604.379548,-18000,,
com.google.Chrome,71,1730154483,1730154554,1730154554.560944,-18000,,
com.apple.finder,3,1730154467,1730154470,1730154470.815157,-18000,,
com.apple.Preview,28,1730154439,1730154467,1730154467.897307,-18000,,
com.microsoft.VSCode,219,1730154220,1730154439,1730154439.443112,-18000,,
com.google.Chrome,3,1730154217,1730154220,1730154220.334556,-18000,,
com.microsoft.VSCode,103,1730154114,1730154217,1730154217.574329,-18000,,
com.google.Chrome,9,1730154105,1730154114,1730154114.806334,-18000,,
com.microsoft.VSCode,54,1730154051,1730154105,1730154105.9033818,-18000,,
com.google.Chrome,29,1730154022,1730154051,1730154051.1478171,-18000,,
com.microsoft.VSCode,4,1730154018,1730154022,1730154022.578515,-18000,,
com.google.Chrome,1,1730154017,1730154018,1730154018.589082,-18000,,
com.microsoft.VSCode,0,1730154017,1730154017,1730154017.830029,-18000,,
com.google.Chrome,1,1730154016,1730154017,1730154017.298019,-18000,,
com.microsoft.VSCode,1,1730154015,1730154016,1730154016.105387,-18000,,
com.google.Chrome,1,1730154014,1730154015,1730154015.335765,-18000,,
com.microsoft.VSCode,1,1730154013,1730154014,1730154014.609243,-18000,,
com.google.Chrome,1,1730154012,1730154013,1730154013.87122,-18000,,
com.microsoft.VSCode,16,1730153996,1730154012,1730154012.372429,-18000,,
com.google.Chrome,7,1730153989,1730153996,1730153996.5949879,-18000,,
com.microsoft.VSCode,1,1730153988,1730153989,1730153989.336646,-18000,,
com.hnc.Discord,3,1730153985,1730153988,1730153988.3254418,-18000,,
com.microsoft.VSCode,29,1730153956,1730153985,1730153985.730618,-18000,,
com.hnc.Discord,1,1730153955,1730153956,1730153956.9892821,-18000,,
com.google.Chrome,74,1730153881,1730153955,1730153955.895159,-18000,,
com.hnc.Discord,2,1730153879,1730153881,1730153881.123723,-18000,,
com.microsoft.VSCode,3,1730153876,1730153879,1730153879.865862,-18000,,
com.hnc.Discord,2,1730153874,1730153876,1730153876.440641,-18000,,
com.google.Chrome,3,1730153871,1730153874,1730153875.030628,-18000,,
com.hnc.Discord,1,1730153870,1730153871,1730153871.19833,-18000,,
com.microsoft.VSCode,250,1730153620,1730153870,1730153870.694448,-18000,,
com.hnc.Discord,1,1730153619,1730153620,1730153620.566683,-18000,,
com.microsoft.VSCode,1,1730153618,1730153619,1730153619.909065,-18000,,
com.hnc.Discord,1,1730153617,1730153618,1730153618.804007,-18000,,
com.microsoft.VSCode,173,1730153444,1730153617,1730153617.123802,-18000,,
com.hnc.Discord,4,1730153440,1730153444,1730153444.103015,-18000,,
com.microsoft.VSCode,5,1730153435,1730153440,1730153440.766501,-18000,,
com.hnc.Discord,2,1730153433,1730153435,1730153435.894878,-18000,,
com.microsoft.VSCode,0,1730153433,1730153433,1730153434.008891,-18000,,
com.hnc.Discord,1,1730153432,1730153433,1730153433.2751431,-18000,,
com.microsoft.VSCode,1,1730153431,1730153432,1730153432.471745,-18000,,
com.hnc.Discord,4,1730153427,1730153431,1730153431.981462,-18000,,
com.microsoft.VSCode,326,1730153101,1730153427,1730153427.166909,-18000,,
com.hnc.Discord,8,1730153093,1730153101,1730153101.965362,-18000,,
com.microsoft.VSCode,145,1730152948,1730153093,1730153093.1567621,-18000,,
com.hnc.Discord,1,1730152947,1730152948,1730152948.6071439,-18000,,
com.microsoft.VSCode,3,1730152944,1730152947,1730152947.293364,-18000,,
com.hnc.Discord,2,1730152942,1730152944,1730152944.551132,-18000,,
com.microsoft.VSCode,2,1730152940,1730152942,1730152942.290061,-18000,,
com.hnc.Discord,1,1730152939,1730152940,1730152940.474019,-18000,,
com.microsoft.VSCode,3,1730152936,1730152939,1730152939.411598,-18000,,
com.hnc.Discord,2,1730152934,1730152936,1730152936.65419,-18000,,
com.microsoft.VSCode,4,1730152930,1730152934,1730152934.1576118,-18000,,
com.hnc.Discord,5,1730152925,1730152930,1730152930.5782828,-18000,,
com.microsoft.VSCode,1,1730152924,1730152925,1730152925.756392,-18000,,
com.hnc.Discord,0,1730152924,1730152924,1730152925.0384479,-18000,,
com.microsoft.VSCode,2,1730152922,1730152924,1730152924.0748038,-18000,,
com.hnc.Discord,1,1730152921,1730152922,1730152922.8708792,-18000,,
com.microsoft.VSCode,0,1730152921,1730152921,1730152921.7125301,-18000,,
com.hnc.Discord,1,1730152920,1730152921,1730152921.288979,-18000,,
com.microsoft.VSCode,5,1730152915,1730152920,1730152920.573337,-18000,,
com.hnc.Discord,3,1730152912,1730152915,1730152915.553594,-18000,,
com.microsoft.VSCode,13,1730152899,1730152912,1730152912.03752,-18000,,
com.hnc.Discord,102,1730152797,1730152899,1730152899.326706,-18000,,
com.microsoft.VSCode,126,1730152671,1730152797,1730152797.17613,-18000,,
com.google.Chrome,69,1730152602,1730152671,1730152671.2395492,-18000,,
com.microsoft.VSCode,5,1730152597,1730152602,1730152602.335995,-18000,,
com.google.Chrome,8,1730152589,1730152597,1730152597.337295,-18000,,
com.microsoft.VSCode,5,1730152584,1730152589,1730152589.7183762,-18000,,
com.google.Chrome,5,1730152579,1730152584,1730152584.72177,-18000,,
com.microsoft.VSCode,3,1730152576,1730152579,1730152579.974864,-18000,,
com.google.Chrome,7,1730152569,1730152576,1730152576.152919,-18000,,
com.microsoft.VSCode,32,1730152537,1730152569,1730152569.9676151,-18000,,
com.google.Chrome,34,1730152503,1730152537,1730152537.3259,-18000,,
com.microsoft.VSCode,18,1730152485,1730152503,1730152503.949977,-18000,,
com.google.Chrome,11,1730152474,1730152485,1730152486.046294,-18000,,
com.microsoft.VSCode,7,1730152467,1730152474,1730152474.291209,-18000,,
com.hnc.Discord,3,1730152464,1730152467,1730152467.4537349,-18000,,
com.microsoft.VSCode,27,1730152437,1730152464,1730152464.087805,-18000,,
com.hnc.Discord,2,1730152435,1730152437,1730152437.590004,-18000,,
com.google.Chrome,31,1730152404,1730152435,1730152435.4664822,-18000,,
com.hnc.Discord,2,1730152402,1730152404,1730152404.87884,-18000,,
com.google.Chrome,8,1730152394,1730152402,1730152402.5336409,-18000,,
com.microsoft.VSCode,2,1730152392,1730152394,1730152394.374105,-18000,,
com.google.Chrome,2,1730152390,1730152392,1730152392.217465,-18000,,
com.microsoft.VSCode,1,1730152389,1730152390,1730152390.591361,-18000,,
com.google.Chrome,10,1730152379,1730152389,1730152390.0205321,-18000,,
com.microsoft.VSCode,131,1730152248,1730152379,1730152379.916703,-18000,,
com.hnc.Discord,7,1730152241,1730152248,1730152248.834072,-18000,,
com.microsoft.VSCode,7,1730152234,1730152241,1730152241.0987291,-18000,,
com.hnc.Discord,23,1730152211,1730152234,1730152234.807745,-18000,,
com.microsoft.VSCode,65,1730152146,1730152211,1730152211.652097,-18000,,
com.hnc.Discord,3,1730152143,1730152146,1730152146.218161,-18000,,
com.microsoft.VSCode,19,1730152124,1730152143,1730152143.458427,-18000,,
com.google.Chrome,9,1730152115,1730152124,1730152124.794369,-18000,,
com.microsoft.VSCode,9,1730152106,1730152115,1730152115.2520452,-18000,,
com.google.Chrome,3,1730152103,1730152106,1730152106.687675,-18000,,
com.microsoft.VSCode,12,1730152091,1730152103,1730152103.634345,-18000,,
com.google.Chrome,2,1730152089,1730152091,1730152091.332026,-18000,,
com.microsoft.VSCode,13,1730152076,1730152089,1730152089.9140449,-18000,,
com.google.Chrome,21,1730152055,1730152076,1730152076.737354,-18000,,
com.microsoft.VSCode,14,1730152041,1730152055,1730152055.7352319,-18000,,
com.google.Chrome,12,1730152029,1730152041,1730152041.1539822,-18000,,
com.microsoft.VSCode,14,1730152015,1730152029,1730152029.972008,-18000,,
com.google.Chrome,17,1730151998,1730152015,1730152015.7430081,-18000,,
com.microsoft.VSCode,8,1730151990,1730151998,1730151998.4418712,-18000,,
com.google.Chrome,1,1730151989,1730151990,1730151990.987577,-18000,,
com.microsoft.VSCode,3,1730151986,1730151989,1730151989.818629,-18000,,
com.google.Chrome,21,1730151965,1730151986,1730151986.480812,-18000,,
com.microsoft.VSCode,5,1730151960,1730151965,1730151965.903925,-18000,,
com.google.Chrome,27,1730151933,1730151960,1730151960.235371,-18000,,
com.microsoft.VSCode,10,1730151923,1730151933,1730151933.194994,-18000,,
com.google.Chrome,2,1730151921,1730151923,1730151923.72719,-18000,,
com.microsoft.VSCode,7,1730151914,1730151921,1730151921.207034,-18000,,
com.google.Chrome,21,1730151893,1730151914,1730151914.521965,-18000,,
com.microsoft.VSCode,85,1730151808,1730151893,1730151893.11182,-18000,,
com.hnc.Discord,10,1730151798,1730151808,1730151808.736877,-18000,,
com.microsoft.VSCode,19,1730151779,1730151798,1730151798.949555,-18000,,
com.hnc.Discord,44,1730151735,1730151779,1730151779.993839,-18000,,
com.microsoft.VSCode,83,1730151652,1730151735,1730151735.078018,-18000,,
com.apple.finder,1,1730151651,1730151652,1730151652.799306,-18000,,
com.hnc.Discord,22,1730151629,1730151651,1730151651.360069,-18000,,
com.leomehlig.today,33,1730151596,1730151629,1730151629.088556,-18000,,
com.google.Chrome,1038,1730150558,1730151596,1730151596.889463,-18000,,
com.hnc.Discord,35,1730150523,1730150558,1730150558.809788,-18000,,
com.google.Chrome,79,1730150444,1730150523,1730150523.304028,-18000,,
com.hnc.Discord,18,1730150426,1730150444,1730150444.988546,-18000,,
com.google.Chrome,4,1730150422,1730150426,1730150426.502362,-18000,,
com.hnc.Discord,3,1730150419,1730150422,1730150422.483094,-18000,,
com.google.Chrome,5,1730150414,1730150419,1730150419.1901078,-18000,,
com.hnc.Discord,36,1730150378,1730150414,1730150414.980493,-18000,,
com.google.Chrome,1028,1730149350,1730150378,1730150378.7663422,-18000,,
com.leomehlig.today,18,1730149315,1730149333,1730149334.645582,-18000,,
com.apple.iCal,4,1730149311,1730149315,1730149315.5419521,-18000,,
com.apple.findmy,1,1730149310,1730149311,1730149311.641397,-18000,,
com.apple.MobileSMS,2,1730149294,1730149296,1730149296.882566,-18000,EB445137-D7F5-57EC-87DA-1DB460D64046,"iPhone13,2"
com.apple.InCallService,103,1730149191,1730149294,1730149294.619664,-18000,EB445137-D7F5-57EC-87DA-1DB460D64046,"iPhone13,2"
com.apple.MobileSMS,19,1730149172,1730149191,1730149191.804599,-18000,EB445137-D7F5-57EC-87DA-1DB460D64046,"iPhone13,2"
com.apple.InCallService,365,1730148806,1730149171,1730149171.979876,-18000,EB445137-D7F5-57EC-87DA-1DB460D64046,"iPhone13,2"
com.apple.MobileSMS,47,1730148759,1730148806,1730148806.9491692,-18000,EB445137-D7F5-57EC-87DA-1DB460D64046,"iPhone13,2"
com.apple.InCallService,2,1730148757,1730148759,1730148759.402007,-18000,EB445137-D7F5-57EC-87DA-1DB460D64046,"iPhone13,2"
com.apple.weather,24,1730148733,1730148757,1730148757.162969,-18000,EB445137-D7F5-57EC-87DA-1DB460D64046,"iPhone13,2"
com.apple.iCal,611,1730148699,1730149310,1730149310.319881,-18000,,
com.apple.iCal,365,1730148257,1730148622,1730148622.8742309,-18000,,
com.leomehlig.today,3,1730148254,1730148257,1730148257.437463,-18000,,
com.apple.findmy,279,1730147975,1730148254,1730148254.4594011,-18000,,
com.apple.InCallService,989,1730147743,1730148732,1730148732.3406482,-18000,EB445137-D7F5-57EC-87DA-1DB460D64046,"iPhone13,2"
com.apple.MobileSMS,60,1730147683,1730147743,1730147743.191781,-18000,EB445137-D7F5-57EC-87DA-1DB460D64046,"iPhone13,2"
com.apple.findmy,12,1730147670,1730147682,1730147682.299488,-18000,EB445137-D7F5-57EC-87DA-1DB460D64046,"iPhone13,2"
com.apple.findmy,6,1730147662,1730147668,1730147668.74611,-18000,EB445137-D7F5-57EC-87DA-1DB460D64046,"iPhone13,2"
com.microsoft.Office.Outlook,14,1730147646,1730147660,1730147660.2706308,-18000,EB445137-D7F5-57EC-87DA-1DB460D64046,"iPhone13,2"
com.microsoft.Office.Outlook,1,1730147623,1730147624,1730147624.919592,-18000,EB445137-D7F5-57EC-87DA-1DB460D64046,"iPhone13,2"
com.microsoft.Office.Outlook,84,1730147520,1730147604,1730147604.8232799,-18000,EB445137-D7F5-57EC-87DA-1DB460D64046,"iPhone13,2"
com.leomehlig.today,484,1730147491,1730147975,1730147975.393357,-18000,,
com.hnc.Discord,1,1730147490,1730147491,1730147491.405927,-18000,,
com.leomehlig.today,53,1730147437,1730147490,1730147490.251285,-18000,,
com.hnc.Discord,5,1730147432,1730147437,1730147437.457396,-18000,,
com.hnc.Discord,337,1730147014,1730147351,1730147351.986072,-18000,,
com.leomehlig.today,4,1730147010,1730147014,1730147014.345372,-18000,,
com.google.Chrome,4,1730147006,1730147010,1730147010.360084,-18000,,
com.leomehlig.today,52,1730146954,1730147006,1730147006.342022,-18000,,
com.google.Chrome,1415,1730145539,1730146954,1730146955.06446,-18000,,
com.apple.MobileSMS,8,1730145437,1730145445,1730145446.5845919,-18000,EB445137-D7F5-57EC-87DA-1DB460D64046,"iPhone13,2"
com.apple.news,169,1730145268,1730145437,1730145438.455612,-18000,EB445137-D7F5-57EC-87DA-1DB460D64046,"iPhone13,2"
com.apple.MobileSMS,3,1730145265,1730145268,1730145268.3178082,-18000,EB445137-D7F5-57EC-87DA-1DB460D64046,"iPhone13,2"
com.apple.weather,5,1730145260,1730145265,1730145265.6030831,-18000,EB445137-D7F5-57EC-87DA-1DB460D64046,"iPhone13,2"
com.apple.weather,7,1730145229,1730145236,1730145236.7230968,-18000,EB445137-D7F5-57EC-87DA-1DB460D64046,"iPhone13,2"
com.google.Chrome,2686,1730142839,1730145525,1730145525.062382,-18000,,
com.apple.weather,9,1730142506,1730142515,1730142515.836607,-18000,EB445137-D7F5-57EC-87DA-1DB460D64046,"iPhone13,2"
com.leomehlig.today,6,1730142468,1730142474,1730142474.904467,-18000,,
com.apple.iCal,6,1730142462,1730142468,1730142468.12495,-18000,,
com.google.Chrome,2,1730142460,1730142462,1730142462.432428,-18000,,
com.google.Chrome,315,1730140181,1730140496,1730140496.504004,-18000,,
com.google.Chrome,301,1730139839,1730140140,1730140140.494662,-18000,,
com.google.Chrome,613,1730138205,1730138818,1730138818.850575,-18000,,
com.apple.camera,0,1730137235,1730137235,1730137235.624486,-18000,EB445137-D7F5-57EC-87DA-1DB460D64046,"iPhone13,2"
com.apple.camera,1,1730137229,1730137230,1730137230.185451,-18000,EB445137-D7F5-57EC-87DA-1DB460D64046,"iPhone13,2"
com.apple.camera,1,1730137226,1730137227,1730137227.012031,-18000,EB445137-D7F5-57EC-87DA-1DB460D64046,"iPhone13,2"
com.apple.camera,0,1730137224,1730137224,1730137224.595324,-18000,EB445137-D7F5-57EC-87DA-1DB460D64046,"iPhone13,2"
com.apple.camera,1,1730137222,1730137223,1730137223.843013,-18000,EB445137-D7F5-57EC-87DA-1DB460D64046,"iPhone13,2"
com.apple.news,146,1730137055,1730137201,1730137201.208136,-18000,EB445137-D7F5-57EC-87DA-1DB460D64046,"iPhone13,2"
com.google.Chrome,1663,1730136466,1730138129,1730138129.283471,-18000,,
com.google.Chrome,470,1730135954,1730136424,1730136424.3846788,-18000,,
com.leomehlig.today,8,1730135946,1730135954,1730135954.977402,-18000,,
com.apple.finder,7,1730135939,1730135946,1730135946.1250648,-18000,,
com.google.Chrome,407,1730135532,1730135939,1730135939.386539,-18000,,
com.leomehlig.today,2,1730135283,1730135285,1730135285.794174,-18000,,
com.google.Chrome,259,1730135024,1730135283,1730135283.7200022,-18000,,
com.leomehlig.today,15,1730134993,1730135008,1730135008.801548,-18000,,
com.apple.finder,18,1730134975,1730134993,1730134993.1391249,-18000,,
com.leomehlig.today,67,1730134908,1730134975,1730134975.335645,-18000,,
com.google.Chrome,9,1730134899,1730134908,1730134908.178608,-18000,,
com.google.Chrome,525,1730134326,1730134851,1730134851.186977,-18000,,
com.google.Chrome,1186,1730132658,1730133844,1730133844.403044,-18000,,
com.google.Chrome,423,1730132091,1730132514,1730132514.993923,-18000,,
com.apple.news,334,1730131434,1730131768,1730131768.7908602,-18000,EB445137-D7F5-57EC-87DA-1DB460D64046,"iPhone13,2"
com.hammerandchisel.discord,8,1730131413,1730131421,1730131421.9051828,-18000,EB445137-D7F5-57EC-87DA-1DB460D64046,"iPhone13,2"
com.microsoft.Office.Outlook,20,1730131392,1730131412,1730131412.471744,-18000,EB445137-D7F5-57EC-87DA-1DB460D64046,"iPhone13,2"
com.myfitnesspal.mfp,6,1730131386,1730131392,1730131392.783931,-18000,EB445137-D7F5-57EC-87DA-1DB460D64046,"iPhone13,2"
com.myfitnesspal.mfp,27,1730131337,1730131364,1730131365.0633512,-18000,EB445137-D7F5-57EC-87DA-1DB460D64046,"iPhone13,2"
com.myfitnesspal.mfp,3,1730130653,1730130656,1730130656.601222,-18000,EB445137-D7F5-57EC-87DA-1DB460D64046,"iPhone13,2"
com.myfitnesspal.mfp,3,1730130650,1730130653,1730130653.445327,-18000,EB445137-D7F5-57EC-87DA-1DB460D64046,"iPhone13,2"
com.myfitnesspal.mfp,102,1730127600,1730127702,1730127703.5255089,-18000,EB445137-D7F5-57EC-87DA-1DB460D64046,"iPhone13,2"
com.hammerandchisel.discord,2,1730127597,1730127599,1730127599.8541021,-18000,EB445137-D7F5-57EC-87DA-1DB460D64046,"iPhone13,2"
com.hammerandchisel.discord,9,1730127311,1730127320,1730127321.056415,-18000,EB445137-D7F5-57EC-87DA-1DB460D64046,"iPhone13,2"
com.apple.weather,4,1730127307,1730127311,1730127311.211112,-18000,EB445137-D7F5-57EC-87DA-1DB460D64046,"iPhone13,2"
com.apple.weather,11,1730126120,1730126131,1730126131.515161,-18000,EB445137-D7F5-57EC-87DA-1DB460D64046,"iPhone13,2"
com.renpho.health,11,1730126106,1730126117,1730126117.6922522,-18000,EB445137-D7F5-57EC-87DA-1DB460D64046,"iPhone13,2"
com.renpho.health,44,1730126039,1730126083,1730126083.796438,-18000,EB445137-D7F5-57EC-87DA-1DB460D64046,"iPhone13,2"
com.microsoft.Office.Outlook,5,1730126033,1730126038,1730126038.169917,-18000,EB445137-D7F5-57EC-87DA-1DB460D64046,"iPhone13,2"
com.microsoft.Office.Outlook,5,1730125010,1730125015,1730125015.352454,-18000,EB445137-D7F5-57EC-87DA-1DB460D64046,"iPhone13,2"
com.microsoft.Office.Outlook,17,1730124693,1730124710,1730124710.590671,-18000,EB445137-D7F5-57EC-87DA-1DB460D64046,"iPhone13,2"
com.microsoft.Office.Outlook,15,1730124534,1730124549,1730124549.9078732,-18000,EB445137-D7F5-57EC-87DA-1DB460D64046,"iPhone13,2"
com.microsoft.Office.Outlook,224,1730124295,1730124519,1730124520.781241,-18000,EB445137-D7F5-57EC-87DA-1DB460D64046,"iPhone13,2"
com.apple.mobiletimer,11,1730124255,1730124266,1730124266.7196798,-18000,EB445137-D7F5-57EC-87DA-1DB460D64046,"iPhone13,2"
com.apple.mobiletimer,29,1730124002,1730124031,1730124031.4650059,-18000,EB445137-D7F5-57EC-87DA-1DB460D64046,"iPhone13,2"
com.apple.mobiletimer,13,1730098350,1730098363,1730098363.543179,-18000,EB445137-D7F5-57EC-87DA-1DB460D64046,"iPhone13,2"
com.apple.mobiletimer,3,1730098343,1730098346,1730098346.341526,-18000,EB445137-D7F5-57EC-87DA-1DB460D64046,"iPhone13,2"
com.apple.mobiletimer,6,1730098091,1730098097,1730098097.372102,-18000,EB445137-D7F5-57EC-87DA-1DB460D64046,"iPhone13,2"
com.apple.mobiletimer,11,1730097789,1730097800,1730097800.3663921,-18000,EB445137-D7F5-57EC-87DA-1DB460D64046,"iPhone13,2"
com.apple.Music,9,1730097780,1730097789,1730097789.723191,-18000,EB445137-D7F5-57EC-87DA-1DB460D64046,"iPhone13,2"
com.apple.Music,5,1730096088,1730096093,1730096093.652451,-18000,EB445137-D7F5-57EC-87DA-1DB460D64046,"iPhone13,2"
com.apple.Music,11,1730095567,1730095578,1730095580.1608272,-18000,EB445137-D7F5-57EC-87DA-1DB460D64046,"iPhone13,2"
com.apple.mobiletimer,4,1730095558,1730095562,1730095562.869926,-18000,EB445137-D7F5-57EC-87DA-1DB460D64046,"iPhone13,2"
com.apple.mobiletimer,13,1730093987,1730094000,1730094000.159803,-18000,EB445137-D7F5-57EC-87DA-1DB460D64046,"iPhone13,2"
com.apple.mobiletimer,9,1730093896,1730093905,1730093906.884839,-18000,EB445137-D7F5-57EC-87DA-1DB460D64046,"iPhone13,2"
com.google.Chrome,1195,1730092569,1730093764,1730093764.963896,-18000,,
com.google.Chrome,307,1730091609,1730091916,1730091916.638032,-18000,,
com.google.Chrome,588,1730090986,1730091574,1730091574.4193702,-18000,,
com.google.Chrome,1747,1730088660,1730090407,1730090407.427433,-18000,,
com.google.Chrome,1206,1730087130,1730088336,1730088336.279605,-18000,,
com.google.Chrome,372,1730086429,1730086801,1730086801.527751,-18000,,
com.apple.finder,9,1730086420,1730086429,1730086429.751651,-18000,,
com.hnc.Discord,6,1730086414,1730086420,1730086420.427329,-18000,,
com.google.Chrome,17,1730086397,1730086414,1730086414.5077229,-18000,,
com.google.chrome.ios,10,1730084234,1730084244,1730084244.7749128,-18000,EB445137-D7F5-57EC-87DA-1DB460D64046,"iPhone13,2"
com.google.chrome.ios,7,1730084162,1730084169,1730084169.0983648,-18000,EB445137-D7F5-57EC-87DA-1DB460D64046,"iPhone13,2"
com.apple.camera,0,1730082245,1730082245,1730082245.749433,-18000,EB445137-D7F5-57EC-87DA-1DB460D64046,"iPhone13,2"
com.google.chrome.ios,11,1730082241,1730082252,1730082252.030863,-18000,EB445137-D7F5-57EC-87DA-1DB460D64046,"iPhone13,2"
com.google.chrome.ios,8,1730082120,1730082128,1730082128.621039,-18000,EB445137-D7F5-57EC-87DA-1DB460D64046,"iPhone13,2"
com.google.chrome.ios,3,1730082109,1730082112,1730082112.146945,-18000,EB445137-D7F5-57EC-87DA-1DB460D64046,"iPhone13,2"
com.google.chrome.ios,10,1730082024,1730082034,1730082034.36729,-18000,EB445137-D7F5-57EC-87DA-1DB460D64046,"iPhone13,2"
com.google.chrome.ios,190,1730081638,1730081828,1730081829.743206,-18000,EB445137-D7F5-57EC-87DA-1DB460D64046,"iPhone13,2"
com.apple.MobileSMS,22,1730079922,1730079944,1730079944.448555,-18000,EB445137-D7F5-57EC-87DA-1DB460D64046,"iPhone13,2"
com.apple.mobileslideshow,4,1730079918,1730079922,1730079922.7303329,-18000,EB445137-D7F5-57EC-87DA-1DB460D64046,"iPhone13,2"
com.apple.MobileSMS,11,1730079906,1730079917,1730079918.036881,-18000,EB445137-D7F5-57EC-87DA-1DB460D64046,"iPhone13,2"
com.apple.MobileSMS,31,1730079842,1730079873,1730079873.955865,-18000,EB445137-D7F5-57EC-87DA-1DB460D64046,"iPhone13,2"
com.apple.findmy,5,1730079837,1730079842,1730079842.65036,-18000,EB445137-D7F5-57EC-87DA-1DB460D64046,"iPhone13,2"
com.apple.MobileSMS,20,1730079817,1730079837,1730079837.212739,-18000,EB445137-D7F5-57EC-87DA-1DB460D64046,"iPhone13,2"
com.hammerandchisel.discord,38,1730073775,1730073813,1730073814.006067,-18000,EB445137-D7F5-57EC-87DA-1DB460D64046,"iPhone13,2"
com.truebill.truebillnative,8,1730073767,1730073775,1730073776.111778,-18000,EB445137-D7F5-57EC-87DA-1DB460D64046,"iPhone13,2"
com.truebill.truebillnative,23,1730069694,1730069717,1730069717.648711,-18000,EB445137-D7F5-57EC-87DA-1DB460D64046,"iPhone13,2"
com.hammerandchisel.discord,12,1730069680,1730069692,1730069692.746562,-18000,EB445137-D7F5-57EC-87DA-1DB460D64046,"iPhone13,2"
com.microsoft.Office.Outlook,10,1730069575,1730069585,1730069585.775101,-18000,EB445137-D7F5-57EC-87DA-1DB460D64046,"iPhone13,2"
com.toyopagroup.picaboo,3,1730069563,1730069566,1730069566.806211,-18000,EB445137-D7F5-57EC-87DA-1DB460D64046,"iPhone13,2"
com.myfitnesspal.mfp,3,1730069560,1730069563,1730069563.97388,-18000,EB445137-D7F5-57EC-87DA-1DB460D64046,"iPhone13,2"
com.google.Chrome,583,1730068973,1730069556,1730069556.4571218,-18000,,
com.microsoft.Outlook,1,1730068972,1730068973,1730068977.014011,-18000,,
com.myfitnesspal.mfp,584,1730068961,1730069545,1730069546.983808,-18000,EB445137-D7F5-57EC-87DA-1DB460D64046,"iPhone13,2"
com.toyopagroup.picaboo,8,1730068952,1730068960,1730068961.249827,-18000,EB445137-D7F5-57EC-87DA-1DB460D64046,"iPhone13,2"
com.microsoft.Outlook,3,1730068771,1730068774,1730068774.224979,-18000,,
com.hnc.Discord,44,1730068727,1730068771,1730068771.8227649,-18000,,
com.leomehlig.today,161,1730068566,1730068727,1730068727.36524,-18000,,
com.microsoft.VSCode,49,1730068517,1730068566,1730068566.199497,-18000,,
com.microsoft.Outlook,33,1730068484,1730068517,1730068517.0595598,-18000,,
com.microsoft.VSCode,3,1730068481,1730068484,1730068484.610079,-18000,,
com.hnc.Discord,1,1730068480,1730068481,1730068481.6123981,-18000,,
com.google.Chrome,4,1730068476,1730068480,1730068480.218888,-18000,,
com.microsoft.Outlook,19,1730068457,1730068476,1730068476.0432549,-18000,,
com.hnc.Discord,5,1730068452,1730068457,1730068457.713647,-18000,,
com.google.Chrome,8,1730068444,1730068452,1730068452.3208961,-18000,,
com.microsoft.Outlook,0,1730068444,1730068444,1730068444.762821,-18000,,
com.google.Chrome,7,1730068437,1730068444,1730068444.1517038,-18000,,
com.hnc.Discord,14,1730068423,1730068437,1730068437.040618,-18000,,
com.microsoft.VSCode,13,1730068410,1730068423,1730068423.321038,-18000,,
com.google.Chrome,25,1730068385,1730068410,1730068410.197639,-18000,,
com.microsoft.VSCode,290,1730068095,1730068385,1730068385.9994931,-18000,,
com.google.Chrome,7,1730068088,1730068095,1730068095.887288,-18000,,
com.microsoft.VSCode,319,1730067769,1730068088,1730068088.10294,-18000,,
com.google.Chrome,52,1730067717,1730067769,1730067769.9340038,-18000,,
com.microsoft.VSCode,29,1730067688,1730067717,1730067717.176258,-18000,,
com.google.Chrome,4,1730067684,1730067688,1730067688.589143,-18000,,
com.microsoft.VSCode,1,1730067683,1730067684,1730067684.28212,-18000,,
com.google.Chrome,13,1730067670,1730067683,1730067683.523473,-18000,,
com.microsoft.VSCode,8,1730067662,1730067670,1730067670.69209,-18000,,
com.google.Chrome,18,1730067644,1730067662,1730067662.324772,-18000,,
com.microsoft.VSCode,169,1730067475,1730067644,1730067644.668172,-18000,,
com.google.Chrome,16,1730067459,1730067475,1730067475.8289142,-18000,,
com.microsoft.VSCode,13,1730067446,1730067459,1730067459.782762,-18000,,
com.google.Chrome,57,1730067389,1730067446,1730067446.765985,-18000,,
com.microsoft.VSCode,11,1730067378,1730067389,1730067389.2176871,-18000,,
com.google.Chrome,29,1730067349,1730067378,1730067379.01911,-18000,,
com.microsoft.VSCode,210,1730067139,1730067349,1730067349.815824,-18000,,
com.google.Chrome,1,1730067138,1730067139,1730067139.8127089,-18000,,
com.microsoft.VSCode,4,1730067134,1730067138,1730067138.501425,-18000,,
com.google.Chrome,1,1730067133,1730067134,1730067134.8686829,-18000,,
com.microsoft.VSCode,15,1730067118,1730067133,1730067133.34934,-18000,,
com.google.Chrome,6,1730067112,1730067118,1730067118.891405,-18000,,
com.microsoft.VSCode,5,1730067107,1730067112,1730067112.853179,-18000,,
com.google.Chrome,5,1730067102,1730067107,1730067107.643039,-18000,,
com.hnc.Discord,1,1730067101,1730067102,1730067103.025919,-18000,,
com.google.Chrome,18,1730067083,1730067101,1730067101.98879,-18000,,
com.hnc.Discord,1,1730067082,1730067083,1730067084.011921,-18000,,
com.microsoft.VSCode,12,1730067070,1730067082,1730067082.5800362,-18000,,
com.hnc.Discord,7,1730067063,1730067070,1730067070.1888351,-18000,,
com.microsoft.VSCode,13,1730067050,1730067063,1730067063.058347,-18000,,
com.hnc.Discord,1,1730067049,1730067050,1730067050.096436,-18000,,
com.microsoft.VSCode,0,1730067049,1730067049,1730067049.516228,-18000,,
com.hnc.Discord,2,1730067047,1730067049,1730067049.410012,-18000,,
com.microsoft.VSCode,3,1730067044,1730067047,1730067047.105431,-18000,,
com.google.Chrome,29,1730067015,1730067044,1730067044.4324589,-18000,,
com.microsoft.VSCode,10,1730067005,1730067015,1730067015.535441,-18000,,
com.google.Chrome,31,1730066974,1730067005,1730067005.479001,-18000,,
com.microsoft.VSCode,18,1730066956,1730066974,1730066974.217052,-18000,,
com.google.Chrome,10,1730066946,1730066956,1730066956.508884,-18000,,
com.microsoft.VSCode,18,1730066928,1730066946,1730066946.697733,-18000,,
com.google.Chrome,12,1730066916,1730066928,1730066928.24397,-18000,,
com.microsoft.VSCode,3,1730066913,1730066916,1730066916.323549,-18000,,
com.google.Chrome,27,1730066886,1730066913,1730066913.215128,-18000,,
com.microsoft.VSCode,17,1730066869,1730066886,1730066886.051981,-18000,,
com.google.Chrome,4,1730066865,1730066869,1730066869.358208,-18000,,
com.microsoft.VSCode,6,1730066859,1730066865,1730066865.8012218,-18000,,
com.google.Chrome,47,1730066812,1730066859,1730066859.786334,-18000,,
com.microsoft.VSCode,276,1730066522,1730066798,1730066798.368102,-18000,,
com.leomehlig.today,324,1730066198,1730066522,1730066522.689645,-18000,,
com.google.Chrome,3,1730066195,1730066198,1730066198.567421,-18000,,
us.zoom.xos,2,1730066193,1730066195,1730066195.3805819,-18000,,
com.apple.finder,5,1730066188,1730066193,1730066193.194217,-18000,,
us.zoom.xos,45,1730066143,1730066188,1730066188.9975839,-18000,,
com.google.Chrome,698,1730065445,1730066143,1730066144.0025969,-18000,,
us.zoom.xos,42,1730065403,1730065445,1730065445.823769,-18000,,
com.google.Chrome,37,1730065366,1730065403,1730065403.0326838,-18000,,
us.zoom.xos,4,1730065362,1730065366,1730065366.346036,-18000,,
com.google.Chrome,49,1730065313,1730065362,1730065362.237052,-18000,,
us.zoom.xos,218,1730065095,1730065313,1730065313.476376,-18000,,
com.google.Chrome,322,1730064773,1730065095,1730065095.473582,-18000,,
us.zoom.xos,59,1730064714,1730064773,1730064773.739902,-18000,,
com.google.Chrome,733,1730063981,1730064714,1730064714.6781712,-18000,,
com.apple.iWork.Numbers,39,1730063942,1730063981,1730063981.374659,-18000,,
com.google.Chrome,21,1730063921,1730063942,1730063942.319118,-18000,,
com.apple.iWork.Numbers,24,1730063897,1730063921,1730063921.116144,-18000,,
com.google.Chrome,9,1730063888,1730063897,1730063897.8191972,-18000,,
com.apple.iWork.Numbers,9,1730063879,1730063888,1730063888.9247851,-18000,,
com.google.Chrome,117,1730063762,1730063879,1730063879.997534,-18000,,
us.zoom.xos,4,1730063758,1730063762,1730063762.258514,-18000,,
com.google.Chrome,417,1730063341,1730063758,1730063758.7671561,-18000,,
com.apple.finder,60,1730063281,1730063341,1730063341.737996,-18000,,
com.google.Chrome,105,1730063176,1730063281,1730063281.053379,-18000,,
com.apple.iWork.Numbers,9,1730063167,1730063176,1730063176.2310472,-18000,,
com.google.Chrome,172,1730062995,1730063167,1730063168.002559,-18000,,
us.zoom.xos,13,1730062982,1730062995,1730062995.163943,-18000,,
com.google.Chrome,289,1730062693,1730062982,1730062982.197997,-18000,,
com.apple.iCal,2,1730062691,1730062693,1730062693.300612,-18000,,
com.google.Chrome,84,1730062607,1730062691,1730062691.801948,-18000,,
com.apple.iCal,0,1730062607,1730062607,1730062607.941396,-18000,,
com.google.Chrome,4,1730062603,1730062607,1730062607.21451,-18000,,
com.apple.iCal,8,1730062595,1730062603,1730062603.332769,-18000,,
com.google.Chrome,237,1730062358,1730062595,1730062596.0263882,-18000,,
com.apple.iCal,4,1730062354,1730062358,1730062358.109175,-18000,,
com.google.Chrome,16,1730062338,1730062354,1730062354.463509,-18000,,
com.apple.iCal,2,1730062336,1730062338,1730062338.6409779,-18000,,
com.google.Chrome,17,1730062319,1730062336,1730062336.1963139,-18000,,
com.apple.iCal,21,1730062298,1730062319,1730062319.411302,-18000,,
com.toyopagroup.picaboo,12,1730062204,1730062216,1730062216.3748732,-18000,EB445137-D7F5-57EC-87DA-1DB460D64046,"iPhone13,2"
com.google.Chrome,1038,1730061260,1730062298,1730062298.835767,-18000,,
us.zoom.xos,2,1730061258,1730061260,1730061260.65492,-18000,,
com.google.Chrome,481,1730060777,1730061258,1730061258.254416,-18000,,
com.apple.Preview,6,1730060771,1730060777,1730060777.613614,-18000,,
us.zoom.xos,4,1730060767,1730060771,1730060771.7967181,-18000,,
com.google.Chrome,260,1730060507,1730060767,1730060767.3402162,-18000,,
us.zoom.xos,334,1730060173,1730060507,1730060507.508754,-18000,,
com.google.Chrome,49,1730060124,1730060173,1730060173.755446,-18000,,
us.zoom.xos,11,1730060113,1730060124,1730060124.683436,-18000,,
com.google.Chrome,79,1730060034,1730060113,1730060114.01597,-18000,,
us.zoom.xos,202,1730059832,1730060034,1730060034.90463,-18000,,
com.google.Chrome,142,1730059690,1730059832,1730059832.8944259,-18000,,
us.zoom.xos,12,1730059678,1730059690,1730059690.734587,-18000,,
com.google.Chrome,100,1730059578,1730059678,1730059678.063243,-18000,,
us.zoom.xos,14,1730059553,1730059567,1730059567.3993092,-18000,,
com.google.Chrome,8,1730059545,1730059553,1730059553.170497,-18000,,
com.toyopagroup.picaboo,9,1730059338,1730059347,1730059348.1428962,-18000,EB445137-D7F5-57EC-87DA-1DB460D64046,"iPhone13,2"
us.zoom.xos,214,1730059331,1730059545,1730059545.870226,-18000,,
com.google.Chrome,32,1730059299,1730059331,1730059331.4079452,-18000,,
us.zoom.xos,2,1730059297,1730059299,1730059299.084836,-18000,,
com.google.Chrome,15,1730059282,1730059297,1730059297.798088,-18000,,
us.zoom.xos,8,1730059274,1730059282,1730059282.238048,-18000,,
com.google.Chrome,4,1730059270,1730059274,1730059274.28602,-18000,,
us.zoom.xos,0,1730059270,1730059270,1730059270.7903528,-18000,,
com.microsoft.VSCode,2,1730059268,1730059270,1730059270.2073889,-18000,,
com.toyopagroup.picaboo,6,1730059107,1730059113,1730059113.03021,-18000,EB445137-D7F5-57EC-87DA-1DB460D64046,"iPhone13,2"
com.toyopagroup.picaboo,3,1730059103,1730059106,1730059106.2548552,-18000,EB445137-D7F5-57EC-87DA-1DB460D64046,"iPhone13,2"
com.toyopagroup.picaboo,15,1730059002,1730059017,1730059017.385143,-18000,EB445137-D7F5-57EC-87DA-1DB460D64046,"iPhone13,2"
us.zoom.xos,295,1730058973,1730059268,1730059268.7664351,-18000,,
com.apple.news,30,1730058968,1730058998,1730058998.423063,-18000,EB445137-D7F5-57EC-87DA-1DB460D64046,"iPhone13,2"
com.google.Chrome,6,1730058967,1730058973,1730058974.094099,-18000,,
com.apple.news,7,1730058919,1730058926,1730058926.953456,-18000,EB445137-D7F5-57EC-87DA-1DB460D64046,"iPhone13,2"
com.apple.news,8,1730058889,1730058897,1730058897.1516008,-18000,EB445137-D7F5-57EC-87DA-1DB460D64046,"iPhone13,2"
com.apple.news,7,1730058603,1730058610,1730058610.2593079,-18000,EB445137-D7F5-57EC-87DA-1DB460D64046,"iPhone13,2"
com.apple.news,7,1730058493,1730058500,1730058500.235539,-18000,EB445137-D7F5-57EC-87DA-1DB460D64046,"iPhone13,2"
com.apple.camera,1,1730058356,1730058357,1730058358.064697,-18000,EB445137-D7F5-57EC-87DA-1DB460D64046,"iPhone13,2"
com.apple.news,9,1730058355,1730058364,1730058364.738432,-18000,EB445137-D7F5-57EC-87DA-1DB460D64046,"iPhone13,2"
com.apple.news,6,1730058265,1730058271,1730058271.704445,-18000,EB445137-D7F5-57EC-87DA-1DB460D64046,"iPhone13,2"
com.apple.news,8,1730058229,1730058237,1730058237.155668,-18000,EB445137-D7F5-57EC-87DA-1DB460D64046,"iPhone13,2"
com.apple.news,168,1730057889,1730058057,1730058057.5690842,-18000,EB445137-D7F5-57EC-87DA-1DB460D64046,"iPhone13,2"
com.microsoft.Office.Outlook,6,1730057880,1730057886,1730057886.36825,-18000,EB445137-D7F5-57EC-87DA-1DB460D64046,"iPhone13,2"
com.hammerandchisel.discord,5,1730057336,1730057341,1730057341.524071,-18000,EB445137-D7F5-57EC-87DA-1DB460D64046,"iPhone13,2"
com.hammerandchisel.discord,21,1730057314,1730057335,1730057335.275577,-18000,EB445137-D7F5-57EC-87DA-1DB460D64046,"iPhone13,2"
com.hammerandchisel.discord,7,1730057277,1730057284,1730057284.800448,-18000,EB445137-D7F5-57EC-87DA-1DB460D64046,"iPhone13,2"
com.hammerandchisel.discord,7,1730057213,1730057220,1730057220.974148,-18000,EB445137-D7F5-57EC-87DA-1DB460D64046,"iPhone13,2"
com.hammerandchisel.discord,7,1730056931,1730056938,1730056938.7127461,-18000,EB445137-D7F5-57EC-87DA-1DB460D64046,"iPhone13,2"
com.hammerandchisel.discord,131,1730056624,1730056755,1730056755.637248,-18000,EB445137-D7F5-57EC-87DA-1DB460D64046,"iPhone13,2"
com.google.Chrome,29,1730056589,1730056618,1730056618.744123,-18000,,
com.microsoft.VSCode,6,1730056572,1730056578,1730056578.67701,-18000,,
com.hammerandchisel.discord,16,1730056530,1730056546,1730056546.656255,-18000,EB445137-D7F5-57EC-87DA-1DB460D64046,"iPhone13,2"
com.hammerandchisel.discord,8,1730056306,1730056314,1730056314.122011,-18000,EB445137-D7F5-57EC-87DA-1DB460D64046,"iPhone13,2"
com.hammerandchisel.discord,8,1730056189,1730056197,1730056197.492673,-18000,EB445137-D7F5-57EC-87DA-1DB460D64046,"iPhone13,2"
com.hammerandchisel.discord,8,1730056148,1730056156,1730056156.7916431,-18000,EB445137-D7F5-57EC-87DA-1DB460D64046,"iPhone13,2"
com.hammerandchisel.discord,190,1730055907,1730056097,1730056097.856392,-18000,EB445137-D7F5-57EC-87DA-1DB460D64046,"iPhone13,2"
com.letterboxd.LetterboxdApp,4,1730055903,1730055907,1730055907.12078,-18000,EB445137-D7F5-57EC-87DA-1DB460D64046,"iPhone13,2"
com.letterboxd.LetterboxdApp,6,1730055702,1730055708,1730055708.606199,-18000,EB445137-D7F5-57EC-87DA-1DB460D64046,"iPhone13,2"
com.letterboxd.LetterboxdApp,2,1730055683,1730055685,1730055685.684939,-18000,EB445137-D7F5-57EC-87DA-1DB460D64046,"iPhone13,2"
com.letterboxd.LetterboxdApp,6,1730055676,1730055682,1730055682.756424,-18000,EB445137-D7F5-57EC-87DA-1DB460D64046,"iPhone13,2"
com.letterboxd.LetterboxdApp,6,1730055425,1730055431,1730055431.6307669,-18000,EB445137-D7F5-57EC-87DA-1DB460D64046,"iPhone13,2"
com.letterboxd.LetterboxdApp,33,1730055378,1730055411,1730055411.338067,-18000,EB445137-D7F5-57EC-87DA-1DB460D64046,"iPhone13,2"
com.apple.MobileSMS,3,1730055365,1730055368,1730055368.545444,-18000,EB445137-D7F5-57EC-87DA-1DB460D64046,"iPhone13,2"
com.apple.MobileSMS,29,1730055335,1730055364,1730055364.3617501,-18000,EB445137-D7F5-57EC-87DA-1DB460D64046,"iPhone13,2"
com.apple.MobileSMS,25,1730055302,1730055327,1730055327.46258,-18000,EB445137-D7F5-57EC-87DA-1DB460D64046,"iPhone13,2"
com.apple.MobileSMS,34,1730055262,1730055296,1730055296.19425,-18000,EB445137-D7F5-57EC-87DA-1DB460D64046,"iPhone13,2"
com.toyopagroup.picaboo,12,1730055250,1730055262,1730055262.3871331,-18000,EB445137-D7F5-57EC-87DA-1DB460D64046,"iPhone13,2"
com.toyopagroup.picaboo,10,1730054805,1730054815,1730054815.837534,-18000,EB445137-D7F5-57EC-87DA-1DB460D64046,"iPhone13,2"
com.apple.MobileSMS,3,1730054792,1730054795,1730054795.416117,-18000,EB445137-D7F5-57EC-87DA-1DB460D64046,"iPhone13,2"
com.apple.MobileSMS,6,1730054214,1730054220,1730054220.339284,-18000,EB445137-D7F5-57EC-87DA-1DB460D64046,"iPhone13,2"
com.apple.MobileSMS,2,1730054160,1730054162,1730054162.574363,-18000,EB445137-D7F5-57EC-87DA-1DB460D64046,"iPhone13,2"
com.apple.InCallService,1,1730054159,1730054160,1730054160.654508,-18000,EB445137-D7F5-57EC-87DA-1DB460D64046,"iPhone13,2"
com.apple.InCallService,4,1730052977,1730052981,1730052981.5426931,-18000,EB445137-D7F5-57EC-87DA-1DB460D64046,"iPhone13,2"
com.apple.MobileSMS,8,1730052969,1730052977,1730052977.424222,-18000,EB445137-D7F5-57EC-87DA-1DB460D64046,"iPhone13,2"
com.apple.findmy,3,1730052966,1730052969,1730052969.1963038,-18000,EB445137-D7F5-57EC-87DA-1DB460D64046,"iPhone13,2"
com.apple.findmy,6,1730052939,1730052945,1730052945.646105,-18000,EB445137-D7F5-57EC-87DA-1DB460D64046,"iPhone13,2"
com.apple.findmy,28,1730052911,1730052939,1730052939.881181,-18000,EB445137-D7F5-57EC-87DA-1DB460D64046,"iPhone13,2"
Astrospheric.Astrospheric,27,1730052884,1730052911,1730052911.6209002,-18000,EB445137-D7F5-57EC-87DA-1DB460D64046,"iPhone13,2"
com.apple.news,3,1730052879,1730052882,1730052882.746364,-18000,EB445137-D7F5-57EC-87DA-1DB460D64046,"iPhone13,2"
com.apple.news,5,1730052819,1730052824,1730052824.292047,-18000,EB445137-D7F5-57EC-87DA-1DB460D64046,"iPhone13,2"
com.apple.news,154,1730052457,1730052611,1730052612.3604388,-18000,EB445137-D7F5-57EC-87DA-1DB460D64046,"iPhone13,2"
com.apple.news,121,1730052280,1730052401,1730052401.525663,-18000,EB445137-D7F5-57EC-87DA-1DB460D64046,"iPhone13,2"
com.apple.Preferences,28,1730052234,1730052262,1730052262.885561,-18000,EB445137-D7F5-57EC-87DA-1DB460D64046,"iPhone13,2"
com.microsoft.Office.Outlook,3,1730052231,1730052234,1730052234.057423,-18000,EB445137-D7F5-57EC-87DA-1DB460D64046,"iPhone13,2"
com.microsoft.Office.Outlook,3,1730052069,1730052072,1730052072.489811,-18000,EB445137-D7F5-57EC-87DA-1DB460D64046,"iPhone13,2"
com.microsoft.Office.Outlook,45,1730051793,1730051838,1730051838.334414,-18000,EB445137-D7F5-57EC-87DA-1DB460D64046,"iPhone13,2"
com.strava.stravaride,55,1730051732,1730051787,1730051787.8879719,-18000,EB445137-D7F5-57EC-87DA-1DB460D64046,"iPhone13,2"
com.apple.Music,7,1730051725,1730051732,1730051732.431954,-18000,EB445137-D7F5-57EC-87DA-1DB460D64046,"iPhone13,2"
com.apple.Music,11,1730051141,1730051152,1730051152.28649,-18000,EB445137-D7F5-57EC-87DA-1DB460D64046,"iPhone13,2"
com.apple.camera,1,1730051141,1730051142,1730051142.282668,-18000,EB445137-D7F5-57EC-87DA-1DB460D64046,"iPhone13,2"
com.apple.Music,6,1730051011,1730051017,1730051018.013025,-18000,EB445137-D7F5-57EC-87DA-1DB460D64046,"iPhone13,2"
com.apple.Music,5,1730051003,1730051008,1730051008.193626,-18000,EB445137-D7F5-57EC-87DA-1DB460D64046,"iPhone13,2"
com.apple.camera,0,1730050940,1730050940,1730050942.354223,-18000,EB445137-D7F5-57EC-87DA-1DB460D64046,"iPhone13,2"
com.apple.Music,63,1730050939,1730051002,1730051004.038756,-18000,EB445137-D7F5-57EC-87DA-1DB460D64046,"iPhone13,2"
com.apple.Music,6,1730050933,1730050939,1730050939.297563,-18000,EB445137-D7F5-57EC-87DA-1DB460D64046,"iPhone13,2"
com.apple.Music,6,1730050118,1730050124,1730050124.590553,-18000,EB445137-D7F5-57EC-87DA-1DB460D64046,"iPhone13,2"
com.apple.Music,14,1730050103,1730050117,1730050117.980221,-18000,EB445137-D7F5-57EC-87DA-1DB460D64046,"iPhone13,2"
com.toyopagroup.picaboo,5,1730050094,1730050099,1730050099.146846,-18000,EB445137-D7F5-57EC-87DA-1DB460D64046,"iPhone13,2"
com.toyopagroup.picaboo,4,1730050079,1730050083,1730050083.980566,-18000,EB445137-D7F5-57EC-87DA-1DB460D64046,"iPhone13,2"
com.toyopagroup.picaboo,4,1730050031,1730050035,1730050040.4100251,-18000,EB445137-D7F5-57EC-87DA-1DB460D64046,"iPhone13,2"
com.apple.camera,14,1730050000,1730050014,1730050040.084445,-18000,EB445137-D7F5-57EC-87DA-1DB460D64046,"iPhone13,2"
com.clairmail.fth.client,17,1730049642,1730049659,1730049659.4789119,-18000,EB445137-D7F5-57EC-87DA-1DB460D64046,"iPhone13,2"
com.apple.MobileSMS,11,1730049631,1730049642,1730049642.096472,-18000,EB445137-D7F5-57EC-87DA-1DB460D64046,"iPhone13,2"
com.apple.MobileSMS,12,1730049599,1730049611,1730049611.818008,-18000,EB445137-D7F5-57EC-87DA-1DB460D64046,"iPhone13,2"
com.apple.MobileSMS,14,1730049568,1730049582,1730049582.715477,-18000,EB445137-D7F5-57EC-87DA-1DB460D64046,"iPhone13,2"
com.apple.MobileSMS,8,1730049540,1730049548,1730049548.9545379,-18000,EB445137-D7F5-57EC-87DA-1DB460D64046,"iPhone13,2"
com.apple.MobileSMS,19,1730049499,1730049518,1730049519.259777,-18000,EB445137-D7F5-57EC-87DA-1DB460D64046,"iPhone13,2"
com.apple.MobileSMS,79,1730049393,1730049472,1730049472.970048,-18000,EB445137-D7F5-57EC-87DA-1DB460D64046,"iPhone13,2"
com.apple.calculator,9,1730049384,1730049393,1730049393.7954211,-18000,EB445137-D7F5-57EC-87DA-1DB460D64046,"iPhone13,2"
com.apple.MobileSMS,32,1730049352,1730049384,1730049384.615604,-18000,EB445137-D7F5-57EC-87DA-1DB460D64046,"iPhone13,2"
com.apple.MobileSMS,40,1730049289,1730049329,1730049330.0216641,-18000,EB445137-D7F5-57EC-87DA-1DB460D64046,"iPhone13,2"
com.apple.calculator,74,1730049215,1730049289,1730049289.621118,-18000,EB445137-D7F5-57EC-87DA-1DB460D64046,"iPhone13,2"
com.apple.MobileSMS,22,1730049193,1730049215,1730049216.248982,-18000,EB445137-D7F5-57EC-87DA-1DB460D64046,"iPhone13,2"
com.apple.calculator,36,1730049156,1730049192,1730049193.107689,-18000,EB445137-D7F5-57EC-87DA-1DB460D64046,"iPhone13,2"
com.toyopagroup.picaboo,4,1730049152,1730049156,1730049156.4867802,-18000,EB445137-D7F5-57EC-87DA-1DB460D64046,"iPhone13,2"
com.toyopagroup.picaboo,6,1730049113,1730049119,1730049119.6328201,-18000,EB445137-D7F5-57EC-87DA-1DB460D64046,"iPhone13,2"
com.toyopagroup.picaboo,1,1730049111,1730049112,1730049112.893093,-18000,EB445137-D7F5-57EC-87DA-1DB460D64046,"iPhone13,2"
com.toyopagroup.picaboo,22,1730048892,1730048914,1730048915.047142,-18000,EB445137-D7F5-57EC-87DA-1DB460D64046,"iPhone13,2"
com.microsoft.VSCode,2,1730048382,1730048384,1730048384.2342482,-18000,,
com.leomehlig.today,144,1730048238,1730048382,1730048382.571265,-18000,,
com.microsoft.VSCode,309,1730047929,1730048238,1730048238.5751781,-18000,,
com.google.Chrome,29,1730047900,1730047929,1730047929.530468,-18000,,
com.microsoft.VSCode,2,1730047898,1730047900,1730047900.320382,-18000,,
com.google.Chrome,28,1730047870,1730047898,1730047898.121221,-18000,,
com.microsoft.VSCode,13,1730047857,1730047870,1730047870.8584309,-18000,,
com.google.Chrome,165,1730047692,1730047857,1730047857.413188,-18000,,
com.microsoft.VSCode,16,1730047676,1730047692,1730047692.8873749,-18000,,
com.google.Chrome,10,1730047666,1730047676,1730047676.587929,-18000,,
com.microsoft.VSCode,951,1730046715,1730047666,1730047666.809226,-18000,,
com.google.Chrome,4,1730046711,1730046715,1730046715.91297,-18000,,
com.microsoft.VSCode,457,1730046254,1730046711,1730046711.4121652,-18000,,
com.google.Chrome,0,1730046254,1730046254,1730046254.948194,-18000,,
com.microsoft.VSCode,22,1730046232,1730046254,1730046254.204893,-18000,,
com.google.Chrome,1,1730046231,1730046232,1730046232.6411371,-18000,,
com.microsoft.VSCode,1,1730046230,1730046231,1730046231.3887959,-18000,,
com.google.Chrome,1,1730046229,1730046230,1730046230.45033,-18000,,
com.microsoft.VSCode,1,1730046228,1730046229,1730046229.550408,-18000,,
com.google.Chrome,0,1730046228,1730046228,1730046228.843734,-18000,,
com.microsoft.VSCode,1,1730046227,1730046228,1730046228.043291,-18000,,
com.google.Chrome,1,1730046226,1730046227,1730046227.129603,-18000,,
com.microsoft.VSCode,3,1730046223,1730046226,1730046226.203246,-18000,,
com.google.Chrome,22,1730046201,1730046223,1730046223.915921,-18000,,
com.microsoft.VSCode,642,1730045559,1730046201,1730046201.168489,-18000,,
com.hnc.Discord,28,1730045531,1730045559,1730045560.028812,-18000,,
com.microsoft.VSCode,855,1730044676,1730045531,1730045531.559088,-18000,,
com.google.Chrome,117,1730044559,1730044676,1730044676.189105,-18000,,
com.microsoft.VSCode,3,1730044556,1730044559,1730044559.612712,-18000,,
com.google.Chrome,183,1730044373,1730044556,1730044556.939368,-18000,,
com.microsoft.VSCode,32,1730044341,1730044373,1730044373.602563,-18000,,
com.google.Chrome,14,1730044327,1730044341,1730044341.516066,-18000,,
com.microsoft.VSCode,14,1730044313,1730044327,1730044327.4058871,-18000,,
com.google.Chrome,223,1730044090,1730044313,1730044313.989122,-18000,,
com.microsoft.VSCode,202,1730043888,1730044090,1730044090.3030381,-18000,,
com.google.Chrome,58,1730043830,1730043888,1730043888.388773,-18000,,
com.microsoft.VSCode,45,1730043785,1730043830,1730043830.860911,-18000,,
com.google.Chrome,55,1730043730,1730043785,1730043785.649404,-18000,,
com.microsoft.VSCode,3,1730043727,1730043730,1730043730.31476,-18000,,
com.google.Chrome,6,1730043721,1730043727,1730043727.267328,-18000,,
com.microsoft.VSCode,7,1730043714,1730043721,1730043721.6996531,-18000,,
com.google.Chrome,3,1730043711,1730043714,1730043714.2966928,-18000,,
com.microsoft.VSCode,4,1730043707,1730043711,1730043711.82128,-18000,,
com.google.Chrome,80,1730043627,1730043707,1730043707.978531,-18000,,
com.microsoft.VSCode,255,1730043372,1730043627,1730043628.281661,-18000,,
com.google.Chrome,160,1730043212,1730043372,1730043372.7052789,-18000,,
com.apple.news,2,1730043045,1730043047,1730043048.017713,-18000,EB445137-D7F5-57EC-87DA-1DB460D64046,"iPhone13,2"
com.toyopagroup.picaboo,1,1730043044,1730043045,1730043046.4027681,-18000,EB445137-D7F5-57EC-87DA-1DB460D64046,"iPhone13,2"
com.toyopagroup.picaboo,6,1730043007,1730043013,1730043013.138309,-18000,EB445137-D7F5-57EC-87DA-1DB460D64046,"iPhone13,2"
com.toyopagroup.picaboo,7,1730042968,1730042975,1730042975.970371,-18000,EB445137-D7F5-57EC-87DA-1DB460D64046,"iPhone13,2"
com.apple.weather,4,1730042964,1730042968,1730042968.6006699,-18000,EB445137-D7F5-57EC-87DA-1DB460D64046,"iPhone13,2"
com.apple.weather,1,1730042861,1730042862,1730042862.2611299,-18000,EB445137-D7F5-57EC-87DA-1DB460D64046,"iPhone13,2"
com.apple.weather,7,1730042853,1730042860,1730042860.511972,-18000,EB445137-D7F5-57EC-87DA-1DB460D64046,"iPhone13,2"
com.apple.weather,21,1730041926,1730041947,1730041947.494375,-18000,EB445137-D7F5-57EC-87DA-1DB460D64046,"iPhone13,2"
com.renpho.health,3,1730041923,1730041926,1730041926.3521929,-18000,EB445137-D7F5-57EC-87DA-1DB460D64046,"iPhone13,2"
com.renpho.health,40,1730041851,1730041891,1730041891.683013,-18000,EB445137-D7F5-57EC-87DA-1DB460D64046,"iPhone13,2"
com.apple.news,378,1730040389,1730040767,1730040767.441203,-18000,EB445137-D7F5-57EC-87DA-1DB460D64046,"iPhone13,2"
com.apple.mobiletimer,13,1730007239,1730007252,1730007252.891405,-18000,EB445137-D7F5-57EC-87DA-1DB460D64046,"iPhone13,2"
com.apple.mobiletimer,9,1730007228,1730007237,1730007237.1833858,-18000,EB445137-D7F5-57EC-87DA-1DB460D64046,"iPhone13,2"
com.apple.Passwords,10,1730006428,1730006438,1730006438.7788901,-18000,EB445137-D7F5-57EC-87DA-1DB460D64046,"iPhone13,2"
com.apple.Passwords,62,1730006365,1730006427,1730006427.448858,-18000,EB445137-D7F5-57EC-87DA-1DB460D64046,"iPhone13,2"
com.apple.Health,28,1730005433,1730005461,1730005461.5898418,-18000,EB445137-D7F5-57EC-87DA-1DB460D64046,"iPhone13,2"
com.apple.Music,3,1730005347,1730005350,1730005350.488934,-18000,EB445137-D7F5-57EC-87DA-1DB460D64046,"iPhone13,2"
com.apple.Music,15,1730005331,1730005346,1730005346.975132,-18000,EB445137-D7F5-57EC-87DA-1DB460D64046,"iPhone13,2"
com.apple.Music,10,1730005059,1730005069,1730005069.679337,-18000,EB445137-D7F5-57EC-87DA-1DB460D64046,"iPhone13,2"
com.apple.Music,2,1730002795,1730002797,1730002797.512768,-18000,EB445137-D7F5-57EC-87DA-1DB460D64046,"iPhone13,2"
com.apple.Music,5,1730002789,1730002794,1730002794.631761,-18000,EB445137-D7F5-57EC-87DA-1DB460D64046,"iPhone13,2"
com.apple.Music,12,1730002762,1730002774,1730002774.748182,-18000,EB445137-D7F5-57EC-87DA-1DB460D64046,"iPhone13,2"
com.t11.celeste,2,1730002760,1730002762,1730002762.751144,-18000,EB445137-D7F5-57EC-87DA-1DB460D64046,"iPhone13,2"
com.t11.celeste,2,1730002629,1730002631,1730002631.838,-18000,EB445137-D7F5-57EC-87DA-1DB460D64046,"iPhone13,2"
com.t11.celeste,37,1730000592,1730000629,1730000629.7524161,-18000,EB445137-D7F5-57EC-87DA-1DB460D64046,"iPhone13,2"
com.apple.Music,3,1730000585,1730000588,1730000588.593804,-18000,EB445137-D7F5-57EC-87DA-1DB460D64046,"iPhone13,2"
com.apple.camera,54,1729998719,1729998773,1729998774.222775,-18000,EB445137-D7F5-57EC-87DA-1DB460D64046,"iPhone13,2"
com.apple.Music,56,1729998717,1729998773,1729998774.218886,-18000,EB445137-D7F5-57EC-87DA-1DB460D64046,"iPhone13,2"
com.apple.Music,48,1729994359,1729994407,1729994407.446034,-18000,EB445137-D7F5-57EC-87DA-1DB460D64046,"iPhone13,2"
com.apple.Music,12,1729993246,1729993258,1729993258.3075938,-18000,EB445137-D7F5-57EC-87DA-1DB460D64046,"iPhone13,2"
com.apple.Music,13,1729991731,1729991744,1729991745.096661,-18000,EB445137-D7F5-57EC-87DA-1DB460D64046,"iPhone13,2"
Astrospheric.Astrospheric,2,1729991726,1729991728,1729991729.4869761,-18000,EB445137-D7F5-57EC-87DA-1DB460D64046,"iPhone13,2"
Astrospheric.Astrospheric,2,1729991559,1729991561,1729991561.8407102,-18000,EB445137-D7F5-57EC-87DA-1DB460D64046,"iPhone13,2"
Astrospheric.Astrospheric,17,1729991502,1729991519,1729991519.485223,-18000,EB445137-D7F5-57EC-87DA-1DB460D64046,"iPhone13,2"
Astrospheric.Astrospheric,3,1729990807,1729990810,1729990810.121839,-18000,EB445137-D7F5-57EC-87DA-1DB460D64046,"iPhone13,2"
Astrospheric.Astrospheric,8,1729990660,1729990668,1729990668.2405071,-18000,EB445137-D7F5-57EC-87DA-1DB460D64046,"iPhone13,2"
com.apple.camera,3,1729990617,1729990620,1729990620.950104,-18000,EB445137-D7F5-57EC-87DA-1DB460D64046,"iPhone13,2"
Astrospheric.Astrospheric,12,1729990615,1729990627,1729990627.218451,-18000,EB445137-D7F5-57EC-87DA-1DB460D64046,"iPhone13,2"
com.apple.camera,1,1729990583,1729990584,1729990584.446384,-18000,EB445137-D7F5-57EC-87DA-1DB460D64046,"iPhone13,2"
Astrospheric.Astrospheric,47,1729990543,1729990590,1729990590.872607,-18000,EB445137-D7F5-57EC-87DA-1DB460D64046,"iPhone13,2"
Astrospheric.Astrospheric,10,1729990471,1729990481,1729990481.052672,-18000,EB445137-D7F5-57EC-87DA-1DB460D64046,"iPhone13,2"
Astrospheric.Astrospheric,2,1729990424,1729990426,1729990427.055393,-18000,EB445137-D7F5-57EC-87DA-1DB460D64046,"iPhone13,2"
Astrospheric.Astrospheric,3,1729990415,1729990418,1729990418.2090302,-18000,EB445137-D7F5-57EC-87DA-1DB460D64046,"iPhone13,2"
Astrospheric.Astrospheric,17,1729990324,1729990341,1729990341.617618,-18000,EB445137-D7F5-57EC-87DA-1DB460D64046,"iPhone13,2"
com.apple.weather,2,1729990322,1729990324,1729990324.767836,-18000,EB445137-D7F5-57EC-87DA-1DB460D64046,"iPhone13,2"
com.apple.weather,11,1729990160,1729990171,1729990171.5165858,-18000,EB445137-D7F5-57EC-87DA-1DB460D64046,"iPhone13,2"
com.apple.weather,3,1729990099,1729990102,1729990102.6199899,-18000,EB445137-D7F5-57EC-87DA-1DB460D64046,"iPhone13,2"
com.apple.weather,2,1729989870,1729989872,1729989872.441081,-18000,EB445137-D7F5-57EC-87DA-1DB460D64046,"iPhone13,2"
com.apple.weather,3,1729989633,1729989636,1729989636.3402638,-18000,EB445137-D7F5-57EC-87DA-1DB460D64046,"iPhone13,2"
com.apple.weather,6,1729989352,1729989358,1729989358.9806662,-18000,EB445137-D7F5-57EC-87DA-1DB460D64046,"iPhone13,2"
com.apple.weather,15,1729989317,1729989332,1729989332.991149,-18000,EB445137-D7F5-57EC-87DA-1DB460D64046,"iPhone13,2"
com.apple.weather,1,1729989020,1729989021,1729989021.247922,-18000,EB445137-D7F5-57EC-87DA-1DB460D64046,"iPhone13,2"
com.apple.weather,65,1729988841,1729988906,1729988906.325294,-18000,EB445137-D7F5-57EC-87DA-1DB460D64046,"iPhone13,2"
com.apple.news,2,1729988839,1729988841,1729988841.454576,-18000,EB445137-D7F5-57EC-87DA-1DB460D64046,"iPhone13,2"
com.apple.news,106,1729988591,1729988697,1729988698.091762,-18000,EB445137-D7F5-57EC-87DA-1DB460D64046,"iPhone13,2"
Astrospheric.Astrospheric,17,1729988562,1729988579,1729988579.983495,-18000,EB445137-D7F5-57EC-87DA-1DB460D64046,"iPhone13,2"
com.apple.news,4,1729978469,1729978473,1729978473.8849502,-18000,EB445137-D7F5-57EC-87DA-1DB460D64046,"iPhone13,2"
com.apple.news,17,1729976718,1729976735,1729976735.614547,-18000,EB445137-D7F5-57EC-87DA-1DB460D64046,"iPhone13,2"
com.toyopagroup.picaboo,103,1729976606,1729976709,1729976709.786365,-18000,EB445137-D7F5-57EC-87DA-1DB460D64046,"iPhone13,2"
com.hammerandchisel.discord,13,1729976593,1729976606,1729976606.842231,-18000,EB445137-D7F5-57EC-87DA-1DB460D64046,"iPhone13,2"
com.toyopagroup.picaboo,32,1729976561,1729976593,1729976594.063788,-18000,EB445137-D7F5-57EC-87DA-1DB460D64046,"iPhone13,2"
com.instructure.icanvas,9,1729976548,1729976557,1729976557.3051162,-18000,EB445137-D7F5-57EC-87DA-1DB460D64046,"iPhone13,2"
com.hammerandchisel.discord,48,1729976497,1729976545,1729976545.1801028,-18000,EB445137-D7F5-57EC-87DA-1DB460D64046,"iPhone13,2"
com.hammerandchisel.discord,3,1729976452,1729976455,1729976455.5119839,-18000,EB445137-D7F5-57EC-87DA-1DB460D64046,"iPhone13,2"
com.hammerandchisel.discord,4,1729976393,1729976397,1729976397.917445,-18000,EB445137-D7F5-57EC-87DA-1DB460D64046,"iPhone13,2"
com.hammerandchisel.discord,11,1729976325,1729976336,1729976336.9848819,-18000,EB445137-D7F5-57EC-87DA-1DB460D64046,"iPhone13,2"
com.hammerandchisel.discord,6,1729976266,1729976272,1729976272.723542,-18000,EB445137-D7F5-57EC-87DA-1DB460D64046,"iPhone13,2"
com.hammerandchisel.discord,12,1729976206,1729976218,1729976218.6930041,-18000,EB445137-D7F5-57EC-87DA-1DB460D64046,"iPhone13,2"
com.apple.MobileSMS,4,1729976169,1729976173,1729976173.8588228,-18000,EB445137-D7F5-57EC-87DA-1DB460D64046,"iPhone13,2"
com.apple.MobileSMS,6,1729975121,1729975127,1729975127.425978,-18000,EB445137-D7F5-57EC-87DA-1DB460D64046,"iPhone13,2"
com.apple.MobileSMS,2,1729974949,1729974951,1729974951.531934,-18000,EB445137-D7F5-57EC-87DA-1DB460D64046,"iPhone13,2"
com.apple.camera,1,1729974841,1729974842,1729974842.159894,-18000,EB445137-D7F5-57EC-87DA-1DB460D64046,"iPhone13,2"
com.apple.MobileSMS,51,1729974740,1729974791,1729974791.9525208,-18000,EB445137-D7F5-57EC-87DA-1DB460D64046,"iPhone13,2"
com.google.ios.youtube,1,1729974739,1729974740,1729974741.300922,-18000,EB445137-D7F5-57EC-87DA-1DB460D64046,"iPhone13,2"
com.google.ios.youtube,12,1729973388,1729973400,1729973400.342504,-18000,EB445137-D7F5-57EC-87DA-1DB460D64046,"iPhone13,2"
com.google.Chrome,10,1729972659,1729972669,1729972669.918385,-18000,,
com.leomehlig.today,158,1729972501,1729972659,1729972659.781234,-18000,,
com.google.ios.youtube,7,1729972422,1729972429,1729972429.957292,-18000,EB445137-D7F5-57EC-87DA-1DB460D64046,"iPhone13,2"
com.microsoft.Office.Outlook,4,1729972418,1729972422,1729972422.596581,-18000,EB445137-D7F5-57EC-87DA-1DB460D64046,"iPhone13,2"
com.microsoft.VSCode,272,1729972229,1729972501,1729972501.259344,-18000,,
com.microsoft.Office.Outlook,10,1729972205,1729972215,1729972215.342515,-18000,EB445137-D7F5-57EC-87DA-1DB460D64046,"iPhone13,2"
com.google.Chrome,309,1729971920,1729972229,1729972229.581489,-18000,,
com.microsoft.VSCode,1,1729971919,1729971920,1729971920.997714,-18000,,
com.microsoft.Office.Outlook,45,1729971624,1729971669,1729971670.272067,-18000,EB445137-D7F5-57EC-87DA-1DB460D64046,"iPhone13,2"
com.hammerandchisel.discord,35,1729971589,1729971624,1729971624.520684,-18000,EB445137-D7F5-57EC-87DA-1DB460D64046,"iPhone13,2"
com.toyopagroup.picaboo,16,1729971572,1729971588,1729971588.328685,-18000,EB445137-D7F5-57EC-87DA-1DB460D64046,"iPhone13,2"
com.apple.mobiletimer,8,1729971564,1729971572,1729971573.006386,-18000,EB445137-D7F5-57EC-87DA-1DB460D64046,"iPhone13,2"
com.microsoft.VSCode,651,1729970534,1729971185,1729971185.595809,-18000,,
com.google.Chrome,11,1729970523,1729970534,1729970534.526208,-18000,,
com.microsoft.VSCode,1,1729970522,1729970523,1729970523.613377,-18000,,
com.google.Chrome,60,1729970462,1729970522,1729970522.794742,-18000,,
com.microsoft.VSCode,26,1729970436,1729970462,1729970462.085641,-18000,,
com.google.Chrome,15,1729970421,1729970436,1729970436.6573992,-18000,,
com.microsoft.VSCode,214,1729970207,1729970421,1729970421.1896381,-18000,,
com.google.Chrome,43,1729970164,1729970207,1729970207.765656,-18000,,
com.microsoft.VSCode,45,1729970119,1729970164,1729970164.9024,-18000,,
com.google.Chrome,73,1729970046,1729970119,1729970119.705632,-18000,,
com.google.Chrome,538,1729969454,1729969992,1729969992.8507528,-18000,,
com.microsoft.VSCode,1111,1729968343,1729969454,1729969454.350154,-18000,,
com.google.Chrome,1,1729968342,1729968343,1729968343.2167048,-18000,,
com.microsoft.VSCode,258,1729968084,1729968342,1729968342.286878,-18000,,
com.google.Chrome,68,1729968016,1729968084,1729968084.4867458,-18000,,
com.microsoft.VSCode,29,1729967987,1729968016,1729968016.730517,-18000,,
com.google.Chrome,5,1729967982,1729967987,1729967987.883655,-18000,,
com.microsoft.VSCode,21,1729967961,1729967982,1729967982.606082,-18000,,
com.google.Chrome,16,1729967945,1729967961,1729967961.153782,-18000,,
com.microsoft.VSCode,12,1729967933,1729967945,1729967945.3023028,-18000,,
com.google.Chrome,25,1729967908,1729967933,1729967933.441611,-18000,,
com.microsoft.VSCode,8,1729967900,1729967908,1729967908.430176,-18000,,
com.google.Chrome,16,1729967884,1729967900,1729967900.508603,-18000,,
com.microsoft.VSCode,494,1729967390,1729967884,1729967884.279105,-18000,,
com.google.Chrome,3,1729967387,1729967390,1729967390.4390512,-18000,,
com.hnc.Discord,1,1729967386,1729967387,1729967387.7394729,-18000,,
com.google.Chrome,102,1729967284,1729967386,1729967386.552814,-18000,,
com.hnc.Discord,2,1729967282,1729967284,1729967284.291798,-18000,,
com.microsoft.VSCode,11,1729967271,1729967282,1729967282.367581,-18000,,
com.google.Chrome,2,1729967269,1729967271,1729967271.3053179,-18000,,
com.microsoft.VSCode,2,1729967267,1729967269,1729967269.7700338,-18000,,
com.google.Chrome,26,1729967241,1729967267,1729967267.261375,-18000,,
com.microsoft.VSCode,178,1729967063,1729967241,1729967241.830523,-18000,,
com.google.Chrome,7,1729967056,1729967063,1729967063.088161,-18000,,
com.microsoft.VSCode,19,1729967037,1729967056,1729967056.5086598,-18000,,
com.apple.mobiletimer,4,1729967019,1729967023,1729967024.0520759,-18000,EB445137-D7F5-57EC-87DA-1DB460D64046,"iPhone13,2"
com.google.Chrome,235,1729966802,1729967037,1729967037.3324862,-18000,,
com.microsoft.VSCode,6,1729966796,1729966802,1729966802.417232,-18000,,
com.google.Chrome,4,1729966792,1729966796,1729966796.3567672,-18000,,
com.microsoft.VSCode,7,1729966785,1729966792,1729966792.913968,-18000,,
com.google.Chrome,21,1729966764,1729966785,1729966785.78987,-18000,,
com.microsoft.VSCode,21,1729966743,1729966764,1729966764.528718,-18000,,
com.google.Chrome,12,1729966731,1729966743,1729966743.436125,-18000,,
com.hnc.Discord,47,1729966684,1729966731,1729966731.055187,-18000,,
com.google.Chrome,46,1729966638,1729966684,1729966684.639813,-18000,,
com.hnc.Discord,1,1729966637,1729966638,1729966638.479116,-18000,,
com.microsoft.VSCode,2,1729966635,1729966637,1729966637.367073,-18000,,
com.hnc.Discord,1,1729966634,1729966635,1729966635.089325,-18000,,
com.google.Chrome,4,1729966630,1729966634,1729966634.161481,-18000,,
com.hnc.Discord,3,1729966627,1729966630,1729966630.0665832,-18000,,
com.google.Chrome,5,1729966622,1729966627,1729966627.406488,-18000,,
com.microsoft.VSCode,8,1729966614,1729966622,1729966622.275269,-18000,,
com.hnc.Discord,14,1729966600,1729966614,1729966614.702066,-18000,,
com.microsoft.VSCode,556,1729966044,1729966600,1729966601.026339,-18000,,
com.google.Chrome,30,1729966014,1729966044,1729966044.910126,-18000,,
com.microsoft.VSCode,7,1729966007,1729966014,1729966014.368188,-18000,,
com.google.Chrome,99,1729965908,1729966007,1729966007.3863401,-18000,,
com.microsoft.VSCode,259,1729965649,1729965908,1729965908.53234,-18000,,
com.apple.finder,58,1729965591,1729965649,1729965649.1524959,-18000,,
com.google.Chrome,115,1729965476,1729965591,1729965591.64834,-18000,,
com.microsoft.VSCode,32,1729965430,1729965462,1729965462.2957,-18000,,
com.leomehlig.today,42,1729965388,1729965430,1729965430.7682118,-18000,,
com.google.Chrome,5,1729965383,1729965388,1729965388.641762,-18000,,
com.apple.mobiletimer,5,1729964714,1729964719,1729964719.68262,-18000,EB445137-D7F5-57EC-87DA-1DB460D64046,"iPhone13,2"
com.apple.mobiletimer,6,1729964612,1729964618,1729964618.6553578,-18000,EB445137-D7F5-57EC-87DA-1DB460D64046,"iPhone13,2"
com.apple.mobiletimer,17,1729964183,1729964200,1729964201.1329288,-18000,EB445137-D7F5-57EC-87DA-1DB460D64046,"iPhone13,2"
com.apple.mobiletimer,2,1729963785,1729963787,1729963787.2457519,-18000,EB445137-D7F5-57EC-87DA-1DB460D64046,"iPhone13,2"
com.apple.mobiletimer,7,1729963653,1729963660,1729963660.486486,-18000,EB445137-D7F5-57EC-87DA-1DB460D64046,"iPhone13,2"
com.apple.mobiletimer,124,1729963470,1729963594,1729963594.316021,-18000,EB445137-D7F5-57EC-87DA-1DB460D64046,"iPhone13,2"
com.apple.mobiletimer,24,1729963379,1729963403,1729963404.1050649,-18000,EB445137-D7F5-57EC-87DA-1DB460D64046,"iPhone13,2"
com.apple.news,104,1729963274,1729963378,1729963378.98948,-18000,EB445137-D7F5-57EC-87DA-1DB460D64046,"iPhone13,2"
com.apple.mobiletimer,2,1729963272,1729963274,1729963274.2581248,-18000,EB445137-D7F5-57EC-87DA-1DB460D64046,"iPhone13,2"
com.apple.news,2,1729963270,1729963272,1729963272.6203132,-18000,EB445137-D7F5-57EC-87DA-1DB460D64046,"iPhone13,2"
com.apple.news,6,1729963104,1729963110,1729963110.086901,-18000,EB445137-D7F5-57EC-87DA-1DB460D64046,"iPhone13,2"
com.apple.news,11,1729963083,1729963094,1729963094.874445,-18000,EB445137-D7F5-57EC-87DA-1DB460D64046,"iPhone13,2"
com.apple.mobiletimer,3,1729963080,1729963083,1729963083.634179,-18000,EB445137-D7F5-57EC-87DA-1DB460D64046,"iPhone13,2"
com.apple.mobiletimer,2,1729963042,1729963044,1729963045.215989,-18000,EB445137-D7F5-57EC-87DA-1DB460D64046,"iPhone13,2"
com.apple.news,65,1729962977,1729963042,1729963042.296115,-18000,EB445137-D7F5-57EC-87DA-1DB460D64046,"iPhone13,2"
com.instructure.icanvas,4,1729962960,1729962964,1729962965.359312,-18000,EB445137-D7F5-57EC-87DA-1DB460D64046,"iPhone13,2"
com.apple.mobiletimer,137,1729962823,1729962960,1729962960.477149,-18000,EB445137-D7F5-57EC-87DA-1DB460D64046,"iPhone13,2"
com.microsoft.Office.Outlook,1,1729962822,1729962823,1729962823.797888,-18000,EB445137-D7F5-57EC-87DA-1DB460D64046,"iPhone13,2"
com.microsoft.Office.Outlook,21,1729962776,1729962797,1729962798.483135,-18000,EB445137-D7F5-57EC-87DA-1DB460D64046,"iPhone13,2"
com.google.chrome.ios,28,1729962743,1729962771,1729962771.9169931,-18000,EB445137-D7F5-57EC-87DA-1DB460D64046,"iPhone13,2"
com.apple.mobiletimer,4,1729962739,1729962743,1729962743.0641952,-18000,EB445137-D7F5-57EC-87DA-1DB460D64046,"iPhone13,2"
com.apple.mobiletimer,8,1729962513,1729962521,1729962521.564825,-18000,EB445137-D7F5-57EC-87DA-1DB460D64046,"iPhone13,2"
com.apple.mobiletimer,3,1729962503,1729962506,1729962506.509009,-18000,EB445137-D7F5-57EC-87DA-1DB460D64046,"iPhone13,2"
com.apple.mobiletimer,79,1729962387,1729962466,1729962467.175698,-18000,EB445137-D7F5-57EC-87DA-1DB460D64046,"iPhone13,2"
Astrospheric.Astrospheric,22,1729962363,1729962385,1729962385.692491,-18000,EB445137-D7F5-57EC-87DA-1DB460D64046,"iPhone13,2"
com.hammerandchisel.discord,7,1729962355,1729962362,1729962362.8414001,-18000,EB445137-D7F5-57EC-87DA-1DB460D64046,"iPhone13,2"
com.apple.mobiletimer,303,1729962052,1729962355,1729962355.6559792,-18000,EB445137-D7F5-57EC-87DA-1DB460D64046,"iPhone13,2"
com.instructure.icanvas,14,1729962016,1729962030,1729962030.79176,-18000,EB445137-D7F5-57EC-87DA-1DB460D64046,"iPhone13,2"
com.myfitnesspal.mfp,8,1729962008,1729962016,1729962016.742017,-18000,EB445137-D7F5-57EC-87DA-1DB460D64046,"iPhone13,2"
com.myfitnesspal.mfp,46,1729960999,1729961045,1729961045.517242,-18000,EB445137-D7F5-57EC-87DA-1DB460D64046,"iPhone13,2"
com.apple.camera,5,1729960934,1729960939,1729960940.3677258,-18000,EB445137-D7F5-57EC-87DA-1DB460D64046,"iPhone13,2"
com.google.Chrome,844,1729959711,1729960555,1729960555.581614,-18000,,
com.apple.MobileSMS,5,1729959327,1729959332,1729959332.0731502,-18000,EB445137-D7F5-57EC-87DA-1DB460D64046,"iPhone13,2"
com.apple.camera,0,1729959276,1729959276,1729959276.976654,-18000,EB445137-D7F5-57EC-87DA-1DB460D64046,"iPhone13,2"
com.apple.MobileSMS,6,1729959070,1729959076,1729959077.218153,-18000,EB445137-D7F5-57EC-87DA-1DB460D64046,"iPhone13,2"
com.apple.MobileSMS,14,1729958715,1729958729,1729958729.525492,-18000,EB445137-D7F5-57EC-87DA-1DB460D64046,"iPhone13,2"
com.apple.MobileSMS,6,1729958626,1729958632,1729958632.729523,-18000,EB445137-D7F5-57EC-87DA-1DB460D64046,"iPhone13,2"
com.apple.MobileSMS,8,1729958618,1729958626,1729958626.559458,-18000,EB445137-D7F5-57EC-87DA-1DB460D64046,"iPhone13,2"
com.apple.MobileSMS,6,1729958501,1729958507,1729958507.804007,-18000,EB445137-D7F5-57EC-87DA-1DB460D64046,"iPhone13,2"
com.google.chrome.ios,10,1729958491,1729958501,1729958501.642375,-18000,EB445137-D7F5-57EC-87DA-1DB460D64046,"iPhone13,2"
com.apple.MobileSMS,11,1729958480,1729958491,1729958491.953146,-18000,EB445137-D7F5-57EC-87DA-1DB460D64046,"iPhone13,2"
com.truebill.truebillnative,42,1729957830,1729957872,1729957873.059653,-18000,EB445137-D7F5-57EC-87DA-1DB460D64046,"iPhone13,2"
com.apple.news,1,1729957824,1729957825,1729957825.89436,-18000,EB445137-D7F5-57EC-87DA-1DB460D64046,"iPhone13,2"
com.hammerandchisel.discord,31,1729957781,1729957812,1729957812.7255468,-18000,EB445137-D7F5-57EC-87DA-1DB460D64046,"iPhone13,2"
com.apple.Health,85,1729957694,1729957779,1729957779.595755,-18000,EB445137-D7F5-57EC-87DA-1DB460D64046,"iPhone13,2"
com.apple.weather,4,1729957690,1729957694,1729957695.063241,-18000,EB445137-D7F5-57EC-87DA-1DB460D64046,"iPhone13,2"
com.google.Chrome,222,1729957677,1729957899,1729957899.921135,-18000,,
com.leomehlig.today,22,1729957655,1729957677,1729957677.036796,-18000,,
com.google.Chrome,15,1729957640,1729957655,1729957655.655801,-18000,,
com.apple.finder,5,1729957635,1729957640,1729957640.767688,-18000,,
com.apple.iCal,29,1729957606,1729957635,1729957635.415525,-18000,,
com.apple.finder,14,1729957592,1729957606,1729957606.068991,-18000,,
com.google.Chrome,4,1729957588,1729957592,1729957592.525795,-18000,,
com.apple.iCal,61,1729957527,1729957588,1729957589.024281,-18000,,
com.google.Chrome,2,1729957525,1729957527,1729957527.855914,-18000,,
com.apple.iCal,20,1729957505,1729957525,1729957525.197966,-18000,,
com.google.Chrome,82,1729957423,1729957505,1729957505.180176,-18000,,
com.leomehlig.today,92,1729957331,1729957423,1729957423.2635732,-18000,,
com.google.Chrome,5,1729957326,1729957331,1729957332.039387,-18000,,
com.apple.weather,4,1729957186,1729957190,1729957190.805249,-18000,EB445137-D7F5-57EC-87DA-1DB460D64046,"iPhone13,2"
com.apple.weather,61,1729956825,1729956886,1729956887.134618,-18000,EB445137-D7F5-57EC-87DA-1DB460D64046,"iPhone13,2"
com.myfitnesspal.mfp,4,1729956820,1729956824,1729956824.899775,-18000,EB445137-D7F5-57EC-87DA-1DB460D64046,"iPhone13,2"
com.myfitnesspal.mfp,7,1729956757,1729956764,1729956765.686665,-18000,EB445137-D7F5-57EC-87DA-1DB460D64046,"iPhone13,2"
com.apple.Health,2,1729956755,1729956757,1729956761.328609,-18000,EB445137-D7F5-57EC-87DA-1DB460D64046,"iPhone13,2"
com.apple.Health,4,1729956750,1729956754,1729956757.247153,-18000,EB445137-D7F5-57EC-87DA-1DB460D64046,"iPhone13,2"
com.myfitnesspal.mfp,92,1729956658,1729956750,1729956750.637464,-18000,EB445137-D7F5-57EC-87DA-1DB460D64046,"iPhone13,2"
com.apple.calculator,6,1729956652,1729956658,1729956659.586112,-18000,EB445137-D7F5-57EC-87DA-1DB460D64046,"iPhone13,2"
com.myfitnesspal.mfp,71,1729956581,1729956652,1729956652.335345,-18000,EB445137-D7F5-57EC-87DA-1DB460D64046,"iPhone13,2"
com.apple.Health,17,1729956562,1729956579,1729956579.6800508,-18000,EB445137-D7F5-57EC-87DA-1DB460D64046,"iPhone13,2"
com.renpho.health,17,1729956545,1729956562,1729956562.6888862,-18000,EB445137-D7F5-57EC-87DA-1DB460D64046,"iPhone13,2"
com.hammerandchisel.discord,59,1729956450,1729956509,1729956509.503705,-18000,EB445137-D7F5-57EC-87DA-1DB460D64046,"iPhone13,2"
Astrospheric.Astrospheric,33,1729956415,1729956448,1729956448.553889,-18000,EB445137-D7F5-57EC-87DA-1DB460D64046,"iPhone13,2"
com.google.ios.youtube,1546,1729953619,1729955165,1729955166.08112,-18000,EB445137-D7F5-57EC-87DA-1DB460D64046,"iPhone13,2"
com.google.Chrome,2,1729923325,1729923327,1729923327.838499,-18000,,
com.google.Chrome,754,1729922383,1729923137,1729923137.4413052,-18000,,
com.google.Chrome,654,1729921431,1729922085,1729922085.194312,-18000,,
com.google.Chrome,521,1729920522,1729921043,1729921043.78561,-18000,,
com.hammerandchisel.discord,8,1729920225,1729920233,1729920233.433433,-18000,EB445137-D7F5-57EC-87DA-1DB460D64046,"iPhone13,2"
Astrospheric.Astrospheric,17,1729920202,1729920219,1729920220.1217089,-18000,EB445137-D7F5-57EC-87DA-1DB460D64046,"iPhone13,2"
com.hammerandchisel.discord,50,1729920148,1729920198,1729920198.734713,-18000,EB445137-D7F5-57EC-87DA-1DB460D64046,"iPhone13,2"
com.google.Chrome,302,1729920144,1729920446,1729920446.177827,-18000,,
com.apple.finder,2,1729920142,1729920144,1729920144.284178,-18000,,
com.microsoft.VSCode,524,1729919618,1729920142,1729920142.902483,-18000,,
com.apple.finder,8,1729919610,1729919618,1729919618.797069,-18000,,
com.microsoft.VSCode,6,1729919604,1729919610,1729919610.2942371,-18000,,
com.apple.MobileSMS,3,1729919601,1729919604,1729919604.644898,-18000,,
com.hammerandchisel.discord,4,1729919594,1729919598,1729919598.728401,-18000,EB445137-D7F5-57EC-87DA-1DB460D64046,"iPhone13,2"
com.hammerandchisel.discord,10,1729919223,1729919233,1729919233.912849,-18000,EB445137-D7F5-57EC-87DA-1DB460D64046,"iPhone13,2"
com.hammerandchisel.discord,17,1729919202,1729919219,1729919219.81885,-18000,EB445137-D7F5-57EC-87DA-1DB460D64046,"iPhone13,2"
com.google.chrome.ios,4,1729919194,1729919198,1729919198.150406,-18000,EB445137-D7F5-57EC-87DA-1DB460D64046,"iPhone13,2"
com.google.chrome.ios,10,1729919182,1729919192,1729919192.766187,-18000,EB445137-D7F5-57EC-87DA-1DB460D64046,"iPhone13,2"
com.google.chrome.ios,5,1729914073,1729914078,1729914078.789188,-18000,EB445137-D7F5-57EC-87DA-1DB460D64046,"iPhone13,2"
com.google.chrome.ios,6,1729913806,1729913812,1729913812.8277369,-18000,EB445137-D7F5-57EC-87DA-1DB460D64046,"iPhone13,2"
com.google.chrome.ios,104,1729911465,1729911569,1729911570.364485,-18000,EB445137-D7F5-57EC-87DA-1DB460D64046,"iPhone13,2"
com.toyopagroup.picaboo,11,1729911453,1729911464,1729911465.086882,-18000,EB445137-D7F5-57EC-87DA-1DB460D64046,"iPhone13,2"
com.apple.camera,1,1729907909,1729907910,1729907910.07641,-18000,EB445137-D7F5-57EC-87DA-1DB460D64046,"iPhone13,2"
com.apple.camera,0,1729907909,1729907909,1729907909.5813022,-18000,EB445137-D7F5-57EC-87DA-1DB460D64046,"iPhone13,2"
com.apple.camera,0,1729907907,1729907907,1729907908.0084229,-18000,EB445137-D7F5-57EC-87DA-1DB460D64046,"iPhone13,2"
com.apple.camera,0,1729907905,1729907905,1729907905.345927,-18000,EB445137-D7F5-57EC-87DA-1DB460D64046,"iPhone13,2"
com.toyopagroup.picaboo,15,1729907903,1729907918,1729907918.151284,-18000,EB445137-D7F5-57EC-87DA-1DB460D64046,"iPhone13,2"
com.toyopagroup.picaboo,3,1729907889,1729907892,1729907892.261734,-18000,EB445137-D7F5-57EC-87DA-1DB460D64046,"iPhone13,2"
com.apple.camera,1,1729907889,1729907890,1729907891.0777001,-18000,EB445137-D7F5-57EC-87DA-1DB460D64046,"iPhone13,2"
com.toyopagroup.picaboo,6,1729907881,1729907887,1729907887.621711,-18000,EB445137-D7F5-57EC-87DA-1DB460D64046,"iPhone13,2"
com.toyopagroup.picaboo,7,1729907860,1729907867,1729907867.6867619,-18000,EB445137-D7F5-57EC-87DA-1DB460D64046,"iPhone13,2"
com.apple.camera,0,1729907851,1729907851,1729907851.398027,-18000,EB445137-D7F5-57EC-87DA-1DB460D64046,"iPhone13,2"
com.toyopagroup.picaboo,10,1729907847,1729907857,1729907857.6959739,-18000,EB445137-D7F5-57EC-87DA-1DB460D64046,"iPhone13,2"
com.toyopagroup.picaboo,20,1729907294,1729907314,1729907314.888472,-18000,EB445137-D7F5-57EC-87DA-1DB460D64046,"iPhone13,2"
com.apple.MobileSMS,6,1729907281,1729907287,1729907287.823934,-18000,EB445137-D7F5-57EC-87DA-1DB460D64046,"iPhone13,2"
com.apple.MobileSMS,11,1729906647,1729906658,1729906658.68998,-18000,EB445137-D7F5-57EC-87DA-1DB460D64046,"iPhone13,2"
com.apple.MobileSMS,9,1729905877,1729905886,1729905886.651528,-18000,EB445137-D7F5-57EC-87DA-1DB460D64046,"iPhone13,2"
com.apple.MobileSMS,3,1729905873,1729905876,1729905876.144223,-18000,EB445137-D7F5-57EC-87DA-1DB460D64046,"iPhone13,2"
com.apple.MobileSMS,47,1729905826,1729905873,1729905873.751658,-18000,EB445137-D7F5-57EC-87DA-1DB460D64046,"iPhone13,2"
com.apple.MobileSMS,16,1729905659,1729905675,1729905675.9734058,-18000,EB445137-D7F5-57EC-87DA-1DB460D64046,"iPhone13,2"
com.apple.MobileSMS,4,1729905428,1729905432,1729905432.663725,-18000,EB445137-D7F5-57EC-87DA-1DB460D64046,"iPhone13,2"
com.apple.MobileSMS,3,1729905420,1729905423,1729905423.154492,-18000,EB445137-D7F5-57EC-87DA-1DB460D64046,"iPhone13,2"
com.apple.MobileSMS,9,1729905359,1729905368,1729905368.2582688,-18000,EB445137-D7F5-57EC-87DA-1DB460D64046,"iPhone13,2"
com.google.chrome.ios,2,1729905357,1729905359,1729905359.480877,-18000,EB445137-D7F5-57EC-87DA-1DB460D64046,"iPhone13,2"
com.google.chrome.ios,7,1729905349,1729905356,1729905356.642044,-18000,EB445137-D7F5-57EC-87DA-1DB460D64046,"iPhone13,2"
com.google.chrome.ios,5,1729905333,1729905338,1729905338.226881,-18000,EB445137-D7F5-57EC-87DA-1DB460D64046,"iPhone13,2"
com.google.chrome.ios,6,1729905039,1729905045,1729905045.2909899,-18000,EB445137-D7F5-57EC-87DA-1DB460D64046,"iPhone13,2"
com.google.chrome.ios,83,1729904955,1729905038,1729905038.805299,-18000,EB445137-D7F5-57EC-87DA-1DB460D64046,"iPhone13,2"
com.google.chrome.ios,9,1729904596,1729904605,1729904605.154588,-18000,EB445137-D7F5-57EC-87DA-1DB460D64046,"iPhone13,2"
com.google.chrome.ios,10,1729904583,1729904593,1729904593.673338,-18000,EB445137-D7F5-57EC-87DA-1DB460D64046,"iPhone13,2"
com.google.chrome.ios,363,1729903904,1729904267,1729904267.6630259,-18000,EB445137-D7F5-57EC-87DA-1DB460D64046,"iPhone13,2"
com.google.chrome.ios,10,1729903893,1729903903,1729903903.7454329,-18000,EB445137-D7F5-57EC-87DA-1DB460D64046,"iPhone13,2"
com.google.chrome.ios,6,1729901164,1729901170,1729901170.727751,-18000,EB445137-D7F5-57EC-87DA-1DB460D64046,"iPhone13,2"
com.google.chrome.ios,28,1729901134,1729901162,1729901163.1609669,-18000,EB445137-D7F5-57EC-87DA-1DB460D64046,"iPhone13,2"
com.myfitnesspal.mfp,0,1729900585,1729900585,1729900585.932615,-18000,EB445137-D7F5-57EC-87DA-1DB460D64046,"iPhone13,2"
com.myfitnesspal.mfp,1,1729900043,1729900044,1729900044.585803,-18000,EB445137-D7F5-57EC-87DA-1DB460D64046,"iPhone13,2"
com.myfitnesspal.mfp,2,1729899963,1729899965,1729899965.190805,-18000,EB445137-D7F5-57EC-87DA-1DB460D64046,"iPhone13,2"
com.myfitnesspal.mfp,6,1729899952,1729899958,1729899958.317686,-18000,EB445137-D7F5-57EC-87DA-1DB460D64046,"iPhone13,2"
com.myfitnesspal.mfp,26,1729899925,1729899951,1729899952.215112,-18000,EB445137-D7F5-57EC-87DA-1DB460D64046,"iPhone13,2"
com.myfitnesspal.mfp,2,1729899923,1729899925,1729899925.539407,-18000,EB445137-D7F5-57EC-87DA-1DB460D64046,"iPhone13,2"
com.myfitnesspal.mfp,386,1729898258,1729898644,1729898645.294138,-18000,EB445137-D7F5-57EC-87DA-1DB460D64046,"iPhone13,2"
com.myfitnesspal.mfp,49,1729898115,1729898164,1729898164.7210588,-18000,EB445137-D7F5-57EC-87DA-1DB460D64046,"iPhone13,2"
com.hammerandchisel.discord,18,1729898096,1729898114,1729898114.98308,-18000,EB445137-D7F5-57EC-87DA-1DB460D64046,"iPhone13,2"
com.hammerandchisel.discord,36,1729898031,1729898067,1729898067.956205,-18000,EB445137-D7F5-57EC-87DA-1DB460D64046,"iPhone13,2"
com.apple.Maps,5,1729898026,1729898031,1729898031.8981519,-18000,EB445137-D7F5-57EC-87DA-1DB460D64046,"iPhone13,2"
com.apple.Maps,17,1729893005,1729893022,1729893022.5218,-18000,EB445137-D7F5-57EC-87DA-1DB460D64046,"iPhone13,2"
com.apple.mobilenotes,2,1729893002,1729893004,1729893004.26483,-18000,EB445137-D7F5-57EC-87DA-1DB460D64046,"iPhone13,2"
com.apple.mobilenotes,7,1729892115,1729892122,1729892122.56563,-18000,EB445137-D7F5-57EC-87DA-1DB460D64046,"iPhone13,2"
com.apple.mobilenotes,6,1729891829,1729891835,1729891835.962199,-18000,EB445137-D7F5-57EC-87DA-1DB460D64046,"iPhone13,2"
com.apple.mobilenotes,41,1729891786,1729891827,1729891828.5393682,-18000,EB445137-D7F5-57EC-87DA-1DB460D64046,"iPhone13,2"
com.hammerandchisel.discord,6,1729891778,1729891784,1729891784.769366,-18000,EB445137-D7F5-57EC-87DA-1DB460D64046,"iPhone13,2"
com.hammerandchisel.discord,6,1729890312,1729890318,1729890318.594998,-18000,EB445137-D7F5-57EC-87DA-1DB460D64046,"iPhone13,2"
com.hammerandchisel.discord,2,1729890303,1729890305,1729890305.404784,-18000,EB445137-D7F5-57EC-87DA-1DB460D64046,"iPhone13,2"
com.apple.MobileSMS,127,1729890270,1729890397,1729890397.884091,-18000,,
com.microsoft.VSCode,6,1729890264,1729890270,1729890270.200568,-18000,,
com.google.Chrome,43,1729890221,1729890264,1729890264.077097,-18000,,
com.microsoft.VSCode,24,1729890197,1729890221,1729890221.691082,-18000,,
com.google.Chrome,71,1729890126,1729890197,1729890197.811794,-18000,,
com.microsoft.VSCode,10,1729890116,1729890126,1729890126.3680758,-18000,,
com.apple.finder,7,1729890109,1729890116,1729890116.863467,-18000,,
com.apple.Notes,1,1729890108,1729890109,1729890109.763751,-18000,,
com.microsoft.VSCode,23,1729890085,1729890108,1729890108.6589131,-18000,,
com.google.Chrome,11,1729890074,1729890085,1729890085.4172091,-18000,,
com.microsoft.VSCode,140,1729889934,1729890074,1729890074.438771,-18000,,
com.apple.finder,5,1729889929,1729889934,1729889934.859808,-18000,,
com.google.Chrome,3,1729889926,1729889929,1729889929.2402139,-18000,,
com.apple.Notes,2,1729889924,1729889926,1729889926.584528,-18000,,
com.microsoft.VSCode,82,1729889842,1729889924,1729889924.998105,-18000,,
com.apple.finder,80,1729889762,1729889842,1729889842.470628,-18000,,
com.microsoft.VSCode,24,1729889738,1729889762,1729889762.7141728,-18000,,
com.apple.finder,18,1729889720,1729889738,1729889738.707489,-18000,,
com.microsoft.VSCode,34,1729889686,1729889720,1729889720.264398,-18000,,
com.hammerandchisel.discord,61,1729889642,1729889703,1729889704.226882,-18000,EB445137-D7F5-57EC-87DA-1DB460D64046,"iPhone13,2"
com.apple.news,67,1729889567,1729889634,1729889634.8423471,-18000,EB445137-D7F5-57EC-87DA-1DB460D64046,"iPhone13,2"
com.hammerandchisel.discord,15,1729889542,1729889557,1729889557.250493,-18000,EB445137-D7F5-57EC-87DA-1DB460D64046,"iPhone13,2"
com.apple.Notes,215,1729889471,1729889686,1729889686.205879,-18000,,
com.google.Chrome,183,1729889288,1729889471,1729889471.86111,-18000,,
com.microsoft.VSCode,1,1729889287,1729889288,1729889288.865048,-18000,,
com.google.Chrome,96,1729889191,1729889287,1729889287.576318,-18000,,
com.microsoft.VSCode,87,1729889104,1729889191,1729889191.6582031,-18000,,
com.google.Chrome,6,1729889098,1729889104,1729889104.4831991,-18000,,
com.apple.MobileSMS,0,1729889098,1729889098,1729889098.9818258,-18000,,
com.microsoft.VSCode,22,1729889076,1729889098,1729889098.144541,-18000,,
com.apple.MobileSMS,1,1729889075,1729889076,1729889076.64958,-18000,,
com.microsoft.VSCode,1,1729889074,1729889075,1729889075.892091,-18000,,
com.apple.MobileSMS,1,1729889073,1729889074,1729889074.879363,-18000,,
com.google.Chrome,31,1729889042,1729889073,1729889074.0071049,-18000,,
com.apple.MobileSMS,1,1729889041,1729889042,1729889042.177075,-18000,,
com.microsoft.VSCode,4,1729889037,1729889041,1729889041.2169619,-18000,,
com.apple.MobileSMS,1,1729889036,1729889037,1729889037.321437,-18000,,
com.google.Chrome,3,1729889033,1729889036,1729889036.450611,-18000,,
com.apple.MobileSMS,1,1729889032,1729889033,1729889033.916013,-18000,,
com.microsoft.VSCode,1082,1729887950,1729889032,1729889032.102405,-18000,,
com.apple.MobileSMS,3,1729887947,1729887950,1729887950.288039,-18000,,
com.microsoft.VSCode,6,1729887941,1729887947,1729887947.932287,-18000,,
com.apple.MobileSMS,40,1729887901,1729887941,1729887941.799014,-18000,,
com.microsoft.VSCode,317,1729887584,1729887901,1729887901.855541,-18000,,
com.apple.MobileSMS,29,1729887555,1729887584,1729887584.0546842,-18000,,
com.microsoft.VSCode,193,1729887362,1729887555,1729887555.336069,-18000,,
com.apple.finder,29,1729887333,1729887362,1729887362.599499,-18000,,
com.microsoft.VSCode,31,1729887302,1729887333,1729887333.395032,-18000,,
com.google.Chrome,1,1729887301,1729887302,1729887302.6274428,-18000,,
com.apple.MobileSMS,3,1729887298,1729887301,1729887301.287916,-18000,,
com.microsoft.VSCode,215,1729887083,1729887298,1729887298.89964,-18000,,
com.google.Chrome,2,1729887081,1729887083,1729887083.616056,-18000,,
com.microsoft.VSCode,7,1729887074,1729887081,1729887081.354361,-18000,,
com.google.Chrome,1,1729887073,1729887074,1729887074.46543,-18000,,
com.microsoft.VSCode,3,1729887070,1729887073,1729887073.316986,-18000,,
com.google.Chrome,21,1729887049,1729887070,1729887070.61946,-18000,,
com.microsoft.VSCode,5,1729887044,1729887049,1729887049.418217,-18000,,
com.google.Chrome,11,1729887033,1729887044,1729887044.956942,-18000,,
com.microsoft.VSCode,13,1729887020,1729887033,1729887033.155459,-18000,,
com.google.Chrome,3,1729887017,1729887020,1729887020.724479,-18000,,
com.microsoft.VSCode,2,1729887015,1729887017,1729887017.194058,-18000,,
com.google.Chrome,2,1729887013,1729887015,1729887015.26163,-18000,,
com.microsoft.VSCode,10,1729887003,1729887013,1729887013.70991,-18000,,
com.google.Chrome,3,1729887000,1729887003,1729887003.4898481,-18000,,
com.microsoft.VSCode,1,1729886999,1729887000,1729887000.693037,-18000,,
com.google.Chrome,30,1729886969,1729886999,1729886999.836073,-18000,,
com.microsoft.VSCode,18,1729886951,1729886969,1729886969.6728082,-18000,,
com.apple.MobileSMS,1,1729886950,1729886951,1729886951.207417,-18000,,
com.microsoft.VSCode,91,1729886859,1729886950,1729886950.22863,-18000,,
com.apple.MobileSMS,34,1729886825,1729886859,1729886859.647352,-18000,,
com.microsoft.VSCode,2,1729886823,1729886825,1729886825.1600208,-18000,,
com.hammerandchisel.discord,8,1729886417,1729886425,1729886425.9798698,-18000,EB445137-D7F5-57EC-87DA-1DB460D64046,"iPhone13,2"
com.hammerandchisel.discord,4,1729885614,1729885618,1729885619.1515012,-18000,EB445137-D7F5-57EC-87DA-1DB460D64046,"iPhone13,2"
com.hammerandchisel.discord,10,1729885016,1729885026,1729885026.051443,-18000,EB445137-D7F5-57EC-87DA-1DB460D64046,"iPhone13,2"
com.microsoft.Office.Outlook,2,1729885014,1729885016,1729885017.0346441,-18000,EB445137-D7F5-57EC-87DA-1DB460D64046,"iPhone13,2"
com.microsoft.Office.Outlook,9,1729884634,1729884643,1729884643.532361,-18000,EB445137-D7F5-57EC-87DA-1DB460D64046,"iPhone13,2"
com.hammerandchisel.discord,45,1729884585,1729884630,1729884630.177022,-18000,EB445137-D7F5-57EC-87DA-1DB460D64046,"iPhone13,2"
com.hammerandchisel.discord,5,1729884459,1729884464,1729884464.93888,-18000,EB445137-D7F5-57EC-87DA-1DB460D64046,"iPhone13,2"
com.hammerandchisel.discord,47,1729884337,1729884384,1729884384.6053739,-18000,EB445137-D7F5-57EC-87DA-1DB460D64046,"iPhone13,2"
com.hammerandchisel.discord,17,1729884006,1729884023,1729884023.557891,-18000,EB445137-D7F5-57EC-87DA-1DB460D64046,"iPhone13,2"
com.hammerandchisel.discord,13,1729883786,1729883799,1729883799.065774,-18000,EB445137-D7F5-57EC-87DA-1DB460D64046,"iPhone13,2"
com.hammerandchisel.discord,73,1729883628,1729883701,1729883701.172106,-18000,EB445137-D7F5-57EC-87DA-1DB460D64046,"iPhone13,2"
Astrospheric.Astrospheric,7,1729883620,1729883627,1729883627.2785358,-18000,EB445137-D7F5-57EC-87DA-1DB460D64046,"iPhone13,2"
Astrospheric.Astrospheric,35,1729882551,1729882586,1729882587.609542,-18000,EB445137-D7F5-57EC-87DA-1DB460D64046,"iPhone13,2"
com.apple.weather,4,1729882546,1729882550,1729882550.285974,-18000,EB445137-D7F5-57EC-87DA-1DB460D64046,"iPhone13,2"
com.microsoft.VSCode,90,1729882075,1729882165,1729882165.9546928,-18000,,
com.microsoft.Excel,2,1729882073,1729882075,1729882075.688879,-18000,,
com.leomehlig.today,135,1729881938,1729882073,1729882073.621021,-18000,,
com.apple.iCal,4,1729881934,1729881938,1729881938.245205,-18000,,
com.google.Chrome,5,1729881929,1729881934,1729881934.868997,-18000,,
com.microsoft.VSCode,86,1729881843,1729881929,1729881930.05834,-18000,,
com.apple.finder,2,1729881841,1729881843,1729881843.626209,-18000,,
com.microsoft.VSCode,437,1729881404,1729881841,1729881841.292904,-18000,,
com.microsoft.Excel,8,1729881396,1729881404,1729881404.0760589,-18000,,
com.apple.finder,4,1729881392,1729881396,1729881396.417723,-18000,,
com.microsoft.Excel,19,1729881373,1729881392,1729881392.474858,-18000,,
com.apple.finder,12,1729881361,1729881373,1729881374.034153,-18000,,
com.microsoft.Excel,4,1729881357,1729881361,1729881361.481046,-18000,,
com.google.Chrome,72,1729881285,1729881357,1729881357.450605,-18000,,
com.microsoft.VSCode,3,1729881282,1729881285,1729881285.20806,-18000,,
com.apple.iCal,13,1729880971,1729880984,1729880984.276483,-18000,,
com.microsoft.Excel,17,1729880954,1729880971,1729880971.856717,-18000,,
com.microsoft.VSCode,186,1729880768,1729880954,1729880954.3326778,-18000,,
com.google.Chrome,56,1729880712,1729880768,1729880768.976851,-18000,,
com.microsoft.VSCode,1,1729880711,1729880712,1729880712.863186,-18000,,
com.google.Chrome,25,1729880686,1729880711,1729880711.989378,-18000,,
com.microsoft.VSCode,172,1729880514,1729880686,1729880686.962286,-18000,,
com.google.Chrome,0,1729880514,1729880514,1729880514.996366,-18000,,
com.apple.finder,8,1729880506,1729880514,1729880514.21076,-18000,,
com.google.Chrome,1,1729880505,1729880506,1729880506.87713,-18000,,
com.microsoft.VSCode,151,1729880354,1729880505,1729880506.04373,-18000,,
com.google.Chrome,61,1729880293,1729880354,1729880354.1282291,-18000,,
com.microsoft.VSCode,210,1729880083,1729880293,1729880293.955894,-18000,,
com.apple.finder,10,1729880073,1729880083,1729880083.40138,-18000,,
com.microsoft.Excel,41,1729880032,1729880073,1729880073.099753,-18000,,
com.apple.iCal,17,1729880015,1729880032,1729880032.894521,-18000,,
com.microsoft.Excel,36,1729879979,1729880015,1729880016.010735,-18000,,
com.apple.finder,49,1729879930,1729879979,1729879979.9028,-18000,,
com.microsoft.VSCode,330,1729879600,1729879930,1729879930.378655,-18000,,
com.apple.finder,12,1729879588,1729879600,1729879600.081356,-18000,,
com.microsoft.VSCode,2,1729879586,1729879588,1729879588.44912,-18000,,
com.apple.finder,8,1729879578,1729879586,1729879587.011057,-18000,,
com.microsoft.VSCode,8,1729879570,1729879578,1729879578.342973,-18000,,
com.apple.finder,29,1729879541,1729879570,1729879570.8344588,-18000,,
com.microsoft.VSCode,123,1729879418,1729879541,1729879541.846468,-18000,,
com.google.Chrome,5,1729879413,1729879418,1729879418.68147,-18000,,
com.microsoft.Excel,3,1729879410,1729879413,1729879413.800386,-18000,,
com.google.Chrome,610,1729878800,1729879410,1729879410.5820432,-18000,,
com.google.Gmail,50,1729878740,1729878790,1729878790.583421,-18000,EB445137-D7F5-57EC-87DA-1DB460D64046,"iPhone13,2"
com.google.Sheets,7,1729878733,1729878740,1729878742.2662292,-18000,EB445137-D7F5-57EC-87DA-1DB460D64046,"iPhone13,2"
com.google.Chrome,787,1729877782,1729878569,1729878569.941989,-18000,,
com.apple.calculator,27,1729877755,1729877782,1729877782.949218,-18000,,
com.google.Chrome,7,1729877748,1729877755,1729877755.2050982,-18000,,
com.apple.calculator,20,1729877728,1729877748,1729877748.405839,-18000,,
com.google.Chrome,945,1729876783,1729877728,1729877728.971787,-18000,,
com.google.Sheets,8,1729876743,1729876751,1729876751.817842,-18000,EB445137-D7F5-57EC-87DA-1DB460D64046,"iPhone13,2"
com.google.Sheets,27,1729875000,1729875027,1729875028.109911,-18000,EB445137-D7F5-57EC-87DA-1DB460D64046,"iPhone13,2"
com.hammerandchisel.discord,2,1729874998,1729875000,1729875000.734756,-18000,EB445137-D7F5-57EC-87DA-1DB460D64046,"iPhone13,2"
com.hammerandchisel.discord,19,1729874351,1729874370,1729874370.770973,-18000,EB445137-D7F5-57EC-87DA-1DB460D64046,"iPhone13,2"
com.microsoft.Office.Outlook,12,1729874339,1729874351,1729874351.559421,-18000,EB445137-D7F5-57EC-87DA-1DB460D64046,"iPhone13,2"
com.microsoft.Office.Outlook,1,1729874314,1729874315,1729874317.100244,-18000,EB445137-D7F5-57EC-87DA-1DB460D64046,"iPhone13,2"
com.google.Sheets,34,1729874280,1729874314,1729874316.1541739,-18000,EB445137-D7F5-57EC-87DA-1DB460D64046,"iPhone13,2"
com.microsoft.Office.Outlook,5,1729874275,1729874280,1729874280.4579601,-18000,EB445137-D7F5-57EC-87DA-1DB460D64046,"iPhone13,2"
com.apple.reminders,6,1729871721,1729871727,1729871727.652824,-18000,EB445137-D7F5-57EC-87DA-1DB460D64046,"iPhone13,2"
com.apple.news,6,1729871715,1729871721,1729871721.303957,-18000,EB445137-D7F5-57EC-87DA-1DB460D64046,"iPhone13,2"
com.apple.news,6,1729870928,1729870934,1729870934.8904471,-18000,EB445137-D7F5-57EC-87DA-1DB460D64046,"iPhone13,2"
com.google.Chrome,512,1729870840,1729871352,1729871352.316464,-18000,,
com.apple.Terminal,78,1729870762,1729870840,1729870841.028841,-18000,,
com.apple.finder,2,1729870760,1729870762,1729870762.721842,-18000,,
com.apple.Terminal,4,1729870756,1729870760,1729870760.545269,-18000,,
com.apple.finder,11,1729870745,1729870756,1729870756.621883,-18000,,
com.apple.news,12,1729870730,1729870742,1729870742.869156,-18000,EB445137-D7F5-57EC-87DA-1DB460D64046,"iPhone13,2"
com.google.Chrome,197,1729870548,1729870745,1729870745.3469582,-18000,,
com.microsoft.Excel,12,1729870269,1729870281,1729870281.29767,-18000,,
com.google.Chrome,312,1729869957,1729870269,1729870269.281911,-18000,,
com.microsoft.Excel,1,1729869956,1729869957,1729869957.967947,-18000,,
com.google.Chrome,35,1729869921,1729869956,1729869956.9698749,-18000,,
com.microsoft.Excel,19,1729869902,1729869921,1729869921.45873,-18000,,
com.google.Chrome,5,1729869897,1729869902,1729869902.469073,-18000,,
com.apple.finder,1,1729869896,1729869897,1729869897.415792,-18000,,
com.microsoft.Excel,25,1729869871,1729869896,1729869896.284013,-18000,,
com.apple.finder,6,1729869865,1729869871,1729869871.760237,-18000,,
com.google.Chrome,107,1729869758,1729869865,1729869865.976945,-18000,,
com.apple.news,77,1729868327,1729868404,1729868404.5316238,-18000,EB445137-D7F5-57EC-87DA-1DB460D64046,"iPhone13,2"
com.apple.news,20,1729868306,1729868326,1729868326.5630422,-18000,EB445137-D7F5-57EC-87DA-1DB460D64046,"iPhone13,2"
com.google.chrome.ios,4,1729868290,1729868294,1729868294.900539,-18000,EB445137-D7F5-57EC-87DA-1DB460D64046,"iPhone13,2"
com.google.chrome.ios,2,1729868248,1729868250,1729868250.069056,-18000,EB445137-D7F5-57EC-87DA-1DB460D64046,"iPhone13,2"
com.google.chrome.ios,1,1729868192,1729868193,1729868193.5790381,-18000,EB445137-D7F5-57EC-87DA-1DB460D64046,"iPhone13,2"
com.google.chrome.ios,2,1729868077,1729868079,1729868079.2674031,-18000,EB445137-D7F5-57EC-87DA-1DB460D64046,"iPhone13,2"
com.google.chrome.ios,3,1729868020,1729868023,1729868023.8705668,-18000,EB445137-D7F5-57EC-87DA-1DB460D64046,"iPhone13,2"
com.google.chrome.ios,2,1729867690,1729867692,1729867692.332972,-18000,EB445137-D7F5-57EC-87DA-1DB460D64046,"iPhone13,2"
com.google.chrome.ios,2,1729867420,1729867422,1729867422.434793,-18000,EB445137-D7F5-57EC-87DA-1DB460D64046,"iPhone13,2"
com.google.chrome.ios,300,1729866679,1729866979,1729866980.480335,-18000,EB445137-D7F5-57EC-87DA-1DB460D64046,"iPhone13,2"
com.apple.weather,3,1729866675,1729866678,1729866678.636229,-18000,EB445137-D7F5-57EC-87DA-1DB460D64046,"iPhone13,2"
com.apple.weather,5,1729866483,1729866488,1729866488.351188,-18000,EB445137-D7F5-57EC-87DA-1DB460D64046,"iPhone13,2"
com.apple.weather,1,1729866481,1729866482,1729866482.7536101,-18000,EB445137-D7F5-57EC-87DA-1DB460D64046,"iPhone13,2"
com.apple.weather,61,1729865880,1729865941,1729865941.779357,-18000,EB445137-D7F5-57EC-87DA-1DB460D64046,"iPhone13,2"
com.renpho.health,5,1729865874,1729865879,1729865880.021831,-18000,EB445137-D7F5-57EC-87DA-1DB460D64046,"iPhone13,2"
com.renpho.health,5,1729865669,1729865674,1729865674.965224,-18000,EB445137-D7F5-57EC-87DA-1DB460D64046,"iPhone13,2"
com.renpho.health,29,1729865232,1729865261,1729865262.3061152,-18000,EB445137-D7F5-57EC-87DA-1DB460D64046,"iPhone13,2"
com.google.Gmail,12,1729865187,1729865199,1729865199.5214338,-18000,EB445137-D7F5-57EC-87DA-1DB460D64046,"iPhone13,2"
com.thestorygraph.thestorygraph,6,1729865181,1729865187,1729865188.722362,-18000,EB445137-D7F5-57EC-87DA-1DB460D64046,"iPhone13,2"
com.thestorygraph.thestorygraph,17,1729864119,1729864136,1729864136.200842,-18000,EB445137-D7F5-57EC-87DA-1DB460D64046,"iPhone13,2"
com.thestorygraph.thestorygraph,10,1729863956,1729863966,1729863966.20603,-18000,EB445137-D7F5-57EC-87DA-1DB460D64046,"iPhone13,2"
com.thestorygraph.thestorygraph,22,1729863001,1729863023,1729863023.554409,-18000,EB445137-D7F5-57EC-87DA-1DB460D64046,"iPhone13,2"
com.thestorygraph.thestorygraph,13,1729830563,1729830576,1729830576.897968,-18000,EB445137-D7F5-57EC-87DA-1DB460D64046,"iPhone13,2"
com.thestorygraph.thestorygraph,2,1729830556,1729830558,1729830558.196876,-18000,EB445137-D7F5-57EC-87DA-1DB460D64046,"iPhone13,2"
com.thestorygraph.thestorygraph,19,1729830513,1729830532,1729830533.8044,-18000,EB445137-D7F5-57EC-87DA-1DB460D64046,"iPhone13,2"
com.google.Chrome,8,1729828709,1729828717,1729828717.5033379,-18000,,
com.microsoft.VSCode,154,1729828555,1729828709,1729828709.66272,-18000,,
com.google.Chrome,5,1729828550,1729828555,1729828555.556562,-18000,,
com.microsoft.VSCode,122,1729828428,1729828550,1729828550.964684,-18000,,
com.google.Chrome,6,1729828422,1729828428,1729828428.788665,-18000,,
com.microsoft.VSCode,61,1729828361,1729828422,1729828422.053626,-18000,,
com.google.Chrome,9,1729828352,1729828361,1729828361.87678,-18000,,
com.microsoft.VSCode,10,1729828342,1729828352,1729828352.489128,-18000,,
com.google.Chrome,30,1729828312,1729828342,1729828342.5731301,-18000,,
com.microsoft.VSCode,57,1729828255,1729828312,1729828312.735286,-18000,,
com.google.Chrome,1,1729828254,1729828255,1729828255.170425,-18000,,
com.microsoft.VSCode,5,1729828249,1729828254,1729828254.266437,-18000,,
com.google.Chrome,3,1729828246,1729828249,1729828249.7269511,-18000,,
com.microsoft.VSCode,6,1729828240,1729828246,1729828246.9404159,-18000,,
com.google.Chrome,1,1729828239,1729828240,1729828240.909029,-18000,,
com.microsoft.VSCode,25,1729828214,1729828239,1729828239.26107,-18000,,
com.google.Chrome,2,1729828212,1729828214,1729828214.9726372,-18000,,
com.microsoft.VSCode,41,1729828171,1729828212,1729828212.163919,-18000,,
com.google.Chrome,2,1729828169,1729828171,1729828171.158904,-18000,,
com.microsoft.VSCode,2,1729828167,1729828169,1729828170.036917,-18000,,
com.google.Chrome,2,1729828165,1729828167,1729828167.3290381,-18000,,
com.microsoft.VSCode,57,1729828108,1729828165,1729828165.5675812,-18000,,
com.google.Chrome,20,1729828088,1729828108,1729828108.665093,-18000,,
com.microsoft.VSCode,1,1729828087,1729828088,1729828088.549515,-18000,,
com.google.Chrome,11,1729828076,1729828087,1729828087.7375932,-18000,,
com.microsoft.VSCode,4,1729828072,1729828076,1729828076.6885161,-18000,,
com.google.Chrome,2,1729828070,1729828072,1729828072.358063,-18000,,
com.microsoft.VSCode,43,1729828027,1729828070,1729828070.4642901,-18000,,
com.google.Chrome,14,1729828013,1729828027,1729828027.993503,-18000,,
com.microsoft.VSCode,17,1729827996,1729828013,1729828013.121104,-18000,,
com.google.Chrome,11,1729827985,1729827996,1729827996.9336782,-18000,,
com.microsoft.VSCode,9,1729827976,1729827985,1729827985.168576,-18000,,
com.google.Chrome,4,1729827972,1729827976,1729827976.7929611,-18000,,
com.microsoft.VSCode,35,1729827937,1729827972,1729827973.027184,-18000,,
com.google.Chrome,4,1729827933,1729827937,1729827937.30368,-18000,,
com.microsoft.VSCode,1,1729827932,1729827933,1729827933.563391,-18000,,
com.google.Chrome,2,1729827930,1729827932,1729827932.27269,-18000,,
com.microsoft.VSCode,14,1729827916,1729827930,1729827930.3880239,-18000,,
com.google.Chrome,1,1729827915,1729827916,1729827917.030869,-18000,,
com.microsoft.VSCode,18,1729827897,1729827915,1729827915.954259,-18000,,
com.google.Chrome,1,1729827896,1729827897,1729827897.096926,-18000,,
com.microsoft.VSCode,2,1729827894,1729827896,1729827896.51332,-18000,,
com.google.Chrome,3,1729827891,1729827894,1729827894.126437,-18000,,
com.microsoft.VSCode,7,1729827884,1729827891,1729827891.9617229,-18000,,
com.google.Chrome,23,1729827861,1729827884,1729827884.413313,-18000,,
com.microsoft.VSCode,374,1729827487,1729827861,1729827861.277532,-18000,,
com.google.Chrome,53,1729827434,1729827487,1729827487.64379,-18000,,
com.microsoft.VSCode,12,1729827422,1729827434,1729827434.151715,-18000,,
com.google.Chrome,4,1729827418,1729827422,1729827422.1660972,-18000,,
com.microsoft.VSCode,105,1729827313,1729827418,1729827418.662014,-18000,,
com.google.Chrome,1,1729827312,1729827313,1729827313.960741,-18000,,
com.microsoft.VSCode,2,1729827310,1729827312,1729827312.998559,-18000,,
com.google.Chrome,5,1729827305,1729827310,1729827310.8450131,-18000,,
com.microsoft.VSCode,10,1729827295,1729827305,1729827305.15172,-18000,,
com.google.Chrome,3,1729827292,1729827295,1729827295.235426,-18000,,
com.microsoft.VSCode,4,1729827288,1729827292,1729827292.300476,-18000,,
com.google.Chrome,15,1729827273,1729827288,1729827288.30282,-18000,,
com.microsoft.VSCode,11,1729827262,1729827273,1729827273.722729,-18000,,
com.google.Chrome,22,1729827240,1729827262,1729827262.9641662,-18000,,
com.microsoft.VSCode,380,1729826860,1729827240,1729827240.868067,-18000,,
com.google.Chrome,10,1729826850,1729826860,1729826860.1520882,-18000,,
com.microsoft.VSCode,505,1729826345,1729826850,1729826850.968696,-18000,,
com.google.Chrome,6,1729826339,1729826345,1729826345.43909,-18000,,
com.microsoft.VSCode,38,1729826301,1729826339,1729826339.9064689,-18000,,
com.google.Chrome,1,1729826300,1729826301,1729826301.987361,-18000,,
com.microsoft.VSCode,3,1729826297,1729826300,1729826300.7989001,-18000,,
com.google.Chrome,1,1729826296,1729826297,1729826298.051275,-18000,,
com.microsoft.VSCode,16,1729826280,1729826296,1729826296.50051,-18000,,
com.google.Chrome,41,1729826239,1729826280,1729826280.6308,-18000,,
com.microsoft.VSCode,109,1729826130,1729826239,1729826239.801756,-18000,,
com.google.Chrome,45,1729826085,1729826130,1729826130.95686,-18000,,
com.microsoft.VSCode,3,1729826082,1729826085,1729826085.6968231,-18000,,
com.google.Chrome,1,1729826081,1729826082,1729826082.305665,-18000,,
com.microsoft.VSCode,7,1729826074,1729826081,1729826081.516588,-18000,,
com.google.Chrome,1,1729826073,1729826074,1729826074.870027,-18000,,
com.microsoft.VSCode,4,1729826069,1729826073,1729826073.722684,-18000,,
com.google.Chrome,1,1729826068,1729826069,1729826069.139082,-18000,,
com.microsoft.VSCode,1,1729826067,1729826068,1729826068.506186,-18000,,
com.google.Chrome,1,1729826066,1729826067,1729826067.7382631,-18000,,
com.microsoft.VSCode,8,1729826058,1729826066,1729826066.527328,-18000,,
com.google.Chrome,43,1729826015,1729826058,1729826058.354346,-18000,,
com.microsoft.VSCode,131,1729825884,1729826015,1729826015.822974,-18000,,
com.google.Chrome,4,1729825880,1729825884,1729825885.013321,-18000,,
com.google.Chrome,20,1729825830,1729825850,1729825850.301004,-18000,,
com.microsoft.VSCode,586,1729825244,1729825830,1729825830.1967092,-18000,,
com.apple.finder,2,1729825242,1729825244,1729825244.5473971,-18000,,
com.microsoft.VSCode,9,1729825233,1729825242,1729825242.066644,-18000,,
com.apple.finder,7,1729825226,1729825233,1729825233.8481789,-18000,,
com.microsoft.VSCode,15,1729825211,1729825226,1729825226.999649,-18000,,
com.apple.finder,5,1729825206,1729825211,1729825211.492301,-18000,,
com.microsoft.VSCode,13,1729825193,1729825206,1729825206.3612409,-18000,,
com.apple.finder,2,1729825191,1729825193,1729825193.77556,-18000,,
com.microsoft.VSCode,14,1729825177,1729825191,1729825191.635467,-18000,,
com.apple.finder,6,1729825171,1729825177,1729825177.239089,-18000,,
com.microsoft.VSCode,491,1729824680,1729825171,1729825171.808854,-18000,,
com.apple.finder,14,1729824666,1729824680,1729824680.624205,-18000,,
com.google.Chrome,8,1729824658,1729824666,1729824666.387865,-18000,,
com.google.Chrome,42,1729824484,1729824526,1729824527.132761,-18000,,
com.apple.camera,3,1729824418,1729824421,1729824421.458476,-18000,EB445137-D7F5-57EC-87DA-1DB460D64046,"iPhone13,2"
com.google.Chrome,739,1729823459,1729824198,1729824199.029818,-18000,,
com.google.Chrome,310,1729822848,1729823158,1729823158.228496,-18000,,
com.google.ios.youtube,1778,1729821051,1729822829,1729822829.360816,-18000,EB445137-D7F5-57EC-87DA-1DB460D64046,"iPhone13,2"
com.google.ios.youtube,271,1729820774,1729821045,1729821046.014185,-18000,EB445137-D7F5-57EC-87DA-1DB460D64046,"iPhone13,2"
com.apple.news,5,1729820764,1729820769,1729820769.575348,-18000,EB445137-D7F5-57EC-87DA-1DB460D64046,"iPhone13,2"
com.google.Chrome,320,1729820740,1729821060,1729821060.0887861,-18000,,
com.apple.finder,5,1729820735,1729820740,1729820740.5232291,-18000,,
com.microsoft.VSCode,15,1729820720,1729820735,1729820735.1037002,-18000,,
com.google.Chrome,385,1729820335,1729820720,1729820720.6080809,-18000,,
com.leomehlig.today,26,1729820309,1729820335,1729820335.1929932,-18000,,
com.microsoft.VSCode,65,1729820244,1729820309,1729820309.803678,-18000,,
com.apple.camera,0,1729819802,1729819802,1729819802.332584,-18000,EB445137-D7F5-57EC-87DA-1DB460D64046,"iPhone13,2"
com.apple.camera,1,1729819800,1729819801,1729819801.244853,-18000,EB445137-D7F5-57EC-87DA-1DB460D64046,"iPhone13,2"
com.apple.camera,0,1729819797,1729819797,1729819797.405943,-18000,EB445137-D7F5-57EC-87DA-1DB460D64046,"iPhone13,2"
com.apple.camera,1,1729819795,1729819796,1729819796.3995,-18000,EB445137-D7F5-57EC-87DA-1DB460D64046,"iPhone13,2"
com.apple.camera,1,1729819793,1729819794,1729819794.294234,-18000,EB445137-D7F5-57EC-87DA-1DB460D64046,"iPhone13,2"
com.apple.camera,0,1729819790,1729819790,1729819790.852614,-18000,EB445137-D7F5-57EC-87DA-1DB460D64046,"iPhone13,2"
com.apple.camera,0,1729819788,1729819788,1729819788.596581,-18000,EB445137-D7F5-57EC-87DA-1DB460D64046,"iPhone13,2"
com.apple.camera,1,1729819787,1729819788,1729819788.151953,-18000,EB445137-D7F5-57EC-87DA-1DB460D64046,"iPhone13,2"
com.apple.camera,0,1729819783,1729819783,1729819783.651291,-18000,EB445137-D7F5-57EC-87DA-1DB460D64046,"iPhone13,2"
com.apple.camera,0,1729819783,1729819783,1729819783.916347,-18000,EB445137-D7F5-57EC-87DA-1DB460D64046,"iPhone13,2"
com.apple.camera,1,1729819781,1729819782,1729819782.1670818,-18000,EB445137-D7F5-57EC-87DA-1DB460D64046,"iPhone13,2"
com.apple.camera,1,1729819778,1729819779,1729819779.098347,-18000,EB445137-D7F5-57EC-87DA-1DB460D64046,"iPhone13,2"
com.apple.news,34,1729819774,1729819808,1729819808.616368,-18000,EB445137-D7F5-57EC-87DA-1DB460D64046,"iPhone13,2"
com.apple.camera,0,1729819749,1729819749,1729819749.3504891,-18000,EB445137-D7F5-57EC-87DA-1DB460D64046,"iPhone13,2"
com.apple.camera,0,1729819745,1729819745,1729819745.970941,-18000,EB445137-D7F5-57EC-87DA-1DB460D64046,"iPhone13,2"
com.apple.camera,0,1729819743,1729819743,1729819743.38206,-18000,EB445137-D7F5-57EC-87DA-1DB460D64046,"iPhone13,2"
com.apple.news,20,1729819742,1729819762,1729819762.377915,-18000,EB445137-D7F5-57EC-87DA-1DB460D64046,"iPhone13,2"
com.apple.camera,1,1729819733,1729819734,1729819734.509824,-18000,EB445137-D7F5-57EC-87DA-1DB460D64046,"iPhone13,2"
com.apple.camera,1,1729819732,1729819733,1729819733.3795528,-18000,EB445137-D7F5-57EC-87DA-1DB460D64046,"iPhone13,2"
com.apple.camera,0,1729819730,1729819730,1729819730.99434,-18000,EB445137-D7F5-57EC-87DA-1DB460D64046,"iPhone13,2"
com.apple.camera,2,1729819724,1729819726,1729819726.1258168,-18000,EB445137-D7F5-57EC-87DA-1DB460D64046,"iPhone13,2"
com.apple.camera,0,1729819722,1729819722,1729819722.839058,-18000,EB445137-D7F5-57EC-87DA-1DB460D64046,"iPhone13,2"
com.apple.camera,1,1729819721,1729819722,1729819722.1718922,-18000,EB445137-D7F5-57EC-87DA-1DB460D64046,"iPhone13,2"
com.apple.camera,0,1729819719,1729819719,1729819719.411613,-18000,EB445137-D7F5-57EC-87DA-1DB460D64046,"iPhone13,2"
com.apple.camera,0,1729819712,1729819712,1729819712.6604052,-18000,EB445137-D7F5-57EC-87DA-1DB460D64046,"iPhone13,2"
com.apple.camera,0,1729819711,1729819711,1729819711.2528548,-18000,EB445137-D7F5-57EC-87DA-1DB460D64046,"iPhone13,2"
com.apple.camera,0,1729819709,1729819709,1729819709.351062,-18000,EB445137-D7F5-57EC-87DA-1DB460D64046,"iPhone13,2"
com.apple.camera,0,1729819705,1729819705,1729819705.716683,-18000,EB445137-D7F5-57EC-87DA-1DB460D64046,"iPhone13,2"
com.apple.news,37,1729819703,1729819740,1729819740.809211,-18000,EB445137-D7F5-57EC-87DA-1DB460D64046,"iPhone13,2"
com.apple.news,6,1729819693,1729819699,1729819699.4145021,-18000,EB445137-D7F5-57EC-87DA-1DB460D64046,"iPhone13,2"
com.apple.camera,1,1729819684,1729819685,1729819685.96423,-18000,EB445137-D7F5-57EC-87DA-1DB460D64046,"iPhone13,2"
com.apple.camera,0,1729819683,1729819683,1729819683.5312681,-18000,EB445137-D7F5-57EC-87DA-1DB460D64046,"iPhone13,2"
com.apple.camera,0,1729819683,1729819683,1729819683.7353501,-18000,EB445137-D7F5-57EC-87DA-1DB460D64046,"iPhone13,2"
com.apple.news,11,1729819681,1729819692,1729819692.242537,-18000,EB445137-D7F5-57EC-87DA-1DB460D64046,"iPhone13,2"
com.apple.camera,1,1729819671,1729819672,1729819672.583854,-18000,EB445137-D7F5-57EC-87DA-1DB460D64046,"iPhone13,2"
com.apple.camera,1,1729819668,1729819669,1729819669.074284,-18000,EB445137-D7F5-57EC-87DA-1DB460D64046,"iPhone13,2"
com.apple.camera,0,1729819668,1729819668,1729819668.7372189,-18000,EB445137-D7F5-57EC-87DA-1DB460D64046,"iPhone13,2"
com.apple.camera,0,1729819666,1729819666,1729819666.953888,-18000,EB445137-D7F5-57EC-87DA-1DB460D64046,"iPhone13,2"
com.apple.camera,1,1729819664,1729819665,1729819665.062295,-18000,EB445137-D7F5-57EC-87DA-1DB460D64046,"iPhone13,2"
com.apple.camera,1,1729819660,1729819661,1729819661.219099,-18000,EB445137-D7F5-57EC-87DA-1DB460D64046,"iPhone13,2"
com.apple.camera,1,1729819659,1729819660,1729819660.131763,-18000,EB445137-D7F5-57EC-87DA-1DB460D64046,"iPhone13,2"
com.apple.camera,1,1729819657,1729819658,1729819658.864083,-18000,EB445137-D7F5-57EC-87DA-1DB460D64046,"iPhone13,2"
com.apple.camera,1,1729819656,1729819657,1729819657.295382,-18000,EB445137-D7F5-57EC-87DA-1DB460D64046,"iPhone13,2"
com.apple.camera,0,1729819656,1729819656,1729819656.692933,-18000,EB445137-D7F5-57EC-87DA-1DB460D64046,"iPhone13,2"
com.apple.camera,0,1729819652,1729819652,1729819652.22171,-18000,EB445137-D7F5-57EC-87DA-1DB460D64046,"iPhone13,2"
com.apple.camera,1,1729819649,1729819650,1729819650.0770478,-18000,EB445137-D7F5-57EC-87DA-1DB460D64046,"iPhone13,2"
com.apple.news,30,1729819648,1729819678,1729819678.868246,-18000,EB445137-D7F5-57EC-87DA-1DB460D64046,"iPhone13,2"
com.apple.camera,0,1729819639,1729819639,1729819639.985608,-18000,EB445137-D7F5-57EC-87DA-1DB460D64046,"iPhone13,2"
com.apple.camera,0,1729819634,1729819634,1729819634.5029101,-18000,EB445137-D7F5-57EC-87DA-1DB460D64046,"iPhone13,2"
com.apple.news,13,1729819633,1729819646,1729819646.269835,-18000,EB445137-D7F5-57EC-87DA-1DB460D64046,"iPhone13,2"
com.apple.news,6,1729819626,1729819632,1729819632.7236528,-18000,EB445137-D7F5-57EC-87DA-1DB460D64046,"iPhone13,2"
com.apple.camera,1,1729819618,1729819619,1729819619.048249,-18000,EB445137-D7F5-57EC-87DA-1DB460D64046,"iPhone13,2"
com.apple.news,8,1729819617,1729819625,1729819625.425408,-18000,EB445137-D7F5-57EC-87DA-1DB460D64046,"iPhone13,2"
com.apple.news,6,1729819607,1729819613,1729819613.6945682,-18000,EB445137-D7F5-57EC-87DA-1DB460D64046,"iPhone13,2"
com.apple.news,16,1729819030,1729819046,1729819047.463015,-18000,EB445137-D7F5-57EC-87DA-1DB460D64046,"iPhone13,2"
com.apple.news,6,1729818845,1729818851,1729818851.858916,-18000,EB445137-D7F5-57EC-87DA-1DB460D64046,"iPhone13,2"
com.apple.news,50,1729818795,1729818845,1729818845.116304,-18000,EB445137-D7F5-57EC-87DA-1DB460D64046,"iPhone13,2"
com.apple.news,100,1729818600,1729818700,1729818700.8352342,-18000,EB445137-D7F5-57EC-87DA-1DB460D64046,"iPhone13,2"
com.apple.news,308,1729818262,1729818570,1729818570.992475,-18000,EB445137-D7F5-57EC-87DA-1DB460D64046,"iPhone13,2"
com.instructure.icanvas,4,1729818250,1729818254,1729818254.465677,-18000,EB445137-D7F5-57EC-87DA-1DB460D64046,"iPhone13,2"
com.instructure.icanvas,14,1729818083,1729818097,1729818097.142633,-18000,EB445137-D7F5-57EC-87DA-1DB460D64046,"iPhone13,2"
com.instructure.icanvas,6,1729818065,1729818071,1729818071.199493,-18000,EB445137-D7F5-57EC-87DA-1DB460D64046,"iPhone13,2"
com.instructure.icanvas,5,1729817845,1729817850,1729817850.486889,-18000,EB445137-D7F5-57EC-87DA-1DB460D64046,"iPhone13,2"
com.instructure.icanvas,134,1729817687,1729817821,1729817822.150701,-18000,EB445137-D7F5-57EC-87DA-1DB460D64046,"iPhone13,2"
com.hammerandchisel.discord,3,1729817684,1729817687,1729817688.925648,-18000,EB445137-D7F5-57EC-87DA-1DB460D64046,"iPhone13,2"
com.microsoft.VSCode,918,1729817659,1729818577,1729818577.877149,-18000,,
com.leomehlig.today,12,1729817647,1729817659,1729817659.896018,-18000,,
com.google.Chrome,62,1729817585,1729817647,1729817647.824007,-18000,,
com.microsoft.VSCode,83,1729817502,1729817585,1729817585.314713,-18000,,
com.google.Chrome,19,1729817483,1729817502,1729817502.163605,-18000,,
com.microsoft.VSCode,6,1729817477,1729817483,1729817483.474261,-18000,,
com.google.Chrome,96,1729817381,1729817477,1729817477.496844,-18000,,
com.microsoft.VSCode,87,1729817294,1729817381,1729817381.973827,-18000,,
com.google.Chrome,109,1729817185,1729817294,1729817294.908914,-18000,,
com.microsoft.VSCode,56,1729817129,1729817185,1729817185.671596,-18000,,
com.google.Chrome,117,1729817012,1729817129,1729817129.80483,-18000,,

