app,usage,start_time,end_time,created_at,tz,device_id,device_model
com.apple.finder,5,1744386206,1744386211,1744386211.275595,-18000,,
com.apple.Terminal,1,1744386205,1744386206,1744386206.2068372,-18000,,
com.apple.finder,17,1744386188,1744386205,1744386205.3968139,-18000,,
com.leomehlig.today,17,1744386171,1744386188,1744386188.173245,-18000,,
com.google.Chrome,12,1744386159,1744386171,1744386171.876535,-18000,,
com.microsoft.VSCode,19,1744386140,1744386159,1744386159.872579,-18000,,
com.apple.news,129,1744386011,1744386140,1744386140.849148,-18000,,
com.microsoft.VSCode,179,1744385832,1744386011,1744386011.9529881,-18000,,
com.google.Chrome,3,1744385829,1744385832,1744385832.960496,-18000,,
com.microsoft.VSCode,23,1744385806,1744385829,1744385830.004508,-18000,,
com.google.Chrome,44,1744385762,1744385806,1744385806.9870548,-18000,,
com.microsoft.VSCode,0,1744385762,1744385762,1744385762.951651,-18000,,
com.google.Chrome,16,1744385746,1744385762,1744385762.1954079,-18000,,
com.microsoft.VSCode,410,1744385336,1744385746,1744385746.764647,-18000,,
com.google.Chrome,9,1744385327,1744385336,1744385336.257183,-18000,,
com.microsoft.VSCode,1,1744385326,1744385327,1744385327.946626,-18000,,
com.google.Chrome,1,1744385325,1744385326,1744385326.238411,-18000,,
com.microsoft.VSCode,2,1744385323,1744385325,1744385325.12457,-18000,,
com.google.Chrome,1,1744385322,1744385323,1744385323.720206,-18000,,
com.microsoft.VSCode,26,1744385296,1744385322,1744385322.433469,-18000,,
com.google.Chrome,1,1744385295,1744385296,1744385296.241672,-18000,,
com.microsoft.VSCode,2,1744385293,1744385295,1744385295.246787,-18000,,
com.google.Chrome,3,1744385290,1744385293,1744385293.191409,-18000,,
com.microsoft.VSCode,6,1744385284,1744385290,1744385291.001943,-18000,,
com.google.Chrome,1,1744385283,1744385284,1744385284.358278,-18000,,
com.microsoft.VSCode,2,1744385281,1744385283,1744385283.657603,-18000,,
com.google.Chrome,0,1744385281,1744385281,1744385281.841804,-18000,,
com.microsoft.VSCode,3,1744385278,1744385281,1744385281.101695,-18000,,
com.google.Chrome,1,1744385277,1744385278,1744385278.902951,-18000,,
com.microsoft.VSCode,2,1744385275,1744385277,1744385277.961351,-18000,,
com.google.Chrome,2,1744385273,1744385275,1744385275.277162,-18000,,
com.microsoft.VSCode,58,1744385215,1744385273,1744385273.636826,-18000,,
com.google.Chrome,3,1744385212,1744385215,1744385215.410228,-18000,,
com.microsoft.VSCode,7,1744385205,1744385212,1744385212.685272,-18000,,
com.google.Chrome,2,1744385203,1744385205,1744385206.00368,-18000,,
com.microsoft.VSCode,30,1744385173,1744385203,1744385203.181416,-18000,,
com.google.Chrome,2,1744385171,1744385173,1744385173.123931,-18000,,
com.microsoft.VSCode,1,1744385170,1744385171,1744385172.022725,-18000,,
com.google.Chrome,1,1744385169,1744385170,1744385170.292939,-18000,,
com.microsoft.VSCode,3,1744385166,1744385169,1744385169.274684,-18000,,
com.google.Chrome,2,1744385164,1744385166,1744385166.792083,-18000,,
com.microsoft.VSCode,1,1744385163,1744385164,1744385165.055654,-18000,,
com.google.Chrome,1,1744385162,1744385163,1744385163.518303,-18000,,
com.microsoft.VSCode,2,1744385160,1744385162,1744385162.481468,-18000,,
com.google.Chrome,1,1744385159,1744385160,1744385160.868085,-18000,,
com.microsoft.VSCode,1,1744385158,1744385159,1744385159.666206,-18000,,
com.google.Chrome,2,1744385156,1744385158,1744385158.316355,-18000,,
com.microsoft.VSCode,1,1744385155,1744385156,1744385156.897325,-18000,,
com.google.Chrome,1,1744385154,1744385155,1744385155.393259,-18000,,
com.microsoft.VSCode,2,1744385152,1744385154,1744385154.238395,-18000,,
com.google.Chrome,1,1744385151,1744385152,1744385152.8897018,-18000,,
com.microsoft.VSCode,2,1744385149,1744385151,1744385151.638999,-18000,,
com.google.Chrome,1,1744385148,1744385149,1744385149.847622,-18000,,
com.microsoft.VSCode,1,1744385147,1744385148,1744385148.769196,-18000,,
com.google.Chrome,2,1744385145,1744385147,1744385147.245789,-18000,,
com.microsoft.VSCode,2,1744385143,1744385145,1744385145.913008,-18000,,
com.google.Chrome,1,1744385142,1744385143,1744385143.974965,-18000,,
com.microsoft.VSCode,1,1744385141,1744385142,1744385142.832567,-18000,,
com.google.Chrome,1,1744385140,1744385141,1744385141.393635,-18000,,
com.microsoft.VSCode,27,1744385113,1744385140,1744385140.140116,-18000,,
com.google.Chrome,1,1744385112,1744385113,1744385113.514936,-18000,,
com.microsoft.VSCode,26,1744385086,1744385112,1744385112.3308659,-18000,,
com.google.Chrome,13,1744385073,1744385086,1744385086.7565222,-18000,,
com.microsoft.VSCode,1,1744385072,1744385073,1744385073.9870691,-18000,,
com.google.Chrome,3,1744385069,1744385072,1744385072.724358,-18000,,
com.microsoft.VSCode,18,1744385051,1744385069,1744385069.798286,-18000,,
com.google.Chrome,3,1744385048,1744385051,1744385051.856916,-18000,,
com.microsoft.VSCode,14,1744385034,1744385048,1744385048.418762,-18000,,
com.google.Chrome,7,1744385027,1744385034,1744385034.428146,-18000,,
com.microsoft.VSCode,75,1744384952,1744385027,1744385027.658011,-18000,,
com.google.Chrome,2,1744384950,1744384952,1744384952.463214,-18000,,
com.microsoft.VSCode,3,1744384947,1744384950,1744384950.937778,-18000,,
com.google.Chrome,2,1744384945,1744384947,1744384947.965513,-18000,,
com.microsoft.VSCode,22,1744384923,1744384945,1744384945.06763,-18000,,
com.google.Chrome,11,1744384912,1744384923,1744384923.250778,-18000,,
com.microsoft.VSCode,3,1744384909,1744384912,1744384912.9370332,-18000,,
com.google.Chrome,1,1744384908,1744384909,1744384909.470512,-18000,,
com.microsoft.VSCode,13,1744384895,1744384908,1744384908.463577,-18000,,
com.google.Chrome,4,1744384891,1744384895,1744384895.106241,-18000,,
com.microsoft.VSCode,3,1744384888,1744384891,1744384891.96067,-18000,,
com.google.Chrome,2,1744384886,1744384888,1744384888.283636,-18000,,
com.microsoft.VSCode,4,1744384882,1744384886,1744384886.651126,-18000,,
com.google.Chrome,3,1744384879,1744384882,1744384882.671551,-18000,,
com.microsoft.VSCode,6,1744384873,1744384879,1744384880.012601,-18000,,
com.google.Chrome,7,1744384866,1744384873,1744384873.788163,-18000,,
com.microsoft.VSCode,17,1744384849,1744384866,1744384866.115665,-18000,,
com.google.Chrome,31,1744384818,1744384849,1744384849.512541,-18000,,
com.microsoft.VSCode,11,1744384807,1744384818,1744384818.69269,-18000,,
com.google.Chrome,12,1744384795,1744384807,1744384807.5807629,-18000,,
com.microsoft.VSCode,60,1744384735,1744384795,1744384795.599823,-18000,,
com.google.Chrome,11,1744384724,1744384735,1744384735.186851,-18000,,
com.microsoft.VSCode,54,1744384670,1744384724,1744384724.812307,-18000,,
com.google.Chrome,107,1744384563,1744384670,1744384671.009646,-18000,,
com.google.Chrome,131,1744384429,1744384560,1744384560.47472,-18000,,
com.microsoft.VSCode,570,1744383844,1744384414,1744384414.622271,-18000,,
com.microsoft.VSCode,369,1744383473,1744383842,1744383842.6599422,-18000,,
com.google.Chrome,2,1744383471,1744383473,1744383473.919036,-18000,,
com.microsoft.VSCode,3,1744383468,1744383471,1744383471.074552,-18000,,
com.google.Chrome,15,1744383453,1744383468,1744383468.980915,-18000,,
com.microsoft.VSCode,33,1744383420,1744383453,1744383453.4680119,-18000,,
com.leomehlig.today,219,1744383201,1744383420,1744383420.380079,-18000,,
com.microsoft.VSCode,84,1744383117,1744383201,1744383201.748085,-18000,,
com.microsoft.VSCode,300,1744382809,1744383109,1744383109.4717588,-18000,,
com.microsoft.VSCode,529,1744382277,1744382806,1744382806.7018518,-18000,,
com.google.Chrome,39,1744382238,1744382277,1744382277.0792542,-18000,,
com.microsoft.VSCode,104,1744382134,1744382238,1744382238.871803,-18000,,
com.google.Chrome,0,1744382134,1744382134,1744382134.869904,-18000,,
com.microsoft.VSCode,57,1744382077,1744382134,1744382134.463933,-18000,,
com.google.Chrome,104,1744381973,1744382077,1744382078.045358,-18000,,
com.microsoft.VSCode,67,1744381906,1744381973,1744381973.41976,-18000,,
com.google.Chrome,21,1744381885,1744381906,1744381907.131767,-18000,,
com.microsoft.VSCode,2,1744381883,1744381885,1744381885.321451,-18000,,
com.google.Chrome,29,1744381854,1744381883,1744381884.02441,-18000,,
com.microsoft.VSCode,1,1744381853,1744381854,1744381855.4657211,-18000,,
com.google.Chrome,52,1744381801,1744381853,1744381853.872823,-18000,,
com.microsoft.VSCode,68,1744381733,1744381801,1744381801.881547,-18000,,
com.apple.MobileSMS,8,1744381725,1744381733,1744381733.55092,-18000,,
com.microsoft.VSCode,84,1744381641,1744381725,1744381725.445358,-18000,,
com.google.Chrome,4,1744381637,1744381641,1744381643.427125,-18000,,
com.microsoft.VSCode,189,1744381448,1744381637,1744381637.856425,-18000,,
com.google.Chrome,2,1744381446,1744381448,1744381448.64637,-18000,,
com.microsoft.VSCode,415,1744381031,1744381446,1744381446.54862,-18000,,
com.google.Chrome,6,1744381025,1744381031,1744381031.073535,-18000,,
com.microsoft.VSCode,45,1744380980,1744381025,1744381025.576395,-18000,,
com.google.Chrome,3,1744380977,1744380980,1744380980.673445,-18000,,
com.microsoft.VSCode,75,1744380902,1744380977,1744380977.927847,-18000,,
com.google.Chrome,67,1744380835,1744380902,1744380902.376864,-18000,,
com.microsoft.VSCode,274,1744380561,1744380835,1744380837.42234,-18000,,
com.google.Chrome,12,1744380549,1744380561,1744380561.715826,-18000,,
com.microsoft.VSCode,560,1744379989,1744380549,1744380549.970814,-18000,,
com.google.Chrome,6,1744379983,1744379989,1744379989.646765,-18000,,
com.microsoft.VSCode,23,1744379960,1744379983,1744379983.788525,-18000,,
com.google.Chrome,24,1744379936,1744379960,1744379960.5783138,-18000,,
com.microsoft.VSCode,12,1744379924,1744379936,1744379936.086697,-18000,,
com.google.Chrome,2,1744379922,1744379924,1744379924.312447,-18000,,
com.microsoft.VSCode,5,1744379917,1744379922,1744379922.885483,-18000,,
com.google.Chrome,0,1744379917,1744379917,1744379917.789287,-18000,,
com.microsoft.VSCode,3,1744379914,1744379917,1744379917.126975,-18000,,
com.google.Chrome,1,1744379913,1744379914,1744379914.354707,-18000,,
com.microsoft.VSCode,33,1744379880,1744379913,1744379913.187477,-18000,,
com.google.Chrome,11,1744379869,1744379880,1744379880.79599,-18000,,
com.microsoft.VSCode,18,1744379851,1744379869,1744379869.820838,-18000,,
com.google.Chrome,1,1744379850,1744379851,1744379851.1584148,-18000,,
com.microsoft.VSCode,139,1744379711,1744379850,1744379850.589507,-18000,,
com.google.Chrome,5,1744379706,1744379711,1744379711.1799579,-18000,,
com.microsoft.VSCode,1,1744379705,1744379706,1744379706.9695,-18000,,
com.google.Chrome,2,1744379703,1744379705,1744379706.000393,-18000,,
com.microsoft.VSCode,19,1744379684,1744379703,1744379703.848495,-18000,,
com.google.Chrome,12,1744379672,1744379684,1744379684.483855,-18000,,
com.microsoft.VSCode,17,1744379655,1744379672,1744379672.626162,-18000,,
com.google.Chrome,5,1744379650,1744379655,1744379655.1760669,-18000,,
com.microsoft.VSCode,5,1744379645,1744379650,1744379650.424674,-18000,,
com.google.Chrome,4,1744379641,1744379645,1744379645.0709782,-18000,,
com.microsoft.VSCode,4,1744379637,1744379641,1744379642.051018,-18000,,
com.google.Chrome,3,1744379634,1744379637,1744379637.350449,-18000,,
com.microsoft.VSCode,6,1744379628,1744379634,1744379634.800101,-18000,,
com.google.Chrome,4,1744379624,1744379628,1744379628.572748,-18000,,
com.microsoft.VSCode,8,1744379616,1744379624,1744379624.391862,-18000,,
com.google.Chrome,28,1744379588,1744379616,1744379616.11263,-18000,,
com.microsoft.VSCode,32,1744379556,1744379588,1744379588.538357,-18000,,
com.google.Chrome,10,1744379546,1744379556,1744379556.104816,-18000,,
com.microsoft.VSCode,6,1744379540,1744379546,1744379546.177413,-18000,,
com.google.Chrome,6,1744379534,1744379540,1744379540.273653,-18000,,
com.microsoft.VSCode,4,1744379530,1744379534,1744379534.957205,-18000,,
com.google.Chrome,85,1744379445,1744379530,1744379530.12001,-18000,,
com.microsoft.VSCode,0,1744379445,1744379445,1744379446.024481,-18000,,
com.google.Chrome,14,1744379431,1744379445,1744379445.410955,-18000,,
com.microsoft.VSCode,28,1744379403,1744379431,1744379431.837438,-18000,,
com.google.Chrome,37,1744379366,1744379403,1744379403.934513,-18000,,
com.apple.finder,1,1744379365,1744379366,1744379366.784699,-18000,,
com.leomehlig.today,93,1744379272,1744379365,1744379365.294688,-18000,,
com.leomehlig.today,13,1744342400,1744342413,1744342414.224853,-18000,,
com.google.Chrome,2288,1744340112,1744342400,1744342400.952869,-18000,,
com.google.Chrome,660,1744338077,1744338737,1744338737.8789139,-18000,,
com.leomehlig.today,54,1744338023,1744338077,1744338078.56736,-18000,,
com.apple.finder,8,1744338015,1744338023,1744338024.050009,-18000,,
com.apple.finder,302,1744323645,1744323947,1744323947.185024,-18000,,
com.leomehlig.today,57,1744323588,1744323645,1744323645.176842,-18000,,
com.google.Chrome,36,1744323552,1744323588,1744323588.089767,-18000,,
com.leomehlig.today,195,1744323357,1744323552,1744323553.0044332,-18000,,
com.google.Chrome,1174,1744322183,1744323357,1744323358.037465,-18000,,
com.apple.findmy,15,1744322168,1744322183,1744322183.0559812,-18000,,
com.google.Chrome,124,1744322044,1744322168,1744322168.989537,-18000,,
com.google.Chrome,371,1744321589,1744321960,1744321961.027941,-18000,,
com.google.Chrome,2509,1744318933,1744321442,1744321442.2969332,-18000,,
com.leomehlig.today,7,1744318926,1744318933,1744318933.090276,-18000,,
com.apple.finder,1,1744318925,1744318926,1744318926.9339352,-18000,,
com.apple.iCal,5,1744318920,1744318925,1744318925.648233,-18000,,
com.leomehlig.today,10,1744318910,1744318920,1744318920.056124,-18000,,
com.google.Chrome,8,1744318902,1744318910,1744318910.519115,-18000,,
com.leomehlig.today,19,1744318856,1744318875,1744318875.742268,-18000,,
com.google.Chrome,2,1744318854,1744318856,1744318859.9619598,-18000,,
com.apple.finder,0,1744318788,1744318788,1744318789.061287,-18000,,
com.google.Chrome,621,1744318167,1744318788,1744318788.399483,-18000,,
com.google.Chrome,162,1744316665,1744316827,1744316827.6568189,-18000,,
com.apple.Passwords,6,1744316659,1744316665,1744316665.965917,-18000,,
com.google.Chrome,2,1744316657,1744316659,1744316659.449222,-18000,,
com.apple.calculator,2,1744316655,1744316657,1744316657.431576,-18000,,
com.apple.calculator,303,1744315059,1744315362,1744315362.777372,-18000,,
com.google.Chrome,5,1744315054,1744315059,1744315059.520698,-18000,,
com.google.Chrome,301,1744312538,1744312839,1744312839.099307,-18000,,
com.google.Chrome,300,1744312237,1744312537,1744312537.976604,-18000,,
com.google.Chrome,318,1744311918,1744312236,1744312236.028898,-18000,,
com.google.Chrome,308,1744311519,1744311827,1744311827.688208,-18000,,
com.google.Chrome,4,1744310244,1744310248,1744310248.4689689,-18000,,
com.leomehlig.today,310,1744309934,1744310244,1744310244.118371,-18000,,
com.google.Chrome,109,1744309825,1744309934,1744309934.535851,-18000,,
com.apple.systempreferences,41,1744309784,1744309825,1744309825.920679,-18000,,
com.google.Chrome,11,1744309767,1744309778,1744309778.085763,-18000,,
com.apple.Passwords,7,1744309735,1744309742,1744309742.412046,-18000,,
com.google.Chrome,17,1744309718,1744309735,1744309735.257992,-18000,,
com.apple.iCal,68,1744309650,1744309718,1744309718.932087,-18000,,
com.google.Chrome,10,1744309640,1744309650,1744309650.269656,-18000,,
com.apple.iCal,17,1744309623,1744309640,1744309640.136187,-18000,,
com.google.Chrome,7,1744309616,1744309623,1744309623.520309,-18000,,
com.apple.iCal,62,1744309554,1744309616,1744309616.769473,-18000,,
com.google.Chrome,12,1744309542,1744309554,1744309554.840488,-18000,,
com.leomehlig.today,164,1744309378,1744309542,1744309542.614361,-18000,,
com.google.Chrome,196,1744309182,1744309378,1744309378.260281,-18000,,
com.google.Chrome,610,1744308565,1744309175,1744309175.994289,-18000,,
com.leomehlig.today,76,1744308489,1744308565,1744308565.1942801,-18000,,
com.google.Chrome,4,1744308485,1744308489,1744308490.027666,-18000,,
com.apple.finder,4,1744308278,1744308282,1744308282.74838,-18000,,
com.apple.finder,3,1744301371,1744301374,1744301374.9625359,-18000,,
com.leomehlig.today,1,1744301370,1744301371,1744301371.220368,-18000,,
com.apple.finder,38,1744301332,1744301370,1744301370.1459389,-18000,,
com.leomehlig.today,18,1744301314,1744301332,1744301332.841628,-18000,,
com.google.Chrome,47,1744301267,1744301314,1744301314.810641,-18000,,
com.apple.iCal,23,1744301132,1744301155,1744301155.232014,-18000,,
com.google.Chrome,234,1744300898,1744301132,1744301132.557664,-18000,,
com.leomehlig.today,16,1744300872,1744300888,1744300888.2570481,-18000,,
com.google.Chrome,27,1744300845,1744300872,1744300872.229364,-18000,,
com.microsoft.VSCode,796,1744300049,1744300845,1744300846.855854,-18000,,
com.google.Chrome,111,1744299938,1744300049,1744300049.495006,-18000,,
com.leomehlig.today,4,1744299934,1744299938,1744299938.505902,-18000,,
com.microsoft.VSCode,2,1744299932,1744299934,1744299934.846354,-18000,,
com.leomehlig.today,7,1744299925,1744299932,1744299932.225905,-18000,,
com.microsoft.VSCode,2,1744299923,1744299925,1744299925.7502542,-18000,,
com.google.Chrome,122,1744299801,1744299923,1744299923.982676,-18000,,
com.apple.finder,2,1744299799,1744299801,1744299801.8855371,-18000,,
com.google.Chrome,2,1744299797,1744299799,1744299799.528263,-18000,,
com.apple.finder,0,1744299797,1744299797,1744299797.7982259,-18000,,
com.google.Chrome,58,1744299739,1744299797,1744299797.239616,-18000,,
com.apple.finder,4,1744299735,1744299739,1744299739.2680879,-18000,,
com.google.Chrome,1292,1744298443,1744299735,1744299735.434993,-18000,,
com.apple.finder,1,1744298442,1744298443,1744298443.4843311,-18000,,
com.google.Chrome,55,1744298387,1744298442,1744298442.489946,-18000,,
com.apple.finder,1,1744298386,1744298387,1744298387.947731,-18000,,
com.google.Chrome,448,1744297938,1744298386,1744298387.012495,-18000,,
com.apple.finder,1,1744297937,1744297938,1744297938.937525,-18000,,
com.google.Chrome,0,1744297937,1744297937,1744297937.616435,-18000,,
com.apple.finder,2,1744297935,1744297937,1744297937.269202,-18000,,
com.google.Chrome,1,1744297934,1744297935,1744297935.6469631,-18000,,
com.apple.finder,15,1744297919,1744297934,1744297934.882029,-18000,,
com.microsoft.VSCode,62,1744297857,1744297919,1744297919.458229,-18000,,
com.google.Chrome,27,1744297830,1744297857,1744297857.8431048,-18000,,
com.microsoft.VSCode,2,1744297828,1744297830,1744297830.7007608,-18000,,
com.google.Chrome,2,1744297826,1744297828,1744297828.1316261,-18000,,
com.microsoft.VSCode,118,1744297708,1744297826,1744297826.4940991,-18000,,
com.apple.finder,115,1744297593,1744297708,1744297708.2879791,-18000,,
com.google.Chrome,25,1744297568,1744297593,1744297593.715966,-18000,,
com.apple.finder,2,1744297566,1744297568,1744297568.6145759,-18000,,
com.google.Chrome,2,1744297564,1744297566,1744297566.750362,-18000,,
com.apple.finder,8,1744297556,1744297564,1744297564.074002,-18000,,
com.google.Chrome,5,1744297551,1744297556,1744297556.18849,-18000,,
com.apple.finder,2,1744297549,1744297551,1744297551.387635,-18000,,
com.google.Chrome,4,1744297545,1744297549,1744297549.38279,-18000,,
com.apple.finder,4,1744297541,1744297545,1744297545.8395329,-18000,,
com.google.Chrome,1,1744297540,1744297541,1744297541.740076,-18000,,
com.microsoft.VSCode,7,1744297533,1744297540,1744297540.972995,-18000,,
com.apple.finder,6,1744297527,1744297533,1744297533.059511,-18000,,
com.microsoft.VSCode,1,1744297526,1744297527,1744297528.022598,-18000,,
com.google.Chrome,4,1744297522,1744297526,1744297526.539592,-18000,,
com.microsoft.VSCode,1,1744297521,1744297522,1744297522.5238729,-18000,,
com.google.Chrome,0,1744297521,1744297521,1744297522.001811,-18000,,
com.microsoft.VSCode,5,1744297516,1744297521,1744297521.131609,-18000,,
com.google.Chrome,1,1744297515,1744297516,1744297516.235151,-18000,,
com.microsoft.VSCode,26,1744297489,1744297515,1744297515.213252,-18000,,
com.google.Chrome,14,1744297475,1744297489,1744297489.758006,-18000,,
com.microsoft.VSCode,29,1744297446,1744297475,1744297475.665543,-18000,,
com.google.Chrome,4,1744297442,1744297446,1744297446.383984,-18000,,
com.microsoft.VSCode,13,1744297429,1744297442,1744297442.781312,-18000,,
com.google.Chrome,1,1744297428,1744297429,1744297429.203749,-18000,,
com.microsoft.VSCode,3,1744297425,1744297428,1744297428.6645222,-18000,,
com.google.Chrome,216,1744297209,1744297425,1744297426.0047522,-18000,,
com.apple.finder,5,1744297204,1744297209,1744297209.615557,-18000,,
com.google.Chrome,563,1744296641,1744297204,1744297204.182674,-18000,,
com.apple.finder,4,1744296637,1744296641,1744296641.9359288,-18000,,
com.google.Chrome,11,1744296626,1744296637,1744296637.783094,-18000,,
com.apple.finder,2,1744296624,1744296626,1744296626.070613,-18000,,
com.google.Chrome,51,1744296573,1744296624,1744296624.750411,-18000,,
com.apple.finder,3,1744296570,1744296573,1744296573.6996288,-18000,,
com.google.Chrome,30,1744296540,1744296570,1744296570.896117,-18000,,
com.apple.Preview,35,1744296505,1744296540,1744296540.249556,-18000,,
com.apple.finder,6,1744296499,1744296505,1744296505.972445,-18000,,
com.google.Chrome,37,1744296462,1744296499,1744296499.593153,-18000,,
com.apple.finder,3,1744296459,1744296462,1744296462.5106192,-18000,,
com.google.Chrome,0,1744296459,1744296459,1744296460.017108,-18000,,
com.microsoft.VSCode,1,1744296458,1744296459,1744296459.246336,-18000,,
com.google.Chrome,15,1744296443,1744296458,1744296458.3832622,-18000,,
com.apple.finder,2,1744296441,1744296443,1744296443.933172,-18000,,
com.google.Chrome,1,1744296440,1744296441,1744296441.057413,-18000,,
com.apple.finder,12,1744296428,1744296440,1744296440.4261498,-18000,,
com.microsoft.VSCode,17,1744296411,1744296428,1744296428.419224,-18000,,
com.google.Chrome,18,1744296393,1744296411,1744296411.937131,-18000,,
com.apple.Notes,8,1744296385,1744296393,1744296393.068784,-18000,,
com.google.Chrome,95,1744296290,1744296385,1744296385.6070561,-18000,,
com.apple.Notes,6,1744296284,1744296290,1744296290.780167,-18000,,
com.google.Chrome,18,1744296266,1744296284,1744296284.484304,-18000,,
com.apple.Notes,7,1744296259,1744296266,1744296266.559701,-18000,,
com.google.Chrome,191,1744296068,1744296259,1744296259.327482,-18000,,
com.apple.Notes,2,1744296066,1744296068,1744296068.1574779,-18000,,
com.google.Chrome,17,1744296049,1744296066,1744296066.237225,-18000,,
com.apple.Notes,3,1744296046,1744296049,1744296049.831382,-18000,,
com.google.Chrome,6,1744296040,1744296046,1744296046.374361,-18000,,
com.apple.Notes,21,1744296019,1744296040,1744296040.249179,-18000,,
com.google.Chrome,4,1744296015,1744296019,1744296019.394109,-18000,,
com.apple.Notes,3,1744296012,1744296015,1744296015.969706,-18000,,
com.google.Chrome,238,1744295774,1744296012,1744296012.1422482,-18000,,
com.apple.Notes,79,1744295695,1744295774,1744295774.0720348,-18000,,
com.google.Chrome,8,1744295687,1744295695,1744295695.117243,-18000,,
com.microsoft.VSCode,3,1744295684,1744295687,1744295687.6304479,-18000,,
com.google.Chrome,74,1744295610,1744295684,1744295684.9573169,-18000,,
com.apple.finder,0,1744295610,1744295610,1744295611.0351949,-18000,,
com.google.Chrome,0,1744295610,1744295610,1744295610.759207,-18000,,
com.apple.finder,2,1744295608,1744295610,1744295610.170182,-18000,,
com.google.Chrome,43,1744295565,1744295608,1744295608.0897698,-18000,,
com.apple.finder,4,1744295561,1744295565,1744295565.080752,-18000,,
com.google.Chrome,13,1744295548,1744295561,1744295561.10292,-18000,,
com.apple.finder,16,1744295532,1744295548,1744295548.9700232,-18000,,
com.google.Chrome,1,1744295531,1744295532,1744295533.033854,-18000,,
com.apple.finder,8,1744295523,1744295531,1744295531.695115,-18000,,
com.google.Chrome,16,1744295507,1744295523,1744295523.555305,-18000,,
com.apple.finder,10,1744295497,1744295507,1744295507.196399,-18000,,
com.google.Chrome,7,1744295490,1744295497,1744295497.63763,-18000,,
com.apple.finder,3,1744295487,1744295490,1744295490.8922281,-18000,,
com.google.Chrome,9,1744295478,1744295487,1744295487.694058,-18000,,
com.apple.finder,20,1744295458,1744295478,1744295478.202013,-18000,,
com.google.Chrome,45,1744295413,1744295458,1744295458.436487,-18000,,
com.apple.finder,8,1744295405,1744295413,1744295413.4439921,-18000,,
com.google.Chrome,18,1744295387,1744295405,1744295405.581285,-18000,,
com.apple.finder,38,1744295349,1744295387,1744295387.74155,-18000,,
com.google.Chrome,213,1744295136,1744295349,1744295349.891109,-18000,,
com.apple.finder,1,1744295135,1744295136,1744295136.902616,-18000,,
com.microsoft.VSCode,1,1744295134,1744295135,1744295135.8708959,-18000,,
com.google.Chrome,15,1744295119,1744295134,1744295134.230874,-18000,,
com.apple.finder,2,1744295117,1744295119,1744295119.228181,-18000,,
com.google.Chrome,18,1744295099,1744295117,1744295117.452352,-18000,,
com.apple.finder,13,1744295086,1744295099,1744295099.377034,-18000,,
com.google.Chrome,42,1744295044,1744295086,1744295086.2708678,-18000,,
com.microsoft.VSCode,41,1744295003,1744295044,1744295044.327095,-18000,,
com.google.Chrome,420,1744294583,1744295003,1744295003.829056,-18000,,
com.apple.finder,36,1744294547,1744294583,1744294583.632256,-18000,,
com.google.Chrome,10,1744294537,1744294547,1744294547.8994331,-18000,,
com.microsoft.VSCode,1,1744294536,1744294537,1744294537.7608418,-18000,,
com.google.Chrome,124,1744294412,1744294536,1744294536.784019,-18000,,
com.microsoft.VSCode,1,1744294411,1744294412,1744294412.6790051,-18000,,
com.google.Chrome,128,1744294283,1744294411,1744294411.158777,-18000,,
com.microsoft.VSCode,18,1744294265,1744294283,1744294284.024997,-18000,,
com.google.Chrome,199,1744294066,1744294265,1744294265.190586,-18000,,
com.microsoft.VSCode,157,1744293909,1744294066,1744294066.1284308,-18000,,
com.google.Chrome,48,1744293861,1744293909,1744293909.6562119,-18000,,
com.apple.Notes,44,1744293817,1744293861,1744293861.978152,-18000,,
com.google.Chrome,169,1744293648,1744293817,1744293817.565759,-18000,,
com.microsoft.VSCode,13,1744293635,1744293648,1744293648.248033,-18000,,
com.google.Chrome,2,1744293633,1744293635,1744293635.464417,-18000,,
com.microsoft.VSCode,29,1744293604,1744293633,1744293633.403105,-18000,,
com.google.Chrome,19,1744293585,1744293604,1744293604.596336,-18000,,
com.microsoft.VSCode,88,1744293497,1744293585,1744293585.883219,-18000,,
com.google.Chrome,2,1744293495,1744293497,1744293497.975247,-18000,,
com.microsoft.VSCode,3,1744293492,1744293495,1744293495.795446,-18000,,
com.google.Chrome,108,1744293384,1744293492,1744293492.8521729,-18000,,
com.microsoft.VSCode,1,1744293383,1744293384,1744293384.9301891,-18000,,
com.google.Chrome,25,1744293358,1744293383,1744293383.544261,-18000,,
com.microsoft.VSCode,0,1744293358,1744293358,1744293358.554066,-18000,,
com.google.Chrome,3,1744293355,1744293358,1744293358.15483,-18000,,
com.microsoft.VSCode,1,1744293354,1744293355,1744293355.670776,-18000,,
com.apple.finder,1,1744293353,1744293354,1744293354.2860188,-18000,,
com.microsoft.VSCode,3,1744293350,1744293353,1744293353.216138,-18000,,
com.google.Chrome,25,1744293325,1744293350,1744293350.682153,-18000,,
com.microsoft.VSCode,6,1744293319,1744293325,1744293325.923728,-18000,,
com.google.Chrome,17,1744293302,1744293319,1744293319.116251,-18000,,
com.microsoft.VSCode,9,1744293293,1744293302,1744293302.1063519,-18000,,
com.google.Chrome,19,1744293274,1744293293,1744293293.585316,-18000,,
com.microsoft.VSCode,5,1744293269,1744293274,1744293274.912497,-18000,,
com.google.Chrome,5,1744293264,1744293269,1744293269.701007,-18000,,
com.microsoft.VSCode,4,1744293260,1744293264,1744293264.492628,-18000,,
com.google.Chrome,94,1744293166,1744293260,1744293260.902001,-18000,,
com.microsoft.VSCode,21,1744293145,1744293166,1744293166.704571,-18000,,
com.google.Chrome,54,1744293091,1744293145,1744293145.653518,-18000,,
com.apple.finder,58,1744293033,1744293091,1744293091.369304,-18000,,
com.google.Chrome,100,1744292933,1744293033,1744293033.265207,-18000,,
com.apple.finder,1,1744292932,1744292933,1744292934.073643,-18000,,
com.google.Chrome,1,1744292931,1744292932,1744292932.8049011,-18000,,
com.apple.finder,3,1744292928,1744292931,1744292931.178319,-18000,,
com.microsoft.VSCode,3,1744292925,1744292928,1744292928.140053,-18000,,
com.apple.finder,4,1744292921,1744292925,1744292925.343821,-18000,,
com.microsoft.VSCode,5,1744292916,1744292921,1744292921.693264,-18000,,
com.google.Chrome,17,1744292899,1744292916,1744292916.703874,-18000,,
com.apple.finder,8,1744292891,1744292899,1744292899.7174249,-18000,,
com.google.Chrome,1,1744292890,1744292891,1744292891.855506,-18000,,
com.apple.finder,4,1744292886,1744292890,1744292890.440521,-18000,,
com.google.Chrome,3,1744292883,1744292886,1744292886.131264,-18000,,
com.microsoft.VSCode,29,1744292854,1744292883,1744292883.2028608,-18000,,
com.apple.finder,9,1744292845,1744292854,1744292854.6253119,-18000,,
com.microsoft.VSCode,21,1744292824,1744292845,1744292845.183179,-18000,,
com.google.Chrome,1,1744292823,1744292824,1744292824.903486,-18000,,
com.microsoft.VSCode,2,1744292821,1744292823,1744292823.497057,-18000,,
com.google.Chrome,6,1744292815,1744292821,1744292821.240841,-18000,,
com.microsoft.VSCode,1,1744292814,1744292815,1744292815.59886,-18000,,
com.apple.finder,41,1744292773,1744292814,1744292814.662434,-18000,,
com.microsoft.VSCode,26,1744292747,1744292773,1744292773.3147721,-18000,,
com.google.Chrome,6,1744292741,1744292747,1744292747.108556,-18000,,
com.microsoft.VSCode,7,1744292734,1744292741,1744292741.6041188,-18000,,
com.google.Chrome,2,1744292732,1744292734,1744292734.204952,-18000,,
com.microsoft.VSCode,13,1744292719,1744292732,1744292732.765222,-18000,,
com.google.Chrome,9,1744292710,1744292719,1744292719.2740622,-18000,,
com.microsoft.VSCode,2,1744292708,1744292710,1744292710.310875,-18000,,
com.google.Chrome,2,1744292706,1744292708,1744292709.047054,-18000,,
com.microsoft.VSCode,69,1744292637,1744292706,1744292706.51407,-18000,,
com.google.Chrome,3,1744292634,1744292637,1744292638.03155,-18000,,
com.microsoft.VSCode,26,1744292608,1744292634,1744292634.2510772,-18000,,
com.google.Chrome,112,1744292496,1744292608,1744292608.687928,-18000,,
com.apple.finder,7,1744292489,1744292496,1744292496.660744,-18000,,
com.leomehlig.today,11,1744292478,1744292489,1744292489.8555799,-18000,,
com.google.Chrome,217,1744292261,1744292478,1744292479.1010861,-18000,,
com.google.Chrome,386,1744253335,1744253721,1744253721.163023,-18000,,
com.apple.finder,103,1744253232,1744253335,1744253335.441914,-18000,,
com.leomehlig.today,1,1744253231,1744253232,1744253232.169666,-18000,,
com.apple.finder,2,1744253229,1744253231,1744253231.6017761,-18000,,
com.microsoft.VSCode,3,1744253226,1744253229,1744253229.8276,-18000,,
com.google.Chrome,5,1744253221,1744253226,1744253226.948228,-18000,,
com.apple.finder,1,1744253220,1744253221,1744253221.240797,-18000,,
com.google.Chrome,52,1744253168,1744253220,1744253220.8237882,-18000,,
com.apple.finder,10,1744253158,1744253168,1744253169.003491,-18000,,
com.google.Chrome,1,1744253157,1744253158,1744253158.821186,-18000,,
com.apple.finder,1,1744253156,1744253157,1744253157.871655,-18000,,
com.google.Chrome,5,1744253151,1744253156,1744253156.2253342,-18000,,
com.apple.finder,0,1744253151,1744253151,1744253152.0433521,-18000,,
com.google.Chrome,2,1744253149,1744253151,1744253151.309095,-18000,,
com.microsoft.VSCode,1,1744253148,1744253149,1744253149.828732,-18000,,
com.apple.finder,4,1744253144,1744253148,1744253148.928894,-18000,,
com.microsoft.VSCode,11,1744253133,1744253144,1744253144.786893,-18000,,
com.apple.finder,5,1744253128,1744253133,1744253133.963001,-18000,,
com.microsoft.VSCode,41,1744253087,1744253128,1744253128.053911,-18000,,
com.google.Chrome,4,1744253083,1744253087,1744253087.70385,-18000,,
com.microsoft.VSCode,6,1744253077,1744253083,1744253083.514575,-18000,,
com.google.Chrome,5,1744253072,1744253077,1744253077.3441582,-18000,,
com.microsoft.VSCode,11,1744253061,1744253072,1744253072.114633,-18000,,
com.google.Chrome,44,1744253017,1744253061,1744253061.804875,-18000,,
com.apple.finder,5,1744253012,1744253017,1744253017.892622,-18000,,
com.google.Chrome,2,1744253010,1744253012,1744253012.723269,-18000,,
com.microsoft.VSCode,1,1744253009,1744253010,1744253010.679295,-18000,,
com.microsoft.VSCode,350,1744251922,1744252272,1744252272.836351,-18000,,
com.google.Chrome,12,1744251855,1744251867,1744251867.611792,-18000,,
com.microsoft.VSCode,9,1744251846,1744251855,1744251855.7589378,-18000,,
com.google.Chrome,209,1744251637,1744251846,1744251846.4720302,-18000,,
com.apple.finder,5,1744251632,1744251637,1744251637.104648,-18000,,
com.google.Chrome,2,1744251630,1744251632,1744251632.323472,-18000,,
com.microsoft.VSCode,3,1744251627,1744251630,1744251630.958606,-18000,,
com.microsoft.VSCode,310,1744251149,1744251459,1744251459.8370318,-18000,,
com.leomehlig.today,3,1744251146,1744251149,1744251150.044842,-18000,,
com.leomehlig.today,314,1744250471,1744250785,1744250785.6039162,-18000,,
com.microsoft.VSCode,1,1744250470,1744250471,1744250471.497342,-18000,,
com.apple.Notes,1,1744250469,1744250470,1744250470.867072,-18000,,
com.microsoft.VSCode,4,1744250465,1744250469,1744250469.413014,-18000,,
com.google.Chrome,35,1744250430,1744250465,1744250465.670014,-18000,,
com.apple.Notes,5,1744250425,1744250430,1744250430.571203,-18000,,
com.google.Chrome,180,1744250245,1744250425,1744250425.6091828,-18000,,
com.microsoft.VSCode,11,1744250234,1744250245,1744250245.68226,-18000,,
com.google.Chrome,8,1744250226,1744250234,1744250234.479677,-18000,,
com.microsoft.VSCode,7,1744250219,1744250226,1744250226.835281,-18000,,
com.google.Chrome,7,1744250212,1744250219,1744250219.105542,-18000,,
com.microsoft.VSCode,1,1744250211,1744250212,1744250212.2872849,-18000,,
com.google.Chrome,5,1744250206,1744250211,1744250211.265043,-18000,,
com.microsoft.VSCode,5,1744250201,1744250206,1744250206.127203,-18000,,
com.google.Chrome,7,1744250194,1744250201,1744250201.919167,-18000,,
com.microsoft.VSCode,91,1744250103,1744250194,1744250194.99704,-18000,,
com.google.Chrome,79,1744250024,1744250103,1744250103.675144,-18000,,
com.apple.finder,2,1744250022,1744250024,1744250024.458003,-18000,,
com.google.Chrome,0,1744250022,1744250022,1744250023.056013,-18000,,
com.apple.finder,11,1744250011,1744250022,1744250022.516119,-18000,,
com.microsoft.VSCode,6,1744250005,1744250011,1744250011.463515,-18000,,
com.apple.finder,17,1744249988,1744250005,1744250005.3367271,-18000,,
com.microsoft.VSCode,17,1744249971,1744249988,1744249988.124671,-18000,,
com.google.Chrome,75,1744249896,1744249971,1744249972.025224,-18000,,
com.microsoft.VSCode,1,1744249881,1744249882,1744249882.534995,-18000,,
com.leomehlig.today,5,1744249876,1744249881,1744249881.1058779,-18000,,
com.microsoft.VSCode,4,1744249872,1744249876,1744249876.8498769,-18000,,
com.google.Chrome,210,1744249662,1744249872,1744249872.486054,-18000,,
com.microsoft.VSCode,1,1744249661,1744249662,1744249662.879926,-18000,,
com.google.Chrome,564,1744249097,1744249661,1744249661.8350391,-18000,,
com.microsoft.VSCode,3,1744249094,1744249097,1744249097.895772,-18000,,
com.google.Chrome,6,1744249088,1744249094,1744249094.739564,-18000,,
com.microsoft.VSCode,1,1744249087,1744249088,1744249088.277618,-18000,,
com.google.Chrome,30,1744249057,1744249087,1744249087.62619,-18000,,
com.microsoft.VSCode,67,1744248990,1744249057,1744249057.7092729,-18000,,
com.google.Chrome,101,1744248889,1744248990,1744248990.53549,-18000,,
com.apple.Notes,26,1744248863,1744248889,1744248889.5635018,-18000,,
com.apple.Preview,85,1744248778,1744248863,1744248863.8660789,-18000,,
com.apple.finder,11,1744248767,1744248778,1744248778.802055,-18000,,
com.apple.Preview,1,1744248766,1744248767,1744248767.875679,-18000,,
com.apple.finder,74,1744248692,1744248766,1744248766.477816,-18000,,
com.google.Chrome,1,1744248691,1744248692,1744248692.394203,-18000,,
com.microsoft.VSCode,6,1744248685,1744248691,1744248691.3574271,-18000,,
com.google.Chrome,5,1744248680,1744248685,1744248685.792925,-18000,,
com.apple.Notes,2,1744248678,1744248680,1744248680.786117,-18000,,
com.microsoft.VSCode,2,1744248676,1744248678,1744248678.238772,-18000,,
com.google.Chrome,138,1744248538,1744248676,1744248677.0381021,-18000,,
com.apple.finder,9,1744248529,1744248538,1744248538.672021,-18000,,
com.google.Chrome,1,1744248528,1744248529,1744248529.816471,-18000,,
com.apple.finder,2,1744248526,1744248528,1744248528.694134,-18000,,
com.google.Chrome,7,1744248519,1744248526,1744248527.024969,-18000,,
com.apple.finder,2,1744248517,1744248519,1744248519.312615,-18000,,
com.microsoft.VSCode,32,1744248485,1744248517,1744248517.271006,-18000,,
com.apple.finder,1,1744248484,1744248485,1744248485.998955,-18000,,
com.google.Chrome,4,1744248480,1744248484,1744248484.795096,-18000,,
com.apple.finder,19,1744248461,1744248480,1744248480.977895,-18000,,
com.microsoft.VSCode,5,1744248456,1744248461,1744248461.365734,-18000,,
com.apple.finder,13,1744248443,1744248456,1744248456.8772578,-18000,,
com.microsoft.VSCode,28,1744248415,1744248443,1744248443.924659,-18000,,
com.apple.finder,21,1744248394,1744248415,1744248415.922779,-18000,,
com.microsoft.VSCode,18,1744248376,1744248394,1744248394.472951,-18000,,
com.apple.finder,7,1744248369,1744248376,1744248376.8006558,-18000,,
com.microsoft.VSCode,144,1744248225,1744248369,1744248369.786669,-18000,,
com.apple.finder,23,1744248202,1744248225,1744248225.121447,-18000,,
com.microsoft.VSCode,4,1744248198,1744248202,1744248202.797616,-18000,,
com.google.Chrome,33,1744248165,1744248198,1744248198.3184252,-18000,,
com.microsoft.VSCode,8,1744248157,1744248165,1744248165.160814,-18000,,
com.google.Chrome,13,1744248144,1744248157,1744248157.228143,-18000,,
com.microsoft.VSCode,5,1744248139,1744248144,1744248144.440655,-18000,,
com.apple.Dictionary,1,1744248138,1744248139,1744248140.0017,-18000,,
com.microsoft.VSCode,6,1744248132,1744248138,1744248138.258321,-18000,,
com.apple.Preview,19,1744248113,1744248132,1744248132.814107,-18000,,
com.microsoft.VSCode,21,1744248092,1744248113,1744248113.147795,-18000,,
com.apple.Preview,22,1744248070,1744248092,1744248092.231639,-18000,,
com.apple.finder,10,1744248060,1744248070,1744248070.971581,-18000,,
com.apple.Preview,7,1744248053,1744248060,1744248060.320771,-18000,,
com.apple.finder,9,1744248044,1744248053,1744248053.714849,-18000,,
com.microsoft.VSCode,108,1744247936,1744248044,1744248044.721519,-18000,,
com.apple.finder,63,1744247873,1744247936,1744247936.779076,-18000,,
com.microsoft.VSCode,7,1744247866,1744247873,1744247873.074543,-18000,,
com.apple.finder,4,1744247862,1744247866,1744247866.375998,-18000,,
com.microsoft.VSCode,14,1744247848,1744247862,1744247862.258987,-18000,,
com.apple.finder,12,1744247836,1744247848,1744247848.1822948,-18000,,
com.microsoft.VSCode,19,1744247817,1744247836,1744247836.604532,-18000,,
com.apple.finder,29,1744247788,1744247817,1744247817.0851521,-18000,,
com.microsoft.VSCode,43,1744247745,1744247788,1744247788.4368,-18000,,
com.apple.finder,2,1744247743,1744247745,1744247745.085149,-18000,,
com.microsoft.VSCode,18,1744247725,1744247743,1744247743.693503,-18000,,
com.apple.finder,8,1744247717,1744247725,1744247725.7509599,-18000,,
com.microsoft.VSCode,6,1744247711,1744247717,1744247717.927833,-18000,,
com.apple.finder,3,1744247708,1744247711,1744247711.352278,-18000,,
com.microsoft.VSCode,4,1744247704,1744247708,1744247708.203021,-18000,,
com.apple.finder,1,1744247703,1744247704,1744247704.452419,-18000,,
com.microsoft.VSCode,5,1744247698,1744247703,1744247703.62538,-18000,,
com.apple.finder,4,1744247694,1744247698,1744247698.765214,-18000,,
com.microsoft.VSCode,3,1744247691,1744247694,1744247694.54249,-18000,,
com.apple.finder,21,1744247670,1744247691,1744247691.180488,-18000,,
com.microsoft.VSCode,9,1744247661,1744247670,1744247670.257118,-18000,,
com.apple.finder,1,1744247660,1744247661,1744247662.031024,-18000,,
com.microsoft.VSCode,2,1744247658,1744247660,1744247660.918756,-18000,,
com.apple.finder,5,1744247653,1744247658,1744247659.051907,-18000,,
com.microsoft.VSCode,2,1744247651,1744247653,1744247654.006475,-18000,,
com.google.Chrome,1,1744247650,1744247651,1744247651.6510038,-18000,,
com.apple.Notes,2,1744247648,1744247650,1744247650.034358,-18000,,
com.microsoft.VSCode,22,1744247626,1744247648,1744247649.0199242,-18000,,
com.apple.Notes,2,1744247624,1744247626,1744247626.082197,-18000,,
com.google.Chrome,1,1744247623,1744247624,1744247624.9238439,-18000,,
com.apple.finder,8,1744247615,1744247623,1744247623.7630281,-18000,,
com.google.Chrome,16,1744247599,1744247615,1744247615.373334,-18000,,
com.apple.finder,32,1744247567,1744247599,1744247599.156188,-18000,,
com.microsoft.VSCode,2,1744247565,1744247567,1744247567.856698,-18000,,
com.apple.finder,3,1744247562,1744247565,1744247565.6062288,-18000,,
com.microsoft.VSCode,51,1744247511,1744247562,1744247562.205594,-18000,,
com.apple.finder,55,1744247456,1744247511,1744247511.465889,-18000,,
com.microsoft.VSCode,2,1744247454,1744247456,1744247456.7565641,-18000,,
com.apple.finder,5,1744247449,1744247454,1744247454.219274,-18000,,
com.microsoft.VSCode,17,1744247432,1744247449,1744247449.8752398,-18000,,
com.apple.finder,13,1744247419,1744247432,1744247432.593412,-18000,,
com.google.Chrome,2,1744247417,1744247419,1744247419.308151,-18000,,
com.microsoft.VSCode,33,1744247384,1744247417,1744247417.201735,-18000,,
com.apple.finder,20,1744247364,1744247384,1744247384.9568748,-18000,,
com.microsoft.VSCode,23,1744247341,1744247364,1744247364.535568,-18000,,
com.apple.finder,6,1744247335,1744247341,1744247341.2239242,-18000,,
com.microsoft.VSCode,58,1744247277,1744247335,1744247335.28375,-18000,,
com.google.Chrome,13,1744247264,1744247277,1744247277.571801,-18000,,
com.microsoft.VSCode,13,1744247251,1744247264,1744247264.49047,-18000,,
com.apple.finder,5,1744247246,1744247251,1744247251.246388,-18000,,
com.microsoft.VSCode,11,1744247235,1744247246,1744247246.640835,-18000,,
com.apple.finder,1,1744247234,1744247235,1744247235.2084808,-18000,,
com.google.Chrome,3,1744247231,1744247234,1744247234.228959,-18000,,
com.apple.finder,22,1744247209,1744247231,1744247231.339705,-18000,,
com.microsoft.VSCode,29,1744247180,1744247209,1744247209.562625,-18000,,
com.google.Chrome,31,1744247149,1744247180,1744247180.8948069,-18000,,
com.microsoft.VSCode,7,1744247142,1744247149,1744247149.47488,-18000,,
com.apple.finder,7,1744247135,1744247142,1744247143.010776,-18000,,
com.microsoft.VSCode,15,1744247120,1744247135,1744247135.772509,-18000,,
com.apple.finder,39,1744247081,1744247120,1744247120.435874,-18000,,
com.microsoft.VSCode,6,1744247075,1744247081,1744247081.707549,-18000,,
com.google.Chrome,6,1744247069,1744247075,1744247075.752544,-18000,,
com.microsoft.VSCode,4,1744247065,1744247069,1744247069.957467,-18000,,
com.google.Chrome,3,1744247062,1744247065,1744247065.739111,-18000,,
com.microsoft.VSCode,2,1744247060,1744247062,1744247062.831499,-18000,,
com.google.Chrome,3,1744247057,1744247060,1744247060.048007,-18000,,
com.microsoft.VSCode,3,1744247054,1744247057,1744247057.254939,-18000,,
com.google.Chrome,4,1744247050,1744247054,1744247054.8026671,-18000,,
com.microsoft.VSCode,3,1744247047,1744247050,1744247050.139512,-18000,,
com.google.Chrome,3,1744247044,1744247047,1744247047.8839312,-18000,,
com.microsoft.VSCode,3,1744247041,1744247044,1744247044.628694,-18000,,
com.google.Chrome,43,1744246998,1744247041,1744247041.0769482,-18000,,
com.microsoft.VSCode,2,1744246996,1744246998,1744246998.682239,-18000,,
com.google.Chrome,4,1744246992,1744246996,1744246996.0419168,-18000,,
com.microsoft.VSCode,35,1744246957,1744246992,1744246992.033737,-18000,,
com.google.Chrome,8,1744246949,1744246957,1744246957.636756,-18000,,
com.apple.Notes,8,1744246941,1744246949,1744246949.783674,-18000,,
com.google.Chrome,12,1744246929,1744246941,1744246941.233422,-18000,,
com.microsoft.VSCode,72,1744246857,1744246929,1744246929.349345,-18000,,
com.google.Chrome,5,1744246852,1744246857,1744246857.642765,-18000,,
com.microsoft.VSCode,11,1744246841,1744246852,1744246852.357205,-18000,,
com.google.Chrome,81,1744246760,1744246841,1744246841.155232,-18000,,
com.microsoft.VSCode,84,1744246676,1744246760,1744246760.874673,-18000,,
com.google.Chrome,27,1744246649,1744246676,1744246677.015812,-18000,,
com.apple.finder,4,1744246645,1744246649,1744246650.0785441,-18000,,
com.leomehlig.today,11,1744246634,1744246645,1744246645.382721,-18000,,
com.leomehlig.today,300,1744246290,1744246590,1744246590.21915,-18000,,
com.apple.Notes,2,1744246288,1744246290,1744246290.216229,-18000,,
com.leomehlig.today,3,1744246285,1744246288,1744246288.122608,-18000,,
com.apple.news,107,1744246178,1744246285,1744246285.2693992,-18000,,
com.leomehlig.today,58,1744246120,1744246178,1744246178.410855,-18000,,
com.google.Chrome,4,1744246116,1744246120,1744246120.168731,-18000,,
com.google.Chrome,147,1744241000,1744241147,1744241147.475935,-18000,,
com.microsoft.Outlook,59,1744240923,1744240982,1744240982.234844,-18000,,
com.google.Chrome,26,1744240897,1744240923,1744240923.818418,-18000,,
com.leomehlig.today,11,1744240886,1744240897,1744240898.260041,-18000,,
com.leomehlig.today,5,1744240771,1744240776,1744240777.32027,-18000,,
com.leomehlig.today,421,1744239953,1744240374,1744240374.731378,-18000,,
com.apple.calculator,0,1744239953,1744239953,1744239953.518405,-18000,,
com.google.Chrome,1,1744239952,1744239953,1744239953.212531,-18000,,
com.apple.MobileSMS,1,1744239951,1744239952,1744239952.9272861,-18000,,
com.google.Chrome,33,1744239918,1744239951,1744239952.7992,-18000,,
com.apple.MobileSMS,3,1744239524,1744239527,1744239527.808775,-18000,,
com.google.Chrome,118,1744239406,1744239524,1744239524.581293,-18000,,
com.apple.calculator,36,1744239370,1744239406,1744239406.0784469,-18000,,
com.google.Chrome,6,1744239364,1744239370,1744239370.3030171,-18000,,
com.apple.calculator,19,1744239345,1744239364,1744239364.145158,-18000,,
com.google.Chrome,19,1744239326,1744239345,1744239345.439219,-18000,,
com.apple.calculator,5,1744239321,1744239326,1744239326.196531,-18000,,
com.strava.stravaride,44,1744238644,1744238688,1744238688.938983,-18000,EB445137-D7F5-57EC-87DA-1DB460D64046,"iPhone13,2"
com.robinhood.release.Robinhood,28,1744238382,1744238410,1744238410.405326,-18000,EB445137-D7F5-57EC-87DA-1DB460D64046,"iPhone13,2"
com.apple.CoreAuthUI,2,1744238382,1744238384,1744238384.748193,-18000,EB445137-D7F5-57EC-87DA-1DB460D64046,"iPhone13,2"
com.microsoft.Office.Outlook,47,1744238273,1744238320,1744238320.5882192,-18000,EB445137-D7F5-57EC-87DA-1DB460D64046,"iPhone13,2"
com.google.Chrome,1143,1744238178,1744239321,1744239321.131885,-18000,,
com.leomehlig.today,12,1744238166,1744238178,1744238178.533468,-18000,,
com.google.Chrome,406,1744237760,1744238166,1744238166.835614,-18000,,
com.apple.MobileSMS,3,1744237757,1744237760,1744237760.431174,-18000,,
com.google.Chrome,47,1744237710,1744237757,1744237757.7120981,-18000,,
com.google.Chrome,206,1744237395,1744237601,1744237601.854881,-18000,,
com.apple.MobileSMS,22,1744237237,1744237259,1744237259.367604,-18000,,
com.google.Chrome,5,1744237232,1744237237,1744237237.19049,-18000,,
com.apple.MobileSMS,2,1744237230,1744237232,1744237232.947624,-18000,,
com.google.Chrome,2,1744237228,1744237230,1744237230.263331,-18000,,
com.apple.MobileSMS,13,1744237215,1744237228,1744237228.776025,-18000,,
com.google.Chrome,151,1744237064,1744237215,1744237215.5615702,-18000,,
com.apple.finder,94,1744236946,1744237040,1744237040.564872,-18000,,
com.leomehlig.today,5,1744236941,1744236946,1744236946.876764,-18000,,
com.microsoft.VSCode,3,1744236938,1744236941,1744236941.704266,-18000,,
com.apple.Notes,4,1744236934,1744236938,1744236938.3673549,-18000,,
com.google.Chrome,53,1744236881,1744236934,1744236934.585726,-18000,,
com.apple.Notes,2,1744236879,1744236881,1744236881.1653528,-18000,,
com.google.Chrome,7,1744236872,1744236879,1744236879.688459,-18000,,
com.apple.Notes,1,1744236871,1744236872,1744236872.622982,-18000,,
com.google.Chrome,8,1744236863,1744236871,1744236871.177853,-18000,,
com.apple.Notes,4,1744236859,1744236863,1744236864.024755,-18000,,
com.google.Chrome,74,1744236785,1744236859,1744236859.180962,-18000,,
com.leomehlig.today,26,1744236690,1744236716,1744236716.847032,-18000,,
com.apple.MobileSMS,9,1744236681,1744236690,1744236690.5719981,-18000,,
com.leomehlig.today,30,1744236651,1744236681,1744236681.5303621,-18000,,
com.google.Chrome,234,1744236417,1744236651,1744236651.080513,-18000,,
com.apple.finder,5,1744236412,1744236417,1744236417.739712,-18000,,
com.google.Chrome,2,1744236410,1744236412,1744236412.404076,-18000,,
com.microsoft.VSCode,21,1744236389,1744236410,1744236411.017332,-18000,,
com.apple.finder,10,1744236379,1744236389,1744236389.504868,-18000,,
com.microsoft.VSCode,40,1744236339,1744236379,1744236379.9444342,-18000,,
com.google.Chrome,44,1744236295,1744236339,1744236339.211461,-18000,,
com.microsoft.VSCode,29,1744236266,1744236295,1744236295.287517,-18000,,
com.google.Chrome,272,1744235994,1744236266,1744236266.7551742,-18000,,
com.apple.finder,4,1744235990,1744235994,1744235994.948666,-18000,,
com.microsoft.VSCode,1,1744235989,1744235990,1744235990.611771,-18000,,
com.google.Chrome,11,1744235978,1744235989,1744235989.352583,-18000,,
com.microsoft.VSCode,5,1744235973,1744235978,1744235978.165227,-18000,,
com.google.Chrome,101,1744235872,1744235973,1744235973.5247068,-18000,,
com.apple.finder,14,1744235858,1744235872,1744235872.632282,-18000,,
com.google.Chrome,1,1744235857,1744235858,1744235858.5678658,-18000,,
com.apple.finder,1,1744235856,1744235857,1744235857.168319,-18000,,
com.google.Chrome,1,1744235855,1744235856,1744235856.53672,-18000,,
com.microsoft.VSCode,27,1744235828,1744235855,1744235855.459332,-18000,,
com.google.Chrome,6,1744235822,1744235828,1744235828.702035,-18000,,
com.microsoft.VSCode,4,1744235818,1744235822,1744235822.616753,-18000,,
com.google.Chrome,1,1744235817,1744235818,1744235818.090538,-18000,,
com.microsoft.VSCode,1,1744235816,1744235817,1744235817.210227,-18000,,
com.google.Chrome,3,1744235813,1744235816,1744235816.313486,-18000,,
com.microsoft.VSCode,1,1744235812,1744235813,1744235813.7744222,-18000,,
com.google.Chrome,17,1744235795,1744235812,1744235812.6599522,-18000,,
com.microsoft.VSCode,101,1744235694,1744235795,1744235795.687594,-18000,,
com.google.Chrome,5,1744235689,1744235694,1744235694.3684192,-18000,,
com.microsoft.VSCode,2,1744235687,1744235689,1744235689.713605,-18000,,
com.google.Chrome,252,1744235435,1744235687,1744235687.848841,-18000,,
com.apple.finder,4,1744235431,1744235435,1744235435.849256,-18000,,
com.google.Chrome,1,1744235430,1744235431,1744235431.928776,-18000,,
com.apple.finder,7,1744235423,1744235430,1744235430.395719,-18000,,
com.google.Chrome,3,1744235420,1744235423,1744235423.375428,-18000,,
com.apple.finder,21,1744235399,1744235420,1744235420.755693,-18000,,
com.microsoft.VSCode,51,1744235348,1744235399,1744235399.950099,-18000,,
com.apple.finder,27,1744235321,1744235348,1744235348.759447,-18000,,
com.microsoft.VSCode,51,1744235270,1744235321,1744235321.83817,-18000,,
com.apple.finder,5,1744235265,1744235270,1744235270.6745238,-18000,,
com.google.Chrome,21,1744235244,1744235265,1744235265.097211,-18000,,
com.apple.finder,1,1744235243,1744235244,1744235244.4697309,-18000,,
com.google.Chrome,1,1744235242,1744235243,1744235243.180397,-18000,,
com.apple.finder,2,1744235240,1744235242,1744235242.362854,-18000,,
com.microsoft.VSCode,0,1744235240,1744235240,1744235240.8595,-18000,,
com.google.Chrome,1,1744235239,1744235240,1744235240.252579,-18000,,
com.microsoft.VSCode,1,1744235238,1744235239,1744235239.428906,-18000,,
com.google.Chrome,1,1744235237,1744235238,1744235239.0621881,-18000,,
com.microsoft.VSCode,2,1744235235,1744235237,1744235237.057231,-18000,,
com.apple.finder,7,1744235228,1744235235,1744235235.9364781,-18000,,
com.microsoft.VSCode,24,1744235204,1744235228,1744235228.826332,-18000,,
com.google.Chrome,7,1744235197,1744235204,1744235204.766389,-18000,,
com.microsoft.VSCode,1,1744235196,1744235197,1744235197.384976,-18000,,
com.google.Chrome,5,1744235191,1744235196,1744235196.451395,-18000,,
com.microsoft.VSCode,5,1744235186,1744235191,1744235191.29136,-18000,,
com.apple.finder,2,1744235184,1744235186,1744235186.156272,-18000,,
com.google.Chrome,2,1744235182,1744235184,1744235185.038848,-18000,,
com.apple.finder,2,1744235180,1744235182,1744235182.419291,-18000,,
com.google.Chrome,2,1744235178,1744235180,1744235180.548346,-18000,,
com.microsoft.VSCode,15,1744235163,1744235178,1744235178.133174,-18000,,
com.apple.finder,5,1744235158,1744235163,1744235163.298039,-18000,,
com.microsoft.VSCode,36,1744235122,1744235158,1744235158.1455631,-18000,,
com.apple.finder,6,1744235116,1744235122,1744235122.1301131,-18000,,
com.microsoft.VSCode,72,1744235044,1744235116,1744235116.713383,-18000,,
com.google.Chrome,3,1744235041,1744235044,1744235044.8993778,-18000,,
com.microsoft.VSCode,73,1744234968,1744235041,1744235041.260741,-18000,,
com.apple.finder,8,1744234960,1744234968,1744234968.7924972,-18000,,
com.microsoft.VSCode,264,1744234696,1744234960,1744234960.1926641,-18000,,
com.leomehlig.today,5,1744234691,1744234696,1744234696.30478,-18000,,
com.microsoft.VSCode,60,1744234631,1744234691,1744234691.752942,-18000,,
com.google.Chrome,55,1744234576,1744234631,1744234632.0209951,-18000,,
com.microsoft.VSCode,21,1744234555,1744234576,1744234577.0473042,-18000,,
com.google.Chrome,749,1744233806,1744234555,1744234555.756443,-18000,,
com.google.Chrome,380,1744232705,1744233085,1744233085.34974,-18000,,
com.apple.finder,11,1744232694,1744232705,1744232705.93289,-18000,,
com.google.Chrome,478,1744232216,1744232694,1744232694.631369,-18000,,
com.apple.finder,4,1744232212,1744232216,1744232216.440933,-18000,,
com.google.Chrome,4,1744232208,1744232212,1744232212.15974,-18000,,
com.apple.finder,9,1744232199,1744232208,1744232208.701398,-18000,,
com.google.Chrome,180,1744232019,1744232199,1744232199.6807551,-18000,,
com.leomehlig.today,1,1744232018,1744232019,1744232020.1305509,-18000,,
com.apple.MobileSMS,39,1744231966,1744232005,1744232005.276073,-18000,EB445137-D7F5-57EC-87DA-1DB460D64046,"iPhone13,2"
com.apple.CoreAuthUI,2,1744231839,1744231841,1744231841.299027,-18000,EB445137-D7F5-57EC-87DA-1DB460D64046,"iPhone13,2"
com.truebill.truebillnative,130,1744231836,1744231966,1744231966.89081,-18000,EB445137-D7F5-57EC-87DA-1DB460D64046,"iPhone13,2"
com.apple.MobileSMS,8,1744231827,1744231835,1744231835.763643,-18000,EB445137-D7F5-57EC-87DA-1DB460D64046,"iPhone13,2"
com.instructure.icanvas,6,1744231819,1744231825,1744231825.748402,-18000,EB445137-D7F5-57EC-87DA-1DB460D64046,"iPhone13,2"
com.apple.CoreAuthUI,2,1744231772,1744231774,1744231774.940958,-18000,EB445137-D7F5-57EC-87DA-1DB460D64046,"iPhone13,2"
com.apple.CoreAuthUI,4,1744231766,1744231770,1744231770.8667579,-18000,EB445137-D7F5-57EC-87DA-1DB460D64046,"iPhone13,2"
com.clairmail.fth.client,49,1744231764,1744231813,1744231813.6692119,-18000,EB445137-D7F5-57EC-87DA-1DB460D64046,"iPhone13,2"
com.apple.calculator,5,1744231757,1744231762,1744231762.735826,-18000,EB445137-D7F5-57EC-87DA-1DB460D64046,"iPhone13,2"
com.apple.MobileSMS,13,1744231744,1744231757,1744231757.629571,-18000,EB445137-D7F5-57EC-87DA-1DB460D64046,"iPhone13,2"
com.apple.calculator,7,1744231737,1744231744,1744231745.0064201,-18000,EB445137-D7F5-57EC-87DA-1DB460D64046,"iPhone13,2"
com.apple.MobileSMS,4,1744231733,1744231737,1744231737.679132,-18000,EB445137-D7F5-57EC-87DA-1DB460D64046,"iPhone13,2"
com.leomehlig.today,384,1744231588,1744231972,1744231972.885324,-18000,,
com.apple.finder,2,1744231586,1744231588,1744231588.0859098,-18000,,
com.apple.iCal,1,1744231585,1744231586,1744231586.853736,-18000,,
com.google.Chrome,255,1744231330,1744231585,1744231585.3155298,-18000,,
com.leomehlig.today,6,1744231324,1744231330,1744231330.876155,-18000,,
com.microsoft.VSCode,1,1744231323,1744231324,1744231324.48218,-18000,,
com.leomehlig.today,1,1744231322,1744231323,1744231323.127095,-18000,,
com.google.Chrome,30,1744231292,1744231322,1744231322.2911692,-18000,,
com.google.Chrome,148,1744229785,1744229933,1744229933.100229,-18000,,
com.apple.finder,26,1744229759,1744229785,1744229785.484654,-18000,,
com.microsoft.VSCode,1,1744229758,1744229759,1744229759.993866,-18000,,
com.apple.finder,0,1744229758,1744229758,1744229758.8214478,-18000,,
com.apple.Notes,1,1744229757,1744229758,1744229758.110091,-18000,,
com.google.Chrome,10,1744229747,1744229757,1744229757.0363321,-18000,,
com.apple.Notes,1,1744229746,1744229747,1744229747.161911,-18000,,
com.google.Chrome,1,1744229745,1744229746,1744229746.48518,-18000,,
com.apple.Notes,2,1744229743,1744229745,1744229745.365411,-18000,,
com.apple.finder,170,1744229573,1744229743,1744229743.0391421,-18000,,
com.apple.finder,588,1744228983,1744229571,1744229571.0525951,-18000,,
com.microsoft.VSCode,4,1744228979,1744228983,1744228983.33255,-18000,,
com.google.Chrome,2,1744228977,1744228979,1744228979.311625,-18000,,
com.leomehlig.today,2,1744228975,1744228977,1744228978.014847,-18000,,
com.apple.MobileSMS,32,1744228522,1744228554,1744228554.4027472,-18000,EB445137-D7F5-57EC-87DA-1DB460D64046,"iPhone13,2"
com.apple.MobileSMS,36,1744228448,1744228484,1744228484.975,-18000,EB445137-D7F5-57EC-87DA-1DB460D64046,"iPhone13,2"
com.apple.news,0,1744228448,1744228448,1744228449.443636,-18000,EB445137-D7F5-57EC-87DA-1DB460D64046,"iPhone13,2"
com.apple.news,195,1744224920,1744225115,1744225115.8925319,-18000,EB445137-D7F5-57EC-87DA-1DB460D64046,"iPhone13,2"
com.apple.CoreAuthUI,2,1744224895,1744224897,1744224897.398144,-18000,EB445137-D7F5-57EC-87DA-1DB460D64046,"iPhone13,2"
com.robinhood.release.Robinhood,29,1744224891,1744224920,1744224920.862145,-18000,EB445137-D7F5-57EC-87DA-1DB460D64046,"iPhone13,2"
com.apple.news,66,1744224825,1744224891,1744224891.637876,-18000,EB445137-D7F5-57EC-87DA-1DB460D64046,"iPhone13,2"
com.apple.MobileSMS,13,1744224804,1744224817,1744224817.910815,-18000,EB445137-D7F5-57EC-87DA-1DB460D64046,"iPhone13,2"
com.apple.MobileSMS,42,1744224760,1744224802,1744224802.155061,-18000,EB445137-D7F5-57EC-87DA-1DB460D64046,"iPhone13,2"
com.apple.CoreAuthUI,2,1744224742,1744224744,1744224744.916637,-18000,EB445137-D7F5-57EC-87DA-1DB460D64046,"iPhone13,2"
com.clairmail.fth.client,22,1744224738,1744224760,1744224760.29116,-18000,EB445137-D7F5-57EC-87DA-1DB460D64046,"iPhone13,2"
com.truebill.truebillnative,2,1744224728,1744224730,1744224730.527462,-18000,EB445137-D7F5-57EC-87DA-1DB460D64046,"iPhone13,2"
com.microsoft.Office.Outlook,2,1744224725,1744224727,1744224727.367991,-18000,EB445137-D7F5-57EC-87DA-1DB460D64046,"iPhone13,2"
com.microsoft.Office.Outlook,2,1744223961,1744223963,1744223963.952796,-18000,EB445137-D7F5-57EC-87DA-1DB460D64046,"iPhone13,2"
com.microsoft.Office.Outlook,1,1744223960,1744223961,1744223961.329114,-18000,EB445137-D7F5-57EC-87DA-1DB460D64046,"iPhone13,2"
com.microsoft.Office.Outlook,13,1744223945,1744223958,1744223958.733797,-18000,EB445137-D7F5-57EC-87DA-1DB460D64046,"iPhone13,2"
com.apple.mobilecal,4,1744221549,1744221553,1744221553.217624,-18000,EB445137-D7F5-57EC-87DA-1DB460D64046,"iPhone13,2"
com.instructure.icanvas,11,1744221537,1744221548,1744221548.2939,-18000,EB445137-D7F5-57EC-87DA-1DB460D64046,"iPhone13,2"
com.apple.Health,36,1744221401,1744221437,1744221437.860259,-18000,EB445137-D7F5-57EC-87DA-1DB460D64046,"iPhone13,2"
com.tinyspeck.chatlyio,23,1744221185,1744221208,1744221208.402447,-18000,EB445137-D7F5-57EC-87DA-1DB460D64046,"iPhone13,2"
co.hinge.mobile.ios,177,1744220934,1744221111,1744221111.363368,-18000,EB445137-D7F5-57EC-87DA-1DB460D64046,"iPhone13,2"
com.apple.Music,1,1744220933,1744220934,1744220934.535161,-18000,EB445137-D7F5-57EC-87DA-1DB460D64046,"iPhone13,2"
com.apple.Music,13,1744220199,1744220212,1744220213.185458,-18000,EB445137-D7F5-57EC-87DA-1DB460D64046,"iPhone13,2"
com.google.chrome.ios,222,1744219757,1744219979,1744219979.926505,-18000,EB445137-D7F5-57EC-87DA-1DB460D64046,"iPhone13,2"
com.instructure.icanvas,28,1744219724,1744219752,1744219752.2686238,-18000,EB445137-D7F5-57EC-87DA-1DB460D64046,"iPhone13,2"
com.google.chrome.ios,1,1744219723,1744219724,1744219724.3542309,-18000,EB445137-D7F5-57EC-87DA-1DB460D64046,"iPhone13,2"
com.google.chrome.ios,181,1744218618,1744218799,1744218800.717855,-18000,EB445137-D7F5-57EC-87DA-1DB460D64046,"iPhone13,2"
com.apple.CoreAuthUI,3,1744213870,1744213873,1744213873.506593,-18000,EB445137-D7F5-57EC-87DA-1DB460D64046,"iPhone13,2"
com.robinhood.release.Robinhood,31,1744213865,1744213896,1744213896.682344,-18000,EB445137-D7F5-57EC-87DA-1DB460D64046,"iPhone13,2"
com.apple.news,375,1744213489,1744213864,1744213864.358677,-18000,EB445137-D7F5-57EC-87DA-1DB460D64046,"iPhone13,2"
com.leomehlig.today,49,1744213005,1744213054,1744213054.6535869,-18000,,
com.google.Chrome,46,1744212959,1744213005,1744213005.6017308,-18000,,
com.apple.news,515,1744212444,1744212959,1744212959.450175,-18000,,
com.google.Chrome,162,1744212282,1744212444,1744212444.162344,-18000,,
com.google.Chrome,328,1744211948,1744212276,1744212276.9257898,-18000,,
com.apple.iCal,134,1744211814,1744211948,1744211948.8725228,-18000,,
com.google.Chrome,540,1744211274,1744211814,1744211814.459734,-18000,,
com.apple.iCal,3,1744211243,1744211246,1744211246.812667,-18000,,
com.apple.mobileslideshow,15,1744211220,1744211235,1744211235.662456,-18000,EB445137-D7F5-57EC-87DA-1DB460D64046,"iPhone13,2"
com.google.Chrome,226,1744211017,1744211243,1744211243.7340941,-18000,,
com.leomehlig.today,113,1744210904,1744211017,1744211017.310308,-18000,,
com.microsoft.Office.Outlook,4,1744210888,1744210892,1744210892.400322,-18000,EB445137-D7F5-57EC-87DA-1DB460D64046,"iPhone13,2"
com.apple.finder,190,1744210714,1744210904,1744210904.792388,-18000,,
com.apple.news,361,1744210353,1744210714,1744210714.314896,-18000,,
com.apple.finder,232,1744210121,1744210353,1744210353.709402,-18000,,
com.apple.shortcuts,1,1744210120,1744210121,1744210121.662428,-18000,,
com.google.Chrome,17,1744210103,1744210120,1744210120.533334,-18000,,
com.microsoft.VSCode,346,1744209757,1744210103,1744210103.670772,-18000,,
com.google.Chrome,11,1744209746,1744209757,1744209757.144446,-18000,,
com.microsoft.VSCode,288,1744209458,1744209746,1744209746.8987179,-18000,,
com.apple.finder,3,1744209455,1744209458,1744209458.26121,-18000,,
com.apple.shortcuts,5,1744209450,1744209455,1744209455.0892448,-18000,,
com.google.Chrome,74,1744209300,1744209374,1744209375.037497,-18000,,
com.leomehlig.today,41,1744209259,1744209300,1744209300.6431909,-18000,,
com.google.Chrome,2371,1744206888,1744209259,1744209259.800644,-18000,,
com.google.Chrome,514,1744206333,1744206847,1744206847.7514791,-18000,,
com.apple.MobileSMS,7,1744206326,1744206333,1744206333.405497,-18000,,
com.google.Chrome,301,1744206025,1744206326,1744206326.029386,-18000,,
com.apple.MobileSMS,44,1744205981,1744206025,1744206025.5501351,-18000,,
com.microsoft.Office.Outlook,8,1744205786,1744205794,1744205794.921328,-18000,EB445137-D7F5-57EC-87DA-1DB460D64046,"iPhone13,2"
com.apple.Music,2,1744205784,1744205786,1744205786.795041,-18000,EB445137-D7F5-57EC-87DA-1DB460D64046,"iPhone13,2"
com.google.Chrome,280,1744205701,1744205981,1744205981.09833,-18000,,
com.leomehlig.today,89,1744205595,1744205684,1744205684.829286,-18000,,
com.google.Chrome,5,1744205590,1744205595,1744205596.049255,-18000,,
com.apple.Music,5,1744204896,1744204901,1744204902.6346579,-18000,EB445137-D7F5-57EC-87DA-1DB460D64046,"iPhone13,2"
com.apple.Music,21,1744204583,1744204604,1744204605.5564852,-18000,EB445137-D7F5-57EC-87DA-1DB460D64046,"iPhone13,2"
co.hinge.mobile.ios,54,1744204375,1744204429,1744204429.470889,-18000,EB445137-D7F5-57EC-87DA-1DB460D64046,"iPhone13,2"
com.apple.weather,1,1744204374,1744204375,1744204375.507629,-18000,EB445137-D7F5-57EC-87DA-1DB460D64046,"iPhone13,2"
com.apple.weather,35,1744204293,1744204328,1744204328.176794,-18000,EB445137-D7F5-57EC-87DA-1DB460D64046,"iPhone13,2"
com.google.Gmail,4,1744204289,1744204293,1744204293.5507011,-18000,EB445137-D7F5-57EC-87DA-1DB460D64046,"iPhone13,2"
com.google.Gmail,11,1744204270,1744204281,1744204281.372219,-18000,EB445137-D7F5-57EC-87DA-1DB460D64046,"iPhone13,2"
com.renpho.health,1,1744204269,1744204270,1744204270.6442661,-18000,EB445137-D7F5-57EC-87DA-1DB460D64046,"iPhone13,2"
com.renpho.health,69,1744203643,1744203712,1744203712.8599539,-18000,EB445137-D7F5-57EC-87DA-1DB460D64046,"iPhone13,2"
com.apple.weather,60,1744201921,1744201981,1744201981.773045,-18000,EB445137-D7F5-57EC-87DA-1DB460D64046,"iPhone13,2"
com.apple.CoreAuthUI,7,1744169833,1744169840,1744169840.184334,-18000,EB445137-D7F5-57EC-87DA-1DB460D64046,"iPhone13,2"
com.apple.journal,1333,1744169832,1744171165,1744171165.6302161,-18000,EB445137-D7F5-57EC-87DA-1DB460D64046,"iPhone13,2"
com.google.Chrome,662,1744168729,1744169391,1744169391.9626698,-18000,,
com.leomehlig.today,3,1744168726,1744168729,1744168730.94174,-18000,,
com.apple.Music,2,1744165459,1744165461,1744165462.339583,-18000,EB445137-D7F5-57EC-87DA-1DB460D64046,"iPhone13,2"
com.apple.MusicUIService,5,1744165448,1744165453,1744165453.650723,-18000,EB445137-D7F5-57EC-87DA-1DB460D64046,"iPhone13,2"
com.apple.Music,40,1744165414,1744165454,1744165455.342828,-18000,EB445137-D7F5-57EC-87DA-1DB460D64046,"iPhone13,2"
com.apple.weather,1,1744165410,1744165411,1744165413.4362512,-18000,EB445137-D7F5-57EC-87DA-1DB460D64046,"iPhone13,2"
com.leomehlig.today,34,1744165169,1744165203,1744165203.386594,-18000,,
com.apple.CoreAuthUI,2,1744165099,1744165101,1744165101.409054,-18000,EB445137-D7F5-57EC-87DA-1DB460D64046,"iPhone13,2"
com.robinhood.release.Robinhood,113,1744165098,1744165211,1744165211.639137,-18000,EB445137-D7F5-57EC-87DA-1DB460D64046,"iPhone13,2"
com.apple.CoreAuthUI,2,1744165015,1744165017,1744165017.7486901,-18000,EB445137-D7F5-57EC-87DA-1DB460D64046,"iPhone13,2"
com.ally.MobileBanking,91,1744165007,1744165098,1744165098.557043,-18000,EB445137-D7F5-57EC-87DA-1DB460D64046,"iPhone13,2"
com.google.Chrome,209,1744164960,1744165169,1744165169.323123,-18000,,
com.apple.calculator,9,1744164951,1744164960,1744164960.09453,-18000,,
com.google.Chrome,3,1744164948,1744164951,1744164951.81058,-18000,,
com.apple.calculator,14,1744164934,1744164948,1744164948.174643,-18000,,
com.google.Chrome,126,1744164808,1744164934,1744164934.2032661,-18000,,
com.apple.finder,4,1744164804,1744164808,1744164808.547876,-18000,,
co.hinge.mobile.ios,12,1744164784,1744164796,1744164796.1597571,-18000,EB445137-D7F5-57EC-87DA-1DB460D64046,"iPhone13,2"
com.google.chrome.ios,66,1744164714,1744164780,1744164781.072442,-18000,EB445137-D7F5-57EC-87DA-1DB460D64046,"iPhone13,2"
com.google.chrome.ios,102,1744164611,1744164713,1744164714.091099,-18000,EB445137-D7F5-57EC-87DA-1DB460D64046,"iPhone13,2"
co.hinge.mobile.ios,14,1744164596,1744164610,1744164610.618784,-18000,EB445137-D7F5-57EC-87DA-1DB460D64046,"iPhone13,2"
co.hinge.mobile.ios,124,1744164470,1744164594,1744164594.405493,-18000,EB445137-D7F5-57EC-87DA-1DB460D64046,"iPhone13,2"
com.intsig.CamScannerLite,2,1744164461,1744164463,1744164464.03047,-18000,EB445137-D7F5-57EC-87DA-1DB460D64046,"iPhone13,2"
com.apple.finder,300,1744164438,1744164738,1744164738.290307,-18000,,
com.leomehlig.today,3,1744164435,1744164438,1744164438.05623,-18000,,
com.google.Chrome,39,1744164396,1744164435,1744164435.255672,-18000,,
com.apple.finder,2,1744164376,1744164378,1744164378.054039,-18000,,
com.microsoft.VSCode,3,1744164373,1744164376,1744164376.788986,-18000,,
com.google.Chrome,6,1744164367,1744164373,1744164373.4521399,-18000,,
com.apple.Preview,1,1744164366,1744164367,1744164367.6607351,-18000,,
com.google.Chrome,1,1744164365,1744164366,1744164366.1718922,-18000,,
com.leomehlig.today,10,1744164355,1744164365,1744164365.060456,-18000,,
com.intsig.CamScannerLite,128,1744164284,1744164412,1744164412.629739,-18000,EB445137-D7F5-57EC-87DA-1DB460D64046,"iPhone13,2"
com.google.chrome.ios,1,1744164283,1744164284,1744164284.618178,-18000,EB445137-D7F5-57EC-87DA-1DB460D64046,"iPhone13,2"
com.intsig.CamScannerLite,19,1744164264,1744164283,1744164283.172565,-18000,EB445137-D7F5-57EC-87DA-1DB460D64046,"iPhone13,2"
com.google.Chrome,194,1744164161,1744164355,1744164355.3546538,-18000,,
com.intsig.CamScannerLite,98,1744164055,1744164153,1744164153.4846358,-18000,EB445137-D7F5-57EC-87DA-1DB460D64046,"iPhone13,2"
com.google.chrome.ios,3,1744164052,1744164055,1744164055.960163,-18000,EB445137-D7F5-57EC-87DA-1DB460D64046,"iPhone13,2"
com.intsig.CamScannerLite,6,1744164046,1744164052,1744164053.0241718,-18000,EB445137-D7F5-57EC-87DA-1DB460D64046,"iPhone13,2"
com.apple.MobileSMS,2,1744164043,1744164045,1744164046.265055,-18000,EB445137-D7F5-57EC-87DA-1DB460D64046,"iPhone13,2"
com.google.Chrome,300,1744163858,1744164158,1744164158.094291,-18000,,
com.leomehlig.today,58,1744163800,1744163858,1744163858.107171,-18000,,
com.google.Chrome,95,1744163705,1744163800,1744163800.905476,-18000,,
com.apple.Preview,1,1744163704,1744163705,1744163705.509225,-18000,,
com.google.Chrome,327,1744163377,1744163704,1744163705.029959,-18000,,
com.apple.Preview,167,1744163210,1744163377,1744163377.59618,-18000,,
com.google.Chrome,2,1744163208,1744163210,1744163210.577258,-18000,,
com.microsoft.VSCode,1,1744163207,1744163208,1744163208.621331,-18000,,
com.apple.Preview,65,1744163142,1744163207,1744163207.4710941,-18000,,
com.microsoft.VSCode,12,1744163130,1744163142,1744163142.656846,-18000,,
com.apple.Preview,0,1744163130,1744163130,1744163130.943516,-18000,,
com.google.Chrome,136,1744162994,1744163130,1744163130.16658,-18000,,
com.apple.Preview,40,1744162954,1744162994,1744162994.1114159,-18000,,
com.leomehlig.today,1,1744162953,1744162954,1744162954.6427932,-18000,,
com.google.Chrome,1,1744162952,1744162953,1744162953.723731,-18000,,
com.microsoft.VSCode,3,1744162949,1744162952,1744162952.184092,-18000,,
com.google.Chrome,16,1744162933,1744162949,1744162949.646675,-18000,,
com.leomehlig.today,7,1744162926,1744162933,1744162933.423315,-18000,,
com.google.Chrome,2,1744162924,1744162926,1744162927.0140162,-18000,,
com.microsoft.VSCode,97,1744162827,1744162924,1744162924.979799,-18000,,
com.google.Chrome,3,1744162824,1744162827,1744162827.9177299,-18000,,
com.apple.Preview,34,1744162790,1744162824,1744162824.284937,-18000,,
com.google.Chrome,3,1744162787,1744162790,1744162790.5857239,-18000,,
com.microsoft.VSCode,3,1744162784,1744162787,1744162787.607873,-18000,,
com.apple.Preview,16,1744162768,1744162784,1744162785.004722,-18000,,
com.google.Chrome,2,1744162766,1744162768,1744162768.9037352,-18000,,
com.microsoft.VSCode,26,1744162740,1744162766,1744162766.864577,-18000,,
com.google.Chrome,111,1744162629,1744162740,1744162740.4162169,-18000,,
com.apple.Preview,1,1744162628,1744162629,1744162629.9080381,-18000,,
com.apple.Preview,334,1744162228,1744162562,1744162562.402604,-18000,,
com.apple.finder,93,1744162135,1744162228,1744162228.8916411,-18000,,
com.google.Chrome,17,1744162118,1744162135,1744162135.0493,-18000,,
com.apple.Preview,262,1744161856,1744162118,1744162119.078433,-18000,,
com.google.Chrome,1,1744161855,1744161856,1744161856.688497,-18000,,
com.microsoft.VSCode,101,1744161754,1744161855,1744161855.995873,-18000,,
com.google.Chrome,201,1744161553,1744161754,1744161754.527318,-18000,,
com.apple.Preview,101,1744161452,1744161553,1744161553.1613421,-18000,,
com.google.Chrome,57,1744161395,1744161452,1744161452.22997,-18000,,
com.apple.Preview,37,1744161358,1744161395,1744161395.212296,-18000,,
com.google.Chrome,4,1744161354,1744161358,1744161358.20071,-18000,,
com.apple.Preview,1,1744161353,1744161354,1744161354.536335,-18000,,
com.microsoft.VSCode,1,1744161352,1744161353,1744161353.737823,-18000,,
com.google.Chrome,12,1744161340,1744161352,1744161352.7381139,-18000,,
com.microsoft.VSCode,33,1744161307,1744161340,1744161340.619688,-18000,,
com.apple.Preview,17,1744161290,1744161307,1744161307.978983,-18000,,
com.google.Chrome,63,1744161227,1744161290,1744161290.470273,-18000,,
com.microsoft.VSCode,45,1744161182,1744161227,1744161227.105699,-18000,,
com.google.Chrome,1,1744161181,1744161182,1744161182.289102,-18000,,
com.apple.Preview,0,1744161181,1744161181,1744161181.6356602,-18000,,
com.google.Chrome,235,1744160946,1744161181,1744161181.369278,-18000,,
com.apple.Preview,38,1744160908,1744160946,1744160946.275928,-18000,,
com.google.Chrome,2,1744160906,1744160908,1744160908.20193,-18000,,
com.microsoft.VSCode,77,1744160829,1744160906,1744160906.058577,-18000,,
com.google.Chrome,210,1744160619,1744160829,1744160829.422377,-18000,,
com.apple.Preview,29,1744160590,1744160619,1744160619.660118,-18000,,
com.google.Chrome,2,1744160588,1744160590,1744160590.948762,-18000,,
com.microsoft.VSCode,5,1744160583,1744160588,1744160588.342056,-18000,,
com.apple.news,89,1744160494,1744160583,1744160583.989211,-18000,,
com.microsoft.VSCode,126,1744160368,1744160494,1744160494.28105,-18000,,
com.google.Chrome,19,1744160349,1744160368,1744160368.193492,-18000,,
com.microsoft.VSCode,13,1744160336,1744160349,1744160349.69755,-18000,,
com.google.Chrome,43,1744160293,1744160336,1744160336.521659,-18000,,
com.microsoft.VSCode,208,1744160085,1744160293,1744160293.802671,-18000,,
com.google.Chrome,344,1744159741,1744160085,1744160085.199409,-18000,,
com.apple.Preview,3,1744159738,1744159741,1744159741.620383,-18000,,
com.google.Chrome,43,1744159695,1744159738,1744159738.7527208,-18000,,
com.apple.Preview,47,1744159648,1744159695,1744159695.581408,-18000,,
com.google.Chrome,4,1744159644,1744159648,1744159648.8402538,-18000,,
com.microsoft.VSCode,179,1744159465,1744159644,1744159644.2020822,-18000,,
com.google.Chrome,358,1744159107,1744159465,1744159465.7399259,-18000,,
com.apple.Preview,89,1744159018,1744159107,1744159107.0680299,-18000,,
com.apple.finder,9,1744159009,1744159018,1744159018.6394958,-18000,,
com.google.Chrome,3,1744159006,1744159009,1744159009.161269,-18000,,
com.apple.finder,10,1744158996,1744159006,1744159006.810567,-18000,,
com.apple.news,450,1744158546,1744158996,1744158996.894192,-18000,,
com.apple.finder,41,1744158505,1744158546,1744158546.41264,-18000,,
com.google.Chrome,9,1744158496,1744158505,1744158505.7629871,-18000,,
com.apple.Notes,2,1744158494,1744158496,1744158496.5972672,-18000,,
com.google.Chrome,31,1744158463,1744158494,1744158494.897562,-18000,,
com.apple.finder,17,1744158446,1744158463,1744158463.140719,-18000,,
com.google.Chrome,19,1744158427,1744158446,1744158446.7534099,-18000,,
com.leomehlig.today,2,1744158425,1744158427,1744158427.56961,-18000,,
com.google.Chrome,9,1744158416,1744158425,1744158425.1270761,-18000,,
com.apple.finder,9,1744158407,1744158416,1744158417.025651,-18000,,
com.google.Chrome,4,1744158403,1744158407,1744158407.0794082,-18000,,
com.leomehlig.today,142,1744158261,1744158403,1744158403.9301438,-18000,,
com.google.Chrome,198,1744158063,1744158261,1744158261.7552528,-18000,,
com.google.Chrome,303,1744157657,1744157960,1744157960.5878491,-18000,,
com.apple.iCal,52,1744157605,1744157657,1744157657.308786,-18000,,
com.apple.MobileSMS,3,1744157024,1744157027,1744157027.5359092,-18000,EB445137-D7F5-57EC-87DA-1DB460D64046,"iPhone13,2"
com.google.Chrome,812,1744156793,1744157605,1744157605.212928,-18000,,
com.leomehlig.today,27,1744156754,1744156781,1744156781.797384,-18000,,
com.google.Gmail,2,1744156722,1744156724,1744156724.3533201,-18000,EB445137-D7F5-57EC-87DA-1DB460D64046,"iPhone13,2"
com.google.Gmail,22,1744156696,1744156718,1744156718.1630092,-18000,EB445137-D7F5-57EC-87DA-1DB460D64046,"iPhone13,2"
com.apple.Music,0,1744156696,1744156696,1744156697.696372,-18000,EB445137-D7F5-57EC-87DA-1DB460D64046,"iPhone13,2"
com.apple.finder,87,1744156667,1744156754,1744156754.476028,-18000,,
com.apple.Music,11,1744155213,1744155224,1744155225.302778,-18000,EB445137-D7F5-57EC-87DA-1DB460D64046,"iPhone13,2"
com.groupme.iphone-app,10,1744155170,1744155180,1744155180.840808,-18000,EB445137-D7F5-57EC-87DA-1DB460D64046,"iPhone13,2"
com.apple.weather,12,1744155094,1744155106,1744155107.006078,-18000,EB445137-D7F5-57EC-87DA-1DB460D64046,"iPhone13,2"
com.groupme.iphone-app,1,1744155093,1744155094,1744155094.8298578,-18000,EB445137-D7F5-57EC-87DA-1DB460D64046,"iPhone13,2"
com.groupme.iphone-app,4,1744155071,1744155075,1744155075.307705,-18000,EB445137-D7F5-57EC-87DA-1DB460D64046,"iPhone13,2"
com.apple.finder,86,1744154960,1744155046,1744155046.422776,-18000,,
com.groupme.iphone-app,103,1744154943,1744155046,1744155047.086035,-18000,EB445137-D7F5-57EC-87DA-1DB460D64046,"iPhone13,2"
com.apple.news,1,1744154942,1744154943,1744154943.9980989,-18000,EB445137-D7F5-57EC-87DA-1DB460D64046,"iPhone13,2"
com.apple.finder,301,1744154346,1744154647,1744154647.5818639,-18000,,
com.google.Chrome,28,1744154318,1744154346,1744154346.595984,-18000,,
com.apple.Notes,3,1744154315,1744154318,1744154318.598903,-18000,,
com.apple.Notes,313,1744152965,1744153278,1744153278.9513922,-18000,,
com.google.Chrome,103,1744152862,1744152965,1744152965.158895,-18000,,
com.apple.Notes,6,1744152856,1744152862,1744152862.863725,-18000,,
com.google.Chrome,4,1744152852,1744152856,1744152856.9237552,-18000,,
com.apple.Notes,4,1744152848,1744152852,1744152852.719246,-18000,,
com.google.Chrome,7,1744152841,1744152848,1744152849.056065,-18000,,
com.apple.Notes,13,1744152828,1744152841,1744152841.755053,-18000,,
com.google.Chrome,179,1744152649,1744152828,1744152828.803716,-18000,,
com.apple.Notes,1,1744152648,1744152649,1744152649.288309,-18000,,
com.microsoft.VSCode,4,1744152644,1744152648,1744152648.4786649,-18000,,
com.apple.Notes,1,1744152643,1744152644,1744152644.665834,-18000,,
com.google.Chrome,6,1744152637,1744152643,1744152643.5359821,-18000,,
com.apple.Notes,18,1744152619,1744152637,1744152637.613373,-18000,,
com.google.Chrome,4,1744152615,1744152619,1744152619.0800529,-18000,,
com.apple.Notes,1,1744152614,1744152615,1744152615.6233358,-18000,,
com.microsoft.VSCode,1,1744152613,1744152614,1744152614.122391,-18000,,
com.google.Chrome,3,1744152610,1744152613,1744152613.582941,-18000,,
com.apple.news,105,1744152425,1744152530,1744152530.790736,-18000,EB445137-D7F5-57EC-87DA-1DB460D64046,"iPhone13,2"
com.apple.news,2,1744152419,1744152421,1744152421.441921,-18000,EB445137-D7F5-57EC-87DA-1DB460D64046,"iPhone13,2"
com.microsoft.VSCode,227,1744152383,1744152610,1744152610.183011,-18000,,
com.google.Chrome,1,1744152382,1744152383,1744152383.656826,-18000,,
com.microsoft.VSCode,3,1744152379,1744152382,1744152382.423224,-18000,,
com.google.Chrome,1,1744152378,1744152379,1744152379.747505,-18000,,
com.microsoft.VSCode,1,1744152377,1744152378,1744152378.224802,-18000,,
com.google.Chrome,2,1744152375,1744152377,1744152377.413581,-18000,,
com.microsoft.VSCode,4,1744152371,1744152375,1744152375.43628,-18000,,
com.google.Chrome,1,1744152370,1744152371,1744152371.4049559,-18000,,
com.apple.Notes,1,1744152369,1744152370,1744152370.468735,-18000,,
com.google.Chrome,20,1744152349,1744152369,1744152369.58728,-18000,,
com.apple.Notes,2,1744152347,1744152349,1744152349.431802,-18000,,
com.microsoft.VSCode,1,1744152346,1744152347,1744152347.949184,-18000,,
com.google.Chrome,3,1744152343,1744152346,1744152346.76263,-18000,,
com.microsoft.VSCode,6,1744152337,1744152343,1744152343.247411,-18000,,
com.google.Chrome,44,1744152293,1744152337,1744152337.635432,-18000,,
com.microsoft.VSCode,4,1744152289,1744152293,1744152293.408917,-18000,,
com.google.Chrome,12,1744152277,1744152289,1744152289.09039,-18000,,
com.microsoft.VSCode,1,1744152276,1744152277,1744152277.6099548,-18000,,
com.google.Chrome,9,1744152267,1744152276,1744152276.85501,-18000,,
com.microsoft.VSCode,4,1744152263,1744152267,1744152267.394952,-18000,,
com.google.Chrome,6,1744152257,1744152263,1744152263.975673,-18000,,
com.microsoft.VSCode,1,1744152256,1744152257,1744152258.009011,-18000,,
com.google.Chrome,1,1744152255,1744152256,1744152256.30637,-18000,,
com.microsoft.VSCode,2,1744152253,1744152255,1744152255.550257,-18000,,
com.google.Chrome,1,1744152252,1744152253,1744152253.211412,-18000,,
com.microsoft.VSCode,6,1744152246,1744152252,1744152252.13678,-18000,,
com.google.Chrome,8,1744152238,1744152246,1744152246.7671971,-18000,,
com.apple.Notes,2,1744152236,1744152238,1744152239.121764,-18000,,
com.google.Chrome,62,1744152174,1744152236,1744152237.0027308,-18000,,
com.apple.Notes,60,1744152114,1744152174,1744152174.914266,-18000,,
com.google.Chrome,255,1744151859,1744152114,1744152114.167623,-18000,,
com.apple.finder,13,1744151846,1744151859,1744151859.124745,-18000,,
com.google.Chrome,52,1744151794,1744151846,1744151846.708153,-18000,,
com.apple.finder,13,1744151781,1744151794,1744151795.053498,-18000,,
com.google.Chrome,18,1744151763,1744151781,1744151781.1119561,-18000,,
com.apple.finder,29,1744151734,1744151763,1744151763.55622,-18000,,
com.google.Chrome,99,1744151635,1744151734,1744151734.677205,-18000,,
com.microsoft.VSCode,3,1744151632,1744151635,1744151635.796813,-18000,,
com.apple.news,97,1744151530,1744151627,1744151628.0418792,-18000,EB445137-D7F5-57EC-87DA-1DB460D64046,"iPhone13,2"
com.apple.news,108,1744151393,1744151501,1744151502.300858,-18000,EB445137-D7F5-57EC-87DA-1DB460D64046,"iPhone13,2"
com.apple.CoreAuthUI,2,1744151377,1744151379,1744151379.764816,-18000,EB445137-D7F5-57EC-87DA-1DB460D64046,"iPhone13,2"
com.robinhood.release.Robinhood,13,1744151375,1744151388,1744151388.978413,-18000,EB445137-D7F5-57EC-87DA-1DB460D64046,"iPhone13,2"
com.apple.finder,344,1744151288,1744151632,1744151632.560618,-18000,,
com.microsoft.VSCode,9,1744151279,1744151288,1744151288.258819,-18000,,
com.apple.finder,3,1744151276,1744151279,1744151279.202791,-18000,,
com.microsoft.VSCode,35,1744151241,1744151276,1744151276.071329,-18000,,
com.apple.finder,25,1744151216,1744151241,1744151241.5526938,-18000,,
com.microsoft.VSCode,8,1744151208,1744151216,1744151216.697126,-18000,,
com.apple.finder,2,1744151206,1744151208,1744151208.99184,-18000,,
com.microsoft.VSCode,61,1744151145,1744151206,1744151206.683803,-18000,,
com.apple.finder,12,1744151133,1744151145,1744151145.803062,-18000,,
com.microsoft.VSCode,193,1744150940,1744151133,1744151133.814126,-18000,,
com.apple.finder,3,1744150937,1744150940,1744150940.067451,-18000,,
com.google.Chrome,16,1744150921,1744150937,1744150937.616524,-18000,,
com.apple.Notes,6,1744150915,1744150921,1744150921.800081,-18000,,
com.google.Chrome,0,1744150915,1744150915,1744150915.945533,-18000,,
com.apple.Notes,8,1744150907,1744150915,1744150915.108269,-18000,,
com.google.Chrome,169,1744150738,1744150907,1744150907.571591,-18000,,
com.apple.Notes,2,1744150736,1744150738,1744150738.25369,-18000,,
com.google.Chrome,9,1744150727,1744150736,1744150736.671624,-18000,,
com.apple.Notes,2,1744150725,1744150727,1744150727.653091,-18000,,
com.google.Chrome,5,1744150720,1744150725,1744150725.14572,-18000,,
com.leomehlig.today,20,1744150700,1744150720,1744150720.230886,-18000,,
com.google.Chrome,15,1744150685,1744150700,1744150700.1897001,-18000,,
com.leomehlig.today,19,1744150666,1744150685,1744150685.72604,-18000,,
com.google.Chrome,12,1744150654,1744150666,1744150666.2228432,-18000,,
com.google.Chrome,16,1744148921,1744148937,1744148937.8788729,-18000,,
com.apple.Preview,2,1744148919,1744148921,1744148921.6537309,-18000,,
com.apple.Preview,303,1744148560,1744148863,1744148863.910532,-18000,,
com.apple.Preview,300,1744147173,1744147473,1744147473.925667,-18000,,
com.google.Chrome,35,1744147138,1744147173,1744147173.422855,-18000,,
com.apple.Preview,79,1744147059,1744147138,1744147138.412146,-18000,,
com.apple.Preview,303,1744146411,1744146714,1744146714.082978,-18000,,
com.apple.Preview,698,1744145119,1744145817,1744145817.403391,-18000,,
com.google.Chrome,68,1744145051,1744145119,1744145119.327447,-18000,,
com.apple.Preview,147,1744144904,1744145051,1744145051.577246,-18000,,
com.google.Chrome,25,1744144879,1744144904,1744144904.3294091,-18000,,
com.apple.Preview,45,1744144834,1744144879,1744144879.061353,-18000,,
com.google.Chrome,66,1744144768,1744144834,1744144834.915948,-18000,,
com.apple.Preview,14,1744144754,1744144768,1744144768.743098,-18000,,
co.hinge.mobile.ios,231,1744143730,1744143961,1744143961.553962,-18000,EB445137-D7F5-57EC-87DA-1DB460D64046,"iPhone13,2"
com.apple.news,1,1744143729,1744143730,1744143730.1477199,-18000,EB445137-D7F5-57EC-87DA-1DB460D64046,"iPhone13,2"
com.apple.Preview,561,1744143102,1744143663,1744143663.9389591,-18000,,
com.google.Chrome,284,1744142818,1744143102,1744143102.47569,-18000,,
com.apple.Preview,114,1744142704,1744142818,1744142818.59745,-18000,,
com.google.Chrome,53,1744142651,1744142704,1744142704.334515,-18000,,
com.apple.Preview,705,1744141946,1744142651,1744142651.402755,-18000,,
com.apple.finder,13,1744141933,1744141946,1744141946.731931,-18000,,
com.google.Chrome,13,1744141920,1744141933,1744141933.180264,-18000,,
com.apple.finder,11,1744141909,1744141920,1744141920.855805,-18000,,
com.google.Chrome,24,1744141885,1744141909,1744141909.6731582,-18000,,
com.apple.finder,35,1744141850,1744141885,1744141885.461442,-18000,,
com.apple.Preview,419,1744141431,1744141850,1744141850.354325,-18000,,
com.apple.finder,4,1744141427,1744141431,1744141431.422621,-18000,,
com.google.Chrome,2,1744141425,1744141427,1744141427.621097,-18000,,
com.google.Chrome,353,1744140629,1744140982,1744140982.8033519,-18000,,
com.apple.news,105,1744140481,1744140586,1744140587.322806,-18000,EB445137-D7F5-57EC-87DA-1DB460D64046,"iPhone13,2"
com.instructure.icanvas,193,1744140284,1744140477,1744140477.306617,-18000,EB445137-D7F5-57EC-87DA-1DB460D64046,"iPhone13,2"
com.apple.MobileSMS,10,1744137574,1744137584,1744137584.504874,-18000,EB445137-D7F5-57EC-87DA-1DB460D64046,"iPhone13,2"
com.apple.Health,5,1744137568,1744137573,1744137573.827868,-18000,EB445137-D7F5-57EC-87DA-1DB460D64046,"iPhone13,2"
com.google.Chrome,89,1744137460,1744137549,1744137549.879125,-18000,,
com.apple.Preview,356,1744137104,1744137460,1744137460.928985,-18000,,
com.apple.finder,0,1744137104,1744137104,1744137104.508716,-18000,,
com.apple.Preview,390,1744136714,1744137104,1744137104.20701,-18000,,
com.apple.finder,14,1744136700,1744136714,1744136714.431404,-18000,,
com.google.Chrome,5,1744136695,1744136700,1744136700.582881,-18000,,
com.apple.finder,5,1744136690,1744136695,1744136695.77513,-18000,,
com.apple.mobileslideshow,34,1744133391,1744133425,1744133425.454334,-18000,EB445137-D7F5-57EC-87DA-1DB460D64046,"iPhone13,2"
co.hinge.mobile.ios,5,1744133382,1744133387,1744133387.909632,-18000,EB445137-D7F5-57EC-87DA-1DB460D64046,"iPhone13,2"
com.apple.mobileslideshow,66,1744133307,1744133373,1744133373.206816,-18000,EB445137-D7F5-57EC-87DA-1DB460D64046,"iPhone13,2"
com.microsoft.Office.Outlook,33,1744133244,1744133277,1744133277.623807,-18000,EB445137-D7F5-57EC-87DA-1DB460D64046,"iPhone13,2"
com.toyopagroup.picaboo,37,1744133203,1744133240,1744133240.900126,-18000,EB445137-D7F5-57EC-87DA-1DB460D64046,"iPhone13,2"
com.apple.news,110,1744131486,1744131596,1744131596.429422,-18000,EB445137-D7F5-57EC-87DA-1DB460D64046,"iPhone13,2"
co.hinge.mobile.ios,163,1744130310,1744130473,1744130473.613353,-18000,EB445137-D7F5-57EC-87DA-1DB460D64046,"iPhone13,2"
co.hinge.mobile.ios,38,1744129318,1744129356,1744129356.887541,-18000,EB445137-D7F5-57EC-87DA-1DB460D64046,"iPhone13,2"
com.google.Maps,45,1744129273,1744129318,1744129318.719767,-18000,EB445137-D7F5-57EC-87DA-1DB460D64046,"iPhone13,2"
com.microsoft.Office.Outlook,5,1744129083,1744129088,1744129088.082546,-18000,EB445137-D7F5-57EC-87DA-1DB460D64046,"iPhone13,2"
com.apple.weather,2,1744129079,1744129081,1744129081.345406,-18000,EB445137-D7F5-57EC-87DA-1DB460D64046,"iPhone13,2"
com.google.chrome.ios,19,1744129059,1744129078,1744129079.0021892,-18000,EB445137-D7F5-57EC-87DA-1DB460D64046,"iPhone13,2"
com.google.chrome.ios,52,1744128612,1744128664,1744128664.390658,-18000,EB445137-D7F5-57EC-87DA-1DB460D64046,"iPhone13,2"
co.hinge.mobile.ios,111,1744128440,1744128551,1744128552.0285568,-18000,EB445137-D7F5-57EC-87DA-1DB460D64046,"iPhone13,2"
com.microsoft.Office.Outlook,3,1744128414,1744128417,1744128417.3461351,-18000,EB445137-D7F5-57EC-87DA-1DB460D64046,"iPhone13,2"
com.google.Maps,2,1744128370,1744128372,1744128372.505122,-18000,EB445137-D7F5-57EC-87DA-1DB460D64046,"iPhone13,2"
com.google.Maps,22,1744128262,1744128284,1744128285.205724,-18000,EB445137-D7F5-57EC-87DA-1DB460D64046,"iPhone13,2"
com.google.Maps,3,1744128257,1744128260,1744128260.545057,-18000,EB445137-D7F5-57EC-87DA-1DB460D64046,"iPhone13,2"
com.google.Maps,19,1744128102,1744128121,1744128121.3374062,-18000,EB445137-D7F5-57EC-87DA-1DB460D64046,"iPhone13,2"
com.google.Maps,33,1744127930,1744127963,1744127964.585802,-18000,EB445137-D7F5-57EC-87DA-1DB460D64046,"iPhone13,2"
com.google.Maps,1,1744127929,1744127930,1744127930.3274112,-18000,EB445137-D7F5-57EC-87DA-1DB460D64046,"iPhone13,2"
com.google.Maps,20,1744127760,1744127780,1744127780.9009151,-18000,EB445137-D7F5-57EC-87DA-1DB460D64046,"iPhone13,2"
com.google.Maps,32,1744127352,1744127384,1744127384.28258,-18000,EB445137-D7F5-57EC-87DA-1DB460D64046,"iPhone13,2"
com.google.Maps,74,1744127104,1744127178,1744127178.843827,-18000,EB445137-D7F5-57EC-87DA-1DB460D64046,"iPhone13,2"
com.google.Maps,68,1744126249,1744126317,1744126318.054165,-18000,EB445137-D7F5-57EC-87DA-1DB460D64046,"iPhone13,2"
com.apple.CoreAuthUI,2,1744125907,1744125909,1744125909.588207,-18000,EB445137-D7F5-57EC-87DA-1DB460D64046,"iPhone13,2"
com.robinhood.release.Robinhood,92,1744125905,1744125997,1744125997.483587,-18000,EB445137-D7F5-57EC-87DA-1DB460D64046,"iPhone13,2"
co.hinge.mobile.ios,88,1744125750,1744125838,1744125838.612235,-18000,EB445137-D7F5-57EC-87DA-1DB460D64046,"iPhone13,2"
com.apple.Health,50,1744125696,1744125746,1744125746.4933481,-18000,EB445137-D7F5-57EC-87DA-1DB460D64046,"iPhone13,2"
co.hinge.mobile.ios,84,1744125092,1744125176,1744125176.258761,-18000,EB445137-D7F5-57EC-87DA-1DB460D64046,"iPhone13,2"
edu.cornell.birds.merlin,43,1744125047,1744125090,1744125090.2630181,-18000,EB445137-D7F5-57EC-87DA-1DB460D64046,"iPhone13,2"
com.google.chrome.ios,7,1744125040,1744125047,1744125047.585908,-18000,EB445137-D7F5-57EC-87DA-1DB460D64046,"iPhone13,2"
edu.cornell.birds.merlin,8,1744125032,1744125040,1744125040.119934,-18000,EB445137-D7F5-57EC-87DA-1DB460D64046,"iPhone13,2"
com.apple.Music,2,1744125023,1744125025,1744125025.555717,-18000,EB445137-D7F5-57EC-87DA-1DB460D64046,"iPhone13,2"
com.apple.Music,24,1744122160,1744122184,1744122185.7721539,-18000,EB445137-D7F5-57EC-87DA-1DB460D64046,"iPhone13,2"
com.apple.MobileSMS,16,1744121603,1744121619,1744121619.694137,-18000,EB445137-D7F5-57EC-87DA-1DB460D64046,"iPhone13,2"
com.apple.Health,6,1744121594,1744121600,1744121601.097964,-18000,EB445137-D7F5-57EC-87DA-1DB460D64046,"iPhone13,2"
com.apple.finder,78,1744121586,1744121664,1744121664.420227,-18000,,
com.leomehlig.today,188,1744121398,1744121586,1744121586.106704,-18000,,
com.apple.finder,3,1744121395,1744121398,1744121398.10491,-18000,,
com.renpho.health,31,1744121179,1744121210,1744121210.296122,-18000,EB445137-D7F5-57EC-87DA-1DB460D64046,"iPhone13,2"
com.apple.weather,2,1744121177,1744121179,1744121179.129682,-18000,EB445137-D7F5-57EC-87DA-1DB460D64046,"iPhone13,2"
com.apple.weather,8,1744121066,1744121074,1744121074.3394442,-18000,EB445137-D7F5-57EC-87DA-1DB460D64046,"iPhone13,2"
com.google.ios.ytcreator,3,1744119645,1744119648,1744119648.364527,-18000,EB445137-D7F5-57EC-87DA-1DB460D64046,"iPhone13,2"
com.apple.weather,43,1744119502,1744119545,1744119545.618427,-18000,EB445137-D7F5-57EC-87DA-1DB460D64046,"iPhone13,2"
com.letterboxd.LetterboxdApp,239,1744119234,1744119473,1744119473.901551,-18000,EB445137-D7F5-57EC-87DA-1DB460D64046,"iPhone13,2"
com.apple.news,661,1744118570,1744119231,1744119231.972136,-18000,EB445137-D7F5-57EC-87DA-1DB460D64046,"iPhone13,2"
com.apple.news,459,1744118109,1744118568,1744118568.709437,-18000,EB445137-D7F5-57EC-87DA-1DB460D64046,"iPhone13,2"
com.apple.mobiletimer,5,1744116477,1744116482,1744116482.261259,-18000,EB445137-D7F5-57EC-87DA-1DB460D64046,"iPhone13,2"
com.instructure.icanvas,143,1744116323,1744116466,1744116466.943306,-18000,EB445137-D7F5-57EC-87DA-1DB460D64046,"iPhone13,2"
com.apple.news,1026,1744081689,1744082715,1744082715.517539,-18000,EB445137-D7F5-57EC-87DA-1DB460D64046,"iPhone13,2"
com.apple.CoreAuthUI,2,1744081559,1744081561,1744081561.779012,-18000,EB445137-D7F5-57EC-87DA-1DB460D64046,"iPhone13,2"
com.robinhood.release.Robinhood,113,1744081557,1744081670,1744081670.983838,-18000,EB445137-D7F5-57EC-87DA-1DB460D64046,"iPhone13,2"
com.truebill.truebillnative,2,1744081547,1744081549,1744081549.6046581,-18000,EB445137-D7F5-57EC-87DA-1DB460D64046,"iPhone13,2"
com.netflix.Netflix,9,1744081535,1744081544,1744081544.161612,-18000,EB445137-D7F5-57EC-87DA-1DB460D64046,"iPhone13,2"
com.google.chrome.ios,22,1744081504,1744081526,1744081526.3850188,-18000,EB445137-D7F5-57EC-87DA-1DB460D64046,"iPhone13,2"
com.apple.MobileSMS,4,1744081375,1744081379,1744081379.407438,-18000,EB445137-D7F5-57EC-87DA-1DB460D64046,"iPhone13,2"
co.hinge.mobile.ios,17,1744081350,1744081367,1744081367.6734939,-18000,EB445137-D7F5-57EC-87DA-1DB460D64046,"iPhone13,2"
com.microsoft.Office.Outlook,4,1744081330,1744081334,1744081334.479095,-18000,EB445137-D7F5-57EC-87DA-1DB460D64046,"iPhone13,2"
com.apple.MobileSMS,19,1744081310,1744081329,1744081329.298821,-18000,EB445137-D7F5-57EC-87DA-1DB460D64046,"iPhone13,2"
com.google.chrome.ios,2,1744081308,1744081310,1744081310.872414,-18000,EB445137-D7F5-57EC-87DA-1DB460D64046,"iPhone13,2"
com.apple.MobileSMS,15,1744081293,1744081308,1744081308.614025,-18000,EB445137-D7F5-57EC-87DA-1DB460D64046,"iPhone13,2"
com.google.chrome.ios,24,1744081269,1744081293,1744081293.897927,-18000,EB445137-D7F5-57EC-87DA-1DB460D64046,"iPhone13,2"
com.apple.MobileSMS,8,1744081261,1744081269,1744081269.4778461,-18000,EB445137-D7F5-57EC-87DA-1DB460D64046,"iPhone13,2"
com.google.chrome.ios,76,1744081185,1744081261,1744081261.2539968,-18000,EB445137-D7F5-57EC-87DA-1DB460D64046,"iPhone13,2"
com.apple.MobileSMS,296,1744080888,1744081184,1744081185.2369561,-18000,EB445137-D7F5-57EC-87DA-1DB460D64046,"iPhone13,2"
com.google.chrome.ios,0,1744080888,1744080888,1744080889.685378,-18000,EB445137-D7F5-57EC-87DA-1DB460D64046,"iPhone13,2"
com.google.chrome.ios,16,1744073645,1744073661,1744073661.529221,-18000,EB445137-D7F5-57EC-87DA-1DB460D64046,"iPhone13,2"
com.thestorygraph.thestorygraph,1,1744073644,1744073645,1744073646.137721,-18000,EB445137-D7F5-57EC-87DA-1DB460D64046,"iPhone13,2"
com.apple.finder,300,1744067848,1744068148,1744068148.796957,-18000,,
com.leomehlig.today,10,1744067838,1744067848,1744067848.764411,-18000,,
com.google.Chrome,9,1744067829,1744067838,1744067839.425973,-18000,,
com.leomehlig.today,3,1744067826,1744067829,1744067831.070891,-18000,,
com.apple.finder,5,1744067821,1744067826,1744067827.2307029,-18000,,
com.thestorygraph.thestorygraph,17,1744066782,1744066799,1744066799.8545961,-18000,EB445137-D7F5-57EC-87DA-1DB460D64046,"iPhone13,2"
com.apple.MobileSMS,2,1744066767,1744066769,1744066769.16294,-18000,EB445137-D7F5-57EC-87DA-1DB460D64046,"iPhone13,2"
com.apple.MobileSMS,2,1744066709,1744066711,1744066711.558879,-18000,EB445137-D7F5-57EC-87DA-1DB460D64046,"iPhone13,2"
com.apple.MobileSMS,14,1744066440,1744066454,1744066454.2315521,-18000,EB445137-D7F5-57EC-87DA-1DB460D64046,"iPhone13,2"
com.apple.MobileSMS,9,1744066054,1744066063,1744066063.430412,-18000,EB445137-D7F5-57EC-87DA-1DB460D64046,"iPhone13,2"
com.google.chrome.ios,9,1744066045,1744066054,1744066054.218265,-18000,EB445137-D7F5-57EC-87DA-1DB460D64046,"iPhone13,2"
com.google.chrome.ios,28,1744065993,1744066021,1744066021.797406,-18000,EB445137-D7F5-57EC-87DA-1DB460D64046,"iPhone13,2"
com.apple.weather,2,1744065991,1744065993,1744065993.082377,-18000,EB445137-D7F5-57EC-87DA-1DB460D64046,"iPhone13,2"
com.apple.weather,8,1744065928,1744065936,1744065936.9568992,-18000,EB445137-D7F5-57EC-87DA-1DB460D64046,"iPhone13,2"
com.instructure.icanvas,10,1744065916,1744065926,1744065926.302721,-18000,EB445137-D7F5-57EC-87DA-1DB460D64046,"iPhone13,2"
com.apple.MobileSMS,0,1744065916,1744065916,1744065917.676121,-18000,EB445137-D7F5-57EC-87DA-1DB460D64046,"iPhone13,2"
com.apple.MobileSMS,15,1744065862,1744065877,1744065877.320664,-18000,EB445137-D7F5-57EC-87DA-1DB460D64046,"iPhone13,2"
com.apple.MobileSMS,3,1744065858,1744065861,1744065861.244858,-18000,EB445137-D7F5-57EC-87DA-1DB460D64046,"iPhone13,2"
com.apple.MobileSMS,69,1744065383,1744065452,1744065452.663584,-18000,EB445137-D7F5-57EC-87DA-1DB460D64046,"iPhone13,2"
com.apple.MobileSMS,50,1744065012,1744065062,1744065062.613333,-18000,EB445137-D7F5-57EC-87DA-1DB460D64046,"iPhone13,2"
com.apple.finder,8,1744063238,1744063246,1744063246.176647,-18000,,
com.leomehlig.today,71,1744063167,1744063238,1744063238.963454,-18000,,
com.google.Chrome,3,1744063164,1744063167,1744063167.5202432,-18000,,
com.apple.finder,4,1744063160,1744063164,1744063164.6508598,-18000,,
com.google.Chrome,991,1744062169,1744063160,1744063160.412012,-18000,,
com.apple.Preview,181,1744061988,1744062169,1744062169.122983,-18000,,
com.google.Chrome,492,1744061496,1744061988,1744061988.3090348,-18000,,
com.google.Chrome,305,1744061188,1744061493,1744061493.278768,-18000,,
com.apple.Preview,63,1744061125,1744061188,1744061188.3304949,-18000,,
com.apple.finder,6,1744061119,1744061125,1744061125.311847,-18000,,
com.apple.Preview,280,1744060839,1744061119,1744061119.3140888,-18000,,
com.google.Chrome,72,1744060767,1744060839,1744060839.9158468,-18000,,
com.apple.Preview,112,1744060655,1744060767,1744060767.535252,-18000,,
com.apple.finder,2,1744060653,1744060655,1744060655.306356,-18000,,
com.apple.Preview,2,1744060651,1744060653,1744060653.3806171,-18000,,
com.apple.finder,8,1744060643,1744060651,1744060651.9579701,-18000,,
com.google.Chrome,0,1744060643,1744060643,1744060643.8845248,-18000,,
com.microsoft.Outlook,1,1744060642,1744060643,1744060643.123557,-18000,,
com.google.Chrome,35,1744060607,1744060642,1744060642.585665,-18000,,
com.microsoft.Outlook,17,1744060590,1744060607,1744060607.095518,-18000,,
com.google.Chrome,33,1744060557,1744060590,1744060590.0435228,-18000,,
com.leomehlig.today,23,1744060534,1744060557,1744060557.863151,-18000,,
com.apple.finder,2,1744060532,1744060534,1744060534.516724,-18000,,
com.apple.iCal,0,1744060532,1744060532,1744060532.920707,-18000,,
com.apple.finder,1,1744060531,1744060532,1744060532.525702,-18000,,
com.apple.Photos,0,1744060531,1744060531,1744060531.52422,-18000,,
com.google.Chrome,2,1744060529,1744060531,1744060531.1070418,-18000,,
com.apple.MobileSMS,0,1744060529,1744060529,1744060529.887514,-18000,,
com.google.Chrome,7,1744060522,1744060529,1744060529.462465,-18000,,
com.apple.CoreAuthUI,2,1744060039,1744060041,1744060041.562124,-18000,EB445137-D7F5-57EC-87DA-1DB460D64046,"iPhone13,2"
com.truebill.truebillnative,13,1744060037,1744060050,1744060050.75702,-18000,EB445137-D7F5-57EC-87DA-1DB460D64046,"iPhone13,2"
com.microsoft.Office.Outlook,22,1744060011,1744060033,1744060033.750668,-18000,EB445137-D7F5-57EC-87DA-1DB460D64046,"iPhone13,2"
com.google.Chrome,300,1744059978,1744060278,1744060278.3374438,-18000,,
com.apple.FaceTime,0,1744059978,1744059978,1744059978.836072,-18000,,
com.google.Chrome,548,1744059430,1744059978,1744059978.191823,-18000,,
com.apple.FaceTime,12,1744059418,1744059430,1744059430.2673821,-18000,,
com.google.Chrome,77,1744059341,1744059418,1744059418.5957341,-18000,,
com.apple.finder,1,1744059340,1744059341,1744059341.688709,-18000,,
com.apple.MobileSMS,1,1744059339,1744059340,1744059340.832494,-18000,,
com.apple.Photos,9,1744059330,1744059339,1744059339.895944,-18000,,
com.apple.MobileSMS,1,1744059329,1744059330,1744059330.516073,-18000,,
com.apple.Photos,22,1744059307,1744059329,1744059329.834346,-18000,,
com.apple.finder,4,1744059303,1744059307,1744059307.459882,-18000,,
com.google.Chrome,17,1744059286,1744059303,1744059303.227412,-18000,,
com.apple.iCal,227,1744059045,1744059272,1744059272.2158651,-18000,,
com.apple.FaceTime,46,1744058999,1744059045,1744059045.2020621,-18000,,
com.apple.MobileSMS,57,1744058942,1744058999,1744058999.386781,-18000,,
com.leomehlig.today,26,1744058916,1744058942,1744058942.8057141,-18000,,
com.apple.MobileSMS,6,1744058910,1744058916,1744058916.6960611,-18000,,
com.leomehlig.today,42,1744058868,1744058910,1744058910.141378,-18000,,
com.apple.news,14,1744058813,1744058827,1744058827.454224,-18000,EB445137-D7F5-57EC-87DA-1DB460D64046,"iPhone13,2"
com.apple.MobileSMS,199,1744058669,1744058868,1744058868.320425,-18000,,
com.leomehlig.today,8,1744058661,1744058669,1744058669.751507,-18000,,
com.apple.CoreAuthUI,2,1744058572,1744058574,1744058574.646086,-18000,EB445137-D7F5-57EC-87DA-1DB460D64046,"iPhone13,2"
com.robinhood.release.Robinhood,24,1744058569,1744058593,1744058593.937845,-18000,EB445137-D7F5-57EC-87DA-1DB460D64046,"iPhone13,2"
com.facebook.Facebook,35,1744058520,1744058555,1744058555.3465328,-18000,EB445137-D7F5-57EC-87DA-1DB460D64046,"iPhone13,2"
com.microsoft.Office.Outlook,3,1744058509,1744058512,1744058512.442632,-18000,EB445137-D7F5-57EC-87DA-1DB460D64046,"iPhone13,2"
com.apple.MobileSMS,410,1744058251,1744058661,1744058661.618679,-18000,,
com.apple.FaceTime,243,1744058008,1744058251,1744058251.993266,-18000,,
com.apple.weather,16,1744057992,1744058008,1744058008.524541,-18000,,
com.toyopagroup.picaboo,23,1744057876,1744057899,1744057899.638278,-18000,EB445137-D7F5-57EC-87DA-1DB460D64046,"iPhone13,2"
com.apple.findmy,0,1744057876,1744057876,1744057877.6325212,-18000,EB445137-D7F5-57EC-87DA-1DB460D64046,"iPhone13,2"
com.apple.FaceTime,203,1744057789,1744057992,1744057992.4507709,-18000,,
com.apple.MobileSMS,175,1744057614,1744057789,1744057789.2453241,-18000,,
com.apple.FaceTime,87,1744057527,1744057614,1744057614.677065,-18000,,
com.apple.MobileSMS,13,1744057514,1744057527,1744057527.9986382,-18000,,
com.apple.MobileSMS,527,1744056715,1744057242,1744057242.391079,-18000,,
com.apple.FaceTime,3,1744056712,1744056715,1744056715.791096,-18000,,
com.apple.MobileSMS,95,1744056617,1744056712,1744056712.168047,-18000,,
com.leomehlig.today,28,1744056589,1744056617,1744056617.187289,-18000,,
com.apple.findmy,10,1744055856,1744055866,1744055866.957968,-18000,EB445137-D7F5-57EC-87DA-1DB460D64046,"iPhone13,2"
com.microsoft.Office.Outlook,3,1744055853,1744055856,1744055856.350991,-18000,EB445137-D7F5-57EC-87DA-1DB460D64046,"iPhone13,2"
com.microsoft.Office.Outlook,12,1744055745,1744055757,1744055757.259335,-18000,EB445137-D7F5-57EC-87DA-1DB460D64046,"iPhone13,2"
com.microsoft.Office.Outlook,15,1744052475,1744052490,1744052491.367383,-18000,EB445137-D7F5-57EC-87DA-1DB460D64046,"iPhone13,2"
com.apple.news,91,1744052384,1744052475,1744052475.90693,-18000,EB445137-D7F5-57EC-87DA-1DB460D64046,"iPhone13,2"
com.microsoft.Office.Outlook,93,1744052280,1744052373,1744052374.1104488,-18000,EB445137-D7F5-57EC-87DA-1DB460D64046,"iPhone13,2"
com.apple.Health,68,1744050069,1744050137,1744050137.88381,-18000,EB445137-D7F5-57EC-87DA-1DB460D64046,"iPhone13,2"
com.apple.MobileSMS,25,1744047467,1744047492,1744047492.6784592,-18000,EB445137-D7F5-57EC-87DA-1DB460D64046,"iPhone13,2"
com.apple.Music,12,1744047454,1744047466,1744047467.140619,-18000,EB445137-D7F5-57EC-87DA-1DB460D64046,"iPhone13,2"
com.apple.news,22,1744047198,1744047220,1744047220.7275438,-18000,EB445137-D7F5-57EC-87DA-1DB460D64046,"iPhone13,2"
Astrospheric.Astrospheric,2,1744047185,1744047187,1744047187.3436131,-18000,EB445137-D7F5-57EC-87DA-1DB460D64046,"iPhone13,2"
Astrospheric.Astrospheric,120,1744046682,1744046802,1744046802.595865,-18000,EB445137-D7F5-57EC-87DA-1DB460D64046,"iPhone13,2"
com.hammerandchisel.discord,82,1744046596,1744046678,1744046678.22526,-18000,EB445137-D7F5-57EC-87DA-1DB460D64046,"iPhone13,2"
com.apple.Health,27,1744046568,1744046595,1744046595.714925,-18000,EB445137-D7F5-57EC-87DA-1DB460D64046,"iPhone13,2"
com.apple.news,219,1744046252,1744046471,1744046472.0929031,-18000,EB445137-D7F5-57EC-87DA-1DB460D64046,"iPhone13,2"
com.apple.MobileSMS,2,1744046237,1744046239,1744046239.6881518,-18000,EB445137-D7F5-57EC-87DA-1DB460D64046,"iPhone13,2"
com.apple.MobileSMS,1,1744043507,1744043508,1744043509.6214828,-18000,EB445137-D7F5-57EC-87DA-1DB460D64046,"iPhone13,2"
com.google.chrome.ios,47,1744043460,1744043507,1744043507.868654,-18000,EB445137-D7F5-57EC-87DA-1DB460D64046,"iPhone13,2"
com.apple.news,1,1744043459,1744043460,1744043461.0645618,-18000,EB445137-D7F5-57EC-87DA-1DB460D64046,"iPhone13,2"
com.apple.news,13,1744041672,1744041685,1744041685.950728,-18000,EB445137-D7F5-57EC-87DA-1DB460D64046,"iPhone13,2"
com.apple.news,283,1744041388,1744041671,1744041671.667546,-18000,EB445137-D7F5-57EC-87DA-1DB460D64046,"iPhone13,2"
com.apple.weather,27,1744041357,1744041384,1744041384.0708141,-18000,EB445137-D7F5-57EC-87DA-1DB460D64046,"iPhone13,2"
com.apple.CoreAuthUI,2,1744041260,1744041262,1744041262.689559,-18000,EB445137-D7F5-57EC-87DA-1DB460D64046,"iPhone13,2"
com.truebill.truebillnative,45,1744041256,1744041301,1744041301.759649,-18000,EB445137-D7F5-57EC-87DA-1DB460D64046,"iPhone13,2"
com.apple.CoreAuthUI,2,1744041228,1744041230,1744041230.2685661,-18000,EB445137-D7F5-57EC-87DA-1DB460D64046,"iPhone13,2"
com.robinhood.release.Robinhood,20,1744041226,1744041246,1744041246.728001,-18000,EB445137-D7F5-57EC-87DA-1DB460D64046,"iPhone13,2"
com.apple.news,2,1744041206,1744041208,1744041208.235409,-18000,EB445137-D7F5-57EC-87DA-1DB460D64046,"iPhone13,2"
com.toyopagroup.picaboo,32,1744041174,1744041206,1744041206.653092,-18000,EB445137-D7F5-57EC-87DA-1DB460D64046,"iPhone13,2"
com.toyopagroup.picaboo,31,1744041139,1744041170,1744041170.820122,-18000,EB445137-D7F5-57EC-87DA-1DB460D64046,"iPhone13,2"
com.microsoft.Office.Outlook,5,1744040723,1744040728,1744040728.9568639,-18000,EB445137-D7F5-57EC-87DA-1DB460D64046,"iPhone13,2"
com.apple.news,72,1744040629,1744040701,1744040701.793932,-18000,EB445137-D7F5-57EC-87DA-1DB460D64046,"iPhone13,2"
com.leomehlig.today,7,1744040594,1744040601,1744040601.3178601,-18000,,
com.google.Chrome,4,1744040590,1744040594,1744040594.929106,-18000,,
com.apple.news,1294,1744039296,1744040590,1744040590.201294,-18000,,
com.google.Chrome,9,1744039287,1744039296,1744039296.3691869,-18000,,
com.apple.iCal,73,1744039214,1744039287,1744039287.4131088,-18000,,
com.google.Chrome,1,1744039213,1744039214,1744039214.293083,-18000,,
com.apple.iCal,2,1744039211,1744039213,1744039213.6021008,-18000,,
com.google.Chrome,3,1744039208,1744039211,1744039211.9255,-18000,,
com.apple.iCal,14,1744039194,1744039208,1744039208.585765,-18000,,
com.google.Chrome,14,1744039180,1744039194,1744039194.3288689,-18000,,
com.apple.iCal,255,1744038925,1744039180,1744039180.631266,-18000,,
com.google.Chrome,14,1744038911,1744038925,1744038925.957835,-18000,,
com.apple.finder,2,1744038909,1744038911,1744038911.09022,-18000,,
com.leomehlig.today,61,1744038848,1744038909,1744038909.2527652,-18000,,
com.google.Chrome,33,1744038815,1744038848,1744038848.576494,-18000,,
com.apple.shortcuts,34,1744038758,1744038792,1744038792.3050761,-18000,EB445137-D7F5-57EC-87DA-1DB460D64046,"iPhone13,2"
com.leomehlig.today,63,1744038752,1744038815,1744038815.7295032,-18000,,
com.apple.shortcuts,7,1744038745,1744038752,1744038752.419918,-18000,,
com.leomehlig.today,5,1744038740,1744038745,1744038745.474977,-18000,,
com.apple.shortcuts,7,1744038733,1744038740,1744038740.941512,-18000,,
com.leomehlig.today,6,1744038727,1744038733,1744038733.801542,-18000,,
com.apple.shortcuts,63,1744038664,1744038727,1744038727.3660069,-18000,,
com.google.Chrome,80,1744038584,1744038664,1744038664.265524,-18000,,
com.letterboxd.LetterboxdApp,136,1744038424,1744038560,1744038560.24985,-18000,EB445137-D7F5-57EC-87DA-1DB460D64046,"iPhone13,2"
com.leomehlig.today,149,1744038420,1744038569,1744038570.220241,-18000,,
com.apple.news,82,1744038338,1744038420,1744038421.099802,-18000,,
com.leomehlig.today,12,1744038326,1744038338,1744038338.818561,-18000,,
com.apple.finder,1,1744038325,1744038326,1744038326.582241,-18000,,
com.apple.iCal,43,1744038282,1744038325,1744038325.940043,-18000,,
com.google.Chrome,27,1744038255,1744038282,1744038282.065505,-18000,,
com.apple.finder,52,1744038203,1744038255,1744038255.358203,-18000,,
com.apple.MobileSMS,4,1744038137,1744038141,1744038141.8629088,-18000,EB445137-D7F5-57EC-87DA-1DB460D64046,"iPhone13,2"
com.apple.Preview,228,1744037975,1744038203,1744038203.471294,-18000,,
com.apple.finder,3,1744037972,1744037975,1744037975.5691118,-18000,,
com.google.Chrome,118,1744037854,1744037972,1744037972.974323,-18000,,
com.apple.iCal,8,1744037830,1744037838,1744037838.131988,-18000,,
com.apple.Terminal,2,1744037828,1744037830,1744037830.243119,-18000,,
com.apple.iCal,1,1744037827,1744037828,1744037828.870995,-18000,,
com.leomehlig.today,8,1744037819,1744037827,1744037827.940102,-18000,,
com.microsoft.Office.Outlook,47,1744036739,1744036786,1744036786.092047,-18000,EB445137-D7F5-57EC-87DA-1DB460D64046,"iPhone13,2"
com.instructure.icanvas,3,1744036736,1744036739,1744036739.355602,-18000,EB445137-D7F5-57EC-87DA-1DB460D64046,"iPhone13,2"
com.instructure.icanvas,10,1744036715,1744036725,1744036725.659363,-18000,EB445137-D7F5-57EC-87DA-1DB460D64046,"iPhone13,2"
com.leomehlig.today,4,1744036691,1744036695,1744036696.0171452,-18000,,
com.microsoft.VSCode,2,1744036689,1744036691,1744036691.92679,-18000,,
com.apple.Terminal,304,1744036385,1744036689,1744036689.129492,-18000,,
com.microsoft.VSCode,32,1744036353,1744036385,1744036385.509608,-18000,,
com.apple.MobileSMS,84,1744036217,1744036301,1744036301.698488,-18000,EB445137-D7F5-57EC-87DA-1DB460D64046,"iPhone13,2"
com.tinyspeck.chatlyio,18,1744036199,1744036217,1744036217.5335832,-18000,EB445137-D7F5-57EC-87DA-1DB460D64046,"iPhone13,2"
com.leomehlig.today,175,1744036178,1744036353,1744036353.8207068,-18000,,
com.apple.CoreAuthUI,1,1744036124,1744036125,1744036126.0338612,-18000,EB445137-D7F5-57EC-87DA-1DB460D64046,"iPhone13,2"
com.robinhood.release.Robinhood,12,1744036123,1744036135,1744036135.281328,-18000,EB445137-D7F5-57EC-87DA-1DB460D64046,"iPhone13,2"
com.google.Chrome,426,1744035752,1744036178,1744036179.1614408,-18000,,
com.leomehlig.today,0,1744035752,1744035752,1744035752.75562,-18000,,
com.google.Chrome,378,1744035374,1744035752,1744035752.344946,-18000,,
com.leomehlig.today,3,1744035371,1744035374,1744035374.727623,-18000,,
com.google.Chrome,446,1744034925,1744035371,1744035371.2893472,-18000,,
com.apple.news,81,1744034844,1744034925,1744034925.590656,-18000,,
com.google.Chrome,551,1744034293,1744034844,1744034844.4016829,-18000,,
com.apple.finder,1,1744034292,1744034293,1744034293.2867599,-18000,,
com.google.Chrome,1,1744034291,1744034292,1744034292.924917,-18000,,
com.apple.calculator,2,1744034289,1744034291,1744034291.998111,-18000,,
com.google.Chrome,69,1744034220,1744034289,1744034289.7361479,-18000,,
com.apple.MobileSMS,40,1744034180,1744034220,1744034220.558811,-18000,,
com.google.Chrome,232,1744033948,1744034180,1744034180.917978,-18000,,
com.apple.calculator,18,1744033930,1744033948,1744033948.6280031,-18000,,
com.google.Chrome,2,1744033928,1744033930,1744033930.253848,-18000,,
com.apple.calculator,21,1744033907,1744033928,1744033928.541974,-18000,,
com.google.Chrome,2,1744033905,1744033907,1744033907.285389,-18000,,
com.apple.calculator,20,1744033885,1744033905,1744033905.715034,-18000,,
com.google.Chrome,172,1744033713,1744033885,1744033885.973974,-18000,,
com.apple.Preview,19,1744033694,1744033713,1744033713.69601,-18000,,
com.google.Chrome,17,1744033677,1744033694,1744033694.17692,-18000,,
com.apple.calculator,3,1744033674,1744033677,1744033677.0555902,-18000,,
com.google.Chrome,27,1744033647,1744033674,1744033674.3690472,-18000,,
com.apple.calculator,23,1744033624,1744033647,1744033648.005023,-18000,,
com.google.Chrome,1,1744033623,1744033624,1744033624.465353,-18000,,
com.apple.calculator,18,1744033605,1744033623,1744033623.2267718,-18000,,
com.google.Chrome,2,1744033603,1744033605,1744033605.338238,-18000,,
com.apple.calculator,19,1744033584,1744033603,1744033603.236892,-18000,,
com.google.Chrome,321,1744033263,1744033584,1744033584.619749,-18000,,
com.apple.MobileSMS,11,1744033252,1744033263,1744033263.427321,-18000,,
com.apple.CoreAuthUI,2,1744033158,1744033160,1744033160.7980452,-18000,EB445137-D7F5-57EC-87DA-1DB460D64046,"iPhone13,2"
com.robinhood.release.Robinhood,68,1744033155,1744033223,1744033224.072977,-18000,EB445137-D7F5-57EC-87DA-1DB460D64046,"iPhone13,2"
com.apple.Music,2,1744033149,1744033151,1744033152.01998,-18000,EB445137-D7F5-57EC-87DA-1DB460D64046,"iPhone13,2"
com.google.Chrome,212,1744033040,1744033252,1744033252.9581618,-18000,,
com.apple.MobileSMS,98,1744032942,1744033040,1744033040.7171721,-18000,,
com.google.Chrome,1,1744032941,1744032942,1744032942.796643,-18000,,
com.apple.MobileSMS,8,1744032933,1744032941,1744032941.59064,-18000,,
com.google.Chrome,18,1744032915,1744032933,1744032933.557179,-18000,,
com.apple.MobileSMS,1,1744032914,1744032915,1744032915.798706,-18000,,
com.google.Chrome,68,1744032846,1744032914,1744032914.093594,-18000,,
com.apple.MobileSMS,16,1744032830,1744032846,1744032846.693636,-18000,,
com.google.Chrome,33,1744032797,1744032830,1744032830.7806401,-18000,,
com.apple.MobileSMS,47,1744032750,1744032797,1744032797.700018,-18000,,
com.google.Chrome,9,1744032741,1744032750,1744032750.1608129,-18000,,
com.apple.MobileSMS,2,1744032739,1744032741,1744032741.042367,-18000,,
com.google.Chrome,12,1744032727,1744032739,1744032739.332689,-18000,,
com.apple.MobileSMS,157,1744032570,1744032727,1744032727.712171,-18000,,
com.google.Chrome,3,1744032567,1744032570,1744032570.880622,-18000,,
com.apple.MobileSMS,0,1744032567,1744032567,1744032567.887294,-18000,,
com.apple.Music,4,1744032563,1744032567,1744032567.804161,-18000,,
com.apple.MobileSMS,2,1744032561,1744032563,1744032564.005285,-18000,,
com.google.Chrome,7,1744032554,1744032561,1744032561.87273,-18000,,
com.apple.finder,0,1744032554,1744032554,1744032554.7466102,-18000,,
com.apple.Notes,2,1744032552,1744032554,1744032554.182815,-18000,,
com.apple.finder,5,1744032547,1744032552,1744032552.770143,-18000,,
com.leomehlig.today,6,1744032541,1744032547,1744032547.935844,-18000,,
com.microsoft.VSCode,8,1744032533,1744032541,1744032541.8043509,-18000,,
com.leomehlig.today,5,1744032528,1744032533,1744032534.072027,-18000,,
com.apple.Music,29,1744031490,1744031519,1744031522.1152868,-18000,EB445137-D7F5-57EC-87DA-1DB460D64046,"iPhone13,2"
com.apple.Health,82,1744030483,1744030565,1744030565.388968,-18000,EB445137-D7F5-57EC-87DA-1DB460D64046,"iPhone13,2"
com.apple.weather,44,1744030426,1744030470,1744030470.610158,-18000,EB445137-D7F5-57EC-87DA-1DB460D64046,"iPhone13,2"
com.apple.mobiletimer,11,1744030411,1744030422,1744030422.124289,-18000,EB445137-D7F5-57EC-87DA-1DB460D64046,"iPhone13,2"
com.apple.MobileSMS,2,1744029722,1744029724,1744029724.5435848,-18000,EB445137-D7F5-57EC-87DA-1DB460D64046,"iPhone13,2"
com.apple.MobileSMS,27,1744029618,1744029645,1744029646.0429978,-18000,EB445137-D7F5-57EC-87DA-1DB460D64046,"iPhone13,2"
com.google.chrome.ios,3,1743999263,1743999266,1743999267.129735,-18000,EB445137-D7F5-57EC-87DA-1DB460D64046,"iPhone13,2"
com.leomehlig.today,5,1743999108,1743999113,1743999113.788408,-18000,,
com.google.Chrome,3,1743999105,1743999108,1743999108.7848039,-18000,,
com.apple.MobileSMS,7,1743999098,1743999105,1743999105.4348922,-18000,,
com.google.Chrome,854,1743998244,1743999098,1743999098.655309,-18000,,
com.apple.MobileSMS,10,1743998234,1743998244,1743998244.667474,-18000,,
com.microsoft.VSCode,313,1743997921,1743998234,1743998234.24558,-18000,,
com.google.Chrome,1,1743997920,1743997921,1743997921.5087662,-18000,,
com.microsoft.VSCode,0,1743997920,1743997920,1743997920.753679,-18000,,
com.google.Chrome,23,1743997897,1743997920,1743997920.305093,-18000,,
com.microsoft.VSCode,15,1743997882,1743997897,1743997897.281124,-18000,,
com.google.Chrome,4,1743997878,1743997882,1743997882.953691,-18000,,
com.microsoft.VSCode,25,1743997853,1743997878,1743997878.912795,-18000,,
com.google.Chrome,25,1743997828,1743997853,1743997853.6812692,-18000,,
com.microsoft.VSCode,122,1743997706,1743997828,1743997828.66229,-18000,,
com.google.chrome.ios,17,1743995624,1743995641,1743995641.9199371,-18000,EB445137-D7F5-57EC-87DA-1DB460D64046,"iPhone13,2"
com.microsoft.Office.Outlook,13,1743995611,1743995624,1743995625.281302,-18000,EB445137-D7F5-57EC-87DA-1DB460D64046,"iPhone13,2"
com.google.chrome.ios,256,1743994959,1743995215,1743995216.345817,-18000,EB445137-D7F5-57EC-87DA-1DB460D64046,"iPhone13,2"
com.apple.MobileSMS,8,1743989723,1743989731,1743989731.901469,-18000,EB445137-D7F5-57EC-87DA-1DB460D64046,"iPhone13,2"
com.apple.MobileSMS,12,1743989463,1743989475,1743989475.612904,-18000,EB445137-D7F5-57EC-87DA-1DB460D64046,"iPhone13,2"
com.google.chrome.ios,2,1743989461,1743989463,1743989465.2145572,-18000,EB445137-D7F5-57EC-87DA-1DB460D64046,"iPhone13,2"
com.google.chrome.ios,57,1743987655,1743987712,1743987713.219712,-18000,EB445137-D7F5-57EC-87DA-1DB460D64046,"iPhone13,2"
com.apple.MobileSMS,3,1743987652,1743987655,1743987655.12469,-18000,EB445137-D7F5-57EC-87DA-1DB460D64046,"iPhone13,2"
com.apple.MobileSMS,3,1743985855,1743985858,1743985859.012038,-18000,EB445137-D7F5-57EC-87DA-1DB460D64046,"iPhone13,2"
com.apple.MobileSMS,19,1743985812,1743985831,1743985831.904935,-18000,EB445137-D7F5-57EC-87DA-1DB460D64046,"iPhone13,2"
com.apple.news,1994,1743983775,1743985769,1743985769.2618098,-18000,EB445137-D7F5-57EC-87DA-1DB460D64046,"iPhone13,2"
com.microsoft.VSCode,176,1743983404,1743983580,1743983580.70041,-18000,,
com.apple.shortcuts,2,1743983402,1743983404,1743983404.5934339,-18000,,
com.microsoft.VSCode,3,1743983368,1743983371,1743983371.555912,-18000,,
com.leomehlig.today,5,1743983363,1743983368,1743983368.6507978,-18000,,
com.microsoft.VSCode,19,1743983344,1743983363,1743983363.312916,-18000,,
com.google.Chrome,2,1743983342,1743983344,1743983345.2360759,-18000,,
com.leomehlig.today,4,1743983338,1743983342,1743983344.5884871,-18000,,
com.apple.news,42,1743983155,1743983197,1743983197.634441,-18000,EB445137-D7F5-57EC-87DA-1DB460D64046,"iPhone13,2"
com.apple.CoreAuthUI,3,1743983124,1743983127,1743983127.909493,-18000,EB445137-D7F5-57EC-87DA-1DB460D64046,"iPhone13,2"
com.robinhood.release.Robinhood,21,1743983123,1743983144,1743983144.8614879,-18000,EB445137-D7F5-57EC-87DA-1DB460D64046,"iPhone13,2"
com.apple.CoreAuthUI,5,1743983022,1743983027,1743983027.753222,-18000,EB445137-D7F5-57EC-87DA-1DB460D64046,"iPhone13,2"
com.robinhood.release.Robinhood,103,1743983018,1743983121,1743983122.025931,-18000,EB445137-D7F5-57EC-87DA-1DB460D64046,"iPhone13,2"
com.apple.news,445,1743982571,1743983016,1743983016.578845,-18000,EB445137-D7F5-57EC-87DA-1DB460D64046,"iPhone13,2"
com.apple.Music,2,1743982552,1743982554,1743982554.6943479,-18000,EB445137-D7F5-57EC-87DA-1DB460D64046,"iPhone13,2"
com.apple.Music,3,1743982176,1743982179,1743982179.9438782,-18000,EB445137-D7F5-57EC-87DA-1DB460D64046,"iPhone13,2"
com.apple.Music,10,1743981267,1743981277,1743981278.44031,-18000,EB445137-D7F5-57EC-87DA-1DB460D64046,"iPhone13,2"
com.apple.InCallService,278,1743980725,1743981003,1743981003.2976031,-18000,EB445137-D7F5-57EC-87DA-1DB460D64046,"iPhone13,2"
com.apple.news,27,1743980692,1743980719,1743980719.357607,-18000,EB445137-D7F5-57EC-87DA-1DB460D64046,"iPhone13,2"
com.apple.mobilenotes,12,1743980672,1743980684,1743980684.652082,-18000,EB445137-D7F5-57EC-87DA-1DB460D64046,"iPhone13,2"
com.apple.mobilenotes,64,1743979095,1743979159,1743979159.593447,-18000,EB445137-D7F5-57EC-87DA-1DB460D64046,"iPhone13,2"
com.apple.news,30,1743977566,1743977596,1743977597.1312652,-18000,EB445137-D7F5-57EC-87DA-1DB460D64046,"iPhone13,2"
com.apple.news,114,1743977416,1743977530,1743977530.415004,-18000,EB445137-D7F5-57EC-87DA-1DB460D64046,"iPhone13,2"
com.instructure.icanvas,6,1743977005,1743977011,1743977011.7868562,-18000,EB445137-D7F5-57EC-87DA-1DB460D64046,"iPhone13,2"
com.apple.MobileSMS,9,1743976993,1743977002,1743977002.377492,-18000,EB445137-D7F5-57EC-87DA-1DB460D64046,"iPhone13,2"
com.apple.MobileSMS,3,1743976990,1743976993,1743976994.335139,-18000,EB445137-D7F5-57EC-87DA-1DB460D64046,"iPhone13,2"
com.google.chrome.ios,0,1743976990,1743976990,1743976991.211927,-18000,EB445137-D7F5-57EC-87DA-1DB460D64046,"iPhone13,2"
com.google.chrome.ios,567,1743976270,1743976837,1743976838.8813949,-18000,EB445137-D7F5-57EC-87DA-1DB460D64046,"iPhone13,2"
com.apple.news,105,1743976165,1743976270,1743976270.47937,-18000,EB445137-D7F5-57EC-87DA-1DB460D64046,"iPhone13,2"
com.google.chrome.ios,97,1743976068,1743976165,1743976166.233449,-18000,EB445137-D7F5-57EC-87DA-1DB460D64046,"iPhone13,2"
com.apple.news,903,1743975163,1743976066,1743976066.948513,-18000,EB445137-D7F5-57EC-87DA-1DB460D64046,"iPhone13,2"
com.apple.news,13,1743975137,1743975150,1743975150.1957688,-18000,EB445137-D7F5-57EC-87DA-1DB460D64046,"iPhone13,2"
com.apple.news,3,1743970952,1743970955,1743970955.136086,-18000,EB445137-D7F5-57EC-87DA-1DB460D64046,"iPhone13,2"
com.apple.news,214,1743970234,1743970448,1743970449.347704,-18000,EB445137-D7F5-57EC-87DA-1DB460D64046,"iPhone13,2"
com.microsoft.Office.Outlook,3,1743970225,1743970228,1743970228.055891,-18000,EB445137-D7F5-57EC-87DA-1DB460D64046,"iPhone13,2"
com.microsoft.Office.Outlook,34,1743970187,1743970221,1743970221.228138,-18000,EB445137-D7F5-57EC-87DA-1DB460D64046,"iPhone13,2"
com.apple.Music,2,1743970185,1743970187,1743970187.5704,-18000,EB445137-D7F5-57EC-87DA-1DB460D64046,"iPhone13,2"
com.apple.Music,26,1743969649,1743969675,1743969676.244419,-18000,EB445137-D7F5-57EC-87DA-1DB460D64046,"iPhone13,2"
com.intsig.CamScannerLite,2,1743969646,1743969648,1743969650.0874639,-18000,EB445137-D7F5-57EC-87DA-1DB460D64046,"iPhone13,2"
com.leomehlig.today,78,1743969250,1743969328,1743969328.286909,-18000,,
com.google.Chrome,67,1743969183,1743969250,1743969250.705864,-18000,,
com.leomehlig.today,10,1743969173,1743969183,1743969183.9553962,-18000,,
com.google.Chrome,44,1743969129,1743969173,1743969173.7948608,-18000,,
com.google.Chrome,521,1743968457,1743968978,1743968978.919467,-18000,,
com.apple.finder,2,1743968095,1743968097,1743968097.633936,-18000,,
com.leomehlig.today,3,1743968092,1743968095,1743968095.5899901,-18000,,
com.google.Chrome,5,1743968087,1743968092,1743968092.872563,-18000,,
com.leomehlig.today,27,1743968060,1743968087,1743968087.7665992,-18000,,
com.google.Chrome,20,1743968040,1743968060,1743968060.1305819,-18000,,
com.apple.finder,3,1743968037,1743968040,1743968040.364299,-18000,,
com.google.Chrome,12,1743968025,1743968037,1743968037.976659,-18000,,
com.apple.finder,7,1743968018,1743968025,1743968025.280344,-18000,,
com.apple.Preview,52,1743967966,1743968018,1743968018.4950151,-18000,,
com.apple.finder,2,1743967964,1743967966,1743967966.725636,-18000,,
com.apple.Preview,15,1743967949,1743967964,1743967964.174366,-18000,,
com.apple.finder,3,1743967946,1743967949,1743967949.31162,-18000,,
com.apple.Preview,3,1743967943,1743967946,1743967946.160155,-18000,,
com.intsig.CamScannerLite,76,1743967887,1743967963,1743967963.772181,-18000,EB445137-D7F5-57EC-87DA-1DB460D64046,"iPhone13,2"
com.apple.finder,255,1743967688,1743967943,1743967943.15488,-18000,,
com.google.Chrome,1233,1743966455,1743967688,1743967688.614079,-18000,,
com.apple.finder,34,1743966421,1743966455,1743966455.606741,-18000,,
com.google.Chrome,404,1743966017,1743966421,1743966421.9555259,-18000,,
com.leomehlig.today,5,1743966012,1743966017,1743966017.5541239,-18000,,
com.google.Chrome,664,1743965348,1743966012,1743966012.712235,-18000,,
com.apple.finder,18,1743965330,1743965348,1743965348.9273071,-18000,,
com.google.Chrome,113,1743965217,1743965330,1743965330.056473,-18000,,
com.leomehlig.today,32,1743965185,1743965217,1743965217.46212,-18000,,
com.leomehlig.today,8,1743964970,1743964978,1743964978.402298,-18000,,
com.google.Chrome,2,1743964968,1743964970,1743964970.792488,-18000,,
com.apple.Music,24,1743964070,1743964094,1743964097.1069431,-18000,EB445137-D7F5-57EC-87DA-1DB460D64046,"iPhone13,2"
com.google.Chrome,1281,1743963647,1743964928,1743964928.621235,-18000,,
com.apple.Preview,1,1743963646,1743963647,1743963647.690635,-18000,,
com.google.Chrome,49,1743963597,1743963646,1743963646.534256,-18000,,
com.apple.Preview,4,1743963593,1743963597,1743963597.642712,-18000,,
com.google.Chrome,125,1743963468,1743963593,1743963593.566162,-18000,,
com.apple.Preview,506,1743962962,1743963468,1743963468.3028212,-18000,,
com.apple.finder,1,1743962961,1743962962,1743962962.58636,-18000,,
com.apple.Preview,227,1743962734,1743962961,1743962961.238776,-18000,,
com.apple.finder,25,1743962709,1743962734,1743962734.069044,-18000,,
com.google.Chrome,15,1743962694,1743962709,1743962709.733468,-18000,,
com.apple.finder,2,1743962671,1743962673,1743962673.2059078,-18000,,
com.apple.finder,18,1743961469,1743961487,1743961487.0708818,-18000,,
com.leomehlig.today,1,1743961468,1743961469,1743961469.3755789,-18000,,
com.google.Chrome,314,1743961154,1743961468,1743961468.532271,-18000,,
com.leomehlig.today,43,1743961111,1743961154,1743961154.206514,-18000,,
com.google.Chrome,41,1743961070,1743961111,1743961111.3001962,-18000,,
com.leomehlig.today,2,1743961068,1743961070,1743961070.593672,-18000,,
com.google.Chrome,4,1743961064,1743961068,1743961068.169064,-18000,,
com.leomehlig.today,3,1743961061,1743961064,1743961064.528569,-18000,,
com.google.Chrome,9,1743961052,1743961061,1743961061.8215818,-18000,,
com.apple.finder,108,1743960924,1743961032,1743961033.9012141,-18000,,
com.microsoft.VSCode,193,1743960731,1743960924,1743960925.025053,-18000,,
com.apple.finder,31,1743960700,1743960731,1743960731.98297,-18000,,
com.microsoft.VSCode,1,1743960699,1743960700,1743960700.797548,-18000,,
com.apple.finder,2,1743960697,1743960699,1743960699.7414389,-18000,,
com.apple.CoreAuthUI,1,1743957749,1743957750,1743957751.013001,-18000,EB445137-D7F5-57EC-87DA-1DB460D64046,"iPhone13,2"
com.truebill.truebillnative,223,1743957748,1743957971,1743957971.7730942,-18000,EB445137-D7F5-57EC-87DA-1DB460D64046,"iPhone13,2"
com.apple.Music,2,1743957745,1743957747,1743957747.555634,-18000,EB445137-D7F5-57EC-87DA-1DB460D64046,"iPhone13,2"
com.apple.Music,20,1743957216,1743957236,1743957236.517768,-18000,EB445137-D7F5-57EC-87DA-1DB460D64046,"iPhone13,2"
com.truebill.truebillnative,1,1743957215,1743957216,1743957219.4250932,-18000,EB445137-D7F5-57EC-87DA-1DB460D64046,"iPhone13,2"
com.apple.CoreAuthUI,7,1743956139,1743956146,1743956146.3439422,-18000,EB445137-D7F5-57EC-87DA-1DB460D64046,"iPhone13,2"
com.truebill.truebillnative,195,1743956136,1743956331,1743956331.885757,-18000,EB445137-D7F5-57EC-87DA-1DB460D64046,"iPhone13,2"
com.apple.finder,310,1743955845,1743956155,1743956155.748733,-18000,,
com.microsoft.VSCode,8,1743955837,1743955845,1743955845.25439,-18000,,
com.apple.systempreferences,89,1743955748,1743955837,1743955837.349942,-18000,,
com.microsoft.VSCode,23,1743955717,1743955740,1743955740.0669708,-18000,,
com.apple.finder,11,1743955706,1743955717,1743955717.604268,-18000,,
com.leomehlig.today,27,1743955679,1743955706,1743955706.759067,-18000,,
com.apple.finder,35,1743955644,1743955679,1743955679.672334,-18000,,
com.microsoft.VSCode,104,1743955540,1743955644,1743955644.166994,-18000,,
com.leomehlig.today,94,1743955446,1743955540,1743955540.417739,-18000,,
com.microsoft.VSCode,1,1743955432,1743955433,1743955433.150762,-18000,,
com.leomehlig.today,2,1743955430,1743955432,1743955432.471993,-18000,,
com.apple.iCal,1,1743955429,1743955430,1743955430.990639,-18000,,
com.google.Chrome,24,1743955405,1743955429,1743955429.288189,-18000,,
com.apple.iCal,5,1743955400,1743955405,1743955405.754384,-18000,,
com.google.Chrome,32,1743955368,1743955400,1743955400.078403,-18000,,
com.leomehlig.today,15,1743955353,1743955368,1743955368.970251,-18000,,
com.google.Chrome,377,1743954976,1743955353,1743955353.123218,-18000,,
com.microsoft.VSCode,2,1743954974,1743954976,1743954976.491836,-18000,,
com.google.Chrome,375,1743954599,1743954974,1743954974.757416,-18000,,
com.microsoft.VSCode,180,1743954419,1743954599,1743954599.151391,-18000,,
com.google.Chrome,2,1743954417,1743954419,1743954419.498096,-18000,,
com.microsoft.VSCode,1,1743954416,1743954417,1743954417.746244,-18000,,
com.google.Chrome,394,1743954022,1743954416,1743954416.762404,-18000,,
com.microsoft.VSCode,1,1743954021,1743954022,1743954022.057198,-18000,,
com.google.Chrome,284,1743953737,1743954021,1743954021.43467,-18000,,
com.microsoft.VSCode,2,1743953735,1743953737,1743953737.5676289,-18000,,
com.google.Chrome,590,1743953145,1743953735,1743953735.984604,-18000,,
com.microsoft.VSCode,37,1743953089,1743953126,1743953126.106279,-18000,,
com.apple.Preview,69,1743953020,1743953089,1743953089.314954,-18000,,
com.apple.finder,4,1743953016,1743953020,1743953020.385572,-18000,,
com.apple.news,408,1743952836,1743953244,1743953244.233643,-18000,EB445137-D7F5-57EC-87DA-1DB460D64046,"iPhone13,2"
com.hammerandchisel.discord,9,1743952822,1743952831,1743952831.685164,-18000,EB445137-D7F5-57EC-87DA-1DB460D64046,"iPhone13,2"
com.microsoft.VSCode,201,1743952815,1743953016,1743953016.178587,-18000,,
com.leomehlig.today,37,1743952778,1743952815,1743952815.089452,-18000,,
com.apple.iCal,1,1743952777,1743952778,1743952778.485744,-18000,,
com.microsoft.VSCode,11,1743952766,1743952777,1743952777.857259,-18000,,
com.google.Chrome,145,1743952621,1743952766,1743952767.1397982,-18000,,
com.apple.finder,6,1743952615,1743952621,1743952621.311771,-18000,,
com.google.Chrome,0,1743952615,1743952615,1743952615.6790051,-18000,,
com.apple.finder,3,1743952612,1743952615,1743952615.25085,-18000,,
com.google.Chrome,417,1743952195,1743952612,1743952612.4985108,-18000,,
com.strava.stravaride,50,1743952082,1743952132,1743952132.853224,-18000,EB445137-D7F5-57EC-87DA-1DB460D64046,"iPhone13,2"
co.hinge.mobile.ios,6,1743952068,1743952074,1743952074.713984,-18000,EB445137-D7F5-57EC-87DA-1DB460D64046,"iPhone13,2"
com.apple.weather,13,1743952046,1743952059,1743952059.235279,-18000,EB445137-D7F5-57EC-87DA-1DB460D64046,"iPhone13,2"
com.apple.Health,2,1743952027,1743952029,1743952030.177648,-18000,EB445137-D7F5-57EC-87DA-1DB460D64046,"iPhone13,2"
com.microsoft.VSCode,274,1743951879,1743952153,1743952153.09869,-18000,,
com.apple.finder,11,1743951868,1743951879,1743951879.610563,-18000,,
com.microsoft.VSCode,7,1743951861,1743951868,1743951868.831789,-18000,,
com.apple.finder,30,1743951831,1743951861,1743951861.608714,-18000,,
com.microsoft.VSCode,5,1743951826,1743951831,1743951831.829338,-18000,,
com.apple.finder,7,1743951819,1743951826,1743951826.6399078,-18000,,
com.microsoft.VSCode,6,1743951813,1743951819,1743951819.987939,-18000,,
com.apple.finder,156,1743951657,1743951813,1743951813.692972,-18000,,
com.microsoft.VSCode,9,1743951648,1743951657,1743951657.99856,-18000,,
com.apple.finder,7,1743951641,1743951648,1743951648.83598,-18000,,
com.microsoft.VSCode,16,1743951625,1743951641,1743951641.377852,-18000,,
com.apple.finder,15,1743951610,1743951625,1743951625.494453,-18000,,
com.microsoft.VSCode,33,1743951577,1743951610,1743951610.9309459,-18000,,
com.apple.finder,24,1743951553,1743951577,1743951577.621412,-18000,,
com.microsoft.VSCode,11,1743951542,1743951553,1743951553.289165,-18000,,
com.apple.finder,30,1743951512,1743951542,1743951542.5069098,-18000,,
com.microsoft.VSCode,5,1743951507,1743951512,1743951513.0299711,-18000,,
com.apple.finder,6,1743951501,1743951507,1743951507.608436,-18000,,
com.microsoft.VSCode,201,1743951300,1743951501,1743951501.487077,-18000,,
com.apple.finder,8,1743951292,1743951300,1743951300.076585,-18000,,
com.microsoft.VSCode,6,1743951286,1743951292,1743951292.524105,-18000,,
com.apple.Notes,43,1743951243,1743951286,1743951286.8243709,-18000,,
com.microsoft.VSCode,147,1743951096,1743951243,1743951243.537315,-18000,,
com.apple.finder,28,1743951068,1743951096,1743951096.080809,-18000,,
com.microsoft.VSCode,28,1743951040,1743951068,1743951068.4103,-18000,,
com.google.Chrome,1,1743951039,1743951040,1743951041.022799,-18000,,
com.microsoft.VSCode,7,1743951032,1743951039,1743951039.965996,-18000,,
com.apple.finder,26,1743951006,1743951032,1743951032.794694,-18000,,
com.microsoft.VSCode,22,1743950984,1743951006,1743951006.847718,-18000,,
com.apple.finder,22,1743950962,1743950984,1743950984.4871578,-18000,,
com.microsoft.VSCode,1,1743950961,1743950962,1743950963.011416,-18000,,
com.apple.finder,4,1743950957,1743950961,1743950961.364897,-18000,,
com.leomehlig.today,0,1743950957,1743950957,1743950958.0469232,-18000,,
com.google.Chrome,1,1743950956,1743950957,1743950957.852979,-18000,,
com.apple.finder,29,1743950927,1743950956,1743950956.4771829,-18000,,
com.google.Chrome,38,1743950889,1743950927,1743950927.297673,-18000,,
com.apple.news,377,1743950512,1743950889,1743950889.4376369,-18000,,
com.google.Chrome,47,1743950465,1743950512,1743950512.992455,-18000,,
com.leomehlig.today,2,1743950463,1743950465,1743950465.4197512,-18000,,
com.google.Chrome,12,1743950451,1743950463,1743950463.8999019,-18000,,
com.apple.Notes,31,1743950420,1743950451,1743950452.0719519,-18000,,
com.google.Chrome,1,1743950419,1743950420,1743950420.801962,-18000,,
com.apple.Notes,1,1743950418,1743950419,1743950419.908201,-18000,,
com.google.Chrome,142,1743950276,1743950418,1743950418.199349,-18000,,
com.apple.Health,18,1743950262,1743950280,1743950280.9147692,-18000,EB445137-D7F5-57EC-87DA-1DB460D64046,"iPhone13,2"
com.hammerandchisel.discord,91,1743950092,1743950183,1743950183.5362802,-18000,EB445137-D7F5-57EC-87DA-1DB460D64046,"iPhone13,2"
com.microsoft.Office.Outlook,2,1743950089,1743950091,1743950091.3601398,-18000,EB445137-D7F5-57EC-87DA-1DB460D64046,"iPhone13,2"
com.microsoft.Office.Outlook,55,1743950032,1743950087,1743950087.2558699,-18000,EB445137-D7F5-57EC-87DA-1DB460D64046,"iPhone13,2"
com.apple.news,64,1743949965,1743950029,1743950030.2650418,-18000,EB445137-D7F5-57EC-87DA-1DB460D64046,"iPhone13,2"
com.apple.weather,0,1743949965,1743949965,1743949966.1737862,-18000,EB445137-D7F5-57EC-87DA-1DB460D64046,"iPhone13,2"
com.google.Chrome,359,1743949866,1743950225,1743950225.764631,-18000,,
com.apple.finder,67,1743949799,1743949866,1743949866.795932,-18000,,
com.google.Chrome,74,1743949725,1743949799,1743949799.6456041,-18000,,
com.apple.finder,1,1743949724,1743949725,1743949725.7562551,-18000,,
com.google.Chrome,31,1743949693,1743949724,1743949724.7109551,-18000,,
com.apple.finder,0,1743949693,1743949693,1743949693.931555,-18000,,
com.google.Chrome,1,1743949692,1743949693,1743949693.108768,-18000,,
com.apple.finder,12,1743949680,1743949692,1743949692.6342978,-18000,,
com.google.Chrome,7,1743949673,1743949680,1743949680.356118,-18000,,
com.apple.finder,16,1743949657,1743949673,1743949673.102161,-18000,,
com.google.Chrome,97,1743949560,1743949657,1743949657.268945,-18000,,
com.apple.finder,22,1743949538,1743949560,1743949560.536121,-18000,,
com.google.Chrome,71,1743949467,1743949538,1743949538.954804,-18000,,
com.apple.finder,5,1743949462,1743949467,1743949467.156598,-18000,,
com.google.Chrome,24,1743949438,1743949462,1743949462.2856112,-18000,,
com.apple.finder,3,1743949435,1743949438,1743949438.847958,-18000,,
com.google.Chrome,5,1743949430,1743949435,1743949435.518445,-18000,,
com.apple.finder,4,1743949426,1743949430,1743949430.9754848,-18000,,
com.google.Chrome,4,1743949422,1743949426,1743949426.844761,-18000,,
com.apple.finder,3,1743949419,1743949422,1743949423.0607681,-18000,,
com.google.Chrome,4,1743949415,1743949419,1743949419.552723,-18000,,
com.apple.finder,9,1743949406,1743949415,1743949415.969363,-18000,,
com.google.Chrome,3,1743949403,1743949406,1743949406.967301,-18000,,
com.apple.finder,6,1743949397,1743949403,1743949403.805912,-18000,,
com.google.Chrome,6,1743949391,1743949397,1743949397.732932,-18000,,
com.apple.finder,5,1743949386,1743949391,1743949391.3293052,-18000,,
com.google.Chrome,3,1743949383,1743949386,1743949386.838222,-18000,,
com.apple.finder,4,1743949379,1743949383,1743949383.429635,-18000,,
com.google.Chrome,3,1743949376,1743949379,1743949379.651931,-18000,,
com.apple.finder,4,1743949372,1743949376,1743949376.158319,-18000,,
com.google.Chrome,3,1743949369,1743949372,1743949372.0913692,-18000,,
com.apple.finder,2,1743949367,1743949369,1743949369.418195,-18000,,
com.google.Chrome,5,1743949362,1743949367,1743949367.111,-18000,,
com.apple.finder,2,1743949360,1743949362,1743949362.871186,-18000,,
com.google.Chrome,5,1743949355,1743949360,1743949360.534608,-18000,,
com.apple.finder,5,1743949350,1743949355,1743949355.361624,-18000,,
com.google.Chrome,3,1743949347,1743949350,1743949350.6136541,-18000,,
com.apple.finder,4,1743949343,1743949347,1743949347.22803,-18000,,
com.google.Chrome,4,1743949339,1743949343,1743949343.584918,-18000,,
com.apple.finder,3,1743949336,1743949339,1743949339.346963,-18000,,
com.google.Chrome,3,1743949333,1743949336,1743949336.8892379,-18000,,
com.apple.finder,2,1743949331,1743949333,1743949333.3805199,-18000,,
com.google.Chrome,3,1743949328,1743949331,1743949331.468289,-18000,,
com.apple.finder,2,1743949326,1743949328,1743949329.012835,-18000,,
com.google.Chrome,3,1743949323,1743949326,1743949326.690129,-18000,,
com.apple.finder,3,1743949320,1743949323,1743949323.885384,-18000,,
com.google.Chrome,3,1743949317,1743949320,1743949320.358971,-18000,,
com.apple.finder,2,1743949315,1743949317,1743949317.6904259,-18000,,
com.google.Chrome,3,1743949312,1743949315,1743949315.286222,-18000,,
com.apple.finder,5,1743949307,1743949312,1743949312.140005,-18000,,
com.google.Chrome,5,1743949302,1743949307,1743949307.1949859,-18000,,
com.apple.finder,2,1743949300,1743949302,1743949302.970432,-18000,,
com.google.Chrome,4,1743949296,1743949300,1743949300.302301,-18000,,
com.apple.finder,5,1743949291,1743949296,1743949296.5045261,-18000,,
com.google.Chrome,3,1743949288,1743949291,1743949291.330243,-18000,,
com.apple.finder,3,1743949285,1743949288,1743949288.352624,-18000,,
com.google.Chrome,5,1743949280,1743949285,1743949285.655406,-18000,,
com.apple.finder,19,1743949261,1743949280,1743949280.581734,-18000,,
com.google.Chrome,4,1743949257,1743949261,1743949261.703948,-18000,,
com.apple.finder,4,1743949253,1743949257,1743949257.856763,-18000,,
com.google.Chrome,3,1743949250,1743949253,1743949253.7903981,-18000,,
com.apple.finder,9,1743949241,1743949250,1743949250.419409,-18000,,
com.google.Chrome,3,1743949238,1743949241,1743949241.269137,-18000,,
com.apple.finder,13,1743949225,1743949238,1743949238.354563,-18000,,
com.google.Chrome,3,1743949222,1743949225,1743949225.100848,-18000,,
com.apple.finder,3,1743949219,1743949222,1743949222.2777948,-18000,,
com.google.Chrome,4,1743949215,1743949219,1743949219.363329,-18000,,
com.apple.finder,2,1743949213,1743949215,1743949216.0106401,-18000,,
com.google.Chrome,4,1743949209,1743949213,1743949213.145793,-18000,,
com.apple.finder,3,1743949206,1743949209,1743949209.714892,-18000,,
com.google.Chrome,4,1743949202,1743949206,1743949206.933635,-18000,,
com.apple.finder,6,1743949196,1743949202,1743949202.78648,-18000,,
com.google.Chrome,3,1743949193,1743949196,1743949196.6039271,-18000,,
com.apple.finder,2,1743949191,1743949193,1743949194.001594,-18000,,
com.google.Chrome,3,1743949188,1743949191,1743949191.840495,-18000,,
com.apple.finder,6,1743949182,1743949188,1743949189.005795,-18000,,
com.google.Chrome,3,1743949179,1743949182,1743949182.631459,-18000,,
com.apple.finder,3,1743949176,1743949179,1743949179.688782,-18000,,
com.google.Chrome,4,1743949172,1743949176,1743949176.458199,-18000,,
com.apple.finder,2,1743949170,1743949172,1743949172.348948,-18000,,
com.google.Chrome,4,1743949166,1743949170,1743949170.1670818,-18000,,
com.apple.finder,12,1743949154,1743949166,1743949166.758368,-18000,,
com.google.Chrome,2,1743949152,1743949154,1743949154.773508,-18000,,
com.apple.finder,4,1743949148,1743949152,1743949152.374587,-18000,,
com.google.Chrome,3,1743949145,1743949148,1743949148.739032,-18000,,
com.apple.finder,3,1743949142,1743949145,1743949145.718472,-18000,,
com.google.Chrome,4,1743949138,1743949142,1743949142.8859339,-18000,,
com.apple.finder,5,1743949133,1743949138,1743949138.3903918,-18000,,
com.google.Chrome,4,1743949129,1743949133,1743949133.696131,-18000,,
com.apple.finder,10,1743949119,1743949129,1743949130.014526,-18000,,
com.google.Chrome,17,1743949102,1743949119,1743949119.04094,-18000,,
com.electron.carta,1,1743949101,1743949102,1743949102.686979,-18000,,
com.google.Chrome,2,1743949099,1743949101,1743949102.038048,-18000,,
com.apple.finder,15,1743949084,1743949099,1743949099.6840901,-18000,,
com.google.Chrome,17,1743949067,1743949084,1743949084.5046458,-18000,,
com.apple.Notes,42,1743949025,1743949067,1743949067.553794,-18000,,
com.google.Chrome,125,1743948900,1743949025,1743949025.403075,-18000,,
com.apple.finder,1,1743948899,1743948900,1743948900.647933,-18000,,
com.electron.carta,34,1743948865,1743948899,1743948899.8355432,-18000,,
com.apple.finder,0,1743948865,1743948865,1743948866.019929,-18000,,
com.google.Chrome,4,1743948861,1743948865,1743948865.206232,-18000,,
com.apple.finder,1,1743948860,1743948861,1743948861.656517,-18000,,
com.electron.carta,9,1743948851,1743948860,1743948860.850833,-18000,,
com.apple.finder,1,1743948850,1743948851,1743948851.3814092,-18000,,
com.electron.carta,47,1743948803,1743948850,1743948850.860266,-18000,,
com.apple.finder,1,1743948802,1743948803,1743948803.5401669,-18000,,
com.google.Chrome,14,1743948788,1743948802,1743948802.16404,-18000,,
com.apple.finder,1,1743948787,1743948788,1743948788.769855,-18000,,
com.electron.carta,41,1743948746,1743948787,1743948787.8463268,-18000,,
com.apple.finder,6,1743948740,1743948746,1743948746.196172,-18000,,
com.google.Chrome,4,1743948736,1743948740,1743948740.305808,-18000,,
com.apple.finder,0,1743948736,1743948736,1743948737.016197,-18000,,
com.electron.carta,38,1743948698,1743948736,1743948736.165643,-18000,,
com.apple.finder,13,1743948685,1743948698,1743948698.392726,-18000,,
com.electron.carta,19,1743948666,1743948685,1743948685.63209,-18000,,
com.google.Chrome,13,1743948653,1743948666,1743948666.0693278,-18000,,
com.electron.carta,127,1743948526,1743948653,1743948653.672174,-18000,,
com.google.Chrome,13,1743948513,1743948526,1743948526.213371,-18000,,
com.electron.carta,72,1743948441,1743948513,1743948513.4522161,-18000,,
com.apple.finder,1,1743948440,1743948441,1743948441.8914552,-18000,,
com.google.Chrome,3,1743948437,1743948440,1743948440.707975,-18000,,
com.apple.finder,1,1743948436,1743948437,1743948437.124403,-18000,,
com.electron.carta,36,1743948400,1743948436,1743948436.242371,-18000,,
com.apple.finder,1,1743948399,1743948400,1743948400.5435982,-18000,,
com.google.Chrome,6,1743948393,1743948399,1743948399.380568,-18000,,
com.apple.finder,44,1743948349,1743948393,1743948393.6291819,-18000,,
com.google.Chrome,7,1743948342,1743948349,1743948349.719743,-18000,,
com.apple.finder,10,1743948332,1743948342,1743948342.834439,-18000,,
com.electron.carta,38,1743948294,1743948332,1743948332.1558561,-18000,,
com.google.Chrome,4,1743948290,1743948294,1743948294.069596,-18000,,
com.electron.carta,16,1743948274,1743948290,1743948291.0096889,-18000,,
com.google.Chrome,3,1743948271,1743948274,1743948274.574216,-18000,,
com.electron.carta,4,1743948267,1743948271,1743948271.686379,-18000,,
com.google.Chrome,98,1743948169,1743948267,1743948267.813427,-18000,,
com.electron.carta,40,1743948129,1743948169,1743948169.458904,-18000,,
com.google.Chrome,2,1743948127,1743948129,1743948129.89273,-18000,,
com.electron.carta,51,1743948076,1743948127,1743948127.798809,-18000,,
com.google.Chrome,2,1743948074,1743948076,1743948076.934027,-18000,,
com.apple.Notes,1,1743948073,1743948074,1743948074.978473,-18000,,
com.electron.carta,4,1743948069,1743948073,1743948073.776586,-18000,,
com.apple.Notes,1,1743948068,1743948069,1743948069.906697,-18000,,
com.google.Chrome,52,1743948016,1743948068,1743948068.87006,-18000,,
com.apple.Notes,5,1743948011,1743948016,1743948016.756796,-18000,,
com.google.Chrome,3,1743948008,1743948011,1743948011.6627688,-18000,,
com.electron.carta,50,1743947958,1743948008,1743948008.424351,-18000,,
com.google.Chrome,6,1743947952,1743947958,1743947958.9626122,-18000,,
com.electron.carta,62,1743947890,1743947952,1743947952.842484,-18000,,
com.google.Chrome,2,1743947888,1743947890,1743947890.8760982,-18000,,
com.electron.carta,1,1743947887,1743947888,1743947888.449332,-18000,,
com.google.Chrome,2,1743947885,1743947887,1743947887.843536,-18000,,
com.electron.carta,80,1743947805,1743947885,1743947885.41099,-18000,,
com.google.Chrome,81,1743947724,1743947805,1743947805.831787,-18000,,
com.apple.finder,78,1743947646,1743947724,1743947724.700799,-18000,,
com.google.Chrome,22,1743947624,1743947646,1743947646.077001,-18000,,
com.apple.finder,65,1743947559,1743947624,1743947624.465414,-18000,,
com.google.Chrome,27,1743947532,1743947559,1743947559.03845,-18000,,
com.apple.finder,7,1743947525,1743947532,1743947532.592348,-18000,,
com.leomehlig.today,11,1743947514,1743947525,1743947525.795514,-18000,,
com.google.Chrome,4,1743947510,1743947514,1743947514.124692,-18000,,
com.apple.weather,4,1743945343,1743945347,1743945347.763616,-18000,EB445137-D7F5-57EC-87DA-1DB460D64046,"iPhone13,2"
com.renpho.health,49,1743945292,1743945341,1743945341.146913,-18000,EB445137-D7F5-57EC-87DA-1DB460D64046,"iPhone13,2"
com.apple.news,2,1743945289,1743945291,1743945291.1295152,-18000,EB445137-D7F5-57EC-87DA-1DB460D64046,"iPhone13,2"
com.apple.news,135,1743945153,1743945288,1743945288.975675,-18000,EB445137-D7F5-57EC-87DA-1DB460D64046,"iPhone13,2"
com.apple.Health,2,1743945086,1743945088,1743945092.138818,-18000,EB445137-D7F5-57EC-87DA-1DB460D64046,"iPhone13,2"
com.letterboxd.LetterboxdApp,100,1743916026,1743916126,1743916126.34213,-18000,EB445137-D7F5-57EC-87DA-1DB460D64046,"iPhone13,2"
com.apple.news,2,1743916024,1743916026,1743916026.031518,-18000,EB445137-D7F5-57EC-87DA-1DB460D64046,"iPhone13,2"
com.google.Chrome,2770,1743914775,1743917545,1743917545.9722362,-18000,,
com.apple.finder,2,1743914773,1743914775,1743914775.791562,-18000,,
com.microsoft.Outlook,7,1743914766,1743914773,1743914773.7129889,-18000,,
com.apple.finder,14,1743914752,1743914766,1743914766.3376908,-18000,,
com.leomehlig.today,28,1743914724,1743914752,1743914752.158433,-18000,,
com.google.Chrome,43,1743914681,1743914724,1743914724.6932778,-18000,,
com.leomehlig.today,75,1743914606,1743914681,1743914683.161573,-18000,,
com.apple.finder,3,1743914603,1743914606,1743914607.11593,-18000,,
com.apple.news,118,1743913352,1743913470,1743913472.165323,-18000,EB445137-D7F5-57EC-87DA-1DB460D64046,"iPhone13,2"
com.google.chrome.ios,5,1743913230,1743913235,1743913235.4784498,-18000,EB445137-D7F5-57EC-87DA-1DB460D64046,"iPhone13,2"
com.apple.news,74,1743913156,1743913230,1743913230.302791,-18000,EB445137-D7F5-57EC-87DA-1DB460D64046,"iPhone13,2"
com.apple.news,2,1743913143,1743913145,1743913146.013313,-18000,EB445137-D7F5-57EC-87DA-1DB460D64046,"iPhone13,2"
com.apple.news,77,1743913007,1743913084,1743913084.8713799,-18000,EB445137-D7F5-57EC-87DA-1DB460D64046,"iPhone13,2"
com.apple.news,28,1743912977,1743913005,1743913005.243351,-18000,EB445137-D7F5-57EC-87DA-1DB460D64046,"iPhone13,2"
com.google.Gmail,2,1743912952,1743912954,1743912954.169584,-18000,EB445137-D7F5-57EC-87DA-1DB460D64046,"iPhone13,2"
com.google.Gmail,63,1743909130,1743909193,1743909194.298674,-18000,EB445137-D7F5-57EC-87DA-1DB460D64046,"iPhone13,2"
com.apple.MobileSMS,0,1743909130,1743909130,1743909131.520998,-18000,EB445137-D7F5-57EC-87DA-1DB460D64046,"iPhone13,2"
com.apple.MobileSMS,5,1743902798,1743902803,1743902803.82126,-18000,EB445137-D7F5-57EC-87DA-1DB460D64046,"iPhone13,2"
com.google.chrome.ios,0,1743902798,1743902798,1743902799.538821,-18000,EB445137-D7F5-57EC-87DA-1DB460D64046,"iPhone13,2"
com.google.chrome.ios,2,1743901914,1743901916,1743901916.664314,-18000,EB445137-D7F5-57EC-87DA-1DB460D64046,"iPhone13,2"
com.google.chrome.ios,3,1743901141,1743901144,1743901144.5914068,-18000,EB445137-D7F5-57EC-87DA-1DB460D64046,"iPhone13,2"
com.google.chrome.ios,8,1743901121,1743901129,1743901129.304192,-18000,EB445137-D7F5-57EC-87DA-1DB460D64046,"iPhone13,2"
com.apple.CoreAuthUI,2,1743900989,1743900991,1743900991.8338099,-18000,EB445137-D7F5-57EC-87DA-1DB460D64046,"iPhone13,2"
com.google.chrome.ios,27,1743900984,1743901011,1743901011.9412909,-18000,EB445137-D7F5-57EC-87DA-1DB460D64046,"iPhone13,2"
com.google.chrome.ios,21,1743900885,1743900906,1743900907.1281729,-18000,EB445137-D7F5-57EC-87DA-1DB460D64046,"iPhone13,2"
com.apple.MobileSMS,2,1743900883,1743900885,1743900885.6631079,-18000,EB445137-D7F5-57EC-87DA-1DB460D64046,"iPhone13,2"
com.apple.MobileSMS,5,1743899108,1743899113,1743899113.189115,-18000,EB445137-D7F5-57EC-87DA-1DB460D64046,"iPhone13,2"
com.apple.MobileSMS,37,1743899025,1743899062,1743899063.1408648,-18000,EB445137-D7F5-57EC-87DA-1DB460D64046,"iPhone13,2"
com.apple.MobileSMS,2,1743899018,1743899020,1743899020.957649,-18000,EB445137-D7F5-57EC-87DA-1DB460D64046,"iPhone13,2"
com.google.chrome.ios,37,1743898773,1743898810,1743898810.673974,-18000,EB445137-D7F5-57EC-87DA-1DB460D64046,"iPhone13,2"
com.apple.Health,21,1743898752,1743898773,1743898773.761055,-18000,EB445137-D7F5-57EC-87DA-1DB460D64046,"iPhone13,2"
com.apple.news,1,1743898750,1743898751,1743898751.936438,-18000,EB445137-D7F5-57EC-87DA-1DB460D64046,"iPhone13,2"
com.apple.news,213,1743897986,1743898199,1743898199.6611,-18000,EB445137-D7F5-57EC-87DA-1DB460D64046,"iPhone13,2"
com.google.chrome.ios,3,1743897975,1743897978,1743897978.47683,-18000,EB445137-D7F5-57EC-87DA-1DB460D64046,"iPhone13,2"
com.google.chrome.ios,47,1743897129,1743897176,1743897176.779735,-18000,EB445137-D7F5-57EC-87DA-1DB460D64046,"iPhone13,2"
com.apple.news,107,1743897022,1743897129,1743897129.44387,-18000,EB445137-D7F5-57EC-87DA-1DB460D64046,"iPhone13,2"
com.apple.news,176,1743896002,1743896178,1743896178.8155022,-18000,EB445137-D7F5-57EC-87DA-1DB460D64046,"iPhone13,2"
com.apple.weather,2,1743895986,1743895988,1743895988.701638,-18000,EB445137-D7F5-57EC-87DA-1DB460D64046,"iPhone13,2"
com.apple.weather,27,1743895914,1743895941,1743895942.3615808,-18000,EB445137-D7F5-57EC-87DA-1DB460D64046,"iPhone13,2"
com.apple.mobiletimer,1,1743895913,1743895914,1743895914.502604,-18000,EB445137-D7F5-57EC-87DA-1DB460D64046,"iPhone13,2"
com.apple.mobiletimer,4,1743893446,1743893450,1743893451.008255,-18000,EB445137-D7F5-57EC-87DA-1DB460D64046,"iPhone13,2"
com.apple.news,2,1743893444,1743893446,1743893446.8871012,-18000,EB445137-D7F5-57EC-87DA-1DB460D64046,"iPhone13,2"
com.apple.news,58,1743892963,1743893021,1743893021.8896751,-18000,EB445137-D7F5-57EC-87DA-1DB460D64046,"iPhone13,2"
co.hinge.mobile.ios,4,1743892939,1743892943,1743892943.8394542,-18000,EB445137-D7F5-57EC-87DA-1DB460D64046,"iPhone13,2"
com.apple.mobiletimer,7,1743892898,1743892905,1743892905.8337169,-18000,EB445137-D7F5-57EC-87DA-1DB460D64046,"iPhone13,2"
com.apple.MobileSMS,4,1743892894,1743892898,1743892898.8968549,-18000,EB445137-D7F5-57EC-87DA-1DB460D64046,"iPhone13,2"
com.apple.MobileSMS,61,1743891470,1743891531,1743891531.984489,-18000,EB445137-D7F5-57EC-87DA-1DB460D64046,"iPhone13,2"
com.apple.MobileSMS,94,1743891371,1743891465,1743891465.886039,-18000,EB445137-D7F5-57EC-87DA-1DB460D64046,"iPhone13,2"
com.apple.MobileSMS,61,1743891050,1743891111,1743891112.02463,-18000,EB445137-D7F5-57EC-87DA-1DB460D64046,"iPhone13,2"
com.apple.MobileSMS,8,1743890966,1743890974,1743890974.245163,-18000,EB445137-D7F5-57EC-87DA-1DB460D64046,"iPhone13,2"
com.apple.MobileSMS,59,1743890765,1743890824,1743890824.9938688,-18000,EB445137-D7F5-57EC-87DA-1DB460D64046,"iPhone13,2"
com.apple.MobileSMS,86,1743890673,1743890759,1743890759.614956,-18000,EB445137-D7F5-57EC-87DA-1DB460D64046,"iPhone13,2"
com.apple.MobileSMS,23,1743890650,1743890673,1743890673.16225,-18000,EB445137-D7F5-57EC-87DA-1DB460D64046,"iPhone13,2"
com.google.chrome.ios,39,1743890611,1743890650,1743890650.6931171,-18000,EB445137-D7F5-57EC-87DA-1DB460D64046,"iPhone13,2"
com.apple.MobileSMS,23,1743890573,1743890596,1743890596.845416,-18000,EB445137-D7F5-57EC-87DA-1DB460D64046,"iPhone13,2"
com.google.chrome.ios,2,1743890571,1743890573,1743890573.592046,-18000,EB445137-D7F5-57EC-87DA-1DB460D64046,"iPhone13,2"
com.google.chrome.ios,22,1743890536,1743890558,1743890558.5724468,-18000,EB445137-D7F5-57EC-87DA-1DB460D64046,"iPhone13,2"
com.google.chrome.ios,2,1743890496,1743890498,1743890499.131369,-18000,EB445137-D7F5-57EC-87DA-1DB460D64046,"iPhone13,2"
com.google.chrome.ios,25,1743890052,1743890077,1743890077.942863,-18000,EB445137-D7F5-57EC-87DA-1DB460D64046,"iPhone13,2"
com.google.chrome.ios,5,1743888120,1743888125,1743888125.8659658,-18000,EB445137-D7F5-57EC-87DA-1DB460D64046,"iPhone13,2"
com.google.chrome.ios,69,1743887830,1743887899,1743887899.594949,-18000,EB445137-D7F5-57EC-87DA-1DB460D64046,"iPhone13,2"
com.apple.Health,2,1743887828,1743887830,1743887830.309505,-18000,EB445137-D7F5-57EC-87DA-1DB460D64046,"iPhone13,2"
com.apple.Health,1,1743887827,1743887828,1743887828.093649,-18000,EB445137-D7F5-57EC-87DA-1DB460D64046,"iPhone13,2"
com.apple.Health,8,1743885538,1743885546,1743885546.379225,-18000,EB445137-D7F5-57EC-87DA-1DB460D64046,"iPhone13,2"
com.google.chrome.ios,2,1743885526,1743885528,1743885529.12353,-18000,EB445137-D7F5-57EC-87DA-1DB460D64046,"iPhone13,2"
com.google.chrome.ios,63,1743885011,1743885074,1743885075.26963,-18000,EB445137-D7F5-57EC-87DA-1DB460D64046,"iPhone13,2"
com.apple.news,3,1743885008,1743885011,1743885011.273532,-18000,EB445137-D7F5-57EC-87DA-1DB460D64046,"iPhone13,2"
com.apple.news,46,1743882741,1743882787,1743882787.484363,-18000,EB445137-D7F5-57EC-87DA-1DB460D64046,"iPhone13,2"
com.letterboxd.LetterboxdApp,0,1743882741,1743882741,1743882742.8036652,-18000,EB445137-D7F5-57EC-87DA-1DB460D64046,"iPhone13,2"
com.letterboxd.LetterboxdApp,21,1743881132,1743881153,1743881154.0832071,-18000,EB445137-D7F5-57EC-87DA-1DB460D64046,"iPhone13,2"
co.hinge.mobile.ios,6,1743879429,1743879435,1743879436.184453,-18000,EB445137-D7F5-57EC-87DA-1DB460D64046,"iPhone13,2"
com.apple.weather,2,1743879426,1743879428,1743879428.7478142,-18000,EB445137-D7F5-57EC-87DA-1DB460D64046,"iPhone13,2"
com.apple.finder,8,1743879193,1743879201,1743879201.355667,-18000,,
com.google.Chrome,7,1743879186,1743879193,1743879193.308023,-18000,,
com.leomehlig.today,165,1743879021,1743879186,1743879187.087562,-18000,,
com.apple.weather,3,1743879015,1743879018,1743879019.133521,-18000,EB445137-D7F5-57EC-87DA-1DB460D64046,"iPhone13,2"
com.apple.news,53,1743878951,1743879004,1743879004.734999,-18000,EB445137-D7F5-57EC-87DA-1DB460D64046,"iPhone13,2"
com.google.Chrome,609,1743878412,1743879021,1743879021.92386,-18000,,
com.apple.Preview,1,1743878411,1743878412,1743878412.789857,-18000,,
com.google.Chrome,738,1743877673,1743878411,1743878411.3988729,-18000,,
com.apple.Preview,10,1743877663,1743877673,1743877673.933838,-18000,,
com.google.Chrome,30,1743877633,1743877663,1743877663.833924,-18000,,
com.apple.Preview,9,1743877624,1743877633,1743877633.249856,-18000,,
com.google.Chrome,1,1743877623,1743877624,1743877624.132588,-18000,,
com.apple.calculator,16,1743877607,1743877623,1743877623.049203,-18000,,
com.google.Chrome,3,1743877604,1743877607,1743877607.4901671,-18000,,
com.apple.Preview,0,1743877604,1743877604,1743877604.763729,-18000,,
com.google.Chrome,4,1743877600,1743877604,1743877604.158958,-18000,,
com.apple.Preview,1,1743877599,1743877600,1743877600.602252,-18000,,
com.apple.calculator,22,1743877577,1743877599,1743877599.8425221,-18000,,
com.apple.Preview,1,1743877576,1743877577,1743877577.986096,-18000,,
com.google.Chrome,1,1743877575,1743877576,1743877576.5950232,-18000,,
com.apple.Preview,16,1743877559,1743877575,1743877575.513696,-18000,,
com.google.Chrome,2,1743877557,1743877559,1743877559.20995,-18000,,
com.apple.calculator,9,1743877548,1743877557,1743877557.487201,-18000,,
com.google.Chrome,3,1743877545,1743877548,1743877548.176631,-18000,,
com.apple.calculator,2,1743877543,1743877545,1743877545.756091,-18000,,
com.google.Chrome,58,1743877485,1743877543,1743877543.228156,-18000,,
com.apple.Preview,3,1743877482,1743877485,1743877485.0404282,-18000,,
com.google.Chrome,45,1743877437,1743877482,1743877482.834361,-18000,,
com.apple.Preview,9,1743877428,1743877437,1743877437.3237991,-18000,,
com.google.Chrome,2,1743877426,1743877428,1743877428.128367,-18000,,
com.apple.Preview,2,1743877424,1743877426,1743877426.763803,-18000,,
com.google.Chrome,94,1743877330,1743877424,1743877424.185955,-18000,,
com.apple.Preview,7,1743877323,1743877330,1743877330.215277,-18000,,
com.google.Chrome,31,1743877292,1743877323,1743877323.981584,-18000,,
com.apple.Preview,0,1743877292,1743877292,1743877292.929465,-18000,,
com.google.Chrome,13,1743877279,1743877292,1743877292.0660582,-18000,,
com.apple.Preview,1,1743877278,1743877279,1743877279.5809379,-18000,,
com.google.Chrome,1,1743877277,1743877278,1743877278.383593,-18000,,
com.apple.Preview,2,1743877275,1743877277,1743877277.804961,-18000,,
com.google.Chrome,44,1743877231,1743877275,1743877275.556285,-18000,,
com.apple.Preview,1,1743877230,1743877231,1743877231.874477,-18000,,
com.google.Chrome,49,1743877181,1743877230,1743877230.524778,-18000,,
com.apple.Preview,2,1743877179,1743877181,1743877181.366916,-18000,,
com.google.Chrome,19,1743877160,1743877179,1743877179.6335778,-18000,,
com.apple.Preview,1,1743877159,1743877160,1743877160.981329,-18000,,
com.google.Chrome,8,1743877151,1743877159,1743877159.664753,-18000,,
com.apple.Preview,2,1743877149,1743877151,1743877151.0524879,-18000,,
com.google.Chrome,3,1743877146,1743877149,1743877149.070592,-18000,,
com.apple.Preview,1,1743877145,1743877146,1743877146.697472,-18000,,
com.google.Chrome,59,1743877086,1743877145,1743877145.2016978,-18000,,
com.apple.Preview,1,1743877085,1743877086,1743877086.589545,-18000,,
com.google.Chrome,44,1743877041,1743877085,1743877085.101753,-18000,,
com.apple.Preview,10,1743877031,1743877041,1743877041.160225,-18000,,
com.google.Chrome,28,1743877003,1743877031,1743877031.043509,-18000,,
com.apple.Preview,7,1743876996,1743877003,1743877003.317078,-18000,,
com.google.Chrome,375,1743876621,1743876996,1743876996.865438,-18000,,
com.apple.Preview,8,1743876613,1743876621,1743876621.6908932,-18000,,
com.apple.news,343,1743876181,1743876524,1743876524.381783,-18000,EB445137-D7F5-57EC-87DA-1DB460D64046,"iPhone13,2"
com.apple.Preview,335,1743876087,1743876422,1743876422.838753,-18000,,
com.google.Chrome,11,1743876076,1743876087,1743876087.2720919,-18000,,
com.apple.Preview,6,1743876070,1743876076,1743876076.103373,-18000,,
com.google.Chrome,4,1743876066,1743876070,1743876070.464349,-18000,,
com.apple.Preview,9,1743876057,1743876066,1743876066.438745,-18000,,
com.google.Chrome,8,1743876049,1743876057,1743876057.6157908,-18000,,
com.apple.Preview,1,1743876048,1743876049,1743876049.232095,-18000,,
com.google.Chrome,11,1743876037,1743876048,1743876048.447702,-18000,,
com.apple.Preview,21,1743876016,1743876037,1743876037.6983929,-18000,,
com.google.Chrome,5,1743876011,1743876016,1743876017.018635,-18000,,
com.apple.Preview,4,1743876007,1743876011,1743876011.6404471,-18000,,
com.google.Chrome,5,1743876002,1743876007,1743876007.10644,-18000,,
com.apple.Preview,2,1743876000,1743876002,1743876002.422,-18000,,
com.google.Chrome,4,1743875996,1743876000,1743876000.170939,-18000,,
com.apple.Preview,5,1743875991,1743875996,1743875996.530123,-18000,,
com.google.Chrome,4,1743875987,1743875991,1743875991.9041018,-18000,,
com.apple.Preview,31,1743875956,1743875987,1743875987.764926,-18000,,
com.google.Chrome,9,1743875947,1743875956,1743875956.4871402,-18000,,
com.apple.Preview,34,1743875913,1743875947,1743875947.8694239,-18000,,
com.google.Chrome,8,1743875905,1743875913,1743875913.593501,-18000,,
com.apple.Preview,4,1743875901,1743875905,1743875905.74036,-18000,,
com.google.Chrome,4,1743875897,1743875901,1743875901.419198,-18000,,
com.apple.Preview,2,1743875895,1743875897,1743875897.638259,-18000,,
com.google.Chrome,11,1743875884,1743875895,1743875895.891954,-18000,,
com.apple.Preview,17,1743875867,1743875884,1743875884.484391,-18000,,
com.google.Chrome,2,1743875865,1743875867,1743875867.9152222,-18000,,
com.apple.Preview,2,1743875863,1743875865,1743875865.3166041,-18000,,
com.google.Chrome,5,1743875858,1743875863,1743875863.8266292,-18000,,
com.apple.Preview,3,1743875855,1743875858,1743875858.7635221,-18000,,
com.google.Chrome,3,1743875852,1743875855,1743875855.479196,-18000,,
com.apple.Preview,1,1743875851,1743875852,1743875852.5779629,-18000,,
com.google.Chrome,2,1743875849,1743875851,1743875851.489001,-18000,,
com.apple.Preview,1,1743875848,1743875849,1743875849.717083,-18000,,
com.google.Chrome,1,1743875847,1743875848,1743875848.4236798,-18000,,
com.apple.Preview,2,1743875845,1743875847,1743875847.091319,-18000,,
com.google.Chrome,1,1743875844,1743875845,1743875845.778362,-18000,,
com.apple.Preview,1,1743875843,1743875844,1743875844.6860042,-18000,,
com.apple.Preview,1,1743875836,1743875837,1743875837.890874,-18000,,
com.google.Chrome,0,1743875836,1743875836,1743875836.8971891,-18000,,
com.apple.Preview,1,1743875835,1743875836,1743875836.428505,-18000,,
com.google.Chrome,3,1743875832,1743875835,1743875835.6593661,-18000,,
com.apple.Preview,2,1743875830,1743875832,1743875832.185008,-18000,,
com.google.Chrome,3,1743875827,1743875830,1743875830.843235,-18000,,
com.apple.Preview,1,1743875826,1743875827,1743875828.046966,-18000,,
com.google.Chrome,1,1743875825,1743875826,1743875827.019181,-18000,,
com.apple.Preview,1,1743875824,1743875825,1743875825.559592,-18000,,
com.google.Chrome,1,1743875823,1743875824,1743875824.576095,-18000,,
com.apple.Preview,1,1743875822,1743875823,1743875823.195102,-18000,,
com.google.Chrome,2,1743875820,1743875822,1743875822.062886,-18000,,
com.apple.Preview,1,1743875819,1743875820,1743875820.2911072,-18000,,
com.google.Chrome,2,1743875817,1743875819,1743875819.333294,-18000,,
com.apple.Preview,0,1743875817,1743875817,1743875817.748815,-18000,,
com.google.Chrome,2,1743875815,1743875817,1743875817.147945,-18000,,
com.apple.Preview,1,1743875814,1743875815,1743875815.945034,-18000,,
com.google.Chrome,3,1743875811,1743875814,1743875814.7674751,-18000,,
com.apple.Preview,1,1743875810,1743875811,1743875811.4412708,-18000,,
com.google.Chrome,2,1743875808,1743875810,1743875810.4645061,-18000,,
com.apple.Preview,0,1743875808,1743875808,1743875808.943719,-18000,,
com.google.Chrome,2,1743875806,1743875808,1743875808.0738,-18000,,
com.apple.Preview,1,1743875805,1743875806,1743875806.791085,-18000,,
com.google.Chrome,2,1743875803,1743875805,1743875805.790412,-18000,,
com.apple.Preview,1,1743875802,1743875803,1743875803.324079,-18000,,
com.google.Chrome,2,1743875800,1743875802,1743875802.614543,-18000,,
com.apple.Preview,2,1743875798,1743875800,1743875800.712192,-18000,,
com.google.Chrome,12,1743875786,1743875798,1743875798.3293362,-18000,,
com.apple.Preview,3,1743875783,1743875786,1743875786.772643,-18000,,
com.google.Chrome,8,1743875775,1743875783,1743875783.979968,-18000,,
com.apple.Preview,8,1743875767,1743875775,1743875775.213749,-18000,,
com.google.Chrome,8,1743875759,1743875767,1743875767.8926911,-18000,,
com.apple.Preview,16,1743875743,1743875759,1743875759.12332,-18000,,
com.google.Chrome,2,1743875741,1743875743,1743875743.508606,-18000,,
com.apple.Preview,8,1743875733,1743875741,1743875741.1745548,-18000,,
com.apple.finder,2,1743875731,1743875733,1743875733.379035,-18000,,
com.google.Chrome,1,1743875730,1743875731,1743875731.0412412,-18000,,
com.apple.finder,3,1743875727,1743875730,1743875730.4008188,-18000,,
com.apple.Preview,6,1743875721,1743875727,1743875727.546303,-18000,,
com.google.Chrome,4,1743875717,1743875721,1743875721.721565,-18000,,
com.apple.Preview,1,1743875716,1743875717,1743875718.004064,-18000,,
com.google.Chrome,3,1743875713,1743875716,1743875716.943245,-18000,,
com.apple.Preview,1,1743875712,1743875713,1743875713.385222,-18000,,
com.google.Chrome,7,1743875705,1743875712,1743875712.395407,-18000,,
com.apple.Preview,1,1743875704,1743875705,1743875705.923357,-18000,,
com.google.Chrome,5,1743875699,1743875704,1743875704.108642,-18000,,
com.apple.Preview,37,1743875662,1743875699,1743875699.697226,-18000,,
com.apple.finder,9,1743875653,1743875662,1743875662.185186,-18000,,
com.google.Chrome,56,1743875597,1743875653,1743875654.030796,-18000,,
com.apple.finder,4,1743875580,1743875584,1743875584.888895,-18000,,
com.google.Chrome,7,1743875573,1743875580,1743875580.1578178,-18000,,
com.apple.Preview,44,1743875529,1743875573,1743875573.1729589,-18000,,
com.apple.news,161,1743875368,1743875529,1743875529.189915,-18000,,
com.apple.Preview,39,1743875329,1743875368,1743875368.623036,-18000,,
com.apple.finder,6,1743875323,1743875329,1743875329.7759252,-18000,,
com.apple.finder,300,1743874394,1743874694,1743874694.798213,-18000,,
com.apple.finder,311,1743873657,1743873968,1743873968.488038,-18000,,
com.apple.finder,308,1743873188,1743873496,1743873496.727468,-18000,,
com.google.Chrome,2,1743873186,1743873188,1743873188.226541,-18000,,
com.apple.finder,1,1743873185,1743873186,1743873187.022459,-18000,,
com.leomehlig.today,0,1743873185,1743873185,1743873185.881995,-18000,,
com.apple.finder,134,1743873051,1743873185,1743873185.367488,-18000,,
com.intsig.CamScannerLite,136,1743873047,1743873183,1743873184.026046,-18000,EB445137-D7F5-57EC-87DA-1DB460D64046,"iPhone13,2"
com.google.chrome.ios,3,1743873043,1743873046,1743873046.2678308,-18000,EB445137-D7F5-57EC-87DA-1DB460D64046,"iPhone13,2"
com.leomehlig.today,17,1743873034,1743873051,1743873051.298552,-18000,,
com.google.Chrome,22,1743873012,1743873034,1743873034.198741,-18000,,
com.apple.CoreAuthUI,2,1743872884,1743872886,1743872886.1509671,-18000,EB445137-D7F5-57EC-87DA-1DB460D64046,"iPhone13,2"
com.google.chrome.ios,17,1743872877,1743872894,1743872894.856649,-18000,EB445137-D7F5-57EC-87DA-1DB460D64046,"iPhone13,2"
com.google.Chrome,25,1743872827,1743872852,1743872852.401056,-18000,,
com.apple.finder,3,1743872824,1743872827,1743872827.344507,-18000,,
com.google.Chrome,7,1743872817,1743872824,1743872824.997346,-18000,,
com.apple.finder,17,1743872800,1743872817,1743872817.0354261,-18000,,
com.google.Chrome,19,1743872781,1743872800,1743872800.985095,-18000,,
com.apple.finder,2,1743872754,1743872756,1743872756.122674,-18000,,
com.google.chrome.ios,22,1743871560,1743871582,1743871583.284766,-18000,EB445137-D7F5-57EC-87DA-1DB460D64046,"iPhone13,2"
com.apple.weather,2,1743871558,1743871560,1743871560.5429091,-18000,EB445137-D7F5-57EC-87DA-1DB460D64046,"iPhone13,2"
com.apple.weather,5,1743871253,1743871258,1743871258.350377,-18000,EB445137-D7F5-57EC-87DA-1DB460D64046,"iPhone13,2"
com.apple.finder,9,1743871229,1743871238,1743871238.878479,-18000,,
com.microsoft.Outlook,2,1743871227,1743871229,1743871229.308656,-18000,,
com.google.Chrome,1,1743871226,1743871227,1743871227.641531,-18000,,
com.apple.Maps,1,1743871225,1743871226,1743871226.699246,-18000,,
com.google.Chrome,3,1743871222,1743871225,1743871226.233376,-18000,,
com.leomehlig.today,46,1743871176,1743871222,1743871222.723188,-18000,,
com.google.Chrome,388,1743870788,1743871176,1743871176.412888,-18000,,
com.apple.Maps,28,1743870760,1743870788,1743870788.860928,-18000,,
com.google.Chrome,43,1743870717,1743870760,1743870760.0165172,-18000,,
com.leomehlig.today,1,1743870716,1743870717,1743870717.087377,-18000,,
com.google.Chrome,664,1743870052,1743870716,1743870716.534666,-18000,,
com.leomehlig.today,0,1743870052,1743870052,1743870052.980816,-18000,,
com.google.Chrome,36,1743870016,1743870052,1743870052.211355,-18000,,
com.leomehlig.today,1,1743870015,1743870016,1743870016.144603,-18000,,
com.google.Chrome,8,1743870007,1743870015,1743870015.761922,-18000,,
com.leomehlig.today,1,1743870006,1743870007,1743870007.404993,-18000,,
com.google.Chrome,80,1743869926,1743870006,1743870006.695982,-18000,,
com.leomehlig.today,1,1743869925,1743869926,1743869926.338439,-18000,,
com.google.Chrome,130,1743869795,1743869925,1743869925.63222,-18000,,
com.leomehlig.today,3,1743869792,1743869795,1743869795.157974,-18000,,
com.apple.Preferences,151,1743869054,1743869205,1743869206.000928,-18000,EB445137-D7F5-57EC-87DA-1DB460D64046,"iPhone13,2"
net.kortina.labs.Venmo,44,1743868756,1743868800,1743868800.08217,-18000,EB445137-D7F5-57EC-87DA-1DB460D64046,"iPhone13,2"
com.apple.MobileSMS,4,1743868750,1743868754,1743868754.289994,-18000,EB445137-D7F5-57EC-87DA-1DB460D64046,"iPhone13,2"
com.apple.camera,4,1743868744,1743868748,1743868748.454505,-18000,EB445137-D7F5-57EC-87DA-1DB460D64046,"iPhone13,2"
com.google.Chrome,1179,1743868613,1743869792,1743869792.458198,-18000,,
com.google.Chrome,559,1743867963,1743868522,1743868522.404238,-18000,,
com.leomehlig.today,53,1743867910,1743867963,1743867964.0302758,-18000,,
com.google.Chrome,315,1743867595,1743867910,1743867910.929059,-18000,,
com.apple.finder,10,1743867585,1743867595,1743867595.802068,-18000,,
com.google.Chrome,1,1743867584,1743867585,1743867585.829318,-18000,,
com.apple.finder,8,1743867576,1743867584,1743867584.3968658,-18000,,
com.google.Chrome,73,1743867503,1743867576,1743867576.5184112,-18000,,
com.apple.finder,1,1743867502,1743867503,1743867504.0141292,-18000,,
com.google.Chrome,2,1743867500,1743867502,1743867502.753968,-18000,,
com.apple.finder,3,1743867497,1743867500,1743867500.973414,-18000,,
com.google.Chrome,3,1743867494,1743867497,1743867497.999548,-18000,,
com.apple.finder,1,1743867493,1743867494,1743867494.775631,-18000,,
com.google.Chrome,2,1743867491,1743867493,1743867493.5153089,-18000,,
com.apple.camera,75,1743867469,1743867544,1743867544.764894,-18000,EB445137-D7F5-57EC-87DA-1DB460D64046,"iPhone13,2"
com.apple.finder,37,1743867454,1743867491,1743867491.042896,-18000,,
com.intsig.CamScannerLite,65,1743867402,1743867467,1743867467.62202,-18000,EB445137-D7F5-57EC-87DA-1DB460D64046,"iPhone13,2"
com.google.Chrome,135,1743867319,1743867454,1743867454.272161,-18000,,
com.leomehlig.today,4,1743867313,1743867317,1743867317.0434299,-18000,,
com.google.Chrome,54,1743867259,1743867313,1743867313.611232,-18000,,
com.apple.finder,0,1743867247,1743867247,1743867248.01844,-18000,,
com.apple.Notes,1,1743867246,1743867247,1743867247.064677,-18000,,
com.apple.finder,1,1743867245,1743867246,1743867246.681421,-18000,,
com.microsoft.VSCode,63,1743867182,1743867245,1743867246.150475,-18000,,
com.apple.finder,9,1743867173,1743867182,1743867182.576375,-18000,,
com.microsoft.VSCode,11,1743867162,1743867173,1743867173.4053159,-18000,,
com.apple.finder,6,1743867156,1743867162,1743867162.9227018,-18000,,
com.microsoft.VSCode,16,1743867140,1743867156,1743867156.7228808,-18000,,
com.apple.finder,11,1743867129,1743867140,1743867140.081912,-18000,,
com.microsoft.VSCode,21,1743867108,1743867129,1743867129.36059,-18000,,
com.apple.finder,48,1743867060,1743867108,1743867108.5273871,-18000,,
com.apple.Preview,16,1743867044,1743867060,1743867060.793642,-18000,,
com.apple.finder,2,1743867042,1743867044,1743867044.910349,-18000,,
com.apple.Preview,4,1743867038,1743867042,1743867042.769051,-18000,,
com.apple.finder,12,1743867026,1743867038,1743867038.798668,-18000,,
com.microsoft.VSCode,1,1743867025,1743867026,1743867026.3906798,-18000,,
com.apple.finder,4,1743867021,1743867025,1743867025.559101,-18000,,
com.microsoft.VSCode,55,1743866966,1743867021,1743867021.4515839,-18000,,
com.apple.finder,18,1743866948,1743866966,1743866966.9879909,-18000,,
com.microsoft.VSCode,2,1743866946,1743866948,1743866948.058354,-18000,,
com.apple.finder,3,1743866943,1743866946,1743866946.570634,-18000,,
com.microsoft.VSCode,115,1743866828,1743866943,1743866943.812494,-18000,,
com.apple.finder,13,1743866815,1743866828,1743866828.2218308,-18000,,
com.microsoft.VSCode,7,1743866808,1743866815,1743866815.0909,-18000,,
com.apple.finder,3,1743866805,1743866808,1743866808.8706942,-18000,,
com.microsoft.VSCode,132,1743866673,1743866805,1743866805.572291,-18000,,
com.apple.finder,88,1743866585,1743866673,1743866673.7437859,-18000,,
com.microsoft.VSCode,6,1743866579,1743866585,1743866585.4324,-18000,,
com.apple.finder,5,1743866574,1743866579,1743866579.849784,-18000,,
com.microsoft.VSCode,93,1743866481,1743866574,1743866575.0606751,-18000,,
com.apple.finder,4,1743866477,1743866481,1743866481.200613,-18000,,
com.microsoft.VSCode,72,1743866405,1743866477,1743866477.386537,-18000,,
com.apple.finder,1,1743866404,1743866405,1743866405.421946,-18000,,
com.microsoft.VSCode,856,1743865548,1743866404,1743866404.384807,-18000,,
com.apple.finder,52,1743865496,1743865548,1743865548.6200671,-18000,,
com.microsoft.VSCode,33,1743865463,1743865496,1743865496.858234,-18000,,
com.apple.Notes,47,1743865416,1743865463,1743865463.673111,-18000,,
com.microsoft.VSCode,11,1743865405,1743865416,1743865416.2764049,-18000,,
com.apple.finder,60,1743865345,1743865405,1743865405.412126,-18000,,
com.microsoft.VSCode,61,1743865284,1743865345,1743865345.7099771,-18000,,
com.apple.finder,5,1743865279,1743865284,1743865284.989094,-18000,,
com.microsoft.VSCode,43,1743865236,1743865279,1743865279.594429,-18000,,
com.apple.finder,4,1743865232,1743865236,1743865236.581294,-18000,,
com.microsoft.VSCode,18,1743865214,1743865232,1743865232.938968,-18000,,
com.apple.finder,78,1743865136,1743865214,1743865214.394422,-18000,,
com.microsoft.VSCode,8,1743865128,1743865136,1743865136.0983481,-18000,,
com.apple.finder,54,1743865074,1743865128,1743865128.273835,-18000,,
com.apple.news,2,1743864994,1743864996,1743864996.697465,-18000,EB445137-D7F5-57EC-87DA-1DB460D64046,"iPhone13,2"
com.microsoft.VSCode,86,1743864988,1743865074,1743865074.648813,-18000,,
com.apple.finder,17,1743864971,1743864988,1743864988.6220322,-18000,,
com.microsoft.VSCode,68,1743864903,1743864971,1743864971.056911,-18000,,
com.apple.finder,5,1743864898,1743864903,1743864903.1195111,-18000,,
com.google.Chrome,14,1743864884,1743864898,1743864898.771518,-18000,,
com.apple.finder,24,1743864860,1743864884,1743864884.134233,-18000,,
com.microsoft.VSCode,7,1743864853,1743864860,1743864860.362669,-18000,,
com.apple.finder,3,1743864850,1743864853,1743864853.183868,-18000,,
com.microsoft.VSCode,14,1743864836,1743864850,1743864850.2980518,-18000,,
com.apple.finder,17,1743864819,1743864836,1743864836.272585,-18000,,
com.microsoft.VSCode,427,1743864392,1743864819,1743864819.5631819,-18000,,
com.apple.finder,69,1743864323,1743864392,1743864392.0791368,-18000,,
com.apple.news,137,1743864186,1743864323,1743864323.755022,-18000,EB445137-D7F5-57EC-87DA-1DB460D64046,"iPhone13,2"
com.microsoft.VSCode,141,1743864182,1743864323,1743864323.1007318,-18000,,
com.apple.finder,2,1743864180,1743864182,1743864182.515013,-18000,,
com.microsoft.VSCode,26,1743864154,1743864180,1743864180.56196,-18000,,
com.apple.news,111,1743864024,1743864135,1743864136.2215152,-18000,EB445137-D7F5-57EC-87DA-1DB460D64046,"iPhone13,2"
com.apple.finder,158,1743863996,1743864154,1743864154.558454,-18000,,
com.microsoft.VSCode,42,1743863954,1743863996,1743863996.8881512,-18000,,
com.apple.finder,14,1743863940,1743863954,1743863955.0060968,-18000,,
com.microsoft.VSCode,1,1743863939,1743863940,1743863940.1416302,-18000,,
com.apple.finder,27,1743863912,1743863939,1743863939.2958221,-18000,,
com.google.Chrome,18,1743863894,1743863912,1743863912.4951348,-18000,,
com.electron.carta,2,1743863892,1743863894,1743863894.768869,-18000,,
com.google.Chrome,36,1743863856,1743863892,1743863892.262929,-18000,,
com.google.Chrome,316,1743863374,1743863690,1743863690.033047,-18000,,
com.electron.carta,9,1743863365,1743863374,1743863374.93659,-18000,,
com.google.Chrome,19,1743863346,1743863365,1743863365.582607,-18000,,
com.electron.carta,21,1743863325,1743863346,1743863346.0710468,-18000,,
com.google.Chrome,14,1743863311,1743863325,1743863325.133714,-18000,,
com.electron.carta,12,1743863299,1743863311,1743863311.49727,-18000,,
com.google.Chrome,34,1743863265,1743863299,1743863299.728651,-18000,,
com.electron.carta,29,1743863236,1743863265,1743863265.241751,-18000,,
com.jinzhenyu.ruler,0,1743863236,1743863236,1743863236.649432,-18000,,
com.electron.carta,1,1743863235,1743863236,1743863236.036309,-18000,,
com.google.Chrome,23,1743863212,1743863235,1743863235.464509,-18000,,
com.jinzhenyu.ruler,11,1743863201,1743863212,1743863212.129971,-18000,,
com.electron.carta,1,1743863200,1743863201,1743863201.804986,-18000,,
com.jinzhenyu.ruler,4,1743863196,1743863200,1743863200.08505,-18000,,
com.electron.carta,29,1743863167,1743863196,1743863196.733392,-18000,,
com.jinzhenyu.ruler,1,1743863166,1743863167,1743863167.504364,-18000,,
com.electron.carta,1,1743863165,1743863166,1743863166.612412,-18000,,
com.jinzhenyu.ruler,0,1743863165,1743863165,1743863165.7096782,-18000,,
com.google.Chrome,74,1743863091,1743863165,1743863165.6535602,-18000,,
com.electron.carta,3,1743863088,1743863091,1743863091.57318,-18000,,
com.google.Chrome,22,1743863066,1743863088,1743863088.796729,-18000,,
com.electron.carta,7,1743863059,1743863066,1743863066.991394,-18000,,
com.jinzhenyu.ruler,3,1743863056,1743863059,1743863059.457057,-18000,,
com.electron.carta,106,1743862950,1743863056,1743863056.588266,-18000,,
com.apple.finder,20,1743862930,1743862950,1743862950.637644,-18000,,
com.tinyspeck.chatlyio,2,1743862902,1743862904,1743862904.956248,-18000,EB445137-D7F5-57EC-87DA-1DB460D64046,"iPhone13,2"
com.apple.weather,15,1743862870,1743862885,1743862885.531524,-18000,EB445137-D7F5-57EC-87DA-1DB460D64046,"iPhone13,2"
com.electron.carta,62,1743862868,1743862930,1743862930.979883,-18000,,
com.leomehlig.today,51,1743862817,1743862868,1743862868.062052,-18000,,
com.apple.Health,14,1743862797,1743862811,1743862812.128345,-18000,EB445137-D7F5-57EC-87DA-1DB460D64046,"iPhone13,2"
com.microsoft.Office.Outlook,0,1743862797,1743862797,1743862798.102787,-18000,EB445137-D7F5-57EC-87DA-1DB460D64046,"iPhone13,2"
com.electron.carta,61,1743862756,1743862817,1743862817.6394548,-18000,,
com.jinzhenyu.ruler,1,1743862755,1743862756,1743862756.298565,-18000,,
com.electron.carta,15,1743862740,1743862755,1743862755.189361,-18000,,
com.google.Chrome,176,1743862564,1743862740,1743862740.344016,-18000,,
com.electron.carta,2,1743862562,1743862564,1743862564.0739698,-18000,,
com.google.Chrome,8,1743862554,1743862562,1743862562.650326,-18000,,
com.electron.carta,7,1743862547,1743862554,1743862554.678451,-18000,,
com.jinzhenyu.ruler,3,1743862544,1743862547,1743862547.5475612,-18000,,
com.electron.carta,112,1743862432,1743862544,1743862544.972934,-18000,,
com.google.Chrome,31,1743862401,1743862432,1743862432.3606172,-18000,,
com.electron.carta,117,1743862284,1743862401,1743862402.0285149,-18000,,
com.jinzhenyu.ruler,1,1743862283,1743862284,1743862284.297051,-18000,,
com.electron.carta,5,1743862278,1743862283,1743862283.407465,-18000,,
com.google.Chrome,35,1743862243,1743862278,1743862278.108592,-18000,,
com.apple.Notes,2,1743862241,1743862243,1743862243.463101,-18000,,
com.google.Chrome,182,1743862059,1743862241,1743862241.439498,-18000,,
com.electron.carta,2,1743862057,1743862059,1743862059.582255,-18000,,
com.google.Chrome,21,1743862036,1743862057,1743862057.073182,-18000,,
com.electron.carta,8,1743862028,1743862036,1743862036.677997,-18000,,
com.jinzhenyu.ruler,4,1743862024,1743862028,1743862028.3500419,-18000,,
com.electron.carta,86,1743861938,1743862024,1743862024.455486,-18000,,
com.google.Chrome,31,1743861907,1743861938,1743861938.702595,-18000,,
com.apple.finder,11,1743861896,1743861907,1743861907.3330421,-18000,,
com.electron.carta,46,1743861850,1743861896,1743861896.906993,-18000,,
com.jinzhenyu.ruler,1,1743861849,1743861850,1743861850.1418982,-18000,,
com.electron.carta,9,1743861840,1743861849,1743861849.30175,-18000,,
com.jinzhenyu.ruler,1,1743861839,1743861840,1743861840.521737,-18000,,
com.electron.carta,51,1743861788,1743861839,1743861839.800695,-18000,,
com.jinzhenyu.ruler,1,1743861787,1743861788,1743861788.3071399,-18000,,
com.electron.carta,1,1743861786,1743861787,1743861787.208623,-18000,,
com.jinzhenyu.ruler,1,1743861785,1743861786,1743861786.905458,-18000,,
com.electron.carta,2,1743861783,1743861785,1743861785.3514528,-18000,,
com.google.Chrome,0,1743861783,1743861783,1743861783.885306,-18000,,
com.jinzhenyu.ruler,1,1743861782,1743861783,1743861783.492598,-18000,,
com.google.Chrome,175,1743861607,1743861782,1743861782.5138311,-18000,,
com.electron.carta,5,1743861602,1743861607,1743861607.558032,-18000,,
com.jinzhenyu.ruler,3,1743861599,1743861602,1743861602.585343,-18000,,
com.electron.carta,45,1743861554,1743861599,1743861599.971323,-18000,,
com.jinzhenyu.ruler,1,1743861553,1743861554,1743861554.062813,-18000,,
com.electron.carta,5,1743861548,1743861553,1743861553.622295,-18000,,
com.google.Chrome,27,1743861521,1743861548,1743861548.902036,-18000,,
com.electron.carta,12,1743861509,1743861521,1743861521.515641,-18000,,
com.jinzhenyu.ruler,4,1743861505,1743861509,1743861509.33424,-18000,,
com.electron.carta,1,1743861504,1743861505,1743861505.996705,-18000,,
com.jinzhenyu.ruler,2,1743861502,1743861504,1743861504.28914,-18000,,
com.electron.carta,75,1743861427,1743861502,1743861502.821367,-18000,,
com.google.Chrome,2,1743861425,1743861427,1743861427.894981,-18000,,
com.jinzhenyu.ruler,1,1743861424,1743861425,1743861426.002398,-18000,,
com.google.Chrome,28,1743861396,1743861424,1743861424.974427,-18000,,
com.jinzhenyu.ruler,11,1743861385,1743861396,1743861396.173493,-18000,,
com.google.Chrome,1,1743861384,1743861385,1743861385.8254108,-18000,,
com.jinzhenyu.ruler,4,1743861380,1743861384,1743861384.7835011,-18000,,
com.google.Chrome,16,1743861364,1743861380,1743861380.7371922,-18000,,
com.apple.finder,9,1743861355,1743861364,1743861364.1614041,-18000,,
com.electron.carta,98,1743861257,1743861355,1743861355.97606,-18000,,
com.jinzhenyu.ruler,1,1743861256,1743861257,1743861257.312218,-18000,,
com.electron.carta,6,1743861250,1743861256,1743861256.82623,-18000,,
com.google.Chrome,1,1743861249,1743861250,1743861250.905034,-18000,,
com.jinzhenyu.ruler,0,1743861249,1743861249,1743861249.8060942,-18000,,
com.google.Chrome,30,1743861219,1743861249,1743861249.197713,-18000,,
com.electron.carta,13,1743861206,1743861219,1743861219.7626262,-18000,,
com.jinzhenyu.ruler,2,1743861204,1743861206,1743861206.590417,-18000,,
com.electron.carta,52,1743861152,1743861204,1743861204.323515,-18000,,
com.google.Chrome,4,1743861148,1743861152,1743861152.4603019,-18000,,
com.jinzhenyu.ruler,1,1743861147,1743861148,1743861148.739537,-18000,,
com.google.Chrome,13,1743861134,1743861147,1743861147.450208,-18000,,
com.apple.Notes,0,1743861134,1743861134,1743861134.8678942,-18000,,
com.google.Chrome,20,1743861114,1743861134,1743861134.207109,-18000,,
com.apple.Notes,1,1743861113,1743861114,1743861114.470041,-18000,,
com.jinzhenyu.ruler,27,1743861086,1743861113,1743861113.37626,-18000,,
com.electron.carta,348,1743860738,1743861086,1743861086.087327,-18000,,
com.apple.finder,25,1743860713,1743860738,1743860738.709193,-18000,,
com.electron.carta,105,1743860608,1743860713,1743860713.897824,-18000,,
com.google.Chrome,51,1743860557,1743860608,1743860608.940559,-18000,,
com.apple.Notes,1,1743860556,1743860557,1743860557.429362,-18000,,
com.google.Chrome,2,1743860554,1743860556,1743860556.5095901,-18000,,
com.apple.Notes,2,1743860552,1743860554,1743860554.4854178,-18000,,
com.google.Chrome,1,1743860551,1743860552,1743860552.726746,-18000,,
com.apple.Notes,1,1743860550,1743860551,1743860551.3965678,-18000,,
com.microsoft.Outlook,1,1743860549,1743860550,1743860550.648545,-18000,,
com.google.Chrome,384,1743860165,1743860549,1743860549.268312,-18000,,
com.microsoft.Outlook,43,1743860122,1743860165,1743860166.093802,-18000,,
com.apple.Notes,21,1743860091,1743860112,1743860112.149261,-18000,,
com.apple.finder,5,1743860086,1743860091,1743860093.08247,-18000,,
com.leomehlig.today,7,1743860079,1743860086,1743860086.904482,-18000,,
com.microsoft.Office.Outlook,8,1743860065,1743860073,1743860073.888799,-18000,EB445137-D7F5-57EC-87DA-1DB460D64046,"iPhone13,2"
com.apple.news,742,1743859319,1743860061,1743860061.2049441,-18000,EB445137-D7F5-57EC-87DA-1DB460D64046,"iPhone13,2"
com.apple.Health,3,1743859308,1743859311,1743859311.7525802,-18000,EB445137-D7F5-57EC-87DA-1DB460D64046,"iPhone13,2"
com.apple.CoreAuthUI,2,1743859278,1743859280,1743859280.7067919,-18000,EB445137-D7F5-57EC-87DA-1DB460D64046,"iPhone13,2"
com.robinhood.release.Robinhood,32,1743859276,1743859308,1743859309.0106869,-18000,EB445137-D7F5-57EC-87DA-1DB460D64046,"iPhone13,2"
com.renpho.health,23,1743859237,1743859260,1743859260.088008,-18000,EB445137-D7F5-57EC-87DA-1DB460D64046,"iPhone13,2"
com.renpho.health,4,1743858484,1743858488,1743858488.826658,-18000,EB445137-D7F5-57EC-87DA-1DB460D64046,"iPhone13,2"
com.renpho.health,31,1743858409,1743858440,1743858440.377732,-18000,EB445137-D7F5-57EC-87DA-1DB460D64046,"iPhone13,2"
com.apple.Health,3,1743858404,1743858407,1743858407.20163,-18000,EB445137-D7F5-57EC-87DA-1DB460D64046,"iPhone13,2"
com.apple.Health,48,1743856324,1743856372,1743856372.328456,-18000,EB445137-D7F5-57EC-87DA-1DB460D64046,"iPhone13,2"
com.letterboxd.LetterboxdApp,7,1743831802,1743831809,1743831809.302593,-18000,EB445137-D7F5-57EC-87DA-1DB460D64046,"iPhone13,2"
com.google.chrome.ios,4,1743831797,1743831801,1743831801.973731,-18000,EB445137-D7F5-57EC-87DA-1DB460D64046,"iPhone13,2"
com.google.chrome.ios,17,1743828653,1743828670,1743828670.624476,-18000,EB445137-D7F5-57EC-87DA-1DB460D64046,"iPhone13,2"
com.letterboxd.LetterboxdApp,2,1743828650,1743828652,1743828652.893261,-18000,EB445137-D7F5-57EC-87DA-1DB460D64046,"iPhone13,2"
com.letterboxd.LetterboxdApp,61,1743828326,1743828387,1743828387.8780808,-18000,EB445137-D7F5-57EC-87DA-1DB460D64046,"iPhone13,2"
com.letterboxd.LetterboxdApp,53,1743823145,1743823198,1743823199.124751,-18000,EB445137-D7F5-57EC-87DA-1DB460D64046,"iPhone13,2"
com.google.Gmail,5,1743823140,1743823145,1743823145.2570791,-18000,EB445137-D7F5-57EC-87DA-1DB460D64046,"iPhone13,2"
com.google.Gmail,111,1743814166,1743814277,1743814277.316382,-18000,EB445137-D7F5-57EC-87DA-1DB460D64046,"iPhone13,2"
com.apple.Maps,14,1743812811,1743812825,1743812826.947301,-18000,EB445137-D7F5-57EC-87DA-1DB460D64046,"iPhone13,2"
com.google.chrome.ios,44,1743807772,1743807816,1743807816.717699,-18000,EB445137-D7F5-57EC-87DA-1DB460D64046,"iPhone13,2"
com.apple.Music,1,1743807434,1743807435,1743807436.112026,-18000,EB445137-D7F5-57EC-87DA-1DB460D64046,"iPhone13,2"
com.apple.Music,23,1743804310,1743804333,1743804333.1713061,-18000,EB445137-D7F5-57EC-87DA-1DB460D64046,"iPhone13,2"
com.apple.Music,55,1743804250,1743804305,1743804305.159055,-18000,EB445137-D7F5-57EC-87DA-1DB460D64046,"iPhone13,2"
com.google.chrome.ios,2,1743804247,1743804249,1743804249.56045,-18000,EB445137-D7F5-57EC-87DA-1DB460D64046,"iPhone13,2"
com.apple.Maps,2,1743802866,1743802868,1743802868.4141479,-18000,EB445137-D7F5-57EC-87DA-1DB460D64046,"iPhone13,2"
com.apple.Maps,23,1743802326,1743802349,1743802349.69578,-18000,EB445137-D7F5-57EC-87DA-1DB460D64046,"iPhone13,2"
com.apple.mobilecal,6,1743802320,1743802326,1743802326.273931,-18000,EB445137-D7F5-57EC-87DA-1DB460D64046,"iPhone13,2"
com.apple.mobilecal,2,1743798375,1743798377,1743798377.8420792,-18000,EB445137-D7F5-57EC-87DA-1DB460D64046,"iPhone13,2"
com.apple.Maps,2,1743797737,1743797739,1743797739.251514,-18000,EB445137-D7F5-57EC-87DA-1DB460D64046,"iPhone13,2"
com.apple.Maps,18,1743797715,1743797733,1743797734.179028,-18000,EB445137-D7F5-57EC-87DA-1DB460D64046,"iPhone13,2"
com.toyopagroup.picaboo,10,1743797663,1743797673,1743797673.350122,-18000,EB445137-D7F5-57EC-87DA-1DB460D64046,"iPhone13,2"
com.apple.MobileSMS,2,1743797658,1743797660,1743797660.949852,-18000,EB445137-D7F5-57EC-87DA-1DB460D64046,"iPhone13,2"
com.toyopagroup.picaboo,6,1743797142,1743797148,1743797148.685028,-18000,EB445137-D7F5-57EC-87DA-1DB460D64046,"iPhone13,2"
com.toyopagroup.picaboo,79,1743796363,1743796442,1743796442.360413,-18000,EB445137-D7F5-57EC-87DA-1DB460D64046,"iPhone13,2"
com.apple.MobileSMS,3,1743796342,1743796345,1743796345.768424,-18000,EB445137-D7F5-57EC-87DA-1DB460D64046,"iPhone13,2"
com.apple.news,0,1743796342,1743796342,1743796343.3352408,-18000,EB445137-D7F5-57EC-87DA-1DB460D64046,"iPhone13,2"
com.apple.news,153,1743793046,1743793199,1743793200.305485,-18000,EB445137-D7F5-57EC-87DA-1DB460D64046,"iPhone13,2"
com.apple.CoreAuthUI,2,1743793014,1743793016,1743793016.803299,-18000,EB445137-D7F5-57EC-87DA-1DB460D64046,"iPhone13,2"
com.robinhood.release.Robinhood,34,1743793012,1743793046,1743793046.560765,-18000,EB445137-D7F5-57EC-87DA-1DB460D64046,"iPhone13,2"
com.apple.news,14,1743792995,1743793009,1743793010.0955648,-18000,EB445137-D7F5-57EC-87DA-1DB460D64046,"iPhone13,2"
com.apple.weather,34,1743792961,1743792995,1743792996.029877,-18000,EB445137-D7F5-57EC-87DA-1DB460D64046,"iPhone13,2"
com.apple.news,11,1743792949,1743792960,1743792961.196182,-18000,EB445137-D7F5-57EC-87DA-1DB460D64046,"iPhone13,2"
com.burbn.instagram,14,1743792927,1743792941,1743792942.074829,-18000,EB445137-D7F5-57EC-87DA-1DB460D64046,"iPhone13,2"
com.groupme.iphone-app,3,1743792918,1743792921,1743792921.255091,-18000,EB445137-D7F5-57EC-87DA-1DB460D64046,"iPhone13,2"
com.apple.news,276,1743792236,1743792512,1743792512.522788,-18000,EB445137-D7F5-57EC-87DA-1DB460D64046,"iPhone13,2"
com.microsoft.Office.Outlook,25,1743792202,1743792227,1743792227.4571462,-18000,EB445137-D7F5-57EC-87DA-1DB460D64046,"iPhone13,2"
com.apple.weather,11,1743792173,1743792184,1743792184.6450648,-18000,EB445137-D7F5-57EC-87DA-1DB460D64046,"iPhone13,2"
com.apple.MobileSMS,2,1743792171,1743792173,1743792173.656448,-18000,EB445137-D7F5-57EC-87DA-1DB460D64046,"iPhone13,2"
co.hinge.mobile.ios,54,1743790101,1743790155,1743790155.981659,-18000,EB445137-D7F5-57EC-87DA-1DB460D64046,"iPhone13,2"
com.leomehlig.today,20,1743790047,1743790067,1743790067.567967,-18000,,
com.apple.finder,5,1743790042,1743790047,1743790047.3662338,-18000,,
com.microsoft.VSCode,83,1743789959,1743790042,1743790043.023109,-18000,,
com.google.Chrome,72,1743789887,1743789959,1743789959.2333689,-18000,,
com.microsoft.VSCode,3,1743789870,1743789873,1743789873.052394,-18000,,
com.leomehlig.today,127,1743789743,1743789870,1743789870.556654,-18000,,
com.toyopagroup.picaboo,50,1743788635,1743788685,1743788685.433357,-18000,EB445137-D7F5-57EC-87DA-1DB460D64046,"iPhone13,2"
com.google.Chrome,1327,1743788416,1743789743,1743789743.593207,-18000,,
com.microsoft.VSCode,5,1743788411,1743788416,1743788429.4811811,-18000,,
com.leomehlig.today,21,1743788390,1743788411,1743788413.302857,-18000,,
com.microsoft.VSCode,29,1743788361,1743788390,1743788391.423286,-18000,,
com.apple.weather,6,1743788313,1743788319,1743788319.56726,-18000,EB445137-D7F5-57EC-87DA-1DB460D64046,"iPhone13,2"
com.apple.weather,5,1743788307,1743788312,1743788312.7340431,-18000,EB445137-D7F5-57EC-87DA-1DB460D64046,"iPhone13,2"
com.apple.weather,10,1743788296,1743788306,1743788306.688906,-18000,EB445137-D7F5-57EC-87DA-1DB460D64046,"iPhone13,2"
co.hinge.mobile.ios,86,1743787449,1743787535,1743787535.808667,-18000,EB445137-D7F5-57EC-87DA-1DB460D64046,"iPhone13,2"
com.apple.mobilecal,5,1743787440,1743787445,1743787445.7001839,-18000,EB445137-D7F5-57EC-87DA-1DB460D64046,"iPhone13,2"
com.tinyspeck.chatlyio,11,1743787425,1743787436,1743787436.790018,-18000,EB445137-D7F5-57EC-87DA-1DB460D64046,"iPhone13,2"
com.apple.news,211,1743787212,1743787423,1743787423.499593,-18000,EB445137-D7F5-57EC-87DA-1DB460D64046,"iPhone13,2"
co.hinge.mobile.ios,16,1743786484,1743786500,1743786501.12072,-18000,EB445137-D7F5-57EC-87DA-1DB460D64046,"iPhone13,2"
com.apple.MobileSMS,5,1743786479,1743786484,1743786484.5090199,-18000,EB445137-D7F5-57EC-87DA-1DB460D64046,"iPhone13,2"
com.apple.MobileSMS,10,1743785016,1743785026,1743785026.919218,-18000,EB445137-D7F5-57EC-87DA-1DB460D64046,"iPhone13,2"
com.apple.news,0,1743785016,1743785016,1743785018.961679,-18000,EB445137-D7F5-57EC-87DA-1DB460D64046,"iPhone13,2"
com.apple.news,103,1743782695,1743782798,1743782799.907387,-18000,EB445137-D7F5-57EC-87DA-1DB460D64046,"iPhone13,2"
co.hinge.mobile.ios,44,1743782324,1743782368,1743782368.689547,-18000,EB445137-D7F5-57EC-87DA-1DB460D64046,"iPhone13,2"
com.microsoft.Office.Outlook,7,1743782313,1743782320,1743782321.061341,-18000,EB445137-D7F5-57EC-87DA-1DB460D64046,"iPhone13,2"
com.apple.MobileSMS,46,1743782263,1743782309,1743782309.477929,-18000,EB445137-D7F5-57EC-87DA-1DB460D64046,"iPhone13,2"
com.apple.mobilecal,5,1743782256,1743782261,1743782261.566638,-18000,EB445137-D7F5-57EC-87DA-1DB460D64046,"iPhone13,2"
com.apple.mobilecal,4,1743782146,1743782150,1743782150.162432,-18000,EB445137-D7F5-57EC-87DA-1DB460D64046,"iPhone13,2"
com.intsig.CamScannerLite,2,1743782139,1743782141,1743782141.381108,-18000,EB445137-D7F5-57EC-87DA-1DB460D64046,"iPhone13,2"
com.microsoft.VSCode,581,1743781141,1743781722,1743781722.066179,-18000,,
com.google.Chrome,2,1743781139,1743781141,1743781141.885726,-18000,,
com.microsoft.VSCode,8,1743781131,1743781139,1743781139.502468,-18000,,
com.google.Chrome,51,1743781080,1743781131,1743781131.900337,-18000,,
com.microsoft.VSCode,293,1743780787,1743781080,1743781080.50815,-18000,,
com.google.Chrome,2,1743780785,1743780787,1743780787.36374,-18000,,
com.microsoft.VSCode,16,1743780769,1743780785,1743780785.192254,-18000,,
com.google.Chrome,5,1743780764,1743780769,1743780769.815524,-18000,,
com.microsoft.VSCode,1758,1743779006,1743780764,1743780764.788441,-18000,,
com.google.Chrome,2,1743779004,1743779006,1743779006.807386,-18000,,
com.leomehlig.today,14,1743778990,1743779004,1743779004.738615,-18000,,
com.google.Chrome,34,1743778956,1743778990,1743778990.0660892,-18000,,
com.apple.finder,33,1743778923,1743778956,1743778956.982024,-18000,,
com.intsig.CamScannerLite,17,1743778906,1743778923,1743778923.864029,-18000,EB445137-D7F5-57EC-87DA-1DB460D64046,"iPhone13,2"
com.instructure.icanvas,20,1743778881,1743778901,1743778901.453737,-18000,EB445137-D7F5-57EC-87DA-1DB460D64046,"iPhone13,2"
com.google.chrome.ios,1,1743778880,1743778881,1743778881.773409,-18000,EB445137-D7F5-57EC-87DA-1DB460D64046,"iPhone13,2"
com.microsoft.VSCode,246,1743778677,1743778923,1743778923.5932999,-18000,,
com.google.Chrome,20,1743778657,1743778677,1743778677.2526379,-18000,,
com.microsoft.VSCode,28,1743778629,1743778657,1743778657.134021,-18000,,
com.google.Chrome,44,1743778585,1743778629,1743778629.0802479,-18000,,
com.apple.news,124,1743778461,1743778585,1743778585.840475,-18000,,
com.google.Chrome,180,1743778281,1743778461,1743778461.602279,-18000,,
com.google.Chrome,390,1743777890,1743778280,1743778280.218714,-18000,,
com.google.Chrome,338,1743777459,1743777797,1743777797.316674,-18000,,
com.google.chrome.ios,19,1743777432,1743777451,1743777451.656575,-18000,EB445137-D7F5-57EC-87DA-1DB460D64046,"iPhone13,2"
co.hinge.mobile.ios,71,1743777358,1743777429,1743777429.63713,-18000,EB445137-D7F5-57EC-87DA-1DB460D64046,"iPhone13,2"
com.apple.news,123,1743777229,1743777352,1743777352.6097898,-18000,EB445137-D7F5-57EC-87DA-1DB460D64046,"iPhone13,2"
com.letterboxd.LetterboxdApp,0,1743777229,1743777229,1743777229.88469,-18000,EB445137-D7F5-57EC-87DA-1DB460D64046,"iPhone13,2"
com.letterboxd.LetterboxdApp,71,1743777029,1743777100,1743777101.178638,-18000,EB445137-D7F5-57EC-87DA-1DB460D64046,"iPhone13,2"
com.apple.news,45,1743776981,1743777026,1743777026.9807281,-18000,EB445137-D7F5-57EC-87DA-1DB460D64046,"iPhone13,2"
com.microsoft.Office.Outlook,4,1743776972,1743776976,1743776976.572177,-18000,EB445137-D7F5-57EC-87DA-1DB460D64046,"iPhone13,2"
com.microsoft.Office.Outlook,3,1743776862,1743776865,1743776865.977072,-18000,EB445137-D7F5-57EC-87DA-1DB460D64046,"iPhone13,2"
com.google.Chrome,10,1743776427,1743776437,1743776437.336,-18000,,
com.leomehlig.today,20,1743776407,1743776427,1743776427.730989,-18000,,
com.google.Chrome,61,1743776346,1743776407,1743776407.138552,-18000,,
com.apple.MobileSMS,3,1743776338,1743776341,1743776342.521764,-18000,EB445137-D7F5-57EC-87DA-1DB460D64046,"iPhone13,2"
com.apple.news,0,1743776338,1743776338,1743776339.69873,-18000,EB445137-D7F5-57EC-87DA-1DB460D64046,"iPhone13,2"
com.leomehlig.today,42,1743776304,1743776346,1743776346.901777,-18000,,
com.google.Chrome,186,1743776118,1743776304,1743776304.538497,-18000,,
com.leomehlig.today,22,1743776096,1743776118,1743776118.681357,-18000,,
com.google.Chrome,736,1743775360,1743776096,1743776096.149035,-18000,,
com.apple.news,100,1743774426,1743774526,1743774526.9641619,-18000,EB445137-D7F5-57EC-87DA-1DB460D64046,"iPhone13,2"
com.apple.CoreAuthUI,2,1743774384,1743774386,1743774386.923044,-18000,EB445137-D7F5-57EC-87DA-1DB460D64046,"iPhone13,2"
com.robinhood.release.Robinhood,44,1743774378,1743774422,1743774422.366502,-18000,EB445137-D7F5-57EC-87DA-1DB460D64046,"iPhone13,2"
com.google.Gmail,20,1743774334,1743774354,1743774354.645385,-18000,EB445137-D7F5-57EC-87DA-1DB460D64046,"iPhone13,2"
com.apple.weather,0,1743774334,1743774334,1743774335.953114,-18000,EB445137-D7F5-57EC-87DA-1DB460D64046,"iPhone13,2"
com.google.Chrome,519,1743774304,1743774823,1743774823.6843638,-18000,,
com.google.Chrome,400,1743773676,1743774076,1743774076.873067,-18000,,
com.leomehlig.today,5,1743773655,1743773660,1743773661.5540938,-18000,,
com.google.Chrome,17,1743773638,1743773655,1743773655.784329,-18000,,
com.apple.weather,2,1743772191,1743772193,1743772193.7622828,-18000,EB445137-D7F5-57EC-87DA-1DB460D64046,"iPhone13,2"
com.apple.Maps,27,1743772156,1743772183,1743772183.798349,-18000,EB445137-D7F5-57EC-87DA-1DB460D64046,"iPhone13,2"
com.microsoft.Office.Outlook,18,1743772135,1743772153,1743772153.835319,-18000,EB445137-D7F5-57EC-87DA-1DB460D64046,"iPhone13,2"
com.apple.weather,3,1743772129,1743772132,1743772132.05367,-18000,EB445137-D7F5-57EC-87DA-1DB460D64046,"iPhone13,2"
com.apple.weather,61,1743771202,1743771263,1743771264.3522081,-18000,EB445137-D7F5-57EC-87DA-1DB460D64046,"iPhone13,2"
com.renpho.health,68,1743771134,1743771202,1743771202.740923,-18000,EB445137-D7F5-57EC-87DA-1DB460D64046,"iPhone13,2"
com.apple.Health,11,1743771121,1743771132,1743771133.072027,-18000,EB445137-D7F5-57EC-87DA-1DB460D64046,"iPhone13,2"
com.apple.CoreAuthUI,2,1743737355,1743737357,1743737357.93835,-18000,EB445137-D7F5-57EC-87DA-1DB460D64046,"iPhone13,2"
com.apple.journal,755,1743737354,1743738109,1743738109.6878018,-18000,EB445137-D7F5-57EC-87DA-1DB460D64046,"iPhone13,2"
com.google.Chrome,5,1743737053,1743737058,1743737058.561141,-18000,,
com.google.Chrome,554,1743736499,1743737053,1743737053.6885881,-18000,,
com.apple.finder,4,1743736495,1743736499,1743736499.592751,-18000,,
com.apple.finder,4,1743736425,1743736429,1743736429.235601,-18000,,
com.apple.iCal,88,1743736337,1743736425,1743736425.801619,-18000,,
com.apple.finder,25,1743736312,1743736337,1743736337.8445,-18000,,
com.apple.iCal,32,1743736280,1743736312,1743736312.17991,-18000,,
co.hinge.mobile.ios,33,1743736233,1743736266,1743736266.694943,-18000,EB445137-D7F5-57EC-87DA-1DB460D64046,"iPhone13,2"
com.apple.Health,26,1743736204,1743736230,1743736231.113039,-18000,EB445137-D7F5-57EC-87DA-1DB460D64046,"iPhone13,2"
com.microsoft.Office.Outlook,0,1743736204,1743736204,1743736205.310882,-18000,EB445137-D7F5-57EC-87DA-1DB460D64046,"iPhone13,2"
com.google.Chrome,197,1743736083,1743736280,1743736280.177778,-18000,,
com.leomehlig.today,95,1743735988,1743736083,1743736083.140799,-18000,,
com.google.Chrome,12,1743735976,1743735988,1743735988.521347,-18000,,
com.leomehlig.today,31,1743735945,1743735976,1743735976.38584,-18000,,
com.apple.finder,18,1743735927,1743735945,1743735945.5078259,-18000,,
com.google.Chrome,22,1743735905,1743735927,1743735927.304388,-18000,,
com.leomehlig.today,26,1743735879,1743735905,1743735905.574205,-18000,,
com.google.Chrome,28,1743735851,1743735879,1743735879.947233,-18000,,
com.leomehlig.today,4,1743735847,1743735851,1743735851.414489,-18000,,
com.google.Chrome,7,1743735840,1743735847,1743735847.692039,-18000,,
com.leomehlig.today,4,1743735836,1743735840,1743735840.846735,-18000,,
com.google.Chrome,21,1743735815,1743735836,1743735836.98201,-18000,,
com.leomehlig.today,1,1743735801,1743735802,1743735803.120551,-18000,,
com.apple.MobileSMS,1,1743735800,1743735801,1743735801.267621,-18000,,
com.leomehlig.today,35,1743735765,1743735800,1743735800.288069,-18000,,
com.google.Chrome,31,1743735734,1743735765,1743735765.617949,-18000,,
com.leomehlig.today,6,1743735714,1743735720,1743735720.891862,-18000,,
com.apple.iCal,8,1743735706,1743735714,1743735714.8673968,-18000,,
com.google.Chrome,115,1743735591,1743735706,1743735706.803869,-18000,,
com.apple.iCal,7,1743735584,1743735591,1743735591.148462,-18000,,
com.leomehlig.today,14,1743735570,1743735584,1743735584.375053,-18000,,
com.google.Chrome,25,1743735545,1743735570,1743735570.391305,-18000,,
com.microsoft.Office.Outlook,14,1743734228,1743734242,1743734242.982099,-18000,EB445137-D7F5-57EC-87DA-1DB460D64046,"iPhone13,2"
com.google.chrome.ios,1,1743734227,1743734228,1743734229.13552,-18000,EB445137-D7F5-57EC-87DA-1DB460D64046,"iPhone13,2"
com.google.chrome.ios,34,1743732289,1743732323,1743732324.063262,-18000,EB445137-D7F5-57EC-87DA-1DB460D64046,"iPhone13,2"
com.apple.MobileSMS,3,1743732286,1743732289,1743732289.7528949,-18000,EB445137-D7F5-57EC-87DA-1DB460D64046,"iPhone13,2"
com.apple.MobileSMS,28,1743730175,1743730203,1743730203.713417,-18000,EB445137-D7F5-57EC-87DA-1DB460D64046,"iPhone13,2"
com.google.chrome.ios,0,1743730175,1743730175,1743730176.169605,-18000,EB445137-D7F5-57EC-87DA-1DB460D64046,"iPhone13,2"
com.google.chrome.ios,22,1743729365,1743729387,1743729388.013103,-18000,EB445137-D7F5-57EC-87DA-1DB460D64046,"iPhone13,2"
com.google.chrome.ios,38,1743729245,1743729283,1743729283.3180618,-18000,EB445137-D7F5-57EC-87DA-1DB460D64046,"iPhone13,2"
com.google.chrome.ios,25,1743729168,1743729193,1743729194.491726,-18000,EB445137-D7F5-57EC-87DA-1DB460D64046,"iPhone13,2"
com.letterboxd.LetterboxdApp,3,1743721879,1743721882,1743721882.372546,-18000,EB445137-D7F5-57EC-87DA-1DB460D64046,"iPhone13,2"
com.google.chrome.ios,12,1743721858,1743721870,1743721870.356204,-18000,EB445137-D7F5-57EC-87DA-1DB460D64046,"iPhone13,2"
com.google.chrome.ios,56,1743721278,1743721334,1743721335.038066,-18000,EB445137-D7F5-57EC-87DA-1DB460D64046,"iPhone13,2"
com.google.chrome.ios,19,1743720976,1743720995,1743720996.794651,-18000,EB445137-D7F5-57EC-87DA-1DB460D64046,"iPhone13,2"
com.google.Chrome,3,1743720156,1743720159,1743720159.997738,-18000,,
com.apple.FaceTime,14,1743720142,1743720156,1743720156.173267,-18000,,
com.google.Chrome,309,1743719833,1743720142,1743720142.7064838,-18000,,
com.apple.findmy,32,1743719801,1743719833,1743719834.061871,-18000,,
com.google.Chrome,262,1743719539,1743719801,1743719801.9726849,-18000,,
com.leomehlig.today,25,1743719508,1743719533,1743719533.0830731,-18000,,
com.google.Chrome,2,1743719506,1743719508,1743719508.4031749,-18000,,
com.apple.Passwords,1,1743719505,1743719506,1743719506.378214,-18000,,
com.apple.iCal,112,1743719393,1743719505,1743719505.4177809,-18000,,
com.google.Chrome,108,1743719285,1743719393,1743719393.678097,-18000,,
com.apple.MobileSMS,21,1743719264,1743719285,1743719285.407829,-18000,,
com.google.Chrome,30,1743719234,1743719264,1743719264.114894,-18000,,
com.apple.MobileSMS,867,1743718367,1743719234,1743719234.077344,-18000,,
com.leomehlig.today,290,1743718077,1743718367,1743718367.930128,-18000,,
com.apple.MobileSMS,138,1743717939,1743718077,1743718077.7482672,-18000,,
com.apple.FaceTime,7,1743717932,1743717939,1743717939.949305,-18000,,
com.apple.MobileSMS,6,1743717926,1743717932,1743717932.493721,-18000,,
com.toyopagroup.picaboo,22,1743717878,1743717900,1743717900.988946,-18000,EB445137-D7F5-57EC-87DA-1DB460D64046,"iPhone13,2"
com.instructure.icanvas,1,1743717877,1743717878,1743717878.550301,-18000,EB445137-D7F5-57EC-87DA-1DB460D64046,"iPhone13,2"
com.apple.findmy,69,1743717857,1743717926,1743717926.9408622,-18000,,
com.apple.MobileSMS,8,1743717849,1743717857,1743717857.6490622,-18000,,
com.google.Chrome,4,1743717845,1743717849,1743717849.5793638,-18000,,
com.instructure.icanvas,5,1743717490,1743717495,1743717496.033471,-18000,EB445137-D7F5-57EC-87DA-1DB460D64046,"iPhone13,2"
com.apple.findmy,0,1743717490,1743717490,1743717491.2071,-18000,EB445137-D7F5-57EC-87DA-1DB460D64046,"iPhone13,2"
com.apple.findmy,11,1743716891,1743716902,1743716903.1616979,-18000,EB445137-D7F5-57EC-87DA-1DB460D64046,"iPhone13,2"
com.instructure.icanvas,1,1743716888,1743716889,1743716890.044714,-18000,EB445137-D7F5-57EC-87DA-1DB460D64046,"iPhone13,2"
com.instructure.icanvas,62,1743715336,1743715398,1743715399.1940222,-18000,EB445137-D7F5-57EC-87DA-1DB460D64046,"iPhone13,2"
com.google.chrome.ios,0,1743715336,1743715336,1743715336.6275492,-18000,EB445137-D7F5-57EC-87DA-1DB460D64046,"iPhone13,2"
com.google.chrome.ios,75,1743714758,1743714833,1743714833.600655,-18000,EB445137-D7F5-57EC-87DA-1DB460D64046,"iPhone13,2"
co.hinge.mobile.ios,4,1743714262,1743714266,1743714266.071039,-18000,EB445137-D7F5-57EC-87DA-1DB460D64046,"iPhone13,2"
co.hinge.mobile.ios,32,1743714223,1743714255,1743714255.54875,-18000,EB445137-D7F5-57EC-87DA-1DB460D64046,"iPhone13,2"
com.microsoft.Office.Outlook,6,1743712376,1743712382,1743712382.247998,-18000,EB445137-D7F5-57EC-87DA-1DB460D64046,"iPhone13,2"
com.google.chrome.ios,24,1743712351,1743712375,1743712375.183031,-18000,EB445137-D7F5-57EC-87DA-1DB460D64046,"iPhone13,2"
com.microsoft.Office.Outlook,15,1743712336,1743712351,1743712351.516048,-18000,EB445137-D7F5-57EC-87DA-1DB460D64046,"iPhone13,2"
com.google.Chrome,333,1743712126,1743712459,1743712459.938812,-18000,,
com.google.Chrome,381,1743711740,1743712121,1743712121.243626,-18000,,
com.google.Chrome,308,1743708730,1743709038,1743709038.991249,-18000,,
com.google.Chrome,1856,1743706873,1743708729,1743708729.5974379,-18000,,
com.leomehlig.today,1,1743706872,1743706873,1743706873.992488,-18000,,
com.google.Chrome,30,1743706842,1743706872,1743706872.766461,-18000,,
com.leomehlig.today,17,1743706825,1743706842,1743706842.7182422,-18000,,
com.google.Chrome,3,1743706822,1743706825,1743706825.3575912,-18000,,
com.apple.Passwords,3,1743706819,1743706822,1743706822.3588681,-18000,,
com.apple.news,82,1743706725,1743706807,1743706807.628557,-18000,EB445137-D7F5-57EC-87DA-1DB460D64046,"iPhone13,2"
com.google.Chrome,155,1743706664,1743706819,1743706819.5351272,-18000,,
com.apple.Passwords,8,1743706656,1743706664,1743706664.036648,-18000,,
com.google.Chrome,2,1743706654,1743706656,1743706656.632348,-18000,,
com.apple.news,102,1743706432,1743706534,1743706534.954689,-18000,EB445137-D7F5-57EC-87DA-1DB460D64046,"iPhone13,2"
com.apple.CoreAuthUI,2,1743706400,1743706402,1743706402.840801,-18000,EB445137-D7F5-57EC-87DA-1DB460D64046,"iPhone13,2"
com.clairmail.fth.client,42,1743706381,1743706423,1743706423.792172,-18000,EB445137-D7F5-57EC-87DA-1DB460D64046,"iPhone13,2"
com.apple.CoreAuthUI,3,1743705643,1743705646,1743705646.0505471,-18000,EB445137-D7F5-57EC-87DA-1DB460D64046,"iPhone13,2"
com.clairmail.fth.client,22,1743705639,1743705661,1743705661.894432,-18000,EB445137-D7F5-57EC-87DA-1DB460D64046,"iPhone13,2"
com.toyopagroup.picaboo,2,1743705635,1743705637,1743705638.00381,-18000,EB445137-D7F5-57EC-87DA-1DB460D64046,"iPhone13,2"
com.google.Chrome,3,1743705569,1743705572,1743705572.627524,-18000,,
com.toyopagroup.picaboo,13,1743705347,1743705360,1743705360.7633739,-18000,EB445137-D7F5-57EC-87DA-1DB460D64046,"iPhone13,2"
com.apple.MobileSMS,0,1743705347,1743705347,1743705348.134196,-18000,EB445137-D7F5-57EC-87DA-1DB460D64046,"iPhone13,2"
com.google.Chrome,394,1743705169,1743705563,1743705563.761945,-18000,,
com.microsoft.Outlook,35,1743705134,1743705169,1743705170.009985,-18000,,
com.google.Chrome,90,1743705044,1743705134,1743705134.6680279,-18000,,
com.apple.MobileSMS,76,1743705019,1743705095,1743705095.3744311,-18000,EB445137-D7F5-57EC-87DA-1DB460D64046,"iPhone13,2"
com.apple.weather,3,1743705016,1743705019,1743705019.316931,-18000,EB445137-D7F5-57EC-87DA-1DB460D64046,"iPhone13,2"
com.toyopagroup.picaboo,3,1743705007,1743705010,1743705010.513432,-18000,EB445137-D7F5-57EC-87DA-1DB460D64046,"iPhone13,2"
com.apple.MobileSMS,4,1743705000,1743705004,1743705004.591663,-18000,EB445137-D7F5-57EC-87DA-1DB460D64046,"iPhone13,2"
net.kortina.labs.Venmo,43,1743704950,1743704993,1743704993.822177,-18000,EB445137-D7F5-57EC-87DA-1DB460D64046,"iPhone13,2"
com.toyopagroup.picaboo,32,1743704913,1743704945,1743704945.856317,-18000,EB445137-D7F5-57EC-87DA-1DB460D64046,"iPhone13,2"
com.apple.MobileSMS,5,1743704908,1743704913,1743704913.678365,-18000,EB445137-D7F5-57EC-87DA-1DB460D64046,"iPhone13,2"
net.kortina.labs.Venmo,4,1743704904,1743704908,1743704909.091269,-18000,EB445137-D7F5-57EC-87DA-1DB460D64046,"iPhone13,2"
com.apple.MobileSMS,3,1743704901,1743704904,1743704904.575817,-18000,EB445137-D7F5-57EC-87DA-1DB460D64046,"iPhone13,2"
net.kortina.labs.Venmo,27,1743704874,1743704901,1743704901.733849,-18000,EB445137-D7F5-57EC-87DA-1DB460D64046,"iPhone13,2"
com.clairmail.fth.client,1,1743704868,1743704869,1743704869.734181,-18000,EB445137-D7F5-57EC-87DA-1DB460D64046,"iPhone13,2"
com.toyopagroup.picaboo,8,1743704860,1743704868,1743704868.568056,-18000,EB445137-D7F5-57EC-87DA-1DB460D64046,"iPhone13,2"
com.apple.MobileSMS,16,1743704841,1743704857,1743704857.5643458,-18000,EB445137-D7F5-57EC-87DA-1DB460D64046,"iPhone13,2"
com.apple.iCal,212,1743704832,1743705044,1743705044.196805,-18000,,
com.apple.MobileSMS,55,1743704776,1743704831,1743704831.613991,-18000,EB445137-D7F5-57EC-87DA-1DB460D64046,"iPhone13,2"
com.apple.calculator,42,1743704733,1743704775,1743704776.069535,-18000,EB445137-D7F5-57EC-87DA-1DB460D64046,"iPhone13,2"
com.clairmail.fth.client,9,1743704724,1743704733,1743704733.163831,-18000,EB445137-D7F5-57EC-87DA-1DB460D64046,"iPhone13,2"
com.apple.MobileSMS,2,1743704716,1743704718,1743704718.36604,-18000,EB445137-D7F5-57EC-87DA-1DB460D64046,"iPhone13,2"
com.apple.CoreAuthUI,1,1743704703,1743704704,1743704705.018825,-18000,EB445137-D7F5-57EC-87DA-1DB460D64046,"iPhone13,2"
com.clairmail.fth.client,18,1743704698,1743704716,1743704716.1559548,-18000,EB445137-D7F5-57EC-87DA-1DB460D64046,"iPhone13,2"
com.apple.MobileSMS,5,1743704684,1743704689,1743704689.864901,-18000,EB445137-D7F5-57EC-87DA-1DB460D64046,"iPhone13,2"
com.tinyspeck.chatlyio,9,1743704675,1743704684,1743704684.5365372,-18000,EB445137-D7F5-57EC-87DA-1DB460D64046,"iPhone13,2"
com.apple.MobileSMS,28,1743704646,1743704674,1743704674.975267,-18000,EB445137-D7F5-57EC-87DA-1DB460D64046,"iPhone13,2"
com.apple.mobilephone,0,1743704646,1743704646,1743704647.089869,-18000,EB445137-D7F5-57EC-87DA-1DB460D64046,"iPhone13,2"
com.apple.mobilephone,1,1743704645,1743704646,1743704646.304537,-18000,EB445137-D7F5-57EC-87DA-1DB460D64046,"iPhone13,2"
com.apple.mobilephone,3,1743704626,1743704629,1743704630.008978,-18000,EB445137-D7F5-57EC-87DA-1DB460D64046,"iPhone13,2"
com.apple.InCallService,1,1743704625,1743704626,1743704626.938174,-18000,EB445137-D7F5-57EC-87DA-1DB460D64046,"iPhone13,2"
com.google.Chrome,221,1743704611,1743704832,1743704832.662328,-18000,,
com.microsoft.Outlook,9,1743704602,1743704611,1743704611.1423059,-18000,,
com.apple.InCallService,2,1743704443,1743704445,1743704445.992999,-18000,EB445137-D7F5-57EC-87DA-1DB460D64046,"iPhone13,2"
com.apple.InCallService,3,1743704294,1743704297,1743704297.876673,-18000,EB445137-D7F5-57EC-87DA-1DB460D64046,"iPhone13,2"
com.apple.InCallService,2,1743704283,1743704285,1743704285.554627,-18000,EB445137-D7F5-57EC-87DA-1DB460D64046,"iPhone13,2"
com.apple.mobilephone,13,1743704270,1743704283,1743704283.847765,-18000,EB445137-D7F5-57EC-87DA-1DB460D64046,"iPhone13,2"
com.google.chrome.ios,2,1743704268,1743704270,1743704270.6518478,-18000,EB445137-D7F5-57EC-87DA-1DB460D64046,"iPhone13,2"
com.google.Chrome,420,1743704182,1743704602,1743704602.304138,-18000,,
com.google.chrome.ios,287,1743703951,1743704238,1743704238.8371038,-18000,EB445137-D7F5-57EC-87DA-1DB460D64046,"iPhone13,2"
com.toyopagroup.picaboo,2,1743703245,1743703247,1743703248.0762439,-18000,EB445137-D7F5-57EC-87DA-1DB460D64046,"iPhone13,2"
com.toyopagroup.picaboo,55,1743703096,1743703151,1743703151.945652,-18000,EB445137-D7F5-57EC-87DA-1DB460D64046,"iPhone13,2"
com.apple.MobileSMS,2,1743703093,1743703095,1743703095.4281502,-18000,EB445137-D7F5-57EC-87DA-1DB460D64046,"iPhone13,2"
com.apple.MobileSMS,12,1743703064,1743703076,1743703077.511663,-18000,EB445137-D7F5-57EC-87DA-1DB460D64046,"iPhone13,2"
com.apple.MobileSMS,71,1743702990,1743703061,1743703061.282454,-18000,EB445137-D7F5-57EC-87DA-1DB460D64046,"iPhone13,2"
com.apple.MobileSMS,173,1743702617,1743702790,1743702790.1172519,-18000,EB445137-D7F5-57EC-87DA-1DB460D64046,"iPhone13,2"
com.google.chrome.ios,3,1743702614,1743702617,1743702617.747161,-18000,EB445137-D7F5-57EC-87DA-1DB460D64046,"iPhone13,2"
com.apple.MobileSMS,40,1743702574,1743702614,1743702614.469528,-18000,EB445137-D7F5-57EC-87DA-1DB460D64046,"iPhone13,2"
com.google.chrome.ios,26,1743702548,1743702574,1743702574.683634,-18000,EB445137-D7F5-57EC-87DA-1DB460D64046,"iPhone13,2"
com.apple.calculator,9,1743702539,1743702548,1743702548.314834,-18000,EB445137-D7F5-57EC-87DA-1DB460D64046,"iPhone13,2"
com.google.chrome.ios,30,1743702509,1743702539,1743702539.6973948,-18000,EB445137-D7F5-57EC-87DA-1DB460D64046,"iPhone13,2"
com.apple.calculator,8,1743702501,1743702509,1743702509.953032,-18000,EB445137-D7F5-57EC-87DA-1DB460D64046,"iPhone13,2"
com.google.chrome.ios,79,1743702422,1743702501,1743702501.351464,-18000,EB445137-D7F5-57EC-87DA-1DB460D64046,"iPhone13,2"
com.apple.weather,2,1743702420,1743702422,1743702423.028068,-18000,EB445137-D7F5-57EC-87DA-1DB460D64046,"iPhone13,2"
com.apple.weather,11,1743699373,1743699384,1743699384.81115,-18000,EB445137-D7F5-57EC-87DA-1DB460D64046,"iPhone13,2"
com.apple.Preferences,42,1743699177,1743699219,1743699220.0122151,-18000,EB445137-D7F5-57EC-87DA-1DB460D64046,"iPhone13,2"
com.google.Chrome,471,1743698775,1743699246,1743699246.371766,-18000,,
com.google.Chrome,396,1743698323,1743698719,1743698719.1878572,-18000,,
com.google.Chrome,22,1743697924,1743697946,1743697946.836382,-18000,,
com.leomehlig.today,4,1743697920,1743697924,1743697924.960122,-18000,,
com.google.Chrome,367,1743697553,1743697920,1743697920.333291,-18000,,
com.apple.iCal,25,1743697528,1743697553,1743697553.725193,-18000,,
com.microsoft.Office.Outlook,105,1743697123,1743697228,1743697228.7095299,-18000,EB445137-D7F5-57EC-87DA-1DB460D64046,"iPhone13,2"
com.apple.news,1,1743697122,1743697123,1743697124.044198,-18000,EB445137-D7F5-57EC-87DA-1DB460D64046,"iPhone13,2"
com.google.Chrome,1434,1743696094,1743697528,1743697528.368967,-18000,,
com.apple.finder,4,1743696090,1743696094,1743696094.125696,-18000,,
com.leomehlig.today,0,1743696090,1743696090,1743696090.640743,-18000,,
com.apple.finder,28,1743696062,1743696090,1743696090.260232,-18000,,
com.leomehlig.today,8,1743696054,1743696062,1743696062.8361778,-18000,,
com.apple.finder,5,1743696049,1743696054,1743696054.52054,-18000,,
com.google.Chrome,3,1743696046,1743696049,1743696049.765641,-18000,,
com.microsoft.VSCode,3,1743696043,1743696046,1743696046.9945312,-18000,,
com.google.Chrome,3,1743696040,1743696043,1743696044.022213,-18000,,
com.leomehlig.today,1,1743696039,1743696040,1743696040.5655751,-18000,,
com.google.Chrome,49,1743695990,1743696039,1743696039.5310678,-18000,,
com.microsoft.VSCode,23,1743695967,1743695990,1743695990.659025,-18000,,
com.apple.finder,2,1743695965,1743695967,1743695967.529306,-18000,,
com.google.Chrome,6,1743695959,1743695965,1743695965.771982,-18000,,
com.leomehlig.today,3,1743695947,1743695950,1743695950.7225308,-18000,,
com.google.Chrome,4,1743695943,1743695947,1743695947.421932,-18000,,
com.apple.Notes,13,1743695930,1743695943,1743695944.060392,-18000,,
com.google.Chrome,1,1743695929,1743695930,1743695930.052619,-18000,,
com.apple.Notes,1,1743695928,1743695929,1743695929.689029,-18000,,
com.google.Chrome,2,1743695926,1743695928,1743695928.246686,-18000,,
com.apple.Notes,5,1743695921,1743695926,1743695926.51434,-18000,,
com.google.Chrome,1,1743695920,1743695921,1743695921.1381269,-18000,,
com.apple.Notes,13,1743695907,1743695920,1743695920.556498,-18000,,
com.google.Chrome,11,1743695896,1743695907,1743695907.770767,-18000,,
com.electron.carta,4,1743695892,1743695896,1743695896.308693,-18000,,
com.google.Chrome,6,1743695886,1743695892,1743695892.714994,-18000,,
com.apple.Notes,0,1743695886,1743695886,1743695886.978149,-18000,,
com.google.Chrome,7,1743695879,1743695886,1743695886.2487001,-18000,,
com.apple.Notes,8,1743695871,1743695879,1743695879.20746,-18000,,
com.electron.carta,63,1743695808,1743695871,1743695871.603544,-18000,,
com.google.Chrome,5,1743695803,1743695808,1743695808.2803621,-18000,,
com.apple.Notes,10,1743695793,1743695803,1743695803.08857,-18000,,
com.electron.carta,45,1743695748,1743695793,1743695793.9624481,-18000,,
com.apple.Notes,33,1743695715,1743695748,1743695748.552133,-18000,,
com.electron.carta,81,1743695634,1743695715,1743695715.8310099,-18000,,
com.apple.finder,19,1743695615,1743695634,1743695634.330832,-18000,,
com.electron.carta,39,1743695576,1743695615,1743695615.354943,-18000,,
com.google.Chrome,8,1743695568,1743695576,1743695576.722626,-18000,,
com.electron.carta,4,1743695564,1743695568,1743695569.002657,-18000,,
com.apple.Notes,14,1743695550,1743695564,1743695564.579544,-18000,,
com.electron.carta,34,1743695516,1743695550,1743695550.560742,-18000,,
com.google.Chrome,2,1743695514,1743695516,1743695516.382959,-18000,,
com.electron.carta,2,1743695512,1743695514,1743695514.107878,-18000,,
com.apple.finder,13,1743695499,1743695512,1743695512.571465,-18000,,
com.electron.carta,51,1743695448,1743695499,1743695499.803895,-18000,,
com.google.Chrome,19,1743695429,1743695448,1743695448.4477282,-18000,,
com.apple.Notes,7,1743695422,1743695429,1743695430.0854092,-18000,,
com.electron.carta,24,1743695398,1743695422,1743695422.854003,-18000,,
com.apple.Notes,3,1743695395,1743695398,1743695398.1562781,-18000,,
com.electron.carta,5,1743695390,1743695395,1743695395.093157,-18000,,
com.apple.Notes,19,1743695371,1743695390,1743695390.8925,-18000,,
com.google.Chrome,7,1743695364,1743695371,1743695371.960744,-18000,,
com.electron.carta,37,1743695327,1743695364,1743695364.744204,-18000,,
com.apple.finder,10,1743695317,1743695327,1743695327.615212,-18000,,
com.electron.carta,84,1743695233,1743695317,1743695317.6055079,-18000,,
com.google.Chrome,16,1743695217,1743695233,1743695233.4773579,-18000,,
com.apple.finder,97,1743695103,1743695200,1743695200.0973148,-18000,,
com.google.Chrome,16,1743695087,1743695103,1743695103.791304,-18000,,
com.apple.finder,22,1743695065,1743695087,1743695087.723872,-18000,,
com.google.Chrome,31,1743695034,1743695065,1743695065.75008,-18000,,
com.microsoft.VSCode,40,1743694994,1743695034,1743695034.668795,-18000,,
com.apple.finder,151,1743694843,1743694994,1743694994.787179,-18000,,
com.apple.news,90,1743694753,1743694843,1743694843.601001,-18000,EB445137-D7F5-57EC-87DA-1DB460D64046,"iPhone13,2"
com.microsoft.VSCode,1083,1743693760,1743694843,1743694843.7776399,-18000,,
com.google.Chrome,1,1743693759,1743693760,1743693760.3559241,-18000,,
com.apple.news,118,1743693235,1743693353,1743693354.3308601,-18000,EB445137-D7F5-57EC-87DA-1DB460D64046,"iPhone13,2"
com.google.chrome.ios,3,1743693225,1743693228,1743693228.500195,-18000,EB445137-D7F5-57EC-87DA-1DB460D64046,"iPhone13,2"
com.google.chrome.ios,13,1743692997,1743693010,1743693011.405459,-18000,EB445137-D7F5-57EC-87DA-1DB460D64046,"iPhone13,2"
com.microsoft.Office.Outlook,39,1743692958,1743692997,1743692998.0338159,-18000,EB445137-D7F5-57EC-87DA-1DB460D64046,"iPhone13,2"
com.microsoft.Office.Outlook,11,1743692944,1743692955,1743692956.441215,-18000,EB445137-D7F5-57EC-87DA-1DB460D64046,"iPhone13,2"
com.microsoft.VSCode,1110,1743692649,1743693759,1743693759.559248,-18000,,
com.apple.news,72,1743692383,1743692455,1743692456.06088,-18000,EB445137-D7F5-57EC-87DA-1DB460D64046,"iPhone13,2"
co.hinge.mobile.ios,65,1743692292,1743692357,1743692357.952174,-18000,EB445137-D7F5-57EC-87DA-1DB460D64046,"iPhone13,2"
com.microsoft.VSCode,590,1743691976,1743692566,1743692566.775085,-18000,,
com.google.Chrome,3,1743691973,1743691976,1743691976.539125,-18000,,
com.microsoft.VSCode,22,1743691951,1743691973,1743691973.578909,-18000,,
com.google.Chrome,2,1743691949,1743691951,1743691951.269172,-18000,,
com.microsoft.VSCode,3,1743691946,1743691949,1743691949.980614,-18000,,
com.google.Chrome,9,1743691937,1743691946,1743691946.687238,-18000,,
com.microsoft.VSCode,20,1743691917,1743691937,1743691937.644751,-18000,,
com.google.Chrome,26,1743691891,1743691917,1743691917.547447,-18000,,
com.microsoft.VSCode,378,1743691513,1743691891,1743691891.255639,-18000,,
com.leomehlig.today,2,1743691511,1743691513,1743691514.074154,-18000,,
com.leomehlig.today,471,1743690273,1743690744,1743690744.44329,-18000,,
com.microsoft.VSCode,47,1743690226,1743690273,1743690273.520158,-18000,,
com.google.Chrome,30,1743690196,1743690226,1743690226.383287,-18000,,
com.microsoft.VSCode,1738,1743688458,1743690196,1743690196.8120131,-18000,,
com.apple.finder,41,1743688417,1743688458,1743688458.238857,-18000,,
com.microsoft.VSCode,8,1743688409,1743688417,1743688417.082989,-18000,,
com.apple.news,6,1743688282,1743688288,1743688288.3456511,-18000,EB445137-D7F5-57EC-87DA-1DB460D64046,"iPhone13,2"
com.microsoft.VSCode,85,1743688186,1743688271,1743688272.4777021,-18000,,
com.apple.finder,2,1743688184,1743688186,1743688186.800743,-18000,,
com.microsoft.VSCode,615,1743687569,1743688184,1743688184.14694,-18000,,
com.apple.finder,11,1743687558,1743687569,1743687569.571873,-18000,,
com.microsoft.VSCode,285,1743687273,1743687558,1743687558.622137,-18000,,
com.google.Chrome,4,1743687269,1743687273,1743687273.7070022,-18000,,
com.electron.carta,7,1743687262,1743687269,1743687269.7172499,-18000,,
com.google.Chrome,81,1743687181,1743687262,1743687262.060235,-18000,,
com.apple.Notes,33,1743687148,1743687181,1743687181.32344,-18000,,
com.microsoft.VSCode,29,1743687119,1743687148,1743687148.9110389,-18000,,
com.google.Chrome,5,1743687114,1743687119,1743687119.825107,-18000,,
com.apple.Notes,31,1743687083,1743687114,1743687114.839336,-18000,,
com.google.Chrome,62,1743687021,1743687083,1743687083.8150501,-18000,,
com.apple.news,261,1743686757,1743687018,1743687019.658678,-18000,EB445137-D7F5-57EC-87DA-1DB460D64046,"iPhone13,2"
com.hammerandchisel.discord,156,1743686581,1743686737,1743686738.014507,-18000,EB445137-D7F5-57EC-87DA-1DB460D64046,"iPhone13,2"
com.apple.weather,34,1743686547,1743686581,1743686581.271708,-18000,EB445137-D7F5-57EC-87DA-1DB460D64046,"iPhone13,2"
com.apple.Health,13,1743686530,1743686543,1743686543.941728,-18000,EB445137-D7F5-57EC-87DA-1DB460D64046,"iPhone13,2"
com.renpho.health,0,1743686530,1743686530,1743686530.892809,-18000,EB445137-D7F5-57EC-87DA-1DB460D64046,"iPhone13,2"
com.renpho.health,46,1743685452,1743685498,1743685499.212696,-18000,EB445137-D7F5-57EC-87DA-1DB460D64046,"iPhone13,2"
com.google.chrome.ios,24,1743684526,1743684550,1743684550.4077082,-18000,EB445137-D7F5-57EC-87DA-1DB460D64046,"iPhone13,2"
com.microsoft.Office.Outlook,60,1743684466,1743684526,1743684526.949644,-18000,EB445137-D7F5-57EC-87DA-1DB460D64046,"iPhone13,2"
com.apple.Health,63,1743684132,1743684195,1743684195.376224,-18000,EB445137-D7F5-57EC-87DA-1DB460D64046,"iPhone13,2"
com.google.Chrome,6,1743647673,1743647679,1743647679.25944,-18000,,
com.apple.MobileSMS,4,1743647669,1743647673,1743647673.191893,-18000,,
com.google.Chrome,14,1743647655,1743647669,1743647669.0825958,-18000,,
com.leomehlig.today,23,1743647632,1743647655,1743647655.527252,-18000,,
com.google.Chrome,16,1743647616,1743647632,1743647632.7719522,-18000,,
com.leomehlig.today,27,1743647589,1743647616,1743647616.506408,-18000,,
com.google.Chrome,29,1743647560,1743647589,1743647589.253128,-18000,,
com.apple.finder,2,1743647541,1743647543,1743647543.844802,-18000,,
com.leomehlig.today,105,1743647436,1743647541,1743647541.892298,-18000,,
com.apple.finder,5,1743647431,1743647436,1743647436.34425,-18000,,
com.letterboxd.LetterboxdApp,76,1743646234,1743646310,1743646310.296447,-18000,EB445137-D7F5-57EC-87DA-1DB460D64046,"iPhone13,2"
com.google.chrome.ios,2,1743646232,1743646234,1743646234.499092,-18000,EB445137-D7F5-57EC-87DA-1DB460D64046,"iPhone13,2"
com.google.chrome.ios,33,1743645460,1743645493,1743645493.8575401,-18000,EB445137-D7F5-57EC-87DA-1DB460D64046,"iPhone13,2"
com.google.chrome.ios,58,1743645046,1743645104,1743645105.16797,-18000,EB445137-D7F5-57EC-87DA-1DB460D64046,"iPhone13,2"
com.google.chrome.ios,57,1743644288,1743644345,1743644345.526555,-18000,EB445137-D7F5-57EC-87DA-1DB460D64046,"iPhone13,2"
com.google.chrome.ios,59,1743643600,1743643659,1743643660.7222838,-18000,EB445137-D7F5-57EC-87DA-1DB460D64046,"iPhone13,2"
com.google.chrome.ios,89,1743643159,1743643248,1743643248.540525,-18000,EB445137-D7F5-57EC-87DA-1DB460D64046,"iPhone13,2"
com.google.chrome.ios,82,1743642805,1743642887,1743642888.411423,-18000,EB445137-D7F5-57EC-87DA-1DB460D64046,"iPhone13,2"
com.hammerandchisel.discord,1,1743642804,1743642805,1743642806.12254,-18000,EB445137-D7F5-57EC-87DA-1DB460D64046,"iPhone13,2"
com.hammerandchisel.discord,42,1743641410,1743641452,1743641452.964416,-18000,EB445137-D7F5-57EC-87DA-1DB460D64046,"iPhone13,2"
com.microsoft.Office.Outlook,7,1743638944,1743638951,1743638951.4880729,-18000,EB445137-D7F5-57EC-87DA-1DB460D64046,"iPhone13,2"
com.apple.weather,7,1743638936,1743638943,1743638943.2274032,-18000,EB445137-D7F5-57EC-87DA-1DB460D64046,"iPhone13,2"
com.apple.weather,37,1743638211,1743638248,1743638249.464077,-18000,EB445137-D7F5-57EC-87DA-1DB460D64046,"iPhone13,2"
com.apple.MobileSMS,1,1743638210,1743638211,1743638211.9932961,-18000,EB445137-D7F5-57EC-87DA-1DB460D64046,"iPhone13,2"
com.apple.MobileSMS,2,1743637624,1743637626,1743637626.486139,-18000,EB445137-D7F5-57EC-87DA-1DB460D64046,"iPhone13,2"
com.apple.MobileSMS,6,1743637353,1743637359,1743637359.831568,-18000,EB445137-D7F5-57EC-87DA-1DB460D64046,"iPhone13,2"
com.google.chrome.ios,19,1743637333,1743637352,1743637352.781251,-18000,EB445137-D7F5-57EC-87DA-1DB460D64046,"iPhone13,2"
com.apple.MobileSMS,24,1743637296,1743637320,1743637321.1763492,-18000,EB445137-D7F5-57EC-87DA-1DB460D64046,"iPhone13,2"
com.apple.news,2,1743634530,1743634532,1743634532.7927299,-18000,EB445137-D7F5-57EC-87DA-1DB460D64046,"iPhone13,2"
com.apple.finder,313,1743634502,1743634815,1743634815.151524,-18000,,
com.apple.Music,3,1743634499,1743634502,1743634502.570677,-18000,,
com.apple.finder,3,1743634496,1743634499,1743634499.426887,-18000,,
com.jinzhenyu.ruler,1,1743634495,1743634496,1743634496.532778,-18000,,
com.apple.news,12,1743634365,1743634377,1743634378.526588,-18000,EB445137-D7F5-57EC-87DA-1DB460D64046,"iPhone13,2"
com.apple.weather,40,1743634317,1743634357,1743634357.411999,-18000,EB445137-D7F5-57EC-87DA-1DB460D64046,"iPhone13,2"
com.electron.carta,243,1743634252,1743634495,1743634496.008481,-18000,,
com.jinzhenyu.ruler,1,1743634251,1743634252,1743634252.9643478,-18000,,
com.electron.carta,27,1743634224,1743634251,1743634251.937372,-18000,,
com.apple.finder,19,1743634205,1743634224,1743634224.121588,-18000,,
com.google.Chrome,9,1743634196,1743634205,1743634205.59592,-18000,,
com.apple.finder,18,1743634178,1743634196,1743634196.274081,-18000,,
com.google.Chrome,17,1743634161,1743634178,1743634178.6401129,-18000,,
com.apple.finder,0,1743634161,1743634161,1743634161.818561,-18000,,
com.google.Chrome,14,1743634147,1743634161,1743634161.2814841,-18000,,
com.apple.finder,4,1743634143,1743634147,1743634147.07303,-18000,,
com.google.Chrome,1,1743634142,1743634143,1743634143.621274,-18000,,
com.electron.carta,1,1743634141,1743634142,1743634142.822567,-18000,,
com.google.Chrome,10,1743634131,1743634141,1743634141.4447498,-18000,,
com.electron.carta,8,1743634123,1743634131,1743634131.833843,-18000,,
com.jinzhenyu.ruler,3,1743634120,1743634123,1743634123.515866,-18000,,
com.electron.carta,243,1743633877,1743634120,1743634120.613843,-18000,,
com.jinzhenyu.ruler,1,1743633876,1743633877,1743633877.2190151,-18000,,
com.electron.carta,7,1743633869,1743633876,1743633876.2234101,-18000,,
com.apple.finder,24,1743633845,1743633869,1743633869.4132152,-18000,,
com.google.Chrome,2,1743633843,1743633845,1743633845.327954,-18000,,
com.apple.finder,17,1743633826,1743633843,1743633843.644083,-18000,,
com.google.Chrome,13,1743633813,1743633826,1743633826.380622,-18000,,
com.apple.finder,35,1743633778,1743633813,1743633813.2647219,-18000,,
com.apple.Preview,1,1743633777,1743633778,1743633778.61834,-18000,,
com.google.Chrome,36,1743633741,1743633777,1743633777.75137,-18000,,
com.jinzhenyu.ruler,7,1743633734,1743633741,1743633741.0595531,-18000,,
com.google.Chrome,4,1743633730,1743633734,1743633734.206295,-18000,,
com.jinzhenyu.ruler,22,1743633708,1743633730,1743633730.3255038,-18000,,
com.electron.carta,2,1743633706,1743633708,1743633708.3057241,-18000,,
com.jinzhenyu.ruler,2,1743633704,1743633706,1743633706.769638,-18000,,
com.electron.carta,96,1743633608,1743633704,1743633704.1624641,-18000,,
com.apple.Preview,7,1743633601,1743633608,1743633608.960806,-18000,,
com.apple.finder,16,1743633585,1743633601,1743633601.9499779,-18000,,
com.electron.carta,45,1743633540,1743633585,1743633585.910012,-18000,,
com.jinzhenyu.ruler,2,1743633538,1743633540,1743633540.702599,-18000,,
com.electron.carta,8,1743633530,1743633538,1743633538.791782,-18000,,
com.jinzhenyu.ruler,27,1743633503,1743633530,1743633530.265291,-18000,,
com.electron.carta,5,1743633498,1743633503,1743633503.930725,-18000,,
com.jinzhenyu.ruler,2,1743633496,1743633498,1743633498.6785579,-18000,,
com.electron.carta,2,1743633494,1743633496,1743633496.5907059,-18000,,
com.jinzhenyu.ruler,1,1743633493,1743633494,1743633494.7766109,-18000,,
com.electron.carta,4,1743633489,1743633493,1743633493.440901,-18000,,
com.jinzhenyu.ruler,1,1743633488,1743633489,1743633489.173456,-18000,,
com.electron.carta,0,1743633488,1743633488,1743633488.2993279,-18000,,
com.jinzhenyu.ruler,0,1743633488,1743633488,1743633488.245501,-18000,,
com.electron.carta,3,1743633485,1743633488,1743633488.191864,-18000,,
com.jinzhenyu.ruler,1,1743633484,1743633485,1743633485.897419,-18000,,
com.electron.carta,75,1743633409,1743633484,1743633484.936775,-18000,,
com.jinzhenyu.ruler,8,1743633401,1743633409,1743633409.950037,-18000,,
com.electron.carta,2,1743633399,1743633401,1743633401.3471441,-18000,,
com.google.Chrome,15,1743633384,1743633399,1743633399.022929,-18000,,
com.electron.carta,48,1743633336,1743633384,1743633384.477282,-18000,,
com.apple.Music,13,1743633323,1743633336,1743633336.498651,-18000,,
com.electron.carta,18,1743633305,1743633323,1743633323.424347,-18000,,
com.apple.finder,59,1743633246,1743633305,1743633305.5990381,-18000,,
com.electron.carta,58,1743633188,1743633246,1743633246.4502301,-18000,,
com.google.Chrome,62,1743633126,1743633188,1743633188.1151118,-18000,,
com.apple.weather,6,1743632920,1743632926,1743632926.5492249,-18000,EB445137-D7F5-57EC-87DA-1DB460D64046,"iPhone13,2"
com.thestorygraph.thestorygraph,27,1743632893,1743632920,1743632920.475631,-18000,EB445137-D7F5-57EC-87DA-1DB460D64046,"iPhone13,2"
com.apple.weather,3,1743632888,1743632891,1743632891.231555,-18000,EB445137-D7F5-57EC-87DA-1DB460D64046,"iPhone13,2"
com.apple.weather,43,1743631231,1743631274,1743631274.437101,-18000,EB445137-D7F5-57EC-87DA-1DB460D64046,"iPhone13,2"
com.apple.MobileSMS,4,1743631227,1743631231,1743631231.337275,-18000,EB445137-D7F5-57EC-87DA-1DB460D64046,"iPhone13,2"
com.apple.weather,0,1743631227,1743631227,1743631228.215308,-18000,EB445137-D7F5-57EC-87DA-1DB460D64046,"iPhone13,2"
com.apple.weather,5,1743631222,1743631227,1743631227.134098,-18000,EB445137-D7F5-57EC-87DA-1DB460D64046,"iPhone13,2"
com.apple.weather,9,1743630705,1743630714,1743630715.115573,-18000,EB445137-D7F5-57EC-87DA-1DB460D64046,"iPhone13,2"
com.apple.weather,12,1743630408,1743630420,1743630420.364279,-18000,EB445137-D7F5-57EC-87DA-1DB460D64046,"iPhone13,2"
com.google.Gmail,10,1743630397,1743630407,1743630407.094325,-18000,EB445137-D7F5-57EC-87DA-1DB460D64046,"iPhone13,2"
com.apple.weather,0,1743630397,1743630397,1743630398.032597,-18000,EB445137-D7F5-57EC-87DA-1DB460D64046,"iPhone13,2"
com.apple.weather,4,1743629783,1743629787,1743629787.291358,-18000,EB445137-D7F5-57EC-87DA-1DB460D64046,"iPhone13,2"
com.microsoft.Office.Outlook,5,1743629776,1743629781,1743629781.409512,-18000,EB445137-D7F5-57EC-87DA-1DB460D64046,"iPhone13,2"
com.apple.weather,0,1743629776,1743629776,1743629777.818181,-18000,EB445137-D7F5-57EC-87DA-1DB460D64046,"iPhone13,2"
com.apple.weather,7,1743629673,1743629680,1743629680.3133202,-18000,EB445137-D7F5-57EC-87DA-1DB460D64046,"iPhone13,2"
com.apple.MobileSMS,11,1743629661,1743629672,1743629672.9179502,-18000,EB445137-D7F5-57EC-87DA-1DB460D64046,"iPhone13,2"
com.apple.weather,0,1743629661,1743629661,1743629662.032125,-18000,EB445137-D7F5-57EC-87DA-1DB460D64046,"iPhone13,2"
com.apple.weather,13,1743629646,1743629659,1743629659.835607,-18000,EB445137-D7F5-57EC-87DA-1DB460D64046,"iPhone13,2"
com.apple.weather,2,1743629641,1743629643,1743629643.266041,-18000,EB445137-D7F5-57EC-87DA-1DB460D64046,"iPhone13,2"
com.apple.weather,5,1743629500,1743629505,1743629506.101976,-18000,EB445137-D7F5-57EC-87DA-1DB460D64046,"iPhone13,2"
com.apple.weather,5,1743628892,1743628897,1743628898.287255,-18000,EB445137-D7F5-57EC-87DA-1DB460D64046,"iPhone13,2"
com.apple.weather,57,1743628209,1743628266,1743628267.3423529,-18000,EB445137-D7F5-57EC-87DA-1DB460D64046,"iPhone13,2"
com.google.chrome.ios,1,1743628208,1743628209,1743628209.8976932,-18000,EB445137-D7F5-57EC-87DA-1DB460D64046,"iPhone13,2"
com.google.chrome.ios,25,1743627599,1743627624,1743627624.804429,-18000,EB445137-D7F5-57EC-87DA-1DB460D64046,"iPhone13,2"
Astrospheric.Astrospheric,19,1743627580,1743627599,1743627599.581019,-18000,EB445137-D7F5-57EC-87DA-1DB460D64046,"iPhone13,2"
com.microsoft.Office.Outlook,12,1743627527,1743627539,1743627539.584166,-18000,EB445137-D7F5-57EC-87DA-1DB460D64046,"iPhone13,2"
com.apple.weather,28,1743627477,1743627505,1743627505.454834,-18000,EB445137-D7F5-57EC-87DA-1DB460D64046,"iPhone13,2"
com.google.Chrome,2,1743627270,1743627272,1743627272.510627,-18000,,
com.apple.finder,1,1743627269,1743627270,1743627270.906605,-18000,,
com.microsoft.VSCode,3,1743627266,1743627269,1743627269.647927,-18000,,
com.apple.finder,5,1743627261,1743627266,1743627266.852359,-18000,,
com.leomehlig.today,13,1743627248,1743627261,1743627261.52063,-18000,,
com.google.Chrome,256,1743626992,1743627248,1743627248.866915,-18000,,
com.leomehlig.today,15,1743626831,1743626846,1743626846.8527188,-18000,,
com.google.Chrome,38,1743626793,1743626831,1743626831.775422,-18000,,
com.apple.finder,27,1743626766,1743626793,1743626793.736217,-18000,,
com.google.Chrome,539,1743626227,1743626766,1743626766.221888,-18000,,
com.apple.finder,72,1743626155,1743626227,1743626227.0717921,-18000,,
com.google.Chrome,319,1743625836,1743626155,1743626155.61139,-18000,,
com.microsoft.VSCode,2,1743625834,1743625836,1743625838.521357,-18000,,
com.apple.weather,9,1743625700,1743625709,1743625709.718416,-18000,EB445137-D7F5-57EC-87DA-1DB460D64046,"iPhone13,2"
com.apple.MobileSMS,4,1743625085,1743625089,1743625089.179442,-18000,EB445137-D7F5-57EC-87DA-1DB460D64046,"iPhone13,2"
com.apple.weather,3,1743625081,1743625084,1743625084.658667,-18000,EB445137-D7F5-57EC-87DA-1DB460D64046,"iPhone13,2"
com.apple.weather,19,1743623777,1743623796,1743623796.088293,-18000,EB445137-D7F5-57EC-87DA-1DB460D64046,"iPhone13,2"
com.apple.PosterBoard,0,1743623777,1743623777,1743623777.987901,-18000,EB445137-D7F5-57EC-87DA-1DB460D64046,"iPhone13,2"
com.apple.weather,6,1743623767,1743623773,1743623774.446599,-18000,EB445137-D7F5-57EC-87DA-1DB460D64046,"iPhone13,2"
com.apple.news,1,1743623766,1743623767,1743623767.93223,-18000,EB445137-D7F5-57EC-87DA-1DB460D64046,"iPhone13,2"
com.apple.news,128,1743620426,1743620554,1743620554.213963,-18000,EB445137-D7F5-57EC-87DA-1DB460D64046,"iPhone13,2"
com.apple.news,375,1743620001,1743620376,1743620378.394728,-18000,EB445137-D7F5-57EC-87DA-1DB460D64046,"iPhone13,2"
com.microsoft.Office.Outlook,37,1743619954,1743619991,1743619991.655531,-18000,EB445137-D7F5-57EC-87DA-1DB460D64046,"iPhone13,2"
com.apple.weather,59,1743619891,1743619950,1743619950.281824,-18000,EB445137-D7F5-57EC-87DA-1DB460D64046,"iPhone13,2"
com.apple.weather,11,1743619795,1743619806,1743619807.000844,-18000,EB445137-D7F5-57EC-87DA-1DB460D64046,"iPhone13,2"
com.apple.mobilecal,1,1743619794,1743619795,1743619795.9783502,-18000,EB445137-D7F5-57EC-87DA-1DB460D64046,"iPhone13,2"
com.apple.mobilecal,7,1743619766,1743619773,1743619773.494646,-18000,EB445137-D7F5-57EC-87DA-1DB460D64046,"iPhone13,2"
com.apple.mobilecal,6,1743619665,1743619671,1743619672.183969,-18000,EB445137-D7F5-57EC-87DA-1DB460D64046,"iPhone13,2"
com.tinyspeck.chatlyio,6,1743619627,1743619633,1743619633.612776,-18000,EB445137-D7F5-57EC-87DA-1DB460D64046,"iPhone13,2"
com.tinyspeck.chatlyio,2,1743619574,1743619576,1743619576.399836,-18000,EB445137-D7F5-57EC-87DA-1DB460D64046,"iPhone13,2"
com.tinyspeck.chatlyio,150,1743619383,1743619533,1743619533.349035,-18000,EB445137-D7F5-57EC-87DA-1DB460D64046,"iPhone13,2"
com.apple.news,0,1743619383,1743619383,1743619384.451356,-18000,EB445137-D7F5-57EC-87DA-1DB460D64046,"iPhone13,2"
com.apple.news,117,1743619225,1743619342,1743619343.233282,-18000,EB445137-D7F5-57EC-87DA-1DB460D64046,"iPhone13,2"
com.microsoft.VSCode,382,1743618638,1743619020,1743619020.647276,-18000,,
com.google.Chrome,3,1743618635,1743618638,1743618638.568965,-18000,,
com.strava.stravaride,6,1743618609,1743618615,1743618615.234829,-18000,EB445137-D7F5-57EC-87DA-1DB460D64046,"iPhone13,2"
com.strava.stravaride,86,1743617288,1743617374,1743617374.443421,-18000,EB445137-D7F5-57EC-87DA-1DB460D64046,"iPhone13,2"
com.apple.weather,31,1743617245,1743617276,1743617276.428763,-18000,EB445137-D7F5-57EC-87DA-1DB460D64046,"iPhone13,2"
com.apple.news,2,1743617228,1743617230,1743617230.904964,-18000,EB445137-D7F5-57EC-87DA-1DB460D64046,"iPhone13,2"
com.apple.news,556,1743616258,1743616814,1743616815.868433,-18000,EB445137-D7F5-57EC-87DA-1DB460D64046,"iPhone13,2"
com.google.chrome.ios,215,1743616020,1743616235,1743616235.750783,-18000,EB445137-D7F5-57EC-87DA-1DB460D64046,"iPhone13,2"
com.apple.weather,13,1743614975,1743614988,1743614989.140197,-18000,EB445137-D7F5-57EC-87DA-1DB460D64046,"iPhone13,2"
com.microsoft.Office.Outlook,12,1743613611,1743613623,1743613623.6234689,-18000,EB445137-D7F5-57EC-87DA-1DB460D64046,"iPhone13,2"
com.apple.Maps,0,1743613611,1743613611,1743613612.529443,-18000,EB445137-D7F5-57EC-87DA-1DB460D64046,"iPhone13,2"
com.apple.Maps,35,1743613414,1743613449,1743613449.416322,-18000,EB445137-D7F5-57EC-87DA-1DB460D64046,"iPhone13,2"
com.apple.weather,78,1743611849,1743611927,1743611927.339974,-18000,EB445137-D7F5-57EC-87DA-1DB460D64046,"iPhone13,2"
com.apple.news,98,1743611751,1743611849,1743611849.052645,-18000,EB445137-D7F5-57EC-87DA-1DB460D64046,"iPhone13,2"
com.apple.news,105,1743610748,1743610853,1743610853.966134,-18000,EB445137-D7F5-57EC-87DA-1DB460D64046,"iPhone13,2"
com.apple.CoreAuthUI,2,1743610719,1743610721,1743610721.13027,-18000,EB445137-D7F5-57EC-87DA-1DB460D64046,"iPhone13,2"
com.discoverfinancial.mobile,27,1743610714,1743610741,1743610741.718297,-18000,EB445137-D7F5-57EC-87DA-1DB460D64046,"iPhone13,2"
com.apple.MobileSMS,16,1743610661,1743610677,1743610677.6715322,-18000,EB445137-D7F5-57EC-87DA-1DB460D64046,"iPhone13,2"
com.apple.weather,0,1743610661,1743610661,1743610662.2794828,-18000,EB445137-D7F5-57EC-87DA-1DB460D64046,"iPhone13,2"
com.apple.weather,15,1743609802,1743609817,1743609817.2670588,-18000,EB445137-D7F5-57EC-87DA-1DB460D64046,"iPhone13,2"
com.apple.news,42,1743609699,1743609741,1743609741.7192302,-18000,EB445137-D7F5-57EC-87DA-1DB460D64046,"iPhone13,2"
com.apple.news,234,1743609432,1743609666,1743609667.103596,-18000,EB445137-D7F5-57EC-87DA-1DB460D64046,"iPhone13,2"
com.apple.weather,2,1743609423,1743609425,1743609425.852758,-18000,EB445137-D7F5-57EC-87DA-1DB460D64046,"iPhone13,2"
com.google.Chrome,45,1743608248,1743608293,1743608293.320599,-18000,,
com.apple.MobileSMS,7,1743608226,1743608233,1743608233.885051,-18000,,
com.google.Chrome,16,1743608210,1743608226,1743608226.6880078,-18000,,
com.apple.finder,1,1743608199,1743608200,1743608201.629714,-18000,,
com.microsoft.VSCode,2,1743608197,1743608199,1743608199.963488,-18000,,
com.google.Chrome,149,1743608048,1743608197,1743608198.489931,-18000,,
com.microsoft.VSCode,103,1743607945,1743608048,1743608048.226355,-18000,,
com.google.Chrome,3,1743607942,1743607945,1743607945.07085,-18000,,
com.apple.finder,1,1743607941,1743607942,1743607942.3908,-18000,,
com.google.Chrome,36,1743607905,1743607941,1743607941.168639,-18000,,
com.apple.finder,1,1743607904,1743607905,1743607905.871077,-18000,,
com.microsoft.VSCode,263,1743607641,1743607904,1743607904.702605,-18000,,
com.apple.finder,2,1743607639,1743607641,1743607641.812582,-18000,,
com.microsoft.Outlook,2,1743607637,1743607639,1743607639.9397721,-18000,,
com.apple.finder,2,1743607635,1743607637,1743607637.9219,-18000,,
com.leomehlig.today,58,1743607577,1743607635,1743607635.1019,-18000,,
com.google.Chrome,19,1743607558,1743607577,1743607577.378686,-18000,,
com.apple.weather,10,1743607231,1743607241,1743607241.871566,-18000,EB445137-D7F5-57EC-87DA-1DB460D64046,"iPhone13,2"
com.google.Chrome,358,1743607165,1743607523,1743607523.524084,-18000,,
com.leomehlig.today,10,1743607155,1743607165,1743607165.922917,-18000,,
com.google.Chrome,216,1743606939,1743607155,1743607155.8583698,-18000,,
com.apple.CoreAuthUI,2,1743606564,1743606566,1743606566.2622662,-18000,EB445137-D7F5-57EC-87DA-1DB460D64046,"iPhone13,2"
com.truebill.truebillnative,17,1743606561,1743606578,1743606578.053567,-18000,EB445137-D7F5-57EC-87DA-1DB460D64046,"iPhone13,2"
com.apple.MobileSMS,4,1743606410,1743606414,1743606414.274039,-18000,EB445137-D7F5-57EC-87DA-1DB460D64046,"iPhone13,2"
com.google.Chrome,319,1743606401,1743606720,1743606720.927882,-18000,,
com.apple.finder,112,1743606289,1743606401,1743606401.941657,-18000,,
com.toyopagroup.picaboo,178,1743606228,1743606406,1743606406.272754,-18000,EB445137-D7F5-57EC-87DA-1DB460D64046,"iPhone13,2"
com.apple.weather,1,1743606227,1743606228,1743606228.4100761,-18000,EB445137-D7F5-57EC-87DA-1DB460D64046,"iPhone13,2"
com.google.Chrome,133,1743606156,1743606289,1743606289.418422,-18000,,
com.google.Chrome,300,1743605180,1743605480,1743605480.2709389,-18000,,
com.apple.weather,8,1743605057,1743605065,1743605065.9149408,-18000,EB445137-D7F5-57EC-87DA-1DB460D64046,"iPhone13,2"
com.apple.weather,2,1743605052,1743605054,1743605055.176461,-18000,EB445137-D7F5-57EC-87DA-1DB460D64046,"iPhone13,2"
com.intsig.CamScannerLite,1,1743605051,1743605052,1743605053.071238,-18000,EB445137-D7F5-57EC-87DA-1DB460D64046,"iPhone13,2"
com.google.Chrome,497,1743604326,1743604823,1743604823.095072,-18000,,
com.microsoft.Outlook,47,1743604268,1743604315,1743604315.972351,-18000,,
com.google.Chrome,122,1743604146,1743604268,1743604268.619317,-18000,,
com.leomehlig.today,2,1743604131,1743604133,1743604134.699913,-18000,,
com.intsig.CamScannerLite,72,1743604044,1743604116,1743604117.119347,-18000,EB445137-D7F5-57EC-87DA-1DB460D64046,"iPhone13,2"
com.apple.Health,2,1743604042,1743604044,1743604044.321766,-18000,EB445137-D7F5-57EC-87DA-1DB460D64046,"iPhone13,2"
com.google.Chrome,160,1743603971,1743604131,1743604131.70615,-18000,,
com.apple.Preview,104,1743603867,1743603971,1743603971.869532,-18000,,
com.google.Chrome,259,1743603608,1743603867,1743603867.626415,-18000,,
com.leomehlig.today,19,1743603589,1743603608,1743603608.62473,-18000,,
com.apple.Preview,350,1743603239,1743603589,1743603589.208421,-18000,,
com.apple.Health,17,1743603209,1743603226,1743603226.619491,-18000,EB445137-D7F5-57EC-87DA-1DB460D64046,"iPhone13,2"
com.toyopagroup.picaboo,41,1743603150,1743603191,1743603192.0272698,-18000,EB445137-D7F5-57EC-87DA-1DB460D64046,"iPhone13,2"
com.apple.Health,65,1743603076,1743603141,1743603141.090232,-18000,EB445137-D7F5-57EC-87DA-1DB460D64046,"iPhone13,2"
com.hammerandchisel.discord,0,1743603076,1743603076,1743603077.375718,-18000,EB445137-D7F5-57EC-87DA-1DB460D64046,"iPhone13,2"
com.apple.Preview,341,1743602759,1743603100,1743603100.996717,-18000,,
com.apple.Preview,608,1743602101,1743602709,1743602709.3711262,-18000,,
com.google.Chrome,202,1743601899,1743602101,1743602101.100565,-18000,,
com.apple.Preview,207,1743601692,1743601899,1743601899.785624,-18000,,
com.apple.finder,4,1743601688,1743601692,1743601692.6321259,-18000,,
com.google.Chrome,58,1743601630,1743601688,1743601688.364177,-18000,,
com.leomehlig.today,54,1743601563,1743601617,1743601618.605772,-18000,,
com.apple.finder,2,1743601561,1743601563,1743601563.136922,-18000,,
com.microsoft.Outlook,13,1743601548,1743601561,1743601561.8426208,-18000,,
com.apple.iCal,58,1743601490,1743601548,1743601548.130316,-18000,,
com.hammerandchisel.discord,115,1743601283,1743601398,1743601398.646747,-18000,EB445137-D7F5-57EC-87DA-1DB460D64046,"iPhone13,2"
com.apple.weather,1,1743601282,1743601283,1743601283.162475,-18000,EB445137-D7F5-57EC-87DA-1DB460D64046,"iPhone13,2"
com.google.Chrome,285,1743601205,1743601490,1743601490.5411592,-18000,,
com.microsoft.Outlook,1,1743601191,1743601192,1743601192.770325,-18000,,
com.google.Chrome,1,1743601190,1743601191,1743601191.827505,-18000,,
com.microsoft.Outlook,5,1743601185,1743601190,1743601190.909013,-18000,,
com.apple.iCal,5,1743601180,1743601185,1743601185.502802,-18000,,
com.google.Chrome,9,1743601171,1743601180,1743601180.7466002,-18000,,
com.apple.iCal,27,1743601144,1743601171,1743601171.494993,-18000,,
com.google.Chrome,80,1743601064,1743601144,1743601144.197546,-18000,,
com.microsoft.Outlook,12,1743601052,1743601064,1743601064.571002,-18000,,
com.google.Chrome,12,1743601040,1743601052,1743601052.471219,-18000,,
com.microsoft.Outlook,9,1743601031,1743601040,1743601041.0539289,-18000,,
com.apple.iCal,13,1743601018,1743601031,1743601031.96085,-18000,,
com.microsoft.Outlook,17,1743601001,1743601018,1743601018.1000872,-18000,,
com.google.Chrome,19,1743600982,1743601001,1743601001.429585,-18000,,
com.microsoft.Outlook,19,1743600963,1743600982,1743600982.631685,-18000,,
com.google.Chrome,34,1743600929,1743600963,1743600963.160592,-18000,,
com.apple.weather,6,1743600703,1743600709,1743600709.7433782,-18000,EB445137-D7F5-57EC-87DA-1DB460D64046,"iPhone13,2"
com.microsoft.Office.Outlook,1,1743600700,1743600701,1743600701.962556,-18000,EB445137-D7F5-57EC-87DA-1DB460D64046,"iPhone13,2"
com.microsoft.Office.Outlook,49,1743599675,1743599724,1743599724.323056,-18000,EB445137-D7F5-57EC-87DA-1DB460D64046,"iPhone13,2"
com.renpho.health,0,1743599675,1743599675,1743599676.2031422,-18000,EB445137-D7F5-57EC-87DA-1DB460D64046,"iPhone13,2"
com.renpho.health,24,1743598535,1743598559,1743598560.2424421,-18000,EB445137-D7F5-57EC-87DA-1DB460D64046,"iPhone13,2"
com.instructure.icanvas,48,1743598486,1743598534,1743598534.881518,-18000,EB445137-D7F5-57EC-87DA-1DB460D64046,"iPhone13,2"
com.instructure.icanvas,9,1743598475,1743598484,1743598484.2254071,-18000,EB445137-D7F5-57EC-87DA-1DB460D64046,"iPhone13,2"
com.apple.Health,64,1743597251,1743597315,1743597316.0383592,-18000,EB445137-D7F5-57EC-87DA-1DB460D64046,"iPhone13,2"
com.apple.weather,75,1743597144,1743597219,1743597219.585449,-18000,EB445137-D7F5-57EC-87DA-1DB460D64046,"iPhone13,2"
com.apple.mobiletimer,0,1743597134,1743597134,1743597136.943147,-18000,EB445137-D7F5-57EC-87DA-1DB460D64046,"iPhone13,2"
com.apple.CoreAuthUI,3,1743562898,1743562901,1743562901.093688,-18000,EB445137-D7F5-57EC-87DA-1DB460D64046,"iPhone13,2"
com.apple.journal,1681,1743562897,1743564578,1743564578.469822,-18000,EB445137-D7F5-57EC-87DA-1DB460D64046,"iPhone13,2"
com.microsoft.Office.Outlook,24,1743562868,1743562892,1743562892.811301,-18000,EB445137-D7F5-57EC-87DA-1DB460D64046,"iPhone13,2"
com.google.Chrome,593,1743561849,1743562442,1743562442.6283479,-18000,,
com.apple.finder,2,1743561847,1743561849,1743561850.2231932,-18000,,
com.apple.finder,2,1743560812,1743560814,1743560815.1224341,-18000,,
com.apple.finder,303,1743560409,1743560712,1743560712.233788,-18000,,
com.leomehlig.today,3,1743560406,1743560409,1743560409.448489,-18000,,
com.microsoft.VSCode,279,1743560127,1743560406,1743560406.2366881,-18000,,
com.apple.mobilecal,15,1743560074,1743560089,1743560089.967808,-18000,EB445137-D7F5-57EC-87DA-1DB460D64046,"iPhone13,2"
com.apple.Preferences,2,1743560069,1743560071,1743560072.613958,-18000,EB445137-D7F5-57EC-87DA-1DB460D64046,"iPhone13,2"
com.microsoft.Office.Outlook,33,1743560034,1743560067,1743560068.047404,-18000,EB445137-D7F5-57EC-87DA-1DB460D64046,"iPhone13,2"
com.apple.news,2,1743560032,1743560034,1743560034.034689,-18000,EB445137-D7F5-57EC-87DA-1DB460D64046,"iPhone13,2"
com.apple.news,91,1743559542,1743559633,1743559634.6085382,-18000,EB445137-D7F5-57EC-87DA-1DB460D64046,"iPhone13,2"
com.apple.news,28,1743558179,1743558207,1743558208.05145,-18000,EB445137-D7F5-57EC-87DA-1DB460D64046,"iPhone13,2"
com.google.chrome.ios,34,1743557183,1743557217,1743557218.023165,-18000,EB445137-D7F5-57EC-87DA-1DB460D64046,"iPhone13,2"
com.microsoft.VSCode,3632,1743556409,1743560041,1743560041.037329,-18000,,
com.google.chrome.ios,15,1743556315,1743556330,1743556331.206283,-18000,EB445137-D7F5-57EC-87DA-1DB460D64046,"iPhone13,2"
com.apple.news,1,1743556314,1743556315,1743556316.9901052,-18000,EB445137-D7F5-57EC-87DA-1DB460D64046,"iPhone13,2"
com.apple.news,12,1743556108,1743556120,1743556120.676291,-18000,EB445137-D7F5-57EC-87DA-1DB460D64046,"iPhone13,2"
com.google.chrome.ios,1,1743556092,1743556093,1743556093.789999,-18000,EB445137-D7F5-57EC-87DA-1DB460D64046,"iPhone13,2"
com.google.chrome.ios,36,1743556055,1743556091,1743556091.3504472,-18000,EB445137-D7F5-57EC-87DA-1DB460D64046,"iPhone13,2"
com.letterboxd.LetterboxdApp,2,1743556053,1743556055,1743556055.3462949,-18000,EB445137-D7F5-57EC-87DA-1DB460D64046,"iPhone13,2"
com.microsoft.VSCode,441,1743555752,1743556193,1743556193.2091022,-18000,,
com.letterboxd.LetterboxdApp,58,1743555628,1743555686,1743555687.260076,-18000,EB445137-D7F5-57EC-87DA-1DB460D64046,"iPhone13,2"
com.toyopagroup.picaboo,2,1743555625,1743555627,1743555628.134729,-18000,EB445137-D7F5-57EC-87DA-1DB460D64046,"iPhone13,2"
com.toyopagroup.picaboo,61,1743555399,1743555460,1743555461.00509,-18000,EB445137-D7F5-57EC-87DA-1DB460D64046,"iPhone13,2"
com.apple.news,1,1743555398,1743555399,1743555399.929188,-18000,EB445137-D7F5-57EC-87DA-1DB460D64046,"iPhone13,2"
com.google.Chrome,414,1743555338,1743555752,1743555752.037434,-18000,,
com.microsoft.VSCode,2,1743555336,1743555338,1743555338.78015,-18000,,
com.google.Chrome,446,1743554890,1743555336,1743555336.29911,-18000,,
com.leomehlig.today,73,1743554817,1743554890,1743554890.355361,-18000,,
com.microsoft.VSCode,155,1743554662,1743554817,1743554817.832545,-18000,,
com.google.Chrome,108,1743554554,1743554662,1743554662.417855,-18000,,
com.microsoft.VSCode,176,1743554363,1743554539,1743554539.331774,-18000,,
com.apple.news,126,1743554075,1743554201,1743554202.494308,-18000,EB445137-D7F5-57EC-87DA-1DB460D64046,"iPhone13,2"
com.microsoft.VSCode,325,1743554025,1743554350,1743554350.8677921,-18000,,
com.google.Chrome,27,1743553998,1743554025,1743554026.040915,-18000,,
com.microsoft.VSCode,188,1743553810,1743553998,1743553998.8084521,-18000,,
com.google.Chrome,126,1743553684,1743553810,1743553810.737163,-18000,,
com.apple.finder,6,1743553678,1743553684,1743553685.061907,-18000,,
com.google.Chrome,2,1743553676,1743553678,1743553678.7890902,-18000,,
com.microsoft.VSCode,181,1743553495,1743553676,1743553676.858344,-18000,,
com.google.Chrome,59,1743553436,1743553495,1743553495.696914,-18000,,
com.apple.finder,3,1743553433,1743553436,1743553437.083747,-18000,,
com.google.Chrome,11,1743553422,1743553433,1743553433.753868,-18000,,
com.apple.finder,9,1743553413,1743553422,1743553422.982644,-18000,,
com.google.Chrome,6,1743553407,1743553413,1743553413.29216,-18000,,
com.apple.finder,8,1743553399,1743553407,1743553407.4933372,-18000,,
com.google.Chrome,31,1743553368,1743553399,1743553399.356713,-18000,,
com.apple.finder,6,1743553362,1743553368,1743553368.9691381,-18000,,
com.google.Chrome,6,1743553356,1743553362,1743553362.1068301,-18000,,
com.apple.finder,13,1743553343,1743553356,1743553356.162722,-18000,,
com.google.Chrome,19,1743553324,1743553343,1743553343.309826,-18000,,
com.apple.finder,10,1743553314,1743553324,1743553324.074193,-18000,,
com.google.Chrome,44,1743553270,1743553314,1743553314.223172,-18000,,
com.apple.finder,5,1743553265,1743553270,1743553270.4675632,-18000,,
com.google.Chrome,16,1743553249,1743553265,1743553265.7548242,-18000,,
com.apple.finder,31,1743553218,1743553249,1743553249.190031,-18000,,
com.google.Chrome,5,1743553213,1743553218,1743553218.908397,-18000,,
com.apple.finder,63,1743553150,1743553213,1743553213.9199839,-18000,,
com.google.Chrome,9,1743553141,1743553150,1743553150.273168,-18000,,
com.apple.finder,13,1743553128,1743553141,1743553141.2030048,-18000,,
com.google.Chrome,5,1743553123,1743553128,1743553128.380474,-18000,,
com.apple.finder,2,1743553121,1743553123,1743553123.393381,-18000,,
com.google.Chrome,18,1743553103,1743553121,1743553121.312986,-18000,,
com.apple.finder,5,1743553098,1743553103,1743553103.5622911,-18000,,
com.google.Chrome,34,1743553064,1743553098,1743553098.396014,-18000,,
com.apple.finder,6,1743553058,1743553064,1743553064.1314712,-18000,,
com.google.Chrome,7,1743553051,1743553058,1743553058.190215,-18000,,
com.apple.finder,29,1743553022,1743553051,1743553051.2552419,-18000,,
com.google.Chrome,10,1743553012,1743553022,1743553022.39554,-18000,,
com.apple.finder,48,1743552964,1743553012,1743553013.034138,-18000,,
com.google.Chrome,13,1743552951,1743552964,1743552964.123088,-18000,,
com.apple.finder,8,1743552943,1743552951,1743552951.108931,-18000,,
com.google.Chrome,1,1743552942,1743552943,1743552943.987877,-18000,,
com.apple.finder,8,1743552934,1743552942,1743552942.772812,-18000,,
com.google.Chrome,2,1743552932,1743552934,1743552934.402627,-18000,,
com.apple.finder,7,1743552925,1743552932,1743552933.0221438,-18000,,
com.google.Chrome,9,1743552916,1743552925,1743552925.2362518,-18000,,
com.apple.finder,25,1743552891,1743552916,1743552916.947674,-18000,,
com.google.Chrome,12,1743552879,1743552891,1743552891.782257,-18000,,
com.apple.finder,9,1743552870,1743552879,1743552880.036442,-18000,,
com.google.Chrome,2,1743552868,1743552870,1743552870.6465,-18000,,
com.apple.finder,6,1743552862,1743552868,1743552868.542095,-18000,,
com.google.Chrome,38,1743552824,1743552862,1743552862.361579,-18000,,
com.apple.finder,11,1743552813,1743552824,1743552824.533994,-18000,,
com.google.Chrome,4,1743552809,1743552813,1743552813.640507,-18000,,
com.apple.finder,8,1743552801,1743552809,1743552809.608605,-18000,,
com.google.Chrome,11,1743552790,1743552801,1743552801.467406,-18000,,
com.apple.finder,5,1743552785,1743552790,1743552790.690134,-18000,,
com.google.Chrome,15,1743552770,1743552785,1743552785.7014241,-18000,,
com.apple.finder,13,1743552757,1743552770,1743552770.2485762,-18000,,
com.google.Chrome,13,1743552744,1743552757,1743552757.857543,-18000,,
com.microsoft.VSCode,2,1743552742,1743552744,1743552744.6627378,-18000,,
com.leomehlig.today,10,1743552732,1743552742,1743552742.2830648,-18000,,
com.apple.news,176,1743552490,1743552666,1743552666.403255,-18000,EB445137-D7F5-57EC-87DA-1DB460D64046,"iPhone13,2"
com.apple.finder,267,1743552465,1743552732,1743552732.243753,-18000,,
com.microsoft.VSCode,3,1743552462,1743552465,1743552465.50424,-18000,,
com.apple.finder,39,1743552423,1743552462,1743552462.94093,-18000,,
com.google.Chrome,1,1743552422,1743552423,1743552423.203123,-18000,,
com.microsoft.VSCode,88,1743552334,1743552422,1743552422.2619119,-18000,,
com.apple.finder,10,1743552324,1743552334,1743552334.085071,-18000,,
com.google.Chrome,10,1743552314,1743552324,1743552324.4193769,-18000,,
com.apple.finder,17,1743552297,1743552314,1743552314.922988,-18000,,
com.google.Chrome,32,1743552265,1743552297,1743552297.332827,-18000,,
com.apple.finder,100,1743552165,1743552265,1743552265.3607512,-18000,,
com.google.Chrome,2,1743552163,1743552165,1743552165.820506,-18000,,
com.apple.finder,3,1743552160,1743552163,1743552164.004136,-18000,,
com.google.Chrome,3,1743552157,1743552160,1743552160.617865,-18000,,
com.apple.finder,11,1743552146,1743552157,1743552157.154848,-18000,,
com.google.Chrome,28,1743552118,1743552146,1743552146.905974,-18000,,
com.apple.finder,18,1743552100,1743552118,1743552118.9044409,-18000,,
com.google.Chrome,22,1743552078,1743552100,1743552100.122755,-18000,,
com.apple.finder,26,1743552052,1743552078,1743552078.764924,-18000,,
com.google.Chrome,36,1743552016,1743552052,1743552053.000591,-18000,,
com.apple.finder,111,1743551905,1743552016,1743552017.054237,-18000,,
com.google.Chrome,2,1743551903,1743551905,1743551905.579433,-18000,,
com.apple.finder,25,1743551878,1743551903,1743551903.230803,-18000,,
com.google.Chrome,3,1743551875,1743551878,1743551878.584045,-18000,,
com.apple.finder,4,1743551871,1743551875,1743551875.773325,-18000,,
com.google.Chrome,40,1743551831,1743551871,1743551871.684252,-18000,,
com.apple.finder,20,1743551811,1743551831,1743551831.753129,-18000,,
com.google.Chrome,11,1743551800,1743551811,1743551811.9891238,-18000,,
com.apple.finder,5,1743551795,1743551800,1743551800.185432,-18000,,
com.google.Chrome,23,1743551772,1743551795,1743551795.995544,-18000,,
com.apple.finder,69,1743551703,1743551772,1743551772.439533,-18000,,
com.google.Chrome,14,1743551689,1743551703,1743551703.488501,-18000,,
com.apple.finder,14,1743551675,1743551689,1743551689.152952,-18000,,
com.google.Chrome,8,1743551667,1743551675,1743551675.656548,-18000,,
com.apple.finder,16,1743551651,1743551667,1743551667.755826,-18000,,
com.google.Chrome,98,1743551553,1743551651,1743551651.3172789,-18000,,
com.apple.finder,4,1743551549,1743551553,1743551553.280167,-18000,,
com.google.Chrome,11,1743551538,1743551549,1743551549.7192101,-18000,,
com.apple.finder,10,1743551528,1743551538,1743551538.1071758,-18000,,
com.google.Chrome,19,1743551509,1743551528,1743551528.237848,-18000,,
com.apple.finder,6,1743551503,1743551509,1743551509.624621,-18000,,
com.apple.news,44,1743551430,1743551474,1743551474.2358599,-18000,EB445137-D7F5-57EC-87DA-1DB460D64046,"iPhone13,2"
com.google.Chrome,86,1743551417,1743551503,1743551503.41858,-18000,,
com.apple.finder,2,1743551415,1743551417,1743551417.962892,-18000,,
com.google.Chrome,16,1743551399,1743551415,1743551415.2339978,-18000,,
com.apple.finder,9,1743551390,1743551399,1743551399.452187,-18000,,
com.google.Chrome,19,1743551371,1743551390,1743551390.848432,-18000,,
com.apple.finder,25,1743551346,1743551371,1743551371.653774,-18000,,
com.google.Chrome,15,1743551331,1743551346,1743551346.7823858,-18000,,
com.apple.finder,3,1743551328,1743551331,1743551331.3034348,-18000,,
com.google.Chrome,39,1743551289,1743551328,1743551328.204482,-18000,,
com.apple.finder,12,1743551277,1743551289,1743551289.40453,-18000,,
com.google.Chrome,79,1743551198,1743551277,1743551277.71351,-18000,,
com.apple.finder,2,1743551196,1743551198,1743551198.7004771,-18000,,
com.google.Chrome,62,1743551134,1743551196,1743551196.1897721,-18000,,
com.apple.finder,10,1743551124,1743551134,1743551134.718769,-18000,,
com.microsoft.VSCode,3,1743551121,1743551124,1743551124.723052,-18000,,
com.apple.Health,85,1743551032,1743551117,1743551117.272464,-18000,EB445137-D7F5-57EC-87DA-1DB460D64046,"iPhone13,2"
com.hammerandchisel.discord,14,1743551009,1743551023,1743551023.676467,-18000,EB445137-D7F5-57EC-87DA-1DB460D64046,"iPhone13,2"
com.apple.finder,130,1743550991,1743551121,1743551121.3911428,-18000,,
com.microsoft.VSCode,5,1743550986,1743550991,1743550991.90657,-18000,,
com.apple.finder,1,1743550985,1743550986,1743550986.7398639,-18000,,
com.microsoft.VSCode,0,1743550985,1743550985,1743550985.999117,-18000,,
com.apple.finder,6,1743550979,1743550985,1743550985.332415,-18000,,
com.microsoft.VSCode,9,1743550970,1743550979,1743550979.950508,-18000,,
com.apple.finder,11,1743550959,1743550970,1743550970.421864,-18000,,
com.google.Chrome,2,1743550957,1743550959,1743550959.178568,-18000,,
com.microsoft.VSCode,59,1743550898,1743550957,1743550958.0095038,-18000,,
com.google.Chrome,36,1743550862,1743550898,1743550898.136279,-18000,,
com.apple.finder,7,1743550855,1743550862,1743550862.9041018,-18000,,
com.google.Chrome,1,1743550854,1743550855,1743550855.743345,-18000,,
com.apple.finder,11,1743550843,1743550854,1743550854.2002769,-18000,,
com.google.Chrome,63,1743550780,1743550843,1743550843.4721332,-18000,,
com.apple.finder,17,1743550763,1743550780,1743550780.454093,-18000,,
com.microsoft.VSCode,8,1743550755,1743550763,1743550763.7364259,-18000,,
com.google.Chrome,2,1743550753,1743550755,1743550755.375893,-18000,,
com.apple.iCal,44,1743550709,1743550753,1743550753.5378618,-18000,,
com.google.Chrome,22,1743550687,1743550709,1743550709.097443,-18000,,
com.hammerandchisel.discord,45,1743550646,1743550691,1743550691.275056,-18000,EB445137-D7F5-57EC-87DA-1DB460D64046,"iPhone13,2"
com.microsoft.VSCode,210,1743550477,1743550687,1743550688.0203261,-18000,,
com.google.Chrome,2,1743550475,1743550477,1743550477.834261,-18000,,
com.microsoft.VSCode,41,1743550434,1743550475,1743550475.4454951,-18000,,
com.google.Chrome,3,1743550431,1743550434,1743550434.787173,-18000,,
com.microsoft.VSCode,11,1743550420,1743550431,1743550431.3658051,-18000,,
com.google.Chrome,23,1743550397,1743550420,1743550420.5149388,-18000,,
com.microsoft.VSCode,336,1743550061,1743550397,1743550397.0908,-18000,,
com.google.Chrome,3,1743550058,1743550061,1743550061.094046,-18000,,
com.microsoft.VSCode,21,1743550037,1743550058,1743550058.835115,-18000,,
com.google.Chrome,6,1743550031,1743550037,1743550037.239274,-18000,,
com.microsoft.VSCode,2,1743550029,1743550031,1743550031.852326,-18000,,
com.google.Chrome,3,1743550026,1743550029,1743550029.7125,-18000,,
com.microsoft.VSCode,4,1743550022,1743550026,1743550026.066759,-18000,,
com.google.Chrome,2,1743550020,1743550022,1743550022.201251,-18000,,
com.microsoft.VSCode,15,1743550005,1743550020,1743550020.5778708,-18000,,
com.google.Chrome,26,1743549979,1743550005,1743550005.830803,-18000,,
com.microsoft.VSCode,87,1743549892,1743549979,1743549979.4279752,-18000,,
com.google.Chrome,19,1743549873,1743549892,1743549892.8714309,-18000,,
com.microsoft.VSCode,74,1743549799,1743549873,1743549873.249604,-18000,,
com.apple.finder,97,1743549702,1743549799,1743549799.172175,-18000,,
com.microsoft.VSCode,26,1743549676,1743549702,1743549702.635209,-18000,,
com.apple.finder,43,1743549633,1743549676,1743549676.95333,-18000,,
com.microsoft.VSCode,7,1743549626,1743549633,1743549633.278222,-18000,,
com.apple.finder,135,1743549491,1743549626,1743549626.864829,-18000,,
com.microsoft.VSCode,67,1743549424,1743549491,1743549491.901936,-18000,,
com.apple.finder,6,1743549418,1743549424,1743549424.8159919,-18000,,
com.microsoft.VSCode,54,1743549364,1743549418,1743549418.045892,-18000,,
com.apple.finder,16,1743549348,1743549364,1743549365.08336,-18000,,
com.microsoft.VSCode,65,1743549283,1743549348,1743549348.668925,-18000,,
com.apple.finder,6,1743549277,1743549283,1743549283.743896,-18000,,
com.microsoft.VSCode,35,1743549242,1743549277,1743549277.157062,-18000,,
com.apple.finder,74,1743549168,1743549242,1743549242.5840359,-18000,,
com.microsoft.VSCode,20,1743549148,1743549168,1743549168.35952,-18000,,
com.apple.finder,5,1743549143,1743549148,1743549148.144901,-18000,,
com.microsoft.VSCode,98,1743549045,1743549143,1743549143.693655,-18000,,
com.apple.finder,33,1743549012,1743549045,1743549045.730403,-18000,,
com.microsoft.VSCode,26,1743548986,1743549012,1743549012.4905329,-18000,,
com.apple.finder,62,1743548924,1743548986,1743548986.606194,-18000,,
com.microsoft.VSCode,5,1743548919,1743548924,1743548925.073772,-18000,,
com.apple.finder,5,1743548914,1743548919,1743548919.188245,-18000,,
com.microsoft.Office.Outlook,29,1743548404,1743548433,1743548433.5210729,-18000,EB445137-D7F5-57EC-87DA-1DB460D64046,"iPhone13,2"
com.apple.finder,1,1743547424,1743547425,1743547425.463001,-18000,,
com.leomehlig.today,126,1743547298,1743547424,1743547424.06841,-18000,,
com.google.Chrome,962,1743546336,1743547298,1743547298.911763,-18000,,
com.leomehlig.today,39,1743545742,1743545781,1743545782.822756,-18000,,
com.apple.Health,19,1743544951,1743544970,1743544970.260572,-18000,EB445137-D7F5-57EC-87DA-1DB460D64046,"iPhone13,2"
com.apple.weather,2,1743544945,1743544947,1743544947.9256082,-18000,EB445137-D7F5-57EC-87DA-1DB460D64046,"iPhone13,2"
com.apple.weather,5,1743544901,1743544906,1743544907.1831079,-18000,EB445137-D7F5-57EC-87DA-1DB460D64046,"iPhone13,2"
com.intsig.CamScannerLite,1,1743544900,1743544901,1743544901.9772282,-18000,EB445137-D7F5-57EC-87DA-1DB460D64046,"iPhone13,2"
com.leomehlig.today,36,1743544857,1743544893,1743544893.214858,-18000,,
com.google.Chrome,102,1743544755,1743544857,1743544857.409213,-18000,,
com.apple.Preview,4,1743544751,1743544755,1743544755.390069,-18000,,
com.apple.finder,1,1743544750,1743544751,1743544751.7662969,-18000,,
com.intsig.CamScannerLite,123,1743544643,1743544766,1743544766.618854,-18000,EB445137-D7F5-57EC-87DA-1DB460D64046,"iPhone13,2"
com.intsig.CamScannerLite,62,1743544502,1743544564,1743544564.7918081,-18000,EB445137-D7F5-57EC-87DA-1DB460D64046,"iPhone13,2"
com.google.chrome.ios,2,1743544500,1743544502,1743544502.655134,-18000,EB445137-D7F5-57EC-87DA-1DB460D64046,"iPhone13,2"
com.intsig.CamScannerLite,32,1743544468,1743544500,1743544500.20697,-18000,EB445137-D7F5-57EC-87DA-1DB460D64046,"iPhone13,2"
com.apple.finder,303,1743544224,1743544527,1743544527.748725,-18000,,
com.microsoft.Office.Outlook,1,1743540942,1743540943,1743540943.8947592,-18000,EB445137-D7F5-57EC-87DA-1DB460D64046,"iPhone13,2"
com.microsoft.Office.Outlook,65,1743539929,1743539994,1743539995.0566912,-18000,EB445137-D7F5-57EC-87DA-1DB460D64046,"iPhone13,2"
com.instructure.icanvas,18,1743539906,1743539924,1743539924.910917,-18000,EB445137-D7F5-57EC-87DA-1DB460D64046,"iPhone13,2"
com.apple.finder,532,1743538204,1743538736,1743538736.4893641,-18000,,
com.apple.Preview,201,1743538003,1743538204,1743538204.0588121,-18000,,
com.apple.finder,10,1743537993,1743538003,1743538003.128536,-18000,,
com.google.Chrome,887,1743537106,1743537993,1743537993.1866,-18000,,
com.instructure.icanvas,60,1743535953,1743536013,1743536013.529131,-18000,EB445137-D7F5-57EC-87DA-1DB460D64046,"iPhone13,2"
com.apple.news,1,1743535950,1743535951,1743535952.3815541,-18000,EB445137-D7F5-57EC-87DA-1DB460D64046,"iPhone13,2"
com.apple.news,132,1743534016,1743534148,1743534149.05477,-18000,EB445137-D7F5-57EC-87DA-1DB460D64046,"iPhone13,2"
com.apple.news,13,1743534001,1743534014,1743534014.110249,-18000,EB445137-D7F5-57EC-87DA-1DB460D64046,"iPhone13,2"
com.hammerandchisel.discord,408,1743531898,1743532306,1743532306.598493,-18000,EB445137-D7F5-57EC-87DA-1DB460D64046,"iPhone13,2"
com.apple.Music,2,1743531886,1743531888,1743531888.639862,-18000,EB445137-D7F5-57EC-87DA-1DB460D64046,"iPhone13,2"
com.apple.Music,25,1743527882,1743527907,1743527908.870398,-18000,EB445137-D7F5-57EC-87DA-1DB460D64046,"iPhone13,2"
com.apple.news,274,1743527341,1743527615,1743527615.930307,-18000,EB445137-D7F5-57EC-87DA-1DB460D64046,"iPhone13,2"
com.apple.news,514,1743526702,1743527216,1743527216.502018,-18000,EB445137-D7F5-57EC-87DA-1DB460D64046,"iPhone13,2"
com.apple.news,56,1743526510,1743526566,1743526567.079706,-18000,EB445137-D7F5-57EC-87DA-1DB460D64046,"iPhone13,2"
com.google.Gmail,52,1743525400,1743525452,1743525452.4520469,-18000,EB445137-D7F5-57EC-87DA-1DB460D64046,"iPhone13,2"
com.google.chrome.ios,1,1743525399,1743525400,1743525400.526661,-18000,EB445137-D7F5-57EC-87DA-1DB460D64046,"iPhone13,2"
com.apple.CoreAuthUI,2,1743523412,1743523414,1743523414.454782,-18000,EB445137-D7F5-57EC-87DA-1DB460D64046,"iPhone13,2"
com.google.chrome.ios,27,1743523403,1743523430,1743523430.4195309,-18000,EB445137-D7F5-57EC-87DA-1DB460D64046,"iPhone13,2"
com.apple.camera,5,1743523398,1743523403,1743523403.988161,-18000,EB445137-D7F5-57EC-87DA-1DB460D64046,"iPhone13,2"
com.apple.weather,3,1743523392,1743523395,1743523395.230437,-18000,EB445137-D7F5-57EC-87DA-1DB460D64046,"iPhone13,2"
com.apple.PosterBoard,2,1743523391,1743523393,1743523393.706363,-18000,EB445137-D7F5-57EC-87DA-1DB460D64046,"iPhone13,2"
com.google.Chrome,2,1743523315,1743523317,1743523317.261559,-18000,,
com.apple.MobileSMS,29,1743523286,1743523315,1743523315.475209,-18000,,
com.google.Chrome,33,1743523253,1743523286,1743523286.636613,-18000,,
com.apple.MobileSMS,17,1743523236,1743523253,1743523253.664288,-18000,,
com.google.Chrome,1,1743523235,1743523236,1743523236.0996342,-18000,,
com.apple.MobileSMS,1,1743523234,1743523235,1743523235.4483209,-18000,,
com.google.Chrome,3,1743523231,1743523234,1743523234.822324,-18000,,
com.apple.MobileSMS,7,1743523224,1743523231,1743523231.280066,-18000,,
com.google.Chrome,38,1743523186,1743523224,1743523224.698196,-18000,,
com.apple.MobileSMS,4,1743523139,1743523143,1743523143.543968,-18000,,
com.google.Chrome,2,1743523137,1743523139,1743523139.796647,-18000,,
com.apple.finder,2,1743523135,1743523137,1743523137.557472,-18000,,
com.leomehlig.today,0,1743523135,1743523135,1743523135.669904,-18000,,
com.apple.finder,2,1743523133,1743523135,1743523135.1039128,-18000,,
com.google.Chrome,16,1743523117,1743523133,1743523133.3344522,-18000,,
com.burbn.instagram,110,1743522949,1743523059,1743523059.6505089,-18000,EB445137-D7F5-57EC-87DA-1DB460D64046,"iPhone13,2"
com.facebook.Facebook,57,1743522892,1743522949,1743522949.100195,-18000,EB445137-D7F5-57EC-87DA-1DB460D64046,"iPhone13,2"
com.intsig.CamScannerLite,2,1743522817,1743522819,1743522819.08195,-18000,EB445137-D7F5-57EC-87DA-1DB460D64046,"iPhone13,2"
com.google.Chrome,302,1743522766,1743523068,1743523068.762171,-18000,,
com.apple.finder,4,1743522762,1743522766,1743522766.1895041,-18000,,
com.google.Chrome,5,1743522757,1743522762,1743522762.721236,-18000,,
com.apple.finder,15,1743522742,1743522757,1743522757.7776852,-18000,,
com.google.Chrome,18,1743522724,1743522742,1743522742.2638931,-18000,,
com.leomehlig.today,52,1743522672,1743522724,1743522724.9099689,-18000,,
com.google.Chrome,13,1743522659,1743522672,1743522672.283475,-18000,,
com.apple.finder,11,1743522631,1743522642,1743522642.879459,-18000,,
com.apple.Preview,39,1743522592,1743522631,1743522631.4611201,-18000,,
com.apple.finder,1,1743522591,1743522592,1743522592.312683,-18000,,
com.apple.Preview,1,1743522590,1743522591,1743522591.5413399,-18000,,
com.apple.finder,19,1743522571,1743522590,1743522590.6928391,-18000,,
com.intsig.CamScannerLite,101,1743522526,1743522627,1743522627.705189,-18000,EB445137-D7F5-57EC-87DA-1DB460D64046,"iPhone13,2"
com.google.Chrome,62,1743522509,1743522571,1743522571.355941,-18000,,
com.microsoft.VSCode,11,1743522498,1743522509,1743522509.4665852,-18000,,
com.google.Chrome,22,1743522476,1743522498,1743522499.0304298,-18000,,
com.microsoft.VSCode,1116,1743521360,1743522476,1743522476.884341,-18000,,
com.google.Chrome,97,1743521263,1743521360,1743521360.85538,-18000,,
com.microsoft.VSCode,23,1743521240,1743521263,1743521263.413732,-18000,,
com.google.Chrome,13,1743521227,1743521240,1743521240.8613238,-18000,,
com.microsoft.VSCode,13,1743521214,1743521227,1743521227.8853478,-18000,,
com.google.Chrome,12,1743521202,1743521214,1743521214.30302,-18000,,
com.microsoft.VSCode,6,1743521196,1743521202,1743521202.3618422,-18000,,
com.google.Chrome,9,1743521187,1743521196,1743521196.289794,-18000,,
com.microsoft.VSCode,87,1743521100,1743521187,1743521187.959817,-18000,,
com.google.Chrome,59,1743521041,1743521100,1743521100.827355,-18000,,
com.microsoft.VSCode,18,1743521023,1743521041,1743521041.792323,-18000,,
com.google.Chrome,17,1743521006,1743521023,1743521023.45246,-18000,,
com.microsoft.VSCode,8,1743520998,1743521006,1743521006.464754,-18000,,
com.google.Chrome,8,1743520990,1743520998,1743520998.5539222,-18000,,
com.apple.Preview,3,1743520987,1743520990,1743520990.183775,-18000,,
com.microsoft.VSCode,51,1743520936,1743520987,1743520987.4821448,-18000,,
com.google.Chrome,34,1743520902,1743520936,1743520936.9975061,-18000,,
com.microsoft.VSCode,33,1743520869,1743520902,1743520902.591886,-18000,,
com.google.Chrome,0,1743520869,1743520869,1743520869.79488,-18000,,
com.microsoft.VSCode,15,1743520854,1743520869,1743520869.098655,-18000,,
com.google.Chrome,32,1743520822,1743520854,1743520854.90035,-18000,,
com.microsoft.VSCode,119,1743520703,1743520822,1743520822.268286,-18000,,
com.google.Chrome,239,1743520464,1743520703,1743520704.009953,-18000,,
com.microsoft.VSCode,52,1743520412,1743520464,1743520464.827825,-18000,,
com.google.Chrome,184,1743520228,1743520412,1743520412.344152,-18000,,
com.microsoft.Office.Outlook,40,1743519859,1743519899,1743519899.421696,-18000,EB445137-D7F5-57EC-87DA-1DB460D64046,"iPhone13,2"
com.toyopagroup.picaboo,19,1743519839,1743519858,1743519858.934132,-18000,EB445137-D7F5-57EC-87DA-1DB460D64046,"iPhone13,2"
com.google.Gmail,2,1743519837,1743519839,1743519839.116878,-18000,EB445137-D7F5-57EC-87DA-1DB460D64046,"iPhone13,2"
com.apple.Preview,412,1743519816,1743520228,1743520228.477229,-18000,,
com.apple.finder,2,1743519814,1743519816,1743519816.305667,-18000,,
com.apple.Preview,4,1743519810,1743519814,1743519814.6123362,-18000,,
com.google.Chrome,23,1743519787,1743519810,1743519810.9417539,-18000,,
com.microsoft.VSCode,86,1743519701,1743519787,1743519787.982575,-18000,,
com.google.Chrome,9,1743519692,1743519701,1743519701.943996,-18000,,
com.apple.Preview,2,1743519690,1743519692,1743519692.597044,-18000,,
com.microsoft.VSCode,164,1743519526,1743519690,1743519690.205991,-18000,,
com.google.Chrome,92,1743519434,1743519526,1743519526.54009,-18000,,
com.microsoft.VSCode,3,1743519431,1743519434,1743519435.0000591,-18000,,
com.google.Chrome,4,1743519427,1743519431,1743519431.979504,-18000,,
com.microsoft.VSCode,21,1743519406,1743519427,1743519427.095965,-18000,,
com.google.Chrome,27,1743519379,1743519406,1743519406.2322788,-18000,,
com.microsoft.VSCode,40,1743519339,1743519379,1743519379.347373,-18000,,
com.google.Chrome,117,1743519222,1743519339,1743519339.6964169,-18000,,
com.microsoft.VSCode,273,1743518949,1743519222,1743519222.821559,-18000,,
com.google.Chrome,30,1743518919,1743518949,1743518949.36727,-18000,,
com.microsoft.VSCode,87,1743518832,1743518919,1743518919.9799252,-18000,,
com.google.Chrome,361,1743518471,1743518832,1743518832.133716,-18000,,
com.apple.Preview,81,1743518390,1743518471,1743518471.565413,-18000,,
com.google.Chrome,10,1743518380,1743518390,1743518390.677062,-18000,,
com.apple.Preview,542,1743517838,1743518380,1743518380.812284,-18000,,
com.apple.MobileSMS,20,1743517818,1743517838,1743517838.36443,-18000,,
com.apple.Preview,35,1743517783,1743517818,1743517818.078758,-18000,,
com.google.Chrome,4,1743517779,1743517783,1743517783.512278,-18000,,
com.apple.Preview,7,1743517772,1743517779,1743517779.2021189,-18000,,
com.apple.finder,53,1743517719,1743517772,1743517772.344919,-18000,,
com.apple.Preview,7,1743517712,1743517719,1743517719.194477,-18000,,
com.google.Chrome,264,1743517448,1743517712,1743517713.044129,-18000,,
com.google.Gmail,85,1743517326,1743517411,1743517412.1894488,-18000,EB445137-D7F5-57EC-87DA-1DB460D64046,"iPhone13,2"
com.apple.Preview,189,1743517259,1743517448,1743517448.331115,-18000,,
com.leomehlig.today,16,1743517243,1743517259,1743517259.472784,-18000,,
com.apple.Preview,252,1743516991,1743517243,1743517243.302026,-18000,,
com.apple.finder,6,1743516985,1743516991,1743516991.373464,-18000,,
com.google.Chrome,69,1743516916,1743516985,1743516985.75636,-18000,,
com.apple.news,141,1743516760,1743516901,1743516901.773793,-18000,EB445137-D7F5-57EC-87DA-1DB460D64046,"iPhone13,2"
com.apple.finder,180,1743516736,1743516916,1743516916.618898,-18000,,
com.apple.news,65,1743515867,1743515932,1743515932.073954,-18000,EB445137-D7F5-57EC-87DA-1DB460D64046,"iPhone13,2"
com.apple.news,376,1743515476,1743515852,1743515852.8318381,-18000,EB445137-D7F5-57EC-87DA-1DB460D64046,"iPhone13,2"
com.microsoft.Office.Outlook,5,1743515418,1743515423,1743515423.476468,-18000,EB445137-D7F5-57EC-87DA-1DB460D64046,"iPhone13,2"
com.microsoft.Office.Outlook,45,1743515371,1743515416,1743515416.789762,-18000,EB445137-D7F5-57EC-87DA-1DB460D64046,"iPhone13,2"
com.apple.news,1,1743515370,1743515371,1743515371.61885,-18000,EB445137-D7F5-57EC-87DA-1DB460D64046,"iPhone13,2"
com.apple.finder,301,1743515355,1743515656,1743515656.591021,-18000,,
com.apple.Preview,23,1743515332,1743515355,1743515355.722439,-18000,,
com.apple.finder,2,1743515330,1743515332,1743515332.4687219,-18000,,
com.apple.Preview,121,1743515209,1743515330,1743515330.9243479,-18000,,
com.apple.finder,3,1743515206,1743515209,1743515209.930867,-18000,,
com.apple.Preview,463,1743514743,1743515206,1743515206.544889,-18000,,
com.apple.finder,16,1743514727,1743514743,1743514749.668212,-18000,,
com.apple.news,135,1743513474,1743513609,1743513609.898006,-18000,EB445137-D7F5-57EC-87DA-1DB460D64046,"iPhone13,2"
com.renpho.health,3,1743513462,1743513465,1743513466.082179,-18000,EB445137-D7F5-57EC-87DA-1DB460D64046,"iPhone13,2"
com.renpho.health,96,1743512556,1743512652,1743512652.577168,-18000,EB445137-D7F5-57EC-87DA-1DB460D64046,"iPhone13,2"
com.apple.Health,21,1743512528,1743512549,1743512549.470653,-18000,EB445137-D7F5-57EC-87DA-1DB460D64046,"iPhone13,2"
com.apple.Health,33,1743511391,1743511424,1743511424.313795,-18000,EB445137-D7F5-57EC-87DA-1DB460D64046,"iPhone13,2"
com.apple.news,108,1743510751,1743510859,1743510860.039562,-18000,EB445137-D7F5-57EC-87DA-1DB460D64046,"iPhone13,2"
com.apple.finder,111,1743476892,1743477003,1743477003.784332,-18000,,
com.leomehlig.today,53,1743476839,1743476892,1743476892.3823361,-18000,,
com.apple.finder,45,1743476794,1743476839,1743476839.293788,-18000,,
com.leomehlig.today,37,1743476757,1743476794,1743476795.016943,-18000,,
com.apple.iCal,17,1743476740,1743476757,1743476757.3790631,-18000,,
com.leomehlig.today,27,1743476713,1743476740,1743476740.4999971,-18000,,
com.apple.finder,10,1743476703,1743476713,1743476713.952818,-18000,,
com.leomehlig.today,77,1743476626,1743476703,1743476703.107201,-18000,,
com.google.Chrome,40,1743476586,1743476626,1743476626.937694,-18000,,
com.leomehlig.today,4,1743476573,1743476577,1743476577.936672,-18000,,
com.google.Chrome,2,1743476571,1743476573,1743476573.7323852,-18000,,
com.apple.finder,2,1743476569,1743476571,1743476571.046085,-18000,,
com.microsoft.VSCode,35,1743476534,1743476569,1743476570.171558,-18000,,
com.apple.finder,62,1743476472,1743476534,1743476534.174169,-18000,,
com.microsoft.VSCode,3,1743476469,1743476472,1743476475.0652618,-18000,,
com.apple.weather,8,1743476101,1743476109,1743476109.623311,-18000,EB445137-D7F5-57EC-87DA-1DB460D64046,"iPhone13,2"
com.instructure.icanvas,46,1743475122,1743475168,1743475168.613895,-18000,EB445137-D7F5-57EC-87DA-1DB460D64046,"iPhone13,2"
com.apple.weather,10,1743472403,1743472413,1743472413.297347,-18000,EB445137-D7F5-57EC-87DA-1DB460D64046,"iPhone13,2"
com.apple.weather,28,1743469382,1743469410,1743469410.284754,-18000,EB445137-D7F5-57EC-87DA-1DB460D64046,"iPhone13,2"
com.apple.Health,5,1743469350,1743469355,1743469355.867976,-18000,EB445137-D7F5-57EC-87DA-1DB460D64046,"iPhone13,2"
com.apple.Health,6,1743469319,1743469325,1743469326.60391,-18000,EB445137-D7F5-57EC-87DA-1DB460D64046,"iPhone13,2"
com.apple.Health,83,1743468963,1743469046,1743469046.995222,-18000,EB445137-D7F5-57EC-87DA-1DB460D64046,"iPhone13,2"
com.apple.news,5,1743468958,1743468963,1743468963.8070111,-18000,EB445137-D7F5-57EC-87DA-1DB460D64046,"iPhone13,2"
com.apple.news,72,1743467897,1743467969,1743467969.974704,-18000,EB445137-D7F5-57EC-87DA-1DB460D64046,"iPhone13,2"
com.apple.news,102,1743467580,1743467682,1743467683.3710198,-18000,EB445137-D7F5-57EC-87DA-1DB460D64046,"iPhone13,2"
com.apple.news,363,1743466783,1743467146,1743467147.474868,-18000,EB445137-D7F5-57EC-87DA-1DB460D64046,"iPhone13,2"
com.apple.news,89,1743466453,1743466542,1743466543.922653,-18000,EB445137-D7F5-57EC-87DA-1DB460D64046,"iPhone13,2"
com.apple.news,55,1743465937,1743465992,1743465992.711214,-18000,EB445137-D7F5-57EC-87DA-1DB460D64046,"iPhone13,2"
com.google.chrome.ios,69,1743464833,1743464902,1743464902.711045,-18000,EB445137-D7F5-57EC-87DA-1DB460D64046,"iPhone13,2"
com.google.chrome.ios,5,1743464823,1743464828,1743464829.24586,-18000,EB445137-D7F5-57EC-87DA-1DB460D64046,"iPhone13,2"
com.apple.news,43,1743464771,1743464814,1743464814.779968,-18000,EB445137-D7F5-57EC-87DA-1DB460D64046,"iPhone13,2"
com.instructure.icanvas,11,1743464756,1743464767,1743464767.827229,-18000,EB445137-D7F5-57EC-87DA-1DB460D64046,"iPhone13,2"
com.tinyspeck.chatlyio,15,1743464474,1743464489,1743464489.3357759,-18000,EB445137-D7F5-57EC-87DA-1DB460D64046,"iPhone13,2"
com.tinyspeck.chatlyio,18,1743463584,1743463602,1743463603.547215,-18000,EB445137-D7F5-57EC-87DA-1DB460D64046,"iPhone13,2"
com.microsoft.Office.Outlook,12,1743463571,1743463583,1743463583.724032,-18000,EB445137-D7F5-57EC-87DA-1DB460D64046,"iPhone13,2"
com.microsoft.VSCode,316,1743463383,1743463699,1743463699.570286,-18000,,
com.apple.finder,5,1743463378,1743463383,1743463383.6126819,-18000,,
com.leomehlig.today,0,1743463378,1743463378,1743463378.825465,-18000,,
com.apple.finder,159,1743463219,1743463378,1743463378.493236,-18000,,
com.leomehlig.today,9,1743463210,1743463219,1743463219.637889,-18000,,
com.apple.finder,31,1743463179,1743463210,1743463210.781817,-18000,,
com.microsoft.VSCode,108,1743463071,1743463179,1743463179.4173698,-18000,,
com.google.Chrome,1,1743463070,1743463071,1743463072.027739,-18000,,
com.microsoft.VSCode,23,1743463047,1743463070,1743463070.3162389,-18000,,
com.google.Chrome,2,1743463045,1743463047,1743463047.080793,-18000,,
com.microsoft.VSCode,178,1743462867,1743463045,1743463045.425895,-18000,,
com.google.Chrome,3,1743462864,1743462867,1743462868.0452452,-18000,,
com.microsoft.VSCode,28,1743462836,1743462864,1743462865.0020452,-18000,,
com.google.Chrome,3,1743462833,1743462836,1743462836.819234,-18000,,
com.microsoft.VSCode,0,1743462833,1743462833,1743462833.939941,-18000,,
com.google.Chrome,48,1743462785,1743462833,1743462833.448021,-18000,,
com.microsoft.VSCode,345,1743462440,1743462785,1743462786.021319,-18000,,
com.apple.finder,5,1743462435,1743462440,1743462440.4565601,-18000,,
com.microsoft.VSCode,473,1743461962,1743462435,1743462435.7993999,-18000,,
com.google.Chrome,18,1743461944,1743461962,1743461962.865302,-18000,,
com.microsoft.VSCode,40,1743461904,1743461944,1743461944.818227,-18000,,
com.google.Chrome,6,1743461898,1743461904,1743461904.978887,-18000,,
com.microsoft.VSCode,8,1743461890,1743461898,1743461898.20252,-18000,,
com.google.Chrome,23,1743461867,1743461890,1743461890.172347,-18000,,
com.microsoft.VSCode,14,1743461853,1743461867,1743461867.225545,-18000,,
com.leomehlig.today,1,1743461852,1743461853,1743461854.206083,-18000,,
com.instructure.icanvas,25,1743461431,1743461456,1743461456.820801,-18000,EB445137-D7F5-57EC-87DA-1DB460D64046,"iPhone13,2"
com.microsoft.VSCode,439,1743461413,1743461852,1743461852.25531,-18000,,
com.leomehlig.today,6,1743461407,1743461413,1743461413.2552729,-18000,,
com.microsoft.VSCode,71,1743461336,1743461407,1743461407.482151,-18000,,
com.apple.finder,34,1743461302,1743461336,1743461336.3551521,-18000,,
com.microsoft.VSCode,23,1743461279,1743461302,1743461303.0195,-18000,,
com.apple.finder,5,1743461274,1743461279,1743461279.906703,-18000,,
com.microsoft.VSCode,50,1743461224,1743461274,1743461274.6792011,-18000,,
com.apple.finder,22,1743461202,1743461224,1743461224.4425669,-18000,,
com.microsoft.VSCode,35,1743461167,1743461202,1743461202.1362271,-18000,,
com.apple.finder,6,1743461161,1743461167,1743461167.3804588,-18000,,
com.microsoft.VSCode,33,1743461128,1743461161,1743461161.920937,-18000,,
com.apple.finder,9,1743461119,1743461128,1743461128.967598,-18000,,
com.microsoft.VSCode,3,1743461116,1743461119,1743461119.130663,-18000,,
com.apple.finder,16,1743461100,1743461116,1743461116.8819818,-18000,,
com.microsoft.VSCode,13,1743461087,1743461100,1743461100.384206,-18000,,
com.apple.finder,6,1743461081,1743461087,1743461087.770611,-18000,,
com.microsoft.VSCode,53,1743461028,1743461081,1743461081.422394,-18000,,
com.apple.finder,24,1743461004,1743461028,1743461028.998925,-18000,,
com.microsoft.VSCode,50,1743460954,1743461004,1743461004.044567,-18000,,
com.apple.finder,10,1743460944,1743460954,1743460954.691236,-18000,,
com.microsoft.VSCode,9,1743460935,1743460944,1743460944.9897962,-18000,,
com.apple.finder,2,1743460933,1743460935,1743460935.227812,-18000,,
com.microsoft.VSCode,31,1743460902,1743460933,1743460933.9378,-18000,,
com.apple.finder,1,1743460901,1743460902,1743460902.489338,-18000,,
com.microsoft.VSCode,3,1743460898,1743460901,1743460901.606744,-18000,,
com.apple.finder,26,1743460872,1743460898,1743460898.8814812,-18000,,
com.microsoft.VSCode,229,1743460643,1743460872,1743460872.269988,-18000,,
com.google.Chrome,6,1743460637,1743460643,1743460643.9772968,-18000,,
com.microsoft.VSCode,109,1743460528,1743460637,1743460637.626019,-18000,,
com.apple.finder,40,1743460488,1743460528,1743460528.3615642,-18000,,
com.microsoft.VSCode,7,1743460481,1743460488,1743460488.226915,-18000,,
com.apple.finder,5,1743460476,1743460481,1743460482.0337238,-18000,,
com.microsoft.VSCode,3,1743460473,1743460476,1743460476.5551472,-18000,,
com.apple.finder,152,1743460321,1743460473,1743460473.2710671,-18000,,
com.microsoft.VSCode,5,1743460316,1743460321,1743460321.2157202,-18000,,
com.apple.finder,9,1743460307,1743460316,1743460316.936901,-18000,,
com.microsoft.VSCode,14,1743460293,1743460307,1743460307.51351,-18000,,
com.apple.finder,10,1743460283,1743460293,1743460293.110311,-18000,,
com.microsoft.VSCode,57,1743460226,1743460283,1743460283.3595572,-18000,,
com.google.Chrome,24,1743460202,1743460226,1743460226.9494228,-18000,,
com.microsoft.VSCode,19,1743460183,1743460202,1743460202.723567,-18000,,
com.apple.finder,12,1743460171,1743460183,1743460183.5275831,-18000,,
com.microsoft.VSCode,10,1743460161,1743460171,1743460171.631788,-18000,,
com.apple.finder,7,1743460154,1743460161,1743460161.152742,-18000,,
com.microsoft.VSCode,8,1743460146,1743460154,1743460154.384855,-18000,,
com.apple.finder,16,1743460130,1743460146,1743460147.045374,-18000,,
com.microsoft.VSCode,136,1743459994,1743460130,1743460130.768557,-18000,,
com.google.Chrome,108,1743459886,1743459994,1743459994.322511,-18000,,
com.microsoft.VSCode,8,1743459878,1743459886,1743459886.918552,-18000,,
com.apple.finder,31,1743459847,1743459878,1743459879.0108562,-18000,,
com.microsoft.VSCode,126,1743459721,1743459847,1743459847.890561,-18000,,
com.google.Chrome,11,1743459710,1743459721,1743459721.454629,-18000,,
com.leomehlig.today,132,1743459578,1743459710,1743459711.092826,-18000,,
com.google.Chrome,254,1743459324,1743459578,1743459578.988329,-18000,,
com.google.Chrome,1597,1743457726,1743459323,1743459323.675764,-18000,,
com.apple.finder,3,1743457723,1743457726,1743457726.980031,-18000,,
com.google.Chrome,17,1743457706,1743457723,1743457723.495143,-18000,,
com.apple.Preview,11,1743457695,1743457706,1743457706.7423038,-18000,,
com.apple.finder,0,1743457695,1743457695,1743457696.044828,-18000,,
com.google.Chrome,64,1743457631,1743457695,1743457695.728712,-18000,,
com.apple.Preview,5,1743457626,1743457631,1743457631.110574,-18000,,
com.apple.finder,1,1743457625,1743457626,1743457626.313099,-18000,,
com.apple.Preview,6,1743457619,1743457625,1743457626.029459,-18000,,
com.google.Chrome,63,1743457556,1743457619,1743457619.0783958,-18000,,
com.apple.Preview,5,1743457551,1743457556,1743457557.022997,-18000,,
com.apple.finder,0,1743457551,1743457551,1743457551.365189,-18000,,
com.apple.Preview,4,1743457547,1743457551,1743457551.172885,-18000,,
com.apple.finder,3,1743457544,1743457547,1743457547.910578,-18000,,
com.google.Chrome,117,1743457427,1743457544,1743457545.0406241,-18000,,
com.apple.Preview,438,1743456989,1743457427,1743457427.319145,-18000,,
com.google.Chrome,3,1743456986,1743456989,1743456989.736856,-18000,,
com.google.Chrome,306,1743456245,1743456551,1743456551.4401479,-18000,,
com.apple.FaceTime,9,1743456236,1743456245,1743456245.9670339,-18000,,
com.google.Chrome,24,1743456212,1743456236,1743456236.211487,-18000,,
com.leomehlig.today,26,1743456186,1743456212,1743456212.553041,-18000,,
com.apple.iCal,1,1743456185,1743456186,1743456186.573563,-18000,,
com.google.Chrome,93,1743456092,1743456185,1743456186.00629,-18000,,
com.apple.iCal,2,1743456090,1743456092,1743456092.4504309,-18000,,
com.google.Chrome,37,1743456053,1743456090,1743456090.608523,-18000,,
com.apple.iCal,2,1743456051,1743456053,1743456053.8574529,-18000,,
com.google.Chrome,115,1743455936,1743456051,1743456051.174051,-18000,,
com.apple.MobileSMS,71,1743455865,1743455936,1743455936.954179,-18000,,
com.google.Chrome,7,1743455858,1743455865,1743455865.039542,-18000,,
com.apple.iCal,253,1743455605,1743455858,1743455858.988271,-18000,,
com.leomehlig.today,145,1743455460,1743455605,1743455605.618157,-18000,,
com.google.Chrome,6,1743455454,1743455460,1743455460.2760592,-18000,,
com.leomehlig.today,31,1743455423,1743455454,1743455454.449367,-18000,,
com.apple.FaceTime,109,1743455314,1743455423,1743455423.755155,-18000,,
com.leomehlig.today,346,1743454968,1743455314,1743455314.6884499,-18000,,
com.apple.Preview,343,1743454625,1743454968,1743454968.607409,-18000,,
com.apple.finder,0,1743454625,1743454625,1743454625.465131,-18000,,
com.apple.Preview,564,1743454061,1743454625,1743454625.160146,-18000,,
com.apple.finder,21,1743454040,1743454061,1743454061.470906,-18000,,
com.google.Chrome,18,1743454022,1743454040,1743454040.069285,-18000,,
com.leomehlig.today,65,1743453957,1743454022,1743454022.583908,-18000,,
com.google.Chrome,5,1743453952,1743453957,1743453957.97276,-18000,,
com.microsoft.Office.Outlook,24,1743453794,1743453818,1743453818.453394,-18000,EB445137-D7F5-57EC-87DA-1DB460D64046,"iPhone13,2"
com.apple.MobileSMS,38,1743453102,1743453140,1743453140.227674,-18000,EB445137-D7F5-57EC-87DA-1DB460D64046,"iPhone13,2"
com.apple.news,4,1743451906,1743451910,1743451910.219304,-18000,EB445137-D7F5-57EC-87DA-1DB460D64046,"iPhone13,2"
com.apple.news,4,1743450986,1743450990,1743450990.349782,-18000,EB445137-D7F5-57EC-87DA-1DB460D64046,"iPhone13,2"
com.apple.news,177,1743446849,1743447026,1743447027.338151,-18000,EB445137-D7F5-57EC-87DA-1DB460D64046,"iPhone13,2"
com.apple.Health,27,1743446813,1743446840,1743446841.054235,-18000,EB445137-D7F5-57EC-87DA-1DB460D64046,"iPhone13,2"
com.instructure.icanvas,26,1743446314,1743446340,1743446340.991904,-18000,EB445137-D7F5-57EC-87DA-1DB460D64046,"iPhone13,2"
com.instructure.icanvas,49,1743446262,1743446311,1743446311.554923,-18000,EB445137-D7F5-57EC-87DA-1DB460D64046,"iPhone13,2"
com.apple.CoreAuthUI,1,1743444990,1743444991,1743444992.060194,-18000,EB445137-D7F5-57EC-87DA-1DB460D64046,"iPhone13,2"
com.google.chrome.ios,39,1743444969,1743445008,1743445008.242408,-18000,EB445137-D7F5-57EC-87DA-1DB460D64046,"iPhone13,2"
com.apple.MobileSMS,4,1743444965,1743444969,1743444969.8709679,-18000,EB445137-D7F5-57EC-87DA-1DB460D64046,"iPhone13,2"
com.apple.news,148,1743444806,1743444954,1743444954.63246,-18000,EB445137-D7F5-57EC-87DA-1DB460D64046,"iPhone13,2"
com.apple.news,27,1743443704,1743443731,1743443731.9036798,-18000,EB445137-D7F5-57EC-87DA-1DB460D64046,"iPhone13,2"
com.apple.news,355,1743443346,1743443701,1743443701.832782,-18000,EB445137-D7F5-57EC-87DA-1DB460D64046,"iPhone13,2"
com.apple.news,1,1743440959,1743440960,1743440962.699491,-18000,EB445137-D7F5-57EC-87DA-1DB460D64046,"iPhone13,2"
com.apple.news,229,1743440317,1743440546,1743440547.402175,-18000,EB445137-D7F5-57EC-87DA-1DB460D64046,"iPhone13,2"
com.microsoft.Office.Outlook,5,1743438687,1743438692,1743438692.445318,-18000,EB445137-D7F5-57EC-87DA-1DB460D64046,"iPhone13,2"
com.doordash.dasher,171,1743438514,1743438685,1743438685.945108,-18000,EB445137-D7F5-57EC-87DA-1DB460D64046,"iPhone13,2"
com.apple.CoreAuthUI,3,1743438401,1743438404,1743438404.2760692,-18000,EB445137-D7F5-57EC-87DA-1DB460D64046,"iPhone13,2"
com.robinhood.release.Robinhood,50,1743438395,1743438445,1743438445.704441,-18000,EB445137-D7F5-57EC-87DA-1DB460D64046,"iPhone13,2"
com.apple.news,84,1743438308,1743438392,1743438392.558352,-18000,EB445137-D7F5-57EC-87DA-1DB460D64046,"iPhone13,2"
com.discoverfinancial.mobile,49,1743438251,1743438300,1743438300.761084,-18000,EB445137-D7F5-57EC-87DA-1DB460D64046,"iPhone13,2"
com.apple.CoreAuthUI,2,1743438221,1743438223,1743438223.266183,-18000,EB445137-D7F5-57EC-87DA-1DB460D64046,"iPhone13,2"
com.discoverfinancial.mobile,29,1743438211,1743438240,1743438240.978925,-18000,EB445137-D7F5-57EC-87DA-1DB460D64046,"iPhone13,2"
com.groupme.iphone-app,2,1743438207,1743438209,1743438209.570167,-18000,EB445137-D7F5-57EC-87DA-1DB460D64046,"iPhone13,2"
com.groupme.iphone-app,5,1743438115,1743438120,1743438120.596585,-18000,EB445137-D7F5-57EC-87DA-1DB460D64046,"iPhone13,2"
com.apple.MobileSMS,2,1743437832,1743437834,1743437834.8862,-18000,EB445137-D7F5-57EC-87DA-1DB460D64046,"iPhone13,2"
com.apple.MobileSMS,37,1743436766,1743436803,1743436803.5420961,-18000,EB445137-D7F5-57EC-87DA-1DB460D64046,"iPhone13,2"
com.apple.weather,43,1743436611,1743436654,1743436654.870895,-18000,EB445137-D7F5-57EC-87DA-1DB460D64046,"iPhone13,2"
com.truebill.truebillnative,36,1743436567,1743436603,1743436603.2927341,-18000,EB445137-D7F5-57EC-87DA-1DB460D64046,"iPhone13,2"
com.apple.calculator,3,1743436564,1743436567,1743436567.855789,-18000,EB445137-D7F5-57EC-87DA-1DB460D64046,"iPhone13,2"
com.truebill.truebillnative,3,1743436561,1743436564,1743436564.277686,-18000,EB445137-D7F5-57EC-87DA-1DB460D64046,"iPhone13,2"
com.apple.calculator,3,1743436558,1743436561,1743436561.422257,-18000,EB445137-D7F5-57EC-87DA-1DB460D64046,"iPhone13,2"
com.apple.CoreAuthUI,2,1743436420,1743436422,1743436422.783019,-18000,EB445137-D7F5-57EC-87DA-1DB460D64046,"iPhone13,2"
com.truebill.truebillnative,142,1743436416,1743436558,1743436559.014435,-18000,EB445137-D7F5-57EC-87DA-1DB460D64046,"iPhone13,2"
com.microsoft.Office.Outlook,16,1743436260,1743436276,1743436276.696169,-18000,EB445137-D7F5-57EC-87DA-1DB460D64046,"iPhone13,2"
com.leomehlig.today,50,1743436209,1743436259,1743436259.098589,-18000,EB445137-D7F5-57EC-87DA-1DB460D64046,"iPhone13,2"
com.apple.MobileSMS,3,1743436206,1743436209,1743436209.73798,-18000,EB445137-D7F5-57EC-87DA-1DB460D64046,"iPhone13,2"
com.leomehlig.today,50,1743436156,1743436206,1743436206.3461041,-18000,EB445137-D7F5-57EC-87DA-1DB460D64046,"iPhone13,2"
com.instructure.icanvas,2,1743436154,1743436156,1743436157.025679,-18000,EB445137-D7F5-57EC-87DA-1DB460D64046,"iPhone13,2"
com.leomehlig.today,30,1743436124,1743436154,1743436155.018869,-18000,EB445137-D7F5-57EC-87DA-1DB460D64046,"iPhone13,2"
com.google.chrome.ios,108,1743436009,1743436117,1743436117.448667,-18000,EB445137-D7F5-57EC-87DA-1DB460D64046,"iPhone13,2"
com.instructure.icanvas,15,1743435994,1743436009,1743436009.2387471,-18000,EB445137-D7F5-57EC-87DA-1DB460D64046,"iPhone13,2"
com.instructure.icanvas,35,1743435956,1743435991,1743435991.842015,-18000,EB445137-D7F5-57EC-87DA-1DB460D64046,"iPhone13,2"
com.apple.MobileSMS,12,1743435917,1743435929,1743435929.384553,-18000,EB445137-D7F5-57EC-87DA-1DB460D64046,"iPhone13,2"
com.apple.CoreAuthUI,1,1743432771,1743432772,1743432772.975662,-18000,EB445137-D7F5-57EC-87DA-1DB460D64046,"iPhone13,2"
com.apple.Passwords,17,1743432769,1743432786,1743432786.2364979,-18000,EB445137-D7F5-57EC-87DA-1DB460D64046,"iPhone13,2"
com.google.Chrome,522,1743427320,1743427842,1743427842.8577871,-18000,,
com.leomehlig.today,1,1743426931,1743426932,1743426932.958581,-18000,,
com.google.Chrome,10,1743426921,1743426931,1743426931.266767,-18000,,
com.leomehlig.today,12,1743426623,1743426635,1743426635.615489,-18000,,
com.google.Chrome,14,1743426609,1743426623,1743426623.610517,-18000,,
com.apple.Health,43,1743426505,1743426548,1743426548.3142219,-18000,EB445137-D7F5-57EC-87DA-1DB460D64046,"iPhone13,2"
com.apple.weather,13,1743426476,1743426489,1743426489.102823,-18000,EB445137-D7F5-57EC-87DA-1DB460D64046,"iPhone13,2"
com.apple.weather,4,1743425877,1743425881,1743425881.704774,-18000,EB445137-D7F5-57EC-87DA-1DB460D64046,"iPhone13,2"
com.renpho.health,2,1743425875,1743425877,1743425877.567729,-18000,EB445137-D7F5-57EC-87DA-1DB460D64046,"iPhone13,2"
com.renpho.health,31,1743425820,1743425851,1743425852.317265,-18000,EB445137-D7F5-57EC-87DA-1DB460D64046,"iPhone13,2"
com.apple.weather,2,1743425812,1743425814,1743425814.503047,-18000,EB445137-D7F5-57EC-87DA-1DB460D64046,"iPhone13,2"
com.apple.weather,6,1743425038,1743425044,1743425045.27374,-18000,EB445137-D7F5-57EC-87DA-1DB460D64046,"iPhone13,2"
com.apple.mobiletimer,11,1743424983,1743424994,1743424994.6547961,-18000,EB445137-D7F5-57EC-87DA-1DB460D64046,"iPhone13,2"
com.apple.news,0,1743424983,1743424983,1743424983.619643,-18000,EB445137-D7F5-57EC-87DA-1DB460D64046,"iPhone13,2"
com.apple.news,137,1743424843,1743424980,1743424981.00774,-18000,EB445137-D7F5-57EC-87DA-1DB460D64046,"iPhone13,2"
com.google.Chrome,365,1743397647,1743398012,1743398013.0976949,-18000,,
com.microsoft.Outlook,3,1743397644,1743397647,1743397647.581469,-18000,,
com.google.Chrome,3,1743397641,1743397644,1743397644.3437738,-18000,,
com.apple.finder,1,1743397640,1743397641,1743397641.701534,-18000,,
com.leomehlig.today,213,1743397427,1743397640,1743397640.3327441,-18000,,
com.apple.finder,53,1743397374,1743397427,1743397427.236298,-18000,,
com.apple.Notes,2,1743397372,1743397374,1743397374.300068,-18000,,
com.apple.finder,4,1743397368,1743397372,1743397372.9186258,-18000,,
com.apple.shortcuts,0,1743397368,1743397368,1743397368.551207,-18000,,
com.google.Chrome,4,1743397364,1743397368,1743397368.317776,-18000,,
com.microsoft.VSCode,165,1743397199,1743397364,1743397365.186943,-18000,,
com.google.Chrome,1,1743397198,1743397199,1743397200.9586282,-18000,,
com.microsoft.VSCode,4,1743397194,1743397198,1743397198.356165,-18000,,
com.apple.systempreferences,8,1743397186,1743397194,1743397194.927123,-18000,,
com.microsoft.VSCode,9,1743397168,1743397177,1743397178.00202,-18000,,
com.letterboxd.LetterboxdApp,112,1743397037,1743397149,1743397149.857696,-18000,EB445137-D7F5-57EC-87DA-1DB460D64046,"iPhone13,2"
com.google.chrome.ios,2,1743397033,1743397035,1743397035.6315532,-18000,EB445137-D7F5-57EC-87DA-1DB460D64046,"iPhone13,2"
com.google.chrome.ios,8,1743388248,1743388256,1743388257.1605759,-18000,EB445137-D7F5-57EC-87DA-1DB460D64046,"iPhone13,2"
com.google.chrome.ios,52,1743387411,1743387463,1743387463.8704162,-18000,EB445137-D7F5-57EC-87DA-1DB460D64046,"iPhone13,2"
com.instructure.icanvas,2,1743387409,1743387411,1743387411.441208,-18000,EB445137-D7F5-57EC-87DA-1DB460D64046,"iPhone13,2"
com.instructure.icanvas,70,1743381738,1743381808,1743381808.307053,-18000,EB445137-D7F5-57EC-87DA-1DB460D64046,"iPhone13,2"
com.instructure.icanvas,37,1743381699,1743381736,1743381736.209019,-18000,EB445137-D7F5-57EC-87DA-1DB460D64046,"iPhone13,2"
com.instructure.icanvas,86,1743381596,1743381682,1743381682.6412911,-18000,EB445137-D7F5-57EC-87DA-1DB460D64046,"iPhone13,2"
com.hammerandchisel.discord,1,1743381595,1743381596,1743381596.668206,-18000,EB445137-D7F5-57EC-87DA-1DB460D64046,"iPhone13,2"
com.microsoft.VSCode,332,1743380128,1743380460,1743380460.145657,-18000,,
com.google.Chrome,1,1743380127,1743380128,1743380128.487256,-18000,,
com.microsoft.VSCode,139,1743379988,1743380127,1743380127.552724,-18000,,
com.google.Chrome,83,1743379905,1743379988,1743379988.458416,-18000,,
com.microsoft.VSCode,83,1743379822,1743379905,1743379905.809657,-18000,,
com.google.Chrome,17,1743379805,1743379822,1743379822.4415479,-18000,,
com.microsoft.VSCode,346,1743379459,1743379805,1743379806.55846,-18000,,
com.apple.finder,25,1743379434,1743379459,1743379459.779224,-18000,,
com.apple.shortcuts,2,1743379432,1743379434,1743379434.6766582,-18000,,
com.microsoft.VSCode,179,1743379131,1743379310,1743379310.8642712,-18000,,
com.apple.finder,2,1743379129,1743379131,1743379132.227862,-18000,,
com.microsoft.VSCode,36,1743379093,1743379129,1743379129.332866,-18000,,
com.apple.dt.Xcode,7,1743379086,1743379093,1743379093.834495,-18000,,
com.apple.finder,25,1743379061,1743379086,1743379086.089083,-18000,,
com.apple.Notes,9,1743379052,1743379061,1743379061.288083,-18000,,
com.apple.finder,2,1743379050,1743379052,1743379052.356632,-18000,,
com.apple.shortcuts,13,1743379037,1743379050,1743379050.516636,-18000,,
com.apple.finder,53,1743378984,1743379037,1743379037.042753,-18000,,
com.apple.shortcuts,3,1743378981,1743378984,1743378984.3462,-18000,,
com.apple.finder,32,1743378912,1743378944,1743378944.213684,-18000,,
com.apple.shortcuts,32,1743378880,1743378912,1743378912.933655,-18000,,
com.apple.finder,39,1743378841,1743378880,1743378880.715074,-18000,,
com.apple.shortcuts,198,1743378643,1743378841,1743378841.812289,-18000,,
com.apple.finder,27,1743378616,1743378643,1743378643.703507,-18000,,
com.microsoft.VSCode,9,1743378607,1743378616,1743378616.1499891,-18000,,
com.apple.shortcuts,33,1743378574,1743378607,1743378607.267877,-18000,,
com.leomehlig.today,38,1743378352,1743378390,1743378390.337183,-18000,,
com.microsoft.VSCode,10,1743378342,1743378352,1743378352.3683481,-18000,,
com.apple.finder,41,1743378301,1743378342,1743378342.501833,-18000,,
com.hammerandchisel.discord,6,1743378107,1743378113,1743378114.177984,-18000,EB445137-D7F5-57EC-87DA-1DB460D64046,"iPhone13,2"
com.apple.findmy,3,1743377770,1743377773,1743377773.1617742,-18000,EB445137-D7F5-57EC-87DA-1DB460D64046,"iPhone13,2"
com.apple.findmy,38,1743377650,1743377688,1743377688.381301,-18000,EB445137-D7F5-57EC-87DA-1DB460D64046,"iPhone13,2"
com.apple.findmy,58,1743377587,1743377645,1743377645.765781,-18000,EB445137-D7F5-57EC-87DA-1DB460D64046,"iPhone13,2"
com.apple.weather,11,1743375157,1743375168,1743375168.758661,-18000,EB445137-D7F5-57EC-87DA-1DB460D64046,"iPhone13,2"
com.toyopagroup.picaboo,4,1743375146,1743375150,1743375151.2348351,-18000,EB445137-D7F5-57EC-87DA-1DB460D64046,"iPhone13,2"
com.toyopagroup.picaboo,6,1743375140,1743375146,1743375146.244086,-18000,EB445137-D7F5-57EC-87DA-1DB460D64046,"iPhone13,2"
com.apple.finder,1,1743373671,1743373672,1743373673.0899801,-18000,,
com.leomehlig.today,10,1743373661,1743373671,1743373671.348295,-18000,,
com.apple.finder,5,1743373656,1743373661,1743373661.533241,-18000,,
com.google.Chrome,39,1743373617,1743373656,1743373656.7189698,-18000,,
com.apple.finder,4,1743373613,1743373617,1743373617.088253,-18000,,
com.google.Chrome,777,1743372836,1743373613,1743373613.626468,-18000,,
com.leomehlig.today,11,1743372825,1743372836,1743372836.528942,-18000,,
com.google.Chrome,1231,1743371594,1743372825,1743372825.561925,-18000,,
com.apple.finder,5,1743371589,1743371594,1743371594.750756,-18000,,
com.google.Chrome,2064,1743369525,1743371589,1743371589.990715,-18000,,
com.google.Chrome,1115,1743368396,1743369511,1743369511.57053,-18000,,
com.leomehlig.today,3,1743368380,1743368383,1743368383.654787,-18000,,
com.google.Chrome,272,1743368108,1743368380,1743368380.325873,-18000,,
com.google.Chrome,307,1743367773,1743368080,1743368081.001579,-18000,,
com.google.Chrome,337,1743367396,1743367733,1743367733.998236,-18000,,
com.google.Chrome,396,1743366627,1743367023,1743367023.282496,-18000,,
com.apple.news,58,1743366569,1743366627,1743366627.231631,-18000,,
com.google.Chrome,84,1743366485,1743366569,1743366569.054021,-18000,,
com.leomehlig.today,6,1743366479,1743366485,1743366486.456958,-18000,,
com.toyopagroup.picaboo,13,1743365518,1743365531,1743365531.423629,-18000,EB445137-D7F5-57EC-87DA-1DB460D64046,"iPhone13,2"
com.leomehlig.today,24,1743365347,1743365371,1743365372.0533938,-18000,,
com.google.Chrome,360,1743364987,1743365347,1743365348.037036,-18000,,
com.apple.finder,2,1743364985,1743364987,1743364987.369646,-18000,,
com.leomehlig.today,1,1743364984,1743364985,1743364985.741712,-18000,,
com.google.Chrome,595,1743364389,1743364984,1743364984.816164,-18000,,
com.leomehlig.today,15,1743364374,1743364389,1743364389.9660401,-18000,,
com.google.Chrome,239,1743364135,1743364374,1743364374.113724,-18000,,
com.apple.finder,3,1743364132,1743364135,1743364135.965724,-18000,,
com.google.Chrome,152,1743363980,1743364132,1743364132.832738,-18000,,
com.apple.finder,3,1743363977,1743363980,1743363980.602604,-18000,,
com.google.Chrome,6,1743363971,1743363977,1743363977.694037,-18000,,
com.apple.finder,3,1743363968,1743363971,1743363971.73341,-18000,,
com.google.Chrome,84,1743363884,1743363968,1743363968.428596,-18000,,
com.apple.Preview,162,1743363722,1743363884,1743363884.4401531,-18000,,
com.google.Chrome,512,1743363210,1743363722,1743363722.993744,-18000,,
com.apple.Preview,9,1743363201,1743363210,1743363210.167399,-18000,,
com.apple.finder,2,1743363199,1743363201,1743363201.0215569,-18000,,
com.google.Chrome,3,1743363196,1743363199,1743363199.611696,-18000,,
com.apple.finder,12,1743363184,1743363196,1743363196.817369,-18000,,
com.google.Chrome,10,1743363174,1743363184,1743363184.242795,-18000,,
com.apple.finder,2,1743363172,1743363174,1743363174.5953279,-18000,,
com.google.Chrome,1,1743363171,1743363172,1743363172.335016,-18000,,
com.apple.finder,1,1743363170,1743363171,1743363171.354876,-18000,,
com.google.Chrome,1,1743363169,1743363170,1743363170.361505,-18000,,
com.apple.finder,1,1743363168,1743363169,1743363169.512084,-18000,,
com.google.Chrome,8,1743363160,1743363168,1743363168.199189,-18000,,
com.apple.finder,16,1743363144,1743363160,1743363160.263521,-18000,,
com.intsig.CamScannerLite,50,1743363010,1743363060,1743363062.1735392,-18000,EB445137-D7F5-57EC-87DA-1DB460D64046,"iPhone13,2"
com.google.chrome.ios,3,1743363007,1743363010,1743363010.3197908,-18000,EB445137-D7F5-57EC-87DA-1DB460D64046,"iPhone13,2"
com.intsig.CamScannerLite,131,1743362876,1743363007,1743363007.8086638,-18000,EB445137-D7F5-57EC-87DA-1DB460D64046,"iPhone13,2"
com.microsoft.Office.Outlook,2,1743362874,1743362876,1743362876.1760058,-18000,EB445137-D7F5-57EC-87DA-1DB460D64046,"iPhone13,2"
com.google.Chrome,279,1743362865,1743363144,1743363144.452532,-18000,,
com.apple.finder,2,1743362848,1743362850,1743362850.401515,-18000,,
com.google.Chrome,10,1743362838,1743362848,1743362848.51032,-18000,,
com.apple.finder,13,1743362825,1743362838,1743362838.383049,-18000,,
com.google.Chrome,145,1743362680,1743362825,1743362825.867198,-18000,,
com.apple.finder,1,1743362679,1743362680,1743362680.434905,-18000,,
com.google.Chrome,29,1743362650,1743362679,1743362679.134681,-18000,,
com.apple.finder,11,1743362639,1743362650,1743362650.621319,-18000,,
com.google.Chrome,23,1743362616,1743362639,1743362639.335813,-18000,,
com.apple.finder,8,1743362608,1743362616,1743362616.653038,-18000,,
com.google.Chrome,7,1743362601,1743362608,1743362608.2965589,-18000,,
com.apple.finder,1,1743362600,1743362601,1743362601.7248101,-18000,,
com.google.Chrome,1,1743362599,1743362600,1743362600.490347,-18000,,
com.apple.finder,2,1743362597,1743362599,1743362599.461451,-18000,,
com.google.Chrome,8,1743362589,1743362597,1743362597.856715,-18000,,
com.apple.finder,1,1743362588,1743362589,1743362590.008154,-18000,,
com.google.Chrome,8,1743362580,1743362588,1743362588.55521,-18000,,
com.apple.finder,4,1743362576,1743362580,1743362580.213822,-18000,,
com.google.Chrome,171,1743362405,1743362576,1743362576.936386,-18000,,
com.apple.finder,3,1743362402,1743362405,1743362405.33816,-18000,,
com.google.Chrome,92,1743362310,1743362402,1743362402.899678,-18000,,
com.apple.finder,3,1743362307,1743362310,1743362310.895819,-18000,,
com.google.Chrome,15,1743362292,1743362307,1743362307.5074,-18000,,
com.apple.finder,3,1743362289,1743362292,1743362292.9598908,-18000,,
com.google.Chrome,408,1743361881,1743362289,1743362289.7224422,-18000,,
com.apple.finder,2,1743361879,1743361881,1743361881.521569,-18000,,
com.google.Chrome,9,1743361870,1743361879,1743361879.786797,-18000,,
com.apple.finder,31,1743361839,1743361870,1743361870.951895,-18000,,
com.google.Chrome,6,1743361833,1743361839,1743361839.6734571,-18000,,
com.leomehlig.today,47,1743361786,1743361833,1743361833.160016,-18000,,
com.microsoft.Office.Outlook,7,1743361778,1743361785,1743361785.748065,-18000,EB445137-D7F5-57EC-87DA-1DB460D64046,"iPhone13,2"
com.apple.MobileSMS,45,1743361732,1743361777,1743361777.6108298,-18000,EB445137-D7F5-57EC-87DA-1DB460D64046,"iPhone13,2"
com.apple.weather,0,1743361732,1743361732,1743361733.357181,-18000,EB445137-D7F5-57EC-87DA-1DB460D64046,"iPhone13,2"
com.apple.weather,8,1743361391,1743361399,1743361399.6348329,-18000,EB445137-D7F5-57EC-87DA-1DB460D64046,"iPhone13,2"
com.apple.weather,9,1743360786,1743360795,1743360796.4255629,-18000,EB445137-D7F5-57EC-87DA-1DB460D64046,"iPhone13,2"
com.apple.weather,13,1743359561,1743359574,1743359575.150496,-18000,EB445137-D7F5-57EC-87DA-1DB460D64046,"iPhone13,2"
com.apple.weather,4,1743359557,1743359561,1743359564.6683378,-18000,EB445137-D7F5-57EC-87DA-1DB460D64046,"iPhone13,2"
com.google.Chrome,2663,1743359123,1743361786,1743361786.333499,-18000,,
com.apple.finder,9,1743359114,1743359123,1743359123.350651,-18000,,
com.apple.finder,1,1743358042,1743358043,1743358043.947628,-18000,,
com.leomehlig.today,1,1743358041,1743358042,1743358042.339113,-18000,,
com.apple.finder,15,1743358026,1743358041,1743358041.579771,-18000,,
com.leomehlig.today,58,1743357968,1743358026,1743358026.604529,-18000,,
com.google.Chrome,6,1743357962,1743357968,1743357968.138784,-18000,,
com.apple.finder,3,1743357959,1743357962,1743357962.183577,-18000,,
com.microsoft.VSCode,4,1743357955,1743357959,1743357959.386211,-18000,,
com.apple.weather,11,1743357650,1743357661,1743357662.326658,-18000,EB445137-D7F5-57EC-87DA-1DB460D64046,"iPhone13,2"
com.apple.finder,119,1743357646,1743357765,1743357765.313177,-18000,,
com.apple.findmy,17,1743355091,1743355108,1743355109.060399,-18000,EB445137-D7F5-57EC-87DA-1DB460D64046,"iPhone13,2"
com.apple.MobileSMS,40,1743355049,1743355089,1743355090.043984,-18000,EB445137-D7F5-57EC-87DA-1DB460D64046,"iPhone13,2"
com.apple.Health,50,1743354365,1743354415,1743354415.691784,-18000,EB445137-D7F5-57EC-87DA-1DB460D64046,"iPhone13,2"
com.microsoft.Office.Outlook,32,1743354331,1743354363,1743354363.0623012,-18000,EB445137-D7F5-57EC-87DA-1DB460D64046,"iPhone13,2"
com.apple.finder,338,1743350966,1743351304,1743351304.304637,-18000,,
com.microsoft.VSCode,22,1743350944,1743350966,1743350966.829863,-18000,,
com.apple.finder,26,1743350918,1743350944,1743350944.928071,-18000,,
com.microsoft.VSCode,14,1743350904,1743350918,1743350918.160248,-18000,,
com.apple.finder,8,1743350896,1743350904,1743350904.543508,-18000,,
com.microsoft.VSCode,8,1743350888,1743350896,1743350896.538111,-18000,,
com.apple.Health,35,1743350834,1743350869,1743350869.641986,-18000,EB445137-D7F5-57EC-87DA-1DB460D64046,"iPhone13,2"
com.apple.MobileSMS,6,1743350827,1743350833,1743350833.2168322,-18000,EB445137-D7F5-57EC-87DA-1DB460D64046,"iPhone13,2"
com.apple.news,41,1743350785,1743350826,1743350826.750307,-18000,EB445137-D7F5-57EC-87DA-1DB460D64046,"iPhone13,2"
com.apple.MobileSMS,9,1743350776,1743350785,1743350785.50885,-18000,EB445137-D7F5-57EC-87DA-1DB460D64046,"iPhone13,2"
com.apple.Preferences,39,1743350690,1743350729,1743350729.973332,-18000,EB445137-D7F5-57EC-87DA-1DB460D64046,"iPhone13,2"
com.apple.news,0,1743350690,1743350690,1743350692.2593079,-18000,EB445137-D7F5-57EC-87DA-1DB460D64046,"iPhone13,2"
com.apple.finder,225,1743350663,1743350888,1743350888.476331,-18000,,
com.apple.Preview,22,1743350641,1743350663,1743350663.7548199,-18000,,
com.apple.finder,6,1743350635,1743350641,1743350641.6455,-18000,,
com.apple.Preview,14,1743350621,1743350635,1743350635.3414001,-18000,,
com.apple.finder,12,1743350609,1743350621,1743350621.961472,-18000,,
com.microsoft.VSCode,18,1743350591,1743350609,1743350609.1514559,-18000,,
com.apple.finder,0,1743350591,1743350591,1743350591.7494268,-18000,,
com.microsoft.VSCode,71,1743350520,1743350591,1743350591.14634,-18000,,
com.apple.finder,6,1743350514,1743350520,1743350520.990288,-18000,,
com.microsoft.VSCode,104,1743350410,1743350514,1743350514.1467,-18000,,
com.apple.news,8,1743350378,1743350386,1743350386.266652,-18000,EB445137-D7F5-57EC-87DA-1DB460D64046,"iPhone13,2"
com.apple.news,165,1743350203,1743350368,1743350368.484074,-18000,EB445137-D7F5-57EC-87DA-1DB460D64046,"iPhone13,2"
com.apple.finder,245,1743350165,1743350410,1743350410.479979,-18000,,
com.microsoft.VSCode,4,1743350161,1743350165,1743350165.082003,-18000,,
com.apple.finder,2,1743350159,1743350161,1743350161.550107,-18000,,
com.apple.news,172,1743349848,1743350020,1743350021.029567,-18000,EB445137-D7F5-57EC-87DA-1DB460D64046,"iPhone13,2"
com.google.chrome.ios,7,1743349836,1743349843,1743349843.993285,-18000,EB445137-D7F5-57EC-87DA-1DB460D64046,"iPhone13,2"
com.microsoft.VSCode,370,1743349789,1743350159,1743350159.583288,-18000,,
com.apple.finder,6,1743349783,1743349789,1743349789.173355,-18000,,
com.microsoft.VSCode,7,1743349776,1743349783,1743349783.93589,-18000,,
com.apple.finder,3,1743349773,1743349776,1743349776.432115,-18000,,
com.microsoft.VSCode,14,1743349759,1743349773,1743349773.213008,-18000,,
com.apple.finder,8,1743349751,1743349759,1743349759.9490662,-18000,,
com.microsoft.VSCode,3,1743349748,1743349751,1743349751.239353,-18000,,
com.apple.finder,2,1743349746,1743349748,1743349748.8789802,-18000,,
com.microsoft.VSCode,98,1743349648,1743349746,1743349746.4274812,-18000,,
com.apple.finder,19,1743349629,1743349648,1743349648.639461,-18000,,
com.microsoft.VSCode,7,1743349622,1743349629,1743349629.775165,-18000,,
com.apple.finder,23,1743349599,1743349622,1743349622.556851,-18000,,
com.microsoft.VSCode,20,1743349579,1743349599,1743349599.818985,-18000,,
com.apple.finder,13,1743349566,1743349579,1743349579.296973,-18000,,
com.google.chrome.ios,46,1743349013,1743349059,1743349064.009879,-18000,EB445137-D7F5-57EC-87DA-1DB460D64046,"iPhone13,2"
com.apple.news,89,1743348923,1743349012,1743349012.3355942,-18000,EB445137-D7F5-57EC-87DA-1DB460D64046,"iPhone13,2"
com.apple.weather,5,1743348909,1743348914,1743348914.2744288,-18000,EB445137-D7F5-57EC-87DA-1DB460D64046,"iPhone13,2"
com.microsoft.VSCode,718,1743348848,1743349566,1743349566.732469,-18000,,
com.apple.finder,8,1743348840,1743348848,1743348848.41431,-18000,,
com.apple.Preview,22,1743348818,1743348840,1743348840.402291,-18000,,
com.apple.finder,3,1743348815,1743348818,1743348818.349557,-18000,,
com.apple.Preview,7,1743348808,1743348815,1743348815.033803,-18000,,
com.apple.finder,13,1743348795,1743348808,1743348808.061449,-18000,,
com.microsoft.VSCode,38,1743348757,1743348795,1743348795.916311,-18000,,
com.apple.finder,118,1743348639,1743348757,1743348757.918161,-18000,,
com.microsoft.VSCode,3,1743348636,1743348639,1743348639.430987,-18000,,
com.apple.finder,8,1743348628,1743348636,1743348636.212473,-18000,,
com.microsoft.VSCode,228,1743348400,1743348628,1743348628.584324,-18000,,
com.google.Chrome,76,1743348324,1743348400,1743348400.082531,-18000,,
com.microsoft.VSCode,53,1743348271,1743348324,1743348324.947075,-18000,,
com.apple.finder,2,1743348269,1743348271,1743348271.159241,-18000,,
com.microsoft.VSCode,8,1743348261,1743348269,1743348269.502773,-18000,,
com.apple.finder,2,1743348259,1743348261,1743348261.2044911,-18000,,
com.microsoft.VSCode,1,1743348258,1743348259,1743348260.006966,-18000,,
com.apple.finder,5,1743348253,1743348258,1743348258.093962,-18000,,
com.microsoft.VSCode,52,1743348201,1743348253,1743348253.227776,-18000,,
com.apple.finder,8,1743348193,1743348201,1743348201.509984,-18000,,
com.microsoft.VSCode,7,1743348186,1743348193,1743348193.91926,-18000,,
com.apple.finder,26,1743348160,1743348186,1743348186.057253,-18000,,
com.microsoft.VSCode,6,1743348154,1743348160,1743348160.669806,-18000,,
com.apple.finder,151,1743348003,1743348154,1743348154.844685,-18000,,
com.microsoft.VSCode,45,1743347958,1743348003,1743348003.7298288,-18000,,
com.apple.finder,60,1743347898,1743347958,1743347958.4901628,-18000,,
com.microsoft.VSCode,27,1743347871,1743347898,1743347898.94726,-18000,,
com.apple.finder,7,1743347864,1743347871,1743347871.243958,-18000,,
com.microsoft.VSCode,91,1743347773,1743347864,1743347864.197788,-18000,,
com.apple.weather,37,1743347756,1743347793,1743347794.456595,-18000,EB445137-D7F5-57EC-87DA-1DB460D64046,"iPhone13,2"
com.apple.news,1,1743347755,1743347756,1743347756.949953,-18000,EB445137-D7F5-57EC-87DA-1DB460D64046,"iPhone13,2"
com.apple.finder,31,1743347742,1743347773,1743347773.7189121,-18000,,
com.microsoft.VSCode,3,1743347739,1743347742,1743347742.4933329,-18000,,
com.apple.finder,32,1743347707,1743347739,1743347739.434366,-18000,,
com.microsoft.VSCode,6,1743347701,1743347707,1743347707.7081199,-18000,,
com.apple.finder,5,1743347696,1743347701,1743347701.5254989,-18000,,
com.microsoft.VSCode,5,1743347691,1743347696,1743347696.516187,-18000,,
com.apple.finder,9,1743347682,1743347691,1743347691.9079561,-18000,,
com.microsoft.VSCode,84,1743347598,1743347682,1743347682.8767629,-18000,,
com.google.Chrome,55,1743347543,1743347598,1743347598.792622,-18000,,
com.apple.news,242,1743347312,1743347554,1743347555.47932,-18000,EB445137-D7F5-57EC-87DA-1DB460D64046,"iPhone13,2"
com.microsoft.VSCode,244,1743347284,1743347528,1743347528.567096,-18000,,
com.leomehlig.today,7,1743347277,1743347284,1743347284.476358,-18000,,
com.microsoft.VSCode,46,1743347231,1743347277,1743347277.2299519,-18000,,
com.apple.finder,7,1743347224,1743347231,1743347231.966212,-18000,,
com.microsoft.VSCode,13,1743347211,1743347224,1743347224.229244,-18000,,
com.apple.finder,9,1743347202,1743347211,1743347211.817377,-18000,,
com.microsoft.VSCode,713,1743346489,1743347202,1743347202.158674,-18000,,
com.apple.finder,16,1743346473,1743346489,1743346489.922174,-18000,,
com.microsoft.VSCode,43,1743346430,1743346473,1743346473.3903852,-18000,,
com.apple.finder,16,1743346414,1743346430,1743346430.7752,-18000,,
com.google.Chrome,26,1743346388,1743346414,1743346414.248172,-18000,,
com.apple.finder,7,1743346381,1743346388,1743346388.4676871,-18000,,
com.google.Chrome,6,1743346375,1743346381,1743346381.509407,-18000,,
com.microsoft.VSCode,54,1743346321,1743346375,1743346375.330737,-18000,,
com.apple.finder,26,1743346295,1743346321,1743346321.744839,-18000,,
com.microsoft.VSCode,2,1743346293,1743346295,1743346295.341063,-18000,,
com.apple.finder,25,1743346268,1743346293,1743346293.9558039,-18000,,
com.google.Chrome,51,1743346217,1743346268,1743346268.863428,-18000,,
com.apple.finder,39,1743346178,1743346217,1743346217.7715511,-18000,,
com.google.Chrome,23,1743346155,1743346178,1743346178.781791,-18000,,
com.apple.finder,4,1743346151,1743346155,1743346155.131285,-18000,,
com.microsoft.VSCode,22,1743346129,1743346151,1743346151.250094,-18000,,
com.apple.finder,91,1743346038,1743346129,1743346129.80764,-18000,,
com.microsoft.VSCode,41,1743345997,1743346038,1743346038.9613252,-18000,,
com.apple.finder,7,1743345990,1743345997,1743345997.686511,-18000,,
com.microsoft.VSCode,5,1743345985,1743345990,1743345990.584002,-18000,,
com.apple.finder,21,1743345964,1743345985,1743345985.872175,-18000,,
com.microsoft.VSCode,45,1743345919,1743345964,1743345964.427923,-18000,,
com.apple.finder,14,1743345905,1743345919,1743345919.222309,-18000,,
com.microsoft.VSCode,1,1743345904,1743345905,1743345905.9085488,-18000,,
com.google.Chrome,0,1743345904,1743345904,1743345904.68718,-18000,,
com.microsoft.VSCode,115,1743345789,1743345904,1743345904.032724,-18000,,
com.google.Chrome,25,1743345764,1743345789,1743345789.748816,-18000,,
com.microsoft.VSCode,23,1743345741,1743345764,1743345764.9356809,-18000,,
com.google.Chrome,27,1743345714,1743345741,1743345741.894906,-18000,,
com.microsoft.VSCode,7,1743345707,1743345714,1743345714.15516,-18000,,
com.google.Chrome,2,1743345705,1743345707,1743345707.5165892,-18000,,
com.microsoft.VSCode,61,1743345644,1743345705,1743345705.067505,-18000,,
com.google.Chrome,29,1743345615,1743345644,1743345645.041041,-18000,,
com.microsoft.VSCode,2,1743345613,1743345615,1743345615.170875,-18000,,
com.apple.finder,4,1743345609,1743345613,1743345613.5712872,-18000,,
com.microsoft.VSCode,2,1743345607,1743345609,1743345609.8808188,-18000,,
com.apple.finder,3,1743345604,1743345607,1743345607.462558,-18000,,
com.microsoft.VSCode,24,1743345580,1743345604,1743345604.294749,-18000,,
com.apple.finder,13,1743345567,1743345580,1743345580.477377,-18000,,
com.microsoft.VSCode,2,1743345565,1743345567,1743345567.431669,-18000,,
com.apple.finder,13,1743345552,1743345565,1743345565.84193,-18000,,
com.microsoft.VSCode,72,1743345480,1743345552,1743345552.268797,-18000,,
com.apple.finder,4,1743345476,1743345480,1743345480.989856,-18000,,
com.microsoft.VSCode,42,1743345434,1743345476,1743345476.088716,-18000,,
com.apple.finder,14,1743345420,1743345434,1743345434.898881,-18000,,
com.microsoft.VSCode,533,1743344887,1743345420,1743345420.3523211,-18000,,
com.google.Chrome,1,1743344886,1743344887,1743344887.565414,-18000,,
com.microsoft.VSCode,16,1743344870,1743344886,1743344886.3888578,-18000,,
com.google.Chrome,2,1743344868,1743344870,1743344870.938747,-18000,,
com.microsoft.VSCode,6,1743344862,1743344868,1743344869.0027761,-18000,,
com.google.Chrome,4,1743344858,1743344862,1743344862.341455,-18000,,
com.microsoft.VSCode,286,1743344572,1743344858,1743344858.601888,-18000,,
com.google.Chrome,13,1743344559,1743344572,1743344572.279334,-18000,,
com.microsoft.VSCode,935,1743343624,1743344559,1743344559.623421,-18000,,
com.google.Chrome,1,1743343623,1743343624,1743343624.842935,-18000,,
com.microsoft.VSCode,13,1743343610,1743343623,1743343623.685096,-18000,,
com.google.Chrome,1,1743343609,1743343610,1743343610.952836,-18000,,
com.microsoft.VSCode,6,1743343603,1743343609,1743343609.91103,-18000,,
com.google.Chrome,2,1743343601,1743343603,1743343603.272614,-18000,,
com.microsoft.VSCode,4,1743343597,1743343601,1743343601.8121219,-18000,,
com.google.Chrome,2,1743343595,1743343597,1743343597.107413,-18000,,
com.microsoft.VSCode,4,1743343591,1743343595,1743343596.054394,-18000,,
com.google.Chrome,2,1743343589,1743343591,1743343591.150741,-18000,,
com.microsoft.VSCode,9,1743343580,1743343589,1743343590.013257,-18000,,
com.google.Chrome,1,1743343579,1743343580,1743343580.784946,-18000,,
com.microsoft.VSCode,5,1743343574,1743343579,1743343579.345735,-18000,,
com.google.Chrome,1,1743343573,1743343574,1743343574.649339,-18000,,
com.microsoft.VSCode,34,1743343539,1743343573,1743343573.310926,-18000,,
com.google.Chrome,1,1743343538,1743343539,1743343539.074981,-18000,,
com.microsoft.VSCode,33,1743343505,1743343538,1743343538.399788,-18000,,
com.google.Chrome,8,1743343497,1743343505,1743343505.9377089,-18000,,
com.microsoft.VSCode,6,1743343491,1743343497,1743343497.315068,-18000,,
com.google.Chrome,3,1743343488,1743343491,1743343491.7834501,-18000,,
com.microsoft.VSCode,20,1743343468,1743343488,1743343488.674487,-18000,,
com.google.Chrome,11,1743343457,1743343468,1743343468.289305,-18000,,
com.microsoft.VSCode,3,1743343454,1743343457,1743343457.1596122,-18000,,
com.google.Chrome,2,1743343452,1743343454,1743343454.384913,-18000,,
com.microsoft.VSCode,1,1743343451,1743343452,1743343453.028963,-18000,,
com.google.Chrome,1,1743343450,1743343451,1743343451.941097,-18000,,
com.microsoft.VSCode,9,1743343441,1743343450,1743343450.5851479,-18000,,
com.google.Chrome,6,1743343435,1743343441,1743343441.477848,-18000,,
com.microsoft.VSCode,4,1743343431,1743343435,1743343435.190628,-18000,,
com.google.Chrome,1,1743343430,1743343431,1743343431.55168,-18000,,
com.microsoft.VSCode,3,1743343427,1743343430,1743343430.278851,-18000,,
com.google.Chrome,5,1743343422,1743343427,1743343427.530819,-18000,,
com.microsoft.VSCode,3,1743343419,1743343422,1743343423.0086641,-18000,,
com.google.Chrome,8,1743343411,1743343419,1743343419.829664,-18000,,
com.microsoft.VSCode,8,1743343403,1743343411,1743343411.7546191,-18000,,
com.google.Chrome,1,1743343402,1743343403,1743343403.353982,-18000,,
com.microsoft.VSCode,3,1743343399,1743343402,1743343402.39393,-18000,,
com.google.Chrome,3,1743343396,1743343399,1743343399.900964,-18000,,
com.microsoft.VSCode,2,1743343394,1743343396,1743343396.227058,-18000,,
com.google.Chrome,1,1743343393,1743343394,1743343394.9841409,-18000,,
com.microsoft.VSCode,1,1743343392,1743343393,1743343393.812247,-18000,,
com.google.Chrome,6,1743343386,1743343392,1743343392.8213081,-18000,,
com.microsoft.VSCode,7,1743343379,1743343386,1743343386.6286778,-18000,,
com.google.Chrome,4,1743343375,1743343379,1743343379.9230042,-18000,,
com.microsoft.VSCode,4,1743343371,1743343375,1743343375.0915298,-18000,,
com.apple.finder,5,1743343366,1743343371,1743343371.420089,-18000,,
com.microsoft.VSCode,3,1743343363,1743343366,1743343366.186915,-18000,,
com.google.Chrome,2,1743343361,1743343363,1743343364.010879,-18000,,
com.microsoft.VSCode,12,1743343349,1743343361,1743343361.398543,-18000,,
com.google.Chrome,3,1743343346,1743343349,1743343349.417736,-18000,,
com.microsoft.VSCode,2,1743343344,1743343346,1743343346.433436,-18000,,
com.google.Chrome,2,1743343342,1743343344,1743343344.15661,-18000,,
com.microsoft.VSCode,3,1743343339,1743343342,1743343342.316294,-18000,,
com.google.Chrome,7,1743343332,1743343339,1743343339.973328,-18000,,
com.microsoft.VSCode,2,1743343330,1743343332,1743343332.6378798,-18000,,
com.google.Chrome,3,1743343327,1743343330,1743343330.290619,-18000,,
com.microsoft.VSCode,4,1743343323,1743343327,1743343328.078535,-18000,,
com.google.Chrome,1,1743343322,1743343323,1743343323.0706801,-18000,,
com.microsoft.VSCode,4,1743343318,1743343322,1743343322.459079,-18000,,
com.google.Chrome,43,1743343275,1743343318,1743343318.4137301,-18000,,
com.microsoft.VSCode,103,1743343172,1743343275,1743343275.7341561,-18000,,
com.google.Chrome,18,1743343154,1743343172,1743343172.7799091,-18000,,
com.microsoft.VSCode,65,1743343089,1743343154,1743343154.637949,-18000,,
com.google.Chrome,16,1743343073,1743343089,1743343089.4081922,-18000,,
com.microsoft.VSCode,3,1743343070,1743343073,1743343073.692573,-18000,,
com.google.Chrome,21,1743343049,1743343070,1743343070.501988,-18000,,
com.microsoft.VSCode,11,1743343038,1743343049,1743343049.117045,-18000,,
com.google.Chrome,14,1743343024,1743343038,1743343038.74066,-18000,,
com.microsoft.VSCode,4,1743343020,1743343024,1743343024.326294,-18000,,
com.google.Chrome,28,1743342992,1743343020,1743343020.777183,-18000,,
com.microsoft.VSCode,2,1743342990,1743342992,1743342992.85391,-18000,,
com.google.Chrome,6,1743342984,1743342990,1743342990.081269,-18000,,
com.microsoft.VSCode,1,1743342983,1743342984,1743342984.572582,-18000,,
com.google.Chrome,32,1743342951,1743342983,1743342983.213807,-18000,,
com.microsoft.VSCode,1,1743342950,1743342951,1743342951.734027,-18000,,
com.google.Chrome,5,1743342945,1743342950,1743342950.117419,-18000,,
com.microsoft.VSCode,2,1743342943,1743342945,1743342945.347378,-18000,,
com.google.Chrome,1,1743342942,1743342943,1743342944.002559,-18000,,
com.microsoft.VSCode,3,1743342939,1743342942,1743342942.655964,-18000,,
com.google.Chrome,79,1743342860,1743342939,1743342939.7136989,-18000,,
com.microsoft.VSCode,20,1743342840,1743342860,1743342860.178808,-18000,,
com.google.Chrome,0,1743342840,1743342840,1743342840.800174,-18000,,
com.microsoft.VSCode,12,1743342828,1743342840,1743342840.128552,-18000,,
com.google.Chrome,3,1743342825,1743342828,1743342828.294682,-18000,,
com.microsoft.VSCode,44,1743342781,1743342825,1743342826.038763,-18000,,
com.google.Chrome,5,1743342776,1743342781,1743342781.913197,-18000,,
com.electron.carta,81,1743342695,1743342776,1743342776.190458,-18000,,
com.google.Chrome,174,1743342521,1743342695,1743342695.92289,-18000,,
com.microsoft.VSCode,27,1743342494,1743342521,1743342521.556233,-18000,,
com.apple.finder,12,1743342482,1743342494,1743342494.7623801,-18000,,
com.microsoft.VSCode,21,1743342461,1743342482,1743342482.322551,-18000,,
com.apple.finder,6,1743342455,1743342461,1743342461.374336,-18000,,
com.apple.Health,29,1743342410,1743342439,1743342440.146049,-18000,EB445137-D7F5-57EC-87DA-1DB460D64046,"iPhone13,2"
com.leomehlig.today,55,1743342400,1743342455,1743342455.636997,-18000,,
com.microsoft.Office.Outlook,16,1743342389,1743342405,1743342405.5666652,-18000,EB445137-D7F5-57EC-87DA-1DB460D64046,"iPhone13,2"
com.letterboxd.LetterboxdApp,109,1743342279,1743342388,1743342388.108494,-18000,EB445137-D7F5-57EC-87DA-1DB460D64046,"iPhone13,2"
edu.cornell.birds.merlin,20,1743342254,1743342274,1743342274.491911,-18000,EB445137-D7F5-57EC-87DA-1DB460D64046,"iPhone13,2"
edu.cornell.birds.merlin,3,1743342251,1743342254,1743342254.0250401,-18000,EB445137-D7F5-57EC-87DA-1DB460D64046,"iPhone13,2"
edu.cornell.birds.merlin,2,1743342244,1743342246,1743342246.8972878,-18000,EB445137-D7F5-57EC-87DA-1DB460D64046,"iPhone13,2"
edu.cornell.birds.merlin,58,1743341780,1743341838,1743341838.4651031,-18000,EB445137-D7F5-57EC-87DA-1DB460D64046,"iPhone13,2"
com.google.chrome.ios,66,1743341574,1743341640,1743341640.5321422,-18000,EB445137-D7F5-57EC-87DA-1DB460D64046,"iPhone13,2"
com.google.chrome.ios,43,1743341426,1743341469,1743341469.8463259,-18000,EB445137-D7F5-57EC-87DA-1DB460D64046,"iPhone13,2"
edu.cornell.birds.merlin,207,1743341217,1743341424,1743341424.4371262,-18000,EB445137-D7F5-57EC-87DA-1DB460D64046,"iPhone13,2"
edu.cornell.birds.merlin,20,1743341195,1743341215,1743341215.449627,-18000,EB445137-D7F5-57EC-87DA-1DB460D64046,"iPhone13,2"
com.apple.camera,5,1743341188,1743341193,1743341204.0027351,-18000,EB445137-D7F5-57EC-87DA-1DB460D64046,"iPhone13,2"
edu.cornell.birds.merlin,33,1743341155,1743341188,1743341189.115457,-18000,EB445137-D7F5-57EC-87DA-1DB460D64046,"iPhone13,2"
edu.cornell.birds.merlin,28,1743340736,1743340764,1743340764.9594479,-18000,EB445137-D7F5-57EC-87DA-1DB460D64046,"iPhone13,2"
com.renpho.health,2,1743340731,1743340733,1743340733.392935,-18000,EB445137-D7F5-57EC-87DA-1DB460D64046,"iPhone13,2"
com.apple.PosterBoard,0,1743340731,1743340731,1743340732.057878,-18000,EB445137-D7F5-57EC-87DA-1DB460D64046,"iPhone13,2"
com.renpho.health,33,1743339370,1743339403,1743339404.107596,-18000,EB445137-D7F5-57EC-87DA-1DB460D64046,"iPhone13,2"
com.apple.weather,75,1743338297,1743338372,1743338372.58541,-18000,EB445137-D7F5-57EC-87DA-1DB460D64046,"iPhone13,2"
com.apple.MobileSMS,42,1743313712,1743313754,1743313754.759665,-18000,EB445137-D7F5-57EC-87DA-1DB460D64046,"iPhone13,2"
com.apple.MobileSMS,3,1743313642,1743313645,1743313645.417296,-18000,EB445137-D7F5-57EC-87DA-1DB460D64046,"iPhone13,2"
com.apple.MobileSMS,7,1743311577,1743311584,1743311585.10331,-18000,EB445137-D7F5-57EC-87DA-1DB460D64046,"iPhone13,2"
com.apple.MobileSMS,2,1743311330,1743311332,1743311332.993665,-18000,EB445137-D7F5-57EC-87DA-1DB460D64046,"iPhone13,2"
com.apple.MobileSMS,21,1743311289,1743311310,1743311310.919983,-18000,EB445137-D7F5-57EC-87DA-1DB460D64046,"iPhone13,2"
com.apple.MobileSMS,83,1743311203,1743311286,1743311286.60852,-18000,EB445137-D7F5-57EC-87DA-1DB460D64046,"iPhone13,2"
com.apple.MobileSMS,7,1743311173,1743311180,1743311180.941391,-18000,EB445137-D7F5-57EC-87DA-1DB460D64046,"iPhone13,2"
com.apple.MobileSMS,30,1743311137,1743311167,1743311167.639576,-18000,EB445137-D7F5-57EC-87DA-1DB460D64046,"iPhone13,2"
com.apple.weather,2,1743311135,1743311137,1743311137.152607,-18000,EB445137-D7F5-57EC-87DA-1DB460D64046,"iPhone13,2"
com.apple.weather,6,1743309025,1743309031,1743309031.6253939,-18000,EB445137-D7F5-57EC-87DA-1DB460D64046,"iPhone13,2"
com.google.chrome.ios,18,1743308961,1743308979,1743308979.4109511,-18000,EB445137-D7F5-57EC-87DA-1DB460D64046,"iPhone13,2"
com.google.chrome.ios,2,1743308959,1743308961,1743308961.460661,-18000,EB445137-D7F5-57EC-87DA-1DB460D64046,"iPhone13,2"
com.google.chrome.ios,1,1743308956,1743308957,1743308957.772187,-18000,EB445137-D7F5-57EC-87DA-1DB460D64046,"iPhone13,2"
com.google.chrome.ios,12,1743306661,1743306673,1743306673.923822,-18000,EB445137-D7F5-57EC-87DA-1DB460D64046,"iPhone13,2"
com.google.chrome.ios,4,1743306657,1743306661,1743306661.064652,-18000,EB445137-D7F5-57EC-87DA-1DB460D64046,"iPhone13,2"
com.google.chrome.ios,12,1743300185,1743300197,1743300197.423366,-18000,EB445137-D7F5-57EC-87DA-1DB460D64046,"iPhone13,2"
com.apple.MobileSMS,5,1743300088,1743300093,1743300093.596204,-18000,EB445137-D7F5-57EC-87DA-1DB460D64046,"iPhone13,2"
com.apple.MobileSMS,20,1743299870,1743299890,1743299891.044097,-18000,EB445137-D7F5-57EC-87DA-1DB460D64046,"iPhone13,2"
com.google.chrome.ios,2,1743299868,1743299870,1743299871.4944758,-18000,EB445137-D7F5-57EC-87DA-1DB460D64046,"iPhone13,2"
com.google.chrome.ios,12,1743294948,1743294960,1743294961.4320621,-18000,EB445137-D7F5-57EC-87DA-1DB460D64046,"iPhone13,2"
com.apple.Maps,3,1743294945,1743294948,1743294948.259968,-18000,EB445137-D7F5-57EC-87DA-1DB460D64046,"iPhone13,2"
com.apple.Maps,13,1743293065,1743293078,1743293079.165473,-18000,EB445137-D7F5-57EC-87DA-1DB460D64046,"iPhone13,2"
com.apple.weather,2,1743293062,1743293064,1743293064.661017,-18000,EB445137-D7F5-57EC-87DA-1DB460D64046,"iPhone13,2"
com.apple.weather,14,1743291957,1743291971,1743291971.800935,-18000,EB445137-D7F5-57EC-87DA-1DB460D64046,"iPhone13,2"
edu.cornell.birds.merlin,3,1743291954,1743291957,1743291957.496395,-18000,EB445137-D7F5-57EC-87DA-1DB460D64046,"iPhone13,2"
edu.cornell.birds.merlin,48,1743290883,1743290931,1743290931.3674378,-18000,EB445137-D7F5-57EC-87DA-1DB460D64046,"iPhone13,2"
com.google.chrome.ios,2,1743290879,1743290881,1743290881.2074862,-18000,EB445137-D7F5-57EC-87DA-1DB460D64046,"iPhone13,2"
com.google.chrome.ios,3,1743287703,1743287706,1743287706.901781,-18000,EB445137-D7F5-57EC-87DA-1DB460D64046,"iPhone13,2"
com.google.chrome.ios,69,1743286028,1743286097,1743286097.940851,-18000,EB445137-D7F5-57EC-87DA-1DB460D64046,"iPhone13,2"
com.burbn.instagram,120,1743285263,1743285383,1743285383.176238,-18000,EB445137-D7F5-57EC-87DA-1DB460D64046,"iPhone13,2"
com.burbn.instagram,148,1743284806,1743284954,1743284954.843643,-18000,EB445137-D7F5-57EC-87DA-1DB460D64046,"iPhone13,2"
com.apple.weather,8,1743284070,1743284078,1743284078.4152122,-18000,EB445137-D7F5-57EC-87DA-1DB460D64046,"iPhone13,2"
com.strava.stravaride,27,1743283792,1743283819,1743283819.257693,-18000,EB445137-D7F5-57EC-87DA-1DB460D64046,"iPhone13,2"
com.strava.stravaride,17,1743282801,1743282818,1743282818.434671,-18000,EB445137-D7F5-57EC-87DA-1DB460D64046,"iPhone13,2"
com.apple.weather,2,1743282677,1743282679,1743282679.6224089,-18000,EB445137-D7F5-57EC-87DA-1DB460D64046,"iPhone13,2"
com.leomehlig.today,90,1743282674,1743282764,1743282764.348981,-18000,,
com.google.Chrome,51,1743282623,1743282674,1743282674.98099,-18000,,
com.leomehlig.today,54,1743282569,1743282623,1743282623.09272,-18000,,
com.google.Chrome,8,1743282561,1743282569,1743282569.5550442,-18000,,
com.leomehlig.today,2,1743282559,1743282561,1743282561.294837,-18000,,
com.google.Chrome,8,1743282551,1743282559,1743282559.890935,-18000,,
com.microsoft.Outlook,16,1743282535,1743282551,1743282551.964184,-18000,,
com.google.Chrome,13,1743282522,1743282535,1743282535.872829,-18000,,
com.leomehlig.today,16,1743282506,1743282522,1743282522.741438,-18000,,
com.google.Chrome,58,1743282448,1743282506,1743282506.7234411,-18000,,
com.apple.finder,1,1743282435,1743282436,1743282436.369958,-18000,,
com.microsoft.VSCode,23,1743282412,1743282435,1743282435.8058438,-18000,,
com.apple.finder,15,1743282397,1743282412,1743282412.363574,-18000,,
com.apple.weather,13,1743282363,1743282376,1743282377.033584,-18000,EB445137-D7F5-57EC-87DA-1DB460D64046,"iPhone13,2"
com.apple.findmy,2,1743282359,1743282361,1743282361.793407,-18000,EB445137-D7F5-57EC-87DA-1DB460D64046,"iPhone13,2"
com.microsoft.VSCode,189,1743282208,1743282397,1743282397.922806,-18000,,
com.google.Chrome,14,1743282194,1743282208,1743282208.998907,-18000,,
com.microsoft.VSCode,146,1743282048,1743282194,1743282194.11955,-18000,,
com.google.Chrome,16,1743282032,1743282048,1743282048.171811,-18000,,
com.microsoft.VSCode,78,1743281954,1743282032,1743282032.6030002,-18000,,
com.google.Chrome,3,1743281951,1743281954,1743281954.3345041,-18000,,
com.microsoft.VSCode,79,1743281872,1743281951,1743281951.998074,-18000,,
com.google.Chrome,36,1743281836,1743281872,1743281872.781219,-18000,,
com.microsoft.VSCode,8,1743281828,1743281836,1743281836.491109,-18000,,
com.google.Chrome,34,1743281794,1743281828,1743281828.793267,-18000,,
com.apple.findmy,7,1743281779,1743281786,1743281786.242712,-18000,EB445137-D7F5-57EC-87DA-1DB460D64046,"iPhone13,2"
com.apple.MobileSMS,3,1743281774,1743281777,1743281777.721487,-18000,EB445137-D7F5-57EC-87DA-1DB460D64046,"iPhone13,2"
com.intsig.CamScannerLite,0,1743281774,1743281774,1743281774.7534962,-18000,EB445137-D7F5-57EC-87DA-1DB460D64046,"iPhone13,2"
com.microsoft.VSCode,52,1743281742,1743281794,1743281794.08305,-18000,,
com.microsoft.VSCode,118,1743281227,1743281345,1743281345.069303,-18000,,
com.google.Chrome,34,1743281193,1743281227,1743281227.1362891,-18000,,
com.microsoft.VSCode,287,1743280906,1743281193,1743281193.765878,-18000,,
com.google.Chrome,49,1743280857,1743280906,1743280907.031073,-18000,,
com.microsoft.VSCode,15,1743280842,1743280857,1743280857.503086,-18000,,
com.google.Chrome,2,1743280840,1743280842,1743280842.5932941,-18000,,
com.microsoft.VSCode,343,1743280497,1743280840,1743280840.132103,-18000,,
com.google.Chrome,5,1743280492,1743280497,1743280497.854868,-18000,,
com.microsoft.VSCode,57,1743280435,1743280492,1743280492.346568,-18000,,
com.google.Chrome,2,1743280433,1743280435,1743280435.923204,-18000,,
com.microsoft.VSCode,5,1743280428,1743280433,1743280433.608076,-18000,,
com.google.Chrome,5,1743280423,1743280428,1743280428.183666,-18000,,
com.microsoft.VSCode,2,1743280421,1743280423,1743280423.427544,-18000,,
com.google.Chrome,4,1743280417,1743280421,1743280421.285283,-18000,,
com.microsoft.VSCode,4,1743280413,1743280417,1743280417.302341,-18000,,
com.google.Chrome,3,1743280410,1743280413,1743280413.145509,-18000,,
com.microsoft.VSCode,1,1743280409,1743280410,1743280410.9469008,-18000,,
com.google.Chrome,1,1743280408,1743280409,1743280409.700844,-18000,,
com.microsoft.VSCode,1,1743280407,1743280408,1743280408.73052,-18000,,
com.google.Chrome,2,1743280405,1743280407,1743280407.3158069,-18000,,
com.microsoft.VSCode,18,1743280387,1743280405,1743280405.414209,-18000,,
com.google.Chrome,37,1743280350,1743280387,1743280387.59099,-18000,,
com.microsoft.VSCode,207,1743280143,1743280350,1743280350.639472,-18000,,
com.google.Chrome,12,1743280131,1743280143,1743280143.803975,-18000,,
com.microsoft.VSCode,327,1743279804,1743280131,1743280131.423884,-18000,,
com.google.Chrome,14,1743279790,1743279804,1743279804.710834,-18000,,
com.microsoft.VSCode,173,1743279617,1743279790,1743279790.723637,-18000,,
com.google.Chrome,17,1743279600,1743279617,1743279617.326472,-18000,,
com.microsoft.VSCode,138,1743279462,1743279600,1743279601.041326,-18000,,
com.google.Chrome,12,1743279450,1743279462,1743279462.368087,-18000,,
com.microsoft.VSCode,2,1743279448,1743279450,1743279450.1334782,-18000,,
com.google.Chrome,10,1743279438,1743279448,1743279448.9196,-18000,,
com.microsoft.VSCode,99,1743279339,1743279438,1743279438.64291,-18000,,
com.google.Chrome,16,1743279323,1743279339,1743279339.465302,-18000,,
com.microsoft.VSCode,40,1743279283,1743279323,1743279323.322132,-18000,,
com.google.Chrome,12,1743279271,1743279283,1743279283.325073,-18000,,
com.microsoft.VSCode,5,1743279266,1743279271,1743279271.078157,-18000,,
com.google.Chrome,2,1743279264,1743279266,1743279266.0850592,-18000,,
com.microsoft.VSCode,18,1743279246,1743279264,1743279264.67279,-18000,,
com.google.Chrome,2,1743279244,1743279246,1743279246.231866,-18000,,
com.microsoft.VSCode,0,1743279244,1743279244,1743279244.858769,-18000,,
com.google.Chrome,3,1743279241,1743279244,1743279244.194728,-18000,,
com.microsoft.VSCode,16,1743279225,1743279241,1743279241.181446,-18000,,
com.google.Chrome,2,1743279223,1743279225,1743279225.240052,-18000,,
com.microsoft.VSCode,2,1743279221,1743279223,1743279223.719521,-18000,,
com.google.Chrome,5,1743279216,1743279221,1743279221.5790548,-18000,,
com.microsoft.VSCode,5,1743279211,1743279216,1743279216.664635,-18000,,
com.google.Chrome,4,1743279207,1743279211,1743279211.24038,-18000,,
com.microsoft.VSCode,6,1743279201,1743279207,1743279207.1133518,-18000,,
com.google.Chrome,5,1743279196,1743279201,1743279201.645941,-18000,,
com.microsoft.VSCode,96,1743279100,1743279196,1743279196.959472,-18000,,
com.google.Chrome,11,1743279089,1743279100,1743279100.327523,-18000,,
com.microsoft.VSCode,11,1743279078,1743279089,1743279089.903339,-18000,,
com.google.Chrome,1,1743279077,1743279078,1743279078.119633,-18000,,
com.microsoft.VSCode,7,1743279070,1743279077,1743279077.13792,-18000,,
com.google.Chrome,1,1743279069,1743279070,1743279070.2505388,-18000,,
com.microsoft.VSCode,0,1743279069,1743279069,1743279069.884043,-18000,,
com.google.Chrome,3,1743279066,1743279069,1743279069.484622,-18000,,
com.microsoft.VSCode,5,1743279061,1743279066,1743279066.7256222,-18000,,
com.google.Chrome,6,1743279055,1743279061,1743279061.7134619,-18000,,
com.microsoft.VSCode,9,1743279046,1743279055,1743279055.054535,-18000,,
com.google.Chrome,1,1743279045,1743279046,1743279046.7369552,-18000,,
com.microsoft.VSCode,20,1743279025,1743279045,1743279045.7308369,-18000,,
com.google.Chrome,10,1743279015,1743279025,1743279025.534481,-18000,,
com.microsoft.VSCode,9,1743279006,1743279015,1743279015.643128,-18000,,
com.google.Chrome,9,1743278997,1743279006,1743279006.441716,-18000,,
com.microsoft.VSCode,22,1743278975,1743278997,1743278997.378134,-18000,,
com.google.Chrome,3,1743278972,1743278975,1743278975.814533,-18000,,
com.microsoft.VSCode,2,1743278970,1743278972,1743278972.679373,-18000,,
com.google.Chrome,129,1743278841,1743278970,1743278970.099051,-18000,,
com.microsoft.VSCode,122,1743278719,1743278841,1743278841.89639,-18000,,
com.google.Chrome,16,1743278703,1743278719,1743278719.368449,-18000,,
com.microsoft.VSCode,66,1743278637,1743278703,1743278703.347585,-18000,,
com.apple.finder,3,1743278634,1743278637,1743278637.04503,-18000,,
com.apple.finder,9,1743278257,1743278266,1743278266.6119142,-18000,,
com.leomehlig.today,2,1743278255,1743278257,1743278257.257841,-18000,,
com.google.Chrome,5,1743278250,1743278255,1743278255.334955,-18000,,
com.leomehlig.today,1,1743278249,1743278250,1743278250.637864,-18000,,
com.google.Chrome,1,1743278248,1743278249,1743278249.597485,-18000,,
com.leomehlig.today,1,1743278247,1743278248,1743278248.907717,-18000,,
com.google.Chrome,20,1743278227,1743278247,1743278247.9428601,-18000,,
com.leomehlig.today,13,1743278214,1743278227,1743278228.285136,-18000,,
com.google.Chrome,4,1743278210,1743278214,1743278214.521059,-18000,,
com.apple.finder,31,1743278179,1743278210,1743278210.901984,-18000,,
com.google.Chrome,35,1743278144,1743278179,1743278179.556345,-18000,,
com.leomehlig.today,2,1743278135,1743278137,1743278137.523014,-18000,,
com.google.Chrome,4,1743278131,1743278135,1743278135.296411,-18000,,
com.apple.finder,27,1743278104,1743278131,1743278131.165309,-18000,,
com.intsig.CamScannerLite,82,1743278066,1743278148,1743278148.4436011,-18000,EB445137-D7F5-57EC-87DA-1DB460D64046,"iPhone13,2"
com.apple.news,116,1743277586,1743277702,1743277702.1623778,-18000,EB445137-D7F5-57EC-87DA-1DB460D64046,"iPhone13,2"
com.intsig.CamScannerLite,3,1743277572,1743277575,1743277575.4503942,-18000,EB445137-D7F5-57EC-87DA-1DB460D64046,"iPhone13,2"
com.apple.Preview,550,1743277554,1743278104,1743278104.050768,-18000,,
com.leomehlig.today,7,1743277547,1743277554,1743277554.5619001,-18000,,
com.apple.Preview,963,1743276584,1743277547,1743277547.241054,-18000,,
com.apple.finder,1,1743276583,1743276584,1743276584.954205,-18000,,
com.apple.Preview,2,1743276581,1743276583,1743276583.400501,-18000,,
com.leomehlig.today,1,1743276580,1743276581,1743276581.934651,-18000,,
com.apple.Preview,265,1743276315,1743276580,1743276580.9078379,-18000,,
com.apple.Preview,584,1743275730,1743276314,1743276314.332783,-18000,,
com.leomehlig.today,153,1743275577,1743275730,1743275730.95815,-18000,,
com.apple.Preview,293,1743275284,1743275577,1743275577.910468,-18000,,
com.apple.finder,2,1743275282,1743275284,1743275284.35027,-18000,,
com.apple.Preview,63,1743275219,1743275282,1743275282.20078,-18000,,
com.apple.finder,14,1743275205,1743275219,1743275219.8474998,-18000,,
com.apple.Preview,3,1743275202,1743275205,1743275205.8920999,-18000,,
com.apple.finder,86,1743275116,1743275202,1743275202.488442,-18000,,
com.intsig.CamScannerLite,168,1743275006,1743275174,1743275174.902794,-18000,EB445137-D7F5-57EC-87DA-1DB460D64046,"iPhone13,2"
com.apple.MobileSMS,2,1743275004,1743275006,1743275006.4883308,-18000,EB445137-D7F5-57EC-87DA-1DB460D64046,"iPhone13,2"
com.apple.Preview,137,1743274979,1743275116,1743275116.663999,-18000,,
com.apple.finder,1,1743274978,1743274979,1743274979.7787971,-18000,,
com.apple.Preview,44,1743274934,1743274978,1743274978.4945002,-18000,,
com.apple.finder,6,1743274928,1743274934,1743274934.975891,-18000,,
com.apple.MobileSMS,9,1743274745,1743274754,1743274754.610915,-18000,EB445137-D7F5-57EC-87DA-1DB460D64046,"iPhone13,2"
com.apple.MobileSMS,7,1743274729,1743274736,1743274736.6187692,-18000,EB445137-D7F5-57EC-87DA-1DB460D64046,"iPhone13,2"
com.apple.news,3,1743274726,1743274729,1743274729.615438,-18000,EB445137-D7F5-57EC-87DA-1DB460D64046,"iPhone13,2"
com.leomehlig.today,227,1743274701,1743274928,1743274928.4389749,-18000,,
com.google.Chrome,582,1743274119,1743274701,1743274702.558182,-18000,,
com.leomehlig.today,4,1743274115,1743274119,1743274119.556412,-18000,,
com.apple.news,10,1743274104,1743274114,1743274115.2558122,-18000,EB445137-D7F5-57EC-87DA-1DB460D64046,"iPhone13,2"
com.apple.news,23,1743274076,1743274099,1743274099.751291,-18000,EB445137-D7F5-57EC-87DA-1DB460D64046,"iPhone13,2"
com.apple.news,2,1743274070,1743274072,1743274072.175991,-18000,EB445137-D7F5-57EC-87DA-1DB460D64046,"iPhone13,2"
com.apple.news,66,1743273739,1743273805,1743273806.221809,-18000,EB445137-D7F5-57EC-87DA-1DB460D64046,"iPhone13,2"
com.apple.Health,2,1743273734,1743273736,1743273736.617389,-18000,EB445137-D7F5-57EC-87DA-1DB460D64046,"iPhone13,2"
com.google.Chrome,420,1743273695,1743274115,1743274115.190227,-18000,,
com.leomehlig.today,10,1743273685,1743273695,1743273695.189647,-18000,,
com.google.Chrome,440,1743273245,1743273685,1743273685.187684,-18000,,
com.apple.Passwords,0,1743273245,1743273245,1743273245.8636441,-18000,,
com.google.Chrome,1,1743273244,1743273245,1743273245.3080502,-18000,,
com.leomehlig.today,0,1743273244,1743273244,1743273244.748691,-18000,,
com.google.Chrome,1,1743273243,1743273244,1743273244.3712258,-18000,,
com.apple.iCal,2,1743273241,1743273243,1743273243.226087,-18000,,
com.google.Chrome,1,1743273240,1743273241,1743273241.8977408,-18000,,
com.microsoft.Outlook,1,1743273239,1743273240,1743273240.670533,-18000,,
com.apple.Health,8,1743273050,1743273058,1743273058.483395,-18000,EB445137-D7F5-57EC-87DA-1DB460D64046,"iPhone13,2"
com.apple.weather,16,1743273032,1743273048,1743273048.777405,-18000,EB445137-D7F5-57EC-87DA-1DB460D64046,"iPhone13,2"
com.google.Chrome,347,1743272892,1743273239,1743273239.8788018,-18000,,
com.leomehlig.today,3,1743272889,1743272892,1743272892.8157759,-18000,,
com.google.Chrome,509,1743272380,1743272889,1743272890.033062,-18000,,
com.leomehlig.today,3,1743272377,1743272380,1743272380.634917,-18000,,
com.google.Chrome,116,1743272261,1743272377,1743272378.001095,-18000,,
com.leomehlig.today,21,1743272240,1743272261,1743272261.990037,-18000,,
com.google.Chrome,740,1743271500,1743272240,1743272240.475498,-18000,,
com.apple.Passwords,10,1743271490,1743271500,1743271500.1815891,-18000,,
com.google.Chrome,3,1743271487,1743271490,1743271490.1714559,-18000,,
com.apple.Passwords,1,1743271486,1743271487,1743271487.49839,-18000,,
com.google.Chrome,0,1743271486,1743271486,1743271486.718482,-18000,,
com.microsoft.Outlook,8,1743271478,1743271486,1743271486.270725,-18000,,
com.apple.Passwords,6,1743271472,1743271478,1743271478.831579,-18000,,
com.microsoft.Outlook,9,1743271463,1743271472,1743271472.319191,-18000,,
com.google.Chrome,1004,1743270459,1743271463,1743271463.196405,-18000,,
com.leomehlig.today,24,1743270435,1743270459,1743270459.967541,-18000,,
com.google.Chrome,389,1743270046,1743270435,1743270435.52066,-18000,,
com.apple.news,120,1743268928,1743269048,1743269048.4222631,-18000,EB445137-D7F5-57EC-87DA-1DB460D64046,"iPhone13,2"
com.google.Chrome,491,1743268912,1743269403,1743269403.207509,-18000,,
com.leomehlig.today,2,1743268910,1743268912,1743268912.464257,-18000,,
com.apple.news,207,1743268549,1743268756,1743268756.7054648,-18000,EB445137-D7F5-57EC-87DA-1DB460D64046,"iPhone13,2"
com.apple.mobileslideshow,64,1743268363,1743268427,1743268428.252903,-18000,EB445137-D7F5-57EC-87DA-1DB460D64046,"iPhone13,2"
com.apple.MobileSMS,0,1743268363,1743268363,1743268363.595327,-18000,EB445137-D7F5-57EC-87DA-1DB460D64046,"iPhone13,2"
com.google.Chrome,1102,1743267808,1743268910,1743268911.035969,-18000,,
com.leomehlig.today,11,1743267797,1743267808,1743267808.053286,-18000,,
com.apple.iCal,1,1743267796,1743267797,1743267798.0142732,-18000,,
com.google.Chrome,715,1743267081,1743267796,1743267796.357414,-18000,,
com.leomehlig.today,63,1743267018,1743267081,1743267081.9451308,-18000,,
com.apple.iCal,111,1743266907,1743267018,1743267018.355523,-18000,,
com.google.Chrome,1107,1743265800,1743266907,1743266907.590719,-18000,,
com.leomehlig.today,76,1743265724,1743265800,1743265801.876474,-18000,,
com.apple.MobileSMS,19,1743263107,1743263126,1743263126.304544,-18000,EB445137-D7F5-57EC-87DA-1DB460D64046,"iPhone13,2"
com.google.Gmail,18,1743263088,1743263106,1743263106.130292,-18000,EB445137-D7F5-57EC-87DA-1DB460D64046,"iPhone13,2"
co.hinge.mobile.ios,35,1743262467,1743262502,1743262502.983976,-18000,EB445137-D7F5-57EC-87DA-1DB460D64046,"iPhone13,2"
com.apple.MobileSMS,2,1743262463,1743262465,1743262465.5890079,-18000,EB445137-D7F5-57EC-87DA-1DB460D64046,"iPhone13,2"
com.apple.MobileSMS,15,1743262136,1743262151,1743262151.919868,-18000,EB445137-D7F5-57EC-87DA-1DB460D64046,"iPhone13,2"
com.apple.calculator,12,1743262123,1743262135,1743262135.997643,-18000,EB445137-D7F5-57EC-87DA-1DB460D64046,"iPhone13,2"
com.apple.weather,2,1743262121,1743262123,1743262123.2769961,-18000,EB445137-D7F5-57EC-87DA-1DB460D64046,"iPhone13,2"
com.apple.weather,9,1743262093,1743262102,1743262102.4712172,-18000,EB445137-D7F5-57EC-87DA-1DB460D64046,"iPhone13,2"
com.leomehlig.today,120,1743262035,1743262155,1743262155.8925428,-18000,,
com.apple.finder,9,1743262026,1743262035,1743262035.399791,-18000,,
com.microsoft.VSCode,6,1743262020,1743262026,1743262026.7217379,-18000,,
com.google.Chrome,78,1743261942,1743262020,1743262020.821116,-18000,,
com.jinzhenyu.ruler,12,1743261930,1743261942,1743261942.273454,-18000,,
com.google.Chrome,5,1743261925,1743261930,1743261931.008486,-18000,,
com.jinzhenyu.ruler,12,1743261913,1743261925,1743261925.6632152,-18000,,
com.electron.carta,1,1743261912,1743261913,1743261913.949117,-18000,,
com.jinzhenyu.ruler,2,1743261910,1743261912,1743261912.4006019,-18000,,
com.electron.carta,72,1743261838,1743261910,1743261910.9258308,-18000,,
com.google.Chrome,10,1743261828,1743261838,1743261838.577227,-18000,,
com.electron.carta,3,1743261825,1743261828,1743261828.6880631,-18000,,
com.google.Chrome,9,1743261816,1743261825,1743261825.425613,-18000,,
com.electron.carta,8,1743261808,1743261816,1743261816.497478,-18000,,
com.google.Chrome,17,1743261791,1743261808,1743261808.6309562,-18000,,
com.electron.carta,6,1743261785,1743261791,1743261791.985715,-18000,,
com.google.Chrome,29,1743261756,1743261785,1743261785.254468,-18000,,
com.electron.carta,29,1743261727,1743261756,1743261756.914161,-18000,,
com.apple.Preview,1,1743261726,1743261727,1743261727.739393,-18000,,
com.google.Chrome,0,1743261726,1743261726,1743261726.9751549,-18000,,
com.electron.carta,6,1743261720,1743261726,1743261726.229104,-18000,,
com.google.Chrome,6,1743261714,1743261720,1743261720.397752,-18000,,
com.electron.carta,27,1743261687,1743261714,1743261715.076282,-18000,,
com.jinzhenyu.ruler,1,1743261686,1743261687,1743261687.260278,-18000,,
com.electron.carta,26,1743261660,1743261686,1743261686.4718351,-18000,,
com.google.Chrome,11,1743261649,1743261660,1743261660.603224,-18000,,
com.electron.carta,7,1743261642,1743261649,1743261649.36017,-18000,,
com.google.Chrome,2,1743261640,1743261642,1743261642.453438,-18000,,
com.electron.carta,112,1743261528,1743261640,1743261640.664053,-18000,,
com.apple.Preview,3,1743261525,1743261528,1743261528.1872292,-18000,,
com.apple.finder,2,1743261523,1743261525,1743261525.4615269,-18000,,
com.jinzhenyu.ruler,0,1743261523,1743261523,1743261523.915411,-18000,,
com.apple.finder,2,1743261521,1743261523,1743261523.2984009,-18000,,
com.google.Chrome,100,1743261421,1743261521,1743261521.708216,-18000,,
com.jinzhenyu.ruler,14,1743261407,1743261421,1743261421.357779,-18000,,
com.electron.carta,3,1743261404,1743261407,1743261407.2960482,-18000,,
com.jinzhenyu.ruler,2,1743261402,1743261404,1743261404.8458772,-18000,,
com.electron.carta,37,1743261365,1743261402,1743261402.512302,-18000,,
com.google.Chrome,10,1743261355,1743261365,1743261365.925756,-18000,,
com.electron.carta,8,1743261347,1743261355,1743261356.044929,-18000,,
com.google.Chrome,5,1743261342,1743261347,1743261347.389728,-18000,,
com.electron.carta,7,1743261335,1743261342,1743261342.727956,-18000,,
com.google.Chrome,16,1743261319,1743261335,1743261335.309093,-18000,,
com.apple.Preview,2,1743261317,1743261319,1743261319.738305,-18000,,
com.google.Chrome,11,1743261306,1743261317,1743261317.181248,-18000,,
com.apple.Preview,1,1743261305,1743261306,1743261307.032428,-18000,,
com.google.Chrome,25,1743261280,1743261305,1743261305.848484,-18000,,
com.electron.carta,8,1743261272,1743261280,1743261280.574683,-18000,,
com.jinzhenyu.ruler,0,1743261272,1743261272,1743261272.753806,-18000,,
com.electron.carta,13,1743261259,1743261272,1743261272.3338408,-18000,,
com.google.Chrome,26,1743261233,1743261259,1743261259.490232,-18000,,
com.electron.carta,75,1743261158,1743261233,1743261234.053231,-18000,,
com.jinzhenyu.ruler,1,1743261157,1743261158,1743261158.46813,-18000,,
com.electron.carta,29,1743261128,1743261157,1743261157.612531,-18000,,
com.apple.Preview,2,1743261126,1743261128,1743261128.3244739,-18000,,
com.apple.finder,2,1743261124,1743261126,1743261126.482995,-18000,,
com.electron.carta,13,1743261111,1743261124,1743261124.418792,-18000,,
com.google.Chrome,2,1743261109,1743261111,1743261111.1622782,-18000,,
com.jinzhenyu.ruler,0,1743261109,1743261109,1743261109.91557,-18000,,
com.google.Chrome,1,1743261108,1743261109,1743261109.355016,-18000,,
com.jinzhenyu.ruler,1,1743261107,1743261108,1743261108.354265,-18000,,
com.google.Chrome,39,1743261068,1743261107,1743261107.7482781,-18000,,
com.jinzhenyu.ruler,14,1743261054,1743261068,1743261068.458144,-18000,,
com.electron.carta,1,1743261053,1743261054,1743261054.6336331,-18000,,
com.jinzhenyu.ruler,2,1743261051,1743261053,1743261053.1449661,-18000,,
com.electron.carta,59,1743260992,1743261051,1743261051.3703609,-18000,,
com.google.Chrome,3,1743260989,1743260992,1743260992.211052,-18000,,
com.electron.carta,7,1743260982,1743260989,1743260989.377223,-18000,,
com.google.Chrome,9,1743260973,1743260982,1743260982.480105,-18000,,
com.electron.carta,3,1743260970,1743260973,1743260973.279803,-18000,,
com.google.Chrome,16,1743260954,1743260970,1743260970.2551079,-18000,,
com.electron.carta,9,1743260945,1743260954,1743260954.910833,-18000,,
com.google.Chrome,9,1743260936,1743260945,1743260945.480833,-18000,,
com.electron.carta,5,1743260931,1743260936,1743260936.4806461,-18000,,
com.google.Chrome,44,1743260887,1743260931,1743260931.610011,-18000,,
com.apple.Preview,2,1743260885,1743260887,1743260887.4745169,-18000,,
com.google.Chrome,14,1743260871,1743260885,1743260885.0820189,-18000,,
com.electron.carta,65,1743260806,1743260871,1743260871.5257,-18000,,
com.jinzhenyu.ruler,0,1743260806,1743260806,1743260806.69985,-18000,,
com.electron.carta,17,1743260789,1743260806,1743260806.06551,-18000,,
com.apple.Preview,2,1743260787,1743260789,1743260790.044935,-18000,,
com.apple.finder,1,1743260786,1743260787,1743260788.026898,-18000,,
com.electron.carta,1,1743260785,1743260786,1743260786.071301,-18000,,
com.apple.Preview,3,1743260782,1743260785,1743260785.0919142,-18000,,
com.electron.carta,5,1743260777,1743260782,1743260782.964758,-18000,,
com.electron.carta,308,1743259988,1743260296,1743260296.467303,-18000,,
com.google.Chrome,2,1743259986,1743259988,1743259988.132784,-18000,,
com.jinzhenyu.ruler,0,1743259986,1743259986,1743259986.776725,-18000,,
com.google.Chrome,12,1743259974,1743259986,1743259986.1148992,-18000,,
com.jinzhenyu.ruler,2,1743259972,1743259974,1743259974.536113,-18000,,
com.google.Chrome,7,1743259965,1743259972,1743259973.033431,-18000,,
com.jinzhenyu.ruler,17,1743259948,1743259965,1743259965.5807362,-18000,,
com.electron.carta,1,1743259947,1743259948,1743259948.9792151,-18000,,
com.jinzhenyu.ruler,2,1743259945,1743259947,1743259947.439162,-18000,,
com.electron.carta,59,1743259886,1743259945,1743259945.3242059,-18000,,
com.google.Chrome,9,1743259877,1743259886,1743259886.365963,-18000,,
com.electron.carta,20,1743259857,1743259877,1743259877.25308,-18000,,
com.google.Chrome,6,1743259851,1743259857,1743259857.081798,-18000,,
com.electron.carta,6,1743259845,1743259851,1743259851.6909862,-18000,,
com.google.Chrome,83,1743259762,1743259845,1743259845.6468,-18000,,
com.electron.carta,17,1743259745,1743259762,1743259762.19366,-18000,,
com.google.Chrome,9,1743259736,1743259745,1743259745.817384,-18000,,
com.electron.carta,2,1743259734,1743259736,1743259736.602398,-18000,,
com.google.Chrome,12,1743259722,1743259734,1743259734.5247679,-18000,,
com.electron.carta,43,1743259679,1743259722,1743259722.457749,-18000,,
com.apple.Preview,4,1743259675,1743259679,1743259679.772136,-18000,,
com.electron.carta,17,1743259658,1743259675,1743259675.562243,-18000,,
com.jinzhenyu.ruler,0,1743259658,1743259658,1743259659.008982,-18000,,
com.electron.carta,6,1743259652,1743259658,1743259658.1388059,-18000,,
com.google.Chrome,5,1743259647,1743259652,1743259652.111445,-18000,,
com.electron.carta,15,1743259632,1743259647,1743259647.8130279,-18000,,
com.apple.Preview,6,1743259626,1743259632,1743259632.791901,-18000,,
com.google.Chrome,2,1743259624,1743259626,1743259626.730953,-18000,,
com.apple.Preview,2,1743259622,1743259624,1743259624.6479502,-18000,,
com.google.Chrome,4,1743259618,1743259622,1743259622.9056811,-18000,,
com.electron.carta,2,1743259616,1743259618,1743259618.048723,-18000,,
com.apple.Preview,1,1743259615,1743259616,1743259616.612187,-18000,,
com.electron.carta,1,1743259614,1743259615,1743259615.721467,-18000,,
com.google.Chrome,2,1743259612,1743259614,1743259614.501395,-18000,,
com.apple.weather,3,1743259593,1743259596,1743259596.303815,-18000,EB445137-D7F5-57EC-87DA-1DB460D64046,"iPhone13,2"
com.electron.carta,58,1743259554,1743259612,1743259612.4639869,-18000,,
com.apple.Preview,1,1743259553,1743259554,1743259554.5102592,-18000,,
com.apple.finder,2,1743259551,1743259553,1743259553.614581,-18000,,
com.electron.carta,11,1743259540,1743259551,1743259551.940731,-18000,,
com.google.Chrome,1,1743259539,1743259540,1743259540.780443,-18000,,
com.jinzhenyu.ruler,1,1743259538,1743259539,1743259539.4542398,-18000,,
com.google.Chrome,11,1743259527,1743259538,1743259538.273128,-18000,,
com.apple.Preview,3,1743259524,1743259527,1743259527.5789719,-18000,,
com.google.Chrome,9,1743259515,1743259524,1743259524.5046868,-18000,,
com.electron.carta,1,1743259514,1743259515,1743259515.587048,-18000,,
com.google.Chrome,12,1743259502,1743259514,1743259514.900097,-18000,,
com.electron.carta,7,1743259495,1743259502,1743259502.902277,-18000,,
com.jinzhenyu.ruler,3,1743259492,1743259495,1743259495.953697,-18000,,
com.electron.carta,59,1743259433,1743259492,1743259492.819592,-18000,,
com.google.Chrome,6,1743259427,1743259433,1743259433.0982451,-18000,,
com.electron.carta,7,1743259420,1743259427,1743259427.1580071,-18000,,
com.google.Chrome,9,1743259411,1743259420,1743259420.396402,-18000,,
com.electron.carta,8,1743259403,1743259411,1743259411.155051,-18000,,
com.google.Chrome,6,1743259397,1743259403,1743259403.717212,-18000,,
com.electron.carta,14,1743259383,1743259397,1743259397.239078,-18000,,
com.jinzhenyu.ruler,1,1743259382,1743259383,1743259383.199091,-18000,,
com.electron.carta,6,1743259376,1743259382,1743259382.38802,-18000,,
com.google.Chrome,1,1743259375,1743259376,1743259376.6804829,-18000,,
com.jinzhenyu.ruler,1,1743259374,1743259375,1743259375.6542258,-18000,,
com.google.Chrome,9,1743259365,1743259374,1743259374.9151669,-18000,,
com.jinzhenyu.ruler,17,1743259348,1743259365,1743259365.200107,-18000,,
com.google.Chrome,6,1743259342,1743259348,1743259348.7126288,-18000,,
com.electron.carta,12,1743259330,1743259342,1743259342.409831,-18000,,
com.jinzhenyu.ruler,3,1743259327,1743259330,1743259330.849916,-18000,,
com.electron.carta,29,1743259298,1743259327,1743259327.4699059,-18000,,
com.google.Chrome,6,1743259292,1743259298,1743259298.114058,-18000,,
com.electron.carta,14,1743259278,1743259292,1743259292.202304,-18000,,
com.google.Chrome,30,1743259248,1743259278,1743259278.735997,-18000,,
com.electron.carta,15,1743259233,1743259248,1743259248.262336,-18000,,
com.google.Chrome,4,1743259229,1743259233,1743259233.1231031,-18000,,
com.electron.carta,7,1743259222,1743259229,1743259229.485698,-18000,,
com.google.Chrome,7,1743259215,1743259222,1743259222.3850288,-18000,,
com.electron.carta,24,1743259191,1743259215,1743259215.842458,-18000,,
com.google.Chrome,61,1743259130,1743259191,1743259191.615608,-18000,,
com.electron.carta,1,1743259129,1743259130,1743259130.5266318,-18000,,
com.apple.Preview,2,1743259127,1743259129,1743259129.5000439,-18000,,
com.electron.carta,17,1743259110,1743259127,1743259127.94762,-18000,,
com.google.Chrome,27,1743259083,1743259110,1743259110.07169,-18000,,
com.electron.carta,50,1743259033,1743259083,1743259083.7987962,-18000,,
com.apple.Preview,3,1743259030,1743259033,1743259033.386705,-18000,,
com.google.Chrome,83,1743258947,1743259030,1743259030.5194721,-18000,,
com.apple.weather,75,1743258929,1743259004,1743259005.162668,-18000,EB445137-D7F5-57EC-87DA-1DB460D64046,"iPhone13,2"
com.electron.carta,64,1743258883,1743258947,1743258947.35081,-18000,,
com.apple.Preview,2,1743258881,1743258883,1743258883.334485,-18000,,
com.apple.finder,2,1743258879,1743258881,1743258881.622573,-18000,,
com.electron.carta,15,1743258864,1743258879,1743258879.8982801,-18000,,
com.google.Chrome,101,1743258763,1743258864,1743258864.9372401,-18000,,
com.jinzhenyu.ruler,0,1743258763,1743258763,1743258764.027858,-18000,,
com.electron.carta,1,1743258762,1743258763,1743258763.08375,-18000,,
com.microsoft.VSCode,8,1743258754,1743258762,1743258762.1402879,-18000,,
com.electron.carta,10,1743258744,1743258754,1743258754.3850079,-18000,,
com.jinzhenyu.ruler,1,1743258743,1743258744,1743258744.161532,-18000,,
com.electron.carta,30,1743258713,1743258743,1743258743.6153421,-18000,,
com.google.Chrome,1,1743258712,1743258713,1743258713.28899,-18000,,
com.jinzhenyu.ruler,1,1743258711,1743258712,1743258712.869238,-18000,,
com.google.Chrome,50,1743258661,1743258711,1743258711.682619,-18000,,
com.jinzhenyu.ruler,1,1743258660,1743258661,1743258661.76108,-18000,,
com.google.Chrome,10,1743258650,1743258660,1743258661.0002298,-18000,,
com.jinzhenyu.ruler,19,1743258631,1743258650,1743258650.927085,-18000,,
com.electron.carta,2,1743258629,1743258631,1743258631.925902,-18000,,
com.jinzhenyu.ruler,4,1743258625,1743258629,1743258629.987035,-18000,,
com.electron.carta,55,1743258570,1743258625,1743258625.8541222,-18000,,
com.jinzhenyu.ruler,1,1743258569,1743258570,1743258570.169952,-18000,,
com.electron.carta,3,1743258566,1743258569,1743258569.7235641,-18000,,
com.google.Chrome,1,1743258565,1743258566,1743258566.300992,-18000,,
com.jinzhenyu.ruler,1,1743258564,1743258565,1743258565.43749,-18000,,
com.google.Chrome,8,1743258556,1743258564,1743258564.696138,-18000,,
com.electron.carta,1,1743258555,1743258556,1743258556.352345,-18000,,
com.google.Chrome,7,1743258548,1743258555,1743258555.2366629,-18000,,
com.electron.carta,9,1743258539,1743258548,1743258548.663622,-18000,,
com.jinzhenyu.ruler,4,1743258535,1743258539,1743258539.251693,-18000,,
com.electron.carta,38,1743258497,1743258535,1743258535.923589,-18000,,
com.google.Chrome,78,1743258419,1743258497,1743258498.044804,-18000,,
com.electron.carta,14,1743258405,1743258419,1743258419.428697,-18000,,
com.google.Chrome,5,1743258400,1743258405,1743258405.2362928,-18000,,
com.electron.carta,3,1743258397,1743258400,1743258400.6999102,-18000,,
com.google.Chrome,6,1743258391,1743258397,1743258397.723967,-18000,,
com.electron.carta,35,1743258356,1743258391,1743258391.578782,-18000,,
com.google.Chrome,3,1743258353,1743258356,1743258356.290267,-18000,,
com.electron.carta,9,1743258344,1743258353,1743258353.229672,-18000,,
com.google.Chrome,7,1743258337,1743258344,1743258344.3957272,-18000,,
com.electron.carta,18,1743258319,1743258337,1743258338.048039,-18000,,
com.google.Chrome,20,1743258299,1743258319,1743258319.9643378,-18000,,
com.electron.carta,30,1743258269,1743258299,1743258299.100544,-18000,,
com.google.Chrome,2,1743258267,1743258269,1743258269.555461,-18000,,
com.apple.Preview,1,1743258266,1743258267,1743258268.0168939,-18000,,
com.google.Chrome,24,1743258242,1743258266,1743258266.3537621,-18000,,
com.apple.Preview,3,1743258239,1743258242,1743258242.672544,-18000,,
com.google.Chrome,10,1743258229,1743258239,1743258239.956774,-18000,,
com.apple.Preview,3,1743258226,1743258229,1743258229.3097239,-18000,,
com.google.Chrome,27,1743258199,1743258226,1743258226.4493818,-18000,,
com.apple.Preview,1,1743258198,1743258199,1743258199.688199,-18000,,
com.electron.carta,1,1743258197,1743258198,1743258198.3519092,-18000,,
com.google.Chrome,54,1743258143,1743258197,1743258197.64558,-18000,,
com.electron.carta,40,1743258103,1743258143,1743258144.022346,-18000,,
com.apple.Preview,7,1743258096,1743258103,1743258103.094007,-18000,,
com.apple.finder,2,1743258094,1743258096,1743258096.5870519,-18000,,
com.electron.carta,23,1743258071,1743258094,1743258094.851522,-18000,,
com.jinzhenyu.ruler,1,1743258070,1743258071,1743258071.2145782,-18000,,
com.electron.carta,1,1743258069,1743258070,1743258070.1732779,-18000,,
com.jinzhenyu.ruler,2,1743258067,1743258069,1743258069.858084,-18000,,
com.electron.carta,1,1743258066,1743258067,1743258067.2329412,-18000,,
com.google.Chrome,0,1743258066,1743258066,1743258066.756516,-18000,,
com.jinzhenyu.ruler,1,1743258065,1743258066,1743258066.448913,-18000,,
com.google.Chrome,72,1743257993,1743258065,1743258065.388427,-18000,,
com.jinzhenyu.ruler,16,1743257977,1743257993,1743257993.597132,-18000,,
com.google.Chrome,5,1743257972,1743257977,1743257977.09323,-18000,,
com.electron.carta,14,1743257958,1743257972,1743257972.373848,-18000,,
com.jinzhenyu.ruler,3,1743257955,1743257958,1743257958.946543,-18000,,
co.hinge.mobile.ios,49,1743257860,1743257909,1743257909.966824,-18000,EB445137-D7F5-57EC-87DA-1DB460D64046,"iPhone13,2"
com.electron.carta,130,1743257825,1743257955,1743257955.818651,-18000,,
com.google.Chrome,28,1743257797,1743257825,1743257825.724701,-18000,,
com.electron.carta,8,1743257789,1743257797,1743257797.37541,-18000,,
com.google.Chrome,20,1743257769,1743257789,1743257789.5029922,-18000,,
com.electron.carta,11,1743257758,1743257769,1743257769.847502,-18000,,
com.google.Chrome,41,1743257717,1743257758,1743257758.147625,-18000,,
com.electron.carta,6,1743257711,1743257717,1743257718.031326,-18000,,
com.google.Chrome,9,1743257702,1743257711,1743257712.006793,-18000,,
com.electron.carta,8,1743257694,1743257702,1743257702.405721,-18000,,
com.google.Chrome,7,1743257687,1743257694,1743257694.104124,-18000,,
com.electron.carta,5,1743257682,1743257687,1743257687.7138948,-18000,,
com.google.Chrome,16,1743257666,1743257682,1743257682.728972,-18000,,
com.apple.Preview,1,1743257665,1743257666,1743257666.25803,-18000,,
com.google.Chrome,12,1743257653,1743257665,1743257665.473689,-18000,,
com.electron.carta,98,1743257555,1743257653,1743257653.175303,-18000,,
com.apple.Preview,1,1743257554,1743257555,1743257555.172408,-18000,,
com.apple.finder,2,1743257552,1743257554,1743257554.4316,-18000,,
com.apple.Preview,5,1743257547,1743257552,1743257552.544596,-18000,,
com.electron.carta,22,1743257525,1743257547,1743257547.7819428,-18000,,
com.google.Chrome,4,1743257521,1743257525,1743257525.857911,-18000,,
com.electron.carta,6,1743257515,1743257521,1743257521.28759,-18000,,
com.google.Chrome,27,1743257488,1743257515,1743257515.7470012,-18000,,
com.jinzhenyu.ruler,2,1743257486,1743257488,1743257488.411514,-18000,,
com.google.Chrome,38,1743257448,1743257486,1743257486.24241,-18000,,
com.jinzhenyu.ruler,1,1743257447,1743257448,1743257448.08303,-18000,,
com.google.Chrome,12,1743257435,1743257447,1743257447.0873609,-18000,,
com.jinzhenyu.ruler,14,1743257421,1743257435,1743257435.829211,-18000,,
com.electron.carta,2,1743257419,1743257421,1743257421.06808,-18000,,
com.jinzhenyu.ruler,3,1743257416,1743257419,1743257419.1370459,-18000,,
com.electron.carta,73,1743257343,1743257416,1743257416.179803,-18000,,
com.jinzhenyu.ruler,1,1743257342,1743257343,1743257343.577014,-18000,,
com.electron.carta,4,1743257338,1743257342,1743257342.84729,-18000,,
com.google.Chrome,1,1743257337,1743257338,1743257338.8882551,-18000,,
com.jinzhenyu.ruler,1,1743257336,1743257337,1743257337.487998,-18000,,
com.google.Chrome,60,1743257276,1743257336,1743257336.6732578,-18000,,
com.jinzhenyu.ruler,2,1743257274,1743257276,1743257276.8768768,-18000,,
com.google.Chrome,10,1743257264,1743257274,1743257274.44612,-18000,,
com.jinzhenyu.ruler,25,1743257239,1743257264,1743257264.110921,-18000,,
com.electron.carta,2,1743257237,1743257239,1743257239.338006,-18000,,
com.jinzhenyu.ruler,2,1743257235,1743257237,1743257237.697322,-18000,,
com.electron.carta,68,1743257167,1743257235,1743257235.2569618,-18000,,
com.jinzhenyu.ruler,8,1743257159,1743257167,1743257167.772733,-18000,,
com.electron.carta,7,1743257152,1743257159,1743257159.5595279,-18000,,
com.google.Chrome,30,1743257122,1743257152,1743257152.64381,-18000,,
com.electron.carta,10,1743257112,1743257122,1743257122.163163,-18000,,
com.google.Chrome,17,1743257095,1743257112,1743257112.121289,-18000,,
com.electron.carta,21,1743257074,1743257095,1743257095.633528,-18000,,
com.google.Chrome,7,1743257067,1743257074,1743257074.936662,-18000,,
com.electron.carta,9,1743257058,1743257067,1743257067.4742432,-18000,,
com.google.Chrome,10,1743257048,1743257058,1743257058.305912,-18000,,
com.electron.carta,13,1743257035,1743257048,1743257049.076154,-18000,,
com.google.Chrome,20,1743257015,1743257035,1743257035.2585402,-18000,,
com.apple.Preview,2,1743257013,1743257015,1743257015.856906,-18000,,
com.google.Chrome,9,1743257004,1743257013,1743257014.01294,-18000,,
com.apple.weather,8,1743256979,1743256987,1743256987.714297,-18000,EB445137-D7F5-57EC-87DA-1DB460D64046,"iPhone13,2"
edu.cornell.birds.merlin,2,1743256977,1743256979,1743256979.498893,-18000,EB445137-D7F5-57EC-87DA-1DB460D64046,"iPhone13,2"
com.electron.carta,59,1743256945,1743257004,1743257004.9199018,-18000,,
com.google.Chrome,8,1743256937,1743256945,1743256945.719339,-18000,,
com.electron.carta,9,1743256928,1743256937,1743256937.924334,-18000,,
com.google.Chrome,8,1743256920,1743256928,1743256928.950598,-18000,,
com.electron.carta,19,1743256901,1743256920,1743256920.50123,-18000,,
com.apple.Preview,5,1743256896,1743256901,1743256901.3905659,-18000,,
com.google.Chrome,1,1743256895,1743256896,1743256896.314372,-18000,,
com.electron.carta,4,1743256891,1743256895,1743256895.2329001,-18000,,
com.google.Chrome,2,1743256889,1743256891,1743256891.540979,-18000,,
com.electron.carta,21,1743256868,1743256889,1743256890.017716,-18000,,
com.apple.Preview,3,1743256865,1743256868,1743256868.337837,-18000,,
com.electron.carta,17,1743256848,1743256865,1743256865.189605,-18000,,
com.google.Chrome,10,1743256838,1743256848,1743256848.2939749,-18000,,
com.electron.carta,99,1743256739,1743256838,1743256839.079988,-18000,,
com.apple.Preview,6,1743256733,1743256739,1743256739.250561,-18000,,
com.apple.finder,0,1743256733,1743256733,1743256733.50239,-18000,,
com.google.Chrome,307,1743256426,1743256733,1743256733.1414418,-18000,,
com.apple.finder,5,1743256421,1743256426,1743256427.049355,-18000,,
com.google.Chrome,99,1743256322,1743256421,1743256422.021669,-18000,,
com.microsoft.VSCode,57,1743256265,1743256322,1743256322.7381701,-18000,,
com.google.Chrome,16,1743256249,1743256265,1743256265.819066,-18000,,
com.microsoft.VSCode,9,1743256240,1743256249,1743256249.138139,-18000,,
com.apple.finder,8,1743256232,1743256240,1743256240.9064178,-18000,,
com.microsoft.VSCode,99,1743256133,1743256232,1743256232.160445,-18000,,
com.apple.finder,3,1743256130,1743256133,1743256133.888731,-18000,,
com.google.Chrome,9,1743256121,1743256130,1743256130.70066,-18000,,
com.apple.finder,7,1743256114,1743256121,1743256121.135673,-18000,,
com.google.Chrome,11,1743256103,1743256114,1743256114.999703,-18000,,
com.apple.finder,16,1743256087,1743256103,1743256103.306838,-18000,,
com.google.Chrome,14,1743256073,1743256087,1743256087.690747,-18000,,
com.apple.finder,69,1743256004,1743256073,1743256073.739146,-18000,,
com.microsoft.VSCode,14,1743255990,1743256004,1743256004.43812,-18000,,
com.google.Chrome,23,1743255967,1743255990,1743255990.462842,-18000,,
edu.cornell.birds.merlin,78,1743255420,1743255498,1743255498.669714,-18000,EB445137-D7F5-57EC-87DA-1DB460D64046,"iPhone13,2"
edu.cornell.birds.merlin,98,1743255152,1743255250,1743255250.868582,-18000,EB445137-D7F5-57EC-87DA-1DB460D64046,"iPhone13,2"
com.microsoft.Office.Outlook,8,1743254781,1743254789,1743254789.2910218,-18000,EB445137-D7F5-57EC-87DA-1DB460D64046,"iPhone13,2"
com.apple.Health,18,1743254757,1743254775,1743254775.4881148,-18000,EB445137-D7F5-57EC-87DA-1DB460D64046,"iPhone13,2"
com.apple.mobiletimer,10,1743254738,1743254748,1743254748.872663,-18000,EB445137-D7F5-57EC-87DA-1DB460D64046,"iPhone13,2"
com.apple.Health,21,1743254712,1743254733,1743254733.595611,-18000,EB445137-D7F5-57EC-87DA-1DB460D64046,"iPhone13,2"
com.apple.Health,18,1743254692,1743254710,1743254710.884675,-18000,EB445137-D7F5-57EC-87DA-1DB460D64046,"iPhone13,2"
com.apple.CoreAuthUI,2,1743254406,1743254408,1743254408.362352,-18000,EB445137-D7F5-57EC-87DA-1DB460D64046,"iPhone13,2"
edu.cornell.birds.merlin,193,1743254393,1743254586,1743254586.520187,-18000,EB445137-D7F5-57EC-87DA-1DB460D64046,"iPhone13,2"
com.google.chrome.ios,9,1743254384,1743254393,1743254393.750277,-18000,EB445137-D7F5-57EC-87DA-1DB460D64046,"iPhone13,2"
com.google.Gmail,6,1743254378,1743254384,1743254384.338027,-18000,EB445137-D7F5-57EC-87DA-1DB460D64046,"iPhone13,2"
com.apple.CoreAuthUI,2,1743254338,1743254340,1743254340.158206,-18000,EB445137-D7F5-57EC-87DA-1DB460D64046,"iPhone13,2"
edu.cornell.birds.merlin,239,1743254136,1743254375,1743254375.125723,-18000,EB445137-D7F5-57EC-87DA-1DB460D64046,"iPhone13,2"
com.apple.AppStore,1,1743254135,1743254136,1743254137.0046558,-18000,EB445137-D7F5-57EC-87DA-1DB460D64046,"iPhone13,2"
com.apple.camera,12,1743254117,1743254129,1743254129.832669,-18000,EB445137-D7F5-57EC-87DA-1DB460D64046,"iPhone13,2"
com.apple.PassbookUIService,5,1743254066,1743254071,1743254071.828901,-18000,EB445137-D7F5-57EC-87DA-1DB460D64046,"iPhone13,2"
com.apple.AppStore,68,1743254049,1743254117,1743254117.203947,-18000,EB445137-D7F5-57EC-87DA-1DB460D64046,"iPhone13,2"
com.apple.MobileSMS,3,1743254044,1743254047,1743254047.77805,-18000,EB445137-D7F5-57EC-87DA-1DB460D64046,"iPhone13,2"
com.apple.MobileSMS,4,1743253316,1743253320,1743253321.2857862,-18000,EB445137-D7F5-57EC-87DA-1DB460D64046,"iPhone13,2"
com.google.Chrome,267,1743253263,1743253530,1743253530.055047,-18000,,
com.apple.finder,3,1743253222,1743253225,1743253225.341675,-18000,,
com.renpho.health,2,1743252564,1743252566,1743252567.016988,-18000,EB445137-D7F5-57EC-87DA-1DB460D64046,"iPhone13,2"
com.renpho.health,62,1743252473,1743252535,1743252535.6325278,-18000,EB445137-D7F5-57EC-87DA-1DB460D64046,"iPhone13,2"
com.apple.mobiletimer,4,1743252461,1743252465,1743252465.761095,-18000,EB445137-D7F5-57EC-87DA-1DB460D64046,"iPhone13,2"
com.apple.mobiletimer,6,1743251432,1743251438,1743251439.074932,-18000,EB445137-D7F5-57EC-87DA-1DB460D64046,"iPhone13,2"
com.apple.mobiletimer,12,1743227663,1743227675,1743227676.126676,-18000,EB445137-D7F5-57EC-87DA-1DB460D64046,"iPhone13,2"
com.apple.finder,35,1743227569,1743227604,1743227605.049695,-18000,,
com.leomehlig.today,1,1743227568,1743227569,1743227569.291981,-18000,,
com.apple.QuickTimePlayerX,146,1743227422,1743227568,1743227568.348505,-18000,,
com.apple.QuickTimePlayerX,301,1743226829,1743227130,1743227130.105571,-18000,,
com.apple.QuickTimePlayerX,456,1743226221,1743226677,1743226677.418252,-18000,,
com.apple.Music,8,1743226213,1743226221,1743226221.589429,-18000,,
com.apple.QuickTimePlayerX,16,1743226197,1743226213,1743226213.078465,-18000,,
com.apple.finder,13,1743226184,1743226197,1743226197.8476682,-18000,,
com.apple.QuickTimePlayerX,6,1743226178,1743226184,1743226184.796978,-18000,,
com.apple.finder,116,1743226062,1743226178,1743226178.5755758,-18000,,
com.apple.Music,169,1743225893,1743226062,1743226062.8442922,-18000,,
com.google.Chrome,57,1743225836,1743225893,1743225893.562316,-18000,,
com.google.Chrome,644,1743224947,1743225591,1743225591.492403,-18000,,
com.apple.Music,112,1743224835,1743224947,1743224947.774724,-18000,,
com.apple.findmy,7,1743224552,1743224559,1743224559.8919802,-18000,EB445137-D7F5-57EC-87DA-1DB460D64046,"iPhone13,2"
Astrospheric.Astrospheric,24,1743223569,1743223593,1743223593.366269,-18000,EB445137-D7F5-57EC-87DA-1DB460D64046,"iPhone13,2"
co.hinge.mobile.ios,14,1743223387,1743223401,1743223401.3253288,-18000,EB445137-D7F5-57EC-87DA-1DB460D64046,"iPhone13,2"
com.apple.Music,1259,1743222820,1743224079,1743224079.34697,-18000,,
com.apple.Notes,7,1743222813,1743222820,1743222820.289751,-18000,,
com.apple.Music,0,1743222813,1743222813,1743222818.1112561,-18000,,
com.apple.Notes,4,1743222809,1743222813,1743222815.4221811,-18000,,
com.apple.weather,3,1743220232,1743220235,1743220235.4060779,-18000,EB445137-D7F5-57EC-87DA-1DB460D64046,"iPhone13,2"
com.apple.weather,2,1743218955,1743218957,1743218957.8892112,-18000,EB445137-D7F5-57EC-87DA-1DB460D64046,"iPhone13,2"
com.apple.MobileSMS,0,1743218955,1743218955,1743218956.644486,-18000,EB445137-D7F5-57EC-87DA-1DB460D64046,"iPhone13,2"
com.apple.MobileSMS,18,1743216861,1743216879,1743216880.201239,-18000,EB445137-D7F5-57EC-87DA-1DB460D64046,"iPhone13,2"
com.apple.mobilecal,11,1743212117,1743212128,1743212128.698477,-18000,EB445137-D7F5-57EC-87DA-1DB460D64046,"iPhone13,2"
com.apple.mobilecal,79,1743212035,1743212114,1743212114.345217,-18000,EB445137-D7F5-57EC-87DA-1DB460D64046,"iPhone13,2"
com.apple.CoreAuthUI,2,1743211950,1743211952,1743211952.575323,-18000,EB445137-D7F5-57EC-87DA-1DB460D64046,"iPhone13,2"
com.google.chrome.ios,108,1743211914,1743212022,1743212022.767243,-18000,EB445137-D7F5-57EC-87DA-1DB460D64046,"iPhone13,2"
com.apple.mobilecal,26,1743211878,1743211904,1743211904.96354,-18000,EB445137-D7F5-57EC-87DA-1DB460D64046,"iPhone13,2"
com.microsoft.Office.Outlook,8,1743211867,1743211875,1743211875.7250628,-18000,EB445137-D7F5-57EC-87DA-1DB460D64046,"iPhone13,2"
com.microsoft.Office.Outlook,43,1743210554,1743210597,1743210598.055907,-18000,EB445137-D7F5-57EC-87DA-1DB460D64046,"iPhone13,2"
com.apple.news,164,1743209910,1743210074,1743210074.9669619,-18000,EB445137-D7F5-57EC-87DA-1DB460D64046,"iPhone13,2"
com.google.chrome.ios,101,1743209262,1743209363,1743209364.091961,-18000,EB445137-D7F5-57EC-87DA-1DB460D64046,"iPhone13,2"
com.hulu.plus,2,1743209260,1743209262,1743209262.864651,-18000,EB445137-D7F5-57EC-87DA-1DB460D64046,"iPhone13,2"
com.google.chrome.ios,34,1743209226,1743209260,1743209260.901667,-18000,EB445137-D7F5-57EC-87DA-1DB460D64046,"iPhone13,2"
com.apple.news,65,1743208804,1743208869,1743208869.993815,-18000,EB445137-D7F5-57EC-87DA-1DB460D64046,"iPhone13,2"
com.apple.MobileSMS,2,1743208793,1743208795,1743208795.748215,-18000,EB445137-D7F5-57EC-87DA-1DB460D64046,"iPhone13,2"
com.apple.MobileSMS,43,1743207356,1743207399,1743207399.974522,-18000,EB445137-D7F5-57EC-87DA-1DB460D64046,"iPhone13,2"
com.apple.MobileSMS,2,1743207291,1743207293,1743207293.764454,-18000,EB445137-D7F5-57EC-87DA-1DB460D64046,"iPhone13,2"
com.apple.Maps,92,1743205639,1743205731,1743205731.115423,-18000,EB445137-D7F5-57EC-87DA-1DB460D64046,"iPhone13,2"
com.apple.MobileSMS,39,1743205149,1743205188,1743205188.904376,-18000,EB445137-D7F5-57EC-87DA-1DB460D64046,"iPhone13,2"
com.apple.MobileSMS,36,1743205067,1743205103,1743205103.911694,-18000,EB445137-D7F5-57EC-87DA-1DB460D64046,"iPhone13,2"
com.apple.MobileSMS,241,1743204826,1743205067,1743205067.2768888,-18000,EB445137-D7F5-57EC-87DA-1DB460D64046,"iPhone13,2"
com.apple.MobileSMS,21,1743203899,1743203920,1743203920.992618,-18000,EB445137-D7F5-57EC-87DA-1DB460D64046,"iPhone13,2"
com.toyopagroup.picaboo,13,1743201944,1743201957,1743201958.105713,-18000,EB445137-D7F5-57EC-87DA-1DB460D64046,"iPhone13,2"
com.apple.MobileSMS,1,1743201943,1743201944,1743201945.465198,-18000,EB445137-D7F5-57EC-87DA-1DB460D64046,"iPhone13,2"
com.apple.MobileSMS,3,1743201939,1743201942,1743201942.55825,-18000,EB445137-D7F5-57EC-87DA-1DB460D64046,"iPhone13,2"
com.apple.mobilenotes,0,1743201939,1743201939,1743201940.153872,-18000,EB445137-D7F5-57EC-87DA-1DB460D64046,"iPhone13,2"
com.apple.mobilenotes,3,1743200151,1743200154,1743200155.2301512,-18000,EB445137-D7F5-57EC-87DA-1DB460D64046,"iPhone13,2"
com.apple.MobileSMS,2,1743200149,1743200151,1743200151.1751509,-18000,EB445137-D7F5-57EC-87DA-1DB460D64046,"iPhone13,2"
com.apple.MobileSMS,4,1743200062,1743200066,1743200066.0913072,-18000,EB445137-D7F5-57EC-87DA-1DB460D64046,"iPhone13,2"
com.apple.MobileSMS,12,1743199976,1743199988,1743199988.788735,-18000,EB445137-D7F5-57EC-87DA-1DB460D64046,"iPhone13,2"
com.apple.mobilenotes,1,1743199975,1743199976,1743199976.813103,-18000,EB445137-D7F5-57EC-87DA-1DB460D64046,"iPhone13,2"
com.apple.mobilenotes,7,1743199505,1743199512,1743199512.569515,-18000,EB445137-D7F5-57EC-87DA-1DB460D64046,"iPhone13,2"
com.apple.MobileSMS,2,1743199503,1743199505,1743199505.415959,-18000,EB445137-D7F5-57EC-87DA-1DB460D64046,"iPhone13,2"
com.apple.MobileSMS,17,1743199448,1743199465,1743199465.679553,-18000,EB445137-D7F5-57EC-87DA-1DB460D64046,"iPhone13,2"
com.apple.MobileSMS,11,1743198108,1743198119,1743198119.979576,-18000,EB445137-D7F5-57EC-87DA-1DB460D64046,"iPhone13,2"
com.microsoft.Office.Outlook,52,1743197437,1743197489,1743197489.130769,-18000,EB445137-D7F5-57EC-87DA-1DB460D64046,"iPhone13,2"
com.apple.MobileSMS,12,1743197423,1743197435,1743197435.9095821,-18000,EB445137-D7F5-57EC-87DA-1DB460D64046,"iPhone13,2"
com.apple.MobileSMS,12,1743196946,1743196958,1743196958.497891,-18000,EB445137-D7F5-57EC-87DA-1DB460D64046,"iPhone13,2"
com.apple.MobileSMS,2,1743196127,1743196129,1743196129.554555,-18000,EB445137-D7F5-57EC-87DA-1DB460D64046,"iPhone13,2"
com.apple.MobileSMS,35,1743196077,1743196112,1743196112.185195,-18000,EB445137-D7F5-57EC-87DA-1DB460D64046,"iPhone13,2"
com.apple.MobileSMS,13,1743196036,1743196049,1743196049.237253,-18000,EB445137-D7F5-57EC-87DA-1DB460D64046,"iPhone13,2"
com.apple.MobileSMS,23,1743195984,1743196007,1743196007.597969,-18000,EB445137-D7F5-57EC-87DA-1DB460D64046,"iPhone13,2"
com.apple.MobileSMS,21,1743195949,1743195970,1743195971.075333,-18000,EB445137-D7F5-57EC-87DA-1DB460D64046,"iPhone13,2"
com.instructure.icanvas,11,1743195439,1743195450,1743195450.70837,-18000,EB445137-D7F5-57EC-87DA-1DB460D64046,"iPhone13,2"
com.instructure.icanvas,5,1743195365,1743195370,1743195371.120625,-18000,EB445137-D7F5-57EC-87DA-1DB460D64046,"iPhone13,2"
com.apple.CoreAuthUI,2,1743195324,1743195326,1743195326.915879,-18000,EB445137-D7F5-57EC-87DA-1DB460D64046,"iPhone13,2"
com.truebill.truebillnative,16,1743195321,1743195337,1743195337.954451,-18000,EB445137-D7F5-57EC-87DA-1DB460D64046,"iPhone13,2"
com.microsoft.Office.Outlook,10,1743195156,1743195166,1743195166.161232,-18000,EB445137-D7F5-57EC-87DA-1DB460D64046,"iPhone13,2"
com.microsoft.Office.Outlook,5,1743195150,1743195155,1743195155.431674,-18000,EB445137-D7F5-57EC-87DA-1DB460D64046,"iPhone13,2"
com.apple.MobileSMS,13,1743195137,1743195150,1743195150.433889,-18000,EB445137-D7F5-57EC-87DA-1DB460D64046,"iPhone13,2"
com.microsoft.Office.Outlook,9,1743195127,1743195136,1743195136.560895,-18000,EB445137-D7F5-57EC-87DA-1DB460D64046,"iPhone13,2"
com.groupme.iphone-app,10,1743195116,1743195126,1743195126.723398,-18000,EB445137-D7F5-57EC-87DA-1DB460D64046,"iPhone13,2"
com.apple.Notes,182,1743194924,1743195106,1743195106.7988,-18000,,
com.google.Chrome,30,1743194894,1743194924,1743194924.342797,-18000,,
com.apple.MobileSMS,10,1743194884,1743194894,1743194894.957426,-18000,,
com.google.Chrome,2217,1743192667,1743194884,1743194884.906112,-18000,,
com.apple.MobileSMS,3,1743192641,1743192644,1743192645.061516,-18000,,
com.google.Chrome,2,1743192639,1743192641,1743192641.748991,-18000,,
com.apple.findmy,13,1743191694,1743191707,1743191707.43497,-18000,EB445137-D7F5-57EC-87DA-1DB460D64046,"iPhone13,2"
com.instructure.icanvas,71,1743191610,1743191681,1743191681.550117,-18000,EB445137-D7F5-57EC-87DA-1DB460D64046,"iPhone13,2"
com.instructure.icanvas,20,1743191046,1743191066,1743191066.5301929,-18000,EB445137-D7F5-57EC-87DA-1DB460D64046,"iPhone13,2"
com.apple.CoreAuthUI,2,1743187632,1743187634,1743187635.203912,-18000,EB445137-D7F5-57EC-87DA-1DB460D64046,"iPhone13,2"
com.clairmail.fth.client,22,1743187630,1743187652,1743187652.368946,-18000,EB445137-D7F5-57EC-87DA-1DB460D64046,"iPhone13,2"
com.google.Chrome,228,1743183016,1743183244,1743183245.066603,-18000,,
com.leomehlig.today,34,1743182982,1743183016,1743183016.508429,-18000,,
com.google.Chrome,19,1743182963,1743182982,1743182982.625135,-18000,,
com.apple.iCal,8,1743182955,1743182963,1743182963.888557,-18000,,
com.google.Chrome,3,1743182952,1743182955,1743182955.462801,-18000,,
com.apple.iCal,7,1743182945,1743182952,1743182952.576884,-18000,,
com.google.Chrome,4,1743182941,1743182945,1743182945.9872699,-18000,,
com.apple.iCal,6,1743182935,1743182941,1743182941.901721,-18000,,
com.google.Chrome,2,1743182933,1743182935,1743182935.117745,-18000,,
com.apple.iCal,1,1743182932,1743182933,1743182933.530158,-18000,,
com.google.Chrome,20,1743182912,1743182932,1743182932.134238,-18000,,
com.apple.iCal,41,1743182871,1743182912,1743182913.613,-18000,,
com.apple.MobileSMS,42,1743182556,1743182598,1743182598.508446,-18000,EB445137-D7F5-57EC-87DA-1DB460D64046,"iPhone13,2"
com.google.Chrome,345,1743182526,1743182871,1743182871.184266,-18000,,
com.apple.iCal,5,1743182521,1743182526,1743182526.982039,-18000,,
com.apple.MobileSMS,21,1743182466,1743182487,1743182487.656791,-18000,EB445137-D7F5-57EC-87DA-1DB460D64046,"iPhone13,2"
com.google.Chrome,184,1743182337,1743182521,1743182521.4814491,-18000,,
com.leomehlig.today,2,1743182335,1743182337,1743182337.853842,-18000,,
com.apple.MobileSMS,1,1743182334,1743182335,1743182335.689734,-18000,,
com.leomehlig.today,3,1743182331,1743182334,1743182334.3864741,-18000,,
com.apple.iCal,1,1743182330,1743182331,1743182331.459279,-18000,,
com.leomehlig.today,2,1743182328,1743182330,1743182330.831122,-18000,,
com.instructure.icanvas,7,1743182316,1743182323,1743182323.333174,-18000,EB445137-D7F5-57EC-87DA-1DB460D64046,"iPhone13,2"
com.microsoft.Office.Outlook,1,1743182272,1743182273,1743182273.873344,-18000,EB445137-D7F5-57EC-87DA-1DB460D64046,"iPhone13,2"
com.apple.MobileSMS,37,1743182233,1743182270,1743182270.4212332,-18000,EB445137-D7F5-57EC-87DA-1DB460D64046,"iPhone13,2"
com.leomehlig.today,12,1743182209,1743182221,1743182221.924274,-18000,,
com.instructure.icanvas,22,1743181372,1743181394,1743181394.1630368,-18000,EB445137-D7F5-57EC-87DA-1DB460D64046,"iPhone13,2"
com.google.Chrome,862,1743181347,1743182209,1743182209.835912,-18000,,
com.leomehlig.today,18,1743181329,1743181347,1743181347.997579,-18000,,
com.google.Chrome,10,1743181319,1743181329,1743181329.100534,-18000,,
com.leomehlig.today,152,1743181167,1743181319,1743181320.2033339,-18000,,
com.apple.iCal,1,1743181166,1743181167,1743181167.358011,-18000,,
com.instructure.icanvas,61,1743181094,1743181155,1743181155.4266682,-18000,EB445137-D7F5-57EC-87DA-1DB460D64046,"iPhone13,2"
com.google.Chrome,507,1743180659,1743181166,1743181166.814241,-18000,,
com.apple.MobileSMS,50,1743180559,1743180609,1743180609.877466,-18000,EB445137-D7F5-57EC-87DA-1DB460D64046,"iPhone13,2"
com.apple.finder,79,1743180533,1743180612,1743180613.170831,-18000,,
com.apple.weather,8,1743175937,1743175945,1743175946.008089,-18000,EB445137-D7F5-57EC-87DA-1DB460D64046,"iPhone13,2"
com.apple.weather,14,1743174971,1743174985,1743174985.026472,-18000,EB445137-D7F5-57EC-87DA-1DB460D64046,"iPhone13,2"
com.google.Gmail,2,1743174969,1743174971,1743174971.065803,-18000,EB445137-D7F5-57EC-87DA-1DB460D64046,"iPhone13,2"
com.apple.finder,2,1743174952,1743174954,1743174954.33398,-18000,,
com.leomehlig.today,9,1743174943,1743174952,1743174953.015829,-18000,,
com.apple.finder,9,1743174934,1743174943,1743174943.837882,-18000,,
com.apple.Notes,2,1743174932,1743174934,1743174934.315178,-18000,,
com.google.Chrome,299,1743174633,1743174932,1743174932.992227,-18000,,
com.apple.MobileSMS,4,1743174286,1743174290,1743174290.690565,-18000,,
com.google.Chrome,76,1743174210,1743174286,1743174286.9859571,-18000,,
com.apple.finder,2,1743174208,1743174210,1743174210.524291,-18000,,
com.leomehlig.today,46,1743174162,1743174208,1743174208.04022,-18000,,
com.apple.finder,4,1743174158,1743174162,1743174162.25558,-18000,,
com.leomehlig.today,4,1743174154,1743174158,1743174158.970457,-18000,,
com.apple.finder,9,1743174145,1743174154,1743174154.236115,-18000,,
com.apple.finder,527,1743173602,1743174129,1743174129.082403,-18000,,
com.google.Chrome,35,1743173567,1743173602,1743173602.143878,-18000,,
com.google.Gmail,40,1743173204,1743173244,1743173244.2377648,-18000,EB445137-D7F5-57EC-87DA-1DB460D64046,"iPhone13,2"
com.apple.finder,363,1743173191,1743173554,1743173555.018176,-18000,,
com.apple.Notes,22,1743173169,1743173191,1743173191.61303,-18000,,
com.apple.finder,7,1743173162,1743173169,1743173169.79795,-18000,,
com.leomehlig.today,2,1743173160,1743173162,1743173162.082591,-18000,,
com.apple.finder,0,1743173160,1743173160,1743173160.79632,-18000,,
com.microsoft.VSCode,28,1743173132,1743173160,1743173160.298677,-18000,,
com.apple.finder,43,1743173089,1743173132,1743173132.4806151,-18000,,
com.microsoft.VSCode,3,1743173086,1743173089,1743173089.5511742,-18000,,
com.google.Chrome,40,1743173046,1743173086,1743173086.58076,-18000,,
com.leomehlig.today,21,1743173015,1743173036,1743173036.973475,-18000,,
com.google.Chrome,5,1743173010,1743173015,1743173015.679909,-18000,,
com.apple.finder,30,1743172980,1743173010,1743173010.5298948,-18000,,
com.microsoft.VSCode,13,1743172967,1743172980,1743172980.582323,-18000,,
com.apple.finder,12,1743172955,1743172967,1743172967.1985312,-18000,,
com.microsoft.VSCode,25,1743172930,1743172955,1743172955.819735,-18000,,
com.google.Chrome,24,1743172906,1743172930,1743172930.5585098,-18000,,
com.microsoft.VSCode,73,1743172833,1743172906,1743172907.044077,-18000,,
com.google.Chrome,39,1743172794,1743172833,1743172833.797651,-18000,,
com.microsoft.VSCode,92,1743172702,1743172794,1743172794.609387,-18000,,
com.google.Chrome,13,1743172689,1743172702,1743172702.303005,-18000,,
com.microsoft.VSCode,20,1743172669,1743172689,1743172690.024118,-18000,,
com.apple.finder,2,1743172667,1743172669,1743172669.7114139,-18000,,
com.microsoft.VSCode,2,1743172665,1743172667,1743172667.3938642,-18000,,
com.google.Chrome,1,1743172664,1743172665,1743172665.48034,-18000,,
com.apple.MobileSMS,13,1743172651,1743172664,1743172664.2081141,-18000,,
com.google.Chrome,15,1743172636,1743172651,1743172652.046953,-18000,,
com.apple.MobileSMS,20,1743172616,1743172636,1743172636.5461922,-18000,,
com.microsoft.VSCode,101,1743172515,1743172616,1743172616.288046,-18000,,
com.apple.finder,3,1743172512,1743172515,1743172515.217297,-18000,,
com.microsoft.VSCode,78,1743172434,1743172512,1743172512.609208,-18000,,
com.apple.finder,53,1743172381,1743172434,1743172434.81025,-18000,,
com.microsoft.VSCode,133,1743172248,1743172381,1743172381.4204059,-18000,,
com.apple.finder,36,1743172212,1743172248,1743172248.559977,-18000,,
com.microsoft.VSCode,57,1743172155,1743172212,1743172212.9366388,-18000,,
com.apple.finder,16,1743172139,1743172155,1743172155.4535441,-18000,,
com.apple.Preview,11,1743172128,1743172139,1743172139.743089,-18000,,
com.apple.finder,1,1743172127,1743172128,1743172128.600977,-18000,,
com.microsoft.VSCode,117,1743172010,1743172127,1743172127.902512,-18000,,
com.apple.finder,44,1743171966,1743172010,1743172010.292361,-18000,,
com.microsoft.VSCode,292,1743171674,1743171966,1743171966.1594691,-18000,,
com.google.Chrome,140,1743171534,1743171674,1743171674.86122,-18000,,
com.microsoft.VSCode,15,1743171519,1743171534,1743171534.96281,-18000,,
com.google.Chrome,184,1743171335,1743171519,1743171519.538484,-18000,,
com.microsoft.VSCode,47,1743171288,1743171335,1743171335.395222,-18000,,
com.google.Chrome,2,1743171286,1743171288,1743171289.0181642,-18000,,
com.microsoft.VSCode,104,1743171182,1743171286,1743171286.387618,-18000,,
com.apple.finder,13,1743171169,1743171182,1743171182.573663,-18000,,
com.google.Chrome,374,1743170795,1743171169,1743171169.991665,-18000,,
com.apple.finder,10,1743170785,1743170795,1743170795.629219,-18000,,
com.google.Chrome,35,1743170750,1743170785,1743170785.598109,-18000,,
com.apple.finder,8,1743170742,1743170750,1743170750.49878,-18000,,
com.google.Chrome,15,1743170727,1743170742,1743170742.3105202,-18000,,
com.apple.finder,3,1743170724,1743170727,1743170727.7896528,-18000,,
com.google.Chrome,10,1743170714,1743170724,1743170724.766193,-18000,,
com.apple.finder,8,1743170706,1743170714,1743170714.812889,-18000,,
com.google.Chrome,25,1743170681,1743170706,1743170706.308708,-18000,,
com.apple.finder,3,1743170678,1743170681,1743170681.613003,-18000,,
com.google.Chrome,13,1743170665,1743170678,1743170678.1823878,-18000,,
com.apple.finder,7,1743170658,1743170665,1743170665.213896,-18000,,
com.google.Chrome,19,1743170639,1743170658,1743170658.955528,-18000,,
com.apple.finder,17,1743170622,1743170639,1743170639.800931,-18000,,
com.google.Chrome,30,1743170592,1743170622,1743170623.046691,-18000,,
com.apple.finder,4,1743170588,1743170592,1743170593.034097,-18000,,
com.google.Chrome,19,1743170569,1743170588,1743170588.1451669,-18000,,
com.apple.finder,3,1743170566,1743170569,1743170569.982448,-18000,,
com.google.Chrome,12,1743170554,1743170566,1743170566.094248,-18000,,
com.apple.finder,30,1743170524,1743170554,1743170554.418229,-18000,,
com.google.Chrome,51,1743170420,1743170471,1743170471.0678082,-18000,,
com.microsoft.VSCode,4,1743170416,1743170420,1743170428.77649,-18000,,
com.apple.finder,8,1743170321,1743170329,1743170330.864635,-18000,,
com.apple.weather,37,1743170278,1743170315,1743170315.663192,-18000,EB445137-D7F5-57EC-87DA-1DB460D64046,"iPhone13,2"
com.apple.news,241,1743170036,1743170277,1743170277.511503,-18000,EB445137-D7F5-57EC-87DA-1DB460D64046,"iPhone13,2"
com.instructure.icanvas,16,1743170002,1743170018,1743170018.763143,-18000,EB445137-D7F5-57EC-87DA-1DB460D64046,"iPhone13,2"
com.renpho.health,0,1743170002,1743170002,1743170002.7163281,-18000,EB445137-D7F5-57EC-87DA-1DB460D64046,"iPhone13,2"
com.renpho.health,33,1743169175,1743169208,1743169208.435132,-18000,EB445137-D7F5-57EC-87DA-1DB460D64046,"iPhone13,2"
com.apple.weather,3,1743169171,1743169174,1743169174.42549,-18000,EB445137-D7F5-57EC-87DA-1DB460D64046,"iPhone13,2"
com.apple.weather,18,1743167946,1743167964,1743167964.8429,-18000,EB445137-D7F5-57EC-87DA-1DB460D64046,"iPhone13,2"
com.apple.Health,46,1743167876,1743167922,1743167922.7236671,-18000,EB445137-D7F5-57EC-87DA-1DB460D64046,"iPhone13,2"
com.apple.news,65,1743167802,1743167867,1743167868.0336199,-18000,EB445137-D7F5-57EC-87DA-1DB460D64046,"iPhone13,2"
com.apple.Health,25,1743135615,1743135640,1743135640.8460221,-18000,EB445137-D7F5-57EC-87DA-1DB460D64046,"iPhone13,2"
com.apple.CoreAuthUI,4,1743135274,1743135278,1743135278.9972181,-18000,EB445137-D7F5-57EC-87DA-1DB460D64046,"iPhone13,2"
com.apple.journal,340,1743135273,1743135613,1743135613.4880772,-18000,EB445137-D7F5-57EC-87DA-1DB460D64046,"iPhone13,2"
com.thestorygraph.thestorygraph,46,1743135217,1743135263,1743135263.969575,-18000,EB445137-D7F5-57EC-87DA-1DB460D64046,"iPhone13,2"
com.google.chrome.ios,15,1743135202,1743135217,1743135217.189876,-18000,EB445137-D7F5-57EC-87DA-1DB460D64046,"iPhone13,2"
com.google.chrome.ios,56,1743133045,1743133101,1743133102.138181,-18000,EB445137-D7F5-57EC-87DA-1DB460D64046,"iPhone13,2"
com.microsoft.Office.Outlook,6,1743133039,1743133045,1743133045.195798,-18000,EB445137-D7F5-57EC-87DA-1DB460D64046,"iPhone13,2"
com.google.chrome.ios,2,1743133033,1743133035,1743133035.4993029,-18000,EB445137-D7F5-57EC-87DA-1DB460D64046,"iPhone13,2"
com.apple.CoreAuthUI,2,1743133014,1743133016,1743133016.5886621,-18000,EB445137-D7F5-57EC-87DA-1DB460D64046,"iPhone13,2"
com.google.chrome.ios,29,1743133004,1743133033,1743133033.2579808,-18000,EB445137-D7F5-57EC-87DA-1DB460D64046,"iPhone13,2"
com.microsoft.Office.Outlook,33,1743132971,1743133004,1743133004.344512,-18000,EB445137-D7F5-57EC-87DA-1DB460D64046,"iPhone13,2"
com.apple.finder,113,1743129591,1743129704,1743129704.53272,-18000,,
com.leomehlig.today,138,1743129453,1743129591,1743129591.357617,-18000,,
com.apple.finder,2,1743129451,1743129453,1743129453.663662,-18000,,
com.leomehlig.today,2,1743129449,1743129451,1743129451.549983,-18000,,
com.microsoft.VSCode,2,1743129447,1743129449,1743129449.941132,-18000,,
com.google.Chrome,46,1743129401,1743129447,1743129447.134378,-18000,,
com.leomehlig.today,31,1743129361,1743129392,1743129392.107095,-18000,,
com.google.Chrome,6,1743129355,1743129361,1743129361.756538,-18000,,
com.microsoft.VSCode,4,1743129351,1743129355,1743129355.6834931,-18000,,
com.apple.finder,2,1743129349,1743129351,1743129351.6406832,-18000,,
com.microsoft.VSCode,71,1743129278,1743129349,1743129349.1992512,-18000,,
com.apple.finder,11,1743129267,1743129278,1743129278.139817,-18000,,
com.microsoft.VSCode,6,1743129261,1743129267,1743129267.6452541,-18000,,
com.apple.finder,4,1743129257,1743129261,1743129261.430083,-18000,,
com.microsoft.VSCode,5,1743129252,1743129257,1743129257.094774,-18000,,
com.apple.finder,16,1743129236,1743129252,1743129252.293847,-18000,,
com.microsoft.VSCode,35,1743129201,1743129236,1743129236.087023,-18000,,
com.apple.finder,16,1743129185,1743129201,1743129201.73542,-18000,,
com.microsoft.VSCode,8,1743129177,1743129185,1743129185.703364,-18000,,
com.google.Chrome,33,1743129144,1743129177,1743129177.163351,-18000,,
com.microsoft.VSCode,2,1743129142,1743129144,1743129144.45754,-18000,,
com.apple.finder,85,1743129057,1743129142,1743129142.521424,-18000,,
com.microsoft.VSCode,58,1743128999,1743129057,1743129057.9795861,-18000,,
com.apple.finder,31,1743128968,1743128999,1743128999.28758,-18000,,
com.microsoft.VSCode,92,1743128876,1743128968,1743128968.538653,-18000,,
com.apple.finder,28,1743128848,1743128876,1743128876.703045,-18000,,
com.microsoft.VSCode,30,1743128818,1743128848,1743128848.081575,-18000,,
com.apple.finder,4,1743128814,1743128818,1743128818.4580898,-18000,,
com.microsoft.VSCode,37,1743128777,1743128814,1743128814.584255,-18000,,
com.apple.finder,45,1743128732,1743128777,1743128777.3595119,-18000,,
com.microsoft.VSCode,6,1743128726,1743128732,1743128732.968032,-18000,,
com.apple.finder,8,1743128718,1743128726,1743128726.130296,-18000,,
com.microsoft.VSCode,5,1743128713,1743128718,1743128718.954459,-18000,,
com.apple.finder,9,1743128704,1743128713,1743128713.625471,-18000,,
com.microsoft.VSCode,9,1743128695,1743128704,1743128704.638169,-18000,,
com.apple.finder,14,1743128681,1743128695,1743128695.920127,-18000,,
com.microsoft.VSCode,8,1743128673,1743128681,1743128682.017867,-18000,,
com.apple.finder,53,1743128620,1743128673,1743128673.8719358,-18000,,
com.microsoft.VSCode,17,1743128603,1743128620,1743128620.937621,-18000,,
com.apple.finder,23,1743128580,1743128603,1743128603.8909268,-18000,,
com.microsoft.VSCode,180,1743128400,1743128580,1743128580.905462,-18000,,
com.apple.finder,12,1743128388,1743128400,1743128400.583843,-18000,,
com.microsoft.VSCode,181,1743128207,1743128388,1743128388.7211719,-18000,,
com.apple.finder,18,1743128189,1743128207,1743128207.5672212,-18000,,
com.microsoft.VSCode,354,1743127835,1743128189,1743128189.426749,-18000,,
com.google.Chrome,67,1743127768,1743127835,1743127835.815885,-18000,,
com.microsoft.VSCode,128,1743127640,1743127768,1743127768.188877,-18000,,
com.google.Chrome,35,1743127605,1743127640,1743127640.186352,-18000,,
com.microsoft.VSCode,1,1743127604,1743127605,1743127605.044736,-18000,,
com.google.Chrome,12,1743127592,1743127604,1743127604.23123,-18000,,
com.microsoft.VSCode,200,1743127392,1743127592,1743127592.9227571,-18000,,
com.google.Chrome,1,1743127391,1743127392,1743127392.8040252,-18000,,
com.microsoft.VSCode,3,1743127388,1743127391,1743127391.149904,-18000,,
com.google.Chrome,17,1743127371,1743127388,1743127388.5108309,-18000,,
com.microsoft.VSCode,7,1743127364,1743127371,1743127371.5636911,-18000,,
com.google.Chrome,15,1743127349,1743127364,1743127364.5331569,-18000,,
com.microsoft.VSCode,545,1743126804,1743127349,1743127349.953902,-18000,,
com.google.Chrome,6,1743126798,1743126804,1743126804.9411159,-18000,,
com.microsoft.VSCode,42,1743126756,1743126798,1743126798.391417,-18000,,
com.google.Chrome,3,1743126753,1743126756,1743126756.5977468,-18000,,
com.microsoft.VSCode,11,1743126742,1743126753,1743126753.815172,-18000,,
com.google.Chrome,2,1743126740,1743126742,1743126742.230504,-18000,,
com.microsoft.VSCode,2,1743126738,1743126740,1743126740.702893,-18000,,
com.google.Chrome,0,1743126738,1743126738,1743126738.8821502,-18000,,
com.microsoft.VSCode,8,1743126730,1743126738,1743126738.151686,-18000,,
com.google.Chrome,1,1743126729,1743126730,1743126730.9097872,-18000,,
com.microsoft.VSCode,4,1743126725,1743126729,1743126729.824119,-18000,,
com.google.Chrome,2,1743126723,1743126725,1743126725.388225,-18000,,
com.microsoft.VSCode,13,1743126710,1743126723,1743126723.9912739,-18000,,
com.google.Chrome,6,1743126704,1743126710,1743126710.713696,-18000,,
com.microsoft.VSCode,4,1743126700,1743126704,1743126704.940662,-18000,,
com.google.Chrome,4,1743126696,1743126700,1743126700.703901,-18000,,
com.microsoft.VSCode,1,1743126695,1743126696,1743126696.7942219,-18000,,
com.google.Chrome,6,1743126689,1743126695,1743126695.529951,-18000,,
com.microsoft.VSCode,106,1743126583,1743126689,1743126689.141823,-18000,,
com.google.Chrome,8,1743126575,1743126583,1743126583.371834,-18000,,
com.microsoft.VSCode,0,1743126575,1743126575,1743126575.908539,-18000,,
com.google.Chrome,2,1743126573,1743126575,1743126575.328555,-18000,,
com.microsoft.VSCode,14,1743126559,1743126573,1743126573.343374,-18000,,
com.google.Chrome,12,1743126547,1743126559,1743126559.767463,-18000,,
com.microsoft.VSCode,34,1743126513,1743126547,1743126547.54956,-18000,,
com.google.Chrome,52,1743126461,1743126513,1743126513.175312,-18000,,
com.microsoft.VSCode,9,1743126452,1743126461,1743126461.841419,-18000,,
com.google.Chrome,3,1743126449,1743126452,1743126452.872591,-18000,,
com.microsoft.VSCode,4,1743126445,1743126449,1743126449.975903,-18000,,
com.google.Chrome,21,1743126424,1743126445,1743126445.5182052,-18000,,
com.microsoft.VSCode,118,1743126306,1743126424,1743126424.381814,-18000,,
com.google.Chrome,1,1743126305,1743126306,1743126306.368887,-18000,,
com.microsoft.VSCode,19,1743126286,1743126305,1743126305.155068,-18000,,
com.google.Chrome,4,1743126282,1743126286,1743126286.1763182,-18000,,
com.microsoft.Outlook,2,1743126280,1743126282,1743126282.8361049,-18000,,
com.google.Chrome,1,1743126279,1743126280,1743126280.7383451,-18000,,
com.apple.MobileSMS,2,1743126277,1743126279,1743126279.1292381,-18000,,
com.google.Chrome,290,1743125987,1743126277,1743126277.347817,-18000,,
com.apple.finder,181,1743125806,1743125987,1743125987.0460649,-18000,,
com.apple.Music,8,1743125798,1743125806,1743125806.702383,-18000,,
com.apple.finder,3,1743125795,1743125798,1743125798.340897,-18000,,
com.apple.Music,2,1743125793,1743125795,1743125795.062653,-18000,,
com.apple.finder,1,1743125792,1743125793,1743125793.550067,-18000,,
com.apple.Music,50,1743125742,1743125792,1743125792.517805,-18000,,
com.apple.finder,51,1743125691,1743125742,1743125742.849086,-18000,,
com.apple.Music,73,1743125618,1743125691,1743125691.573588,-18000,,
com.apple.finder,3,1743125615,1743125618,1743125618.471744,-18000,,
com.apple.Music,36,1743125579,1743125615,1743125615.574846,-18000,,
com.google.Chrome,52,1743125527,1743125579,1743125579.6262121,-18000,,
com.apple.finder,8,1743125519,1743125527,1743125528.018797,-18000,,
com.leomehlig.today,1,1743125514,1743125515,1743125515.112649,-18000,,
com.google.Chrome,7,1743125507,1743125514,1743125514.437489,-18000,,
com.google.Chrome,864,1743124355,1743125219,1743125219.893811,-18000,,
com.leomehlig.today,2,1743124353,1743124355,1743124356.0188498,-18000,,
com.apple.news,28,1743124309,1743124337,1743124337.156466,-18000,EB445137-D7F5-57EC-87DA-1DB460D64046,"iPhone13,2"
com.apple.Health,9,1743124295,1743124304,1743124304.110431,-18000,EB445137-D7F5-57EC-87DA-1DB460D64046,"iPhone13,2"
com.apple.Health,6,1743122357,1743122363,1743122364.324232,-18000,EB445137-D7F5-57EC-87DA-1DB460D64046,"iPhone13,2"
com.tinyspeck.chatlyio,11,1743122009,1743122020,1743122020.719459,-18000,EB445137-D7F5-57EC-87DA-1DB460D64046,"iPhone13,2"
com.apple.weather,21,1743121986,1743122007,1743122007.105215,-18000,EB445137-D7F5-57EC-87DA-1DB460D64046,"iPhone13,2"
co.hinge.mobile.ios,1212,1743120771,1743121983,1743121983.5507488,-18000,EB445137-D7F5-57EC-87DA-1DB460D64046,"iPhone13,2"
com.leomehlig.today,312,1743120735,1743121047,1743121047.0720859,-18000,,
com.google.Chrome,51,1743120684,1743120735,1743120735.6982388,-18000,,
com.apple.Notes,838,1743119846,1743120684,1743120684.08723,-18000,,
com.google.Chrome,284,1743119562,1743119846,1743119846.530729,-18000,,
com.apple.Preview,0,1743119562,1743119562,1743119562.892757,-18000,,
com.google.Chrome,139,1743119423,1743119562,1743119562.088225,-18000,,
com.apple.Preview,335,1743119088,1743119423,1743119423.256474,-18000,,
com.leomehlig.today,2,1743119086,1743119088,1743119088.288999,-18000,,
com.apple.Preview,449,1743118637,1743119086,1743119086.65587,-18000,,
com.apple.finder,6,1743118631,1743118637,1743118637.479322,-18000,,
com.apple.Preview,1,1743118630,1743118631,1743118631.6530728,-18000,,
com.google.Chrome,972,1743117658,1743118630,1743118630.345232,-18000,,
com.apple.Preview,82,1743117576,1743117658,1743117658.844135,-18000,,
com.google.Chrome,98,1743117478,1743117576,1743117576.7967548,-18000,,
com.apple.Preview,1,1743117477,1743117478,1743117478.848793,-18000,,
com.leomehlig.today,40,1743117437,1743117477,1743117477.146861,-18000,,
com.google.Chrome,10,1743117427,1743117437,1743117437.545484,-18000,,
com.leomehlig.today,1,1743117426,1743117427,1743117427.297574,-18000,,
com.google.Chrome,1860,1743115566,1743117426,1743117426.3239331,-18000,,
com.google.Chrome,302,1743115060,1743115362,1743115362.061455,-18000,,
com.apple.findmy,3,1743115057,1743115060,1743115061.094784,-18000,,
com.apple.FaceTime,0,1743115057,1743115057,1743115059.40023,-18000,,
com.apple.findmy,14,1743115043,1743115057,1743115057.6992269,-18000,,
com.google.Chrome,861,1743114182,1743115043,1743115043.9073892,-18000,,
com.apple.MobileSMS,395,1743113787,1743114182,1743114182.343017,-18000,,
com.apple.FaceTime,4,1743113783,1743113787,1743113787.535928,-18000,,
com.apple.MobileSMS,59,1743113724,1743113783,1743113783.182389,-18000,,
com.apple.findmy,34,1743113690,1743113724,1743113725.2459779,-18000,,
com.apple.MobileSMS,5,1743113685,1743113690,1743113690.964328,-18000,,
com.google.Chrome,3,1743113682,1743113685,1743113685.3252969,-18000,,
com.leomehlig.today,14,1743113668,1743113682,1743113682.405469,-18000,,
com.google.chrome.ios,16,1743112784,1743112800,1743112800.260085,-18000,EB445137-D7F5-57EC-87DA-1DB460D64046,"iPhone13,2"
com.myfitnesspal.mfp,2,1743112664,1743112666,1743112666.79403,-18000,EB445137-D7F5-57EC-87DA-1DB460D64046,"iPhone13,2"
com.myfitnesspal.mfp,2,1743112585,1743112587,1743112587.951855,-18000,EB445137-D7F5-57EC-87DA-1DB460D64046,"iPhone13,2"
com.myfitnesspal.mfp,27,1743111075,1743111102,1743111102.748358,-18000,EB445137-D7F5-57EC-87DA-1DB460D64046,"iPhone13,2"
com.apple.Health,2,1743111072,1743111074,1743111074.417822,-18000,EB445137-D7F5-57EC-87DA-1DB460D64046,"iPhone13,2"
com.apple.Health,21,1743110583,1743110604,1743110604.678856,-18000,EB445137-D7F5-57EC-87DA-1DB460D64046,"iPhone13,2"
com.instructure.icanvas,10,1743110558,1743110568,1743110568.562254,-18000,EB445137-D7F5-57EC-87DA-1DB460D64046,"iPhone13,2"
com.leomehlig.today,3,1743109753,1743109756,1743109756.822386,-18000,,
com.leomehlig.today,303,1743109271,1743109574,1743109574.8749819,-18000,,
com.google.Chrome,954,1743108317,1743109271,1743109271.554253,-18000,,
com.apple.Preview,385,1743107932,1743108317,1743108317.8124418,-18000,,
com.apple.finder,10,1743107922,1743107932,1743107932.637255,-18000,,
com.instructure.icanvas,42,1743107857,1743107899,1743107899.354879,-18000,EB445137-D7F5-57EC-87DA-1DB460D64046,"iPhone13,2"
com.instructure.icanvas,8,1743107849,1743107857,1743107857.18192,-18000,EB445137-D7F5-57EC-87DA-1DB460D64046,"iPhone13,2"
com.microsoft.Office.Outlook,0,1743107849,1743107849,1743107849.972828,-18000,EB445137-D7F5-57EC-87DA-1DB460D64046,"iPhone13,2"
com.google.Chrome,914,1743107008,1743107922,1743107922.920521,-18000,,
com.apple.Preview,141,1743106867,1743107008,1743107009.0202441,-18000,,
com.google.Chrome,44,1743106823,1743106867,1743106867.465739,-18000,,
com.apple.Preview,21,1743106710,1743106731,1743106731.364565,-18000,,
com.apple.finder,5,1743106705,1743106710,1743106710.445147,-18000,,
com.google.Chrome,40,1743106665,1743106705,1743106705.2890759,-18000,,
com.leomehlig.today,187,1743106478,1743106665,1743106665.664268,-18000,,
com.apple.iCal,8,1743106470,1743106478,1743106478.472392,-18000,,
com.leomehlig.today,2,1743106468,1743106470,1743106470.591905,-18000,,
com.google.Chrome,14,1743106454,1743106468,1743106468.081667,-18000,,
com.microsoft.Outlook,39,1743106415,1743106454,1743106454.617962,-18000,,
com.google.Chrome,109,1743106306,1743106415,1743106415.753587,-18000,,
com.apple.iCal,4,1743106302,1743106306,1743106306.523977,-18000,,
com.google.Chrome,30,1743106272,1743106302,1743106302.068524,-18000,,
com.apple.iCal,3,1743106269,1743106272,1743106272.906801,-18000,,
com.google.Chrome,24,1743106245,1743106269,1743106269.0500898,-18000,,
com.apple.iCal,1,1743106244,1743106245,1743106246.014873,-18000,,
com.google.Chrome,4,1743106240,1743106244,1743106244.905644,-18000,,
com.apple.iCal,2,1743106238,1743106240,1743106240.3820229,-18000,,
com.google.Chrome,11,1743106227,1743106238,1743106238.297202,-18000,,
com.apple.iCal,4,1743106223,1743106227,1743106227.575159,-18000,,
com.google.Chrome,10,1743106213,1743106223,1743106223.773777,-18000,,
com.apple.iCal,3,1743106210,1743106213,1743106213.1176472,-18000,,
com.google.Chrome,2,1743106208,1743106210,1743106211.037102,-18000,,
com.apple.iCal,1,1743106207,1743106208,1743106208.978963,-18000,,
com.google.Chrome,14,1743106193,1743106207,1743106207.830611,-18000,,
com.apple.iCal,1,1743106192,1743106193,1743106193.722606,-18000,,
com.google.Chrome,4,1743106188,1743106192,1743106192.399808,-18000,,
com.apple.iCal,3,1743106185,1743106188,1743106188.288847,-18000,,
com.google.Chrome,3,1743106182,1743106185,1743106185.186644,-18000,,
com.apple.iCal,3,1743106179,1743106182,1743106182.2932382,-18000,,
com.google.Chrome,8,1743106171,1743106179,1743106179.954514,-18000,,
com.apple.iCal,10,1743106161,1743106171,1743106171.6726809,-18000,,
com.google.Chrome,3,1743106158,1743106161,1743106161.632087,-18000,,
com.apple.iCal,2,1743106156,1743106158,1743106158.80043,-18000,,
com.google.Chrome,1,1743106155,1743106156,1743106156.494454,-18000,,
com.apple.iCal,5,1743106150,1743106155,1743106155.112174,-18000,,
com.google.Chrome,4,1743106146,1743106150,1743106150.4242601,-18000,,
com.apple.iCal,5,1743106141,1743106146,1743106146.903833,-18000,,
com.google.Chrome,15,1743106126,1743106141,1743106141.471149,-18000,,
com.microsoft.Outlook,10,1743106116,1743106126,1743106126.563935,-18000,,
com.apple.Preview,3,1743106113,1743106116,1743106116.889484,-18000,,
com.microsoft.Office.Outlook,70,1743106100,1743106170,1743106170.501598,-18000,EB445137-D7F5-57EC-87DA-1DB460D64046,"iPhone13,2"
com.instructure.icanvas,0,1743106100,1743106100,1743106100.759825,-18000,EB445137-D7F5-57EC-87DA-1DB460D64046,"iPhone13,2"
com.instructure.icanvas,33,1743105145,1743105178,1743105178.152835,-18000,EB445137-D7F5-57EC-87DA-1DB460D64046,"iPhone13,2"
com.apple.Preview,7,1743105084,1743105091,1743105091.987842,-18000,,
com.apple.finder,4,1743105080,1743105084,1743105084.920831,-18000,,
com.google.Chrome,1,1743105079,1743105080,1743105080.120697,-18000,,
com.microsoft.Excel,2,1743105077,1743105079,1743105079.2307,-18000,,
com.google.Chrome,59,1743105018,1743105077,1743105078.004043,-18000,,
com.microsoft.Excel,6,1743105012,1743105018,1743105018.523598,-18000,,
com.google.Chrome,28,1743104984,1743105012,1743105012.982635,-18000,,
com.apple.finder,19,1743104965,1743104984,1743104984.420135,-18000,,
com.microsoft.Excel,42,1743104923,1743104965,1743104965.467157,-18000,,
com.google.Chrome,3,1743104920,1743104923,1743104923.165405,-18000,,
com.microsoft.Excel,65,1743104855,1743104920,1743104920.663245,-18000,,
com.google.Chrome,45,1743104810,1743104855,1743104855.358292,-18000,,
com.microsoft.Excel,22,1743104788,1743104810,1743104810.519243,-18000,,
com.google.Chrome,35,1743104753,1743104788,1743104788.5952392,-18000,,
com.microsoft.Excel,0,1743104753,1743104753,1743104753.844751,-18000,,
com.google.Chrome,6,1743104747,1743104753,1743104753.05071,-18000,,
com.microsoft.Excel,2,1743104745,1743104747,1743104747.710129,-18000,,
com.google.Chrome,1,1743104744,1743104745,1743104745.684423,-18000,,
com.microsoft.Excel,1,1743104743,1743104744,1743104744.506347,-18000,,
com.google.Chrome,13,1743104730,1743104743,1743104743.224773,-18000,,
com.microsoft.Excel,2,1743104728,1743104730,1743104730.470859,-18000,,
com.google.Chrome,3,1743104725,1743104728,1743104728.71728,-18000,,
com.microsoft.Excel,1,1743104724,1743104725,1743104725.605123,-18000,,
com.google.Chrome,9,1743104715,1743104724,1743104724.616612,-18000,,
com.microsoft.Excel,53,1743104662,1743104715,1743104715.242424,-18000,,
com.google.Chrome,9,1743104653,1743104662,1743104662.519567,-18000,,
com.microsoft.Excel,2,1743104651,1743104653,1743104653.32355,-18000,,
com.google.Chrome,4,1743104647,1743104651,1743104651.281845,-18000,,
com.microsoft.Excel,36,1743104611,1743104647,1743104647.6383991,-18000,,
com.google.Chrome,66,1743104545,1743104611,1743104611.514281,-18000,,
com.apple.finder,2,1743104543,1743104545,1743104545.828593,-18000,,
com.microsoft.Excel,3,1743104540,1743104543,1743104543.384574,-18000,,
com.apple.finder,7,1743104533,1743104540,1743104540.7956119,-18000,,
com.microsoft.Excel,4,1743104529,1743104533,1743104533.701127,-18000,,
com.apple.finder,7,1743104522,1743104529,1743104529.131604,-18000,,
com.google.Chrome,1,1743104521,1743104522,1743104522.092785,-18000,,
com.microsoft.Excel,2,1743104519,1743104521,1743104521.543347,-18000,,
com.google.Chrome,2,1743104517,1743104519,1743104519.0618138,-18000,,
com.apple.finder,2,1743104515,1743104517,1743104517.660863,-18000,,
com.google.Chrome,18,1743104497,1743104515,1743104516.0344028,-18000,,
com.apple.finder,1,1743104496,1743104497,1743104497.5820851,-18000,,
com.microsoft.Excel,10,1743104486,1743104496,1743104496.945113,-18000,,
com.apple.finder,1,1743104485,1743104486,1743104486.730863,-18000,,
com.google.Chrome,9,1743104476,1743104485,1743104485.619882,-18000,,
com.apple.finder,49,1743104427,1743104476,1743104476.152421,-18000,,
com.microsoft.Excel,17,1743104410,1743104427,1743104427.094676,-18000,,
com.apple.finder,13,1743104397,1743104410,1743104410.914567,-18000,,
com.microsoft.Excel,37,1743104360,1743104397,1743104397.986752,-18000,,
com.google.Chrome,2,1743104358,1743104360,1743104360.575025,-18000,,
com.microsoft.Excel,1,1743104357,1743104358,1743104358.245195,-18000,,
com.google.Chrome,10,1743104347,1743104357,1743104357.7153459,-18000,,
com.microsoft.Excel,11,1743104336,1743104347,1743104347.561511,-18000,,
com.google.Chrome,23,1743104313,1743104336,1743104336.536302,-18000,,
com.microsoft.Excel,1,1743104312,1743104313,1743104313.270606,-18000,,
com.google.Chrome,3,1743104309,1743104312,1743104312.376694,-18000,,
com.microsoft.Excel,1,1743104308,1743104309,1743104309.5833812,-18000,,
com.google.Chrome,3,1743104305,1743104308,1743104308.457859,-18000,,
com.microsoft.Excel,2,1743104303,1743104305,1743104305.360023,-18000,,
com.google.Chrome,4,1743104299,1743104303,1743104303.9172812,-18000,,
com.microsoft.Excel,6,1743104293,1743104299,1743104299.5192971,-18000,,
com.google.Chrome,2,1743104291,1743104293,1743104293.745197,-18000,,
com.apple.finder,0,1743104291,1743104291,1743104291.934675,-18000,,
com.microsoft.Excel,8,1743104283,1743104291,1743104291.057605,-18000,,
com.apple.finder,1,1743104282,1743104283,1743104283.9655771,-18000,,
com.google.Chrome,29,1743104253,1743104282,1743104282.171416,-18000,,
com.apple.finder,12,1743104241,1743104253,1743104253.776338,-18000,,
com.microsoft.Excel,82,1743104159,1743104241,1743104241.188329,-18000,,
com.apple.finder,13,1743104146,1743104159,1743104159.172085,-18000,,
com.microsoft.Excel,25,1743104121,1743104146,1743104146.0958838,-18000,,
com.google.Chrome,18,1743104103,1743104121,1743104121.585627,-18000,,
com.microsoft.Excel,127,1743103976,1743104103,1743104103.1245031,-18000,,
com.google.Chrome,8,1743103968,1743103976,1743103976.5255861,-18000,,
com.microsoft.Excel,1,1743103967,1743103968,1743103968.1736789,-18000,,
com.google.Chrome,6,1743103961,1743103967,1743103967.254315,-18000,,
com.microsoft.Excel,23,1743103938,1743103961,1743103961.538516,-18000,,
com.google.Chrome,30,1743103908,1743103938,1743103938.419426,-18000,,
com.microsoft.Excel,9,1743103899,1743103908,1743103908.360826,-18000,,
com.google.Chrome,16,1743103883,1743103899,1743103899.305941,-18000,,
com.microsoft.Excel,50,1743103833,1743103883,1743103883.886179,-18000,,
com.google.Chrome,22,1743103811,1743103833,1743103833.222161,-18000,,
com.microsoft.Excel,64,1743103747,1743103811,1743103811.652225,-18000,,
com.google.Chrome,16,1743103731,1743103747,1743103747.1975598,-18000,,
com.microsoft.Excel,401,1743103330,1743103731,1743103731.0881371,-18000,,
com.google.Chrome,26,1743103304,1743103330,1743103330.13517,-18000,,
com.microsoft.Excel,4,1743103300,1743103304,1743103304.97283,-18000,,
com.google.Chrome,6,1743103294,1743103300,1743103301.025214,-18000,,
com.microsoft.Excel,67,1743103227,1743103294,1743103294.0457978,-18000,,
com.google.Chrome,102,1743103125,1743103227,1743103227.805122,-18000,,
com.microsoft.Excel,848,1743102277,1743103125,1743103125.527705,-18000,,
com.apple.finder,1,1743102276,1743102277,1743102277.8273082,-18000,,
com.google.Chrome,3,1743102273,1743102276,1743102276.725236,-18000,,
com.apple.finder,2,1743102271,1743102273,1743102273.3054981,-18000,,
com.microsoft.Excel,14,1743102257,1743102271,1743102271.8472838,-18000,,
com.apple.finder,26,1743102231,1743102257,1743102257.373959,-18000,,
com.google.Chrome,264,1743101967,1743102231,1743102231.958197,-18000,,
com.instructure.icanvas,106,1743100855,1743100961,1743100962.064822,-18000,EB445137-D7F5-57EC-87DA-1DB460D64046,"iPhone13,2"
com.microsoft.Office.Outlook,23,1743100831,1743100854,1743100854.239008,-18000,EB445137-D7F5-57EC-87DA-1DB460D64046,"iPhone13,2"
com.google.Chrome,147,1743100711,1743100858,1743100858.787962,-18000,,
com.apple.Preview,11,1743100700,1743100711,1743100711.2389588,-18000,,
com.google.Chrome,183,1743100517,1743100700,1743100700.61025,-18000,,
com.apple.Preview,1,1743100516,1743100517,1743100517.121612,-18000,,
com.google.Chrome,20,1743100496,1743100516,1743100516.204509,-18000,,
com.apple.Preview,7,1743100489,1743100496,1743100496.417325,-18000,,
com.apple.finder,5,1743100484,1743100489,1743100489.61841,-18000,,
com.google.Chrome,3,1743100481,1743100484,1743100484.6757932,-18000,,
com.apple.finder,1,1743100480,1743100481,1743100481.860168,-18000,,
com.google.Chrome,50,1743100430,1743100480,1743100480.246413,-18000,,
com.apple.iCal,11,1743100419,1743100430,1743100430.422739,-18000,,
com.google.Chrome,232,1743100187,1743100419,1743100419.373011,-18000,,
com.apple.Passwords,6,1743100181,1743100187,1743100187.568495,-18000,,
com.google.Chrome,4,1743100177,1743100181,1743100181.18167,-18000,,
com.apple.Passwords,6,1743100159,1743100165,1743100165.970933,-18000,,
com.google.Chrome,470,1743099689,1743100159,1743100159.250365,-18000,,
co.hinge.mobile.ios,7,1743094108,1743094115,1743094115.237098,-18000,EB445137-D7F5-57EC-87DA-1DB460D64046,"iPhone13,2"
com.burbn.instagram,226,1743092767,1743092993,1743092993.489712,-18000,EB445137-D7F5-57EC-87DA-1DB460D64046,"iPhone13,2"
com.google.Chrome,1025,1743091710,1743092735,1743092735.3318229,-18000,,
com.leomehlig.today,3,1743091707,1743091710,1743091710.06492,-18000,,
com.leomehlig.today,267,1743090571,1743090838,1743090838.453505,-18000,,
com.apple.finder,37,1743090534,1743090571,1743090571.519826,-18000,,
com.google.Chrome,30,1743090504,1743090534,1743090534.223755,-18000,,
com.apple.finder,9,1743090495,1743090504,1743090504.536217,-18000,,
com.google.Chrome,4,1743090491,1743090495,1743090495.073611,-18000,,
com.apple.finder,5,1743090486,1743090491,1743090491.1886868,-18000,,
com.google.Chrome,1,1743090485,1743090486,1743090486.867368,-18000,,
com.apple.finder,5,1743090480,1743090485,1743090485.395786,-18000,,
com.google.Chrome,6,1743090474,1743090480,1743090480.077605,-18000,,
com.apple.finder,12,1743090462,1743090474,1743090474.844625,-18000,,
com.google.Chrome,7,1743090455,1743090462,1743090462.181725,-18000,,
com.apple.finder,8,1743090447,1743090455,1743090455.341632,-18000,,
com.google.Chrome,17,1743090430,1743090447,1743090447.207861,-18000,,
com.apple.finder,2,1743090428,1743090430,1743090430.8798609,-18000,,
com.google.Chrome,1,1743090427,1743090428,1743090428.2789922,-18000,,
com.apple.finder,4,1743090423,1743090427,1743090427.558294,-18000,,
com.google.Chrome,11,1743090412,1743090423,1743090423.4297729,-18000,,
com.apple.finder,2,1743090410,1743090412,1743090412.595199,-18000,,
com.google.Chrome,2,1743090408,1743090410,1743090410.648479,-18000,,
com.apple.finder,5,1743090403,1743090408,1743090408.55601,-18000,,
com.google.Chrome,3,1743090400,1743090403,1743090403.844249,-18000,,
com.apple.finder,5,1743090395,1743090400,1743090400.715005,-18000,,
com.google.Chrome,3,1743090392,1743090395,1743090395.307266,-18000,,
com.apple.finder,5,1743090387,1743090392,1743090392.710353,-18000,,
com.google.Chrome,3,1743090384,1743090387,1743090387.978105,-18000,,
com.apple.finder,7,1743090377,1743090384,1743090384.4488711,-18000,,
com.google.Chrome,77,1743090300,1743090377,1743090377.330708,-18000,,
com.apple.finder,4,1743090296,1743090300,1743090300.81919,-18000,,
com.microsoft.VSCode,23,1743090273,1743090296,1743090296.743394,-18000,,
com.apple.finder,48,1743090225,1743090273,1743090274.0191622,-18000,,
com.microsoft.VSCode,1,1743090224,1743090225,1743090225.179562,-18000,,
com.google.Chrome,49,1743090175,1743090224,1743090224.423732,-18000,,
com.apple.finder,34,1743090129,1743090163,1743090163.233924,-18000,,
com.microsoft.VSCode,11,1743090118,1743090129,1743090129.418416,-18000,,
com.apple.finder,18,1743090100,1743090118,1743090118.80273,-18000,,
com.microsoft.VSCode,26,1743090074,1743090100,1743090100.6071339,-18000,,
com.apple.finder,12,1743090062,1743090074,1743090074.22223,-18000,,
com.microsoft.VSCode,28,1743090034,1743090062,1743090062.241827,-18000,,
com.apple.finder,16,1743090018,1743090034,1743090034.2788172,-18000,,
com.microsoft.VSCode,135,1743089883,1743090018,1743090018.948907,-18000,,
com.google.Chrome,4,1743089879,1743089883,1743089883.0488849,-18000,,
com.electron.carta,122,1743089757,1743089879,1743089880.1676621,-18000,,
com.google.Chrome,9,1743089748,1743089757,1743089757.276515,-18000,,
com.electron.carta,22,1743089726,1743089748,1743089748.820314,-18000,,
com.google.Chrome,17,1743089709,1743089726,1743089726.96813,-18000,,
com.electron.carta,48,1743089661,1743089709,1743089709.105651,-18000,,
com.google.Chrome,5,1743089656,1743089661,1743089661.287113,-18000,,
com.electron.carta,25,1743089631,1743089656,1743089656.2247,-18000,,
com.google.Chrome,27,1743089604,1743089631,1743089631.168171,-18000,,
com.electron.carta,80,1743089524,1743089604,1743089604.706356,-18000,,
com.google.Chrome,12,1743089512,1743089524,1743089524.379365,-18000,,
com.electron.carta,26,1743089486,1743089512,1743089512.754655,-18000,,
com.jinzhenyu.ruler,2,1743089484,1743089486,1743089486.218832,-18000,,
com.electron.carta,1,1743089483,1743089484,1743089484.680942,-18000,,
com.google.Chrome,60,1743089423,1743089483,1743089483.96678,-18000,,
com.electron.carta,47,1743089376,1743089423,1743089423.407623,-18000,,
com.google.Chrome,2,1743089374,1743089376,1743089376.322832,-18000,,
com.jinzhenyu.ruler,1,1743089373,1743089374,1743089374.196564,-18000,,
com.google.Chrome,87,1743089286,1743089373,1743089373.411838,-18000,,
com.jinzhenyu.ruler,17,1743089269,1743089286,1743089286.90942,-18000,,
com.electron.carta,6,1743089263,1743089269,1743089269.199008,-18000,,
com.jinzhenyu.ruler,5,1743089258,1743089263,1743089263.217385,-18000,,
com.electron.carta,58,1743089200,1743089258,1743089258.0700889,-18000,,
com.google.Chrome,0,1743089200,1743089200,1743089200.869134,-18000,,
com.jinzhenyu.ruler,1,1743089199,1743089200,1743089200.510941,-18000,,
com.google.Chrome,9,1743089190,1743089199,1743089199.751039,-18000,,
com.jinzhenyu.ruler,2,1743089188,1743089190,1743089190.5730329,-18000,,
com.google.Chrome,7,1743089181,1743089188,1743089188.969921,-18000,,
com.jinzhenyu.ruler,16,1743089165,1743089181,1743089181.5768661,-18000,,
com.electron.carta,2,1743089163,1743089165,1743089165.326535,-18000,,
com.jinzhenyu.ruler,1,1743089162,1743089163,1743089163.558751,-18000,,
com.electron.carta,58,1743089104,1743089162,1743089162.62435,-18000,,
com.google.Chrome,0,1743089104,1743089104,1743089104.874676,-18000,,
com.jinzhenyu.ruler,2,1743089102,1743089104,1743089104.134501,-18000,,
com.google.Chrome,32,1743089070,1743089102,1743089102.858547,-18000,,
com.jinzhenyu.ruler,11,1743089059,1743089070,1743089070.2600641,-18000,,
com.google.Chrome,6,1743089053,1743089059,1743089059.907877,-18000,,
com.jinzhenyu.ruler,23,1743089030,1743089053,1743089053.508939,-18000,,
com.electron.carta,2,1743089028,1743089030,1743089030.280869,-18000,,
com.jinzhenyu.ruler,2,1743089026,1743089028,1743089028.551374,-18000,,
com.electron.carta,53,1743088973,1743089026,1743089026.944601,-18000,,
com.google.Chrome,1,1743088972,1743088973,1743088973.955945,-18000,,
com.jinzhenyu.ruler,0,1743088972,1743088972,1743088973.0637279,-18000,,
com.google.Chrome,54,1743088918,1743088972,1743088972.110372,-18000,,
com.jinzhenyu.ruler,22,1743088896,1743088918,1743088918.151709,-18000,,
com.electron.carta,2,1743088894,1743088896,1743088896.483264,-18000,,
com.jinzhenyu.ruler,1,1743088893,1743088894,1743088894.7334208,-18000,,
com.electron.carta,142,1743088751,1743088893,1743088893.771059,-18000,,
com.google.Chrome,60,1743088691,1743088751,1743088751.526898,-18000,,
com.electron.carta,42,1743088649,1743088691,1743088691.549201,-18000,,
com.google.Chrome,25,1743088624,1743088649,1743088649.6277971,-18000,,
com.google.Chrome,359,1743087925,1743088284,1743088284.1035461,-18000,,
com.electron.carta,23,1743087902,1743087925,1743087925.120045,-18000,,
com.google.Chrome,10,1743087892,1743087902,1743087903.018961,-18000,,
com.electron.carta,14,1743087878,1743087892,1743087892.673852,-18000,,
com.google.Chrome,16,1743087862,1743087878,1743087878.171091,-18000,,
com.electron.carta,3,1743087859,1743087862,1743087862.550222,-18000,,
com.google.Chrome,5,1743087854,1743087859,1743087859.265984,-18000,,
com.electron.carta,12,1743087842,1743087854,1743087855.067275,-18000,,
com.google.Chrome,18,1743087824,1743087842,1743087842.242275,-18000,,
com.electron.carta,16,1743087808,1743087824,1743087824.80597,-18000,,
com.google.Chrome,38,1743087770,1743087808,1743087808.639508,-18000,,
com.electron.carta,26,1743087744,1743087770,1743087771.034215,-18000,,
com.google.Chrome,70,1743087674,1743087744,1743087744.549151,-18000,,
com.electron.carta,3,1743087671,1743087674,1743087674.551237,-18000,,
com.google.Chrome,1,1743087670,1743087671,1743087671.7550402,-18000,,
com.electron.carta,2,1743087668,1743087670,1743087670.128875,-18000,,
com.google.Chrome,31,1743087637,1743087668,1743087668.754533,-18000,,
com.electron.carta,129,1743087508,1743087637,1743087637.3039188,-18000,,
com.google.Chrome,0,1743087508,1743087508,1743087508.912294,-18000,,
com.jinzhenyu.ruler,1,1743087507,1743087508,1743087508.327402,-18000,,
com.google.Chrome,99,1743087408,1743087507,1743087507.183494,-18000,,
com.jinzhenyu.ruler,2,1743087406,1743087408,1743087408.161629,-18000,,
com.google.Chrome,9,1743087397,1743087406,1743087406.588906,-18000,,
com.jinzhenyu.ruler,20,1743087377,1743087397,1743087397.9096909,-18000,,
com.electron.carta,56,1743087321,1743087377,1743087377.4825249,-18000,,
com.google.Chrome,2,1743087319,1743087321,1743087321.1702309,-18000,,
com.jinzhenyu.ruler,1,1743087318,1743087319,1743087319.8038812,-18000,,
com.google.Chrome,51,1743087267,1743087318,1743087318.654547,-18000,,
com.jinzhenyu.ruler,27,1743087240,1743087267,1743087267.081728,-18000,,
com.electron.carta,2,1743087238,1743087240,1743087240.231279,-18000,,
com.jinzhenyu.ruler,1,1743087237,1743087238,1743087238.31186,-18000,,
com.electron.carta,41,1743087196,1743087237,1743087237.5574079,-18000,,
com.google.Chrome,50,1743087146,1743087196,1743087196.829247,-18000,,
com.electron.carta,16,1743087130,1743087146,1743087146.296587,-18000,,
com.google.Chrome,15,1743087115,1743087130,1743087130.763072,-18000,,
com.electron.carta,45,1743087070,1743087115,1743087115.4690042,-18000,,
com.google.Chrome,9,1743087061,1743087070,1743087070.28858,-18000,,
com.electron.carta,13,1743087048,1743087061,1743087061.527942,-18000,,
com.google.Chrome,13,1743087035,1743087048,1743087048.44642,-18000,,
com.electron.carta,17,1743087018,1743087035,1743087035.903995,-18000,,
com.google.Chrome,94,1743086924,1743087018,1743087018.487348,-18000,,
com.electron.carta,99,1743086825,1743086924,1743086924.2268949,-18000,,
com.google.Chrome,36,1743086789,1743086825,1743086825.3363051,-18000,,
com.electron.carta,36,1743086753,1743086789,1743086789.815562,-18000,,
com.google.Chrome,3,1743086750,1743086753,1743086754.029626,-18000,,
com.jinzhenyu.ruler,1,1743086749,1743086750,1743086750.978462,-18000,,
com.google.Chrome,4,1743086745,1743086749,1743086749.58142,-18000,,
com.leomehlig.today,157,1743086588,1743086745,1743086745.230569,-18000,,
com.google.Chrome,43,1743086545,1743086588,1743086588.923856,-18000,,
com.jinzhenyu.ruler,24,1743086521,1743086545,1743086545.054724,-18000,,
com.electron.carta,3,1743086518,1743086521,1743086521.602755,-18000,,
com.jinzhenyu.ruler,4,1743086514,1743086518,1743086518.1319818,-18000,,
com.electron.carta,61,1743086453,1743086514,1743086514.628327,-18000,,
com.google.Chrome,1,1743086452,1743086453,1743086453.6055121,-18000,,
com.jinzhenyu.ruler,1,1743086451,1743086452,1743086452.585798,-18000,,
com.google.Chrome,2,1743086449,1743086451,1743086451.565453,-18000,,
com.electron.carta,2,1743086447,1743086449,1743086449.867903,-18000,,
com.google.Chrome,72,1743086375,1743086447,1743086447.4230561,-18000,,
com.jinzhenyu.ruler,31,1743086344,1743086375,1743086375.164392,-18000,,
com.electron.carta,2,1743086342,1743086344,1743086344.2944422,-18000,,
com.jinzhenyu.ruler,6,1743086336,1743086342,1743086342.37867,-18000,,
com.electron.carta,34,1743086302,1743086336,1743086336.327676,-18000,,
com.google.Chrome,12,1743086290,1743086302,1743086302.353663,-18000,,
com.electron.carta,23,1743086267,1743086290,1743086290.1544151,-18000,,
com.google.Chrome,40,1743086227,1743086267,1743086267.3676848,-18000,,
com.electron.carta,9,1743086218,1743086227,1743086227.779543,-18000,,
com.google.Chrome,9,1743086209,1743086218,1743086218.1034532,-18000,,
com.electron.carta,27,1743086182,1743086209,1743086209.400889,-18000,,
com.google.Chrome,7,1743086175,1743086182,1743086182.545881,-18000,,
com.electron.carta,14,1743086161,1743086175,1743086175.6622,-18000,,
com.google.Chrome,12,1743086149,1743086161,1743086161.5839682,-18000,,
com.electron.carta,17,1743086132,1743086149,1743086149.5550961,-18000,,
com.google.Chrome,14,1743086118,1743086132,1743086132.554208,-18000,,
com.electron.carta,27,1743086091,1743086118,1743086118.6152248,-18000,,
com.google.Chrome,310,1743085781,1743086091,1743086091.9200602,-18000,,
com.electron.carta,173,1743085608,1743085781,1743085781.33797,-18000,,
com.microsoft.VSCode,37,1743085571,1743085608,1743085608.873825,-18000,,
com.google.Chrome,6,1743085565,1743085571,1743085571.553862,-18000,,
com.electron.carta,51,1743085514,1743085565,1743085565.439661,-18000,,
com.google.Chrome,20,1743085494,1743085514,1743085514.216573,-18000,,
com.apple.finder,14,1743085480,1743085494,1743085494.500894,-18000,,
com.google.Chrome,45,1743085435,1743085480,1743085480.831273,-18000,,
com.apple.finder,5,1743085430,1743085435,1743085435.7410588,-18000,,
com.google.Chrome,3,1743085427,1743085430,1743085430.2409592,-18000,,
com.apple.finder,2,1743085425,1743085427,1743085427.1103082,-18000,,
com.google.Chrome,2,1743085423,1743085425,1743085425.6152291,-18000,,
com.apple.finder,2,1743085421,1743085423,1743085423.161324,-18000,,
com.google.Chrome,21,1743085400,1743085421,1743085421.114009,-18000,,
com.apple.finder,5,1743085395,1743085400,1743085400.4412599,-18000,,
com.electron.carta,28,1743085367,1743085395,1743085395.289882,-18000,,
com.apple.finder,98,1743085269,1743085367,1743085368.027569,-18000,,
com.electron.carta,127,1743085142,1743085269,1743085269.668689,-18000,,
com.apple.finder,9,1743085133,1743085142,1743085142.4955602,-18000,,
com.electron.carta,49,1743085084,1743085133,1743085133.470993,-18000,,
com.apple.finder,5,1743085079,1743085084,1743085084.645821,-18000,,
com.electron.carta,15,1743085064,1743085079,1743085079.72749,-18000,,
com.apple.finder,188,1743084876,1743085064,1743085064.265823,-18000,,
com.electron.carta,211,1743084665,1743084876,1743084876.102263,-18000,,
com.apple.Terminal,124,1743084541,1743084665,1743084665.122086,-18000,,
com.apple.finder,20,1743084434,1743084454,1743084454.140211,-18000,,
com.apple.Terminal,20,1743084414,1743084434,1743084434.8550801,-18000,,
com.apple.finder,4,1743084410,1743084414,1743084414.129665,-18000,,
com.toyopagroup.picaboo,57,1743084148,1743084205,1743084205.989914,-18000,EB445137-D7F5-57EC-87DA-1DB460D64046,"iPhone13,2"
com.microsoft.Office.Outlook,2,1743084146,1743084148,1743084148.448152,-18000,EB445137-D7F5-57EC-87DA-1DB460D64046,"iPhone13,2"
com.apple.finder,315,1743084093,1743084408,1743084408.259974,-18000,,
com.apple.Terminal,19,1743084074,1743084093,1743084093.982211,-18000,,
com.apple.finder,2,1743084072,1743084074,1743084074.715767,-18000,,
com.google.Chrome,1,1743084071,1743084072,1743084072.993098,-18000,,
com.apple.finder,1,1743084070,1743084071,1743084071.795728,-18000,,
com.apple.Terminal,40,1743084030,1743084070,1743084070.0657458,-18000,,
com.apple.finder,8,1743084022,1743084030,1743084030.563788,-18000,,
com.apple.Terminal,34,1743083988,1743084022,1743084022.125216,-18000,,
com.google.Chrome,1,1743083987,1743083988,1743083988.981117,-18000,,
com.apple.Terminal,31,1743083956,1743083987,1743083988.010756,-18000,,
com.apple.finder,4,1743083952,1743083956,1743083956.2693372,-18000,,
com.apple.Terminal,18,1743083934,1743083952,1743083952.230191,-18000,,
com.apple.finder,3,1743083931,1743083934,1743083934.039603,-18000,,
com.google.Chrome,34,1743083897,1743083931,1743083931.467205,-18000,,
com.apple.finder,40,1743083857,1743083897,1743083897.6130981,-18000,,
com.google.Chrome,30,1743083827,1743083857,1743083857.3225532,-18000,,
com.apple.finder,2,1743083825,1743083827,1743083827.4279618,-18000,,
com.google.Chrome,3,1743083822,1743083825,1743083825.1895251,-18000,,
com.apple.finder,3,1743083819,1743083822,1743083822.1505098,-18000,,
com.google.Chrome,116,1743083703,1743083819,1743083819.478971,-18000,,
com.apple.finder,9,1743083694,1743083703,1743083703.138473,-18000,,
com.google.Chrome,19,1743083675,1743083694,1743083694.196414,-18000,,
com.apple.finder,2,1743083673,1743083675,1743083675.2154331,-18000,,
com.google.Chrome,33,1743083640,1743083673,1743083673.699774,-18000,,
com.apple.finder,188,1743083452,1743083640,1743083640.5287561,-18000,,
com.google.Chrome,28,1743083424,1743083452,1743083452.054462,-18000,,
com.apple.finder,46,1743083378,1743083424,1743083424.850179,-18000,,
com.leomehlig.today,4,1743083374,1743083378,1743083378.8946981,-18000,,
com.apple.finder,9,1743083365,1743083374,1743083374.654516,-18000,,
com.google.Chrome,10,1743083355,1743083365,1743083365.197281,-18000,,
com.microsoft.Office.Outlook,70,1743083312,1743083382,1743083382.5831962,-18000,EB445137-D7F5-57EC-87DA-1DB460D64046,"iPhone13,2"
com.apple.Health,19,1743083284,1743083303,1743083303.6627421,-18000,EB445137-D7F5-57EC-87DA-1DB460D64046,"iPhone13,2"
com.apple.finder,54,1743083272,1743083326,1743083326.149733,-18000,,
com.google.Chrome,5,1743083267,1743083272,1743083273.6417398,-18000,,
com.renpho.health,81,1743082367,1743082448,1743082448.920646,-18000,EB445137-D7F5-57EC-87DA-1DB460D64046,"iPhone13,2"
com.apple.CoreAuthUI,2,1743046865,1743046867,1743046867.420037,-18000,EB445137-D7F5-57EC-87DA-1DB460D64046,"iPhone13,2"
com.apple.journal,760,1743046864,1743047624,1743047624.056487,-18000,EB445137-D7F5-57EC-87DA-1DB460D64046,"iPhone13,2"
com.apple.Health,53,1743046806,1743046859,1743046859.5929031,-18000,EB445137-D7F5-57EC-87DA-1DB460D64046,"iPhone13,2"
com.thestorygraph.thestorygraph,14,1743046789,1743046803,1743046803.945825,-18000,EB445137-D7F5-57EC-87DA-1DB460D64046,"iPhone13,2"
com.google.Chrome,758,1743041588,1743042346,1743042346.291951,-18000,,
com.apple.finder,1,1743041587,1743041588,1743041589.02899,-18000,,
com.leomehlig.today,17,1743041570,1743041587,1743041587.41658,-18000,,
com.apple.Music,4,1743038855,1743038859,1743038860.17241,-18000,EB445137-D7F5-57EC-87DA-1DB460D64046,"iPhone13,2"
com.apple.Music,20,1743037682,1743037702,1743037702.957514,-18000,EB445137-D7F5-57EC-87DA-1DB460D64046,"iPhone13,2"
com.leomehlig.today,35,1743037460,1743037495,1743037495.306133,-18000,,
com.apple.MobileSMS,77,1743037383,1743037460,1743037460.344018,-18000,,
com.leomehlig.today,91,1743037292,1743037383,1743037383.21176,-18000,,
com.apple.MobileSMS,42,1743037250,1743037292,1743037293.156434,-18000,,
com.leomehlig.today,240,1743037010,1743037250,1743037250.4919071,-18000,,
com.google.Chrome,81,1743036929,1743037010,1743037010.358747,-18000,,
com.leomehlig.today,43,1743036873,1743036916,1743036916.1344361,-18000,,
com.apple.iCal,9,1743036864,1743036873,1743036873.361388,-18000,,
com.leomehlig.today,82,1743036782,1743036864,1743036864.478932,-18000,,
com.google.Chrome,4,1743036778,1743036782,1743036783.173699,-18000,,
com.apple.Terminal,1,1743036777,1743036778,1743036778.701011,-18000,,
com.google.Chrome,15,1743036762,1743036777,1743036777.095146,-18000,,
com.leomehlig.today,15,1743036747,1743036762,1743036762.629986,-18000,,
com.google.Chrome,482,1743036265,1743036747,1743036748.003361,-18000,,
com.leomehlig.today,37,1743036228,1743036265,1743036265.454042,-18000,,
com.google.Chrome,27,1743036201,1743036228,1743036228.277075,-18000,,
com.leomehlig.today,0,1743036201,1743036201,1743036201.954407,-18000,,
com.google.Chrome,2,1743036199,1743036201,1743036201.324586,-18000,,
com.leomehlig.today,3,1743036196,1743036199,1743036199.996501,-18000,,
com.google.Chrome,23,1743036173,1743036196,1743036196.961981,-18000,,
com.apple.iCal,2,1743036171,1743036173,1743036173.9076262,-18000,,
com.google.Chrome,8,1743036163,1743036171,1743036172.0367188,-18000,,
com.leomehlig.today,31,1743036132,1743036163,1743036163.726543,-18000,,
com.google.Chrome,212,1743035920,1743036132,1743036132.632848,-18000,,
com.apple.finder,24,1743035896,1743035920,1743035921.01314,-18000,,
com.apple.Preview,19,1743035877,1743035896,1743035896.1492782,-18000,,
com.google.Chrome,420,1743035457,1743035877,1743035877.88134,-18000,,
com.apple.Preview,1,1743035456,1743035457,1743035457.865343,-18000,,
com.leomehlig.today,8,1743035448,1743035456,1743035456.634149,-18000,,
com.google.Chrome,3,1743035445,1743035448,1743035448.346062,-18000,,
com.apple.Preview,52,1743035393,1743035445,1743035445.4760242,-18000,,
com.apple.Preview,505,1743034887,1743035392,1743035392.039849,-18000,,
co.hinge.mobile.ios,36,1743034828,1743034864,1743034864.723971,-18000,EB445137-D7F5-57EC-87DA-1DB460D64046,"iPhone13,2"
com.apple.Health,1,1743034827,1743034828,1743034828.095903,-18000,EB445137-D7F5-57EC-87DA-1DB460D64046,"iPhone13,2"
com.google.Chrome,272,1743034615,1743034887,1743034887.5487351,-18000,,
com.apple.Preview,171,1743034444,1743034615,1743034615.456588,-18000,,
com.apple.finder,4,1743034440,1743034444,1743034444.701645,-18000,,
com.apple.Preview,5,1743034435,1743034440,1743034440.620014,-18000,,
com.google.Chrome,296,1743034139,1743034435,1743034436.002548,-18000,,
com.apple.Preview,224,1743033915,1743034139,1743034139.924192,-18000,,
com.google.Chrome,263,1743033652,1743033915,1743033915.449728,-18000,,
com.apple.Preview,225,1743033427,1743033652,1743033653.0382729,-18000,,
com.apple.finder,5,1743033422,1743033427,1743033428.0368419,-18000,,
com.google.Chrome,33,1743033389,1743033422,1743033422.578899,-18000,,
com.apple.Preview,7,1743033382,1743033389,1743033389.5748348,-18000,,
com.google.Chrome,53,1743033329,1743033382,1743033382.336571,-18000,,
com.apple.finder,4,1743033325,1743033329,1743033329.822339,-18000,,
com.google.Chrome,556,1743032769,1743033325,1743033325.314937,-18000,,
com.apple.Health,15,1743032660,1743032675,1743032675.6332932,-18000,EB445137-D7F5-57EC-87DA-1DB460D64046,"iPhone13,2"
com.apple.findmy,6,1743032580,1743032586,1743032587.1932569,-18000,EB445137-D7F5-57EC-87DA-1DB460D64046,"iPhone13,2"
com.apple.news,549,1743032027,1743032576,1743032576.634925,-18000,EB445137-D7F5-57EC-87DA-1DB460D64046,"iPhone13,2"
com.intsig.CamScannerLite,2,1743032001,1743032003,1743032004.5424252,-18000,EB445137-D7F5-57EC-87DA-1DB460D64046,"iPhone13,2"
com.google.Chrome,558,1743031652,1743032210,1743032210.195596,-18000,,
com.apple.Preview,72,1743031580,1743031652,1743031652.520818,-18000,,
com.apple.finder,400,1743031180,1743031580,1743031580.607084,-18000,,
com.apple.MobileSMS,22,1743031158,1743031180,1743031181.0300488,-18000,,
com.apple.finder,1,1743031157,1743031158,1743031158.81933,-18000,,
com.apple.MobileSMS,49,1743031108,1743031157,1743031157.401597,-18000,,
com.intsig.CamScannerLite,357,1743030905,1743031262,1743031263.1872869,-18000,EB445137-D7F5-57EC-87DA-1DB460D64046,"iPhone13,2"
com.apple.weather,2,1743030898,1743030900,1743030900.8322759,-18000,EB445137-D7F5-57EC-87DA-1DB460D64046,"iPhone13,2"
com.apple.weather,2,1743030896,1743030898,1743030898.428945,-18000,EB445137-D7F5-57EC-87DA-1DB460D64046,"iPhone13,2"
com.apple.finder,301,1743030807,1743031108,1743031108.962369,-18000,,
com.apple.Terminal,209,1743030598,1743030807,1743030807.086817,-18000,,
com.apple.finder,70,1743030528,1743030598,1743030598.098847,-18000,,
com.apple.Terminal,17,1743030511,1743030528,1743030528.222388,-18000,,
com.apple.finder,2,1743030509,1743030511,1743030511.525336,-18000,,
com.google.Chrome,7,1743030502,1743030509,1743030509.039102,-18000,,
com.apple.iCal,23,1743030479,1743030502,1743030503.051166,-18000,,
com.google.Chrome,280,1743030199,1743030479,1743030479.8364081,-18000,,
com.apple.finder,74,1743030125,1743030199,1743030199.813816,-18000,,
com.google.Chrome,396,1743029729,1743030125,1743030125.2095609,-18000,,
com.apple.finder,2,1743029727,1743029729,1743029729.080085,-18000,,
com.leomehlig.today,1,1743029726,1743029727,1743029727.21145,-18000,,
com.apple.Terminal,23,1743029703,1743029726,1743029726.633671,-18000,,
com.apple.finder,10,1743029693,1743029703,1743029703.883318,-18000,,
com.apple.Terminal,61,1743029632,1743029693,1743029693.5548449,-18000,,
com.leomehlig.today,47,1743029585,1743029632,1743029632.55176,-18000,,
com.apple.finder,2,1743029583,1743029585,1743029585.862865,-18000,,
com.cisco.secureclient.gui,4,1743029579,1743029583,1743029583.667842,-18000,,
com.microsoft.VSCode,3,1743029576,1743029579,1743029579.688035,-18000,,
com.cisco.secureclient.gui,5,1743029571,1743029576,1743029576.210867,-18000,,
com.apple.Terminal,3,1743029568,1743029571,1743029571.096633,-18000,,
com.cisco.secureclient.gui,3,1743029565,1743029568,1743029568.902194,-18000,,
com.apple.finder,2,1743029563,1743029565,1743029565.257403,-18000,,
com.cisco.secureclient.gui,1,1743029562,1743029563,1743029563.086465,-18000,,
com.apple.iCal,5,1743029557,1743029562,1743029562.357631,-18000,,
com.apple.finder,4,1743029553,1743029557,1743029557.3874211,-18000,,
com.apple.weather,8,1743028022,1743028030,1743028030.980953,-18000,EB445137-D7F5-57EC-87DA-1DB460D64046,"iPhone13,2"
com.toyopagroup.picaboo,9,1743027953,1743027962,1743027962.835099,-18000,EB445137-D7F5-57EC-87DA-1DB460D64046,"iPhone13,2"
com.apple.finder,12,1743027829,1743027841,1743027841.3537378,-18000,,
com.google.Chrome,993,1743026836,1743027829,1743027829.154449,-18000,,
com.apple.iCal,41,1743026795,1743026836,1743026836.7781348,-18000,,
com.google.Chrome,71,1743026724,1743026795,1743026795.2214499,-18000,,
com.apple.Terminal,38,1743026686,1743026724,1743026724.0672622,-18000,,
com.google.Chrome,3,1743026683,1743026686,1743026686.807405,-18000,,
com.apple.Terminal,17,1743026666,1743026683,1743026683.164318,-18000,,
com.google.Chrome,1,1743026665,1743026666,1743026666.1199741,-18000,,
com.apple.Terminal,3,1743026662,1743026665,1743026665.17479,-18000,,
com.google.Chrome,1,1743026661,1743026662,1743026662.8979468,-18000,,
com.apple.Terminal,8,1743026653,1743026661,1743026661.931437,-18000,,
com.google.Chrome,1,1743026652,1743026653,1743026653.555637,-18000,,
com.apple.Terminal,15,1743026637,1743026652,1743026652.645359,-18000,,
com.google.Chrome,67,1743026570,1743026637,1743026637.119594,-18000,,
com.apple.Terminal,91,1743026479,1743026570,1743026570.580081,-18000,,
com.google.Chrome,102,1743026377,1743026479,1743026479.458915,-18000,,
com.apple.Terminal,418,1743025959,1743026377,1743026377.534271,-18000,,
com.microsoft.VSCode,27,1743025932,1743025959,1743025959.134073,-18000,,
com.apple.Terminal,38,1743025894,1743025932,1743025932.19965,-18000,,
com.apple.finder,19,1743025875,1743025894,1743025894.254129,-18000,,
com.google.Chrome,16,1743025859,1743025875,1743025876.058176,-18000,,
com.apple.finder,157,1743025702,1743025859,1743025861.112572,-18000,,
com.google.chrome.ios,115,1743024186,1743024301,1743024302.095247,-18000,EB445137-D7F5-57EC-87DA-1DB460D64046,"iPhone13,2"
com.apple.MobileSMS,2,1743023775,1743023777,1743023777.783986,-18000,EB445137-D7F5-57EC-87DA-1DB460D64046,"iPhone13,2"
com.apple.finder,306,1743023744,1743024050,1743024050.303464,-18000,,
com.google.Chrome,29,1743023715,1743023744,1743023745.0092049,-18000,,
com.apple.MobileSMS,6,1743023708,1743023714,1743023714.349362,-18000,EB445137-D7F5-57EC-87DA-1DB460D64046,"iPhone13,2"
com.apple.MobileSMS,28,1743023687,1743023715,1743023715.1589708,-18000,,
com.google.Chrome,42,1743023645,1743023687,1743023687.542513,-18000,,
com.apple.MobileSMS,4,1743023641,1743023645,1743023645.377907,-18000,,
com.google.Chrome,2,1743023639,1743023641,1743023641.649465,-18000,,
com.apple.MobileSMS,3,1743023636,1743023639,1743023639.47639,-18000,,
com.apple.Terminal,100,1743023536,1743023636,1743023636.651825,-18000,,
com.apple.Notes,31,1743023505,1743023536,1743023536.857724,-18000,,
com.apple.MobileSMS,9,1743023496,1743023505,1743023505.531254,-18000,,
com.apple.Notes,114,1743023382,1743023496,1743023496.105726,-18000,,
com.apple.iCal,88,1743023294,1743023382,1743023382.9528198,-18000,,
com.apple.Notes,4,1743023290,1743023294,1743023294.411625,-18000,,
com.apple.Notes,304,1743022837,1743023141,1743023142.010541,-18000,,
com.apple.MobileSMS,4,1743022799,1743022803,1743022803.656671,-18000,EB445137-D7F5-57EC-87DA-1DB460D64046,"iPhone13,2"
com.apple.Terminal,44,1743022793,1743022837,1743022837.697743,-18000,,
com.apple.Notes,37,1743022756,1743022793,1743022793.2827,-18000,,
com.apple.Terminal,11,1743022745,1743022756,1743022756.2351499,-18000,,
com.apple.finder,2,1743022743,1743022745,1743022745.0987082,-18000,,
com.apple.Terminal,7,1743022736,1743022743,1743022743.28549,-18000,,
com.apple.finder,2,1743022734,1743022736,1743022736.866231,-18000,,
com.google.Chrome,3,1743022731,1743022734,1743022736.317405,-18000,,
com.leomehlig.today,22,1743022709,1743022731,1743022731.2669768,-18000,,
com.google.Chrome,17,1743022692,1743022709,1743022710.025785,-18000,,
com.microsoft.Outlook,4,1743022688,1743022692,1743022692.113344,-18000,,
com.google.Chrome,1,1743022687,1743022688,1743022689.0806332,-18000,,
com.apple.finder,18,1743022669,1743022687,1743022688.892592,-18000,,
com.apple.Terminal,91,1743022578,1743022669,1743022669.722032,-18000,,
com.apple.finder,18,1743022560,1743022578,1743022578.07798,-18000,,
com.apple.Notes,3,1743022557,1743022560,1743022560.80275,-18000,,
com.apple.finder,2,1743022555,1743022557,1743022557.1014361,-18000,,
com.google.Chrome,51,1743022504,1743022555,1743022555.65232,-18000,,
com.apple.Terminal,5,1743022499,1743022504,1743022504.747257,-18000,,
com.google.Chrome,28,1743022471,1743022499,1743022499.701803,-18000,,
com.apple.Terminal,3,1743022468,1743022471,1743022472.0311332,-18000,,
com.google.Chrome,3,1743022465,1743022468,1743022468.590287,-18000,,
com.apple.Terminal,177,1743022288,1743022465,1743022465.677568,-18000,,
com.microsoft.VSCode,9,1743022279,1743022288,1743022288.103654,-18000,,
com.apple.Terminal,9,1743022264,1743022273,1743022273.608039,-18000,,
com.apple.finder,26,1743022238,1743022264,1743022264.707639,-18000,,
com.apple.Terminal,54,1743022184,1743022238,1743022238.898273,-18000,,
com.cisco.secureclient.gui,41,1743022143,1743022184,1743022184.5466042,-18000,,
com.apple.Terminal,1,1743022142,1743022143,1743022143.3670712,-18000,,
com.microsoft.VSCode,4,1743022138,1743022142,1743022142.099951,-18000,,
com.apple.Notes,186,1743021952,1743022138,1743022138.631382,-18000,,
com.microsoft.VSCode,4,1743021948,1743021952,1743021952.363055,-18000,,
com.apple.news,99,1743021656,1743021755,1743021756.052576,-18000,EB445137-D7F5-57EC-87DA-1DB460D64046,"iPhone13,2"
com.apple.mobilenotes,72,1743021566,1743021638,1743021638.100354,-18000,EB445137-D7F5-57EC-87DA-1DB460D64046,"iPhone13,2"
com.hammerandchisel.discord,8,1743021556,1743021564,1743021564.093594,-18000,EB445137-D7F5-57EC-87DA-1DB460D64046,"iPhone13,2"
com.google.chrome.ios,38,1743021518,1743021556,1743021556.25983,-18000,EB445137-D7F5-57EC-87DA-1DB460D64046,"iPhone13,2"
com.microsoft.Office.Outlook,13,1743021505,1743021518,1743021518.298266,-18000,EB445137-D7F5-57EC-87DA-1DB460D64046,"iPhone13,2"
com.apple.Music,0,1743021505,1743021505,1743021506.084173,-18000,EB445137-D7F5-57EC-87DA-1DB460D64046,"iPhone13,2"
com.apple.Music,9,1743020332,1743020341,1743020341.682771,-18000,EB445137-D7F5-57EC-87DA-1DB460D64046,"iPhone13,2"
com.microsoft.VSCode,211,1743020004,1743020215,1743020215.583974,-18000,,
com.microsoft.VSCode,316,1743019370,1743019686,1743019686.724757,-18000,,
com.apple.finder,6,1743019364,1743019370,1743019370.910686,-18000,,
com.google.Chrome,2,1743019362,1743019364,1743019364.566749,-18000,,
com.apple.news,72,1743014296,1743014368,1743014368.2948442,-18000,EB445137-D7F5-57EC-87DA-1DB460D64046,"iPhone13,2"
com.microsoft.Office.Outlook,8,1743014266,1743014274,1743014274.959447,-18000,EB445137-D7F5-57EC-87DA-1DB460D64046,"iPhone13,2"
com.apple.news,1,1743014265,1743014266,1743014266.720741,-18000,EB445137-D7F5-57EC-87DA-1DB460D64046,"iPhone13,2"
com.apple.news,62,1743012736,1743012798,1743012798.37937,-18000,EB445137-D7F5-57EC-87DA-1DB460D64046,"iPhone13,2"
com.microsoft.Office.Outlook,9,1743012721,1743012730,1743012730.4642901,-18000,EB445137-D7F5-57EC-87DA-1DB460D64046,"iPhone13,2"
com.microsoft.Office.Outlook,4,1743012717,1743012721,1743012721.463879,-18000,EB445137-D7F5-57EC-87DA-1DB460D64046,"iPhone13,2"
com.hammerandchisel.discord,13,1743012703,1743012716,1743012716.22325,-18000,EB445137-D7F5-57EC-87DA-1DB460D64046,"iPhone13,2"
com.apple.mobilecal,20,1743012060,1743012080,1743012080.367498,-18000,EB445137-D7F5-57EC-87DA-1DB460D64046,"iPhone13,2"
com.apple.MobileSMS,5,1743011938,1743011943,1743011943.936641,-18000,EB445137-D7F5-57EC-87DA-1DB460D64046,"iPhone13,2"
com.apple.MobileSMS,12,1743011887,1743011899,1743011899.775298,-18000,EB445137-D7F5-57EC-87DA-1DB460D64046,"iPhone13,2"
com.instructure.icanvas,22,1743011859,1743011881,1743011881.489478,-18000,EB445137-D7F5-57EC-87DA-1DB460D64046,"iPhone13,2"
com.google.chrome.ios,0,1743011859,1743011859,1743011860.53878,-18000,EB445137-D7F5-57EC-87DA-1DB460D64046,"iPhone13,2"
com.google.chrome.ios,136,1743011599,1743011735,1743011736.5870261,-18000,EB445137-D7F5-57EC-87DA-1DB460D64046,"iPhone13,2"
com.google.chrome.ios,204,1743011338,1743011542,1743011542.370071,-18000,EB445137-D7F5-57EC-87DA-1DB460D64046,"iPhone13,2"
com.apple.news,119,1743011214,1743011333,1743011333.295532,-18000,EB445137-D7F5-57EC-87DA-1DB460D64046,"iPhone13,2"
com.microsoft.Office.Outlook,3,1743011206,1743011209,1743011209.353335,-18000,EB445137-D7F5-57EC-87DA-1DB460D64046,"iPhone13,2"
com.apple.MobileSMS,35,1743011169,1743011204,1743011204.222461,-18000,EB445137-D7F5-57EC-87DA-1DB460D64046,"iPhone13,2"
com.microsoft.Office.Outlook,7,1743011140,1743011147,1743011147.1731439,-18000,EB445137-D7F5-57EC-87DA-1DB460D64046,"iPhone13,2"
com.hammerandchisel.discord,24,1743011112,1743011136,1743011137.0003471,-18000,EB445137-D7F5-57EC-87DA-1DB460D64046,"iPhone13,2"
com.google.chrome.ios,2,1743009114,1743009116,1743009116.5029402,-18000,EB445137-D7F5-57EC-87DA-1DB460D64046,"iPhone13,2"
com.microsoft.Office.Outlook,6,1743006474,1743006480,1743006480.326861,-18000,EB445137-D7F5-57EC-87DA-1DB460D64046,"iPhone13,2"
com.apple.news,70,1743005040,1743005110,1743005111.038017,-18000,EB445137-D7F5-57EC-87DA-1DB460D64046,"iPhone13,2"
com.apple.news,268,1743004596,1743004864,1743004865.8938441,-18000,EB445137-D7F5-57EC-87DA-1DB460D64046,"iPhone13,2"
com.google.chrome.ios,77,1743004510,1743004587,1743004587.748169,-18000,EB445137-D7F5-57EC-87DA-1DB460D64046,"iPhone13,2"
com.google.Chrome,20,1743004143,1743004163,1743004164.030748,-18000,,
com.microsoft.VSCode,22,1743004121,1743004143,1743004144.355367,-18000,,
com.google.Chrome,58,1743004063,1743004121,1743004121.339961,-18000,,
com.microsoft.VSCode,41,1743004022,1743004063,1743004063.748174,-18000,,
com.google.Chrome,69,1743003953,1743004022,1743004022.778542,-18000,,
com.microsoft.VSCode,100,1743003777,1743003877,1743003878.92634,-18000,,
com.apple.finder,2,1743003775,1743003777,1743003778.290518,-18000,,
com.tinyspeck.chatlyio,3,1743003759,1743003762,1743003762.162847,-18000,EB445137-D7F5-57EC-87DA-1DB460D64046,"iPhone13,2"
co.hinge.mobile.ios,11,1743003744,1743003755,1743003755.623526,-18000,EB445137-D7F5-57EC-87DA-1DB460D64046,"iPhone13,2"
com.microsoft.Office.Outlook,0,1743003744,1743003744,1743003744.9134789,-18000,EB445137-D7F5-57EC-87DA-1DB460D64046,"iPhone13,2"
com.apple.finder,1,1743002755,1743002756,1743002756.781816,-18000,,
com.apple.Terminal,81,1743002674,1743002755,1743002755.657394,-18000,,
com.apple.finder,1,1743002673,1743002674,1743002675.224817,-18000,,
com.microsoft.Office.Outlook,11,1743001866,1743001877,1743001877.814342,-18000,EB445137-D7F5-57EC-87DA-1DB460D64046,"iPhone13,2"
com.tinyspeck.chatlyio,34,1743001831,1743001865,1743001865.160466,-18000,EB445137-D7F5-57EC-87DA-1DB460D64046,"iPhone13,2"
com.tinyspeck.chatlyio,6,1743001814,1743001820,1743001820.304476,-18000,EB445137-D7F5-57EC-87DA-1DB460D64046,"iPhone13,2"
com.tinyspeck.chatlyio,11,1743000003,1743000014,1743000014.5510921,-18000,EB445137-D7F5-57EC-87DA-1DB460D64046,"iPhone13,2"
com.tinyspeck.chatlyio,95,1742999871,1742999966,1742999966.682421,-18000,EB445137-D7F5-57EC-87DA-1DB460D64046,"iPhone13,2"
com.apple.news,270,1742999540,1742999810,1742999810.192477,-18000,EB445137-D7F5-57EC-87DA-1DB460D64046,"iPhone13,2"
com.apple.news,72,1742999453,1742999525,1742999526.195033,-18000,EB445137-D7F5-57EC-87DA-1DB460D64046,"iPhone13,2"
com.apple.finder,1,1742999438,1742999439,1742999439.71576,-18000,,
com.leomehlig.today,2,1742999436,1742999438,1742999438.408125,-18000,,
com.google.Chrome,57,1742999379,1742999436,1742999436.5724149,-18000,,
com.leomehlig.today,22,1742999357,1742999379,1742999379.2899399,-18000,,
com.google.Chrome,25,1742999332,1742999357,1742999357.453932,-18000,,
com.apple.weather,3,1742999329,1742999332,1742999332.5734282,-18000,,
com.google.Chrome,507,1742998822,1742999329,1742999329.747394,-18000,,
com.leomehlig.today,12,1742998810,1742998822,1742998822.903119,-18000,,
com.apple.iCal,6,1742998804,1742998810,1742998810.251056,-18000,,
com.google.Chrome,363,1742998441,1742998804,1742998804.526361,-18000,,
com.apple.news,99,1742998256,1742998355,1742998355.5198588,-18000,EB445137-D7F5-57EC-87DA-1DB460D64046,"iPhone13,2"
com.apple.MobileSMS,25,1742998215,1742998240,1742998240.5819669,-18000,EB445137-D7F5-57EC-87DA-1DB460D64046,"iPhone13,2"
com.apple.finder,2,1742998127,1742998129,1742998129.460019,-18000,,
com.google.Chrome,21,1742998106,1742998127,1742998128.015532,-18000,,
com.apple.MobileSMS,61,1742998086,1742998147,1742998147.9655051,-18000,EB445137-D7F5-57EC-87DA-1DB460D64046,"iPhone13,2"
co.hinge.mobile.ios,103,1742997983,1742998086,1742998086.756269,-18000,EB445137-D7F5-57EC-87DA-1DB460D64046,"iPhone13,2"
com.apple.MobileSMS,8,1742997975,1742997983,1742997983.3375921,-18000,EB445137-D7F5-57EC-87DA-1DB460D64046,"iPhone13,2"
co.hinge.mobile.ios,108,1742997867,1742997975,1742997975.804984,-18000,EB445137-D7F5-57EC-87DA-1DB460D64046,"iPhone13,2"
com.renpho.health,1,1742997866,1742997867,1742997867.650988,-18000,EB445137-D7F5-57EC-87DA-1DB460D64046,"iPhone13,2"
com.renpho.health,38,1742995940,1742995978,1742995978.5480242,-18000,EB445137-D7F5-57EC-87DA-1DB460D64046,"iPhone13,2"
com.instructure.icanvas,14,1742995133,1742995147,1742995147.2204719,-18000,EB445137-D7F5-57EC-87DA-1DB460D64046,"iPhone13,2"
com.microsoft.Office.Outlook,5,1742995123,1742995128,1742995128.140091,-18000,EB445137-D7F5-57EC-87DA-1DB460D64046,"iPhone13,2"
com.microsoft.Office.Outlook,15,1742995105,1742995120,1742995120.181072,-18000,EB445137-D7F5-57EC-87DA-1DB460D64046,"iPhone13,2"
com.microsoft.Office.Outlook,2,1742995098,1742995100,1742995100.4602962,-18000,EB445137-D7F5-57EC-87DA-1DB460D64046,"iPhone13,2"
com.apple.Health,21,1742961987,1742962008,1742962008.870977,-18000,EB445137-D7F5-57EC-87DA-1DB460D64046,"iPhone13,2"
com.apple.journal,12,1742961972,1742961984,1742961984.808343,-18000,EB445137-D7F5-57EC-87DA-1DB460D64046,"iPhone13,2"
com.apple.journal,346,1742961624,1742961970,1742961970.849853,-18000,EB445137-D7F5-57EC-87DA-1DB460D64046,"iPhone13,2"
com.apple.CoreAuthUI,2,1742960976,1742960978,1742960978.226959,-18000,EB445137-D7F5-57EC-87DA-1DB460D64046,"iPhone13,2"
com.apple.journal,651,1742960973,1742961624,1742961624.362986,-18000,EB445137-D7F5-57EC-87DA-1DB460D64046,"iPhone13,2"
com.thestorygraph.thestorygraph,0,1742960973,1742960973,1742960975.011392,-18000,EB445137-D7F5-57EC-87DA-1DB460D64046,"iPhone13,2"
com.thestorygraph.thestorygraph,34,1742960800,1742960834,1742960834.517086,-18000,EB445137-D7F5-57EC-87DA-1DB460D64046,"iPhone13,2"
com.apple.PosterBoard,2,1742960798,1742960800,1742960800.9131641,-18000,EB445137-D7F5-57EC-87DA-1DB460D64046,"iPhone13,2"
com.google.Chrome,711,1742956783,1742957494,1742957494.750788,-18000,,
com.apple.finder,3,1742956780,1742956783,1742956783.976228,-18000,,
co.hinge.mobile.ios,175,1742956478,1742956653,1742956653.453444,-18000,EB445137-D7F5-57EC-87DA-1DB460D64046,"iPhone13,2"
com.google.chrome.ios,15,1742956463,1742956478,1742956479.0430279,-18000,EB445137-D7F5-57EC-87DA-1DB460D64046,"iPhone13,2"
co.hinge.mobile.ios,469,1742955994,1742956463,1742956463.415923,-18000,EB445137-D7F5-57EC-87DA-1DB460D64046,"iPhone13,2"
co.hinge.mobile.ios,17,1742955966,1742955983,1742955983.8840718,-18000,EB445137-D7F5-57EC-87DA-1DB460D64046,"iPhone13,2"
com.apple.news,80,1742955127,1742955207,1742955207.484819,-18000,EB445137-D7F5-57EC-87DA-1DB460D64046,"iPhone13,2"
com.apple.Music,2,1742955114,1742955116,1742955116.708507,-18000,EB445137-D7F5-57EC-87DA-1DB460D64046,"iPhone13,2"
com.apple.Music,12,1742953267,1742953279,1742953280.764501,-18000,EB445137-D7F5-57EC-87DA-1DB460D64046,"iPhone13,2"
com.apple.finder,5,1742952969,1742952974,1742952974.206616,-18000,,
com.leomehlig.today,143,1742952826,1742952969,1742952969.508669,-18000,,
com.google.Chrome,313,1742952513,1742952826,1742952826.8404942,-18000,,
co.hinge.mobile.ios,531,1742952243,1742952774,1742952774.86449,-18000,EB445137-D7F5-57EC-87DA-1DB460D64046,"iPhone13,2"
com.apple.finder,311,1742952202,1742952513,1742952513.668285,-18000,,
com.apple.CoreAuthUI,2,1742952054,1742952056,1742952056.970998,-18000,EB445137-D7F5-57EC-87DA-1DB460D64046,"iPhone13,2"
com.robinhood.release.Robinhood,137,1742952052,1742952189,1742952190.0144238,-18000,EB445137-D7F5-57EC-87DA-1DB460D64046,"iPhone13,2"
com.ally.MobileBanking,1,1742952047,1742952048,1742952048.366601,-18000,EB445137-D7F5-57EC-87DA-1DB460D64046,"iPhone13,2"
com.google.Chrome,217,1742951985,1742952202,1742952202.392354,-18000,,
com.apple.finder,1,1742951972,1742951973,1742951974.46869,-18000,,
com.microsoft.VSCode,234,1742951738,1742951972,1742951972.900535,-18000,,
com.apple.finder,5,1742951733,1742951738,1742951738.9101648,-18000,,
com.microsoft.VSCode,5,1742951728,1742951733,1742951733.877932,-18000,,
com.google.Chrome,7,1742951721,1742951728,1742951728.544358,-18000,,
com.microsoft.VSCode,2,1742951719,1742951721,1742951721.0582042,-18000,,
com.google.Chrome,2,1742951717,1742951719,1742951719.4097738,-18000,,
com.apple.CoreAuthUI,2,1742951555,1742951557,1742951557.76756,-18000,EB445137-D7F5-57EC-87DA-1DB460D64046,"iPhone13,2"
com.ally.MobileBanking,172,1742951544,1742951716,1742951716.888421,-18000,EB445137-D7F5-57EC-87DA-1DB460D64046,"iPhone13,2"
com.apple.Notes,241,1742951476,1742951717,1742951717.727048,-18000,,
com.truebill.truebillnative,119,1742951423,1742951542,1742951542.3501701,-18000,EB445137-D7F5-57EC-87DA-1DB460D64046,"iPhone13,2"
com.apple.calculator,119,1742951357,1742951476,1742951476.351303,-18000,,
com.apple.CoreAuthUI,2,1742951201,1742951203,1742951203.953098,-18000,EB445137-D7F5-57EC-87DA-1DB460D64046,"iPhone13,2"
com.truebill.truebillnative,173,1742951197,1742951370,1742951371.096992,-18000,EB445137-D7F5-57EC-87DA-1DB460D64046,"iPhone13,2"
com.apple.news,2,1742951191,1742951193,1742951193.551511,-18000,EB445137-D7F5-57EC-87DA-1DB460D64046,"iPhone13,2"
com.apple.Notes,209,1742951148,1742951357,1742951357.8228831,-18000,,
com.google.Chrome,20,1742951128,1742951148,1742951148.539753,-18000,,
com.microsoft.VSCode,3,1742951125,1742951128,1742951128.3335218,-18000,,
com.apple.finder,43,1742951082,1742951125,1742951125.2850928,-18000,,
com.microsoft.VSCode,28,1742951054,1742951082,1742951082.379438,-18000,,
com.apple.finder,129,1742950925,1742951054,1742951054.1704412,-18000,,
com.microsoft.VSCode,31,1742950894,1742950925,1742950925.5905051,-18000,,
com.apple.finder,17,1742950877,1742950894,1742950894.68896,-18000,,
com.microsoft.VSCode,2,1742950875,1742950877,1742950877.439965,-18000,,
com.apple.finder,6,1742950869,1742950875,1742950876.018775,-18000,,
com.apple.Preview,69,1742950800,1742950869,1742950869.1533508,-18000,,
com.apple.finder,5,1742950795,1742950800,1742950800.995233,-18000,,
com.microsoft.VSCode,193,1742950602,1742950795,1742950795.218286,-18000,,
com.apple.Dictionary,1,1742950601,1742950602,1742950602.80544,-18000,,
com.microsoft.VSCode,476,1742950125,1742950601,1742950601.836741,-18000,,
com.apple.finder,10,1742950115,1742950125,1742950125.510026,-18000,,
com.microsoft.VSCode,188,1742949927,1742950115,1742950115.523993,-18000,,
com.apple.finder,3,1742949924,1742949927,1742949927.196902,-18000,,
com.leomehlig.today,31,1742949893,1742949924,1742949924.779927,-18000,,
com.google.Chrome,413,1742949480,1742949893,1742949894.040709,-18000,,
com.microsoft.Outlook,76,1742949404,1742949480,1742949480.378365,-18000,,
com.google.Chrome,52,1742949352,1742949404,1742949404.5575972,-18000,,
com.google.Chrome,342,1742948979,1742949321,1742949321.0562382,-18000,,
com.leomehlig.today,78,1742948892,1742948970,1742948970.290248,-18000,,
com.google.Chrome,116,1742948776,1742948892,1742948892.295353,-18000,,
com.apple.finder,7,1742948751,1742948758,1742948758.229562,-18000,,
com.leomehlig.today,6,1742948745,1742948751,1742948751.110338,-18000,,
com.google.Chrome,358,1742948387,1742948745,1742948745.509962,-18000,,
com.leomehlig.today,15,1742948372,1742948387,1742948387.3047938,-18000,,
com.google.Chrome,5,1742948367,1742948372,1742948372.266824,-18000,,
com.google.Chrome,487,1742947427,1742947914,1742947914.583305,-18000,,
com.apple.MobileSMS,8,1742947419,1742947427,1742947427.081307,-18000,,
com.google.Chrome,305,1742947114,1742947419,1742947419.3701549,-18000,,
com.google.Chrome,311,1742946743,1742947054,1742947054.0884252,-18000,,
com.google.Chrome,319,1742946299,1742946618,1742946618.533761,-18000,,
com.apple.MobileSMS,40,1742946259,1742946299,1742946299.3963141,-18000,,
com.google.Chrome,276,1742945983,1742946259,1742946259.448402,-18000,,
com.leomehlig.today,17,1742945602,1742945619,1742945619.342299,-18000,,
com.apple.finder,0,1742945602,1742945602,1742945602.920683,-18000,,
com.apple.Preview,3,1742945599,1742945602,1742945602.185422,-18000,,
com.google.Chrome,1116,1742944483,1742945599,1742945599.045378,-18000,,
com.apple.news,312,1742944081,1742944393,1742944393.9078488,-18000,EB445137-D7F5-57EC-87DA-1DB460D64046,"iPhone13,2"
com.apple.CoreAuthUI,2,1742944029,1742944031,1742944031.287128,-18000,EB445137-D7F5-57EC-87DA-1DB460D64046,"iPhone13,2"
com.clairmail.fth.client,21,1742944026,1742944047,1742944047.598072,-18000,EB445137-D7F5-57EC-87DA-1DB460D64046,"iPhone13,2"
Astrospheric.Astrospheric,2,1742944021,1742944023,1742944023.526161,-18000,EB445137-D7F5-57EC-87DA-1DB460D64046,"iPhone13,2"
com.google.Chrome,915,1742943058,1742943973,1742943973.1729012,-18000,,
Astrospheric.Astrospheric,28,1742941650,1742941678,1742941678.525939,-18000,EB445137-D7F5-57EC-87DA-1DB460D64046,"iPhone13,2"
com.apple.Music,1,1742941641,1742941642,1742941642.766422,-18000,EB445137-D7F5-57EC-87DA-1DB460D64046,"iPhone13,2"
com.apple.Music,6,1742941611,1742941617,1742941617.647124,-18000,EB445137-D7F5-57EC-87DA-1DB460D64046,"iPhone13,2"
com.apple.Music,2,1742940428,1742940430,1742940430.189991,-18000,EB445137-D7F5-57EC-87DA-1DB460D64046,"iPhone13,2"
com.apple.Music,13,1742939690,1742939703,1742939705.993762,-18000,EB445137-D7F5-57EC-87DA-1DB460D64046,"iPhone13,2"
com.google.Chrome,433,1742939012,1742939445,1742939445.484604,-18000,,
com.google.Chrome,574,1742938263,1742938837,1742938837.1634688,-18000,,
co.hinge.mobile.ios,25,1742937258,1742937283,1742937283.3293018,-18000,EB445137-D7F5-57EC-87DA-1DB460D64046,"iPhone13,2"
com.apple.news,1,1742937254,1742937255,1742937255.4516249,-18000,EB445137-D7F5-57EC-87DA-1DB460D64046,"iPhone13,2"
com.apple.news,19,1742935812,1742935831,1742935831.4645271,-18000,EB445137-D7F5-57EC-87DA-1DB460D64046,"iPhone13,2"
com.instructure.icanvas,9,1742935790,1742935799,1742935799.0372062,-18000,EB445137-D7F5-57EC-87DA-1DB460D64046,"iPhone13,2"
com.microsoft.Office.Outlook,7,1742935783,1742935790,1742935790.550877,-18000,EB445137-D7F5-57EC-87DA-1DB460D64046,"iPhone13,2"
com.apple.CoreAuthUI,2,1742935768,1742935770,1742935770.158148,-18000,EB445137-D7F5-57EC-87DA-1DB460D64046,"iPhone13,2"
com.clairmail.fth.client,15,1742935766,1742935781,1742935781.2376351,-18000,EB445137-D7F5-57EC-87DA-1DB460D64046,"iPhone13,2"
com.google.Chrome,187,1742934375,1742934562,1742934562.3868032,-18000,,
com.google.Chrome,434,1742932320,1742932754,1742932754.303901,-18000,,
com.apple.Preview,5,1742932315,1742932320,1742932320.197655,-18000,,
com.apple.CoreAuthUI,4,1742931065,1742931069,1742931069.658514,-18000,EB445137-D7F5-57EC-87DA-1DB460D64046,"iPhone13,2"
com.clairmail.fth.client,18,1742931062,1742931080,1742931081.265749,-18000,EB445137-D7F5-57EC-87DA-1DB460D64046,"iPhone13,2"
com.apple.MobileSMS,14,1742931035,1742931049,1742931049.207909,-18000,EB445137-D7F5-57EC-87DA-1DB460D64046,"iPhone13,2"
com.apple.Music,1,1742931034,1742931035,1742931035.67596,-18000,EB445137-D7F5-57EC-87DA-1DB460D64046,"iPhone13,2"
com.apple.Preview,199,1742929690,1742929889,1742929889.867861,-18000,,
com.google.Chrome,3,1742929687,1742929690,1742929690.66605,-18000,,
com.apple.Preview,153,1742929534,1742929687,1742929687.759172,-18000,,
com.google.Chrome,99,1742929435,1742929534,1742929534.1807609,-18000,,
com.apple.Preview,16,1742929419,1742929435,1742929435.566571,-18000,,
com.google.Chrome,50,1742929369,1742929419,1742929419.540535,-18000,,
com.apple.Preview,1,1742929368,1742929369,1742929369.523871,-18000,,
com.google.Chrome,5,1742929363,1742929368,1742929368.695251,-18000,,
com.apple.Preview,2,1742929361,1742929363,1742929363.556658,-18000,,
com.google.Chrome,5,1742929356,1742929361,1742929361.5762591,-18000,,
com.apple.Preview,1,1742929355,1742929356,1742929356.777498,-18000,,
com.google.Chrome,6,1742929349,1742929355,1742929355.2377992,-18000,,
com.apple.Preview,1,1742929348,1742929349,1742929349.899643,-18000,,
com.google.Chrome,3,1742929345,1742929348,1742929348.86512,-18000,,
com.apple.Preview,1,1742929344,1742929345,1742929345.605606,-18000,,
com.google.Chrome,2,1742929342,1742929344,1742929344.426718,-18000,,
com.apple.Preview,1,1742929341,1742929342,1742929343.052201,-18000,,
com.google.Chrome,2,1742929339,1742929341,1742929341.880348,-18000,,
com.apple.Preview,1,1742929338,1742929339,1742929339.528481,-18000,,
com.google.Chrome,3,1742929335,1742929338,1742929338.290851,-18000,,
com.apple.Preview,2,1742929333,1742929335,1742929336.249697,-18000,,
com.google.Chrome,10,1742929323,1742929333,1742929333.0772018,-18000,,
com.apple.Preview,46,1742929277,1742929323,1742929323.108793,-18000,,
com.apple.finder,7,1742929270,1742929277,1742929277.957512,-18000,,
com.google.Chrome,3,1742929267,1742929270,1742929270.576517,-18000,,
com.apple.Music,9,1742928142,1742928151,1742928153.184099,-18000,EB445137-D7F5-57EC-87DA-1DB460D64046,"iPhone13,2"
com.instructure.icanvas,1,1742928141,1742928142,1742928142.424368,-18000,EB445137-D7F5-57EC-87DA-1DB460D64046,"iPhone13,2"
com.google.Chrome,159,1742927891,1742928050,1742928050.382864,-18000,,
com.apple.Preview,5,1742927886,1742927891,1742927891.1017919,-18000,,
com.instructure.icanvas,11,1742927873,1742927884,1742927884.74214,-18000,EB445137-D7F5-57EC-87DA-1DB460D64046,"iPhone13,2"
com.leomehlig.today,48,1742927838,1742927886,1742927886.529772,-18000,,
com.instructure.icanvas,55,1742927811,1742927866,1742927866.8175569,-18000,EB445137-D7F5-57EC-87DA-1DB460D64046,"iPhone13,2"
com.apple.Preview,359,1742927479,1742927838,1742927838.1972861,-18000,,
com.apple.finder,15,1742927464,1742927479,1742927479.1297212,-18000,,
com.google.Chrome,442,1742927022,1742927464,1742927464.64029,-18000,,
com.apple.iCal,8,1742927014,1742927022,1742927022.770817,-18000,,
com.apple.finder,38,1742926976,1742927014,1742927014.914782,-18000,,
com.google.Chrome,935,1742926041,1742926976,1742926976.0796928,-18000,,
com.microsoft.Office.Outlook,6,1742925960,1742925966,1742925967.017076,-18000,EB445137-D7F5-57EC-87DA-1DB460D64046,"iPhone13,2"
com.apple.weather,2,1742925956,1742925958,1742925958.464356,-18000,EB445137-D7F5-57EC-87DA-1DB460D64046,"iPhone13,2"
com.strava.stravaride,13,1742925938,1742925951,1742925951.8704739,-18000,EB445137-D7F5-57EC-87DA-1DB460D64046,"iPhone13,2"
com.apple.mobilephone,59,1742925814,1742925873,1742925873.528872,-18000,EB445137-D7F5-57EC-87DA-1DB460D64046,"iPhone13,2"
com.apple.InCallService,68,1742925746,1742925814,1742925814.9823508,-18000,EB445137-D7F5-57EC-87DA-1DB460D64046,"iPhone13,2"
com.apple.mobilephone,9,1742925737,1742925746,1742925746.6515431,-18000,EB445137-D7F5-57EC-87DA-1DB460D64046,"iPhone13,2"
com.apple.MobileSMS,22,1742925715,1742925737,1742925738.029722,-18000,EB445137-D7F5-57EC-87DA-1DB460D64046,"iPhone13,2"
com.apple.mobilephone,26,1742925689,1742925715,1742925715.814389,-18000,EB445137-D7F5-57EC-87DA-1DB460D64046,"iPhone13,2"
com.apple.weather,6,1742925683,1742925689,1742925689.316231,-18000,EB445137-D7F5-57EC-87DA-1DB460D64046,"iPhone13,2"
com.google.Chrome,360,1742925619,1742925979,1742925979.9381142,-18000,,
com.leomehlig.today,2,1742925617,1742925619,1742925619.6023622,-18000,,
com.apple.weather,61,1742925616,1742925677,1742925677.6033192,-18000,EB445137-D7F5-57EC-87DA-1DB460D64046,"iPhone13,2"
co.hinge.mobile.ios,5,1742924495,1742924500,1742924500.357386,-18000,EB445137-D7F5-57EC-87DA-1DB460D64046,"iPhone13,2"
com.apple.Music,2,1742924490,1742924492,1742924492.3838692,-18000,EB445137-D7F5-57EC-87DA-1DB460D64046,"iPhone13,2"
com.apple.Music,56,1742921157,1742921213,1742921213.438692,-18000,EB445137-D7F5-57EC-87DA-1DB460D64046,"iPhone13,2"
com.apple.weather,2,1742921151,1742921153,1742921153.9167008,-18000,EB445137-D7F5-57EC-87DA-1DB460D64046,"iPhone13,2"
com.apple.weather,1,1742921150,1742921151,1742921151.561348,-18000,EB445137-D7F5-57EC-87DA-1DB460D64046,"iPhone13,2"
com.apple.weather,72,1742920992,1742921064,1742921064.3952022,-18000,EB445137-D7F5-57EC-87DA-1DB460D64046,"iPhone13,2"
com.apple.MobileSMS,6,1742920986,1742920992,1742920992.122764,-18000,EB445137-D7F5-57EC-87DA-1DB460D64046,"iPhone13,2"
com.apple.news,101,1742919389,1742919490,1742919490.3093219,-18000,EB445137-D7F5-57EC-87DA-1DB460D64046,"iPhone13,2"
com.apple.news,26,1742919357,1742919383,1742919383.266501,-18000,EB445137-D7F5-57EC-87DA-1DB460D64046,"iPhone13,2"
com.apple.news,35,1742919313,1742919348,1742919349.0268369,-18000,EB445137-D7F5-57EC-87DA-1DB460D64046,"iPhone13,2"
com.apple.MobileSMS,6,1742919292,1742919298,1742919299.016021,-18000,EB445137-D7F5-57EC-87DA-1DB460D64046,"iPhone13,2"
com.instructure.icanvas,1,1742919291,1742919292,1742919292.304513,-18000,EB445137-D7F5-57EC-87DA-1DB460D64046,"iPhone13,2"
com.instructure.icanvas,18,1742919264,1742919282,1742919282.996726,-18000,EB445137-D7F5-57EC-87DA-1DB460D64046,"iPhone13,2"
com.robinhood.release.Robinhood,0,1742919264,1742919264,1742919264.680402,-18000,EB445137-D7F5-57EC-87DA-1DB460D64046,"iPhone13,2"
com.leomehlig.today,336,1742919210,1742919546,1742919546.3372269,-18000,,
com.google.Chrome,18,1742919192,1742919210,1742919211.1083431,-18000,,
com.apple.finder,1,1742919191,1742919192,1742919192.734254,-18000,,
com.google.Chrome,2,1742919189,1742919191,1742919191.308096,-18000,,
com.microsoft.VSCode,2,1742919187,1742919189,1742919189.478375,-18000,,
com.google.Chrome,1,1742919186,1742919187,1742919187.819675,-18000,,
com.microsoft.VSCode,3,1742919168,1742919171,1742919171.2896729,-18000,,
com.apple.finder,2,1742919166,1742919168,1742919168.844284,-18000,,
com.microsoft.VSCode,70,1742919096,1742919166,1742919166.047972,-18000,,
com.google.Chrome,49,1742919047,1742919096,1742919096.800688,-18000,,
com.apple.keychainaccess,1,1742919046,1742919047,1742919047.91927,-18000,,
com.google.Chrome,19,1742919027,1742919046,1742919046.723713,-18000,,
com.apple.keychainaccess,2,1742919025,1742919027,1742919027.783546,-18000,,
com.apple.CoreAuthUI,2,1742918511,1742918513,1742918513.396527,-18000,EB445137-D7F5-57EC-87DA-1DB460D64046,"iPhone13,2"
com.robinhood.release.Robinhood,130,1742918506,1742918636,1742918636.5381222,-18000,EB445137-D7F5-57EC-87DA-1DB460D64046,"iPhone13,2"
com.doordash.dasher,1,1742918502,1742918503,1742918503.7987552,-18000,EB445137-D7F5-57EC-87DA-1DB460D64046,"iPhone13,2"
com.doordash.dasher,70,1742918133,1742918203,1742918203.8510752,-18000,EB445137-D7F5-57EC-87DA-1DB460D64046,"iPhone13,2"
com.google.Chrome,887,1742918130,1742919017,1742919017.1844149,-18000,,
com.microsoft.VSCode,21,1742918109,1742918130,1742918130.281108,-18000,,
com.google.Chrome,27,1742918082,1742918109,1742918109.922528,-18000,,
com.apple.Photos,2,1742918080,1742918082,1742918082.4332871,-18000,,
com.google.Chrome,2,1742918078,1742918080,1742918080.6043339,-18000,,
com.apple.Photos,46,1742918032,1742918078,1742918078.246091,-18000,,
com.google.Chrome,313,1742917719,1742918032,1742918032.9413671,-18000,,
com.apple.finder,6,1742917713,1742917719,1742917719.2329679,-18000,,
com.apple.CoreAuthUI,2,1742917662,1742917664,1742917665.0171762,-18000,EB445137-D7F5-57EC-87DA-1DB460D64046,"iPhone13,2"
com.doordash.dasher,302,1742917646,1742917948,1742917948.7050629,-18000,EB445137-D7F5-57EC-87DA-1DB460D64046,"iPhone13,2"
com.google.Chrome,126,1742917587,1742917713,1742917713.623477,-18000,,
com.microsoft.VSCode,3,1742917584,1742917587,1742917587.525453,-18000,,
com.google.Chrome,331,1742917253,1742917584,1742917584.7225518,-18000,,
com.microsoft.VSCode,92,1742917123,1742917215,1742917215.545937,-18000,,
com.microsoft.Office.Outlook,7,1742917116,1742917123,1742917123.5550299,-18000,EB445137-D7F5-57EC-87DA-1DB460D64046,"iPhone13,2"
com.apple.Health,18,1742917096,1742917114,1742917115.0024362,-18000,EB445137-D7F5-57EC-87DA-1DB460D64046,"iPhone13,2"
com.apple.Health,86,1742917008,1742917094,1742917094.606597,-18000,EB445137-D7F5-57EC-87DA-1DB460D64046,"iPhone13,2"
com.apple.Health,13,1742916938,1742916951,1742916952.041379,-18000,EB445137-D7F5-57EC-87DA-1DB460D64046,"iPhone13,2"
com.apple.MobileSMS,3,1742916926,1742916929,1742916929.6085,-18000,EB445137-D7F5-57EC-87DA-1DB460D64046,"iPhone13,2"
com.apple.mobileslideshow,100,1742916824,1742916924,1742916924.095182,-18000,EB445137-D7F5-57EC-87DA-1DB460D64046,"iPhone13,2"
com.microsoft.VSCode,1131,1742915987,1742917118,1742917118.738473,-18000,,
com.google.Chrome,189,1742915798,1742915987,1742915987.6275768,-18000,,
com.microsoft.VSCode,38,1742915760,1742915798,1742915798.91151,-18000,,
com.google.Chrome,6,1742915754,1742915760,1742915760.767208,-18000,,
com.microsoft.VSCode,88,1742915666,1742915754,1742915754.73835,-18000,,
com.google.Chrome,17,1742915649,1742915666,1742915666.2601619,-18000,,
com.microsoft.VSCode,32,1742915617,1742915649,1742915650.018637,-18000,,
com.google.Chrome,86,1742915531,1742915617,1742915617.959128,-18000,,
com.microsoft.VSCode,31,1742915500,1742915531,1742915531.934021,-18000,,
com.microsoft.VSCode,433,1742914881,1742915314,1742915314.857475,-18000,,
com.google.Chrome,45,1742914836,1742914881,1742914881.634841,-18000,,
com.microsoft.VSCode,114,1742914722,1742914836,1742914836.715627,-18000,,
com.google.Chrome,7,1742914715,1742914722,1742914722.671968,-18000,,
com.microsoft.VSCode,10,1742914705,1742914715,1742914716.0273108,-18000,,
com.google.Chrome,34,1742914671,1742914705,1742914706.02824,-18000,,
com.microsoft.VSCode,8,1742914663,1742914671,1742914671.6089082,-18000,,
com.google.Chrome,5,1742914658,1742914663,1742914663.3995562,-18000,,
com.microsoft.VSCode,10,1742914648,1742914658,1742914658.25088,-18000,,
com.google.Chrome,4,1742914644,1742914648,1742914648.4371119,-18000,,
com.microsoft.VSCode,4,1742914640,1742914644,1742914644.137543,-18000,,
com.google.Chrome,3,1742914637,1742914640,1742914640.925325,-18000,,
com.microsoft.VSCode,7,1742914630,1742914637,1742914637.771051,-18000,,
com.google.Chrome,19,1742914611,1742914630,1742914630.807876,-18000,,
com.microsoft.VSCode,3,1742914608,1742914611,1742914612.0211139,-18000,,
com.google.Chrome,0,1742914608,1742914608,1742914608.547246,-18000,,
com.microsoft.VSCode,5,1742914603,1742914608,1742914608.131757,-18000,,
com.google.Chrome,2,1742914601,1742914603,1742914603.892161,-18000,,
com.microsoft.VSCode,5,1742914596,1742914601,1742914601.742307,-18000,,
com.google.Chrome,47,1742914549,1742914596,1742914596.326254,-18000,,
com.microsoft.VSCode,3,1742914546,1742914549,1742914549.300776,-18000,,
com.google.Chrome,29,1742914517,1742914546,1742914546.630425,-18000,,
com.microsoft.VSCode,9,1742914508,1742914517,1742914517.304034,-18000,,
com.google.Chrome,31,1742914477,1742914508,1742914508.695475,-18000,,
com.microsoft.VSCode,0,1742914477,1742914477,1742914477.729218,-18000,,
com.google.Chrome,5,1742914472,1742914477,1742914477.360167,-18000,,
com.microsoft.VSCode,82,1742914390,1742914472,1742914472.865792,-18000,,
com.google.Chrome,106,1742914284,1742914390,1742914390.664649,-18000,,
com.microsoft.VSCode,254,1742914030,1742914284,1742914284.680748,-18000,,
com.google.Chrome,16,1742914014,1742914030,1742914030.223359,-18000,,
com.microsoft.VSCode,127,1742913887,1742914014,1742914014.5026731,-18000,,
com.google.Chrome,1,1742913886,1742913887,1742913887.380457,-18000,,
com.microsoft.VSCode,208,1742913678,1742913886,1742913886.7349129,-18000,,
com.google.Chrome,10,1742913668,1742913678,1742913678.2500749,-18000,,
com.microsoft.VSCode,14,1742913654,1742913668,1742913668.092976,-18000,,
com.google.Chrome,197,1742913457,1742913654,1742913654.501902,-18000,,
com.microsoft.VSCode,24,1742913433,1742913457,1742913457.349726,-18000,,
com.google.Chrome,5,1742913428,1742913433,1742913433.3506532,-18000,,
com.microsoft.VSCode,1,1742913427,1742913428,1742913428.902756,-18000,,
com.apple.Passwords,1,1742913426,1742913427,1742913427.444035,-18000,,
com.microsoft.VSCode,15,1742913411,1742913426,1742913426.143279,-18000,,
com.apple.Passwords,1,1742913410,1742913411,1742913411.7706351,-18000,,
com.google.Chrome,296,1742913114,1742913410,1742913410.659525,-18000,,
com.apple.Passwords,5,1742913109,1742913114,1742913114.299086,-18000,,
com.google.Chrome,14,1742913095,1742913109,1742913109.1290479,-18000,,
com.apple.Passwords,4,1742913087,1742913091,1742913091.878982,-18000,,
com.google.Chrome,6,1742913081,1742913087,1742913087.7814012,-18000,,
com.apple.Passwords,13,1742913068,1742913081,1742913081.094271,-18000,,
com.google.Chrome,28,1742913040,1742913068,1742913068.5303202,-18000,,
com.apple.keychainaccess,2,1742913038,1742913040,1742913040.5239859,-18000,,
com.google.Chrome,1,1742913029,1742913030,1742913030.6020222,-18000,,
com.microsoft.VSCode,27,1742912883,1742912910,1742912910.513167,-18000,,
com.apple.finder,3,1742912880,1742912883,1742912883.89587,-18000,,
com.microsoft.VSCode,629,1742912251,1742912880,1742912880.427866,-18000,,
com.apple.finder,20,1742912231,1742912251,1742912251.200558,-18000,,
com.microsoft.VSCode,60,1742912171,1742912231,1742912231.852293,-18000,,
com.google.Chrome,28,1742912143,1742912171,1742912171.259155,-18000,,
com.microsoft.VSCode,223,1742911920,1742912143,1742912143.538179,-18000,,
com.apple.finder,28,1742911892,1742911920,1742911920.845568,-18000,,
com.microsoft.VSCode,727,1742911165,1742911892,1742911892.470773,-18000,,
com.google.Chrome,15,1742911150,1742911165,1742911165.801507,-18000,,
com.apple.finder,1,1742911149,1742911150,1742911150.953387,-18000,,
com.apple.CoreAuthUI,2,1742910980,1742910982,1742910982.399761,-18000,EB445137-D7F5-57EC-87DA-1DB460D64046,"iPhone13,2"
com.clairmail.fth.client,40,1742910975,1742911015,1742911015.764391,-18000,EB445137-D7F5-57EC-87DA-1DB460D64046,"iPhone13,2"
com.apple.CoreAuthUI,2,1742910544,1742910546,1742910546.063896,-18000,EB445137-D7F5-57EC-87DA-1DB460D64046,"iPhone13,2"
com.ancestry.Tree-To-Go,416,1742910540,1742910956,1742910956.321351,-18000,EB445137-D7F5-57EC-87DA-1DB460D64046,"iPhone13,2"
com.ancestry.Tree-To-Go,10,1742910528,1742910538,1742910539.069299,-18000,EB445137-D7F5-57EC-87DA-1DB460D64046,"iPhone13,2"
com.apple.news,156,1742910303,1742910459,1742910459.5011969,-18000,EB445137-D7F5-57EC-87DA-1DB460D64046,"iPhone13,2"
com.apple.news,62,1742910195,1742910257,1742910257.756483,-18000,EB445137-D7F5-57EC-87DA-1DB460D64046,"iPhone13,2"
com.apple.news,4,1742910191,1742910195,1742910195.212082,-18000,EB445137-D7F5-57EC-87DA-1DB460D64046,"iPhone13,2"
co.hinge.mobile.ios,25,1742910149,1742910174,1742910174.837644,-18000,EB445137-D7F5-57EC-87DA-1DB460D64046,"iPhone13,2"
com.microsoft.Office.Outlook,34,1742910108,1742910142,1742910142.09974,-18000,EB445137-D7F5-57EC-87DA-1DB460D64046,"iPhone13,2"
com.apple.weather,0,1742910108,1742910108,1742910108.885798,-18000,EB445137-D7F5-57EC-87DA-1DB460D64046,"iPhone13,2"
com.apple.weather,62,1742909603,1742909665,1742909665.683759,-18000,EB445137-D7F5-57EC-87DA-1DB460D64046,"iPhone13,2"
com.renpho.health,39,1742909564,1742909603,1742909604.2874808,-18000,EB445137-D7F5-57EC-87DA-1DB460D64046,"iPhone13,2"
com.apple.Health,37,1742875574,1742875611,1742875611.6748881,-18000,EB445137-D7F5-57EC-87DA-1DB460D64046,"iPhone13,2"
com.apple.journal,6,1742875568,1742875574,1742875574.066942,-18000,EB445137-D7F5-57EC-87DA-1DB460D64046,"iPhone13,2"
com.apple.journal,593,1742874973,1742875566,1742875566.285358,-18000,EB445137-D7F5-57EC-87DA-1DB460D64046,"iPhone13,2"
com.apple.CoreAuthUI,9,1742874075,1742874084,1742874084.850009,-18000,EB445137-D7F5-57EC-87DA-1DB460D64046,"iPhone13,2"
com.apple.CoreAuthUI,4,1742874069,1742874073,1742874073.662046,-18000,EB445137-D7F5-57EC-87DA-1DB460D64046,"iPhone13,2"
com.apple.journal,904,1742874068,1742874972,1742874972.264162,-18000,EB445137-D7F5-57EC-87DA-1DB460D64046,"iPhone13,2"
com.thestorygraph.thestorygraph,3,1742874062,1742874065,1742874065.589807,-18000,EB445137-D7F5-57EC-87DA-1DB460D64046,"iPhone13,2"
com.thestorygraph.thestorygraph,91,1742873971,1742874062,1742874062.430495,-18000,EB445137-D7F5-57EC-87DA-1DB460D64046,"iPhone13,2"
com.apple.finder,34,1742867429,1742867463,1742867464.261558,-18000,,
com.leomehlig.today,19,1742867410,1742867429,1742867429.5564098,-18000,,
com.google.Chrome,6,1742867404,1742867410,1742867410.8057818,-18000,,
com.apple.Preview,3,1742867401,1742867404,1742867404.2758389,-18000,,
com.microsoft.VSCode,12,1742867389,1742867401,1742867401.969194,-18000,,
com.apple.Preview,1,1742867388,1742867389,1742867389.252305,-18000,,
com.google.Chrome,14,1742867374,1742867388,1742867388.339375,-18000,,
com.apple.Preview,2,1742867372,1742867374,1742867374.9405022,-18000,,
com.microsoft.VSCode,60,1742867312,1742867372,1742867372.573258,-18000,,
com.apple.Preview,23,1742867289,1742867312,1742867312.98061,-18000,,
com.apple.finder,1,1742867288,1742867289,1742867289.53893,-18000,,
com.microsoft.VSCode,312,1742866976,1742867288,1742867288.239119,-18000,,
com.google.Chrome,2,1742866974,1742866976,1742866976.1143332,-18000,,
com.leomehlig.today,19,1742866955,1742866974,1742866975.0147638,-18000,,
com.google.Chrome,2,1742866953,1742866955,1742866955.566558,-18000,,
com.apple.Terminal,5,1742866948,1742866953,1742866953.672035,-18000,,
com.google.Chrome,43,1742866905,1742866948,1742866948.515305,-18000,,
com.apple.iCal,5,1742866900,1742866905,1742866905.1140099,-18000,,
com.google.Chrome,44,1742866856,1742866900,1742866900.692992,-18000,,
com.microsoft.VSCode,3,1742866853,1742866856,1742866856.396591,-18000,,
com.google.Chrome,33,1742866820,1742866853,1742866853.938919,-18000,,
com.leomehlig.today,5,1742866815,1742866820,1742866820.311689,-18000,,
com.google.Chrome,12,1742866803,1742866815,1742866815.661258,-18000,,
com.microsoft.VSCode,94,1742866693,1742866787,1742866787.3164248,-18000,,
com.apple.finder,2,1742866691,1742866693,1742866693.649116,-18000,,
com.microsoft.VSCode,65,1742866626,1742866691,1742866691.537568,-18000,,
com.apple.finder,3,1742866623,1742866626,1742866626.404728,-18000,,
com.microsoft.VSCode,10,1742866613,1742866623,1742866623.423491,-18000,,
com.google.Chrome,37,1742866576,1742866613,1742866613.8659348,-18000,,
com.microsoft.VSCode,10,1742866566,1742866576,1742866576.337642,-18000,,
com.google.Chrome,19,1742866547,1742866566,1742866566.7377238,-18000,,
com.apple.finder,1,1742866546,1742866547,1742866547.844495,-18000,,
com.apple.Preview,1,1742866545,1742866546,1742866546.8559241,-18000,,
com.microsoft.VSCode,22,1742866523,1742866545,1742866545.954311,-18000,,
com.apple.Preview,118,1742866405,1742866523,1742866523.991128,-18000,,
com.apple.finder,1,1742866404,1742866405,1742866405.529665,-18000,,
com.microsoft.VSCode,115,1742866289,1742866404,1742866404.199857,-18000,,
com.apple.finder,2,1742866287,1742866289,1742866289.437134,-18000,,
com.microsoft.VSCode,10,1742866277,1742866287,1742866287.703536,-18000,,
com.google.Chrome,3,1742866274,1742866277,1742866277.958204,-18000,,
com.microsoft.VSCode,179,1742866095,1742866274,1742866274.696413,-18000,,
com.apple.finder,5,1742866090,1742866095,1742866095.96492,-18000,,
com.microsoft.VSCode,132,1742865958,1742866090,1742866090.357524,-18000,,
com.apple.finder,42,1742865916,1742865958,1742865958.228199,-18000,,
com.microsoft.VSCode,88,1742865828,1742865916,1742865916.191163,-18000,,
com.apple.finder,4,1742865824,1742865828,1742865828.379816,-18000,,
com.microsoft.VSCode,59,1742865765,1742865824,1742865824.700453,-18000,,
com.apple.finder,2,1742865763,1742865765,1742865765.124062,-18000,,
com.google.Chrome,23,1742865740,1742865763,1742865764.039211,-18000,,
com.apple.finder,1,1742865739,1742865740,1742865740.422734,-18000,,
com.microsoft.VSCode,48,1742865691,1742865739,1742865739.6006489,-18000,,
com.apple.finder,5,1742865686,1742865691,1742865691.8708758,-18000,,
com.microsoft.VSCode,70,1742865616,1742865686,1742865686.6882482,-18000,,
com.apple.finder,3,1742865613,1742865616,1742865616.546643,-18000,,
com.apple.Preview,4,1742865609,1742865613,1742865613.3309999,-18000,,
com.microsoft.VSCode,71,1742865538,1742865609,1742865609.869574,-18000,,
com.apple.Preview,8,1742865530,1742865538,1742865538.843822,-18000,,
com.apple.finder,18,1742865512,1742865530,1742865530.294057,-18000,,
com.microsoft.VSCode,17,1742865495,1742865512,1742865512.51408,-18000,,
com.google.Chrome,9,1742865486,1742865495,1742865495.270603,-18000,,
com.microsoft.VSCode,636,1742864850,1742865486,1742865486.86465,-18000,,
com.google.Chrome,70,1742864780,1742864850,1742864850.089466,-18000,,
com.microsoft.VSCode,10,1742864770,1742864780,1742864780.5526528,-18000,,
com.apple.Notes,13,1742864757,1742864770,1742864770.6212192,-18000,,
com.apple.finder,68,1742864689,1742864757,1742864757.3307,-18000,,
com.microsoft.VSCode,36,1742864653,1742864689,1742864689.606631,-18000,,
com.google.Chrome,31,1742864622,1742864653,1742864653.99206,-18000,,
com.microsoft.VSCode,25,1742864597,1742864622,1742864622.202712,-18000,,
com.google.Chrome,29,1742864568,1742864597,1742864597.1482658,-18000,,
com.microsoft.VSCode,1,1742864567,1742864568,1742864568.393254,-18000,,
com.google.Chrome,41,1742864526,1742864567,1742864567.258256,-18000,,
com.microsoft.VSCode,87,1742864439,1742864526,1742864526.641698,-18000,,
com.google.Chrome,6,1742864433,1742864439,1742864439.855717,-18000,,
com.microsoft.VSCode,2,1742864431,1742864433,1742864433.85047,-18000,,
com.google.Chrome,15,1742864416,1742864431,1742864431.4121928,-18000,,
com.microsoft.VSCode,61,1742864355,1742864416,1742864416.923973,-18000,,
com.google.Chrome,2,1742864353,1742864355,1742864355.469355,-18000,,
com.apple.finder,1,1742864352,1742864353,1742864353.300895,-18000,,
com.microsoft.VSCode,31,1742864321,1742864352,1742864352.757308,-18000,,
com.apple.finder,4,1742864317,1742864321,1742864321.747011,-18000,,
com.google.Chrome,2,1742864315,1742864317,1742864317.103446,-18000,,
com.apple.finder,4,1742864311,1742864315,1742864315.859312,-18000,,
com.google.Chrome,5,1742864306,1742864311,1742864311.476675,-18000,,
com.apple.finder,11,1742864295,1742864306,1742864306.558257,-18000,,
com.google.Chrome,16,1742864279,1742864295,1742864295.148958,-18000,,
com.apple.finder,16,1742864263,1742864279,1742864279.661901,-18000,,
com.apple.Terminal,1,1742864262,1742864263,1742864263.439903,-18000,,
com.google.Chrome,81,1742864181,1742864262,1742864262.386437,-18000,,
com.apple.Terminal,0,1742864181,1742864181,1742864182.045368,-18000,,
com.apple.finder,5,1742864176,1742864181,1742864181.305805,-18000,,
com.apple.Terminal,1,1742864175,1742864176,1742864176.072688,-18000,,
com.google.Chrome,4,1742864171,1742864175,1742864175.132158,-18000,,
com.apple.Terminal,2,1742864169,1742864171,1742864171.967799,-18000,,
com.google.Chrome,15,1742864154,1742864169,1742864169.326788,-18000,,
com.apple.Terminal,2,1742864152,1742864154,1742864154.341693,-18000,,
com.apple.finder,2,1742864150,1742864152,1742864152.205369,-18000,,
com.apple.Terminal,1,1742864149,1742864150,1742864150.743647,-18000,,
com.google.Chrome,37,1742864112,1742864149,1742864149.5450091,-18000,,
com.apple.Terminal,58,1742864054,1742864112,1742864113.0168428,-18000,,
com.apple.finder,28,1742864026,1742864054,1742864054.889326,-18000,,
com.electron.carta,379,1742863647,1742864026,1742864026.132564,-18000,,
com.apple.finder,6,1742863641,1742863647,1742863647.643218,-18000,,
com.electron.carta,26,1742863615,1742863641,1742863641.054836,-18000,,
com.apple.finder,7,1742863608,1742863615,1742863615.3375611,-18000,,
com.google.Chrome,4,1742863604,1742863608,1742863608.4983869,-18000,,
com.apple.finder,64,1742863540,1742863604,1742863604.439266,-18000,,
com.google.Chrome,19,1742863521,1742863540,1742863540.879077,-18000,,
com.apple.finder,185,1742863336,1742863521,1742863522.186048,-18000,,
com.apple.archiveutility,2,1742863334,1742863336,1742863336.800562,-18000,,
com.apple.finder,9,1742863325,1742863334,1742863334.573876,-18000,,
com.apple.archiveutility,6,1742863319,1742863325,1742863325.379494,-18000,,
com.apple.finder,28,1742863291,1742863319,1742863319.9748611,-18000,,
com.apple.archiveutility,4,1742863287,1742863291,1742863291.109523,-18000,,
com.apple.finder,3,1742863284,1742863287,1742863287.652557,-18000,,
com.apple.archiveutility,9,1742863275,1742863284,1742863284.200351,-18000,,
com.apple.finder,4,1742863271,1742863275,1742863275.829787,-18000,,
com.apple.archiveutility,10,1742863261,1742863271,1742863271.329749,-18000,,
com.apple.finder,5,1742863256,1742863261,1742863261.7803679,-18000,,
com.apple.archiveutility,12,1742863244,1742863256,1742863256.660286,-18000,,
com.apple.finder,1,1742863243,1742863244,1742863244.841768,-18000,,
com.apple.archiveutility,4,1742863239,1742863243,1742863243.864984,-18000,,
com.apple.finder,1,1742863238,1742863239,1742863239.832555,-18000,,
com.apple.archiveutility,2,1742863236,1742863238,1742863238.486466,-18000,,
com.apple.finder,8,1742863228,1742863236,1742863236.4453979,-18000,,
com.apple.archiveutility,8,1742863220,1742863228,1742863228.6432981,-18000,,
com.apple.finder,3,1742863217,1742863220,1742863220.901348,-18000,,
com.apple.archiveutility,7,1742863210,1742863217,1742863217.190253,-18000,,
com.apple.finder,9,1742863201,1742863210,1742863210.654601,-18000,,
com.apple.archiveutility,6,1742863195,1742863201,1742863201.6958308,-18000,,
com.apple.finder,4,1742863191,1742863195,1742863195.376974,-18000,,
com.apple.archiveutility,7,1742863184,1742863191,1742863191.214449,-18000,,
com.apple.finder,3,1742863181,1742863184,1742863184.9359078,-18000,,
com.apple.archiveutility,8,1742863173,1742863181,1742863181.207865,-18000,,
com.apple.finder,4,1742863169,1742863173,1742863173.991498,-18000,,
com.apple.archiveutility,7,1742863162,1742863169,1742863169.638058,-18000,,
com.apple.finder,5,1742863157,1742863162,1742863162.5899382,-18000,,
com.apple.archiveutility,3,1742863154,1742863157,1742863157.24864,-18000,,
com.apple.finder,4,1742863150,1742863154,1742863154.411473,-18000,,
com.apple.archiveutility,7,1742863143,1742863150,1742863150.6103702,-18000,,
com.apple.finder,4,1742863139,1742863143,1742863143.927917,-18000,,
com.apple.archiveutility,7,1742863132,1742863139,1742863139.507956,-18000,,
com.apple.finder,4,1742863128,1742863132,1742863132.281177,-18000,,
com.apple.archiveutility,6,1742863122,1742863128,1742863128.466858,-18000,,
com.apple.finder,8,1742863114,1742863122,1742863122.17934,-18000,,
com.apple.archiveutility,7,1742863107,1742863114,1742863114.763819,-18000,,
com.apple.finder,5,1742863102,1742863107,1742863107.3100982,-18000,,
com.apple.archiveutility,7,1742863095,1742863102,1742863102.982485,-18000,,
com.apple.finder,3,1742863092,1742863095,1742863095.9387999,-18000,,
com.apple.archiveutility,1,1742863091,1742863092,1742863092.378597,-18000,,
com.apple.finder,4,1742863087,1742863091,1742863091.719207,-18000,,
com.apple.archiveutility,1,1742863086,1742863087,1742863087.369343,-18000,,
com.apple.finder,4,1742863082,1742863086,1742863086.646278,-18000,,
com.apple.archiveutility,1,1742863081,1742863082,1742863082.663134,-18000,,
com.apple.finder,5,1742863076,1742863081,1742863081.975575,-18000,,
com.apple.archiveutility,0,1742863076,1742863076,1742863076.830624,-18000,,
com.apple.finder,5,1742863071,1742863076,1742863076.195959,-18000,,
com.apple.archiveutility,1,1742863070,1742863071,1742863071.2692518,-18000,,
com.apple.finder,5,1742863065,1742863070,1742863070.545563,-18000,,
com.apple.archiveutility,1,1742863064,1742863065,1742863065.56252,-18000,,
com.apple.finder,4,1742863060,1742863064,1742863064.912218,-18000,,
com.apple.archiveutility,1,1742863059,1742863060,1742863060.164614,-18000,,
com.apple.finder,6,1742863053,1742863059,1742863059.470489,-18000,,
com.apple.archiveutility,0,1742863053,1742863053,1742863053.955982,-18000,,
com.apple.finder,7,1742863046,1742863053,1742863053.149105,-18000,,
com.apple.archiveutility,0,1742863046,1742863046,1742863046.7901201,-18000,,
com.apple.finder,5,1742863041,1742863046,1742863046.0751739,-18000,,
com.apple.archiveutility,1,1742863040,1742863041,1742863041.673777,-18000,,
com.apple.finder,14,1742863026,1742863040,1742863040.873802,-18000,,
com.apple.archiveutility,1,1742863025,1742863026,1742863026.5368052,-18000,,
com.apple.finder,99,1742862926,1742863025,1742863025.808058,-18000,,
com.microsoft.VSCode,79,1742862847,1742862926,1742862927.190524,-18000,,
com.apple.finder,6,1742862841,1742862847,1742862847.711725,-18000,,
com.google.Chrome,223,1742862618,1742862841,1742862841.558025,-18000,,
com.apple.finder,7,1742862611,1742862618,1742862618.477566,-18000,,
com.google.Chrome,266,1742862345,1742862611,1742862611.7779388,-18000,,
com.apple.finder,2,1742862343,1742862345,1742862346.4412599,-18000,,
com.apple.news,120,1742862223,1742862343,1742862343.59868,-18000,,
com.apple.finder,178,1742862045,1742862223,1742862223.5014648,-18000,,
com.leomehlig.today,118,1742861927,1742862045,1742862046.045485,-18000,,
com.google.Chrome,352,1742861575,1742861927,1742861927.293449,-18000,,
com.google.Chrome,493,1742861079,1742861572,1742861572.338151,-18000,,
com.google.Chrome,301,1742860777,1742861078,1742861078.273762,-18000,,
com.google.Chrome,781,1742859995,1742860776,1742860776.707586,-18000,,
com.leomehlig.today,23,1742859972,1742859995,1742859995.53506,-18000,,
com.google.Chrome,844,1742859128,1742859972,1742859972.586063,-18000,,
com.leomehlig.today,11,1742859117,1742859128,1742859128.8228521,-18000,,
com.google.Chrome,22,1742859095,1742859117,1742859117.312564,-18000,,
com.leomehlig.today,25,1742859070,1742859095,1742859095.365665,-18000,,
com.leomehlig.today,303,1742858476,1742858779,1742858779.399599,-18000,,
com.google.Chrome,167,1742858309,1742858476,1742858476.63417,-18000,,
com.leomehlig.today,17,1742858292,1742858309,1742858309.717272,-18000,,
com.google.Chrome,1138,1742857154,1742858292,1742858292.128017,-18000,,
com.leomehlig.today,59,1742857095,1742857154,1742857154.813725,-18000,,
com.google.Chrome,1360,1742855735,1742857095,1742857095.246788,-18000,,
com.leomehlig.today,19,1742855716,1742855735,1742855735.931149,-18000,,
com.google.Chrome,5,1742855711,1742855716,1742855716.2668018,-18000,,
com.leomehlig.today,10,1742855672,1742855682,1742855682.965866,-18000,,
com.google.Chrome,122,1742855550,1742855672,1742855672.200231,-18000,,
com.google.Chrome,647,1742853172,1742853819,1742853820.014535,-18000,,
com.google.Chrome,374,1742850940,1742851314,1742851314.219922,-18000,,
com.google.Chrome,738,1742849857,1742850595,1742850595.136903,-18000,,
com.leomehlig.today,30,1742849827,1742849857,1742849858.563463,-18000,,
com.google.Chrome,944,1742848883,1742849827,1742849827.843019,-18000,,
com.apple.finder,1,1742848869,1742848870,1742848870.46213,-18000,,
com.apple.Passwords,1,1742848868,1742848869,1742848869.225904,-18000,,
com.apple.finder,1,1742848867,1742848868,1742848868.8617449,-18000,,
com.cisco.secureclient.gui,6,1742848861,1742848867,1742848867.545068,-18000,,
com.apple.finder,3,1742848858,1742848861,1742848861.786273,-18000,,
com.apple.Terminal,18,1742848840,1742848858,1742848858.133153,-18000,,
com.apple.finder,21,1742848819,1742848840,1742848840.721909,-18000,,
com.apple.archiveutility,1,1742848818,1742848819,1742848819.5721521,-18000,,
com.apple.finder,20,1742848798,1742848818,1742848818.285626,-18000,,
com.apple.finder,302,1742848385,1742848687,1742848687.798448,-18000,,
com.apple.Terminal,19,1742848366,1742848385,1742848385.508285,-18000,,
com.apple.finder,6,1742848360,1742848366,1742848366.1953,-18000,,
com.apple.Terminal,39,1742848321,1742848360,1742848360.572176,-18000,,
com.microsoft.VSCode,17,1742848304,1742848321,1742848321.972446,-18000,,
com.apple.Terminal,40,1742848264,1742848304,1742848304.701388,-18000,,
com.apple.Passwords,8,1742848256,1742848264,1742848264.8830872,-18000,,
com.cisco.secureclient.gui,41,1742848215,1742848256,1742848256.568939,-18000,,
com.apple.Passwords,1,1742848214,1742848215,1742848215.966979,-18000,,
com.cisco.secureclient.gui,4,1742848210,1742848214,1742848214.7749271,-18000,,
com.apple.Passwords,2,1742848208,1742848210,1742848210.299887,-18000,,
com.cisco.secureclient.gui,5,1742848203,1742848208,1742848208.514744,-18000,,
com.apple.Passwords,10,1742848193,1742848203,1742848203.816586,-18000,,
com.cisco.secureclient.gui,11,1742848182,1742848193,1742848193.550154,-18000,,
com.apple.Terminal,3,1742848179,1742848182,1742848182.093823,-18000,,
com.apple.finder,13,1742848166,1742848179,1742848179.904471,-18000,,
com.apple.finder,1,1742846379,1742846380,1742846381.4908462,-18000,,
com.apple.Music,1,1742846378,1742846379,1742846380.047618,-18000,,
com.apple.finder,2,1742846376,1742846378,1742846378.801914,-18000,,
com.leomehlig.today,75,1742846301,1742846376,1742846376.626758,-18000,,
com.apple.Music,1,1742846300,1742846301,1742846301.1982698,-18000,,
com.google.Chrome,18,1742846282,1742846300,1742846300.576799,-18000,,
com.leomehlig.today,22,1742846260,1742846282,1742846282.0885081,-18000,,
com.google.Chrome,724,1742845536,1742846260,1742846260.757304,-18000,,
com.leomehlig.today,10,1742845526,1742845536,1742845536.648046,-18000,,
com.google.Chrome,6,1742845520,1742845526,1742845526.911035,-18000,,
com.google.Chrome,875,1742844538,1742845413,1742845413.6667871,-18000,,
com.google.Chrome,1199,1742843206,1742844405,1742844405.170014,-18000,,
com.apple.Music,10,1742843196,1742843206,1742843206.0593,-18000,,
com.microsoft.Outlook,417,1742842779,1742843196,1742843196.6928759,-18000,,
com.google.Chrome,75,1742842704,1742842779,1742842779.284687,-18000,,
com.apple.Music,148,1742842542,1742842690,1742842690.19509,-18000,,
com.apple.finder,2,1742842540,1742842542,1742842542.620117,-18000,,
com.google.Chrome,32,1742842508,1742842540,1742842540.902735,-18000,,
com.google.Chrome,242,1742831153,1742831395,1742831395.119077,-18000,,
com.apple.Passwords,6,1742831147,1742831153,1742831153.6735768,-18000,,
com.google.Chrome,10,1742831137,1742831147,1742831147.429929,-18000,,
com.apple.Passwords,7,1742831130,1742831137,1742831137.9783878,-18000,,
com.google.Chrome,19,1742831111,1742831130,1742831130.692275,-18000,,
com.apple.Passwords,6,1742831105,1742831111,1742831111.971218,-18000,,
com.google.Chrome,236,1742830869,1742831105,1742831105.49607,-18000,,
com.google.Chrome,2,1742826800,1742826802,1742826802.941412,-18000,,
com.apple.MobileSMS,6,1742826794,1742826800,1742826800.151925,-18000,,
com.google.Chrome,2,1742826792,1742826794,1742826794.3255,-18000,,
com.apple.finder,6,1742826786,1742826792,1742826792.401298,-18000,,
com.microsoft.Outlook,5,1742826781,1742826786,1742826786.724454,-18000,,
com.apple.iCal,5,1742826776,1742826781,1742826781.268161,-18000,,
com.google.Chrome,141,1742826635,1742826776,1742826776.6076121,-18000,,
com.apple.iCal,4,1742826631,1742826635,1742826635.057448,-18000,,
com.google.Chrome,1,1742826630,1742826631,1742826631.975543,-18000,,
com.apple.iCal,32,1742826598,1742826630,1742826630.312026,-18000,,
com.google.Chrome,2,1742826596,1742826598,1742826598.394854,-18000,,
com.apple.iCal,9,1742826587,1742826596,1742826596.85701,-18000,,
com.google.Chrome,55,1742826532,1742826587,1742826587.779041,-18000,,
com.microsoft.Outlook,23,1742826493,1742826516,1742826516.941839,-18000,,
com.google.Chrome,4,1742826489,1742826493,1742826493.973654,-18000,,
com.google.Chrome,115,1742794936,1742795051,1742795052.242244,-18000,,
com.google.Chrome,472,1742794238,1742794710,1742794710.993836,-18000,,
com.apple.Music,4,1742794234,1742794238,1742794238.80556,-18000,,
com.google.Chrome,51,1742794183,1742794234,1742794234.791188,-18000,,
com.apple.Music,218,1742793965,1742794183,1742794183.837553,-18000,,
com.google.Chrome,576,1742793389,1742793965,1742793965.418007,-18000,,
com.apple.Music,755,1742792634,1742793389,1742793389.096675,-18000,,
com.google.Chrome,415,1742792219,1742792634,1742792634.782979,-18000,,
com.google.Chrome,450,1742791504,1742791954,1742791954.0830278,-18000,,
com.apple.Music,195,1742791309,1742791504,1742791504.554573,-18000,,
com.google.Chrome,1277,1742790032,1742791309,1742791309.9013438,-18000,,
com.google.Chrome,2762,1742787197,1742789959,1742789959.290587,-18000,,
com.apple.finder,1,1742787196,1742787197,1742787197.640301,-18000,,
com.leomehlig.today,2,1742787194,1742787196,1742787196.404632,-18000,,
com.apple.Notes,12,1742787182,1742787194,1742787194.794498,-18000,,
com.apple.Notes,93,1742766655,1742766748,1742766748.501549,-18000,,
com.leomehlig.today,37,1742766618,1742766655,1742766655.072185,-18000,,
com.apple.finder,19,1742766599,1742766618,1742766618.1930041,-18000,,
com.apple.MobileSMS,3,1742694757,1742694760,1742694760.532124,-18000,EB445137-D7F5-57EC-87DA-1DB460D64046,"iPhone13,2"
com.toyopagroup.picaboo,1,1742694726,1742694727,1742694727.900521,-18000,EB445137-D7F5-57EC-87DA-1DB460D64046,"iPhone13,2"
com.apple.MobileSMS,26,1742694700,1742694726,1742694726.081092,-18000,EB445137-D7F5-57EC-87DA-1DB460D64046,"iPhone13,2"
com.toyopagroup.picaboo,7,1742694693,1742694700,1742694700.827219,-18000,EB445137-D7F5-57EC-87DA-1DB460D64046,"iPhone13,2"
com.apple.MobileSMS,0,1742694693,1742694693,1742694694.070231,-18000,EB445137-D7F5-57EC-87DA-1DB460D64046,"iPhone13,2"
com.apple.MobileSMS,4,1742694688,1742694692,1742694692.619251,-18000,EB445137-D7F5-57EC-87DA-1DB460D64046,"iPhone13,2"
com.apple.MobileSMS,4,1742694647,1742694651,1742694651.693245,-18000,EB445137-D7F5-57EC-87DA-1DB460D64046,"iPhone13,2"
com.toyopagroup.picaboo,28,1742694616,1742694644,1742694644.7595248,-18000,EB445137-D7F5-57EC-87DA-1DB460D64046,"iPhone13,2"
com.apple.MobileSMS,2,1742694612,1742694614,1742694615.134572,-18000,EB445137-D7F5-57EC-87DA-1DB460D64046,"iPhone13,2"
com.apple.MobileSMS,2,1742694610,1742694612,1742694612.530627,-18000,EB445137-D7F5-57EC-87DA-1DB460D64046,"iPhone13,2"
com.apple.MobileSMS,1,1742694579,1742694580,1742694580.737939,-18000,EB445137-D7F5-57EC-87DA-1DB460D64046,"iPhone13,2"
com.apple.MobileSMS,42,1742694536,1742694578,1742694578.2492762,-18000,EB445137-D7F5-57EC-87DA-1DB460D64046,"iPhone13,2"
com.apple.MobileSMS,14,1742694522,1742694536,1742694536.104836,-18000,EB445137-D7F5-57EC-87DA-1DB460D64046,"iPhone13,2"
com.apple.news,16,1742694506,1742694522,1742694522.7321491,-18000,EB445137-D7F5-57EC-87DA-1DB460D64046,"iPhone13,2"
com.apple.MobileSMS,7,1742694490,1742694497,1742694498.013668,-18000,EB445137-D7F5-57EC-87DA-1DB460D64046,"iPhone13,2"
com.apple.MobileSMS,4,1742694475,1742694479,1742694479.558955,-18000,EB445137-D7F5-57EC-87DA-1DB460D64046,"iPhone13,2"
com.apple.MobileSMS,5,1742694467,1742694472,1742694472.094145,-18000,EB445137-D7F5-57EC-87DA-1DB460D64046,"iPhone13,2"
com.apple.MobileSMS,2,1742694460,1742694462,1742694462.99206,-18000,EB445137-D7F5-57EC-87DA-1DB460D64046,"iPhone13,2"
com.apple.MobileSMS,47,1742694410,1742694457,1742694457.9900498,-18000,EB445137-D7F5-57EC-87DA-1DB460D64046,"iPhone13,2"
com.apple.MobileSMS,2,1742694405,1742694407,1742694407.751261,-18000,EB445137-D7F5-57EC-87DA-1DB460D64046,"iPhone13,2"
com.apple.MobileSMS,10,1742694380,1742694390,1742694390.616076,-18000,EB445137-D7F5-57EC-87DA-1DB460D64046,"iPhone13,2"
com.apple.news,50,1742694327,1742694377,1742694377.3558269,-18000,EB445137-D7F5-57EC-87DA-1DB460D64046,"iPhone13,2"
com.apple.MobileSMS,7,1742694314,1742694321,1742694321.962048,-18000,EB445137-D7F5-57EC-87DA-1DB460D64046,"iPhone13,2"
com.toyopagroup.picaboo,15,1742694279,1742694294,1742694294.5812678,-18000,EB445137-D7F5-57EC-87DA-1DB460D64046,"iPhone13,2"
com.apple.MobileSMS,13,1742694260,1742694273,1742694273.161248,-18000,EB445137-D7F5-57EC-87DA-1DB460D64046,"iPhone13,2"
com.toyopagroup.picaboo,88,1742694166,1742694254,1742694254.9166799,-18000,EB445137-D7F5-57EC-87DA-1DB460D64046,"iPhone13,2"
com.toyopagroup.picaboo,13,1742694082,1742694095,1742694095.483786,-18000,EB445137-D7F5-57EC-87DA-1DB460D64046,"iPhone13,2"
com.toyopagroup.picaboo,6,1742693878,1742693884,1742693884.3341231,-18000,EB445137-D7F5-57EC-87DA-1DB460D64046,"iPhone13,2"
com.apple.MobileSMS,5,1742693755,1742693760,1742693760.690631,-18000,EB445137-D7F5-57EC-87DA-1DB460D64046,"iPhone13,2"
com.apple.InCallService,4,1742693751,1742693755,1742693755.5283499,-18000,EB445137-D7F5-57EC-87DA-1DB460D64046,"iPhone13,2"
com.apple.InCallService,5,1742693745,1742693750,1742693750.676929,-18000,EB445137-D7F5-57EC-87DA-1DB460D64046,"iPhone13,2"
com.apple.InCallService,2,1742693740,1742693742,1742693742.944944,-18000,EB445137-D7F5-57EC-87DA-1DB460D64046,"iPhone13,2"
com.apple.MobileSMS,4,1742693736,1742693740,1742693741.621908,-18000,EB445137-D7F5-57EC-87DA-1DB460D64046,"iPhone13,2"
com.apple.MobileSMS,3,1742693732,1742693735,1742693735.99087,-18000,EB445137-D7F5-57EC-87DA-1DB460D64046,"iPhone13,2"
com.apple.news,35,1742693599,1742693634,1742693634.768508,-18000,EB445137-D7F5-57EC-87DA-1DB460D64046,"iPhone13,2"
com.toyopagroup.picaboo,8,1742693579,1742693587,1742693587.971165,-18000,EB445137-D7F5-57EC-87DA-1DB460D64046,"iPhone13,2"
com.apple.InCallService,1,1742693559,1742693560,1742693560.2976398,-18000,EB445137-D7F5-57EC-87DA-1DB460D64046,"iPhone13,2"
com.apple.InCallService,2,1742693555,1742693557,1742693557.695085,-18000,EB445137-D7F5-57EC-87DA-1DB460D64046,"iPhone13,2"
com.apple.InCallService,2,1742693486,1742693488,1742693488.587435,-18000,EB445137-D7F5-57EC-87DA-1DB460D64046,"iPhone13,2"
com.apple.InCallService,5,1742693469,1742693474,1742693474.756068,-18000,EB445137-D7F5-57EC-87DA-1DB460D64046,"iPhone13,2"
com.apple.InCallService,3,1742693426,1742693429,1742693429.127874,-18000,EB445137-D7F5-57EC-87DA-1DB460D64046,"iPhone13,2"
com.apple.MobileSMS,2,1742693421,1742693423,1742693423.48951,-18000,EB445137-D7F5-57EC-87DA-1DB460D64046,"iPhone13,2"
com.apple.InCallService,1,1742693418,1742693419,1742693419.648676,-18000,EB445137-D7F5-57EC-87DA-1DB460D64046,"iPhone13,2"
com.apple.news,131,1742692881,1742693012,1742693012.9146109,-18000,EB445137-D7F5-57EC-87DA-1DB460D64046,"iPhone13,2"
co.hinge.mobile.ios,49,1742692824,1742692873,1742692873.1366,-18000,EB445137-D7F5-57EC-87DA-1DB460D64046,"iPhone13,2"
com.apple.DocumentsApp,34,1742692215,1742692249,1742692249.405455,-18000,EB445137-D7F5-57EC-87DA-1DB460D64046,"iPhone13,2"
com.apple.weather,2,1742691941,1742691943,1742691943.575547,-18000,EB445137-D7F5-57EC-87DA-1DB460D64046,"iPhone13,2"
com.apple.weather,28,1742691786,1742691814,1742691814.907871,-18000,EB445137-D7F5-57EC-87DA-1DB460D64046,"iPhone13,2"
com.apple.weather,9,1742691731,1742691740,1742691740.654743,-18000,EB445137-D7F5-57EC-87DA-1DB460D64046,"iPhone13,2"
com.apple.weather,7,1742691709,1742691716,1742691716.195056,-18000,EB445137-D7F5-57EC-87DA-1DB460D64046,"iPhone13,2"
com.apple.findmy,5,1742691603,1742691608,1742691608.34007,-18000,EB445137-D7F5-57EC-87DA-1DB460D64046,"iPhone13,2"
com.apple.findmy,14,1742690640,1742690654,1742690654.824511,-18000,EB445137-D7F5-57EC-87DA-1DB460D64046,"iPhone13,2"
com.apple.weather,2,1742690638,1742690640,1742690640.3562741,-18000,EB445137-D7F5-57EC-87DA-1DB460D64046,"iPhone13,2"
com.strava.stravaride,81,1742685510,1742685591,1742685591.958679,-18000,EB445137-D7F5-57EC-87DA-1DB460D64046,"iPhone13,2"
com.apple.MobileSMS,31,1742685468,1742685499,1742685499.585424,-18000,EB445137-D7F5-57EC-87DA-1DB460D64046,"iPhone13,2"
com.apple.findmy,237,1742680996,1742681233,1742681233.570107,-18000,EB445137-D7F5-57EC-87DA-1DB460D64046,"iPhone13,2"
com.apple.findmy,5,1742680702,1742680707,1742680707.9415221,-18000,EB445137-D7F5-57EC-87DA-1DB460D64046,"iPhone13,2"
com.apple.findmy,66,1742680447,1742680513,1742680513.6589742,-18000,EB445137-D7F5-57EC-87DA-1DB460D64046,"iPhone13,2"
com.apple.MobileSMS,1,1742680446,1742680447,1742680447.854697,-18000,EB445137-D7F5-57EC-87DA-1DB460D64046,"iPhone13,2"
com.apple.MobileSMS,4,1742680094,1742680098,1742680098.934305,-18000,EB445137-D7F5-57EC-87DA-1DB460D64046,"iPhone13,2"
com.apple.findmy,1,1742680093,1742680094,1742680095.0205898,-18000,EB445137-D7F5-57EC-87DA-1DB460D64046,"iPhone13,2"
com.apple.findmy,8,1742680075,1742680083,1742680083.565598,-18000,EB445137-D7F5-57EC-87DA-1DB460D64046,"iPhone13,2"
com.apple.finder,2,1742680000,1742680002,1742680002.698907,-18000,,
com.apple.MobileSMS,14,1742679986,1742680000,1742680001.01597,-18000,,
com.apple.finder,1,1742679985,1742679986,1742679986.341813,-18000,,
com.leomehlig.today,77,1742679908,1742679985,1742679985.409133,-18000,,
com.toyopagroup.picaboo,57,1742679793,1742679850,1742679850.864406,-18000,EB445137-D7F5-57EC-87DA-1DB460D64046,"iPhone13,2"
com.apple.MobileSMS,0,1742679793,1742679793,1742679794.065857,-18000,EB445137-D7F5-57EC-87DA-1DB460D64046,"iPhone13,2"
com.google.Chrome,233,1742679675,1742679908,1742679908.573067,-18000,,
com.leomehlig.today,42,1742679633,1742679675,1742679675.9745312,-18000,,
com.google.Chrome,987,1742678646,1742679633,1742679633.207399,-18000,,
com.google.Chrome,819,1742677820,1742678639,1742678639.810092,-18000,,
com.leomehlig.today,36,1742677784,1742677820,1742677820.673177,-18000,,
com.google.Chrome,767,1742677017,1742677784,1742677784.764816,-18000,,
com.leomehlig.today,8,1742677009,1742677017,1742677017.640156,-18000,,
com.google.Chrome,1832,1742675177,1742677009,1742677009.472431,-18000,,
com.google.Chrome,328,1742674787,1742675115,1742675115.4099622,-18000,,
com.leomehlig.today,3,1742674784,1742674787,1742674787.553345,-18000,,
com.google.Chrome,952,1742673832,1742674784,1742674784.5334702,-18000,,
com.apple.MobileSMS,5,1742672825,1742672830,1742672830.696406,-18000,EB445137-D7F5-57EC-87DA-1DB460D64046,"iPhone13,2"
com.toyopagroup.picaboo,35,1742672773,1742672808,1742672808.9465199,-18000,EB445137-D7F5-57EC-87DA-1DB460D64046,"iPhone13,2"
com.google.Chrome,943,1742672761,1742673704,1742673704.814059,-18000,,
com.leomehlig.today,5,1742672756,1742672761,1742672761.056849,-18000,,
com.google.Chrome,477,1742672279,1742672756,1742672756.949243,-18000,,
com.google.Chrome,1470,1742670423,1742671893,1742671893.427583,-18000,,
com.google.Chrome,413,1742670009,1742670422,1742670422.080861,-18000,,
com.leomehlig.today,18,1742669969,1742669987,1742669988.399427,-18000,,
com.google.Chrome,16,1742669953,1742669969,1742669970.479138,-18000,,
com.google.chrome.ios,74,1742667160,1742667234,1742667234.606972,-18000,EB445137-D7F5-57EC-87DA-1DB460D64046,"iPhone13,2"
com.amazon.Amazon,4,1742667156,1742667160,1742667160.766803,-18000,EB445137-D7F5-57EC-87DA-1DB460D64046,"iPhone13,2"
com.apple.mobilecal,44,1742667112,1742667156,1742667156.1442351,-18000,EB445137-D7F5-57EC-87DA-1DB460D64046,"iPhone13,2"
com.google.Sheets,28,1742666892,1742666920,1742666920.184958,-18000,EB445137-D7F5-57EC-87DA-1DB460D64046,"iPhone13,2"
com.apple.MobileSMS,6,1742666491,1742666497,1742666497.748847,-18000,EB445137-D7F5-57EC-87DA-1DB460D64046,"iPhone13,2"
com.apple.Maps,39,1742666452,1742666491,1742666491.042233,-18000,EB445137-D7F5-57EC-87DA-1DB460D64046,"iPhone13,2"
com.apple.MobileSMS,14,1742666295,1742666309,1742666309.674384,-18000,EB445137-D7F5-57EC-87DA-1DB460D64046,"iPhone13,2"
com.facebook.Facebook,127,1742666168,1742666295,1742666295.683786,-18000,EB445137-D7F5-57EC-87DA-1DB460D64046,"iPhone13,2"
com.apple.Music,13,1742664081,1742664094,1742664094.510742,-18000,EB445137-D7F5-57EC-87DA-1DB460D64046,"iPhone13,2"
com.apple.musicrecognition,6,1742664075,1742664081,1742664081.866039,-18000,EB445137-D7F5-57EC-87DA-1DB460D64046,"iPhone13,2"
com.apple.findmy,0,1742664075,1742664075,1742664076.577032,-18000,EB445137-D7F5-57EC-87DA-1DB460D64046,"iPhone13,2"
com.apple.findmy,13,1742660079,1742660092,1742660092.378087,-18000,EB445137-D7F5-57EC-87DA-1DB460D64046,"iPhone13,2"
com.apple.findmy,22,1742660029,1742660051,1742660051.4754171,-18000,EB445137-D7F5-57EC-87DA-1DB460D64046,"iPhone13,2"
com.apple.findmy,20,1742659670,1742659690,1742659690.430402,-18000,EB445137-D7F5-57EC-87DA-1DB460D64046,"iPhone13,2"
com.apple.findmy,25,1742659534,1742659559,1742659559.8788939,-18000,EB445137-D7F5-57EC-87DA-1DB460D64046,"iPhone13,2"
com.apple.DocumentsApp,1,1742659529,1742659530,1742659530.580686,-18000,EB445137-D7F5-57EC-87DA-1DB460D64046,"iPhone13,2"
com.apple.DocumentsApp,42,1742659280,1742659322,1742659322.171455,-18000,EB445137-D7F5-57EC-87DA-1DB460D64046,"iPhone13,2"
com.apple.MobileSMS,21,1742659246,1742659267,1742659267.472708,-18000,EB445137-D7F5-57EC-87DA-1DB460D64046,"iPhone13,2"
com.amazon.Amazon,1,1742659244,1742659245,1742659245.73099,-18000,EB445137-D7F5-57EC-87DA-1DB460D64046,"iPhone13,2"
com.amazon.Amazon,42,1742659025,1742659067,1742659067.638011,-18000,EB445137-D7F5-57EC-87DA-1DB460D64046,"iPhone13,2"
com.apple.MobileSMS,2,1742658631,1742658633,1742658633.3788319,-18000,EB445137-D7F5-57EC-87DA-1DB460D64046,"iPhone13,2"
com.apple.MobileSMS,5,1742658287,1742658292,1742658292.537572,-18000,EB445137-D7F5-57EC-87DA-1DB460D64046,"iPhone13,2"
com.apple.mobileslideshow,21,1742658266,1742658287,1742658287.332643,-18000,EB445137-D7F5-57EC-87DA-1DB460D64046,"iPhone13,2"
com.apple.MobileSMS,4,1742658262,1742658266,1742658266.904731,-18000,EB445137-D7F5-57EC-87DA-1DB460D64046,"iPhone13,2"
com.apple.mobileslideshow,42,1742658220,1742658262,1742658262.367114,-18000,EB445137-D7F5-57EC-87DA-1DB460D64046,"iPhone13,2"
com.apple.mobileslideshow,15,1742658052,1742658067,1742658067.837486,-18000,EB445137-D7F5-57EC-87DA-1DB460D64046,"iPhone13,2"
com.apple.MobileSMS,2,1742658050,1742658052,1742658053.0930948,-18000,EB445137-D7F5-57EC-87DA-1DB460D64046,"iPhone13,2"
com.truebill.truebillnative,22,1742656995,1742657017,1742657017.927514,-18000,EB445137-D7F5-57EC-87DA-1DB460D64046,"iPhone13,2"
com.apple.CoreAuthUI,12,1742656940,1742656952,1742656952.220357,-18000,EB445137-D7F5-57EC-87DA-1DB460D64046,"iPhone13,2"
com.truebill.truebillnative,58,1742656937,1742656995,1742656995.268166,-18000,EB445137-D7F5-57EC-87DA-1DB460D64046,"iPhone13,2"
com.apple.findmy,4,1742656924,1742656928,1742656928.515308,-18000,EB445137-D7F5-57EC-87DA-1DB460D64046,"iPhone13,2"
com.apple.findmy,26,1742656897,1742656923,1742656923.424879,-18000,EB445137-D7F5-57EC-87DA-1DB460D64046,"iPhone13,2"
com.apple.mobileslideshow,162,1742656725,1742656887,1742656887.830854,-18000,EB445137-D7F5-57EC-87DA-1DB460D64046,"iPhone13,2"
com.apple.MobileSMS,25,1742656695,1742656720,1742656720.2873511,-18000,EB445137-D7F5-57EC-87DA-1DB460D64046,"iPhone13,2"
com.apple.MobileSMS,12,1742656659,1742656671,1742656671.959207,-18000,EB445137-D7F5-57EC-87DA-1DB460D64046,"iPhone13,2"
com.apple.MobileSMS,5,1742656645,1742656650,1742656650.341594,-18000,EB445137-D7F5-57EC-87DA-1DB460D64046,"iPhone13,2"
com.apple.MobileSMS,6,1742656638,1742656644,1742656644.841604,-18000,EB445137-D7F5-57EC-87DA-1DB460D64046,"iPhone13,2"
com.apple.Health,35,1742656594,1742656629,1742656629.417922,-18000,EB445137-D7F5-57EC-87DA-1DB460D64046,"iPhone13,2"
com.apple.Health,58,1742656533,1742656591,1742656591.839164,-18000,EB445137-D7F5-57EC-87DA-1DB460D64046,"iPhone13,2"
com.apple.MobileSMS,5,1742656526,1742656531,1742656531.5208879,-18000,EB445137-D7F5-57EC-87DA-1DB460D64046,"iPhone13,2"
com.apple.MobileSMS,158,1742656368,1742656526,1742656526.710907,-18000,EB445137-D7F5-57EC-87DA-1DB460D64046,"iPhone13,2"
com.renpho.health,3,1742656362,1742656365,1742656365.80673,-18000,EB445137-D7F5-57EC-87DA-1DB460D64046,"iPhone13,2"
com.renpho.health,23,1742656050,1742656073,1742656074.020469,-18000,EB445137-D7F5-57EC-87DA-1DB460D64046,"iPhone13,2"
com.apple.weather,2,1742656048,1742656050,1742656050.919666,-18000,EB445137-D7F5-57EC-87DA-1DB460D64046,"iPhone13,2"
com.apple.weather,7,1742655844,1742655851,1742655852.149523,-18000,EB445137-D7F5-57EC-87DA-1DB460D64046,"iPhone13,2"
com.apple.MobileSMS,2,1742655842,1742655844,1742655844.33079,-18000,EB445137-D7F5-57EC-87DA-1DB460D64046,"iPhone13,2"
com.apple.MobileSMS,3,1742655720,1742655723,1742655723.404918,-18000,EB445137-D7F5-57EC-87DA-1DB460D64046,"iPhone13,2"
com.apple.MobileSMS,24,1742655692,1742655716,1742655717.019181,-18000,EB445137-D7F5-57EC-87DA-1DB460D64046,"iPhone13,2"
com.apple.findmy,6,1742655683,1742655689,1742655689.210048,-18000,EB445137-D7F5-57EC-87DA-1DB460D64046,"iPhone13,2"
com.apple.MobileSMS,25,1742655653,1742655678,1742655678.521194,-18000,EB445137-D7F5-57EC-87DA-1DB460D64046,"iPhone13,2"
com.apple.MobileSMS,11,1742655640,1742655651,1742655651.78543,-18000,EB445137-D7F5-57EC-87DA-1DB460D64046,"iPhone13,2"
com.apple.MobileSMS,4,1742655364,1742655368,1742655368.7610059,-18000,EB445137-D7F5-57EC-87DA-1DB460D64046,"iPhone13,2"
com.google.chrome.ios,11,1742655353,1742655364,1742655364.7674541,-18000,EB445137-D7F5-57EC-87DA-1DB460D64046,"iPhone13,2"
com.apple.MobileSMS,74,1742655279,1742655353,1742655353.664966,-18000,EB445137-D7F5-57EC-87DA-1DB460D64046,"iPhone13,2"
com.amazon.Amazon,348,1742654821,1742655169,1742655171.298682,-18000,EB445137-D7F5-57EC-87DA-1DB460D64046,"iPhone13,2"
com.google.chrome.ios,58,1742654640,1742654698,1742654698.147021,-18000,EB445137-D7F5-57EC-87DA-1DB460D64046,"iPhone13,2"
com.apple.MobileSMS,8,1742654572,1742654580,1742654580.515168,-18000,EB445137-D7F5-57EC-87DA-1DB460D64046,"iPhone13,2"
com.google.Maps,31,1742654541,1742654572,1742654572.230795,-18000,EB445137-D7F5-57EC-87DA-1DB460D64046,"iPhone13,2"
com.apple.findmy,33,1742654505,1742654538,1742654538.842548,-18000,EB445137-D7F5-57EC-87DA-1DB460D64046,"iPhone13,2"
com.apple.findmy,2,1742654498,1742654500,1742654500.414962,-18000,EB445137-D7F5-57EC-87DA-1DB460D64046,"iPhone13,2"
com.apple.findmy,51,1742653122,1742653173,1742653173.475224,-18000,EB445137-D7F5-57EC-87DA-1DB460D64046,"iPhone13,2"
com.apple.mobiletimer,8,1742651501,1742651509,1742651509.112073,-18000,EB445137-D7F5-57EC-87DA-1DB460D64046,"iPhone13,2"
com.apple.CoreAuthUI,2,1742614831,1742614833,1742614834.035923,-18000,EB445137-D7F5-57EC-87DA-1DB460D64046,"iPhone13,2"
com.apple.journal,1106,1742614830,1742615936,1742615936.440703,-18000,EB445137-D7F5-57EC-87DA-1DB460D64046,"iPhone13,2"
com.google.Chrome,3686,1742609785,1742613471,1742613471.274632,-18000,,
com.google.Chrome,685,1742608985,1742609670,1742609670.813535,-18000,,
com.google.Chrome,1449,1742607467,1742608916,1742608916.025487,-18000,,
com.leomehlig.today,2,1742607465,1742607467,1742607467.8841991,-18000,,
co.hinge.mobile.ios,300,1742607056,1742607356,1742607356.5524359,-18000,EB445137-D7F5-57EC-87DA-1DB460D64046,"iPhone13,2"
co.hinge.mobile.ios,236,1742606818,1742607054,1742607054.7851372,-18000,EB445137-D7F5-57EC-87DA-1DB460D64046,"iPhone13,2"
com.letterboxd.LetterboxdApp,7,1742606811,1742606818,1742606819.030706,-18000,EB445137-D7F5-57EC-87DA-1DB460D64046,"iPhone13,2"
co.hinge.mobile.ios,118,1742606691,1742606809,1742606809.5986218,-18000,EB445137-D7F5-57EC-87DA-1DB460D64046,"iPhone13,2"
com.letterboxd.LetterboxdApp,4,1742606687,1742606691,1742606691.6540542,-18000,EB445137-D7F5-57EC-87DA-1DB460D64046,"iPhone13,2"
co.hinge.mobile.ios,16,1742606671,1742606687,1742606687.4509869,-18000,EB445137-D7F5-57EC-87DA-1DB460D64046,"iPhone13,2"
co.hinge.mobile.ios,6,1742606658,1742606664,1742606664.2256532,-18000,EB445137-D7F5-57EC-87DA-1DB460D64046,"iPhone13,2"
co.hinge.mobile.ios,44,1742606613,1742606657,1742606657.331658,-18000,EB445137-D7F5-57EC-87DA-1DB460D64046,"iPhone13,2"
com.leomehlig.today,322,1742606587,1742606909,1742606909.71564,-18000,,
co.hinge.mobile.ios,94,1742606442,1742606536,1742606536.566077,-18000,EB445137-D7F5-57EC-87DA-1DB460D64046,"iPhone13,2"
com.microsoft.Office.Outlook,7,1742606433,1742606440,1742606440.113411,-18000,EB445137-D7F5-57EC-87DA-1DB460D64046,"iPhone13,2"
com.apple.news,2,1742606431,1742606433,1742606433.109486,-18000,EB445137-D7F5-57EC-87DA-1DB460D64046,"iPhone13,2"
com.google.Chrome,210,1742606377,1742606587,1742606587.7973099,-18000,,
com.apple.finder,4,1742606356,1742606360,1742606360.352128,-18000,,
com.microsoft.VSCode,6,1742606350,1742606356,1742606356.400806,-18000,,
com.google.Chrome,7,1742606343,1742606350,1742606350.470506,-18000,,
com.microsoft.VSCode,61,1742606282,1742606343,1742606343.388695,-18000,,
com.google.Chrome,44,1742606238,1742606282,1742606282.8416781,-18000,,
com.microsoft.VSCode,21,1742606217,1742606238,1742606238.403238,-18000,,
com.google.Chrome,16,1742606201,1742606217,1742606217.690631,-18000,,
com.microsoft.VSCode,5,1742606196,1742606201,1742606201.6340508,-18000,,
com.google.Chrome,5,1742606191,1742606196,1742606196.574986,-18000,,
com.microsoft.VSCode,10,1742606181,1742606191,1742606191.489574,-18000,,
com.google.Chrome,5,1742606176,1742606181,1742606181.4864511,-18000,,
com.microsoft.VSCode,127,1742606049,1742606176,1742606176.819174,-18000,,
com.google.Chrome,32,1742606017,1742606049,1742606049.68905,-18000,,
com.microsoft.VSCode,9,1742606008,1742606017,1742606017.46392,-18000,,
com.google.Chrome,1,1742606007,1742606008,1742606009.017861,-18000,,
com.microsoft.VSCode,10,1742605997,1742606007,1742606007.70619,-18000,,
com.google.Chrome,9,1742605988,1742605997,1742605997.1975641,-18000,,
com.microsoft.VSCode,4,1742605984,1742605988,1742605988.341528,-18000,,
com.google.Chrome,2,1742605982,1742605984,1742605984.3462229,-18000,,
com.apple.finder,1,1742605981,1742605982,1742605982.314289,-18000,,
com.microsoft.VSCode,4,1742605977,1742605981,1742605981.407673,-18000,,
com.apple.finder,1,1742605976,1742605977,1742605977.511951,-18000,,
com.google.Chrome,14,1742605962,1742605976,1742605976.572105,-18000,,
com.apple.finder,1,1742605961,1742605962,1742605962.718611,-18000,,
com.microsoft.VSCode,43,1742605918,1742605961,1742605961.252758,-18000,,
com.apple.finder,22,1742605896,1742605918,1742605918.081203,-18000,,
com.apple.Notes,21,1742605875,1742605896,1742605896.233995,-18000,,
com.apple.news,357,1742605516,1742605873,1742605873.482446,-18000,EB445137-D7F5-57EC-87DA-1DB460D64046,"iPhone13,2"
com.apple.Notes,366,1742605426,1742605792,1742605792.370208,-18000,,
com.apple.finder,34,1742605392,1742605426,1742605426.753844,-18000,,
com.apple.Notes,25,1742605367,1742605392,1742605392.732541,-18000,,
com.apple.finder,203,1742605164,1742605367,1742605367.0728002,-18000,,
com.microsoft.VSCode,4,1742605160,1742605164,1742605164.916669,-18000,,
com.apple.Notes,4,1742605156,1742605160,1742605160.763305,-18000,,
com.microsoft.VSCode,7,1742605149,1742605156,1742605157.018045,-18000,,
com.google.Chrome,1,1742605148,1742605149,1742605149.2099361,-18000,,
com.microsoft.VSCode,2,1742605146,1742605148,1742605148.467994,-18000,,
com.google.Chrome,15,1742605131,1742605146,1742605146.601573,-18000,,
com.microsoft.VSCode,134,1742604997,1742605131,1742605131.342832,-18000,,
com.google.Chrome,6,1742604991,1742604997,1742604997.232675,-18000,,
com.microsoft.VSCode,6,1742604985,1742604991,1742604991.288616,-18000,,
com.google.Chrome,13,1742604972,1742604985,1742604985.5027618,-18000,,
com.microsoft.VSCode,119,1742604853,1742604972,1742604972.951005,-18000,,
com.google.Chrome,48,1742604805,1742604853,1742604853.913715,-18000,,
com.microsoft.VSCode,99,1742604706,1742604805,1742604805.4296842,-18000,,
com.apple.Notes,15,1742604691,1742604706,1742604706.869714,-18000,,
com.google.Chrome,9,1742604682,1742604691,1742604691.066678,-18000,,
com.microsoft.Outlook,43,1742604639,1742604682,1742604682.115847,-18000,,
com.leomehlig.today,0,1742604639,1742604639,1742604639.7601418,-18000,,
com.google.Chrome,5,1742604634,1742604639,1742604639.351146,-18000,,
co.hinge.mobile.ios,11,1742604500,1742604511,1742604511.109006,-18000,EB445137-D7F5-57EC-87DA-1DB460D64046,"iPhone13,2"
com.apple.findmy,6,1742598601,1742598607,1742598607.303765,-18000,EB445137-D7F5-57EC-87DA-1DB460D64046,"iPhone13,2"
com.letterboxd.LetterboxdApp,53,1742597947,1742598000,1742598000.247024,-18000,EB445137-D7F5-57EC-87DA-1DB460D64046,"iPhone13,2"
co.hinge.mobile.ios,152,1742597778,1742597930,1742597930.4230509,-18000,EB445137-D7F5-57EC-87DA-1DB460D64046,"iPhone13,2"
com.google.chrome.ios,73,1742597705,1742597778,1742597778.802765,-18000,EB445137-D7F5-57EC-87DA-1DB460D64046,"iPhone13,2"
co.hinge.mobile.ios,68,1742597636,1742597704,1742597705.168415,-18000,EB445137-D7F5-57EC-87DA-1DB460D64046,"iPhone13,2"
co.hinge.mobile.ios,1,1742597635,1742597636,1742597636.386907,-18000,EB445137-D7F5-57EC-87DA-1DB460D64046,"iPhone13,2"
co.hinge.mobile.ios,962,1742596517,1742597479,1742597479.196255,-18000,EB445137-D7F5-57EC-87DA-1DB460D64046,"iPhone13,2"
com.google.Chrome,2785,1742593705,1742596490,1742596490.623215,-18000,,
com.leomehlig.today,107,1742593478,1742593585,1742593585.4730968,-18000,,
com.google.Chrome,13,1742593465,1742593478,1742593478.645365,-18000,,
com.google.chrome.ios,5,1742592156,1742592161,1742592161.336705,-18000,EB445137-D7F5-57EC-87DA-1DB460D64046,"iPhone13,2"
com.google.Gmail,15,1742589957,1742589972,1742589972.271716,-18000,EB445137-D7F5-57EC-87DA-1DB460D64046,"iPhone13,2"
com.google.Gmail,9,1742589940,1742589949,1742589950.123095,-18000,EB445137-D7F5-57EC-87DA-1DB460D64046,"iPhone13,2"
com.microsoft.Office.Outlook,18,1742589918,1742589936,1742589936.8273,-18000,EB445137-D7F5-57EC-87DA-1DB460D64046,"iPhone13,2"
com.hammerandchisel.discord,14,1742589902,1742589916,1742589916.367099,-18000,EB445137-D7F5-57EC-87DA-1DB460D64046,"iPhone13,2"
com.apple.weather,17,1742588195,1742588212,1742588212.045117,-18000,EB445137-D7F5-57EC-87DA-1DB460D64046,"iPhone13,2"
com.toyopagroup.picaboo,28,1742588133,1742588161,1742588161.292238,-18000,EB445137-D7F5-57EC-87DA-1DB460D64046,"iPhone13,2"
com.google.Chrome,801,1742575284,1742576085,1742576086.396363,-18000,,
com.google.chrome.ios,491,1742574302,1742574793,1742574793.718893,-18000,EB445137-D7F5-57EC-87DA-1DB460D64046,"iPhone13,2"
com.apple.news,56,1742574217,1742574273,1742574273.291836,-18000,EB445137-D7F5-57EC-87DA-1DB460D64046,"iPhone13,2"
com.apple.news,54,1742574128,1742574182,1742574182.432804,-18000,EB445137-D7F5-57EC-87DA-1DB460D64046,"iPhone13,2"
com.letterboxd.LetterboxdApp,79,1742573283,1742573362,1742573363.037215,-18000,EB445137-D7F5-57EC-87DA-1DB460D64046,"iPhone13,2"
com.google.chrome.ios,197,1742573086,1742573283,1742573283.5802321,-18000,EB445137-D7F5-57EC-87DA-1DB460D64046,"iPhone13,2"
com.google.chrome.ios,37,1742570264,1742570301,1742570301.467067,-18000,EB445137-D7F5-57EC-87DA-1DB460D64046,"iPhone13,2"
com.apple.CoreAuthUI,2,1742570114,1742570116,1742570116.923747,-18000,EB445137-D7F5-57EC-87DA-1DB460D64046,"iPhone13,2"
com.truebill.truebillnative,59,1742570112,1742570171,1742570171.504951,-18000,EB445137-D7F5-57EC-87DA-1DB460D64046,"iPhone13,2"
com.truebill.truebillnative,2,1742570106,1742570108,1742570108.204889,-18000,EB445137-D7F5-57EC-87DA-1DB460D64046,"iPhone13,2"
com.apple.CoreAuthUI,2,1742569382,1742569384,1742569384.549068,-18000,EB445137-D7F5-57EC-87DA-1DB460D64046,"iPhone13,2"
com.truebill.truebillnative,78,1742569378,1742569456,1742569456.590872,-18000,EB445137-D7F5-57EC-87DA-1DB460D64046,"iPhone13,2"
com.google.chrome.ios,19,1742569349,1742569368,1742569368.265841,-18000,EB445137-D7F5-57EC-87DA-1DB460D64046,"iPhone13,2"
com.google.chrome.ios,28,1742568951,1742568979,1742568979.425787,-18000,EB445137-D7F5-57EC-87DA-1DB460D64046,"iPhone13,2"
com.apple.weather,2,1742567937,1742567939,1742567939.8094559,-18000,EB445137-D7F5-57EC-87DA-1DB460D64046,"iPhone13,2"
com.apple.weather,28,1742567865,1742567893,1742567893.903799,-18000,EB445137-D7F5-57EC-87DA-1DB460D64046,"iPhone13,2"
com.apple.news,17,1742567847,1742567864,1742567864.646823,-18000,EB445137-D7F5-57EC-87DA-1DB460D64046,"iPhone13,2"
com.apple.tv,21,1742567136,1742567157,1742567157.785289,-18000,EB445137-D7F5-57EC-87DA-1DB460D64046,"iPhone13,2"
com.apple.Health,2,1742567126,1742567128,1742567128.36371,-18000,EB445137-D7F5-57EC-87DA-1DB460D64046,"iPhone13,2"
com.apple.Health,100,1742566868,1742566968,1742566969.4435,-18000,EB445137-D7F5-57EC-87DA-1DB460D64046,"iPhone13,2"
com.amazon.Amazon,57,1742566808,1742566865,1742566866.086067,-18000,EB445137-D7F5-57EC-87DA-1DB460D64046,"iPhone13,2"
com.renpho.health,2,1742566803,1742566805,1742566805.826795,-18000,EB445137-D7F5-57EC-87DA-1DB460D64046,"iPhone13,2"
com.renpho.health,42,1742566065,1742566107,1742566107.667603,-18000,EB445137-D7F5-57EC-87DA-1DB460D64046,"iPhone13,2"
com.apple.Preferences,1,1742566063,1742566064,1742566068.110616,-18000,EB445137-D7F5-57EC-87DA-1DB460D64046,"iPhone13,2"
com.apple.Health,14,1742528559,1742528573,1742528573.664031,-18000,EB445137-D7F5-57EC-87DA-1DB460D64046,"iPhone13,2"
com.thestorygraph.thestorygraph,20,1742528536,1742528556,1742528557.0341349,-18000,EB445137-D7F5-57EC-87DA-1DB460D64046,"iPhone13,2"
com.apple.calculator,2,1742528534,1742528536,1742528536.096503,-18000,EB445137-D7F5-57EC-87DA-1DB460D64046,"iPhone13,2"
com.apple.calculator,3,1742524729,1742524732,1742524732.9643822,-18000,EB445137-D7F5-57EC-87DA-1DB460D64046,"iPhone13,2"
com.apple.calculator,6,1742524722,1742524728,1742524728.362296,-18000,EB445137-D7F5-57EC-87DA-1DB460D64046,"iPhone13,2"
com.toyopagroup.picaboo,44,1742523900,1742523944,1742523944.434583,-18000,EB445137-D7F5-57EC-87DA-1DB460D64046,"iPhone13,2"
com.apple.news,2,1742523890,1742523892,1742523893.095099,-18000,EB445137-D7F5-57EC-87DA-1DB460D64046,"iPhone13,2"
com.google.Chrome,168,1742523864,1742524032,1742524032.97206,-18000,,
com.apple.MobileSMS,18,1742523846,1742523864,1742523864.2351608,-18000,,
com.google.Chrome,4959,1742518887,1742523846,1742523846.132944,-18000,,
com.apple.MobileSMS,21,1742518866,1742518887,1742518887.983676,-18000,,
com.google.Chrome,400,1742518466,1742518866,1742518866.822923,-18000,,
com.apple.MobileSMS,4,1742518462,1742518466,1742518466.1259441,-18000,,
com.google.Chrome,21,1742518441,1742518462,1742518462.488543,-18000,,
com.apple.MobileSMS,50,1742518391,1742518441,1742518441.840036,-18000,,
com.leomehlig.today,52,1742518339,1742518391,1742518391.9872298,-18000,,
com.apple.MobileSMS,45,1742518294,1742518339,1742518339.261487,-18000,,
com.google.Chrome,561,1742517733,1742518294,1742518294.6281471,-18000,,
com.apple.MobileSMS,1,1742517732,1742517733,1742517733.8009958,-18000,,
com.google.Chrome,33,1742517699,1742517732,1742517732.6408901,-18000,,
com.apple.MobileSMS,15,1742517684,1742517699,1742517699.4273782,-18000,,
com.google.Chrome,1,1742517683,1742517684,1742517684.909359,-18000,,
com.apple.MobileSMS,1,1742517682,1742517683,1742517683.886852,-18000,,
com.google.Chrome,2,1742517680,1742517682,1742517682.3310761,-18000,,
com.apple.MobileSMS,9,1742517671,1742517680,1742517680.897606,-18000,,
com.google.Chrome,1762,1742515909,1742517671,1742517671.847296,-18000,,
com.google.Chrome,948,1742514915,1742515863,1742515863.898456,-18000,,
com.google.Chrome,601,1742514131,1742514732,1742514732.5145102,-18000,,
com.microsoft.Outlook,15,1742514116,1742514131,1742514131.741266,-18000,,
com.apple.news,6,1742511740,1742511746,1742511747.225747,-18000,EB445137-D7F5-57EC-87DA-1DB460D64046,"iPhone13,2"
com.apple.mobilephone,27,1742511703,1742511730,1742511731.088177,-18000,EB445137-D7F5-57EC-87DA-1DB460D64046,"iPhone13,2"
com.apple.MobileSMS,5,1742511698,1742511703,1742511703.43285,-18000,EB445137-D7F5-57EC-87DA-1DB460D64046,"iPhone13,2"
com.apple.mobileslideshow,13,1742511685,1742511698,1742511699.222342,-18000,EB445137-D7F5-57EC-87DA-1DB460D64046,"iPhone13,2"
com.apple.MobileSMS,117,1742511568,1742511685,1742511685.951377,-18000,EB445137-D7F5-57EC-87DA-1DB460D64046,"iPhone13,2"
com.apple.mobilephone,36,1742511532,1742511568,1742511569.093081,-18000,EB445137-D7F5-57EC-87DA-1DB460D64046,"iPhone13,2"
com.apple.MobileSMS,6,1742511526,1742511532,1742511532.555215,-18000,EB445137-D7F5-57EC-87DA-1DB460D64046,"iPhone13,2"
com.apple.mobilephone,5,1742511521,1742511526,1742511526.8458428,-18000,EB445137-D7F5-57EC-87DA-1DB460D64046,"iPhone13,2"
com.apple.MobileSMS,5,1742511516,1742511521,1742511521.509206,-18000,EB445137-D7F5-57EC-87DA-1DB460D64046,"iPhone13,2"
com.apple.mobilephone,30,1742511486,1742511516,1742511517.077005,-18000,EB445137-D7F5-57EC-87DA-1DB460D64046,"iPhone13,2"
com.apple.MobileSMS,351,1742511135,1742511486,1742511486.165326,-18000,EB445137-D7F5-57EC-87DA-1DB460D64046,"iPhone13,2"
com.apple.mobilephone,85,1742511050,1742511135,1742511135.439357,-18000,EB445137-D7F5-57EC-87DA-1DB460D64046,"iPhone13,2"
com.apple.MobileSMS,6,1742511044,1742511050,1742511051.0029101,-18000,EB445137-D7F5-57EC-87DA-1DB460D64046,"iPhone13,2"
com.apple.mobilephone,38,1742511006,1742511044,1742511044.373548,-18000,EB445137-D7F5-57EC-87DA-1DB460D64046,"iPhone13,2"
com.apple.MobileSMS,15,1742510991,1742511006,1742511007.138898,-18000,EB445137-D7F5-57EC-87DA-1DB460D64046,"iPhone13,2"
com.apple.news,309,1742510680,1742510989,1742510989.599073,-18000,EB445137-D7F5-57EC-87DA-1DB460D64046,"iPhone13,2"
com.apple.mobileslideshow,174,1742510430,1742510604,1742510604.691531,-18000,EB445137-D7F5-57EC-87DA-1DB460D64046,"iPhone13,2"
com.apple.MobileSMS,0,1742510430,1742510430,1742510430.5579848,-18000,EB445137-D7F5-57EC-87DA-1DB460D64046,"iPhone13,2"
com.apple.MobileSMS,4,1742509182,1742509186,1742509186.6722898,-18000,EB445137-D7F5-57EC-87DA-1DB460D64046,"iPhone13,2"
com.truebill.truebillnative,0,1742509182,1742509182,1742509183.9199982,-18000,EB445137-D7F5-57EC-87DA-1DB460D64046,"iPhone13,2"
com.microsoft.Outlook,41,1742509145,1742509186,1742509186.833959,-18000,,
com.apple.findmy,13,1742509132,1742509145,1742509145.990077,-18000,,
com.microsoft.Outlook,6,1742509126,1742509132,1742509133.031344,-18000,,
com.apple.Passwords,2,1742509124,1742509126,1742509126.402282,-18000,,
com.apple.iCal,1,1742509123,1742509124,1742509124.747827,-18000,,
com.google.Chrome,3,1742509120,1742509123,1742509124.030031,-18000,,
com.truebill.truebillnative,103,1742509038,1742509141,1742509142.1399589,-18000,EB445137-D7F5-57EC-87DA-1DB460D64046,"iPhone13,2"
com.apple.Notes,88,1742509032,1742509120,1742509120.957015,-18000,,
com.apple.calculator,66,1742508972,1742509038,1742509038.35844,-18000,EB445137-D7F5-57EC-87DA-1DB460D64046,"iPhone13,2"
com.google.Chrome,168,1742508864,1742509032,1742509032.64733,-18000,,
com.apple.iCal,19,1742508827,1742508846,1742508846.2765431,-18000,,
com.google.Chrome,51,1742508776,1742508827,1742508827.3053699,-18000,,
com.apple.Notes,66,1742508710,1742508776,1742508776.64031,-18000,,
com.apple.CoreAuthUI,2,1742508639,1742508641,1742508642.03989,-18000,EB445137-D7F5-57EC-87DA-1DB460D64046,"iPhone13,2"
com.truebill.truebillnative,255,1742508621,1742508876,1742508876.270761,-18000,EB445137-D7F5-57EC-87DA-1DB460D64046,"iPhone13,2"
com.google.Chrome,105,1742508605,1742508710,1742508710.529923,-18000,,
com.apple.Passwords,8,1742508597,1742508605,1742508605.930057,-18000,,
com.google.Chrome,1,1742508596,1742508597,1742508597.351763,-18000,,
com.apple.Passwords,1,1742508595,1742508596,1742508596.8323278,-18000,,
com.google.Chrome,4,1742508591,1742508595,1742508595.648078,-18000,,
com.apple.Passwords,27,1742508564,1742508591,1742508591.531734,-18000,,
com.apple.CoreAuthUI,22,1742508547,1742508569,1742508569.29361,-18000,EB445137-D7F5-57EC-87DA-1DB460D64046,"iPhone13,2"
com.truebill.truebillnative,35,1742508534,1742508569,1742508569.226655,-18000,EB445137-D7F5-57EC-87DA-1DB460D64046,"iPhone13,2"
com.apple.CoreAuthUI,2,1742508425,1742508427,1742508427.255142,-18000,EB445137-D7F5-57EC-87DA-1DB460D64046,"iPhone13,2"
com.ally.MobileBanking,129,1742508403,1742508532,1742508532.805554,-18000,EB445137-D7F5-57EC-87DA-1DB460D64046,"iPhone13,2"
com.apple.CoreAuthUI,2,1742508386,1742508388,1742508388.123394,-18000,EB445137-D7F5-57EC-87DA-1DB460D64046,"iPhone13,2"
com.apple.CoreAuthUI,2,1742508380,1742508382,1742508382.9252548,-18000,EB445137-D7F5-57EC-87DA-1DB460D64046,"iPhone13,2"
com.ally.MobileBanking,44,1742508358,1742508402,1742508402.785833,-18000,EB445137-D7F5-57EC-87DA-1DB460D64046,"iPhone13,2"
com.apple.CoreAuthUI,2,1742508193,1742508195,1742508195.5276809,-18000,EB445137-D7F5-57EC-87DA-1DB460D64046,"iPhone13,2"
com.robinhood.release.Robinhood,163,1742508183,1742508346,1742508346.456855,-18000,EB445137-D7F5-57EC-87DA-1DB460D64046,"iPhone13,2"
com.apple.mobileslideshow,4,1742508176,1742508180,1742508180.691677,-18000,EB445137-D7F5-57EC-87DA-1DB460D64046,"iPhone13,2"
com.apple.mobileslideshow,87,1742508060,1742508147,1742508148.077424,-18000,EB445137-D7F5-57EC-87DA-1DB460D64046,"iPhone13,2"
com.hammerandchisel.discord,0,1742508060,1742508060,1742508061.1248422,-18000,EB445137-D7F5-57EC-87DA-1DB460D64046,"iPhone13,2"
com.google.Chrome,541,1742508023,1742508564,1742508564.661283,-18000,,
com.apple.iCal,119,1742507904,1742508023,1742508023.3508248,-18000,,
com.google.Chrome,24,1742507880,1742507904,1742507904.610331,-18000,,
com.apple.iCal,24,1742507856,1742507880,1742507880.369216,-18000,,
com.google.Chrome,3,1742507853,1742507856,1742507856.4972758,-18000,,
com.apple.iCal,6,1742507847,1742507853,1742507853.937717,-18000,,
com.google.Chrome,4,1742507843,1742507847,1742507847.3604379,-18000,,
com.apple.iCal,9,1742507834,1742507843,1742507843.397695,-18000,,
com.google.Chrome,9,1742507825,1742507834,1742507834.263495,-18000,,
com.apple.iCal,17,1742507808,1742507825,1742507825.2134051,-18000,,
com.google.Chrome,15,1742507793,1742507808,1742507808.658253,-18000,,
com.apple.iCal,11,1742507782,1742507793,1742507793.936119,-18000,,
com.google.Chrome,6,1742507776,1742507782,1742507782.31235,-18000,,
com.apple.iCal,42,1742507734,1742507776,1742507776.940896,-18000,,
com.google.Chrome,4,1742507730,1742507734,1742507734.690734,-18000,,
com.apple.iCal,1,1742507729,1742507730,1742507730.4794068,-18000,,
com.google.Chrome,19,1742507710,1742507729,1742507729.207979,-18000,,
com.leomehlig.today,97,1742507613,1742507710,1742507710.275619,-18000,,
com.google.Chrome,22,1742507591,1742507613,1742507613.285912,-18000,,
com.hammerandchisel.discord,30,1742507469,1742507499,1742507500.48974,-18000,EB445137-D7F5-57EC-87DA-1DB460D64046,"iPhone13,2"
com.microsoft.Office.Outlook,1,1742507468,1742507469,1742507469.603104,-18000,EB445137-D7F5-57EC-87DA-1DB460D64046,"iPhone13,2"
com.microsoft.Office.Outlook,34,1742507429,1742507463,1742507463.462601,-18000,EB445137-D7F5-57EC-87DA-1DB460D64046,"iPhone13,2"
com.google.Gmail,4,1742507417,1742507421,1742507423.4865432,-18000,EB445137-D7F5-57EC-87DA-1DB460D64046,"iPhone13,2"
com.apple.mobileslideshow,1,1742507416,1742507417,1742507421.745342,-18000,EB445137-D7F5-57EC-87DA-1DB460D64046,"iPhone13,2"
com.leomehlig.today,180,1742507401,1742507581,1742507581.047322,-18000,,
com.google.Chrome,23,1742507378,1742507401,1742507401.161495,-18000,,
com.leomehlig.today,64,1742507314,1742507378,1742507378.519901,-18000,,
com.apple.findmy,7,1742507307,1742507314,1742507314.9939299,-18000,,
com.leomehlig.today,25,1742507282,1742507307,1742507307.45033,-18000,,
com.google.Chrome,39,1742507243,1742507282,1742507282.173301,-18000,,
com.leomehlig.today,4,1742507239,1742507243,1742507243.066821,-18000,,
com.apple.mobileslideshow,271,1742506989,1742507260,1742507260.8748689,-18000,EB445137-D7F5-57EC-87DA-1DB460D64046,"iPhone13,2"
com.apple.findmy,2,1742506987,1742506989,1742506991.173541,-18000,EB445137-D7F5-57EC-87DA-1DB460D64046,"iPhone13,2"
com.apple.MobileSMS,265,1742506974,1742507239,1742507239.564659,-18000,,
com.leomehlig.today,61,1742506913,1742506974,1742506974.333199,-18000,,
com.google.Chrome,2607,1742504306,1742506913,1742506913.4308739,-18000,,
com.leomehlig.today,10,1742504296,1742504306,1742504306.153153,-18000,,
com.google.Chrome,1044,1742503252,1742504296,1742504296.318416,-18000,,
com.apple.news,153,1742503099,1742503252,1742503252.477027,-18000,,
com.google.Chrome,250,1742502849,1742503099,1742503099.195832,-18000,,
com.leomehlig.today,27,1742502822,1742502849,1742502849.908836,-18000,,
com.google.Chrome,1614,1742501208,1742502822,1742502822.8078651,-18000,,
com.leomehlig.today,19,1742501139,1742501158,1742501158.40095,-18000,,
com.google.Chrome,10,1742501129,1742501139,1742501139.421073,-18000,,
com.apple.findmy,6,1742500584,1742500590,1742500590.551475,-18000,EB445137-D7F5-57EC-87DA-1DB460D64046,"iPhone13,2"
com.apple.findmy,5,1742500045,1742500050,1742500050.69123,-18000,EB445137-D7F5-57EC-87DA-1DB460D64046,"iPhone13,2"
com.google.Chrome,617,1742499918,1742500535,1742500535.9194589,-18000,,
com.apple.findmy,71,1742499866,1742499937,1742499937.895854,-18000,EB445137-D7F5-57EC-87DA-1DB460D64046,"iPhone13,2"
com.google.Chrome,1032,1742498516,1742499548,1742499548.899029,-18000,,
com.leomehlig.today,56,1742498460,1742498516,1742498516.438523,-18000,,
com.apple.iCal,6,1742498454,1742498460,1742498460.508934,-18000,,
com.leomehlig.today,214,1742498240,1742498454,1742498454.6192489,-18000,,
com.google.Chrome,29,1742498211,1742498240,1742498240.266782,-18000,,
com.leomehlig.today,4,1742498207,1742498211,1742498211.072311,-18000,,
com.apple.iCal,36,1742498171,1742498207,1742498207.230116,-18000,,
com.leomehlig.today,213,1742497958,1742498171,1742498171.34945,-18000,,
com.google.Chrome,6,1742497952,1742497958,1742497959.195535,-18000,,
com.apple.news,6,1742495728,1742495734,1742495734.5989141,-18000,EB445137-D7F5-57EC-87DA-1DB460D64046,"iPhone13,2"
com.apple.news,36,1742494097,1742494133,1742494133.919962,-18000,EB445137-D7F5-57EC-87DA-1DB460D64046,"iPhone13,2"
com.microsoft.Office.Outlook,7,1742494067,1742494074,1742494074.917181,-18000,EB445137-D7F5-57EC-87DA-1DB460D64046,"iPhone13,2"
com.apple.InCallService,19,1742493922,1742493941,1742493941.62,-18000,EB445137-D7F5-57EC-87DA-1DB460D64046,"iPhone13,2"
com.apple.mobilephone,2,1742493920,1742493922,1742493922.424532,-18000,EB445137-D7F5-57EC-87DA-1DB460D64046,"iPhone13,2"
com.google.chrome.ios,2,1742493918,1742493920,1742493920.60587,-18000,EB445137-D7F5-57EC-87DA-1DB460D64046,"iPhone13,2"
com.google.chrome.ios,15,1742493102,1742493117,1742493117.45133,-18000,EB445137-D7F5-57EC-87DA-1DB460D64046,"iPhone13,2"
com.apple.mobilephone,2,1742493100,1742493102,1742493102.853919,-18000,EB445137-D7F5-57EC-87DA-1DB460D64046,"iPhone13,2"
com.apple.mobilephone,2,1742493088,1742493090,1742493090.267134,-18000,EB445137-D7F5-57EC-87DA-1DB460D64046,"iPhone13,2"
com.apple.InCallService,11,1742493077,1742493088,1742493089.180115,-18000,EB445137-D7F5-57EC-87DA-1DB460D64046,"iPhone13,2"
com.apple.mobilephone,3,1742493074,1742493077,1742493077.127157,-18000,EB445137-D7F5-57EC-87DA-1DB460D64046,"iPhone13,2"
com.apple.MobileSMS,1,1742493073,1742493074,1742493074.81763,-18000,EB445137-D7F5-57EC-87DA-1DB460D64046,"iPhone13,2"
com.google.chrome.ios,1,1742493072,1742493073,1742493073.754766,-18000,EB445137-D7F5-57EC-87DA-1DB460D64046,"iPhone13,2"
com.google.chrome.ios,288,1742492721,1742493009,1742493009.9551458,-18000,EB445137-D7F5-57EC-87DA-1DB460D64046,"iPhone13,2"
com.google.chrome.ios,79,1742492571,1742492650,1742492650.890696,-18000,EB445137-D7F5-57EC-87DA-1DB460D64046,"iPhone13,2"
com.apple.PosterBoard,0,1742492571,1742492571,1742492571.9145842,-18000,EB445137-D7F5-57EC-87DA-1DB460D64046,"iPhone13,2"
com.google.chrome.ios,274,1742492291,1742492565,1742492565.261435,-18000,EB445137-D7F5-57EC-87DA-1DB460D64046,"iPhone13,2"
com.google.chrome.ios,98,1742491930,1742492028,1742492028.955071,-18000,EB445137-D7F5-57EC-87DA-1DB460D64046,"iPhone13,2"
com.strava.stravaride,59,1742491870,1742491929,1742491929.140326,-18000,EB445137-D7F5-57EC-87DA-1DB460D64046,"iPhone13,2"
com.apple.MobileSMS,14,1742491841,1742491855,1742491855.8877401,-18000,EB445137-D7F5-57EC-87DA-1DB460D64046,"iPhone13,2"
com.apple.MobileSMS,10,1742491827,1742491837,1742491837.913758,-18000,EB445137-D7F5-57EC-87DA-1DB460D64046,"iPhone13,2"
com.apple.MobileSMS,2,1742491825,1742491827,1742491827.7268472,-18000,EB445137-D7F5-57EC-87DA-1DB460D64046,"iPhone13,2"
com.apple.MobileSMS,0,1742491823,1742491823,1742491824.0278249,-18000,EB445137-D7F5-57EC-87DA-1DB460D64046,"iPhone13,2"
com.apple.MobileSMS,9,1742491495,1742491504,1742491504.598213,-18000,EB445137-D7F5-57EC-87DA-1DB460D64046,"iPhone13,2"
com.apple.MobileSMS,5,1742491472,1742491477,1742491477.622477,-18000,EB445137-D7F5-57EC-87DA-1DB460D64046,"iPhone13,2"
com.google.chrome.ios,1,1742491471,1742491472,1742491472.736178,-18000,EB445137-D7F5-57EC-87DA-1DB460D64046,"iPhone13,2"
com.google.chrome.ios,28,1742491067,1742491095,1742491095.840899,-18000,EB445137-D7F5-57EC-87DA-1DB460D64046,"iPhone13,2"
com.apple.MobileSMS,4,1742491063,1742491067,1742491068.010253,-18000,EB445137-D7F5-57EC-87DA-1DB460D64046,"iPhone13,2"
com.apple.MobileSMS,11,1742491046,1742491057,1742491057.343812,-18000,EB445137-D7F5-57EC-87DA-1DB460D64046,"iPhone13,2"
com.toyopagroup.picaboo,11,1742490067,1742490078,1742490078.4110909,-18000,EB445137-D7F5-57EC-87DA-1DB460D64046,"iPhone13,2"
com.google.chrome.ios,0,1742490067,1742490067,1742490067.9458408,-18000,EB445137-D7F5-57EC-87DA-1DB460D64046,"iPhone13,2"
com.google.chrome.ios,79,1742489511,1742489590,1742489590.8819861,-18000,EB445137-D7F5-57EC-87DA-1DB460D64046,"iPhone13,2"
com.apple.mobilecal,55,1742488216,1742488271,1742488271.337729,-18000,EB445137-D7F5-57EC-87DA-1DB460D64046,"iPhone13,2"
com.apple.MobileSMS,38,1742488175,1742488213,1742488213.996663,-18000,EB445137-D7F5-57EC-87DA-1DB460D64046,"iPhone13,2"
com.apple.MobileSMS,2,1742488172,1742488174,1742488174.9892092,-18000,EB445137-D7F5-57EC-87DA-1DB460D64046,"iPhone13,2"
com.apple.MobileSMS,3,1742483739,1742483742,1742483742.332576,-18000,EB445137-D7F5-57EC-87DA-1DB460D64046,"iPhone13,2"
com.apple.MobileSMS,53,1742483658,1742483711,1742483711.619997,-18000,EB445137-D7F5-57EC-87DA-1DB460D64046,"iPhone13,2"
com.apple.findmy,48,1742481853,1742481901,1742481901.265102,-18000,EB445137-D7F5-57EC-87DA-1DB460D64046,"iPhone13,2"
com.apple.MobileSMS,4,1742481849,1742481853,1742481853.3914042,-18000,EB445137-D7F5-57EC-87DA-1DB460D64046,"iPhone13,2"
com.apple.MobileSMS,20,1742481056,1742481076,1742481076.6191921,-18000,EB445137-D7F5-57EC-87DA-1DB460D64046,"iPhone13,2"
com.google.Chrome,689,1742480302,1742480991,1742480991.8711948,-18000,,
com.renpho.health,3,1742480196,1742480199,1742480199.027542,-18000,EB445137-D7F5-57EC-87DA-1DB460D64046,"iPhone13,2"
com.renpho.health,39,1742479207,1742479246,1742479246.51124,-18000,EB445137-D7F5-57EC-87DA-1DB460D64046,"iPhone13,2"
com.apple.Health,20,1742479125,1742479145,1742479145.2213511,-18000,EB445137-D7F5-57EC-87DA-1DB460D64046,"iPhone13,2"
com.apple.Health,35,1742442819,1742442854,1742442854.6153169,-18000,EB445137-D7F5-57EC-87DA-1DB460D64046,"iPhone13,2"
com.apple.journal,0,1742442819,1742442819,1742442819.929085,-18000,EB445137-D7F5-57EC-87DA-1DB460D64046,"iPhone13,2"
com.apple.journal,803,1742442014,1742442817,1742442817.17365,-18000,EB445137-D7F5-57EC-87DA-1DB460D64046,"iPhone13,2"
com.apple.CoreAuthUI,4,1742440771,1742440775,1742440775.422199,-18000,EB445137-D7F5-57EC-87DA-1DB460D64046,"iPhone13,2"
com.apple.journal,1241,1742440768,1742442009,1742442010.128717,-18000,EB445137-D7F5-57EC-87DA-1DB460D64046,"iPhone13,2"
com.apple.mobiletimer,14,1742440748,1742440762,1742440762.728953,-18000,EB445137-D7F5-57EC-87DA-1DB460D64046,"iPhone13,2"
com.apple.news,151,1742440587,1742440738,1742440738.9931521,-18000,EB445137-D7F5-57EC-87DA-1DB460D64046,"iPhone13,2"
com.facebook.Facebook,170,1742440404,1742440574,1742440574.172504,-18000,EB445137-D7F5-57EC-87DA-1DB460D64046,"iPhone13,2"
com.apple.weather,30,1742439768,1742439798,1742439798.738344,-18000,EB445137-D7F5-57EC-87DA-1DB460D64046,"iPhone13,2"
com.apple.weather,19,1742439746,1742439765,1742439765.5533361,-18000,EB445137-D7F5-57EC-87DA-1DB460D64046,"iPhone13,2"
com.toyopagroup.picaboo,13,1742439716,1742439729,1742439730.013266,-18000,EB445137-D7F5-57EC-87DA-1DB460D64046,"iPhone13,2"
com.apple.Health,3,1742439710,1742439713,1742439713.654007,-18000,EB445137-D7F5-57EC-87DA-1DB460D64046,"iPhone13,2"
com.google.Chrome,4,1742439643,1742439647,1742439647.5973458,-18000,,
com.apple.news,301,1742439342,1742439643,1742439643.5883799,-18000,,
com.apple.Health,75,1742437420,1742437495,1742437496.692035,-18000,EB445137-D7F5-57EC-87DA-1DB460D64046,"iPhone13,2"
com.myfitnesspal.mfp,72,1742437348,1742437420,1742437420.5013251,-18000,EB445137-D7F5-57EC-87DA-1DB460D64046,"iPhone13,2"
com.apple.Health,58,1742437287,1742437345,1742437345.242155,-18000,EB445137-D7F5-57EC-87DA-1DB460D64046,"iPhone13,2"
com.apple.PosterBoard,0,1742437282,1742437282,1742437283.271038,-18000,EB445137-D7F5-57EC-87DA-1DB460D64046,"iPhone13,2"
com.google.Chrome,2524,1742436818,1742439342,1742439342.242995,-18000,,
com.apple.iCal,37,1742436781,1742436818,1742436818.662688,-18000,,
com.google.Chrome,1,1742436780,1742436781,1742436782.007659,-18000,,
com.apple.iCal,4,1742436776,1742436780,1742436780.223378,-18000,,
com.google.Chrome,2,1742436774,1742436776,1742436776.538433,-18000,,
com.apple.iCal,2,1742436772,1742436774,1742436774.414238,-18000,,
com.google.Chrome,8,1742436764,1742436772,1742436772.914254,-18000,,
com.apple.iCal,7,1742436757,1742436764,1742436764.4654,-18000,,
com.google.Chrome,1,1742436756,1742436757,1742436757.7254128,-18000,,
com.apple.iCal,4,1742436752,1742436756,1742436756.984249,-18000,,
com.google.Chrome,1,1742436751,1742436752,1742436752.731905,-18000,,
com.apple.iCal,14,1742436737,1742436751,1742436751.835741,-18000,,
com.google.Chrome,2,1742436735,1742436737,1742436737.106264,-18000,,
com.apple.iCal,2,1742436733,1742436735,1742436735.351291,-18000,,
com.google.Chrome,3,1742436730,1742436733,1742436733.8894339,-18000,,
com.apple.iCal,2,1742436728,1742436730,1742436730.263287,-18000,,
com.google.Chrome,36,1742436692,1742436728,1742436728.339385,-18000,,
com.microsoft.Outlook,48,1742436644,1742436692,1742436692.517786,-18000,,
com.google.Chrome,232,1742436412,1742436644,1742436644.740745,-18000,,
com.microsoft.Outlook,4,1742436408,1742436412,1742436412.282145,-18000,,
com.google.Chrome,1,1742436407,1742436408,1742436408.570739,-18000,,
com.microsoft.Outlook,7,1742436400,1742436407,1742436407.454764,-18000,,
com.google.Chrome,92,1742436308,1742436400,1742436400.2387738,-18000,,
com.microsoft.Outlook,74,1742436234,1742436308,1742436308.0646029,-18000,,
com.google.Chrome,19,1742436215,1742436234,1742436234.732765,-18000,,
com.apple.MobileSMS,162,1742436053,1742436215,1742436215.241015,-18000,,
com.google.Chrome,1679,1742434374,1742436053,1742436053.259742,-18000,,
com.apple.Notes,34,1742434340,1742434374,1742434374.505579,-18000,,
com.google.Chrome,36,1742434304,1742434340,1742434340.8463578,-18000,,
com.apple.news,344,1742433960,1742434304,1742434305.407789,-18000,,
com.google.Chrome,13,1742433947,1742433960,1742433960.960308,-18000,,
com.apple.MobileSMS,44,1742432940,1742432984,1742432984.1655931,-18000,EB445137-D7F5-57EC-87DA-1DB460D64046,"iPhone13,2"
com.microsoft.Office.Outlook,5,1742432921,1742432926,1742432926.4804049,-18000,EB445137-D7F5-57EC-87DA-1DB460D64046,"iPhone13,2"
com.google.chrome.ios,114,1742432803,1742432917,1742432917.546509,-18000,EB445137-D7F5-57EC-87DA-1DB460D64046,"iPhone13,2"
com.toyopagroup.picaboo,92,1742432696,1742432788,1742432788.5467958,-18000,EB445137-D7F5-57EC-87DA-1DB460D64046,"iPhone13,2"
com.google.Chrome,25,1742431939,1742431964,1742431965.208551,-18000,,
com.apple.finder,17,1742431922,1742431939,1742431939.335266,-18000,,
com.electron.carta,1,1742431921,1742431922,1742431922.705174,-18000,,
com.google.Chrome,233,1742431688,1742431921,1742431921.383638,-18000,,
com.microsoft.VSCode,255,1742431375,1742431630,1742431630.706892,-18000,,
com.apple.finder,215,1742431160,1742431375,1742431375.957761,-18000,,
com.microsoft.VSCode,7,1742431153,1742431160,1742431160.3360682,-18000,,
com.apple.finder,39,1742431114,1742431153,1742431153.904556,-18000,,
com.microsoft.VSCode,7,1742431107,1742431114,1742431114.3904948,-18000,,
com.apple.finder,599,1742430508,1742431107,1742431107.0872688,-18000,,
com.microsoft.VSCode,15,1742430493,1742430508,1742430508.8852692,-18000,,
com.apple.finder,217,1742430276,1742430493,1742430493.172532,-18000,,
com.electron.carta,4,1742430272,1742430276,1742430276.10713,-18000,,
com.apple.finder,117,1742430155,1742430272,1742430272.710685,-18000,,
com.microsoft.VSCode,1,1742430154,1742430155,1742430155.557421,-18000,,
com.electron.carta,8,1742430146,1742430154,1742430154.116477,-18000,,
com.jinzhenyu.ruler,2,1742430144,1742430146,1742430146.667636,-18000,,
com.electron.carta,12,1742430132,1742430144,1742430144.9821591,-18000,,
com.jinzhenyu.ruler,1,1742430131,1742430132,1742430132.413481,-18000,,
com.electron.carta,5,1742430126,1742430131,1742430131.04532,-18000,,
com.apple.finder,10,1742430116,1742430126,1742430126.83927,-18000,,
com.apple.Notes,175,1742429941,1742430116,1742430116.564897,-18000,,
com.apple.finder,61,1742429880,1742429941,1742429941.317416,-18000,,
com.electron.carta,429,1742429451,1742429880,1742429880.179086,-18000,,
com.apple.finder,31,1742429420,1742429451,1742429451.491152,-18000,,
com.google.Chrome,8,1742429412,1742429420,1742429420.881789,-18000,,
com.toyopagroup.picaboo,56,1742429067,1742429123,1742429123.930027,-18000,EB445137-D7F5-57EC-87DA-1DB460D64046,"iPhone13,2"
com.toyopagroup.picaboo,26,1742428946,1742428972,1742428972.699918,-18000,EB445137-D7F5-57EC-87DA-1DB460D64046,"iPhone13,2"
com.google.chrome.ios,20,1742428838,1742428858,1742428859.019487,-18000,EB445137-D7F5-57EC-87DA-1DB460D64046,"iPhone13,2"
com.apple.MobileSMS,5,1742428833,1742428838,1742428838.113013,-18000,EB445137-D7F5-57EC-87DA-1DB460D64046,"iPhone13,2"
com.apple.news,0,1742428833,1742428833,1742428833.781989,-18000,EB445137-D7F5-57EC-87DA-1DB460D64046,"iPhone13,2"
com.apple.news,48,1742426075,1742426123,1742426123.845824,-18000,EB445137-D7F5-57EC-87DA-1DB460D64046,"iPhone13,2"
com.apple.CoreAuthUI,2,1742426023,1742426025,1742426025.648635,-18000,EB445137-D7F5-57EC-87DA-1DB460D64046,"iPhone13,2"
com.truebill.truebillnative,53,1742426020,1742426073,1742426073.622891,-18000,EB445137-D7F5-57EC-87DA-1DB460D64046,"iPhone13,2"
com.strava.stravaride,89,1742425927,1742426016,1742426016.8269072,-18000,EB445137-D7F5-57EC-87DA-1DB460D64046,"iPhone13,2"
com.apple.weather,57,1742425850,1742425907,1742425907.219145,-18000,EB445137-D7F5-57EC-87DA-1DB460D64046,"iPhone13,2"
com.apple.findmy,64,1742425786,1742425850,1742425851.05907,-18000,EB445137-D7F5-57EC-87DA-1DB460D64046,"iPhone13,2"
com.apple.MobileSMS,3,1742425237,1742425240,1742425241.024413,-18000,EB445137-D7F5-57EC-87DA-1DB460D64046,"iPhone13,2"
com.microsoft.Office.Outlook,3,1742425234,1742425237,1742425237.081419,-18000,EB445137-D7F5-57EC-87DA-1DB460D64046,"iPhone13,2"
com.markhambly.APOD,49,1742425181,1742425230,1742425231.05789,-18000,EB445137-D7F5-57EC-87DA-1DB460D64046,"iPhone13,2"
com.apple.findmy,7,1742425167,1742425174,1742425174.9882941,-18000,EB445137-D7F5-57EC-87DA-1DB460D64046,"iPhone13,2"
com.apple.news,107,1742425059,1742425166,1742425166.496935,-18000,EB445137-D7F5-57EC-87DA-1DB460D64046,"iPhone13,2"
com.apple.findmy,24,1742425022,1742425046,1742425046.5208611,-18000,EB445137-D7F5-57EC-87DA-1DB460D64046,"iPhone13,2"
com.letterboxd.LetterboxdApp,209,1742424808,1742425017,1742425017.50757,-18000,EB445137-D7F5-57EC-87DA-1DB460D64046,"iPhone13,2"
com.google.chrome.ios,74,1742424730,1742424804,1742424804.362173,-18000,EB445137-D7F5-57EC-87DA-1DB460D64046,"iPhone13,2"
com.apple.findmy,17,1742424626,1742424643,1742424643.927145,-18000,EB445137-D7F5-57EC-87DA-1DB460D64046,"iPhone13,2"
com.apple.weather,55,1742424476,1742424531,1742424531.158035,-18000,EB445137-D7F5-57EC-87DA-1DB460D64046,"iPhone13,2"
com.apple.findmy,18,1742424446,1742424464,1742424464.180956,-18000,EB445137-D7F5-57EC-87DA-1DB460D64046,"iPhone13,2"
com.microsoft.Office.Outlook,6,1742424412,1742424418,1742424418.434195,-18000,EB445137-D7F5-57EC-87DA-1DB460D64046,"iPhone13,2"
com.apple.findmy,9,1742424327,1742424336,1742424336.982233,-18000,EB445137-D7F5-57EC-87DA-1DB460D64046,"iPhone13,2"
com.apple.findmy,64,1742424018,1742424082,1742424082.416827,-18000,EB445137-D7F5-57EC-87DA-1DB460D64046,"iPhone13,2"
com.toyopagroup.picaboo,1,1742424017,1742424018,1742424021.01974,-18000,EB445137-D7F5-57EC-87DA-1DB460D64046,"iPhone13,2"
com.toyopagroup.picaboo,11,1742423646,1742423657,1742423657.75281,-18000,EB445137-D7F5-57EC-87DA-1DB460D64046,"iPhone13,2"
com.apple.mobileslideshow,83,1742423559,1742423642,1742423642.8634539,-18000,EB445137-D7F5-57EC-87DA-1DB460D64046,"iPhone13,2"
com.toyopagroup.picaboo,64,1742423495,1742423559,1742423559.480569,-18000,EB445137-D7F5-57EC-87DA-1DB460D64046,"iPhone13,2"
com.google.chrome.ios,5,1742423490,1742423495,1742423495.687815,-18000,EB445137-D7F5-57EC-87DA-1DB460D64046,"iPhone13,2"
com.toyopagroup.picaboo,8,1742423482,1742423490,1742423490.686195,-18000,EB445137-D7F5-57EC-87DA-1DB460D64046,"iPhone13,2"
com.apple.CoreAuthUI,1,1742423389,1742423390,1742423391.006865,-18000,EB445137-D7F5-57EC-87DA-1DB460D64046,"iPhone13,2"
com.google.chrome.ios,116,1742423363,1742423479,1742423479.513286,-18000,EB445137-D7F5-57EC-87DA-1DB460D64046,"iPhone13,2"
com.apple.CoreAuthUI,2,1742423357,1742423359,1742423359.824345,-18000,EB445137-D7F5-57EC-87DA-1DB460D64046,"iPhone13,2"
com.google.chrome.ios,63,1742423299,1742423362,1742423362.744277,-18000,EB445137-D7F5-57EC-87DA-1DB460D64046,"iPhone13,2"
com.apple.MobileSMS,2,1742423293,1742423295,1742423295.268491,-18000,EB445137-D7F5-57EC-87DA-1DB460D64046,"iPhone13,2"
com.apple.findmy,7,1742423282,1742423289,1742423289.4124742,-18000,EB445137-D7F5-57EC-87DA-1DB460D64046,"iPhone13,2"
com.apple.CoreAuthUI,2,1742423246,1742423248,1742423248.868754,-18000,EB445137-D7F5-57EC-87DA-1DB460D64046,"iPhone13,2"
com.truebill.truebillnative,31,1742423243,1742423274,1742423274.857573,-18000,EB445137-D7F5-57EC-87DA-1DB460D64046,"iPhone13,2"
com.apple.MobileSMS,19,1742423224,1742423243,1742423243.131036,-18000,EB445137-D7F5-57EC-87DA-1DB460D64046,"iPhone13,2"
com.apple.MobileSMS,4,1742423214,1742423218,1742423218.344221,-18000,EB445137-D7F5-57EC-87DA-1DB460D64046,"iPhone13,2"
com.apple.weather,16,1742423198,1742423214,1742423215.072839,-18000,EB445137-D7F5-57EC-87DA-1DB460D64046,"iPhone13,2"
com.apple.MobileSMS,18,1742423173,1742423191,1742423191.5785909,-18000,EB445137-D7F5-57EC-87DA-1DB460D64046,"iPhone13,2"
com.apple.mobilecal,1,1742423171,1742423172,1742423173.014769,-18000,EB445137-D7F5-57EC-87DA-1DB460D64046,"iPhone13,2"
com.apple.mobilecal,15,1742423155,1742423170,1742423170.757304,-18000,EB445137-D7F5-57EC-87DA-1DB460D64046,"iPhone13,2"
com.apple.MobileSMS,5,1742423140,1742423145,1742423145.595463,-18000,EB445137-D7F5-57EC-87DA-1DB460D64046,"iPhone13,2"
com.apple.DocumentsApp,33,1742423107,1742423140,1742423140.837799,-18000,EB445137-D7F5-57EC-87DA-1DB460D64046,"iPhone13,2"
com.apple.MobileSMS,73,1742423034,1742423107,1742423107.455346,-18000,EB445137-D7F5-57EC-87DA-1DB460D64046,"iPhone13,2"
com.apple.DocumentsApp,11,1742423023,1742423034,1742423034.6572719,-18000,EB445137-D7F5-57EC-87DA-1DB460D64046,"iPhone13,2"
com.apple.MobileSMS,195,1742422828,1742423023,1742423023.330807,-18000,EB445137-D7F5-57EC-87DA-1DB460D64046,"iPhone13,2"
com.apple.DocumentsApp,125,1742422701,1742422826,1742422826.9923449,-18000,EB445137-D7F5-57EC-87DA-1DB460D64046,"iPhone13,2"
com.google.chrome.ios,56,1742422641,1742422697,1742422697.185379,-18000,EB445137-D7F5-57EC-87DA-1DB460D64046,"iPhone13,2"
com.apple.MobileSMS,27,1742422614,1742422641,1742422641.799339,-18000,EB445137-D7F5-57EC-87DA-1DB460D64046,"iPhone13,2"
com.apple.weather,132,1742422450,1742422582,1742422582.582056,-18000,EB445137-D7F5-57EC-87DA-1DB460D64046,"iPhone13,2"
com.apple.weather,52,1742422398,1742422450,1742422450.611285,-18000,EB445137-D7F5-57EC-87DA-1DB460D64046,"iPhone13,2"
com.apple.weather,69,1742422242,1742422311,1742422311.0580769,-18000,EB445137-D7F5-57EC-87DA-1DB460D64046,"iPhone13,2"
com.apple.MobileSMS,2,1742422239,1742422241,1742422241.5356069,-18000,EB445137-D7F5-57EC-87DA-1DB460D64046,"iPhone13,2"
com.apple.weather,20,1742422202,1742422222,1742422222.632065,-18000,EB445137-D7F5-57EC-87DA-1DB460D64046,"iPhone13,2"
com.apple.CoreAuthUI,2,1742422188,1742422190,1742422190.330131,-18000,EB445137-D7F5-57EC-87DA-1DB460D64046,"iPhone13,2"
com.apple.MobileSMS,13,1742422163,1742422176,1742422176.139178,-18000,EB445137-D7F5-57EC-87DA-1DB460D64046,"iPhone13,2"
com.apple.MobileSMS,22,1742422129,1742422151,1742422152.001987,-18000,EB445137-D7F5-57EC-87DA-1DB460D64046,"iPhone13,2"
com.apple.MobileSMS,16,1742422106,1742422122,1742422122.944158,-18000,EB445137-D7F5-57EC-87DA-1DB460D64046,"iPhone13,2"
com.apple.weather,12,1742422078,1742422090,1742422090.863792,-18000,EB445137-D7F5-57EC-87DA-1DB460D64046,"iPhone13,2"
com.apple.findmy,7,1742422013,1742422020,1742422020.7369308,-18000,EB445137-D7F5-57EC-87DA-1DB460D64046,"iPhone13,2"
com.apple.news,131,1742421881,1742422012,1742422012.3606749,-18000,EB445137-D7F5-57EC-87DA-1DB460D64046,"iPhone13,2"
com.apple.weather,82,1742421791,1742421873,1742421873.533856,-18000,EB445137-D7F5-57EC-87DA-1DB460D64046,"iPhone13,2"
com.apple.news,6,1742421785,1742421791,1742421791.9251618,-18000,EB445137-D7F5-57EC-87DA-1DB460D64046,"iPhone13,2"
com.apple.MobileSMS,1,1742421784,1742421785,1742421786.031033,-18000,EB445137-D7F5-57EC-87DA-1DB460D64046,"iPhone13,2"
com.apple.MobileSMS,15,1742421767,1742421782,1742421782.220983,-18000,EB445137-D7F5-57EC-87DA-1DB460D64046,"iPhone13,2"
com.apple.news,0,1742421767,1742421767,1742421767.94782,-18000,EB445137-D7F5-57EC-87DA-1DB460D64046,"iPhone13,2"
com.apple.news,12,1742421754,1742421766,1742421766.971587,-18000,EB445137-D7F5-57EC-87DA-1DB460D64046,"iPhone13,2"
com.apple.weather,6,1742421738,1742421744,1742421744.283392,-18000,EB445137-D7F5-57EC-87DA-1DB460D64046,"iPhone13,2"
com.apple.weather,6,1742421716,1742421722,1742421722.835109,-18000,EB445137-D7F5-57EC-87DA-1DB460D64046,"iPhone13,2"
com.apple.weather,61,1742421652,1742421713,1742421713.8972921,-18000,EB445137-D7F5-57EC-87DA-1DB460D64046,"iPhone13,2"
com.apple.MobileAddressBook,103,1742421549,1742421652,1742421652.966021,-18000,EB445137-D7F5-57EC-87DA-1DB460D64046,"iPhone13,2"
com.apple.weather,27,1742421486,1742421513,1742421514.0111709,-18000,EB445137-D7F5-57EC-87DA-1DB460D64046,"iPhone13,2"
com.google.chrome.ios,118,1742421257,1742421375,1742421376.008432,-18000,EB445137-D7F5-57EC-87DA-1DB460D64046,"iPhone13,2"
com.toyopagroup.picaboo,33,1742421220,1742421253,1742421253.3549318,-18000,EB445137-D7F5-57EC-87DA-1DB460D64046,"iPhone13,2"
com.microsoft.Office.Outlook,30,1742421078,1742421108,1742421108.410764,-18000,EB445137-D7F5-57EC-87DA-1DB460D64046,"iPhone13,2"
com.tinyspeck.chatlyio,11,1742417314,1742417325,1742417325.5951161,-18000,EB445137-D7F5-57EC-87DA-1DB460D64046,"iPhone13,2"
com.microsoft.Office.Outlook,2,1742417312,1742417314,1742417314.481719,-18000,EB445137-D7F5-57EC-87DA-1DB460D64046,"iPhone13,2"
com.microsoft.Office.Outlook,49,1742417261,1742417310,1742417310.8964128,-18000,EB445137-D7F5-57EC-87DA-1DB460D64046,"iPhone13,2"
com.microsoft.Office.Outlook,13,1742417248,1742417261,1742417261.57156,-18000,EB445137-D7F5-57EC-87DA-1DB460D64046,"iPhone13,2"
com.apple.MobileSMS,191,1742417056,1742417247,1742417247.817078,-18000,EB445137-D7F5-57EC-87DA-1DB460D64046,"iPhone13,2"
com.toyopagroup.picaboo,80,1742416961,1742417041,1742417042.039206,-18000,EB445137-D7F5-57EC-87DA-1DB460D64046,"iPhone13,2"
com.apple.findmy,1,1742416960,1742416961,1742416961.925446,-18000,EB445137-D7F5-57EC-87DA-1DB460D64046,"iPhone13,2"
com.apple.findmy,11,1742415606,1742415617,1742415617.933522,-18000,EB445137-D7F5-57EC-87DA-1DB460D64046,"iPhone13,2"
com.apple.InCallService,70,1742410915,1742410985,1742410985.161255,-18000,EB445137-D7F5-57EC-87DA-1DB460D64046,"iPhone13,2"
com.apple.news,76,1742410839,1742410915,1742410915.352518,-18000,EB445137-D7F5-57EC-87DA-1DB460D64046,"iPhone13,2"
com.apple.mobilephone,2,1742410825,1742410827,1742410827.871352,-18000,EB445137-D7F5-57EC-87DA-1DB460D64046,"iPhone13,2"
com.apple.mobilephone,2,1742410297,1742410299,1742410300.1674318,-18000,EB445137-D7F5-57EC-87DA-1DB460D64046,"iPhone13,2"
com.apple.InCallService,482,1742409815,1742410297,1742410297.966088,-18000,EB445137-D7F5-57EC-87DA-1DB460D64046,"iPhone13,2"
com.apple.mobilephone,3,1742409812,1742409815,1742409815.629561,-18000,EB445137-D7F5-57EC-87DA-1DB460D64046,"iPhone13,2"
com.apple.MobileSMS,1,1742409811,1742409812,1742409812.623403,-18000,EB445137-D7F5-57EC-87DA-1DB460D64046,"iPhone13,2"
com.google.Maps,1,1742409810,1742409811,1742409811.6617742,-18000,EB445137-D7F5-57EC-87DA-1DB460D64046,"iPhone13,2"
com.google.Maps,4,1742408738,1742408742,1742408742.711195,-18000,EB445137-D7F5-57EC-87DA-1DB460D64046,"iPhone13,2"
com.google.Maps,11,1742408253,1742408264,1742408265.075574,-18000,EB445137-D7F5-57EC-87DA-1DB460D64046,"iPhone13,2"
com.apple.weather,19,1742408234,1742408253,1742408253.3912868,-18000,EB445137-D7F5-57EC-87DA-1DB460D64046,"iPhone13,2"
com.apple.weather,115,1742408022,1742408137,1742408138.02998,-18000,EB445137-D7F5-57EC-87DA-1DB460D64046,"iPhone13,2"
com.google.Maps,3,1742408019,1742408022,1742408022.184417,-18000,EB445137-D7F5-57EC-87DA-1DB460D64046,"iPhone13,2"
com.google.Maps,71,1742407776,1742407847,1742407848.414699,-18000,EB445137-D7F5-57EC-87DA-1DB460D64046,"iPhone13,2"
com.google.Maps,10,1742407434,1742407444,1742407444.138691,-18000,EB445137-D7F5-57EC-87DA-1DB460D64046,"iPhone13,2"
com.apple.weather,2,1742407432,1742407434,1742407434.3071299,-18000,EB445137-D7F5-57EC-87DA-1DB460D64046,"iPhone13,2"
com.apple.weather,50,1742407339,1742407389,1742407389.969911,-18000,EB445137-D7F5-57EC-87DA-1DB460D64046,"iPhone13,2"
com.google.Maps,1,1742407338,1742407339,1742407339.7587419,-18000,EB445137-D7F5-57EC-87DA-1DB460D64046,"iPhone13,2"
com.google.Maps,36,1742407008,1742407044,1742407044.2417421,-18000,EB445137-D7F5-57EC-87DA-1DB460D64046,"iPhone13,2"
com.apple.weather,4,1742407004,1742407008,1742407008.104054,-18000,EB445137-D7F5-57EC-87DA-1DB460D64046,"iPhone13,2"
com.apple.weather,3,1742406602,1742406605,1742406605.4799662,-18000,EB445137-D7F5-57EC-87DA-1DB460D64046,"iPhone13,2"
com.apple.weather,11,1742406587,1742406598,1742406598.774363,-18000,EB445137-D7F5-57EC-87DA-1DB460D64046,"iPhone13,2"
com.google.Maps,1,1742406585,1742406586,1742406586.8673549,-18000,EB445137-D7F5-57EC-87DA-1DB460D64046,"iPhone13,2"
com.google.Maps,21,1742405848,1742405869,1742405869.723269,-18000,EB445137-D7F5-57EC-87DA-1DB460D64046,"iPhone13,2"
com.apple.MobileSMS,14,1742405834,1742405848,1742405848.626642,-18000,EB445137-D7F5-57EC-87DA-1DB460D64046,"iPhone13,2"
com.apple.MobileSMS,5,1742405780,1742405785,1742405785.592891,-18000,EB445137-D7F5-57EC-87DA-1DB460D64046,"iPhone13,2"
com.apple.weather,114,1742405659,1742405773,1742405774.044256,-18000,EB445137-D7F5-57EC-87DA-1DB460D64046,"iPhone13,2"
com.toyopagroup.picaboo,18,1742405587,1742405605,1742405605.35433,-18000,EB445137-D7F5-57EC-87DA-1DB460D64046,"iPhone13,2"
com.google.Maps,2,1742405585,1742405587,1742405587.0567951,-18000,EB445137-D7F5-57EC-87DA-1DB460D64046,"iPhone13,2"
com.google.Maps,3960,1742401563,1742405523,1742405523.625197,-18000,EB445137-D7F5-57EC-87DA-1DB460D64046,"iPhone13,2"
com.google.Maps,200,1742401288,1742401488,1742401488.9949532,-18000,EB445137-D7F5-57EC-87DA-1DB460D64046,"iPhone13,2"
com.google.Maps,100,1742401076,1742401176,1742401177.034284,-18000,EB445137-D7F5-57EC-87DA-1DB460D64046,"iPhone13,2"
com.google.chrome.ios,3,1742401073,1742401076,1742401076.133051,-18000,EB445137-D7F5-57EC-87DA-1DB460D64046,"iPhone13,2"
com.google.Maps,9,1742401064,1742401073,1742401073.4782019,-18000,EB445137-D7F5-57EC-87DA-1DB460D64046,"iPhone13,2"
com.apple.weather,26,1742401038,1742401064,1742401064.4755669,-18000,EB445137-D7F5-57EC-87DA-1DB460D64046,"iPhone13,2"
com.google.Maps,19,1742401019,1742401038,1742401038.282182,-18000,EB445137-D7F5-57EC-87DA-1DB460D64046,"iPhone13,2"
com.google.chrome.ios,4,1742401015,1742401019,1742401019.471607,-18000,EB445137-D7F5-57EC-87DA-1DB460D64046,"iPhone13,2"
com.google.Maps,33,1742400982,1742401015,1742401015.730073,-18000,EB445137-D7F5-57EC-87DA-1DB460D64046,"iPhone13,2"
com.apple.mobilecal,22,1742400960,1742400982,1742400982.928489,-18000,EB445137-D7F5-57EC-87DA-1DB460D64046,"iPhone13,2"
com.apple.mobilecal,16,1742400583,1742400599,1742400599.358629,-18000,EB445137-D7F5-57EC-87DA-1DB460D64046,"iPhone13,2"
com.google.Maps,187,1742400393,1742400580,1742400580.5636759,-18000,EB445137-D7F5-57EC-87DA-1DB460D64046,"iPhone13,2"
com.apple.weather,2,1742400391,1742400393,1742400393.9208941,-18000,EB445137-D7F5-57EC-87DA-1DB460D64046,"iPhone13,2"
com.google.chrome.ios,5,1742400386,1742400391,1742400391.47509,-18000,EB445137-D7F5-57EC-87DA-1DB460D64046,"iPhone13,2"
com.apple.weather,55,1742400331,1742400386,1742400386.474087,-18000,EB445137-D7F5-57EC-87DA-1DB460D64046,"iPhone13,2"
com.apple.MobileSMS,3,1742399873,1742399876,1742399876.4998388,-18000,EB445137-D7F5-57EC-87DA-1DB460D64046,"iPhone13,2"
com.google.Maps,0,1742399873,1742399873,1742399874.405668,-18000,EB445137-D7F5-57EC-87DA-1DB460D64046,"iPhone13,2"
com.google.Maps,23,1742399546,1742399569,1742399569.245173,-18000,EB445137-D7F5-57EC-87DA-1DB460D64046,"iPhone13,2"
com.google.Maps,4,1742399443,1742399447,1742399447.8922381,-18000,EB445137-D7F5-57EC-87DA-1DB460D64046,"iPhone13,2"
com.google.chrome.ios,3,1742399440,1742399443,1742399443.810792,-18000,EB445137-D7F5-57EC-87DA-1DB460D64046,"iPhone13,2"
com.google.chrome.ios,8,1742399295,1742399303,1742399303.0622249,-18000,EB445137-D7F5-57EC-87DA-1DB460D64046,"iPhone13,2"
com.apple.weather,5,1742399290,1742399295,1742399295.610817,-18000,EB445137-D7F5-57EC-87DA-1DB460D64046,"iPhone13,2"
com.apple.weather,16,1742399270,1742399286,1742399286.3784509,-18000,EB445137-D7F5-57EC-87DA-1DB460D64046,"iPhone13,2"
com.google.chrome.ios,1,1742399269,1742399270,1742399270.459938,-18000,EB445137-D7F5-57EC-87DA-1DB460D64046,"iPhone13,2"
com.google.chrome.ios,124,1742399107,1742399231,1742399231.432955,-18000,EB445137-D7F5-57EC-87DA-1DB460D64046,"iPhone13,2"
com.google.Maps,53,1742399054,1742399107,1742399107.908135,-18000,EB445137-D7F5-57EC-87DA-1DB460D64046,"iPhone13,2"
com.apple.news,3,1742399041,1742399044,1742399044.435923,-18000,EB445137-D7F5-57EC-87DA-1DB460D64046,"iPhone13,2"
com.apple.news,36,1742398891,1742398927,1742398927.597674,-18000,EB445137-D7F5-57EC-87DA-1DB460D64046,"iPhone13,2"
com.apple.news,42,1742398316,1742398358,1742398358.1993852,-18000,EB445137-D7F5-57EC-87DA-1DB460D64046,"iPhone13,2"
com.apple.MobileSMS,2,1742398303,1742398305,1742398305.895078,-18000,EB445137-D7F5-57EC-87DA-1DB460D64046,"iPhone13,2"
com.apple.MobileSMS,24,1742398279,1742398303,1742398303.111707,-18000,EB445137-D7F5-57EC-87DA-1DB460D64046,"iPhone13,2"
com.apple.weather,40,1742398223,1742398263,1742398263.651465,-18000,EB445137-D7F5-57EC-87DA-1DB460D64046,"iPhone13,2"
com.apple.MobileSMS,2,1742398220,1742398222,1742398222.585026,-18000,EB445137-D7F5-57EC-87DA-1DB460D64046,"iPhone13,2"
com.apple.MobileSMS,24,1742398159,1742398183,1742398184.041494,-18000,EB445137-D7F5-57EC-87DA-1DB460D64046,"iPhone13,2"
com.apple.MobileSMS,22,1742398124,1742398146,1742398146.67203,-18000,EB445137-D7F5-57EC-87DA-1DB460D64046,"iPhone13,2"
com.apple.weather,5,1742398115,1742398120,1742398120.189914,-18000,EB445137-D7F5-57EC-87DA-1DB460D64046,"iPhone13,2"
com.apple.weather,69,1742397531,1742397600,1742397600.146435,-18000,EB445137-D7F5-57EC-87DA-1DB460D64046,"iPhone13,2"
com.google.Maps,5708,1742391370,1742397078,1742397078.285639,-18000,EB445137-D7F5-57EC-87DA-1DB460D64046,"iPhone13,2"
com.google.Maps,2,1742390763,1742390765,1742390765.890915,-18000,EB445137-D7F5-57EC-87DA-1DB460D64046,"iPhone13,2"
com.apple.MobileSMS,0,1742390763,1742390763,1742390763.489223,-18000,EB445137-D7F5-57EC-87DA-1DB460D64046,"iPhone13,2"
com.apple.MobileSMS,4,1742390737,1742390741,1742390741.201499,-18000,EB445137-D7F5-57EC-87DA-1DB460D64046,"iPhone13,2"
com.apple.InCallService,1,1742390736,1742390737,1742390737.589254,-18000,EB445137-D7F5-57EC-87DA-1DB460D64046,"iPhone13,2"
com.apple.InCallService,1,1742390734,1742390735,1742390735.8769631,-18000,EB445137-D7F5-57EC-87DA-1DB460D64046,"iPhone13,2"
com.apple.InCallService,2,1742390728,1742390730,1742390730.200954,-18000,EB445137-D7F5-57EC-87DA-1DB460D64046,"iPhone13,2"
com.apple.InCallService,12,1742390713,1742390725,1742390725.926763,-18000,EB445137-D7F5-57EC-87DA-1DB460D64046,"iPhone13,2"
com.apple.MobileSMS,4,1742390709,1742390713,1742390714.101603,-18000,EB445137-D7F5-57EC-87DA-1DB460D64046,"iPhone13,2"
com.google.Maps,4,1742390683,1742390687,1742390687.1978822,-18000,EB445137-D7F5-57EC-87DA-1DB460D64046,"iPhone13,2"
com.apple.MobileSMS,2,1742390681,1742390683,1742390683.545779,-18000,EB445137-D7F5-57EC-87DA-1DB460D64046,"iPhone13,2"
com.apple.MobileSMS,20,1742390640,1742390660,1742390660.8966951,-18000,EB445137-D7F5-57EC-87DA-1DB460D64046,"iPhone13,2"
com.apple.weather,2,1742390638,1742390640,1742390640.586134,-18000,EB445137-D7F5-57EC-87DA-1DB460D64046,"iPhone13,2"
com.apple.weather,19,1742389863,1742389882,1742389882.754014,-18000,EB445137-D7F5-57EC-87DA-1DB460D64046,"iPhone13,2"
com.google.Maps,2,1742389861,1742389863,1742389863.571074,-18000,EB445137-D7F5-57EC-87DA-1DB460D64046,"iPhone13,2"
com.google.Maps,3,1742389466,1742389469,1742389469.027701,-18000,EB445137-D7F5-57EC-87DA-1DB460D64046,"iPhone13,2"
com.google.Maps,14,1742389414,1742389428,1742389428.829632,-18000,EB445137-D7F5-57EC-87DA-1DB460D64046,"iPhone13,2"
com.google.Maps,156,1742388830,1742388986,1742388986.495758,-18000,EB445137-D7F5-57EC-87DA-1DB460D64046,"iPhone13,2"
com.google.Maps,6,1742388639,1742388645,1742388645.9814792,-18000,EB445137-D7F5-57EC-87DA-1DB460D64046,"iPhone13,2"
com.google.Maps,83,1742388484,1742388567,1742388567.958467,-18000,EB445137-D7F5-57EC-87DA-1DB460D64046,"iPhone13,2"
com.apple.MobileSMS,2,1742388482,1742388484,1742388484.305457,-18000,EB445137-D7F5-57EC-87DA-1DB460D64046,"iPhone13,2"
com.apple.MobileSMS,6,1742388125,1742388131,1742388132.19944,-18000,EB445137-D7F5-57EC-87DA-1DB460D64046,"iPhone13,2"
com.google.Maps,1,1742388124,1742388125,1742388125.8338509,-18000,EB445137-D7F5-57EC-87DA-1DB460D64046,"iPhone13,2"
com.google.Maps,24,1742387845,1742387869,1742387869.5119982,-18000,EB445137-D7F5-57EC-87DA-1DB460D64046,"iPhone13,2"
com.google.Maps,9,1742386985,1742386994,1742386994.213965,-18000,EB445137-D7F5-57EC-87DA-1DB460D64046,"iPhone13,2"
com.google.chrome.ios,2,1742386983,1742386985,1742386985.822229,-18000,EB445137-D7F5-57EC-87DA-1DB460D64046,"iPhone13,2"
com.google.chrome.ios,23,1742386770,1742386793,1742386793.418297,-18000,EB445137-D7F5-57EC-87DA-1DB460D64046,"iPhone13,2"
com.apple.weather,3,1742386767,1742386770,1742386770.512078,-18000,EB445137-D7F5-57EC-87DA-1DB460D64046,"iPhone13,2"
com.apple.weather,63,1742386456,1742386519,1742386519.909058,-18000,EB445137-D7F5-57EC-87DA-1DB460D64046,"iPhone13,2"
com.apple.weather,10,1742386224,1742386234,1742386234.645997,-18000,EB445137-D7F5-57EC-87DA-1DB460D64046,"iPhone13,2"
com.google.Maps,20,1742386204,1742386224,1742386224.746406,-18000,EB445137-D7F5-57EC-87DA-1DB460D64046,"iPhone13,2"
com.apple.weather,2,1742386201,1742386203,1742386203.078251,-18000,EB445137-D7F5-57EC-87DA-1DB460D64046,"iPhone13,2"
com.apple.weather,26,1742385850,1742385876,1742385876.588159,-18000,EB445137-D7F5-57EC-87DA-1DB460D64046,"iPhone13,2"
com.google.chrome.ios,1,1742385849,1742385850,1742385850.73319,-18000,EB445137-D7F5-57EC-87DA-1DB460D64046,"iPhone13,2"
com.google.chrome.ios,168,1742385203,1742385371,1742385371.896126,-18000,EB445137-D7F5-57EC-87DA-1DB460D64046,"iPhone13,2"
com.apple.MobileSMS,27,1742380284,1742380311,1742380311.806755,-18000,EB445137-D7F5-57EC-87DA-1DB460D64046,"iPhone13,2"
com.apple.mobiletimer,5,1742380207,1742380212,1742380212.502829,-18000,EB445137-D7F5-57EC-87DA-1DB460D64046,"iPhone13,2"
com.apple.mobiletimer,4,1742378420,1742378424,1742378425.4141002,-18000,EB445137-D7F5-57EC-87DA-1DB460D64046,"iPhone13,2"
com.apple.Music,4,1742378416,1742378420,1742378420.8855062,-18000,EB445137-D7F5-57EC-87DA-1DB460D64046,"iPhone13,2"
com.apple.mobiletimer,1,1742378415,1742378416,1742378416.691098,-18000,EB445137-D7F5-57EC-87DA-1DB460D64046,"iPhone13,2"
com.apple.Health,42,1742358717,1742358759,1742358759.792245,-18000,EB445137-D7F5-57EC-87DA-1DB460D64046,"iPhone13,2"
com.apple.journal,1283,1742357431,1742358714,1742358714.876707,-18000,EB445137-D7F5-57EC-87DA-1DB460D64046,"iPhone13,2"
com.apple.CoreAuthUI,6,1742357431,1742357437,1742357437.3221421,-18000,EB445137-D7F5-57EC-87DA-1DB460D64046,"iPhone13,2"
com.strava.stravaride,537,1742356892,1742357429,1742357429.154667,-18000,EB445137-D7F5-57EC-87DA-1DB460D64046,"iPhone13,2"
com.apple.CoreAuthUI,5,1742356849,1742356854,1742356854.2070742,-18000,EB445137-D7F5-57EC-87DA-1DB460D64046,"iPhone13,2"
com.apple.journal,41,1742356848,1742356889,1742356889.0915809,-18000,EB445137-D7F5-57EC-87DA-1DB460D64046,"iPhone13,2"
com.apple.weather,54,1742356787,1742356841,1742356841.315373,-18000,EB445137-D7F5-57EC-87DA-1DB460D64046,"iPhone13,2"
com.apple.weather,18,1742356765,1742356783,1742356783.276077,-18000,EB445137-D7F5-57EC-87DA-1DB460D64046,"iPhone13,2"
com.apple.news,151,1742356612,1742356763,1742356763.97338,-18000,EB445137-D7F5-57EC-87DA-1DB460D64046,"iPhone13,2"
com.apple.mobiletimer,19,1742355614,1742355633,1742355633.3788872,-18000,EB445137-D7F5-57EC-87DA-1DB460D64046,"iPhone13,2"
com.google.Chrome,8,1742355114,1742355122,1742355122.3296242,-18000,,
com.google.Chrome,417,1742352448,1742352865,1742352865.882772,-18000,,
com.apple.mobiletimer,44,1742351867,1742351911,1742351911.612822,-18000,EB445137-D7F5-57EC-87DA-1DB460D64046,"iPhone13,2"
com.apple.Fitness,1,1742351861,1742351862,1742351862.980019,-18000,EB445137-D7F5-57EC-87DA-1DB460D64046,"iPhone13,2"
com.google.Chrome,386,1742351688,1742352074,1742352074.3724298,-18000,,
com.microsoft.VSCode,7,1742351681,1742351688,1742351688.371955,-18000,,
com.apple.shortcuts,196,1742351485,1742351681,1742351681.1129189,-18000,,
com.microsoft.VSCode,10,1742351346,1742351356,1742351356.5263991,-18000,,
com.leomehlig.today,5,1742351341,1742351346,1742351346.441805,-18000,,
com.microsoft.VSCode,60,1742351281,1742351341,1742351341.2057261,-18000,,
com.apple.shortcuts,43,1742351238,1742351281,1742351282.027241,-18000,,
com.leomehlig.today,39,1742351199,1742351238,1742351239.04213,-18000,,
com.microsoft.VSCode,16,1742351183,1742351199,1742351200.3366032,-18000,,
com.google.Chrome,69,1742351114,1742351183,1742351183.457001,-18000,,
com.apple.finder,2,1742351112,1742351114,1742351114.097029,-18000,,
com.microsoft.VSCode,151,1742350961,1742351112,1742351112.664968,-18000,,
com.apple.finder,29,1742350932,1742350961,1742350961.949569,-18000,,
com.microsoft.VSCode,127,1742350805,1742350932,1742350932.1604872,-18000,,
com.electron.carta,57,1742350748,1742350805,1742350805.7732959,-18000,,
com.microsoft.VSCode,20,1742350728,1742350748,1742350748.82337,-18000,,
com.electron.carta,60,1742350668,1742350728,1742350728.1194959,-18000,,
com.jinzhenyu.ruler,17,1742350651,1742350668,1742350668.0514688,-18000,,
com.electron.carta,11,1742350640,1742350651,1742350651.812393,-18000,,
com.microsoft.VSCode,109,1742350531,1742350640,1742350640.915508,-18000,,
com.apple.finder,0,1742350531,1742350531,1742350531.889614,-18000,,
com.electron.carta,276,1742350255,1742350531,1742350531.308732,-18000,,
com.apple.finder,1,1742350254,1742350255,1742350255.541244,-18000,,
com.electron.carta,302,1742349952,1742350254,1742350254.199336,-18000,,
com.apple.finder,74,1742349878,1742349952,1742349952.890902,-18000,,
com.microsoft.VSCode,31,1742349847,1742349878,1742349878.465796,-18000,,
com.apple.Notes,7,1742349840,1742349847,1742349847.67086,-18000,,
com.apple.Fitness,69,1742349762,1742349831,1742349831.618122,-18000,EB445137-D7F5-57EC-87DA-1DB460D64046,"iPhone13,2"
com.apple.Health,8,1742349753,1742349761,1742349761.7312222,-18000,EB445137-D7F5-57EC-87DA-1DB460D64046,"iPhone13,2"
com.apple.mobileslideshow,6,1742349747,1742349753,1742349753.173339,-18000,EB445137-D7F5-57EC-87DA-1DB460D64046,"iPhone13,2"
com.apple.Photos,110,1742349730,1742349840,1742349841.0821671,-18000,,
com.apple.mobileslideshow,1,1742349726,1742349727,1742349727.2951288,-18000,EB445137-D7F5-57EC-87DA-1DB460D64046,"iPhone13,2"
com.apple.ScreenContinuity,9,1742349721,1742349730,1742349730.081328,-18000,,
com.apple.Photos,490,1742349231,1742349721,1742349721.991605,-18000,,
com.google.Chrome,4,1742349227,1742349231,1742349232.0100641,-18000,,
com.apple.MobileSMS,1,1742349226,1742349227,1742349227.070548,-18000,,
com.google.Chrome,2,1742349224,1742349226,1742349226.7850971,-18000,,
com.apple.mobileslideshow,139,1742349146,1742349285,1742349285.7242498,-18000,EB445137-D7F5-57EC-87DA-1DB460D64046,"iPhone13,2"
com.apple.mobileslideshow,34,1742348545,1742348579,1742348579.756839,-18000,EB445137-D7F5-57EC-87DA-1DB460D64046,"iPhone13,2"
com.apple.Photos,724,1742348500,1742349224,1742349224.6173592,-18000,,
com.google.Chrome,28,1742348472,1742348500,1742348500.183039,-18000,,
com.apple.MobileSMS,5,1742344686,1742344691,1742344691.824018,-18000,EB445137-D7F5-57EC-87DA-1DB460D64046,"iPhone13,2"
com.apple.MobileSMS,10,1742342895,1742342905,1742342905.7433,-18000,EB445137-D7F5-57EC-87DA-1DB460D64046,"iPhone13,2"
com.apple.MobileSMS,2,1742342654,1742342656,1742342656.580844,-18000,EB445137-D7F5-57EC-87DA-1DB460D64046,"iPhone13,2"
com.apple.weather,42,1742341155,1742341197,1742341197.625792,-18000,EB445137-D7F5-57EC-87DA-1DB460D64046,"iPhone13,2"
com.google.chrome.ios,267,1742340888,1742341155,1742341155.8738508,-18000,EB445137-D7F5-57EC-87DA-1DB460D64046,"iPhone13,2"
com.apple.weather,12,1742340876,1742340888,1742340888.270318,-18000,EB445137-D7F5-57EC-87DA-1DB460D64046,"iPhone13,2"
com.apple.findmy,36,1742340818,1742340854,1742340854.205209,-18000,EB445137-D7F5-57EC-87DA-1DB460D64046,"iPhone13,2"
com.apple.MobileSMS,5,1742340813,1742340818,1742340818.195097,-18000,EB445137-D7F5-57EC-87DA-1DB460D64046,"iPhone13,2"
com.apple.mobileslideshow,66,1742339297,1742339363,1742339363.757987,-18000,EB445137-D7F5-57EC-87DA-1DB460D64046,"iPhone13,2"
com.apple.MobileSMS,40,1742339257,1742339297,1742339297.3030849,-18000,EB445137-D7F5-57EC-87DA-1DB460D64046,"iPhone13,2"
com.google.chrome.ios,1,1742339256,1742339257,1742339257.536207,-18000,EB445137-D7F5-57EC-87DA-1DB460D64046,"iPhone13,2"
com.google.chrome.ios,2,1742339253,1742339255,1742339255.2645721,-18000,EB445137-D7F5-57EC-87DA-1DB460D64046,"iPhone13,2"
com.google.Chrome,15,1742339033,1742339048,1742339048.886692,-18000,,
com.google.chrome.ios,73,1742337828,1742337901,1742337901.724609,-18000,EB445137-D7F5-57EC-87DA-1DB460D64046,"iPhone13,2"
com.apple.Health,112,1742337715,1742337827,1742337827.104871,-18000,EB445137-D7F5-57EC-87DA-1DB460D64046,"iPhone13,2"
com.google.Maps,196,1742332274,1742332470,1742332470.5875711,-18000,EB445137-D7F5-57EC-87DA-1DB460D64046,"iPhone13,2"
com.apple.Maps,2,1742332200,1742332202,1742332202.854504,-18000,EB445137-D7F5-57EC-87DA-1DB460D64046,"iPhone13,2"
com.hammerandchisel.discord,21,1742332148,1742332169,1742332169.2753248,-18000,EB445137-D7F5-57EC-87DA-1DB460D64046,"iPhone13,2"
com.apple.mobileslideshow,1,1742332147,1742332148,1742332149.126275,-18000,EB445137-D7F5-57EC-87DA-1DB460D64046,"iPhone13,2"
com.apple.mobileslideshow,59,1742331472,1742331531,1742331532.064073,-18000,EB445137-D7F5-57EC-87DA-1DB460D64046,"iPhone13,2"
com.apple.mobileslideshow,38,1742331050,1742331088,1742331088.217284,-18000,EB445137-D7F5-57EC-87DA-1DB460D64046,"iPhone13,2"
com.apple.mobileslideshow,24,1742330719,1742330743,1742330743.916095,-18000,EB445137-D7F5-57EC-87DA-1DB460D64046,"iPhone13,2"
com.apple.mobileslideshow,14,1742330499,1742330513,1742330513.325841,-18000,EB445137-D7F5-57EC-87DA-1DB460D64046,"iPhone13,2"
com.apple.mobileslideshow,64,1742329964,1742330028,1742330028.6648111,-18000,EB445137-D7F5-57EC-87DA-1DB460D64046,"iPhone13,2"
com.apple.mobileslideshow,15,1742329419,1742329434,1742329434.297714,-18000,EB445137-D7F5-57EC-87DA-1DB460D64046,"iPhone13,2"
com.apple.mobileslideshow,37,1742328922,1742328959,1742328959.218425,-18000,EB445137-D7F5-57EC-87DA-1DB460D64046,"iPhone13,2"
com.apple.mobileslideshow,44,1742328733,1742328777,1742328777.428987,-18000,EB445137-D7F5-57EC-87DA-1DB460D64046,"iPhone13,2"
com.apple.mobileslideshow,31,1742328482,1742328513,1742328513.637967,-18000,EB445137-D7F5-57EC-87DA-1DB460D64046,"iPhone13,2"
com.apple.mobileslideshow,34,1742327667,1742327701,1742327702.128072,-18000,EB445137-D7F5-57EC-87DA-1DB460D64046,"iPhone13,2"
com.google.chrome.ios,2,1742327665,1742327667,1742327668.097828,-18000,EB445137-D7F5-57EC-87DA-1DB460D64046,"iPhone13,2"
com.apple.mobileslideshow,2,1742327663,1742327665,1742327665.6258059,-18000,EB445137-D7F5-57EC-87DA-1DB460D64046,"iPhone13,2"
com.google.chrome.ios,80,1742324405,1742324485,1742324485.516028,-18000,EB445137-D7F5-57EC-87DA-1DB460D64046,"iPhone13,2"
com.google.chrome.ios,79,1742322396,1742322475,1742322476.011394,-18000,EB445137-D7F5-57EC-87DA-1DB460D64046,"iPhone13,2"
com.apple.mobileslideshow,6,1742322390,1742322396,1742322396.111676,-18000,EB445137-D7F5-57EC-87DA-1DB460D64046,"iPhone13,2"
com.google.Maps,4,1742322386,1742322390,1742322390.741256,-18000,EB445137-D7F5-57EC-87DA-1DB460D64046,"iPhone13,2"
com.google.Maps,48,1742322329,1742322377,1742322377.6078901,-18000,EB445137-D7F5-57EC-87DA-1DB460D64046,"iPhone13,2"
com.apple.mobileslideshow,4,1742322322,1742322326,1742322326.589494,-18000,EB445137-D7F5-57EC-87DA-1DB460D64046,"iPhone13,2"
com.apple.mobileslideshow,4,1742322069,1742322073,1742322073.413508,-18000,EB445137-D7F5-57EC-87DA-1DB460D64046,"iPhone13,2"
com.apple.mobileslideshow,28,1742320371,1742320399,1742320399.945081,-18000,EB445137-D7F5-57EC-87DA-1DB460D64046,"iPhone13,2"
com.google.chrome.ios,9,1742320362,1742320371,1742320371.9607038,-18000,EB445137-D7F5-57EC-87DA-1DB460D64046,"iPhone13,2"
com.google.chrome.ios,90,1742319342,1742319432,1742319432.9512901,-18000,EB445137-D7F5-57EC-87DA-1DB460D64046,"iPhone13,2"
com.google.chrome.ios,29,1742318525,1742318554,1742318554.767871,-18000,EB445137-D7F5-57EC-87DA-1DB460D64046,"iPhone13,2"
com.google.chrome.ios,30,1742318057,1742318087,1742318087.694096,-18000,EB445137-D7F5-57EC-87DA-1DB460D64046,"iPhone13,2"
com.google.chrome.ios,91,1742317821,1742317912,1742317912.991737,-18000,EB445137-D7F5-57EC-87DA-1DB460D64046,"iPhone13,2"
com.google.chrome.ios,19,1742317788,1742317807,1742317807.698695,-18000,EB445137-D7F5-57EC-87DA-1DB460D64046,"iPhone13,2"
com.google.chrome.ios,83,1742317610,1742317693,1742317693.260633,-18000,EB445137-D7F5-57EC-87DA-1DB460D64046,"iPhone13,2"
com.google.chrome.ios,47,1742317456,1742317503,1742317504.062861,-18000,EB445137-D7F5-57EC-87DA-1DB460D64046,"iPhone13,2"
com.google.chrome.ios,60,1742316431,1742316491,1742316491.577317,-18000,EB445137-D7F5-57EC-87DA-1DB460D64046,"iPhone13,2"
com.apple.mobilenotes,4,1742316427,1742316431,1742316431.5089269,-18000,EB445137-D7F5-57EC-87DA-1DB460D64046,"iPhone13,2"
com.apple.mobileslideshow,3,1742316421,1742316424,1742316424.681264,-18000,EB445137-D7F5-57EC-87DA-1DB460D64046,"iPhone13,2"
com.google.Maps,21,1742316400,1742316421,1742316421.437697,-18000,EB445137-D7F5-57EC-87DA-1DB460D64046,"iPhone13,2"
com.apple.mobileslideshow,2,1742316397,1742316399,1742316399.7030702,-18000,EB445137-D7F5-57EC-87DA-1DB460D64046,"iPhone13,2"
com.apple.mobileslideshow,14,1742315992,1742316006,1742316006.830174,-18000,EB445137-D7F5-57EC-87DA-1DB460D64046,"iPhone13,2"
com.google.Maps,12,1742315477,1742315489,1742315489.440978,-18000,EB445137-D7F5-57EC-87DA-1DB460D64046,"iPhone13,2"
com.apple.mobileslideshow,5,1742315468,1742315473,1742315473.794102,-18000,EB445137-D7F5-57EC-87DA-1DB460D64046,"iPhone13,2"
com.apple.mobileslideshow,12,1742315455,1742315467,1742315467.215214,-18000,EB445137-D7F5-57EC-87DA-1DB460D64046,"iPhone13,2"
com.google.Maps,2,1742315448,1742315450,1742315450.8123798,-18000,EB445137-D7F5-57EC-87DA-1DB460D64046,"iPhone13,2"
com.google.Maps,46,1742314688,1742314734,1742314735.312252,-18000,EB445137-D7F5-57EC-87DA-1DB460D64046,"iPhone13,2"
com.google.Maps,805,1742313597,1742314402,1742314404.101753,-18000,EB445137-D7F5-57EC-87DA-1DB460D64046,"iPhone13,2"
com.google.Maps,3959,1742309574,1742313533,1742313533.586015,-18000,EB445137-D7F5-57EC-87DA-1DB460D64046,"iPhone13,2"
com.apple.weather,2,1742309570,1742309572,1742309572.256898,-18000,EB445137-D7F5-57EC-87DA-1DB460D64046,"iPhone13,2"
com.apple.weather,10,1742309013,1742309023,1742309023.797818,-18000,EB445137-D7F5-57EC-87DA-1DB460D64046,"iPhone13,2"
com.apple.news,2,1742309010,1742309012,1742309012.302331,-18000,EB445137-D7F5-57EC-87DA-1DB460D64046,"iPhone13,2"
com.apple.news,10,1742308850,1742308860,1742308860.7832298,-18000,EB445137-D7F5-57EC-87DA-1DB460D64046,"iPhone13,2"
com.apple.MobileSMS,21,1742308823,1742308844,1742308844.2927442,-18000,EB445137-D7F5-57EC-87DA-1DB460D64046,"iPhone13,2"
com.apple.Health,0,1742308823,1742308823,1742308824.6079512,-18000,EB445137-D7F5-57EC-87DA-1DB460D64046,"iPhone13,2"
com.apple.Health,27,1742308138,1742308165,1742308165.36272,-18000,EB445137-D7F5-57EC-87DA-1DB460D64046,"iPhone13,2"
com.google.Chrome,154,1742308017,1742308171,1742308171.040313,-18000,,
com.apple.MobileSMS,146,1742307871,1742308017,1742308017.654047,-18000,,
com.google.Chrome,168,1742307703,1742307871,1742307871.328412,-18000,,
com.apple.MobileSMS,1,1742307702,1742307703,1742307703.379547,-18000,,
com.google.Chrome,1,1742307701,1742307702,1742307702.566496,-18000,,
com.apple.MobileSMS,1,1742307700,1742307701,1742307701.3602,-18000,,
com.apple.MobileSMS,11,1742307313,1742307324,1742307324.201216,-18000,,
com.google.Chrome,418,1742306895,1742307313,1742307313.819994,-18000,,
com.apple.Notes,1,1742306894,1742306895,1742306895.862022,-18000,,
com.google.Chrome,183,1742306711,1742306894,1742306894.0637898,-18000,,
com.apple.Notes,3,1742306708,1742306711,1742306711.925259,-18000,,
com.google.Chrome,8,1742306700,1742306708,1742306709.0025768,-18000,,
com.google.Chrome,10,1742271414,1742271424,1742271424.6207762,-18000,,
com.google.Chrome,716,1742267133,1742267849,1742267849.41974,-18000,,
com.google.Chrome,312,1742264326,1742264638,1742264638.1516929,-18000,,
com.google.Chrome,476,1742261427,1742261903,1742261903.1268702,-18000,,
com.google.Chrome,586,1742257766,1742258352,1742258352.71398,-18000,,
com.apple.MobileSMS,2,1742257682,1742257684,1742257684.853257,-18000,,
com.google.Chrome,9,1742257673,1742257682,1742257682.497066,-18000,,
com.apple.MobileSMS,4,1742257669,1742257673,1742257673.141007,-18000,,
com.google.Chrome,2,1742257667,1742257669,1742257669.733686,-18000,,
com.apple.findmy,13,1742257654,1742257667,1742257667.18121,-18000,,
com.google.Chrome,18,1742257636,1742257654,1742257654.6313171,-18000,,
com.apple.MobileSMS,20,1742257616,1742257636,1742257636.4067311,-18000,,
com.google.Chrome,29,1742257587,1742257616,1742257616.6184359,-18000,,
com.apple.MobileSMS,130,1742257457,1742257587,1742257587.5271559,-18000,,
com.apple.Photos,849,1742256608,1742257457,1742257457.529073,-18000,,
com.apple.finder,8,1742256548,1742256556,1742256556.275912,-18000,,
com.apple.Notes,5,1742256543,1742256548,1742256548.072507,-18000,,
com.google.Chrome,12,1742256531,1742256543,1742256544.0737228,-18000,,
com.google.Maps,10,1742241214,1742241224,1742241224.9797091,-18000,EB445137-D7F5-57EC-87DA-1DB460D64046,"iPhone13,2"
com.apple.MobileSMS,2,1742241212,1742241214,1742241214.6503139,-18000,EB445137-D7F5-57EC-87DA-1DB460D64046,"iPhone13,2"
com.apple.MobileSMS,7,1742240563,1742240570,1742240570.903686,-18000,EB445137-D7F5-57EC-87DA-1DB460D64046,"iPhone13,2"
com.apple.MobileSMS,27,1742240511,1742240538,1742240538.5474381,-18000,EB445137-D7F5-57EC-87DA-1DB460D64046,"iPhone13,2"
com.apple.findmy,17,1742240492,1742240509,1742240509.236773,-18000,EB445137-D7F5-57EC-87DA-1DB460D64046,"iPhone13,2"
com.google.Maps,47,1742237946,1742237993,1742237993.513161,-18000,EB445137-D7F5-57EC-87DA-1DB460D64046,"iPhone13,2"
com.google.Maps,82,1742236426,1742236508,1742236509.107466,-18000,EB445137-D7F5-57EC-87DA-1DB460D64046,"iPhone13,2"
com.google.Maps,15,1742234184,1742234199,1742234199.6532269,-18000,EB445137-D7F5-57EC-87DA-1DB460D64046,"iPhone13,2"
com.google.Maps,8,1742232804,1742232812,1742232813.1341028,-18000,EB445137-D7F5-57EC-87DA-1DB460D64046,"iPhone13,2"
com.google.Maps,84,1742231963,1742232047,1742232048.097055,-18000,EB445137-D7F5-57EC-87DA-1DB460D64046,"iPhone13,2"
com.apple.MobileSMS,2,1742231960,1742231962,1742231962.5601811,-18000,EB445137-D7F5-57EC-87DA-1DB460D64046,"iPhone13,2"
com.apple.MobileSMS,21,1742230740,1742230761,1742230761.911539,-18000,EB445137-D7F5-57EC-87DA-1DB460D64046,"iPhone13,2"
com.google.Maps,0,1742230740,1742230740,1742230741.060504,-18000,EB445137-D7F5-57EC-87DA-1DB460D64046,"iPhone13,2"
com.google.Maps,13,1742228603,1742228616,1742228617.1845279,-18000,EB445137-D7F5-57EC-87DA-1DB460D64046,"iPhone13,2"
com.apple.weather,7,1742223748,1742223755,1742223755.8705611,-18000,EB445137-D7F5-57EC-87DA-1DB460D64046,"iPhone13,2"
com.apple.Health,3,1742223744,1742223747,1742223747.4109778,-18000,EB445137-D7F5-57EC-87DA-1DB460D64046,"iPhone13,2"
com.apple.Health,22,1742222888,1742222910,1742222910.782237,-18000,EB445137-D7F5-57EC-87DA-1DB460D64046,"iPhone13,2"
com.instructure.icanvas,0,1742222888,1742222888,1742222889.030931,-18000,EB445137-D7F5-57EC-87DA-1DB460D64046,"iPhone13,2"
com.google.Chrome,401,1742221344,1742221745,1742221745.654983,-18000,,
com.apple.Notes,3,1742221341,1742221344,1742221344.844979,-18000,,
com.google.Chrome,155,1742221186,1742221341,1742221341.9820108,-18000,,
com.instructure.icanvas,68,1742220624,1742220692,1742220693.125499,-18000,EB445137-D7F5-57EC-87DA-1DB460D64046,"iPhone13,2"
com.instructure.icanvas,65,1742219369,1742219434,1742219435.170232,-18000,EB445137-D7F5-57EC-87DA-1DB460D64046,"iPhone13,2"
com.instructure.icanvas,15,1742219352,1742219367,1742219367.867748,-18000,EB445137-D7F5-57EC-87DA-1DB460D64046,"iPhone13,2"
com.apple.mobiletimer,1,1742219351,1742219352,1742219352.3883219,-18000,EB445137-D7F5-57EC-87DA-1DB460D64046,"iPhone13,2"
com.apple.mobiletimer,9,1742188182,1742188191,1742188191.625046,-18000,EB445137-D7F5-57EC-87DA-1DB460D64046,"iPhone13,2"
com.apple.Health,47,1742188123,1742188170,1742188170.938531,-18000,EB445137-D7F5-57EC-87DA-1DB460D64046,"iPhone13,2"
com.apple.CoreAuthUI,11,1742187543,1742187554,1742187554.135178,-18000,EB445137-D7F5-57EC-87DA-1DB460D64046,"iPhone13,2"
com.apple.CoreAuthUI,14,1742187528,1742187542,1742187542.2106528,-18000,EB445137-D7F5-57EC-87DA-1DB460D64046,"iPhone13,2"
com.apple.journal,593,1742187527,1742188120,1742188120.545689,-18000,EB445137-D7F5-57EC-87DA-1DB460D64046,"iPhone13,2"
com.apple.Health,89,1742187435,1742187524,1742187524.478555,-18000,EB445137-D7F5-57EC-87DA-1DB460D64046,"iPhone13,2"
com.strava.stravaride,3,1742187429,1742187432,1742187432.038132,-18000,EB445137-D7F5-57EC-87DA-1DB460D64046,"iPhone13,2"
com.strava.stravaride,54,1742186990,1742187044,1742187044.086092,-18000,EB445137-D7F5-57EC-87DA-1DB460D64046,"iPhone13,2"
com.apple.CoreAuthUI,2,1742186586,1742186588,1742186588.682702,-18000,EB445137-D7F5-57EC-87DA-1DB460D64046,"iPhone13,2"
com.apple.journal,397,1742186585,1742186982,1742186982.665195,-18000,EB445137-D7F5-57EC-87DA-1DB460D64046,"iPhone13,2"
com.google.chrome.ios,2,1742186581,1742186583,1742186583.250011,-18000,EB445137-D7F5-57EC-87DA-1DB460D64046,"iPhone13,2"
com.google.Chrome,17,1742186501,1742186518,1742186518.3528,-18000,,
com.google.chrome.ios,24,1742183553,1742183577,1742183577.946089,-18000,EB445137-D7F5-57EC-87DA-1DB460D64046,"iPhone13,2"
com.google.chrome.ios,30,1742183459,1742183489,1742183490.1668959,-18000,EB445137-D7F5-57EC-87DA-1DB460D64046,"iPhone13,2"
com.apple.MobileSMS,1,1742183458,1742183459,1742183459.910682,-18000,EB445137-D7F5-57EC-87DA-1DB460D64046,"iPhone13,2"
com.google.Chrome,418,1742182826,1742183244,1742183244.50688,-18000,,
com.apple.MobileSMS,71,1742182611,1742182682,1742182683.0757298,-18000,EB445137-D7F5-57EC-87DA-1DB460D64046,"iPhone13,2"
com.strava.stravaride,0,1742182611,1742182611,1742182611.7892861,-18000,EB445137-D7F5-57EC-87DA-1DB460D64046,"iPhone13,2"
com.google.Chrome,300,1742182512,1742182812,1742182813.0229921,-18000,,
com.google.Chrome,400,1742178922,1742179322,1742179322.725771,-18000,,
com.google.Chrome,318,1742178277,1742178595,1742178595.882107,-18000,,
com.google.Chrome,358,1742177225,1742177583,1742177583.6284451,-18000,,
com.google.Chrome,435,1742175548,1742175983,1742175983.309124,-18000,,
com.apple.finder,34,1742175514,1742175548,1742175549.361384,-18000,,
com.strava.stravaride,1,1742174737,1742174738,1742174738.6981611,-18000,EB445137-D7F5-57EC-87DA-1DB460D64046,"iPhone13,2"
com.strava.stravaride,47,1742174321,1742174368,1742174368.647071,-18000,EB445137-D7F5-57EC-87DA-1DB460D64046,"iPhone13,2"
com.strava.stravaride,127,1742174192,1742174319,1742174320.1155071,-18000,EB445137-D7F5-57EC-87DA-1DB460D64046,"iPhone13,2"
com.apple.mobileslideshow,18,1742174174,1742174192,1742174192.869484,-18000,EB445137-D7F5-57EC-87DA-1DB460D64046,"iPhone13,2"
com.apple.MobileSMS,24,1742174150,1742174174,1742174174.9987411,-18000,EB445137-D7F5-57EC-87DA-1DB460D64046,"iPhone13,2"
com.apple.mobileslideshow,3,1742174147,1742174150,1742174153.391927,-18000,EB445137-D7F5-57EC-87DA-1DB460D64046,"iPhone13,2"
com.strava.stravaride,130,1742174016,1742174146,1742174146.76093,-18000,EB445137-D7F5-57EC-87DA-1DB460D64046,"iPhone13,2"
com.apple.MobileSMS,8,1742173992,1742174000,1742174000.719235,-18000,EB445137-D7F5-57EC-87DA-1DB460D64046,"iPhone13,2"
com.apple.MobileSMS,121,1742173827,1742173948,1742173948.420938,-18000,EB445137-D7F5-57EC-87DA-1DB460D64046,"iPhone13,2"
com.apple.finder,3,1742173750,1742173753,1742173753.78132,-18000,,
com.apple.Notes,6,1742173744,1742173750,1742173750.940582,-18000,,
com.google.Chrome,1,1742173743,1742173744,1742173744.831074,-18000,,
com.apple.Notes,1,1742173742,1742173743,1742173743.7,-18000,,
com.apple.ScreenContinuity,10,1742173732,1742173742,1742173742.612078,-18000,,
com.apple.Photos,782,1742172950,1742173732,1742173732.764925,-18000,,
com.apple.ScreenContinuity,32,1742172918,1742172950,1742172957.96966,-18000,,
com.google.Chrome,6,1742172912,1742172918,1742172918.7001061,-18000,,
com.apple.Photos,24,1742172888,1742172912,1742172912.845848,-18000,,
com.google.Chrome,19,1742172869,1742172888,1742172888.114917,-18000,,
com.apple.mobileslideshow,177,1742172752,1742172929,1742172929.694209,-18000,EB445137-D7F5-57EC-87DA-1DB460D64046,"iPhone13,2"
com.apple.mobileslideshow,82,1742172614,1742172696,1742172696.1211228,-18000,EB445137-D7F5-57EC-87DA-1DB460D64046,"iPhone13,2"
com.apple.mobileslideshow,280,1742172334,1742172614,1742172614.28967,-18000,EB445137-D7F5-57EC-87DA-1DB460D64046,"iPhone13,2"
com.apple.mobileslideshow,31,1742172302,1742172333,1742172333.854989,-18000,EB445137-D7F5-57EC-87DA-1DB460D64046,"iPhone13,2"
com.apple.MobileSMS,20,1742172113,1742172133,1742172133.368922,-18000,EB445137-D7F5-57EC-87DA-1DB460D64046,"iPhone13,2"
com.apple.weather,0,1742172113,1742172113,1742172114.246019,-18000,EB445137-D7F5-57EC-87DA-1DB460D64046,"iPhone13,2"
com.apple.weather,31,1742171950,1742171981,1742171981.766797,-18000,EB445137-D7F5-57EC-87DA-1DB460D64046,"iPhone13,2"
com.apple.weather,14,1742171930,1742171944,1742171944.213647,-18000,EB445137-D7F5-57EC-87DA-1DB460D64046,"iPhone13,2"
com.apple.Fitness,2,1742171928,1742171930,1742171930.25859,-18000,EB445137-D7F5-57EC-87DA-1DB460D64046,"iPhone13,2"
com.apple.Fitness,11,1742169243,1742169254,1742169255.332006,-18000,EB445137-D7F5-57EC-87DA-1DB460D64046,"iPhone13,2"
com.apple.Health,2,1742169237,1742169239,1742169239.801992,-18000,EB445137-D7F5-57EC-87DA-1DB460D64046,"iPhone13,2"
com.apple.mobileslideshow,3,1742169231,1742169234,1742169234.641467,-18000,EB445137-D7F5-57EC-87DA-1DB460D64046,"iPhone13,2"
com.apple.mobileslideshow,2,1742169228,1742169230,1742169230.8385448,-18000,EB445137-D7F5-57EC-87DA-1DB460D64046,"iPhone13,2"
com.apple.mobileslideshow,124,1742168187,1742168311,1742168311.438023,-18000,EB445137-D7F5-57EC-87DA-1DB460D64046,"iPhone13,2"
com.apple.mobileslideshow,12,1742168085,1742168097,1742168097.7682328,-18000,EB445137-D7F5-57EC-87DA-1DB460D64046,"iPhone13,2"
com.apple.mobileslideshow,14,1742168069,1742168083,1742168083.834173,-18000,EB445137-D7F5-57EC-87DA-1DB460D64046,"iPhone13,2"
com.apple.mobileslideshow,102,1742167967,1742168069,1742168069.467904,-18000,EB445137-D7F5-57EC-87DA-1DB460D64046,"iPhone13,2"
com.apple.mobileslideshow,65,1742167830,1742167895,1742167895.9227982,-18000,EB445137-D7F5-57EC-87DA-1DB460D64046,"iPhone13,2"
com.apple.calculator,1,1742167828,1742167829,1742167829.574142,-18000,EB445137-D7F5-57EC-87DA-1DB460D64046,"iPhone13,2"
com.apple.calculator,5,1742166295,1742166300,1742166301.34905,-18000,EB445137-D7F5-57EC-87DA-1DB460D64046,"iPhone13,2"
com.strava.stravaride,9,1742166286,1742166295,1742166295.307694,-18000,EB445137-D7F5-57EC-87DA-1DB460D64046,"iPhone13,2"
com.google.Maps,2,1742166284,1742166286,1742166286.6524138,-18000,EB445137-D7F5-57EC-87DA-1DB460D64046,"iPhone13,2"
com.google.Maps,7,1742165944,1742165951,1742165951.9764009,-18000,EB445137-D7F5-57EC-87DA-1DB460D64046,"iPhone13,2"
com.google.Maps,3,1742165752,1742165755,1742165755.154554,-18000,EB445137-D7F5-57EC-87DA-1DB460D64046,"iPhone13,2"
com.google.Maps,8,1742165743,1742165751,1742165751.7315722,-18000,EB445137-D7F5-57EC-87DA-1DB460D64046,"iPhone13,2"
com.apple.mobileslideshow,2,1742165741,1742165743,1742165743.525528,-18000,EB445137-D7F5-57EC-87DA-1DB460D64046,"iPhone13,2"
com.strava.stravaride,1,1742165740,1742165741,1742165741.90874,-18000,EB445137-D7F5-57EC-87DA-1DB460D64046,"iPhone13,2"
com.strava.stravaride,16,1742165538,1742165554,1742165554.3595328,-18000,EB445137-D7F5-57EC-87DA-1DB460D64046,"iPhone13,2"
com.apple.mobileslideshow,3,1742165535,1742165538,1742165538.0685139,-18000,EB445137-D7F5-57EC-87DA-1DB460D64046,"iPhone13,2"
com.apple.mobileslideshow,20,1742165465,1742165485,1742165485.463084,-18000,EB445137-D7F5-57EC-87DA-1DB460D64046,"iPhone13,2"
com.google.Maps,68,1742165397,1742165465,1742165465.575661,-18000,EB445137-D7F5-57EC-87DA-1DB460D64046,"iPhone13,2"
com.strava.stravaride,7,1742165390,1742165397,1742165397.296587,-18000,EB445137-D7F5-57EC-87DA-1DB460D64046,"iPhone13,2"
com.strava.stravaride,3,1742164645,1742164648,1742164648.638864,-18000,EB445137-D7F5-57EC-87DA-1DB460D64046,"iPhone13,2"
com.google.chrome.ios,1,1742164644,1742164645,1742164645.568588,-18000,EB445137-D7F5-57EC-87DA-1DB460D64046,"iPhone13,2"
com.google.Maps,21,1742164336,1742164357,1742164357.769073,-18000,EB445137-D7F5-57EC-87DA-1DB460D64046,"iPhone13,2"
com.apple.InCallService,1,1742164308,1742164309,1742164309.855418,-18000,EB445137-D7F5-57EC-87DA-1DB460D64046,"iPhone13,2"
com.google.Maps,13,1742162236,1742162249,1742162249.172255,-18000,EB445137-D7F5-57EC-87DA-1DB460D64046,"iPhone13,2"
com.apple.mobileslideshow,27,1742162209,1742162236,1742162236.549633,-18000,EB445137-D7F5-57EC-87DA-1DB460D64046,"iPhone13,2"
com.google.Maps,5,1742162204,1742162209,1742162209.695194,-18000,EB445137-D7F5-57EC-87DA-1DB460D64046,"iPhone13,2"
com.google.Maps,6,1742161992,1742161998,1742161998.206222,-18000,EB445137-D7F5-57EC-87DA-1DB460D64046,"iPhone13,2"
com.google.Maps,20,1742161897,1742161917,1742161917.846241,-18000,EB445137-D7F5-57EC-87DA-1DB460D64046,"iPhone13,2"
com.strava.stravaride,2,1742161895,1742161897,1742161897.942882,-18000,EB445137-D7F5-57EC-87DA-1DB460D64046,"iPhone13,2"
com.strava.stravaride,3,1742161422,1742161425,1742161425.803673,-18000,EB445137-D7F5-57EC-87DA-1DB460D64046,"iPhone13,2"
com.google.Maps,29,1742161359,1742161388,1742161388.1606221,-18000,EB445137-D7F5-57EC-87DA-1DB460D64046,"iPhone13,2"
com.google.Maps,10,1742161335,1742161345,1742161346.060501,-18000,EB445137-D7F5-57EC-87DA-1DB460D64046,"iPhone13,2"
com.google.Maps,43,1742161025,1742161068,1742161068.9506822,-18000,EB445137-D7F5-57EC-87DA-1DB460D64046,"iPhone13,2"
com.apple.mobileslideshow,2,1742161023,1742161025,1742161025.609074,-18000,EB445137-D7F5-57EC-87DA-1DB460D64046,"iPhone13,2"
com.apple.mobileslideshow,14,1742160666,1742160680,1742160681.009358,-18000,EB445137-D7F5-57EC-87DA-1DB460D64046,"iPhone13,2"
com.google.Maps,24,1742160642,1742160666,1742160666.0690222,-18000,EB445137-D7F5-57EC-87DA-1DB460D64046,"iPhone13,2"
com.google.Maps,19,1742160418,1742160437,1742160437.485835,-18000,EB445137-D7F5-57EC-87DA-1DB460D64046,"iPhone13,2"
com.apple.mobileslideshow,4,1742160414,1742160418,1742160418.819804,-18000,EB445137-D7F5-57EC-87DA-1DB460D64046,"iPhone13,2"
com.google.Maps,26,1742160388,1742160414,1742160414.6236,-18000,EB445137-D7F5-57EC-87DA-1DB460D64046,"iPhone13,2"
com.google.Maps,17,1742160138,1742160155,1742160156.0155292,-18000,EB445137-D7F5-57EC-87DA-1DB460D64046,"iPhone13,2"
com.strava.stravaride,2,1742160136,1742160138,1742160138.8056731,-18000,EB445137-D7F5-57EC-87DA-1DB460D64046,"iPhone13,2"
com.strava.stravaride,14,1742159740,1742159754,1742159754.883006,-18000,EB445137-D7F5-57EC-87DA-1DB460D64046,"iPhone13,2"
com.google.Maps,2,1742159731,1742159733,1742159733.440021,-18000,EB445137-D7F5-57EC-87DA-1DB460D64046,"iPhone13,2"
com.google.Maps,8,1742159661,1742159669,1742159669.923095,-18000,EB445137-D7F5-57EC-87DA-1DB460D64046,"iPhone13,2"
com.apple.mobileslideshow,5,1742159656,1742159661,1742159661.9896379,-18000,EB445137-D7F5-57EC-87DA-1DB460D64046,"iPhone13,2"
com.google.Maps,7,1742159649,1742159656,1742159656.678966,-18000,EB445137-D7F5-57EC-87DA-1DB460D64046,"iPhone13,2"
com.apple.mobileslideshow,24,1742159625,1742159649,1742159649.279669,-18000,EB445137-D7F5-57EC-87DA-1DB460D64046,"iPhone13,2"
com.apple.mobileslideshow,47,1742158385,1742158432,1742158432.9067168,-18000,EB445137-D7F5-57EC-87DA-1DB460D64046,"iPhone13,2"
com.google.Maps,5,1742158380,1742158385,1742158385.232534,-18000,EB445137-D7F5-57EC-87DA-1DB460D64046,"iPhone13,2"
com.apple.mobileslideshow,10,1742158370,1742158380,1742158380.471981,-18000,EB445137-D7F5-57EC-87DA-1DB460D64046,"iPhone13,2"
com.apple.mobileslideshow,10,1742156642,1742156652,1742156652.689005,-18000,EB445137-D7F5-57EC-87DA-1DB460D64046,"iPhone13,2"
com.google.Maps,9,1742156633,1742156642,1742156642.761338,-18000,EB445137-D7F5-57EC-87DA-1DB460D64046,"iPhone13,2"
com.apple.mobileslideshow,30,1742156603,1742156633,1742156634.027662,-18000,EB445137-D7F5-57EC-87DA-1DB460D64046,"iPhone13,2"
com.apple.mobileslideshow,23,1742155227,1742155250,1742155250.6939669,-18000,EB445137-D7F5-57EC-87DA-1DB460D64046,"iPhone13,2"
com.apple.mobileslideshow,10,1742155213,1742155223,1742155224.010426,-18000,EB445137-D7F5-57EC-87DA-1DB460D64046,"iPhone13,2"
com.google.Maps,4,1742155209,1742155213,1742155213.080256,-18000,EB445137-D7F5-57EC-87DA-1DB460D64046,"iPhone13,2"
com.apple.mobileslideshow,34,1742154359,1742154393,1742154393.496303,-18000,EB445137-D7F5-57EC-87DA-1DB460D64046,"iPhone13,2"
com.google.Maps,5,1742154354,1742154359,1742154359.618689,-18000,EB445137-D7F5-57EC-87DA-1DB460D64046,"iPhone13,2"
com.apple.mobileslideshow,10,1742154344,1742154354,1742154354.464881,-18000,EB445137-D7F5-57EC-87DA-1DB460D64046,"iPhone13,2"
com.google.Maps,26,1742153148,1742153174,1742153174.598732,-18000,EB445137-D7F5-57EC-87DA-1DB460D64046,"iPhone13,2"
com.apple.mobileslideshow,2,1742153146,1742153148,1742153148.238745,-18000,EB445137-D7F5-57EC-87DA-1DB460D64046,"iPhone13,2"
com.apple.mobileslideshow,11,1742151892,1742151903,1742151904.176846,-18000,EB445137-D7F5-57EC-87DA-1DB460D64046,"iPhone13,2"
com.google.Maps,5,1742151887,1742151892,1742151892.6117969,-18000,EB445137-D7F5-57EC-87DA-1DB460D64046,"iPhone13,2"
com.google.Maps,65,1742151819,1742151884,1742151884.802034,-18000,EB445137-D7F5-57EC-87DA-1DB460D64046,"iPhone13,2"
com.apple.mobileslideshow,3,1742151816,1742151819,1742151819.97594,-18000,EB445137-D7F5-57EC-87DA-1DB460D64046,"iPhone13,2"
com.apple.Health,2,1742151814,1742151816,1742151816.560178,-18000,EB445137-D7F5-57EC-87DA-1DB460D64046,"iPhone13,2"
com.apple.Health,47,1742151015,1742151062,1742151062.307541,-18000,EB445137-D7F5-57EC-87DA-1DB460D64046,"iPhone13,2"
com.apple.mobileslideshow,2,1742151012,1742151014,1742151014.135365,-18000,EB445137-D7F5-57EC-87DA-1DB460D64046,"iPhone13,2"
com.apple.mobileslideshow,86,1742150308,1742150394,1742150394.9477038,-18000,EB445137-D7F5-57EC-87DA-1DB460D64046,"iPhone13,2"
com.google.Maps,9,1742150288,1742150297,1742150297.9957151,-18000,EB445137-D7F5-57EC-87DA-1DB460D64046,"iPhone13,2"
com.google.chrome.ios,2,1742150285,1742150287,1742150287.3183532,-18000,EB445137-D7F5-57EC-87DA-1DB460D64046,"iPhone13,2"
com.google.chrome.ios,8,1742150144,1742150152,1742150152.871179,-18000,EB445137-D7F5-57EC-87DA-1DB460D64046,"iPhone13,2"
com.google.Maps,36,1742149250,1742149286,1742149287.174259,-18000,EB445137-D7F5-57EC-87DA-1DB460D64046,"iPhone13,2"
com.apple.Maps,2,1742149248,1742149250,1742149250.265075,-18000,EB445137-D7F5-57EC-87DA-1DB460D64046,"iPhone13,2"
com.apple.camera,1,1742149245,1742149246,1742149246.731986,-18000,EB445137-D7F5-57EC-87DA-1DB460D64046,"iPhone13,2"
com.apple.camera,74,1742149169,1742149243,1742149243.267002,-18000,EB445137-D7F5-57EC-87DA-1DB460D64046,"iPhone13,2"
com.apple.camera,12,1742148034,1742148046,1742148060.178756,-18000,EB445137-D7F5-57EC-87DA-1DB460D64046,"iPhone13,2"
com.google.chrome.ios,0,1742148034,1742148034,1742148058.549094,-18000,EB445137-D7F5-57EC-87DA-1DB460D64046,"iPhone13,2"
com.google.chrome.ios,26,1742147228,1742147254,1742147255.652334,-18000,EB445137-D7F5-57EC-87DA-1DB460D64046,"iPhone13,2"
com.google.chrome.ios,95,1742147130,1742147225,1742147225.8449621,-18000,EB445137-D7F5-57EC-87DA-1DB460D64046,"iPhone13,2"
com.apple.weather,4,1742147126,1742147130,1742147131.0494928,-18000,EB445137-D7F5-57EC-87DA-1DB460D64046,"iPhone13,2"
com.google.chrome.ios,5,1742147120,1742147125,1742147125.513006,-18000,EB445137-D7F5-57EC-87DA-1DB460D64046,"iPhone13,2"
com.apple.mobilenotes,8,1742147112,1742147120,1742147120.954401,-18000,EB445137-D7F5-57EC-87DA-1DB460D64046,"iPhone13,2"
com.microsoft.onenote,1,1742147110,1742147111,1742147111.815254,-18000,EB445137-D7F5-57EC-87DA-1DB460D64046,"iPhone13,2"
com.apple.mobileslideshow,37,1742147070,1742147107,1742147107.880797,-18000,EB445137-D7F5-57EC-87DA-1DB460D64046,"iPhone13,2"
com.apple.MobileSMS,29,1742147038,1742147067,1742147067.892842,-18000,EB445137-D7F5-57EC-87DA-1DB460D64046,"iPhone13,2"
com.apple.MobileSMS,67,1742146569,1742146636,1742146636.954988,-18000,EB445137-D7F5-57EC-87DA-1DB460D64046,"iPhone13,2"
com.apple.MobileSMS,18,1742145995,1742146013,1742146013.4669771,-18000,EB445137-D7F5-57EC-87DA-1DB460D64046,"iPhone13,2"
com.apple.weather,0,1742145995,1742145995,1742145997.081664,-18000,EB445137-D7F5-57EC-87DA-1DB460D64046,"iPhone13,2"
com.apple.weather,51,1742145755,1742145806,1742145807.067227,-18000,EB445137-D7F5-57EC-87DA-1DB460D64046,"iPhone13,2"
com.apple.mobilecal,2,1742145753,1742145755,1742145755.2957659,-18000,EB445137-D7F5-57EC-87DA-1DB460D64046,"iPhone13,2"
com.apple.mobilecal,49,1742143528,1742143577,1742143577.711059,-18000,EB445137-D7F5-57EC-87DA-1DB460D64046,"iPhone13,2"
com.apple.mobilecal,7,1742143521,1742143528,1742143528.8801398,-18000,EB445137-D7F5-57EC-87DA-1DB460D64046,"iPhone13,2"
com.apple.calculator,2,1742143501,1742143503,1742143503.6749191,-18000,EB445137-D7F5-57EC-87DA-1DB460D64046,"iPhone13,2"
com.apple.calculator,22,1742143472,1742143494,1742143494.545105,-18000,EB445137-D7F5-57EC-87DA-1DB460D64046,"iPhone13,2"
com.apple.mobileslideshow,81,1742143385,1742143466,1742143466.672552,-18000,EB445137-D7F5-57EC-87DA-1DB460D64046,"iPhone13,2"
com.apple.MobileSMS,40,1742143345,1742143385,1742143385.301307,-18000,EB445137-D7F5-57EC-87DA-1DB460D64046,"iPhone13,2"
com.apple.InCallService,53,1742142749,1742142802,1742142802.648188,-18000,EB445137-D7F5-57EC-87DA-1DB460D64046,"iPhone13,2"
com.apple.mobilephone,3,1742142746,1742142749,1742142749.1857882,-18000,EB445137-D7F5-57EC-87DA-1DB460D64046,"iPhone13,2"
com.google.Maps,64,1742142682,1742142746,1742142746.2492619,-18000,EB445137-D7F5-57EC-87DA-1DB460D64046,"iPhone13,2"
com.apple.InCallService,1111,1742141571,1742142682,1742142683.135323,-18000,EB445137-D7F5-57EC-87DA-1DB460D64046,"iPhone13,2"
com.google.Maps,10,1742141561,1742141571,1742141571.762916,-18000,EB445137-D7F5-57EC-87DA-1DB460D64046,"iPhone13,2"
com.apple.InCallService,4,1742141557,1742141561,1742141561.263214,-18000,EB445137-D7F5-57EC-87DA-1DB460D64046,"iPhone13,2"
com.google.Maps,3280,1742138277,1742141557,1742141557.269552,-18000,EB445137-D7F5-57EC-87DA-1DB460D64046,"iPhone13,2"
com.google.Maps,131,1742137166,1742137297,1742137297.4778352,-18000,EB445137-D7F5-57EC-87DA-1DB460D64046,"iPhone13,2"
com.apple.MobileSMS,6,1742135671,1742135677,1742135678.035234,-18000,EB445137-D7F5-57EC-87DA-1DB460D64046,"iPhone13,2"
com.apple.Maps,1,1742135670,1742135671,1742135672.379878,-18000,EB445137-D7F5-57EC-87DA-1DB460D64046,"iPhone13,2"
com.google.Chrome,68,1742134944,1742135012,1742135012.749645,-18000,,
com.apple.Notes,2,1742134942,1742134944,1742134944.9010072,-18000,,
com.apple.Maps,216,1742134796,1742135012,1742135012.236022,-18000,EB445137-D7F5-57EC-87DA-1DB460D64046,"iPhone13,2"
com.apple.news,1,1742134791,1742134792,1742134792.3928308,-18000,EB445137-D7F5-57EC-87DA-1DB460D64046,"iPhone13,2"
com.google.Chrome,678,1742134264,1742134942,1742134942.3029819,-18000,,
com.apple.Notes,9,1742134255,1742134264,1742134264.815583,-18000,,
com.google.Chrome,6,1742134249,1742134255,1742134256.0612211,-18000,,
com.apple.news,9,1742133402,1742133411,1742133412.345648,-18000,EB445137-D7F5-57EC-87DA-1DB460D64046,"iPhone13,2"
com.apple.news,1,1742133390,1742133391,1742133392.00354,-18000,EB445137-D7F5-57EC-87DA-1DB460D64046,"iPhone13,2"
com.apple.news,89,1742133277,1742133366,1742133367.268512,-18000,EB445137-D7F5-57EC-87DA-1DB460D64046,"iPhone13,2"
com.apple.Health,31,1742133237,1742133268,1742133268.815067,-18000,EB445137-D7F5-57EC-87DA-1DB460D64046,"iPhone13,2"
com.groupme.iphone-app,9,1742132352,1742132361,1742132361.7135081,-18000,EB445137-D7F5-57EC-87DA-1DB460D64046,"iPhone13,2"
com.apple.journal,1200,1742100404,1742101604,1742101604.665399,-18000,EB445137-D7F5-57EC-87DA-1DB460D64046,"iPhone13,2"
com.apple.MobileSMS,14,1742100390,1742100404,1742100404.4451451,-18000,EB445137-D7F5-57EC-87DA-1DB460D64046,"iPhone13,2"
com.apple.CoreAuthUI,2,1742099180,1742099182,1742099182.5581799,-18000,EB445137-D7F5-57EC-87DA-1DB460D64046,"iPhone13,2"
com.apple.journal,1210,1742099179,1742100389,1742100389.680217,-18000,EB445137-D7F5-57EC-87DA-1DB460D64046,"iPhone13,2"
com.apple.MobileSMS,7,1742099150,1742099157,1742099157.697094,-18000,EB445137-D7F5-57EC-87DA-1DB460D64046,"iPhone13,2"
com.google.Chrome,11,1742098434,1742098445,1742098445.2600632,-18000,,
com.google.Chrome,542,1742094589,1742095131,1742095131.228785,-18000,,
com.microsoft.Office.Outlook,8,1742094473,1742094481,1742094481.672818,-18000,EB445137-D7F5-57EC-87DA-1DB460D64046,"iPhone13,2"
com.apple.MobileSMS,1,1742094472,1742094473,1742094473.2220268,-18000,EB445137-D7F5-57EC-87DA-1DB460D64046,"iPhone13,2"
com.google.Chrome,448,1742093495,1742093943,1742093943.1528811,-18000,,
com.apple.MobileSMS,40,1742089994,1742090034,1742090035.163433,-18000,EB445137-D7F5-57EC-87DA-1DB460D64046,"iPhone13,2"
com.apple.MobileSMS,8,1742089979,1742089987,1742090022.1381521,-18000,EB445137-D7F5-57EC-87DA-1DB460D64046,"iPhone13,2"
com.google.Chrome,442,1742089028,1742089470,1742089470.847056,-18000,,
com.google.Chrome,320,1742087987,1742088307,1742088307.9168549,-18000,,
com.google.Chrome,299,1742087003,1742087302,1742087302.333844,-18000,,
com.apple.systempreferences,0,1742086998,1742086998,1742086998.920428,-18000,,
com.apple.MobileSMS,2,1742086892,1742086894,1742086895.5127769,-18000,EB445137-D7F5-57EC-87DA-1DB460D64046,"iPhone13,2"
com.apple.MobileSMS,5,1742086887,1742086892,1742086894.896899,-18000,EB445137-D7F5-57EC-87DA-1DB460D64046,"iPhone13,2"
com.google.Chrome,858,1742086124,1742086982,1742086982.967698,-18000,,
com.apple.finder,1,1742086123,1742086124,1742086124.244631,-18000,,
com.apple.systempreferences,52,1742086071,1742086123,1742086123.225637,-18000,,
com.apple.finder,3,1742086061,1742086064,1742086064.031519,-18000,,
com.google.Chrome,142,1742085919,1742086061,1742086061.483129,-18000,,
com.apple.MobileSMS,26,1742083062,1742083088,1742083088.9405432,-18000,EB445137-D7F5-57EC-87DA-1DB460D64046,"iPhone13,2"
com.apple.mobileslideshow,9,1742083053,1742083062,1742083062.6211371,-18000,EB445137-D7F5-57EC-87DA-1DB460D64046,"iPhone13,2"
com.google.Maps,15,1742082251,1742082266,1742082266.555616,-18000,EB445137-D7F5-57EC-87DA-1DB460D64046,"iPhone13,2"
com.google.Maps,22,1742081571,1742081593,1742081594.309764,-18000,EB445137-D7F5-57EC-87DA-1DB460D64046,"iPhone13,2"
com.apple.camera,1,1742081569,1742081570,1742081570.659286,-18000,EB445137-D7F5-57EC-87DA-1DB460D64046,"iPhone13,2"
com.apple.camera,61,1742080257,1742080318,1742080325.373611,-18000,EB445137-D7F5-57EC-87DA-1DB460D64046,"iPhone13,2"
com.apple.mobileslideshow,2,1742080254,1742080256,1742080256.32565,-18000,EB445137-D7F5-57EC-87DA-1DB460D64046,"iPhone13,2"
com.apple.mobileslideshow,142,1742079781,1742079923,1742079924.082008,-18000,EB445137-D7F5-57EC-87DA-1DB460D64046,"iPhone13,2"
com.apple.InCallService,5,1742079776,1742079781,1742079781.681182,-18000,EB445137-D7F5-57EC-87DA-1DB460D64046,"iPhone13,2"
com.apple.mobilephone,2,1742079774,1742079776,1742079777.027962,-18000,EB445137-D7F5-57EC-87DA-1DB460D64046,"iPhone13,2"
com.apple.mobileslideshow,15,1742079759,1742079774,1742079774.786615,-18000,EB445137-D7F5-57EC-87DA-1DB460D64046,"iPhone13,2"
com.google.Maps,4,1742079548,1742079552,1742079552.701272,-18000,EB445137-D7F5-57EC-87DA-1DB460D64046,"iPhone13,2"
com.google.Maps,33,1742078817,1742078850,1742078850.219238,-18000,EB445137-D7F5-57EC-87DA-1DB460D64046,"iPhone13,2"
com.google.Maps,228,1742078502,1742078730,1742078730.762352,-18000,EB445137-D7F5-57EC-87DA-1DB460D64046,"iPhone13,2"
com.apple.mobileslideshow,8,1742078494,1742078502,1742078502.9049392,-18000,EB445137-D7F5-57EC-87DA-1DB460D64046,"iPhone13,2"
com.google.Maps,61,1742078433,1742078494,1742078494.2259789,-18000,EB445137-D7F5-57EC-87DA-1DB460D64046,"iPhone13,2"
com.apple.mobileslideshow,11,1742078422,1742078433,1742078433.850885,-18000,EB445137-D7F5-57EC-87DA-1DB460D64046,"iPhone13,2"
com.google.Maps,7,1742078401,1742078408,1742078408.6835089,-18000,EB445137-D7F5-57EC-87DA-1DB460D64046,"iPhone13,2"
com.apple.MobileSMS,23,1742078378,1742078401,1742078401.682344,-18000,EB445137-D7F5-57EC-87DA-1DB460D64046,"iPhone13,2"
com.google.Maps,108,1742078269,1742078377,1742078377.5800471,-18000,EB445137-D7F5-57EC-87DA-1DB460D64046,"iPhone13,2"
com.google.Maps,52,1742078114,1742078166,1742078166.6201549,-18000,EB445137-D7F5-57EC-87DA-1DB460D64046,"iPhone13,2"
com.google.Maps,24,1742078037,1742078061,1742078061.919483,-18000,EB445137-D7F5-57EC-87DA-1DB460D64046,"iPhone13,2"
com.toyopagroup.picaboo,3,1742077877,1742077880,1742077880.841464,-18000,EB445137-D7F5-57EC-87DA-1DB460D64046,"iPhone13,2"
com.google.Maps,1,1742077876,1742077877,1742077878.2328238,-18000,EB445137-D7F5-57EC-87DA-1DB460D64046,"iPhone13,2"
com.google.Maps,9,1742077866,1742077875,1742077875.5773501,-18000,EB445137-D7F5-57EC-87DA-1DB460D64046,"iPhone13,2"
com.google.Maps,16,1742077553,1742077569,1742077570.201529,-18000,EB445137-D7F5-57EC-87DA-1DB460D64046,"iPhone13,2"
com.google.Maps,43,1742077502,1742077545,1742077546.2478728,-18000,EB445137-D7F5-57EC-87DA-1DB460D64046,"iPhone13,2"
com.apple.MobileSMS,2,1742077499,1742077501,1742077501.901612,-18000,EB445137-D7F5-57EC-87DA-1DB460D64046,"iPhone13,2"
com.apple.MobileSMS,8,1742076369,1742076377,1742076377.630358,-18000,EB445137-D7F5-57EC-87DA-1DB460D64046,"iPhone13,2"
com.apple.MobileSMS,21,1742076337,1742076358,1742076358.762825,-18000,EB445137-D7F5-57EC-87DA-1DB460D64046,"iPhone13,2"
com.apple.findmy,6,1742076331,1742076337,1742076337.6073918,-18000,EB445137-D7F5-57EC-87DA-1DB460D64046,"iPhone13,2"
com.apple.MobileSMS,6,1742076325,1742076331,1742076331.344615,-18000,EB445137-D7F5-57EC-87DA-1DB460D64046,"iPhone13,2"
com.apple.weather,1,1742076324,1742076325,1742076325.859772,-18000,EB445137-D7F5-57EC-87DA-1DB460D64046,"iPhone13,2"
com.apple.weather,6,1742075928,1742075934,1742075935.134859,-18000,EB445137-D7F5-57EC-87DA-1DB460D64046,"iPhone13,2"
com.toyopagroup.picaboo,1,1742075927,1742075928,1742075928.903846,-18000,EB445137-D7F5-57EC-87DA-1DB460D64046,"iPhone13,2"
com.toyopagroup.picaboo,7,1742075900,1742075907,1742075907.335363,-18000,EB445137-D7F5-57EC-87DA-1DB460D64046,"iPhone13,2"
com.apple.MobileSMS,1,1742075899,1742075900,1742075900.085898,-18000,EB445137-D7F5-57EC-87DA-1DB460D64046,"iPhone13,2"
com.apple.MobileSMS,36,1742075860,1742075896,1742075896.450101,-18000,EB445137-D7F5-57EC-87DA-1DB460D64046,"iPhone13,2"
com.google.Maps,1,1742075859,1742075860,1742075860.986061,-18000,EB445137-D7F5-57EC-87DA-1DB460D64046,"iPhone13,2"
com.google.Maps,3664,1742072186,1742075850,1742075850.8198562,-18000,EB445137-D7F5-57EC-87DA-1DB460D64046,"iPhone13,2"
com.apple.MobileSMS,5,1742072181,1742072186,1742072186.218193,-18000,EB445137-D7F5-57EC-87DA-1DB460D64046,"iPhone13,2"
com.google.Maps,53,1742072128,1742072181,1742072181.303848,-18000,EB445137-D7F5-57EC-87DA-1DB460D64046,"iPhone13,2"
com.google.Maps,27,1742071899,1742071926,1742071927.043336,-18000,EB445137-D7F5-57EC-87DA-1DB460D64046,"iPhone13,2"
com.apple.MobileSMS,2,1742071897,1742071899,1742071899.456943,-18000,EB445137-D7F5-57EC-87DA-1DB460D64046,"iPhone13,2"
com.apple.MobileSMS,49,1742071559,1742071608,1742071609.610766,-18000,EB445137-D7F5-57EC-87DA-1DB460D64046,"iPhone13,2"
com.google.Maps,15,1742071544,1742071559,1742071560.040309,-18000,EB445137-D7F5-57EC-87DA-1DB460D64046,"iPhone13,2"
com.google.Maps,44,1742071417,1742071461,1742071461.072027,-18000,EB445137-D7F5-57EC-87DA-1DB460D64046,"iPhone13,2"
com.apple.weather,4,1742071412,1742071416,1742071416.880004,-18000,EB445137-D7F5-57EC-87DA-1DB460D64046,"iPhone13,2"
com.apple.weather,13,1742071376,1742071389,1742071390.10633,-18000,EB445137-D7F5-57EC-87DA-1DB460D64046,"iPhone13,2"
com.apple.weather,29,1742071341,1742071370,1742071370.954969,-18000,EB445137-D7F5-57EC-87DA-1DB460D64046,"iPhone13,2"
com.apple.weather,6,1742071334,1742071340,1742071340.675466,-18000,EB445137-D7F5-57EC-87DA-1DB460D64046,"iPhone13,2"
com.apple.weather,8,1742071324,1742071332,1742071332.6251469,-18000,EB445137-D7F5-57EC-87DA-1DB460D64046,"iPhone13,2"
com.apple.weather,35,1742071265,1742071300,1742071300.154989,-18000,EB445137-D7F5-57EC-87DA-1DB460D64046,"iPhone13,2"
com.apple.weather,5,1742071032,1742071037,1742071037.187265,-18000,EB445137-D7F5-57EC-87DA-1DB460D64046,"iPhone13,2"
com.apple.weather,10,1742070252,1742070262,1742070262.576895,-18000,EB445137-D7F5-57EC-87DA-1DB460D64046,"iPhone13,2"
com.apple.weather,64,1742070035,1742070099,1742070099.289249,-18000,EB445137-D7F5-57EC-87DA-1DB460D64046,"iPhone13,2"
com.google.Maps,3,1742069434,1742069437,1742069437.36273,-18000,EB445137-D7F5-57EC-87DA-1DB460D64046,"iPhone13,2"
com.google.Maps,90,1742069071,1742069161,1742069161.374928,-18000,EB445137-D7F5-57EC-87DA-1DB460D64046,"iPhone13,2"
com.apple.InCallService,349,1742066945,1742067294,1742067294.139267,-18000,EB445137-D7F5-57EC-87DA-1DB460D64046,"iPhone13,2"
com.apple.mobilephone,13,1742066932,1742066945,1742066945.9649339,-18000,EB445137-D7F5-57EC-87DA-1DB460D64046,"iPhone13,2"
com.apple.mobilephone,2,1742066930,1742066932,1742066932.397592,-18000,EB445137-D7F5-57EC-87DA-1DB460D64046,"iPhone13,2"
com.apple.mobilephone,1,1742066919,1742066920,1742066920.561005,-18000,EB445137-D7F5-57EC-87DA-1DB460D64046,"iPhone13,2"
com.apple.InCallService,253,1742066666,1742066919,1742066919.235559,-18000,EB445137-D7F5-57EC-87DA-1DB460D64046,"iPhone13,2"
com.apple.mobilephone,5,1742066661,1742066666,1742066666.8678942,-18000,EB445137-D7F5-57EC-87DA-1DB460D64046,"iPhone13,2"
com.apple.news,2,1742066658,1742066660,1742066660.862452,-18000,EB445137-D7F5-57EC-87DA-1DB460D64046,"iPhone13,2"
com.google.Maps,2,1742066616,1742066618,1742066618.691911,-18000,EB445137-D7F5-57EC-87DA-1DB460D64046,"iPhone13,2"
com.google.Maps,3,1742066605,1742066608,1742066608.408782,-18000,EB445137-D7F5-57EC-87DA-1DB460D64046,"iPhone13,2"
com.google.Maps,80,1742066476,1742066556,1742066556.8994498,-18000,EB445137-D7F5-57EC-87DA-1DB460D64046,"iPhone13,2"
com.google.Maps,73,1742066176,1742066249,1742066249.776963,-18000,EB445137-D7F5-57EC-87DA-1DB460D64046,"iPhone13,2"
com.google.Maps,71,1742066104,1742066175,1742066175.164516,-18000,EB445137-D7F5-57EC-87DA-1DB460D64046,"iPhone13,2"
com.apple.Maps,40,1742066062,1742066102,1742066102.248179,-18000,EB445137-D7F5-57EC-87DA-1DB460D64046,"iPhone13,2"
com.apple.MobileSMS,92,1742065970,1742066062,1742066062.172437,-18000,EB445137-D7F5-57EC-87DA-1DB460D64046,"iPhone13,2"
com.apple.Maps,2,1742065968,1742065970,1742065970.115253,-18000,EB445137-D7F5-57EC-87DA-1DB460D64046,"iPhone13,2"
com.apple.Maps,25,1742065938,1742065963,1742065963.614213,-18000,EB445137-D7F5-57EC-87DA-1DB460D64046,"iPhone13,2"
com.apple.MobileSMS,26,1742065911,1742065937,1742065937.992018,-18000,EB445137-D7F5-57EC-87DA-1DB460D64046,"iPhone13,2"
com.apple.MobileSMS,4,1742065906,1742065910,1742065910.943112,-18000,EB445137-D7F5-57EC-87DA-1DB460D64046,"iPhone13,2"
com.apple.MobileSMS,6,1742065734,1742065740,1742065740.227251,-18000,EB445137-D7F5-57EC-87DA-1DB460D64046,"iPhone13,2"
com.apple.MobileSMS,2,1742065731,1742065733,1742065733.3629088,-18000,EB445137-D7F5-57EC-87DA-1DB460D64046,"iPhone13,2"
com.apple.tv,16,1742065121,1742065137,1742065137.417735,-18000,EB445137-D7F5-57EC-87DA-1DB460D64046,"iPhone13,2"
com.apple.Maps,1,1742065112,1742065113,1742065113.941138,-18000,EB445137-D7F5-57EC-87DA-1DB460D64046,"iPhone13,2"
com.apple.Maps,1,1742065111,1742065112,1742065113.667702,-18000,EB445137-D7F5-57EC-87DA-1DB460D64046,"iPhone13,2"
com.apple.Maps,2,1742065104,1742065106,1742065106.437557,-18000,EB445137-D7F5-57EC-87DA-1DB460D64046,"iPhone13,2"
com.apple.Maps,13,1742065043,1742065056,1742065056.384242,-18000,EB445137-D7F5-57EC-87DA-1DB460D64046,"iPhone13,2"
com.apple.weather,38,1742064870,1742064908,1742064908.6701531,-18000,EB445137-D7F5-57EC-87DA-1DB460D64046,"iPhone13,2"
com.apple.MobileSMS,2,1742064868,1742064870,1742064870.441152,-18000,EB445137-D7F5-57EC-87DA-1DB460D64046,"iPhone13,2"
com.apple.MobileSMS,4,1742064849,1742064853,1742064853.857355,-18000,EB445137-D7F5-57EC-87DA-1DB460D64046,"iPhone13,2"
com.apple.MobileSMS,17,1742064788,1742064805,1742064805.120768,-18000,EB445137-D7F5-57EC-87DA-1DB460D64046,"iPhone13,2"
com.apple.weather,20,1742064768,1742064788,1742064788.543052,-18000,EB445137-D7F5-57EC-87DA-1DB460D64046,"iPhone13,2"
com.apple.findmy,16,1742064752,1742064768,1742064768.5809379,-18000,EB445137-D7F5-57EC-87DA-1DB460D64046,"iPhone13,2"
com.apple.weather,5,1742064744,1742064749,1742064749.335393,-18000,EB445137-D7F5-57EC-87DA-1DB460D64046,"iPhone13,2"
com.apple.weather,27,1742064702,1742064729,1742064729.770478,-18000,EB445137-D7F5-57EC-87DA-1DB460D64046,"iPhone13,2"
com.apple.Music,2,1742061857,1742061859,1742061859.454612,-18000,EB445137-D7F5-57EC-87DA-1DB460D64046,"iPhone13,2"
com.apple.Music,4,1742060996,1742061000,1742061001.639954,-18000,EB445137-D7F5-57EC-87DA-1DB460D64046,"iPhone13,2"
com.apple.Maps,1,1742060995,1742060996,1742060997.3060741,-18000,EB445137-D7F5-57EC-87DA-1DB460D64046,"iPhone13,2"
com.apple.Maps,8,1742060800,1742060808,1742060809.101799,-18000,EB445137-D7F5-57EC-87DA-1DB460D64046,"iPhone13,2"
com.apple.Maps,23,1742060574,1742060597,1742060598.325244,-18000,EB445137-D7F5-57EC-87DA-1DB460D64046,"iPhone13,2"
com.apple.news,1,1742060567,1742060568,1742060568.434567,-18000,EB445137-D7F5-57EC-87DA-1DB460D64046,"iPhone13,2"
com.apple.news,9,1742059995,1742060004,1742060004.066433,-18000,EB445137-D7F5-57EC-87DA-1DB460D64046,"iPhone13,2"
com.apple.news,312,1742059674,1742059986,1742059986.6649451,-18000,EB445137-D7F5-57EC-87DA-1DB460D64046,"iPhone13,2"
com.apple.MobileSMS,2,1742059669,1742059671,1742059671.7096028,-18000,EB445137-D7F5-57EC-87DA-1DB460D64046,"iPhone13,2"
com.google.Chrome,334,1742059630,1742059964,1742059964.730571,-18000,,
com.apple.finder,32,1742059598,1742059630,1742059630.668227,-18000,,
com.leomehlig.today,1,1742059597,1742059598,1742059598.724906,-18000,,
com.apple.finder,1,1742059596,1742059597,1742059597.46595,-18000,,
com.google.Chrome,1,1742059595,1742059596,1742059596.390802,-18000,,
com.apple.finder,1,1742059594,1742059595,1742059595.7467098,-18000,,
com.apple.Notes,1,1742059593,1742059594,1742059594.7096329,-18000,,
com.apple.finder,8,1742059585,1742059593,1742059593.301476,-18000,,
com.apple.Photos,1,1742059584,1742059585,1742059585.835501,-18000,,
com.google.Chrome,50,1742059534,1742059584,1742059584.8648071,-18000,,
com.apple.finder,15,1742059519,1742059534,1742059534.2368078,-18000,,
com.google.Chrome,1,1742059518,1742059519,1742059519.7332358,-18000,,
com.apple.finder,6,1742059512,1742059518,1742059518.2385778,-18000,,
com.google.Chrome,46,1742059466,1742059512,1742059512.335446,-18000,,
com.apple.Photos,3,1742059463,1742059466,1742059466.112664,-18000,,
com.google.Chrome,7,1742059456,1742059463,1742059463.969219,-18000,,
com.apple.Photos,2,1742059454,1742059456,1742059456.6292582,-18000,,
com.google.Chrome,57,1742059397,1742059454,1742059454.484827,-18000,,
com.apple.MobileSMS,4,1742059393,1742059397,1742059397.869441,-18000,,
com.google.Chrome,5,1742059388,1742059393,1742059393.162755,-18000,,
com.apple.MobileSMS,2,1742059386,1742059388,1742059388.929596,-18000,,
com.google.Chrome,4,1742059382,1742059386,1742059386.597818,-18000,,
com.apple.MobileSMS,6,1742059376,1742059382,1742059382.973907,-18000,,
com.apple.MobileSMS,16,1742059358,1742059374,1742059374.527556,-18000,EB445137-D7F5-57EC-87DA-1DB460D64046,"iPhone13,2"
com.apple.news,1,1742059354,1742059355,1742059355.955809,-18000,EB445137-D7F5-57EC-87DA-1DB460D64046,"iPhone13,2"
com.apple.news,25,1742059066,1742059091,1742059092.01053,-18000,EB445137-D7F5-57EC-87DA-1DB460D64046,"iPhone13,2"
com.apple.MobileSMS,6,1742059044,1742059050,1742059050.560184,-18000,EB445137-D7F5-57EC-87DA-1DB460D64046,"iPhone13,2"
com.apple.mobileslideshow,7,1742059037,1742059044,1742059045.140563,-18000,EB445137-D7F5-57EC-87DA-1DB460D64046,"iPhone13,2"
com.apple.findmy,2,1742059022,1742059024,1742059024.171733,-18000,EB445137-D7F5-57EC-87DA-1DB460D64046,"iPhone13,2"
com.apple.findmy,0,1742059021,1742059021,1742059022.242573,-18000,EB445137-D7F5-57EC-87DA-1DB460D64046,"iPhone13,2"
com.apple.findmy,4,1742058935,1742058939,1742058939.973063,-18000,EB445137-D7F5-57EC-87DA-1DB460D64046,"iPhone13,2"
com.apple.findmy,4,1742058813,1742058817,1742058817.795918,-18000,EB445137-D7F5-57EC-87DA-1DB460D64046,"iPhone13,2"
com.apple.CoreAuthUI,8,1742058752,1742058760,1742058760.020952,-18000,EB445137-D7F5-57EC-87DA-1DB460D64046,"iPhone13,2"
com.truebill.truebillnative,64,1742058749,1742058813,1742058813.235863,-18000,EB445137-D7F5-57EC-87DA-1DB460D64046,"iPhone13,2"
com.apple.MobileSMS,4,1742058661,1742058665,1742058665.5914679,-18000,,
com.apple.MobileSMS,2,1742058566,1742058568,1742058568.3737469,-18000,EB445137-D7F5-57EC-87DA-1DB460D64046,"iPhone13,2"
com.apple.findmy,2,1742058562,1742058564,1742058564.723701,-18000,EB445137-D7F5-57EC-87DA-1DB460D64046,"iPhone13,2"
com.google.Chrome,302,1742058359,1742058661,1742058662.198077,-18000,,
com.apple.findmy,11,1742058348,1742058359,1742058360.040608,-18000,,
com.apple.findmy,112,1742057443,1742057555,1742057555.907902,-18000,EB445137-D7F5-57EC-87DA-1DB460D64046,"iPhone13,2"
com.apple.camera,32,1742057410,1742057442,1742057443.071106,-18000,EB445137-D7F5-57EC-87DA-1DB460D64046,"iPhone13,2"
com.apple.MobileSMS,2,1742057382,1742057384,1742057384.576767,-18000,EB445137-D7F5-57EC-87DA-1DB460D64046,"iPhone13,2"
com.apple.weather,57,1742057322,1742057379,1742057379.4891791,-18000,EB445137-D7F5-57EC-87DA-1DB460D64046,"iPhone13,2"
com.apple.news,107,1742057214,1742057321,1742057321.0507379,-18000,EB445137-D7F5-57EC-87DA-1DB460D64046,"iPhone13,2"
com.apple.weather,5,1742057188,1742057193,1742057193.376652,-18000,EB445137-D7F5-57EC-87DA-1DB460D64046,"iPhone13,2"
com.google.Chrome,1434,1742056914,1742058348,1742058348.5884619,-18000,,
com.apple.MobileSMS,17,1742056897,1742056914,1742056914.903418,-18000,,
com.google.Chrome,186,1742056711,1742056897,1742056897.33749,-18000,,
com.apple.weather,62,1742056505,1742056567,1742056567.235357,-18000,EB445137-D7F5-57EC-87DA-1DB460D64046,"iPhone13,2"
com.microsoft.Office.Outlook,8,1742056497,1742056505,1742056505.704742,-18000,EB445137-D7F5-57EC-87DA-1DB460D64046,"iPhone13,2"
com.google.Chrome,171,1742056493,1742056664,1742056664.4126701,-18000,,
com.apple.MobileSMS,2,1742056491,1742056493,1742056493.258266,-18000,,
com.apple.findmy,8,1742056483,1742056491,1742056491.3408551,-18000,,
com.apple.news,5,1742056468,1742056473,1742056473.674615,-18000,EB445137-D7F5-57EC-87DA-1DB460D64046,"iPhone13,2"
com.apple.MobileSMS,55,1742056428,1742056483,1742056483.312395,-18000,,
com.apple.findmy,78,1742056350,1742056428,1742056428.222122,-18000,,
com.google.Chrome,748,1742055602,1742056350,1742056351.0706692,-18000,,
com.apple.news,29,1742055117,1742055146,1742055146.521214,-18000,EB445137-D7F5-57EC-87DA-1DB460D64046,"iPhone13,2"
com.apple.Notes,259,1742055105,1742055364,1742055365.409185,-18000,,
com.apple.findmy,56,1742055049,1742055105,1742055105.1614141,-18000,,
com.apple.Notes,7,1742055042,1742055049,1742055049.43049,-18000,,
com.microsoft.VSCode,357,1742054685,1742055042,1742055043.0399709,-18000,,
com.apple.Notes,49,1742054636,1742054685,1742054685.59863,-18000,,
com.apple.findmy,29,1742054607,1742054636,1742054636.4687781,-18000,,
com.apple.finder,7,1742054600,1742054607,1742054607.467581,-18000,,
com.apple.news,242,1742054356,1742054598,1742054599.0933352,-18000,EB445137-D7F5-57EC-87DA-1DB460D64046,"iPhone13,2"
com.apple.findmy,6,1742054350,1742054356,1742054356.488133,-18000,EB445137-D7F5-57EC-87DA-1DB460D64046,"iPhone13,2"
com.apple.news,126,1742054223,1742054349,1742054349.172688,-18000,EB445137-D7F5-57EC-87DA-1DB460D64046,"iPhone13,2"
com.apple.Preferences,20,1742053822,1742053842,1742053842.966048,-18000,EB445137-D7F5-57EC-87DA-1DB460D64046,"iPhone13,2"
com.microsoft.onenote,109,1742053713,1742053822,1742053822.759561,-18000,EB445137-D7F5-57EC-87DA-1DB460D64046,"iPhone13,2"
com.apple.findmy,2,1742053709,1742053711,1742053711.3261771,-18000,EB445137-D7F5-57EC-87DA-1DB460D64046,"iPhone13,2"
com.apple.findmy,6,1742053691,1742053697,1742053697.700035,-18000,EB445137-D7F5-57EC-87DA-1DB460D64046,"iPhone13,2"
com.microsoft.Office.Outlook,3,1742053688,1742053691,1742053692.2796059,-18000,EB445137-D7F5-57EC-87DA-1DB460D64046,"iPhone13,2"
com.apple.Health,20,1742053667,1742053687,1742053688.098997,-18000,EB445137-D7F5-57EC-87DA-1DB460D64046,"iPhone13,2"
com.apple.Health,48,1742053613,1742053661,1742053661.711868,-18000,EB445137-D7F5-57EC-87DA-1DB460D64046,"iPhone13,2"
com.apple.finder,2,1742053404,1742053406,1742053406.35038,-18000,,
com.leomehlig.today,11,1742053393,1742053404,1742053404.2424622,-18000,,
com.apple.finder,1,1742053392,1742053393,1742053393.832416,-18000,,
com.apple.Notes,1,1742053391,1742053392,1742053392.393817,-18000,,
com.google.Chrome,28,1742053363,1742053391,1742053391.031343,-18000,,
com.apple.finder,2,1742053347,1742053349,1742053349.119591,-18000,,
com.apple.reminders,4,1742053343,1742053347,1742053347.28497,-18000,,
com.apple.finder,4,1742053339,1742053343,1742053343.067216,-18000,,
com.apple.Terminal,1,1742053338,1742053339,1742053339.998396,-18000,,
com.apple.finder,8,1742053330,1742053338,1742053338.2695699,-18000,,
com.apple.Terminal,55,1742053275,1742053330,1742053330.546802,-18000,,
com.apple.finder,13,1742053262,1742053275,1742053275.190628,-18000,,
com.google.Chrome,2,1742053260,1742053262,1742053262.906857,-18000,,
com.toyopagroup.picaboo,14,1742053242,1742053256,1742053256.2923641,-18000,EB445137-D7F5-57EC-87DA-1DB460D64046,"iPhone13,2"
com.apple.findmy,2,1742053240,1742053242,1742053242.04637,-18000,EB445137-D7F5-57EC-87DA-1DB460D64046,"iPhone13,2"
com.apple.findmy,8,1742053229,1742053237,1742053237.313443,-18000,EB445137-D7F5-57EC-87DA-1DB460D64046,"iPhone13,2"
com.google.Chrome,4,1742053223,1742053227,1742053227.244296,-18000,,
com.apple.MobileSMS,1,1742053222,1742053223,1742053223.212072,-18000,,
com.google.Chrome,37,1742053185,1742053222,1742053222.267023,-18000,,
com.apple.MobileSMS,2,1742053183,1742053185,1742053185.973778,-18000,,
com.google.Chrome,34,1742053149,1742053183,1742053183.5523071,-18000,,
com.apple.MobileSMS,2,1742053147,1742053149,1742053149.0690799,-18000,,
com.google.Chrome,4,1742053143,1742053147,1742053147.946399,-18000,,
com.apple.MobileSMS,2,1742053141,1742053143,1742053143.062259,-18000,,
com.google.Chrome,4,1742053137,1742053141,1742053141.875197,-18000,,
com.apple.MobileSMS,2,1742053135,1742053137,1742053137.2542238,-18000,,
com.google.Chrome,9,1742053126,1742053135,1742053135.6081939,-18000,,
com.apple.MobileSMS,1,1742053125,1742053126,1742053126.053595,-18000,,
com.google.Chrome,1,1742053124,1742053125,1742053125.308291,-18000,,
com.apple.MobileSMS,1,1742053123,1742053124,1742053124.6095471,-18000,,
com.google.Chrome,7,1742053116,1742053123,1742053123.927726,-18000,,
com.apple.MobileSMS,4,1742053112,1742053116,1742053116.154039,-18000,,
com.google.Chrome,9,1742053103,1742053112,1742053112.834033,-18000,,
com.apple.MobileSMS,5,1742053098,1742053103,1742053103.230588,-18000,,
com.google.Chrome,20,1742053078,1742053098,1742053098.032578,-18000,,
com.apple.MobileSMS,3,1742053075,1742053078,1742053078.3694758,-18000,,
com.google.Chrome,5,1742053070,1742053075,1742053075.525279,-18000,,
com.apple.MobileSMS,3,1742053067,1742053070,1742053070.3784308,-18000,,
com.google.Chrome,19,1742053048,1742053067,1742053067.634198,-18000,,
com.apple.MobileSMS,1,1742053047,1742053048,1742053048.9035869,-18000,,
com.google.Chrome,9,1742053038,1742053047,1742053047.3429952,-18000,,
com.apple.MobileSMS,4,1742053034,1742053038,1742053038.267425,-18000,,
com.google.Chrome,59,1742052975,1742053034,1742053034.972282,-18000,,
com.apple.MobileSMS,1,1742052974,1742052975,1742052975.574918,-18000,,
com.google.Chrome,1,1742052973,1742052974,1742052974.366149,-18000,,
com.apple.MobileSMS,1,1742052972,1742052973,1742052973.677178,-18000,,
com.google.Chrome,27,1742052945,1742052972,1742052972.4253058,-18000,,
com.apple.MobileSMS,2,1742052943,1742052945,1742052945.130021,-18000,,
com.google.Chrome,65,1742052878,1742052943,1742052943.2590141,-18000,,
com.apple.MobileSMS,1,1742052877,1742052878,1742052878.839153,-18000,,
com.google.Chrome,39,1742052838,1742052877,1742052877.591865,-18000,,
com.apple.MobileSMS,0,1742052838,1742052838,1742052838.672842,-18000,,
com.google.Chrome,1,1742052837,1742052838,1742052838.1579819,-18000,,
com.apple.MobileSMS,1,1742052836,1742052837,1742052837.4791741,-18000,,
com.google.Chrome,3,1742052833,1742052836,1742052836.735664,-18000,,
com.apple.MobileSMS,2,1742052831,1742052833,1742052833.9459372,-18000,,
com.google.Chrome,2,1742052829,1742052831,1742052831.178354,-18000,,
com.apple.MobileSMS,2,1742052827,1742052829,1742052829.32202,-18000,,
com.google.Chrome,0,1742052827,1742052827,1742052828.029436,-18000,,
com.apple.MobileSMS,2,1742052825,1742052827,1742052827.036799,-18000,,
com.google.Chrome,1,1742052824,1742052825,1742052825.877898,-18000,,
com.apple.MobileSMS,1,1742052823,1742052824,1742052824.595443,-18000,,
com.google.Chrome,19,1742052804,1742052823,1742052823.7512789,-18000,,
com.apple.MobileSMS,29,1742052775,1742052804,1742052804.873927,-18000,,
com.google.Chrome,10,1742052765,1742052775,1742052775.668653,-18000,,
com.apple.findmy,63,1742052196,1742052259,1742052259.737493,-18000,EB445137-D7F5-57EC-87DA-1DB460D64046,"iPhone13,2"
com.apple.findmy,8,1742052187,1742052195,1742052195.718188,-18000,EB445137-D7F5-57EC-87DA-1DB460D64046,"iPhone13,2"
com.apple.MobileSMS,6,1742052181,1742052187,1742052187.8292851,-18000,EB445137-D7F5-57EC-87DA-1DB460D64046,"iPhone13,2"
com.apple.MobileSMS,62,1742051628,1742051690,1742051690.887959,-18000,EB445137-D7F5-57EC-87DA-1DB460D64046,"iPhone13,2"
com.apple.findmy,5,1742051623,1742051628,1742051628.8100262,-18000,EB445137-D7F5-57EC-87DA-1DB460D64046,"iPhone13,2"
com.apple.findmy,6,1742051413,1742051419,1742051419.771374,-18000,EB445137-D7F5-57EC-87DA-1DB460D64046,"iPhone13,2"
com.apple.MobileSMS,22,1742051391,1742051413,1742051413.686458,-18000,EB445137-D7F5-57EC-87DA-1DB460D64046,"iPhone13,2"
com.apple.findmy,2,1742051383,1742051385,1742051385.264151,-18000,EB445137-D7F5-57EC-87DA-1DB460D64046,"iPhone13,2"
com.apple.InCallService,11,1742051372,1742051383,1742051383.3928452,-18000,EB445137-D7F5-57EC-87DA-1DB460D64046,"iPhone13,2"
com.apple.findmy,83,1742051289,1742051372,1742051372.386148,-18000,EB445137-D7F5-57EC-87DA-1DB460D64046,"iPhone13,2"
com.apple.MobileSMS,39,1742051249,1742051288,1742051288.839828,-18000,EB445137-D7F5-57EC-87DA-1DB460D64046,"iPhone13,2"
com.google.chrome.ios,0,1742051248,1742051248,1742051249.0741038,-18000,EB445137-D7F5-57EC-87DA-1DB460D64046,"iPhone13,2"
com.apple.weather,2,1742051246,1742051248,1742051248.24153,-18000,EB445137-D7F5-57EC-87DA-1DB460D64046,"iPhone13,2"
com.apple.weather,2,1742051169,1742051171,1742051171.928122,-18000,EB445137-D7F5-57EC-87DA-1DB460D64046,"iPhone13,2"
com.apple.MobileSMS,13,1742051156,1742051169,1742051170.031605,-18000,EB445137-D7F5-57EC-87DA-1DB460D64046,"iPhone13,2"
com.microsoft.Office.Outlook,2,1742051154,1742051156,1742051156.57426,-18000,EB445137-D7F5-57EC-87DA-1DB460D64046,"iPhone13,2"
com.microsoft.Office.Outlook,64,1742050704,1742050768,1742050768.330061,-18000,EB445137-D7F5-57EC-87DA-1DB460D64046,"iPhone13,2"
com.apple.findmy,3,1742050699,1742050702,1742050702.819648,-18000,EB445137-D7F5-57EC-87DA-1DB460D64046,"iPhone13,2"
com.apple.findmy,138,1742050293,1742050431,1742050432.1164942,-18000,EB445137-D7F5-57EC-87DA-1DB460D64046,"iPhone13,2"
com.apple.weather,2,1742050291,1742050293,1742050293.356618,-18000,EB445137-D7F5-57EC-87DA-1DB460D64046,"iPhone13,2"
com.apple.PosterBoard,1,1742050291,1742050292,1742050292.219592,-18000,EB445137-D7F5-57EC-87DA-1DB460D64046,"iPhone13,2"
com.apple.weather,37,1742049793,1742049830,1742049831.0443568,-18000,EB445137-D7F5-57EC-87DA-1DB460D64046,"iPhone13,2"
com.renpho.health,35,1742049758,1742049793,1742049793.280037,-18000,EB445137-D7F5-57EC-87DA-1DB460D64046,"iPhone13,2"
com.apple.findmy,20,1742049727,1742049747,1742049747.445157,-18000,EB445137-D7F5-57EC-87DA-1DB460D64046,"iPhone13,2"
com.google.ios.youtube,636,1742048323,1742048959,1742048959.502841,-18000,EB445137-D7F5-57EC-87DA-1DB460D64046,"iPhone13,2"
com.apple.weather,3,1742048320,1742048323,1742048323.688601,-18000,EB445137-D7F5-57EC-87DA-1DB460D64046,"iPhone13,2"
com.apple.mobiletimer,2,1742048315,1742048317,1742048317.87064,-18000,EB445137-D7F5-57EC-87DA-1DB460D64046,"iPhone13,2"
com.apple.weather,12,1742048303,1742048315,1742048315.589396,-18000,EB445137-D7F5-57EC-87DA-1DB460D64046,"iPhone13,2"
com.apple.mobiletimer,5,1742048298,1742048303,1742048303.4920201,-18000,EB445137-D7F5-57EC-87DA-1DB460D64046,"iPhone13,2"
com.apple.weather,20,1742048278,1742048298,1742048298.128876,-18000,EB445137-D7F5-57EC-87DA-1DB460D64046,"iPhone13,2"
com.google.ios.youtube,239,1742048036,1742048275,1742048275.563439,-18000,EB445137-D7F5-57EC-87DA-1DB460D64046,"iPhone13,2"
com.apple.mobiletimer,27,1742019595,1742019622,1742019622.5885549,-18000,EB445137-D7F5-57EC-87DA-1DB460D64046,"iPhone13,2"
com.google.Gmail,13,1742018781,1742018794,1742018794.8516622,-18000,EB445137-D7F5-57EC-87DA-1DB460D64046,"iPhone13,2"
com.apple.MobileSMS,28,1742017831,1742017859,1742017859.599599,-18000,EB445137-D7F5-57EC-87DA-1DB460D64046,"iPhone13,2"
com.apple.weather,35,1742017742,1742017777,1742017777.574584,-18000,EB445137-D7F5-57EC-87DA-1DB460D64046,"iPhone13,2"
com.apple.weather,26,1742017308,1742017334,1742017334.895203,-18000,EB445137-D7F5-57EC-87DA-1DB460D64046,"iPhone13,2"
com.apple.weather,114,1742016797,1742016911,1742016912.155315,-18000,EB445137-D7F5-57EC-87DA-1DB460D64046,"iPhone13,2"
com.apple.weather,55,1742016403,1742016458,1742016458.782753,-18000,EB445137-D7F5-57EC-87DA-1DB460D64046,"iPhone13,2"
com.apple.news,23,1742016380,1742016403,1742016403.4590502,-18000,EB445137-D7F5-57EC-87DA-1DB460D64046,"iPhone13,2"
com.apple.Preferences,1,1742016371,1742016372,1742016372.998749,-18000,EB445137-D7F5-57EC-87DA-1DB460D64046,"iPhone13,2"
com.apple.weather,155,1742016209,1742016364,1742016364.520047,-18000,EB445137-D7F5-57EC-87DA-1DB460D64046,"iPhone13,2"
com.apple.weather,36,1742016158,1742016194,1742016194.10549,-18000,EB445137-D7F5-57EC-87DA-1DB460D64046,"iPhone13,2"
com.google.Gmail,8,1742016067,1742016075,1742016075.382149,-18000,EB445137-D7F5-57EC-87DA-1DB460D64046,"iPhone13,2"
com.apple.MobileSMS,0,1742016067,1742016067,1742016067.836056,-18000,EB445137-D7F5-57EC-87DA-1DB460D64046,"iPhone13,2"
com.apple.MobileSMS,54,1742016007,1742016061,1742016061.400106,-18000,EB445137-D7F5-57EC-87DA-1DB460D64046,"iPhone13,2"
com.apple.weather,0,1742016007,1742016007,1742016007.405402,-18000,EB445137-D7F5-57EC-87DA-1DB460D64046,"iPhone13,2"
com.apple.weather,149,1742015854,1742016003,1742016003.4573932,-18000,EB445137-D7F5-57EC-87DA-1DB460D64046,"iPhone13,2"
com.apple.weather,2,1742015852,1742015854,1742015854.3686728,-18000,EB445137-D7F5-57EC-87DA-1DB460D64046,"iPhone13,2"
com.apple.weather,17,1742015749,1742015766,1742015766.9041061,-18000,EB445137-D7F5-57EC-87DA-1DB460D64046,"iPhone13,2"
com.toyopagroup.picaboo,40,1742015634,1742015674,1742015674.5899339,-18000,EB445137-D7F5-57EC-87DA-1DB460D64046,"iPhone13,2"
com.apple.Preferences,7,1742015619,1742015626,1742015626.504087,-18000,EB445137-D7F5-57EC-87DA-1DB460D64046,"iPhone13,2"
com.apple.weather,18,1742015258,1742015276,1742015276.46527,-18000,EB445137-D7F5-57EC-87DA-1DB460D64046,"iPhone13,2"
com.apple.weather,141,1742015111,1742015252,1742015253.043427,-18000,EB445137-D7F5-57EC-87DA-1DB460D64046,"iPhone13,2"
com.apple.weather,42,1742013953,1742013995,1742013995.1391358,-18000,EB445137-D7F5-57EC-87DA-1DB460D64046,"iPhone13,2"
com.apple.weather,6,1742013053,1742013059,1742013059.313165,-18000,EB445137-D7F5-57EC-87DA-1DB460D64046,"iPhone13,2"
com.apple.weather,31,1742011013,1742011044,1742011045.2796268,-18000,EB445137-D7F5-57EC-87DA-1DB460D64046,"iPhone13,2"
com.apple.tv,1,1742011011,1742011012,1742011015.54579,-18000,EB445137-D7F5-57EC-87DA-1DB460D64046,"iPhone13,2"
com.google.Chrome,24,1742009024,1742009048,1742009048.748582,-18000,,
com.apple.Notes,39,1742008985,1742009024,1742009024.718818,-18000,,
com.google.Chrome,28,1742008957,1742008985,1742008985.3684568,-18000,,
com.apple.Notes,2,1742008955,1742008957,1742008957.368581,-18000,,
com.google.Chrome,37,1742008918,1742008955,1742008955.5538878,-18000,,
com.apple.Notes,2,1742008916,1742008918,1742008918.233571,-18000,,
com.google.Chrome,59,1742008857,1742008916,1742008916.63961,-18000,,
com.apple.Notes,26,1742008831,1742008857,1742008857.6170669,-18000,,
com.google.Chrome,10,1742008821,1742008831,1742008831.769954,-18000,,
com.apple.tv,129,1742008672,1742008801,1742008801.325243,-18000,EB445137-D7F5-57EC-87DA-1DB460D64046,"iPhone13,2"
com.apple.tv,83,1742008572,1742008655,1742008655.7821589,-18000,EB445137-D7F5-57EC-87DA-1DB460D64046,"iPhone13,2"
com.apple.Preferences,14,1742008558,1742008572,1742008572.525073,-18000,EB445137-D7F5-57EC-87DA-1DB460D64046,"iPhone13,2"
com.apple.tv,7,1742008548,1742008555,1742008555.053681,-18000,EB445137-D7F5-57EC-87DA-1DB460D64046,"iPhone13,2"
com.apple.stocks,2,1742008544,1742008546,1742008546.0675569,-18000,EB445137-D7F5-57EC-87DA-1DB460D64046,"iPhone13,2"
com.apple.tv,1,1742008543,1742008544,1742008544.478558,-18000,EB445137-D7F5-57EC-87DA-1DB460D64046,"iPhone13,2"
com.apple.tv,127,1742008356,1742008483,1742008483.4072142,-18000,EB445137-D7F5-57EC-87DA-1DB460D64046,"iPhone13,2"
com.apple.tv,40,1742008171,1742008211,1742008211.567368,-18000,EB445137-D7F5-57EC-87DA-1DB460D64046,"iPhone13,2"
com.apple.tv,158,1742007796,1742007954,1742007954.075557,-18000,EB445137-D7F5-57EC-87DA-1DB460D64046,"iPhone13,2"
com.google.Chrome,581,1742007609,1742008190,1742008191.288169,-18000,,
com.apple.finder,32,1742007577,1742007609,1742007611.0155249,-18000,,
com.apple.weather,31,1742007234,1742007265,1742007265.40374,-18000,EB445137-D7F5-57EC-87DA-1DB460D64046,"iPhone13,2"
com.apple.weather,9,1742005542,1742005551,1742005551.8206182,-18000,EB445137-D7F5-57EC-87DA-1DB460D64046,"iPhone13,2"
com.apple.mobileslideshow,2,1742005540,1742005542,1742005542.456778,-18000,EB445137-D7F5-57EC-87DA-1DB460D64046,"iPhone13,2"
com.apple.mobileslideshow,35,1742004646,1742004681,1742004682.0691671,-18000,EB445137-D7F5-57EC-87DA-1DB460D64046,"iPhone13,2"
com.apple.weather,2,1742004644,1742004646,1742004646.211238,-18000,EB445137-D7F5-57EC-87DA-1DB460D64046,"iPhone13,2"
com.apple.weather,32,1742003341,1742003373,1742003373.800529,-18000,EB445137-D7F5-57EC-87DA-1DB460D64046,"iPhone13,2"
com.apple.weather,4,1741998642,1741998646,1741998647.051834,-18000,EB445137-D7F5-57EC-87DA-1DB460D64046,"iPhone13,2"
com.apple.weather,15,1741997010,1741997025,1741997026.3185601,-18000,EB445137-D7F5-57EC-87DA-1DB460D64046,"iPhone13,2"
com.apple.news,1,1741997009,1741997010,1741997011.0262241,-18000,EB445137-D7F5-57EC-87DA-1DB460D64046,"iPhone13,2"
com.apple.news,81,1741991103,1741991184,1741991184.5208302,-18000,EB445137-D7F5-57EC-87DA-1DB460D64046,"iPhone13,2"
com.groundspeak.GeocachingIntro,12,1741991055,1741991067,1741991067.760717,-18000,EB445137-D7F5-57EC-87DA-1DB460D64046,"iPhone13,2"
com.microsoft.Office.Outlook,5,1741991043,1741991048,1741991048.8776941,-18000,EB445137-D7F5-57EC-87DA-1DB460D64046,"iPhone13,2"
com.apple.MobileSMS,3,1741991037,1741991040,1741991040.406451,-18000,EB445137-D7F5-57EC-87DA-1DB460D64046,"iPhone13,2"
com.apple.MobileSMS,3,1741991003,1741991006,1741991006.321384,-18000,EB445137-D7F5-57EC-87DA-1DB460D64046,"iPhone13,2"
com.apple.MobileSMS,11,1741990989,1741991000,1741991001.148902,-18000,EB445137-D7F5-57EC-87DA-1DB460D64046,"iPhone13,2"
com.apple.MobileSMS,67,1741990914,1741990981,1741990982.0211859,-18000,EB445137-D7F5-57EC-87DA-1DB460D64046,"iPhone13,2"
com.apple.news,7,1741990907,1741990914,1741990914.084278,-18000,EB445137-D7F5-57EC-87DA-1DB460D64046,"iPhone13,2"
com.apple.news,80,1741985524,1741985604,1741985604.955271,-18000,EB445137-D7F5-57EC-87DA-1DB460D64046,"iPhone13,2"
com.apple.reminders,2,1741985451,1741985453,1741985453.18154,-18000,EB445137-D7F5-57EC-87DA-1DB460D64046,"iPhone13,2"
com.microsoft.Office.Outlook,1,1741984074,1741984075,1741984075.724294,-18000,EB445137-D7F5-57EC-87DA-1DB460D64046,"iPhone13,2"
com.microsoft.Office.Outlook,68,1741983879,1741983947,1741983947.152052,-18000,EB445137-D7F5-57EC-87DA-1DB460D64046,"iPhone13,2"
com.toyopagroup.picaboo,26,1741983161,1741983187,1741983187.4522681,-18000,EB445137-D7F5-57EC-87DA-1DB460D64046,"iPhone13,2"
com.microsoft.Office.Outlook,3,1741983118,1741983121,1741983121.403113,-18000,EB445137-D7F5-57EC-87DA-1DB460D64046,"iPhone13,2"
com.google.chrome.ios,36,1741983082,1741983118,1741983118.6425529,-18000,EB445137-D7F5-57EC-87DA-1DB460D64046,"iPhone13,2"
com.microsoft.Office.Outlook,4,1741983078,1741983082,1741983082.864934,-18000,EB445137-D7F5-57EC-87DA-1DB460D64046,"iPhone13,2"
com.apple.CoreAuthUI,2,1741983016,1741983018,1741983018.08108,-18000,EB445137-D7F5-57EC-87DA-1DB460D64046,"iPhone13,2"
com.google.chrome.ios,80,1741982998,1741983078,1741983078.368185,-18000,EB445137-D7F5-57EC-87DA-1DB460D64046,"iPhone13,2"
com.microsoft.Office.Outlook,5,1741982993,1741982998,1741982998.1883311,-18000,EB445137-D7F5-57EC-87DA-1DB460D64046,"iPhone13,2"
com.google.chrome.ios,1,1741982992,1741982993,1741982994.0176091,-18000,EB445137-D7F5-57EC-87DA-1DB460D64046,"iPhone13,2"
com.microsoft.Office.Outlook,150,1741982842,1741982992,1741982992.394133,-18000,EB445137-D7F5-57EC-87DA-1DB460D64046,"iPhone13,2"
com.apple.MobileSMS,2,1741982837,1741982839,1741982839.205412,-18000,EB445137-D7F5-57EC-87DA-1DB460D64046,"iPhone13,2"
com.apple.PeopleViewService,2,1741982835,1741982837,1741982837.613611,-18000,EB445137-D7F5-57EC-87DA-1DB460D64046,"iPhone13,2"
com.microsoft.Office.Outlook,2,1741982830,1741982832,1741982832.7353501,-18000,EB445137-D7F5-57EC-87DA-1DB460D64046,"iPhone13,2"
com.clairmail.fth.client,45,1741982784,1741982829,1741982829.663271,-18000,EB445137-D7F5-57EC-87DA-1DB460D64046,"iPhone13,2"
com.microsoft.Office.Outlook,9,1741982774,1741982783,1741982783.958739,-18000,EB445137-D7F5-57EC-87DA-1DB460D64046,"iPhone13,2"
com.clairmail.fth.client,0,1741982774,1741982774,1741982774.794557,-18000,EB445137-D7F5-57EC-87DA-1DB460D64046,"iPhone13,2"
com.apple.CoreAuthUI,2,1741982765,1741982767,1741982767.9060779,-18000,EB445137-D7F5-57EC-87DA-1DB460D64046,"iPhone13,2"
com.clairmail.fth.client,11,1741982761,1741982772,1741982772.381124,-18000,EB445137-D7F5-57EC-87DA-1DB460D64046,"iPhone13,2"
com.apple.weather,2,1741982755,1741982757,1741982757.373045,-18000,EB445137-D7F5-57EC-87DA-1DB460D64046,"iPhone13,2"
com.apple.finder,5,1741981993,1741981998,1741981998.7926168,-18000,,
com.leomehlig.today,54,1741981939,1741981993,1741981993.247744,-18000,,
com.google.Chrome,0,1741981939,1741981939,1741981939.917568,-18000,,
com.apple.weather,2,1741981937,1741981939,1741981939.1340752,-18000,,
com.microsoft.VSCode,1,1741981936,1741981937,1741981937.939199,-18000,,
com.google.Chrome,64,1741981872,1741981936,1741981936.2668982,-18000,,
com.microsoft.VSCode,49,1741981823,1741981872,1741981872.302998,-18000,,
com.google.Chrome,23,1741981800,1741981823,1741981823.114804,-18000,,
com.microsoft.VSCode,256,1741981544,1741981800,1741981800.9293652,-18000,,
com.google.Chrome,33,1741981511,1741981544,1741981544.291257,-18000,,
com.microsoft.VSCode,1,1741981510,1741981511,1741981511.5428128,-18000,,
com.apple.MobileSMS,4,1741981506,1741981510,1741981510.345542,-18000,,
com.microsoft.VSCode,556,1741980950,1741981506,1741981506.3119102,-18000,,
com.apple.MobileSMS,1,1741980949,1741980950,1741980950.171267,-18000,,
com.microsoft.VSCode,9,1741980940,1741980949,1741980949.299293,-18000,,
com.apple.MobileSMS,95,1741980845,1741980940,1741980940.704893,-18000,,
com.microsoft.VSCode,11,1741980834,1741980845,1741980845.237684,-18000,,
com.apple.MobileSMS,103,1741980731,1741980834,1741980834.974741,-18000,,
com.apple.weather,31,1741980480,1741980511,1741980512.044627,-18000,EB445137-D7F5-57EC-87DA-1DB460D64046,"iPhone13,2"
com.apple.MobileSMS,2,1741980478,1741980480,1741980480.255938,-18000,EB445137-D7F5-57EC-87DA-1DB460D64046,"iPhone13,2"
com.microsoft.VSCode,273,1741980458,1741980731,1741980731.377534,-18000,,
com.google.Chrome,6,1741980452,1741980458,1741980458.093377,-18000,,
com.apple.iCal,20,1741980432,1741980452,1741980452.92325,-18000,,
com.google.Chrome,8,1741980424,1741980432,1741980432.100177,-18000,,
com.apple.iCal,80,1741980344,1741980424,1741980424.812069,-18000,,
com.google.Chrome,2,1741980342,1741980344,1741980344.310245,-18000,,
com.apple.iCal,7,1741980335,1741980342,1741980342.354597,-18000,,
com.google.Chrome,40,1741980295,1741980335,1741980335.269279,-18000,,
com.microsoft.VSCode,425,1741979858,1741980283,1741980283.228823,-18000,,
com.google.Chrome,1,1741979857,1741979858,1741979858.146249,-18000,,
com.microsoft.VSCode,374,1741979483,1741979857,1741979857.480046,-18000,,
com.google.Chrome,7,1741979476,1741979483,1741979483.9994159,-18000,,
com.microsoft.VSCode,13,1741979463,1741979476,1741979476.794026,-18000,,
com.google.Chrome,1,1741979462,1741979463,1741979463.810021,-18000,,
com.microsoft.VSCode,35,1741979427,1741979462,1741979462.380165,-18000,,
com.google.Chrome,2,1741979425,1741979427,1741979427.970242,-18000,,
com.microsoft.VSCode,6,1741979419,1741979425,1741979425.206356,-18000,,
com.google.Chrome,2,1741979417,1741979419,1741979419.8045568,-18000,,
com.microsoft.VSCode,17,1741979400,1741979417,1741979417.388588,-18000,,
com.google.Chrome,2,1741979398,1741979400,1741979400.443592,-18000,,
com.microsoft.VSCode,4,1741979394,1741979398,1741979398.839679,-18000,,
com.google.Chrome,4,1741979390,1741979394,1741979395.024647,-18000,,
com.microsoft.VSCode,13,1741979377,1741979390,1741979390.285073,-18000,,
com.google.Chrome,4,1741979373,1741979377,1741979377.510538,-18000,,
com.microsoft.VSCode,5,1741979368,1741979373,1741979373.4362001,-18000,,
com.google.Chrome,2,1741979366,1741979368,1741979368.703464,-18000,,
com.microsoft.VSCode,13,1741979353,1741979366,1741979366.1797,-18000,,
com.google.Chrome,3,1741979350,1741979353,1741979353.906248,-18000,,
com.microsoft.VSCode,0,1741979350,1741979350,1741979350.7286959,-18000,,
com.google.Chrome,1,1741979349,1741979350,1741979350.261845,-18000,,
com.microsoft.VSCode,5,1741979344,1741979349,1741979349.786747,-18000,,
com.google.Chrome,15,1741979329,1741979344,1741979344.438514,-18000,,
com.microsoft.VSCode,45,1741979284,1741979329,1741979329.782413,-18000,,
com.apple.MobileSMS,1,1741979283,1741979284,1741979284.429196,-18000,,
com.microsoft.VSCode,39,1741979244,1741979283,1741979283.6638489,-18000,,
com.apple.MobileSMS,218,1741979026,1741979244,1741979244.221068,-18000,,
com.apple.weather,221,1741978805,1741979026,1741979026.8043609,-18000,,
com.google.Chrome,95,1741978710,1741978805,1741978805.1093159,-18000,,
com.microsoft.VSCode,23,1741978687,1741978710,1741978710.69668,-18000,,
com.apple.finder,9,1741978678,1741978687,1741978687.7121491,-18000,,
com.apple.MobileSMS,9,1741977819,1741977828,1741977828.896975,-18000,EB445137-D7F5-57EC-87DA-1DB460D64046,"iPhone13,2"
com.apple.MobileSMS,4,1741977783,1741977787,1741977787.965186,-18000,EB445137-D7F5-57EC-87DA-1DB460D64046,"iPhone13,2"
com.microsoft.Office.Outlook,50,1741976502,1741976552,1741976552.203055,-18000,EB445137-D7F5-57EC-87DA-1DB460D64046,"iPhone13,2"
com.microsoft.Office.Outlook,13,1741976488,1741976501,1741976501.277919,-18000,EB445137-D7F5-57EC-87DA-1DB460D64046,"iPhone13,2"
com.apple.weather,0,1741976488,1741976488,1741976488.476438,-18000,EB445137-D7F5-57EC-87DA-1DB460D64046,"iPhone13,2"
com.apple.finder,2,1741975428,1741975430,1741975430.317523,-18000,,
com.leomehlig.today,28,1741975400,1741975428,1741975428.108784,-18000,,
com.google.Chrome,41,1741975359,1741975400,1741975400.1654,-18000,,
com.microsoft.VSCode,32,1741975327,1741975359,1741975359.0875611,-18000,,
com.google.Chrome,133,1741975194,1741975327,1741975327.890693,-18000,,
com.microsoft.VSCode,33,1741975161,1741975194,1741975194.537241,-18000,,
com.google.Chrome,24,1741975137,1741975161,1741975161.074101,-18000,,
com.microsoft.VSCode,11,1741975126,1741975137,1741975137.6192641,-18000,,
com.leomehlig.today,17,1741975109,1741975126,1741975126.433572,-18000,,
com.apple.iCal,12,1741975097,1741975109,1741975109.2155008,-18000,,
com.leomehlig.today,20,1741975077,1741975097,1741975097.541137,-18000,,
com.microsoft.VSCode,1,1741975076,1741975077,1741975077.861895,-18000,,
com.leomehlig.today,9,1741975067,1741975076,1741975076.073694,-18000,,
com.apple.weather,12,1741975028,1741975040,1741975040.7384892,-18000,EB445137-D7F5-57EC-87DA-1DB460D64046,"iPhone13,2"
com.apple.news,2,1741975026,1741975028,1741975028.887944,-18000,EB445137-D7F5-57EC-87DA-1DB460D64046,"iPhone13,2"
com.apple.weather,17,1741975009,1741975026,1741975026.6476479,-18000,EB445137-D7F5-57EC-87DA-1DB460D64046,"iPhone13,2"
com.apple.news,1,1741975008,1741975009,1741975010.052813,-18000,EB445137-D7F5-57EC-87DA-1DB460D64046,"iPhone13,2"
com.apple.news,92,1741974762,1741974854,1741974854.418699,-18000,EB445137-D7F5-57EC-87DA-1DB460D64046,"iPhone13,2"
com.microsoft.Office.Outlook,9,1741974748,1741974757,1741974757.016286,-18000,EB445137-D7F5-57EC-87DA-1DB460D64046,"iPhone13,2"
com.microsoft.Office.Outlook,8,1741974740,1741974748,1741974748.3440762,-18000,EB445137-D7F5-57EC-87DA-1DB460D64046,"iPhone13,2"
com.hammerandchisel.discord,0,1741974740,1741974740,1741974740.455049,-18000,EB445137-D7F5-57EC-87DA-1DB460D64046,"iPhone13,2"
com.microsoft.VSCode,850,1741974217,1741975067,1741975067.45486,-18000,,
com.google.Chrome,19,1741974198,1741974217,1741974217.394871,-18000,,
com.microsoft.VSCode,87,1741974111,1741974198,1741974198.3782911,-18000,,
com.google.Chrome,0,1741974111,1741974111,1741974111.9323459,-18000,,
com.microsoft.VSCode,3,1741974108,1741974111,1741974111.320829,-18000,,
com.google.Chrome,3,1741974105,1741974108,1741974108.258356,-18000,,
com.microsoft.VSCode,8,1741974097,1741974105,1741974105.736969,-18000,,
com.google.Chrome,14,1741974083,1741974097,1741974097.766592,-18000,,
com.microsoft.VSCode,78,1741974005,1741974083,1741974083.228417,-18000,,
com.google.Chrome,13,1741973992,1741974005,1741974005.104222,-18000,,
com.microsoft.VSCode,50,1741973942,1741973992,1741973992.306271,-18000,,
com.hammerandchisel.discord,21,1741973685,1741973706,1741973706.562523,-18000,EB445137-D7F5-57EC-87DA-1DB460D64046,"iPhone13,2"
com.microsoft.VSCode,165,1741973477,1741973642,1741973642.583641,-18000,,
com.google.Chrome,7,1741973470,1741973477,1741973477.553691,-18000,,
com.microsoft.VSCode,28,1741973442,1741973470,1741973470.9950051,-18000,,
com.google.Chrome,2,1741973440,1741973442,1741973442.6508899,-18000,,
com.microsoft.VSCode,3,1741973437,1741973440,1741973440.57917,-18000,,
com.google.Chrome,4,1741973433,1741973437,1741973437.4035912,-18000,,
com.microsoft.VSCode,1,1741973432,1741973433,1741973433.821629,-18000,,
com.google.Chrome,4,1741973428,1741973432,1741973432.333951,-18000,,
com.microsoft.VSCode,61,1741973367,1741973428,1741973428.251563,-18000,,
com.google.Chrome,3,1741973364,1741973367,1741973367.534865,-18000,,
com.microsoft.VSCode,6,1741973358,1741973364,1741973364.580446,-18000,,
com.google.Chrome,8,1741973350,1741973358,1741973358.52274,-18000,,
com.microsoft.VSCode,2,1741973348,1741973350,1741973350.851372,-18000,,
com.google.Chrome,22,1741973326,1741973348,1741973348.156816,-18000,,
com.microsoft.VSCode,21,1741973305,1741973326,1741973326.238274,-18000,,
com.google.Chrome,14,1741973291,1741973305,1741973305.870809,-18000,,
com.microsoft.VSCode,11,1741973280,1741973291,1741973291.231472,-18000,,
com.google.Chrome,2,1741973278,1741973280,1741973280.563422,-18000,,
com.microsoft.VSCode,5,1741973273,1741973278,1741973278.351809,-18000,,
com.google.Chrome,1,1741973272,1741973273,1741973273.8347301,-18000,,
com.microsoft.VSCode,2,1741973270,1741973272,1741973272.510711,-18000,,
com.google.Chrome,1,1741973269,1741973270,1741973270.5922241,-18000,,
com.microsoft.VSCode,2,1741973267,1741973269,1741973269.6599898,-18000,,
com.google.Chrome,1,1741973266,1741973267,1741973267.646892,-18000,,
com.microsoft.VSCode,16,1741973250,1741973266,1741973266.349731,-18000,,
com.google.Chrome,9,1741973241,1741973250,1741973250.527602,-18000,,
com.microsoft.VSCode,8,1741973233,1741973241,1741973241.132996,-18000,,
com.google.Chrome,2,1741973231,1741973233,1741973233.660658,-18000,,
com.microsoft.VSCode,3,1741973228,1741973231,1741973231.530381,-18000,,
com.google.Chrome,4,1741973224,1741973228,1741973228.7447739,-18000,,
com.microsoft.VSCode,8,1741973216,1741973224,1741973224.605276,-18000,,
com.google.Chrome,4,1741973212,1741973216,1741973216.250478,-18000,,
com.microsoft.VSCode,12,1741973200,1741973212,1741973212.1825209,-18000,,
com.google.Chrome,6,1741973194,1741973200,1741973200.199709,-18000,,
com.microsoft.VSCode,11,1741973183,1741973194,1741973194.802932,-18000,,
com.google.Chrome,5,1741973178,1741973183,1741973183.472286,-18000,,
com.microsoft.VSCode,6,1741973172,1741973178,1741973178.2108278,-18000,,
com.google.Chrome,21,1741973151,1741973172,1741973172.853976,-18000,,
com.microsoft.VSCode,456,1741972695,1741973151,1741973151.863755,-18000,,
com.google.Chrome,18,1741972677,1741972695,1741972695.2684212,-18000,,
com.microsoft.VSCode,15,1741972662,1741972677,1741972677.446804,-18000,,
com.google.Chrome,32,1741972630,1741972662,1741972662.0807018,-18000,,
com.microsoft.VSCode,211,1741972419,1741972630,1741972630.300904,-18000,,
com.google.Chrome,8,1741972411,1741972419,1741972419.326579,-18000,,
com.microsoft.VSCode,2,1741972409,1741972411,1741972411.2086291,-18000,,
com.google.Chrome,1,1741972408,1741972409,1741972409.6560922,-18000,,
com.microsoft.VSCode,2,1741972406,1741972408,1741972408.518036,-18000,,
com.google.Chrome,1,1741972405,1741972406,1741972406.4349241,-18000,,
com.microsoft.VSCode,3,1741972402,1741972405,1741972405.2381291,-18000,,
com.google.Chrome,3,1741972399,1741972402,1741972402.323773,-18000,,
com.microsoft.VSCode,3,1741972396,1741972399,1741972399.969022,-18000,,
com.google.Chrome,1,1741972395,1741972396,1741972396.787914,-18000,,
com.microsoft.VSCode,1,1741972394,1741972395,1741972395.70051,-18000,,
com.google.Chrome,2,1741972392,1741972394,1741972394.125194,-18000,,
com.microsoft.VSCode,3,1741972389,1741972392,1741972392.353864,-18000,,
com.google.Chrome,2,1741972387,1741972389,1741972389.166512,-18000,,
com.microsoft.VSCode,2,1741972385,1741972387,1741972387.179009,-18000,,
com.google.Chrome,2,1741972383,1741972385,1741972385.200335,-18000,,
com.microsoft.VSCode,1,1741972382,1741972383,1741972384.045285,-18000,,
com.google.Chrome,1,1741972381,1741972382,1741972382.5806022,-18000,,
com.microsoft.VSCode,2,1741972379,1741972381,1741972381.4639978,-18000,,
com.google.Chrome,3,1741972376,1741972379,1741972379.6956968,-18000,,
com.microsoft.VSCode,1,1741972375,1741972376,1741972377.0543861,-18000,,
com.google.Chrome,2,1741972373,1741972375,1741972375.4652982,-18000,,
com.microsoft.VSCode,2,1741972371,1741972373,1741972373.98343,-18000,,
com.google.Chrome,2,1741972369,1741972371,1741972371.881501,-18000,,
com.microsoft.VSCode,41,1741972328,1741972369,1741972369.101389,-18000,,
com.google.Chrome,3,1741972325,1741972328,1741972328.260875,-18000,,
com.microsoft.VSCode,2,1741972323,1741972325,1741972325.2958832,-18000,,
com.google.Chrome,2,1741972321,1741972323,1741972323.164054,-18000,,
com.microsoft.VSCode,2,1741972319,1741972321,1741972321.743263,-18000,,
com.google.Chrome,3,1741972316,1741972319,1741972319.498211,-18000,,
com.microsoft.VSCode,0,1741972316,1741972316,1741972316.707447,-18000,,
com.google.Chrome,2,1741972314,1741972316,1741972316.1484342,-18000,,
com.microsoft.VSCode,2,1741972312,1741972314,1741972314.650151,-18000,,
com.google.Chrome,2,1741972310,1741972312,1741972312.987925,-18000,,
com.microsoft.VSCode,7,1741972303,1741972310,1741972310.340534,-18000,,
com.google.Chrome,3,1741972300,1741972303,1741972303.237194,-18000,,
com.microsoft.VSCode,156,1741972144,1741972300,1741972300.9409041,-18000,,
com.google.Chrome,4,1741972140,1741972144,1741972144.489966,-18000,,
com.microsoft.VSCode,54,1741972086,1741972140,1741972140.742474,-18000,,
com.google.Chrome,1,1741972085,1741972086,1741972086.385664,-18000,,
com.microsoft.VSCode,86,1741971999,1741972085,1741972085.998657,-18000,,
com.google.Chrome,1,1741971998,1741971999,1741971999.648076,-18000,,
com.microsoft.VSCode,18,1741971980,1741971998,1741971998.822379,-18000,,
com.google.Chrome,3,1741971977,1741971980,1741971980.982675,-18000,,
com.microsoft.VSCode,3,1741971974,1741971977,1741971977.303797,-18000,,
com.google.Chrome,1,1741971973,1741971974,1741971974.569975,-18000,,
com.microsoft.VSCode,8,1741971965,1741971973,1741971973.921534,-18000,,
com.google.Chrome,17,1741971948,1741971965,1741971965.06638,-18000,,
com.microsoft.VSCode,2,1741971946,1741971948,1741971948.383255,-18000,,
com.google.Chrome,1,1741971945,1741971946,1741971946.947751,-18000,,
com.microsoft.VSCode,2,1741971943,1741971945,1741971945.892998,-18000,,
com.google.Chrome,1,1741971942,1741971943,1741971943.695024,-18000,,
com.microsoft.VSCode,2,1741971940,1741971942,1741971942.502173,-18000,,
com.google.Chrome,1,1741971939,1741971940,1741971940.601831,-18000,,
com.microsoft.VSCode,2,1741971937,1741971939,1741971939.3710542,-18000,,
com.google.Chrome,1,1741971936,1741971937,1741971937.76293,-18000,,
com.microsoft.VSCode,85,1741971851,1741971936,1741971936.94015,-18000,,
com.google.Chrome,2,1741971849,1741971851,1741971851.064454,-18000,,
com.microsoft.VSCode,83,1741971766,1741971849,1741971849.43816,-18000,,
com.google.Chrome,2,1741971764,1741971766,1741971766.148524,-18000,,
com.microsoft.VSCode,3,1741971761,1741971764,1741971764.927977,-18000,,
com.google.Chrome,15,1741971746,1741971761,1741971761.337331,-18000,,
com.microsoft.VSCode,1,1741971745,1741971746,1741971746.8383741,-18000,,
com.google.Chrome,6,1741971739,1741971745,1741971745.2661572,-18000,,
com.microsoft.VSCode,32,1741971707,1741971739,1741971739.747112,-18000,,
com.google.Chrome,79,1741971628,1741971707,1741971707.794704,-18000,,
com.leomehlig.today,45,1741971583,1741971628,1741971628.524393,-18000,,
com.google.Chrome,11,1741971572,1741971583,1741971584.020557,-18000,,
com.leomehlig.today,6,1741971566,1741971572,1741971572.8601952,-18000,,
com.apple.news,39,1741970067,1741970106,1741970106.825453,-18000,EB445137-D7F5-57EC-87DA-1DB460D64046,"iPhone13,2"
com.microsoft.Office.Outlook,6,1741969908,1741969914,1741969914.8013902,-18000,EB445137-D7F5-57EC-87DA-1DB460D64046,"iPhone13,2"
com.microsoft.Office.Outlook,65,1741968852,1741968917,1741968917.328126,-18000,EB445137-D7F5-57EC-87DA-1DB460D64046,"iPhone13,2"
com.apple.mobilecal,0,1741968852,1741968852,1741968853.990483,-18000,EB445137-D7F5-57EC-87DA-1DB460D64046,"iPhone13,2"
com.apple.mobilecal,63,1741968124,1741968187,1741968187.342186,-18000,EB445137-D7F5-57EC-87DA-1DB460D64046,"iPhone13,2"
com.apple.MobileSMS,5,1741968111,1741968116,1741968116.960493,-18000,EB445137-D7F5-57EC-87DA-1DB460D64046,"iPhone13,2"
com.apple.MobileSMS,20,1741968029,1741968049,1741968049.3528352,-18000,EB445137-D7F5-57EC-87DA-1DB460D64046,"iPhone13,2"
com.microsoft.Office.Outlook,2,1741968014,1741968016,1741968016.965385,-18000,EB445137-D7F5-57EC-87DA-1DB460D64046,"iPhone13,2"
com.microsoft.Office.Outlook,5,1741968006,1741968011,1741968011.759934,-18000,EB445137-D7F5-57EC-87DA-1DB460D64046,"iPhone13,2"
com.apple.MobileSMS,13,1741967987,1741968000,1741968000.1269011,-18000,EB445137-D7F5-57EC-87DA-1DB460D64046,"iPhone13,2"
com.apple.news,25,1741967962,1741967987,1741967987.731729,-18000,EB445137-D7F5-57EC-87DA-1DB460D64046,"iPhone13,2"
com.apple.MobileSMS,150,1741967810,1741967960,1741967960.75698,-18000,EB445137-D7F5-57EC-87DA-1DB460D64046,"iPhone13,2"
com.apple.MobileSMS,3,1741967058,1741967061,1741967061.919801,-18000,EB445137-D7F5-57EC-87DA-1DB460D64046,"iPhone13,2"
com.apple.weather,2,1741967055,1741967057,1741967057.112417,-18000,EB445137-D7F5-57EC-87DA-1DB460D64046,"iPhone13,2"
com.apple.weather,14,1741967028,1741967042,1741967043.193639,-18000,EB445137-D7F5-57EC-87DA-1DB460D64046,"iPhone13,2"
com.apple.weather,10,1741965654,1741965664,1741965664.427462,-18000,EB445137-D7F5-57EC-87DA-1DB460D64046,"iPhone13,2"
com.renpho.health,1,1741965653,1741965654,1741965654.8431,-18000,EB445137-D7F5-57EC-87DA-1DB460D64046,"iPhone13,2"
com.renpho.health,23,1741965595,1741965618,1741965618.779804,-18000,EB445137-D7F5-57EC-87DA-1DB460D64046,"iPhone13,2"
com.google.ios.youtube,1458,1741963252,1741964710,1741964710.933011,-18000,EB445137-D7F5-57EC-87DA-1DB460D64046,"iPhone13,2"
com.google.chrome.ios,189,1741936065,1741936254,1741936254.291379,-18000,EB445137-D7F5-57EC-87DA-1DB460D64046,"iPhone13,2"
com.microsoft.onenote,2,1741936063,1741936065,1741936065.666154,-18000,EB445137-D7F5-57EC-87DA-1DB460D64046,"iPhone13,2"
com.microsoft.onenote,58,1741933658,1741933716,1741933717.505722,-18000,EB445137-D7F5-57EC-87DA-1DB460D64046,"iPhone13,2"
Astrospheric.Astrospheric,2,1741933652,1741933654,1741933654.4931931,-18000,EB445137-D7F5-57EC-87DA-1DB460D64046,"iPhone13,2"
Astrospheric.Astrospheric,8,1741933310,1741933318,1741933318.3577971,-18000,EB445137-D7F5-57EC-87DA-1DB460D64046,"iPhone13,2"
Astrospheric.Astrospheric,5,1741933265,1741933270,1741933270.4991732,-18000,EB445137-D7F5-57EC-87DA-1DB460D64046,"iPhone13,2"
com.google.chrome.ios,4,1741933261,1741933265,1741933265.345823,-18000,EB445137-D7F5-57EC-87DA-1DB460D64046,"iPhone13,2"
com.google.chrome.ios,61,1741933115,1741933176,1741933176.67801,-18000,EB445137-D7F5-57EC-87DA-1DB460D64046,"iPhone13,2"
com.groundspeak.GeocachingIntro,1,1741933114,1741933115,1741933115.739733,-18000,EB445137-D7F5-57EC-87DA-1DB460D64046,"iPhone13,2"
com.groundspeak.GeocachingIntro,147,1741932245,1741932392,1741932392.701498,-18000,EB445137-D7F5-57EC-87DA-1DB460D64046,"iPhone13,2"
com.google.chrome.ios,7,1741932238,1741932245,1741932245.415606,-18000,EB445137-D7F5-57EC-87DA-1DB460D64046,"iPhone13,2"
com.google.chrome.ios,26,1741932189,1741932215,1741932216.454073,-18000,EB445137-D7F5-57EC-87DA-1DB460D64046,"iPhone13,2"
com.groundspeak.GeocachingIntro,263,1741931926,1741932189,1741932189.799683,-18000,EB445137-D7F5-57EC-87DA-1DB460D64046,"iPhone13,2"
com.groundspeak.GeocachingIntro,33,1741931765,1741931798,1741931799.155561,-18000,EB445137-D7F5-57EC-87DA-1DB460D64046,"iPhone13,2"
com.groundspeak.GeocachingIntro,83,1741930929,1741931012,1741931013.003835,-18000,EB445137-D7F5-57EC-87DA-1DB460D64046,"iPhone13,2"
com.apple.AuthenticationServicesUI,4,1741930537,1741930541,1741930541.7307692,-18000,EB445137-D7F5-57EC-87DA-1DB460D64046,"iPhone13,2"
com.groundspeak.GeocachingIntro,122,1741930505,1741930627,1741930627.7882419,-18000,EB445137-D7F5-57EC-87DA-1DB460D64046,"iPhone13,2"
com.apple.AppStore,95,1741930410,1741930505,1741930505.708998,-18000,EB445137-D7F5-57EC-87DA-1DB460D64046,"iPhone13,2"
Astrospheric.Astrospheric,1,1741930406,1741930407,1741930407.66742,-18000,EB445137-D7F5-57EC-87DA-1DB460D64046,"iPhone13,2"
Astrospheric.Astrospheric,15,1741929859,1741929874,1741929874.375916,-18000,EB445137-D7F5-57EC-87DA-1DB460D64046,"iPhone13,2"
com.apple.weather,2,1741929857,1741929859,1741929859.46696,-18000,EB445137-D7F5-57EC-87DA-1DB460D64046,"iPhone13,2"
com.apple.weather,4,1741928689,1741928693,1741928694.5666409,-18000,EB445137-D7F5-57EC-87DA-1DB460D64046,"iPhone13,2"
com.apple.MobileSMS,3,1741927893,1741927896,1741927896.0777159,-18000,EB445137-D7F5-57EC-87DA-1DB460D64046,"iPhone13,2"
com.apple.news,2,1741927744,1741927746,1741927746.984271,-18000,EB445137-D7F5-57EC-87DA-1DB460D64046,"iPhone13,2"
com.apple.news,102,1741927522,1741927624,1741927624.121142,-18000,EB445137-D7F5-57EC-87DA-1DB460D64046,"iPhone13,2"
com.apple.MobileSMS,9,1741927513,1741927522,1741927522.7056131,-18000,EB445137-D7F5-57EC-87DA-1DB460D64046,"iPhone13,2"
com.apple.news,546,1741926966,1741927512,1741927512.527439,-18000,EB445137-D7F5-57EC-87DA-1DB460D64046,"iPhone13,2"
com.apple.MobileSMS,26,1741926940,1741926966,1741926967.185658,-18000,EB445137-D7F5-57EC-87DA-1DB460D64046,"iPhone13,2"
com.apple.news,228,1741926712,1741926940,1741926940.257828,-18000,EB445137-D7F5-57EC-87DA-1DB460D64046,"iPhone13,2"
Astrospheric.Astrospheric,2,1741926690,1741926692,1741926692.826221,-18000,EB445137-D7F5-57EC-87DA-1DB460D64046,"iPhone13,2"
Astrospheric.Astrospheric,20,1741925889,1741925909,1741925909.337994,-18000,EB445137-D7F5-57EC-87DA-1DB460D64046,"iPhone13,2"
com.apple.MobileSMS,106,1741925530,1741925636,1741925636.702426,-18000,EB445137-D7F5-57EC-87DA-1DB460D64046,"iPhone13,2"
com.apple.weather,6,1741925523,1741925529,1741925529.939948,-18000,EB445137-D7F5-57EC-87DA-1DB460D64046,"iPhone13,2"
com.apple.weather,7,1741925220,1741925227,1741925227.3034868,-18000,EB445137-D7F5-57EC-87DA-1DB460D64046,"iPhone13,2"
com.apple.weather,2,1741924706,1741924708,1741924708.814283,-18000,EB445137-D7F5-57EC-87DA-1DB460D64046,"iPhone13,2"
Astrospheric.Astrospheric,53,1741924653,1741924706,1741924706.31634,-18000,EB445137-D7F5-57EC-87DA-1DB460D64046,"iPhone13,2"
com.apple.news,80,1741924569,1741924649,1741924649.430256,-18000,EB445137-D7F5-57EC-87DA-1DB460D64046,"iPhone13,2"
com.hammerandchisel.discord,12,1741924136,1741924148,1741924148.970438,-18000,EB445137-D7F5-57EC-87DA-1DB460D64046,"iPhone13,2"
com.google.chrome.ios,18,1741923165,1741923183,1741923183.8325992,-18000,EB445137-D7F5-57EC-87DA-1DB460D64046,"iPhone13,2"
com.t11.celeste,2,1741923163,1741923165,1741923165.258492,-18000,EB445137-D7F5-57EC-87DA-1DB460D64046,"iPhone13,2"
com.t11.celeste,30,1741923120,1741923150,1741923150.961093,-18000,EB445137-D7F5-57EC-87DA-1DB460D64046,"iPhone13,2"
com.apple.weather,2,1741923072,1741923074,1741923074.191807,-18000,EB445137-D7F5-57EC-87DA-1DB460D64046,"iPhone13,2"
com.apple.weather,9,1741919657,1741919666,1741919666.8000011,-18000,EB445137-D7F5-57EC-87DA-1DB460D64046,"iPhone13,2"
com.hammerandchisel.discord,2,1741919655,1741919657,1741919657.607759,-18000,EB445137-D7F5-57EC-87DA-1DB460D64046,"iPhone13,2"
com.hammerandchisel.discord,38,1741919217,1741919255,1741919256.280874,-18000,EB445137-D7F5-57EC-87DA-1DB460D64046,"iPhone13,2"
com.apple.mobileslideshow,0,1741919217,1741919217,1741919218.5468888,-18000,EB445137-D7F5-57EC-87DA-1DB460D64046,"iPhone13,2"
com.apple.mobileslideshow,103,1741918354,1741918457,1741918458.213076,-18000,EB445137-D7F5-57EC-87DA-1DB460D64046,"iPhone13,2"
com.apple.MobileSMS,18,1741916106,1741916124,1741916124.127759,-18000,EB445137-D7F5-57EC-87DA-1DB460D64046,"iPhone13,2"
Astrospheric.Astrospheric,1,1741916105,1741916106,1741916106.5018,-18000,EB445137-D7F5-57EC-87DA-1DB460D64046,"iPhone13,2"
Astrospheric.Astrospheric,6,1741916060,1741916066,1741916066.34586,-18000,EB445137-D7F5-57EC-87DA-1DB460D64046,"iPhone13,2"
Astrospheric.Astrospheric,17,1741916031,1741916048,1741916048.8147058,-18000,EB445137-D7F5-57EC-87DA-1DB460D64046,"iPhone13,2"
com.microsoft.Office.Outlook,5,1741915965,1741915970,1741915970.173413,-18000,EB445137-D7F5-57EC-87DA-1DB460D64046,"iPhone13,2"
com.apple.MobileSMS,69,1741915861,1741915930,1741915930.53421,-18000,EB445137-D7F5-57EC-87DA-1DB460D64046,"iPhone13,2"
com.apple.MobileSMS,10,1741915813,1741915823,1741915823.433378,-18000,EB445137-D7F5-57EC-87DA-1DB460D64046,"iPhone13,2"
com.apple.MobileSMS,9,1741915772,1741915781,1741915781.700144,-18000,EB445137-D7F5-57EC-87DA-1DB460D64046,"iPhone13,2"
com.google.ios.youtube,0,1741915772,1741915772,1741915773.571127,-18000,EB445137-D7F5-57EC-87DA-1DB460D64046,"iPhone13,2"
com.google.ios.youtube,614,1741913629,1741914243,1741914243.364038,-18000,EB445137-D7F5-57EC-87DA-1DB460D64046,"iPhone13,2"
com.tinyspeck.chatlyio,14,1741913598,1741913612,1741913613.0195742,-18000,EB445137-D7F5-57EC-87DA-1DB460D64046,"iPhone13,2"
com.apple.news,2,1741913595,1741913597,1741913597.5367541,-18000,EB445137-D7F5-57EC-87DA-1DB460D64046,"iPhone13,2"
com.leomehlig.today,156,1741912422,1741912578,1741912578.103331,-18000,,
com.apple.finder,3,1741912419,1741912422,1741912422.9013228,-18000,,
com.hnc.Discord,20,1741912399,1741912419,1741912419.425286,-18000,,
com.google.Chrome,495,1741911904,1741912399,1741912399.06664,-18000,,
com.google.Chrome,2295,1741909515,1741911810,1741911810.47173,-18000,,
com.google.Chrome,306,1741909141,1741909447,1741909447.245462,-18000,,
com.hnc.Discord,2,1741909139,1741909141,1741909141.164524,-18000,,
com.google.Chrome,32,1741909107,1741909139,1741909139.506604,-18000,,
com.hnc.Discord,15,1741909092,1741909107,1741909107.707672,-18000,,
com.google.Chrome,7,1741909085,1741909092,1741909092.314664,-18000,,
com.hnc.Discord,1,1741909084,1741909085,1741909085.376795,-18000,,
com.google.Chrome,2,1741909082,1741909084,1741909084.279502,-18000,,
com.hnc.Discord,3,1741909079,1741909082,1741909082.5559978,-18000,,
com.google.Chrome,540,1741908539,1741909079,1741909079.095228,-18000,,
com.apple.finder,1,1741908538,1741908539,1741908539.684379,-18000,,
com.apple.findmy,4,1741908534,1741908538,1741908538.487045,-18000,,
com.apple.news,135,1741908263,1741908398,1741908399.501756,-18000,EB445137-D7F5-57EC-87DA-1DB460D64046,"iPhone13,2"
com.apple.news,32,1741907676,1741907708,1741907708.197991,-18000,EB445137-D7F5-57EC-87DA-1DB460D64046,"iPhone13,2"
com.apple.weather,3,1741907655,1741907658,1741907658.203485,-18000,EB445137-D7F5-57EC-87DA-1DB460D64046,"iPhone13,2"
com.apple.findmy,296,1741904808,1741905104,1741905105.010213,-18000,,
com.apple.finder,5,1741904803,1741904808,1741904808.957452,-18000,,
