app,usage,start_time,end_time,created_at,tz,device_id,device_model
com.google.Chrome,2,1708461157,1708461159,1708461159.823092,-21600,,
com.apple.systempreferences,13,1708461144,1708461157,1708461157.2819982,-21600,,
com.google.Chrome,29,1708461108,1708461137,1708461137.467733,-21600,,
com.apple.Terminal,8,1708461100,1708461108,1708461108.840687,-21600,,
com.google.Chrome,92,1708461008,1708461100,1708461100.335679,-21600,,
com.apple.Terminal,11,1708460997,1708461008,1708461008.35152,-21600,,
com.google.Chrome,2,1708460995,1708460997,1708460997.346947,-21600,,
com.apple.Terminal,16,1708460979,1708460995,1708460995.301978,-21600,,
com.google.Chrome,4,1708460975,1708460979,1708460979.0824971,-21600,,
com.apple.Terminal,8,1708460967,1708460975,1708460975.596099,-21600,,
com.apple.finder,3,1708460964,1708460967,1708460967.711384,-21600,,
com.apple.Terminal,3,1708460961,1708460964,1708460964.490505,-21600,,
com.apple.finder,25,1708460936,1708460961,1708460961.901972,-21600,,
com.google.Chrome,149,1708460787,1708460936,1708460936.964627,-21600,,
us.zoom.xos,6,1708460781,1708460787,1708460788.005115,-21600,,
com.google.Chrome,311,1708460470,1708460781,1708460781.337215,-21600,,
us.zoom.xos,2,1708460468,1708460470,1708460470.866157,-21600,,
com.google.Chrome,12,1708460456,1708460468,1708460468.595169,-21600,,
us.zoom.xos,9,1708460447,1708460456,1708460456.79162,-21600,,
com.google.Chrome,303,1708460144,1708460447,1708460447.798633,-21600,,
us.zoom.xos,7,1708460137,1708460144,1708460145.0070539,-21600,,
com.google.Chrome,93,1708460044,1708460137,1708460137.8384671,-21600,,
us.zoom.xos,3,1708460041,1708460044,1708460044.726944,-21600,,
com.google.Chrome,7,1708460034,1708460041,1708460041.881882,-21600,,
us.zoom.xos,9,1708460025,1708460034,1708460034.349504,-21600,,
com.google.Chrome,6,1708460019,1708460025,1708460025.3993158,-21600,,
us.zoom.xos,45,1708459974,1708460019,1708460019.468214,-21600,,
com.google.Chrome,38,1708459936,1708459974,1708459974.624034,-21600,,
us.zoom.xos,33,1708459903,1708459936,1708459936.864921,-21600,,
com.google.Chrome,34,1708459869,1708459903,1708459903.597106,-21600,,
com.microsoft.VSCode,122,1708459747,1708459869,1708459869.142113,-21600,,
us.zoom.xos,2,1708459745,1708459747,1708459747.331349,-21600,,
com.microsoft.VSCode,269,1708459476,1708459745,1708459745.250618,-21600,,
us.zoom.xos,25,1708459451,1708459476,1708459476.464838,-21600,,
com.microsoft.VSCode,54,1708459397,1708459451,1708459451.2822351,-21600,,
com.apple.finder,4,1708459393,1708459397,1708459398.090832,-21600,,
com.microsoft.VSCode,28,1708459365,1708459393,1708459393.871479,-21600,,
com.apple.finder,12,1708459353,1708459365,1708459365.573175,-21600,,
com.microsoft.VSCode,11,1708459342,1708459353,1708459353.931899,-21600,,
com.google.Chrome,8,1708459334,1708459342,1708459343.047793,-21600,,
com.microsoft.onenote.mac,2,1708459332,1708459334,1708459334.689884,-21600,,
com.google.Chrome,5,1708459327,1708459332,1708459332.326305,-21600,,
com.apple.systempreferences,2,1708459325,1708459327,1708459328.634583,-21600,,
com.google.Chrome,2,1708459323,1708459325,1708459325.29036,-21600,,
com.apple.iCal,60,1708459263,1708459323,1708459323.109005,-21600,,
com.apple.Maps,18,1708459245,1708459263,1708459264.045558,-21600,,
com.apple.iCal,12,1708459233,1708459245,1708459245.8123631,-21600,,
us.zoom.xos,21,1708459212,1708459233,1708459233.920335,-21600,,
com.google.Chrome,1,1708459211,1708459212,1708459212.89213,-21600,,
us.zoom.xos,2,1708459209,1708459211,1708459211.3213692,-21600,,
com.google.Chrome,21,1708459188,1708459209,1708459209.460853,-21600,,
com.microsoft.VSCode,53,1708459135,1708459188,1708459188.912751,-21600,,
com.apple.finder,13,1708459122,1708459135,1708459136.0138168,-21600,,
com.microsoft.VSCode,10,1708459112,1708459122,1708459122.601367,-21600,,
com.apple.finder,6,1708459106,1708459112,1708459112.703491,-21600,,
com.microsoft.VSCode,102,1708459004,1708459106,1708459106.176135,-21600,,
com.apple.finder,26,1708458978,1708459004,1708459004.740641,-21600,,
com.apple.Notes,37,1708458941,1708458978,1708458979.075924,-21600,,
com.apple.finder,282,1708458659,1708458941,1708458941.9461179,-21600,,
com.microsoft.onenote.mac,158,1708458501,1708458659,1708458659.600243,-21600,,
com.apple.Notes,9,1708458492,1708458501,1708458501.762651,-21600,,
com.apple.finder,49,1708458443,1708458492,1708458492.6446018,-21600,,
com.google.Chrome,26,1708458417,1708458443,1708458443.973628,-21600,,
com.leomehlig.today,448,1708457969,1708458417,1708458418.845159,-21600,,
com.google.Chrome,713,1708457256,1708457969,1708457969.5906348,-21600,,
com.apple.Preview,284,1708456972,1708457256,1708457256.645839,-21600,,
com.apple.Preview,311,1708456660,1708456971,1708456971.4399772,-21600,,
com.google.Chrome,56,1708456604,1708456660,1708456660.319337,-21600,,
com.hnc.Discord,53,1708456551,1708456604,1708456604.301966,-21600,,
com.google.Chrome,24,1708456527,1708456551,1708456552.0380402,-21600,,
com.apple.Preview,1,1708456526,1708456527,1708456527.9186358,-21600,,
com.google.Chrome,36,1708456490,1708456526,1708456526.961344,-21600,,
com.apple.Preview,264,1708456226,1708456490,1708456490.38527,-21600,,
com.google.Chrome,29,1708456197,1708456226,1708456226.921461,-21600,,
com.apple.Preview,71,1708456126,1708456197,1708456197.84249,-21600,,
com.google.Chrome,2,1708456124,1708456126,1708456126.808796,-21600,,
com.apple.Preview,27,1708456097,1708456124,1708456124.6102371,-21600,,
com.google.Chrome,17,1708456080,1708456097,1708456097.754581,-21600,,
com.apple.Preview,51,1708456029,1708456080,1708456080.26331,-21600,,
com.apple.finder,1,1708456028,1708456029,1708456029.4911652,-21600,,
com.apple.Preview,185,1708455843,1708456028,1708456029.06036,-21600,,
com.apple.finder,3,1708455840,1708455843,1708455843.54706,-21600,,
com.google.Chrome,53,1708455787,1708455840,1708455840.748503,-21600,,
com.leomehlig.today,5,1708455782,1708455787,1708455788.4977732,-21600,,
com.microsoft.VSCode,22,1708455760,1708455782,1708455782.333745,-21600,,
com.microsoft.VSCode,3,1708449307,1708449310,1708449310.4903831,-21600,,
com.microsoft.VSCode,2,1708449304,1708449306,1708449306.235925,-21600,,
com.google.Chrome,15,1708449289,1708449304,1708449305.019763,-21600,,
com.leomehlig.today,25,1708449264,1708449289,1708449289.783918,-21600,,
com.google.Chrome,12,1708449252,1708449264,1708449264.273396,-21600,,
com.microsoft.VSCode,97,1708449155,1708449252,1708449252.49598,-21600,,
com.google.Chrome,16,1708449139,1708449155,1708449155.763023,-21600,,
com.microsoft.VSCode,57,1708449082,1708449139,1708449140.019949,-21600,,
com.google.Chrome,33,1708449049,1708449082,1708449082.514792,-21600,,
com.microsoft.VSCode,14,1708449035,1708449049,1708449049.963192,-21600,,
com.google.Chrome,6,1708449029,1708449035,1708449035.306294,-21600,,
com.microsoft.VSCode,16,1708449013,1708449029,1708449030.020859,-21600,,
com.google.Chrome,4,1708449009,1708449013,1708449013.080358,-21600,,
com.microsoft.VSCode,177,1708448832,1708449009,1708449009.524891,-21600,,
com.google.Chrome,1,1708448831,1708448832,1708448832.968534,-21600,,
com.microsoft.VSCode,1,1708448830,1708448831,1708448831.344707,-21600,,
com.google.Chrome,2,1708448828,1708448830,1708448830.562224,-21600,,
com.microsoft.VSCode,2,1708448826,1708448828,1708448828.6895509,-21600,,
com.google.Chrome,1,1708448825,1708448826,1708448826.980689,-21600,,
com.microsoft.VSCode,37,1708448788,1708448825,1708448825.5122108,-21600,,
com.google.Chrome,1,1708448787,1708448788,1708448788.534826,-21600,,
com.microsoft.VSCode,10,1708448777,1708448787,1708448787.242113,-21600,,
com.google.Chrome,11,1708448766,1708448777,1708448777.747855,-21600,,
com.microsoft.VSCode,28,1708448738,1708448766,1708448766.053453,-21600,,
com.google.Chrome,5,1708448733,1708448738,1708448738.763274,-21600,,
com.microsoft.VSCode,6,1708448727,1708448733,1708448733.8330011,-21600,,
com.google.Chrome,52,1708448675,1708448727,1708448727.7730942,-21600,,
com.microsoft.VSCode,76,1708448592,1708448668,1708448668.860238,-21600,,
com.google.Chrome,46,1708448546,1708448592,1708448592.797192,-21600,,
com.microsoft.VSCode,399,1708447958,1708448357,1708448357.109414,-21600,,
com.google.Chrome,3,1708447955,1708447958,1708447958.897717,-21600,,
com.leomehlig.today,1,1708447954,1708447955,1708447955.8090072,-21600,,
com.google.Chrome,39,1708447915,1708447954,1708447954.966368,-21600,,
com.leomehlig.today,2,1708447913,1708447915,1708447915.206522,-21600,,
com.google.Chrome,1,1708447912,1708447913,1708447913.856611,-21600,,
com.microsoft.VSCode,48,1708447864,1708447912,1708447912.641142,-21600,,
com.google.Chrome,11,1708447853,1708447864,1708447864.5992398,-21600,,
com.microsoft.VSCode,1113,1708446740,1708447853,1708447854.851974,-21600,,
com.leomehlig.today,2,1708446738,1708446740,1708446740.363402,-21600,,
com.microsoft.VSCode,597,1708446141,1708446738,1708446738.489685,-21600,,
com.leomehlig.today,48,1708446093,1708446141,1708446141.943303,-21600,,
com.microsoft.VSCode,5,1708446088,1708446093,1708446093.7670379,-21600,,
com.google.Chrome,23,1708446065,1708446088,1708446088.894208,-21600,,
com.google.Chrome,564,1708403301,1708403865,1708403865.5589728,-21600,,
com.google.Chrome,301,1708402597,1708402898,1708402898.0697908,-21600,,
com.google.Chrome,515,1708402051,1708402566,1708402566.9987211,-21600,,
com.apple.finder,29,1708402022,1708402051,1708402052.045062,-21600,,
com.apple.finder,36,1708395720,1708395756,1708395756.1178288,-21600,,
com.microsoft.VSCode,3,1708395717,1708395720,1708395720.6422791,-21600,,
com.apple.finder,46,1708395671,1708395717,1708395717.176326,-21600,,
com.microsoft.VSCode,474,1708395197,1708395671,1708395672.01335,-21600,,
com.apple.finder,5,1708395192,1708395197,1708395197.3444982,-21600,,
com.microsoft.VSCode,56,1708395136,1708395192,1708395192.878331,-21600,,
com.apple.finder,162,1708394974,1708395136,1708395136.62572,-21600,,
com.microsoft.VSCode,21,1708394953,1708394974,1708394975.0318952,-21600,,
com.leomehlig.today,136,1708394817,1708394953,1708394953.5874748,-21600,,
com.apple.Notes,4,1708394813,1708394817,1708394817.196281,-21600,,
com.leomehlig.today,6,1708394807,1708394813,1708394814.052475,-21600,,
com.apple.Notes,44,1708394763,1708394807,1708394807.1563,-21600,,
com.leomehlig.today,25,1708394738,1708394763,1708394763.942451,-21600,,
com.google.Chrome,20,1708394718,1708394738,1708394738.3281689,-21600,,
com.leomehlig.today,33,1708394685,1708394718,1708394718.108742,-21600,,
com.google.Chrome,14,1708394671,1708394685,1708394685.723302,-21600,,
com.leomehlig.today,38,1708394633,1708394671,1708394671.226314,-21600,,
com.google.Chrome,135,1708394498,1708394633,1708394633.659696,-21600,,
com.leomehlig.today,180,1708394318,1708394498,1708394498.319902,-21600,,
com.microsoft.VSCode,133,1708394185,1708394318,1708394318.52585,-21600,,
com.google.Chrome,1,1708394184,1708394185,1708394185.292221,-21600,,
com.microsoft.VSCode,2,1708394182,1708394184,1708394184.198108,-21600,,
com.google.Chrome,1,1708394181,1708394182,1708394182.780581,-21600,,
com.microsoft.VSCode,110,1708394071,1708394181,1708394181.8613272,-21600,,
com.google.Chrome,0,1708394071,1708394071,1708394071.910845,-21600,,
com.microsoft.VSCode,12,1708394059,1708394071,1708394071.114083,-21600,,
com.google.Chrome,1,1708394058,1708394059,1708394059.529824,-21600,,
com.microsoft.VSCode,768,1708393290,1708394058,1708394059.008925,-21600,,
com.google.Chrome,5,1708393285,1708393290,1708393290.767486,-21600,,
com.microsoft.VSCode,11,1708393274,1708393285,1708393285.23416,-21600,,
com.google.Chrome,140,1708393134,1708393274,1708393274.812402,-21600,,
com.microsoft.VSCode,393,1708392741,1708393134,1708393135.757895,-21600,,
com.apple.finder,4,1708392737,1708392741,1708392741.197581,-21600,,
com.google.Chrome,8,1708392729,1708392737,1708392737.5820742,-21600,,
com.leomehlig.today,33,1708392696,1708392729,1708392729.316815,-21600,,
com.google.Chrome,218,1708392478,1708392696,1708392696.792354,-21600,,
com.apple.Preview,76,1708392402,1708392478,1708392478.932891,-21600,,
com.google.Chrome,530,1708391872,1708392402,1708392402.84863,-21600,,
com.google.Chrome,301,1708391568,1708391869,1708391869.0250359,-21600,,
com.google.Chrome,588,1708390978,1708391566,1708391566.1292171,-21600,,
com.leomehlig.today,1,1708390977,1708390978,1708390979.0039902,-21600,,
com.apple.Preview,211,1708390766,1708390977,1708390978.0546532,-21600,,
com.leomehlig.today,11,1708390755,1708390766,1708390766.2975311,-21600,,
com.apple.Preview,0,1708390755,1708390755,1708390756.097011,-21600,,
com.microsoft.Office.Outlook,12,1708390204,1708390216,1708390216.268643,-21600,EB445137-D7F5-57EC-87DA-1DB460D64046,"iPhone13,2"
com.google.Chrome,697,1708390058,1708390755,1708390755.5294518,-21600,,
com.google.Chrome,434,1708389622,1708390056,1708390056.9435658,-21600,,
com.microsoft.Office.Outlook,3,1708389593,1708389596,1708389596.879957,-21600,EB445137-D7F5-57EC-87DA-1DB460D64046,"iPhone13,2"
com.google.Chrome,313,1708389308,1708389621,1708389621.0220342,-21600,,
com.apple.Preview,33,1708389275,1708389308,1708389308.179731,-21600,,
com.google.Chrome,73,1708389202,1708389275,1708389275.515818,-21600,,
com.apple.Preview,131,1708389071,1708389202,1708389202.327458,-21600,,
com.google.Chrome,2,1708389069,1708389071,1708389071.132976,-21600,,
com.apple.Preview,231,1708388838,1708389069,1708389069.5659618,-21600,,
com.google.Chrome,12,1708388826,1708388838,1708388838.796047,-21600,,
com.apple.Preview,5,1708388821,1708388826,1708388826.740556,-21600,,
com.google.Chrome,3,1708388818,1708388821,1708388821.620671,-21600,,
com.apple.Preview,7,1708388811,1708388818,1708388818.191897,-21600,,
com.google.Chrome,1,1708388810,1708388811,1708388811.910404,-21600,,
com.apple.Preview,23,1708388787,1708388810,1708388810.2403069,-21600,,
com.google.Chrome,11,1708388776,1708388787,1708388787.82247,-21600,,
com.apple.Preview,26,1708388750,1708388776,1708388776.436034,-21600,,
com.google.Chrome,43,1708388707,1708388750,1708388750.582748,-21600,,
com.apple.Preview,2,1708388705,1708388707,1708388707.337261,-21600,,
com.google.Chrome,5,1708388700,1708388705,1708388705.266944,-21600,,
com.apple.Preview,6,1708388694,1708388700,1708388700.985172,-21600,,
com.google.Chrome,38,1708388656,1708388694,1708388694.74436,-21600,,
com.apple.Preview,11,1708388645,1708388656,1708388656.846375,-21600,,
com.google.Chrome,4,1708388641,1708388645,1708388645.553098,-21600,,
com.apple.Preview,6,1708388635,1708388641,1708388641.508847,-21600,,
com.google.Chrome,42,1708388593,1708388635,1708388635.9499788,-21600,,
com.apple.Preview,6,1708388587,1708388593,1708388593.4146008,-21600,,
com.google.Chrome,5,1708388582,1708388587,1708388587.265215,-21600,,
com.apple.Preview,17,1708388565,1708388582,1708388582.745595,-21600,,
com.google.Chrome,65,1708388500,1708388565,1708388565.7958999,-21600,,
com.leomehlig.today,48,1708388452,1708388500,1708388500.144831,-21600,,
com.apple.iCal,28,1708388424,1708388452,1708388453.065486,-21600,,
com.leomehlig.today,11,1708388413,1708388424,1708388424.609107,-21600,,
com.microsoft.Office.Outlook,19,1708388275,1708388294,1708388294.613778,-21600,EB445137-D7F5-57EC-87DA-1DB460D64046,"iPhone13,2"
com.google.Chrome,139,1708388274,1708388413,1708388413.111682,-21600,,
edu.illinois.rokwire.ios,8,1708388267,1708388275,1708388276.012167,-21600,EB445137-D7F5-57EC-87DA-1DB460D64046,"iPhone13,2"
com.apple.Preview,218,1708387366,1708387584,1708387584.7634559,-21600,,
com.apple.finder,2,1708387364,1708387366,1708387366.416702,-21600,,
edu.illinois.rokwire.ios,13,1708386847,1708386860,1708386860.794512,-21600,EB445137-D7F5-57EC-87DA-1DB460D64046,"iPhone13,2"
com.google.Chrome,557,1708386807,1708387364,1708387364.738576,-21600,,
edu.illinois.rokwire.ios,5,1708386670,1708386675,1708386675.431521,-21600,EB445137-D7F5-57EC-87DA-1DB460D64046,"iPhone13,2"
edu.illinois.rokwire.ios,9,1708385796,1708385805,1708385805.3181949,-21600,EB445137-D7F5-57EC-87DA-1DB460D64046,"iPhone13,2"
edu.illinois.rokwire.ios,13,1708385781,1708385794,1708385794.19853,-21600,EB445137-D7F5-57EC-87DA-1DB460D64046,"iPhone13,2"
com.apple.mobileslideshow,2,1708385775,1708385777,1708385777.99819,-21600,EB445137-D7F5-57EC-87DA-1DB460D64046,"iPhone13,2"
com.apple.mobileslideshow,4,1708385513,1708385517,1708385517.518036,-21600,EB445137-D7F5-57EC-87DA-1DB460D64046,"iPhone13,2"
com.apple.mobileslideshow,130,1708384715,1708384845,1708384845.6556349,-21600,EB445137-D7F5-57EC-87DA-1DB460D64046,"iPhone13,2"
com.apple.journal,4,1708384698,1708384702,1708384702.1312962,-21600,EB445137-D7F5-57EC-87DA-1DB460D64046,"iPhone13,2"
com.apple.journal,1,1708384694,1708384695,1708384695.837452,-21600,EB445137-D7F5-57EC-87DA-1DB460D64046,"iPhone13,2"
com.apple.journal,146,1708384337,1708384483,1708384483.017304,-21600,EB445137-D7F5-57EC-87DA-1DB460D64046,"iPhone13,2"
com.google.Chrome,408,1708383758,1708384166,1708384166.5693111,-21600,,
com.apple.finder,157,1708383601,1708383758,1708383758.1768122,-21600,,
com.apple.MobileSMS,7,1708383304,1708383311,1708383311.877764,-21600,EB445137-D7F5-57EC-87DA-1DB460D64046,"iPhone13,2"
com.toyopagroup.picaboo,76,1708383226,1708383302,1708383302.8835459,-21600,EB445137-D7F5-57EC-87DA-1DB460D64046,"iPhone13,2"
com.hammerandchisel.discord,2,1708383224,1708383226,1708383226.200633,-21600,EB445137-D7F5-57EC-87DA-1DB460D64046,"iPhone13,2"
com.hammerandchisel.discord,185,1708383038,1708383223,1708383223.40908,-21600,EB445137-D7F5-57EC-87DA-1DB460D64046,"iPhone13,2"
com.truebill.truebillnative,76,1708382940,1708383016,1708383016.134074,-21600,EB445137-D7F5-57EC-87DA-1DB460D64046,"iPhone13,2"
com.microsoft.Office.Outlook,70,1708382863,1708382933,1708382933.7670898,-21600,EB445137-D7F5-57EC-87DA-1DB460D64046,"iPhone13,2"
com.thestorygraph.thestorygraph,220,1708382639,1708382859,1708382859.756781,-21600,EB445137-D7F5-57EC-87DA-1DB460D64046,"iPhone13,2"
com.google.chrome.ios,63,1708382576,1708382639,1708382639.958133,-21600,EB445137-D7F5-57EC-87DA-1DB460D64046,"iPhone13,2"
com.thestorygraph.thestorygraph,30,1708382546,1708382576,1708382576.496479,-21600,EB445137-D7F5-57EC-87DA-1DB460D64046,"iPhone13,2"
com.google.chrome.ios,4,1708382542,1708382546,1708382546.7203689,-21600,EB445137-D7F5-57EC-87DA-1DB460D64046,"iPhone13,2"
com.thestorygraph.thestorygraph,15,1708382527,1708382542,1708382542.191227,-21600,EB445137-D7F5-57EC-87DA-1DB460D64046,"iPhone13,2"
com.google.chrome.ios,88,1708382439,1708382527,1708382527.032033,-21600,EB445137-D7F5-57EC-87DA-1DB460D64046,"iPhone13,2"
com.thestorygraph.thestorygraph,68,1708382370,1708382438,1708382438.5931249,-21600,EB445137-D7F5-57EC-87DA-1DB460D64046,"iPhone13,2"
com.apple.mobileslideshow,87,1708382261,1708382348,1708382348.270646,-21600,EB445137-D7F5-57EC-87DA-1DB460D64046,"iPhone13,2"
edu.illinois.rokwire.ios,3,1708382255,1708382258,1708382258.101088,-21600,EB445137-D7F5-57EC-87DA-1DB460D64046,"iPhone13,2"
edu.illinois.rokwire.ios,6,1708382204,1708382210,1708382210.6446009,-21600,EB445137-D7F5-57EC-87DA-1DB460D64046,"iPhone13,2"
edu.illinois.rokwire.ios,18,1708382165,1708382183,1708382183.049166,-21600,EB445137-D7F5-57EC-87DA-1DB460D64046,"iPhone13,2"
com.google.ios.youtube,551,1708381598,1708382149,1708382150.0382462,-21600,EB445137-D7F5-57EC-87DA-1DB460D64046,"iPhone13,2"
com.reddit.Reddit,4,1708381592,1708381596,1708381596.219583,-21600,EB445137-D7F5-57EC-87DA-1DB460D64046,"iPhone13,2"
com.reddit.Reddit,9,1708380418,1708380427,1708380427.152334,-21600,EB445137-D7F5-57EC-87DA-1DB460D64046,"iPhone13,2"
com.reddit.Reddit,1,1708378439,1708378440,1708378440.8534389,-21600,EB445137-D7F5-57EC-87DA-1DB460D64046,"iPhone13,2"
com.reddit.Reddit,53,1708378371,1708378424,1708378424.515518,-21600,EB445137-D7F5-57EC-87DA-1DB460D64046,"iPhone13,2"
com.google.chrome.ios,231,1708378140,1708378371,1708378371.1995978,-21600,EB445137-D7F5-57EC-87DA-1DB460D64046,"iPhone13,2"
com.google.ios.youtube,116,1708378024,1708378140,1708378140.367172,-21600,EB445137-D7F5-57EC-87DA-1DB460D64046,"iPhone13,2"
com.google.chrome.ios,50,1708377974,1708378024,1708378024.432242,-21600,EB445137-D7F5-57EC-87DA-1DB460D64046,"iPhone13,2"
com.google.ios.youtube,205,1708377769,1708377974,1708377974.444238,-21600,EB445137-D7F5-57EC-87DA-1DB460D64046,"iPhone13,2"
com.google.chrome.ios,3,1708377766,1708377769,1708377769.1008182,-21600,EB445137-D7F5-57EC-87DA-1DB460D64046,"iPhone13,2"
com.apple.Music,11,1708377753,1708377764,1708377764.927607,-21600,EB445137-D7F5-57EC-87DA-1DB460D64046,"iPhone13,2"
com.apple.Music,6,1708377632,1708377638,1708377638.491729,-21600,EB445137-D7F5-57EC-87DA-1DB460D64046,"iPhone13,2"
com.apple.Music,5,1708377460,1708377465,1708377465.102481,-21600,EB445137-D7F5-57EC-87DA-1DB460D64046,"iPhone13,2"
com.apple.Music,3,1708377319,1708377322,1708377322.058803,-21600,EB445137-D7F5-57EC-87DA-1DB460D64046,"iPhone13,2"
com.apple.Music,5,1708377164,1708377169,1708377169.5148191,-21600,EB445137-D7F5-57EC-87DA-1DB460D64046,"iPhone13,2"
com.apple.Music,6,1708377106,1708377112,1708377112.484136,-21600,EB445137-D7F5-57EC-87DA-1DB460D64046,"iPhone13,2"
com.apple.Music,13,1708377090,1708377103,1708377103.920259,-21600,EB445137-D7F5-57EC-87DA-1DB460D64046,"iPhone13,2"
com.instructure.icanvas,0,1708377024,1708377024,1708377024.623285,-21600,EB445137-D7F5-57EC-87DA-1DB460D64046,"iPhone13,2"
com.instructure.icanvas,2,1708377021,1708377023,1708377023.8416982,-21600,EB445137-D7F5-57EC-87DA-1DB460D64046,"iPhone13,2"
com.instructure.icanvas,11,1708376883,1708376894,1708376894.688268,-21600,EB445137-D7F5-57EC-87DA-1DB460D64046,"iPhone13,2"
com.instructure.icanvas,3,1708376877,1708376880,1708376880.938091,-21600,EB445137-D7F5-57EC-87DA-1DB460D64046,"iPhone13,2"
com.instructure.icanvas,6,1708375196,1708375202,1708375202.393649,-21600,EB445137-D7F5-57EC-87DA-1DB460D64046,"iPhone13,2"
com.instructure.icanvas,17,1708375032,1708375049,1708375049.138276,-21600,EB445137-D7F5-57EC-87DA-1DB460D64046,"iPhone13,2"
com.microsoft.Office.Outlook,7,1708375025,1708375032,1708375032.529484,-21600,EB445137-D7F5-57EC-87DA-1DB460D64046,"iPhone13,2"
com.microsoft.Office.Outlook,10,1708375014,1708375024,1708375024.398103,-21600,EB445137-D7F5-57EC-87DA-1DB460D64046,"iPhone13,2"
com.microsoft.Office.Outlook,80,1708374918,1708374998,1708374998.3511438,-21600,EB445137-D7F5-57EC-87DA-1DB460D64046,"iPhone13,2"
com.apple.news,31,1708372918,1708372949,1708372950.0193648,-21600,EB445137-D7F5-57EC-87DA-1DB460D64046,"iPhone13,2"
com.apple.news,160,1708372723,1708372883,1708372883.3140569,-21600,EB445137-D7F5-57EC-87DA-1DB460D64046,"iPhone13,2"
com.tier9digital.sundial,14,1708372680,1708372694,1708372694.8869271,-21600,EB445137-D7F5-57EC-87DA-1DB460D64046,"iPhone13,2"
Astrospheric.Astrospheric,109,1708372567,1708372676,1708372676.450536,-21600,EB445137-D7F5-57EC-87DA-1DB460D64046,"iPhone13,2"
com.apple.weather,6,1708372560,1708372566,1708372566.8497,-21600,EB445137-D7F5-57EC-87DA-1DB460D64046,"iPhone13,2"
com.google.chrome.ios,73,1708369003,1708369076,1708369076.3241758,-21600,EB445137-D7F5-57EC-87DA-1DB460D64046,"iPhone13,2"
com.leomehlig.today,21,1708368978,1708368999,1708368999.298592,-21600,EB445137-D7F5-57EC-87DA-1DB460D64046,"iPhone13,2"
com.apple.mobilecal,11,1708368964,1708368975,1708368975.8625011,-21600,EB445137-D7F5-57EC-87DA-1DB460D64046,"iPhone13,2"
com.apple.camera,4,1708368775,1708368779,1708368779.746021,-21600,EB445137-D7F5-57EC-87DA-1DB460D64046,"iPhone13,2"
com.burbn.instagram,7,1708367596,1708367603,1708367603.495785,-21600,EB445137-D7F5-57EC-87DA-1DB460D64046,"iPhone13,2"
com.burbn.instagram,62,1708367126,1708367188,1708367188.9856238,-21600,EB445137-D7F5-57EC-87DA-1DB460D64046,"iPhone13,2"
edu.illinois.rokwire.ios,20,1708367105,1708367125,1708367125.634128,-21600,EB445137-D7F5-57EC-87DA-1DB460D64046,"iPhone13,2"
edu.illinois.rokwire.ios,10,1708366488,1708366498,1708366498.428644,-21600,EB445137-D7F5-57EC-87DA-1DB460D64046,"iPhone13,2"
edu.illinois.rokwire.ios,3,1708366483,1708366486,1708366486.7464771,-21600,EB445137-D7F5-57EC-87DA-1DB460D64046,"iPhone13,2"
edu.illinois.rokwire.ios,2,1708366467,1708366469,1708366469.8593311,-21600,EB445137-D7F5-57EC-87DA-1DB460D64046,"iPhone13,2"
edu.illinois.rokwire.ios,32,1708365059,1708365091,1708365091.826182,-21600,EB445137-D7F5-57EC-87DA-1DB460D64046,"iPhone13,2"
com.apple.Health,5,1708365053,1708365058,1708365058.581198,-21600,EB445137-D7F5-57EC-87DA-1DB460D64046,"iPhone13,2"
com.apple.Health,155,1708364090,1708364245,1708364245.6885371,-21600,EB445137-D7F5-57EC-87DA-1DB460D64046,"iPhone13,2"
com.microsoft.Office.Outlook,5,1708364085,1708364090,1708364090.737475,-21600,EB445137-D7F5-57EC-87DA-1DB460D64046,"iPhone13,2"
com.microsoft.Office.Outlook,6,1708364076,1708364082,1708364082.610949,-21600,EB445137-D7F5-57EC-87DA-1DB460D64046,"iPhone13,2"
com.microsoft.Office.Outlook,35,1708363482,1708363517,1708363517.959406,-21600,EB445137-D7F5-57EC-87DA-1DB460D64046,"iPhone13,2"
com.apple.MobileSMS,3,1708363210,1708363213,1708363213.52313,-21600,EB445137-D7F5-57EC-87DA-1DB460D64046,"iPhone13,2"
com.instructure.icanvas,8,1708363199,1708363207,1708363207.3521519,-21600,EB445137-D7F5-57EC-87DA-1DB460D64046,"iPhone13,2"
com.microsoft.Office.Outlook,13,1708363184,1708363197,1708363197.3521461,-21600,EB445137-D7F5-57EC-87DA-1DB460D64046,"iPhone13,2"
com.toyopagroup.picaboo,67,1708363116,1708363183,1708363183.774582,-21600,EB445137-D7F5-57EC-87DA-1DB460D64046,"iPhone13,2"
com.apple.MobileSMS,4,1708362133,1708362137,1708362137.3884091,-21600,EB445137-D7F5-57EC-87DA-1DB460D64046,"iPhone13,2"
com.apple.MobileSMS,2,1708361022,1708361024,1708361024.919435,-21600,EB445137-D7F5-57EC-87DA-1DB460D64046,"iPhone13,2"
com.apple.weather,6,1708361016,1708361022,1708361022.730702,-21600,EB445137-D7F5-57EC-87DA-1DB460D64046,"iPhone13,2"
com.apple.weather,3,1708360920,1708360923,1708360923.4722018,-21600,EB445137-D7F5-57EC-87DA-1DB460D64046,"iPhone13,2"
com.apple.weather,7,1708360574,1708360581,1708360581.930167,-21600,EB445137-D7F5-57EC-87DA-1DB460D64046,"iPhone13,2"
com.apple.Health,3,1708360571,1708360574,1708360574.3110418,-21600,EB445137-D7F5-57EC-87DA-1DB460D64046,"iPhone13,2"
com.apple.Health,1,1708360503,1708360504,1708360504.468627,-21600,EB445137-D7F5-57EC-87DA-1DB460D64046,"iPhone13,2"
com.apple.Health,14,1708360481,1708360495,1708360495.3963308,-21600,EB445137-D7F5-57EC-87DA-1DB460D64046,"iPhone13,2"
com.apple.finder,5,1708316523,1708316528,1708316528.1374369,-21600,,
com.google.Chrome,2,1708316521,1708316523,1708316523.589344,-21600,,
com.apple.Preview,1,1708316520,1708316521,1708316521.73943,-21600,,
com.apple.finder,2,1708316518,1708316520,1708316520.6084352,-21600,,
com.apple.iCal,15,1708316503,1708316518,1708316518.82612,-21600,,
com.google.Chrome,7,1708316496,1708316503,1708316503.801948,-21600,,
com.apple.iCal,27,1708316469,1708316496,1708316496.931573,-21600,,
com.apple.finder,4,1708316465,1708316469,1708316469.089395,-21600,,
com.microsoft.Outlook,3,1708316462,1708316465,1708316465.717823,-21600,,
com.google.Chrome,1600,1708314862,1708316462,1708316462.512066,-21600,,
com.apple.Preview,6,1708314856,1708314862,1708314862.217197,-21600,,
com.apple.Preview,302,1708313647,1708313949,1708313949.438376,-21600,,
com.leomehlig.today,4,1708313643,1708313647,1708313647.9052281,-21600,,
com.apple.AppStore,27,1708313616,1708313643,1708313643.666841,-21600,,
com.leomehlig.today,2,1708313614,1708313616,1708313616.612416,-21600,,
com.leomehlig.today,428,1708312869,1708313297,1708313297.0429559,-21600,,
com.apple.Preview,1421,1708311448,1708312869,1708312869.140328,-21600,,
com.apple.finder,2,1708311446,1708311448,1708311448.379278,-21600,,
com.leomehlig.today,54,1708311392,1708311446,1708311446.755889,-21600,,
com.google.Chrome,25,1708311367,1708311392,1708311392.882498,-21600,,
com.leomehlig.today,2,1708311365,1708311367,1708311367.600172,-21600,,
com.google.Chrome,2,1708311363,1708311365,1708311365.805491,-21600,,
com.google.Chrome,449,1708310246,1708310695,1708310695.349822,-21600,,
com.google.Chrome,300,1708309815,1708310115,1708310115.728549,-21600,,
com.google.Chrome,556,1708309026,1708309582,1708309582.101527,-21600,,
com.leomehlig.today,7,1708309019,1708309026,1708309026.919348,-21600,,
com.google.Chrome,563,1708308456,1708309019,1708309019.2818089,-21600,,
com.microsoft.Outlook,49,1708308407,1708308456,1708308456.1885939,-21600,,
com.google.Chrome,41,1708308366,1708308407,1708308407.389128,-21600,,
com.google.Chrome,631,1708304332,1708304963,1708304963.5691519,-21600,,
com.leomehlig.today,396,1708303936,1708304332,1708304333.1440349,-21600,,
com.apple.iCal,6,1708303930,1708303936,1708303936.9703221,-21600,,
com.leomehlig.today,3,1708303927,1708303930,1708303930.953773,-21600,,
com.google.Chrome,464,1708303463,1708303927,1708303927.281261,-21600,,
com.microsoft.Outlook,85,1708303378,1708303463,1708303463.609252,-21600,,
com.apple.finder,4,1708303374,1708303378,1708303378.446721,-21600,,
com.apple.finder,3,1708282653,1708282656,1708282656.244876,-21600,,
com.leomehlig.today,1,1708282652,1708282653,1708282653.8392382,-21600,,
com.apple.finder,4,1708282648,1708282652,1708282652.460935,-21600,,
com.apple.Music,4,1708282644,1708282648,1708282648.716728,-21600,,
com.google.Chrome,2,1708282642,1708282644,1708282644.8483129,-21600,,
com.leomehlig.today,74,1708282568,1708282642,1708282642.359726,-21600,,
com.apple.Notes,11,1708282557,1708282568,1708282568.497179,-21600,,
com.leomehlig.today,32,1708282525,1708282557,1708282557.801053,-21600,,
com.microsoft.VSCode,63,1708282462,1708282525,1708282525.5022202,-21600,,
com.google.Chrome,3,1708282459,1708282462,1708282462.575118,-21600,,
com.microsoft.VSCode,32,1708282427,1708282459,1708282459.869279,-21600,,
com.google.Chrome,3,1708282424,1708282427,1708282427.061048,-21600,,
com.microsoft.VSCode,28,1708282396,1708282424,1708282424.867147,-21600,,
com.google.Chrome,2,1708282394,1708282396,1708282396.092525,-21600,,
com.microsoft.VSCode,9,1708282385,1708282394,1708282394.67455,-21600,,
com.google.Chrome,50,1708282335,1708282385,1708282385.153059,-21600,,
com.microsoft.VSCode,585,1708281750,1708282335,1708282335.524605,-21600,,
com.apple.Music,69,1708281681,1708281750,1708281750.848349,-21600,,
com.apple.finder,17,1708281664,1708281681,1708281681.83094,-21600,,
com.google.Chrome,1,1708281579,1708281580,1708281580.335542,-21600,,
com.leomehlig.today,1,1708281578,1708281579,1708281579.151833,-21600,,
com.microsoft.VSCode,11,1708281567,1708281578,1708281579.083178,-21600,,
com.leomehlig.today,2,1708281565,1708281567,1708281567.901732,-21600,,
com.microsoft.VSCode,571,1708280994,1708281565,1708281565.750418,-21600,,
com.google.Chrome,5,1708280989,1708280994,1708280994.413704,-21600,,
com.leomehlig.today,36,1708280953,1708280989,1708280989.411396,-21600,,
com.google.Chrome,273,1708280680,1708280953,1708280953.464879,-21600,,
com.leomehlig.today,2,1708280678,1708280680,1708280680.138803,-21600,,
com.google.Chrome,2221,1708278457,1708280678,1708280678.321775,-21600,,
com.leomehlig.today,43,1708278414,1708278457,1708278457.704299,-21600,,
com.google.Chrome,2,1708278412,1708278414,1708278414.6016831,-21600,,
com.google.Chrome,613,1708210600,1708211213,1708211213.762284,-21600,,
com.google.Chrome,430,1708210095,1708210525,1708210525.986774,-21600,,
com.google.Chrome,492,1708209484,1708209976,1708209976.035692,-21600,,
com.google.Chrome,302,1708208935,1708209237,1708209237.06187,-21600,,
com.google.Chrome,593,1708207905,1708208498,1708208499.010225,-21600,,
com.google.Chrome,491,1708207178,1708207669,1708207669.255515,-21600,,
com.google.Chrome,36,1708206149,1708206185,1708206186.1660829,-21600,,
com.apple.finder,9,1708206140,1708206149,1708206149.71915,-21600,,
com.apple.FaceTime,2,1708206138,1708206140,1708206140.6075869,-21600,,
com.google.Chrome,83,1708206055,1708206138,1708206139.141111,-21600,,
com.google.Chrome,579,1708205455,1708206034,1708206035.0067391,-21600,,
com.google.Chrome,626,1708204162,1708204788,1708204788.921492,-21600,,
com.apple.finder,4,1708204158,1708204162,1708204162.9825358,-21600,,
com.apple.finder,2,1708199596,1708199598,1708199599.3124042,-21600,,
com.google.Chrome,8,1708199588,1708199596,1708199596.760715,-21600,,
com.leomehlig.today,61,1708199527,1708199588,1708199588.802078,-21600,,
com.google.Chrome,23,1708199504,1708199527,1708199527.747164,-21600,,
com.leomehlig.today,8,1708199496,1708199504,1708199504.5352678,-21600,,
com.google.Chrome,114,1708199382,1708199496,1708199496.572711,-21600,,
com.apple.Preview,1,1708199381,1708199382,1708199382.98083,-21600,,
com.google.Chrome,53,1708199328,1708199381,1708199381.6074939,-21600,,
com.apple.Preview,63,1708199265,1708199328,1708199329.044394,-21600,,
com.google.Chrome,10,1708199255,1708199265,1708199265.473402,-21600,,
com.apple.Preview,9,1708199246,1708199255,1708199255.9726691,-21600,,
com.apple.Preview,301,1708198828,1708199129,1708199129.946498,-21600,,
com.google.Chrome,76,1708198752,1708198828,1708198828.586492,-21600,,
com.apple.Preview,77,1708198675,1708198752,1708198752.9013572,-21600,,
com.google.Chrome,58,1708198617,1708198675,1708198675.631093,-21600,,
com.google.Chrome,399,1708198110,1708198509,1708198509.2071981,-21600,,
com.apple.Preview,49,1708198061,1708198110,1708198110.2253242,-21600,,
com.google.Chrome,33,1708198028,1708198061,1708198061.190115,-21600,,
com.apple.Preview,46,1708197982,1708198028,1708198028.208941,-21600,,
com.google.Chrome,102,1708197880,1708197982,1708197982.786485,-21600,,
com.apple.Preview,49,1708197831,1708197880,1708197880.8397598,-21600,,
com.google.Chrome,3,1708197828,1708197831,1708197831.24365,-21600,,
com.google.Chrome,300,1708197525,1708197825,1708197825.955174,-21600,,
com.apple.Preview,12,1708197513,1708197525,1708197525.965294,-21600,,
com.google.Chrome,23,1708197490,1708197513,1708197513.852155,-21600,,
com.apple.Preview,41,1708197449,1708197490,1708197490.619245,-21600,,
com.google.Chrome,2,1708197447,1708197449,1708197449.201277,-21600,,
com.apple.Preview,286,1708197161,1708197447,1708197447.740772,-21600,,
com.google.Chrome,4,1708197157,1708197161,1708197161.269875,-21600,,
com.apple.Preview,30,1708197127,1708197157,1708197157.256321,-21600,,
com.google.Chrome,135,1708196992,1708197127,1708197128.029626,-21600,,
com.apple.Preview,448,1708196544,1708196992,1708196992.4163132,-21600,,
com.google.Chrome,10,1708196534,1708196544,1708196544.86271,-21600,,
com.apple.Preview,11,1708196523,1708196534,1708196534.924821,-21600,,
com.google.Chrome,719,1708195804,1708196523,1708196523.765682,-21600,,
com.google.Chrome,468,1708195336,1708195804,1708195804.421885,-21600,,
com.google.Chrome,300,1708195030,1708195330,1708195330.669445,-21600,,
com.apple.Preview,40,1708194990,1708195030,1708195030.633841,-21600,,
com.google.Chrome,31,1708194959,1708194990,1708194990.567816,-21600,,
com.apple.Preview,205,1708194754,1708194959,1708194959.7584429,-21600,,
com.apple.finder,1,1708194753,1708194754,1708194754.635353,-21600,,
com.google.Chrome,151,1708194602,1708194753,1708194753.226676,-21600,,
com.leomehlig.today,51,1708194551,1708194602,1708194602.9197989,-21600,,
com.apple.iCal,8,1708194543,1708194551,1708194551.27986,-21600,,
com.leomehlig.today,11,1708194532,1708194543,1708194543.62344,-21600,,
com.google.Chrome,16,1708194516,1708194532,1708194532.72997,-21600,,
com.microsoft.VSCode,6,1708194510,1708194516,1708194516.9918919,-21600,,
com.microsoft.VSCode,161,1708132243,1708132404,1708132404.561911,-21600,,
com.apple.finder,39,1708132204,1708132243,1708132243.9526381,-21600,,
com.microsoft.VSCode,289,1708131915,1708132204,1708132204.432152,-21600,,
com.google.Chrome,9,1708131906,1708131915,1708131915.273219,-21600,,
com.microsoft.VSCode,11,1708131895,1708131906,1708131906.786814,-21600,,
com.google.Chrome,7,1708131888,1708131895,1708131895.478679,-21600,,
com.microsoft.VSCode,27,1708131861,1708131888,1708131888.644028,-21600,,
com.google.Chrome,8,1708131853,1708131861,1708131861.296648,-21600,,
com.microsoft.VSCode,53,1708131800,1708131853,1708131853.33818,-21600,,
com.google.Chrome,21,1708131779,1708131800,1708131800.992281,-21600,,
com.microsoft.VSCode,242,1708131537,1708131779,1708131779.478251,-21600,,
com.google.Chrome,23,1708131514,1708131537,1708131537.589102,-21600,,
com.microsoft.VSCode,2,1708131512,1708131514,1708131516.076961,-21600,,
com.google.Chrome,268,1708131244,1708131512,1708131513.0154572,-21600,,
com.microsoft.VSCode,90,1708131154,1708131244,1708131244.9156342,-21600,,
com.google.Chrome,8,1708131146,1708131154,1708131154.1655889,-21600,,
com.microsoft.VSCode,93,1708131053,1708131146,1708131146.476345,-21600,,
com.google.Chrome,1,1708131052,1708131053,1708131054.091743,-21600,,
com.microsoft.Excel,25,1708131027,1708131052,1708131052.798459,-21600,,
com.apple.finder,6,1708131021,1708131027,1708131027.592373,-21600,,
com.google.Chrome,0,1708131021,1708131021,1708131022.0180101,-21600,,
com.microsoft.Excel,5,1708131016,1708131021,1708131021.07858,-21600,,
com.google.Chrome,28,1708130988,1708131016,1708131016.794301,-21600,,
com.microsoft.VSCode,30,1708130958,1708130988,1708130988.412111,-21600,,
com.microsoft.Excel,5,1708130953,1708130958,1708130958.191413,-21600,,
com.microsoft.VSCode,17,1708130936,1708130953,1708130953.8616328,-21600,,
com.microsoft.Excel,1,1708130935,1708130936,1708130936.479001,-21600,,
com.microsoft.VSCode,17,1708130918,1708130935,1708130935.144366,-21600,,
com.microsoft.Excel,6,1708130912,1708130918,1708130918.406528,-21600,,
com.microsoft.VSCode,48,1708130864,1708130912,1708130912.610879,-21600,,
com.apple.finder,3,1708130861,1708130864,1708130864.159439,-21600,,
com.microsoft.Excel,2,1708130859,1708130861,1708130861.439338,-21600,,
com.microsoft.VSCode,29,1708130830,1708130859,1708130859.881763,-21600,,
com.microsoft.Excel,0,1708130830,1708130830,1708130830.9820461,-21600,,
com.microsoft.VSCode,23,1708130807,1708130830,1708130830.0689979,-21600,,
com.microsoft.Excel,3,1708130804,1708130807,1708130807.842226,-21600,,
com.microsoft.VSCode,43,1708130761,1708130804,1708130804.4591,-21600,,
com.apple.finder,1,1708130760,1708130761,1708130761.6806931,-21600,,
com.microsoft.Excel,23,1708130737,1708130760,1708130760.527021,-21600,,
com.apple.finder,5,1708130732,1708130737,1708130737.8829908,-21600,,
com.microsoft.VSCode,22,1708130710,1708130732,1708130732.9631,-21600,,
com.microsoft.Excel,1,1708130709,1708130710,1708130710.521903,-21600,,
com.microsoft.VSCode,2,1708130707,1708130709,1708130709.213321,-21600,,
com.apple.finder,27,1708130680,1708130707,1708130707.1789432,-21600,,
com.microsoft.Excel,109,1708130571,1708130680,1708130680.6181889,-21600,,
com.google.Chrome,51,1708130520,1708130571,1708130571.365382,-21600,,
com.microsoft.Excel,7,1708130513,1708130520,1708130520.9858088,-21600,,
com.google.Chrome,19,1708130494,1708130513,1708130513.494951,-21600,,
com.microsoft.Excel,2,1708130492,1708130494,1708130494.929165,-21600,,
com.google.Chrome,305,1708130187,1708130492,1708130492.928273,-21600,,
com.apple.MobileSMS,41,1708130146,1708130187,1708130187.266933,-21600,,
com.google.Chrome,478,1708129668,1708130146,1708130146.938071,-21600,,
com.apple.iWork.Numbers,65,1708129603,1708129668,1708129668.550723,-21600,,
com.google.Chrome,74,1708129529,1708129603,1708129603.761231,-21600,,
com.apple.MobileSMS,4,1708129525,1708129529,1708129529.1238852,-21600,,
com.google.Chrome,112,1708129413,1708129525,1708129525.168109,-21600,,
com.apple.iWork.Numbers,46,1708129367,1708129413,1708129413.081532,-21600,,
com.google.Chrome,141,1708129226,1708129367,1708129367.604299,-21600,,
com.apple.iWork.Numbers,41,1708129185,1708129226,1708129226.7223969,-21600,,
com.google.Chrome,101,1708129084,1708129185,1708129186.0354419,-21600,,
com.apple.iWork.Numbers,31,1708129053,1708129084,1708129084.52707,-21600,,
com.google.Chrome,111,1708128942,1708129053,1708129053.512969,-21600,,
com.microsoft.VSCode,43,1708128899,1708128942,1708128942.721889,-21600,,
com.google.Chrome,85,1708128814,1708128899,1708128899.2538261,-21600,,
com.microsoft.VSCode,189,1708128625,1708128814,1708128814.311244,-21600,,
com.google.Chrome,12,1708128613,1708128625,1708128625.52252,-21600,,
com.microsoft.VSCode,148,1708128465,1708128613,1708128613.97735,-21600,,
com.apple.finder,7,1708128458,1708128465,1708128465.3624759,-21600,,
com.microsoft.VSCode,9,1708128449,1708128458,1708128458.667533,-21600,,
com.google.Chrome,1,1708128448,1708128449,1708128449.440983,-21600,,
com.apple.MobileSMS,27,1708128421,1708128448,1708128448.088502,-21600,,
com.google.Chrome,77,1708128344,1708128421,1708128421.864398,-21600,,
com.apple.finder,12,1708128332,1708128344,1708128344.115886,-21600,,
com.apple.archiveutility,1,1708128331,1708128332,1708128332.173311,-21600,,
com.apple.finder,2,1708128329,1708128331,1708128331.8450332,-21600,,
com.google.Chrome,54,1708128275,1708128329,1708128329.319915,-21600,,
com.apple.MobileSMS,6,1708128269,1708128275,1708128275.3367019,-21600,,
com.apple.finder,48,1708128221,1708128269,1708128269.7,-21600,,
com.google.Chrome,93,1708128128,1708128221,1708128222.0527081,-21600,,
com.apple.MobileSMS,44,1708128084,1708128128,1708128128.70935,-21600,,
com.microsoft.VSCode,3,1708128081,1708128084,1708128084.617127,-21600,,
com.apple.dt.Xcode,16,1708128065,1708128081,1708128081.941767,-21600,,
com.apple.dt.Xcode,370,1708123626,1708123996,1708123996.628408,-21600,,
com.microsoft.onenote.mac,21,1708123605,1708123626,1708123626.196755,-21600,,
com.apple.dt.Xcode,37,1708123568,1708123605,1708123605.826201,-21600,,
com.apple.finder,10,1708123511,1708123521,1708123521.423948,-21600,,
com.apple.dt.Xcode,13,1708123498,1708123511,1708123511.134644,-21600,,
com.microsoft.onenote.mac,53,1708123445,1708123498,1708123498.842762,-21600,,
com.apple.finder,4,1708123441,1708123445,1708123445.7772532,-21600,,
com.apple.finder,8,1708121069,1708121077,1708121077.8952909,-21600,,
com.microsoft.onenote.mac,20,1708121049,1708121069,1708121069.733922,-21600,,
com.apple.dt.Xcode,5,1708121044,1708121049,1708121049.225356,-21600,,
com.apple.finder,15,1708121029,1708121044,1708121044.287785,-21600,,
com.apple.iWork.Numbers,75,1708120954,1708121029,1708121029.678763,-21600,,
com.microsoft.VSCode,1,1708120953,1708120954,1708120954.212549,-21600,,
com.apple.finder,2,1708120951,1708120953,1708120953.4131808,-21600,,
com.microsoft.VSCode,1,1708120950,1708120951,1708120951.638681,-21600,,
com.apple.iWork.Numbers,25,1708120925,1708120950,1708120950.755938,-21600,,
com.apple.finder,16,1708120909,1708120925,1708120925.6266022,-21600,,
com.apple.iWork.Numbers,36,1708120873,1708120909,1708120909.148847,-21600,,
com.apple.finder,2,1708120871,1708120873,1708120873.37996,-21600,,
com.microsoft.VSCode,5,1708120866,1708120871,1708120872.007153,-21600,,
com.apple.finder,19,1708120847,1708120866,1708120866.946805,-21600,,
com.microsoft.VSCode,2,1708120845,1708120847,1708120847.749816,-21600,,
com.apple.finder,16,1708120829,1708120845,1708120846.013883,-21600,,
com.apple.iWork.Numbers,156,1708120673,1708120829,1708120829.617979,-21600,,
com.google.Chrome,23,1708120650,1708120673,1708120673.112389,-21600,,
com.google.Chrome,388,1708120253,1708120641,1708120641.2923388,-21600,,
com.microsoft.VSCode,5,1708120248,1708120253,1708120253.3015962,-21600,,
com.google.Chrome,132,1708120116,1708120248,1708120248.3526201,-21600,,
com.microsoft.VSCode,14,1708120102,1708120116,1708120116.384613,-21600,,
com.microsoft.VSCode,634,1708119080,1708119714,1708119714.717723,-21600,,
com.apple.finder,34,1708119046,1708119080,1708119080.2099771,-21600,,
com.apple.dt.Xcode,118,1708118928,1708119046,1708119046.5472121,-21600,,
com.google.Chrome,54,1708118874,1708118928,1708118928.347564,-21600,,
com.apple.dt.Xcode,62,1708118812,1708118874,1708118874.4441772,-21600,,
com.google.Chrome,134,1708118678,1708118812,1708118812.2638721,-21600,,
com.apple.dt.Xcode,34,1708118644,1708118678,1708118678.672996,-21600,,
com.google.Chrome,60,1708118584,1708118644,1708118644.7180982,-21600,,
com.apple.dt.Xcode,38,1708118546,1708118584,1708118584.82998,-21600,,
com.google.Chrome,7,1708118539,1708118546,1708118546.766749,-21600,,
com.apple.dt.Xcode,3,1708118536,1708118539,1708118539.1795878,-21600,,
com.microsoft.onenote.mac,2,1708118534,1708118536,1708118536.151849,-21600,,
com.apple.dt.Xcode,47,1708118487,1708118534,1708118534.858924,-21600,,
com.microsoft.onenote.mac,7,1708118480,1708118487,1708118487.846247,-21600,,
com.apple.dt.Xcode,1,1708118479,1708118480,1708118480.6369638,-21600,,
com.microsoft.onenote.mac,1,1708118478,1708118479,1708118479.606728,-21600,,
com.google.Chrome,1,1708118477,1708118478,1708118478.434762,-21600,,
com.apple.dt.Xcode,14,1708118463,1708118477,1708118477.410612,-21600,,
com.google.Chrome,1,1708118462,1708118463,1708118463.3941422,-21600,,
com.microsoft.onenote.mac,5,1708118457,1708118462,1708118462.4303231,-21600,,
com.google.Chrome,1,1708118456,1708118457,1708118458.057818,-21600,,
com.apple.dt.Xcode,7,1708118449,1708118456,1708118456.7014089,-21600,,
com.google.Chrome,17,1708118432,1708118449,1708118449.267188,-21600,,
com.apple.dt.Xcode,1,1708118431,1708118432,1708118432.590023,-21600,,
com.google.Chrome,5,1708118426,1708118431,1708118431.441998,-21600,,
com.apple.dt.Xcode,55,1708118371,1708118426,1708118426.666966,-21600,,
com.microsoft.onenote.mac,2,1708118369,1708118371,1708118371.745305,-21600,,
com.apple.dt.Xcode,8,1708118361,1708118369,1708118369.321278,-21600,,
com.microsoft.onenote.mac,2,1708118359,1708118361,1708118361.182873,-21600,,
com.apple.dt.Xcode,15,1708118344,1708118359,1708118359.503556,-21600,,
com.google.Chrome,7,1708118337,1708118344,1708118344.598695,-21600,,
com.apple.dt.Xcode,83,1708118254,1708118337,1708118337.9860868,-21600,,
com.google.Chrome,4,1708118250,1708118254,1708118254.259262,-21600,,
com.apple.dt.Xcode,9,1708118241,1708118250,1708118250.735064,-21600,,
com.google.Chrome,16,1708118225,1708118241,1708118241.936173,-21600,,
com.apple.dt.Xcode,9,1708118216,1708118225,1708118225.913511,-21600,,
com.google.Chrome,3,1708118213,1708118216,1708118216.369714,-21600,,
com.apple.dt.Xcode,16,1708118197,1708118213,1708118213.735344,-21600,,
com.google.Chrome,3,1708118194,1708118197,1708118197.913321,-21600,,
com.apple.dt.Xcode,6,1708118188,1708118194,1708118194.996155,-21600,,
com.google.Chrome,15,1708118173,1708118188,1708118188.1479301,-21600,,
com.apple.dt.Xcode,5,1708118168,1708118173,1708118173.779927,-21600,,
com.google.Chrome,2,1708118166,1708118168,1708118168.3803868,-21600,,
com.apple.dt.Xcode,11,1708118155,1708118166,1708118166.145163,-21600,,
com.google.Chrome,1,1708118154,1708118155,1708118155.924705,-21600,,
com.apple.dt.Xcode,3,1708118151,1708118154,1708118154.624515,-21600,,
com.google.Chrome,2,1708118149,1708118151,1708118151.3987808,-21600,,
com.apple.dt.Xcode,12,1708118137,1708118149,1708118149.965591,-21600,,
com.google.Chrome,14,1708118123,1708118137,1708118137.397478,-21600,,
com.apple.dt.Xcode,13,1708118110,1708118123,1708118123.741644,-21600,,
com.google.Chrome,1,1708118109,1708118110,1708118110.9281058,-21600,,
com.apple.dt.Xcode,3,1708118106,1708118109,1708118109.682022,-21600,,
com.google.Chrome,1,1708118105,1708118106,1708118106.474969,-21600,,
com.apple.dt.Xcode,15,1708118090,1708118105,1708118105.713752,-21600,,
com.google.Chrome,2,1708118088,1708118090,1708118090.28896,-21600,,
com.apple.dt.Xcode,9,1708118079,1708118088,1708118088.944304,-21600,,
com.google.Chrome,2,1708118077,1708118079,1708118079.076985,-21600,,
com.apple.dt.Xcode,4,1708118073,1708118077,1708118077.218008,-21600,,
com.google.Chrome,13,1708118060,1708118073,1708118073.667423,-21600,,
com.apple.dt.Xcode,23,1708118037,1708118060,1708118060.6325688,-21600,,
com.google.Chrome,0,1708118024,1708118024,1708118024.551959,-21600,,
com.apple.dt.Xcode,1,1708118023,1708118024,1708118024.220798,-21600,,
com.microsoft.onenote.mac,2,1708118021,1708118023,1708118023.204509,-21600,,
com.google.Chrome,3,1708118018,1708118021,1708118021.858525,-21600,,
com.microsoft.onenote.mac,2,1708118005,1708118007,1708118007.134887,-21600,,
com.apple.dt.Xcode,33,1708117972,1708118005,1708118005.550477,-21600,,
com.apple.finder,18,1708117954,1708117972,1708117972.859058,-21600,,
com.apple.dt.Xcode,35,1708117919,1708117954,1708117954.69941,-21600,,
com.microsoft.onenote.mac,7,1708117912,1708117919,1708117920.014348,-21600,,
com.apple.dt.Xcode,94,1708117818,1708117912,1708117912.609442,-21600,,
com.microsoft.onenote.mac,266,1708117552,1708117818,1708117818.180464,-21600,,
com.google.Chrome,222,1708117330,1708117552,1708117552.1473389,-21600,,
com.microsoft.onenote.mac,44,1708117286,1708117330,1708117331.3841538,-21600,,
com.google.Chrome,75,1708117211,1708117286,1708117287.003203,-21600,,
com.microsoft.onenote.mac,463,1708116748,1708117211,1708117212.669382,-21600,,
com.apple.finder,105,1708116643,1708116748,1708116748.162843,-21600,,
com.microsoft.onenote.mac,198,1708116445,1708116643,1708116643.743782,-21600,,
com.google.Chrome,9,1708116436,1708116445,1708116445.541061,-21600,,
com.leomehlig.today,60,1708116376,1708116436,1708116436.891705,-21600,,
com.google.Chrome,2333,1708114043,1708116376,1708116376.090158,-21600,,
com.leomehlig.today,10,1708114033,1708114043,1708114043.724427,-21600,,
com.google.Chrome,26,1708114007,1708114033,1708114033.0954552,-21600,,
com.apple.iCal,1,1708113987,1708113988,1708113988.594352,-21600,,
com.apple.iCal,39,1708102947,1708102986,1708102986.5615559,-21600,,
com.apple.Notes,12,1708102935,1708102947,1708102948.04501,-21600,,
com.google.Chrome,68,1708102867,1708102935,1708102935.423943,-21600,,
com.microsoft.onenote.mac,145,1708102722,1708102867,1708102867.885916,-21600,,
com.google.Chrome,34,1708102688,1708102722,1708102722.900599,-21600,,
com.apple.MobileSMS,6,1708102682,1708102688,1708102688.992958,-21600,,
com.google.Chrome,6,1708102676,1708102682,1708102682.389388,-21600,,
com.apple.MobileSMS,4,1708102672,1708102676,1708102676.449512,-21600,,
com.google.Chrome,23,1708102649,1708102672,1708102672.321672,-21600,,
com.apple.MobileSMS,13,1708102636,1708102649,1708102649.30425,-21600,,
com.google.Chrome,24,1708102612,1708102636,1708102636.41398,-21600,,
com.apple.iCal,5,1708102607,1708102612,1708102612.893392,-21600,,
com.google.Chrome,72,1708102535,1708102607,1708102607.146399,-21600,,
com.apple.MobileSMS,5,1708102530,1708102535,1708102536.3685741,-21600,,
com.google.Chrome,3,1708102527,1708102530,1708102530.2908912,-21600,,
com.google.Chrome,95,1708098577,1708098672,1708098673.530503,-21600,,
us.zoom.xos,23,1708098554,1708098577,1708098577.4808478,-21600,,
com.google.Chrome,2,1708098552,1708098554,1708098554.758668,-21600,,
us.zoom.xos,6,1708098546,1708098552,1708098552.211976,-21600,,
com.google.Chrome,10,1708098536,1708098546,1708098546.4893188,-21600,,
us.zoom.xos,4,1708098532,1708098536,1708098536.759248,-21600,,
com.google.Chrome,1805,1708096727,1708098532,1708098532.230654,-21600,,
us.zoom.xos,12,1708096715,1708096727,1708096727.083014,-21600,,
com.google.Chrome,831,1708095884,1708096715,1708096715.6546168,-21600,,
us.zoom.xos,6,1708095878,1708095884,1708095884.710094,-21600,,
com.google.Chrome,1,1708095877,1708095878,1708095878.435216,-21600,,
us.zoom.xos,0,1708095877,1708095877,1708095877.68835,-21600,,
com.google.Chrome,1,1708095876,1708095877,1708095877.11309,-21600,,
us.zoom.xos,3,1708095873,1708095876,1708095876.2435389,-21600,,
com.google.Chrome,61,1708095812,1708095873,1708095873.4303331,-21600,,
us.zoom.xos,1,1708095811,1708095812,1708095812.899043,-21600,,
com.google.Chrome,2,1708095809,1708095811,1708095811.797066,-21600,,
us.zoom.xos,1,1708095808,1708095809,1708095809.6640491,-21600,,
com.google.Chrome,3,1708095805,1708095808,1708095808.296301,-21600,,
us.zoom.xos,2,1708095803,1708095805,1708095805.713135,-21600,,
com.google.Chrome,2,1708095801,1708095803,1708095803.872879,-21600,,
us.zoom.xos,3,1708095798,1708095801,1708095801.5438771,-21600,,
com.google.Chrome,2,1708095796,1708095798,1708095798.774307,-21600,,
com.apple.iCal,23,1708095773,1708095796,1708095796.970092,-21600,,
com.google.Chrome,2,1708095771,1708095773,1708095773.744402,-21600,,
com.apple.iCal,5,1708095766,1708095771,1708095771.4091082,-21600,,
com.google.Chrome,12,1708095754,1708095766,1708095766.3043342,-21600,,
com.apple.iCal,17,1708095737,1708095754,1708095754.725038,-21600,,
us.zoom.xos,40,1708095697,1708095737,1708095737.290247,-21600,,
com.apple.iCal,15,1708095682,1708095697,1708095697.7955232,-21600,,
com.google.Chrome,1,1708095681,1708095682,1708095682.4946299,-21600,,
com.apple.iCal,9,1708095672,1708095681,1708095681.120739,-21600,,
com.google.Chrome,11,1708095661,1708095672,1708095672.653204,-21600,,
us.zoom.xos,12,1708095649,1708095661,1708095661.4874969,-21600,,
com.google.Chrome,20,1708095629,1708095649,1708095649.317653,-21600,,
us.zoom.xos,9,1708095620,1708095629,1708095629.691032,-21600,,
com.google.Chrome,3,1708095617,1708095620,1708095620.27106,-21600,,
us.zoom.xos,6,1708095611,1708095617,1708095617.5791922,-21600,,
com.google.Chrome,0,1708095611,1708095611,1708095611.810657,-21600,,
us.zoom.xos,3,1708095608,1708095611,1708095611.433545,-21600,,
com.google.Chrome,9,1708095599,1708095608,1708095608.6437259,-21600,,
us.zoom.xos,28,1708095571,1708095599,1708095599.845973,-21600,,
com.google.Chrome,50,1708095521,1708095571,1708095571.14328,-21600,,
us.zoom.xos,25,1708095496,1708095521,1708095521.604845,-21600,,
com.google.Chrome,360,1708095136,1708095496,1708095496.998785,-21600,,
com.leomehlig.today,6,1708095130,1708095136,1708095138.389385,-21600,,
com.leomehlig.today,83,1708057697,1708057780,1708057780.449572,-21600,,
com.google.Chrome,202,1708057495,1708057697,1708057697.883648,-21600,,
com.apple.iCal,89,1708057383,1708057472,1708057473.2057729,-21600,,
com.google.Chrome,2,1708057381,1708057383,1708057383.07015,-21600,,
com.google.Chrome,199,1708052550,1708052749,1708052749.705764,-21600,,
com.apple.iCal,148,1708052384,1708052532,1708052532.9459891,-21600,,
com.apple.finder,2,1708052382,1708052384,1708052384.8199658,-21600,,
com.apple.finder,3,1708052289,1708052292,1708052292.614376,-21600,,
com.leomehlig.today,4,1708052285,1708052289,1708052289.474372,-21600,,
com.apple.finder,1,1708052284,1708052285,1708052285.336087,-21600,,
com.leomehlig.today,6,1708052278,1708052284,1708052284.732249,-21600,,
com.google.Chrome,0,1708052278,1708052278,1708052281.90256,-21600,,
com.leomehlig.today,176,1708052102,1708052278,1708052278.392089,-21600,,
com.google.Chrome,17,1708052085,1708052102,1708052102.166594,-21600,,
com.apple.finder,6,1708052079,1708052085,1708052085.100354,-21600,,
com.microsoft.VSCode,12,1708052067,1708052079,1708052079.627312,-21600,,
com.apple.finder,31,1708052036,1708052067,1708052067.883356,-21600,,
com.google.Chrome,11,1708052025,1708052036,1708052036.334176,-21600,,
com.microsoft.VSCode,2,1708052023,1708052025,1708052025.6120338,-21600,,
com.google.Chrome,8,1708052015,1708052023,1708052023.6702728,-21600,,
com.microsoft.VSCode,57,1708051958,1708052015,1708052015.610548,-21600,,
com.google.Chrome,37,1708051921,1708051958,1708051959.033838,-21600,,
com.microsoft.VSCode,6,1708051915,1708051921,1708051921.720648,-21600,,
com.google.Chrome,19,1708051896,1708051915,1708051915.092286,-21600,,
com.microsoft.VSCode,21,1708051875,1708051896,1708051896.2218208,-21600,,
com.google.Chrome,47,1708051828,1708051875,1708051875.690661,-21600,,
com.microsoft.VSCode,758,1708051070,1708051828,1708051828.222631,-21600,,
com.apple.Dictionary,1,1708051069,1708051070,1708051070.748324,-21600,,
com.microsoft.VSCode,961,1708050108,1708051069,1708051069.7693849,-21600,,
com.leomehlig.today,16,1708050092,1708050108,1708050108.216632,-21600,,
com.leomehlig.today,17,1708049289,1708049306,1708049306.66172,-21600,,
com.microsoft.VSCode,41,1708049248,1708049289,1708049289.718812,-21600,,
com.leomehlig.today,12,1708049236,1708049248,1708049248.39613,-21600,,
com.microsoft.VSCode,26,1708049210,1708049236,1708049236.1831698,-21600,,
com.leomehlig.today,33,1708049177,1708049210,1708049210.628859,-21600,,
com.microsoft.VSCode,2,1708049175,1708049177,1708049178.0825238,-21600,,
com.leomehlig.today,64,1708049111,1708049175,1708049175.577023,-21600,,
com.google.Chrome,10,1708049101,1708049111,1708049111.381353,-21600,,
com.leomehlig.today,17,1708049084,1708049101,1708049101.469028,-21600,,
com.google.Chrome,52,1708049032,1708049084,1708049084.841011,-21600,,
com.leomehlig.today,28,1708049004,1708049032,1708049032.4765291,-21600,,
com.google.Chrome,14,1708048990,1708049004,1708049004.877672,-21600,,
com.leomehlig.today,46,1708048944,1708048990,1708048990.611964,-21600,,
com.apple.Preview,1881,1708047063,1708048944,1708048944.4564729,-21600,,
com.apple.finder,2,1708047061,1708047063,1708047063.12309,-21600,,
com.google.Chrome,11,1708047050,1708047061,1708047061.6432319,-21600,,
com.leomehlig.today,40,1708047010,1708047050,1708047050.738665,-21600,,
com.google.Chrome,760,1708046250,1708047010,1708047010.758292,-21600,,
com.google.Chrome,332,1708045675,1708046007,1708046007.6686049,-21600,,
com.leomehlig.today,94,1708045581,1708045675,1708045675.478181,-21600,,
com.google.Chrome,69,1708045512,1708045581,1708045581.9639769,-21600,,
com.leomehlig.today,20,1708045492,1708045512,1708045512.647389,-21600,,
com.apple.iCal,14,1708045478,1708045492,1708045492.493015,-21600,,
com.leomehlig.today,7,1708045471,1708045478,1708045478.890215,-21600,,
com.google.Chrome,1,1708045470,1708045471,1708045474.34537,-21600,,
com.apple.finder,2,1708045468,1708045470,1708045470.535596,-21600,,
com.apple.finder,3,1708024985,1708024988,1708024988.212428,-21600,,
com.google.Chrome,57,1708024928,1708024985,1708024985.9483109,-21600,,
com.apple.MobileSMS,7,1708024921,1708024928,1708024928.238519,-21600,,
com.google.Chrome,31,1708024890,1708024921,1708024921.537458,-21600,,
com.apple.MobileSMS,24,1708024866,1708024890,1708024890.670799,-21600,,
com.google.Chrome,2,1708024864,1708024866,1708024866.082485,-21600,,
com.apple.MobileSMS,6,1708024858,1708024864,1708024864.158365,-21600,,
com.google.Chrome,8,1708024850,1708024858,1708024858.8319988,-21600,,
com.apple.MobileSMS,3,1708024847,1708024850,1708024850.0733109,-21600,,
com.google.Chrome,65,1708024782,1708024847,1708024847.229465,-21600,,
com.apple.MobileSMS,129,1708024653,1708024782,1708024782.1963902,-21600,,
com.google.Chrome,158,1708024495,1708024653,1708024654.067594,-21600,,
com.leomehlig.today,6,1708024489,1708024495,1708024495.787741,-21600,,
com.apple.reminders,22,1708024467,1708024489,1708024490.0969949,-21600,,
com.google.Chrome,141,1708024326,1708024467,1708024467.056762,-21600,,
com.google.Chrome,318,1708023614,1708023932,1708023932.6861548,-21600,,
com.leomehlig.today,21,1708023593,1708023614,1708023614.827639,-21600,,
com.google.Chrome,1,1708023592,1708023593,1708023593.749115,-21600,,
com.leomehlig.today,5,1708023587,1708023592,1708023592.075642,-21600,,
com.google.Chrome,17,1708023570,1708023587,1708023587.371077,-21600,,
com.google.Chrome,386,1708023136,1708023522,1708023522.161943,-21600,,
com.google.Chrome,346,1708022789,1708023135,1708023135.104202,-21600,,
com.leomehlig.today,4,1708022785,1708022789,1708022789.873694,-21600,,
com.google.Chrome,23,1708022762,1708022785,1708022785.9198232,-21600,,
com.leomehlig.today,2,1708022760,1708022762,1708022762.8594952,-21600,,
com.google.Chrome,52,1708022708,1708022760,1708022760.636529,-21600,,
com.google.Chrome,300,1708022272,1708022572,1708022572.081722,-21600,,
com.google.Chrome,380,1708021744,1708022124,1708022124.864232,-21600,,
com.google.Chrome,522,1708021143,1708021665,1708021665.699548,-21600,,
com.google.Chrome,340,1708020775,1708021115,1708021115.226517,-21600,,
com.leomehlig.today,3,1708020772,1708020775,1708020776.2950811,-21600,,
com.leomehlig.today,43,1708020341,1708020384,1708020385.148972,-21600,,
com.apple.finder,2,1708020339,1708020341,1708020344.570952,-21600,,
com.apple.finder,11,1708017767,1708017778,1708017778.7471929,-21600,,
com.google.Chrome,23,1708017744,1708017767,1708017767.217716,-21600,,
com.apple.finder,16,1708017728,1708017744,1708017744.577901,-21600,,
com.apple.Preview,1,1708017727,1708017728,1708017729.025641,-21600,,
com.google.Chrome,11,1708017716,1708017727,1708017727.538896,-21600,,
com.apple.Preview,8,1708017708,1708017716,1708017716.96859,-21600,,
com.apple.finder,7,1708017701,1708017708,1708017708.652547,-21600,,
com.google.Chrome,14,1708017687,1708017701,1708017701.462295,-21600,,
com.apple.Preview,159,1708017528,1708017687,1708017687.810158,-21600,,
com.google.Chrome,4,1708017524,1708017528,1708017528.34992,-21600,,
com.apple.Preview,197,1708017327,1708017524,1708017524.567102,-21600,,
com.google.Chrome,4,1708017323,1708017327,1708017327.322725,-21600,,
com.apple.Preview,10,1708017313,1708017323,1708017324.0261412,-21600,,
com.google.Chrome,3,1708017310,1708017313,1708017313.8975391,-21600,,
com.apple.Preview,6,1708017304,1708017310,1708017310.394318,-21600,,
com.google.Chrome,3,1708017301,1708017304,1708017304.67174,-21600,,
com.apple.Preview,5,1708017296,1708017301,1708017301.749737,-21600,,
com.google.Chrome,34,1708017262,1708017296,1708017296.550383,-21600,,
com.apple.Preview,14,1708017248,1708017262,1708017262.653563,-21600,,
com.google.Chrome,6,1708017242,1708017248,1708017248.658235,-21600,,
com.apple.Preview,34,1708017208,1708017242,1708017242.993336,-21600,,
com.google.Chrome,186,1708017022,1708017208,1708017208.600802,-21600,,
com.apple.Preview,85,1708016937,1708017022,1708017022.704268,-21600,,
com.google.Chrome,31,1708016906,1708016937,1708016937.670821,-21600,,
com.apple.Preview,3,1708016903,1708016906,1708016906.159071,-21600,,
com.google.Chrome,5,1708016898,1708016903,1708016903.10204,-21600,,
com.apple.Preview,333,1708016565,1708016898,1708016898.219151,-21600,,
com.google.Chrome,7,1708016558,1708016565,1708016565.453836,-21600,,
com.apple.Preview,7,1708016551,1708016558,1708016558.7955232,-21600,,
com.google.Chrome,3,1708016548,1708016551,1708016551.851053,-21600,,
com.apple.Preview,214,1708016334,1708016548,1708016549.030402,-21600,,
com.google.Chrome,5,1708016329,1708016334,1708016334.15536,-21600,,
com.apple.Preview,10,1708016319,1708016329,1708016329.464932,-21600,,
com.google.Chrome,58,1708016261,1708016319,1708016319.267077,-21600,,
com.apple.Preview,101,1708016160,1708016261,1708016261.815638,-21600,,
com.google.Chrome,2,1708016158,1708016160,1708016160.6596441,-21600,,
com.apple.Preview,4,1708016154,1708016158,1708016159.0303822,-21600,,
com.google.Chrome,6,1708016148,1708016154,1708016154.134974,-21600,,
com.apple.Preview,148,1708016000,1708016148,1708016148.1986651,-21600,,
com.google.Chrome,5,1708015995,1708016000,1708016000.796866,-21600,,
com.apple.Preview,135,1708015860,1708015995,1708015995.187387,-21600,,
com.google.Chrome,2,1708015858,1708015860,1708015860.462745,-21600,,
com.apple.Preview,115,1708015743,1708015858,1708015858.138321,-21600,,
com.google.Chrome,1,1708015742,1708015743,1708015743.650083,-21600,,
com.apple.Preview,156,1708015586,1708015742,1708015742.429029,-21600,,
com.google.Chrome,8,1708015578,1708015586,1708015586.7838159,-21600,,
com.apple.Preview,127,1708015451,1708015578,1708015578.470879,-21600,,
com.google.Chrome,3,1708015448,1708015451,1708015451.268014,-21600,,
com.apple.Preview,22,1708015426,1708015448,1708015448.806285,-21600,,
com.google.Chrome,28,1708015398,1708015426,1708015426.165913,-21600,,
com.apple.Preview,95,1708015303,1708015398,1708015398.3191,-21600,,
com.google.Chrome,9,1708015294,1708015303,1708015303.621306,-21600,,
com.apple.Preview,7,1708015287,1708015294,1708015294.155144,-21600,,
com.google.Chrome,20,1708015267,1708015287,1708015287.088235,-21600,,
com.apple.Preview,141,1708015126,1708015267,1708015267.983496,-21600,,
com.google.Chrome,1,1708015125,1708015126,1708015126.395084,-21600,,
com.apple.Preview,1,1708015124,1708015125,1708015125.775166,-21600,,
com.google.Chrome,4,1708015120,1708015124,1708015124.0929809,-21600,,
com.apple.Preview,8,1708015112,1708015120,1708015120.07037,-21600,,
com.google.Chrome,6,1708015106,1708015112,1708015112.2654061,-21600,,
com.apple.Preview,3,1708015103,1708015106,1708015106.754869,-21600,,
com.google.Chrome,12,1708015091,1708015103,1708015103.444065,-21600,,
com.apple.Preview,117,1708014974,1708015091,1708015091.867293,-21600,,
com.google.Chrome,7,1708014967,1708014974,1708014974.818142,-21600,,
com.apple.Preview,13,1708014954,1708014967,1708014967.1551971,-21600,,
com.google.Chrome,48,1708014906,1708014954,1708014954.593305,-21600,,
com.apple.Preview,132,1708014774,1708014906,1708014906.707049,-21600,,
com.google.Chrome,16,1708014758,1708014774,1708014774.3844461,-21600,,
com.apple.Preview,407,1708014351,1708014758,1708014758.358393,-21600,,
com.google.Chrome,9,1708014342,1708014351,1708014351.864369,-21600,,
com.apple.Preview,57,1708014285,1708014342,1708014342.9404302,-21600,,
com.apple.Preview,705,1708013578,1708014283,1708014283.6326752,-21600,,
com.google.Chrome,156,1708013422,1708013578,1708013578.2589622,-21600,,
com.apple.Preview,366,1708013056,1708013422,1708013422.4045758,-21600,,
com.google.Chrome,251,1708012805,1708013056,1708013056.895683,-21600,,
com.apple.Preview,11,1708012794,1708012805,1708012805.805767,-21600,,
com.apple.finder,2,1708012792,1708012794,1708012794.7682738,-21600,,
com.google.Chrome,2,1708012790,1708012792,1708012792.772338,-21600,,
com.apple.finder,6,1708012784,1708012790,1708012790.0598922,-21600,,
com.google.Chrome,2,1708012782,1708012784,1708012784.9506068,-21600,,
com.apple.Preview,4,1708012778,1708012782,1708012782.3534632,-21600,,
com.apple.finder,4,1708012774,1708012778,1708012778.576168,-21600,,
com.google.Chrome,50,1708012724,1708012774,1708012774.4498491,-21600,,
com.apple.finder,15,1708012709,1708012724,1708012724.466607,-21600,,
com.google.Chrome,59,1708012650,1708012709,1708012709.2713962,-21600,,
com.apple.finder,7,1708012643,1708012650,1708012650.816279,-21600,,
com.apple.finder,5,1707964732,1707964737,1707964737.611887,-21600,,
com.hnc.Discord,1,1707964731,1707964732,1707964732.098711,-21600,,
com.google.Chrome,73,1707964658,1707964731,1707964731.198543,-21600,,
com.leomehlig.today,89,1707964569,1707964658,1707964658.825304,-21600,,
com.leomehlig.today,394,1707963620,1707964014,1707964014.4030461,-21600,,
com.apple.iCal,15,1707963605,1707963620,1707963620.4080071,-21600,,
com.leomehlig.today,10,1707963595,1707963605,1707963605.487284,-21600,,
com.apple.iCal,36,1707963559,1707963595,1707963595.306788,-21600,,
com.leomehlig.today,2,1707963554,1707963556,1707963556.356885,-21600,,
com.apple.iCal,38,1707963516,1707963554,1707963554.55021,-21600,,
com.leomehlig.today,68,1707963448,1707963516,1707963517.0268931,-21600,,
com.google.Chrome,19,1707963429,1707963448,1707963448.916357,-21600,,
com.hnc.Discord,59,1707963370,1707963429,1707963429.999366,-21600,,
com.google.Chrome,159,1707963211,1707963370,1707963370.507951,-21600,,
com.hnc.Discord,61,1707963150,1707963211,1707963211.278006,-21600,,
com.google.Chrome,7,1707963143,1707963150,1707963150.6551208,-21600,,
com.hnc.Discord,272,1707962871,1707963143,1707963143.2154222,-21600,,
com.google.Chrome,2,1707962869,1707962871,1707962871.2565951,-21600,,
com.google.Chrome,300,1707962546,1707962846,1707962846.0936809,-21600,,
com.hnc.Discord,27,1707962519,1707962546,1707962546.115174,-21600,,
com.google.Chrome,28,1707962491,1707962519,1707962519.417292,-21600,,
com.hnc.Discord,80,1707962411,1707962491,1707962491.857985,-21600,,
com.google.Chrome,10,1707962401,1707962411,1707962411.381958,-21600,,
com.hnc.Discord,7,1707962394,1707962401,1707962401.429358,-21600,,
com.google.Chrome,109,1707962285,1707962394,1707962394.040993,-21600,,
com.leomehlig.today,177,1707962108,1707962285,1707962285.416584,-21600,,
com.google.Chrome,1008,1707961100,1707962108,1707962108.416216,-21600,,
com.leomehlig.today,26,1707961074,1707961100,1707961100.7512112,-21600,,
com.google.Chrome,11,1707961063,1707961074,1707961074.367702,-21600,,
com.google.Chrome,1966,1707958698,1707960664,1707960664.3361192,-21600,,
com.leomehlig.today,9,1707958689,1707958698,1707958698.377689,-21600,,
com.google.Chrome,39,1707958650,1707958689,1707958689.073741,-21600,,
com.google.Chrome,563,1707957030,1707957593,1707957593.5141249,-21600,,
com.apple.finder,2,1707957028,1707957030,1707957030.43958,-21600,,
com.microsoft.VSCode,3,1707957025,1707957028,1707957028.905628,-21600,,
com.apple.finder,4,1707957021,1707957025,1707957025.2396789,-21600,,
com.apple.Preview,2,1707957019,1707957021,1707957021.8023338,-21600,,
com.apple.finder,2,1707957017,1707957019,1707957019.334597,-21600,,
com.apple.Notes,2,1707957015,1707957017,1707957017.129519,-21600,,
com.leomehlig.today,54,1707956961,1707957015,1707957015.5040889,-21600,,
com.apple.iCal,12,1707956949,1707956961,1707956961.1975908,-21600,,
com.leomehlig.today,23,1707956926,1707956949,1707956949.697237,-21600,,
com.google.Chrome,5,1707956921,1707956926,1707956926.859888,-21600,,
com.google.Chrome,116,1707950354,1707950470,1707950470.059279,-21600,,
com.google.Chrome,194,1707936536,1707936730,1707936730.617001,-21600,,
com.apple.Notes,27,1707936509,1707936536,1707936536.192072,-21600,,
com.google.Chrome,382,1707936127,1707936509,1707936509.409216,-21600,,
com.microsoft.VSCode,172,1707935955,1707936127,1707936127.641402,-21600,,
com.leomehlig.today,39,1707935916,1707935955,1707935955.211715,-21600,,
com.apple.finder,2,1707935914,1707935916,1707935916.679724,-21600,,
com.apple.Preview,434,1707935480,1707935914,1707935914.901542,-21600,,
com.apple.finder,1,1707935479,1707935480,1707935480.731018,-21600,,
com.microsoft.VSCode,8,1707935471,1707935479,1707935479.115447,-21600,,
com.microsoft.VSCode,566,1707928327,1707928893,1707928893.8046489,-21600,,
com.google.Chrome,475,1707927852,1707928327,1707928327.387785,-21600,,
com.microsoft.VSCode,346,1707927506,1707927852,1707927852.454623,-21600,,
com.google.Chrome,219,1707927287,1707927506,1707927506.710688,-21600,,
com.microsoft.VSCode,1080,1707926207,1707927287,1707927287.235787,-21600,,
com.google.Chrome,19,1707926188,1707926207,1707926208.039206,-21600,,
com.microsoft.VSCode,43,1707926145,1707926188,1707926188.659142,-21600,,
com.google.Chrome,51,1707926094,1707926145,1707926145.335383,-21600,,
com.microsoft.VSCode,356,1707925738,1707926094,1707926094.8376598,-21600,,
com.microsoft.VSCode,873,1707924762,1707925635,1707925635.580852,-21600,,
com.google.Chrome,3,1707924759,1707924762,1707924762.083576,-21600,,
com.microsoft.VSCode,22,1707924737,1707924759,1707924759.83316,-21600,,
com.google.Chrome,22,1707924715,1707924737,1707924738.039136,-21600,,
com.apple.finder,1,1707924714,1707924715,1707924721.086454,-21600,,
com.apple.finder,24,1707883349,1707883373,1707883373.046238,-21600,,
com.apple.MobileSMS,76,1707883273,1707883349,1707883349.4326448,-21600,,
com.apple.finder,1,1707883272,1707883273,1707883273.345399,-21600,,
com.microsoft.onenote.mac,4,1707883268,1707883272,1707883272.121947,-21600,,
com.leomehlig.today,42,1707883226,1707883268,1707883268.704221,-21600,,
com.microsoft.onenote.mac,565,1707882661,1707883226,1707883226.965383,-21600,,
com.leomehlig.today,45,1707882616,1707882661,1707882661.412421,-21600,,
com.google.Chrome,5,1707882611,1707882616,1707882616.3690748,-21600,,
com.google.Chrome,312,1707881609,1707881921,1707881921.093494,-21600,,
com.google.Chrome,408,1707881097,1707881505,1707881505.056552,-21600,,
com.google.Chrome,496,1707880579,1707881075,1707881075.30807,-21600,,
com.leomehlig.today,2,1707880577,1707880579,1707880579.0728269,-21600,,
com.apple.Preview,1,1707880576,1707880577,1707880577.60267,-21600,,
com.leomehlig.today,0,1707880576,1707880576,1707880577.234504,-21600,,
com.google.Chrome,84,1707880492,1707880576,1707880576.605328,-21600,,
com.leomehlig.today,139,1707880353,1707880492,1707880492.4324079,-21600,,
com.google.Chrome,185,1707880168,1707880353,1707880353.905653,-21600,,
com.leomehlig.today,25,1707880143,1707880168,1707880168.357661,-21600,,
com.google.Chrome,791,1707879352,1707880143,1707880143.6112862,-21600,,
com.apple.Preview,217,1707879135,1707879352,1707879352.4768438,-21600,,
com.google.Chrome,33,1707879102,1707879135,1707879135.111202,-21600,,
com.apple.finder,3,1707879099,1707879102,1707879102.8938742,-21600,,
com.apple.Preview,2,1707879097,1707879099,1707879099.731427,-21600,,
com.apple.finder,1,1707879096,1707879097,1707879097.5933409,-21600,,
com.google.Chrome,8,1707879088,1707879096,1707879096.3190598,-21600,,
com.leomehlig.today,29,1707879059,1707879088,1707879088.9605231,-21600,,
com.apple.finder,1,1707879058,1707879059,1707879060.052522,-21600,,
com.apple.Preview,3,1707879055,1707879058,1707879058.722019,-21600,,
com.google.Chrome,2,1707879053,1707879055,1707879055.550754,-21600,,
com.microsoft.VSCode,3,1707879050,1707879053,1707879054.0027518,-21600,,
com.google.Chrome,8,1707879042,1707879050,1707879050.868301,-21600,,
com.google.Chrome,113,1707875951,1707876064,1707876064.7816482,-21600,,
com.apple.MobileSMS,1,1707875950,1707875951,1707875951.844499,-21600,,
com.google.Chrome,295,1707875655,1707875950,1707875950.206301,-21600,,
com.apple.MobileSMS,39,1707875616,1707875655,1707875656.0283542,-21600,,
com.google.Chrome,3,1707875613,1707875616,1707875616.065443,-21600,,
com.apple.MobileSMS,7,1707875606,1707875613,1707875613.093624,-21600,,
com.google.Chrome,13,1707875593,1707875606,1707875606.119512,-21600,,
com.apple.systempreferences,3,1707875589,1707875592,1707875592.618983,-21600,,
com.google.Chrome,65,1707875522,1707875587,1707875587.677297,-21600,,
com.apple.iWork.Numbers,389,1707875133,1707875522,1707875522.8037992,-21600,,
com.google.Chrome,701,1707874432,1707875133,1707875133.127526,-21600,,
com.microsoft.Excel,41,1707874391,1707874432,1707874432.579355,-21600,,
com.google.Chrome,639,1707873752,1707874391,1707874391.800514,-21600,,
com.apple.MobileSMS,3,1707873749,1707873752,1707873752.5399761,-21600,,
com.microsoft.VSCode,1,1707873748,1707873749,1707873749.918889,-21600,,
com.microsoft.VSCode,65,1707873038,1707873103,1707873103.961256,-21600,,
com.microsoft.VSCode,4,1707871118,1707871122,1707871122.273412,-21600,,
com.leomehlig.today,91,1707871027,1707871118,1707871119.0598202,-21600,,
com.microsoft.VSCode,476,1707870551,1707871027,1707871027.207614,-21600,,
com.google.Chrome,7,1707870544,1707870551,1707870551.421732,-21600,,
com.microsoft.VSCode,176,1707870368,1707870544,1707870544.368167,-21600,,
com.google.Chrome,8,1707870360,1707870368,1707870368.680025,-21600,,
com.microsoft.VSCode,128,1707870232,1707870360,1707870360.1061149,-21600,,
com.google.Chrome,6,1707870226,1707870232,1707870232.692573,-21600,,
com.microsoft.VSCode,53,1707870173,1707870226,1707870226.731132,-21600,,
com.apple.Dictionary,1,1707870172,1707870173,1707870173.697253,-21600,,
com.microsoft.VSCode,293,1707869879,1707870172,1707870172.1416101,-21600,,
com.google.Chrome,3,1707869876,1707869879,1707869879.533989,-21600,,
com.microsoft.VSCode,89,1707869787,1707869876,1707869876.6088,-21600,,
com.google.Chrome,2,1707869785,1707869787,1707869787.525379,-21600,,
com.microsoft.VSCode,2,1707869783,1707869785,1707869785.34465,-21600,,
com.google.Chrome,2,1707869781,1707869783,1707869783.2808862,-21600,,
com.microsoft.VSCode,40,1707869741,1707869781,1707869781.140265,-21600,,
com.google.Chrome,5,1707869736,1707869741,1707869741.399466,-21600,,
com.microsoft.VSCode,80,1707869656,1707869736,1707869736.8944678,-21600,,
com.google.Chrome,94,1707869562,1707869656,1707869656.327067,-21600,,
com.microsoft.VSCode,1,1707869561,1707869562,1707869562.480451,-21600,,
com.google.Chrome,39,1707869522,1707869561,1707869561.528837,-21600,,
com.microsoft.VSCode,140,1707869382,1707869522,1707869523.0349069,-21600,,
com.leomehlig.today,15,1707869367,1707869382,1707869382.6007771,-21600,,
com.microsoft.VSCode,5,1707869362,1707869367,1707869368.041522,-21600,,
com.google.Chrome,10,1707869352,1707869362,1707869362.79214,-21600,,
com.apple.MobileSMS,47,1707869305,1707869352,1707869352.9660568,-21600,,
com.google.Chrome,88,1707869217,1707869305,1707869305.885061,-21600,,
com.apple.MobileSMS,2,1707869215,1707869217,1707869217.382788,-21600,,
com.google.Chrome,1,1707869214,1707869215,1707869215.711189,-21600,,
com.apple.MobileSMS,6,1707869208,1707869214,1707869214.7707949,-21600,,
com.leomehlig.today,2,1707869206,1707869208,1707869212.1432328,-21600,,
com.leomehlig.today,20,1707862110,1707862130,1707862131.1839461,-21600,,
com.microsoft.VSCode,2,1707862108,1707862110,1707862111.015908,-21600,,
com.microsoft.VSCode,218,1707861889,1707862107,1707862108.088948,-21600,,
com.google.Chrome,6,1707861883,1707861889,1707861889.381582,-21600,,
com.microsoft.VSCode,44,1707861839,1707861883,1707861883.6258512,-21600,,
com.google.Chrome,8,1707861831,1707861839,1707861839.507921,-21600,,
com.microsoft.VSCode,14,1707861817,1707861831,1707861831.7033172,-21600,,
com.google.Chrome,2,1707861815,1707861817,1707861817.482192,-21600,,
com.microsoft.VSCode,8,1707861807,1707861815,1707861815.888628,-21600,,
com.google.Chrome,5,1707861802,1707861807,1707861807.174509,-21600,,
com.microsoft.VSCode,31,1707861771,1707861802,1707861802.065044,-21600,,
com.google.Chrome,62,1707861709,1707861771,1707861771.55531,-21600,,
com.microsoft.VSCode,147,1707861562,1707861709,1707861709.940125,-21600,,
com.google.Chrome,1,1707861561,1707861562,1707861562.754766,-21600,,
com.microsoft.VSCode,39,1707861522,1707861561,1707861561.608896,-21600,,
com.google.Chrome,6,1707861516,1707861522,1707861522.981456,-21600,,
com.microsoft.VSCode,205,1707861311,1707861516,1707861516.605926,-21600,,
com.leomehlig.today,92,1707861219,1707861311,1707861311.744648,-21600,,
com.microsoft.VSCode,583,1707860636,1707861219,1707861219.264152,-21600,,
com.apple.Dictionary,2,1707860634,1707860636,1707860636.3051438,-21600,,
com.microsoft.VSCode,2,1707860632,1707860634,1707860635.010864,-21600,,
com.apple.Dictionary,1,1707860631,1707860632,1707860632.9710112,-21600,,
com.microsoft.VSCode,164,1707860467,1707860631,1707860631.1195889,-21600,,
com.google.Chrome,4,1707860463,1707860467,1707860467.321261,-21600,,
com.microsoft.VSCode,36,1707860427,1707860463,1707860463.64299,-21600,,
com.google.Chrome,31,1707860396,1707860427,1707860427.907831,-21600,,
com.microsoft.VSCode,7,1707860389,1707860396,1707860396.7553601,-21600,,
com.google.Chrome,6,1707860383,1707860389,1707860389.315691,-21600,,
com.microsoft.VSCode,1035,1707859348,1707860383,1707860383.5457702,-21600,,
us.zoom.xos,1,1707859347,1707859348,1707859348.196768,-21600,,
com.microsoft.VSCode,3,1707859344,1707859347,1707859347.1755052,-21600,,
com.google.Chrome,1,1707859343,1707859344,1707859344.450165,-21600,,
us.zoom.xos,12,1707859331,1707859343,1707859343.7925038,-21600,,
us.zoom.xos,668,1707857861,1707858529,1707858529.352262,-21600,,
us.zoom.xos,310,1707857458,1707857768,1707857768.219372,-21600,,
us.zoom.xos,703,1707856708,1707857411,1707857411.2092361,-21600,,
us.zoom.xos,393,1707856220,1707856613,1707856613.092236,-21600,,
com.google.Chrome,42,1707856178,1707856220,1707856220.2684932,-21600,,
us.zoom.xos,2,1707856176,1707856178,1707856178.734048,-21600,,
us.zoom.xos,311,1707855797,1707856108,1707856108.8612108,-21600,,
us.zoom.xos,453,1707854995,1707855448,1707855448.523763,-21600,,
com.apple.iCal,64,1707854931,1707854995,1707854995.970459,-21600,,
com.leomehlig.today,8,1707854923,1707854931,1707854931.3812299,-21600,,
com.apple.iCal,197,1707854726,1707854923,1707854923.956572,-21600,,
com.google.Chrome,7,1707854719,1707854726,1707854726.5456629,-21600,,
com.apple.MobileSMS,16,1707854703,1707854719,1707854719.608129,-21600,,
com.google.Chrome,18,1707854685,1707854703,1707854703.3106809,-21600,,
com.apple.MobileSMS,1,1707854684,1707854685,1707854685.8306332,-21600,,
com.google.Chrome,5,1707854679,1707854684,1707854684.814013,-21600,,
com.apple.MobileSMS,22,1707854657,1707854679,1707854679.687434,-21600,,
com.google.Chrome,162,1707854495,1707854657,1707854657.132407,-21600,,
us.zoom.xos,62,1707854433,1707854495,1707854495.7510982,-21600,,
com.microsoft.VSCode,1,1707854432,1707854433,1707854433.0620399,-21600,,
us.zoom.xos,3,1707854429,1707854432,1707854432.606287,-21600,,
com.microsoft.VSCode,47,1707854382,1707854429,1707854429.979497,-21600,,
us.zoom.xos,63,1707854282,1707854345,1707854345.323432,-21600,,
com.google.Chrome,0,1707854282,1707854282,1707854282.489118,-21600,,
us.zoom.xos,2,1707854280,1707854282,1707854282.224767,-21600,,
com.google.Chrome,814,1707853466,1707854280,1707854280.0687041,-21600,,
com.leomehlig.today,55,1707853411,1707853466,1707853466.6729321,-21600,,
com.google.Chrome,5,1707853406,1707853411,1707853411.50004,-21600,,
com.microsoft.VSCode,2246,1707851160,1707853406,1707853406.635326,-21600,,
com.google.Chrome,0,1707851160,1707851160,1707851160.836893,-21600,,
com.microsoft.VSCode,135,1707851025,1707851160,1707851160.1357641,-21600,,
com.google.Chrome,32,1707850993,1707851025,1707851025.1634989,-21600,,
us.zoom.xos,8,1707850985,1707850993,1707850994.011808,-21600,,
com.google.Chrome,31,1707850954,1707850985,1707850985.3569012,-21600,,
com.apple.finder,2,1707850952,1707850954,1707850954.996242,-21600,,
com.apple.Preview,9,1707850943,1707850952,1707850952.285397,-21600,,
com.apple.finder,8,1707850935,1707850943,1707850943.562577,-21600,,
com.apple.archiveutility,0,1707850935,1707850935,1707850935.7354488,-21600,,
com.apple.finder,10,1707850925,1707850935,1707850935.3515239,-21600,,
com.google.Chrome,19,1707850906,1707850925,1707850925.1451511,-21600,,
com.leomehlig.today,10,1707850896,1707850906,1707850906.896533,-21600,,
com.microsoft.VSCode,9,1707850887,1707850896,1707850896.716398,-21600,,
com.google.Chrome,45,1707850842,1707850887,1707850887.109107,-21600,,
com.microsoft.VSCode,50,1707850792,1707850842,1707850842.365224,-21600,,
com.google.Chrome,7,1707850785,1707850792,1707850792.700914,-21600,,
com.microsoft.VSCode,5,1707850780,1707850785,1707850785.124691,-21600,,
com.google.Chrome,7,1707850773,1707850780,1707850780.458459,-21600,,
com.microsoft.VSCode,4,1707850769,1707850773,1707850774.0789309,-21600,,
us.zoom.xos,46,1707850723,1707850769,1707850769.0653892,-21600,,
com.microsoft.VSCode,5,1707850718,1707850723,1707850723.386466,-21600,,
us.zoom.xos,4,1707850714,1707850718,1707850718.667865,-21600,,
com.microsoft.VSCode,2,1707850712,1707850714,1707850714.40539,-21600,,
us.zoom.xos,21,1707850691,1707850712,1707850712.990514,-21600,,
com.microsoft.VSCode,38,1707850653,1707850691,1707850691.3693938,-21600,,
com.apple.Preview,1,1707850652,1707850653,1707850653.260867,-21600,,
com.leomehlig.today,12,1707850640,1707850652,1707850653.019727,-21600,,
com.leomehlig.today,57,1707846316,1707846373,1707846373.376481,-21600,,
com.apple.Preview,1,1707846315,1707846316,1707846316.712095,-21600,,
com.google.Chrome,12,1707846303,1707846315,1707846315.824888,-21600,,
com.apple.Preview,21,1707846282,1707846303,1707846303.8684359,-21600,,
com.google.Chrome,14,1707846268,1707846282,1707846282.977098,-21600,,
com.apple.Preview,628,1707845640,1707846268,1707846268.877068,-21600,,
com.google.Chrome,20,1707845620,1707845640,1707845640.099673,-21600,,
com.apple.Preview,77,1707845543,1707845620,1707845620.1799932,-21600,,
com.google.Chrome,562,1707844981,1707845543,1707845543.550291,-21600,,
com.apple.Preview,333,1707844648,1707844981,1707844981.193156,-21600,,
com.apple.finder,1,1707844647,1707844648,1707844648.572716,-21600,,
com.google.Chrome,113,1707844534,1707844647,1707844647.098215,-21600,,
com.leomehlig.today,17,1707844517,1707844534,1707844535.298223,-21600,,
com.leomehlig.today,124,1707841666,1707841790,1707841790.143138,-21600,,
com.google.Chrome,56,1707841610,1707841666,1707841666.261249,-21600,,
com.apple.finder,7,1707841603,1707841610,1707841610.334692,-21600,,
com.apple.Preview,3,1707841600,1707841603,1707841603.2945352,-21600,,
com.apple.finder,2,1707841598,1707841600,1707841600.294698,-21600,,
com.google.Chrome,18,1707841580,1707841598,1707841598.7157369,-21600,,
com.apple.finder,13,1707841567,1707841580,1707841580.3913279,-21600,,
com.google.Chrome,8,1707841559,1707841567,1707841567.380937,-21600,,
com.apple.finder,13,1707841546,1707841559,1707841559.09508,-21600,,
com.apple.Preview,5,1707841541,1707841546,1707841546.658762,-21600,,
com.google.Chrome,5,1707841536,1707841541,1707841541.4087648,-21600,,
com.apple.Preview,22,1707841514,1707841536,1707841536.644967,-21600,,
com.google.Chrome,1,1707841513,1707841514,1707841514.078395,-21600,,
com.apple.Preview,3,1707841510,1707841513,1707841513.401449,-21600,,
com.google.Chrome,2,1707841508,1707841510,1707841510.135905,-21600,,
com.apple.Preview,6,1707841502,1707841508,1707841508.794445,-21600,,
com.google.Chrome,7,1707841495,1707841502,1707841502.971103,-21600,,
com.apple.Preview,3,1707841492,1707841495,1707841495.055759,-21600,,
com.google.Chrome,2,1707841490,1707841492,1707841492.446954,-21600,,
com.apple.Preview,19,1707841471,1707841490,1707841490.3027701,-21600,,
com.google.Chrome,1,1707841470,1707841471,1707841471.0259151,-21600,,
com.apple.Preview,6,1707841464,1707841470,1707841470.1982322,-21600,,
com.google.Chrome,1,1707841463,1707841464,1707841464.872839,-21600,,
com.apple.Preview,3,1707841460,1707841463,1707841463.2280831,-21600,,
com.google.Chrome,0,1707841460,1707841460,1707841460.65446,-21600,,
com.apple.Preview,5,1707841455,1707841460,1707841460.185433,-21600,,
com.google.Chrome,1,1707841454,1707841455,1707841455.684284,-21600,,
com.apple.Preview,2,1707841452,1707841454,1707841454.492183,-21600,,
com.google.Chrome,4,1707841448,1707841452,1707841452.8537822,-21600,,
com.apple.Preview,17,1707841431,1707841448,1707841448.161092,-21600,,
com.google.Chrome,7,1707841424,1707841431,1707841431.1904988,-21600,,
com.apple.Preview,40,1707841384,1707841424,1707841424.143851,-21600,,
com.google.Chrome,7,1707841377,1707841384,1707841384.2456012,-21600,,
com.apple.Preview,3,1707841374,1707841377,1707841377.801962,-21600,,
com.google.Chrome,2,1707841372,1707841374,1707841374.437934,-21600,,
com.apple.Preview,3,1707841369,1707841372,1707841372.692945,-21600,,
com.google.Chrome,1,1707841368,1707841369,1707841369.421885,-21600,,
com.apple.Preview,1,1707841367,1707841368,1707841368.731375,-21600,,
com.google.Chrome,1,1707841366,1707841367,1707841367.928787,-21600,,
com.apple.Preview,7,1707841359,1707841366,1707841366.206863,-21600,,
com.google.Chrome,4,1707841355,1707841359,1707841359.577474,-21600,,
com.apple.Preview,13,1707841342,1707841355,1707841355.6446838,-21600,,
com.google.Chrome,2,1707841340,1707841342,1707841342.06115,-21600,,
com.apple.Preview,3,1707841337,1707841340,1707841340.197818,-21600,,
com.apple.finder,6,1707841331,1707841337,1707841338.173276,-21600,,
com.google.Chrome,856,1707840475,1707841331,1707841331.1411371,-21600,,
com.google.Chrome,588,1707791338,1707791926,1707791926.03964,-21600,,
com.apple.finder,133,1707791205,1707791338,1707791338.252389,-21600,,
com.apple.finder,2,1707791202,1707791204,1707791204.623601,-21600,,
com.google.Chrome,0,1707791202,1707791202,1707791202.981565,-21600,,
com.apple.finder,1,1707791201,1707791202,1707791202.160324,-21600,,
com.apple.Preview,1,1707791200,1707791201,1707791201.7905111,-21600,,
com.apple.finder,2,1707791198,1707791200,1707791200.65839,-21600,,
com.apple.MobileSMS,3,1707791195,1707791198,1707791198.103935,-21600,,
com.apple.finder,4,1707791191,1707791195,1707791195.226814,-21600,,
com.microsoft.Excel,2,1707791189,1707791191,1707791191.7535381,-21600,,
com.google.Chrome,1,1707791188,1707791189,1707791189.186069,-21600,,
com.leomehlig.today,128,1707791060,1707791188,1707791188.7988892,-21600,,
com.google.Chrome,20,1707791040,1707791060,1707791060.835608,-21600,,
com.leomehlig.today,14,1707791026,1707791040,1707791040.061883,-21600,,
com.google.Chrome,54,1707790972,1707791026,1707791026.580713,-21600,,
com.apple.Preview,1,1707790971,1707790972,1707790972.256916,-21600,,
com.google.Chrome,70,1707790901,1707790971,1707790971.3458781,-21600,,
com.apple.Preview,200,1707790701,1707790901,1707790901.119515,-21600,,
com.google.Chrome,18,1707790683,1707790701,1707790701.745899,-21600,,
com.apple.Preview,5,1707790678,1707790683,1707790683.148398,-21600,,
com.google.Chrome,45,1707790633,1707790678,1707790678.9388099,-21600,,
com.apple.Preview,41,1707790592,1707790633,1707790634.051917,-21600,,
com.google.Chrome,93,1707790499,1707790592,1707790592.8224201,-21600,,
com.apple.Preview,1,1707790498,1707790499,1707790499.69458,-21600,,
com.leomehlig.today,41,1707790457,1707790498,1707790498.524496,-21600,,
com.apple.Preview,195,1707790262,1707790457,1707790457.721822,-21600,,
com.apple.finder,17,1707790245,1707790262,1707790262.409167,-21600,,
com.google.Chrome,146,1707790099,1707790245,1707790245.932263,-21600,,
com.microsoft.Excel,1,1707790098,1707790099,1707790099.462425,-21600,,
com.google.Chrome,1,1707790097,1707790098,1707790098.754261,-21600,,
com.microsoft.Excel,1,1707790096,1707790097,1707790097.810761,-21600,,
com.google.Chrome,1,1707790095,1707790096,1707790096.24283,-21600,,
com.microsoft.Excel,1,1707790094,1707790095,1707790095.124718,-21600,,
com.google.Chrome,2,1707790092,1707790094,1707790094.2831988,-21600,,
com.microsoft.Excel,1,1707790091,1707790092,1707790092.887466,-21600,,
com.google.Chrome,1,1707790090,1707790091,1707790091.7503262,-21600,,
com.microsoft.Excel,1,1707790089,1707790090,1707790090.748774,-21600,,
com.google.Chrome,1,1707790088,1707790089,1707790089.626545,-21600,,
com.microsoft.Excel,3,1707790085,1707790088,1707790088.127172,-21600,,
com.google.Chrome,7,1707790078,1707790085,1707790085.672586,-21600,,
com.microsoft.Excel,10,1707790068,1707790078,1707790078.2216501,-21600,,
com.google.Chrome,5,1707790063,1707790068,1707790068.228671,-21600,,
com.microsoft.Excel,18,1707790045,1707790063,1707790063.55618,-21600,,
com.google.Chrome,29,1707790016,1707790045,1707790045.86088,-21600,,
com.microsoft.Excel,7,1707790009,1707790016,1707790016.528411,-21600,,
com.google.Chrome,16,1707789993,1707790009,1707790009.330086,-21600,,
com.microsoft.Excel,6,1707789987,1707789993,1707789993.686315,-21600,,
com.google.Chrome,8,1707789979,1707789987,1707789987.9513001,-21600,,
com.microsoft.Excel,2,1707789977,1707789979,1707789979.815697,-21600,,
com.google.Chrome,3,1707789974,1707789977,1707789977.906551,-21600,,
com.microsoft.Excel,9,1707789965,1707789974,1707789974.2701712,-21600,,
com.google.Chrome,10,1707789955,1707789965,1707789965.92471,-21600,,
com.microsoft.Excel,1,1707789954,1707789955,1707789955.9219809,-21600,,
com.google.Chrome,3,1707789951,1707789954,1707789954.7741609,-21600,,
com.microsoft.Excel,3,1707789948,1707789951,1707789951.352087,-21600,,
com.google.Chrome,9,1707789939,1707789948,1707789949.012085,-21600,,
com.microsoft.Excel,8,1707789931,1707789939,1707789939.710617,-21600,,
com.google.Chrome,5,1707789926,1707789931,1707789931.6258368,-21600,,
com.microsoft.Excel,18,1707789908,1707789926,1707789926.8307328,-21600,,
com.google.Chrome,6,1707789902,1707789908,1707789908.665108,-21600,,
com.microsoft.Excel,1,1707789901,1707789902,1707789902.151933,-21600,,
com.google.Chrome,161,1707789740,1707789901,1707789901.4801059,-21600,,
org.stellarium.Stellarium,533,1707789207,1707789740,1707789740.8837671,-21600,,
com.google.Chrome,2,1707789205,1707789207,1707789208.006071,-21600,,
com.apple.camera,3,1707789075,1707789078,1707789079.207622,-21600,EB445137-D7F5-57EC-87DA-1DB460D64046,"iPhone13,2"
com.burbn.instagram,117,1707788806,1707788923,1707788923.5757232,-21600,EB445137-D7F5-57EC-87DA-1DB460D64046,"iPhone13,2"
com.apple.Health,92,1707788689,1707788781,1707788781.415164,-21600,EB445137-D7F5-57EC-87DA-1DB460D64046,"iPhone13,2"
com.apple.Fitness,10,1707788678,1707788688,1707788688.886935,-21600,EB445137-D7F5-57EC-87DA-1DB460D64046,"iPhone13,2"
com.leomehlig.today,16,1707788635,1707788651,1707788651.332099,-21600,EB445137-D7F5-57EC-87DA-1DB460D64046,"iPhone13,2"
com.apple.mobilecal,15,1707788612,1707788627,1707788627.024249,-21600,EB445137-D7F5-57EC-87DA-1DB460D64046,"iPhone13,2"
com.t11.celeste,3,1707788596,1707788599,1707788599.716491,-21600,EB445137-D7F5-57EC-87DA-1DB460D64046,"iPhone13,2"
com.t11.celeste,56,1707787330,1707787386,1707787386.0760531,-21600,EB445137-D7F5-57EC-87DA-1DB460D64046,"iPhone13,2"
com.google.chrome.ios,6,1707787322,1707787328,1707787328.101513,-21600,EB445137-D7F5-57EC-87DA-1DB460D64046,"iPhone13,2"
com.google.chrome.ios,30,1707786262,1707786292,1707786292.6490722,-21600,EB445137-D7F5-57EC-87DA-1DB460D64046,"iPhone13,2"
com.apple.camera,8,1707785813,1707785821,1707785821.025196,-21600,EB445137-D7F5-57EC-87DA-1DB460D64046,"iPhone13,2"
com.tinyspeck.chatlyio,8,1707785811,1707785819,1707785819.754216,-21600,EB445137-D7F5-57EC-87DA-1DB460D64046,"iPhone13,2"
com.tinyspeck.chatlyio,6,1707785763,1707785769,1707785769.9716458,-21600,EB445137-D7F5-57EC-87DA-1DB460D64046,"iPhone13,2"
com.tinyspeck.chatlyio,1,1707785757,1707785758,1707785758.722188,-21600,EB445137-D7F5-57EC-87DA-1DB460D64046,"iPhone13,2"
com.tinyspeck.chatlyio,6,1707785562,1707785568,1707785568.741823,-21600,EB445137-D7F5-57EC-87DA-1DB460D64046,"iPhone13,2"
com.tinyspeck.chatlyio,1,1707785560,1707785561,1707785561.831801,-21600,EB445137-D7F5-57EC-87DA-1DB460D64046,"iPhone13,2"
com.tinyspeck.chatlyio,1,1707784850,1707784851,1707784851.666123,-21600,EB445137-D7F5-57EC-87DA-1DB460D64046,"iPhone13,2"
com.tinyspeck.chatlyio,2,1707784469,1707784471,1707784471.191393,-21600,EB445137-D7F5-57EC-87DA-1DB460D64046,"iPhone13,2"
com.google.Chrome,280,1707784418,1707784698,1707784698.213684,-21600,,
com.apple.iCal,7,1707784411,1707784418,1707784418.6603389,-21600,,
com.google.Chrome,6,1707784405,1707784411,1707784411.708775,-21600,,
com.leomehlig.today,6,1707784399,1707784405,1707784406.557033,-21600,,
com.tinyspeck.chatlyio,6,1707784198,1707784204,1707784204.5317612,-21600,EB445137-D7F5-57EC-87DA-1DB460D64046,"iPhone13,2"
com.tinyspeck.chatlyio,6,1707784049,1707784055,1707784055.9079819,-21600,EB445137-D7F5-57EC-87DA-1DB460D64046,"iPhone13,2"
com.tinyspeck.chatlyio,6,1707783874,1707783880,1707783880.411576,-21600,EB445137-D7F5-57EC-87DA-1DB460D64046,"iPhone13,2"
com.tinyspeck.chatlyio,6,1707783648,1707783654,1707783654.44817,-21600,EB445137-D7F5-57EC-87DA-1DB460D64046,"iPhone13,2"
com.tinyspeck.chatlyio,6,1707783513,1707783519,1707783519.267346,-21600,EB445137-D7F5-57EC-87DA-1DB460D64046,"iPhone13,2"
com.tinyspeck.chatlyio,6,1707783210,1707783216,1707783216.620607,-21600,EB445137-D7F5-57EC-87DA-1DB460D64046,"iPhone13,2"
com.tinyspeck.chatlyio,68,1707783111,1707783179,1707783179.405941,-21600,EB445137-D7F5-57EC-87DA-1DB460D64046,"iPhone13,2"
com.leomehlig.today,11,1707782970,1707782981,1707782981.991859,-21600,,
com.google.Chrome,24,1707782946,1707782970,1707782970.1545901,-21600,,
com.apple.iCal,54,1707782892,1707782946,1707782946.577956,-21600,,
Astrospheric.Astrospheric,40,1707782845,1707782885,1707782885.705338,-21600,EB445137-D7F5-57EC-87DA-1DB460D64046,"iPhone13,2"
com.instructure.icanvas,5,1707782836,1707782841,1707782841.78918,-21600,EB445137-D7F5-57EC-87DA-1DB460D64046,"iPhone13,2"
com.apple.finder,61,1707782831,1707782892,1707782892.409195,-21600,,
com.google.Chrome,303,1707782528,1707782831,1707782831.687869,-21600,,
com.microsoft.rdc.macos,2,1707782526,1707782528,1707782529.450772,-21600,,
com.instructure.icanvas,10,1707782524,1707782534,1707782534.757832,-21600,EB445137-D7F5-57EC-87DA-1DB460D64046,"iPhone13,2"
com.instructure.icanvas,8,1707782505,1707782513,1707782513.1442409,-21600,EB445137-D7F5-57EC-87DA-1DB460D64046,"iPhone13,2"
Astrospheric.Astrospheric,4,1707782498,1707782502,1707782502.49071,-21600,EB445137-D7F5-57EC-87DA-1DB460D64046,"iPhone13,2"
Astrospheric.Astrospheric,7,1707781656,1707781663,1707781663.777091,-21600,EB445137-D7F5-57EC-87DA-1DB460D64046,"iPhone13,2"
edu.illinois.rokwire.ios,3,1707781651,1707781654,1707781654.507287,-21600,EB445137-D7F5-57EC-87DA-1DB460D64046,"iPhone13,2"
edu.illinois.rokwire.ios,28,1707779923,1707779951,1707779951.045824,-21600,EB445137-D7F5-57EC-87DA-1DB460D64046,"iPhone13,2"
com.apple.Health,7,1707779911,1707779918,1707779918.448977,-21600,EB445137-D7F5-57EC-87DA-1DB460D64046,"iPhone13,2"
com.apple.Health,5,1707779905,1707779910,1707779910.031852,-21600,EB445137-D7F5-57EC-87DA-1DB460D64046,"iPhone13,2"
com.apple.Health,7,1707779897,1707779904,1707779904.224987,-21600,EB445137-D7F5-57EC-87DA-1DB460D64046,"iPhone13,2"
com.apple.Health,42,1707779846,1707779888,1707779888.686195,-21600,EB445137-D7F5-57EC-87DA-1DB460D64046,"iPhone13,2"
com.instructure.icanvas,14,1707779749,1707779763,1707779764.0472322,-21600,EB445137-D7F5-57EC-87DA-1DB460D64046,"iPhone13,2"
com.google.chrome.ios,5,1707779744,1707779749,1707779749.9445848,-21600,EB445137-D7F5-57EC-87DA-1DB460D64046,"iPhone13,2"
com.google.chrome.ios,26,1707778975,1707779001,1707779001.984149,-21600,EB445137-D7F5-57EC-87DA-1DB460D64046,"iPhone13,2"
edu.illinois.rokwire.ios,2,1707778973,1707778975,1707778975.539428,-21600,EB445137-D7F5-57EC-87DA-1DB460D64046,"iPhone13,2"
com.apple.camera,1,1707778592,1707778593,1707778593.99892,-21600,EB445137-D7F5-57EC-87DA-1DB460D64046,"iPhone13,2"
com.apple.camera,0,1707778591,1707778591,1707778591.961416,-21600,EB445137-D7F5-57EC-87DA-1DB460D64046,"iPhone13,2"
edu.illinois.rokwire.ios,7,1707778589,1707778596,1707778596.992478,-21600,EB445137-D7F5-57EC-87DA-1DB460D64046,"iPhone13,2"
edu.illinois.rokwire.ios,102,1707778483,1707778585,1707778585.405026,-21600,EB445137-D7F5-57EC-87DA-1DB460D64046,"iPhone13,2"
com.microsoft.rdc.macos,43,1707777534,1707777577,1707777577.262154,-21600,,
com.leomehlig.today,6,1707777528,1707777534,1707777534.652048,-21600,,
com.toyopagroup.picaboo,32,1707776479,1707776511,1707776511.519411,-21600,EB445137-D7F5-57EC-87DA-1DB460D64046,"iPhone13,2"
com.instructure.icanvas,13,1707776459,1707776472,1707776472.95382,-21600,EB445137-D7F5-57EC-87DA-1DB460D64046,"iPhone13,2"
com.apple.news,14,1707774480,1707774494,1707774494.7291021,-21600,EB445137-D7F5-57EC-87DA-1DB460D64046,"iPhone13,2"
com.apple.news,165,1707774284,1707774449,1707774449.547371,-21600,EB445137-D7F5-57EC-87DA-1DB460D64046,"iPhone13,2"
com.intsig.CamScannerLite,7,1707774266,1707774273,1707774273.742394,-21600,EB445137-D7F5-57EC-87DA-1DB460D64046,"iPhone13,2"
com.leomehlig.today,153,1707771383,1707771536,1707771536.574589,-21600,,
com.apple.finder,37,1707771346,1707771383,1707771383.2678552,-21600,,
com.google.Chrome,146,1707771200,1707771346,1707771346.697043,-21600,,
com.leomehlig.today,3,1707771197,1707771200,1707771202.081872,-21600,,
com.leomehlig.today,2,1707770864,1707770866,1707770867.543858,-21600,,
com.leomehlig.today,47,1707770817,1707770864,1707770865.359601,-21600,,
com.google.Chrome,220,1707770597,1707770817,1707770817.2067661,-21600,,
com.apple.Notes,38,1707770559,1707770597,1707770597.2336411,-21600,,
com.google.Chrome,93,1707770466,1707770559,1707770559.571171,-21600,,
com.microsoft.Outlook,87,1707770379,1707770466,1707770467.0736198,-21600,,
com.intsig.CamScannerLite,107,1707770130,1707770237,1707770237.727539,-21600,EB445137-D7F5-57EC-87DA-1DB460D64046,"iPhone13,2"
com.apple.news,5,1707770123,1707770128,1707770128.121777,-21600,EB445137-D7F5-57EC-87DA-1DB460D64046,"iPhone13,2"
com.google.Chrome,1368,1707769011,1707770379,1707770380.017596,-21600,,
com.apple.Preview,13,1707768998,1707769011,1707769011.3982449,-21600,,
com.google.Chrome,86,1707768912,1707768998,1707768998.5351639,-21600,,
com.apple.Preview,44,1707768868,1707768912,1707768912.4428391,-21600,,
com.google.Chrome,234,1707768634,1707768868,1707768868.7370281,-21600,,
com.apple.Preview,50,1707768584,1707768634,1707768634.693944,-21600,,
com.google.Chrome,170,1707768414,1707768584,1707768584.6136842,-21600,,
com.apple.Preview,154,1707768260,1707768414,1707768415.014667,-21600,,
com.google.Chrome,14,1707768246,1707768260,1707768260.267046,-21600,,
com.apple.Preview,86,1707768160,1707768246,1707768246.914901,-21600,,
com.google.Chrome,100,1707768060,1707768160,1707768161.0185041,-21600,,
com.apple.Preview,13,1707768047,1707768060,1707768060.971694,-21600,,
com.google.Chrome,58,1707767989,1707768047,1707768047.0687718,-21600,,
com.apple.Preview,125,1707767864,1707767989,1707767989.7023702,-21600,,
com.google.Chrome,9,1707767855,1707767864,1707767864.7080731,-21600,,
com.apple.Preview,171,1707767684,1707767855,1707767855.577259,-21600,,
com.google.Chrome,5,1707767679,1707767684,1707767684.5736852,-21600,,
com.apple.Preview,1,1707767678,1707767679,1707767679.426959,-21600,,
com.google.Chrome,3,1707767675,1707767678,1707767678.504208,-21600,,
com.apple.Preview,27,1707767648,1707767675,1707767675.229492,-21600,,
com.apple.finder,1,1707767647,1707767648,1707767648.935225,-21600,,
com.apple.Preview,2,1707767645,1707767647,1707767647.5433831,-21600,,
com.google.Chrome,52,1707767593,1707767645,1707767645.748296,-21600,,
com.apple.finder,2,1707767591,1707767593,1707767594.0056648,-21600,,
com.leomehlig.today,2,1707767589,1707767591,1707767592.039393,-21600,,
com.google.Chrome,7,1707767582,1707767589,1707767589.690583,-21600,,
com.apple.news,6,1707767430,1707767436,1707767436.5880609,-21600,EB445137-D7F5-57EC-87DA-1DB460D64046,"iPhone13,2"
com.apple.news,3,1707767403,1707767406,1707767406.124479,-21600,EB445137-D7F5-57EC-87DA-1DB460D64046,"iPhone13,2"
com.apple.news,1,1707767398,1707767399,1707767399.401373,-21600,EB445137-D7F5-57EC-87DA-1DB460D64046,"iPhone13,2"
com.apple.news,6,1707764415,1707764421,1707764421.3858008,-21600,EB445137-D7F5-57EC-87DA-1DB460D64046,"iPhone13,2"
com.apple.news,23,1707764390,1707764413,1707764413.43297,-21600,EB445137-D7F5-57EC-87DA-1DB460D64046,"iPhone13,2"
com.google.Chrome,6,1707764267,1707764273,1707764273.422435,-21600,,
com.apple.Preview,375,1707763892,1707764267,1707764267.4089332,-21600,,
com.apple.Preview,1475,1707762304,1707763779,1707763779.244182,-21600,,
com.apple.finder,2,1707762302,1707762304,1707762304.3321,-21600,,
com.google.Chrome,1,1707762301,1707762302,1707762302.924955,-21600,,
com.leomehlig.today,21,1707762280,1707762301,1707762301.695173,-21600,,
com.google.chrome.ios,39,1707761128,1707761167,1707761167.6331859,-21600,EB445137-D7F5-57EC-87DA-1DB460D64046,"iPhone13,2"
com.instructure.icanvas,22,1707761106,1707761128,1707761128.099121,-21600,EB445137-D7F5-57EC-87DA-1DB460D64046,"iPhone13,2"
edu.illinois.rokwire.ios,5,1707761099,1707761104,1707761104.789046,-21600,EB445137-D7F5-57EC-87DA-1DB460D64046,"iPhone13,2"
com.microsoft.Office.Outlook,5,1707761092,1707761097,1707761097.4893398,-21600,EB445137-D7F5-57EC-87DA-1DB460D64046,"iPhone13,2"
com.microsoft.Office.Outlook,10,1707761080,1707761090,1707761090.871763,-21600,EB445137-D7F5-57EC-87DA-1DB460D64046,"iPhone13,2"
com.microsoft.Office.Outlook,10,1707760922,1707760932,1707760932.399054,-21600,EB445137-D7F5-57EC-87DA-1DB460D64046,"iPhone13,2"
com.microsoft.Office.Outlook,26,1707760727,1707760753,1707760753.6746778,-21600,EB445137-D7F5-57EC-87DA-1DB460D64046,"iPhone13,2"
edu.illinois.rokwire.ios,4,1707760707,1707760711,1707760711.13018,-21600,EB445137-D7F5-57EC-87DA-1DB460D64046,"iPhone13,2"
edu.illinois.rokwire.ios,37,1707760500,1707760537,1707760537.733828,-21600,EB445137-D7F5-57EC-87DA-1DB460D64046,"iPhone13,2"
com.toyopagroup.picaboo,2,1707760497,1707760499,1707760500.417406,-21600,EB445137-D7F5-57EC-87DA-1DB460D64046,"iPhone13,2"
com.toyopagroup.picaboo,3,1707760159,1707760162,1707760162.982329,-21600,EB445137-D7F5-57EC-87DA-1DB460D64046,"iPhone13,2"
com.toyopagroup.picaboo,1,1707760157,1707760158,1707760158.7870111,-21600,EB445137-D7F5-57EC-87DA-1DB460D64046,"iPhone13,2"
com.toyopagroup.picaboo,13,1707759968,1707759981,1707759981.9372602,-21600,EB445137-D7F5-57EC-87DA-1DB460D64046,"iPhone13,2"
com.toyopagroup.picaboo,5,1707759880,1707759885,1707759886.013118,-21600,EB445137-D7F5-57EC-87DA-1DB460D64046,"iPhone13,2"
com.toyopagroup.picaboo,25,1707759712,1707759737,1707759737.3286428,-21600,EB445137-D7F5-57EC-87DA-1DB460D64046,"iPhone13,2"
com.google.chrome.ios,4,1707759708,1707759712,1707759712.621181,-21600,EB445137-D7F5-57EC-87DA-1DB460D64046,"iPhone13,2"
com.google.chrome.ios,10,1707759674,1707759684,1707759684.393641,-21600,EB445137-D7F5-57EC-87DA-1DB460D64046,"iPhone13,2"
com.google.chrome.ios,53,1707759357,1707759410,1707759410.949816,-21600,EB445137-D7F5-57EC-87DA-1DB460D64046,"iPhone13,2"
com.microsoft.Office.Outlook,3,1707759354,1707759357,1707759357.301723,-21600,EB445137-D7F5-57EC-87DA-1DB460D64046,"iPhone13,2"
com.microsoft.Office.Outlook,10,1707759241,1707759251,1707759251.819077,-21600,EB445137-D7F5-57EC-87DA-1DB460D64046,"iPhone13,2"
com.microsoft.Office.Outlook,8,1707758288,1707758296,1707758296.145006,-21600,EB445137-D7F5-57EC-87DA-1DB460D64046,"iPhone13,2"
com.microsoft.Office.Outlook,15,1707758220,1707758235,1707758236.0068278,-21600,EB445137-D7F5-57EC-87DA-1DB460D64046,"iPhone13,2"
com.apple.news,4,1707758216,1707758220,1707758220.5803661,-21600,EB445137-D7F5-57EC-87DA-1DB460D64046,"iPhone13,2"
com.apple.news,533,1707756807,1707757340,1707757340.374217,-21600,EB445137-D7F5-57EC-87DA-1DB460D64046,"iPhone13,2"
com.apple.MobileSMS,3,1707756804,1707756807,1707756807.0930161,-21600,EB445137-D7F5-57EC-87DA-1DB460D64046,"iPhone13,2"
com.apple.news,7,1707756797,1707756804,1707756804.945317,-21600,EB445137-D7F5-57EC-87DA-1DB460D64046,"iPhone13,2"
com.apple.news,5,1707756737,1707756742,1707756742.964754,-21600,EB445137-D7F5-57EC-87DA-1DB460D64046,"iPhone13,2"
com.instructure.icanvas,23,1707756686,1707756709,1707756709.6058679,-21600,EB445137-D7F5-57EC-87DA-1DB460D64046,"iPhone13,2"
com.leomehlig.today,57,1707756556,1707756613,1707756614.144123,-21600,,
com.google.Chrome,346,1707756210,1707756556,1707756556.433944,-21600,,
com.microsoft.rdc.macos,3,1707756207,1707756210,1707756210.911974,-21600,,
com.apple.camera,2,1707755377,1707755379,1707755380.481193,-21600,EB445137-D7F5-57EC-87DA-1DB460D64046,"iPhone13,2"
com.instructure.icanvas,24,1707755373,1707755397,1707755397.465774,-21600,EB445137-D7F5-57EC-87DA-1DB460D64046,"iPhone13,2"
com.instructure.icanvas,3,1707754478,1707754481,1707754482.090133,-21600,EB445137-D7F5-57EC-87DA-1DB460D64046,"iPhone13,2"
com.instructure.icanvas,10,1707754262,1707754272,1707754272.9901838,-21600,EB445137-D7F5-57EC-87DA-1DB460D64046,"iPhone13,2"
com.apple.Health,37,1707752222,1707752259,1707752259.930883,-21600,EB445137-D7F5-57EC-87DA-1DB460D64046,"iPhone13,2"
com.apple.Health,50,1707752057,1707752107,1707752107.550128,-21600,EB445137-D7F5-57EC-87DA-1DB460D64046,"iPhone13,2"
com.strava.stravaride,48,1707752008,1707752056,1707752056.480295,-21600,EB445137-D7F5-57EC-87DA-1DB460D64046,"iPhone13,2"
com.google.Maps,3,1707752003,1707752006,1707752006.0662808,-21600,EB445137-D7F5-57EC-87DA-1DB460D64046,"iPhone13,2"
com.google.Maps,11,1707751900,1707751911,1707751911.407246,-21600,EB445137-D7F5-57EC-87DA-1DB460D64046,"iPhone13,2"
com.google.Maps,1,1707751896,1707751897,1707751897.510707,-21600,EB445137-D7F5-57EC-87DA-1DB460D64046,"iPhone13,2"
com.google.Maps,2,1707751894,1707751896,1707751896.0099711,-21600,EB445137-D7F5-57EC-87DA-1DB460D64046,"iPhone13,2"
com.google.Maps,14,1707751878,1707751892,1707751892.686071,-21600,EB445137-D7F5-57EC-87DA-1DB460D64046,"iPhone13,2"
com.peacocktv.peacock,1506,1707750150,1707751656,1707751656.158787,-21600,EB445137-D7F5-57EC-87DA-1DB460D64046,"iPhone13,2"
com.apple.Health,8,1707750140,1707750148,1707750148.5114532,-21600,EB445137-D7F5-57EC-87DA-1DB460D64046,"iPhone13,2"
com.apple.Health,18,1707750031,1707750049,1707750049.184124,-21600,EB445137-D7F5-57EC-87DA-1DB460D64046,"iPhone13,2"
com.google.Maps,16,1707749644,1707749660,1707749660.654037,-21600,EB445137-D7F5-57EC-87DA-1DB460D64046,"iPhone13,2"
com.thestorygraph.thestorygraph,22,1707716617,1707716639,1707716639.401782,-21600,EB445137-D7F5-57EC-87DA-1DB460D64046,"iPhone13,2"
co.hinge.mobile.ios,8,1707716606,1707716614,1707716614.24158,-21600,EB445137-D7F5-57EC-87DA-1DB460D64046,"iPhone13,2"
co.hinge.mobile.ios,12,1707716268,1707716280,1707716280.023874,-21600,EB445137-D7F5-57EC-87DA-1DB460D64046,"iPhone13,2"
co.hinge.mobile.ios,138,1707715824,1707715962,1707715962.784251,-21600,EB445137-D7F5-57EC-87DA-1DB460D64046,"iPhone13,2"
com.microsoft.Office.Outlook,6,1707715811,1707715817,1707715817.336189,-21600,EB445137-D7F5-57EC-87DA-1DB460D64046,"iPhone13,2"
com.apple.Health,20,1707715789,1707715809,1707715809.182167,-21600,EB445137-D7F5-57EC-87DA-1DB460D64046,"iPhone13,2"
com.apple.Music,14,1707715775,1707715789,1707715790.492482,-21600,EB445137-D7F5-57EC-87DA-1DB460D64046,"iPhone13,2"
com.apple.Music,10,1707713747,1707713757,1707713757.2770882,-21600,EB445137-D7F5-57EC-87DA-1DB460D64046,"iPhone13,2"
com.apple.Music,11,1707713651,1707713662,1707713662.240765,-21600,EB445137-D7F5-57EC-87DA-1DB460D64046,"iPhone13,2"
com.apple.Music,10,1707713210,1707713220,1707713220.9374828,-21600,EB445137-D7F5-57EC-87DA-1DB460D64046,"iPhone13,2"
com.apple.Music,6,1707712773,1707712779,1707712779.506803,-21600,EB445137-D7F5-57EC-87DA-1DB460D64046,"iPhone13,2"
com.apple.Music,3,1707712664,1707712667,1707712667.575626,-21600,EB445137-D7F5-57EC-87DA-1DB460D64046,"iPhone13,2"
com.apple.Music,70,1707712556,1707712626,1707712626.619666,-21600,EB445137-D7F5-57EC-87DA-1DB460D64046,"iPhone13,2"
com.google.chrome.ios,9,1707712534,1707712543,1707712543.818413,-21600,EB445137-D7F5-57EC-87DA-1DB460D64046,"iPhone13,2"
com.google.ios.youtube,142,1707712392,1707712534,1707712534.886091,-21600,EB445137-D7F5-57EC-87DA-1DB460D64046,"iPhone13,2"
com.t11.celeste,5,1707712382,1707712387,1707712387.2616181,-21600,EB445137-D7F5-57EC-87DA-1DB460D64046,"iPhone13,2"
com.t11.celeste,115,1707712254,1707712369,1707712370.0226002,-21600,EB445137-D7F5-57EC-87DA-1DB460D64046,"iPhone13,2"
com.microsoft.rdc.macos,429,1707711061,1707711490,1707711490.492316,-21600,,
com.apple.finder,3,1707711058,1707711061,1707711061.140514,-21600,,
com.microsoft.rdc.macos,12,1707711046,1707711058,1707711058.683965,-21600,,
com.microsoft.rdc.macos,353,1707706909,1707707262,1707707262.253014,-21600,,
com.microsoft.rdc.macos,5,1707704601,1707704606,1707704606.5581841,-21600,,
com.microsoft.rdc.macos,484,1707704086,1707704570,1707704570.114531,-21600,,
com.microsoft.rdc.macos,331,1707703710,1707704041,1707704041.593009,-21600,,
com.google.ios.youtube,175,1707703523,1707703698,1707703698.476151,-21600,EB445137-D7F5-57EC-87DA-1DB460D64046,"iPhone13,2"
com.microsoft.rdc.macos,450,1707703249,1707703699,1707703699.341754,-21600,,
com.apple.camera,111,1707703134,1707703245,1707703245.863309,-21600,EB445137-D7F5-57EC-87DA-1DB460D64046,"iPhone13,2"
com.google.chrome.ios,18,1707703130,1707703148,1707703148.9229732,-21600,EB445137-D7F5-57EC-87DA-1DB460D64046,"iPhone13,2"
com.google.chrome.ios,73,1707703022,1707703095,1707703095.858581,-21600,EB445137-D7F5-57EC-87DA-1DB460D64046,"iPhone13,2"
com.google.chrome.ios,2,1707702990,1707702992,1707702992.265379,-21600,EB445137-D7F5-57EC-87DA-1DB460D64046,"iPhone13,2"
com.google.chrome.ios,6,1707702651,1707702657,1707702657.6953878,-21600,EB445137-D7F5-57EC-87DA-1DB460D64046,"iPhone13,2"
com.microsoft.rdc.macos,1045,1707702125,1707703170,1707703170.240131,-21600,,
com.google.chrome.ios,1,1707702097,1707702098,1707702098.789648,-21600,EB445137-D7F5-57EC-87DA-1DB460D64046,"iPhone13,2"
com.google.chrome.ios,71,1707701990,1707702061,1707702061.794561,-21600,EB445137-D7F5-57EC-87DA-1DB460D64046,"iPhone13,2"
com.apple.compass,4,1707701937,1707701941,1707701941.7182431,-21600,EB445137-D7F5-57EC-87DA-1DB460D64046,"iPhone13,2"
com.microsoft.onenote.mac,320,1707701805,1707702125,1707702125.785861,-21600,,
com.apple.compass,4,1707701765,1707701769,1707701769.610787,-21600,EB445137-D7F5-57EC-87DA-1DB460D64046,"iPhone13,2"
com.apple.compass,11,1707701747,1707701758,1707701758.48027,-21600,EB445137-D7F5-57EC-87DA-1DB460D64046,"iPhone13,2"
com.microsoft.rdc.macos,387,1707701418,1707701805,1707701805.668272,-21600,,
org.stellarium.Stellarium,32,1707701386,1707701418,1707701418.625763,-21600,,
com.apple.compass,4,1707701287,1707701291,1707701291.0710878,-21600,EB445137-D7F5-57EC-87DA-1DB460D64046,"iPhone13,2"
com.apple.compass,2,1707699872,1707699874,1707699874.9222,-21600,EB445137-D7F5-57EC-87DA-1DB460D64046,"iPhone13,2"
com.microsoft.rdc.macos,1535,1707699851,1707701386,1707701386.044228,-21600,,
com.apple.compass,18,1707699846,1707699864,1707699864.241691,-21600,EB445137-D7F5-57EC-87DA-1DB460D64046,"iPhone13,2"
com.apple.camera,1,1707699846,1707699847,1707699847.629343,-21600,EB445137-D7F5-57EC-87DA-1DB460D64046,"iPhone13,2"
com.apple.finder,9,1707699842,1707699851,1707699851.13322,-21600,,
org.stellarium.Stellarium,4,1707699838,1707699842,1707699842.211587,-21600,,
com.apple.compass,11,1707699721,1707699732,1707699732.929313,-21600,EB445137-D7F5-57EC-87DA-1DB460D64046,"iPhone13,2"
com.apple.compass,45,1707699129,1707699174,1707699174.506091,-21600,EB445137-D7F5-57EC-87DA-1DB460D64046,"iPhone13,2"
com.apple.Preferences,14,1707699106,1707699120,1707699120.517195,-21600,EB445137-D7F5-57EC-87DA-1DB460D64046,"iPhone13,2"
com.t11.celeste,5,1707699099,1707699104,1707699104.1307368,-21600,EB445137-D7F5-57EC-87DA-1DB460D64046,"iPhone13,2"
com.t11.celeste,14,1707699028,1707699042,1707699042.759801,-21600,EB445137-D7F5-57EC-87DA-1DB460D64046,"iPhone13,2"
com.apple.compass,19,1707699008,1707699027,1707699027.775996,-21600,EB445137-D7F5-57EC-87DA-1DB460D64046,"iPhone13,2"
com.ryansponzilli.DeepSkyCatalog,3,1707699003,1707699006,1707699006.7365851,-21600,EB445137-D7F5-57EC-87DA-1DB460D64046,"iPhone13,2"
com.ryansponzilli.DeepSkyCatalog,70,1707698510,1707698580,1707698580.466998,-21600,EB445137-D7F5-57EC-87DA-1DB460D64046,"iPhone13,2"
com.ryansponzilli.DeepSkyCatalog,5,1707698489,1707698494,1707698494.584063,-21600,EB445137-D7F5-57EC-87DA-1DB460D64046,"iPhone13,2"
com.ryansponzilli.DeepSkyCatalog,103,1707698377,1707698480,1707698480.592901,-21600,EB445137-D7F5-57EC-87DA-1DB460D64046,"iPhone13,2"
com.apple.MobileSMS,2,1707698373,1707698375,1707698375.296564,-21600,EB445137-D7F5-57EC-87DA-1DB460D64046,"iPhone13,2"
org.stellarium.Stellarium,572,1707698316,1707698888,1707698888.613265,-21600,,
com.apple.finder,8,1707698308,1707698316,1707698316.4760752,-21600,,
com.apple.Preview,0,1707698308,1707698308,1707698308.631398,-21600,,
com.google.Chrome,2,1707698306,1707698308,1707698308.264154,-21600,,
com.leomehlig.today,2,1707698304,1707698306,1707698306.8595371,-21600,,
com.apple.MobileSMS,6,1707697759,1707697765,1707697765.99142,-21600,EB445137-D7F5-57EC-87DA-1DB460D64046,"iPhone13,2"
com.apple.MobileSMS,15,1707697743,1707697758,1707697758.060474,-21600,EB445137-D7F5-57EC-87DA-1DB460D64046,"iPhone13,2"
com.apple.MobileSMS,10,1707697666,1707697676,1707697676.219672,-21600,EB445137-D7F5-57EC-87DA-1DB460D64046,"iPhone13,2"
com.apple.MobileSMS,39,1707697587,1707697626,1707697626.899077,-21600,EB445137-D7F5-57EC-87DA-1DB460D64046,"iPhone13,2"
com.google.Maps,1303,1707696284,1707697587,1707697587.132745,-21600,EB445137-D7F5-57EC-87DA-1DB460D64046,"iPhone13,2"
com.apple.podcasts,5,1707696279,1707696284,1707696284.981666,-21600,EB445137-D7F5-57EC-87DA-1DB460D64046,"iPhone13,2"
com.apple.podcasts,162,1707695058,1707695220,1707695220.4851189,-21600,EB445137-D7F5-57EC-87DA-1DB460D64046,"iPhone13,2"
com.google.Maps,10,1707695045,1707695055,1707695055.813798,-21600,EB445137-D7F5-57EC-87DA-1DB460D64046,"iPhone13,2"
com.apple.Maps,13,1707695032,1707695045,1707695045.26333,-21600,EB445137-D7F5-57EC-87DA-1DB460D64046,"iPhone13,2"
com.google.Maps,14,1707695018,1707695032,1707695032.3614368,-21600,EB445137-D7F5-57EC-87DA-1DB460D64046,"iPhone13,2"
com.apple.Maps,37,1707694979,1707695016,1707695016.677686,-21600,EB445137-D7F5-57EC-87DA-1DB460D64046,"iPhone13,2"
com.apple.MobileSMS,21,1707693619,1707693640,1707693640.742507,-21600,EB445137-D7F5-57EC-87DA-1DB460D64046,"iPhone13,2"
Astrospheric.Astrospheric,8,1707693611,1707693619,1707693619.2066379,-21600,EB445137-D7F5-57EC-87DA-1DB460D64046,"iPhone13,2"
com.apple.MobileSMS,10,1707693600,1707693610,1707693610.908813,-21600,EB445137-D7F5-57EC-87DA-1DB460D64046,"iPhone13,2"
com.apple.MobileSMS,31,1707693070,1707693101,1707693102.1488938,-21600,EB445137-D7F5-57EC-87DA-1DB460D64046,"iPhone13,2"
com.google.chrome.ios,14,1707692765,1707692779,1707692779.1157432,-21600,EB445137-D7F5-57EC-87DA-1DB460D64046,"iPhone13,2"
com.apple.news,160,1707692605,1707692765,1707692765.1437368,-21600,EB445137-D7F5-57EC-87DA-1DB460D64046,"iPhone13,2"
com.apple.news,1,1707692596,1707692597,1707692597.930183,-21600,EB445137-D7F5-57EC-87DA-1DB460D64046,"iPhone13,2"
com.apple.news,43,1707692539,1707692582,1707692582.228928,-21600,EB445137-D7F5-57EC-87DA-1DB460D64046,"iPhone13,2"
com.apple.Health,20,1707691495,1707691515,1707691516.012476,-21600,EB445137-D7F5-57EC-87DA-1DB460D64046,"iPhone13,2"
com.apple.Music,5,1707691489,1707691494,1707691494.421819,-21600,EB445137-D7F5-57EC-87DA-1DB460D64046,"iPhone13,2"
com.apple.Music,15,1707691374,1707691389,1707691389.397373,-21600,EB445137-D7F5-57EC-87DA-1DB460D64046,"iPhone13,2"
com.apple.weather,16,1707691068,1707691084,1707691084.790621,-21600,EB445137-D7F5-57EC-87DA-1DB460D64046,"iPhone13,2"
com.leomehlig.today,2,1707691058,1707691060,1707691060.3492122,-21600,,
com.toyopagroup.picaboo,22,1707691028,1707691050,1707691050.34205,-21600,EB445137-D7F5-57EC-87DA-1DB460D64046,"iPhone13,2"
Astrospheric.Astrospheric,52,1707690932,1707690984,1707690984.7078109,-21600,EB445137-D7F5-57EC-87DA-1DB460D64046,"iPhone13,2"
com.leomehlig.today,221,1707690834,1707691055,1707691055.084324,-21600,,
Astrospheric.Astrospheric,6,1707690061,1707690067,1707690067.10764,-21600,EB445137-D7F5-57EC-87DA-1DB460D64046,"iPhone13,2"
Astrospheric.Astrospheric,6,1707689697,1707689703,1707689703.986613,-21600,EB445137-D7F5-57EC-87DA-1DB460D64046,"iPhone13,2"
com.google.Chrome,2489,1707688345,1707690834,1707690834.9447908,-21600,,
com.leomehlig.today,95,1707688250,1707688345,1707688346.010919,-21600,,
Astrospheric.Astrospheric,18,1707688063,1707688081,1707688082.9020371,-21600,EB445137-D7F5-57EC-87DA-1DB460D64046,"iPhone13,2"
com.apple.MobileSMS,4,1707688059,1707688063,1707688063.282891,-21600,EB445137-D7F5-57EC-87DA-1DB460D64046,"iPhone13,2"
com.apple.MobileSMS,32,1707688008,1707688040,1707688040.9899402,-21600,EB445137-D7F5-57EC-87DA-1DB460D64046,"iPhone13,2"
com.apple.MobileSMS,2,1707687958,1707687960,1707687960.8684568,-21600,EB445137-D7F5-57EC-87DA-1DB460D64046,"iPhone13,2"
com.apple.mobilephone,4,1707687952,1707687956,1707687956.3180299,-21600,EB445137-D7F5-57EC-87DA-1DB460D64046,"iPhone13,2"
com.apple.MobileSMS,12,1707687934,1707687946,1707687946.186674,-21600,EB445137-D7F5-57EC-87DA-1DB460D64046,"iPhone13,2"
com.apple.findmy,14,1707687919,1707687933,1707687934.050019,-21600,EB445137-D7F5-57EC-87DA-1DB460D64046,"iPhone13,2"
com.google.Chrome,356,1707687894,1707688250,1707688250.639355,-21600,,
com.apple.MobileSMS,30,1707687888,1707687918,1707687918.287444,-21600,EB445137-D7F5-57EC-87DA-1DB460D64046,"iPhone13,2"
com.leomehlig.today,13,1707687881,1707687894,1707687894.298631,-21600,,
com.apple.FaceTime,7,1707687874,1707687881,1707687881.774283,-21600,,
com.burbn.instagram,33,1707687158,1707687191,1707687191.3571072,-21600,EB445137-D7F5-57EC-87DA-1DB460D64046,"iPhone13,2"
com.apple.news,34,1707687115,1707687149,1707687149.44852,-21600,EB445137-D7F5-57EC-87DA-1DB460D64046,"iPhone13,2"
com.google.Chrome,374,1707686755,1707687129,1707687129.608234,-21600,,
com.google.Chrome,405,1707685889,1707686294,1707686294.493995,-21600,,
com.leomehlig.today,13,1707685876,1707685889,1707685889.9196138,-21600,,
com.google.Chrome,74,1707685802,1707685876,1707685876.908177,-21600,,
com.leomehlig.today,7,1707685795,1707685802,1707685802.790457,-21600,,
com.apple.news,370,1707685344,1707685714,1707685715.4397268,-21600,EB445137-D7F5-57EC-87DA-1DB460D64046,"iPhone13,2"
com.apple.findmy,11,1707685330,1707685341,1707685341.4984531,-21600,EB445137-D7F5-57EC-87DA-1DB460D64046,"iPhone13,2"
com.intsig.CamScannerLite,39,1707685276,1707685315,1707685315.68153,-21600,EB445137-D7F5-57EC-87DA-1DB460D64046,"iPhone13,2"
com.intsig.CamScannerLite,10,1707685260,1707685270,1707685270.332104,-21600,EB445137-D7F5-57EC-87DA-1DB460D64046,"iPhone13,2"
com.leomehlig.today,351,1707685202,1707685553,1707685553.024823,-21600,,
com.google.Chrome,1,1707685201,1707685202,1707685202.6837602,-21600,,
com.apple.Preview,17,1707685184,1707685201,1707685201.549728,-21600,,
com.google.Chrome,10,1707685174,1707685184,1707685184.542636,-21600,,
com.apple.Preview,7,1707685167,1707685174,1707685174.141951,-21600,,
com.google.Chrome,10,1707685157,1707685167,1707685167.514351,-21600,,
com.apple.Preview,12,1707685145,1707685157,1707685157.824655,-21600,,
com.google.Chrome,6,1707685139,1707685145,1707685145.7152638,-21600,,
com.intsig.CamScannerLite,5,1707684998,1707685003,1707685003.964685,-21600,EB445137-D7F5-57EC-87DA-1DB460D64046,"iPhone13,2"
com.apple.Preview,277,1707684862,1707685139,1707685139.557498,-21600,,
com.google.Chrome,32,1707684830,1707684862,1707684862.446028,-21600,,
com.leomehlig.today,3,1707684827,1707684830,1707684830.710641,-21600,,
com.google.Chrome,1,1707684826,1707684827,1707684827.86509,-21600,,
com.leomehlig.today,7,1707684819,1707684826,1707684826.7491012,-21600,,
com.intsig.CamScannerLite,81,1707684713,1707684794,1707684794.095722,-21600,EB445137-D7F5-57EC-87DA-1DB460D64046,"iPhone13,2"
com.google.Chrome,217,1707684602,1707684819,1707684819.7038321,-21600,,
com.google.Chrome,301,1707684282,1707684583,1707684583.503231,-21600,,
com.leomehlig.today,2,1707684280,1707684282,1707684282.46259,-21600,,
com.google.Chrome,5,1707684275,1707684280,1707684280.5185142,-21600,,
com.apple.finder,1,1707684274,1707684275,1707684275.2936811,-21600,,
com.apple.Preview,297,1707683977,1707684274,1707684274.744329,-21600,,
com.apple.finder,4,1707683973,1707683977,1707683977.605386,-21600,,
com.google.Chrome,151,1707683822,1707683973,1707683973.726067,-21600,,
com.leomehlig.today,2,1707683820,1707683822,1707683822.138564,-21600,,
com.google.Chrome,390,1707683430,1707683820,1707683820.37882,-21600,,
com.google.Chrome,555,1707682874,1707683429,1707683429.5852752,-21600,,
com.microsoft.VSCode,5,1707682869,1707682874,1707682874.684531,-21600,,
com.leomehlig.today,61,1707682808,1707682869,1707682869.157435,-21600,,
com.microsoft.VSCode,9,1707682799,1707682808,1707682808.610276,-21600,,
com.leomehlig.today,13,1707682786,1707682799,1707682799.904145,-21600,,
com.microsoft.VSCode,77,1707682709,1707682786,1707682786.23666,-21600,,
com.google.Chrome,8,1707682701,1707682709,1707682709.089062,-21600,,
com.microsoft.VSCode,15,1707682686,1707682701,1707682701.092937,-21600,,
com.google.Chrome,11,1707682675,1707682686,1707682686.310966,-21600,,
com.microsoft.VSCode,16,1707682659,1707682675,1707682675.28985,-21600,,
com.google.Chrome,1,1707682658,1707682659,1707682659.724979,-21600,,
com.microsoft.VSCode,5,1707682653,1707682658,1707682658.881577,-21600,,
com.google.Chrome,1,1707682652,1707682653,1707682653.562499,-21600,,
com.microsoft.VSCode,3,1707682649,1707682652,1707682652.4900389,-21600,,
com.google.Chrome,4,1707682645,1707682649,1707682649.05506,-21600,,
com.microsoft.VSCode,400,1707682245,1707682645,1707682646.009896,-21600,,
com.google.Chrome,1,1707682244,1707682245,1707682245.2565088,-21600,,
com.microsoft.VSCode,7,1707682237,1707682244,1707682244.147286,-21600,,
com.google.Chrome,0,1707682237,1707682237,1707682237.961057,-21600,,
com.microsoft.VSCode,282,1707681955,1707682237,1707682237.121917,-21600,,
com.apple.Dictionary,1,1707681954,1707681955,1707681955.914034,-21600,,
com.microsoft.VSCode,12,1707681942,1707681954,1707681954.115144,-21600,,
com.google.Chrome,8,1707681934,1707681942,1707681942.3620281,-21600,,
com.microsoft.VSCode,0,1707681934,1707681934,1707681935.0309138,-21600,,
com.apple.Dictionary,1,1707681933,1707681934,1707681934.5879421,-21600,,
com.microsoft.VSCode,104,1707681829,1707681933,1707681933.338731,-21600,,
com.apple.Dictionary,3,1707681826,1707681829,1707681829.343219,-21600,,
com.microsoft.VSCode,79,1707681747,1707681826,1707681826.832753,-21600,,
com.google.Chrome,43,1707681704,1707681747,1707681747.902019,-21600,,
com.microsoft.VSCode,71,1707681633,1707681704,1707681704.336097,-21600,,
com.google.Chrome,36,1707681597,1707681633,1707681633.307405,-21600,,
com.microsoft.VSCode,57,1707681540,1707681597,1707681597.796167,-21600,,
com.google.Chrome,2,1707681538,1707681540,1707681540.697896,-21600,,
com.microsoft.VSCode,2,1707681536,1707681538,1707681539.014512,-21600,,
com.google.Chrome,0,1707681536,1707681536,1707681536.925122,-21600,,
com.microsoft.VSCode,3,1707681533,1707681536,1707681536.133892,-21600,,
com.google.Chrome,2,1707681531,1707681533,1707681533.2654839,-21600,,
com.microsoft.VSCode,7,1707681524,1707681531,1707681532.0273042,-21600,,
com.google.Chrome,2,1707681522,1707681524,1707681524.561022,-21600,,
com.microsoft.VSCode,6,1707681516,1707681522,1707681522.7886639,-21600,,
com.google.Chrome,2,1707681514,1707681516,1707681516.2088618,-21600,,
com.microsoft.VSCode,4,1707681510,1707681514,1707681514.362527,-21600,,
com.google.Chrome,2,1707681508,1707681510,1707681510.7175379,-21600,,
com.microsoft.VSCode,4,1707681504,1707681508,1707681508.450582,-21600,,
com.google.Chrome,25,1707681479,1707681504,1707681504.517918,-21600,,
com.microsoft.VSCode,5,1707681474,1707681479,1707681479.664403,-21600,,
com.google.Chrome,10,1707681464,1707681474,1707681474.338752,-21600,,
com.microsoft.VSCode,18,1707681446,1707681464,1707681465.036155,-21600,,
com.google.Chrome,1,1707681445,1707681446,1707681446.079095,-21600,,
com.microsoft.VSCode,5,1707681440,1707681445,1707681445.190146,-21600,,
com.apple.Dictionary,1,1707681439,1707681440,1707681440.989458,-21600,,
com.microsoft.VSCode,2,1707681437,1707681439,1707681439.507241,-21600,,
com.apple.Dictionary,2,1707681435,1707681437,1707681437.975635,-21600,,
com.microsoft.VSCode,19,1707681416,1707681435,1707681435.789836,-21600,,
com.google.Chrome,0,1707681416,1707681416,1707681416.586981,-21600,,
com.microsoft.VSCode,2,1707681414,1707681416,1707681416.2366009,-21600,,
com.google.Chrome,48,1707681366,1707681414,1707681414.911273,-21600,,
com.microsoft.VSCode,2,1707681364,1707681366,1707681366.123697,-21600,,
com.google.Chrome,6,1707681358,1707681364,1707681364.511625,-21600,,
com.microsoft.VSCode,47,1707681311,1707681358,1707681359.047995,-21600,,
com.google.Chrome,1,1707681310,1707681311,1707681311.1709862,-21600,,
com.microsoft.VSCode,3,1707681307,1707681310,1707681310.2020922,-21600,,
com.google.Chrome,2,1707681305,1707681307,1707681307.749866,-21600,,
com.microsoft.VSCode,10,1707681295,1707681305,1707681306.036345,-21600,,
com.google.Chrome,2,1707681293,1707681295,1707681295.453597,-21600,,
com.microsoft.VSCode,63,1707681230,1707681293,1707681293.9327412,-21600,,
com.google.Chrome,27,1707681203,1707681230,1707681230.291918,-21600,,
com.microsoft.VSCode,244,1707680959,1707681203,1707681203.4415321,-21600,,
com.leomehlig.today,6,1707680953,1707680959,1707680959.288131,-21600,,
com.microsoft.VSCode,122,1707680831,1707680953,1707680953.172323,-21600,,
com.google.Chrome,0,1707680831,1707680831,1707680831.89728,-21600,,
com.microsoft.VSCode,4,1707680827,1707680831,1707680831.451836,-21600,,
com.apple.Dictionary,2,1707680825,1707680827,1707680827.284797,-21600,,
com.microsoft.VSCode,131,1707680694,1707680825,1707680825.762092,-21600,,
com.google.Chrome,1,1707680693,1707680694,1707680694.6025438,-21600,,
com.microsoft.VSCode,941,1707679752,1707680693,1707680693.573515,-21600,,
com.google.Chrome,37,1707679715,1707679752,1707679752.159008,-21600,,
com.microsoft.VSCode,174,1707679541,1707679715,1707679715.502157,-21600,,
com.apple.finder,20,1707679521,1707679541,1707679541.363491,-21600,,
com.apple.archiveutility,0,1707679521,1707679521,1707679521.390836,-21600,,
com.apple.finder,9,1707679512,1707679521,1707679521.113325,-21600,,
com.google.Chrome,50,1707679462,1707679512,1707679512.731883,-21600,,
com.apple.news,5,1707678516,1707678521,1707678522.0383902,-21600,EB445137-D7F5-57EC-87DA-1DB460D64046,"iPhone13,2"
com.apple.news,256,1707678007,1707678263,1707678263.109175,-21600,EB445137-D7F5-57EC-87DA-1DB460D64046,"iPhone13,2"
com.apple.news,7,1707677996,1707678003,1707678003.258312,-21600,EB445137-D7F5-57EC-87DA-1DB460D64046,"iPhone13,2"
com.apple.news,218,1707677752,1707677970,1707677970.881731,-21600,EB445137-D7F5-57EC-87DA-1DB460D64046,"iPhone13,2"
com.burbn.instagram,5,1707677713,1707677718,1707677718.7331839,-21600,EB445137-D7F5-57EC-87DA-1DB460D64046,"iPhone13,2"
com.burbn.instagram,108,1707677250,1707677358,1707677358.394755,-21600,EB445137-D7F5-57EC-87DA-1DB460D64046,"iPhone13,2"
com.leomehlig.today,3,1707677245,1707677248,1707677248.803492,-21600,EB445137-D7F5-57EC-87DA-1DB460D64046,"iPhone13,2"
com.leomehlig.today,109,1707677135,1707677244,1707677245.348827,-21600,EB445137-D7F5-57EC-87DA-1DB460D64046,"iPhone13,2"
com.google.chrome.ios,14,1707677119,1707677133,1707677133.1866,-21600,EB445137-D7F5-57EC-87DA-1DB460D64046,"iPhone13,2"
com.ryansponzilli.DeepSkyCatalog,24,1707677095,1707677119,1707677119.65628,-21600,EB445137-D7F5-57EC-87DA-1DB460D64046,"iPhone13,2"
com.microsoft.Office.Outlook,18,1707677073,1707677091,1707677091.554045,-21600,EB445137-D7F5-57EC-87DA-1DB460D64046,"iPhone13,2"
com.microsoft.Office.Outlook,10,1707677063,1707677073,1707677073.3399282,-21600,EB445137-D7F5-57EC-87DA-1DB460D64046,"iPhone13,2"
Astrospheric.Astrospheric,72,1707676988,1707677060,1707677060.4556599,-21600,EB445137-D7F5-57EC-87DA-1DB460D64046,"iPhone13,2"
com.apple.weather,17,1707676970,1707676987,1707676987.7374601,-21600,EB445137-D7F5-57EC-87DA-1DB460D64046,"iPhone13,2"
com.apple.MobileSMS,3,1707676906,1707676909,1707676909.724547,-21600,EB445137-D7F5-57EC-87DA-1DB460D64046,"iPhone13,2"
com.tier9digital.sundial,5,1707676899,1707676904,1707676904.488358,-21600,EB445137-D7F5-57EC-87DA-1DB460D64046,"iPhone13,2"
com.tier9digital.sundial,6,1707675796,1707675802,1707675802.713503,-21600,EB445137-D7F5-57EC-87DA-1DB460D64046,"iPhone13,2"
Astrospheric.Astrospheric,31,1707675755,1707675786,1707675786.735718,-21600,EB445137-D7F5-57EC-87DA-1DB460D64046,"iPhone13,2"
edu.illinois.rokwire.ios,3,1707675750,1707675753,1707675753.9163861,-21600,EB445137-D7F5-57EC-87DA-1DB460D64046,"iPhone13,2"
edu.illinois.rokwire.ios,20,1707675689,1707675709,1707675709.578999,-21600,EB445137-D7F5-57EC-87DA-1DB460D64046,"iPhone13,2"
com.google.Maps,3,1707675686,1707675689,1707675689.310051,-21600,EB445137-D7F5-57EC-87DA-1DB460D64046,"iPhone13,2"
com.google.Maps,11,1707675492,1707675503,1707675503.395492,-21600,EB445137-D7F5-57EC-87DA-1DB460D64046,"iPhone13,2"
edu.illinois.rokwire.ios,3,1707675485,1707675488,1707675488.104593,-21600,EB445137-D7F5-57EC-87DA-1DB460D64046,"iPhone13,2"
edu.illinois.rokwire.ios,6,1707675429,1707675435,1707675435.734373,-21600,EB445137-D7F5-57EC-87DA-1DB460D64046,"iPhone13,2"
edu.illinois.rokwire.ios,7,1707675421,1707675428,1707675428.269449,-21600,EB445137-D7F5-57EC-87DA-1DB460D64046,"iPhone13,2"
edu.illinois.rokwire.ios,27,1707675120,1707675147,1707675147.964437,-21600,EB445137-D7F5-57EC-87DA-1DB460D64046,"iPhone13,2"
edu.illinois.rokwire.ios,61,1707675027,1707675088,1707675088.7084532,-21600,EB445137-D7F5-57EC-87DA-1DB460D64046,"iPhone13,2"
com.apple.Health,184,1707674349,1707674533,1707674533.676636,-21600,EB445137-D7F5-57EC-87DA-1DB460D64046,"iPhone13,2"
com.google.Chrome,615,1707672292,1707672907,1707672908.526085,-21600,,
com.facebook.Facebook,162,1707671913,1707672075,1707672075.534142,-21600,EB445137-D7F5-57EC-87DA-1DB460D64046,"iPhone13,2"
com.apple.InCallService,145,1707671768,1707671913,1707671913.316113,-21600,EB445137-D7F5-57EC-87DA-1DB460D64046,"iPhone13,2"
com.facebook.Facebook,44,1707671724,1707671768,1707671768.6104388,-21600,EB445137-D7F5-57EC-87DA-1DB460D64046,"iPhone13,2"
com.google.ios.youtube,2550,1707668617,1707671167,1707671167.670455,-21600,EB445137-D7F5-57EC-87DA-1DB460D64046,"iPhone13,2"
com.apple.camera,2,1707668603,1707668605,1707668606.193176,-21600,EB445137-D7F5-57EC-87DA-1DB460D64046,"iPhone13,2"
com.google.ios.youtube,16,1707668600,1707668616,1707668616.853188,-21600,EB445137-D7F5-57EC-87DA-1DB460D64046,"iPhone13,2"
com.google.ios.youtube,10,1707668388,1707668398,1707668398.950657,-21600,EB445137-D7F5-57EC-87DA-1DB460D64046,"iPhone13,2"
com.google.ios.youtube,1298,1707665759,1707667057,1707667057.627118,-21600,EB445137-D7F5-57EC-87DA-1DB460D64046,"iPhone13,2"
com.google.chrome.ios,1,1707665758,1707665759,1707665759.4654,-21600,EB445137-D7F5-57EC-87DA-1DB460D64046,"iPhone13,2"
com.google.ios.youtube,1,1707665757,1707665758,1707665758.556232,-21600,EB445137-D7F5-57EC-87DA-1DB460D64046,"iPhone13,2"
com.google.chrome.ios,2,1707665755,1707665757,1707665757.7139878,-21600,EB445137-D7F5-57EC-87DA-1DB460D64046,"iPhone13,2"
com.google.ios.youtube,97,1707665658,1707665755,1707665755.366809,-21600,EB445137-D7F5-57EC-87DA-1DB460D64046,"iPhone13,2"
com.google.ios.youtube,2496,1707663077,1707665573,1707665573.727662,-21600,EB445137-D7F5-57EC-87DA-1DB460D64046,"iPhone13,2"
com.thestorygraph.thestorygraph,5,1707630269,1707630274,1707630274.542665,-21600,EB445137-D7F5-57EC-87DA-1DB460D64046,"iPhone13,2"
com.google.chrome.ios,70,1707630199,1707630269,1707630270.179243,-21600,EB445137-D7F5-57EC-87DA-1DB460D64046,"iPhone13,2"
com.thestorygraph.thestorygraph,242,1707629957,1707630199,1707630199.875185,-21600,EB445137-D7F5-57EC-87DA-1DB460D64046,"iPhone13,2"
com.google.chrome.ios,132,1707626784,1707626916,1707626916.874722,-21600,EB445137-D7F5-57EC-87DA-1DB460D64046,"iPhone13,2"
com.apple.Health,32,1707626751,1707626783,1707626783.91659,-21600,EB445137-D7F5-57EC-87DA-1DB460D64046,"iPhone13,2"
com.google.ios.youtube,3,1707626745,1707626748,1707626748.9164782,-21600,EB445137-D7F5-57EC-87DA-1DB460D64046,"iPhone13,2"
com.google.ios.youtube,65,1707625786,1707625851,1707625851.786014,-21600,EB445137-D7F5-57EC-87DA-1DB460D64046,"iPhone13,2"
com.google.ios.youtube,0,1707625748,1707625748,1707625748.766385,-21600,EB445137-D7F5-57EC-87DA-1DB460D64046,"iPhone13,2"
com.google.ios.youtube,67,1707625416,1707625483,1707625483.905972,-21600,EB445137-D7F5-57EC-87DA-1DB460D64046,"iPhone13,2"
com.google.ios.youtube,2,1707625001,1707625003,1707625003.996657,-21600,EB445137-D7F5-57EC-87DA-1DB460D64046,"iPhone13,2"
com.google.ios.youtube,10,1707624603,1707624613,1707624613.893249,-21600,EB445137-D7F5-57EC-87DA-1DB460D64046,"iPhone13,2"
com.google.Chrome,545,1707624308,1707624853,1707624853.543757,-21600,,
com.google.ios.youtube,135,1707623844,1707623979,1707623979.928022,-21600,EB445137-D7F5-57EC-87DA-1DB460D64046,"iPhone13,2"
com.google.ios.youtube,1,1707623744,1707623745,1707623745.8579621,-21600,EB445137-D7F5-57EC-87DA-1DB460D64046,"iPhone13,2"
com.google.ios.youtube,3,1707623350,1707623353,1707623353.4797869,-21600,EB445137-D7F5-57EC-87DA-1DB460D64046,"iPhone13,2"
com.google.ios.youtube,7,1707623295,1707623302,1707623302.1567202,-21600,EB445137-D7F5-57EC-87DA-1DB460D64046,"iPhone13,2"
com.google.ios.youtube,6,1707623090,1707623096,1707623096.594115,-21600,EB445137-D7F5-57EC-87DA-1DB460D64046,"iPhone13,2"
com.google.ios.youtube,85,1707622506,1707622591,1707622591.9453979,-21600,EB445137-D7F5-57EC-87DA-1DB460D64046,"iPhone13,2"
com.toyopagroup.picaboo,7,1707622499,1707622506,1707622506.844047,-21600,EB445137-D7F5-57EC-87DA-1DB460D64046,"iPhone13,2"
com.toyopagroup.picaboo,27,1707622366,1707622393,1707622393.53725,-21600,EB445137-D7F5-57EC-87DA-1DB460D64046,"iPhone13,2"
com.google.ios.youtube,8,1707622357,1707622365,1707622365.8483372,-21600,EB445137-D7F5-57EC-87DA-1DB460D64046,"iPhone13,2"
com.google.ios.youtube,179,1707622117,1707622296,1707622296.873663,-21600,EB445137-D7F5-57EC-87DA-1DB460D64046,"iPhone13,2"
com.apple.news,41,1707622052,1707622093,1707622093.757628,-21600,EB445137-D7F5-57EC-87DA-1DB460D64046,"iPhone13,2"
com.apple.news,8,1707622035,1707622043,1707622043.275309,-21600,EB445137-D7F5-57EC-87DA-1DB460D64046,"iPhone13,2"
com.apple.news,1,1707621344,1707621345,1707621345.290807,-21600,EB445137-D7F5-57EC-87DA-1DB460D64046,"iPhone13,2"
com.apple.news,1,1707621334,1707621335,1707621335.9952621,-21600,EB445137-D7F5-57EC-87DA-1DB460D64046,"iPhone13,2"
com.apple.news,1,1707621326,1707621327,1707621327.383188,-21600,EB445137-D7F5-57EC-87DA-1DB460D64046,"iPhone13,2"
com.apple.news,193,1707621011,1707621204,1707621204.743536,-21600,EB445137-D7F5-57EC-87DA-1DB460D64046,"iPhone13,2"
com.apple.news,4,1707620540,1707620544,1707620544.478516,-21600,EB445137-D7F5-57EC-87DA-1DB460D64046,"iPhone13,2"
com.apple.news,100,1707620234,1707620334,1707620334.4110389,-21600,EB445137-D7F5-57EC-87DA-1DB460D64046,"iPhone13,2"
com.apple.news,153,1707619772,1707619925,1707619925.203555,-21600,EB445137-D7F5-57EC-87DA-1DB460D64046,"iPhone13,2"
com.apple.news,919,1707618472,1707619391,1707619391.441473,-21600,EB445137-D7F5-57EC-87DA-1DB460D64046,"iPhone13,2"
com.burbn.instagram,79,1707618339,1707618418,1707618418.159789,-21600,EB445137-D7F5-57EC-87DA-1DB460D64046,"iPhone13,2"
com.burbn.instagram,89,1707617986,1707618075,1707618075.4319181,-21600,EB445137-D7F5-57EC-87DA-1DB460D64046,"iPhone13,2"
com.apple.MobileSMS,3,1707617971,1707617974,1707617974.995491,-21600,EB445137-D7F5-57EC-87DA-1DB460D64046,"iPhone13,2"
co.hinge.mobile.ios,171,1707617522,1707617693,1707617693.938087,-21600,EB445137-D7F5-57EC-87DA-1DB460D64046,"iPhone13,2"
com.facebook.Facebook,6,1707617268,1707617274,1707617274.871918,-21600,EB445137-D7F5-57EC-87DA-1DB460D64046,"iPhone13,2"
com.apple.news,279,1707616988,1707617267,1707617267.176268,-21600,EB445137-D7F5-57EC-87DA-1DB460D64046,"iPhone13,2"
com.apple.news,155,1707616586,1707616741,1707616741.1125798,-21600,EB445137-D7F5-57EC-87DA-1DB460D64046,"iPhone13,2"
com.apple.news,53,1707615810,1707615863,1707615863.089251,-21600,EB445137-D7F5-57EC-87DA-1DB460D64046,"iPhone13,2"
com.apple.news,2,1707615737,1707615739,1707615739.3197598,-21600,EB445137-D7F5-57EC-87DA-1DB460D64046,"iPhone13,2"
com.apple.news,86,1707615596,1707615682,1707615682.736815,-21600,EB445137-D7F5-57EC-87DA-1DB460D64046,"iPhone13,2"
com.apple.news,6,1707615304,1707615310,1707615310.132049,-21600,EB445137-D7F5-57EC-87DA-1DB460D64046,"iPhone13,2"
com.apple.news,3,1707615184,1707615187,1707615187.898922,-21600,EB445137-D7F5-57EC-87DA-1DB460D64046,"iPhone13,2"
com.apple.news,3,1707615110,1707615113,1707615113.597285,-21600,EB445137-D7F5-57EC-87DA-1DB460D64046,"iPhone13,2"
com.apple.news,3,1707614999,1707615002,1707615002.067276,-21600,EB445137-D7F5-57EC-87DA-1DB460D64046,"iPhone13,2"
com.apple.news,69,1707614704,1707614773,1707614773.950541,-21600,EB445137-D7F5-57EC-87DA-1DB460D64046,"iPhone13,2"
com.apple.news,6,1707614629,1707614635,1707614635.984789,-21600,EB445137-D7F5-57EC-87DA-1DB460D64046,"iPhone13,2"
com.apple.news,44,1707614516,1707614560,1707614560.370131,-21600,EB445137-D7F5-57EC-87DA-1DB460D64046,"iPhone13,2"
com.apple.news,1,1707614474,1707614475,1707614475.9345798,-21600,EB445137-D7F5-57EC-87DA-1DB460D64046,"iPhone13,2"
com.apple.news,89,1707614204,1707614293,1707614293.40973,-21600,EB445137-D7F5-57EC-87DA-1DB460D64046,"iPhone13,2"
com.apple.news,2,1707614008,1707614010,1707614010.771511,-21600,EB445137-D7F5-57EC-87DA-1DB460D64046,"iPhone13,2"
com.apple.news,72,1707613847,1707613919,1707613919.580203,-21600,EB445137-D7F5-57EC-87DA-1DB460D64046,"iPhone13,2"
com.apple.news,4,1707613819,1707613823,1707613823.8370628,-21600,EB445137-D7F5-57EC-87DA-1DB460D64046,"iPhone13,2"
com.apple.Fitness,14,1707613702,1707613716,1707613716.992451,-21600,EB445137-D7F5-57EC-87DA-1DB460D64046,"iPhone13,2"
com.apple.Fitness,3,1707613659,1707613662,1707613662.470022,-21600,EB445137-D7F5-57EC-87DA-1DB460D64046,"iPhone13,2"
com.apple.Fitness,30,1707613548,1707613578,1707613578.021105,-21600,EB445137-D7F5-57EC-87DA-1DB460D64046,"iPhone13,2"
com.apple.Fitness,13,1707613494,1707613507,1707613507.8007889,-21600,EB445137-D7F5-57EC-87DA-1DB460D64046,"iPhone13,2"
com.apple.Maps,70,1707613107,1707613177,1707613177.1769528,-21600,EB445137-D7F5-57EC-87DA-1DB460D64046,"iPhone13,2"
com.apple.Health,2,1707613105,1707613107,1707613107.4368858,-21600,EB445137-D7F5-57EC-87DA-1DB460D64046,"iPhone13,2"
com.apple.Health,6,1707612840,1707612846,1707612846.492474,-21600,EB445137-D7F5-57EC-87DA-1DB460D64046,"iPhone13,2"
com.apple.Health,41,1707612793,1707612834,1707612834.60644,-21600,EB445137-D7F5-57EC-87DA-1DB460D64046,"iPhone13,2"
com.apple.Health,54,1707612207,1707612261,1707612261.378608,-21600,EB445137-D7F5-57EC-87DA-1DB460D64046,"iPhone13,2"
com.apple.news,11,1707612192,1707612203,1707612203.7665539,-21600,EB445137-D7F5-57EC-87DA-1DB460D64046,"iPhone13,2"
com.apple.news,8,1707612138,1707612146,1707612146.672029,-21600,EB445137-D7F5-57EC-87DA-1DB460D64046,"iPhone13,2"
com.apple.news,2,1707612136,1707612138,1707612138.050072,-21600,EB445137-D7F5-57EC-87DA-1DB460D64046,"iPhone13,2"
com.apple.news,64,1707612007,1707612071,1707612071.3278952,-21600,EB445137-D7F5-57EC-87DA-1DB460D64046,"iPhone13,2"
com.apple.news,92,1707611392,1707611484,1707611484.159276,-21600,EB445137-D7F5-57EC-87DA-1DB460D64046,"iPhone13,2"
com.apple.news,2,1707611279,1707611281,1707611281.231656,-21600,EB445137-D7F5-57EC-87DA-1DB460D64046,"iPhone13,2"
com.apple.news,3,1707611167,1707611170,1707611170.074595,-21600,EB445137-D7F5-57EC-87DA-1DB460D64046,"iPhone13,2"
com.apple.news,42,1707610877,1707610919,1707610919.737567,-21600,EB445137-D7F5-57EC-87DA-1DB460D64046,"iPhone13,2"
com.apple.news,38,1707610712,1707610750,1707610750.89143,-21600,EB445137-D7F5-57EC-87DA-1DB460D64046,"iPhone13,2"
com.apple.news,5,1707610347,1707610352,1707610352.9471831,-21600,EB445137-D7F5-57EC-87DA-1DB460D64046,"iPhone13,2"
com.apple.news,1,1707610080,1707610081,1707610081.807644,-21600,EB445137-D7F5-57EC-87DA-1DB460D64046,"iPhone13,2"
com.apple.news,102,1707609969,1707610071,1707610071.457346,-21600,EB445137-D7F5-57EC-87DA-1DB460D64046,"iPhone13,2"
com.apple.news,6,1707609726,1707609732,1707609732.372707,-21600,EB445137-D7F5-57EC-87DA-1DB460D64046,"iPhone13,2"
com.apple.news,54,1707609317,1707609371,1707609371.85362,-21600,EB445137-D7F5-57EC-87DA-1DB460D64046,"iPhone13,2"
com.google.chrome.ios,74,1707608821,1707608895,1707608896.037417,-21600,EB445137-D7F5-57EC-87DA-1DB460D64046,"iPhone13,2"
com.apple.news,3,1707608818,1707608821,1707608821.665694,-21600,EB445137-D7F5-57EC-87DA-1DB460D64046,"iPhone13,2"
com.apple.news,1,1707608791,1707608792,1707608792.504781,-21600,EB445137-D7F5-57EC-87DA-1DB460D64046,"iPhone13,2"
com.apple.news,74,1707608145,1707608219,1707608219.973542,-21600,EB445137-D7F5-57EC-87DA-1DB460D64046,"iPhone13,2"
com.google.Chrome,775,1707606079,1707606854,1707606854.713811,-21600,,
com.apple.calculator,24,1707606055,1707606079,1707606079.1754909,-21600,,
com.google.Chrome,1,1707606054,1707606055,1707606055.1768289,-21600,,
com.apple.calculator,2,1707606052,1707606054,1707606054.43437,-21600,,
com.google.Chrome,1,1707606051,1707606052,1707606052.4829102,-21600,,
com.apple.calculator,6,1707606045,1707606051,1707606051.50137,-21600,,
com.google.Chrome,4,1707606041,1707606045,1707606045.660452,-21600,,
com.apple.calculator,2,1707606039,1707606041,1707606041.75774,-21600,,
com.google.Chrome,1,1707606038,1707606039,1707606039.872592,-21600,,
com.apple.calculator,2,1707606036,1707606038,1707606038.481526,-21600,,
com.google.Chrome,1,1707606035,1707606036,1707606036.467123,-21600,,
com.apple.calculator,2,1707606033,1707606035,1707606035.056793,-21600,,
com.google.Chrome,2,1707606031,1707606033,1707606033.3680139,-21600,,
com.apple.calculator,1,1707606030,1707606031,1707606031.9463391,-21600,,
com.google.Chrome,2,1707606028,1707606030,1707606030.017421,-21600,,
com.apple.calculator,2,1707606026,1707606028,1707606028.944742,-21600,,
com.google.Chrome,11,1707606015,1707606026,1707606026.441908,-21600,,
com.apple.calculator,1,1707606014,1707606015,1707606015.726928,-21600,,
com.google.Chrome,79,1707605935,1707606014,1707606014.723796,-21600,,
com.google.Chrome,288,1707601930,1707602218,1707602218.594218,-21600,,
com.apple.finder,113,1707601817,1707601930,1707601930.266988,-21600,,
com.apple.finder,11,1707598549,1707598560,1707598560.4446511,-21600,,
com.google.Chrome,206,1707598343,1707598549,1707598549.440556,-21600,,
com.apple.iCal,26,1707598317,1707598343,1707598344.2085562,-21600,,
com.apple.finder,11,1707598306,1707598317,1707598317.900131,-21600,,
com.google.Chrome,4,1707598302,1707598306,1707598306.979635,-21600,,
com.leomehlig.today,65,1707598237,1707598302,1707598302.631693,-21600,,
com.google.Chrome,26,1707598211,1707598237,1707598237.4177551,-21600,,
com.leomehlig.today,20,1707598191,1707598211,1707598211.4597049,-21600,,
com.apple.Notes,22,1707598169,1707598191,1707598192.006295,-21600,,
com.leomehlig.today,20,1707598149,1707598169,1707598169.462832,-21600,,
com.apple.Notes,11,1707598138,1707598149,1707598149.049228,-21600,,
com.leomehlig.today,217,1707597921,1707598138,1707598138.180242,-21600,,
com.google.Chrome,252,1707597669,1707597921,1707597921.904074,-21600,,
com.apple.Preview,93,1707597576,1707597669,1707597669.8343291,-21600,,
com.google.Chrome,411,1707597165,1707597576,1707597576.107555,-21600,,
com.apple.Preview,2,1707597163,1707597165,1707597165.599743,-21600,,
com.google.Chrome,2,1707597161,1707597163,1707597163.725172,-21600,,
com.apple.Preview,17,1707597144,1707597161,1707597161.4540691,-21600,,
com.google.Chrome,4,1707597140,1707597144,1707597144.042389,-21600,,
com.hnc.Discord,12,1707597128,1707597140,1707597140.361758,-21600,,
com.google.Chrome,135,1707596993,1707597128,1707597128.594316,-21600,,
com.leomehlig.today,1,1707596992,1707596993,1707596993.726588,-21600,,
com.google.Chrome,208,1707596784,1707596992,1707596992.287597,-21600,,
com.leomehlig.today,5,1707596779,1707596784,1707596784.089223,-21600,,
com.google.Chrome,139,1707596640,1707596779,1707596779.9106321,-21600,,
com.hnc.Discord,42,1707596598,1707596640,1707596640.1888309,-21600,,
com.google.Chrome,12,1707596586,1707596598,1707596598.968149,-21600,,
com.google.Chrome,329,1707596114,1707596443,1707596443.4077392,-21600,,
com.leomehlig.today,45,1707596069,1707596114,1707596114.795278,-21600,,
com.google.Chrome,46,1707596023,1707596069,1707596069.243331,-21600,,
com.apple.Preview,236,1707595787,1707596023,1707596023.082655,-21600,,
com.google.Chrome,156,1707595631,1707595787,1707595787.675844,-21600,,
com.google.Chrome,300,1707595231,1707595531,1707595531.315463,-21600,,
com.apple.Preview,48,1707595183,1707595231,1707595231.2272692,-21600,,
com.google.Chrome,7,1707595176,1707595183,1707595183.05099,-21600,,
com.apple.Preview,4,1707595172,1707595176,1707595176.2852778,-21600,,
com.google.Chrome,74,1707595098,1707595172,1707595172.063349,-21600,,
com.apple.Preview,36,1707595062,1707595098,1707595098.067809,-21600,,
com.google.Chrome,25,1707595037,1707595062,1707595062.631119,-21600,,
com.apple.Preview,473,1707594564,1707595037,1707595037.7336779,-21600,,
com.google.Chrome,761,1707593803,1707594564,1707594564.629693,-21600,,
com.apple.Preview,15,1707593788,1707593803,1707593803.5016189,-21600,,
com.google.Chrome,15,1707593773,1707593788,1707593789.003018,-21600,,
com.apple.Preview,479,1707593294,1707593773,1707593773.674922,-21600,,
com.apple.finder,2,1707593292,1707593294,1707593294.362228,-21600,,
com.apple.Preview,1,1707593291,1707593292,1707593292.7277188,-21600,,
com.google.Chrome,495,1707592796,1707593291,1707593291.086784,-21600,,
com.leomehlig.today,23,1707592773,1707592796,1707592796.899428,-21600,,
com.google.Chrome,1232,1707591541,1707592773,1707592773.529352,-21600,,
com.leomehlig.today,60,1707591481,1707591541,1707591541.4116158,-21600,,
com.google.Chrome,3,1707591478,1707591481,1707591481.385997,-21600,,
com.google.Chrome,635,1707540441,1707541076,1707541076.752687,-21600,,
com.google.Chrome,6,1707513874,1707513880,1707513880.2565808,-21600,,
com.google.Chrome,521,1707513269,1707513790,1707513790.872371,-21600,,
com.google.Chrome,59,1707504722,1707504781,1707504781.6324701,-21600,,
com.leomehlig.today,317,1707504405,1707504722,1707504722.1117558,-21600,,
com.google.Chrome,1,1707504404,1707504405,1707504406.025378,-21600,,
com.apple.finder,3,1707504401,1707504404,1707504404.170717,-21600,,
com.apple.Preview,555,1707503846,1707504401,1707504401.6473022,-21600,,
com.apple.finder,1,1707503845,1707503846,1707503846.900566,-21600,,
com.google.Chrome,59,1707503786,1707503845,1707503845.2464972,-21600,,
com.apple.iCal,120,1707503666,1707503786,1707503786.495411,-21600,,
com.google.Chrome,9,1707503657,1707503666,1707503666.180553,-21600,,
com.google.Chrome,85,1707495878,1707495963,1707495963.51706,-21600,,
com.google.Chrome,419,1707495414,1707495833,1707495833.72122,-21600,,
com.peacocktv.peacock,10,1707494920,1707494930,1707494930.705148,-21600,EB445137-D7F5-57EC-87DA-1DB460D64046,"iPhone13,2"
com.peacocktv.peacock,10,1707494355,1707494365,1707494365.11779,-21600,EB445137-D7F5-57EC-87DA-1DB460D64046,"iPhone13,2"
com.peacocktv.peacock,13,1707493777,1707493790,1707493790.5296621,-21600,EB445137-D7F5-57EC-87DA-1DB460D64046,"iPhone13,2"
com.google.Chrome,688,1707493079,1707493767,1707493767.625958,-21600,,
com.peacocktv.peacock,1,1707492154,1707492155,1707492155.68259,-21600,EB445137-D7F5-57EC-87DA-1DB460D64046,"iPhone13,2"
com.peacocktv.peacock,1486,1707490664,1707492150,1707492150.446004,-21600,EB445137-D7F5-57EC-87DA-1DB460D64046,"iPhone13,2"
com.apple.weather,15,1707490642,1707490657,1707490657.510423,-21600,EB445137-D7F5-57EC-87DA-1DB460D64046,"iPhone13,2"
com.apple.weather,9,1707490380,1707490389,1707490389.3288078,-21600,EB445137-D7F5-57EC-87DA-1DB460D64046,"iPhone13,2"
com.thestorygraph.thestorygraph,9,1707490362,1707490371,1707490371.2586222,-21600,EB445137-D7F5-57EC-87DA-1DB460D64046,"iPhone13,2"
com.apple.Health,43,1707490290,1707490333,1707490334.027371,-21600,EB445137-D7F5-57EC-87DA-1DB460D64046,"iPhone13,2"
com.apple.Health,2,1707490287,1707490289,1707490289.830226,-21600,EB445137-D7F5-57EC-87DA-1DB460D64046,"iPhone13,2"
com.microsoft.Office.Outlook,47,1707490226,1707490273,1707490273.3238258,-21600,EB445137-D7F5-57EC-87DA-1DB460D64046,"iPhone13,2"
com.thestorygraph.thestorygraph,25,1707456276,1707456301,1707456302.048373,-21600,EB445137-D7F5-57EC-87DA-1DB460D64046,"iPhone13,2"
com.apple.news,246,1707454635,1707454881,1707454882.243653,-21600,EB445137-D7F5-57EC-87DA-1DB460D64046,"iPhone13,2"
com.whentowork.iOS.WhenToWork-Employee-Scheduling,6,1707454477,1707454483,1707454483.042026,-21600,EB445137-D7F5-57EC-87DA-1DB460D64046,"iPhone13,2"
com.microsoft.Office.Outlook,6,1707454467,1707454473,1707454473.193674,-21600,EB445137-D7F5-57EC-87DA-1DB460D64046,"iPhone13,2"
com.apple.Health,32,1707454433,1707454465,1707454465.8090339,-21600,EB445137-D7F5-57EC-87DA-1DB460D64046,"iPhone13,2"
com.google.Chrome,1280,1707450906,1707452186,1707452187.180579,-21600,,
com.apple.mobilecal,44,1707450178,1707450222,1707450222.820785,-21600,EB445137-D7F5-57EC-87DA-1DB460D64046,"iPhone13,2"
com.apple.Health,32,1707449858,1707449890,1707449890.779845,-21600,EB445137-D7F5-57EC-87DA-1DB460D64046,"iPhone13,2"
com.toyopagroup.picaboo,22,1707449561,1707449583,1707449583.408654,-21600,EB445137-D7F5-57EC-87DA-1DB460D64046,"iPhone13,2"
com.google.Chrome,440,1707449534,1707449974,1707449974.435616,-21600,,
us.zoom.xos,3,1707449531,1707449534,1707449534.212425,-21600,,
com.google.Chrome,16,1707449515,1707449531,1707449531.2502198,-21600,,
us.zoom.xos,6,1707449509,1707449515,1707449515.816493,-21600,,
com.apple.MobileSMS,50,1707449451,1707449501,1707449501.7637,-21600,EB445137-D7F5-57EC-87DA-1DB460D64046,"iPhone13,2"
com.apple.MobileSMS,10,1707449117,1707449127,1707449127.457247,-21600,EB445137-D7F5-57EC-87DA-1DB460D64046,"iPhone13,2"
com.apple.MobileSMS,4,1707448977,1707448981,1707448981.980988,-21600,EB445137-D7F5-57EC-87DA-1DB460D64046,"iPhone13,2"
com.apple.MobileSMS,1,1707448964,1707448965,1707448965.7429981,-21600,EB445137-D7F5-57EC-87DA-1DB460D64046,"iPhone13,2"
com.apple.MobileSMS,3,1707448890,1707448893,1707448893.169209,-21600,EB445137-D7F5-57EC-87DA-1DB460D64046,"iPhone13,2"
com.apple.MobileSMS,2,1707448856,1707448858,1707448858.695766,-21600,EB445137-D7F5-57EC-87DA-1DB460D64046,"iPhone13,2"
com.apple.MobileSMS,18,1707448616,1707448634,1707448634.258916,-21600,EB445137-D7F5-57EC-87DA-1DB460D64046,"iPhone13,2"
com.apple.MobileSMS,1,1707448612,1707448613,1707448613.934856,-21600,EB445137-D7F5-57EC-87DA-1DB460D64046,"iPhone13,2"
com.apple.MobileSMS,12,1707448515,1707448527,1707448527.4001021,-21600,EB445137-D7F5-57EC-87DA-1DB460D64046,"iPhone13,2"
com.apple.MobileSMS,47,1707448396,1707448443,1707448443.084162,-21600,EB445137-D7F5-57EC-87DA-1DB460D64046,"iPhone13,2"
com.apple.MobileSMS,16,1707448307,1707448323,1707448323.016645,-21600,EB445137-D7F5-57EC-87DA-1DB460D64046,"iPhone13,2"
com.apple.MobileSMS,13,1707448271,1707448284,1707448284.4509149,-21600,EB445137-D7F5-57EC-87DA-1DB460D64046,"iPhone13,2"
com.apple.MobileSMS,1,1707448216,1707448217,1707448217.79141,-21600,EB445137-D7F5-57EC-87DA-1DB460D64046,"iPhone13,2"
com.apple.camera,1,1707448211,1707448212,1707448212.084268,-21600,EB445137-D7F5-57EC-87DA-1DB460D64046,"iPhone13,2"
com.apple.MobileSMS,12,1707448170,1707448182,1707448182.981169,-21600,EB445137-D7F5-57EC-87DA-1DB460D64046,"iPhone13,2"
com.apple.MobileSMS,27,1707448128,1707448155,1707448156.04393,-21600,EB445137-D7F5-57EC-87DA-1DB460D64046,"iPhone13,2"
co.hinge.mobile.ios,45,1707448081,1707448126,1707448127.012604,-21600,EB445137-D7F5-57EC-87DA-1DB460D64046,"iPhone13,2"
com.thestorygraph.thestorygraph,9,1707448070,1707448079,1707448079.3836079,-21600,EB445137-D7F5-57EC-87DA-1DB460D64046,"iPhone13,2"
com.google.chrome.ios,19,1707448048,1707448067,1707448067.996973,-21600,EB445137-D7F5-57EC-87DA-1DB460D64046,"iPhone13,2"
com.apple.MobileSMS,64,1707447980,1707448044,1707448044.979282,-21600,EB445137-D7F5-57EC-87DA-1DB460D64046,"iPhone13,2"
com.apple.MobileSMS,9,1707447706,1707447715,1707447715.2096062,-21600,EB445137-D7F5-57EC-87DA-1DB460D64046,"iPhone13,2"
com.apple.camera,1,1707447703,1707447704,1707447704.301095,-21600,EB445137-D7F5-57EC-87DA-1DB460D64046,"iPhone13,2"
com.apple.MobileSMS,41,1707447665,1707447706,1707447706.235623,-21600,EB445137-D7F5-57EC-87DA-1DB460D64046,"iPhone13,2"
com.apple.MobileSMS,22,1707447641,1707447663,1707447663.6184402,-21600,EB445137-D7F5-57EC-87DA-1DB460D64046,"iPhone13,2"
com.apple.MobileSMS,3,1707447624,1707447627,1707447627.5702739,-21600,EB445137-D7F5-57EC-87DA-1DB460D64046,"iPhone13,2"
com.apple.MobileSMS,33,1707447538,1707447571,1707447571.7122688,-21600,EB445137-D7F5-57EC-87DA-1DB460D64046,"iPhone13,2"
com.apple.findmy,12,1707447211,1707447223,1707447223.69518,-21600,EB445137-D7F5-57EC-87DA-1DB460D64046,"iPhone13,2"
co.hinge.mobile.ios,7,1707446953,1707446960,1707446960.631779,-21600,EB445137-D7F5-57EC-87DA-1DB460D64046,"iPhone13,2"
co.hinge.mobile.ios,4,1707446433,1707446437,1707446437.172007,-21600,EB445137-D7F5-57EC-87DA-1DB460D64046,"iPhone13,2"
us.zoom.xos,4,1707426861,1707426865,1707426865.8623319,-21600,,
us.zoom.xos,469,1707425930,1707426399,1707426399.155003,-21600,,
us.zoom.xos,356,1707425349,1707425705,1707425705.651566,-21600,,
com.google.Chrome,2,1707425347,1707425349,1707425349.270436,-21600,,
us.zoom.xos,1,1707425346,1707425347,1707425347.164983,-21600,,
com.google.Chrome,23,1707425323,1707425346,1707425346.106935,-21600,,
us.zoom.xos,598,1707424725,1707425323,1707425323.952156,-21600,,
us.zoom.xos,825,1707422720,1707423545,1707423545.759846,-21600,,
com.google.Chrome,13,1707422707,1707422720,1707422720.223969,-21600,,
us.zoom.xos,2,1707422705,1707422707,1707422707.1960502,-21600,,
com.google.Chrome,1,1707422704,1707422705,1707422705.629324,-21600,,
us.zoom.xos,22,1707422682,1707422704,1707422704.126931,-21600,,
com.google.Chrome,2,1707422680,1707422682,1707422682.367535,-21600,,
us.zoom.xos,1,1707422679,1707422680,1707422680.9052238,-21600,,
com.google.Chrome,29,1707422650,1707422679,1707422679.521658,-21600,,
com.google.Chrome,2385,1707414725,1707417110,1707417111.315679,-21600,,
com.leomehlig.today,103,1707414622,1707414725,1707414725.532553,-21600,,
com.google.Chrome,71,1707414551,1707414622,1707414622.5862699,-21600,,
com.apple.Preview,8,1707414543,1707414551,1707414551.989326,-21600,,
com.apple.finder,7,1707414536,1707414543,1707414543.106454,-21600,,
com.apple.archiveutility,1,1707414535,1707414536,1707414536.345334,-21600,,
com.apple.finder,8,1707414527,1707414535,1707414536.02279,-21600,,
com.google.Chrome,17,1707414510,1707414527,1707414527.3379068,-21600,,
com.leomehlig.today,39,1707414471,1707414510,1707414510.947722,-21600,,
com.google.Chrome,4,1707414467,1707414471,1707414472.270259,-21600,,
com.google.Chrome,22,1707412100,1707412122,1707412122.808249,-21600,,
com.apple.Preview,44,1707412056,1707412100,1707412100.925709,-21600,,
com.apple.finder,2,1707412054,1707412056,1707412056.098105,-21600,,
com.google.Chrome,10,1707412044,1707412054,1707412054.128701,-21600,,
com.apple.finder,2,1707412042,1707412044,1707412044.512377,-21600,,
com.google.Chrome,1,1707412041,1707412042,1707412043.0964808,-21600,,
com.apple.finder,15,1707412026,1707412041,1707412041.430727,-21600,,
com.google.Chrome,1,1707412025,1707412026,1707412026.415821,-21600,,
com.apple.finder,8,1707412017,1707412025,1707412025.5181298,-21600,,
com.google.Chrome,16,1707412001,1707412017,1707412017.107283,-21600,,
com.apple.Preview,17,1707411984,1707412001,1707412001.575788,-21600,,
com.apple.finder,4,1707411980,1707411984,1707411984.3271651,-21600,,
com.apple.Preview,12,1707411968,1707411980,1707411980.803522,-21600,,
com.google.Chrome,1,1707411967,1707411968,1707411968.7097092,-21600,,
com.apple.Preview,14,1707411953,1707411967,1707411967.30231,-21600,,
com.google.Chrome,1,1707411952,1707411953,1707411953.812683,-21600,,
com.apple.Preview,0,1707411952,1707411952,1707411953.01022,-21600,,
com.google.Chrome,1,1707411951,1707411952,1707411952.55913,-21600,,
com.apple.Preview,1,1707411950,1707411951,1707411952.033843,-21600,,
com.google.Chrome,1,1707411949,1707411950,1707411950.0435839,-21600,,
com.apple.Preview,3,1707411946,1707411949,1707411949.593766,-21600,,
com.google.Chrome,6,1707411940,1707411946,1707411946.598093,-21600,,
com.apple.Preview,2,1707411938,1707411940,1707411940.3515081,-21600,,
com.google.Chrome,1,1707411937,1707411938,1707411938.288889,-21600,,
com.apple.Preview,1,1707411936,1707411937,1707411937.776161,-21600,,
com.google.Chrome,2,1707411934,1707411936,1707411936.4770842,-21600,,
com.apple.Preview,29,1707411905,1707411934,1707411934.443896,-21600,,
com.google.Chrome,4,1707411901,1707411905,1707411905.942051,-21600,,
com.apple.Preview,9,1707411892,1707411901,1707411901.200511,-21600,,
com.google.Chrome,2,1707411890,1707411892,1707411892.757577,-21600,,
com.apple.Preview,3,1707411887,1707411890,1707411890.5946522,-21600,,
com.google.Chrome,12,1707411875,1707411887,1707411887.0910568,-21600,,
com.apple.Preview,4,1707411871,1707411875,1707411876.028109,-21600,,
com.google.Chrome,1,1707411870,1707411871,1707411872.010343,-21600,,
com.apple.Preview,1,1707411869,1707411870,1707411870.1974921,-21600,,
com.google.Chrome,2,1707411867,1707411869,1707411869.4723768,-21600,,
com.apple.Preview,9,1707411858,1707411867,1707411867.743686,-21600,,
com.google.Chrome,4,1707411854,1707411858,1707411859.028611,-21600,,
com.apple.Preview,0,1707411854,1707411854,1707411854.8505778,-21600,,
com.google.Chrome,2,1707411852,1707411854,1707411854.230729,-21600,,
com.apple.Preview,3,1707411849,1707411852,1707411852.883,-21600,,
com.google.Chrome,4,1707411845,1707411849,1707411849.599318,-21600,,
com.apple.Preview,3,1707411842,1707411845,1707411845.9743152,-21600,,
com.google.Chrome,12,1707411830,1707411842,1707411842.19927,-21600,,
com.apple.Preview,7,1707411823,1707411830,1707411830.5120568,-21600,,
com.google.Chrome,4,1707411819,1707411823,1707411823.9534512,-21600,,
com.apple.Preview,1,1707411818,1707411819,1707411819.7001262,-21600,,
com.google.Chrome,0,1707411818,1707411818,1707411818.823807,-21600,,
com.apple.Preview,4,1707411814,1707411818,1707411818.4133139,-21600,,
com.google.Chrome,6,1707411808,1707411814,1707411814.544805,-21600,,
com.apple.Preview,3,1707411805,1707411808,1707411808.258109,-21600,,
com.google.Chrome,8,1707411797,1707411805,1707411805.2721062,-21600,,
com.apple.Preview,7,1707411790,1707411797,1707411797.28293,-21600,,
com.google.Chrome,39,1707411751,1707411790,1707411790.089768,-21600,,
com.apple.Preview,91,1707411660,1707411751,1707411752.028862,-21600,,
com.google.Chrome,3,1707411657,1707411660,1707411660.7832541,-21600,,
com.apple.Preview,2,1707411655,1707411657,1707411658.032928,-21600,,
com.google.Chrome,2,1707411653,1707411655,1707411655.621894,-21600,,
com.apple.Preview,4,1707411649,1707411653,1707411653.175521,-21600,,
com.google.Chrome,3,1707411646,1707411649,1707411649.410202,-21600,,
com.apple.Preview,6,1707411640,1707411646,1707411646.874865,-21600,,
com.google.Chrome,3,1707411637,1707411640,1707411640.4080958,-21600,,
com.apple.Preview,6,1707411631,1707411637,1707411637.121817,-21600,,
com.google.Chrome,21,1707411610,1707411631,1707411631.620178,-21600,,
com.apple.Preview,1,1707411609,1707411610,1707411610.7505379,-21600,,
com.google.Chrome,1,1707411608,1707411609,1707411609.391741,-21600,,
com.apple.Preview,10,1707411598,1707411608,1707411608.793188,-21600,,
com.google.Chrome,6,1707411592,1707411598,1707411598.069693,-21600,,
com.apple.Preview,36,1707411556,1707411592,1707411592.680677,-21600,,
com.google.Chrome,18,1707411538,1707411556,1707411556.971309,-21600,,
com.apple.Preview,42,1707411496,1707411538,1707411538.815978,-21600,,
com.apple.finder,6,1707411490,1707411496,1707411496.106254,-21600,,
com.apple.Preview,80,1707411410,1707411490,1707411490.76132,-21600,,
com.apple.finder,0,1707411410,1707411410,1707411410.769171,-21600,,
com.apple.Preview,106,1707411304,1707411410,1707411410.228225,-21600,,
com.apple.finder,7,1707411297,1707411304,1707411304.46228,-21600,,
com.apple.Preview,555,1707410742,1707411297,1707411297.3097072,-21600,,
com.apple.finder,0,1707410742,1707410742,1707410742.906808,-21600,,
com.apple.Preview,268,1707410474,1707410742,1707410742.113037,-21600,,
com.apple.finder,1,1707410473,1707410474,1707410474.619944,-21600,,
com.apple.Preview,192,1707410281,1707410473,1707410473.8829908,-21600,,
com.apple.finder,1,1707410280,1707410281,1707410281.905352,-21600,,
com.apple.Preview,148,1707410132,1707410280,1707410280.21563,-21600,,
com.apple.finder,3,1707410129,1707410132,1707410132.928193,-21600,,
com.apple.Preview,1207,1707408922,1707410129,1707410129.085696,-21600,,
com.google.Chrome,181,1707408741,1707408922,1707408922.825882,-21600,,
com.apple.Health,65,1707408497,1707408562,1707408562.561791,-21600,EB445137-D7F5-57EC-87DA-1DB460D64046,"iPhone13,2"
com.apple.Preview,620,1707408121,1707408741,1707408741.666024,-21600,,
com.google.Chrome,127,1707407994,1707408121,1707408121.326678,-21600,,
com.apple.Preview,129,1707407865,1707407994,1707407994.412795,-21600,,
com.apple.finder,43,1707407822,1707407865,1707407865.1051621,-21600,,
com.google.Chrome,2,1707407820,1707407822,1707407822.979032,-21600,,
com.apple.Preview,11,1707407809,1707407820,1707407820.123797,-21600,,
com.apple.finder,3,1707407806,1707407809,1707407809.4702702,-21600,,
com.apple.Preview,5,1707407801,1707407806,1707407806.3029451,-21600,,
com.apple.finder,15,1707407786,1707407801,1707407801.595664,-21600,,
com.apple.iWork.Numbers,5,1707407781,1707407786,1707407786.422512,-21600,,
com.apple.finder,34,1707407747,1707407781,1707407781.886857,-21600,,
com.google.Chrome,125,1707407622,1707407747,1707407747.8589349,-21600,,
com.apple.news,216,1707407316,1707407532,1707407533.022502,-21600,EB445137-D7F5-57EC-87DA-1DB460D64046,"iPhone13,2"
com.burbn.instagram,67,1707407233,1707407300,1707407300.9057732,-21600,EB445137-D7F5-57EC-87DA-1DB460D64046,"iPhone13,2"
com.apple.MobileSMS,32,1707407199,1707407231,1707407231.97856,-21600,EB445137-D7F5-57EC-87DA-1DB460D64046,"iPhone13,2"
com.apple.weather,14,1707407185,1707407199,1707407199.583715,-21600,EB445137-D7F5-57EC-87DA-1DB460D64046,"iPhone13,2"
com.apple.weather,1,1707405870,1707405871,1707405871.717784,-21600,EB445137-D7F5-57EC-87DA-1DB460D64046,"iPhone13,2"
com.apple.weather,7,1707405842,1707405849,1707405849.440294,-21600,EB445137-D7F5-57EC-87DA-1DB460D64046,"iPhone13,2"
com.apple.news,444,1707405392,1707405836,1707405836.57793,-21600,EB445137-D7F5-57EC-87DA-1DB460D64046,"iPhone13,2"
com.google.chrome.ios,76,1707405316,1707405392,1707405392.9482942,-21600,EB445137-D7F5-57EC-87DA-1DB460D64046,"iPhone13,2"
com.apple.news,38,1707405278,1707405316,1707405316.448519,-21600,EB445137-D7F5-57EC-87DA-1DB460D64046,"iPhone13,2"
com.google.Chrome,28,1707405228,1707405256,1707405256.581424,-21600,,
com.apple.iCal,2,1707405226,1707405228,1707405228.535791,-21600,,
com.leomehlig.today,73,1707405153,1707405226,1707405226.222882,-21600,,
com.apple.iCal,4,1707405149,1707405153,1707405153.857181,-21600,,
com.google.Chrome,43,1707405106,1707405149,1707405149.668006,-21600,,
com.apple.AppStore,32,1707405057,1707405089,1707405089.409709,-21600,EB445137-D7F5-57EC-87DA-1DB460D64046,"iPhone13,2"
com.apple.Health,10,1707405019,1707405029,1707405029.886595,-21600,EB445137-D7F5-57EC-87DA-1DB460D64046,"iPhone13,2"
com.apple.Health,34,1707370419,1707370453,1707370453.1527781,-21600,EB445137-D7F5-57EC-87DA-1DB460D64046,"iPhone13,2"
com.goodreads.Goodreads,52,1707370351,1707370403,1707370403.863673,-21600,EB445137-D7F5-57EC-87DA-1DB460D64046,"iPhone13,2"
com.thestorygraph.thestorygraph,28,1707370321,1707370349,1707370349.3697782,-21600,EB445137-D7F5-57EC-87DA-1DB460D64046,"iPhone13,2"
co.hinge.mobile.ios,123,1707368987,1707369110,1707369110.65844,-21600,EB445137-D7F5-57EC-87DA-1DB460D64046,"iPhone13,2"
com.thestorygraph.thestorygraph,5,1707368972,1707368977,1707368977.590956,-21600,EB445137-D7F5-57EC-87DA-1DB460D64046,"iPhone13,2"
com.thestorygraph.thestorygraph,47,1707368907,1707368954,1707368954.2993321,-21600,EB445137-D7F5-57EC-87DA-1DB460D64046,"iPhone13,2"
com.apple.Health,35,1707368860,1707368895,1707368895.302723,-21600,EB445137-D7F5-57EC-87DA-1DB460D64046,"iPhone13,2"
com.apple.Health,11,1707368686,1707368697,1707368697.512511,-21600,EB445137-D7F5-57EC-87DA-1DB460D64046,"iPhone13,2"
com.apple.Health,3,1707367584,1707367587,1707367587.892694,-21600,EB445137-D7F5-57EC-87DA-1DB460D64046,"iPhone13,2"
com.apple.Health,3,1707367156,1707367159,1707367159.717152,-21600,EB445137-D7F5-57EC-87DA-1DB460D64046,"iPhone13,2"
com.apple.Health,6,1707366604,1707366610,1707366610.884238,-21600,EB445137-D7F5-57EC-87DA-1DB460D64046,"iPhone13,2"
com.apple.Health,10,1707366421,1707366431,1707366431.9283972,-21600,EB445137-D7F5-57EC-87DA-1DB460D64046,"iPhone13,2"
co.hinge.mobile.ios,5,1707366351,1707366356,1707366356.2176728,-21600,EB445137-D7F5-57EC-87DA-1DB460D64046,"iPhone13,2"
com.google.Chrome,340,1707365986,1707366326,1707366327.247974,-21600,,
com.apple.MobileSMS,24,1707365962,1707365986,1707365986.18961,-21600,,
com.google.Chrome,1,1707365961,1707365962,1707365962.119832,-21600,,
com.apple.MobileSMS,20,1707365941,1707365961,1707365961.2323232,-21600,,
com.google.Chrome,17,1707365924,1707365941,1707365941.517261,-21600,,
co.hinge.mobile.ios,3,1707364582,1707364585,1707364585.891992,-21600,EB445137-D7F5-57EC-87DA-1DB460D64046,"iPhone13,2"
com.apple.Music,4,1707364574,1707364578,1707364578.430506,-21600,EB445137-D7F5-57EC-87DA-1DB460D64046,"iPhone13,2"
com.google.Chrome,1311,1707364486,1707365797,1707365797.404793,-21600,,
com.apple.MobileSMS,5,1707364481,1707364486,1707364486.2424269,-21600,,
com.apple.finder,1,1707364480,1707364481,1707364481.2586842,-21600,,
com.apple.Music,5,1707364474,1707364479,1707364479.3633618,-21600,EB445137-D7F5-57EC-87DA-1DB460D64046,"iPhone13,2"
com.apple.Music,10,1707363340,1707363350,1707363350.514296,-21600,EB445137-D7F5-57EC-87DA-1DB460D64046,"iPhone13,2"
com.apple.Music,13,1707363321,1707363334,1707363334.3568292,-21600,EB445137-D7F5-57EC-87DA-1DB460D64046,"iPhone13,2"
com.apple.finder,11,1707363152,1707363163,1707363163.662929,-21600,,
com.google.Chrome,2,1707363150,1707363152,1707363152.221389,-21600,,
com.leomehlig.today,188,1707362962,1707363150,1707363150.547456,-21600,,
com.google.Chrome,6,1707362956,1707362962,1707362962.161802,-21600,,
com.microsoft.Office.Outlook,2,1707362899,1707362901,1707362901.7397509,-21600,EB445137-D7F5-57EC-87DA-1DB460D64046,"iPhone13,2"
com.microsoft.Office.Outlook,24,1707362870,1707362894,1707362894.856166,-21600,EB445137-D7F5-57EC-87DA-1DB460D64046,"iPhone13,2"
com.apple.Preview,720,1707362236,1707362956,1707362957.01196,-21600,,
com.google.Chrome,1,1707362235,1707362236,1707362236.8331451,-21600,,
com.leomehlig.today,14,1707362221,1707362235,1707362235.289247,-21600,,
com.apple.Preview,15,1707362206,1707362221,1707362221.6454139,-21600,,
com.apple.finder,7,1707362199,1707362206,1707362206.064701,-21600,,
com.apple.Preview,2,1707362197,1707362199,1707362199.484756,-21600,,
com.google.Chrome,1065,1707361132,1707362197,1707362197.486388,-21600,,
com.leomehlig.today,10,1707361122,1707361132,1707361132.76572,-21600,,
co.hinge.mobile.ios,4,1707361053,1707361057,1707361057.8847241,-21600,EB445137-D7F5-57EC-87DA-1DB460D64046,"iPhone13,2"
com.toyopagroup.picaboo,24,1707360803,1707360827,1707360827.898305,-21600,EB445137-D7F5-57EC-87DA-1DB460D64046,"iPhone13,2"
com.google.Chrome,451,1707360671,1707361122,1707361122.8597322,-21600,,
com.leomehlig.today,41,1707360630,1707360671,1707360671.357976,-21600,,
com.microsoft.VSCode,252,1707360378,1707360630,1707360630.1437612,-21600,,
com.leomehlig.today,0,1707360378,1707360378,1707360379.009173,-21600,,
com.microsoft.VSCode,38,1707360340,1707360378,1707360378.3514152,-21600,,
com.leomehlig.today,0,1707360340,1707360340,1707360340.959091,-21600,,
com.google.Chrome,1,1707360339,1707360340,1707360340.221262,-21600,,
com.leomehlig.today,1,1707360338,1707360339,1707360339.500211,-21600,,
com.microsoft.VSCode,65,1707360273,1707360338,1707360338.471349,-21600,,
com.leomehlig.today,1,1707360272,1707360273,1707360273.761096,-21600,,
com.microsoft.VSCode,594,1707359678,1707360272,1707360273.048945,-21600,,
com.apple.news,264,1707359325,1707359589,1707359589.47048,-21600,EB445137-D7F5-57EC-87DA-1DB460D64046,"iPhone13,2"
com.instructure.icanvas,4,1707359259,1707359263,1707359263.350216,-21600,EB445137-D7F5-57EC-87DA-1DB460D64046,"iPhone13,2"
com.instructure.icanvas,6,1707359205,1707359211,1707359211.2149138,-21600,EB445137-D7F5-57EC-87DA-1DB460D64046,"iPhone13,2"
com.instructure.icanvas,5,1707359185,1707359190,1707359190.718217,-21600,EB445137-D7F5-57EC-87DA-1DB460D64046,"iPhone13,2"
com.instructure.icanvas,5,1707359171,1707359176,1707359176.709423,-21600,EB445137-D7F5-57EC-87DA-1DB460D64046,"iPhone13,2"
com.microsoft.VSCode,312,1707359158,1707359470,1707359470.2685308,-21600,,
com.leomehlig.today,2,1707359156,1707359158,1707359158.971374,-21600,,
com.instructure.icanvas,14,1707358772,1707358786,1707358786.9317799,-21600,EB445137-D7F5-57EC-87DA-1DB460D64046,"iPhone13,2"
co.hinge.mobile.ios,4,1707358768,1707358772,1707358772.485105,-21600,EB445137-D7F5-57EC-87DA-1DB460D64046,"iPhone13,2"
com.microsoft.VSCode,679,1707358477,1707359156,1707359156.401803,-21600,,
com.google.Chrome,17,1707358460,1707358477,1707358478.041198,-21600,,
com.microsoft.VSCode,0,1707358460,1707358460,1707358460.776923,-21600,,
com.google.Chrome,15,1707358445,1707358460,1707358460.130475,-21600,,
com.microsoft.VSCode,6,1707358439,1707358445,1707358445.0453548,-21600,,
com.google.Chrome,21,1707358418,1707358439,1707358439.312989,-21600,,
com.microsoft.VSCode,21,1707358397,1707358418,1707358418.207092,-21600,,
com.google.Chrome,2,1707358395,1707358397,1707358397.654089,-21600,,
com.microsoft.VSCode,6,1707358389,1707358395,1707358395.74691,-21600,,
com.google.Chrome,87,1707358302,1707358389,1707358389.3133821,-21600,,
com.microsoft.VSCode,51,1707358251,1707358302,1707358302.419013,-21600,,
com.leomehlig.today,1,1707358250,1707358251,1707358251.6477609,-21600,,
co.hinge.mobile.ios,10,1707358138,1707358148,1707358148.453351,-21600,EB445137-D7F5-57EC-87DA-1DB460D64046,"iPhone13,2"
co.hinge.mobile.ios,6,1707357689,1707357695,1707357695.38624,-21600,EB445137-D7F5-57EC-87DA-1DB460D64046,"iPhone13,2"
co.hinge.mobile.ios,6,1707357036,1707357042,1707357042.4272928,-21600,EB445137-D7F5-57EC-87DA-1DB460D64046,"iPhone13,2"
com.microsoft.VSCode,1425,1707356825,1707358250,1707358250.7984571,-21600,,
co.hinge.mobile.ios,38,1707356786,1707356824,1707356824.507402,-21600,EB445137-D7F5-57EC-87DA-1DB460D64046,"iPhone13,2"
com.google.chrome.ios,258,1707356528,1707356786,1707356786.338943,-21600,EB445137-D7F5-57EC-87DA-1DB460D64046,"iPhone13,2"
co.hinge.mobile.ios,65,1707356463,1707356528,1707356528.4431791,-21600,EB445137-D7F5-57EC-87DA-1DB460D64046,"iPhone13,2"
com.microsoft.VSCode,316,1707356414,1707356730,1707356730.565604,-21600,,
com.leomehlig.today,3,1707356411,1707356414,1707356414.5678391,-21600,,
com.google.Gmail,13,1707356384,1707356397,1707356397.925189,-21600,EB445137-D7F5-57EC-87DA-1DB460D64046,"iPhone13,2"
co.hinge.mobile.ios,13,1707356366,1707356379,1707356379.070303,-21600,EB445137-D7F5-57EC-87DA-1DB460D64046,"iPhone13,2"
com.google.Chrome,123,1707356288,1707356411,1707356411.1287951,-21600,,
com.leomehlig.today,7,1707356281,1707356288,1707356288.680352,-21600,,
com.google.Chrome,343,1707355938,1707356281,1707356281.896544,-21600,,
com.apple.systempreferences,25,1707355913,1707355938,1707355938.649112,-21600,,
co.hinge.mobile.ios,10,1707355575,1707355585,1707355585.672904,-21600,EB445137-D7F5-57EC-87DA-1DB460D64046,"iPhone13,2"
co.hinge.mobile.ios,132,1707354885,1707355017,1707355017.9894218,-21600,EB445137-D7F5-57EC-87DA-1DB460D64046,"iPhone13,2"
com.google.Chrome,1536,1707354370,1707355906,1707355907.002321,-21600,,
com.apple.finder,22,1707354348,1707354370,1707354370.999826,-21600,,
com.apple.news,17,1707354250,1707354267,1707354267.184173,-21600,EB445137-D7F5-57EC-87DA-1DB460D64046,"iPhone13,2"
com.google.Chrome,117,1707354231,1707354348,1707354348.568248,-21600,,
com.leomehlig.today,53,1707354029,1707354082,1707354083.116435,-21600,,
com.apple.news,85,1707352839,1707352924,1707352925.070092,-21600,EB445137-D7F5-57EC-87DA-1DB460D64046,"iPhone13,2"
com.apple.MobileSMS,3,1707352824,1707352827,1707352827.424891,-21600,EB445137-D7F5-57EC-87DA-1DB460D64046,"iPhone13,2"
edu.illinois.rokwire.ios,25,1707352798,1707352823,1707352823.2067099,-21600,EB445137-D7F5-57EC-87DA-1DB460D64046,"iPhone13,2"
com.burbn.instagram,99,1707350181,1707350280,1707350280.342993,-21600,EB445137-D7F5-57EC-87DA-1DB460D64046,"iPhone13,2"
com.facebook.Facebook,309,1707349870,1707350179,1707350179.967451,-21600,EB445137-D7F5-57EC-87DA-1DB460D64046,"iPhone13,2"
com.google.ios.youtube,707,1707349158,1707349865,1707349865.599699,-21600,EB445137-D7F5-57EC-87DA-1DB460D64046,"iPhone13,2"
com.google.chrome.ios,46,1707349112,1707349158,1707349158.380072,-21600,EB445137-D7F5-57EC-87DA-1DB460D64046,"iPhone13,2"
com.google.ios.youtube,707,1707348402,1707349109,1707349109.5652409,-21600,EB445137-D7F5-57EC-87DA-1DB460D64046,"iPhone13,2"
com.peacocktv.peacock,720,1707347681,1707348401,1707348401.421565,-21600,EB445137-D7F5-57EC-87DA-1DB460D64046,"iPhone13,2"
co.hinge.mobile.ios,87,1707347592,1707347679,1707347679.5524402,-21600,EB445137-D7F5-57EC-87DA-1DB460D64046,"iPhone13,2"
com.burbn.instagram,62,1707347518,1707347580,1707347580.913275,-21600,EB445137-D7F5-57EC-87DA-1DB460D64046,"iPhone13,2"
co.hinge.mobile.ios,52,1707347464,1707347516,1707347516.051744,-21600,EB445137-D7F5-57EC-87DA-1DB460D64046,"iPhone13,2"
com.apple.Maps,33,1707347423,1707347456,1707347456.2540321,-21600,EB445137-D7F5-57EC-87DA-1DB460D64046,"iPhone13,2"
co.hinge.mobile.ios,8,1707347408,1707347416,1707347416.797323,-21600,EB445137-D7F5-57EC-87DA-1DB460D64046,"iPhone13,2"
com.google.chrome.ios,35,1707347365,1707347400,1707347400.5705,-21600,EB445137-D7F5-57EC-87DA-1DB460D64046,"iPhone13,2"
com.peacocktv.peacock,2292,1707345073,1707347365,1707347365.871481,-21600,EB445137-D7F5-57EC-87DA-1DB460D64046,"iPhone13,2"
co.hinge.mobile.ios,291,1707344773,1707345064,1707345064.391752,-21600,EB445137-D7F5-57EC-87DA-1DB460D64046,"iPhone13,2"
com.apple.MobileSMS,7,1707344746,1707344753,1707344753.422674,-21600,EB445137-D7F5-57EC-87DA-1DB460D64046,"iPhone13,2"
com.apple.MobileSMS,32,1707344701,1707344733,1707344733.140712,-21600,EB445137-D7F5-57EC-87DA-1DB460D64046,"iPhone13,2"
com.apple.Music,10,1707344685,1707344695,1707344696.1226192,-21600,EB445137-D7F5-57EC-87DA-1DB460D64046,"iPhone13,2"
com.apple.Music,1,1707344482,1707344483,1707344483.9059849,-21600,EB445137-D7F5-57EC-87DA-1DB460D64046,"iPhone13,2"
com.apple.Music,2,1707342986,1707342988,1707342988.707714,-21600,EB445137-D7F5-57EC-87DA-1DB460D64046,"iPhone13,2"
com.apple.Music,6,1707342966,1707342972,1707342972.217414,-21600,EB445137-D7F5-57EC-87DA-1DB460D64046,"iPhone13,2"
com.apple.Music,29,1707342935,1707342964,1707342964.83973,-21600,EB445137-D7F5-57EC-87DA-1DB460D64046,"iPhone13,2"
com.apple.Music,40,1707342853,1707342893,1707342893.642534,-21600,EB445137-D7F5-57EC-87DA-1DB460D64046,"iPhone13,2"
com.apple.Health,42,1707342623,1707342665,1707342665.462215,-21600,EB445137-D7F5-57EC-87DA-1DB460D64046,"iPhone13,2"
com.burbn.instagram,214,1707340879,1707341093,1707341093.389326,-21600,EB445137-D7F5-57EC-87DA-1DB460D64046,"iPhone13,2"
com.burbn.instagram,191,1707340633,1707340824,1707340824.7922602,-21600,EB445137-D7F5-57EC-87DA-1DB460D64046,"iPhone13,2"
com.burbn.instagram,110,1707340514,1707340624,1707340624.351593,-21600,EB445137-D7F5-57EC-87DA-1DB460D64046,"iPhone13,2"
com.apple.shortcuts,74,1707340431,1707340505,1707340505.971394,-21600,EB445137-D7F5-57EC-87DA-1DB460D64046,"iPhone13,2"
com.apple.news,3,1707340424,1707340427,1707340428.047795,-21600,EB445137-D7F5-57EC-87DA-1DB460D64046,"iPhone13,2"
com.apple.news,7,1707340115,1707340122,1707340122.089021,-21600,EB445137-D7F5-57EC-87DA-1DB460D64046,"iPhone13,2"
com.apple.news,154,1707339530,1707339684,1707339684.7757468,-21600,EB445137-D7F5-57EC-87DA-1DB460D64046,"iPhone13,2"
com.truebill.truebillnative,9,1707339394,1707339403,1707339403.741298,-21600,EB445137-D7F5-57EC-87DA-1DB460D64046,"iPhone13,2"
co.hinge.mobile.ios,4,1707339390,1707339394,1707339394.19248,-21600,EB445137-D7F5-57EC-87DA-1DB460D64046,"iPhone13,2"
com.google.chrome.ios,38,1707339352,1707339390,1707339391.183687,-21600,EB445137-D7F5-57EC-87DA-1DB460D64046,"iPhone13,2"
co.hinge.mobile.ios,33,1707339316,1707339349,1707339349.1478992,-21600,EB445137-D7F5-57EC-87DA-1DB460D64046,"iPhone13,2"
com.google.chrome.ios,37,1707339279,1707339316,1707339316.670583,-21600,EB445137-D7F5-57EC-87DA-1DB460D64046,"iPhone13,2"
com.truebill.truebillnative,53,1707339226,1707339279,1707339279.053308,-21600,EB445137-D7F5-57EC-87DA-1DB460D64046,"iPhone13,2"
co.hinge.mobile.ios,378,1707338782,1707339160,1707339160.710145,-21600,EB445137-D7F5-57EC-87DA-1DB460D64046,"iPhone13,2"
com.intsig.CamScannerLite,7,1707338741,1707338748,1707338749.031522,-21600,EB445137-D7F5-57EC-87DA-1DB460D64046,"iPhone13,2"
com.leomehlig.today,62,1707337831,1707337893,1707337894.190763,-21600,,
com.intsig.CamScannerLite,204,1707337647,1707337851,1707337851.961807,-21600,EB445137-D7F5-57EC-87DA-1DB460D64046,"iPhone13,2"
com.instructure.icanvas,5,1707337637,1707337642,1707337643.011859,-21600,EB445137-D7F5-57EC-87DA-1DB460D64046,"iPhone13,2"
com.google.Chrome,258,1707337573,1707337831,1707337831.136994,-21600,,
com.google.Chrome,312,1707337250,1707337562,1707337562.37778,-21600,,
com.google.Chrome,1132,1707336113,1707337245,1707337245.628635,-21600,,
com.apple.Preview,43,1707336070,1707336113,1707336113.8487139,-21600,,
com.google.Chrome,101,1707335969,1707336070,1707336070.962908,-21600,,
com.leomehlig.today,0,1707335969,1707335969,1707335969.954976,-21600,,
com.google.Chrome,330,1707335639,1707335969,1707335969.6571112,-21600,,
com.apple.news,355,1707332029,1707332384,1707332384.410437,-21600,EB445137-D7F5-57EC-87DA-1DB460D64046,"iPhone13,2"
edu.illinois.rokwire.ios,18,1707332010,1707332028,1707332028.3577209,-21600,EB445137-D7F5-57EC-87DA-1DB460D64046,"iPhone13,2"
edu.illinois.rokwire.ios,12,1707331997,1707332009,1707332009.7816381,-21600,EB445137-D7F5-57EC-87DA-1DB460D64046,"iPhone13,2"
com.google.Chrome,96,1707331873,1707331969,1707331969.309102,-21600,,
com.leomehlig.today,21,1707331852,1707331873,1707331873.6748981,-21600,,
com.google.Chrome,4,1707331848,1707331852,1707331852.287941,-21600,,
com.apple.Notes,33,1707331815,1707331848,1707331848.579619,-21600,,
com.google.Chrome,2,1707331811,1707331813,1707331815.387473,-21600,,
com.apple.systempreferences,3,1707331809,1707331812,1707331812.876914,-21600,,
com.google.Chrome,22,1707331787,1707331809,1707331809.740714,-21600,,
com.apple.Preview,557,1707331230,1707331787,1707331787.342906,-21600,,
com.google.Chrome,18,1707331212,1707331230,1707331230.821636,-21600,,
com.apple.Preview,523,1707330689,1707331212,1707331212.244252,-21600,,
com.apple.finder,2,1707330687,1707330689,1707330689.884758,-21600,,
com.leomehlig.today,5,1707330682,1707330687,1707330687.728307,-21600,,
com.google.Chrome,4,1707330678,1707330682,1707330682.454737,-21600,,
edu.illinois.rokwire.ios,4,1707330614,1707330618,1707330618.491873,-21600,EB445137-D7F5-57EC-87DA-1DB460D64046,"iPhone13,2"
edu.illinois.rokwire.ios,2,1707329772,1707329774,1707329774.9776049,-21600,EB445137-D7F5-57EC-87DA-1DB460D64046,"iPhone13,2"
edu.illinois.rokwire.ios,66,1707329492,1707329558,1707329558.590623,-21600,EB445137-D7F5-57EC-87DA-1DB460D64046,"iPhone13,2"
com.instructure.icanvas,135,1707329067,1707329202,1707329202.866185,-21600,EB445137-D7F5-57EC-87DA-1DB460D64046,"iPhone13,2"
com.apple.camera,3,1707329045,1707329048,1707329048.882824,-21600,EB445137-D7F5-57EC-87DA-1DB460D64046,"iPhone13,2"
com.google.chrome.ios,43,1707328015,1707328058,1707328058.690788,-21600,EB445137-D7F5-57EC-87DA-1DB460D64046,"iPhone13,2"
edu.illinois.rokwire.ios,57,1707327217,1707327274,1707327275.014511,-21600,EB445137-D7F5-57EC-87DA-1DB460D64046,"iPhone13,2"
com.instructure.icanvas,10,1707327207,1707327217,1707327217.4613008,-21600,EB445137-D7F5-57EC-87DA-1DB460D64046,"iPhone13,2"
Astrospheric.Astrospheric,56,1707325461,1707325517,1707325517.337226,-21600,EB445137-D7F5-57EC-87DA-1DB460D64046,"iPhone13,2"
com.leomehlig.today,18,1707325442,1707325460,1707325460.9593549,-21600,EB445137-D7F5-57EC-87DA-1DB460D64046,"iPhone13,2"
com.apple.Health,34,1707325386,1707325420,1707325420.4993858,-21600,EB445137-D7F5-57EC-87DA-1DB460D64046,"iPhone13,2"
com.microsoft.Office.Outlook,17,1707325346,1707325363,1707325364.486562,-21600,EB445137-D7F5-57EC-87DA-1DB460D64046,"iPhone13,2"
com.google.chrome.ios,11,1707325334,1707325345,1707325346.173233,-21600,EB445137-D7F5-57EC-87DA-1DB460D64046,"iPhone13,2"
com.microsoft.Office.Outlook,9,1707325325,1707325334,1707325334.778589,-21600,EB445137-D7F5-57EC-87DA-1DB460D64046,"iPhone13,2"
com.instructure.icanvas,8,1707325315,1707325323,1707325324.1888142,-21600,EB445137-D7F5-57EC-87DA-1DB460D64046,"iPhone13,2"
com.google.Chrome,43,1707325237,1707325280,1707325280.6567612,-21600,,
com.microsoft.VSCode,18,1707325219,1707325237,1707325237.4553351,-21600,,
com.leomehlig.today,12,1707325207,1707325219,1707325219.6929421,-21600,,
com.microsoft.VSCode,3,1707325204,1707325207,1707325207.331181,-21600,,
com.leomehlig.today,2,1707325202,1707325204,1707325204.348947,-21600,,
com.google.Chrome,0,1707325202,1707325202,1707325202.935174,-21600,,
com.leomehlig.today,21,1707325181,1707325202,1707325202.139715,-21600,,
com.google.Chrome,3,1707325178,1707325181,1707325181.1571078,-21600,,
com.microsoft.VSCode,9,1707325169,1707325178,1707325178.546385,-21600,,
com.microsoft.VSCode,4142,1707319967,1707324109,1707324109.160248,-21600,,
com.google.Chrome,3,1707319964,1707319967,1707319967.320918,-21600,,
com.microsoft.VSCode,15,1707319949,1707319964,1707319964.237669,-21600,,
com.google.Chrome,37,1707319912,1707319949,1707319949.963584,-21600,,
com.apple.finder,3,1707319909,1707319912,1707319912.637082,-21600,,
com.apple.Health,16,1707318879,1707318895,1707318895.811112,-21600,EB445137-D7F5-57EC-87DA-1DB460D64046,"iPhone13,2"
com.apple.Health,21,1707318855,1707318876,1707318876.4729729,-21600,EB445137-D7F5-57EC-87DA-1DB460D64046,"iPhone13,2"
com.apple.finder,142,1707280489,1707280631,1707280631.175716,-21600,,
com.microsoft.onenote.mac,20,1707280469,1707280489,1707280489.804224,-21600,,
com.google.Chrome,60,1707280409,1707280469,1707280469.1638498,-21600,,
com.microsoft.onenote.mac,1,1707280408,1707280409,1707280410.045878,-21600,,
com.google.Chrome,2,1707280406,1707280408,1707280408.367515,-21600,,
com.microsoft.onenote.mac,70,1707280336,1707280406,1707280406.519466,-21600,,
com.leomehlig.today,13,1707280323,1707280336,1707280336.499511,-21600,,
com.leomehlig.today,128,1707278344,1707278472,1707278472.73357,-21600,,
com.apple.finder,0,1707278344,1707278344,1707278344.814066,-21600,,
com.apple.Preview,6,1707278338,1707278344,1707278344.527627,-21600,,
com.google.Chrome,62,1707278276,1707278338,1707278339.016804,-21600,,
com.leomehlig.today,8,1707278268,1707278276,1707278276.9532619,-21600,,
com.google.Chrome,4,1707278264,1707278268,1707278268.31221,-21600,,
com.leomehlig.today,68,1707278196,1707278264,1707278264.747436,-21600,,
com.google.Chrome,21,1707278175,1707278196,1707278196.4558039,-21600,,
com.leomehlig.today,59,1707278116,1707278175,1707278175.474393,-21600,,
com.google.Chrome,312,1707277804,1707278116,1707278117.027268,-21600,,
com.google.Chrome,307,1707277450,1707277757,1707277757.825317,-21600,,
com.google.Chrome,872,1707276520,1707277392,1707277392.59116,-21600,,
com.leomehlig.today,56,1707276464,1707276520,1707276520.167152,-21600,,
com.google.Chrome,392,1707276072,1707276464,1707276464.184249,-21600,,
com.apple.Preview,39,1707276033,1707276072,1707276072.362399,-21600,,
com.google.Chrome,2,1707276031,1707276033,1707276033.9461188,-21600,,
com.apple.Preview,23,1707276008,1707276031,1707276031.491133,-21600,,
com.google.Chrome,259,1707275749,1707276008,1707276008.8953938,-21600,,
com.apple.Preview,47,1707275702,1707275749,1707275749.2305,-21600,,
com.google.Chrome,7,1707275695,1707275702,1707275702.137498,-21600,,
com.apple.Preview,1,1707275694,1707275695,1707275695.278242,-21600,,
com.google.Chrome,26,1707275668,1707275694,1707275694.161746,-21600,,
com.apple.Preview,47,1707275621,1707275668,1707275668.956548,-21600,,
com.google.Chrome,35,1707275586,1707275621,1707275621.461632,-21600,,
com.apple.Preview,83,1707275503,1707275586,1707275586.910905,-21600,,
com.google.Chrome,28,1707275475,1707275503,1707275503.297653,-21600,,
com.apple.Preview,1,1707275474,1707275475,1707275475.872064,-21600,,
com.google.Chrome,107,1707275367,1707275474,1707275474.952168,-21600,,
com.apple.Preview,1,1707275366,1707275367,1707275367.604896,-21600,,
com.google.Chrome,8,1707275358,1707275366,1707275366.434037,-21600,,
com.apple.Preview,10,1707275348,1707275358,1707275358.717987,-21600,,
com.google.Chrome,113,1707275235,1707275348,1707275348.8892999,-21600,,
com.apple.Preview,154,1707275081,1707275235,1707275235.7497501,-21600,,
com.google.Chrome,59,1707275022,1707275081,1707275081.1844711,-21600,,
com.apple.Preview,59,1707274963,1707275022,1707275022.7982612,-21600,,
com.google.Chrome,152,1707274811,1707274963,1707274963.330902,-21600,,
com.apple.Preview,4,1707274807,1707274811,1707274811.2073689,-21600,,
com.google.Chrome,130,1707274677,1707274807,1707274807.683669,-21600,,
com.apple.Preview,4,1707274673,1707274677,1707274677.450025,-21600,,
com.google.Chrome,88,1707274585,1707274673,1707274673.6698952,-21600,,
com.apple.Preview,38,1707274547,1707274585,1707274585.379091,-21600,,
com.google.Chrome,93,1707274454,1707274547,1707274547.1502352,-21600,,
com.apple.Preview,244,1707274210,1707274454,1707274454.944306,-21600,,
com.google.Chrome,12,1707274198,1707274210,1707274210.543068,-21600,,
com.apple.Preview,91,1707274107,1707274198,1707274198.5086632,-21600,,
com.google.Chrome,59,1707274048,1707274107,1707274108.0115762,-21600,,
com.apple.Preview,58,1707273990,1707274048,1707274048.8661819,-21600,,
com.google.Chrome,4,1707273986,1707273990,1707273990.731101,-21600,,
com.apple.Preview,79,1707273907,1707273986,1707273986.932301,-21600,,
com.google.Chrome,483,1707273424,1707273907,1707273907.162962,-21600,,
com.leomehlig.today,15,1707273409,1707273424,1707273425.019783,-21600,,
com.google.Chrome,17,1707273392,1707273409,1707273409.490562,-21600,,
com.google.Chrome,305,1707270073,1707270378,1707270378.8554091,-21600,,
com.google.Chrome,303,1707269769,1707270072,1707270072.3209949,-21600,,
com.apple.systempreferences,30,1707269739,1707269769,1707269769.52698,-21600,,
com.google.Chrome,1922,1707267810,1707269732,1707269733.062698,-21600,,
com.microsoft.Outlook,0,1707267810,1707267810,1707267810.423012,-21600,,
com.google.Chrome,71,1707267739,1707267810,1707267810.192059,-21600,,
com.google.Chrome,1654,1707264206,1707265860,1707265861.880321,-21600,,
com.apple.Preview,2,1707264204,1707264206,1707264206.62212,-21600,,
com.leomehlig.today,71,1707264133,1707264204,1707264204.519568,-21600,,
com.apple.Preview,1,1707264132,1707264133,1707264133.635316,-21600,,
com.apple.MobileSMS,10,1707254476,1707254486,1707254486.400566,-21600,EB445137-D7F5-57EC-87DA-1DB460D64046,"iPhone13,2"
com.toyopagroup.picaboo,2,1707254474,1707254476,1707254477.0628328,-21600,EB445137-D7F5-57EC-87DA-1DB460D64046,"iPhone13,2"
com.apple.MobileSMS,2,1707254472,1707254474,1707254474.298565,-21600,EB445137-D7F5-57EC-87DA-1DB460D64046,"iPhone13,2"
com.apple.Preview,30,1707254439,1707254469,1707254470.119607,-21600,,
com.google.Chrome,16,1707254423,1707254439,1707254439.832731,-21600,,
us.zoom.xos,36,1707254387,1707254423,1707254423.658087,-21600,,
com.google.Chrome,271,1707254116,1707254387,1707254387.2183728,-21600,,
us.zoom.xos,0,1707254116,1707254116,1707254116.9384809,-21600,,
us.zoom.xos,795,1707253100,1707253895,1707253895.922163,-21600,,
com.google.Chrome,85,1707253015,1707253100,1707253100.3615909,-21600,,
us.zoom.xos,5,1707253010,1707253015,1707253015.03611,-21600,,
com.google.Chrome,120,1707252890,1707253010,1707253010.2614288,-21600,,
us.zoom.xos,40,1707252850,1707252890,1707252890.415501,-21600,,
com.google.Chrome,12,1707252838,1707252850,1707252850.343535,-21600,,
us.zoom.xos,2,1707252836,1707252838,1707252838.215816,-21600,,
com.google.Chrome,1,1707252835,1707252836,1707252836.873903,-21600,,
us.zoom.xos,34,1707252801,1707252835,1707252835.9424849,-21600,,
com.google.Chrome,11,1707252790,1707252801,1707252801.895245,-21600,,
us.zoom.xos,2,1707252788,1707252790,1707252790.6172,-21600,,
com.google.Chrome,87,1707252701,1707252788,1707252788.7822971,-21600,,
us.zoom.xos,238,1707252463,1707252701,1707252701.610849,-21600,,
com.apple.MobileSMS,5,1707252458,1707252463,1707252463.9357,-21600,,
com.apple.camera,1,1707252392,1707252393,1707252393.118371,-21600,EB445137-D7F5-57EC-87DA-1DB460D64046,"iPhone13,2"
us.zoom.xos,75,1707252383,1707252458,1707252458.912092,-21600,,
com.apple.iCal,77,1707252306,1707252383,1707252383.959724,-21600,,
com.google.Chrome,22,1707252284,1707252306,1707252306.4364,-21600,,
us.zoom.xos,82,1707252202,1707252284,1707252284.1022491,-21600,,
com.google.Chrome,21,1707252181,1707252202,1707252202.527728,-21600,,
com.apple.iCal,32,1707252149,1707252181,1707252181.731516,-21600,,
com.google.Chrome,97,1707252052,1707252149,1707252149.989641,-21600,,
com.apple.news,353,1707251422,1707251775,1707251776.0343652,-21600,EB445137-D7F5-57EC-87DA-1DB460D64046,"iPhone13,2"
com.hammerandchisel.discord,66,1707251340,1707251406,1707251406.3510818,-21600,EB445137-D7F5-57EC-87DA-1DB460D64046,"iPhone13,2"
com.apple.Health,43,1707251287,1707251330,1707251330.611216,-21600,EB445137-D7F5-57EC-87DA-1DB460D64046,"iPhone13,2"
com.microsoft.Office.Outlook,3,1707251282,1707251285,1707251285.188047,-21600,EB445137-D7F5-57EC-87DA-1DB460D64046,"iPhone13,2"
us.zoom.xos,883,1707251169,1707252052,1707252052.6010032,-21600,,
com.microsoft.Office.Outlook,8,1707251148,1707251156,1707251156.971829,-21600,EB445137-D7F5-57EC-87DA-1DB460D64046,"iPhone13,2"
us.zoom.xos,304,1707250609,1707250913,1707250913.6011028,-21600,,
com.truebill.truebillnative,66,1707250539,1707250605,1707250605.076761,-21600,EB445137-D7F5-57EC-87DA-1DB460D64046,"iPhone13,2"
com.burbn.instagram,3,1707250534,1707250537,1707250537.3647919,-21600,EB445137-D7F5-57EC-87DA-1DB460D64046,"iPhone13,2"
com.burbn.instagram,139,1707250290,1707250429,1707250429.396173,-21600,EB445137-D7F5-57EC-87DA-1DB460D64046,"iPhone13,2"
us.zoom.xos,471,1707250115,1707250586,1707250586.775487,-21600,,
com.burbn.instagram,69,1707249743,1707249812,1707249812.797165,-21600,EB445137-D7F5-57EC-87DA-1DB460D64046,"iPhone13,2"
us.zoom.xos,411,1707249514,1707249925,1707249925.174624,-21600,,
com.google.Chrome,2,1707249512,1707249514,1707249514.354941,-21600,,
us.zoom.xos,0,1707249512,1707249512,1707249512.991622,-21600,,
com.google.Chrome,63,1707249449,1707249512,1707249512.215992,-21600,,
com.google.Chrome,301,1707249148,1707249449,1707249449.495064,-21600,,
com.apple.news,511,1707248918,1707249429,1707249429.672198,-21600,EB445137-D7F5-57EC-87DA-1DB460D64046,"iPhone13,2"
com.google.Chrome,1350,1707247794,1707249144,1707249144.3151069,-21600,,
com.microsoft.VSCode,46,1707247748,1707247794,1707247794.507626,-21600,,
com.google.Chrome,30,1707247718,1707247748,1707247748.443099,-21600,,
com.leomehlig.today,9,1707247709,1707247718,1707247718.419642,-21600,,
com.google.Chrome,12,1707247697,1707247709,1707247709.324894,-21600,,
com.leomehlig.today,25,1707247672,1707247697,1707247697.689237,-21600,,
com.google.Chrome,41,1707247631,1707247672,1707247672.608224,-21600,,
com.microsoft.VSCode,7,1707247624,1707247631,1707247631.067779,-21600,,
com.google.Chrome,2,1707247622,1707247624,1707247624.480845,-21600,,
com.microsoft.VSCode,14,1707247608,1707247622,1707247622.6732678,-21600,,
com.google.Chrome,1,1707247607,1707247608,1707247608.091567,-21600,,
com.apple.finder,4,1707247603,1707247607,1707247607.585572,-21600,,
com.apple.archiveutility,0,1707247603,1707247603,1707247603.432698,-21600,,
com.apple.finder,19,1707247584,1707247603,1707247603.164726,-21600,,
com.google.Chrome,14,1707247570,1707247584,1707247584.993267,-21600,,
com.microsoft.VSCode,16,1707247554,1707247570,1707247570.491706,-21600,,
com.google.Chrome,43,1707247511,1707247554,1707247554.3977652,-21600,,
com.microsoft.VSCode,335,1707247176,1707247511,1707247511.47875,-21600,,
com.google.Chrome,14,1707247162,1707247176,1707247176.207137,-21600,,
com.microsoft.VSCode,81,1707247081,1707247162,1707247162.9427118,-21600,,
com.google.Chrome,2,1707247079,1707247081,1707247081.087198,-21600,,
com.microsoft.VSCode,6,1707247073,1707247079,1707247080.038113,-21600,,
com.google.Chrome,2,1707247071,1707247073,1707247073.69912,-21600,,
com.microsoft.VSCode,4,1707247067,1707247071,1707247072.0143452,-21600,,
com.google.Chrome,1,1707247066,1707247067,1707247067.598449,-21600,,
com.microsoft.VSCode,0,1707247066,1707247066,1707247066.9255,-21600,,
com.google.Chrome,23,1707247043,1707247066,1707247066.195642,-21600,,
com.microsoft.VSCode,83,1707246960,1707247043,1707247043.560152,-21600,,
com.google.Chrome,3,1707246957,1707246960,1707246960.993074,-21600,,
com.microsoft.VSCode,21,1707246936,1707246957,1707246957.876328,-21600,,
com.google.Chrome,4,1707246932,1707246936,1707246936.270549,-21600,,
com.microsoft.VSCode,10,1707246922,1707246932,1707246932.519318,-21600,,
com.google.Chrome,10,1707246912,1707246922,1707246922.676589,-21600,,
com.microsoft.VSCode,47,1707246865,1707246912,1707246912.8595219,-21600,,
com.google.Chrome,45,1707246820,1707246865,1707246865.256083,-21600,,
com.apple.Photos,0,1707246820,1707246820,1707246820.6194549,-21600,,
com.microsoft.VSCode,87,1707246733,1707246820,1707246820.310358,-21600,,
com.google.Chrome,11,1707246722,1707246733,1707246733.6315398,-21600,,
com.microsoft.VSCode,165,1707246557,1707246722,1707246722.0909948,-21600,,
com.google.Chrome,11,1707246546,1707246557,1707246557.867814,-21600,,
com.microsoft.VSCode,36,1707246510,1707246546,1707246546.4354892,-21600,,
com.google.Chrome,11,1707246499,1707246510,1707246510.649115,-21600,,
com.microsoft.VSCode,68,1707246431,1707246499,1707246499.4033809,-21600,,
com.google.Chrome,2,1707246429,1707246431,1707246431.214898,-21600,,
com.microsoft.VSCode,87,1707246342,1707246429,1707246429.603119,-21600,,
com.google.Chrome,15,1707246327,1707246342,1707246342.6734319,-21600,,
com.microsoft.VSCode,5,1707246322,1707246327,1707246327.227283,-21600,,
com.google.Chrome,50,1707246272,1707246322,1707246322.676557,-21600,,
com.microsoft.VSCode,135,1707246137,1707246272,1707246272.957998,-21600,,
com.google.Chrome,7,1707246130,1707246137,1707246137.188425,-21600,,
com.microsoft.VSCode,2,1707246128,1707246130,1707246130.476893,-21600,,
com.google.Chrome,242,1707245886,1707246128,1707246128.313355,-21600,,
com.leomehlig.today,0,1707245881,1707245881,1707245882.570466,-21600,,
com.leomehlig.today,72,1707244859,1707244931,1707244931.697573,-21600,EB445137-D7F5-57EC-87DA-1DB460D64046,"iPhone13,2"
com.ryansponzilli.DeepSkyCatalog,48,1707244807,1707244855,1707244855.561368,-21600,EB445137-D7F5-57EC-87DA-1DB460D64046,"iPhone13,2"
com.tier9digital.sundial,81,1707244722,1707244803,1707244803.809533,-21600,EB445137-D7F5-57EC-87DA-1DB460D64046,"iPhone13,2"
Astrospheric.Astrospheric,38,1707244680,1707244718,1707244718.71718,-21600,EB445137-D7F5-57EC-87DA-1DB460D64046,"iPhone13,2"
com.google.chrome.ios,7,1707244671,1707244678,1707244678.622431,-21600,EB445137-D7F5-57EC-87DA-1DB460D64046,"iPhone13,2"
com.google.chrome.ios,3,1707244345,1707244348,1707244348.556823,-21600,EB445137-D7F5-57EC-87DA-1DB460D64046,"iPhone13,2"
com.google.chrome.ios,47,1707242514,1707242561,1707242561.935824,-21600,EB445137-D7F5-57EC-87DA-1DB460D64046,"iPhone13,2"
com.instructure.icanvas,4,1707242510,1707242514,1707242514.3414578,-21600,EB445137-D7F5-57EC-87DA-1DB460D64046,"iPhone13,2"
com.microsoft.Office.Outlook,43,1707242467,1707242510,1707242511.481913,-21600,EB445137-D7F5-57EC-87DA-1DB460D64046,"iPhone13,2"
com.google.chrome.ios,51,1707242415,1707242466,1707242466.891216,-21600,EB445137-D7F5-57EC-87DA-1DB460D64046,"iPhone13,2"
com.instructure.icanvas,4,1707242411,1707242415,1707242415.489471,-21600,EB445137-D7F5-57EC-87DA-1DB460D64046,"iPhone13,2"
com.burbn.instagram,8,1707242387,1707242395,1707242395.2922978,-21600,EB445137-D7F5-57EC-87DA-1DB460D64046,"iPhone13,2"
com.burbn.instagram,121,1707242223,1707242344,1707242344.8146548,-21600,EB445137-D7F5-57EC-87DA-1DB460D64046,"iPhone13,2"
com.instructure.icanvas,16,1707242204,1707242220,1707242220.274362,-21600,EB445137-D7F5-57EC-87DA-1DB460D64046,"iPhone13,2"
com.microsoft.Office.Outlook,7,1707242196,1707242203,1707242203.097639,-21600,EB445137-D7F5-57EC-87DA-1DB460D64046,"iPhone13,2"
com.microsoft.Office.Outlook,27,1707242141,1707242168,1707242168.617238,-21600,EB445137-D7F5-57EC-87DA-1DB460D64046,"iPhone13,2"
com.instructure.icanvas,12,1707242126,1707242138,1707242138.953887,-21600,EB445137-D7F5-57EC-87DA-1DB460D64046,"iPhone13,2"
com.apple.MobileSMS,2,1707242123,1707242125,1707242125.858265,-21600,EB445137-D7F5-57EC-87DA-1DB460D64046,"iPhone13,2"
com.apple.mobilecal,6,1707242116,1707242122,1707242122.737924,-21600,EB445137-D7F5-57EC-87DA-1DB460D64046,"iPhone13,2"
com.apple.mobilecal,9,1707242107,1707242116,1707242116.39264,-21600,EB445137-D7F5-57EC-87DA-1DB460D64046,"iPhone13,2"
com.apple.mobilecal,1,1707242078,1707242079,1707242079.8059978,-21600,EB445137-D7F5-57EC-87DA-1DB460D64046,"iPhone13,2"
com.apple.mobilecal,5,1707242070,1707242075,1707242075.071893,-21600,EB445137-D7F5-57EC-87DA-1DB460D64046,"iPhone13,2"
com.apple.mobilecal,7,1707242038,1707242045,1707242045.255621,-21600,EB445137-D7F5-57EC-87DA-1DB460D64046,"iPhone13,2"
com.microsoft.Office.Outlook,4,1707242034,1707242038,1707242038.2640529,-21600,EB445137-D7F5-57EC-87DA-1DB460D64046,"iPhone13,2"
com.microsoft.Office.Outlook,1,1707241971,1707241972,1707241972.790422,-21600,EB445137-D7F5-57EC-87DA-1DB460D64046,"iPhone13,2"
com.microsoft.Office.Outlook,1,1707241885,1707241886,1707241886.495744,-21600,EB445137-D7F5-57EC-87DA-1DB460D64046,"iPhone13,2"
com.microsoft.Office.Outlook,0,1707241884,1707241884,1707241884.881164,-21600,EB445137-D7F5-57EC-87DA-1DB460D64046,"iPhone13,2"
com.microsoft.Office.Outlook,1,1707241669,1707241670,1707241670.8616529,-21600,EB445137-D7F5-57EC-87DA-1DB460D64046,"iPhone13,2"
com.microsoft.Office.Outlook,8,1707241424,1707241432,1707241432.022695,-21600,EB445137-D7F5-57EC-87DA-1DB460D64046,"iPhone13,2"
com.microsoft.Office.Outlook,5,1707241400,1707241405,1707241405.0608149,-21600,EB445137-D7F5-57EC-87DA-1DB460D64046,"iPhone13,2"
com.microsoft.Office.Outlook,5,1707241329,1707241334,1707241334.844898,-21600,EB445137-D7F5-57EC-87DA-1DB460D64046,"iPhone13,2"
com.microsoft.Office.Outlook,3,1707241234,1707241237,1707241237.3681731,-21600,EB445137-D7F5-57EC-87DA-1DB460D64046,"iPhone13,2"
com.microsoft.Office.Outlook,11,1707241163,1707241174,1707241174.41151,-21600,EB445137-D7F5-57EC-87DA-1DB460D64046,"iPhone13,2"
edu.illinois.rokwire.ios,11,1707241152,1707241163,1707241163.4624,-21600,EB445137-D7F5-57EC-87DA-1DB460D64046,"iPhone13,2"
edu.illinois.rokwire.ios,1,1707240716,1707240717,1707240717.511111,-21600,EB445137-D7F5-57EC-87DA-1DB460D64046,"iPhone13,2"
edu.illinois.rokwire.ios,4,1707240635,1707240639,1707240639.854713,-21600,EB445137-D7F5-57EC-87DA-1DB460D64046,"iPhone13,2"
edu.illinois.rokwire.ios,15,1707239525,1707239540,1707239540.6604319,-21600,EB445137-D7F5-57EC-87DA-1DB460D64046,"iPhone13,2"
com.apple.podcasts,3,1707239521,1707239524,1707239524.144481,-21600,EB445137-D7F5-57EC-87DA-1DB460D64046,"iPhone13,2"
com.apple.podcasts,17,1707239495,1707239512,1707239512.776048,-21600,EB445137-D7F5-57EC-87DA-1DB460D64046,"iPhone13,2"
com.google.chrome.ios,4,1707239490,1707239494,1707239494.5281858,-21600,EB445137-D7F5-57EC-87DA-1DB460D64046,"iPhone13,2"
com.google.chrome.ios,14,1707239472,1707239486,1707239486.762792,-21600,EB445137-D7F5-57EC-87DA-1DB460D64046,"iPhone13,2"
com.instructure.icanvas,17,1707239455,1707239472,1707239472.095547,-21600,EB445137-D7F5-57EC-87DA-1DB460D64046,"iPhone13,2"
edu.illinois.rokwire.ios,2,1707239448,1707239450,1707239450.797981,-21600,EB445137-D7F5-57EC-87DA-1DB460D64046,"iPhone13,2"
edu.illinois.rokwire.ios,43,1707238902,1707238945,1707238945.512464,-21600,EB445137-D7F5-57EC-87DA-1DB460D64046,"iPhone13,2"
com.google.chrome.ios,10,1707238891,1707238901,1707238901.6119819,-21600,EB445137-D7F5-57EC-87DA-1DB460D64046,"iPhone13,2"
com.leomehlig.today,30,1707238864,1707238894,1707238895.058491,-21600,,
com.google.Chrome,11,1707238853,1707238864,1707238864.29326,-21600,,
com.leomehlig.today,19,1707238834,1707238853,1707238854.0218148,-21600,,
com.google.Chrome,2,1707238832,1707238834,1707238834.463845,-21600,,
com.google.Chrome,319,1707238361,1707238680,1707238680.487279,-21600,,
com.google.chrome.ios,12,1707238026,1707238038,1707238038.835043,-21600,EB445137-D7F5-57EC-87DA-1DB460D64046,"iPhone13,2"
com.google.chrome.ios,31,1707237934,1707237965,1707237965.933115,-21600,EB445137-D7F5-57EC-87DA-1DB460D64046,"iPhone13,2"
com.microsoft.Office.Outlook,11,1707237923,1707237934,1707237934.475716,-21600,EB445137-D7F5-57EC-87DA-1DB460D64046,"iPhone13,2"
com.apple.mobilecal,7,1707237916,1707237923,1707237923.503901,-21600,EB445137-D7F5-57EC-87DA-1DB460D64046,"iPhone13,2"
com.microsoft.Office.Outlook,2,1707237913,1707237915,1707237915.604008,-21600,EB445137-D7F5-57EC-87DA-1DB460D64046,"iPhone13,2"
com.google.Maps,21,1707237888,1707237909,1707237909.67618,-21600,EB445137-D7F5-57EC-87DA-1DB460D64046,"iPhone13,2"
com.google.chrome.ios,6,1707237882,1707237888,1707237888.198437,-21600,EB445137-D7F5-57EC-87DA-1DB460D64046,"iPhone13,2"
com.microsoft.Office.Outlook,38,1707237844,1707237882,1707237882.610972,-21600,EB445137-D7F5-57EC-87DA-1DB460D64046,"iPhone13,2"
com.google.Chrome,673,1707237650,1707238323,1707238323.605585,-21600,,
com.apple.Preview,182,1707237468,1707237650,1707237650.111045,-21600,,
com.google.Chrome,2,1707237466,1707237468,1707237468.6882749,-21600,,
com.apple.Preview,27,1707237439,1707237466,1707237466.6819181,-21600,,
com.google.Chrome,4,1707237435,1707237439,1707237439.432757,-21600,,
com.apple.Preview,6,1707237429,1707237435,1707237435.0732841,-21600,,
com.google.Chrome,5,1707237424,1707237429,1707237429.424227,-21600,,
com.apple.Preview,10,1707237414,1707237424,1707237424.3831449,-21600,,
com.google.Chrome,2,1707237412,1707237414,1707237414.7780871,-21600,,
com.apple.Preview,56,1707237356,1707237412,1707237412.6600552,-21600,,
com.google.Chrome,37,1707237319,1707237356,1707237356.684948,-21600,,
com.apple.Preview,244,1707237075,1707237319,1707237319.1715798,-21600,,
com.google.Chrome,10,1707237065,1707237075,1707237075.732116,-21600,,
com.apple.Preview,1,1707237064,1707237065,1707237065.453198,-21600,,
com.apple.Preview,307,1707236756,1707237063,1707237063.604529,-21600,,
com.apple.finder,1,1707236755,1707236756,1707236756.770441,-21600,,
com.apple.Preview,4,1707236751,1707236755,1707236755.4085178,-21600,,
com.google.Chrome,102,1707236649,1707236751,1707236751.439318,-21600,,
com.leomehlig.today,46,1707236603,1707236649,1707236649.303598,-21600,,
com.google.Chrome,585,1707236018,1707236603,1707236603.446371,-21600,,
com.instructure.icanvas,9,1707234633,1707234642,1707234642.39916,-21600,EB445137-D7F5-57EC-87DA-1DB460D64046,"iPhone13,2"
com.apple.MobileSMS,10,1707234615,1707234625,1707234625.450192,-21600,EB445137-D7F5-57EC-87DA-1DB460D64046,"iPhone13,2"
com.google.chrome.ios,167,1707234448,1707234615,1707234615.951572,-21600,EB445137-D7F5-57EC-87DA-1DB460D64046,"iPhone13,2"
com.apple.MobileSMS,73,1707234375,1707234448,1707234448.576391,-21600,EB445137-D7F5-57EC-87DA-1DB460D64046,"iPhone13,2"
com.google.Chrome,291,1707234354,1707234645,1707234645.151641,-21600,,
com.peacocktv.peacock,1453,1707231876,1707233329,1707233329.3899689,-21600,EB445137-D7F5-57EC-87DA-1DB460D64046,"iPhone13,2"
com.google.Maps,16,1707231113,1707231129,1707231130.0389209,-21600,EB445137-D7F5-57EC-87DA-1DB460D64046,"iPhone13,2"
com.apple.Health,6,1707230841,1707230847,1707230847.61674,-21600,EB445137-D7F5-57EC-87DA-1DB460D64046,"iPhone13,2"
com.apple.Music,40,1707193933,1707193973,1707193973.446953,-21600,EB445137-D7F5-57EC-87DA-1DB460D64046,"iPhone13,2"
com.apple.journal,272,1707193658,1707193930,1707193930.674016,-21600,EB445137-D7F5-57EC-87DA-1DB460D64046,"iPhone13,2"
com.apple.Health,33,1707193624,1707193657,1707193657.6153889,-21600,EB445137-D7F5-57EC-87DA-1DB460D64046,"iPhone13,2"
com.apple.Music,1,1707193623,1707193624,1707193624.940669,-21600,EB445137-D7F5-57EC-87DA-1DB460D64046,"iPhone13,2"
com.apple.Music,11,1707193595,1707193606,1707193606.777041,-21600,EB445137-D7F5-57EC-87DA-1DB460D64046,"iPhone13,2"
com.apple.Music,11,1707193579,1707193590,1707193590.947003,-21600,EB445137-D7F5-57EC-87DA-1DB460D64046,"iPhone13,2"
com.apple.Music,9,1707192447,1707192456,1707192456.892195,-21600,EB445137-D7F5-57EC-87DA-1DB460D64046,"iPhone13,2"
com.apple.Music,1,1707192444,1707192445,1707192445.6909971,-21600,EB445137-D7F5-57EC-87DA-1DB460D64046,"iPhone13,2"
com.apple.Music,35,1707192357,1707192392,1707192393.95429,-21600,EB445137-D7F5-57EC-87DA-1DB460D64046,"iPhone13,2"
com.apple.calculator,3,1707192350,1707192353,1707192354.810981,-21600,EB445137-D7F5-57EC-87DA-1DB460D64046,"iPhone13,2"
com.apple.calculator,8,1707192209,1707192217,1707192217.116506,-21600,EB445137-D7F5-57EC-87DA-1DB460D64046,"iPhone13,2"
com.leomehlig.today,92,1707192080,1707192172,1707192172.8964171,-21600,,
com.apple.Preview,25,1707192055,1707192080,1707192080.97653,-21600,,
com.apple.Preview,324,1707191645,1707191969,1707191969.866157,-21600,,
com.google.Chrome,8,1707191637,1707191645,1707191645.775413,-21600,,
com.apple.Preview,152,1707191485,1707191637,1707191637.853096,-21600,,
com.google.Chrome,48,1707191437,1707191485,1707191485.534184,-21600,,
com.apple.calculator,41,1707191307,1707191348,1707191348.165025,-21600,EB445137-D7F5-57EC-87DA-1DB460D64046,"iPhone13,2"
com.google.Chrome,305,1707191083,1707191388,1707191388.992118,-21600,,
com.apple.Preview,146,1707190937,1707191083,1707191083.2165341,-21600,,
co.hinge.mobile.ios,159,1707190478,1707190637,1707190637.620785,-21600,EB445137-D7F5-57EC-87DA-1DB460D64046,"iPhone13,2"
com.apple.news,39,1707190310,1707190349,1707190349.869254,-21600,EB445137-D7F5-57EC-87DA-1DB460D64046,"iPhone13,2"
com.google.Maps,2,1707190158,1707190160,1707190160.981992,-21600,EB445137-D7F5-57EC-87DA-1DB460D64046,"iPhone13,2"
com.google.chrome.ios,6,1707190152,1707190158,1707190158.938726,-21600,EB445137-D7F5-57EC-87DA-1DB460D64046,"iPhone13,2"
com.instructure.icanvas,17,1707190135,1707190152,1707190152.658071,-21600,EB445137-D7F5-57EC-87DA-1DB460D64046,"iPhone13,2"
com.google.Chrome,992,1707189945,1707190937,1707190937.50699,-21600,,
com.google.Chrome,315,1707189595,1707189910,1707189910.0145512,-21600,,
com.apple.Preview,94,1707189501,1707189595,1707189595.7113729,-21600,,
com.google.Chrome,2,1707189499,1707189501,1707189501.2587109,-21600,,
com.apple.Preview,19,1707189480,1707189499,1707189499.548239,-21600,,
com.apple.finder,3,1707189477,1707189480,1707189480.938066,-21600,,
com.google.Chrome,468,1707189009,1707189477,1707189478.060409,-21600,,
com.leomehlig.today,47,1707188962,1707189009,1707189009.7234712,-21600,,
com.apple.systempreferences,0,1707188956,1707188956,1707188956.73089,-21600,,
com.google.Chrome,639,1707188317,1707188956,1707188956.226338,-21600,,
com.leomehlig.today,9,1707188308,1707188317,1707188317.9541721,-21600,,
com.toyopagroup.picaboo,21,1707187987,1707188008,1707188008.9838948,-21600,EB445137-D7F5-57EC-87DA-1DB460D64046,"iPhone13,2"
com.apple.MobileSMS,5,1707187982,1707187987,1707187987.093487,-21600,EB445137-D7F5-57EC-87DA-1DB460D64046,"iPhone13,2"
com.google.Chrome,1057,1707187251,1707188308,1707188308.797627,-21600,,
com.microsoft.Outlook,2,1707187249,1707187251,1707187251.579699,-21600,,
com.google.Chrome,125,1707187124,1707187249,1707187249.786087,-21600,,
com.apple.MobileSMS,10,1707186900,1707186910,1707186910.75344,-21600,EB445137-D7F5-57EC-87DA-1DB460D64046,"iPhone13,2"
com.apple.MobileSMS,2,1707186897,1707186899,1707186899.4406981,-21600,EB445137-D7F5-57EC-87DA-1DB460D64046,"iPhone13,2"
com.apple.InCallService,1,1707186896,1707186897,1707186897.3939,-21600,EB445137-D7F5-57EC-87DA-1DB460D64046,"iPhone13,2"
com.apple.InCallService,1,1707186602,1707186603,1707186603.8809109,-21600,EB445137-D7F5-57EC-87DA-1DB460D64046,"iPhone13,2"
com.apple.InCallService,1,1707186595,1707186596,1707186596.9160771,-21600,EB445137-D7F5-57EC-87DA-1DB460D64046,"iPhone13,2"
com.apple.MobileSMS,9,1707186586,1707186595,1707186595.2719011,-21600,EB445137-D7F5-57EC-87DA-1DB460D64046,"iPhone13,2"
com.apple.findmy,2,1707186581,1707186583,1707186584.06706,-21600,EB445137-D7F5-57EC-87DA-1DB460D64046,"iPhone13,2"
com.apple.findmy,5,1707186575,1707186580,1707186580.5298328,-21600,EB445137-D7F5-57EC-87DA-1DB460D64046,"iPhone13,2"
com.apple.findmy,13,1707186528,1707186541,1707186541.558519,-21600,EB445137-D7F5-57EC-87DA-1DB460D64046,"iPhone13,2"
com.apple.findmy,12,1707186428,1707186440,1707186440.103116,-21600,EB445137-D7F5-57EC-87DA-1DB460D64046,"iPhone13,2"
com.apple.Maps,4,1707186423,1707186427,1707186427.638536,-21600,EB445137-D7F5-57EC-87DA-1DB460D64046,"iPhone13,2"
com.apple.Maps,1,1707186417,1707186418,1707186418.695747,-21600,EB445137-D7F5-57EC-87DA-1DB460D64046,"iPhone13,2"
com.apple.Maps,2,1707186409,1707186411,1707186411.416637,-21600,EB445137-D7F5-57EC-87DA-1DB460D64046,"iPhone13,2"
com.apple.Maps,2,1707186248,1707186250,1707186250.647509,-21600,EB445137-D7F5-57EC-87DA-1DB460D64046,"iPhone13,2"
com.apple.Maps,23,1707186110,1707186133,1707186133.5921268,-21600,EB445137-D7F5-57EC-87DA-1DB460D64046,"iPhone13,2"
com.apple.Maps,14,1707186095,1707186109,1707186109.8473902,-21600,EB445137-D7F5-57EC-87DA-1DB460D64046,"iPhone13,2"
com.apple.Maps,1,1707186084,1707186085,1707186085.922892,-21600,EB445137-D7F5-57EC-87DA-1DB460D64046,"iPhone13,2"
com.apple.Maps,4,1707186068,1707186072,1707186072.0830688,-21600,EB445137-D7F5-57EC-87DA-1DB460D64046,"iPhone13,2"
com.apple.Maps,32,1707185928,1707185960,1707185960.317822,-21600,EB445137-D7F5-57EC-87DA-1DB460D64046,"iPhone13,2"
com.microsoft.Office.Outlook,9,1707185843,1707185852,1707185852.927648,-21600,EB445137-D7F5-57EC-87DA-1DB460D64046,"iPhone13,2"
com.google.Maps,28,1707185812,1707185840,1707185840.666635,-21600,EB445137-D7F5-57EC-87DA-1DB460D64046,"iPhone13,2"
com.toyopagroup.picaboo,5,1707185806,1707185811,1707185812.151634,-21600,EB445137-D7F5-57EC-87DA-1DB460D64046,"iPhone13,2"
com.toyopagroup.picaboo,10,1707181519,1707181529,1707181529.777101,-21600,EB445137-D7F5-57EC-87DA-1DB460D64046,"iPhone13,2"
com.toyopagroup.picaboo,2,1707181494,1707181496,1707181496.5907412,-21600,EB445137-D7F5-57EC-87DA-1DB460D64046,"iPhone13,2"
com.toyopagroup.picaboo,15,1707181432,1707181447,1707181447.284606,-21600,EB445137-D7F5-57EC-87DA-1DB460D64046,"iPhone13,2"
com.toyopagroup.picaboo,14,1707181392,1707181406,1707181406.3024712,-21600,EB445137-D7F5-57EC-87DA-1DB460D64046,"iPhone13,2"
com.google.Gmail,8,1707181204,1707181212,1707181212.294213,-21600,EB445137-D7F5-57EC-87DA-1DB460D64046,"iPhone13,2"
com.hammerandchisel.discord,3,1707181201,1707181204,1707181204.593703,-21600,EB445137-D7F5-57EC-87DA-1DB460D64046,"iPhone13,2"
com.hammerandchisel.discord,2,1707181157,1707181159,1707181159.26561,-21600,EB445137-D7F5-57EC-87DA-1DB460D64046,"iPhone13,2"
com.hammerandchisel.discord,2,1707181000,1707181002,1707181002.544451,-21600,EB445137-D7F5-57EC-87DA-1DB460D64046,"iPhone13,2"
com.hammerandchisel.discord,7,1707180948,1707180955,1707180956.440671,-21600,EB445137-D7F5-57EC-87DA-1DB460D64046,"iPhone13,2"
com.hammerandchisel.discord,1,1707180946,1707180947,1707180947.870053,-21600,EB445137-D7F5-57EC-87DA-1DB460D64046,"iPhone13,2"
com.hammerandchisel.discord,5,1707180751,1707180756,1707180756.992948,-21600,EB445137-D7F5-57EC-87DA-1DB460D64046,"iPhone13,2"
com.google.Maps,5,1707180746,1707180751,1707180751.8609571,-21600,EB445137-D7F5-57EC-87DA-1DB460D64046,"iPhone13,2"
com.google.Maps,8,1707180498,1707180506,1707180506.45617,-21600,EB445137-D7F5-57EC-87DA-1DB460D64046,"iPhone13,2"
com.google.chrome.ios,16,1707180482,1707180498,1707180499.337224,-21600,EB445137-D7F5-57EC-87DA-1DB460D64046,"iPhone13,2"
com.microsoft.Office.Outlook,17,1707180465,1707180482,1707180483.569999,-21600,EB445137-D7F5-57EC-87DA-1DB460D64046,"iPhone13,2"
com.google.Maps,3,1707180461,1707180464,1707180464.353112,-21600,EB445137-D7F5-57EC-87DA-1DB460D64046,"iPhone13,2"
com.google.Maps,4,1707180447,1707180451,1707180451.362004,-21600,EB445137-D7F5-57EC-87DA-1DB460D64046,"iPhone13,2"
com.google.Maps,1,1707180412,1707180413,1707180413.996159,-21600,EB445137-D7F5-57EC-87DA-1DB460D64046,"iPhone13,2"
com.google.Maps,34,1707180173,1707180207,1707180208.025789,-21600,EB445137-D7F5-57EC-87DA-1DB460D64046,"iPhone13,2"
com.google.chrome.ios,79,1707179796,1707179875,1707179875.685522,-21600,EB445137-D7F5-57EC-87DA-1DB460D64046,"iPhone13,2"
com.google.Maps,10,1707179560,1707179570,1707179570.596274,-21600,EB445137-D7F5-57EC-87DA-1DB460D64046,"iPhone13,2"
com.google.Maps,2,1707179519,1707179521,1707179521.7881079,-21600,EB445137-D7F5-57EC-87DA-1DB460D64046,"iPhone13,2"
com.google.Chrome,783,1707178408,1707179191,1707179192.3758159,-21600,,
com.google.Maps,2,1707178344,1707178346,1707178346.1419559,-21600,EB445137-D7F5-57EC-87DA-1DB460D64046,"iPhone13,2"
com.google.Maps,37,1707178307,1707178344,1707178344.0943189,-21600,EB445137-D7F5-57EC-87DA-1DB460D64046,"iPhone13,2"
com.google.Maps,31,1707178271,1707178302,1707178302.852457,-21600,EB445137-D7F5-57EC-87DA-1DB460D64046,"iPhone13,2"
com.google.Chrome,60,1707178209,1707178269,1707178269.457479,-21600,,
com.microsoft.Outlook,27,1707178182,1707178209,1707178209.8329968,-21600,,
com.apple.Preview,1,1707178181,1707178182,1707178182.417076,-21600,,
com.microsoft.Outlook,2,1707178179,1707178181,1707178181.29044,-21600,,
com.apple.Notes,1,1707178178,1707178179,1707178179.768122,-21600,,
com.microsoft.Outlook,2,1707178176,1707178178,1707178178.515598,-21600,,
com.leomehlig.today,31,1707178145,1707178176,1707178176.368887,-21600,,
com.google.Maps,50,1707177706,1707177756,1707177756.0404549,-21600,EB445137-D7F5-57EC-87DA-1DB460D64046,"iPhone13,2"
com.facebook.Facebook,247,1707176538,1707176785,1707176785.567235,-21600,EB445137-D7F5-57EC-87DA-1DB460D64046,"iPhone13,2"
com.peacocktv.peacock,1484,1707175035,1707176519,1707176519.458736,-21600,EB445137-D7F5-57EC-87DA-1DB460D64046,"iPhone13,2"
edu.illinois.rokwire.ios,19,1707174726,1707174745,1707174745.059032,-21600,EB445137-D7F5-57EC-87DA-1DB460D64046,"iPhone13,2"
com.apple.Health,25,1707174660,1707174685,1707174685.597583,-21600,EB445137-D7F5-57EC-87DA-1DB460D64046,"iPhone13,2"
com.thestorygraph.thestorygraph,22,1707174636,1707174658,1707174658.4129338,-21600,EB445137-D7F5-57EC-87DA-1DB460D64046,"iPhone13,2"
com.microsoft.Office.Outlook,15,1707173184,1707173199,1707173199.64178,-21600,EB445137-D7F5-57EC-87DA-1DB460D64046,"iPhone13,2"
com.apple.MobileSMS,2,1707172316,1707172318,1707172318.787883,-21600,EB445137-D7F5-57EC-87DA-1DB460D64046,"iPhone13,2"
com.apple.MobileSMS,6,1707172266,1707172272,1707172273.0354571,-21600,EB445137-D7F5-57EC-87DA-1DB460D64046,"iPhone13,2"
com.apple.MobileSMS,11,1707172230,1707172241,1707172241.1864738,-21600,EB445137-D7F5-57EC-87DA-1DB460D64046,"iPhone13,2"
com.apple.MobileSMS,17,1707172072,1707172089,1707172089.783057,-21600,EB445137-D7F5-57EC-87DA-1DB460D64046,"iPhone13,2"
com.instructure.icanvas,2,1707172070,1707172072,1707172072.938201,-21600,EB445137-D7F5-57EC-87DA-1DB460D64046,"iPhone13,2"
com.instructure.icanvas,6,1707171947,1707171953,1707171953.468207,-21600,EB445137-D7F5-57EC-87DA-1DB460D64046,"iPhone13,2"
com.microsoft.Office.Outlook,5,1707171942,1707171947,1707171947.394371,-21600,EB445137-D7F5-57EC-87DA-1DB460D64046,"iPhone13,2"
com.microsoft.Office.Outlook,31,1707171703,1707171734,1707171734.4188728,-21600,EB445137-D7F5-57EC-87DA-1DB460D64046,"iPhone13,2"
com.apple.MobileSMS,45,1707171566,1707171611,1707171611.6635041,-21600,EB445137-D7F5-57EC-87DA-1DB460D64046,"iPhone13,2"
com.apple.MobileSMS,7,1707171155,1707171162,1707171162.803637,-21600,EB445137-D7F5-57EC-87DA-1DB460D64046,"iPhone13,2"
com.apple.MobileSMS,2,1707171145,1707171147,1707171147.844118,-21600,EB445137-D7F5-57EC-87DA-1DB460D64046,"iPhone13,2"
com.apple.InCallService,1,1707171144,1707171145,1707171145.8750892,-21600,EB445137-D7F5-57EC-87DA-1DB460D64046,"iPhone13,2"
com.apple.InCallService,2,1707170770,1707170772,1707170772.517688,-21600,EB445137-D7F5-57EC-87DA-1DB460D64046,"iPhone13,2"
com.apple.MobileSMS,9,1707170761,1707170770,1707170770.959774,-21600,EB445137-D7F5-57EC-87DA-1DB460D64046,"iPhone13,2"
com.apple.MobileSMS,13,1707170748,1707170761,1707170762.060731,-21600,EB445137-D7F5-57EC-87DA-1DB460D64046,"iPhone13,2"
com.burbn.instagram,79,1707169357,1707169436,1707169436.3485289,-21600,EB445137-D7F5-57EC-87DA-1DB460D64046,"iPhone13,2"
com.apple.mobilecal,7,1707167626,1707167633,1707167633.0240932,-21600,EB445137-D7F5-57EC-87DA-1DB460D64046,"iPhone13,2"
com.apple.news,359,1707166529,1707166888,1707166888.3282871,-21600,EB445137-D7F5-57EC-87DA-1DB460D64046,"iPhone13,2"
com.apple.news,3,1707166524,1707166527,1707166527.730161,-21600,EB445137-D7F5-57EC-87DA-1DB460D64046,"iPhone13,2"
com.apple.MobileSMS,2,1707166516,1707166518,1707166519.121217,-21600,EB445137-D7F5-57EC-87DA-1DB460D64046,"iPhone13,2"
com.microsoft.Office.Outlook,11,1707166504,1707166515,1707166515.951407,-21600,EB445137-D7F5-57EC-87DA-1DB460D64046,"iPhone13,2"
com.microsoft.Office.Outlook,6,1707166109,1707166115,1707166115.976472,-21600,EB445137-D7F5-57EC-87DA-1DB460D64046,"iPhone13,2"
com.leomehlig.today,40,1707166050,1707166090,1707166090.782193,-21600,,
com.microsoft.Office.Outlook,10,1707165900,1707165910,1707165910.4028049,-21600,EB445137-D7F5-57EC-87DA-1DB460D64046,"iPhone13,2"
com.microsoft.Office.Outlook,6,1707165561,1707165567,1707165567.9008079,-21600,EB445137-D7F5-57EC-87DA-1DB460D64046,"iPhone13,2"
com.microsoft.Office.Outlook,46,1707165411,1707165457,1707165457.498874,-21600,EB445137-D7F5-57EC-87DA-1DB460D64046,"iPhone13,2"
com.apple.news,8,1707165403,1707165411,1707165411.998524,-21600,EB445137-D7F5-57EC-87DA-1DB460D64046,"iPhone13,2"
com.google.Chrome,751,1707165299,1707166050,1707166051.012982,-21600,,
com.google.Chrome,337,1707164888,1707165225,1707165225.686911,-21600,,
com.leomehlig.today,15,1707164873,1707164888,1707164888.102404,-21600,,
com.google.Chrome,515,1707164358,1707164873,1707164873.209593,-21600,,
com.apple.finder,2,1707164356,1707164358,1707164358.1769152,-21600,,
com.apple.Preview,6,1707164350,1707164356,1707164356.850167,-21600,,
com.apple.finder,5,1707164345,1707164350,1707164350.117549,-21600,,
com.google.Chrome,2,1707164343,1707164345,1707164345.634552,-21600,,
com.microsoft.Word,1,1707164342,1707164343,1707164343.585966,-21600,,
com.google.Chrome,121,1707164221,1707164342,1707164342.31409,-21600,,
com.leomehlig.today,32,1707164189,1707164221,1707164221.646812,-21600,,
com.google.Chrome,13,1707164176,1707164189,1707164189.463297,-21600,,
com.apple.finder,1,1707164175,1707164176,1707164176.69374,-21600,,
com.apple.Preview,22,1707164153,1707164175,1707164175.8984919,-21600,,
com.apple.finder,12,1707164141,1707164153,1707164153.8051229,-21600,,
com.google.Chrome,21,1707164120,1707164141,1707164141.301754,-21600,,
com.microsoft.Word,11,1707164109,1707164120,1707164120.3267488,-21600,,
com.google.Chrome,2,1707164107,1707164109,1707164109.376811,-21600,,
com.microsoft.Word,2,1707164105,1707164107,1707164107.578387,-21600,,
com.google.Chrome,1,1707164104,1707164105,1707164105.6002002,-21600,,
com.microsoft.Word,7,1707164097,1707164104,1707164104.456418,-21600,,
com.google.Chrome,1,1707164096,1707164097,1707164098.0359712,-21600,,
com.microsoft.Word,8,1707164088,1707164096,1707164096.996005,-21600,,
com.google.Chrome,2,1707164086,1707164088,1707164088.23438,-21600,,
com.microsoft.Word,16,1707164070,1707164086,1707164086.726869,-21600,,
com.google.Chrome,8,1707164062,1707164070,1707164070.113608,-21600,,
com.microsoft.Word,47,1707164015,1707164062,1707164062.635028,-21600,,
com.google.Chrome,4,1707164011,1707164015,1707164015.293867,-21600,,
com.microsoft.Word,37,1707163974,1707164011,1707164011.2921329,-21600,,
com.google.Chrome,706,1707163268,1707163974,1707163974.9296489,-21600,,
com.microsoft.Word,26,1707163242,1707163268,1707163268.781489,-21600,,
com.google.Chrome,5,1707163237,1707163242,1707163242.6472669,-21600,,
com.microsoft.Word,73,1707163164,1707163237,1707163238.0252972,-21600,,
com.google.Chrome,6,1707163158,1707163164,1707163164.321928,-21600,,
com.microsoft.Word,11,1707163147,1707163158,1707163158.7968411,-21600,,
com.google.Chrome,7,1707163140,1707163147,1707163147.8462381,-21600,,
com.microsoft.Word,5,1707163135,1707163140,1707163140.5688019,-21600,,
com.google.Chrome,2,1707163133,1707163135,1707163135.389684,-21600,,
com.microsoft.Word,2,1707163131,1707163133,1707163133.7776,-21600,,
com.google.Chrome,20,1707163111,1707163131,1707163131.1077762,-21600,,
com.microsoft.Word,30,1707163081,1707163111,1707163111.331173,-21600,,
com.google.Chrome,6,1707163075,1707163081,1707163081.051048,-21600,,
com.microsoft.Word,14,1707163061,1707163075,1707163075.88047,-21600,,
com.google.Chrome,1,1707163060,1707163061,1707163061.845803,-21600,,
com.microsoft.Word,95,1707162965,1707163060,1707163060.7872062,-21600,,
com.google.Chrome,107,1707162858,1707162965,1707162965.180753,-21600,,
com.microsoft.Word,8,1707162850,1707162858,1707162858.252623,-21600,,
com.apple.iCal,150,1707162700,1707162850,1707162850.301682,-21600,,
com.microsoft.Word,3,1707162697,1707162700,1707162700.101167,-21600,,
com.microsoft.Word,7,1707159506,1707159513,1707159513.9477239,-21600,,
com.google.Chrome,47,1707159459,1707159506,1707159506.8726768,-21600,,
com.microsoft.Word,475,1707158984,1707159459,1707159459.8017778,-21600,,
com.google.Chrome,94,1707158890,1707158984,1707158984.841727,-21600,,
com.microsoft.Word,14,1707158876,1707158890,1707158890.915351,-21600,,
com.google.Chrome,0,1707158876,1707158876,1707158877.0167031,-21600,,
com.microsoft.Word,27,1707158849,1707158876,1707158876.3820329,-21600,,
com.google.Chrome,0,1707158849,1707158849,1707158849.982899,-21600,,
com.microsoft.Word,101,1707158748,1707158849,1707158849.290354,-21600,,
com.google.Chrome,0,1707158748,1707158748,1707158748.8296762,-21600,,
com.microsoft.Word,34,1707158714,1707158748,1707158748.209434,-21600,,
com.google.Chrome,35,1707158679,1707158714,1707158714.983801,-21600,,
com.microsoft.Word,24,1707158655,1707158679,1707158679.203923,-21600,,
com.google.Chrome,2,1707158653,1707158655,1707158655.053584,-21600,,
com.microsoft.Word,76,1707158577,1707158653,1707158653.8012471,-21600,,
com.google.Chrome,4,1707158573,1707158577,1707158577.620034,-21600,,
com.microsoft.Word,37,1707158536,1707158573,1707158573.121749,-21600,,
com.google.Chrome,123,1707158413,1707158536,1707158536.074411,-21600,,
com.microsoft.Word,28,1707158385,1707158413,1707158413.787307,-21600,,
com.google.Chrome,0,1707158385,1707158385,1707158385.949954,-21600,,
com.microsoft.Word,12,1707158373,1707158385,1707158385.235815,-21600,,
com.google.Chrome,194,1707158179,1707158373,1707158373.663671,-21600,,
com.microsoft.Word,111,1707158068,1707158179,1707158179.9330292,-21600,,
com.google.Chrome,3,1707158065,1707158068,1707158068.185683,-21600,,
com.microsoft.Word,6,1707158059,1707158065,1707158065.5486012,-21600,,
com.google.Chrome,1,1707158058,1707158059,1707158059.275094,-21600,,
com.microsoft.Word,1,1707158057,1707158058,1707158058.72019,-21600,,
com.google.Chrome,1,1707158056,1707158057,1707158057.8494558,-21600,,
com.microsoft.Word,0,1707158056,1707158056,1707158056.8853068,-21600,,
com.google.Chrome,5,1707158051,1707158056,1707158056.088297,-21600,,
com.microsoft.Word,1,1707158050,1707158051,1707158051.390829,-21600,,
com.google.Chrome,1,1707158049,1707158050,1707158050.47397,-21600,,
com.microsoft.Word,2,1707158047,1707158049,1707158049.2422419,-21600,,
com.google.Chrome,14,1707158033,1707158047,1707158047.387175,-21600,,
com.microsoft.Word,0,1707158033,1707158033,1707158033.9493861,-21600,,
com.google.Chrome,36,1707157997,1707158033,1707158033.109501,-21600,,
com.microsoft.Word,8,1707157989,1707157997,1707157997.57042,-21600,,
com.google.Chrome,9,1707157980,1707157989,1707157989.8264809,-21600,,
com.microsoft.Word,4,1707157976,1707157980,1707157980.3199549,-21600,,
com.google.Chrome,0,1707157976,1707157976,1707157976.801803,-21600,,
com.microsoft.Word,12,1707157964,1707157976,1707157976.0665379,-21600,,
com.google.Chrome,11,1707157953,1707157964,1707157964.2292929,-21600,,
com.microsoft.Word,5,1707157948,1707157953,1707157953.596009,-21600,,
com.google.Chrome,1,1707157947,1707157948,1707157948.740371,-21600,,
com.microsoft.Word,3,1707157944,1707157947,1707157947.352559,-21600,,
com.google.Chrome,3,1707157941,1707157944,1707157944.435355,-21600,,
com.microsoft.Word,10,1707157931,1707157941,1707157941.757328,-21600,,
com.google.Chrome,2,1707157929,1707157931,1707157931.1697922,-21600,,
com.microsoft.Word,3,1707157926,1707157929,1707157929.867984,-21600,,
com.google.Chrome,5,1707157921,1707157926,1707157926.078034,-21600,,
com.microsoft.Word,4,1707157917,1707157921,1707157921.251354,-21600,,
com.google.Chrome,8,1707157909,1707157917,1707157917.309111,-21600,,
com.microsoft.Word,4,1707157905,1707157909,1707157909.1174688,-21600,,
com.google.Chrome,1,1707157904,1707157905,1707157905.9169888,-21600,,
com.microsoft.Word,10,1707157894,1707157904,1707157904.135387,-21600,,
com.google.Chrome,2,1707157892,1707157894,1707157894.915934,-21600,,
com.microsoft.Word,2,1707157890,1707157892,1707157892.1655521,-21600,,
com.google.Chrome,8,1707157882,1707157890,1707157890.4678168,-21600,,
com.microsoft.Word,16,1707157866,1707157882,1707157882.7717829,-21600,,
com.apple.finder,8,1707157858,1707157866,1707157866.447962,-21600,,
com.google.Chrome,60,1707157798,1707157858,1707157858.8881779,-21600,,
com.apple.news,2,1707157576,1707157578,1707157578.330645,-21600,EB445137-D7F5-57EC-87DA-1DB460D64046,"iPhone13,2"
com.apple.camera,1,1707157355,1707157356,1707157356.4356642,-21600,EB445137-D7F5-57EC-87DA-1DB460D64046,"iPhone13,2"
com.apple.news,10,1707157352,1707157362,1707157362.4007092,-21600,EB445137-D7F5-57EC-87DA-1DB460D64046,"iPhone13,2"
com.apple.news,1,1707157187,1707157188,1707157188.4952312,-21600,EB445137-D7F5-57EC-87DA-1DB460D64046,"iPhone13,2"
com.apple.news,3,1707156934,1707156937,1707156937.121737,-21600,EB445137-D7F5-57EC-87DA-1DB460D64046,"iPhone13,2"
com.apple.news,299,1707156571,1707156870,1707156870.788394,-21600,EB445137-D7F5-57EC-87DA-1DB460D64046,"iPhone13,2"
com.apple.podcasts,2,1707156557,1707156559,1707156559.405508,-21600,EB445137-D7F5-57EC-87DA-1DB460D64046,"iPhone13,2"
com.instructure.icanvas,4,1707156529,1707156533,1707156533.945547,-21600,EB445137-D7F5-57EC-87DA-1DB460D64046,"iPhone13,2"
com.instructure.icanvas,6,1707156433,1707156439,1707156439.295106,-21600,EB445137-D7F5-57EC-87DA-1DB460D64046,"iPhone13,2"
com.instructure.icanvas,110,1707156310,1707156420,1707156420.711228,-21600,EB445137-D7F5-57EC-87DA-1DB460D64046,"iPhone13,2"
edu.illinois.rokwire.ios,4,1707156306,1707156310,1707156310.567195,-21600,EB445137-D7F5-57EC-87DA-1DB460D64046,"iPhone13,2"
edu.illinois.rokwire.ios,36,1707155452,1707155488,1707155488.706592,-21600,EB445137-D7F5-57EC-87DA-1DB460D64046,"iPhone13,2"
com.apple.MobileSMS,4,1707155448,1707155452,1707155452.164322,-21600,EB445137-D7F5-57EC-87DA-1DB460D64046,"iPhone13,2"
com.apple.MobileSMS,4,1707155443,1707155447,1707155447.6632261,-21600,EB445137-D7F5-57EC-87DA-1DB460D64046,"iPhone13,2"
com.apple.camera,1,1707155443,1707155444,1707155444.568634,-21600,EB445137-D7F5-57EC-87DA-1DB460D64046,"iPhone13,2"
com.apple.MobileSMS,8,1707155370,1707155378,1707155378.863305,-21600,EB445137-D7F5-57EC-87DA-1DB460D64046,"iPhone13,2"
com.google.Gmail,6,1707152528,1707152534,1707152534.280832,-21600,EB445137-D7F5-57EC-87DA-1DB460D64046,"iPhone13,2"
com.instructure.icanvas,6,1707152370,1707152376,1707152376.368099,-21600,EB445137-D7F5-57EC-87DA-1DB460D64046,"iPhone13,2"
com.burbn.instagram,63,1707152300,1707152363,1707152363.965255,-21600,EB445137-D7F5-57EC-87DA-1DB460D64046,"iPhone13,2"
com.instructure.icanvas,4,1707152288,1707152292,1707152292.6587071,-21600,EB445137-D7F5-57EC-87DA-1DB460D64046,"iPhone13,2"
com.amazon.Amazon,80,1707152204,1707152284,1707152284.479676,-21600,EB445137-D7F5-57EC-87DA-1DB460D64046,"iPhone13,2"
com.apple.MobileSMS,2,1707152200,1707152202,1707152202.4181051,-21600,EB445137-D7F5-57EC-87DA-1DB460D64046,"iPhone13,2"
com.apple.MobileSMS,19,1707152125,1707152144,1707152145.0585032,-21600,EB445137-D7F5-57EC-87DA-1DB460D64046,"iPhone13,2"
com.truebill.truebillnative,13,1707152086,1707152099,1707152099.523117,-21600,EB445137-D7F5-57EC-87DA-1DB460D64046,"iPhone13,2"
com.truebill.truebillnative,97,1707151771,1707151868,1707151868.652916,-21600,EB445137-D7F5-57EC-87DA-1DB460D64046,"iPhone13,2"
com.ryansponzilli.DeepSkyCatalog,45,1707151718,1707151763,1707151763.424444,-21600,EB445137-D7F5-57EC-87DA-1DB460D64046,"iPhone13,2"
Astrospheric.Astrospheric,5,1707151710,1707151715,1707151715.564883,-21600,EB445137-D7F5-57EC-87DA-1DB460D64046,"iPhone13,2"
com.tier9digital.sundial,6,1707151704,1707151710,1707151711.057884,-21600,EB445137-D7F5-57EC-87DA-1DB460D64046,"iPhone13,2"
Astrospheric.Astrospheric,25,1707151673,1707151698,1707151698.904218,-21600,EB445137-D7F5-57EC-87DA-1DB460D64046,"iPhone13,2"
com.microsoft.Office.Outlook,60,1707151604,1707151664,1707151664.513089,-21600,EB445137-D7F5-57EC-87DA-1DB460D64046,"iPhone13,2"
com.google.chrome.ios,5,1707151598,1707151603,1707151603.923355,-21600,EB445137-D7F5-57EC-87DA-1DB460D64046,"iPhone13,2"
com.google.chrome.ios,4,1707151225,1707151229,1707151229.240679,-21600,EB445137-D7F5-57EC-87DA-1DB460D64046,"iPhone13,2"
com.google.chrome.ios,70,1707150925,1707150995,1707150996.337076,-21600,EB445137-D7F5-57EC-87DA-1DB460D64046,"iPhone13,2"
com.instructure.icanvas,50,1707150875,1707150925,1707150925.686785,-21600,EB445137-D7F5-57EC-87DA-1DB460D64046,"iPhone13,2"
com.leomehlig.today,10,1707150864,1707150874,1707150874.9151878,-21600,EB445137-D7F5-57EC-87DA-1DB460D64046,"iPhone13,2"
com.google.Maps,15,1707150838,1707150853,1707150853.376769,-21600,EB445137-D7F5-57EC-87DA-1DB460D64046,"iPhone13,2"
com.google.Maps,1,1707150633,1707150634,1707150634.626229,-21600,EB445137-D7F5-57EC-87DA-1DB460D64046,"iPhone13,2"
com.google.Maps,8,1707150607,1707150615,1707150615.3291779,-21600,EB445137-D7F5-57EC-87DA-1DB460D64046,"iPhone13,2"
com.google.Chrome,415,1707150033,1707150448,1707150448.356368,-21600,,
com.hammerandchisel.discord,23,1707149955,1707149978,1707149978.8010879,-21600,EB445137-D7F5-57EC-87DA-1DB460D64046,"iPhone13,2"
com.google.Chrome,604,1707147489,1707148093,1707148094.1353831,-21600,,
com.peacocktv.peacock,1492,1707145228,1707146720,1707146720.482785,-21600,EB445137-D7F5-57EC-87DA-1DB460D64046,"iPhone13,2"
com.google.Maps,9,1707144769,1707144778,1707144778.926676,-21600,EB445137-D7F5-57EC-87DA-1DB460D64046,"iPhone13,2"
com.google.Maps,17,1707144639,1707144656,1707144656.737318,-21600,EB445137-D7F5-57EC-87DA-1DB460D64046,"iPhone13,2"
com.apple.Health,13,1707144295,1707144308,1707144308.6707602,-21600,EB445137-D7F5-57EC-87DA-1DB460D64046,"iPhone13,2"
com.apple.Health,23,1707144186,1707144209,1707144210.471487,-21600,EB445137-D7F5-57EC-87DA-1DB460D64046,"iPhone13,2"
com.thestorygraph.thestorygraph,5,1707144178,1707144183,1707144183.966353,-21600,EB445137-D7F5-57EC-87DA-1DB460D64046,"iPhone13,2"
com.thestorygraph.thestorygraph,29,1707144000,1707144029,1707144029.895107,-21600,EB445137-D7F5-57EC-87DA-1DB460D64046,"iPhone13,2"
com.thestorygraph.thestorygraph,13,1707111135,1707111148,1707111148.640329,-21600,EB445137-D7F5-57EC-87DA-1DB460D64046,"iPhone13,2"
com.thestorygraph.thestorygraph,3,1707111125,1707111128,1707111128.7963529,-21600,EB445137-D7F5-57EC-87DA-1DB460D64046,"iPhone13,2"
com.thestorygraph.thestorygraph,34,1707110933,1707110967,1707110967.718765,-21600,EB445137-D7F5-57EC-87DA-1DB460D64046,"iPhone13,2"
com.apple.Health,12,1707108782,1707108794,1707108794.371372,-21600,EB445137-D7F5-57EC-87DA-1DB460D64046,"iPhone13,2"
com.apple.Health,64,1707107451,1707107515,1707107515.7620559,-21600,EB445137-D7F5-57EC-87DA-1DB460D64046,"iPhone13,2"
com.apple.MobileSMS,2,1707104969,1707104971,1707104971.494326,-21600,EB445137-D7F5-57EC-87DA-1DB460D64046,"iPhone13,2"
com.apple.MobileSMS,3,1707104966,1707104969,1707104969.6719298,-21600,EB445137-D7F5-57EC-87DA-1DB460D64046,"iPhone13,2"
com.google.Chrome,109,1707104961,1707105070,1707105070.782885,-21600,,
com.leomehlig.today,48,1707104913,1707104961,1707104962.0346498,-21600,,
com.apple.Notes,5,1707104908,1707104913,1707104913.803234,-21600,,
com.leomehlig.today,1,1707104907,1707104908,1707104908.5079699,-21600,,
com.apple.Notes,14,1707104893,1707104907,1707104907.439062,-21600,,
com.leomehlig.today,2,1707104891,1707104893,1707104893.958768,-21600,,
com.apple.Notes,13,1707104878,1707104891,1707104891.701391,-21600,,
com.leomehlig.today,213,1707104665,1707104878,1707104878.716319,-21600,,
com.apple.MobileSMS,4,1707104623,1707104627,1707104627.491782,-21600,EB445137-D7F5-57EC-87DA-1DB460D64046,"iPhone13,2"
com.apple.MobileSMS,17,1707103630,1707103647,1707103648.1052709,-21600,EB445137-D7F5-57EC-87DA-1DB460D64046,"iPhone13,2"
com.toyopagroup.picaboo,25,1707103175,1707103200,1707103200.4526482,-21600,EB445137-D7F5-57EC-87DA-1DB460D64046,"iPhone13,2"
com.apple.weather,9,1707103166,1707103175,1707103175.1533608,-21600,EB445137-D7F5-57EC-87DA-1DB460D64046,"iPhone13,2"
com.google.Chrome,1581,1707103084,1707104665,1707104665.84757,-21600,,
com.leomehlig.today,53,1707103031,1707103084,1707103084.823142,-21600,,
com.apple.finder,4,1707103027,1707103031,1707103032.010176,-21600,,
com.google.Chrome,16,1707103011,1707103027,1707103027.071749,-21600,,
com.apple.weather,6,1707102647,1707102653,1707102653.124014,-21600,EB445137-D7F5-57EC-87DA-1DB460D64046,"iPhone13,2"
com.apple.weather,2,1707102643,1707102645,1707102645.8792949,-21600,EB445137-D7F5-57EC-87DA-1DB460D64046,"iPhone13,2"
com.apple.weather,9,1707101383,1707101392,1707101392.7977839,-21600,EB445137-D7F5-57EC-87DA-1DB460D64046,"iPhone13,2"
com.apple.Maps,1080,1707099285,1707100365,1707100365.886883,-21600,EB445137-D7F5-57EC-87DA-1DB460D64046,"iPhone13,2"
com.apple.Maps,70,1707099149,1707099219,1707099219.155655,-21600,EB445137-D7F5-57EC-87DA-1DB460D64046,"iPhone13,2"
com.apple.Maps,25,1707098937,1707098962,1707098962.851454,-21600,EB445137-D7F5-57EC-87DA-1DB460D64046,"iPhone13,2"
com.apple.Maps,5,1707098304,1707098309,1707098309.066311,-21600,EB445137-D7F5-57EC-87DA-1DB460D64046,"iPhone13,2"
com.apple.Maps,114,1707097965,1707098079,1707098079.6413631,-21600,EB445137-D7F5-57EC-87DA-1DB460D64046,"iPhone13,2"
com.apple.Music,74,1707097891,1707097965,1707097965.3173862,-21600,EB445137-D7F5-57EC-87DA-1DB460D64046,"iPhone13,2"
com.apple.mobilenotes,8,1707097883,1707097891,1707097891.876327,-21600,EB445137-D7F5-57EC-87DA-1DB460D64046,"iPhone13,2"
com.apple.Music,40,1707097841,1707097881,1707097881.438634,-21600,EB445137-D7F5-57EC-87DA-1DB460D64046,"iPhone13,2"
com.apple.MobileSMS,3,1707097836,1707097839,1707097839.538862,-21600,EB445137-D7F5-57EC-87DA-1DB460D64046,"iPhone13,2"
com.apple.Maps,1,1707097817,1707097818,1707097818.422332,-21600,EB445137-D7F5-57EC-87DA-1DB460D64046,"iPhone13,2"
com.apple.podcasts,3,1707097814,1707097817,1707097817.394271,-21600,EB445137-D7F5-57EC-87DA-1DB460D64046,"iPhone13,2"
com.apple.Maps,3,1707097814,1707097817,1707097817.3026981,-21600,EB445137-D7F5-57EC-87DA-1DB460D64046,"iPhone13,2"
com.apple.Maps,43,1707097572,1707097615,1707097615.5002751,-21600,EB445137-D7F5-57EC-87DA-1DB460D64046,"iPhone13,2"
com.apple.podcasts,43,1707097572,1707097615,1707097615.503154,-21600,EB445137-D7F5-57EC-87DA-1DB460D64046,"iPhone13,2"
com.apple.podcasts,13,1707096780,1707096793,1707096793.389406,-21600,EB445137-D7F5-57EC-87DA-1DB460D64046,"iPhone13,2"
com.apple.Maps,1,1707096780,1707096781,1707096781.582192,-21600,EB445137-D7F5-57EC-87DA-1DB460D64046,"iPhone13,2"
com.apple.Maps,3,1707096498,1707096501,1707096501.263731,-21600,EB445137-D7F5-57EC-87DA-1DB460D64046,"iPhone13,2"
com.apple.podcasts,3,1707096498,1707096501,1707096501.2671928,-21600,EB445137-D7F5-57EC-87DA-1DB460D64046,"iPhone13,2"
com.apple.Maps,3029,1707093465,1707096494,1707096494.402919,-21600,EB445137-D7F5-57EC-87DA-1DB460D64046,"iPhone13,2"
com.apple.podcasts,3029,1707093465,1707096494,1707096494.574277,-21600,EB445137-D7F5-57EC-87DA-1DB460D64046,"iPhone13,2"
com.apple.podcasts,2282,1707091148,1707093430,1707093430.472239,-21600,EB445137-D7F5-57EC-87DA-1DB460D64046,"iPhone13,2"
com.apple.Maps,2271,1707091148,1707093419,1707093419.168221,-21600,EB445137-D7F5-57EC-87DA-1DB460D64046,"iPhone13,2"
com.apple.podcasts,69,1707090763,1707090832,1707090832.492784,-21600,EB445137-D7F5-57EC-87DA-1DB460D64046,"iPhone13,2"
com.apple.Maps,2,1707090758,1707090760,1707090760.2126951,-21600,EB445137-D7F5-57EC-87DA-1DB460D64046,"iPhone13,2"
com.apple.Maps,4,1707090754,1707090758,1707090759.106864,-21600,EB445137-D7F5-57EC-87DA-1DB460D64046,"iPhone13,2"
com.apple.podcasts,4,1707090754,1707090758,1707090759.146857,-21600,EB445137-D7F5-57EC-87DA-1DB460D64046,"iPhone13,2"
com.apple.podcasts,127,1707090617,1707090744,1707090744.1314979,-21600,EB445137-D7F5-57EC-87DA-1DB460D64046,"iPhone13,2"
com.apple.Maps,34,1707090583,1707090617,1707090618.095656,-21600,EB445137-D7F5-57EC-87DA-1DB460D64046,"iPhone13,2"
com.apple.Music,10,1707090573,1707090583,1707090583.303697,-21600,EB445137-D7F5-57EC-87DA-1DB460D64046,"iPhone13,2"
com.apple.Music,16,1707090400,1707090416,1707090416.2449632,-21600,EB445137-D7F5-57EC-87DA-1DB460D64046,"iPhone13,2"
com.apple.Music,22,1707090247,1707090269,1707090270.7875671,-21600,EB445137-D7F5-57EC-87DA-1DB460D64046,"iPhone13,2"
com.apple.Music,114,1707090116,1707090230,1707090230.144171,-21600,EB445137-D7F5-57EC-87DA-1DB460D64046,"iPhone13,2"
com.apple.podcasts,96,1707090018,1707090114,1707090114.418972,-21600,EB445137-D7F5-57EC-87DA-1DB460D64046,"iPhone13,2"
com.google.ios.youtube,39,1707089977,1707090016,1707090016.609891,-21600,EB445137-D7F5-57EC-87DA-1DB460D64046,"iPhone13,2"
com.apple.mobilenotes,4,1707089957,1707089961,1707089961.8897018,-21600,EB445137-D7F5-57EC-87DA-1DB460D64046,"iPhone13,2"
com.apple.mobilenotes,6,1707089801,1707089807,1707089807.4813309,-21600,EB445137-D7F5-57EC-87DA-1DB460D64046,"iPhone13,2"
com.apple.mobilenotes,5,1707089795,1707089800,1707089800.078971,-21600,EB445137-D7F5-57EC-87DA-1DB460D64046,"iPhone13,2"
com.burbn.instagram,2,1707089793,1707089795,1707089795.84972,-21600,EB445137-D7F5-57EC-87DA-1DB460D64046,"iPhone13,2"
com.burbn.instagram,7,1707089512,1707089519,1707089519.9307752,-21600,EB445137-D7F5-57EC-87DA-1DB460D64046,"iPhone13,2"
com.burbn.instagram,8,1707089501,1707089509,1707089509.4248471,-21600,EB445137-D7F5-57EC-87DA-1DB460D64046,"iPhone13,2"
com.strava.stravaride,7,1707089493,1707089500,1707089500.146006,-21600,EB445137-D7F5-57EC-87DA-1DB460D64046,"iPhone13,2"
com.apple.MobileSMS,8,1707089485,1707089493,1707089493.4143019,-21600,EB445137-D7F5-57EC-87DA-1DB460D64046,"iPhone13,2"
com.apple.MobileSMS,3,1707089394,1707089397,1707089397.8417711,-21600,EB445137-D7F5-57EC-87DA-1DB460D64046,"iPhone13,2"
com.apple.MobileSMS,3,1707088442,1707088445,1707088445.9389338,-21600,EB445137-D7F5-57EC-87DA-1DB460D64046,"iPhone13,2"
com.apple.MobileSMS,24,1707088177,1707088201,1707088201.583806,-21600,EB445137-D7F5-57EC-87DA-1DB460D64046,"iPhone13,2"
com.google.ios.youtube,1034,1707086918,1707087952,1707087952.2330952,-21600,EB445137-D7F5-57EC-87DA-1DB460D64046,"iPhone13,2"
com.google.ios.youtube,4,1707086787,1707086791,1707086791.8962831,-21600,EB445137-D7F5-57EC-87DA-1DB460D64046,"iPhone13,2"
com.google.ios.youtube,6,1707086552,1707086558,1707086558.6049562,-21600,EB445137-D7F5-57EC-87DA-1DB460D64046,"iPhone13,2"
com.google.ios.youtube,4,1707086477,1707086481,1707086481.471428,-21600,EB445137-D7F5-57EC-87DA-1DB460D64046,"iPhone13,2"
com.google.ios.youtube,199,1707086233,1707086432,1707086432.9353461,-21600,EB445137-D7F5-57EC-87DA-1DB460D64046,"iPhone13,2"
com.google.chrome.ios,22,1707085694,1707085716,1707085716.797931,-21600,EB445137-D7F5-57EC-87DA-1DB460D64046,"iPhone13,2"
com.apple.findmy,4,1707085690,1707085694,1707085694.221329,-21600,EB445137-D7F5-57EC-87DA-1DB460D64046,"iPhone13,2"
com.apple.findmy,2,1707084090,1707084092,1707084092.438937,-21600,EB445137-D7F5-57EC-87DA-1DB460D64046,"iPhone13,2"
com.apple.findmy,12,1707083404,1707083416,1707083416.544612,-21600,EB445137-D7F5-57EC-87DA-1DB460D64046,"iPhone13,2"
com.apple.mobilenotes,15,1707083310,1707083325,1707083325.770586,-21600,EB445137-D7F5-57EC-87DA-1DB460D64046,"iPhone13,2"
com.google.Chrome,300,1707082874,1707083174,1707083174.485321,-21600,,
com.google.ios.youtube,684,1707082626,1707083310,1707083310.594284,-21600,EB445137-D7F5-57EC-87DA-1DB460D64046,"iPhone13,2"
com.apple.MobileSMS,4,1707082619,1707082623,1707082623.510438,-21600,EB445137-D7F5-57EC-87DA-1DB460D64046,"iPhone13,2"
com.google.Chrome,1179,1707081693,1707082872,1707082872.435079,-21600,,
com.apple.iWork.Numbers,55,1707081638,1707081693,1707081693.4725208,-21600,,
com.google.Chrome,82,1707081556,1707081638,1707081638.969712,-21600,,
com.apple.news,119,1707081165,1707081284,1707081284.290124,-21600,EB445137-D7F5-57EC-87DA-1DB460D64046,"iPhone13,2"
com.apple.news,3,1707081157,1707081160,1707081160.635987,-21600,EB445137-D7F5-57EC-87DA-1DB460D64046,"iPhone13,2"
com.robinhood.release.Robinhood,56,1707081076,1707081132,1707081132.887937,-21600,EB445137-D7F5-57EC-87DA-1DB460D64046,"iPhone13,2"
com.instructure.icanvas,13,1707081057,1707081070,1707081070.389206,-21600,EB445137-D7F5-57EC-87DA-1DB460D64046,"iPhone13,2"
com.apple.news,2,1707081040,1707081042,1707081042.654654,-21600,EB445137-D7F5-57EC-87DA-1DB460D64046,"iPhone13,2"
com.microsoft.Office.Outlook,10,1707079532,1707079542,1707079542.7433639,-21600,EB445137-D7F5-57EC-87DA-1DB460D64046,"iPhone13,2"
com.microsoft.Office.Outlook,13,1707079180,1707079193,1707079193.742418,-21600,EB445137-D7F5-57EC-87DA-1DB460D64046,"iPhone13,2"
com.apple.news,424,1707077354,1707077778,1707077778.4912128,-21600,EB445137-D7F5-57EC-87DA-1DB460D64046,"iPhone13,2"
com.toyopagroup.picaboo,18,1707077321,1707077339,1707077339.668164,-21600,EB445137-D7F5-57EC-87DA-1DB460D64046,"iPhone13,2"
com.burbn.instagram,48,1707077272,1707077320,1707077320.6998491,-21600,EB445137-D7F5-57EC-87DA-1DB460D64046,"iPhone13,2"
com.letterboxd.LetterboxdApp,73,1707077196,1707077269,1707077269.9089131,-21600,EB445137-D7F5-57EC-87DA-1DB460D64046,"iPhone13,2"
com.apple.mobilenotes,13,1707077173,1707077186,1707077186.206536,-21600,EB445137-D7F5-57EC-87DA-1DB460D64046,"iPhone13,2"
com.toyopagroup.picaboo,19,1707076396,1707076415,1707076416.288547,-21600,EB445137-D7F5-57EC-87DA-1DB460D64046,"iPhone13,2"
Astrospheric.Astrospheric,3,1707076392,1707076395,1707076395.672698,-21600,EB445137-D7F5-57EC-87DA-1DB460D64046,"iPhone13,2"
Astrospheric.Astrospheric,3,1707076386,1707076389,1707076389.515753,-21600,EB445137-D7F5-57EC-87DA-1DB460D64046,"iPhone13,2"
Astrospheric.Astrospheric,7,1707076378,1707076385,1707076385.923921,-21600,EB445137-D7F5-57EC-87DA-1DB460D64046,"iPhone13,2"
Astrospheric.Astrospheric,2,1707076375,1707076377,1707076377.902266,-21600,EB445137-D7F5-57EC-87DA-1DB460D64046,"iPhone13,2"
Astrospheric.Astrospheric,31,1707070946,1707070977,1707070978.097729,-21600,EB445137-D7F5-57EC-87DA-1DB460D64046,"iPhone13,2"
com.google.Chrome,131,1707070656,1707070787,1707070787.562797,-21600,,
com.facebook.Facebook,41,1707068117,1707068158,1707068158.5274448,-21600,EB445137-D7F5-57EC-87DA-1DB460D64046,"iPhone13,2"
com.apple.MobileSMS,3,1707068068,1707068071,1707068071.951724,-21600,EB445137-D7F5-57EC-87DA-1DB460D64046,"iPhone13,2"
com.google.Chrome,3850,1707066498,1707070348,1707070348.71074,-21600,,
com.google.Chrome,526,1707065701,1707066227,1707066227.258471,-21600,,
com.apple.MobileSMS,7,1707063584,1707063591,1707063591.9406781,-21600,EB445137-D7F5-57EC-87DA-1DB460D64046,"iPhone13,2"
com.apple.MobileSMS,9,1707063183,1707063192,1707063192.512704,-21600,EB445137-D7F5-57EC-87DA-1DB460D64046,"iPhone13,2"
com.google.ios.youtube,531,1707058486,1707059017,1707059017.320386,-21600,EB445137-D7F5-57EC-87DA-1DB460D64046,"iPhone13,2"
com.google.ios.youtube,65,1707058416,1707058481,1707058481.612977,-21600,EB445137-D7F5-57EC-87DA-1DB460D64046,"iPhone13,2"
com.apple.Health,75,1707058326,1707058401,1707058401.7635279,-21600,EB445137-D7F5-57EC-87DA-1DB460D64046,"iPhone13,2"
com.thestorygraph.thestorygraph,1,1707058281,1707058282,1707058282.032493,-21600,EB445137-D7F5-57EC-87DA-1DB460D64046,"iPhone13,2"
com.thestorygraph.thestorygraph,20,1707058150,1707058170,1707058170.693692,-21600,EB445137-D7F5-57EC-87DA-1DB460D64046,"iPhone13,2"
com.thestorygraph.thestorygraph,19,1707057600,1707057619,1707057620.003763,-21600,EB445137-D7F5-57EC-87DA-1DB460D64046,"iPhone13,2"
com.thestorygraph.thestorygraph,13,1707046147,1707046160,1707046160.7984328,-21600,EB445137-D7F5-57EC-87DA-1DB460D64046,"iPhone13,2"
com.thestorygraph.thestorygraph,10,1707046011,1707046021,1707046021.300199,-21600,EB445137-D7F5-57EC-87DA-1DB460D64046,"iPhone13,2"
com.google.Chrome,643,1707021185,1707021828,1707021828.547751,-21600,,
com.google.Chrome,301,1707020732,1707021033,1707021033.229783,-21600,,
com.google.Chrome,2932,1707017771,1707020703,1707020703.400309,-21600,,
com.google.Chrome,1213,1707016545,1707017758,1707017758.530943,-21600,,
com.leomehlig.today,74,1707016471,1707016545,1707016545.0326629,-21600,,
com.google.Chrome,6,1707016465,1707016471,1707016471.82109,-21600,,
com.google.Chrome,302,1707015754,1707016056,1707016056.28039,-21600,,
com.google.Chrome,1400,1707014257,1707015657,1707015657.9488912,-21600,,
com.google.Chrome,300,1707013675,1707013975,1707013975.39367,-21600,,
com.google.Chrome,302,1707013350,1707013652,1707013652.122041,-21600,,
com.leomehlig.today,10,1707013340,1707013350,1707013350.3641,-21600,,
com.google.Chrome,4,1707013336,1707013340,1707013340.512006,-21600,,
com.google.Chrome,424,1707012892,1707013316,1707013316.45595,-21600,,
com.google.Chrome,10,1706991613,1706991623,1706991623.125082,-21600,,
com.leomehlig.today,242,1706991371,1706991613,1706991613.423325,-21600,,
com.google.Chrome,30,1706991341,1706991371,1706991371.205593,-21600,,
com.apple.Preview,294,1706991047,1706991341,1706991341.715994,-21600,,
com.google.Chrome,7,1706991040,1706991047,1706991047.867075,-21600,,
com.apple.Preview,231,1706990809,1706991040,1706991040.114003,-21600,,
com.google.Chrome,2,1706990807,1706990809,1706990809.103529,-21600,,
com.apple.Preview,11,1706990796,1706990807,1706990807.28939,-21600,,
com.google.Chrome,70,1706990726,1706990796,1706990796.0633101,-21600,,
com.apple.Preview,364,1706990362,1706990726,1706990726.0579948,-21600,,
com.google.Chrome,27,1706990335,1706990362,1706990362.295463,-21600,,
com.apple.Preview,99,1706990236,1706990335,1706990335.7560558,-21600,,
com.google.Chrome,89,1706990147,1706990236,1706990236.852628,-21600,,
com.google.Chrome,380,1706988780,1706989160,1706989160.56701,-21600,,
com.google.Chrome,483,1706987972,1706988455,1706988455.563736,-21600,,
com.apple.Preview,1,1706987971,1706987972,1706987972.906019,-21600,,
com.apple.Preview,324,1706980912,1706981236,1706981236.098778,-21600,,
com.apple.finder,1,1706980911,1706980912,1706980912.791611,-21600,,
com.google.Chrome,2,1706980909,1706980911,1706980911.319161,-21600,,
com.google.Chrome,331,1706935975,1706936306,1706936306.392374,-21600,,
com.apple.finder,1,1706935974,1706935975,1706935976.7722359,-21600,,
com.hnc.Discord,7,1706935967,1706935974,1706935974.549913,-21600,,
com.hnc.Discord,305,1706933981,1706934286,1706934286.282806,-21600,,
com.apple.FaceTime,1,1706933980,1706933981,1706933981.149265,-21600,,
com.hnc.Discord,127,1706933853,1706933980,1706933980.8549309,-21600,,
com.apple.finder,121,1706933732,1706933853,1706933853.4101481,-21600,,
com.apple.iCal,142,1706933590,1706933732,1706933732.765079,-21600,,
com.apple.finder,7,1706933583,1706933590,1706933590.3850288,-21600,,
com.microsoft.onenote.mac,10,1706933573,1706933583,1706933583.46823,-21600,,
com.google.Chrome,3,1706933570,1706933573,1706933573.646532,-21600,,
com.google.Chrome,940,1706932600,1706933540,1706933540.809249,-21600,,
com.microsoft.onenote.mac,88,1706932512,1706932600,1706932600.5153189,-21600,,
com.google.Chrome,223,1706932289,1706932512,1706932512.878405,-21600,,
com.google.Chrome,5,1706929814,1706929819,1706929819.9340591,-21600,,
com.apple.Preview,51,1706929763,1706929814,1706929814.358595,-21600,,
com.apple.Preview,337,1706928661,1706928998,1706928998.205868,-21600,,
com.google.Chrome,106,1706928555,1706928661,1706928661.9635692,-21600,,
com.google.Chrome,332,1706928120,1706928452,1706928452.466909,-21600,,
com.apple.finder,3,1706928117,1706928120,1706928120.514924,-21600,,
com.apple.Notes,2,1706928115,1706928117,1706928117.209303,-21600,,
com.apple.finder,1,1706928114,1706928115,1706928115.118338,-21600,,
com.apple.Preview,3,1706928111,1706928114,1706928114.3115249,-21600,,
com.apple.iCal,3,1706928108,1706928111,1706928111.602289,-21600,,
com.microsoft.Outlook,3,1706928105,1706928108,1706928108.995181,-21600,,
com.google.Chrome,83,1706928022,1706928105,1706928105.102572,-21600,,
com.microsoft.Outlook,13,1706928009,1706928022,1706928022.339627,-21600,,
com.apple.iCal,108,1706927901,1706928009,1706928009.1747189,-21600,,
com.microsoft.Outlook,2,1706927899,1706927901,1706927901.995339,-21600,,
com.apple.iCal,4,1706927895,1706927899,1706927899.633615,-21600,,
com.google.Chrome,10,1706927885,1706927895,1706927895.822939,-21600,,
com.instructure.icanvas,2,1706903584,1706903586,1706903586.5553389,-21600,EB445137-D7F5-57EC-87DA-1DB460D64046,"iPhone13,2"
com.instructure.icanvas,43,1706900155,1706900198,1706900199.04059,-21600,EB445137-D7F5-57EC-87DA-1DB460D64046,"iPhone13,2"
us.parkmobile.ParkMobile,24,1706900129,1706900153,1706900153.287091,-21600,EB445137-D7F5-57EC-87DA-1DB460D64046,"iPhone13,2"
com.apple.MobileSMS,6,1706900123,1706900129,1706900129.404858,-21600,EB445137-D7F5-57EC-87DA-1DB460D64046,"iPhone13,2"
com.google.Chrome,515,1706899885,1706900400,1706900400.682112,-21600,,
com.apple.Preview,54,1706899831,1706899885,1706899885.868813,-21600,,
com.google.Chrome,209,1706899622,1706899831,1706899831.154684,-21600,,
com.apple.MobileSMS,64,1706899422,1706899486,1706899486.233611,-21600,EB445137-D7F5-57EC-87DA-1DB460D64046,"iPhone13,2"
com.apple.Preview,357,1706899265,1706899622,1706899622.677149,-21600,,
com.google.Chrome,39,1706899226,1706899265,1706899265.2542682,-21600,,
com.apple.Preview,19,1706899207,1706899226,1706899226.377174,-21600,,
com.apple.finder,1,1706899206,1706899207,1706899208.034697,-21600,,
com.google.Chrome,3,1706899203,1706899206,1706899206.750959,-21600,,
com.apple.finder,1,1706899202,1706899203,1706899204.039904,-21600,,
com.google.Chrome,8,1706899194,1706899202,1706899202.306322,-21600,,
edu.illinois.rokwire.ios,18,1706899049,1706899067,1706899067.871661,-21600,EB445137-D7F5-57EC-87DA-1DB460D64046,"iPhone13,2"
edu.illinois.rokwire.ios,10,1706899039,1706899049,1706899049.57606,-21600,EB445137-D7F5-57EC-87DA-1DB460D64046,"iPhone13,2"
edu.illinois.rokwire.ios,12,1706898211,1706898223,1706898223.486558,-21600,EB445137-D7F5-57EC-87DA-1DB460D64046,"iPhone13,2"
edu.illinois.rokwire.ios,3,1706898208,1706898211,1706898211.425488,-21600,EB445137-D7F5-57EC-87DA-1DB460D64046,"iPhone13,2"
edu.illinois.rokwire.ios,2,1706897420,1706897422,1706897422.9986,-21600,EB445137-D7F5-57EC-87DA-1DB460D64046,"iPhone13,2"
edu.illinois.rokwire.ios,2,1706897417,1706897419,1706897419.7912621,-21600,EB445137-D7F5-57EC-87DA-1DB460D64046,"iPhone13,2"
edu.illinois.rokwire.ios,34,1706896614,1706896648,1706896648.511915,-21600,EB445137-D7F5-57EC-87DA-1DB460D64046,"iPhone13,2"
com.apple.MobileSMS,3,1706896610,1706896613,1706896613.214031,-21600,EB445137-D7F5-57EC-87DA-1DB460D64046,"iPhone13,2"
com.apple.MobileSMS,2,1706896548,1706896550,1706896550.444011,-21600,EB445137-D7F5-57EC-87DA-1DB460D64046,"iPhone13,2"
com.toyopagroup.picaboo,28,1706896209,1706896237,1706896237.1077561,-21600,EB445137-D7F5-57EC-87DA-1DB460D64046,"iPhone13,2"
com.apple.MobileSMS,12,1706896195,1706896207,1706896207.363605,-21600,EB445137-D7F5-57EC-87DA-1DB460D64046,"iPhone13,2"
com.apple.MobileSMS,1,1706896175,1706896176,1706896176.789221,-21600,EB445137-D7F5-57EC-87DA-1DB460D64046,"iPhone13,2"
com.apple.MobileSMS,15,1706896152,1706896167,1706896167.595271,-21600,EB445137-D7F5-57EC-87DA-1DB460D64046,"iPhone13,2"
com.toyopagroup.picaboo,8,1706895935,1706895943,1706895943.5611172,-21600,EB445137-D7F5-57EC-87DA-1DB460D64046,"iPhone13,2"
com.toyopagroup.picaboo,15,1706895812,1706895827,1706895827.535866,-21600,EB445137-D7F5-57EC-87DA-1DB460D64046,"iPhone13,2"
com.instructure.icanvas,7,1706895804,1706895811,1706895812.129463,-21600,EB445137-D7F5-57EC-87DA-1DB460D64046,"iPhone13,2"
com.instructure.icanvas,14,1706895755,1706895769,1706895769.198307,-21600,EB445137-D7F5-57EC-87DA-1DB460D64046,"iPhone13,2"
com.instructure.icanvas,6,1706895675,1706895681,1706895681.9381099,-21600,EB445137-D7F5-57EC-87DA-1DB460D64046,"iPhone13,2"
com.instructure.icanvas,7,1706895451,1706895458,1706895458.06608,-21600,EB445137-D7F5-57EC-87DA-1DB460D64046,"iPhone13,2"
com.instructure.icanvas,27,1706895263,1706895290,1706895290.456935,-21600,EB445137-D7F5-57EC-87DA-1DB460D64046,"iPhone13,2"
com.google.chrome.ios,18,1706895245,1706895263,1706895263.761436,-21600,EB445137-D7F5-57EC-87DA-1DB460D64046,"iPhone13,2"
com.google.chrome.ios,204,1706894126,1706894330,1706894330.483585,-21600,EB445137-D7F5-57EC-87DA-1DB460D64046,"iPhone13,2"
com.google.chrome.ios,242,1706893166,1706893408,1706893408.257146,-21600,EB445137-D7F5-57EC-87DA-1DB460D64046,"iPhone13,2"
com.apple.MobileSMS,16,1706893150,1706893166,1706893166.699595,-21600,EB445137-D7F5-57EC-87DA-1DB460D64046,"iPhone13,2"
com.google.chrome.ios,5,1706893145,1706893150,1706893150.710544,-21600,EB445137-D7F5-57EC-87DA-1DB460D64046,"iPhone13,2"
com.apple.MobileSMS,31,1706893114,1706893145,1706893146.02424,-21600,EB445137-D7F5-57EC-87DA-1DB460D64046,"iPhone13,2"
com.google.chrome.ios,30,1706893084,1706893114,1706893114.89099,-21600,EB445137-D7F5-57EC-87DA-1DB460D64046,"iPhone13,2"
com.microsoft.Office.Outlook,25,1706893059,1706893084,1706893084.352021,-21600,EB445137-D7F5-57EC-87DA-1DB460D64046,"iPhone13,2"
com.apple.MobileSMS,10,1706893049,1706893059,1706893059.628514,-21600,EB445137-D7F5-57EC-87DA-1DB460D64046,"iPhone13,2"
com.apple.MobileSMS,1,1706892919,1706892920,1706892920.593992,-21600,EB445137-D7F5-57EC-87DA-1DB460D64046,"iPhone13,2"
com.apple.MobileSMS,22,1706892776,1706892798,1706892798.360581,-21600,EB445137-D7F5-57EC-87DA-1DB460D64046,"iPhone13,2"
us.parkmobile.ParkMobile,3,1706892773,1706892776,1706892776.5175018,-21600,EB445137-D7F5-57EC-87DA-1DB460D64046,"iPhone13,2"
us.parkmobile.ParkMobile,11,1706892733,1706892744,1706892744.3036408,-21600,EB445137-D7F5-57EC-87DA-1DB460D64046,"iPhone13,2"
us.parkmobile.ParkMobile,20,1706892710,1706892730,1706892730.661447,-21600,EB445137-D7F5-57EC-87DA-1DB460D64046,"iPhone13,2"
com.apple.Maps,3,1706892706,1706892709,1706892709.194422,-21600,EB445137-D7F5-57EC-87DA-1DB460D64046,"iPhone13,2"
com.apple.Maps,24,1706892597,1706892621,1706892621.4007502,-21600,EB445137-D7F5-57EC-87DA-1DB460D64046,"iPhone13,2"
com.google.Maps,4,1706892592,1706892596,1706892597.060956,-21600,EB445137-D7F5-57EC-87DA-1DB460D64046,"iPhone13,2"
us.parkmobile.ParkMobile,40,1706892546,1706892586,1706892586.2686172,-21600,EB445137-D7F5-57EC-87DA-1DB460D64046,"iPhone13,2"
com.google.Chrome,11,1706888895,1706888906,1706888906.194114,-21600,,
us.zoom.xos,20,1706888875,1706888895,1706888895.2184072,-21600,,
com.google.Chrome,12,1706888863,1706888875,1706888875.483657,-21600,,
us.zoom.xos,2,1706888861,1706888863,1706888863.940384,-21600,,
com.google.Chrome,9,1706888852,1706888861,1706888861.495819,-21600,,
us.zoom.xos,15,1706888837,1706888852,1706888852.175984,-21600,,
com.google.Chrome,2104,1706886733,1706888837,1706888837.773339,-21600,,
us.zoom.xos,28,1706886705,1706886733,1706886733.548578,-21600,,
com.google.Chrome,353,1706886352,1706886705,1706886705.916897,-21600,,
us.zoom.xos,8,1706886344,1706886352,1706886352.188363,-21600,,
com.google.Chrome,104,1706886240,1706886344,1706886344.074836,-21600,,
us.zoom.xos,1,1706886239,1706886240,1706886240.6881971,-21600,,
com.google.Chrome,2,1706886237,1706886239,1706886239.4636378,-21600,,
us.zoom.xos,1,1706886236,1706886237,1706886237.634942,-21600,,
com.google.Chrome,2,1706886234,1706886236,1706886236.1912289,-21600,,
us.zoom.xos,1,1706886233,1706886234,1706886234.715486,-21600,,
com.apple.iCal,2,1706886231,1706886233,1706886233.3414822,-21600,,
com.apple.Notes,1,1706886230,1706886231,1706886231.775013,-21600,,
com.google.Chrome,2,1706886228,1706886230,1706886230.555485,-21600,,
com.apple.Notes,1,1706886227,1706886228,1706886228.848929,-21600,,
us.zoom.xos,5,1706886222,1706886227,1706886228.00239,-21600,,
com.apple.Notes,1,1706886221,1706886222,1706886222.816284,-21600,,
com.google.Chrome,8,1706886213,1706886221,1706886221.683331,-21600,,
com.apple.Notes,2,1706886211,1706886213,1706886214.035459,-21600,,
us.zoom.xos,48,1706886163,1706886211,1706886211.752312,-21600,,
com.apple.Notes,1,1706886162,1706886163,1706886163.575059,-21600,,
com.google.Chrome,1,1706886161,1706886162,1706886162.534882,-21600,,
com.apple.Notes,7,1706886154,1706886161,1706886161.706768,-21600,,
us.zoom.xos,14,1706886140,1706886154,1706886154.5592299,-21600,,
com.apple.Notes,2,1706886138,1706886140,1706886140.390337,-21600,,
us.zoom.xos,2,1706886136,1706886138,1706886138.591315,-21600,,
com.apple.Notes,13,1706886123,1706886136,1706886136.3762379,-21600,,
com.apple.iCal,16,1706886107,1706886123,1706886123.8883429,-21600,,
com.google.Chrome,27,1706886080,1706886107,1706886107.219596,-21600,,
us.zoom.xos,40,1706886040,1706886080,1706886080.575951,-21600,,
com.google.Chrome,22,1706886018,1706886040,1706886040.4507442,-21600,,
us.zoom.xos,2,1706886016,1706886018,1706886018.565738,-21600,,
com.google.Chrome,3,1706886013,1706886016,1706886016.28333,-21600,,
us.zoom.xos,3,1706886010,1706886013,1706886013.9570088,-21600,,
com.google.Chrome,8,1706886002,1706886010,1706886010.7284021,-21600,,
us.zoom.xos,7,1706885995,1706886002,1706886002.579515,-21600,,
com.google.Chrome,2,1706885993,1706885995,1706885995.2448769,-21600,,
us.zoom.xos,22,1706885971,1706885993,1706885993.281395,-21600,,
com.google.Chrome,5,1706885966,1706885971,1706885971.665392,-21600,,
us.zoom.xos,9,1706885957,1706885966,1706885966.2790031,-21600,,
com.google.Chrome,12,1706885945,1706885957,1706885957.168888,-21600,,
us.zoom.xos,0,1706885945,1706885945,1706885945.548465,-21600,,
com.google.Chrome,38,1706885907,1706885945,1706885945.0939832,-21600,,
us.zoom.xos,2,1706885905,1706885907,1706885907.116694,-21600,,
com.google.Chrome,0,1706885905,1706885905,1706885905.72183,-21600,,
us.zoom.xos,3,1706885902,1706885905,1706885905.3033829,-21600,,
com.google.Chrome,16,1706885886,1706885902,1706885902.182115,-21600,,
us.zoom.xos,44,1706885842,1706885886,1706885886.9154382,-21600,,
com.hammerandchisel.discord,5,1706885768,1706885773,1706885773.029735,-21600,EB445137-D7F5-57EC-87DA-1DB460D64046,"iPhone13,2"
com.hammerandchisel.discord,6,1706885762,1706885768,1706885768.708664,-21600,EB445137-D7F5-57EC-87DA-1DB460D64046,"iPhone13,2"
com.hammerandchisel.discord,74,1706885688,1706885762,1706885762.393261,-21600,EB445137-D7F5-57EC-87DA-1DB460D64046,"iPhone13,2"
com.apple.Maps,63,1706885584,1706885647,1706885647.399647,-21600,EB445137-D7F5-57EC-87DA-1DB460D64046,"iPhone13,2"
com.google.Maps,38,1706885541,1706885579,1706885579.1575608,-21600,EB445137-D7F5-57EC-87DA-1DB460D64046,"iPhone13,2"
com.apple.Health,17,1706885489,1706885506,1706885506.7447581,-21600,EB445137-D7F5-57EC-87DA-1DB460D64046,"iPhone13,2"
com.google.Chrome,377,1706885465,1706885842,1706885842.941774,-21600,,
com.apple.finder,17,1706885448,1706885465,1706885465.3827271,-21600,,
com.apple.mobiletimer,3,1706885269,1706885272,1706885272.487988,-21600,EB445137-D7F5-57EC-87DA-1DB460D64046,"iPhone13,2"
com.thestorygraph.thestorygraph,38,1706852829,1706852867,1706852867.748231,-21600,EB445137-D7F5-57EC-87DA-1DB460D64046,"iPhone13,2"
com.apple.finder,4,1706850013,1706850017,1706850017.35577,-21600,,
com.google.Chrome,2,1706850011,1706850013,1706850013.531538,-21600,,
com.apple.finder,1,1706850010,1706850011,1706850011.9065042,-21600,,
com.microsoft.onenote.mac,31,1706849979,1706850010,1706850010.38795,-21600,,
com.apple.finder,3,1706849971,1706849974,1706849974.309609,-21600,,
com.microsoft.Office.Outlook,20,1706848485,1706848505,1706848505.206839,-21600,EB445137-D7F5-57EC-87DA-1DB460D64046,"iPhone13,2"
com.apple.journal,50,1706848432,1706848482,1706848482.399291,-21600,EB445137-D7F5-57EC-87DA-1DB460D64046,"iPhone13,2"
com.apple.Health,50,1706848376,1706848426,1706848426.19489,-21600,EB445137-D7F5-57EC-87DA-1DB460D64046,"iPhone13,2"
com.toyopagroup.picaboo,28,1706848344,1706848372,1706848372.5695271,-21600,EB445137-D7F5-57EC-87DA-1DB460D64046,"iPhone13,2"
com.apple.weather,3,1706848336,1706848339,1706848339.619114,-21600,EB445137-D7F5-57EC-87DA-1DB460D64046,"iPhone13,2"
com.apple.finder,224,1706848331,1706848555,1706848555.167543,-21600,,
com.leomehlig.today,100,1706848231,1706848331,1706848331.982019,-21600,,
com.apple.weather,8,1706848205,1706848213,1706848213.608993,-21600,EB445137-D7F5-57EC-87DA-1DB460D64046,"iPhone13,2"
com.apple.Preview,1044,1706847187,1706848231,1706848232.051492,-21600,,
com.apple.finder,2,1706847185,1706847187,1706847187.174012,-21600,,
com.google.Chrome,4,1706847181,1706847185,1706847185.4136338,-21600,,
com.leomehlig.today,18,1706847163,1706847181,1706847181.55674,-21600,,
com.apple.weather,35,1706846416,1706846451,1706846451.2585778,-21600,EB445137-D7F5-57EC-87DA-1DB460D64046,"iPhone13,2"
com.apple.Music,11,1706846405,1706846416,1706846416.2153602,-21600,EB445137-D7F5-57EC-87DA-1DB460D64046,"iPhone13,2"
com.apple.Music,14,1706845693,1706845707,1706845708.238676,-21600,EB445137-D7F5-57EC-87DA-1DB460D64046,"iPhone13,2"
com.microsoft.Office.Outlook,3,1706845689,1706845692,1706845692.52731,-21600,EB445137-D7F5-57EC-87DA-1DB460D64046,"iPhone13,2"
com.leomehlig.today,3,1706845298,1706845301,1706845301.383879,-21600,,
com.leomehlig.today,51,1706845247,1706845298,1706845298.235406,-21600,,
com.google.Chrome,2018,1706843229,1706845247,1706845248.0974832,-21600,,
com.microsoft.Office.Outlook,7,1706842249,1706842256,1706842256.308803,-21600,EB445137-D7F5-57EC-87DA-1DB460D64046,"iPhone13,2"
com.thestorygraph.thestorygraph,2,1706842247,1706842249,1706842249.898011,-21600,EB445137-D7F5-57EC-87DA-1DB460D64046,"iPhone13,2"
com.google.Chrome,529,1706841344,1706841873,1706841873.652667,-21600,,
com.leomehlig.today,31,1706841313,1706841344,1706841345.015503,-21600,,
com.apple.iCal,7,1706841306,1706841313,1706841313.605731,-21600,,
com.leomehlig.today,13,1706841293,1706841306,1706841306.81933,-21600,,
com.google.Chrome,1,1706841292,1706841293,1706841293.466198,-21600,,
com.apple.Preview,1,1706841291,1706841292,1706841292.7064018,-21600,,
com.google.Chrome,0,1706841291,1706841291,1706841291.861347,-21600,,
com.microsoft.Word,2,1706841289,1706841291,1706841291.152045,-21600,,
com.google.Chrome,10,1706841279,1706841289,1706841289.834217,-21600,,
com.thestorygraph.thestorygraph,178,1706840866,1706841044,1706841045.0201058,-21600,EB445137-D7F5-57EC-87DA-1DB460D64046,"iPhone13,2"
com.thestorygraph.thestorygraph,24,1706840841,1706840865,1706840866.045466,-21600,EB445137-D7F5-57EC-87DA-1DB460D64046,"iPhone13,2"
com.microsoft.Office.Outlook,3,1706840834,1706840837,1706840838.041702,-21600,EB445137-D7F5-57EC-87DA-1DB460D64046,"iPhone13,2"
com.microsoft.Office.Outlook,6,1706840762,1706840768,1706840768.111521,-21600,EB445137-D7F5-57EC-87DA-1DB460D64046,"iPhone13,2"
com.microsoft.Office.Outlook,19,1706840739,1706840758,1706840758.459248,-21600,EB445137-D7F5-57EC-87DA-1DB460D64046,"iPhone13,2"
net.kortina.labs.Venmo,3,1706840736,1706840739,1706840742.9443312,-21600,EB445137-D7F5-57EC-87DA-1DB460D64046,"iPhone13,2"
com.google.Chrome,382,1706840703,1706841085,1706841085.74234,-21600,,
com.apple.Preview,64,1706840639,1706840703,1706840703.448221,-21600,,
com.apple.finder,1,1706840638,1706840639,1706840639.563046,-21600,,
com.google.Chrome,16,1706840622,1706840638,1706840638.53652,-21600,,
com.microsoft.Word,5,1706840617,1706840622,1706840622.4390259,-21600,,
com.apple.finder,15,1706840602,1706840617,1706840617.581636,-21600,,
com.microsoft.Word,99,1706840503,1706840602,1706840602.422044,-21600,,
com.google.Chrome,5,1706840498,1706840503,1706840503.319444,-21600,,
com.microsoft.Word,38,1706840460,1706840498,1706840498.4857621,-21600,,
com.google.Chrome,22,1706840438,1706840460,1706840460.816457,-21600,,
com.microsoft.Word,1,1706840437,1706840438,1706840438.7710361,-21600,,
com.apple.Photos,23,1706840414,1706840437,1706840438.092035,-21600,,
com.google.Chrome,60,1706840354,1706840414,1706840414.831276,-21600,,
com.microsoft.Word,2,1706840352,1706840354,1706840354.1306992,-21600,,
com.google.Chrome,3,1706840349,1706840352,1706840352.319973,-21600,,
com.microsoft.Word,1,1706840348,1706840349,1706840349.976486,-21600,,
com.google.Chrome,7,1706840341,1706840348,1706840348.948605,-21600,,
com.apple.finder,9,1706840332,1706840341,1706840341.723578,-21600,,
com.google.Chrome,19,1706840313,1706840332,1706840332.697433,-21600,,
com.apple.Preview,42,1706840271,1706840313,1706840313.653963,-21600,,
com.apple.finder,24,1706840247,1706840271,1706840271.7069201,-21600,,
net.kortina.labs.Venmo,241,1706840069,1706840310,1706840310.627225,-21600,EB445137-D7F5-57EC-87DA-1DB460D64046,"iPhone13,2"
com.clairmail.fth.client,13,1706840054,1706840067,1706840067.032587,-21600,EB445137-D7F5-57EC-87DA-1DB460D64046,"iPhone13,2"
com.clairmail.fth.client,101,1706839943,1706840044,1706840044.837466,-21600,EB445137-D7F5-57EC-87DA-1DB460D64046,"iPhone13,2"
com.tinyspeck.chatlyio,30,1706839913,1706839943,1706839943.470738,-21600,EB445137-D7F5-57EC-87DA-1DB460D64046,"iPhone13,2"
com.google.chrome.ios,17,1706839896,1706839913,1706839913.618017,-21600,EB445137-D7F5-57EC-87DA-1DB460D64046,"iPhone13,2"
com.google.chrome.ios,61,1706839734,1706839795,1706839795.7994509,-21600,EB445137-D7F5-57EC-87DA-1DB460D64046,"iPhone13,2"
com.tinyspeck.chatlyio,213,1706839521,1706839734,1706839735.060091,-21600,EB445137-D7F5-57EC-87DA-1DB460D64046,"iPhone13,2"
com.google.Chrome,821,1706839426,1706840247,1706840247.954016,-21600,,
com.apple.finder,6,1706839420,1706839426,1706839426.415296,-21600,,
us.zoom.xos,3,1706839417,1706839420,1706839420.7210178,-21600,,
com.google.Chrome,31,1706839386,1706839417,1706839417.9215112,-21600,,
com.google.Chrome,744,1706829817,1706830561,1706830561.512836,-21600,,
com.google.Chrome,1195,1706828252,1706829447,1706829447.338337,-21600,,
com.google.Chrome,1085,1706826741,1706827826,1706827826.545747,-21600,,
us.zoom.xos,12,1706826729,1706826741,1706826741.683825,-21600,,
us.zoom.xos,553,1706822008,1706822561,1706822561.692234,-21600,,
com.google.Chrome,19,1706821989,1706822008,1706822008.226522,-21600,,
us.zoom.xos,550,1706821439,1706821989,1706821989.772474,-21600,,
us.zoom.xos,311,1706821055,1706821366,1706821366.896062,-21600,,
us.zoom.xos,311,1706820576,1706820887,1706820887.225299,-21600,,
com.google.Chrome,3,1706820573,1706820576,1706820576.105196,-21600,,
us.zoom.xos,5,1706820568,1706820573,1706820573.953999,-21600,,
us.zoom.xos,28,1706820433,1706820461,1706820461.145272,-21600,,
us.zoom.xos,385,1706819616,1706820001,1706820001.249501,-21600,,
com.google.Chrome,44,1706819572,1706819616,1706819616.667255,-21600,,
us.zoom.xos,10,1706819544,1706819554,1706819554.2438722,-21600,,
us.zoom.xos,986,1706818208,1706819194,1706819194.809447,-21600,,
com.google.Chrome,41,1706818167,1706818208,1706818208.349582,-21600,,
us.zoom.xos,1,1706818166,1706818167,1706818168.023179,-21600,,
com.google.Chrome,2,1706818164,1706818166,1706818166.311112,-21600,,
us.zoom.xos,7,1706818157,1706818164,1706818165.065199,-21600,,
com.google.Chrome,4,1706818153,1706818157,1706818157.598754,-21600,,
us.zoom.xos,692,1706817461,1706818153,1706818153.7991629,-21600,,
com.google.Chrome,50,1706817411,1706817461,1706817461.567404,-21600,,
com.apple.finder,5,1706817406,1706817411,1706817411.5194712,-21600,,
com.apple.TextEdit,132,1706817268,1706817400,1706817400.334486,-21600,,
com.apple.finder,2,1706817266,1706817268,1706817268.840286,-21600,,
com.apple.TextEdit,8,1706817258,1706817266,1706817266.37361,-21600,,
com.apple.finder,38,1706817210,1706817248,1706817248.412245,-21600,,
com.apple.dt.Xcode,5,1706817205,1706817210,1706817210.504564,-21600,,
com.microsoft.VSCode,11,1706817194,1706817205,1706817205.7267509,-21600,,
com.google.Chrome,5,1706817189,1706817194,1706817195.091605,-21600,,
com.apple.dt.Xcode,16,1706817173,1706817189,1706817190.068437,-21600,,
com.apple.finder,0,1706817173,1706817173,1706817174.8466,-21600,,
com.apple.dt.Xcode,33,1706817140,1706817173,1706817173.858696,-21600,,
com.apple.finder,5,1706817135,1706817140,1706817140.731972,-21600,,
com.apple.dt.Xcode,7,1706817128,1706817135,1706817135.514241,-21600,,
com.apple.finder,9,1706817119,1706817128,1706817128.145267,-21600,,
com.apple.dt.Xcode,18,1706817101,1706817119,1706817119.241922,-21600,,
com.apple.finder,18,1706817083,1706817101,1706817101.632146,-21600,,
com.apple.archiveutility,3,1706817080,1706817083,1706817083.4191551,-21600,,
com.apple.finder,8,1706817072,1706817080,1706817081.020298,-21600,,
com.google.Chrome,74,1706816998,1706817072,1706817072.7281451,-21600,,
com.apple.iCal,1,1706816997,1706816998,1706816998.523769,-21600,,
com.google.Chrome,120,1706816877,1706816997,1706816997.070102,-21600,,
com.apple.iCal,71,1706816806,1706816877,1706816877.29148,-21600,,
com.leomehlig.today,124,1706816682,1706816806,1706816806.937676,-21600,,
com.apple.finder,69,1706816613,1706816682,1706816682.606607,-21600,,
com.apple.Preview,298,1706816315,1706816613,1706816613.173147,-21600,,
com.apple.finder,7,1706816308,1706816315,1706816315.134445,-21600,,
com.google.Chrome,4,1706816304,1706816308,1706816308.933545,-21600,,
com.leomehlig.today,27,1706816277,1706816304,1706816304.355105,-21600,,
com.google.Chrome,243,1706816034,1706816277,1706816277.9232259,-21600,,
com.microsoft.VSCode,4,1706816030,1706816034,1706816034.2163858,-21600,,
com.google.Chrome,0,1706816030,1706816030,1706816030.591115,-21600,,
com.microsoft.VSCode,28,1706816002,1706816030,1706816030.1315541,-21600,,
com.google.Chrome,639,1706815363,1706816002,1706816002.4212642,-21600,,
com.microsoft.VSCode,156,1706815207,1706815363,1706815363.693172,-21600,,
com.google.Chrome,7,1706815200,1706815207,1706815207.926992,-21600,,
com.microsoft.VSCode,66,1706815134,1706815200,1706815200.655375,-21600,,
com.google.Chrome,8,1706815126,1706815134,1706815134.488368,-21600,,
com.microsoft.VSCode,181,1706814945,1706815126,1706815126.29556,-21600,,
com.google.Chrome,77,1706814868,1706814945,1706814945.915734,-21600,,
com.microsoft.VSCode,362,1706814506,1706814868,1706814868.744308,-21600,,
com.apple.finder,1,1706814505,1706814506,1706814506.382509,-21600,,
com.google.Chrome,18,1706814487,1706814505,1706814505.378862,-21600,,
com.leomehlig.today,87,1706814400,1706814487,1706814487.895519,-21600,,
com.google.Chrome,7,1706814393,1706814400,1706814400.418371,-21600,,
com.apple.Preview,3,1706814390,1706814393,1706814394.0411658,-21600,,
com.google.Chrome,26,1706814364,1706814390,1706814390.776988,-21600,,
com.apple.Preview,17,1706814347,1706814364,1706814364.7798948,-21600,,
com.apple.finder,4,1706814343,1706814347,1706814347.096181,-21600,,
com.google.Chrome,2,1706814341,1706814343,1706814344.054739,-21600,,
com.apple.MobileSMS,14,1706810426,1706810440,1706810440.124403,-21600,EB445137-D7F5-57EC-87DA-1DB460D64046,"iPhone13,2"
com.toyopagroup.picaboo,11,1706809964,1706809975,1706809975.991868,-21600,EB445137-D7F5-57EC-87DA-1DB460D64046,"iPhone13,2"
com.apple.weather,5,1706809959,1706809964,1706809964.4744658,-21600,EB445137-D7F5-57EC-87DA-1DB460D64046,"iPhone13,2"
com.google.Chrome,6,1706809832,1706809838,1706809838.695912,-21600,,
com.apple.Preview,6,1706809826,1706809832,1706809832.4052138,-21600,,
com.apple.Preview,5485,1706804337,1706809822,1706809823.206747,-21600,,
com.google.Chrome,1,1706804336,1706804337,1706804337.324873,-21600,,
com.google.Chrome,305,1706803599,1706803904,1706803904.897398,-21600,,
com.apple.Preview,4,1706803595,1706803599,1706803599.512378,-21600,,
com.google.Chrome,1,1706803594,1706803595,1706803595.213433,-21600,,
com.apple.Preview,1,1706803593,1706803594,1706803594.45492,-21600,,
com.google.Chrome,2,1706803591,1706803593,1706803593.383555,-21600,,
com.microsoft.VSCode,4,1706803587,1706803591,1706803591.614085,-21600,,
com.google.Chrome,1,1706803586,1706803587,1706803587.783663,-21600,,
com.apple.Preview,67,1706803519,1706803586,1706803586.529474,-21600,,
com.apple.finder,13,1706803506,1706803519,1706803519.807643,-21600,,
com.apple.Preview,2,1706803504,1706803506,1706803506.740253,-21600,,
com.google.Chrome,530,1706802974,1706803504,1706803504.256201,-21600,,
com.apple.Preview,33,1706802941,1706802974,1706802974.182949,-21600,,
com.apple.finder,1,1706802940,1706802941,1706802941.310116,-21600,,
com.apple.Preview,11,1706802929,1706802940,1706802940.273905,-21600,,
com.apple.finder,42,1706802887,1706802929,1706802929.344002,-21600,,
com.google.Chrome,38,1706802849,1706802887,1706802887.5019321,-21600,,
com.apple.weather,5,1706801716,1706801721,1706801722.0065222,-21600,EB445137-D7F5-57EC-87DA-1DB460D64046,"iPhone13,2"
com.burbn.instagram,181,1706801467,1706801648,1706801648.7490602,-21600,EB445137-D7F5-57EC-87DA-1DB460D64046,"iPhone13,2"
com.google.Chrome,109,1706801309,1706801418,1706801418.120356,-21600,,
com.leomehlig.today,30,1706801279,1706801309,1706801309.771589,-21600,,
com.google.Chrome,23,1706801256,1706801279,1706801279.2615418,-21600,,
com.leomehlig.today,9,1706801247,1706801256,1706801257.032393,-21600,,
com.apple.Health,26,1706799123,1706799149,1706799149.3079019,-21600,EB445137-D7F5-57EC-87DA-1DB460D64046,"iPhone13,2"
com.leomehlig.today,6,1706762180,1706762186,1706762186.63222,-21600,,
com.leomehlig.today,9,1706762148,1706762157,1706762157.165283,-21600,,
com.leomehlig.today,3,1706762120,1706762123,1706762123.8663158,-21600,,
com.google.Chrome,14,1706762106,1706762120,1706762120.505718,-21600,,
com.leomehlig.today,294,1706761812,1706762106,1706762106.227974,-21600,,
com.google.Chrome,247,1706761565,1706761812,1706761812.7265491,-21600,,
com.microsoft.VSCode,111,1706761454,1706761565,1706761566.02581,-21600,,
com.google.Chrome,14,1706761440,1706761454,1706761454.388074,-21600,,
com.microsoft.VSCode,2,1706761438,1706761440,1706761440.754852,-21600,,
com.google.Chrome,902,1706760536,1706761438,1706761438.176909,-21600,,
com.apple.iCal,65,1706760471,1706760536,1706760536.888379,-21600,,
com.google.Chrome,467,1706760004,1706760471,1706760471.5828938,-21600,,
com.microsoft.VSCode,10,1706759994,1706760004,1706760004.916199,-21600,,
com.google.Chrome,3,1706759991,1706759994,1706759994.55023,-21600,,
com.leomehlig.today,38,1706759953,1706759991,1706759991.8511682,-21600,,
com.leomehlig.today,25,1706756209,1706756234,1706756234.790592,-21600,,
com.apple.Preview,166,1706756043,1706756209,1706756209.211241,-21600,,
com.apple.FaceTime,8,1706756035,1706756043,1706756043.7246342,-21600,,
com.apple.Preview,194,1706755841,1706756035,1706756035.6786919,-21600,,
com.google.Chrome,115,1706755726,1706755841,1706755841.934524,-21600,,
com.apple.Preview,47,1706755679,1706755726,1706755726.1116772,-21600,,
com.google.Chrome,2,1706755677,1706755679,1706755679.940476,-21600,,
com.leomehlig.today,12,1706755665,1706755677,1706755677.4038792,-21600,,
com.apple.Preview,683,1706754982,1706755665,1706755665.739084,-21600,,
com.google.Chrome,401,1706754581,1706754982,1706754982.7331061,-21600,,
com.apple.Preview,749,1706753832,1706754581,1706754581.388421,-21600,,
com.leomehlig.today,1,1706753831,1706753832,1706753832.68154,-21600,,
com.apple.Preview,1,1706753830,1706753831,1706753831.548353,-21600,,
com.google.Chrome,1,1706753829,1706753830,1706753830.828147,-21600,,
com.google.Chrome,300,1706752325,1706752625,1706752625.887172,-21600,,
com.google.Chrome,514,1706751802,1706752316,1706752316.571008,-21600,,
com.apple.Preview,32,1706751770,1706751802,1706751802.2269258,-21600,,
com.apple.finder,2,1706751768,1706751770,1706751770.9674258,-21600,,
com.apple.Preview,2,1706751766,1706751768,1706751768.288467,-21600,,
com.google.Chrome,4,1706751762,1706751766,1706751766.599473,-21600,,
com.leomehlig.today,256,1706751506,1706751762,1706751762.309047,-21600,,
com.google.Chrome,438,1706751068,1706751506,1706751506.191829,-21600,,
com.google.Chrome,1020,1706750047,1706751067,1706751067.2927508,-21600,,
com.google.Chrome,1033,1706748990,1706750023,1706750023.543531,-21600,,
com.google.Chrome,646,1706748339,1706748985,1706748985.032909,-21600,,
com.leomehlig.today,4,1706748335,1706748339,1706748339.182434,-21600,,
com.google.Chrome,10,1706748325,1706748335,1706748335.42927,-21600,,
com.leomehlig.today,28,1706748297,1706748325,1706748325.964364,-21600,,
com.google.Chrome,89,1706748208,1706748297,1706748297.433996,-21600,,
com.apple.Preview,28,1706748180,1706748208,1706748208.269443,-21600,,
com.google.Chrome,2,1706748178,1706748180,1706748180.610563,-21600,,
com.apple.Preview,2,1706748176,1706748178,1706748178.40703,-21600,,
com.google.Chrome,4,1706748172,1706748176,1706748176.8968349,-21600,,
com.apple.Preview,11,1706748161,1706748172,1706748172.755223,-21600,,
com.apple.finder,6,1706748155,1706748161,1706748161.364991,-21600,,
com.google.Chrome,14,1706748141,1706748155,1706748155.6356769,-21600,,
com.apple.findmy,4,1706747343,1706747347,1706747347.809554,-21600,EB445137-D7F5-57EC-87DA-1DB460D64046,"iPhone13,2"
com.apple.calculator,3,1706747338,1706747341,1706747341.958204,-21600,EB445137-D7F5-57EC-87DA-1DB460D64046,"iPhone13,2"
com.apple.calculator,6,1706747128,1706747134,1706747134.5220509,-21600,EB445137-D7F5-57EC-87DA-1DB460D64046,"iPhone13,2"
com.apple.calculator,7,1706747120,1706747127,1706747127.57955,-21600,EB445137-D7F5-57EC-87DA-1DB460D64046,"iPhone13,2"
com.google.chrome.ios,69,1706747030,1706747099,1706747099.4649181,-21600,EB445137-D7F5-57EC-87DA-1DB460D64046,"iPhone13,2"
com.google.chrome.ios,47,1706746820,1706746867,1706746867.1448379,-21600,EB445137-D7F5-57EC-87DA-1DB460D64046,"iPhone13,2"
com.hammerandchisel.discord,233,1706746587,1706746820,1706746820.8971748,-21600,EB445137-D7F5-57EC-87DA-1DB460D64046,"iPhone13,2"
com.instructure.icanvas,4,1706746581,1706746585,1706746585.676822,-21600,EB445137-D7F5-57EC-87DA-1DB460D64046,"iPhone13,2"
com.google.Chrome,1,1706746518,1706746519,1706746520.23416,-21600,,
com.google.Chrome,890,1706745552,1706746442,1706746442.0871549,-21600,,
com.instructure.icanvas,87,1706745366,1706745453,1706745453.9865742,-21600,EB445137-D7F5-57EC-87DA-1DB460D64046,"iPhone13,2"
com.apple.MobileSMS,3,1706745348,1706745351,1706745351.8401232,-21600,EB445137-D7F5-57EC-87DA-1DB460D64046,"iPhone13,2"
com.apple.MobileSMS,28,1706743699,1706743727,1706743727.4559631,-21600,EB445137-D7F5-57EC-87DA-1DB460D64046,"iPhone13,2"
com.instructure.icanvas,3,1706743696,1706743699,1706743699.919773,-21600,EB445137-D7F5-57EC-87DA-1DB460D64046,"iPhone13,2"
com.instructure.icanvas,37,1706743131,1706743168,1706743168.121972,-21600,EB445137-D7F5-57EC-87DA-1DB460D64046,"iPhone13,2"
com.instructure.icanvas,20,1706742751,1706742771,1706742771.753004,-21600,EB445137-D7F5-57EC-87DA-1DB460D64046,"iPhone13,2"
edu.illinois.rokwire.ios,5,1706742746,1706742751,1706742752.1156158,-21600,EB445137-D7F5-57EC-87DA-1DB460D64046,"iPhone13,2"
edu.illinois.rokwire.ios,17,1706742141,1706742158,1706742158.160783,-21600,EB445137-D7F5-57EC-87DA-1DB460D64046,"iPhone13,2"
edu.illinois.rokwire.ios,37,1706742103,1706742140,1706742140.216497,-21600,EB445137-D7F5-57EC-87DA-1DB460D64046,"iPhone13,2"
com.apple.MobileSMS,6,1706742094,1706742100,1706742100.176512,-21600,EB445137-D7F5-57EC-87DA-1DB460D64046,"iPhone13,2"
com.disney.disneyplus,1406,1706740673,1706742079,1706742079.984877,-21600,EB445137-D7F5-57EC-87DA-1DB460D64046,"iPhone13,2"
com.instructure.icanvas,13,1706740660,1706740673,1706740673.783586,-21600,EB445137-D7F5-57EC-87DA-1DB460D64046,"iPhone13,2"
com.apple.MobileSMS,73,1706740585,1706740658,1706740658.3724809,-21600,EB445137-D7F5-57EC-87DA-1DB460D64046,"iPhone13,2"
com.disney.disneyplus,603,1706739982,1706740585,1706740586.18853,-21600,EB445137-D7F5-57EC-87DA-1DB460D64046,"iPhone13,2"
com.apple.MobileSMS,29,1706739940,1706739969,1706739969.802707,-21600,EB445137-D7F5-57EC-87DA-1DB460D64046,"iPhone13,2"
com.apple.MobileSMS,5,1706738687,1706738692,1706738692.2248669,-21600,EB445137-D7F5-57EC-87DA-1DB460D64046,"iPhone13,2"
com.apple.MobileSMS,3,1706738582,1706738585,1706738585.044376,-21600,EB445137-D7F5-57EC-87DA-1DB460D64046,"iPhone13,2"
com.apple.MobileSMS,2,1706738443,1706738445,1706738445.223073,-21600,EB445137-D7F5-57EC-87DA-1DB460D64046,"iPhone13,2"
com.apple.MobileSMS,20,1706738404,1706738424,1706738424.457511,-21600,EB445137-D7F5-57EC-87DA-1DB460D64046,"iPhone13,2"
com.apple.MobileSMS,1,1706738388,1706738389,1706738389.708271,-21600,EB445137-D7F5-57EC-87DA-1DB460D64046,"iPhone13,2"
com.apple.MobileSMS,31,1706738307,1706738338,1706738338.223994,-21600,EB445137-D7F5-57EC-87DA-1DB460D64046,"iPhone13,2"
com.apple.MobileSMS,4,1706738262,1706738266,1706738266.302815,-21600,EB445137-D7F5-57EC-87DA-1DB460D64046,"iPhone13,2"
com.apple.MobileSMS,5,1706738256,1706738261,1706738261.408722,-21600,EB445137-D7F5-57EC-87DA-1DB460D64046,"iPhone13,2"
com.apple.MobileSMS,49,1706738202,1706738251,1706738251.493921,-21600,EB445137-D7F5-57EC-87DA-1DB460D64046,"iPhone13,2"
com.apple.MobileSMS,11,1706738181,1706738192,1706738192.0691319,-21600,EB445137-D7F5-57EC-87DA-1DB460D64046,"iPhone13,2"
com.apple.MobileSMS,13,1706738155,1706738168,1706738168.048362,-21600,EB445137-D7F5-57EC-87DA-1DB460D64046,"iPhone13,2"
com.apple.MobileSMS,10,1706738089,1706738099,1706738099.3062801,-21600,EB445137-D7F5-57EC-87DA-1DB460D64046,"iPhone13,2"
com.apple.MobileSMS,4,1706738085,1706738089,1706738089.163488,-21600,EB445137-D7F5-57EC-87DA-1DB460D64046,"iPhone13,2"
com.apple.MobileSMS,2,1706738015,1706738017,1706738017.5834498,-21600,EB445137-D7F5-57EC-87DA-1DB460D64046,"iPhone13,2"
com.apple.MobileSMS,3,1706737924,1706737927,1706737927.661926,-21600,EB445137-D7F5-57EC-87DA-1DB460D64046,"iPhone13,2"
com.google.Maps,10,1706737912,1706737922,1706737922.0998,-21600,EB445137-D7F5-57EC-87DA-1DB460D64046,"iPhone13,2"
com.apple.MobileSMS,5,1706737907,1706737912,1706737912.2830029,-21600,EB445137-D7F5-57EC-87DA-1DB460D64046,"iPhone13,2"
com.apple.MobileSMS,4,1706737890,1706737894,1706737894.767072,-21600,EB445137-D7F5-57EC-87DA-1DB460D64046,"iPhone13,2"
com.apple.findmy,24,1706737866,1706737890,1706737890.136863,-21600,EB445137-D7F5-57EC-87DA-1DB460D64046,"iPhone13,2"
com.apple.MobileSMS,4,1706737862,1706737866,1706737866.450619,-21600,EB445137-D7F5-57EC-87DA-1DB460D64046,"iPhone13,2"
com.apple.MobileSMS,1,1706737857,1706737858,1706737858.721074,-21600,EB445137-D7F5-57EC-87DA-1DB460D64046,"iPhone13,2"
com.apple.MobileSMS,12,1706737841,1706737853,1706737853.358533,-21600,EB445137-D7F5-57EC-87DA-1DB460D64046,"iPhone13,2"
com.apple.MobileSMS,75,1706737745,1706737820,1706737820.644322,-21600,EB445137-D7F5-57EC-87DA-1DB460D64046,"iPhone13,2"
com.apple.MobileSMS,101,1706737618,1706737719,1706737719.944762,-21600,EB445137-D7F5-57EC-87DA-1DB460D64046,"iPhone13,2"
com.apple.MobileSMS,12,1706737594,1706737606,1706737606.6304111,-21600,EB445137-D7F5-57EC-87DA-1DB460D64046,"iPhone13,2"
com.apple.MobileSMS,277,1706737225,1706737502,1706737502.0818691,-21600,EB445137-D7F5-57EC-87DA-1DB460D64046,"iPhone13,2"
com.apple.news,6,1706737219,1706737225,1706737225.896399,-21600,EB445137-D7F5-57EC-87DA-1DB460D64046,"iPhone13,2"
com.apple.news,606,1706736562,1706737168,1706737168.963723,-21600,EB445137-D7F5-57EC-87DA-1DB460D64046,"iPhone13,2"
com.apple.news,5,1706736548,1706736553,1706736553.5781069,-21600,EB445137-D7F5-57EC-87DA-1DB460D64046,"iPhone13,2"
com.apple.news,393,1706734444,1706734837,1706734837.714966,-21600,EB445137-D7F5-57EC-87DA-1DB460D64046,"iPhone13,2"
com.apple.findmy,17,1706734409,1706734426,1706734426.886263,-21600,EB445137-D7F5-57EC-87DA-1DB460D64046,"iPhone13,2"
com.google.Chrome,9,1706733894,1706733903,1706733903.920285,-21600,,
com.leomehlig.today,149,1706733745,1706733894,1706733894.17843,-21600,,
com.google.Chrome,35,1706733710,1706733745,1706733745.605742,-21600,,
com.leomehlig.today,40,1706733670,1706733710,1706733710.090938,-21600,,
com.google.Chrome,17,1706733653,1706733670,1706733670.420802,-21600,,
com.microsoft.VSCode,82,1706733571,1706733653,1706733653.539773,-21600,,
com.google.Chrome,5,1706733566,1706733571,1706733571.47185,-21600,,
com.microsoft.VSCode,124,1706733442,1706733566,1706733566.8908691,-21600,,
com.google.Chrome,53,1706733389,1706733442,1706733442.298188,-21600,,
com.microsoft.VSCode,15,1706733374,1706733389,1706733389.651166,-21600,,
com.google.Chrome,53,1706733321,1706733374,1706733374.250876,-21600,,
com.microsoft.VSCode,589,1706732732,1706733321,1706733321.2943811,-21600,,
com.apple.finder,2,1706732730,1706732732,1706732732.075623,-21600,,
com.google.Chrome,6,1706732724,1706732730,1706732730.3187551,-21600,,
com.apple.finder,1,1706732723,1706732724,1706732724.797004,-21600,,
com.microsoft.VSCode,171,1706732552,1706732723,1706732723.552137,-21600,,
com.apple.finder,2,1706732550,1706732552,1706732552.731114,-21600,,
com.google.Chrome,395,1706732155,1706732550,1706732550.434381,-21600,,
com.leomehlig.today,10,1706732145,1706732155,1706732155.074367,-21600,,
com.google.Chrome,1167,1706730978,1706732145,1706732145.156228,-21600,,
com.microsoft.VSCode,6,1706730972,1706730978,1706730978.351606,-21600,,
com.leomehlig.today,47,1706730925,1706730972,1706730972.583816,-21600,,
com.microsoft.VSCode,9,1706730916,1706730925,1706730925.1537871,-21600,,
com.instructure.icanvas,7,1706730879,1706730886,1706730886.4286761,-21600,EB445137-D7F5-57EC-87DA-1DB460D64046,"iPhone13,2"
com.apple.MobileSMS,57,1706730818,1706730875,1706730875.806257,-21600,EB445137-D7F5-57EC-87DA-1DB460D64046,"iPhone13,2"
com.apple.news,3,1706730815,1706730818,1706730820.288556,-21600,EB445137-D7F5-57EC-87DA-1DB460D64046,"iPhone13,2"
com.apple.news,119,1706727471,1706727590,1706727590.416631,-21600,EB445137-D7F5-57EC-87DA-1DB460D64046,"iPhone13,2"
com.toyopagroup.picaboo,17,1706727434,1706727451,1706727451.910609,-21600,EB445137-D7F5-57EC-87DA-1DB460D64046,"iPhone13,2"
com.apple.news,10,1706727422,1706727432,1706727432.22361,-21600,EB445137-D7F5-57EC-87DA-1DB460D64046,"iPhone13,2"
com.microsoft.VSCode,815,1706726566,1706727381,1706727381.849484,-21600,,
com.apple.Preview,1,1706726565,1706726566,1706726567.008873,-21600,,
com.microsoft.VSCode,9,1706726556,1706726565,1706726565.896049,-21600,,
com.apple.Preview,3,1706726553,1706726556,1706726556.263385,-21600,,
com.microsoft.VSCode,7,1706726546,1706726553,1706726553.619489,-21600,,
com.apple.Preview,1,1706726545,1706726546,1706726546.378183,-21600,,
com.apple.finder,2,1706726543,1706726545,1706726545.180901,-21600,,
com.apple.Preview,5,1706726538,1706726543,1706726544.0738878,-21600,,
com.apple.finder,3,1706726535,1706726538,1706726538.889233,-21600,,
com.microsoft.VSCode,42,1706726493,1706726535,1706726535.468651,-21600,,
com.apple.news,2,1706726404,1706726406,1706726406.8588262,-21600,EB445137-D7F5-57EC-87DA-1DB460D64046,"iPhone13,2"
com.apple.news,247,1706725372,1706725619,1706725619.849164,-21600,EB445137-D7F5-57EC-87DA-1DB460D64046,"iPhone13,2"
com.microsoft.Office.Outlook,33,1706725339,1706725372,1706725372.9333858,-21600,EB445137-D7F5-57EC-87DA-1DB460D64046,"iPhone13,2"
com.apple.news,565,1706724774,1706725339,1706725339.796204,-21600,EB445137-D7F5-57EC-87DA-1DB460D64046,"iPhone13,2"
com.microsoft.Office.Outlook,78,1706724623,1706724701,1706724701.923248,-21600,EB445137-D7F5-57EC-87DA-1DB460D64046,"iPhone13,2"
edu.illinois.rokwire.ios,2,1706724621,1706724623,1706724623.868336,-21600,EB445137-D7F5-57EC-87DA-1DB460D64046,"iPhone13,2"
edu.illinois.rokwire.ios,42,1706723396,1706723438,1706723438.146492,-21600,EB445137-D7F5-57EC-87DA-1DB460D64046,"iPhone13,2"
com.instructure.icanvas,2,1706720392,1706720394,1706720394.054802,-21600,EB445137-D7F5-57EC-87DA-1DB460D64046,"iPhone13,2"
com.instructure.icanvas,65,1706720326,1706720391,1706720392.079292,-21600,EB445137-D7F5-57EC-87DA-1DB460D64046,"iPhone13,2"
com.apple.MobileSMS,3,1706720323,1706720326,1706720326.456209,-21600,EB445137-D7F5-57EC-87DA-1DB460D64046,"iPhone13,2"
com.apple.mobiletimer,4,1706720316,1706720320,1706720320.046603,-21600,EB445137-D7F5-57EC-87DA-1DB460D64046,"iPhone13,2"
com.apple.Health,53,1706720261,1706720314,1706720314.7645922,-21600,EB445137-D7F5-57EC-87DA-1DB460D64046,"iPhone13,2"
com.microsoft.Office.Outlook,29,1706720182,1706720211,1706720211.732547,-21600,EB445137-D7F5-57EC-87DA-1DB460D64046,"iPhone13,2"
com.instructure.icanvas,16,1706720166,1706720182,1706720182.268795,-21600,EB445137-D7F5-57EC-87DA-1DB460D64046,"iPhone13,2"
com.microsoft.VSCode,487,1706718484,1706718971,1706718971.3501868,-21600,,
com.google.Chrome,14,1706718470,1706718484,1706718484.4932299,-21600,,
com.microsoft.VSCode,6,1706718464,1706718470,1706718470.44135,-21600,,
com.google.Chrome,7,1706718457,1706718464,1706718464.960994,-21600,,
com.microsoft.VSCode,9,1706718448,1706718457,1706718457.350342,-21600,,
com.google.Chrome,3,1706718445,1706718448,1706718448.368092,-21600,,
com.microsoft.VSCode,71,1706718374,1706718445,1706718445.070524,-21600,,
com.google.Chrome,2,1706718372,1706718374,1706718374.5405731,-21600,,
com.microsoft.VSCode,0,1706718372,1706718372,1706718372.6558208,-21600,,
com.google.Chrome,1,1706718371,1706718372,1706718372.374572,-21600,,
com.microsoft.VSCode,1,1706718370,1706718371,1706718371.576721,-21600,,
com.apple.finder,1,1706718369,1706718370,1706718370.4368482,-21600,,
com.microsoft.VSCode,2,1706718367,1706718369,1706718369.719394,-21600,,
com.apple.finder,1,1706718366,1706718367,1706718367.30392,-21600,,
com.google.Chrome,28,1706718338,1706718366,1706718366.206452,-21600,,
com.apple.finder,9,1706718329,1706718338,1706718338.711619,-21600,,
com.microsoft.VSCode,791,1706717538,1706718329,1706718329.423451,-21600,,
com.google.Chrome,183,1706717355,1706717538,1706717538.397564,-21600,,
com.microsoft.VSCode,1,1706717354,1706717355,1706717355.937211,-21600,,
com.microsoft.VSCode,1291,1706716060,1706717351,1706717351.2740011,-21600,,
com.google.Chrome,38,1706716022,1706716060,1706716060.210031,-21600,,
com.microsoft.VSCode,302,1706715720,1706716022,1706716022.8879352,-21600,,
com.google.Chrome,5,1706715715,1706715720,1706715720.6753979,-21600,,
com.microsoft.VSCode,319,1706715396,1706715715,1706715715.8794708,-21600,,
com.apple.finder,5,1706715391,1706715396,1706715396.615938,-21600,,
com.microsoft.VSCode,144,1706715247,1706715391,1706715391.706963,-21600,,
com.apple.finder,1,1706715246,1706715247,1706715247.8076792,-21600,,
com.microsoft.VSCode,0,1706715246,1706715246,1706715246.466604,-21600,,
com.apple.finder,3,1706715243,1706715246,1706715246.140904,-21600,,
com.microsoft.VSCode,1,1706715242,1706715243,1706715243.268892,-21600,,
com.google.Chrome,2,1706715240,1706715242,1706715242.3241339,-21600,,
com.microsoft.VSCode,2,1706715238,1706715240,1706715240.912051,-21600,,
com.google.Chrome,5,1706715233,1706715238,1706715238.447709,-21600,,
com.microsoft.VSCode,7,1706715226,1706715233,1706715233.642274,-21600,,
com.apple.finder,6,1706715220,1706715226,1706715226.885748,-21600,,
com.microsoft.VSCode,24,1706715196,1706715220,1706715220.153158,-21600,,
com.google.Chrome,27,1706715169,1706715196,1706715196.248383,-21600,,
com.instructure.icanvas,1,1706714710,1706714711,1706714711.7908158,-21600,EB445137-D7F5-57EC-87DA-1DB460D64046,"iPhone13,2"
com.instructure.icanvas,2,1706714652,1706714654,1706714654.166713,-21600,EB445137-D7F5-57EC-87DA-1DB460D64046,"iPhone13,2"
com.instructure.icanvas,2,1706714531,1706714533,1706714533.346456,-21600,EB445137-D7F5-57EC-87DA-1DB460D64046,"iPhone13,2"
com.instructure.icanvas,31,1706714341,1706714372,1706714373.106112,-21600,EB445137-D7F5-57EC-87DA-1DB460D64046,"iPhone13,2"
com.google.Maps,4,1706714333,1706714337,1706714337.427304,-21600,EB445137-D7F5-57EC-87DA-1DB460D64046,"iPhone13,2"
com.google.Maps,2,1706714321,1706714323,1706714323.289281,-21600,EB445137-D7F5-57EC-87DA-1DB460D64046,"iPhone13,2"
com.google.Maps,43,1706714278,1706714321,1706714321.16722,-21600,EB445137-D7F5-57EC-87DA-1DB460D64046,"iPhone13,2"
com.google.Maps,8,1706714145,1706714153,1706714154.1817331,-21600,EB445137-D7F5-57EC-87DA-1DB460D64046,"iPhone13,2"
com.toyopagroup.picaboo,72,1706714073,1706714145,1706714145.372552,-21600,EB445137-D7F5-57EC-87DA-1DB460D64046,"iPhone13,2"
com.apple.Health,21,1706713868,1706713889,1706713889.3133888,-21600,EB445137-D7F5-57EC-87DA-1DB460D64046,"iPhone13,2"
com.instructure.icanvas,14,1706713852,1706713866,1706713866.39663,-21600,EB445137-D7F5-57EC-87DA-1DB460D64046,"iPhone13,2"
com.google.Chrome,674,1706676008,1706676682,1706676683.2416759,-21600,,
com.google.Chrome,723,1706674914,1706675637,1706675637.3621922,-21600,,
com.google.Chrome,625,1706674209,1706674834,1706674834.168634,-21600,,
com.google.Chrome,1720,1706672093,1706673813,1706673813.6316519,-21600,,
com.google.Chrome,1244,1706670682,1706671926,1706671926.490135,-21600,,
com.apple.finder,20,1706670662,1706670682,1706670682.082165,-21600,,
com.apple.finder,3,1706669193,1706669196,1706669196.893096,-21600,,
com.google.Chrome,1,1706669192,1706669193,1706669193.19245,-21600,,
com.leomehlig.today,160,1706669032,1706669192,1706669192.60881,-21600,,
com.google.Chrome,1073,1706667959,1706669032,1706669032.356711,-21600,,
com.google.Chrome,309,1706667627,1706667936,1706667936.999817,-21600,,
com.microsoft.Word,16,1706667611,1706667627,1706667627.131952,-21600,,
com.google.Chrome,1064,1706666547,1706667611,1706667611.110398,-21600,,
com.microsoft.Word,8,1706666539,1706666547,1706666547.594358,-21600,,
com.google.Chrome,85,1706666454,1706666539,1706666539.8449922,-21600,,
com.leomehlig.today,7,1706666447,1706666454,1706666454.773965,-21600,,
com.google.Chrome,1,1706666446,1706666447,1706666447.848332,-21600,,
com.apple.MobileSMS,3,1706666443,1706666446,1706666446.449884,-21600,,
com.google.Chrome,95,1706666348,1706666443,1706666443.378059,-21600,,
com.leomehlig.today,31,1706666317,1706666348,1706666348.308469,-21600,,
com.google.Chrome,1000,1706665317,1706666317,1706666317.6655931,-21600,,
com.apple.Preview,1,1706665316,1706665317,1706665317.604049,-21600,,
com.google.Chrome,10,1706665306,1706665316,1706665316.564121,-21600,,
com.apple.Preview,60,1706665246,1706665306,1706665306.322454,-21600,,
com.google.Chrome,157,1706665089,1706665246,1706665246.0821671,-21600,,
com.apple.Preview,36,1706665053,1706665089,1706665089.8743029,-21600,,
com.apple.finder,6,1706665047,1706665053,1706665054.0198169,-21600,,
com.google.Chrome,618,1706664429,1706665047,1706665047.305632,-21600,,
com.intsig.CamScannerLite,7,1706664297,1706664304,1706664304.0950189,-21600,EB445137-D7F5-57EC-87DA-1DB460D64046,"iPhone13,2"
com.intsig.CamScannerLite,15,1706664088,1706664103,1706664103.351066,-21600,EB445137-D7F5-57EC-87DA-1DB460D64046,"iPhone13,2"
com.google.Chrome,633,1706663794,1706664427,1706664427.7189841,-21600,,
com.apple.calculator,48,1706663746,1706663794,1706663794.0970001,-21600,,
com.google.Chrome,294,1706663452,1706663746,1706663746.9441,-21600,,
com.intsig.CamScannerLite,144,1706663442,1706663586,1706663586.7519,-21600,EB445137-D7F5-57EC-87DA-1DB460D64046,"iPhone13,2"
com.toyopagroup.picaboo,3,1706663437,1706663440,1706663441.233583,-21600,EB445137-D7F5-57EC-87DA-1DB460D64046,"iPhone13,2"
com.toyopagroup.picaboo,101,1706663020,1706663121,1706663121.4912372,-21600,EB445137-D7F5-57EC-87DA-1DB460D64046,"iPhone13,2"
com.toyopagroup.picaboo,45,1706662962,1706663007,1706663007.89647,-21600,EB445137-D7F5-57EC-87DA-1DB460D64046,"iPhone13,2"
com.google.Chrome,508,1706662942,1706663450,1706663450.5274138,-21600,,
com.toyopagroup.picaboo,16,1706662905,1706662921,1706662921.344851,-21600,EB445137-D7F5-57EC-87DA-1DB460D64046,"iPhone13,2"
com.leomehlig.today,40,1706662902,1706662942,1706662942.345485,-21600,,
com.google.ios.youtube,3,1706662902,1706662905,1706662905.237889,-21600,EB445137-D7F5-57EC-87DA-1DB460D64046,"iPhone13,2"
com.apple.camera,6,1706662714,1706662720,1706662720.354682,-21600,EB445137-D7F5-57EC-87DA-1DB460D64046,"iPhone13,2"
com.google.ios.youtube,9,1706662711,1706662720,1706662720.2902951,-21600,EB445137-D7F5-57EC-87DA-1DB460D64046,"iPhone13,2"
com.google.ios.youtube,2,1706661926,1706661928,1706661929.021422,-21600,EB445137-D7F5-57EC-87DA-1DB460D64046,"iPhone13,2"
com.google.ios.youtube,4,1706661305,1706661309,1706661309.433068,-21600,EB445137-D7F5-57EC-87DA-1DB460D64046,"iPhone13,2"
com.google.ios.youtube,8,1706660967,1706660975,1706660975.926213,-21600,EB445137-D7F5-57EC-87DA-1DB460D64046,"iPhone13,2"
com.google.ios.youtube,50,1706660859,1706660909,1706660909.959818,-21600,EB445137-D7F5-57EC-87DA-1DB460D64046,"iPhone13,2"
com.google.ios.youtube,2480,1706658306,1706660786,1706660786.3063002,-21600,EB445137-D7F5-57EC-87DA-1DB460D64046,"iPhone13,2"
com.apple.MobileSMS,39,1706658253,1706658292,1706658292.6158872,-21600,EB445137-D7F5-57EC-87DA-1DB460D64046,"iPhone13,2"
com.apple.MobileSMS,8,1706658183,1706658191,1706658191.827373,-21600,EB445137-D7F5-57EC-87DA-1DB460D64046,"iPhone13,2"
com.apple.MobileSMS,10,1706658170,1706658180,1706658180.182496,-21600,EB445137-D7F5-57EC-87DA-1DB460D64046,"iPhone13,2"
com.apple.MobileSMS,5,1706658084,1706658089,1706658089.078347,-21600,EB445137-D7F5-57EC-87DA-1DB460D64046,"iPhone13,2"
com.apple.MobileSMS,26,1706658052,1706658078,1706658078.307924,-21600,EB445137-D7F5-57EC-87DA-1DB460D64046,"iPhone13,2"
com.google.Maps,3,1706658049,1706658052,1706658052.47769,-21600,EB445137-D7F5-57EC-87DA-1DB460D64046,"iPhone13,2"
com.google.Maps,1,1706658045,1706658046,1706658046.8528671,-21600,EB445137-D7F5-57EC-87DA-1DB460D64046,"iPhone13,2"
com.google.Maps,1,1706657047,1706657048,1706657048.880806,-21600,EB445137-D7F5-57EC-87DA-1DB460D64046,"iPhone13,2"
com.google.Maps,1,1706657021,1706657022,1706657022.894628,-21600,EB445137-D7F5-57EC-87DA-1DB460D64046,"iPhone13,2"
com.google.Maps,38,1706656858,1706656896,1706656896.867336,-21600,EB445137-D7F5-57EC-87DA-1DB460D64046,"iPhone13,2"
com.instructure.icanvas,19,1706656834,1706656853,1706656853.514785,-21600,EB445137-D7F5-57EC-87DA-1DB460D64046,"iPhone13,2"
com.apple.MobileSMS,14,1706653653,1706653667,1706653667.527241,-21600,EB445137-D7F5-57EC-87DA-1DB460D64046,"iPhone13,2"
com.apple.weather,3,1706653649,1706653652,1706653653.149876,-21600,EB445137-D7F5-57EC-87DA-1DB460D64046,"iPhone13,2"
com.apple.weather,1,1706653470,1706653471,1706653471.561502,-21600,EB445137-D7F5-57EC-87DA-1DB460D64046,"iPhone13,2"
com.apple.weather,11,1706653458,1706653469,1706653469.450087,-21600,EB445137-D7F5-57EC-87DA-1DB460D64046,"iPhone13,2"
com.google.Maps,36,1706653421,1706653457,1706653458.0131412,-21600,EB445137-D7F5-57EC-87DA-1DB460D64046,"iPhone13,2"
com.google.Maps,1,1706653352,1706653353,1706653353.927552,-21600,EB445137-D7F5-57EC-87DA-1DB460D64046,"iPhone13,2"
com.google.Maps,15,1706652987,1706653002,1706653002.787387,-21600,EB445137-D7F5-57EC-87DA-1DB460D64046,"iPhone13,2"
com.goodreads.Goodreads,21,1706652963,1706652984,1706652984.189482,-21600,EB445137-D7F5-57EC-87DA-1DB460D64046,"iPhone13,2"
com.thestorygraph.thestorygraph,3,1706652960,1706652963,1706652963.223691,-21600,EB445137-D7F5-57EC-87DA-1DB460D64046,"iPhone13,2"
com.goodreads.Goodreads,16,1706652944,1706652960,1706652960.87924,-21600,EB445137-D7F5-57EC-87DA-1DB460D64046,"iPhone13,2"
com.thestorygraph.thestorygraph,11,1706652933,1706652944,1706652944.601937,-21600,EB445137-D7F5-57EC-87DA-1DB460D64046,"iPhone13,2"
com.google.Maps,5,1706652923,1706652928,1706652928.583794,-21600,EB445137-D7F5-57EC-87DA-1DB460D64046,"iPhone13,2"
com.google.Maps,10,1706652366,1706652376,1706652376.9545941,-21600,EB445137-D7F5-57EC-87DA-1DB460D64046,"iPhone13,2"
com.google.Maps,10,1706652025,1706652035,1706652035.07896,-21600,EB445137-D7F5-57EC-87DA-1DB460D64046,"iPhone13,2"
com.google.Maps,10,1706651647,1706651657,1706651657.15886,-21600,EB445137-D7F5-57EC-87DA-1DB460D64046,"iPhone13,2"
com.google.Maps,12,1706651630,1706651642,1706651642.6789021,-21600,EB445137-D7F5-57EC-87DA-1DB460D64046,"iPhone13,2"
com.google.Maps,6,1706651492,1706651498,1706651498.8326468,-21600,EB445137-D7F5-57EC-87DA-1DB460D64046,"iPhone13,2"
com.google.Maps,51,1706650542,1706650593,1706650593.9288092,-21600,EB445137-D7F5-57EC-87DA-1DB460D64046,"iPhone13,2"
com.leomehlig.today,23,1706650181,1706650204,1706650204.372716,-21600,,
com.google.Chrome,1,1706650180,1706650181,1706650181.9366589,-21600,,
us.zoom.xos,0,1706650180,1706650180,1706650181.0475159,-21600,,
com.google.Chrome,6,1706650174,1706650180,1706650180.8746781,-21600,,
com.google.chrome.ios,338,1706649740,1706650078,1706650078.367972,-21600,EB445137-D7F5-57EC-87DA-1DB460D64046,"iPhone13,2"
com.google.chrome.ios,17,1706649692,1706649709,1706649709.790415,-21600,EB445137-D7F5-57EC-87DA-1DB460D64046,"iPhone13,2"
com.google.Chrome,305,1706649617,1706649922,1706649922.4443579,-21600,,
us.zoom.xos,17,1706649600,1706649617,1706649617.948744,-21600,,
us.zoom.xos,470,1706648696,1706649166,1706649166.7173948,-21600,,
com.toyopagroup.picaboo,28,1706648470,1706648498,1706648498.7595382,-21600,EB445137-D7F5-57EC-87DA-1DB460D64046,"iPhone13,2"
com.truebill.truebillnative,3,1706648464,1706648467,1706648467.623811,-21600,EB445137-D7F5-57EC-87DA-1DB460D64046,"iPhone13,2"
com.truebill.truebillnative,9,1706647801,1706647810,1706647810.882834,-21600,EB445137-D7F5-57EC-87DA-1DB460D64046,"iPhone13,2"
com.truebill.truebillnative,13,1706647559,1706647572,1706647572.244547,-21600,EB445137-D7F5-57EC-87DA-1DB460D64046,"iPhone13,2"
com.truebill.truebillnative,71,1706647136,1706647207,1706647207.955642,-21600,EB445137-D7F5-57EC-87DA-1DB460D64046,"iPhone13,2"
com.clairmail.fth.client,22,1706647113,1706647135,1706647135.1839008,-21600,EB445137-D7F5-57EC-87DA-1DB460D64046,"iPhone13,2"
com.instructure.icanvas,12,1706647079,1706647091,1706647091.88778,-21600,EB445137-D7F5-57EC-87DA-1DB460D64046,"iPhone13,2"
com.instructure.icanvas,6,1706646994,1706647000,1706647000.866488,-21600,EB445137-D7F5-57EC-87DA-1DB460D64046,"iPhone13,2"
com.instructure.icanvas,25,1706646859,1706646884,1706646884.8513188,-21600,EB445137-D7F5-57EC-87DA-1DB460D64046,"iPhone13,2"
us.zoom.xos,1136,1706646620,1706647756,1706647756.6194701,-21600,,
us.zoom.xos,302,1706646203,1706646505,1706646505.1209779,-21600,,
us.zoom.xos,300,1706645542,1706645842,1706645842.845691,-21600,,
com.google.Chrome,44,1706645498,1706645542,1706645542.092647,-21600,,
us.zoom.xos,50,1706645448,1706645498,1706645498.5416589,-21600,,
com.microsoft.Office.Outlook,44,1706645432,1706645476,1706645476.4449902,-21600,EB445137-D7F5-57EC-87DA-1DB460D64046,"iPhone13,2"
com.apple.MobileSMS,5,1706645427,1706645432,1706645432.467245,-21600,EB445137-D7F5-57EC-87DA-1DB460D64046,"iPhone13,2"
com.apple.MobileSMS,14,1706645410,1706645424,1706645424.904741,-21600,EB445137-D7F5-57EC-87DA-1DB460D64046,"iPhone13,2"
com.apple.MobileSMS,13,1706645370,1706645383,1706645383.154161,-21600,EB445137-D7F5-57EC-87DA-1DB460D64046,"iPhone13,2"
edu.illinois.rokwire.ios,22,1706645348,1706645370,1706645370.332261,-21600,EB445137-D7F5-57EC-87DA-1DB460D64046,"iPhone13,2"
com.apple.MobileSMS,10,1706645337,1706645347,1706645347.753079,-21600,EB445137-D7F5-57EC-87DA-1DB460D64046,"iPhone13,2"
com.toyopagroup.picaboo,6,1706645330,1706645336,1706645337.357719,-21600,EB445137-D7F5-57EC-87DA-1DB460D64046,"iPhone13,2"
com.toyopagroup.picaboo,25,1706645048,1706645073,1706645073.6983519,-21600,EB445137-D7F5-57EC-87DA-1DB460D64046,"iPhone13,2"
com.apple.MobileSMS,8,1706645040,1706645048,1706645048.242834,-21600,EB445137-D7F5-57EC-87DA-1DB460D64046,"iPhone13,2"
us.zoom.xos,305,1706644985,1706645290,1706645290.887786,-21600,,
com.microsoft.onenote.mac,4,1706644981,1706644985,1706644986.115757,-21600,,
com.leomehlig.today,89,1706644892,1706644981,1706644981.5926042,-21600,,
us.zoom.xos,106,1706644786,1706644892,1706644892.178644,-21600,,
com.google.Chrome,1,1706644785,1706644786,1706644786.989754,-21600,,
us.zoom.xos,2,1706644783,1706644785,1706644785.8408198,-21600,,
com.google.Chrome,20,1706644763,1706644783,1706644783.767826,-21600,,
com.microsoft.Outlook,92,1706644671,1706644763,1706644763.54139,-21600,,
com.apple.Preview,177,1706644494,1706644671,1706644671.9942908,-21600,,
com.google.Chrome,2,1706644492,1706644494,1706644494.9839082,-21600,,
com.apple.Preview,4,1706644488,1706644492,1706644492.163068,-21600,,
com.google.Chrome,2,1706644486,1706644488,1706644488.391622,-21600,,
com.apple.Preview,9,1706644477,1706644486,1706644486.721082,-21600,,
com.google.Chrome,1,1706644476,1706644477,1706644478.029776,-21600,,
com.apple.Preview,1,1706644475,1706644476,1706644476.45876,-21600,,
com.google.Chrome,1,1706644474,1706644475,1706644475.686061,-21600,,
com.apple.Preview,2,1706644472,1706644474,1706644474.390013,-21600,,
com.google.Chrome,2,1706644470,1706644472,1706644472.728965,-21600,,
com.apple.Preview,9,1706644461,1706644470,1706644471.0162082,-21600,,
com.apple.finder,6,1706644455,1706644461,1706644461.45865,-21600,,
com.apple.archiveutility,0,1706644455,1706644455,1706644455.7821798,-21600,,
com.apple.finder,9,1706644446,1706644455,1706644455.419256,-21600,,
com.google.Chrome,70,1706644376,1706644446,1706644446.379446,-21600,,
com.apple.MobileSMS,7,1706643978,1706643985,1706643985.828393,-21600,EB445137-D7F5-57EC-87DA-1DB460D64046,"iPhone13,2"
com.apple.MobileSMS,1,1706643820,1706643821,1706643821.290575,-21600,EB445137-D7F5-57EC-87DA-1DB460D64046,"iPhone13,2"
com.apple.MobileSMS,16,1706643079,1706643095,1706643095.1748018,-21600,EB445137-D7F5-57EC-87DA-1DB460D64046,"iPhone13,2"
com.google.Maps,17,1706643059,1706643076,1706643076.545185,-21600,EB445137-D7F5-57EC-87DA-1DB460D64046,"iPhone13,2"
com.apple.mobileslideshow,7,1706643039,1706643046,1706643046.149595,-21600,EB445137-D7F5-57EC-87DA-1DB460D64046,"iPhone13,2"
com.google.Chrome,712,1706642280,1706642992,1706642992.989999,-21600,,
com.leomehlig.today,2,1706642278,1706642280,1706642282.1706982,-21600,,
com.apple.mobileslideshow,6,1706641463,1706641469,1706641469.5685658,-21600,EB445137-D7F5-57EC-87DA-1DB460D64046,"iPhone13,2"
com.apple.mobileslideshow,15,1706640876,1706640891,1706640891.800226,-21600,EB445137-D7F5-57EC-87DA-1DB460D64046,"iPhone13,2"
com.google.Maps,3,1706640860,1706640863,1706640863.170388,-21600,EB445137-D7F5-57EC-87DA-1DB460D64046,"iPhone13,2"
com.google.Maps,2,1706640821,1706640823,1706640823.2415829,-21600,EB445137-D7F5-57EC-87DA-1DB460D64046,"iPhone13,2"
com.google.Maps,10,1706640798,1706640808,1706640808.346747,-21600,EB445137-D7F5-57EC-87DA-1DB460D64046,"iPhone13,2"
com.google.chrome.ios,108,1706637684,1706637792,1706637792.892282,-21600,EB445137-D7F5-57EC-87DA-1DB460D64046,"iPhone13,2"
com.apple.news,263,1706637419,1706637682,1706637682.4294329,-21600,EB445137-D7F5-57EC-87DA-1DB460D64046,"iPhone13,2"
com.microsoft.Office.Outlook,83,1706637328,1706637411,1706637411.45948,-21600,EB445137-D7F5-57EC-87DA-1DB460D64046,"iPhone13,2"
com.google.chrome.ios,124,1706637203,1706637327,1706637327.707182,-21600,EB445137-D7F5-57EC-87DA-1DB460D64046,"iPhone13,2"
com.apple.mobilecal,2,1706637102,1706637104,1706637104.8848572,-21600,EB445137-D7F5-57EC-87DA-1DB460D64046,"iPhone13,2"
com.google.Maps,4,1706637097,1706637101,1706637101.903214,-21600,EB445137-D7F5-57EC-87DA-1DB460D64046,"iPhone13,2"
com.google.Maps,47,1706636727,1706636774,1706636774.103911,-21600,EB445137-D7F5-57EC-87DA-1DB460D64046,"iPhone13,2"
com.microsoft.Office.Outlook,5,1706636721,1706636726,1706636726.719585,-21600,EB445137-D7F5-57EC-87DA-1DB460D64046,"iPhone13,2"
com.apple.mobilecal,4,1706636716,1706636720,1706636720.307475,-21600,EB445137-D7F5-57EC-87DA-1DB460D64046,"iPhone13,2"
com.apple.mobilecal,3,1706636681,1706636684,1706636684.616792,-21600,EB445137-D7F5-57EC-87DA-1DB460D64046,"iPhone13,2"
com.apple.mobilecal,3,1706636662,1706636665,1706636665.829904,-21600,EB445137-D7F5-57EC-87DA-1DB460D64046,"iPhone13,2"
com.microsoft.Office.Outlook,3,1706636658,1706636661,1706636661.783235,-21600,EB445137-D7F5-57EC-87DA-1DB460D64046,"iPhone13,2"
com.microsoft.Office.Outlook,2,1706636348,1706636350,1706636350.169672,-21600,EB445137-D7F5-57EC-87DA-1DB460D64046,"iPhone13,2"
com.microsoft.Office.Outlook,4,1706636078,1706636082,1706636082.264437,-21600,EB445137-D7F5-57EC-87DA-1DB460D64046,"iPhone13,2"
com.microsoft.Office.Outlook,8,1706636045,1706636053,1706636053.66429,-21600,EB445137-D7F5-57EC-87DA-1DB460D64046,"iPhone13,2"
com.google.ios.youtube,808,1706635023,1706635831,1706635831.329391,-21600,EB445137-D7F5-57EC-87DA-1DB460D64046,"iPhone13,2"
edu.illinois.rokwire.ios,3,1706635020,1706635023,1706635023.180237,-21600,EB445137-D7F5-57EC-87DA-1DB460D64046,"iPhone13,2"
edu.illinois.rokwire.ios,1,1706634905,1706634906,1706634906.754278,-21600,EB445137-D7F5-57EC-87DA-1DB460D64046,"iPhone13,2"
com.leomehlig.today,4,1706633454,1706633458,1706633458.824578,-21600,,
com.google.Chrome,2,1706633452,1706633454,1706633454.407814,-21600,,
com.apple.dt.Xcode,4,1706633448,1706633452,1706633452.207288,-21600,,
com.google.Chrome,5,1706633443,1706633448,1706633448.4835072,-21600,,
com.microsoft.onenote.mac,56,1706633387,1706633443,1706633443.3813229,-21600,,
com.google.Chrome,1,1706633386,1706633387,1706633387.573851,-21600,,
com.microsoft.onenote.mac,16,1706633370,1706633386,1706633386.817821,-21600,,
com.google.Chrome,2,1706633368,1706633370,1706633370.558764,-21600,,
com.microsoft.onenote.mac,7,1706633361,1706633368,1706633368.4323401,-21600,,
com.google.Chrome,40,1706633321,1706633361,1706633361.191938,-21600,,
edu.illinois.rokwire.ios,7,1706633315,1706633322,1706633322.878509,-21600,EB445137-D7F5-57EC-87DA-1DB460D64046,"iPhone13,2"
edu.illinois.rokwire.ios,7,1706633301,1706633308,1706633308.3421512,-21600,EB445137-D7F5-57EC-87DA-1DB460D64046,"iPhone13,2"
com.apple.dt.Xcode,26,1706633253,1706633279,1706633279.589447,-21600,,
com.ryansponzilli.DeepSkyCatalogMac,22,1706633231,1706633253,1706633253.830906,-21600,,
com.apple.dt.Xcode,43,1706633188,1706633231,1706633231.879253,-21600,,
com.google.Chrome,18,1706633170,1706633188,1706633188.104197,-21600,,
com.apple.dt.Xcode,3,1706633167,1706633170,1706633170.648401,-21600,,
com.microsoft.onenote.mac,301,1706632866,1706633167,1706633167.9085832,-21600,,
com.google.Chrome,9,1706632857,1706632866,1706632866.603492,-21600,,
com.microsoft.onenote.mac,3,1706632854,1706632857,1706632857.46366,-21600,,
com.google.Chrome,435,1706632419,1706632854,1706632854.572505,-21600,,
com.leomehlig.today,70,1706632349,1706632419,1706632419.275078,-21600,,
com.google.Chrome,44,1706632305,1706632349,1706632349.223258,-21600,,
edu.illinois.rokwire.ios,13,1706632305,1706632318,1706632318.672683,-21600,EB445137-D7F5-57EC-87DA-1DB460D64046,"iPhone13,2"
com.apple.finder,14,1706632291,1706632305,1706632305.961035,-21600,,
edu.illinois.rokwire.ios,32,1706632257,1706632289,1706632289.098503,-21600,EB445137-D7F5-57EC-87DA-1DB460D64046,"iPhone13,2"
com.microsoft.Office.Outlook,19,1706632182,1706632201,1706632201.0574121,-21600,EB445137-D7F5-57EC-87DA-1DB460D64046,"iPhone13,2"
com.google.Maps,5,1706632177,1706632182,1706632182.569108,-21600,EB445137-D7F5-57EC-87DA-1DB460D64046,"iPhone13,2"
com.google.Maps,10,1706631273,1706631283,1706631283.277684,-21600,EB445137-D7F5-57EC-87DA-1DB460D64046,"iPhone13,2"
com.google.Maps,14,1706630355,1706630369,1706630369.932481,-21600,EB445137-D7F5-57EC-87DA-1DB460D64046,"iPhone13,2"
com.google.Maps,1,1706630352,1706630353,1706630353.397814,-21600,EB445137-D7F5-57EC-87DA-1DB460D64046,"iPhone13,2"
com.google.Maps,2,1706630217,1706630219,1706630219.470409,-21600,EB445137-D7F5-57EC-87DA-1DB460D64046,"iPhone13,2"
com.google.Maps,3,1706629799,1706629802,1706629802.539517,-21600,EB445137-D7F5-57EC-87DA-1DB460D64046,"iPhone13,2"
com.google.Maps,13,1706629518,1706629531,1706629531.5696359,-21600,EB445137-D7F5-57EC-87DA-1DB460D64046,"iPhone13,2"
com.peacocktv.peacock,1516,1706627494,1706629010,1706629010.0646338,-21600,EB445137-D7F5-57EC-87DA-1DB460D64046,"iPhone13,2"
com.google.ios.youtube,17,1706627475,1706627492,1706627492.182404,-21600,EB445137-D7F5-57EC-87DA-1DB460D64046,"iPhone13,2"
Astrospheric.Astrospheric,5,1706627445,1706627450,1706627450.38959,-21600,EB445137-D7F5-57EC-87DA-1DB460D64046,"iPhone13,2"
Astrospheric.Astrospheric,10,1706627224,1706627234,1706627234.5615458,-21600,EB445137-D7F5-57EC-87DA-1DB460D64046,"iPhone13,2"
Astrospheric.Astrospheric,15,1706627008,1706627023,1706627023.886396,-21600,EB445137-D7F5-57EC-87DA-1DB460D64046,"iPhone13,2"
com.microsoft.Office.Outlook,28,1706626968,1706626996,1706626996.3055038,-21600,EB445137-D7F5-57EC-87DA-1DB460D64046,"iPhone13,2"
com.apple.Health,24,1706626922,1706626946,1706626946.236016,-21600,EB445137-D7F5-57EC-87DA-1DB460D64046,"iPhone13,2"
com.google.Maps,6,1706626915,1706626921,1706626921.1999722,-21600,EB445137-D7F5-57EC-87DA-1DB460D64046,"iPhone13,2"
com.google.Maps,26,1706626847,1706626873,1706626873.19909,-21600,EB445137-D7F5-57EC-87DA-1DB460D64046,"iPhone13,2"
com.google.Maps,37,1706626807,1706626844,1706626844.5027509,-21600,EB445137-D7F5-57EC-87DA-1DB460D64046,"iPhone13,2"
com.toyopagroup.picaboo,10,1706592012,1706592022,1706592022.415813,-21600,EB445137-D7F5-57EC-87DA-1DB460D64046,"iPhone13,2"
com.toyopagroup.picaboo,2,1706591416,1706591418,1706591418.022493,-21600,EB445137-D7F5-57EC-87DA-1DB460D64046,"iPhone13,2"
com.toyopagroup.picaboo,6,1706590772,1706590778,1706590778.3395,-21600,EB445137-D7F5-57EC-87DA-1DB460D64046,"iPhone13,2"
com.toyopagroup.picaboo,10,1706590514,1706590524,1706590524.243887,-21600,EB445137-D7F5-57EC-87DA-1DB460D64046,"iPhone13,2"
com.toyopagroup.picaboo,4,1706590171,1706590175,1706590175.682146,-21600,EB445137-D7F5-57EC-87DA-1DB460D64046,"iPhone13,2"
com.toyopagroup.picaboo,1,1706589589,1706589590,1706589590.9428859,-21600,EB445137-D7F5-57EC-87DA-1DB460D64046,"iPhone13,2"
com.toyopagroup.picaboo,11,1706589577,1706589588,1706589588.949275,-21600,EB445137-D7F5-57EC-87DA-1DB460D64046,"iPhone13,2"
com.toyopagroup.picaboo,8,1706589549,1706589557,1706589557.136448,-21600,EB445137-D7F5-57EC-87DA-1DB460D64046,"iPhone13,2"
com.toyopagroup.picaboo,13,1706589000,1706589013,1706589013.1173291,-21600,EB445137-D7F5-57EC-87DA-1DB460D64046,"iPhone13,2"
com.toyopagroup.picaboo,10,1706588943,1706588953,1706588953.445096,-21600,EB445137-D7F5-57EC-87DA-1DB460D64046,"iPhone13,2"
com.toyopagroup.picaboo,10,1706588506,1706588516,1706588516.7324681,-21600,EB445137-D7F5-57EC-87DA-1DB460D64046,"iPhone13,2"
com.toyopagroup.picaboo,10,1706588436,1706588446,1706588446.65463,-21600,EB445137-D7F5-57EC-87DA-1DB460D64046,"iPhone13,2"
com.toyopagroup.picaboo,13,1706588387,1706588400,1706588400.534868,-21600,EB445137-D7F5-57EC-87DA-1DB460D64046,"iPhone13,2"
com.toyopagroup.picaboo,117,1706588266,1706588383,1706588383.646968,-21600,EB445137-D7F5-57EC-87DA-1DB460D64046,"iPhone13,2"
com.toyopagroup.picaboo,88,1706588171,1706588259,1706588259.074994,-21600,EB445137-D7F5-57EC-87DA-1DB460D64046,"iPhone13,2"
com.apple.Health,38,1706588127,1706588165,1706588165.292023,-21600,EB445137-D7F5-57EC-87DA-1DB460D64046,"iPhone13,2"
com.thestorygraph.thestorygraph,3,1706588124,1706588127,1706588127.411635,-21600,EB445137-D7F5-57EC-87DA-1DB460D64046,"iPhone13,2"
com.thestorygraph.thestorygraph,11,1706588109,1706588120,1706588120.106711,-21600,EB445137-D7F5-57EC-87DA-1DB460D64046,"iPhone13,2"
com.thestorygraph.thestorygraph,10,1706587819,1706587829,1706587829.519178,-21600,EB445137-D7F5-57EC-87DA-1DB460D64046,"iPhone13,2"
com.thestorygraph.thestorygraph,3,1706587815,1706587818,1706587818.77733,-21600,EB445137-D7F5-57EC-87DA-1DB460D64046,"iPhone13,2"
com.thestorygraph.thestorygraph,10,1706587673,1706587683,1706587683.39392,-21600,EB445137-D7F5-57EC-87DA-1DB460D64046,"iPhone13,2"
com.thestorygraph.thestorygraph,15,1706587657,1706587672,1706587672.575324,-21600,EB445137-D7F5-57EC-87DA-1DB460D64046,"iPhone13,2"
com.toyopagroup.picaboo,10,1706587645,1706587655,1706587655.261033,-21600,EB445137-D7F5-57EC-87DA-1DB460D64046,"iPhone13,2"
com.toyopagroup.picaboo,13,1706587420,1706587433,1706587433.382597,-21600,EB445137-D7F5-57EC-87DA-1DB460D64046,"iPhone13,2"
com.toyopagroup.picaboo,17,1706586711,1706586728,1706586728.212172,-21600,EB445137-D7F5-57EC-87DA-1DB460D64046,"iPhone13,2"
com.apple.Music,10,1706586700,1706586710,1706586710.0959249,-21600,EB445137-D7F5-57EC-87DA-1DB460D64046,"iPhone13,2"
com.apple.MobileSMS,3,1706586695,1706586698,1706586698.746283,-21600,EB445137-D7F5-57EC-87DA-1DB460D64046,"iPhone13,2"
com.apple.finder,3,1706586525,1706586528,1706586528.850127,-21600,,
com.microsoft.onenote.mac,8,1706586517,1706586525,1706586525.635308,-21600,,
com.apple.MobileSMS,10,1706586512,1706586522,1706586522.1234899,-21600,EB445137-D7F5-57EC-87DA-1DB460D64046,"iPhone13,2"
com.apple.MobileSMS,2,1706586509,1706586511,1706586511.394526,-21600,EB445137-D7F5-57EC-87DA-1DB460D64046,"iPhone13,2"
com.google.Chrome,23,1706586494,1706586517,1706586517.8504891,-21600,,
com.apple.finder,4,1706586490,1706586494,1706586494.462673,-21600,,
com.google.Chrome,19,1706586471,1706586490,1706586490.843195,-21600,,
com.leomehlig.today,133,1706586338,1706586471,1706586471.81011,-21600,,
com.google.Chrome,2,1706586336,1706586338,1706586338.256062,-21600,,
com.leomehlig.today,6,1706586330,1706586336,1706586336.863611,-21600,,
com.google.Chrome,0,1706586330,1706586330,1706586331.0279942,-21600,,
com.leomehlig.today,18,1706586312,1706586330,1706586330.5686321,-21600,,
com.apple.MobileSMS,10,1706586255,1706586265,1706586265.7641459,-21600,EB445137-D7F5-57EC-87DA-1DB460D64046,"iPhone13,2"
com.google.Chrome,148,1706586164,1706586312,1706586312.715157,-21600,,
com.google.Chrome,503,1706585232,1706585735,1706585735.5784888,-21600,,
com.apple.MobileSMS,1,1706584914,1706584915,1706584915.8310409,-21600,EB445137-D7F5-57EC-87DA-1DB460D64046,"iPhone13,2"
com.apple.Health,6,1706584908,1706584914,1706584914.59379,-21600,EB445137-D7F5-57EC-87DA-1DB460D64046,"iPhone13,2"
com.apple.Health,10,1706584788,1706584798,1706584798.907069,-21600,EB445137-D7F5-57EC-87DA-1DB460D64046,"iPhone13,2"
com.google.Chrome,1118,1706583922,1706585040,1706585040.0480561,-21600,,
com.apple.Preview,92,1706583830,1706583922,1706583922.698097,-21600,,
com.google.Chrome,2,1706583828,1706583830,1706583830.988075,-21600,,
com.apple.Health,167,1706583255,1706583422,1706583422.958653,-21600,EB445137-D7F5-57EC-87DA-1DB460D64046,"iPhone13,2"
com.microsoft.onenote.mac,689,1706583139,1706583828,1706583828.637424,-21600,,
com.apple.Preview,18,1706583121,1706583139,1706583139.7570372,-21600,,
com.hnc.Discord,3,1706583118,1706583121,1706583121.372118,-21600,,
com.apple.Preview,2,1706583116,1706583118,1706583118.9581208,-21600,,
com.google.Chrome,16,1706583100,1706583116,1706583116.98054,-21600,,
com.apple.iCal,93,1706583007,1706583100,1706583100.636996,-21600,,
com.google.Chrome,14,1706582993,1706583007,1706583007.654105,-21600,,
com.apple.iCal,41,1706582952,1706582993,1706582993.299347,-21600,,
com.google.Chrome,48,1706582904,1706582952,1706582952.633959,-21600,,
com.hnc.Discord,21,1706582883,1706582904,1706582904.262007,-21600,,
com.google.Chrome,11,1706582872,1706582883,1706582883.214922,-21600,,
com.hnc.Discord,9,1706582863,1706582872,1706582872.406623,-21600,,
com.google.Chrome,119,1706582744,1706582863,1706582863.794982,-21600,,
com.apple.systempreferences,13,1706582731,1706582744,1706582744.364327,-21600,,
com.google.Chrome,46,1706582679,1706582725,1706582725.156691,-21600,,
com.apple.MobileSMS,13,1706582653,1706582666,1706582666.437934,-21600,EB445137-D7F5-57EC-87DA-1DB460D64046,"iPhone13,2"
com.amazon.Amazon,39,1706582614,1706582653,1706582654.070339,-21600,EB445137-D7F5-57EC-87DA-1DB460D64046,"iPhone13,2"
com.apple.MobileSMS,5,1706582609,1706582614,1706582614.432919,-21600,EB445137-D7F5-57EC-87DA-1DB460D64046,"iPhone13,2"
com.apple.camera,2,1706582367,1706582369,1706582377.475079,-21600,EB445137-D7F5-57EC-87DA-1DB460D64046,"iPhone13,2"
com.apple.camera,4,1706579379,1706579383,1706579383.701149,-21600,EB445137-D7F5-57EC-87DA-1DB460D64046,"iPhone13,2"
com.hammerandchisel.discord,5,1706579376,1706579381,1706579381.258076,-21600,EB445137-D7F5-57EC-87DA-1DB460D64046,"iPhone13,2"
com.hammerandchisel.discord,77,1706579124,1706579201,1706579201.475119,-21600,EB445137-D7F5-57EC-87DA-1DB460D64046,"iPhone13,2"
com.google.Chrome,4,1706579119,1706579123,1706579123.066406,-21600,,
com.hnc.Discord,21,1706579098,1706579119,1706579119.238597,-21600,,
com.google.Chrome,2,1706579096,1706579098,1706579098.9800038,-21600,,
com.hnc.Discord,1,1706579095,1706579096,1706579096.873162,-21600,,
com.google.Chrome,86,1706579009,1706579095,1706579095.901434,-21600,,
com.leomehlig.today,130,1706578879,1706579009,1706579009.8087049,-21600,,
com.google.Chrome,2,1706578877,1706578879,1706578879.7460442,-21600,,
com.apple.Photos,10,1706578867,1706578877,1706578877.929906,-21600,,
com.google.Chrome,2,1706578865,1706578867,1706578867.115254,-21600,,
com.leomehlig.today,15,1706578850,1706578865,1706578865.982821,-21600,,
com.google.Chrome,75,1706578775,1706578850,1706578850.655019,-21600,,
com.apple.Preview,310,1706578465,1706578775,1706578775.6250858,-21600,,
com.google.Chrome,294,1706578171,1706578465,1706578465.4641461,-21600,,
com.google.Chrome,339,1706577831,1706578170,1706578170.642376,-21600,,
com.apple.Preview,414,1706577417,1706577831,1706577831.875445,-21600,,
com.burbn.instagram,252,1706577070,1706577322,1706577322.671845,-21600,EB445137-D7F5-57EC-87DA-1DB460D64046,"iPhone13,2"
com.apple.Preview,304,1706576954,1706577258,1706577258.758503,-21600,,
com.leomehlig.today,94,1706576860,1706576954,1706576955.02827,-21600,,
com.apple.Preview,412,1706576448,1706576860,1706576860.894322,-21600,,
com.google.Chrome,4,1706576444,1706576448,1706576448.086967,-21600,,
com.apple.Preview,8,1706576436,1706576444,1706576444.8468199,-21600,,
com.google.Chrome,3,1706576433,1706576436,1706576436.966608,-21600,,
com.apple.Preview,35,1706576398,1706576433,1706576433.171195,-21600,,
com.google.Chrome,40,1706576358,1706576398,1706576398.262823,-21600,,
com.apple.Preview,16,1706576342,1706576358,1706576359.0301661,-21600,,
com.google.Chrome,44,1706576298,1706576342,1706576342.8144832,-21600,,
com.apple.Preview,253,1706576045,1706576298,1706576298.42258,-21600,,
com.google.Chrome,101,1706575944,1706576045,1706576045.612222,-21600,,
com.apple.Preview,441,1706575503,1706575944,1706575944.637563,-21600,,
com.google.Chrome,89,1706575414,1706575503,1706575503.793082,-21600,,
com.apple.Preview,716,1706574698,1706575414,1706575414.461537,-21600,,
com.google.Chrome,27,1706574671,1706574698,1706574698.329581,-21600,,
com.apple.Preview,202,1706574469,1706574671,1706574671.8799958,-21600,,
com.google.Chrome,97,1706574372,1706574469,1706574469.432492,-21600,,
com.apple.Preview,85,1706574287,1706574372,1706574372.6362891,-21600,,
com.google.Chrome,42,1706574245,1706574287,1706574287.749906,-21600,,
com.apple.Preview,197,1706574048,1706574245,1706574245.910744,-21600,,
com.apple.finder,3,1706574045,1706574048,1706574048.73331,-21600,,
com.google.Chrome,72,1706573973,1706574045,1706574045.880673,-21600,,
com.google.Chrome,5,1706571825,1706571830,1706571830.1318688,-21600,,
com.google.Chrome,491,1706571121,1706571612,1706571612.277318,-21600,,
com.apple.Preview,2,1706571119,1706571121,1706571122.600092,-21600,,
com.burbn.instagram,319,1706570328,1706570647,1706570647.2775002,-21600,EB445137-D7F5-57EC-87DA-1DB460D64046,"iPhone13,2"
edu.illinois.rokwire.ios,68,1706570253,1706570321,1706570321.321702,-21600,EB445137-D7F5-57EC-87DA-1DB460D64046,"iPhone13,2"
com.google.ios.youtube,201,1706570050,1706570251,1706570252.039715,-21600,EB445137-D7F5-57EC-87DA-1DB460D64046,"iPhone13,2"
com.apple.MobileSMS,14,1706570036,1706570050,1706570050.68595,-21600,EB445137-D7F5-57EC-87DA-1DB460D64046,"iPhone13,2"
com.google.ios.youtube,37,1706569999,1706570036,1706570036.9749532,-21600,EB445137-D7F5-57EC-87DA-1DB460D64046,"iPhone13,2"
com.apple.MobileSMS,8,1706569991,1706569999,1706569999.648912,-21600,EB445137-D7F5-57EC-87DA-1DB460D64046,"iPhone13,2"
com.hammerandchisel.discord,12,1706569977,1706569989,1706569989.0560532,-21600,EB445137-D7F5-57EC-87DA-1DB460D64046,"iPhone13,2"
com.instructure.icanvas,1,1706569973,1706569974,1706569974.612437,-21600,EB445137-D7F5-57EC-87DA-1DB460D64046,"iPhone13,2"
com.google.ios.youtube,2287,1706567685,1706569972,1706569973.735165,-21600,EB445137-D7F5-57EC-87DA-1DB460D64046,"iPhone13,2"
com.instructure.icanvas,10,1706567675,1706567685,1706567685.8547668,-21600,EB445137-D7F5-57EC-87DA-1DB460D64046,"iPhone13,2"
com.instructure.icanvas,24,1706567087,1706567111,1706567111.702837,-21600,EB445137-D7F5-57EC-87DA-1DB460D64046,"iPhone13,2"
com.toyopagroup.picaboo,6,1706567081,1706567087,1706567087.9791899,-21600,EB445137-D7F5-57EC-87DA-1DB460D64046,"iPhone13,2"
com.toyopagroup.picaboo,11,1706567070,1706567081,1706567081.1740952,-21600,EB445137-D7F5-57EC-87DA-1DB460D64046,"iPhone13,2"
com.toyopagroup.picaboo,1,1706565442,1706565443,1706565443.8349872,-21600,EB445137-D7F5-57EC-87DA-1DB460D64046,"iPhone13,2"
com.toyopagroup.picaboo,6,1706565435,1706565441,1706565441.940676,-21600,EB445137-D7F5-57EC-87DA-1DB460D64046,"iPhone13,2"
com.apple.Music,6,1706565429,1706565435,1706565435.2851238,-21600,EB445137-D7F5-57EC-87DA-1DB460D64046,"iPhone13,2"
com.apple.Music,19,1706565393,1706565412,1706565412.492302,-21600,EB445137-D7F5-57EC-87DA-1DB460D64046,"iPhone13,2"
com.google.Maps,4,1706565387,1706565391,1706565391.641593,-21600,EB445137-D7F5-57EC-87DA-1DB460D64046,"iPhone13,2"
com.google.Maps,16,1706565336,1706565352,1706565352.660965,-21600,EB445137-D7F5-57EC-87DA-1DB460D64046,"iPhone13,2"
com.instructure.icanvas,5,1706565330,1706565335,1706565335.6205912,-21600,EB445137-D7F5-57EC-87DA-1DB460D64046,"iPhone13,2"
com.instructure.icanvas,2,1706565227,1706565229,1706565229.0148559,-21600,EB445137-D7F5-57EC-87DA-1DB460D64046,"iPhone13,2"
com.apple.Preview,33,1706565113,1706565146,1706565146.580246,-21600,,
com.apple.camera,12,1706565046,1706565058,1706565062.53379,-21600,EB445137-D7F5-57EC-87DA-1DB460D64046,"iPhone13,2"
com.instructure.icanvas,14,1706565044,1706565058,1706565062.51424,-21600,EB445137-D7F5-57EC-87DA-1DB460D64046,"iPhone13,2"
com.instructure.icanvas,5,1706565003,1706565008,1706565008.0197392,-21600,EB445137-D7F5-57EC-87DA-1DB460D64046,"iPhone13,2"
com.google.Chrome,160,1706564953,1706565113,1706565113.9127212,-21600,,
com.apple.Preview,2,1706564951,1706564953,1706564955.375284,-21600,,
com.instructure.icanvas,6,1706564888,1706564894,1706564894.280551,-21600,EB445137-D7F5-57EC-87DA-1DB460D64046,"iPhone13,2"
com.instructure.icanvas,15,1706564687,1706564702,1706564702.809688,-21600,EB445137-D7F5-57EC-87DA-1DB460D64046,"iPhone13,2"
com.google.chrome.ios,236,1706561762,1706561998,1706561998.285269,-21600,EB445137-D7F5-57EC-87DA-1DB460D64046,"iPhone13,2"
com.amazon.Amazon,57,1706561705,1706561762,1706561762.589882,-21600,EB445137-D7F5-57EC-87DA-1DB460D64046,"iPhone13,2"
com.google.chrome.ios,32,1706561673,1706561705,1706561706.042314,-21600,EB445137-D7F5-57EC-87DA-1DB460D64046,"iPhone13,2"
com.amazon.Amazon,106,1706561567,1706561673,1706561673.291944,-21600,EB445137-D7F5-57EC-87DA-1DB460D64046,"iPhone13,2"
com.google.chrome.ios,41,1706561526,1706561567,1706561568.101671,-21600,EB445137-D7F5-57EC-87DA-1DB460D64046,"iPhone13,2"
com.apple.MobileSMS,3,1706561425,1706561428,1706561428.245183,-21600,EB445137-D7F5-57EC-87DA-1DB460D64046,"iPhone13,2"
com.burbn.instagram,104,1706561013,1706561117,1706561117.8817081,-21600,EB445137-D7F5-57EC-87DA-1DB460D64046,"iPhone13,2"
com.thestorygraph.thestorygraph,9,1706560999,1706561008,1706561008.2672482,-21600,EB445137-D7F5-57EC-87DA-1DB460D64046,"iPhone13,2"
com.thestorygraph.thestorygraph,10,1706560976,1706560986,1706560986.761405,-21600,EB445137-D7F5-57EC-87DA-1DB460D64046,"iPhone13,2"
com.thestorygraph.thestorygraph,10,1706560871,1706560881,1706560881.589123,-21600,EB445137-D7F5-57EC-87DA-1DB460D64046,"iPhone13,2"
com.thestorygraph.thestorygraph,10,1706560782,1706560792,1706560792.592854,-21600,EB445137-D7F5-57EC-87DA-1DB460D64046,"iPhone13,2"
com.thestorygraph.thestorygraph,10,1706560540,1706560550,1706560550.9118361,-21600,EB445137-D7F5-57EC-87DA-1DB460D64046,"iPhone13,2"
com.thestorygraph.thestorygraph,10,1706560262,1706560272,1706560273.000515,-21600,EB445137-D7F5-57EC-87DA-1DB460D64046,"iPhone13,2"
com.thestorygraph.thestorygraph,9,1706560097,1706560106,1706560106.289602,-21600,EB445137-D7F5-57EC-87DA-1DB460D64046,"iPhone13,2"
com.thestorygraph.thestorygraph,10,1706559564,1706559574,1706559574.59661,-21600,EB445137-D7F5-57EC-87DA-1DB460D64046,"iPhone13,2"
com.thestorygraph.thestorygraph,72,1706559047,1706559119,1706559119.594346,-21600,EB445137-D7F5-57EC-87DA-1DB460D64046,"iPhone13,2"
com.apple.MobileSMS,3,1706559039,1706559042,1706559042.936778,-21600,EB445137-D7F5-57EC-87DA-1DB460D64046,"iPhone13,2"
com.apple.MobileSMS,5,1706558059,1706558064,1706558065.143105,-21600,EB445137-D7F5-57EC-87DA-1DB460D64046,"iPhone13,2"
com.apple.Preview,88,1706558052,1706558140,1706558141.2730541,-21600,,
com.apple.finder,3,1706558049,1706558052,1706558052.7884789,-21600,,
com.google.Chrome,9,1706558040,1706558049,1706558049.6663408,-21600,,
com.microsoft.Powerpoint,4,1706558036,1706558040,1706558040.588975,-21600,,
com.google.Chrome,21,1706558015,1706558036,1706558036.4970999,-21600,,
com.burbn.instagram,438,1706554265,1706554703,1706554703.84873,-21600,EB445137-D7F5-57EC-87DA-1DB460D64046,"iPhone13,2"
com.toyopagroup.picaboo,48,1706554214,1706554262,1706554262.595609,-21600,EB445137-D7F5-57EC-87DA-1DB460D64046,"iPhone13,2"
com.microsoft.Office.Outlook,1,1706554213,1706554214,1706554214.790866,-21600,EB445137-D7F5-57EC-87DA-1DB460D64046,"iPhone13,2"
com.google.Chrome,155,1706554006,1706554161,1706554161.753154,-21600,,
com.microsoft.Powerpoint,94,1706553912,1706554006,1706554006.1893911,-21600,,
com.google.Chrome,17,1706553895,1706553912,1706553912.7052999,-21600,,
com.microsoft.Powerpoint,256,1706553639,1706553895,1706553895.355736,-21600,,
com.google.Chrome,60,1706553579,1706553639,1706553639.972069,-21600,,
com.apple.finder,10,1706553569,1706553579,1706553579.114651,-21600,,
com.facebook.Facebook,95,1706553447,1706553542,1706553542.8468618,-21600,EB445137-D7F5-57EC-87DA-1DB460D64046,"iPhone13,2"
com.apple.MobileSMS,9,1706553434,1706553443,1706553443.656805,-21600,EB445137-D7F5-57EC-87DA-1DB460D64046,"iPhone13,2"
com.apple.MobileSMS,7,1706553425,1706553432,1706553432.380674,-21600,EB445137-D7F5-57EC-87DA-1DB460D64046,"iPhone13,2"
com.apple.MobileSMS,13,1706553231,1706553244,1706553244.300105,-21600,EB445137-D7F5-57EC-87DA-1DB460D64046,"iPhone13,2"
com.google.ios.youtube,43,1706553188,1706553231,1706553231.383833,-21600,EB445137-D7F5-57EC-87DA-1DB460D64046,"iPhone13,2"
com.microsoft.Office.Outlook,7,1706552669,1706552676,1706552676.568404,-21600,EB445137-D7F5-57EC-87DA-1DB460D64046,"iPhone13,2"
edu.illinois.rokwire.ios,7,1706552660,1706552667,1706552667.349325,-21600,EB445137-D7F5-57EC-87DA-1DB460D64046,"iPhone13,2"
edu.illinois.rokwire.ios,2,1706552401,1706552403,1706552403.632415,-21600,EB445137-D7F5-57EC-87DA-1DB460D64046,"iPhone13,2"
edu.illinois.rokwire.ios,1,1706551980,1706551981,1706551982.202623,-21600,EB445137-D7F5-57EC-87DA-1DB460D64046,"iPhone13,2"
edu.illinois.rokwire.ios,27,1706551509,1706551536,1706551536.045734,-21600,EB445137-D7F5-57EC-87DA-1DB460D64046,"iPhone13,2"
com.apple.MobileSMS,3,1706551504,1706551507,1706551508.028332,-21600,EB445137-D7F5-57EC-87DA-1DB460D64046,"iPhone13,2"
com.apple.MobileSMS,6,1706551440,1706551446,1706551446.1456041,-21600,EB445137-D7F5-57EC-87DA-1DB460D64046,"iPhone13,2"
com.apple.MobileSMS,6,1706551383,1706551389,1706551389.406342,-21600,EB445137-D7F5-57EC-87DA-1DB460D64046,"iPhone13,2"
com.apple.MobileSMS,2,1706551372,1706551374,1706551374.229315,-21600,EB445137-D7F5-57EC-87DA-1DB460D64046,"iPhone13,2"
com.apple.InCallService,1,1706551371,1706551372,1706551373.280374,-21600,EB445137-D7F5-57EC-87DA-1DB460D64046,"iPhone13,2"
com.apple.InCallService,1,1706550735,1706550736,1706550737.005952,-21600,EB445137-D7F5-57EC-87DA-1DB460D64046,"iPhone13,2"
com.apple.MobileSMS,16,1706550719,1706550735,1706550735.6288629,-21600,EB445137-D7F5-57EC-87DA-1DB460D64046,"iPhone13,2"
com.apple.findmy,10,1706550708,1706550718,1706550719.404316,-21600,EB445137-D7F5-57EC-87DA-1DB460D64046,"iPhone13,2"
com.apple.calculator,7,1706550699,1706550706,1706550707.0322561,-21600,EB445137-D7F5-57EC-87DA-1DB460D64046,"iPhone13,2"
com.apple.calculator,10,1706550469,1706550479,1706550479.016449,-21600,EB445137-D7F5-57EC-87DA-1DB460D64046,"iPhone13,2"
com.apple.calculator,10,1706550398,1706550408,1706550408.5892792,-21600,EB445137-D7F5-57EC-87DA-1DB460D64046,"iPhone13,2"
com.apple.calculator,27,1706549569,1706549596,1706549596.430022,-21600,EB445137-D7F5-57EC-87DA-1DB460D64046,"iPhone13,2"
com.apple.mobilenotes,42,1706547518,1706547560,1706547560.557771,-21600,EB445137-D7F5-57EC-87DA-1DB460D64046,"iPhone13,2"
com.apple.news,3,1706547511,1706547514,1706547515.3744931,-21600,EB445137-D7F5-57EC-87DA-1DB460D64046,"iPhone13,2"
com.apple.news,60,1706547376,1706547436,1706547437.678073,-21600,EB445137-D7F5-57EC-87DA-1DB460D64046,"iPhone13,2"
com.apple.Health,99,1706547233,1706547332,1706547332.5622091,-21600,EB445137-D7F5-57EC-87DA-1DB460D64046,"iPhone13,2"
com.apple.findmy,16,1706547201,1706547217,1706547217.788224,-21600,EB445137-D7F5-57EC-87DA-1DB460D64046,"iPhone13,2"
com.google.chrome.ios,61,1706547133,1706547194,1706547194.9094949,-21600,EB445137-D7F5-57EC-87DA-1DB460D64046,"iPhone13,2"
com.google.chrome.ios,26,1706547020,1706547046,1706547046.75175,-21600,EB445137-D7F5-57EC-87DA-1DB460D64046,"iPhone13,2"
com.microsoft.Office.Outlook,7,1706547013,1706547020,1706547020.218744,-21600,EB445137-D7F5-57EC-87DA-1DB460D64046,"iPhone13,2"
com.google.Maps,10,1706546983,1706546993,1706546994.205776,-21600,EB445137-D7F5-57EC-87DA-1DB460D64046,"iPhone13,2"
com.google.Maps,7,1706545873,1706545880,1706545880.871035,-21600,EB445137-D7F5-57EC-87DA-1DB460D64046,"iPhone13,2"
com.google.Maps,97,1706545757,1706545854,1706545854.238301,-21600,EB445137-D7F5-57EC-87DA-1DB460D64046,"iPhone13,2"
com.google.Maps,6,1706545639,1706545645,1706545645.892957,-21600,EB445137-D7F5-57EC-87DA-1DB460D64046,"iPhone13,2"
com.google.Maps,8,1706545630,1706545638,1706545638.029336,-21600,EB445137-D7F5-57EC-87DA-1DB460D64046,"iPhone13,2"
com.google.Maps,10,1706545479,1706545489,1706545489.4565558,-21600,EB445137-D7F5-57EC-87DA-1DB460D64046,"iPhone13,2"
com.google.Maps,10,1706545208,1706545218,1706545218.694896,-21600,EB445137-D7F5-57EC-87DA-1DB460D64046,"iPhone13,2"
com.google.Maps,10,1706544956,1706544966,1706544966.812014,-21600,EB445137-D7F5-57EC-87DA-1DB460D64046,"iPhone13,2"
com.google.Maps,13,1706544227,1706544240,1706544240.607763,-21600,EB445137-D7F5-57EC-87DA-1DB460D64046,"iPhone13,2"
com.google.Maps,2,1706544223,1706544225,1706544225.686831,-21600,EB445137-D7F5-57EC-87DA-1DB460D64046,"iPhone13,2"
com.google.Maps,10,1706544016,1706544026,1706544026.759871,-21600,EB445137-D7F5-57EC-87DA-1DB460D64046,"iPhone13,2"
com.google.Maps,6,1706544007,1706544013,1706544013.9959989,-21600,EB445137-D7F5-57EC-87DA-1DB460D64046,"iPhone13,2"
com.google.Maps,3,1706544004,1706544007,1706544007.324424,-21600,EB445137-D7F5-57EC-87DA-1DB460D64046,"iPhone13,2"
com.google.Maps,34,1706543584,1706543618,1706543618.670728,-21600,EB445137-D7F5-57EC-87DA-1DB460D64046,"iPhone13,2"
com.google.Maps,10,1706543378,1706543388,1706543388.55579,-21600,EB445137-D7F5-57EC-87DA-1DB460D64046,"iPhone13,2"
com.google.Maps,6,1706543369,1706543375,1706543375.96389,-21600,EB445137-D7F5-57EC-87DA-1DB460D64046,"iPhone13,2"
com.google.chrome.ios,54,1706543315,1706543369,1706543369.539114,-21600,EB445137-D7F5-57EC-87DA-1DB460D64046,"iPhone13,2"
com.google.chrome.ios,25,1706543263,1706543288,1706543288.690246,-21600,EB445137-D7F5-57EC-87DA-1DB460D64046,"iPhone13,2"
com.google.Maps,7,1706543256,1706543263,1706543263.2582579,-21600,EB445137-D7F5-57EC-87DA-1DB460D64046,"iPhone13,2"
com.google.chrome.ios,19,1706543237,1706543256,1706543257.070794,-21600,EB445137-D7F5-57EC-87DA-1DB460D64046,"iPhone13,2"
com.google.Maps,4,1706543193,1706543197,1706543197.52564,-21600,EB445137-D7F5-57EC-87DA-1DB460D64046,"iPhone13,2"
com.google.Maps,10,1706543132,1706543142,1706543142.712881,-21600,EB445137-D7F5-57EC-87DA-1DB460D64046,"iPhone13,2"
com.google.Maps,14,1706543117,1706543131,1706543131.763073,-21600,EB445137-D7F5-57EC-87DA-1DB460D64046,"iPhone13,2"
com.peacocktv.peacock,1904,1706541056,1706542960,1706542961.951941,-21600,EB445137-D7F5-57EC-87DA-1DB460D64046,"iPhone13,2"
com.google.Maps,4,1706541051,1706541055,1706541056.088684,-21600,EB445137-D7F5-57EC-87DA-1DB460D64046,"iPhone13,2"
com.google.Maps,12,1706540360,1706540372,1706540372.2581248,-21600,EB445137-D7F5-57EC-87DA-1DB460D64046,"iPhone13,2"
com.apple.weather,27,1706540313,1706540340,1706540340.235626,-21600,EB445137-D7F5-57EC-87DA-1DB460D64046,"iPhone13,2"
com.apple.Health,35,1706540242,1706540277,1706540277.407748,-21600,EB445137-D7F5-57EC-87DA-1DB460D64046,"iPhone13,2"
com.apple.Health,9,1706540218,1706540227,1706540227.772562,-21600,EB445137-D7F5-57EC-87DA-1DB460D64046,"iPhone13,2"
com.google.Maps,22,1706540184,1706540206,1706540206.834978,-21600,EB445137-D7F5-57EC-87DA-1DB460D64046,"iPhone13,2"
com.apple.camera,0,1706540101,1706540101,1706540102.878787,-21600,EB445137-D7F5-57EC-87DA-1DB460D64046,"iPhone13,2"
com.thestorygraph.thestorygraph,36,1706506582,1706506618,1706506618.669831,-21600,EB445137-D7F5-57EC-87DA-1DB460D64046,"iPhone13,2"
com.thestorygraph.thestorygraph,10,1706506453,1706506463,1706506463.4706001,-21600,EB445137-D7F5-57EC-87DA-1DB460D64046,"iPhone13,2"
com.thestorygraph.thestorygraph,10,1706506018,1706506028,1706506028.207827,-21600,EB445137-D7F5-57EC-87DA-1DB460D64046,"iPhone13,2"
com.thestorygraph.thestorygraph,4,1706505186,1706505190,1706505190.821497,-21600,EB445137-D7F5-57EC-87DA-1DB460D64046,"iPhone13,2"
com.thestorygraph.thestorygraph,39,1706504499,1706504538,1706504538.988503,-21600,EB445137-D7F5-57EC-87DA-1DB460D64046,"iPhone13,2"
com.apple.camera,0,1706504373,1706504373,1706504373.896882,-21600,EB445137-D7F5-57EC-87DA-1DB460D64046,"iPhone13,2"
com.apple.Health,359,1706501905,1706502264,1706502264.563838,-21600,EB445137-D7F5-57EC-87DA-1DB460D64046,"iPhone13,2"
com.apple.Health,8,1706501876,1706501884,1706501884.26045,-21600,EB445137-D7F5-57EC-87DA-1DB460D64046,"iPhone13,2"
com.apple.Health,16,1706501854,1706501870,1706501870.2991781,-21600,EB445137-D7F5-57EC-87DA-1DB460D64046,"iPhone13,2"
com.risesci.nyx,3,1706501848,1706501851,1706501851.806686,-21600,EB445137-D7F5-57EC-87DA-1DB460D64046,"iPhone13,2"
com.apple.finder,33,1706501841,1706501874,1706501875.026768,-21600,,
com.google.Chrome,8,1706501833,1706501841,1706501841.212551,-21600,,
com.risesci.nyx,3,1706501770,1706501773,1706501773.4116611,-21600,EB445137-D7F5-57EC-87DA-1DB460D64046,"iPhone13,2"
com.risesci.nyx,2,1706501558,1706501560,1706501560.654591,-21600,EB445137-D7F5-57EC-87DA-1DB460D64046,"iPhone13,2"
com.risesci.nyx,20,1706500898,1706500918,1706500918.497782,-21600,EB445137-D7F5-57EC-87DA-1DB460D64046,"iPhone13,2"
com.risesci.nyx,6,1706500873,1706500879,1706500879.4845262,-21600,EB445137-D7F5-57EC-87DA-1DB460D64046,"iPhone13,2"
com.risesci.nyx,10,1706500818,1706500828,1706500829.0093942,-21600,EB445137-D7F5-57EC-87DA-1DB460D64046,"iPhone13,2"
com.burbn.instagram,5,1706500809,1706500814,1706500814.405092,-21600,EB445137-D7F5-57EC-87DA-1DB460D64046,"iPhone13,2"
com.microsoft.Excel,1142,1706500691,1706501833,1706501833.136969,-21600,,
com.apple.finder,28,1706500663,1706500691,1706500691.498405,-21600,,
com.burbn.instagram,1,1706500422,1706500423,1706500423.266618,-21600,EB445137-D7F5-57EC-87DA-1DB460D64046,"iPhone13,2"
com.google.Chrome,333,1706500330,1706500663,1706500663.754945,-21600,,
com.burbn.instagram,31,1706500318,1706500349,1706500349.917223,-21600,EB445137-D7F5-57EC-87DA-1DB460D64046,"iPhone13,2"
com.hammerandchisel.discord,49,1706500264,1706500313,1706500313.724947,-21600,EB445137-D7F5-57EC-87DA-1DB460D64046,"iPhone13,2"
com.apple.camera,0,1706500206,1706500206,1706500206.622999,-21600,EB445137-D7F5-57EC-87DA-1DB460D64046,"iPhone13,2"
com.hammerandchisel.discord,8,1706500204,1706500212,1706500212.2708511,-21600,EB445137-D7F5-57EC-87DA-1DB460D64046,"iPhone13,2"
com.google.Chrome,305,1706499808,1706500113,1706500113.417556,-21600,,
com.google.Chrome,521,1706499284,1706499805,1706499805.621125,-21600,,
com.leomehlig.today,114,1706499170,1706499284,1706499284.732425,-21600,,
com.hammerandchisel.discord,1,1706497607,1706497608,1706497609.0117002,-21600,EB445137-D7F5-57EC-87DA-1DB460D64046,"iPhone13,2"
com.google.Chrome,1792,1706497378,1706499170,1706499170.6853251,-21600,,
com.apple.Notes,3,1706497375,1706497378,1706497378.354838,-21600,,
com.hammerandchisel.discord,6,1706497057,1706497063,1706497063.1956968,-21600,EB445137-D7F5-57EC-87DA-1DB460D64046,"iPhone13,2"
com.hammerandchisel.discord,3,1706497043,1706497046,1706497046.694,-21600,EB445137-D7F5-57EC-87DA-1DB460D64046,"iPhone13,2"
com.apple.Notes,313,1706497027,1706497340,1706497340.9237962,-21600,,
com.leomehlig.today,4,1706497023,1706497027,1706497027.328106,-21600,,
com.apple.Notes,30,1706496993,1706497023,1706497023.246859,-21600,,
com.google.Chrome,5,1706496988,1706496993,1706496993.2701821,-21600,,
com.hammerandchisel.discord,6,1706496252,1706496258,1706496258.986325,-21600,EB445137-D7F5-57EC-87DA-1DB460D64046,"iPhone13,2"
com.hammerandchisel.discord,22,1706496229,1706496251,1706496251.720872,-21600,EB445137-D7F5-57EC-87DA-1DB460D64046,"iPhone13,2"
com.hammerandchisel.discord,17,1706496212,1706496229,1706496229.543902,-21600,EB445137-D7F5-57EC-87DA-1DB460D64046,"iPhone13,2"
com.apple.camera,4,1706496207,1706496211,1706496211.538696,-21600,EB445137-D7F5-57EC-87DA-1DB460D64046,"iPhone13,2"
com.google.Chrome,790,1706496182,1706496972,1706496972.171819,-21600,,
com.leomehlig.today,2,1706496180,1706496182,1706496182.433434,-21600,,
com.google.Chrome,341,1706495839,1706496180,1706496180.408033,-21600,,
com.google.Chrome,480,1706494768,1706495248,1706495248.139875,-21600,,
com.google.Chrome,425,1706494312,1706494737,1706494737.9337502,-21600,,
com.toyopagroup.picaboo,20,1706494172,1706494192,1706494192.147843,-21600,EB445137-D7F5-57EC-87DA-1DB460D64046,"iPhone13,2"
com.risesci.nyx,7,1706494165,1706494172,1706494172.5918431,-21600,EB445137-D7F5-57EC-87DA-1DB460D64046,"iPhone13,2"
com.risesci.nyx,3,1706493785,1706493788,1706493788.103891,-21600,EB445137-D7F5-57EC-87DA-1DB460D64046,"iPhone13,2"
com.hammerandchisel.discord,2,1706493778,1706493780,1706493780.2278419,-21600,EB445137-D7F5-57EC-87DA-1DB460D64046,"iPhone13,2"
com.google.Chrome,519,1706493681,1706494200,1706494200.53372,-21600,,
com.hammerandchisel.discord,25,1706493646,1706493671,1706493671.218564,-21600,EB445137-D7F5-57EC-87DA-1DB460D64046,"iPhone13,2"
com.apple.camera,1,1706493640,1706493641,1706493641.1725512,-21600,EB445137-D7F5-57EC-87DA-1DB460D64046,"iPhone13,2"
com.google.Chrome,353,1706493124,1706493477,1706493477.3523622,-21600,,
com.leomehlig.today,50,1706493074,1706493124,1706493124.973007,-21600,,
com.hammerandchisel.discord,83,1706487739,1706487822,1706487822.642842,-21600,EB445137-D7F5-57EC-87DA-1DB460D64046,"iPhone13,2"
com.microsoft.Office.Outlook,59,1706487411,1706487470,1706487470.008679,-21600,EB445137-D7F5-57EC-87DA-1DB460D64046,"iPhone13,2"
com.burbn.instagram,600,1706485366,1706485966,1706485966.4143848,-21600,EB445137-D7F5-57EC-87DA-1DB460D64046,"iPhone13,2"
com.risesci.nyx,61,1706485292,1706485353,1706485353.15836,-21600,EB445137-D7F5-57EC-87DA-1DB460D64046,"iPhone13,2"
com.hammerandchisel.discord,4,1706483333,1706483337,1706483337.062479,-21600,EB445137-D7F5-57EC-87DA-1DB460D64046,"iPhone13,2"
com.facebook.Facebook,685,1706481753,1706482438,1706482438.473717,-21600,EB445137-D7F5-57EC-87DA-1DB460D64046,"iPhone13,2"
com.truebill.truebillnative,46,1706481699,1706481745,1706481745.463846,-21600,EB445137-D7F5-57EC-87DA-1DB460D64046,"iPhone13,2"
com.apple.MobileSMS,40,1706481649,1706481689,1706481689.70435,-21600,EB445137-D7F5-57EC-87DA-1DB460D64046,"iPhone13,2"
edu.illinois.rokwire.ios,39,1706481610,1706481649,1706481649.66871,-21600,EB445137-D7F5-57EC-87DA-1DB460D64046,"iPhone13,2"
com.apple.MobileSMS,27,1706481576,1706481603,1706481604.0072432,-21600,EB445137-D7F5-57EC-87DA-1DB460D64046,"iPhone13,2"
com.hammerandchisel.discord,4,1706481572,1706481576,1706481576.110564,-21600,EB445137-D7F5-57EC-87DA-1DB460D64046,"iPhone13,2"
com.hammerandchisel.discord,4,1706481472,1706481476,1706481476.186588,-21600,EB445137-D7F5-57EC-87DA-1DB460D64046,"iPhone13,2"
com.hammerandchisel.discord,16,1706481411,1706481427,1706481427.185608,-21600,EB445137-D7F5-57EC-87DA-1DB460D64046,"iPhone13,2"
com.apple.Music,5,1706481241,1706481246,1706481246.1835198,-21600,EB445137-D7F5-57EC-87DA-1DB460D64046,"iPhone13,2"
com.apple.Music,8,1706480078,1706480086,1706480086.416788,-21600,EB445137-D7F5-57EC-87DA-1DB460D64046,"iPhone13,2"
com.apple.Music,13,1706480026,1706480039,1706480039.06284,-21600,EB445137-D7F5-57EC-87DA-1DB460D64046,"iPhone13,2"
com.apple.Music,1,1706479413,1706479414,1706479414.802141,-21600,EB445137-D7F5-57EC-87DA-1DB460D64046,"iPhone13,2"
com.apple.Music,11,1706479398,1706479409,1706479410.2198858,-21600,EB445137-D7F5-57EC-87DA-1DB460D64046,"iPhone13,2"
com.hammerandchisel.discord,3,1706479388,1706479391,1706479392.045618,-21600,EB445137-D7F5-57EC-87DA-1DB460D64046,"iPhone13,2"
com.hammerandchisel.discord,8,1706479344,1706479352,1706479352.7506661,-21600,EB445137-D7F5-57EC-87DA-1DB460D64046,"iPhone13,2"
com.apple.MobileSMS,3,1706479341,1706479344,1706479344.761956,-21600,EB445137-D7F5-57EC-87DA-1DB460D64046,"iPhone13,2"
com.leomehlig.today,29,1706479304,1706479333,1706479333.213829,-21600,,
com.google.Chrome,113,1706479191,1706479304,1706479304.375413,-21600,,
com.leomehlig.today,19,1706479172,1706479191,1706479191.151408,-21600,,
com.apple.Preview,645,1706478527,1706479172,1706479172.441883,-21600,,
com.google.Chrome,90,1706478437,1706478527,1706478527.391629,-21600,,
com.apple.Preview,814,1706477623,1706478437,1706478437.17675,-21600,,
com.leomehlig.today,6,1706477617,1706477623,1706477623.2747688,-21600,,
com.apple.Preview,29,1706477588,1706477617,1706477617.6503139,-21600,,
com.apple.MobileSMS,12,1706477302,1706477314,1706477315.071852,-21600,EB445137-D7F5-57EC-87DA-1DB460D64046,"iPhone13,2"
com.apple.FaceTime,292,1706477296,1706477588,1706477589.115302,-21600,,
com.apple.DeskCam,4,1706477292,1706477296,1706477296.18404,-21600,,
com.apple.FaceTime,0,1706477292,1706477292,1706477293.003572,-21600,,
com.apple.DeskCam,8,1706477284,1706477292,1706477292.21327,-21600,,
com.apple.FaceTime,2,1706477282,1706477284,1706477284.6031451,-21600,,
com.apple.FaceTime,307,1706476906,1706477213,1706477213.476207,-21600,,
com.apple.MobileSMS,5,1706476901,1706476906,1706476906.1411,-21600,,
com.apple.FaceTime,5,1706476896,1706476901,1706476901.373619,-21600,,
com.apple.MobileSMS,9,1706476329,1706476338,1706476338.80831,-21600,EB445137-D7F5-57EC-87DA-1DB460D64046,"iPhone13,2"
com.apple.MobileSMS,26,1706476114,1706476140,1706476140.274877,-21600,EB445137-D7F5-57EC-87DA-1DB460D64046,"iPhone13,2"
com.apple.FaceTime,384,1706476111,1706476495,1706476495.5075889,-21600,,
com.apple.MobileSMS,10,1706476032,1706476042,1706476042.407064,-21600,EB445137-D7F5-57EC-87DA-1DB460D64046,"iPhone13,2"
com.apple.MobileSMS,2,1706475969,1706475971,1706475971.374789,-21600,EB445137-D7F5-57EC-87DA-1DB460D64046,"iPhone13,2"
com.burbn.instagram,9,1706475959,1706475968,1706475968.2071462,-21600,EB445137-D7F5-57EC-87DA-1DB460D64046,"iPhone13,2"
com.apple.MobileSMS,152,1706475806,1706475958,1706475958.965767,-21600,EB445137-D7F5-57EC-87DA-1DB460D64046,"iPhone13,2"
com.apple.Maps,9,1706475797,1706475806,1706475806.2807732,-21600,EB445137-D7F5-57EC-87DA-1DB460D64046,"iPhone13,2"
com.apple.Maps,6,1706475784,1706475790,1706475790.699997,-21600,EB445137-D7F5-57EC-87DA-1DB460D64046,"iPhone13,2"
com.apple.Preview,328,1706475783,1706476111,1706476111.515985,-21600,,
com.apple.Notes,14,1706475769,1706475783,1706475783.169559,-21600,,
com.apple.Preview,8,1706475761,1706475769,1706475769.956501,-21600,,
com.apple.finder,3,1706475758,1706475761,1706475761.246517,-21600,,
com.google.Chrome,1,1706475757,1706475758,1706475758.9599671,-21600,,
com.leomehlig.today,32,1706475725,1706475757,1706475757.446799,-21600,,
com.apple.Maps,3,1706475310,1706475313,1706475313.321628,-21600,EB445137-D7F5-57EC-87DA-1DB460D64046,"iPhone13,2"
com.apple.camera,1,1706475310,1706475311,1706475311.229011,-21600,EB445137-D7F5-57EC-87DA-1DB460D64046,"iPhone13,2"
com.apple.Maps,8,1706475226,1706475234,1706475234.0631042,-21600,EB445137-D7F5-57EC-87DA-1DB460D64046,"iPhone13,2"
com.apple.Maps,12,1706475002,1706475014,1706475014.4970841,-21600,EB445137-D7F5-57EC-87DA-1DB460D64046,"iPhone13,2"
com.apple.Maps,67,1706474442,1706474509,1706474509.1617951,-21600,EB445137-D7F5-57EC-87DA-1DB460D64046,"iPhone13,2"
com.clairmail.fth.client,8,1706474431,1706474439,1706474439.364111,-21600,EB445137-D7F5-57EC-87DA-1DB460D64046,"iPhone13,2"
com.clairmail.fth.client,27,1706474108,1706474135,1706474135.389347,-21600,EB445137-D7F5-57EC-87DA-1DB460D64046,"iPhone13,2"
com.apple.Music,7,1706474096,1706474103,1706474103.891343,-21600,EB445137-D7F5-57EC-87DA-1DB460D64046,"iPhone13,2"
com.burbn.instagram,736,1706473360,1706474096,1706474096.580214,-21600,EB445137-D7F5-57EC-87DA-1DB460D64046,"iPhone13,2"
com.clairmail.fth.client,4,1706473356,1706473360,1706473360.4227018,-21600,EB445137-D7F5-57EC-87DA-1DB460D64046,"iPhone13,2"
com.clairmail.fth.client,18,1706473313,1706473331,1706473331.407267,-21600,EB445137-D7F5-57EC-87DA-1DB460D64046,"iPhone13,2"
com.burbn.instagram,11,1706473302,1706473313,1706473314.209379,-21600,EB445137-D7F5-57EC-87DA-1DB460D64046,"iPhone13,2"
com.apple.Music,29,1706473270,1706473299,1706473299.779346,-21600,EB445137-D7F5-57EC-87DA-1DB460D64046,"iPhone13,2"
com.burbn.instagram,6,1706473264,1706473270,1706473270.4805532,-21600,EB445137-D7F5-57EC-87DA-1DB460D64046,"iPhone13,2"
com.burbn.instagram,144,1706473022,1706473166,1706473166.421421,-21600,EB445137-D7F5-57EC-87DA-1DB460D64046,"iPhone13,2"
com.apple.Music,39,1706472977,1706473016,1706473016.597921,-21600,EB445137-D7F5-57EC-87DA-1DB460D64046,"iPhone13,2"
com.burbn.instagram,128,1706472849,1706472977,1706472977.649541,-21600,EB445137-D7F5-57EC-87DA-1DB460D64046,"iPhone13,2"
com.hammerandchisel.discord,72,1706472763,1706472835,1706472835.081489,-21600,EB445137-D7F5-57EC-87DA-1DB460D64046,"iPhone13,2"
com.burbn.instagram,15,1706472745,1706472760,1706472761.0039802,-21600,EB445137-D7F5-57EC-87DA-1DB460D64046,"iPhone13,2"
com.apple.Maps,38,1706472707,1706472745,1706472745.333605,-21600,EB445137-D7F5-57EC-87DA-1DB460D64046,"iPhone13,2"
com.burbn.instagram,7,1706472698,1706472705,1706472705.305567,-21600,EB445137-D7F5-57EC-87DA-1DB460D64046,"iPhone13,2"
com.toyopagroup.picaboo,46,1706472652,1706472698,1706472698.44412,-21600,EB445137-D7F5-57EC-87DA-1DB460D64046,"iPhone13,2"
com.apple.MobileSMS,1,1706472651,1706472652,1706472652.809898,-21600,EB445137-D7F5-57EC-87DA-1DB460D64046,"iPhone13,2"
com.toyopagroup.picaboo,4,1706472647,1706472651,1706472651.4783258,-21600,EB445137-D7F5-57EC-87DA-1DB460D64046,"iPhone13,2"
com.apple.Maps,596,1706472049,1706472645,1706472645.8225222,-21600,EB445137-D7F5-57EC-87DA-1DB460D64046,"iPhone13,2"
com.apple.Music,3,1706472045,1706472048,1706472048.618328,-21600,EB445137-D7F5-57EC-87DA-1DB460D64046,"iPhone13,2"
com.apple.Music,5,1706471899,1706471904,1706471904.0429091,-21600,EB445137-D7F5-57EC-87DA-1DB460D64046,"iPhone13,2"
com.apple.Music,4,1706471882,1706471886,1706471886.237052,-21600,EB445137-D7F5-57EC-87DA-1DB460D64046,"iPhone13,2"
com.apple.Music,63,1706471819,1706471882,1706471882.155859,-21600,EB445137-D7F5-57EC-87DA-1DB460D64046,"iPhone13,2"
com.apple.Music,5,1706471809,1706471814,1706471815.0106611,-21600,EB445137-D7F5-57EC-87DA-1DB460D64046,"iPhone13,2"
com.apple.Maps,41,1706471648,1706471689,1706471689.572942,-21600,EB445137-D7F5-57EC-87DA-1DB460D64046,"iPhone13,2"
com.toyopagroup.picaboo,9,1706471610,1706471619,1706471619.52193,-21600,EB445137-D7F5-57EC-87DA-1DB460D64046,"iPhone13,2"
com.toyopagroup.picaboo,8,1706471563,1706471571,1706471571.053463,-21600,EB445137-D7F5-57EC-87DA-1DB460D64046,"iPhone13,2"
com.toyopagroup.picaboo,21,1706471531,1706471552,1706471552.358653,-21600,EB445137-D7F5-57EC-87DA-1DB460D64046,"iPhone13,2"
com.apple.Music,2,1706471529,1706471531,1706471532.001209,-21600,EB445137-D7F5-57EC-87DA-1DB460D64046,"iPhone13,2"
com.apple.Music,11,1706471492,1706471503,1706471503.094202,-21600,EB445137-D7F5-57EC-87DA-1DB460D64046,"iPhone13,2"
com.apple.Music,12,1706471458,1706471470,1706471470.424539,-21600,EB445137-D7F5-57EC-87DA-1DB460D64046,"iPhone13,2"
com.apple.Music,15,1706471337,1706471352,1706471353.397451,-21600,EB445137-D7F5-57EC-87DA-1DB460D64046,"iPhone13,2"
com.toyopagroup.picaboo,2,1706471333,1706471335,1706471335.8632998,-21600,EB445137-D7F5-57EC-87DA-1DB460D64046,"iPhone13,2"
com.toyopagroup.picaboo,14,1706471316,1706471330,1706471330.2236729,-21600,EB445137-D7F5-57EC-87DA-1DB460D64046,"iPhone13,2"
com.apple.MobileSMS,2,1706471314,1706471316,1706471316.2532868,-21600,EB445137-D7F5-57EC-87DA-1DB460D64046,"iPhone13,2"
com.microsoft.Office.Outlook,6,1706471279,1706471285,1706471285.535965,-21600,EB445137-D7F5-57EC-87DA-1DB460D64046,"iPhone13,2"
com.instructure.icanvas,4,1706471274,1706471278,1706471278.103183,-21600,EB445137-D7F5-57EC-87DA-1DB460D64046,"iPhone13,2"
com.apple.MobileSMS,3,1706471269,1706471272,1706471272.156997,-21600,EB445137-D7F5-57EC-87DA-1DB460D64046,"iPhone13,2"
com.instructure.icanvas,19,1706471249,1706471268,1706471268.087659,-21600,EB445137-D7F5-57EC-87DA-1DB460D64046,"iPhone13,2"
com.instructure.icanvas,3,1706471084,1706471087,1706471087.942636,-21600,EB445137-D7F5-57EC-87DA-1DB460D64046,"iPhone13,2"
com.instructure.icanvas,4,1706471073,1706471077,1706471077.144326,-21600,EB445137-D7F5-57EC-87DA-1DB460D64046,"iPhone13,2"
com.instructure.icanvas,1,1706471052,1706471053,1706471053.933527,-21600,EB445137-D7F5-57EC-87DA-1DB460D64046,"iPhone13,2"
com.instructure.icanvas,1,1706470450,1706470451,1706470451.5990539,-21600,EB445137-D7F5-57EC-87DA-1DB460D64046,"iPhone13,2"
com.instructure.icanvas,6,1706470055,1706470061,1706470061.6047292,-21600,EB445137-D7F5-57EC-87DA-1DB460D64046,"iPhone13,2"
com.instructure.icanvas,2,1706469906,1706469908,1706469908.068595,-21600,EB445137-D7F5-57EC-87DA-1DB460D64046,"iPhone13,2"
com.instructure.icanvas,16,1706469069,1706469085,1706469085.504684,-21600,EB445137-D7F5-57EC-87DA-1DB460D64046,"iPhone13,2"
com.apple.camera,2,1706468419,1706468421,1706468421.028959,-21600,EB445137-D7F5-57EC-87DA-1DB460D64046,"iPhone13,2"
com.instructure.icanvas,2,1706468419,1706468421,1706468421.203531,-21600,EB445137-D7F5-57EC-87DA-1DB460D64046,"iPhone13,2"
com.instructure.icanvas,1,1706468417,1706468418,1706468418.717655,-21600,EB445137-D7F5-57EC-87DA-1DB460D64046,"iPhone13,2"
com.instructure.icanvas,2,1706468412,1706468414,1706468414.3397598,-21600,EB445137-D7F5-57EC-87DA-1DB460D64046,"iPhone13,2"
com.instructure.icanvas,1,1706468094,1706468095,1706468095.97609,-21600,EB445137-D7F5-57EC-87DA-1DB460D64046,"iPhone13,2"
com.instructure.icanvas,6,1706467880,1706467886,1706467886.603078,-21600,EB445137-D7F5-57EC-87DA-1DB460D64046,"iPhone13,2"
com.instructure.icanvas,24,1706467771,1706467795,1706467795.092917,-21600,EB445137-D7F5-57EC-87DA-1DB460D64046,"iPhone13,2"
com.instructure.icanvas,56,1706467620,1706467676,1706467676.833459,-21600,EB445137-D7F5-57EC-87DA-1DB460D64046,"iPhone13,2"
com.burbn.instagram,4,1706467616,1706467620,1706467620.848796,-21600,EB445137-D7F5-57EC-87DA-1DB460D64046,"iPhone13,2"
com.burbn.instagram,98,1706467043,1706467141,1706467141.676656,-21600,EB445137-D7F5-57EC-87DA-1DB460D64046,"iPhone13,2"
com.apple.news,285,1706466445,1706466730,1706466730.818008,-21600,EB445137-D7F5-57EC-87DA-1DB460D64046,"iPhone13,2"
com.whentowork.iOS.WhenToWork-Employee-Scheduling,21,1706466416,1706466437,1706466438.0151958,-21600,EB445137-D7F5-57EC-87DA-1DB460D64046,"iPhone13,2"
com.apple.Music,8,1706466385,1706466393,1706466393.779738,-21600,EB445137-D7F5-57EC-87DA-1DB460D64046,"iPhone13,2"
com.apple.Music,36,1706466347,1706466383,1706466384.737842,-21600,EB445137-D7F5-57EC-87DA-1DB460D64046,"iPhone13,2"
com.toyopagroup.picaboo,13,1706466319,1706466332,1706466332.888273,-21600,EB445137-D7F5-57EC-87DA-1DB460D64046,"iPhone13,2"
com.toyopagroup.picaboo,6,1706465888,1706465894,1706465894.2961621,-21600,EB445137-D7F5-57EC-87DA-1DB460D64046,"iPhone13,2"
com.leomehlig.today,31,1706464603,1706464634,1706464634.357671,-21600,,
com.google.Chrome,200,1706464403,1706464603,1706464603.522979,-21600,,
edu.illinois.rokwire.ios,21,1706464326,1706464347,1706464347.3072782,-21600,EB445137-D7F5-57EC-87DA-1DB460D64046,"iPhone13,2"
com.burbn.instagram,355,1706463954,1706464309,1706464309.733793,-21600,EB445137-D7F5-57EC-87DA-1DB460D64046,"iPhone13,2"
com.toyopagroup.picaboo,14,1706463933,1706463947,1706463948.218575,-21600,EB445137-D7F5-57EC-87DA-1DB460D64046,"iPhone13,2"
com.toyopagroup.picaboo,1,1706463895,1706463896,1706463896.296402,-21600,EB445137-D7F5-57EC-87DA-1DB460D64046,"iPhone13,2"
com.toyopagroup.picaboo,12,1706463880,1706463892,1706463892.195364,-21600,EB445137-D7F5-57EC-87DA-1DB460D64046,"iPhone13,2"
com.google.Chrome,645,1706463448,1706464093,1706464093.775553,-21600,,
com.hnc.Discord,34,1706463414,1706463448,1706463448.544958,-21600,,
com.google.Chrome,10,1706463404,1706463414,1706463414.756942,-21600,,
com.hnc.Discord,8,1706463396,1706463404,1706463405.134213,-21600,,
com.google.Chrome,110,1706463286,1706463396,1706463396.6194348,-21600,,
com.google.Chrome,315,1706462767,1706463082,1706463082.048897,-21600,,
com.google.Chrome,960,1706461785,1706462745,1706462745.043521,-21600,,
com.google.Chrome,750,1706460942,1706461692,1706461692.749819,-21600,,
com.leomehlig.today,20,1706460922,1706460942,1706460942.615687,-21600,,
com.apple.finder,8,1706460914,1706460922,1706460922.27248,-21600,,
com.thestorygraph.thestorygraph,221,1706460446,1706460667,1706460667.1895509,-21600,EB445137-D7F5-57EC-87DA-1DB460D64046,"iPhone13,2"
com.truebill.truebillnative,58,1706460386,1706460444,1706460444.215173,-21600,EB445137-D7F5-57EC-87DA-1DB460D64046,"iPhone13,2"
com.risesci.nyx,66,1706460317,1706460383,1706460383.453738,-21600,EB445137-D7F5-57EC-87DA-1DB460D64046,"iPhone13,2"
com.apple.journal,16,1706460301,1706460317,1706460317.7540212,-21600,EB445137-D7F5-57EC-87DA-1DB460D64046,"iPhone13,2"
com.risesci.nyx,21,1706460276,1706460297,1706460297.04193,-21600,EB445137-D7F5-57EC-87DA-1DB460D64046,"iPhone13,2"
us.parkmobile.ParkMobile,10,1706458097,1706458107,1706458107.7472749,-21600,EB445137-D7F5-57EC-87DA-1DB460D64046,"iPhone13,2"
us.parkmobile.ParkMobile,18,1706458054,1706458072,1706458072.797711,-21600,EB445137-D7F5-57EC-87DA-1DB460D64046,"iPhone13,2"
com.strava.stravaride,2,1706458047,1706458049,1706458049.4922209,-21600,EB445137-D7F5-57EC-87DA-1DB460D64046,"iPhone13,2"
com.strava.stravaride,43,1706457720,1706457763,1706457763.982939,-21600,EB445137-D7F5-57EC-87DA-1DB460D64046,"iPhone13,2"
com.microsoft.Office.Outlook,3,1706457708,1706457711,1706457711.083117,-21600,EB445137-D7F5-57EC-87DA-1DB460D64046,"iPhone13,2"
com.microsoft.Office.Outlook,7,1706457701,1706457708,1706457708.135429,-21600,EB445137-D7F5-57EC-87DA-1DB460D64046,"iPhone13,2"
com.toyopagroup.picaboo,11,1706457690,1706457701,1706457701.0485702,-21600,EB445137-D7F5-57EC-87DA-1DB460D64046,"iPhone13,2"
com.risesci.nyx,21,1706457663,1706457684,1706457685.0706248,-21600,EB445137-D7F5-57EC-87DA-1DB460D64046,"iPhone13,2"
com.peacocktv.peacock,4,1706457659,1706457663,1706457664.155808,-21600,EB445137-D7F5-57EC-87DA-1DB460D64046,"iPhone13,2"
com.peacocktv.peacock,1974,1706455399,1706457373,1706457373.4783912,-21600,EB445137-D7F5-57EC-87DA-1DB460D64046,"iPhone13,2"
com.apple.MobileSMS,22,1706454185,1706454207,1706454207.723548,-21600,EB445137-D7F5-57EC-87DA-1DB460D64046,"iPhone13,2"
co.hinge.mobile.ios,48,1706454129,1706454177,1706454177.108745,-21600,EB445137-D7F5-57EC-87DA-1DB460D64046,"iPhone13,2"
com.toyopagroup.picaboo,27,1706454095,1706454122,1706454122.717774,-21600,EB445137-D7F5-57EC-87DA-1DB460D64046,"iPhone13,2"
com.google.ios.youtube,472,1706453591,1706454063,1706454063.994129,-21600,EB445137-D7F5-57EC-87DA-1DB460D64046,"iPhone13,2"
com.risesci.nyx,27,1706453515,1706453542,1706453542.59092,-21600,EB445137-D7F5-57EC-87DA-1DB460D64046,"iPhone13,2"
com.apple.Health,26,1706453488,1706453514,1706453514.35749,-21600,EB445137-D7F5-57EC-87DA-1DB460D64046,"iPhone13,2"
com.toyopagroup.picaboo,13,1706453462,1706453475,1706453475.70967,-21600,EB445137-D7F5-57EC-87DA-1DB460D64046,"iPhone13,2"
com.apple.finder,3,1706404467,1706404470,1706404470.593745,-21600,,
com.leomehlig.today,3,1706404464,1706404467,1706404467.512517,-21600,,
com.apple.finder,2,1706404462,1706404464,1706404464.858282,-21600,,
com.google.Chrome,367,1706404095,1706404462,1706404462.7652779,-21600,,
com.leomehlig.today,1,1706404094,1706404095,1706404097.074081,-21600,,
com.google.chrome.ios,45,1706403817,1706403862,1706403862.941379,-21600,EB445137-D7F5-57EC-87DA-1DB460D64046,"iPhone13,2"
com.apple.MobileSMS,6,1706403811,1706403817,1706403817.457593,-21600,EB445137-D7F5-57EC-87DA-1DB460D64046,"iPhone13,2"
com.risesci.nyx,7,1706403786,1706403793,1706403793.585489,-21600,EB445137-D7F5-57EC-87DA-1DB460D64046,"iPhone13,2"
com.leomehlig.today,455,1706403630,1706404085,1706404085.262614,-21600,,
com.risesci.nyx,2,1706403619,1706403621,1706403621.7277489,-21600,EB445137-D7F5-57EC-87DA-1DB460D64046,"iPhone13,2"
com.google.Chrome,33,1706403597,1706403630,1706403630.969295,-21600,,
com.risesci.nyx,3,1706403568,1706403571,1706403571.918501,-21600,EB445137-D7F5-57EC-87DA-1DB460D64046,"iPhone13,2"
com.google.Chrome,301,1706403238,1706403539,1706403539.368977,-21600,,
com.risesci.nyx,6,1706402654,1706402660,1706402660.107343,-21600,EB445137-D7F5-57EC-87DA-1DB460D64046,"iPhone13,2"
com.google.Chrome,432,1706402505,1706402937,1706402937.908253,-21600,,
com.risesci.nyx,1,1706402012,1706402013,1706402013.8994188,-21600,EB445137-D7F5-57EC-87DA-1DB460D64046,"iPhone13,2"
com.google.Chrome,217,1706401977,1706402194,1706402194.972496,-21600,,
com.leomehlig.today,8,1706401969,1706401977,1706401977.613079,-21600,,
com.google.Chrome,2,1706401967,1706401969,1706401969.9558291,-21600,,
com.leomehlig.today,20,1706401947,1706401967,1706401967.548166,-21600,,
com.risesci.nyx,8,1706401147,1706401155,1706401155.326853,-21600,EB445137-D7F5-57EC-87DA-1DB460D64046,"iPhone13,2"
com.google.Chrome,812,1706401135,1706401947,1706401947.875293,-21600,,
com.leomehlig.today,27,1706401108,1706401135,1706401135.830385,-21600,,
com.robinhood.release.Robinhood,3,1706401098,1706401101,1706401101.445967,-21600,EB445137-D7F5-57EC-87DA-1DB460D64046,"iPhone13,2"
com.google.Chrome,670,1706400438,1706401108,1706401108.4417648,-21600,,
com.robinhood.release.Robinhood,8,1706399721,1706399729,1706399729.195675,-21600,EB445137-D7F5-57EC-87DA-1DB460D64046,"iPhone13,2"
com.robinhood.release.Robinhood,14,1706399379,1706399393,1706399393.580832,-21600,EB445137-D7F5-57EC-87DA-1DB460D64046,"iPhone13,2"
com.apple.Fitness,69,1706399303,1706399372,1706399372.711358,-21600,EB445137-D7F5-57EC-87DA-1DB460D64046,"iPhone13,2"
com.apple.Music,12,1706399257,1706399269,1706399269.609206,-21600,EB445137-D7F5-57EC-87DA-1DB460D64046,"iPhone13,2"
edu.illinois.rokwire.ios,8,1706399249,1706399257,1706399257.926224,-21600,EB445137-D7F5-57EC-87DA-1DB460D64046,"iPhone13,2"
com.apple.finder,155,1706399243,1706399398,1706399398.0835009,-21600,,
edu.illinois.rokwire.ios,4,1706398991,1706398995,1706398995.4375281,-21600,EB445137-D7F5-57EC-87DA-1DB460D64046,"iPhone13,2"
edu.illinois.rokwire.ios,11,1706398943,1706398954,1706398954.937063,-21600,EB445137-D7F5-57EC-87DA-1DB460D64046,"iPhone13,2"
com.goodreads.Goodreads,125,1706398671,1706398796,1706398796.8539429,-21600,EB445137-D7F5-57EC-87DA-1DB460D64046,"iPhone13,2"
com.thestorygraph.thestorygraph,5,1706398666,1706398671,1706398671.940537,-21600,EB445137-D7F5-57EC-87DA-1DB460D64046,"iPhone13,2"
com.goodreads.Goodreads,6,1706398659,1706398665,1706398665.991593,-21600,EB445137-D7F5-57EC-87DA-1DB460D64046,"iPhone13,2"
com.clairmail.fth.client,23,1706398625,1706398648,1706398648.344049,-21600,EB445137-D7F5-57EC-87DA-1DB460D64046,"iPhone13,2"
com.truebill.truebillnative,13,1706398611,1706398624,1706398624.059012,-21600,EB445137-D7F5-57EC-87DA-1DB460D64046,"iPhone13,2"
com.risesci.nyx,54,1706398135,1706398189,1706398189.721991,-21600,EB445137-D7F5-57EC-87DA-1DB460D64046,"iPhone13,2"
com.toyopagroup.picaboo,5,1706396255,1706396260,1706396260.9086308,-21600,EB445137-D7F5-57EC-87DA-1DB460D64046,"iPhone13,2"
com.apple.Music,4,1706396251,1706396255,1706396255.8930001,-21600,EB445137-D7F5-57EC-87DA-1DB460D64046,"iPhone13,2"
com.apple.Music,1,1706395561,1706395562,1706395562.6251159,-21600,EB445137-D7F5-57EC-87DA-1DB460D64046,"iPhone13,2"
com.apple.Music,53,1706395457,1706395510,1706395510.0071611,-21600,EB445137-D7F5-57EC-87DA-1DB460D64046,"iPhone13,2"
com.apple.Music,7,1706395101,1706395108,1706395108.149085,-21600,EB445137-D7F5-57EC-87DA-1DB460D64046,"iPhone13,2"
com.apple.weather,3,1706395096,1706395099,1706395099.2118201,-21600,EB445137-D7F5-57EC-87DA-1DB460D64046,"iPhone13,2"
com.apple.camera,5,1706395049,1706395054,1706395054.61327,-21600,EB445137-D7F5-57EC-87DA-1DB460D64046,"iPhone13,2"
com.apple.weather,6,1706395048,1706395054,1706395054.560956,-21600,EB445137-D7F5-57EC-87DA-1DB460D64046,"iPhone13,2"
com.apple.weather,4,1706394977,1706394981,1706394981.518734,-21600,EB445137-D7F5-57EC-87DA-1DB460D64046,"iPhone13,2"
com.thestorygraph.thestorygraph,60,1706394713,1706394773,1706394773.304035,-21600,EB445137-D7F5-57EC-87DA-1DB460D64046,"iPhone13,2"
com.burbn.instagram,4,1706393200,1706393204,1706393204.9758391,-21600,EB445137-D7F5-57EC-87DA-1DB460D64046,"iPhone13,2"
com.toyopagroup.picaboo,24,1706393175,1706393199,1706393199.782692,-21600,EB445137-D7F5-57EC-87DA-1DB460D64046,"iPhone13,2"
co.hinge.mobile.ios,197,1706392880,1706393077,1706393077.253669,-21600,EB445137-D7F5-57EC-87DA-1DB460D64046,"iPhone13,2"
com.thestorygraph.thestorygraph,5,1706392870,1706392875,1706392875.493237,-21600,EB445137-D7F5-57EC-87DA-1DB460D64046,"iPhone13,2"
com.apple.MobileSMS,16,1706392846,1706392862,1706392862.134588,-21600,EB445137-D7F5-57EC-87DA-1DB460D64046,"iPhone13,2"
com.risesci.nyx,3,1706392843,1706392846,1706392847.3543591,-21600,EB445137-D7F5-57EC-87DA-1DB460D64046,"iPhone13,2"
com.risesci.nyx,1,1706392203,1706392204,1706392204.844763,-21600,EB445137-D7F5-57EC-87DA-1DB460D64046,"iPhone13,2"
com.risesci.nyx,1,1706392048,1706392049,1706392049.8206859,-21600,EB445137-D7F5-57EC-87DA-1DB460D64046,"iPhone13,2"
com.risesci.nyx,1,1706391949,1706391950,1706391950.413683,-21600,EB445137-D7F5-57EC-87DA-1DB460D64046,"iPhone13,2"
com.risesci.nyx,2,1706391944,1706391946,1706391946.82494,-21600,EB445137-D7F5-57EC-87DA-1DB460D64046,"iPhone13,2"
com.risesci.nyx,5,1706391786,1706391791,1706391791.111125,-21600,EB445137-D7F5-57EC-87DA-1DB460D64046,"iPhone13,2"
com.risesci.nyx,6,1706391743,1706391749,1706391749.627043,-21600,EB445137-D7F5-57EC-87DA-1DB460D64046,"iPhone13,2"
com.risesci.nyx,3,1706391268,1706391271,1706391271.1802511,-21600,EB445137-D7F5-57EC-87DA-1DB460D64046,"iPhone13,2"
com.risesci.nyx,1,1706390740,1706390741,1706390741.843556,-21600,EB445137-D7F5-57EC-87DA-1DB460D64046,"iPhone13,2"
com.apple.camera,6,1706390733,1706390739,1706390740.204613,-21600,EB445137-D7F5-57EC-87DA-1DB460D64046,"iPhone13,2"
com.risesci.nyx,8,1706390731,1706390739,1706390740.2127209,-21600,EB445137-D7F5-57EC-87DA-1DB460D64046,"iPhone13,2"
com.apple.finder,1,1706388860,1706388861,1706388862.029276,-21600,,
com.google.Chrome,2,1706388858,1706388860,1706388860.6102638,-21600,,
com.leomehlig.today,5,1706388853,1706388858,1706388858.6669369,-21600,,
com.google.Chrome,2,1706388851,1706388853,1706388853.5461931,-21600,,
com.apple.iCal,41,1706388810,1706388851,1706388851.947056,-21600,,
com.google.Chrome,1,1706388809,1706388810,1706388810.81991,-21600,,
com.apple.iCal,132,1706388677,1706388809,1706388809.453238,-21600,,
com.google.Chrome,10,1706388667,1706388677,1706388677.1939359,-21600,,
com.apple.Preview,7,1706388660,1706388667,1706388667.753021,-21600,,
com.google.Chrome,2,1706388658,1706388660,1706388660.8164392,-21600,,
com.microsoft.Word,1,1706388657,1706388658,1706388659.1256208,-21600,,
com.risesci.nyx,1,1706388606,1706388607,1706388607.992435,-21600,EB445137-D7F5-57EC-87DA-1DB460D64046,"iPhone13,2"
com.google.Chrome,66,1706388591,1706388657,1706388657.531269,-21600,,
com.risesci.nyx,17,1706388395,1706388412,1706388412.566623,-21600,EB445137-D7F5-57EC-87DA-1DB460D64046,"iPhone13,2"
com.leomehlig.today,278,1706388313,1706388591,1706388591.313832,-21600,,
com.google.Chrome,475,1706387838,1706388313,1706388314.079025,-21600,,
com.leomehlig.today,5,1706387833,1706387838,1706387839.0048409,-21600,,
com.google.Chrome,2887,1706384946,1706387833,1706387834.015984,-21600,,
com.google.Chrome,60,1706384691,1706384751,1706384751.5573158,-21600,,
com.leomehlig.today,12,1706384679,1706384691,1706384691.479096,-21600,,
com.google.Chrome,81,1706384598,1706384679,1706384679.356662,-21600,,
com.leomehlig.today,14,1706384584,1706384598,1706384598.112722,-21600,,
com.google.Chrome,2,1706384582,1706384584,1706384584.301647,-21600,,
com.leomehlig.today,1,1706384581,1706384582,1706384582.0830421,-21600,,
com.google.Chrome,38,1706384543,1706384581,1706384581.134789,-21600,,
com.google.Chrome,607,1706383674,1706384281,1706384281.548389,-21600,,
com.google.Chrome,361,1706383282,1706383643,1706383643.522801,-21600,,
com.apple.finder,2,1706383280,1706383282,1706383282.969641,-21600,,
com.apple.Music,21,1706383259,1706383280,1706383281.051882,-21600,,
com.apple.finder,15,1706383244,1706383259,1706383259.543391,-21600,,
com.apple.finder,7,1706381538,1706381545,1706381545.19571,-21600,,
com.microsoft.Outlook,2,1706381536,1706381538,1706381538.694006,-21600,,
com.toyopagroup.picaboo,8,1706381518,1706381526,1706381526.133188,-21600,EB445137-D7F5-57EC-87DA-1DB460D64046,"iPhone13,2"
com.apple.MobileSMS,51,1706381485,1706381536,1706381537.008992,-21600,,
com.apple.findmy,19,1706381466,1706381485,1706381485.554044,-21600,,
com.apple.MobileSMS,1,1706381465,1706381466,1706381466.1375551,-21600,,
com.microsoft.Outlook,27,1706381420,1706381447,1706381447.196127,-21600,,
com.apple.MobileSMS,11,1706381409,1706381420,1706381420.918721,-21600,,
com.microsoft.Outlook,28,1706381381,1706381409,1706381409.29214,-21600,,
com.apple.MobileSMS,50,1706381331,1706381381,1706381381.195802,-21600,,
com.apple.finder,10,1706381321,1706381331,1706381331.986462,-21600,,
com.microsoft.Word,3,1706381318,1706381321,1706381322.0881848,-21600,,
com.google.Chrome,8,1706381310,1706381318,1706381318.802034,-21600,,
com.apple.MobileSMS,60,1706381250,1706381310,1706381310.329458,-21600,,
com.leomehlig.today,95,1706381155,1706381250,1706381250.732034,-21600,,
com.toyopagroup.picaboo,59,1706380305,1706380364,1706380364.3297892,-21600,EB445137-D7F5-57EC-87DA-1DB460D64046,"iPhone13,2"
com.risesci.nyx,11,1706380289,1706380300,1706380300.816551,-21600,EB445137-D7F5-57EC-87DA-1DB460D64046,"iPhone13,2"
com.google.Chrome,1080,1706380075,1706381155,1706381155.198029,-21600,,
com.google.Chrome,377,1706379695,1706380072,1706380072.3899179,-21600,,
com.apple.Preview,5,1706379690,1706379695,1706379695.830737,-21600,,
com.google.Chrome,1,1706379689,1706379690,1706379690.809767,-21600,,
com.apple.Preview,1,1706379688,1706379689,1706379689.63277,-21600,,
com.google.Chrome,17,1706379671,1706379688,1706379688.812516,-21600,,
com.apple.Preview,7,1706379664,1706379671,1706379671.3211432,-21600,,
com.google.Chrome,26,1706379638,1706379664,1706379664.0941792,-21600,,
com.apple.Preview,91,1706379547,1706379638,1706379638.512938,-21600,,
com.google.Chrome,155,1706379392,1706379547,1706379547.098854,-21600,,
com.apple.Preview,32,1706379360,1706379392,1706379392.4364882,-21600,,
com.google.Chrome,44,1706379316,1706379360,1706379360.7615662,-21600,,
com.apple.Preview,52,1706379264,1706379316,1706379316.186595,-21600,,
com.google.Chrome,85,1706379179,1706379264,1706379264.93039,-21600,,
com.apple.Preview,20,1706379159,1706379179,1706379179.6021938,-21600,,
com.hammerandchisel.discord,130,1706379018,1706379148,1706379148.371544,-21600,EB445137-D7F5-57EC-87DA-1DB460D64046,"iPhone13,2"
com.apple.Preview,335,1706378822,1706379157,1706379157.262169,-21600,,
com.google.Chrome,11,1706378811,1706378822,1706378822.465764,-21600,,
com.apple.Preview,34,1706378777,1706378811,1706378811.1841989,-21600,,
com.google.Chrome,41,1706378736,1706378777,1706378777.4802098,-21600,,
com.apple.Preview,142,1706378594,1706378736,1706378736.334274,-21600,,
com.google.Chrome,170,1706378424,1706378594,1706378594.917974,-21600,,
com.apple.Preview,293,1706378131,1706378424,1706378424.454437,-21600,,
com.google.Chrome,2,1706378129,1706378131,1706378131.187074,-21600,,
com.apple.Preview,12,1706378117,1706378129,1706378129.362783,-21600,,
com.apple.finder,4,1706378113,1706378117,1706378117.085822,-21600,,
com.google.Chrome,104,1706378009,1706378113,1706378113.373805,-21600,,
com.microsoft.Word,1,1706378008,1706378009,1706378009.517611,-21600,,
com.google.Chrome,6,1706378002,1706378008,1706378008.287236,-21600,,
com.microsoft.Word,155,1706377847,1706378002,1706378002.280922,-21600,,
com.google.Chrome,114,1706377733,1706377847,1706377847.124704,-21600,,
com.microsoft.Word,27,1706377706,1706377733,1706377733.9797401,-21600,,
com.apple.finder,8,1706377698,1706377706,1706377706.947741,-21600,,
com.google.Chrome,74,1706377624,1706377698,1706377698.967583,-21600,,
com.leomehlig.today,8,1706377616,1706377624,1706377624.4790711,-21600,,
com.google.Chrome,3,1706377613,1706377616,1706377616.595786,-21600,,
com.leomehlig.today,5,1706377608,1706377613,1706377613.812402,-21600,,
com.google.Chrome,6,1706377602,1706377608,1706377608.5658069,-21600,,
com.apple.camera,9,1706377201,1706377210,1706377210.863013,-21600,EB445137-D7F5-57EC-87DA-1DB460D64046,"iPhone13,2"
com.letterboxd.LetterboxdApp,5,1706377199,1706377204,1706377204.891271,-21600,EB445137-D7F5-57EC-87DA-1DB460D64046,"iPhone13,2"
com.letterboxd.LetterboxdApp,0,1706377196,1706377196,1706377196.863768,-21600,EB445137-D7F5-57EC-87DA-1DB460D64046,"iPhone13,2"
com.letterboxd.LetterboxdApp,138,1706376610,1706376748,1706376748.369205,-21600,EB445137-D7F5-57EC-87DA-1DB460D64046,"iPhone13,2"
com.burbn.instagram,4,1706376588,1706376592,1706376592.71226,-21600,EB445137-D7F5-57EC-87DA-1DB460D64046,"iPhone13,2"
com.burbn.instagram,82,1706376419,1706376501,1706376501.9060721,-21600,EB445137-D7F5-57EC-87DA-1DB460D64046,"iPhone13,2"
com.risesci.nyx,47,1706376370,1706376417,1706376417.756109,-21600,EB445137-D7F5-57EC-87DA-1DB460D64046,"iPhone13,2"
com.apple.weather,4,1706376366,1706376370,1706376371.0828161,-21600,EB445137-D7F5-57EC-87DA-1DB460D64046,"iPhone13,2"
com.apple.weather,6,1706375940,1706375946,1706375946.842927,-21600,EB445137-D7F5-57EC-87DA-1DB460D64046,"iPhone13,2"
com.apple.weather,6,1706375934,1706375940,1706375940.129797,-21600,EB445137-D7F5-57EC-87DA-1DB460D64046,"iPhone13,2"
com.google.Chrome,369,1706375486,1706375855,1706375855.277245,-21600,,
com.leomehlig.today,2,1706375484,1706375486,1706375487.2323542,-21600,,
com.facebook.Facebook,203,1706375281,1706375484,1706375484.135499,-21600,EB445137-D7F5-57EC-87DA-1DB460D64046,"iPhone13,2"
com.microsoft.Office.Outlook,20,1706375255,1706375275,1706375275.430265,-21600,EB445137-D7F5-57EC-87DA-1DB460D64046,"iPhone13,2"
edu.illinois.rokwire.ios,54,1706375191,1706375245,1706375245.155695,-21600,EB445137-D7F5-57EC-87DA-1DB460D64046,"iPhone13,2"
com.leomehlig.today,8,1706375180,1706375188,1706375188.402524,-21600,,
com.microsoft.onenote.mac,37,1706375143,1706375180,1706375181.146678,-21600,,
com.leomehlig.today,101,1706375036,1706375137,1706375137.396325,-21600,,
com.google.Chrome,2,1706375034,1706375036,1706375036.581606,-21600,,
com.leomehlig.today,46,1706374988,1706375034,1706375034.823814,-21600,,
com.google.Chrome,3,1706374965,1706374968,1706374968.774249,-21600,,
com.apple.MobileSMS,6,1706374959,1706374965,1706374965.4103498,-21600,,
com.google.Chrome,2,1706374954,1706374956,1706374957.078443,-21600,,
com.thestorygraph.thestorygraph,140,1706374781,1706374921,1706374921.8186688,-21600,EB445137-D7F5-57EC-87DA-1DB460D64046,"iPhone13,2"
com.thestorygraph.thestorygraph,20,1706374760,1706374780,1706374780.7515159,-21600,EB445137-D7F5-57EC-87DA-1DB460D64046,"iPhone13,2"
com.risesci.nyx,0,1706374523,1706374523,1706374523.9808311,-21600,EB445137-D7F5-57EC-87DA-1DB460D64046,"iPhone13,2"
com.apple.camera,4,1706374518,1706374522,1706374523.321189,-21600,EB445137-D7F5-57EC-87DA-1DB460D64046,"iPhone13,2"
com.risesci.nyx,6,1706374516,1706374522,1706374523.350702,-21600,EB445137-D7F5-57EC-87DA-1DB460D64046,"iPhone13,2"
com.risesci.nyx,10,1706372982,1706372992,1706372992.8125181,-21600,EB445137-D7F5-57EC-87DA-1DB460D64046,"iPhone13,2"
com.risesci.nyx,13,1706372587,1706372600,1706372600.070922,-21600,EB445137-D7F5-57EC-87DA-1DB460D64046,"iPhone13,2"
com.risesci.nyx,17,1706371884,1706371901,1706371901.726677,-21600,EB445137-D7F5-57EC-87DA-1DB460D64046,"iPhone13,2"
com.peacocktv.peacock,1495,1706370137,1706371632,1706371632.209975,-21600,EB445137-D7F5-57EC-87DA-1DB460D64046,"iPhone13,2"
com.markhambly.APOD,2,1706370131,1706370133,1706370133.923588,-21600,EB445137-D7F5-57EC-87DA-1DB460D64046,"iPhone13,2"
com.markhambly.APOD,8,1706368868,1706368876,1706368876.6729832,-21600,EB445137-D7F5-57EC-87DA-1DB460D64046,"iPhone13,2"
com.markhambly.APOD,0,1706368825,1706368825,1706368826.215334,-21600,EB445137-D7F5-57EC-87DA-1DB460D64046,"iPhone13,2"
com.burbn.instagram,1091,1706367731,1706368822,1706368823.0128798,-21600,EB445137-D7F5-57EC-87DA-1DB460D64046,"iPhone13,2"
com.risesci.nyx,32,1706367659,1706367691,1706367692.058316,-21600,EB445137-D7F5-57EC-87DA-1DB460D64046,"iPhone13,2"
com.apple.Health,33,1706367622,1706367655,1706367656.0489979,-21600,EB445137-D7F5-57EC-87DA-1DB460D64046,"iPhone13,2"
com.google.Chrome,2483,1706328357,1706330840,1706330840.9330711,-21600,,
com.google.Chrome,1037,1706327288,1706328325,1706328325.4115639,-21600,,
com.google.Chrome,165,1706317035,1706317200,1706317200.712426,-21600,,
com.apple.finder,1,1706317034,1706317035,1706317036.144177,-21600,,
com.apple.finder,216,1706309525,1706309741,1706309741.664514,-21600,,
com.apple.Notes,2,1706309523,1706309525,1706309525.449568,-21600,,
com.apple.finder,216,1706309307,1706309523,1706309523.2228851,-21600,,
com.apple.MobileSMS,113,1706309194,1706309307,1706309307.5112848,-21600,,
com.apple.finder,6,1706309188,1706309194,1706309194.8165889,-21600,,
com.apple.MobileSMS,4,1706309184,1706309188,1706309188.5376902,-21600,,
com.google.Chrome,86,1706309098,1706309184,1706309184.670645,-21600,,
com.apple.MobileSMS,4,1706309094,1706309098,1706309098.552497,-21600,,
com.google.Chrome,65,1706309029,1706309094,1706309094.092733,-21600,,
com.apple.MobileSMS,5,1706309024,1706309029,1706309029.790968,-21600,,
com.google.Chrome,147,1706308877,1706309024,1706309024.1274319,-21600,,
com.google.Chrome,284,1706304828,1706305112,1706305112.710551,-21600,,
com.apple.Notes,9,1706304819,1706304828,1706304828.518446,-21600,,
com.leomehlig.today,7,1706304812,1706304819,1706304819.410528,-21600,,
com.apple.Notes,37,1706304775,1706304812,1706304812.3945231,-21600,,
com.apple.finder,73,1706304702,1706304775,1706304775.052208,-21600,,
com.apple.Notes,30,1706304672,1706304702,1706304702.338293,-21600,,
com.apple.finder,6,1706304666,1706304672,1706304672.673964,-21600,,
com.apple.Notes,4,1706304662,1706304666,1706304666.6412048,-21600,,
com.apple.finder,5,1706304657,1706304662,1706304662.1460428,-21600,,
com.google.Chrome,18,1706304639,1706304657,1706304657.2014031,-21600,,
com.apple.finder,1,1706304638,1706304639,1706304639.9024901,-21600,,
com.google.Chrome,170,1706304468,1706304638,1706304638.3697,-21600,,
com.leomehlig.today,111,1706304357,1706304468,1706304468.7812428,-21600,,
com.google.Chrome,11,1706304346,1706304357,1706304357.138509,-21600,,
com.leomehlig.today,96,1706304250,1706304346,1706304346.5291061,-21600,,
com.leomehlig.today,331,1706303917,1706304248,1706304248.575053,-21600,,
com.google.Chrome,461,1706303456,1706303917,1706303917.722568,-21600,,
com.google.Chrome,445,1706302917,1706303362,1706303362.205709,-21600,,
com.leomehlig.today,35,1706302882,1706302917,1706302917.681758,-21600,,
com.google.Chrome,1350,1706301532,1706302882,1706302882.6450648,-21600,,
com.google.Chrome,1029,1706300475,1706301504,1706301504.504521,-21600,,
com.leomehlig.today,10,1706300465,1706300475,1706300475.805542,-21600,,
com.google.Chrome,71,1706300394,1706300465,1706300465.9586911,-21600,,
com.google.Maps,15,1706286629,1706286644,1706286644.3652492,-21600,EB445137-D7F5-57EC-87DA-1DB460D64046,"iPhone13,2"
com.risesci.nyx,11,1706286613,1706286624,1706286624.554858,-21600,EB445137-D7F5-57EC-87DA-1DB460D64046,"iPhone13,2"
com.risesci.nyx,10,1706286565,1706286575,1706286575.710779,-21600,EB445137-D7F5-57EC-87DA-1DB460D64046,"iPhone13,2"
com.risesci.nyx,10,1706285592,1706285602,1706285602.3033981,-21600,EB445137-D7F5-57EC-87DA-1DB460D64046,"iPhone13,2"
com.risesci.nyx,10,1706284758,1706284768,1706284768.785129,-21600,EB445137-D7F5-57EC-87DA-1DB460D64046,"iPhone13,2"
com.risesci.nyx,6,1706284695,1706284701,1706284701.054105,-21600,EB445137-D7F5-57EC-87DA-1DB460D64046,"iPhone13,2"
com.google.Chrome,309,1706284674,1706284983,1706284983.67067,-21600,,
com.risesci.nyx,8,1706284576,1706284584,1706284584.966947,-21600,EB445137-D7F5-57EC-87DA-1DB460D64046,"iPhone13,2"
com.risesci.nyx,72,1706284392,1706284464,1706284464.896469,-21600,EB445137-D7F5-57EC-87DA-1DB460D64046,"iPhone13,2"
com.google.Chrome,41,1706284217,1706284258,1706284258.5080771,-21600,,
com.apple.camera,2,1706284192,1706284194,1706284195.7542028,-21600,EB445137-D7F5-57EC-87DA-1DB460D64046,"iPhone13,2"
com.risesci.nyx,7,1706284185,1706284192,1706284193.057781,-21600,EB445137-D7F5-57EC-87DA-1DB460D64046,"iPhone13,2"
us.zoom.xos,35,1706284182,1706284217,1706284217.611995,-21600,,
com.google.Chrome,16,1706284166,1706284182,1706284183.0140228,-21600,,
us.zoom.xos,6,1706284160,1706284166,1706284166.639377,-21600,,
com.google.Chrome,1,1706284159,1706284160,1706284161.013053,-21600,,
us.zoom.xos,5,1706284154,1706284159,1706284159.445966,-21600,,
com.google.Chrome,1,1706284153,1706284154,1706284155.017642,-21600,,
us.zoom.xos,11,1706284142,1706284153,1706284153.1295218,-21600,,
com.google.Chrome,10,1706284132,1706284142,1706284142.34098,-21600,,
us.zoom.xos,9,1706284123,1706284132,1706284132.889312,-21600,,
com.google.Chrome,3,1706284120,1706284123,1706284123.691187,-21600,,
us.zoom.xos,3,1706284117,1706284120,1706284120.876418,-21600,,
com.google.Chrome,4,1706284113,1706284117,1706284118.0604038,-21600,,
us.zoom.xos,12,1706284101,1706284113,1706284113.72942,-21600,,
com.google.Chrome,6,1706284095,1706284101,1706284101.998635,-21600,,
us.zoom.xos,5,1706284090,1706284095,1706284095.8984408,-21600,,
com.google.Chrome,1,1706284089,1706284090,1706284090.521348,-21600,,
us.zoom.xos,27,1706284062,1706284089,1706284089.102491,-21600,,
com.google.Chrome,15,1706284047,1706284062,1706284062.619825,-21600,,
com.risesci.nyx,6,1706283931,1706283937,1706283937.568296,-21600,EB445137-D7F5-57EC-87DA-1DB460D64046,"iPhone13,2"
us.zoom.xos,248,1706283799,1706284047,1706284047.5752358,-21600,,
com.google.Chrome,10,1706283789,1706283799,1706283799.375619,-21600,,
us.zoom.xos,13,1706283776,1706283789,1706283789.326546,-21600,,
com.google.Chrome,3,1706283773,1706283776,1706283776.508512,-21600,,
us.zoom.xos,18,1706283755,1706283773,1706283773.895472,-21600,,
com.google.Chrome,36,1706283719,1706283755,1706283755.461804,-21600,,
us.zoom.xos,5,1706283714,1706283719,1706283719.288443,-21600,,
com.google.Chrome,5,1706283709,1706283714,1706283714.795377,-21600,,
us.zoom.xos,6,1706283703,1706283709,1706283709.972662,-21600,,
com.google.Chrome,3,1706283700,1706283703,1706283703.2308931,-21600,,
us.zoom.xos,2,1706283698,1706283700,1706283700.3374882,-21600,,
com.google.Chrome,22,1706283676,1706283698,1706283698.628962,-21600,,
us.zoom.xos,4,1706283672,1706283676,1706283676.321295,-21600,,
com.google.Chrome,44,1706283628,1706283672,1706283672.526318,-21600,,
us.zoom.xos,558,1706283070,1706283628,1706283628.4352012,-21600,,
com.google.Chrome,1,1706283069,1706283070,1706283070.882519,-21600,,
us.zoom.xos,14,1706283055,1706283069,1706283069.844839,-21600,,
com.google.Chrome,44,1706283011,1706283055,1706283056.056231,-21600,,
us.zoom.xos,44,1706282967,1706283011,1706283011.2543511,-21600,,
com.google.Chrome,66,1706282901,1706282967,1706282968.008631,-21600,,
us.zoom.xos,2,1706282899,1706282901,1706282901.8802118,-21600,,
com.google.Chrome,27,1706282872,1706282899,1706282899.5948138,-21600,,
us.zoom.xos,10,1706282862,1706282872,1706282872.947966,-21600,,
com.google.Chrome,4,1706282858,1706282862,1706282862.363926,-21600,,
us.zoom.xos,22,1706282836,1706282858,1706282858.615881,-21600,,
com.google.Chrome,10,1706282826,1706282836,1706282836.086903,-21600,,
us.zoom.xos,93,1706282733,1706282826,1706282827.032652,-21600,,
com.google.Chrome,100,1706282633,1706282733,1706282733.570857,-21600,,
us.zoom.xos,72,1706282561,1706282633,1706282633.768324,-21600,,
com.google.Chrome,14,1706282547,1706282561,1706282561.664809,-21600,,
us.zoom.xos,73,1706282474,1706282547,1706282547.773037,-21600,,
com.google.Chrome,15,1706282459,1706282474,1706282474.346092,-21600,,
us.zoom.xos,20,1706282439,1706282459,1706282459.808917,-21600,,
com.google.Chrome,832,1706281607,1706282439,1706282439.839487,-21600,,
us.zoom.xos,16,1706281591,1706281607,1706281607.573478,-21600,,
com.google.Chrome,15,1706281576,1706281591,1706281591.858165,-21600,,
us.zoom.xos,1,1706281575,1706281576,1706281576.435501,-21600,,
com.google.Chrome,1,1706281574,1706281575,1706281575.3311849,-21600,,
us.zoom.xos,2,1706281572,1706281574,1706281574.1497269,-21600,,
com.google.Chrome,1,1706281571,1706281572,1706281573.008313,-21600,,
us.zoom.xos,1,1706281570,1706281571,1706281571.528943,-21600,,
com.google.Chrome,2,1706281568,1706281570,1706281570.345187,-21600,,
us.zoom.xos,10,1706281558,1706281568,1706281568.167783,-21600,,
com.google.Chrome,4,1706281554,1706281558,1706281558.425442,-21600,,
us.zoom.xos,23,1706281531,1706281554,1706281554.912725,-21600,,
com.google.Chrome,14,1706281517,1706281531,1706281531.779715,-21600,,
us.zoom.xos,45,1706281472,1706281517,1706281517.901157,-21600,,
com.google.Chrome,2,1706281470,1706281472,1706281472.581691,-21600,,
us.zoom.xos,18,1706281452,1706281470,1706281470.4234219,-21600,,
com.google.Chrome,7,1706281445,1706281452,1706281452.475574,-21600,,
us.zoom.xos,172,1706281273,1706281445,1706281445.890971,-21600,,
com.google.Chrome,18,1706281255,1706281273,1706281273.6246219,-21600,,
us.zoom.xos,1,1706281254,1706281255,1706281255.696309,-21600,,
com.google.Chrome,22,1706281232,1706281254,1706281254.592778,-21600,,
us.zoom.xos,1,1706281231,1706281232,1706281232.6212192,-21600,,
com.google.Chrome,1,1706281230,1706281231,1706281231.1492,-21600,,
us.zoom.xos,3,1706281227,1706281230,1706281230.2665858,-21600,,
com.google.Chrome,22,1706281205,1706281227,1706281227.784634,-21600,,
us.zoom.xos,16,1706281189,1706281205,1706281205.8397388,-21600,,
com.google.Chrome,3,1706281186,1706281189,1706281189.213819,-21600,,
us.zoom.xos,1,1706281185,1706281186,1706281186.12354,-21600,,
com.google.Chrome,15,1706281170,1706281185,1706281185.4193501,-21600,,
us.zoom.xos,16,1706281154,1706281170,1706281170.815304,-21600,,
com.google.Chrome,41,1706281113,1706281154,1706281155.027255,-21600,,
com.risesci.nyx,89,1706281051,1706281140,1706281141.3274698,-21600,EB445137-D7F5-57EC-87DA-1DB460D64046,"iPhone13,2"
com.apple.Health,12,1706281032,1706281044,1706281044.233393,-21600,EB445137-D7F5-57EC-87DA-1DB460D64046,"iPhone13,2"
com.thestorygraph.thestorygraph,24,1706247186,1706247210,1706247210.839742,-21600,EB445137-D7F5-57EC-87DA-1DB460D64046,"iPhone13,2"
com.apple.camera,1,1706247149,1706247150,1706247150.34445,-21600,EB445137-D7F5-57EC-87DA-1DB460D64046,"iPhone13,2"
com.google.Chrome,1335,1706242042,1706243377,1706243377.7051911,-21600,,
com.google.Chrome,302,1706240817,1706241119,1706241119.620579,-21600,,
com.google.Chrome,959,1706239722,1706240681,1706240681.783546,-21600,,
com.apple.finder,8,1706239714,1706239722,1706239723.421767,-21600,,
com.apple.finder,10,1706237082,1706237092,1706237092.534528,-21600,,
com.leomehlig.today,2,1706237080,1706237082,1706237082.229537,-21600,,
com.apple.finder,2,1706237078,1706237080,1706237080.721226,-21600,,
com.apple.iCal,1,1706237077,1706237078,1706237079.022997,-21600,,
com.apple.finder,5,1706237072,1706237077,1706237077.914229,-21600,,
com.leomehlig.today,49,1706237023,1706237072,1706237072.961509,-21600,,
com.google.Chrome,16,1706237007,1706237023,1706237023.77346,-21600,,
com.google.Chrome,402,1706235967,1706236369,1706236369.231622,-21600,,
com.apple.iCal,16,1706235951,1706235967,1706235967.291813,-21600,,
com.google.Chrome,1,1706235950,1706235951,1706235951.674573,-21600,,
com.apple.iCal,9,1706235941,1706235950,1706235950.5640879,-21600,,
com.google.Chrome,2,1706235939,1706235941,1706235941.524585,-21600,,
com.apple.iCal,1,1706235938,1706235939,1706235939.580023,-21600,,
com.google.Chrome,2,1706235936,1706235938,1706235938.52196,-21600,,
com.apple.iCal,9,1706235927,1706235936,1706235936.926126,-21600,,
com.google.Chrome,17,1706235910,1706235927,1706235927.968355,-21600,,
com.apple.iCal,60,1706235850,1706235910,1706235910.510291,-21600,,
com.google.Chrome,3,1706235847,1706235850,1706235850.605198,-21600,,
com.apple.iCal,2,1706235845,1706235847,1706235847.685564,-21600,,
com.google.Chrome,12,1706235833,1706235845,1706235846.001193,-21600,,
com.apple.iCal,6,1706235827,1706235833,1706235833.232449,-21600,,
com.google.Chrome,1,1706235826,1706235827,1706235827.985997,-21600,,
com.apple.iCal,17,1706235809,1706235826,1706235826.744938,-21600,,
com.google.Chrome,215,1706235594,1706235809,1706235809.268178,-21600,,
com.google.Chrome,880,1706234563,1706235443,1706235443.458688,-21600,,
com.apple.news,3,1706234321,1706234324,1706234324.293548,-21600,EB445137-D7F5-57EC-87DA-1DB460D64046,"iPhone13,2"
com.apple.news,263,1706234010,1706234273,1706234273.169981,-21600,EB445137-D7F5-57EC-87DA-1DB460D64046,"iPhone13,2"
com.apple.news,97,1706233900,1706233997,1706233997.215969,-21600,EB445137-D7F5-57EC-87DA-1DB460D64046,"iPhone13,2"
com.apple.Music,6,1706233885,1706233891,1706233891.196707,-21600,EB445137-D7F5-57EC-87DA-1DB460D64046,"iPhone13,2"
com.apple.Music,11,1706233792,1706233803,1706233803.556487,-21600,EB445137-D7F5-57EC-87DA-1DB460D64046,"iPhone13,2"
com.apple.camera,0,1706233792,1706233792,1706233793.178158,-21600,EB445137-D7F5-57EC-87DA-1DB460D64046,"iPhone13,2"
com.google.Chrome,333,1706233629,1706233962,1706233962.540844,-21600,,
com.apple.Music,13,1706233573,1706233586,1706233586.948287,-21600,EB445137-D7F5-57EC-87DA-1DB460D64046,"iPhone13,2"
com.apple.Music,61,1706233453,1706233514,1706233514.644535,-21600,EB445137-D7F5-57EC-87DA-1DB460D64046,"iPhone13,2"
com.apple.mobiletimer,3,1706233450,1706233453,1706233453.566821,-21600,EB445137-D7F5-57EC-87DA-1DB460D64046,"iPhone13,2"
com.google.Chrome,570,1706233058,1706233628,1706233628.9135718,-21600,,
com.leomehlig.today,86,1706232972,1706233058,1706233058.9057832,-21600,,
com.google.Chrome,319,1706232653,1706232972,1706232972.970084,-21600,,
com.apple.Preview,0,1706232653,1706232653,1706232653.934589,-21600,,
com.google.Chrome,1,1706232652,1706232653,1706232653.311511,-21600,,
com.microsoft.VSCode,1,1706232651,1706232652,1706232652.676342,-21600,,
com.google.Chrome,171,1706232480,1706232651,1706232651.403174,-21600,,
com.apple.mobiletimer,9,1706232375,1706232384,1706232384.9322429,-21600,EB445137-D7F5-57EC-87DA-1DB460D64046,"iPhone13,2"
com.apple.mobiletimer,15,1706232359,1706232374,1706232374.271599,-21600,EB445137-D7F5-57EC-87DA-1DB460D64046,"iPhone13,2"
com.apple.Music,3,1706232356,1706232359,1706232359.130015,-21600,EB445137-D7F5-57EC-87DA-1DB460D64046,"iPhone13,2"
com.apple.Music,5,1706232103,1706232108,1706232108.85267,-21600,EB445137-D7F5-57EC-87DA-1DB460D64046,"iPhone13,2"
com.apple.Music,7,1706231590,1706231597,1706231597.460891,-21600,EB445137-D7F5-57EC-87DA-1DB460D64046,"iPhone13,2"
com.google.Chrome,601,1706231286,1706231887,1706231887.145516,-21600,,
com.google.Chrome,300,1706230963,1706231263,1706231263.981183,-21600,,
com.apple.Music,3,1706230841,1706230844,1706230844.739856,-21600,EB445137-D7F5-57EC-87DA-1DB460D64046,"iPhone13,2"
com.apple.Music,35,1706230623,1706230658,1706230658.096185,-21600,EB445137-D7F5-57EC-87DA-1DB460D64046,"iPhone13,2"
com.intsig.CamScannerLite,3,1706230619,1706230622,1706230622.7731009,-21600,EB445137-D7F5-57EC-87DA-1DB460D64046,"iPhone13,2"
com.intsig.CamScannerLite,1,1706230573,1706230574,1706230574.749666,-21600,EB445137-D7F5-57EC-87DA-1DB460D64046,"iPhone13,2"
com.google.Chrome,456,1706230502,1706230958,1706230958.930468,-21600,,
com.apple.Preview,2,1706230500,1706230502,1706230502.369382,-21600,,
com.google.Chrome,145,1706230355,1706230500,1706230500.223285,-21600,,
com.apple.Preview,14,1706230341,1706230355,1706230355.85831,-21600,,
com.apple.finder,4,1706230337,1706230341,1706230341.195538,-21600,,
com.intsig.CamScannerLite,10,1706230330,1706230340,1706230340.774899,-21600,EB445137-D7F5-57EC-87DA-1DB460D64046,"iPhone13,2"
com.intsig.CamScannerLite,131,1706230188,1706230319,1706230319.446662,-21600,EB445137-D7F5-57EC-87DA-1DB460D64046,"iPhone13,2"
com.risesci.nyx,3,1706230182,1706230185,1706230185.346816,-21600,EB445137-D7F5-57EC-87DA-1DB460D64046,"iPhone13,2"
com.google.Chrome,528,1706229809,1706230337,1706230337.852203,-21600,,
com.microsoft.VSCode,75,1706229734,1706229809,1706229809.453576,-21600,,
com.apple.finder,5,1706229729,1706229734,1706229735.047621,-21600,,
com.microsoft.VSCode,581,1706229148,1706229729,1706229729.562015,-21600,,
com.google.Chrome,155,1706228993,1706229148,1706229148.3731542,-21600,,
com.leomehlig.today,18,1706228975,1706228993,1706228993.5150561,-21600,,
com.apple.finder,0,1706228975,1706228975,1706228975.6519651,-21600,,
us.zoom.xos,4,1706228971,1706228975,1706228975.228791,-21600,,
com.apple.iCal,1,1706228970,1706228971,1706228971.061833,-21600,,
com.google.Chrome,7,1706228963,1706228970,1706228970.546567,-21600,,
com.apple.MobileSMS,3,1706228960,1706228963,1706228963.1094708,-21600,,
com.risesci.nyx,4,1706228896,1706228900,1706228900.781807,-21600,EB445137-D7F5-57EC-87DA-1DB460D64046,"iPhone13,2"
com.toyopagroup.picaboo,9,1706228887,1706228896,1706228896.977951,-21600,EB445137-D7F5-57EC-87DA-1DB460D64046,"iPhone13,2"
com.google.Chrome,88,1706228872,1706228960,1706228960.492933,-21600,,
com.toyopagroup.picaboo,3,1706225672,1706225675,1706225675.413444,-21600,EB445137-D7F5-57EC-87DA-1DB460D64046,"iPhone13,2"
com.apple.camera,1,1706225665,1706225666,1706225666.189371,-21600,EB445137-D7F5-57EC-87DA-1DB460D64046,"iPhone13,2"
com.toyopagroup.picaboo,2,1706225452,1706225454,1706225454.9927511,-21600,EB445137-D7F5-57EC-87DA-1DB460D64046,"iPhone13,2"
com.toyopagroup.picaboo,22,1706225308,1706225330,1706225330.82096,-21600,EB445137-D7F5-57EC-87DA-1DB460D64046,"iPhone13,2"
com.apple.camera,0,1706225106,1706225106,1706225106.687753,-21600,EB445137-D7F5-57EC-87DA-1DB460D64046,"iPhone13,2"
com.google.Chrome,3,1706225090,1706225093,1706225093.6304479,-21600,,
com.google.Gmail,46,1706225034,1706225080,1706225080.6580029,-21600,EB445137-D7F5-57EC-87DA-1DB460D64046,"iPhone13,2"
com.google.Chrome,733,1706224286,1706225019,1706225020.613274,-21600,,
com.google.Chrome,317,1706223878,1706224195,1706224195.391008,-21600,,
com.google.Chrome,488,1706223228,1706223716,1706223716.2496982,-21600,,
com.leomehlig.today,10,1706223218,1706223228,1706223229.1041799,-21600,,
com.thestorygraph.thestorygraph,19,1706222022,1706222041,1706222041.685745,-21600,EB445137-D7F5-57EC-87DA-1DB460D64046,"iPhone13,2"
com.apple.weather,3,1706222017,1706222020,1706222020.75743,-21600,EB445137-D7F5-57EC-87DA-1DB460D64046,"iPhone13,2"
com.apple.weather,5,1706222007,1706222012,1706222012.5656428,-21600,EB445137-D7F5-57EC-87DA-1DB460D64046,"iPhone13,2"
com.google.chrome.ios,8,1706221997,1706222005,1706222005.173386,-21600,EB445137-D7F5-57EC-87DA-1DB460D64046,"iPhone13,2"
com.google.Gmail,7,1706221990,1706221997,1706221997.579138,-21600,EB445137-D7F5-57EC-87DA-1DB460D64046,"iPhone13,2"
com.leomehlig.today,82,1706220376,1706220458,1706220459.098702,-21600,,
com.google.Chrome,1396,1706218980,1706220376,1706220377.025455,-21600,,
com.microsoft.Office.Outlook,3,1706218839,1706218842,1706218842.396648,-21600,EB445137-D7F5-57EC-87DA-1DB460D64046,"iPhone13,2"
com.burbn.instagram,63,1706218744,1706218807,1706218807.091963,-21600,EB445137-D7F5-57EC-87DA-1DB460D64046,"iPhone13,2"
com.burbn.instagram,113,1706218625,1706218738,1706218738.177618,-21600,EB445137-D7F5-57EC-87DA-1DB460D64046,"iPhone13,2"
com.google.Chrome,1124,1706217663,1706218787,1706218787.242186,-21600,,
us.zoom.xos,61,1706217602,1706217663,1706217664.0915399,-21600,,
com.toyopagroup.picaboo,3,1706217503,1706217506,1706217506.232287,-21600,EB445137-D7F5-57EC-87DA-1DB460D64046,"iPhone13,2"
com.apple.AppStore,16,1706217266,1706217282,1706217282.802427,-21600,EB445137-D7F5-57EC-87DA-1DB460D64046,"iPhone13,2"
com.google.chrome.ios,10,1706217256,1706217266,1706217266.593677,-21600,EB445137-D7F5-57EC-87DA-1DB460D64046,"iPhone13,2"
com.apple.AppStore,36,1706217220,1706217256,1706217256.486816,-21600,EB445137-D7F5-57EC-87DA-1DB460D64046,"iPhone13,2"
com.risesci.nyx,2,1706217215,1706217217,1706217217.8317971,-21600,EB445137-D7F5-57EC-87DA-1DB460D64046,"iPhone13,2"
com.risesci.nyx,2,1706216766,1706216768,1706216768.44099,-21600,EB445137-D7F5-57EC-87DA-1DB460D64046,"iPhone13,2"
com.risesci.nyx,8,1706216757,1706216765,1706216765.1329122,-21600,EB445137-D7F5-57EC-87DA-1DB460D64046,"iPhone13,2"
com.risesci.nyx,41,1706216504,1706216545,1706216545.580282,-21600,EB445137-D7F5-57EC-87DA-1DB460D64046,"iPhone13,2"
us.zoom.xos,301,1706215413,1706215714,1706215714.0823488,-21600,,
com.toyopagroup.picaboo,22,1706215144,1706215166,1706215166.414153,-21600,EB445137-D7F5-57EC-87DA-1DB460D64046,"iPhone13,2"
com.whentowork.iOS.WhenToWork-Employee-Scheduling,61,1706214483,1706214544,1706214544.919169,-21600,EB445137-D7F5-57EC-87DA-1DB460D64046,"iPhone13,2"
com.microsoft.Office.Outlook,12,1706214471,1706214483,1706214483.1558409,-21600,EB445137-D7F5-57EC-87DA-1DB460D64046,"iPhone13,2"
us.zoom.xos,608,1706214436,1706215044,1706215044.493355,-21600,,
com.apple.iCal,37,1706214399,1706214436,1706214436.2350168,-21600,,
us.zoom.xos,1,1706214398,1706214399,1706214399.945286,-21600,,
com.microsoft.Office.Outlook,88,1706214307,1706214395,1706214395.830501,-21600,EB445137-D7F5-57EC-87DA-1DB460D64046,"iPhone13,2"
us.zoom.xos,341,1706213932,1706214273,1706214273.190413,-21600,,
com.google.Chrome,158,1706213774,1706213932,1706213932.0898929,-21600,,
us.zoom.xos,70,1706213704,1706213774,1706213774.38202,-21600,,
com.google.Chrome,19,1706213685,1706213704,1706213705.008491,-21600,,
com.thestorygraph.thestorygraph,43,1706213575,1706213618,1706213618.1538439,-21600,EB445137-D7F5-57EC-87DA-1DB460D64046,"iPhone13,2"
us.zoom.xos,119,1706213566,1706213685,1706213685.191728,-21600,,
com.apple.news,8,1706213563,1706213571,1706213571.414871,-21600,EB445137-D7F5-57EC-87DA-1DB460D64046,"iPhone13,2"
com.google.Chrome,69,1706213497,1706213566,1706213566.997765,-21600,,
us.zoom.xos,10,1706213487,1706213497,1706213497.64319,-21600,,
com.google.Chrome,34,1706213453,1706213487,1706213487.3368092,-21600,,
com.apple.news,288,1706213164,1706213452,1706213452.8579369,-21600,EB445137-D7F5-57EC-87DA-1DB460D64046,"iPhone13,2"
com.toyopagroup.picaboo,8,1706213042,1706213050,1706213050.520138,-21600,EB445137-D7F5-57EC-87DA-1DB460D64046,"iPhone13,2"
com.risesci.nyx,72,1706212970,1706213042,1706213042.20754,-21600,EB445137-D7F5-57EC-87DA-1DB460D64046,"iPhone13,2"
com.toyopagroup.picaboo,18,1706212945,1706212963,1706212963.7081342,-21600,EB445137-D7F5-57EC-87DA-1DB460D64046,"iPhone13,2"
us.zoom.xos,742,1706212711,1706213453,1706213453.6314058,-21600,,
com.google.Chrome,1,1706212710,1706212711,1706212711.587801,-21600,,
us.zoom.xos,3,1706212707,1706212710,1706212710.273083,-21600,,
com.google.Chrome,45,1706212662,1706212707,1706212707.474001,-21600,,
com.apple.Notes,175,1706212487,1706212662,1706212662.9094539,-21600,,
com.google.Chrome,11,1706212476,1706212487,1706212487.727172,-21600,,
com.apple.Preview,4,1706212472,1706212476,1706212476.872628,-21600,,
com.apple.finder,1,1706212471,1706212472,1706212472.684844,-21600,,
com.apple.Preview,2,1706212469,1706212471,1706212471.115899,-21600,,
com.google.Chrome,613,1706211856,1706212469,1706212469.315213,-21600,,
com.apple.Preview,7,1706211849,1706211856,1706211856.123022,-21600,,
com.google.Chrome,7,1706211842,1706211849,1706211849.143367,-21600,,
com.apple.Preview,3,1706211839,1706211842,1706211842.449634,-21600,,
com.google.Chrome,5,1706211834,1706211839,1706211839.751643,-21600,,
com.apple.Preview,55,1706211779,1706211834,1706211834.909518,-21600,,
com.apple.finder,4,1706211775,1706211779,1706211779.490519,-21600,,
com.apple.Preview,129,1706211646,1706211775,1706211775.1754498,-21600,,
com.google.Chrome,69,1706211577,1706211646,1706211646.385802,-21600,,
com.apple.Preview,2,1706211560,1706211562,1706211562.6195412,-21600,,
com.apple.weather,16,1706211456,1706211472,1706211472.179348,-21600,EB445137-D7F5-57EC-87DA-1DB460D64046,"iPhone13,2"
com.google.chrome.ios,158,1706211290,1706211448,1706211448.234963,-21600,EB445137-D7F5-57EC-87DA-1DB460D64046,"iPhone13,2"
com.google.chrome.ios,30,1706211208,1706211238,1706211240.020581,-21600,EB445137-D7F5-57EC-87DA-1DB460D64046,"iPhone13,2"
com.apple.Preview,318,1706211049,1706211367,1706211367.31076,-21600,,
com.google.Chrome,9,1706211040,1706211049,1706211049.315433,-21600,,
com.apple.Preview,5,1706211035,1706211040,1706211040.241678,-21600,,
com.google.Chrome,12,1706211023,1706211035,1706211035.966953,-21600,,
com.apple.Preview,13,1706211010,1706211023,1706211023.107679,-21600,,
com.apple.finder,11,1706210999,1706211010,1706211010.6709452,-21600,,
com.apple.archiveutility,0,1706210999,1706210999,1706210999.842184,-21600,,
com.apple.finder,3,1706210996,1706210999,1706210999.4501219,-21600,,
com.google.Chrome,3968,1706207028,1706210996,1706210996.219894,-21600,,
com.apple.finder,2,1706207026,1706207028,1706207029.390919,-21600,,
com.google.Chrome,3,1706207023,1706207026,1706207026.7945929,-21600,,
com.leomehlig.today,59,1706206964,1706207023,1706207023.678872,-21600,,
com.google.Chrome,2,1706206962,1706206964,1706206966.624691,-21600,,
com.toyopagroup.picaboo,3,1706206303,1706206306,1706206306.27452,-21600,EB445137-D7F5-57EC-87DA-1DB460D64046,"iPhone13,2"
com.google.Gmail,6,1706205624,1706205630,1706205630.273644,-21600,EB445137-D7F5-57EC-87DA-1DB460D64046,"iPhone13,2"
com.apple.news,287,1706205337,1706205624,1706205624.141471,-21600,EB445137-D7F5-57EC-87DA-1DB460D64046,"iPhone13,2"
com.apple.Health,101,1706205223,1706205324,1706205324.041226,-21600,EB445137-D7F5-57EC-87DA-1DB460D64046,"iPhone13,2"
com.toyopagroup.picaboo,5,1706205208,1706205213,1706205213.178329,-21600,EB445137-D7F5-57EC-87DA-1DB460D64046,"iPhone13,2"
com.toyopagroup.picaboo,52,1706205153,1706205205,1706205205.5455198,-21600,EB445137-D7F5-57EC-87DA-1DB460D64046,"iPhone13,2"
edu.illinois.rokwire.ios,38,1706205042,1706205080,1706205080.147186,-21600,EB445137-D7F5-57EC-87DA-1DB460D64046,"iPhone13,2"
com.toyopagroup.picaboo,4,1706205037,1706205041,1706205041.1685228,-21600,EB445137-D7F5-57EC-87DA-1DB460D64046,"iPhone13,2"
com.toyopagroup.picaboo,16,1706204996,1706205012,1706205012.5999851,-21600,EB445137-D7F5-57EC-87DA-1DB460D64046,"iPhone13,2"
com.microsoft.Office.Outlook,3,1706204993,1706204996,1706204996.486238,-21600,EB445137-D7F5-57EC-87DA-1DB460D64046,"iPhone13,2"
com.microsoft.Office.Outlook,66,1706204353,1706204419,1706204419.39418,-21600,EB445137-D7F5-57EC-87DA-1DB460D64046,"iPhone13,2"
com.google.Gmail,22,1706204331,1706204353,1706204353.7218208,-21600,EB445137-D7F5-57EC-87DA-1DB460D64046,"iPhone13,2"
com.google.Maps,35,1706204296,1706204331,1706204331.975951,-21600,EB445137-D7F5-57EC-87DA-1DB460D64046,"iPhone13,2"
com.google.Maps,24,1706203861,1706203885,1706203885.573275,-21600,EB445137-D7F5-57EC-87DA-1DB460D64046,"iPhone13,2"
com.google.Chrome,4,1706203802,1706203806,1706203806.4693341,-21600,,
com.apple.finder,2,1706203800,1706203802,1706203802.4741511,-21600,,
com.microsoft.Word,1,1706203799,1706203800,1706203801.060673,-21600,,
com.apple.Preview,11,1706203788,1706203799,1706203799.53434,-21600,,
com.apple.finder,7,1706203781,1706203788,1706203789.0208201,-21600,,
com.google.Chrome,40,1706203741,1706203781,1706203781.167227,-21600,,
com.apple.finder,0,1706203741,1706203741,1706203741.9050589,-21600,,
com.google.Chrome,4,1706203737,1706203741,1706203741.298544,-21600,,
com.apple.finder,15,1706203722,1706203737,1706203737.641947,-21600,,
com.google.Chrome,17,1706203705,1706203722,1706203722.679069,-21600,,
com.apple.finder,14,1706203691,1706203705,1706203705.864571,-21600,,
com.microsoft.Word,95,1706203596,1706203691,1706203691.4670038,-21600,,
com.apple.finder,8,1706203588,1706203596,1706203596.123199,-21600,,
com.microsoft.Word,134,1706203454,1706203588,1706203588.550767,-21600,,
com.google.Chrome,2,1706203452,1706203454,1706203454.853973,-21600,,
com.apple.Preview,34,1706203418,1706203452,1706203452.7528,-21600,,
com.apple.finder,15,1706203403,1706203418,1706203418.460894,-21600,,
com.google.Chrome,20,1706203383,1706203403,1706203403.4129438,-21600,,
edu.illinois.rokwire.ios,54,1706203162,1706203216,1706203216.972907,-21600,EB445137-D7F5-57EC-87DA-1DB460D64046,"iPhone13,2"
com.risesci.nyx,7,1706203153,1706203160,1706203160.544168,-21600,EB445137-D7F5-57EC-87DA-1DB460D64046,"iPhone13,2"
com.google.Maps,7,1706203146,1706203153,1706203153.533467,-21600,EB445137-D7F5-57EC-87DA-1DB460D64046,"iPhone13,2"
com.microsoft.Word,310,1706203073,1706203383,1706203383.188078,-21600,,
com.google.Chrome,11,1706203062,1706203073,1706203073.1419702,-21600,,
com.microsoft.Word,443,1706202619,1706203062,1706203062.483485,-21600,,
com.apple.Preview,1,1706202618,1706202619,1706202619.057428,-21600,,
com.microsoft.Word,291,1706202327,1706202618,1706202618.330147,-21600,,
com.apple.Preview,6,1706202321,1706202327,1706202327.863991,-21600,,
com.google.Chrome,1,1706202320,1706202321,1706202321.54571,-21600,,
com.apple.Preview,4,1706202316,1706202320,1706202320.601954,-21600,,
com.microsoft.Word,491,1706201825,1706202316,1706202316.724803,-21600,,
com.microsoft.Word,1064,1706200740,1706201804,1706201804.555799,-21600,,
com.apple.Preview,48,1706200692,1706200740,1706200740.725412,-21600,,
com.microsoft.Word,474,1706200218,1706200692,1706200693.017723,-21600,,
com.google.Chrome,20,1706200198,1706200218,1706200218.418501,-21600,,
com.microsoft.Word,30,1706200168,1706200198,1706200198.9482331,-21600,,
com.apple.Preview,3,1706200165,1706200168,1706200168.594533,-21600,,
com.microsoft.Word,22,1706200143,1706200165,1706200165.051588,-21600,,
com.apple.Preview,8,1706200135,1706200143,1706200143.690732,-21600,,
com.microsoft.Word,7,1706200128,1706200135,1706200135.106375,-21600,,
com.apple.Preview,12,1706200116,1706200128,1706200128.245702,-21600,,
com.microsoft.Word,10,1706200106,1706200116,1706200116.271315,-21600,,
com.apple.Preview,16,1706200090,1706200106,1706200106.589648,-21600,,
com.microsoft.Word,14,1706200076,1706200090,1706200090.803523,-21600,,
com.apple.Preview,23,1706200053,1706200076,1706200076.7486129,-21600,,
com.microsoft.Word,7,1706200046,1706200053,1706200053.1843262,-21600,,
com.apple.Preview,24,1706200022,1706200046,1706200046.5559468,-21600,,
com.microsoft.Word,11,1706200011,1706200022,1706200022.988354,-21600,,
com.apple.Preview,28,1706199983,1706200011,1706200011.184445,-21600,,
com.microsoft.Word,3,1706199980,1706199983,1706199983.343194,-21600,,
com.apple.Preview,6,1706199974,1706199980,1706199980.059484,-21600,,
com.microsoft.Word,3,1706199971,1706199974,1706199974.479795,-21600,,
com.apple.Preview,0,1706199971,1706199971,1706199971.930767,-21600,,
com.microsoft.Word,9,1706199962,1706199971,1706199971.339787,-21600,,
com.apple.Preview,6,1706199956,1706199962,1706199962.6659489,-21600,,
com.microsoft.Word,5,1706199951,1706199956,1706199956.36179,-21600,,
com.apple.Preview,40,1706199911,1706199951,1706199951.6423988,-21600,,
com.microsoft.Word,4,1706199907,1706199911,1706199911.7896419,-21600,,
com.apple.Preview,1,1706199906,1706199907,1706199907.122354,-21600,,
com.microsoft.Word,5,1706199901,1706199906,1706199906.4583979,-21600,,
com.apple.Preview,1,1706199900,1706199901,1706199901.849046,-21600,,
com.microsoft.Word,15,1706199885,1706199900,1706199900.392765,-21600,,
com.apple.Preview,2,1706199883,1706199885,1706199885.2419438,-21600,,
com.microsoft.Word,8,1706199875,1706199883,1706199883.34837,-21600,,
com.apple.Preview,1,1706199874,1706199875,1706199875.989452,-21600,,
com.microsoft.Word,2,1706199872,1706199874,1706199874.915664,-21600,,
com.apple.Preview,5,1706199867,1706199872,1706199872.847497,-21600,,
com.microsoft.Word,11,1706199856,1706199867,1706199867.9171,-21600,,
com.apple.Preview,2,1706199854,1706199856,1706199856.8886461,-21600,,
com.microsoft.Word,12,1706199842,1706199854,1706199854.2795,-21600,,
com.apple.Preview,10,1706199832,1706199842,1706199842.109863,-21600,,
com.microsoft.Word,1,1706199831,1706199832,1706199833.000023,-21600,,
com.apple.Preview,0,1706199831,1706199831,1706199831.948468,-21600,,
com.microsoft.Word,7,1706199824,1706199831,1706199831.040471,-21600,,
com.apple.Preview,1,1706199823,1706199824,1706199824.204776,-21600,,
com.microsoft.Word,1,1706199822,1706199823,1706199823.2816072,-21600,,
com.apple.Preview,3,1706199819,1706199822,1706199822.179913,-21600,,
com.microsoft.Word,3,1706199816,1706199819,1706199819.851365,-21600,,
com.apple.Preview,3,1706199813,1706199816,1706199816.816527,-21600,,
com.microsoft.Word,10,1706199803,1706199813,1706199813.1962051,-21600,,
com.apple.Preview,1,1706199802,1706199803,1706199803.368453,-21600,,
com.microsoft.Word,11,1706199791,1706199802,1706199802.2985091,-21600,,
com.apple.Preview,1,1706199790,1706199791,1706199792.029202,-21600,,
com.microsoft.Word,2,1706199788,1706199790,1706199790.769462,-21600,,
com.apple.Preview,20,1706199768,1706199788,1706199788.596863,-21600,,
com.microsoft.Word,2,1706199766,1706199768,1706199768.398789,-21600,,
com.apple.Preview,24,1706199742,1706199766,1706199766.838047,-21600,,
com.microsoft.Word,18,1706199724,1706199742,1706199742.3529139,-21600,,
com.apple.Preview,9,1706199715,1706199724,1706199724.2590141,-21600,,
com.microsoft.Word,12,1706199703,1706199715,1706199715.171454,-21600,,
com.apple.Preview,18,1706199685,1706199703,1706199703.4881182,-21600,,
com.microsoft.Word,10,1706199675,1706199685,1706199685.3311992,-21600,,
com.apple.Preview,9,1706199666,1706199675,1706199675.943277,-21600,,
com.microsoft.Word,10,1706199656,1706199666,1706199666.141423,-21600,,
com.apple.Preview,2,1706199654,1706199656,1706199656.877015,-21600,,
com.microsoft.Word,7,1706199647,1706199654,1706199654.2824059,-21600,,
com.apple.Preview,2,1706199645,1706199647,1706199647.802373,-21600,,
com.microsoft.Word,3,1706199642,1706199645,1706199645.0418491,-21600,,
com.apple.Preview,41,1706199601,1706199642,1706199642.875756,-21600,,
com.microsoft.Word,3,1706199598,1706199601,1706199601.0619922,-21600,,
com.apple.Preview,8,1706199590,1706199598,1706199598.119917,-21600,,
com.microsoft.Word,4,1706199586,1706199590,1706199590.755636,-21600,,
com.apple.Preview,4,1706199582,1706199586,1706199586.78226,-21600,,
com.microsoft.Word,4,1706199578,1706199582,1706199582.049432,-21600,,
com.apple.Preview,59,1706199519,1706199578,1706199579.062862,-21600,,
com.microsoft.Word,45,1706199474,1706199519,1706199519.614039,-21600,,
com.apple.Preview,36,1706199438,1706199474,1706199474.290477,-21600,,
com.microsoft.Word,5,1706199433,1706199438,1706199438.991704,-21600,,
com.apple.Preview,4,1706199429,1706199433,1706199433.365097,-21600,,
com.microsoft.Word,21,1706199408,1706199429,1706199429.6802058,-21600,,
com.apple.Preview,38,1706199370,1706199408,1706199408.0719419,-21600,,
com.microsoft.Word,36,1706199334,1706199370,1706199370.5608602,-21600,,
com.apple.Preview,7,1706199327,1706199334,1706199334.2897701,-21600,,
com.microsoft.Word,5,1706199322,1706199327,1706199327.645187,-21600,,
com.apple.Preview,79,1706199243,1706199322,1706199322.48239,-21600,,
com.microsoft.Word,167,1706199076,1706199243,1706199243.124412,-21600,,
com.google.Chrome,247,1706198829,1706199076,1706199076.8304892,-21600,,
com.apple.Preview,30,1706198799,1706198829,1706198829.536761,-21600,,
com.apple.finder,15,1706198784,1706198799,1706198799.991506,-21600,,
com.google.Chrome,139,1706198645,1706198784,1706198784.621554,-21600,,
com.microsoft.Word,4,1706198641,1706198645,1706198645.084621,-21600,,
com.apple.Preview,6,1706198635,1706198641,1706198641.9738212,-21600,,
com.apple.finder,14,1706198621,1706198635,1706198635.676958,-21600,,
com.apple.Preview,7,1706198614,1706198621,1706198621.526945,-21600,,
com.apple.finder,9,1706198605,1706198614,1706198614.506614,-21600,,
com.google.Maps,2,1706198402,1706198404,1706198404.988159,-21600,EB445137-D7F5-57EC-87DA-1DB460D64046,"iPhone13,2"
com.google.Chrome,215,1706198390,1706198605,1706198605.59654,-21600,,
com.microsoft.Word,57,1706198333,1706198390,1706198390.230331,-21600,,
com.apple.finder,12,1706198321,1706198333,1706198334.031775,-21600,,
com.google.Chrome,3,1706198318,1706198321,1706198321.8784618,-21600,,
com.apple.finder,8,1706198310,1706198318,1706198318.5058498,-21600,,
com.google.Chrome,82,1706198228,1706198310,1706198310.301252,-21600,,
com.google.Maps,8,1706197748,1706197756,1706197756.977169,-21600,EB445137-D7F5-57EC-87DA-1DB460D64046,"iPhone13,2"
com.google.Maps,18,1706197543,1706197561,1706197561.314956,-21600,EB445137-D7F5-57EC-87DA-1DB460D64046,"iPhone13,2"
com.google.Maps,12,1706197417,1706197429,1706197430.0292912,-21600,EB445137-D7F5-57EC-87DA-1DB460D64046,"iPhone13,2"
com.google.Chrome,3,1706197406,1706197409,1706197409.192595,-21600,,
com.google.Maps,20,1706197066,1706197086,1706197086.444664,-21600,EB445137-D7F5-57EC-87DA-1DB460D64046,"iPhone13,2"
com.toyopagroup.picaboo,12,1706197052,1706197064,1706197064.601602,-21600,EB445137-D7F5-57EC-87DA-1DB460D64046,"iPhone13,2"
com.microsoft.Office.Outlook,36,1706197014,1706197050,1706197050.52876,-21600,EB445137-D7F5-57EC-87DA-1DB460D64046,"iPhone13,2"
com.microsoft.Office.Outlook,20,1706196505,1706196525,1706196525.249485,-21600,EB445137-D7F5-57EC-87DA-1DB460D64046,"iPhone13,2"
com.google.Chrome,968,1706196432,1706197400,1706197400.7553349,-21600,,
com.apple.MobileSMS,2,1706196416,1706196418,1706196418.694169,-21600,EB445137-D7F5-57EC-87DA-1DB460D64046,"iPhone13,2"
com.google.Maps,45,1706196364,1706196409,1706196409.59354,-21600,EB445137-D7F5-57EC-87DA-1DB460D64046,"iPhone13,2"
com.risesci.nyx,77,1706196284,1706196361,1706196361.4999661,-21600,EB445137-D7F5-57EC-87DA-1DB460D64046,"iPhone13,2"
com.apple.Health,10,1706196271,1706196281,1706196281.562762,-21600,EB445137-D7F5-57EC-87DA-1DB460D64046,"iPhone13,2"
com.google.Chrome,792,1706153975,1706154767,1706154767.622071,-21600,,
com.google.Chrome,1747,1706151708,1706153455,1706153455.368394,-21600,,
com.apple.MobileSMS,27,1706151681,1706151708,1706151708.9638948,-21600,,
com.google.Chrome,11,1706151670,1706151681,1706151681.321371,-21600,,
com.google.Chrome,2,1706151098,1706151100,1706151100.8157501,-21600,,
com.leomehlig.today,17,1706151081,1706151098,1706151098.4192019,-21600,,
com.google.Chrome,81,1706151000,1706151081,1706151081.2510781,-21600,,
com.leomehlig.today,23,1706150977,1706151000,1706151000.560676,-21600,,
com.google.Chrome,22,1706150955,1706150977,1706150978.05799,-21600,,
com.apple.finder,12,1706150943,1706150955,1706150955.7764568,-21600,,
com.microsoft.Word,18,1706150925,1706150943,1706150943.979954,-21600,,
com.google.Chrome,2,1706150923,1706150925,1706150926.137065,-21600,,
com.microsoft.Word,0,1706150923,1706150923,1706150924.9855552,-21600,,
com.apple.finder,18,1706150905,1706150923,1706150923.087933,-21600,,
com.google.Chrome,152,1706150753,1706150905,1706150905.281095,-21600,,
com.leomehlig.today,38,1706150715,1706150753,1706150753.58008,-21600,,
com.google.Chrome,946,1706149769,1706150715,1706150715.234066,-21600,,
com.leomehlig.today,1,1706149768,1706149769,1706149769.8955579,-21600,,
com.google.Chrome,544,1706149224,1706149768,1706149768.369277,-21600,,
com.google.Chrome,2027,1706147069,1706149096,1706149096.5695891,-21600,,
com.apple.finder,15,1706147054,1706147069,1706147070.013552,-21600,,
com.leomehlig.today,2,1706147052,1706147054,1706147054.1052551,-21600,,
com.microsoft.VSCode,8,1706147044,1706147052,1706147052.702811,-21600,,
com.leomehlig.today,4,1706147040,1706147044,1706147044.55693,-21600,,
com.google.Chrome,194,1706146846,1706147040,1706147040.874631,-21600,,
com.microsoft.VSCode,1611,1706145235,1706146846,1706146846.616842,-21600,,
com.leomehlig.today,13,1706145222,1706145235,1706145235.277853,-21600,,
com.apple.MobileSMS,31,1706145191,1706145222,1706145223.06675,-21600,,
com.google.Chrome,6,1706145185,1706145191,1706145191.7869182,-21600,,
com.microsoft.Office.Outlook,21,1706143552,1706143573,1706143573.626509,-21600,EB445137-D7F5-57EC-87DA-1DB460D64046,"iPhone13,2"
com.microsoft.Office.Outlook,29,1706143396,1706143425,1706143425.128053,-21600,EB445137-D7F5-57EC-87DA-1DB460D64046,"iPhone13,2"
com.apple.MobileSMS,2,1706143394,1706143396,1706143396.312757,-21600,EB445137-D7F5-57EC-87DA-1DB460D64046,"iPhone13,2"
com.apple.MobileSMS,6,1706143354,1706143360,1706143360.676419,-21600,EB445137-D7F5-57EC-87DA-1DB460D64046,"iPhone13,2"
com.apple.MobileSMS,3,1706142383,1706142386,1706142386.789299,-21600,EB445137-D7F5-57EC-87DA-1DB460D64046,"iPhone13,2"
com.apple.MobileSMS,8,1706142357,1706142365,1706142365.06712,-21600,EB445137-D7F5-57EC-87DA-1DB460D64046,"iPhone13,2"
com.facebook.Facebook,5,1706142352,1706142357,1706142358.067422,-21600,EB445137-D7F5-57EC-87DA-1DB460D64046,"iPhone13,2"
com.facebook.Facebook,10,1706142340,1706142350,1706142350.6695051,-21600,EB445137-D7F5-57EC-87DA-1DB460D64046,"iPhone13,2"
com.facebook.Facebook,10,1706142327,1706142337,1706142337.481235,-21600,EB445137-D7F5-57EC-87DA-1DB460D64046,"iPhone13,2"
com.facebook.Facebook,90,1706142094,1706142184,1706142184.838192,-21600,EB445137-D7F5-57EC-87DA-1DB460D64046,"iPhone13,2"
org.name.serializdmobile,127,1706141704,1706141831,1706141831.185574,-21600,EB445137-D7F5-57EC-87DA-1DB460D64046,"iPhone13,2"
org.name.serializdmobile,6,1706140911,1706140917,1706140917.200556,-21600,EB445137-D7F5-57EC-87DA-1DB460D64046,"iPhone13,2"
org.name.serializdmobile,139,1706140754,1706140893,1706140893.249197,-21600,EB445137-D7F5-57EC-87DA-1DB460D64046,"iPhone13,2"
com.apple.Preferences,98,1706140631,1706140729,1706140729.119837,-21600,EB445137-D7F5-57EC-87DA-1DB460D64046,"iPhone13,2"
com.google.Chrome,402,1706139958,1706140360,1706140360.414322,-21600,,
com.leomehlig.today,1,1706139957,1706139958,1706139959.062367,-21600,,
com.burbn.instagram,44,1706139751,1706139795,1706139795.626001,-21600,EB445137-D7F5-57EC-87DA-1DB460D64046,"iPhone13,2"
com.apple.Music,5,1706139732,1706139737,1706139737.5651932,-21600,EB445137-D7F5-57EC-87DA-1DB460D64046,"iPhone13,2"
com.leomehlig.today,51,1706139608,1706139659,1706139659.048115,-21600,,
com.google.Chrome,9,1706139599,1706139608,1706139608.980266,-21600,,
com.apple.Music,2,1706137632,1706137634,1706137634.0372028,-21600,EB445137-D7F5-57EC-87DA-1DB460D64046,"iPhone13,2"
com.apple.Music,2,1706137182,1706137184,1706137184.0278258,-21600,EB445137-D7F5-57EC-87DA-1DB460D64046,"iPhone13,2"
com.apple.Music,3,1706136843,1706136846,1706136846.769404,-21600,EB445137-D7F5-57EC-87DA-1DB460D64046,"iPhone13,2"
com.apple.camera,14,1706136760,1706136774,1706136774.418678,-21600,EB445137-D7F5-57EC-87DA-1DB460D64046,"iPhone13,2"
com.apple.Music,30,1706136759,1706136789,1706136789.502516,-21600,EB445137-D7F5-57EC-87DA-1DB460D64046,"iPhone13,2"
com.apple.Music,7,1706136751,1706136758,1706136758.8331208,-21600,EB445137-D7F5-57EC-87DA-1DB460D64046,"iPhone13,2"
com.apple.Music,2,1706136740,1706136742,1706136742.810606,-21600,EB445137-D7F5-57EC-87DA-1DB460D64046,"iPhone13,2"
com.apple.Music,9,1706136716,1706136725,1706136725.3666492,-21600,EB445137-D7F5-57EC-87DA-1DB460D64046,"iPhone13,2"
com.apple.Music,2,1706136505,1706136507,1706136507.478684,-21600,EB445137-D7F5-57EC-87DA-1DB460D64046,"iPhone13,2"
com.apple.Music,2,1706136149,1706136151,1706136151.75296,-21600,EB445137-D7F5-57EC-87DA-1DB460D64046,"iPhone13,2"
com.apple.Music,22,1706136124,1706136146,1706136146.990258,-21600,EB445137-D7F5-57EC-87DA-1DB460D64046,"iPhone13,2"
com.apple.news,6,1706136117,1706136123,1706136124.225134,-21600,EB445137-D7F5-57EC-87DA-1DB460D64046,"iPhone13,2"
com.apple.news,49,1706136038,1706136087,1706136087.542193,-21600,EB445137-D7F5-57EC-87DA-1DB460D64046,"iPhone13,2"
com.google.Maps,4,1706136022,1706136026,1706136027.021647,-21600,EB445137-D7F5-57EC-87DA-1DB460D64046,"iPhone13,2"
com.google.Maps,10,1706135969,1706135979,1706135979.07934,-21600,EB445137-D7F5-57EC-87DA-1DB460D64046,"iPhone13,2"
com.google.Maps,50,1706135672,1706135722,1706135722.481256,-21600,EB445137-D7F5-57EC-87DA-1DB460D64046,"iPhone13,2"
com.burbn.instagram,3,1706135665,1706135668,1706135668.213849,-21600,EB445137-D7F5-57EC-87DA-1DB460D64046,"iPhone13,2"
com.burbn.instagram,4,1706135387,1706135391,1706135391.576657,-21600,EB445137-D7F5-57EC-87DA-1DB460D64046,"iPhone13,2"
com.burbn.instagram,1,1706135355,1706135356,1706135356.2015529,-21600,EB445137-D7F5-57EC-87DA-1DB460D64046,"iPhone13,2"
com.burbn.instagram,4,1706135309,1706135313,1706135313.476012,-21600,EB445137-D7F5-57EC-87DA-1DB460D64046,"iPhone13,2"
com.burbn.instagram,34,1706135268,1706135302,1706135302.949215,-21600,EB445137-D7F5-57EC-87DA-1DB460D64046,"iPhone13,2"
com.burbn.instagram,34,1706135220,1706135254,1706135255.033838,-21600,EB445137-D7F5-57EC-87DA-1DB460D64046,"iPhone13,2"
com.apple.Health,133,1706134651,1706134784,1706134784.85535,-21600,EB445137-D7F5-57EC-87DA-1DB460D64046,"iPhone13,2"
com.apple.findmy,11,1706134634,1706134645,1706134645.3840919,-21600,EB445137-D7F5-57EC-87DA-1DB460D64046,"iPhone13,2"
com.hammerandchisel.discord,4,1706134630,1706134634,1706134634.265868,-21600,EB445137-D7F5-57EC-87DA-1DB460D64046,"iPhone13,2"
com.google.Chrome,284,1706134525,1706134809,1706134809.383306,-21600,,
com.leomehlig.today,93,1706134432,1706134525,1706134525.655489,-21600,,
com.google.Chrome,16,1706134416,1706134432,1706134432.550143,-21600,,
com.leomehlig.today,13,1706134403,1706134416,1706134416.141634,-21600,,
com.google.Chrome,88,1706134315,1706134403,1706134404.142443,-21600,,
com.microsoft.VSCode,2,1706134313,1706134315,1706134315.509132,-21600,,
com.hammerandchisel.discord,10,1706134030,1706134040,1706134040.441283,-21600,EB445137-D7F5-57EC-87DA-1DB460D64046,"iPhone13,2"
com.hammerandchisel.discord,59,1706133970,1706134029,1706134029.514849,-21600,EB445137-D7F5-57EC-87DA-1DB460D64046,"iPhone13,2"
com.instructure.icanvas,2,1706133967,1706133969,1706133969.672175,-21600,EB445137-D7F5-57EC-87DA-1DB460D64046,"iPhone13,2"
com.instructure.icanvas,46,1706133916,1706133962,1706133962.880281,-21600,EB445137-D7F5-57EC-87DA-1DB460D64046,"iPhone13,2"
edu.illinois.rokwire.ios,2,1706133914,1706133916,1706133916.405103,-21600,EB445137-D7F5-57EC-87DA-1DB460D64046,"iPhone13,2"
com.markhambly.APOD,35,1706133550,1706133585,1706133585.588872,-21600,EB445137-D7F5-57EC-87DA-1DB460D64046,"iPhone13,2"
com.hammerandchisel.discord,8,1706133521,1706133529,1706133529.196237,-21600,EB445137-D7F5-57EC-87DA-1DB460D64046,"iPhone13,2"
co.hinge.mobile.ios,192,1706133314,1706133506,1706133506.416199,-21600,EB445137-D7F5-57EC-87DA-1DB460D64046,"iPhone13,2"
com.google.chrome.ios,27,1706133287,1706133314,1706133314.606662,-21600,EB445137-D7F5-57EC-87DA-1DB460D64046,"iPhone13,2"
co.hinge.mobile.ios,184,1706133102,1706133286,1706133286.082772,-21600,EB445137-D7F5-57EC-87DA-1DB460D64046,"iPhone13,2"
com.hammerandchisel.discord,68,1706133026,1706133094,1706133094.5807471,-21600,EB445137-D7F5-57EC-87DA-1DB460D64046,"iPhone13,2"
com.instructure.icanvas,5,1706133010,1706133015,1706133015.490005,-21600,EB445137-D7F5-57EC-87DA-1DB460D64046,"iPhone13,2"
com.instructure.icanvas,2,1706132893,1706132895,1706132895.066831,-21600,EB445137-D7F5-57EC-87DA-1DB460D64046,"iPhone13,2"
com.instructure.icanvas,49,1706132479,1706132528,1706132528.2239962,-21600,EB445137-D7F5-57EC-87DA-1DB460D64046,"iPhone13,2"
com.apple.news,176,1706129802,1706129978,1706129978.2597961,-21600,EB445137-D7F5-57EC-87DA-1DB460D64046,"iPhone13,2"
com.apple.mobiletimer,9,1706129784,1706129793,1706129793.986693,-21600,EB445137-D7F5-57EC-87DA-1DB460D64046,"iPhone13,2"
com.apple.Preferences,2,1706129780,1706129782,1706129782.620172,-21600,EB445137-D7F5-57EC-87DA-1DB460D64046,"iPhone13,2"
com.google.Maps,112,1706129663,1706129775,1706129775.663383,-21600,EB445137-D7F5-57EC-87DA-1DB460D64046,"iPhone13,2"
com.risesci.nyx,6,1706129647,1706129653,1706129653.885884,-21600,EB445137-D7F5-57EC-87DA-1DB460D64046,"iPhone13,2"
com.google.Gmail,15,1706129629,1706129644,1706129644.9928641,-21600,EB445137-D7F5-57EC-87DA-1DB460D64046,"iPhone13,2"
com.microsoft.VSCode,743,1706128493,1706129236,1706129236.190332,-21600,,
com.apple.Preview,16,1706128477,1706128493,1706128493.821703,-21600,,
com.microsoft.VSCode,5,1706128472,1706128477,1706128477.8286529,-21600,,
com.google.Chrome,1,1706128471,1706128472,1706128472.8899012,-21600,,
com.microsoft.VSCode,2,1706128469,1706128471,1706128471.4629722,-21600,,
com.google.Chrome,8,1706128461,1706128469,1706128469.670804,-21600,,
com.microsoft.VSCode,14,1706128447,1706128461,1706128462.018021,-21600,,
com.google.Chrome,21,1706128426,1706128447,1706128447.6301079,-21600,,
com.microsoft.VSCode,104,1706128322,1706128426,1706128426.608259,-21600,,
com.leomehlig.today,66,1706128256,1706128322,1706128322.092136,-21600,,
com.apple.MobileSMS,3,1706128253,1706128256,1706128256.392587,-21600,,
com.leomehlig.today,0,1706128253,1706128253,1706128254.205838,-21600,,
com.apple.MobileSMS,0,1706128253,1706128253,1706128253.935399,-21600,,
com.microsoft.VSCode,1157,1706127096,1706128253,1706128253.314087,-21600,,
com.apple.finder,1,1706127095,1706127096,1706127096.1624908,-21600,,
com.apple.Preview,15,1706127080,1706127095,1706127095.2661881,-21600,,
com.apple.finder,2,1706127078,1706127080,1706127080.723367,-21600,,
com.apple.Preview,29,1706127049,1706127078,1706127078.613406,-21600,,
com.apple.finder,4,1706127045,1706127049,1706127049.737529,-21600,,
com.apple.Preview,15,1706127030,1706127045,1706127045.688065,-21600,,
com.microsoft.VSCode,1044,1706125986,1706127030,1706127030.667592,-21600,,
com.google.Chrome,2,1706125984,1706125986,1706125986.843268,-21600,,
com.apple.iCal,8,1706125976,1706125984,1706125984.8076758,-21600,,
com.google.Chrome,6,1706125970,1706125976,1706125976.525677,-21600,,
com.google.Gmail,8,1706122789,1706122797,1706122797.9898791,-21600,EB445137-D7F5-57EC-87DA-1DB460D64046,"iPhone13,2"
com.microsoft.Office.Outlook,18,1706122764,1706122782,1706122782.338527,-21600,EB445137-D7F5-57EC-87DA-1DB460D64046,"iPhone13,2"
com.google.chrome.ios,24,1706122737,1706122761,1706122761.614449,-21600,EB445137-D7F5-57EC-87DA-1DB460D64046,"iPhone13,2"
com.google.Gmail,5,1706122732,1706122737,1706122738.00695,-21600,EB445137-D7F5-57EC-87DA-1DB460D64046,"iPhone13,2"
com.google.Chrome,545,1706122018,1706122563,1706122563.828327,-21600,,
com.google.Chrome,776,1706121225,1706122001,1706122001.323514,-21600,,
com.microsoft.VSCode,7,1706121218,1706121225,1706121225.486864,-21600,,
edu.illinois.rokwire.ios,4,1706121117,1706121121,1706121121.409354,-21600,EB445137-D7F5-57EC-87DA-1DB460D64046,"iPhone13,2"
edu.illinois.rokwire.ios,3,1706121023,1706121026,1706121026.951092,-21600,EB445137-D7F5-57EC-87DA-1DB460D64046,"iPhone13,2"
edu.illinois.rokwire.ios,6,1706120111,1706120117,1706120117.052957,-21600,EB445137-D7F5-57EC-87DA-1DB460D64046,"iPhone13,2"
edu.illinois.rokwire.ios,2,1706119936,1706119938,1706119938.9211478,-21600,EB445137-D7F5-57EC-87DA-1DB460D64046,"iPhone13,2"
edu.illinois.rokwire.ios,53,1706118885,1706118938,1706118938.2787051,-21600,EB445137-D7F5-57EC-87DA-1DB460D64046,"iPhone13,2"
com.amazon.Amazon,65,1706118808,1706118873,1706118874.196467,-21600,EB445137-D7F5-57EC-87DA-1DB460D64046,"iPhone13,2"
com.apple.news,4,1706118800,1706118804,1706118805.034749,-21600,EB445137-D7F5-57EC-87DA-1DB460D64046,"iPhone13,2"
com.apple.news,6,1706118084,1706118090,1706118090.484407,-21600,EB445137-D7F5-57EC-87DA-1DB460D64046,"iPhone13,2"
com.apple.news,80,1706117999,1706118079,1706118079.133041,-21600,EB445137-D7F5-57EC-87DA-1DB460D64046,"iPhone13,2"
com.apple.news,52,1706117913,1706117965,1706117965.869596,-21600,EB445137-D7F5-57EC-87DA-1DB460D64046,"iPhone13,2"
com.toyopagroup.picaboo,23,1706117886,1706117909,1706117909.305732,-21600,EB445137-D7F5-57EC-87DA-1DB460D64046,"iPhone13,2"
com.apple.news,102,1706115596,1706115698,1706115699.005729,-21600,EB445137-D7F5-57EC-87DA-1DB460D64046,"iPhone13,2"
com.toyopagroup.picaboo,28,1706115567,1706115595,1706115595.3916159,-21600,EB445137-D7F5-57EC-87DA-1DB460D64046,"iPhone13,2"
com.google.Maps,2,1706115565,1706115567,1706115568.230589,-21600,EB445137-D7F5-57EC-87DA-1DB460D64046,"iPhone13,2"
com.google.Maps,22,1706114660,1706114682,1706114682.441221,-21600,EB445137-D7F5-57EC-87DA-1DB460D64046,"iPhone13,2"
com.toyopagroup.picaboo,6,1706114596,1706114602,1706114602.281752,-21600,EB445137-D7F5-57EC-87DA-1DB460D64046,"iPhone13,2"
com.toyopagroup.picaboo,4,1706114572,1706114576,1706114576.4834352,-21600,EB445137-D7F5-57EC-87DA-1DB460D64046,"iPhone13,2"
com.microsoft.VSCode,59,1706114351,1706114410,1706114410.846781,-21600,,
com.microsoft.VSCode,6,1706114280,1706114286,1706114286.490861,-21600,,
com.apple.shortcuts,20,1706114253,1706114273,1706114273.376122,-21600,EB445137-D7F5-57EC-87DA-1DB460D64046,"iPhone13,2"
com.risesci.nyx,17,1706114231,1706114248,1706114248.8038049,-21600,EB445137-D7F5-57EC-87DA-1DB460D64046,"iPhone13,2"
com.google.Chrome,80,1706114200,1706114280,1706114280.510905,-21600,,
com.apple.MobileSMS,52,1706114148,1706114200,1706114200.472163,-21600,,
com.google.Chrome,17,1706114131,1706114148,1706114148.573807,-21600,,
com.microsoft.VSCode,3,1706114128,1706114131,1706114131.830303,-21600,,
com.google.Chrome,121,1706114007,1706114128,1706114129.671279,-21600,,
com.microsoft.VSCode,44,1706113963,1706114007,1706114007.234298,-21600,,
com.apple.Preview,38,1706113925,1706113963,1706113963.347217,-21600,,
com.microsoft.VSCode,217,1706113708,1706113925,1706113925.281991,-21600,,
com.apple.Preview,2,1706113706,1706113708,1706113708.3490272,-21600,,
com.microsoft.VSCode,10,1706113696,1706113706,1706113706.486055,-21600,,
com.apple.Preview,2,1706113694,1706113696,1706113696.629953,-21600,,
com.microsoft.VSCode,250,1706113444,1706113694,1706113694.443042,-21600,,
com.apple.finder,5,1706113439,1706113444,1706113444.51543,-21600,,
com.risesci.nyx,21,1706112898,1706112919,1706112919.5698829,-21600,EB445137-D7F5-57EC-87DA-1DB460D64046,"iPhone13,2"
com.apple.Health,9,1706112886,1706112895,1706112896.038049,-21600,EB445137-D7F5-57EC-87DA-1DB460D64046,"iPhone13,2"
com.apple.mobilecal,6,1706112874,1706112880,1706112880.699421,-21600,EB445137-D7F5-57EC-87DA-1DB460D64046,"iPhone13,2"
com.microsoft.VSCode,1048,1706112391,1706113439,1706113439.757537,-21600,,
com.apple.Preview,156,1706112235,1706112391,1706112391.9154,-21600,,
com.microsoft.VSCode,278,1706111957,1706112235,1706112235.624675,-21600,,
com.apple.Preview,66,1706111891,1706111957,1706111957.08376,-21600,,
com.microsoft.VSCode,148,1706111743,1706111891,1706111891.276832,-21600,,
com.apple.Preview,2,1706111741,1706111743,1706111743.5102382,-21600,,
com.microsoft.VSCode,7,1706111734,1706111741,1706111741.888921,-21600,,
com.apple.Preview,6,1706111728,1706111734,1706111734.1368752,-21600,,
com.microsoft.VSCode,0,1706111728,1706111728,1706111729.017513,-21600,,
com.google.Chrome,2,1706111726,1706111728,1706111728.251076,-21600,,
com.microsoft.VSCode,59,1706111667,1706111726,1706111726.907751,-21600,,
com.google.Chrome,2,1706111665,1706111667,1706111667.184052,-21600,,
com.apple.Preview,122,1706111543,1706111665,1706111665.356511,-21600,,
com.apple.finder,8,1706111535,1706111543,1706111543.683385,-21600,,
com.google.Chrome,9,1706111526,1706111535,1706111535.314966,-21600,,
com.microsoft.VSCode,268,1706111258,1706111526,1706111526.3142052,-21600,,
com.microsoft.VSCode,499,1706110735,1706111234,1706111234.021947,-21600,,
com.apple.finder,4,1706110731,1706110735,1706110735.126569,-21600,,
com.microsoft.VSCode,129,1706110602,1706110731,1706110731.808208,-21600,,
com.apple.finder,1,1706110601,1706110602,1706110602.8754082,-21600,,
com.microsoft.VSCode,1,1706110600,1706110601,1706110601.551292,-21600,,
com.apple.finder,6,1706110594,1706110600,1706110600.6144319,-21600,,
com.microsoft.VSCode,19,1706110575,1706110594,1706110594.438585,-21600,,
com.google.Chrome,15,1706110560,1706110575,1706110575.782515,-21600,,
com.microsoft.VSCode,8,1706110552,1706110560,1706110561.078528,-21600,,
com.apple.finder,7,1706110545,1706110552,1706110552.966685,-21600,,
com.microsoft.VSCode,11,1706110534,1706110545,1706110545.209044,-21600,,
com.google.Chrome,101,1706110433,1706110534,1706110534.895232,-21600,,
com.apple.mobilecal,15,1706110404,1706110419,1706110420.014759,-21600,EB445137-D7F5-57EC-87DA-1DB460D64046,"iPhone13,2"
com.apple.mobilecal,3,1706110354,1706110357,1706110357.6902819,-21600,EB445137-D7F5-57EC-87DA-1DB460D64046,"iPhone13,2"
com.apple.mobilecal,1,1706110312,1706110313,1706110313.398767,-21600,EB445137-D7F5-57EC-87DA-1DB460D64046,"iPhone13,2"
com.apple.mobilecal,1,1706110259,1706110260,1706110260.953117,-21600,EB445137-D7F5-57EC-87DA-1DB460D64046,"iPhone13,2"
com.apple.mobilecal,3,1706110251,1706110254,1706110254.840483,-21600,EB445137-D7F5-57EC-87DA-1DB460D64046,"iPhone13,2"
com.thestorygraph.thestorygraph,12,1706074589,1706074601,1706074601.392101,-21600,EB445137-D7F5-57EC-87DA-1DB460D64046,"iPhone13,2"
com.toyopagroup.picaboo,32,1706071065,1706071097,1706071097.7348108,-21600,EB445137-D7F5-57EC-87DA-1DB460D64046,"iPhone13,2"
com.apple.journal,410,1706070648,1706071058,1706071058.606813,-21600,EB445137-D7F5-57EC-87DA-1DB460D64046,"iPhone13,2"
com.apple.mobiletimer,13,1706070631,1706070644,1706070644.8409228,-21600,EB445137-D7F5-57EC-87DA-1DB460D64046,"iPhone13,2"
com.google.Maps,76,1706070545,1706070621,1706070621.620878,-21600,EB445137-D7F5-57EC-87DA-1DB460D64046,"iPhone13,2"
com.google.Maps,2,1706070535,1706070537,1706070537.902429,-21600,EB445137-D7F5-57EC-87DA-1DB460D64046,"iPhone13,2"
com.apple.Health,89,1706070434,1706070523,1706070523.2925549,-21600,EB445137-D7F5-57EC-87DA-1DB460D64046,"iPhone13,2"
com.goodreads.Goodreads,36,1706070396,1706070432,1706070432.251869,-21600,EB445137-D7F5-57EC-87DA-1DB460D64046,"iPhone13,2"
com.thestorygraph.thestorygraph,5,1706070391,1706070396,1706070396.876477,-21600,EB445137-D7F5-57EC-87DA-1DB460D64046,"iPhone13,2"
com.goodreads.Goodreads,33,1706070358,1706070391,1706070391.333446,-21600,EB445137-D7F5-57EC-87DA-1DB460D64046,"iPhone13,2"
com.thestorygraph.thestorygraph,68,1706070288,1706070356,1706070357.0136971,-21600,EB445137-D7F5-57EC-87DA-1DB460D64046,"iPhone13,2"
org.name.serializdmobile,4,1706070277,1706070281,1706070281.790889,-21600,EB445137-D7F5-57EC-87DA-1DB460D64046,"iPhone13,2"
com.apple.camera,1,1706069415,1706069416,1706069417.1142058,-21600,EB445137-D7F5-57EC-87DA-1DB460D64046,"iPhone13,2"
org.name.serializdmobile,5,1706069411,1706069416,1706069417.1135,-21600,EB445137-D7F5-57EC-87DA-1DB460D64046,"iPhone13,2"
com.apple.camera,0,1706069411,1706069411,1706069411.96531,-21600,EB445137-D7F5-57EC-87DA-1DB460D64046,"iPhone13,2"
org.name.serializdmobile,50,1706067128,1706067178,1706067178.106423,-21600,EB445137-D7F5-57EC-87DA-1DB460D64046,"iPhone13,2"
com.google.Chrome,1685,1706065395,1706067080,1706067081.229105,-21600,,
org.name.serializdmobile,4,1706065326,1706065330,1706065330.736099,-21600,EB445137-D7F5-57EC-87DA-1DB460D64046,"iPhone13,2"
org.name.serializdmobile,30,1706064577,1706064607,1706064607.243002,-21600,EB445137-D7F5-57EC-87DA-1DB460D64046,"iPhone13,2"
org.name.serializdmobile,271,1706064240,1706064511,1706064511.924686,-21600,EB445137-D7F5-57EC-87DA-1DB460D64046,"iPhone13,2"
com.toyopagroup.picaboo,2,1706064235,1706064237,1706064238.086175,-21600,EB445137-D7F5-57EC-87DA-1DB460D64046,"iPhone13,2"
com.google.Chrome,1277,1706063870,1706065147,1706065147.869777,-21600,,
com.google.Chrome,301,1706063144,1706063445,1706063445.6754441,-21600,,
com.toyopagroup.picaboo,3,1706062057,1706062060,1706062060.964818,-21600,EB445137-D7F5-57EC-87DA-1DB460D64046,"iPhone13,2"
com.google.chrome.ios,10,1706062046,1706062056,1706062056.088042,-21600,EB445137-D7F5-57EC-87DA-1DB460D64046,"iPhone13,2"
com.google.chrome.ios,3,1706062043,1706062046,1706062046.837418,-21600,EB445137-D7F5-57EC-87DA-1DB460D64046,"iPhone13,2"
com.google.Chrome,658,1706061917,1706062575,1706062575.8090482,-21600,,
com.apple.finder,173,1706061744,1706061917,1706061918.4704518,-21600,,
com.apple.Preview,1,1706061743,1706061744,1706061744.6915278,-21600,,
com.apple.finder,1,1706061742,1706061743,1706061743.712123,-21600,,
com.leomehlig.today,2,1706061740,1706061742,1706061742.069261,-21600,,
com.apple.finder,2,1706061738,1706061740,1706061740.843635,-21600,,
com.leomehlig.today,28,1706061710,1706061738,1706061738.2551289,-21600,,
com.apple.Preview,1671,1706060039,1706061710,1706061710.859208,-21600,,
com.leomehlig.today,8,1706060031,1706060039,1706060039.346839,-21600,,
com.google.chrome.ios,546,1706059300,1706059846,1706059846.161388,-21600,EB445137-D7F5-57EC-87DA-1DB460D64046,"iPhone13,2"
com.clairmail.fth.client,17,1706059267,1706059284,1706059284.15834,-21600,EB445137-D7F5-57EC-87DA-1DB460D64046,"iPhone13,2"
com.apple.AppStore,30,1706059234,1706059264,1706059264.243277,-21600,EB445137-D7F5-57EC-87DA-1DB460D64046,"iPhone13,2"
com.apple.Preferences,4,1706059227,1706059231,1706059232.051574,-21600,EB445137-D7F5-57EC-87DA-1DB460D64046,"iPhone13,2"
com.truebill.truebillnative,54,1706059169,1706059223,1706059223.946023,-21600,EB445137-D7F5-57EC-87DA-1DB460D64046,"iPhone13,2"
com.markhambly.APOD,68,1706059073,1706059141,1706059141.405726,-21600,EB445137-D7F5-57EC-87DA-1DB460D64046,"iPhone13,2"
Astrospheric.Astrospheric,33,1706059026,1706059059,1706059059.775175,-21600,EB445137-D7F5-57EC-87DA-1DB460D64046,"iPhone13,2"
com.risesci.nyx,3,1706058918,1706058921,1706058924.084876,-21600,EB445137-D7F5-57EC-87DA-1DB460D64046,"iPhone13,2"
com.toyopagroup.picaboo,1,1706058905,1706058906,1706058924.031076,-21600,EB445137-D7F5-57EC-87DA-1DB460D64046,"iPhone13,2"
com.leomehlig.today,0,1706058796,1706058796,1706058797.328782,-21600,,
com.apple.Preview,1378,1706057391,1706058769,1706058769.467208,-21600,,
com.apple.finder,3,1706057388,1706057391,1706057391.850786,-21600,,
com.google.Chrome,49,1706057339,1706057388,1706057388.927693,-21600,,
com.google.Chrome,523,1706056034,1706056557,1706056557.7451339,-21600,,
com.google.Chrome,907,1706054733,1706055640,1706055640.300055,-21600,,
com.leomehlig.today,43,1706054690,1706054733,1706054733.665924,-21600,,
com.google.Chrome,4,1706054686,1706054690,1706054690.386116,-21600,,
com.apple.MobileSMS,8,1706054678,1706054686,1706054686.711194,-21600,,
com.google.Chrome,31,1706054647,1706054678,1706054678.301476,-21600,,
com.letterboxd.LetterboxdApp,6,1706051271,1706051277,1706051277.339686,-21600,EB445137-D7F5-57EC-87DA-1DB460D64046,"iPhone13,2"
com.letterboxd.LetterboxdApp,178,1706050875,1706051053,1706051053.9341621,-21600,EB445137-D7F5-57EC-87DA-1DB460D64046,"iPhone13,2"
com.google.Chrome,4,1706048288,1706048292,1706048292.944191,-21600,,
com.google.Chrome,733,1706047554,1706048287,1706048287.771768,-21600,,
com.apple.MobileSMS,16,1706047538,1706047554,1706047554.9646091,-21600,,
com.google.Chrome,7,1706047531,1706047538,1706047538.906304,-21600,,
com.apple.MobileSMS,4,1706047527,1706047531,1706047531.984809,-21600,,
com.google.Chrome,10,1706047517,1706047527,1706047527.877788,-21600,,
com.apple.MobileSMS,5,1706047512,1706047517,1706047517.764528,-21600,,
com.google.Chrome,3,1706047509,1706047512,1706047512.0850391,-21600,,
com.apple.MobileSMS,15,1706047471,1706047486,1706047486.117974,-21600,EB445137-D7F5-57EC-87DA-1DB460D64046,"iPhone13,2"
com.toyopagroup.picaboo,20,1706047451,1706047471,1706047471.333055,-21600,EB445137-D7F5-57EC-87DA-1DB460D64046,"iPhone13,2"
com.google.Chrome,192,1706045055,1706045247,1706045248.078085,-21600,,
us.zoom.xos,128,1706044927,1706045055,1706045055.5513248,-21600,,
us.zoom.xos,301,1706044554,1706044855,1706044855.227398,-21600,,
com.apple.MobileSMS,23,1706044527,1706044550,1706044550.395648,-21600,EB445137-D7F5-57EC-87DA-1DB460D64046,"iPhone13,2"
com.apple.MobileSMS,45,1706044509,1706044554,1706044554.919695,-21600,,
us.zoom.xos,3,1706044506,1706044509,1706044509.16005,-21600,,
us.zoom.xos,307,1706043772,1706044079,1706044079.403806,-21600,,
com.microsoft.Office.Outlook,10,1706043753,1706043763,1706043763.424965,-21600,EB445137-D7F5-57EC-87DA-1DB460D64046,"iPhone13,2"
com.apple.MobileSMS,48,1706043724,1706043772,1706043772.662893,-21600,,
us.zoom.xos,112,1706043612,1706043724,1706043724.485681,-21600,,
com.apple.MobileSMS,2,1706043610,1706043612,1706043612.0410252,-21600,,
us.zoom.xos,74,1706043536,1706043610,1706043610.3341599,-21600,,
com.apple.MobileSMS,36,1706043500,1706043536,1706043536.3344378,-21600,,
edu.illinois.rokwire.ios,42,1706043448,1706043490,1706043490.0699549,-21600,EB445137-D7F5-57EC-87DA-1DB460D64046,"iPhone13,2"
com.apple.MobileSMS,4,1706043444,1706043448,1706043448.204041,-21600,EB445137-D7F5-57EC-87DA-1DB460D64046,"iPhone13,2"
us.zoom.xos,90,1706043410,1706043500,1706043500.8242579,-21600,,
com.google.Chrome,5,1706043405,1706043410,1706043410.1506739,-21600,,
com.apple.MobileSMS,25,1706043380,1706043405,1706043405.548363,-21600,,
us.zoom.xos,54,1706043326,1706043380,1706043380.83012,-21600,,
com.google.Chrome,15,1706043311,1706043326,1706043326.823395,-21600,,
com.apple.MobileSMS,2,1706043309,1706043311,1706043311.220415,-21600,,
us.zoom.xos,123,1706043186,1706043309,1706043309.6259909,-21600,,
us.zoom.xos,801,1706042364,1706043165,1706043165.636338,-21600,,
com.apple.MobileSMS,3,1706042361,1706042364,1706042364.6636992,-21600,,
us.zoom.xos,18,1706042343,1706042361,1706042361.715781,-21600,,
com.apple.MobileSMS,10,1706042333,1706042343,1706042343.364128,-21600,,
us.zoom.xos,38,1706042295,1706042333,1706042333.8964581,-21600,,
com.apple.MobileSMS,9,1706042293,1706042302,1706042302.4660568,-21600,EB445137-D7F5-57EC-87DA-1DB460D64046,"iPhone13,2"
us.zoom.xos,306,1706041644,1706041950,1706041950.8047,-21600,,
com.apple.MobileSMS,6,1706041638,1706041644,1706041644.712709,-21600,,
us.zoom.xos,235,1706041403,1706041638,1706041638.1742501,-21600,,
com.google.Chrome,80,1706041323,1706041403,1706041403.0748801,-21600,,
com.apple.MobileSMS,16,1706041171,1706041187,1706041187.639229,-21600,EB445137-D7F5-57EC-87DA-1DB460D64046,"iPhone13,2"
com.intsig.CamScannerLite,4,1706041166,1706041170,1706041170.889676,-21600,EB445137-D7F5-57EC-87DA-1DB460D64046,"iPhone13,2"
us.zoom.xos,165,1706041158,1706041323,1706041323.294508,-21600,,
com.google.Chrome,69,1706041089,1706041158,1706041158.729199,-21600,,
us.zoom.xos,461,1706040628,1706041089,1706041089.562632,-21600,,
com.intsig.CamScannerLite,10,1706040042,1706040052,1706040052.843605,-21600,EB445137-D7F5-57EC-87DA-1DB460D64046,"iPhone13,2"
us.zoom.xos,654,1706039950,1706040604,1706040604.483728,-21600,,
com.google.Chrome,542,1706039408,1706039950,1706039950.994628,-21600,,
com.intsig.CamScannerLite,4,1706039350,1706039354,1706039354.259661,-21600,EB445137-D7F5-57EC-87DA-1DB460D64046,"iPhone13,2"
com.leomehlig.today,59,1706039349,1706039408,1706039408.194773,-21600,,
com.intsig.CamScannerLite,126,1706038994,1706039120,1706039120.5210981,-21600,EB445137-D7F5-57EC-87DA-1DB460D64046,"iPhone13,2"
com.google.Chrome,393,1706038956,1706039349,1706039349.099004,-21600,,
com.microsoft.Office.Outlook,31,1706038119,1706038150,1706038150.482304,-21600,EB445137-D7F5-57EC-87DA-1DB460D64046,"iPhone13,2"
com.hammerandchisel.discord,16,1706037846,1706037862,1706037862.882441,-21600,EB445137-D7F5-57EC-87DA-1DB460D64046,"iPhone13,2"
com.microsoft.Office.Outlook,9,1706037834,1706037843,1706037843.380701,-21600,EB445137-D7F5-57EC-87DA-1DB460D64046,"iPhone13,2"
com.apple.mobilecal,33,1706037801,1706037834,1706037834.753831,-21600,EB445137-D7F5-57EC-87DA-1DB460D64046,"iPhone13,2"
com.microsoft.Office.Outlook,35,1706037764,1706037799,1706037799.133744,-21600,EB445137-D7F5-57EC-87DA-1DB460D64046,"iPhone13,2"
com.burbn.instagram,90,1706036774,1706036864,1706036864.635995,-21600,EB445137-D7F5-57EC-87DA-1DB460D64046,"iPhone13,2"
com.microsoft.Office.Outlook,28,1706036743,1706036771,1706036771.3054361,-21600,EB445137-D7F5-57EC-87DA-1DB460D64046,"iPhone13,2"
com.apple.Health,21,1706036720,1706036741,1706036741.7378988,-21600,EB445137-D7F5-57EC-87DA-1DB460D64046,"iPhone13,2"
com.amazon.Amazon,95,1706036563,1706036658,1706036658.177545,-21600,EB445137-D7F5-57EC-87DA-1DB460D64046,"iPhone13,2"
com.apple.MobileSMS,3,1706036557,1706036560,1706036560.270308,-21600,EB445137-D7F5-57EC-87DA-1DB460D64046,"iPhone13,2"
com.apple.MobileSMS,2,1706036205,1706036207,1706036208.137906,-21600,EB445137-D7F5-57EC-87DA-1DB460D64046,"iPhone13,2"
com.apple.MobileSMS,4,1706035787,1706035791,1706035791.127572,-21600,EB445137-D7F5-57EC-87DA-1DB460D64046,"iPhone13,2"
com.apple.MobileSMS,20,1706035711,1706035731,1706035731.961611,-21600,EB445137-D7F5-57EC-87DA-1DB460D64046,"iPhone13,2"
com.apple.MobileSMS,4,1706034766,1706034770,1706034770.113852,-21600,EB445137-D7F5-57EC-87DA-1DB460D64046,"iPhone13,2"
com.apple.MobileSMS,6,1706034749,1706034755,1706034755.876534,-21600,EB445137-D7F5-57EC-87DA-1DB460D64046,"iPhone13,2"
com.apple.MobileSMS,1,1706033971,1706033972,1706033972.291964,-21600,EB445137-D7F5-57EC-87DA-1DB460D64046,"iPhone13,2"
com.apple.MobileSMS,37,1706033671,1706033708,1706033708.461968,-21600,EB445137-D7F5-57EC-87DA-1DB460D64046,"iPhone13,2"
com.toyopagroup.picaboo,61,1706033076,1706033137,1706033137.4059482,-21600,EB445137-D7F5-57EC-87DA-1DB460D64046,"iPhone13,2"
com.apple.MobileSMS,17,1706033059,1706033076,1706033076.302754,-21600,EB445137-D7F5-57EC-87DA-1DB460D64046,"iPhone13,2"
com.google.chrome.ios,5,1706033054,1706033059,1706033059.6709728,-21600,EB445137-D7F5-57EC-87DA-1DB460D64046,"iPhone13,2"
com.google.chrome.ios,3,1706032933,1706032936,1706032936.772771,-21600,EB445137-D7F5-57EC-87DA-1DB460D64046,"iPhone13,2"
com.google.chrome.ios,1,1706032653,1706032654,1706032654.8046842,-21600,EB445137-D7F5-57EC-87DA-1DB460D64046,"iPhone13,2"
com.google.chrome.ios,2,1706032606,1706032608,1706032608.6558928,-21600,EB445137-D7F5-57EC-87DA-1DB460D64046,"iPhone13,2"
com.google.chrome.ios,2,1706032590,1706032592,1706032592.104563,-21600,EB445137-D7F5-57EC-87DA-1DB460D64046,"iPhone13,2"
com.google.chrome.ios,77,1706032508,1706032585,1706032585.999558,-21600,EB445137-D7F5-57EC-87DA-1DB460D64046,"iPhone13,2"
com.instructure.icanvas,3,1706032321,1706032324,1706032324.9919028,-21600,EB445137-D7F5-57EC-87DA-1DB460D64046,"iPhone13,2"
com.apple.mobilecal,3,1706032318,1706032321,1706032321.067889,-21600,EB445137-D7F5-57EC-87DA-1DB460D64046,"iPhone13,2"
com.apple.mobilecal,3,1706032272,1706032275,1706032275.6659842,-21600,EB445137-D7F5-57EC-87DA-1DB460D64046,"iPhone13,2"
com.apple.mobilecal,4,1706032226,1706032230,1706032230.598248,-21600,EB445137-D7F5-57EC-87DA-1DB460D64046,"iPhone13,2"
co.hinge.mobile.ios,65,1706032023,1706032088,1706032088.661356,-21600,EB445137-D7F5-57EC-87DA-1DB460D64046,"iPhone13,2"
com.apple.news,65,1706031950,1706032015,1706032015.425918,-21600,EB445137-D7F5-57EC-87DA-1DB460D64046,"iPhone13,2"
com.google.Maps,4,1706031566,1706031570,1706031570.7176108,-21600,EB445137-D7F5-57EC-87DA-1DB460D64046,"iPhone13,2"
com.google.Maps,63,1706031341,1706031404,1706031405.0599241,-21600,EB445137-D7F5-57EC-87DA-1DB460D64046,"iPhone13,2"
com.apple.MobileSMS,61,1706031109,1706031170,1706031170.108427,-21600,EB445137-D7F5-57EC-87DA-1DB460D64046,"iPhone13,2"
com.apple.MobileSMS,1,1706031107,1706031108,1706031108.633738,-21600,EB445137-D7F5-57EC-87DA-1DB460D64046,"iPhone13,2"
com.apple.Health,59,1706031029,1706031088,1706031088.226262,-21600,EB445137-D7F5-57EC-87DA-1DB460D64046,"iPhone13,2"
com.thestorygraph.thestorygraph,3,1706031019,1706031022,1706031023.251389,-21600,EB445137-D7F5-57EC-87DA-1DB460D64046,"iPhone13,2"
com.thestorygraph.thestorygraph,38,1706030364,1706030402,1706030402.128237,-21600,EB445137-D7F5-57EC-87DA-1DB460D64046,"iPhone13,2"
com.google.Maps,4,1706030357,1706030361,1706030361.385803,-21600,EB445137-D7F5-57EC-87DA-1DB460D64046,"iPhone13,2"
com.google.Maps,2,1706030333,1706030335,1706030335.046236,-21600,EB445137-D7F5-57EC-87DA-1DB460D64046,"iPhone13,2"
com.google.Maps,16,1706030293,1706030309,1706030309.016767,-21600,EB445137-D7F5-57EC-87DA-1DB460D64046,"iPhone13,2"
com.google.Maps,10,1706030170,1706030180,1706030180.460964,-21600,EB445137-D7F5-57EC-87DA-1DB460D64046,"iPhone13,2"
com.google.Maps,10,1706029878,1706029888,1706029888.4393501,-21600,EB445137-D7F5-57EC-87DA-1DB460D64046,"iPhone13,2"
com.google.Maps,10,1706029758,1706029768,1706029768.4678411,-21600,EB445137-D7F5-57EC-87DA-1DB460D64046,"iPhone13,2"
com.google.Maps,10,1706029638,1706029648,1706029648.53424,-21600,EB445137-D7F5-57EC-87DA-1DB460D64046,"iPhone13,2"
com.google.Maps,8,1706028696,1706028704,1706028704.571049,-21600,EB445137-D7F5-57EC-87DA-1DB460D64046,"iPhone13,2"
com.google.Maps,8,1706028004,1706028012,1706028012.024627,-21600,EB445137-D7F5-57EC-87DA-1DB460D64046,"iPhone13,2"
com.google.Maps,8,1706027965,1706027973,1706027973.519083,-21600,EB445137-D7F5-57EC-87DA-1DB460D64046,"iPhone13,2"
com.google.Maps,10,1706027832,1706027842,1706027842.595619,-21600,EB445137-D7F5-57EC-87DA-1DB460D64046,"iPhone13,2"
com.risesci.nyx,38,1706027789,1706027827,1706027827.492214,-21600,EB445137-D7F5-57EC-87DA-1DB460D64046,"iPhone13,2"
com.risesci.nyx,18,1706027761,1706027779,1706027779.906107,-21600,EB445137-D7F5-57EC-87DA-1DB460D64046,"iPhone13,2"
com.google.Maps,17,1706027744,1706027761,1706027761.373138,-21600,EB445137-D7F5-57EC-87DA-1DB460D64046,"iPhone13,2"
com.google.Maps,6,1706027670,1706027676,1706027676.665007,-21600,EB445137-D7F5-57EC-87DA-1DB460D64046,"iPhone13,2"
com.google.Maps,20,1706027647,1706027667,1706027667.282021,-21600,EB445137-D7F5-57EC-87DA-1DB460D64046,"iPhone13,2"
com.peacocktv.peacock,3,1706027641,1706027644,1706027644.776528,-21600,EB445137-D7F5-57EC-87DA-1DB460D64046,"iPhone13,2"
com.peacocktv.peacock,1487,1706026086,1706027573,1706027573.429105,-21600,EB445137-D7F5-57EC-87DA-1DB460D64046,"iPhone13,2"
com.google.Maps,2,1706026079,1706026081,1706026081.988513,-21600,EB445137-D7F5-57EC-87DA-1DB460D64046,"iPhone13,2"
com.google.Maps,60,1706024773,1706024833,1706024833.636273,-21600,EB445137-D7F5-57EC-87DA-1DB460D64046,"iPhone13,2"
com.apple.PosterBoard,3,1706024666,1706024669,1706024669.982934,-21600,EB445137-D7F5-57EC-87DA-1DB460D64046,"iPhone13,2"
com.google.Maps,5,1706024561,1706024566,1706024566.387748,-21600,EB445137-D7F5-57EC-87DA-1DB460D64046,"iPhone13,2"
com.google.Maps,12,1706024530,1706024542,1706024542.164947,-21600,EB445137-D7F5-57EC-87DA-1DB460D64046,"iPhone13,2"
com.google.Maps,44,1706024476,1706024520,1706024520.036804,-21600,EB445137-D7F5-57EC-87DA-1DB460D64046,"iPhone13,2"
com.google.Maps,38,1706023479,1706023517,1706023517.889991,-21600,EB445137-D7F5-57EC-87DA-1DB460D64046,"iPhone13,2"
com.burbn.instagram,418,1706023060,1706023478,1706023478.792244,-21600,EB445137-D7F5-57EC-87DA-1DB460D64046,"iPhone13,2"
com.apple.weather,11,1706023033,1706023044,1706023045.025024,-21600,EB445137-D7F5-57EC-87DA-1DB460D64046,"iPhone13,2"
com.apple.news,45,1706022981,1706023026,1706023026.045352,-21600,EB445137-D7F5-57EC-87DA-1DB460D64046,"iPhone13,2"
com.burbn.instagram,33,1706022926,1706022959,1706022959.732595,-21600,EB445137-D7F5-57EC-87DA-1DB460D64046,"iPhone13,2"
com.microsoft.Office.Outlook,56,1706022867,1706022923,1706022923.187941,-21600,EB445137-D7F5-57EC-87DA-1DB460D64046,"iPhone13,2"
com.microsoft.Office.Outlook,40,1706022486,1706022526,1706022526.067538,-21600,EB445137-D7F5-57EC-87DA-1DB460D64046,"iPhone13,2"
com.apple.camera,0,1706022367,1706022367,1706022368.554776,-21600,EB445137-D7F5-57EC-87DA-1DB460D64046,"iPhone13,2"
com.risesci.nyx,49,1706022202,1706022251,1706022251.251539,-21600,EB445137-D7F5-57EC-87DA-1DB460D64046,"iPhone13,2"
com.apple.Health,25,1706022172,1706022197,1706022197.888083,-21600,EB445137-D7F5-57EC-87DA-1DB460D64046,"iPhone13,2"
com.google.Maps,5,1706022165,1706022170,1706022170.6574888,-21600,EB445137-D7F5-57EC-87DA-1DB460D64046,"iPhone13,2"
com.google.Maps,20,1706021935,1706021955,1706021955.906699,-21600,EB445137-D7F5-57EC-87DA-1DB460D64046,"iPhone13,2"
com.google.Chrome,1562,1705983863,1705985425,1705985426.125123,-21600,,
com.google.Chrome,347,1705982555,1705982902,1705982902.3984308,-21600,,
com.google.Chrome,4,1705974438,1705974442,1705974442.610178,-21600,,
com.google.Chrome,313,1705974025,1705974338,1705974338.848442,-21600,,
com.leomehlig.today,20,1705974005,1705974025,1705974025.113153,-21600,,
com.google.Chrome,740,1705973265,1705974005,1705974006.112318,-21600,,
com.leomehlig.today,8,1705973257,1705973265,1705973266.070207,-21600,,
com.google.Chrome,258,1705972999,1705973257,1705973257.446115,-21600,,
com.google.Chrome,524,1705972473,1705972997,1705972997.601904,-21600,,
com.google.Chrome,489,1705971879,1705972368,1705972368.9455981,-21600,,
com.leomehlig.today,13,1705971866,1705971879,1705971879.912221,-21600,,
com.apple.iCal,11,1705971855,1705971866,1705971866.4341002,-21600,,
com.leomehlig.today,5,1705971850,1705971855,1705971855.2812219,-21600,,
com.google.Chrome,10,1705971840,1705971850,1705971851.034544,-21600,,
com.google.Chrome,66,1705953613,1705953679,1705953679.643324,-21600,,
com.google.Chrome,469,1705953042,1705953511,1705953511.683146,-21600,,
us.zoom.xos,12,1705953030,1705953042,1705953042.6191869,-21600,,
com.google.Chrome,90,1705952940,1705953030,1705953030.5446172,-21600,,
us.zoom.xos,87,1705952853,1705952940,1705952940.9759789,-21600,,
com.google.Chrome,12,1705952841,1705952853,1705952853.7753181,-21600,,
us.zoom.xos,89,1705952752,1705952841,1705952842.059988,-21600,,
com.google.Chrome,2,1705952750,1705952752,1705952752.496134,-21600,,
com.google.Chrome,300,1705950924,1705951224,1705951224.758317,-21600,,
com.google.Chrome,690,1705950227,1705950917,1705950917.028353,-21600,,
us.zoom.xos,15,1705950083,1705950098,1705950098.788528,-21600,,
com.google.Chrome,6,1705950077,1705950083,1705950083.324253,-21600,,
us.zoom.xos,6,1705950071,1705950077,1705950077.701098,-21600,,
com.google.Chrome,3,1705950068,1705950071,1705950071.3381739,-21600,,
us.zoom.xos,6,1705950062,1705950068,1705950068.826683,-21600,,
com.google.Chrome,3,1705950059,1705950062,1705950062.5475368,-21600,,
us.zoom.xos,2,1705950057,1705950059,1705950059.903627,-21600,,
com.google.Chrome,6,1705950051,1705950057,1705950057.9682,-21600,,
us.zoom.xos,10,1705950041,1705950051,1705950051.127285,-21600,,
com.google.Chrome,5,1705950036,1705950041,1705950041.24291,-21600,,
us.zoom.xos,27,1705950009,1705950036,1705950036.71143,-21600,,
com.google.Chrome,1,1705950008,1705950009,1705950009.888857,-21600,,
us.zoom.xos,1,1705950007,1705950008,1705950008.071672,-21600,,
com.google.Chrome,30,1705949977,1705950007,1705950007.8877,-21600,,
us.zoom.xos,29,1705949948,1705949977,1705949978.072669,-21600,,
com.google.Chrome,360,1705949588,1705949948,1705949948.729238,-21600,,
com.google.Chrome,165,1705945243,1705945408,1705945408.645899,-21600,,
com.leomehlig.today,26,1705945217,1705945243,1705945243.22294,-21600,,
com.google.Chrome,238,1705944979,1705945217,1705945217.633673,-21600,,
com.google.Chrome,1997,1705942955,1705944952,1705944952.537137,-21600,,
com.microsoft.Outlook,23,1705942932,1705942955,1705942955.802439,-21600,,
com.google.Chrome,542,1705942390,1705942932,1705942932.114512,-21600,,
com.google.Chrome,3,1705941012,1705941015,1705941015.815851,-21600,,
com.google.Chrome,373,1705940639,1705941012,1705941013.624603,-21600,,
